,SuccessfulHandoverCount,TotalSuccessfulHandoverCount,TotalSuccessfulHandoverCountRange,TotalSuccessfulHandoverCountLoadBalancing,TotalSuccessfulHandoverCountOverload,FailedHandoverCount,TotalFailedHandoverCount,AvgQoS,MinQoS,AvgQoS_LoadBased,MinQoS_LoadBased,AvgQoS_RangeBased,MinQoS_RangeBased,GiniLoad,VehicleCount
0,0,0,0,0,0,0,0,1.0,1,1.0,1,1.0,1,0.0,0
1,16,16,0,16,0,0,0,1.0,1,1.0,1,1.0,1,0.2981687554246577,30
2,13,29,0,29,0,0,0,1.0,1,1.0,1,1.0,1,0.31202009050008755,32
3,0,29,0,29,0,0,0,1.0,1,1.0,1,1.0,1,0.2971212644012368,33
4,0,29,0,29,0,0,0,1.0,1,1.0,1,1.0,1,0.299266327258737,34
5,0,29,0,29,0,0,0,1.0,1,1.0,1,1.0,1,0.2781686082604953,36
6,1,30,0,30,0,0,0,1.0,1,1.0,1,1.0,1,0.2514025275151531,38
7,1,31,0,31,0,0,0,1.0,1,1.0,1,1.0,1,0.23371165092071078,40
8,0,31,0,31,0,0,0,1.0,1,1.0,1,1.0,1,0.23371165092071078,40
9,0,31,0,31,0,0,0,1.0,1,1.0,1,1.0,1,0.23371165092071078,40
10,1,32,1,31,0,0,0,1.0,1,1.0,1,1.0,1,0.2549109259444573,41
11,2,34,2,32,0,0,0,1.0,1,1.0,1,1.0,1,0.20710542432533388,40
12,2,36,3,33,0,0,0,1.0,1,1.0,1,1.0,1,0.22162979477070646,39
13,2,38,5,33,0,0,0,1.0,1,1.0,1,1.0,1,0.2573186643930569,37
14,1,39,5,34,0,0,0,1.0,1,1.0,1,1.0,1,0.26662596355372004,35
15,0,39,5,34,0,0,0,1.0,1,1.0,1,1.0,1,0.2789729783887986,36
16,2,41,7,34,0,0,0,1.0,1,1.0,1,1.0,1,0.2775452855796676,34
17,1,42,7,35,0,0,0,1.0,1,1.0,1,1.0,1,0.2854924012765749,33
18,1,43,7,36,0,0,0,1.0,1,1.0,1,1.0,1,0.2701414867119578,34
19,1,44,8,36,0,0,0,1.0,1,1.0,1,1.0,1,0.29642227967498785,34
20,0,44,8,36,0,0,0,1.0,1,1.0,1,1.0,1,0.2762321767309692,34
21,3,47,9,38,0,0,0,1.0,1,1.0,1,1.0,1,0.2803899151279327,36
22,1,48,9,39,0,0,0,1.0,1,1.0,1,1.0,1,0.25348329771455114,35
23,5,53,11,42,0,0,0,1.0,1,1.0,1,1.0,1,0.22775857230036514,35
24,2,55,13,42,0,0,0,1.0,1,1.0,1,1.0,1,0.2170131671793112,35
25,5,60,17,43,0,0,0,1.0,1,1.0,1,1.0,1,0.31607090053498454,35
26,4,64,19,45,0,0,0,1.0,1,1.0,1,1.0,1,0.28493867122561356,36
27,2,66,21,45,0,0,0,1.0,1,1.0,1,1.0,1,0.24155909507835782,34
28,0,66,21,45,0,0,0,1.0,1,1.0,1,1.0,1,0.23977079313775698,35
29,1,67,21,46,0,0,0,1.0,1,1.0,1,1.0,1,0.18372793679395197,33
30,1,68,22,46,0,0,0,1.0,1,1.0,1,1.0,1,0.21604310179297126,33
31,1,69,23,46,0,0,0,1.0,1,1.0,1,1.0,1,0.2888336223831463,33
32,1,70,24,46,0,0,0,1.0,1,1.0,1,1.0,1,0.34920166465456604,32
33,1,71,24,47,0,0,0,1.0,1,1.0,1,1.0,1,0.32547305574401586,33
34,3,74,25,49,0,0,0,1.0,1,1.0,1,1.0,1,0.3087142522248281,33
35,0,74,25,49,0,0,0,1.0,1,1.0,1,1.0,1,0.29275207225629,35
36,1,75,25,50,0,0,0,1.0,1,1.0,1,1.0,1,0.29932184947906076,36
37,2,77,26,51,0,0,0,1.0,1,1.0,1,1.0,1,0.2500424915205002,37
38,1,78,26,52,0,0,0,1.0,1,1.0,1,1.0,1,0.2404801727026674,36
39,1,79,26,53,0,0,0,1.0,1,1.0,1,1.0,1,0.26403766970523723,38
40,1,80,26,54,0,0,0,1.0,1,1.0,1,1.0,1,0.2682302338613531,40
41,1,81,26,55,0,0,0,1.0,1,1.0,1,1.0,1,0.2359634064421726,40
42,3,84,29,55,0,0,0,1.0,1,1.0,1,1.0,1,0.2643366647517936,40
43,3,87,30,57,0,0,0,1.0,1,1.0,1,1.0,1,0.2640161608713309,43
44,1,88,30,58,0,0,0,1.0,1,1.0,1,1.0,1,0.2474211384034103,43
45,1,89,30,59,0,0,0,1.0,1,1.0,1,1.0,1,0.21769510343002021,44
46,1,90,31,59,0,0,0,1.0,1,1.0,1,1.0,1,0.22771015223954566,44
47,0,90,31,59,0,0,0,1.0,1,1.0,1,1.0,1,0.22771015223954566,44
48,3,93,33,60,0,0,0,1.0,1,1.0,1,1.0,1,0.24731222997884791,44
49,0,93,33,60,0,0,0,1.0,1,1.0,1,1.0,1,0.20345236168934505,41
50,0,93,33,60,0,0,0,1.0,1,1.0,1,1.0,1,0.2263918605151332,40
51,0,93,33,60,0,0,0,1.0,1,1.0,1,1.0,1,0.237832584650124,38
52,1,94,34,60,0,0,0,1.0,1,1.0,1,1.0,1,0.33052743537030166,37
53,0,94,34,60,0,0,0,1.0,1,1.0,1,1.0,1,0.33699786693049916,38
54,4,98,36,62,0,0,0,1.0,1,1.0,1,1.0,1,0.3319712286072629,38
55,3,101,37,64,0,0,0,1.0,1,1.0,1,1.0,1,0.33002164568806064,38
56,1,102,38,64,0,0,0,1.0,1,1.0,1,1.0,1,0.31070501080939994,38
57,1,103,39,64,0,0,0,1.0,1,1.0,1,1.0,1,0.2975206200721864,38
58,3,106,42,64,0,0,0,1.0,1,1.0,1,1.0,1,0.3374908931150439,38
59,2,108,42,66,0,0,0,1.0,1,1.0,1,1.0,1,0.2885928038857082,40
60,1,109,43,66,0,0,0,1.0,1,1.0,1,1.0,1,0.2941137626656802,40
61,0,109,43,66,0,0,0,1.0,1,1.0,1,1.0,1,0.2899296666836831,40
62,3,112,44,68,0,0,0,1.0,1,1.0,1,1.0,1,0.2866144730381396,42
63,2,114,45,69,0,0,0,1.0,1,1.0,1,1.0,1,0.2779882223402866,40
64,0,114,45,69,0,0,0,1.0,1,1.0,1,1.0,1,0.27330864974671476,41
65,2,116,46,70,0,0,0,1.0,1,1.0,1,1.0,1,0.2813197040256705,41
66,1,117,47,70,0,0,0,1.0,1,1.0,1,1.0,1,0.30401473092731074,41
67,2,119,47,72,0,0,0,1.0,1,1.0,1,1.0,1,0.2666110262598392,41
68,1,120,48,72,0,0,0,1.0,1,1.0,1,1.0,1,0.27282178248134364,41
69,2,122,49,73,0,0,0,1.0,1,1.0,1,1.0,1,0.2598322658777794,41
70,1,123,49,74,0,0,0,1.0,1,1.0,1,1.0,1,0.2662396740978522,42
71,1,124,50,74,0,0,0,1.0,1,1.0,1,1.0,1,0.2593719852103412,44
72,0,124,50,74,0,0,0,1.0,1,1.0,1,1.0,1,0.2593719852103412,44
73,3,127,50,77,0,0,0,1.0,1,1.0,1,1.0,1,0.21774009762201177,46
74,0,127,50,77,0,0,0,1.0,1,1.0,1,1.0,1,0.24682587663869235,44
75,2,129,51,78,0,0,0,1.0,1,1.0,1,1.0,1,0.18743025881474928,44
76,4,133,53,80,0,0,0,1.0,1,1.0,1,1.0,1,0.25815581971849255,45
77,3,136,53,83,0,0,0,1.0,1,1.0,1,1.0,1,0.1806689612680267,44
78,1,137,54,83,0,0,0,1.0,1,1.0,1,1.0,1,0.24076808819466955,44
79,2,139,54,85,0,0,0,1.0,1,1.0,1,1.0,1,0.2221415422296882,43
80,1,140,55,85,0,0,0,1.0,1,1.0,1,1.0,1,0.21378653982938836,43
81,3,143,58,85,0,0,0,1.0,1,1.0,1,1.0,1,0.28686564472783826,44
82,1,144,59,85,0,0,0,1.0,1,1.0,1,1.0,1,0.2906171537982458,45
83,3,147,61,86,0,0,0,1.0,1,1.0,1,1.0,1,0.302653930870366,45
84,0,147,61,86,0,0,0,1.0,1,1.0,1,1.0,1,0.302653930870366,45
85,1,148,62,86,0,0,0,1.0,1,1.0,1,1.0,1,0.30498103675727883,45
86,1,149,62,87,0,0,0,1.0,1,1.0,1,1.0,1,0.2580282883048909,45
87,0,149,62,87,0,0,0,1.0,1,1.0,1,1.0,1,0.2779926031347468,44
88,1,150,62,88,0,0,0,1.0,1,1.0,1,1.0,1,0.2629821992894202,45
89,0,150,62,88,0,0,0,1.0,1,1.0,1,1.0,1,0.2761135576308376,46
90,0,150,62,88,0,0,0,1.0,1,1.0,1,1.0,1,0.3024193168439656,44
91,1,151,63,88,0,0,0,1.0,1,1.0,1,1.0,1,0.30121816229221743,45
92,0,151,63,88,0,0,0,1.0,1,1.0,1,1.0,1,0.3127951565327486,46
93,0,151,63,88,0,0,0,1.0,1,1.0,1,1.0,1,0.3127951565327486,46
94,0,151,63,88,0,0,0,1.0,1,1.0,1,1.0,1,0.3127951565327486,46
95,1,152,63,89,0,0,0,1.0,1,1.0,1,1.0,1,0.31544708305990155,46
96,1,153,64,89,0,0,0,1.0,1,1.0,1,1.0,1,0.32591784211562325,46
97,1,154,64,90,0,0,0,1.0,1,1.0,1,1.0,1,0.31449145573425497,47
98,1,155,65,90,0,0,0,1.0,1,1.0,1,1.0,1,0.332017937314646,47
99,3,158,66,92,0,0,0,1.0,1,1.0,1,1.0,1,0.32963396754304464,46
100,2,160,67,93,0,0,0,1.0,1,1.0,1,1.0,1,0.334112316506989,48
101,3,163,68,95,0,0,0,1.0,1,1.0,1,1.0,1,0.31313375653481235,49
102,1,164,69,95,0,0,0,1.0,1,1.0,1,1.0,1,0.32042135419477863,49
103,4,168,70,98,0,0,0,1.0,1,1.0,1,1.0,1,0.2570755696668941,48
104,4,172,72,100,0,0,0,1.0,1,1.0,1,1.0,1,0.276175078280852,49
105,4,176,74,102,0,0,0,1.0,1,1.0,1,1.0,1,0.24742215905433337,48
106,1,177,75,102,0,0,0,1.0,1,1.0,1,1.0,1,0.24874186553183242,48
107,1,178,76,102,0,0,0,1.0,1,1.0,1,1.0,1,0.26067046345208866,47
108,1,179,76,103,0,0,0,1.0,1,1.0,1,1.0,1,0.24428275209852326,47
109,4,183,78,105,0,0,0,1.0,1,1.0,1,1.0,1,0.26653822986207515,47
110,3,186,79,107,0,0,0,1.0,1,1.0,1,1.0,1,0.25329860513231767,47
111,7,193,82,111,0,0,0,1.0,1,1.0,1,1.0,1,0.15001319023463833,46
112,4,197,85,112,0,0,0,1.0,1,1.0,1,1.0,1,0.13230679129997228,46
113,1,198,86,112,0,0,0,1.0,1,1.0,1,1.0,1,0.1471007123203296,45
114,0,198,86,112,0,0,0,1.0,1,1.0,1,1.0,1,0.14363458046873567,46
115,1,199,87,112,0,0,0,1.0,1,1.0,1,1.0,1,0.1785004597803044,47
116,0,199,87,112,0,0,0,1.0,1,1.0,1,1.0,1,0.164564000062193,48
117,3,202,90,112,0,0,0,1.0,1,1.0,1,1.0,1,0.1951993685216668,48
118,0,202,90,112,0,0,0,1.0,1,1.0,1,1.0,1,0.19455741816493868,49
119,1,203,91,112,0,0,0,1.0,1,1.0,1,1.0,1,0.21125333140692126,50
120,0,203,91,112,0,0,0,1.0,1,1.0,1,1.0,1,0.21159103968592566,51
121,0,203,91,112,0,0,0,1.0,1,1.0,1,1.0,1,0.21159103968592566,51
122,2,205,92,113,0,0,0,1.0,1,1.0,1,1.0,1,0.15311396378874037,51
123,0,205,92,113,0,0,0,1.0,1,1.0,1,1.0,1,0.15311396378874037,51
124,0,205,92,113,0,0,0,1.0,1,1.0,1,1.0,1,0.15311396378874037,51
125,0,205,92,113,0,0,0,1.0,1,1.0,1,1.0,1,0.20493063978734155,50
126,3,208,94,114,0,0,0,1.0,1,1.0,1,1.0,1,0.21643649216874336,52
127,3,211,94,117,0,0,0,1.0,1,1.0,1,1.0,1,0.18873466956221718,50
128,1,212,94,118,0,0,0,1.0,1,1.0,1,1.0,1,0.16788415500352652,50
129,0,212,94,118,0,0,0,1.0,1,1.0,1,1.0,1,0.19076858531837515,52
130,0,212,94,118,0,0,0,1.0,1,1.0,1,1.0,1,0.19076858531837515,52
131,3,215,95,120,0,0,0,1.0,1,1.0,1,1.0,1,0.1662441296234372,54
132,1,216,96,120,0,0,0,1.0,1,1.0,1,1.0,1,0.1753264532168863,54
133,4,220,97,123,0,0,0,1.0,1,1.0,1,1.0,1,0.1458838625304463,52
134,0,220,97,123,0,0,0,1.0,1,1.0,1,1.0,1,0.15936954764948505,52
135,4,224,101,123,0,0,0,1.0,1,1.0,1,1.0,1,0.17921933168901147,51
136,2,226,102,124,0,0,0,1.0,1,1.0,1,1.0,1,0.1690268700713595,51
137,2,228,103,125,0,0,0,1.0,1,1.0,1,1.0,1,0.13871030922136598,50
138,1,229,104,125,0,0,0,1.0,1,1.0,1,1.0,1,0.1579176807669167,52
139,6,235,106,129,0,0,0,1.0,1,1.0,1,1.0,1,0.15738536600904993,51
140,1,236,107,129,0,0,0,1.0,1,1.0,1,1.0,1,0.15447324000132626,51
141,2,238,108,130,0,0,0,1.0,1,1.0,1,1.0,1,0.1642778604839964,50
142,2,240,110,130,0,0,0,1.0,1,1.0,1,1.0,1,0.1476012442260213,51
143,2,242,110,132,0,0,0,1.0,1,1.0,1,1.0,1,0.154354854261435,48
144,2,244,112,132,0,0,0,1.0,1,1.0,1,1.0,1,0.16883793874414235,49
145,4,248,116,132,0,0,0,1.0,1,1.0,1,1.0,1,0.12317853244418712,47
146,2,250,118,132,0,0,0,1.0,1,1.0,1,1.0,1,0.15013057146948608,49
147,0,250,118,132,0,0,0,1.0,1,1.0,1,1.0,1,0.1286892445284869,46
148,1,251,119,132,0,0,0,1.0,1,1.0,1,1.0,1,0.10934463694894204,47
149,1,252,120,132,0,0,0,1.0,1,1.0,1,1.0,1,0.08488638049445624,46
150,0,252,120,132,0,0,0,1.0,1,1.0,1,1.0,1,0.08046020889685557,47
151,1,253,121,132,0,0,0,1.0,1,1.0,1,1.0,1,0.12770192100413683,46
152,0,253,121,132,0,0,0,1.0,1,1.0,1,1.0,1,0.14774992461654082,45
153,0,253,121,132,0,0,0,1.0,1,1.0,1,1.0,1,0.16100593193536994,46
154,0,253,121,132,0,0,0,1.0,1,1.0,1,1.0,1,0.1746359548119874,44
155,3,256,124,132,0,0,0,1.0,1,1.0,1,1.0,1,0.22070093189641982,45
156,4,260,126,134,0,0,0,1.0,1,1.0,1,1.0,1,0.25076517970963075,43
157,1,261,126,135,0,0,0,1.0,1,1.0,1,1.0,1,0.22110687583154942,42
158,2,263,126,137,0,0,0,1.0,1,1.0,1,1.0,1,0.2006658297467384,43
159,1,264,127,137,0,0,0,1.0,1,1.0,1,1.0,1,0.259810986064528,44
160,2,266,128,138,0,0,0,1.0,1,1.0,1,1.0,1,0.2603294141184486,44
161,5,271,131,140,0,0,0,1.0,1,1.0,1,1.0,1,0.26281859725903994,44
162,5,276,132,144,0,0,0,1.0,1,1.0,1,1.0,1,0.2039227943532023,44
163,8,284,138,146,0,0,0,1.0,1,1.0,1,1.0,1,0.2437423283894771,44
164,3,287,140,147,0,0,0,1.0,1,1.0,1,1.0,1,0.2826525348556637,44
165,5,292,141,151,0,0,0,1.0,1,1.0,1,1.0,1,0.18615959339800012,43
166,0,292,141,151,0,0,0,1.0,1,1.0,1,1.0,1,0.20442863943147935,43
167,1,293,142,151,0,0,0,1.0,1,1.0,1,1.0,1,0.19592959505532362,42
168,0,293,142,151,0,0,0,1.0,1,1.0,1,1.0,1,0.1566206357657968,40
169,0,293,142,151,0,0,0,1.0,1,1.0,1,1.0,1,0.14786020137120215,41
170,0,293,142,151,0,0,0,1.0,1,1.0,1,1.0,1,0.18221794348752152,39
171,1,294,142,152,0,0,0,1.0,1,1.0,1,1.0,1,0.14744847555945712,39
172,0,294,142,152,0,0,0,1.0,1,1.0,1,1.0,1,0.1618817761229502,38
173,2,296,144,152,0,0,0,1.0,1,1.0,1,1.0,1,0.24891081964292555,38
174,1,297,144,153,0,0,0,1.0,1,1.0,1,1.0,1,0.20327617721080504,37
175,2,299,146,153,0,0,0,1.0,1,1.0,1,1.0,1,0.26040507738240887,36
176,1,300,147,153,0,0,0,1.0,1,1.0,1,1.0,1,0.29307288964658446,36
177,1,301,148,153,0,0,0,1.0,1,1.0,1,1.0,1,0.29837913455967513,38
178,1,302,149,153,0,0,0,1.0,1,1.0,1,1.0,1,0.33631155684268726,39
179,4,306,149,157,0,0,0,1.0,1,1.0,1,1.0,1,0.25277457803256137,40
180,1,307,150,157,0,0,0,1.0,1,1.0,1,1.0,1,0.23950900656754678,40
181,0,307,150,157,0,0,0,1.0,1,1.0,1,1.0,1,0.2622151537580629,39
182,1,308,151,157,0,0,0,1.0,1,1.0,1,1.0,1,0.26769612853254576,40
183,1,309,152,157,0,0,0,1.0,1,1.0,1,1.0,1,0.31406850959212385,40
184,0,309,152,157,0,0,0,1.0,1,1.0,1,1.0,1,0.3153417154048716,38
185,2,311,153,158,0,0,0,1.0,1,1.0,1,1.0,1,0.31558784953976615,38
186,3,314,154,160,0,0,0,1.0,1,1.0,1,1.0,1,0.26095108585498733,37
187,3,317,156,161,0,0,0,1.0,1,1.0,1,1.0,1,0.26960809928944873,36
188,5,322,159,163,0,0,0,1.0,1,1.0,1,1.0,1,0.20775421253479462,36
189,1,323,159,164,0,0,0,1.0,1,1.0,1,1.0,1,0.19106659840750187,36
190,1,324,159,165,0,0,0,1.0,1,1.0,1,1.0,1,0.1989113240658215,36
191,1,325,160,165,0,0,0,1.0,1,1.0,1,1.0,1,0.2077686773286434,37
192,1,326,161,165,0,0,0,1.0,1,1.0,1,1.0,1,0.1917054475521913,37
193,2,328,162,166,0,0,0,1.0,1,1.0,1,1.0,1,0.18445880829789763,38
194,0,328,162,166,0,0,0,1.0,1,1.0,1,1.0,1,0.20152165046055798,39
195,3,331,164,167,0,0,0,1.0,1,1.0,1,1.0,1,0.20200870970715679,40
196,0,331,164,167,0,0,0,1.0,1,1.0,1,1.0,1,0.20200870970715679,40
197,0,331,164,167,0,0,0,1.0,1,1.0,1,1.0,1,0.23853558600429753,40
198,2,333,165,168,0,0,0,1.0,1,1.0,1,1.0,1,0.2387111872686664,40
199,1,334,166,168,0,0,0,1.0,1,1.0,1,1.0,1,0.24293391157104222,40
200,0,334,166,168,0,0,0,1.0,1,1.0,1,1.0,1,0.24293391157104222,40
201,2,336,167,169,0,0,0,1.0,1,1.0,1,1.0,1,0.21415462142951344,39
202,0,336,167,169,0,0,0,1.0,1,1.0,1,1.0,1,0.19261866476518077,40
203,2,338,169,169,0,0,0,1.0,1,1.0,1,1.0,1,0.19360046701415087,39
204,1,339,170,169,0,0,0,1.0,1,1.0,1,1.0,1,0.19516506844757328,38
205,1,340,171,169,0,0,0,1.0,1,1.0,1,1.0,1,0.18525491129381924,37
206,0,340,171,169,0,0,0,1.0,1,1.0,1,1.0,1,0.21986939708071035,36
207,2,342,171,171,0,0,0,1.0,1,1.0,1,1.0,1,0.1760286795935704,37
208,0,342,171,171,0,0,0,1.0,1,1.0,1,1.0,1,0.20448090983101594,36
209,1,343,172,171,0,0,0,1.0,1,1.0,1,1.0,1,0.239296859295785,36
210,2,345,174,171,0,0,0,1.0,1,1.0,1,1.0,1,0.2816408403387244,36
211,1,346,174,172,0,0,0,1.0,1,1.0,1,1.0,1,0.2937568375559295,34
212,2,348,175,173,0,0,0,1.0,1,1.0,1,1.0,1,0.2997713169067818,34
213,1,349,175,174,0,0,0,1.0,1,1.0,1,1.0,1,0.3129125345001988,36
214,0,349,175,174,0,0,0,1.0,1,1.0,1,1.0,1,0.2984084141366145,35
215,2,351,177,174,0,0,0,1.0,1,1.0,1,1.0,1,0.2979077323834762,35
216,3,354,177,177,0,0,0,1.0,1,1.0,1,1.0,1,0.24950604926000697,37
217,4,358,178,180,0,0,0,1.0,1,1.0,1,1.0,1,0.22647107851339127,37
218,5,363,182,181,0,0,0,1.0,1,1.0,1,1.0,1,0.20983474901743693,37
219,4,367,183,184,0,0,0,1.0,1,1.0,1,1.0,1,0.167189842950641,37
220,0,367,183,184,0,0,0,1.0,1,1.0,1,1.0,1,0.18108267250637877,38
221,3,370,185,185,0,0,0,1.0,1,1.0,1,1.0,1,0.1184772054983422,39
222,1,371,186,185,0,0,0,1.0,1,1.0,1,1.0,1,0.14101828951123407,39
223,1,372,186,186,0,0,0,1.0,1,1.0,1,1.0,1,0.1307877481086416,40
224,0,372,186,186,0,0,0,1.0,1,1.0,1,1.0,1,0.1278920551358501,40
225,2,374,187,187,0,0,0,1.0,1,1.0,1,1.0,1,0.10073794191955229,39
226,2,376,189,187,0,0,0,1.0,1,1.0,1,1.0,1,0.1665583820787365,39
227,2,378,191,187,0,0,0,1.0,1,1.0,1,1.0,1,0.23851712125237814,39
228,2,380,193,187,0,0,0,1.0,1,1.0,1,1.0,1,0.26039984793931237,38
229,4,384,194,190,0,0,0,1.0,1,1.0,1,1.0,1,0.23349398896315623,39
230,3,387,195,192,0,0,0,1.0,1,1.0,1,1.0,1,0.15825296771821448,38
231,1,388,196,192,0,0,0,1.0,1,1.0,1,1.0,1,0.15384306245126692,38
232,2,390,198,192,0,0,0,1.0,1,1.0,1,1.0,1,0.1847519469069223,37
233,2,392,199,193,0,0,0,1.0,1,1.0,1,1.0,1,0.18040666388759877,36
234,1,393,200,193,0,0,0,1.0,1,1.0,1,1.0,1,0.19330796922208487,34
235,2,395,202,193,0,0,0,1.0,1,1.0,1,1.0,1,0.32093508548118915,34
236,1,396,202,194,0,0,0,1.0,1,1.0,1,1.0,1,0.3059129659956165,33
237,1,397,202,195,0,0,0,1.0,1,1.0,1,1.0,1,0.29711716280280714,32
238,1,398,203,195,0,0,0,1.0,1,1.0,1,1.0,1,0.33901616320641426,32
239,1,399,204,195,0,0,0,1.0,1,1.0,1,1.0,1,0.31663361691590225,31
240,2,401,204,197,0,0,0,1.0,1,1.0,1,1.0,1,0.2650055139783282,28
241,2,403,206,197,0,0,0,1.0,1,1.0,1,1.0,1,0.3608602261967489,27
242,4,407,207,200,0,0,0,1.0,1,1.0,1,1.0,1,0.31433582433325913,29
243,2,409,208,201,0,0,0,1.0,1,1.0,1,1.0,1,0.27871653106977096,28
244,0,409,208,201,0,0,0,1.0,1,1.0,1,1.0,1,0.28716261477450195,28
245,1,410,209,201,0,0,0,1.0,1,1.0,1,1.0,1,0.27422539274496227,27
246,3,413,211,202,0,0,0,1.0,1,1.0,1,1.0,1,0.24178553640394246,25
247,0,413,211,202,0,0,0,1.0,1,1.0,1,1.0,1,0.2538599843148982,26
248,0,413,211,202,0,0,0,1.0,1,1.0,1,1.0,1,0.251299640383231,27
249,1,414,212,202,0,0,0,1.0,1,1.0,1,1.0,1,0.2754567458926265,26
250,0,414,212,202,0,0,0,1.0,1,1.0,1,1.0,1,0.29727329841497846,27
251,0,414,212,202,0,0,0,1.0,1,1.0,1,1.0,1,0.31298490619998226,28
252,1,415,213,202,0,0,0,1.0,1,1.0,1,1.0,1,0.3246694269699427,28
253,1,416,213,203,0,0,0,1.0,1,1.0,1,1.0,1,0.2896314185170372,28
254,0,416,213,203,0,0,0,1.0,1,1.0,1,1.0,1,0.3166423590496356,29
255,2,418,214,204,0,0,0,1.0,1,1.0,1,1.0,1,0.34914557739661783,30
256,3,421,216,205,0,0,0,1.0,1,1.0,1,1.0,1,0.35690338760230694,30
257,4,425,217,208,0,0,0,1.0,1,1.0,1,1.0,1,0.3627240468726322,32
258,2,427,219,208,0,0,0,1.0,1,1.0,1,1.0,1,0.359469483983894,32
259,2,429,219,210,0,0,0,1.0,1,1.0,1,1.0,1,0.33012939973764455,32
260,1,430,220,210,0,0,0,1.0,1,1.0,1,1.0,1,0.2869439268782551,34
261,0,430,220,210,0,0,0,1.0,1,1.0,1,1.0,1,0.3015076819249897,35
262,2,432,222,210,0,0,0,1.0,1,1.0,1,1.0,1,0.3794322871362049,36
263,0,432,222,210,0,0,0,1.0,1,1.0,1,1.0,1,0.3579521519641784,34
264,0,432,222,210,0,0,0,1.0,1,1.0,1,1.0,1,0.3579521519641784,34
265,0,432,222,210,0,0,0,1.0,1,1.0,1,1.0,1,0.39203207334404955,33
266,2,434,223,211,0,0,0,1.0,1,1.0,1,1.0,1,0.3759027543291861,34
267,2,436,223,213,0,0,0,1.0,1,1.0,1,1.0,1,0.3381494797759646,33
268,1,437,223,214,0,0,0,1.0,1,1.0,1,1.0,1,0.3365322508125745,34
269,0,437,223,214,0,0,0,1.0,1,1.0,1,1.0,1,0.3365322508125745,34
270,1,438,223,215,0,0,0,1.0,1,1.0,1,1.0,1,0.3400154770790785,36
271,0,438,223,215,0,0,0,1.0,1,1.0,1,1.0,1,0.3400154770790785,36
272,0,438,223,215,0,0,0,1.0,1,1.0,1,1.0,1,0.3467780011631908,38
273,0,438,223,215,0,0,0,1.0,1,1.0,1,1.0,1,0.3467780011631908,38
274,1,439,224,215,0,0,0,1.0,1,1.0,1,1.0,1,0.36872847138817433,38
275,1,440,224,216,0,0,0,1.0,1,1.0,1,1.0,1,0.3487050928744007,38
276,1,441,224,217,0,0,0,1.0,1,1.0,1,1.0,1,0.36577143729193157,39
277,1,442,224,218,0,0,0,1.0,1,1.0,1,1.0,1,0.3239327748977707,38
278,0,442,224,218,0,0,0,1.0,1,1.0,1,1.0,1,0.304556110151944,38
279,1,443,225,218,0,0,0,1.0,1,1.0,1,1.0,1,0.3089171026258499,38
280,0,443,225,218,0,0,0,1.0,1,1.0,1,1.0,1,0.31278312912727196,38
281,0,443,225,218,0,0,0,1.0,1,1.0,1,1.0,1,0.3116565073386269,38
282,2,445,226,219,0,0,0,1.0,1,1.0,1,1.0,1,0.3220394180524981,38
283,4,449,228,221,0,0,0,1.0,1,1.0,1,1.0,1,0.34831881296884765,38
284,1,450,228,222,0,0,0,1.0,1,1.0,1,1.0,1,0.31331648884615104,39
285,1,451,228,223,0,0,0,1.0,1,1.0,1,1.0,1,0.287378995274057,39
286,0,451,228,223,0,0,0,1.0,1,1.0,1,1.0,1,0.287378995274057,39
287,3,454,228,226,0,0,0,1.0,1,1.0,1,1.0,1,0.238287169678338,39
288,1,455,228,227,0,0,0,1.0,1,1.0,1,1.0,1,0.17984690425214558,39
289,1,456,229,227,0,0,0,1.0,1,1.0,1,1.0,1,0.2268776644631898,39
290,0,456,229,227,0,0,0,1.0,1,1.0,1,1.0,1,0.22717195284533423,39
291,1,457,229,228,0,0,0,1.0,1,1.0,1,1.0,1,0.20882536016851563,39
292,0,457,229,228,0,0,0,1.0,1,1.0,1,1.0,1,0.21805411947790454,40
293,4,461,232,229,0,0,0,1.0,1,1.0,1,1.0,1,0.182500430150121,41
294,2,463,233,230,0,0,0,1.0,1,1.0,1,1.0,1,0.13875900992836396,40
295,2,465,234,231,0,0,0,1.0,1,1.0,1,1.0,1,0.1553382069360295,42
296,3,468,237,231,0,0,0,1.0,1,1.0,1,1.0,1,0.22084571010616133,42
297,5,473,239,234,0,0,0,1.0,1,1.0,1,1.0,1,0.16416538151160026,43
298,2,475,240,235,0,0,0,1.0,1,1.0,1,1.0,1,0.19722917448470875,44
299,4,479,241,238,0,0,0,1.0,1,1.0,1,1.0,1,0.1412199925388195,44
300,2,481,241,240,0,0,0,1.0,1,1.0,1,1.0,1,0.08466947683876631,45
301,1,482,242,240,0,0,0,1.0,1,1.0,1,1.0,1,0.12287363887176356,47
302,2,484,243,241,0,0,0,1.0,1,1.0,1,1.0,1,0.12819167454050548,46
303,1,485,244,241,0,0,0,1.0,1,1.0,1,1.0,1,0.13597017148317836,45
304,3,488,247,241,0,0,0,1.0,1,1.0,1,1.0,1,0.1881194131384001,45
305,0,488,247,241,0,0,0,1.0,1,1.0,1,1.0,1,0.18077309565132763,43
306,2,490,248,242,0,0,0,1.0,1,1.0,1,1.0,1,0.21986866087259507,44
307,4,494,249,245,0,0,0,1.0,1,1.0,1,1.0,1,0.1845103092746357,42
308,2,496,251,245,0,0,0,1.0,1,1.0,1,1.0,1,0.18307531885662584,41
309,0,496,251,245,0,0,0,1.0,1,1.0,1,1.0,1,0.1945470394345876,42
310,0,496,251,245,0,0,0,1.0,1,1.0,1,1.0,1,0.20005700803679582,41
311,0,496,251,245,0,0,0,1.0,1,1.0,1,1.0,1,0.20005700803679582,41
312,1,497,251,246,0,0,0,1.0,1,1.0,1,1.0,1,0.16565564751015016,44
313,0,497,251,246,0,0,0,1.0,1,1.0,1,1.0,1,0.17439753012193018,43
314,0,497,251,246,0,0,0,1.0,1,1.0,1,1.0,1,0.17439753012193018,43
315,0,497,251,246,0,0,0,1.0,1,1.0,1,1.0,1,0.1454454724685366,43
316,1,498,252,246,0,0,0,1.0,1,1.0,1,1.0,1,0.17905550709383936,43
317,0,498,252,246,0,0,0,1.0,1,1.0,1,1.0,1,0.19201891329673718,44
318,3,501,254,247,0,0,0,1.0,1,1.0,1,1.0,1,0.2628499536482722,45
319,3,504,254,250,0,0,0,1.0,1,1.0,1,1.0,1,0.21979691001676757,46
320,2,506,254,252,0,0,0,1.0,1,1.0,1,1.0,1,0.2101577356800013,45
321,0,506,254,252,0,0,0,1.0,1,1.0,1,1.0,1,0.1947728109455382,44
322,0,506,254,252,0,0,0,1.0,1,1.0,1,1.0,1,0.19102092232767828,42
323,4,510,256,254,0,0,0,1.0,1,1.0,1,1.0,1,0.1648110687313684,42
324,0,510,256,254,0,0,0,1.0,1,1.0,1,1.0,1,0.17557642196097986,43
325,2,512,258,254,0,0,0,1.0,1,1.0,1,1.0,1,0.23814352532232852,43
326,1,513,258,255,0,0,0,1.0,1,1.0,1,1.0,1,0.21505499510011475,43
327,5,518,260,258,0,0,0,1.0,1,1.0,1,1.0,1,0.21813970547765782,44
328,0,518,260,258,0,0,0,1.0,1,1.0,1,1.0,1,0.21813970547765782,44
329,0,518,260,258,0,0,0,1.0,1,1.0,1,1.0,1,0.20071110286451682,45
330,0,518,260,258,0,0,0,1.0,1,1.0,1,1.0,1,0.20304481263574137,46
331,0,518,260,258,0,0,0,1.0,1,1.0,1,1.0,1,0.20304481263574137,46
332,1,519,260,259,0,0,0,1.0,1,1.0,1,1.0,1,0.154560067544951,47
333,0,519,260,259,0,0,0,1.0,1,1.0,1,1.0,1,0.16831938558077464,48
334,0,519,260,259,0,0,0,1.0,1,1.0,1,1.0,1,0.16831938558077464,48
335,1,520,261,259,0,0,0,1.0,1,1.0,1,1.0,1,0.1628948554914603,49
336,1,521,261,260,0,0,0,1.0,1,1.0,1,1.0,1,0.164948976656833,50
337,2,523,262,261,0,0,0,1.0,1,1.0,1,1.0,1,0.1720037970732412,51
338,1,524,263,261,0,0,0,1.0,1,1.0,1,1.0,1,0.2031906444858752,51
339,4,528,264,264,0,0,0,1.0,1,1.0,1,1.0,1,0.19728768382860332,51
340,1,529,265,264,0,0,0,1.0,1,1.0,1,1.0,1,0.2195194875861405,51
341,3,532,265,267,0,0,0,1.0,1,1.0,1,1.0,1,0.1697599340048869,51
342,1,533,266,267,0,0,0,1.0,1,1.0,1,1.0,1,0.19669630573849461,51
343,1,534,266,268,0,0,0,1.0,1,1.0,1,1.0,1,0.19503321579576038,51
344,0,534,266,268,0,0,0,1.0,1,1.0,1,1.0,1,0.19461955361177558,50
345,0,534,266,268,0,0,0,1.0,1,1.0,1,1.0,1,0.19461955361177558,50
346,3,537,268,269,0,0,0,1.0,1,1.0,1,1.0,1,0.24880167024007704,50
347,3,540,268,272,0,0,0,1.0,1,1.0,1,1.0,1,0.1971764598977829,51
348,1,541,269,272,0,0,0,1.0,1,1.0,1,1.0,1,0.2181949100089571,52
349,3,544,272,272,0,0,0,1.0,1,1.0,1,1.0,1,0.22968536769034315,54
350,3,547,272,275,0,0,0,1.0,1,1.0,1,1.0,1,0.22537797930377038,54
351,4,551,275,276,0,0,0,1.0,1,1.0,1,1.0,1,0.2257369278805849,54
352,5,556,276,280,0,0,0,1.0,1,1.0,1,1.0,1,0.20376919935216445,56
353,3,559,277,282,0,0,0,1.0,1,1.0,1,1.0,1,0.15290325812493197,54
354,0,559,277,282,0,0,0,1.0,1,1.0,1,1.0,1,0.16804327849405123,53
355,1,560,278,282,0,0,0,1.0,1,1.0,1,1.0,1,0.16129941292461883,54
356,1,561,279,282,0,0,0,1.0,1,1.0,1,1.0,1,0.18138983184097013,54
357,4,565,283,282,0,0,0,1.0,1,1.0,1,1.0,1,0.225921482601997,53
358,0,565,283,282,0,0,0,1.0,1,1.0,1,1.0,1,0.23901624090778995,49
359,0,565,283,282,0,0,0,1.0,1,1.0,1,1.0,1,0.2558562991931965,48
360,0,565,283,282,0,0,0,1.0,1,1.0,1,1.0,1,0.27417785827413876,47
361,1,566,283,283,0,0,0,1.0,1,1.0,1,1.0,1,0.24917191218853066,46
362,0,566,283,283,0,0,0,1.0,1,1.0,1,1.0,1,0.25147425676188273,46
363,2,568,284,284,0,0,0,1.0,1,1.0,1,1.0,1,0.22120525720702888,47
364,0,568,284,284,0,0,0,1.0,1,1.0,1,1.0,1,0.22120525720702888,47
365,0,568,284,284,0,0,0,1.0,1,1.0,1,1.0,1,0.22120525720702888,47
366,3,571,286,285,0,0,0,1.0,1,1.0,1,1.0,1,0.2668385549720667,50
367,0,571,286,285,0,0,0,1.0,1,1.0,1,1.0,1,0.2668385549720667,50
368,1,572,286,286,0,0,0,1.0,1,1.0,1,1.0,1,0.2412363649788732,51
369,1,573,286,287,0,0,0,1.0,1,1.0,1,1.0,1,0.23783057867865237,51
370,2,575,286,289,0,0,0,1.0,1,1.0,1,1.0,1,0.21025871397309917,51
371,2,577,286,291,0,0,0,1.0,1,1.0,1,1.0,1,0.21213297708257636,52
372,0,577,286,291,0,0,0,1.0,1,1.0,1,1.0,1,0.2132540057517584,53
373,2,579,288,291,0,0,0,1.0,1,1.0,1,1.0,1,0.2122879182708565,53
374,2,581,289,292,0,0,0,1.0,1,1.0,1,1.0,1,0.23670186932986037,53
375,5,586,292,294,0,0,0,1.0,1,1.0,1,1.0,1,0.187976337585912,53
376,1,587,293,294,0,0,0,1.0,1,1.0,1,1.0,1,0.1822812785064023,53
377,3,590,295,295,0,0,0,1.0,1,1.0,1,1.0,1,0.16883639196106545,53
378,1,591,296,295,0,0,0,1.0,1,1.0,1,1.0,1,0.1614287354068512,53
379,1,592,297,295,0,0,0,1.0,1,1.0,1,1.0,1,0.1714475698831091,54
380,1,593,298,295,0,0,0,1.0,1,1.0,1,1.0,1,0.16627729334196958,54
381,1,594,299,295,0,0,0,1.0,1,1.0,1,1.0,1,0.18180512618672648,54
382,2,596,301,295,0,0,0,1.0,1,1.0,1,1.0,1,0.19218306865701718,55
383,2,598,302,296,0,0,0,1.0,1,1.0,1,1.0,1,0.17756460232249582,55
384,1,599,303,296,0,0,0,1.0,1,1.0,1,1.0,1,0.20216884670352492,54
385,3,602,303,299,0,0,0,1.0,1,1.0,1,1.0,1,0.17193585514290752,52
386,2,604,304,300,0,0,0,1.0,1,1.0,1,1.0,1,0.15605601717053869,52
387,2,606,305,301,0,0,0,1.0,1,1.0,1,1.0,1,0.17781579929917984,50
388,3,609,306,303,0,0,0,1.0,1,1.0,1,1.0,1,0.16858442153444028,52
389,1,610,306,304,0,0,0,1.0,1,1.0,1,1.0,1,0.1688554262117736,51
390,1,611,307,304,0,0,0,1.0,1,1.0,1,1.0,1,0.18298509368276594,50
391,4,615,309,306,0,0,0,1.0,1,1.0,1,1.0,1,0.17994867877418877,49
392,2,617,311,306,0,0,0,1.0,1,1.0,1,1.0,1,0.2177846700787192,47
393,5,622,313,309,0,0,0,1.0,1,1.0,1,1.0,1,0.2162462236237706,47
394,3,625,315,310,0,0,0,1.0,1,1.0,1,1.0,1,0.22296986323821064,48
395,5,630,317,313,0,0,0,1.0,1,1.0,1,1.0,1,0.26765932405214027,46
396,2,632,318,314,0,0,0,1.0,1,1.0,1,1.0,1,0.29014307047363574,43
397,1,633,318,315,0,0,0,1.0,1,1.0,1,1.0,1,0.28819242401371814,42
398,1,634,319,315,0,0,0,1.0,1,1.0,1,1.0,1,0.33145507621575715,40
399,2,636,319,317,0,0,0,1.0,1,1.0,1,1.0,1,0.2749309240445798,39
400,2,638,320,318,0,0,0,1.0,1,1.0,1,1.0,1,0.23142932622805093,38
401,1,639,320,319,0,0,0,1.0,1,1.0,1,1.0,1,0.24537569125831254,37
402,0,639,320,319,0,0,0,1.0,1,1.0,1,1.0,1,0.23878975980605424,36
403,1,640,321,319,0,0,0,1.0,1,1.0,1,1.0,1,0.19562521351558243,38
404,2,642,323,319,0,0,0,1.0,1,1.0,1,1.0,1,0.23905428513417099,39
405,3,645,323,322,0,0,0,1.0,1,1.0,1,1.0,1,0.1697813590125182,40
406,1,646,323,323,0,0,0,1.0,1,1.0,1,1.0,1,0.13666941762674595,41
407,0,646,323,323,0,0,0,1.0,1,1.0,1,1.0,1,0.12679902644031832,42
408,0,646,323,323,0,0,0,1.0,1,1.0,1,1.0,1,0.1258274220592002,43
409,1,647,324,323,0,0,0,1.0,1,1.0,1,1.0,1,0.16799031604902315,44
410,0,647,324,323,0,0,0,1.0,1,1.0,1,1.0,1,0.18412750982734497,46
411,1,648,325,323,0,0,0,1.0,1,1.0,1,1.0,1,0.2095825366596405,46
412,1,649,325,324,0,0,0,1.0,1,1.0,1,1.0,1,0.21660130622596063,47
413,2,651,326,325,0,0,0,1.0,1,1.0,1,1.0,1,0.24304512048998334,47
414,0,651,326,325,0,0,0,1.0,1,1.0,1,1.0,1,0.24304512048998334,47
415,2,653,326,327,0,0,0,1.0,1,1.0,1,1.0,1,0.23471287389402035,48
416,0,653,326,327,0,0,0,1.0,1,1.0,1,1.0,1,0.23892641013839364,49
417,1,654,326,328,0,0,0,1.0,1,1.0,1,1.0,1,0.21892414393346685,49
418,1,655,326,329,0,0,0,1.0,1,1.0,1,1.0,1,0.21729906909075533,50
419,2,657,326,331,0,0,0,1.0,1,1.0,1,1.0,1,0.19153914788934734,50
420,1,658,327,331,0,0,0,1.0,1,1.0,1,1.0,1,0.18479109296845492,50
421,0,658,327,331,0,0,0,1.0,1,1.0,1,1.0,1,0.18479109296845492,50
422,0,658,327,331,0,0,0,1.0,1,1.0,1,1.0,1,0.20849500580892807,50
423,3,661,330,331,0,0,0,1.0,1,1.0,1,1.0,1,0.24249658751002912,51
424,1,662,330,332,0,0,0,1.0,1,1.0,1,1.0,1,0.22824825427055417,49
425,1,663,331,332,0,0,0,1.0,1,1.0,1,1.0,1,0.24248418969278088,48
426,2,665,331,334,0,0,0,1.0,1,1.0,1,1.0,1,0.21760057523845405,50
427,5,670,334,336,0,0,0,1.0,1,1.0,1,1.0,1,0.2545119821392997,48
428,5,675,337,338,0,0,0,1.0,1,1.0,1,1.0,1,0.31732718110945685,49
429,5,680,337,343,0,0,0,1.0,1,1.0,1,1.0,1,0.2681563179717495,45
430,4,684,339,345,0,0,0,1.0,1,1.0,1,1.0,1,0.24531840532500346,44
431,1,685,339,346,0,0,0,1.0,1,1.0,1,1.0,1,0.23624289817124763,42
432,0,685,339,346,0,0,0,1.0,1,1.0,1,1.0,1,0.2468117452577555,40
433,1,686,340,346,0,0,0,1.0,1,1.0,1,1.0,1,0.26941497207066545,39
434,3,689,342,347,0,0,0,1.0,1,1.0,1,1.0,1,0.21952805458976607,39
435,3,692,345,347,0,0,0,1.0,1,1.0,1,1.0,1,0.3240984997230306,38
436,1,693,345,348,0,0,0,1.0,1,1.0,1,1.0,1,0.29171322461067334,38
437,3,696,346,350,0,0,0,1.0,1,1.0,1,1.0,1,0.263110669657428,39
438,0,696,346,350,0,0,0,1.0,1,1.0,1,1.0,1,0.25809603254365565,38
439,1,697,346,351,0,0,0,1.0,1,1.0,1,1.0,1,0.2632475839505292,39
440,0,697,346,351,0,0,0,1.0,1,1.0,1,1.0,1,0.2632475839505292,39
441,4,701,347,354,0,0,0,1.0,1,1.0,1,1.0,1,0.15398849049535276,41
442,0,701,347,354,0,0,0,1.0,1,1.0,1,1.0,1,0.16601148578798752,42
443,0,701,347,354,0,0,0,1.0,1,1.0,1,1.0,1,0.16601148578798752,42
444,0,701,347,354,0,0,0,1.0,1,1.0,1,1.0,1,0.16598731090572752,43
445,2,703,349,354,0,0,0,1.0,1,1.0,1,1.0,1,0.1824517646633901,44
446,0,703,349,354,0,0,0,1.0,1,1.0,1,1.0,1,0.19444885620874444,44
447,3,706,350,356,0,0,0,1.0,1,1.0,1,1.0,1,0.20878161660688233,47
448,2,708,351,357,0,0,0,1.0,1,1.0,1,1.0,1,0.24293961291841698,46
449,1,709,351,358,0,0,0,1.0,1,1.0,1,1.0,1,0.2247550135795864,46
450,0,709,351,358,0,0,0,1.0,1,1.0,1,1.0,1,0.2585382613012013,46
451,1,710,352,358,0,0,0,1.0,1,1.0,1,1.0,1,0.2795381484821518,47
452,1,711,352,359,0,0,0,1.0,1,1.0,1,1.0,1,0.2888354627683352,47
453,0,711,352,359,0,0,0,1.0,1,1.0,1,1.0,1,0.2888354627683352,47
454,2,713,352,361,0,0,0,1.0,1,1.0,1,1.0,1,0.2333927431807364,46
455,5,718,353,365,0,0,0,1.0,1,1.0,1,1.0,1,0.18560342026450616,47
456,1,719,353,366,0,0,0,1.0,1,1.0,1,1.0,1,0.15553737391716113,49
457,1,720,354,366,0,0,0,1.0,1,1.0,1,1.0,1,0.1816840854503408,50
458,0,720,354,366,0,0,0,1.0,1,1.0,1,1.0,1,0.1816840854503408,50
459,1,721,354,367,0,0,0,1.0,1,1.0,1,1.0,1,0.14661490036241637,52
460,2,723,354,369,0,0,0,1.0,1,1.0,1,1.0,1,0.14921584936135787,53
461,1,724,354,370,0,0,0,1.0,1,1.0,1,1.0,1,0.1541946884513864,54
462,0,724,354,370,0,0,0,1.0,1,1.0,1,1.0,1,0.1541946884513864,54
463,4,728,356,372,0,0,0,1.0,1,1.0,1,1.0,1,0.1534118251350366,55
464,3,731,358,373,0,0,0,1.0,1,1.0,1,1.0,1,0.16953119042381493,56
465,1,732,358,374,0,0,0,1.0,1,1.0,1,1.0,1,0.1496565254465202,54
466,1,733,359,374,0,0,0,1.0,1,1.0,1,1.0,1,0.15900659685986696,54
467,4,737,362,375,0,0,0,1.0,1,1.0,1,1.0,1,0.14402698583063706,51
468,5,742,365,377,0,0,0,1.0,1,1.0,1,1.0,1,0.1207124771439171,51
469,2,744,366,378,0,0,0,1.0,1,1.0,1,1.0,1,0.1539505307101507,48
470,3,747,369,378,0,0,0,1.0,1,1.0,1,1.0,1,0.20133486393954403,47
471,4,751,372,379,0,0,0,1.0,1,1.0,1,1.0,1,0.23054791239225186,44
472,7,758,376,382,0,0,0,1.0,1,1.0,1,1.0,1,0.2625044298135157,43
473,4,762,376,386,0,0,0,1.0,1,1.0,1,1.0,1,0.13652170623397553,41
474,0,762,376,386,0,0,0,1.0,1,1.0,1,1.0,1,0.18784763575876096,39
475,3,765,376,389,0,0,0,1.0,1,1.0,1,1.0,1,0.13103692077312404,40
476,1,766,377,389,0,0,0,1.0,1,1.0,1,1.0,1,0.14086946632094013,38
477,3,769,379,390,0,0,0,1.0,1,1.0,1,1.0,1,0.23900352734764999,35
478,0,769,379,390,0,0,0,1.0,1,1.0,1,1.0,1,0.24325067443660817,35
479,1,770,380,390,0,0,0,1.0,1,1.0,1,1.0,1,0.2788009482145842,32
480,0,770,380,390,0,0,0,1.0,1,1.0,1,1.0,1,0.3016329000691301,32
481,0,770,380,390,0,0,0,1.0,1,1.0,1,1.0,1,0.29242992063943213,33
482,2,772,382,390,0,0,0,1.0,1,1.0,1,1.0,1,0.3552471813049767,34
483,0,772,382,390,0,0,0,1.0,1,1.0,1,1.0,1,0.3542018910986741,32
484,0,772,382,390,0,0,0,1.0,1,1.0,1,1.0,1,0.33743868548839573,33
485,3,775,384,391,0,0,0,1.0,1,1.0,1,1.0,1,0.31143831498092583,34
486,2,777,384,393,0,0,0,1.0,1,1.0,1,1.0,1,0.2877696519009921,36
487,2,779,384,395,0,0,0,1.0,1,1.0,1,1.0,1,0.2336486429143895,36
488,3,782,385,397,0,0,0,1.0,1,1.0,1,1.0,1,0.2083573738981222,37
489,4,786,387,399,0,0,0,1.0,1,1.0,1,1.0,1,0.2347956709863733,38
490,0,786,387,399,0,0,0,1.0,1,1.0,1,1.0,1,0.2347956709863733,38
491,1,787,387,400,0,0,0,1.0,1,1.0,1,1.0,1,0.21153537749494286,37
492,2,789,388,401,0,0,0,1.0,1,1.0,1,1.0,1,0.22968006028770094,37
493,0,789,388,401,0,0,0,1.0,1,1.0,1,1.0,1,0.22968006028770094,37
494,4,793,390,403,0,0,0,1.0,1,1.0,1,1.0,1,0.2384614257724893,39
495,0,793,390,403,0,0,0,1.0,1,1.0,1,1.0,1,0.24212158701265218,40
496,1,794,390,404,0,0,0,1.0,1,1.0,1,1.0,1,0.21827977006165317,40
497,1,795,390,405,0,0,0,1.0,1,1.0,1,1.0,1,0.17201710996622815,43
498,1,796,390,406,0,0,0,1.0,1,1.0,1,1.0,1,0.1392987633425029,43
499,0,796,390,406,0,0,0,1.0,1,1.0,1,1.0,1,0.1489747608319082,44
500,1,797,391,406,0,0,0,1.0,1,1.0,1,1.0,1,0.16163856351990386,45
501,1,798,391,407,0,0,0,1.0,1,1.0,1,1.0,1,0.14830265720953276,45
502,3,801,393,408,0,0,0,1.0,1,1.0,1,1.0,1,0.1614890090941703,45
503,1,802,394,408,0,0,0,1.0,1,1.0,1,1.0,1,0.1695436435876186,46
504,3,805,396,409,0,0,0,1.0,1,1.0,1,1.0,1,0.21996622291859086,47
505,1,806,396,410,0,0,0,1.0,1,1.0,1,1.0,1,0.21067882140977934,42
506,1,807,397,410,0,0,0,1.0,1,1.0,1,1.0,1,0.2701244929961108,41
507,0,807,397,410,0,0,0,1.0,1,1.0,1,1.0,1,0.26271489839814,38
508,4,811,400,411,0,0,0,1.0,1,1.0,1,1.0,1,0.3746801372615299,38
509,0,811,400,411,0,0,0,1.0,1,1.0,1,1.0,1,0.3597526538406765,37
510,0,811,400,411,0,0,0,1.0,1,1.0,1,1.0,1,0.36719081672810977,36
511,2,813,401,412,0,0,0,1.0,1,1.0,1,1.0,1,0.38743536297941394,34
512,0,813,401,412,0,0,0,1.0,1,1.0,1,1.0,1,0.3624323032458983,32
513,0,813,401,412,0,0,0,1.0,1,1.0,1,1.0,1,0.3624323032458983,32
514,1,814,401,413,0,0,0,1.0,1,1.0,1,1.0,1,0.346296745741205,35
515,0,814,401,413,0,0,0,1.0,1,1.0,1,1.0,1,0.346296745741205,35
516,3,817,401,416,0,0,0,1.0,1,1.0,1,1.0,1,0.30933919260184184,36
517,1,818,401,417,0,0,0,1.0,1,1.0,1,1.0,1,0.29870401514255845,36
518,5,823,401,422,0,0,0,1.0,1,1.0,1,1.0,1,0.26776514327020673,39
519,1,824,402,422,0,0,0,1.0,1,1.0,1,1.0,1,0.2557813680094169,39
520,2,826,403,423,0,0,0,1.0,1,1.0,1,1.0,1,0.27442490170756056,39
521,1,827,403,424,0,0,0,1.0,1,1.0,1,1.0,1,0.2454972736851507,40
522,0,827,403,424,0,0,0,1.0,1,1.0,1,1.0,1,0.2454972736851507,40
523,1,828,403,425,0,0,0,1.0,1,1.0,1,1.0,1,0.2473231697529047,41
524,1,829,403,426,0,0,0,1.0,1,1.0,1,1.0,1,0.2301798894182177,41
525,2,831,405,426,0,0,0,1.0,1,1.0,1,1.0,1,0.2479681726133428,40
526,2,833,406,427,0,0,0,1.0,1,1.0,1,1.0,1,0.2688364179514095,40
527,3,836,407,429,0,0,0,1.0,1,1.0,1,1.0,1,0.26557726221615974,40
528,1,837,408,429,0,0,0,1.0,1,1.0,1,1.0,1,0.24711250636581572,40
529,1,838,408,430,0,0,0,1.0,1,1.0,1,1.0,1,0.2504441941904204,39
530,0,838,408,430,0,0,0,1.0,1,1.0,1,1.0,1,0.2504441941904204,39
531,1,839,409,430,0,0,0,1.0,1,1.0,1,1.0,1,0.24357092708218925,39
532,0,839,409,430,0,0,0,1.0,1,1.0,1,1.0,1,0.2508837158042566,40
533,1,840,410,430,0,0,0,1.0,1,1.0,1,1.0,1,0.30606241542613516,40
534,2,842,410,432,0,0,0,1.0,1,1.0,1,1.0,1,0.30150690398330643,42
535,2,844,410,434,0,0,0,1.0,1,1.0,1,1.0,1,0.3002275623584586,42
536,0,844,410,434,0,0,0,1.0,1,1.0,1,1.0,1,0.30662631597279055,43
537,1,845,410,435,0,0,0,1.0,1,1.0,1,1.0,1,0.2623826017250709,43
538,1,846,411,435,0,0,0,1.0,1,1.0,1,1.0,1,0.2897068207638476,44
539,1,847,411,436,0,0,0,1.0,1,1.0,1,1.0,1,0.2735891259554629,44
540,0,847,411,436,0,0,0,1.0,1,1.0,1,1.0,1,0.2735891259554629,44
541,1,848,412,436,0,0,0,1.0,1,1.0,1,1.0,1,0.2646353650717111,45
542,3,851,413,438,0,0,0,1.0,1,1.0,1,1.0,1,0.24056006392590804,46
543,2,853,415,438,0,0,0,1.0,1,1.0,1,1.0,1,0.29328881611507274,43
544,2,855,417,438,0,0,0,1.0,1,1.0,1,1.0,1,0.34320130716832564,42
545,3,858,419,439,0,0,0,1.0,1,1.0,1,1.0,1,0.28845026404552926,43
546,2,860,421,439,0,0,0,1.0,1,1.0,1,1.0,1,0.32347438515426113,41
547,3,863,421,442,0,0,0,1.0,1,1.0,1,1.0,1,0.23993669539184512,40
548,3,866,424,442,0,0,0,1.0,1,1.0,1,1.0,1,0.2790466270362485,40
549,2,868,426,442,0,0,0,1.0,1,1.0,1,1.0,1,0.3164918677415069,39
550,2,870,427,443,0,0,0,1.0,1,1.0,1,1.0,1,0.33102018942815203,38
551,3,873,429,444,0,0,0,1.0,1,1.0,1,1.0,1,0.36277764450849587,38
552,3,876,430,446,0,0,0,1.0,1,1.0,1,1.0,1,0.38744106610336965,39
553,0,876,430,446,0,0,0,1.0,1,1.0,1,1.0,1,0.38128462255972195,38
554,4,880,431,449,0,0,0,1.0,1,1.0,1,1.0,1,0.3367093276013674,39
555,0,880,431,449,0,0,0,1.0,1,1.0,1,1.0,1,0.33429389035025264,39
556,3,883,432,451,0,0,0,1.0,1,1.0,1,1.0,1,0.31148269190427413,40
557,1,884,432,452,0,0,0,1.0,1,1.0,1,1.0,1,0.3084777891082453,40
558,0,884,432,452,0,0,0,1.0,1,1.0,1,1.0,1,0.3084777891082453,40
559,2,886,433,453,0,0,0,1.0,1,1.0,1,1.0,1,0.2735968625698787,40
560,2,888,433,455,0,0,0,1.0,1,1.0,1,1.0,1,0.23710496620521912,41
561,2,890,434,456,0,0,0,1.0,1,1.0,1,1.0,1,0.22947665345497914,42
562,1,891,435,456,0,0,0,1.0,1,1.0,1,1.0,1,0.25117087016443607,42
563,1,892,436,456,0,0,0,1.0,1,1.0,1,1.0,1,0.2852987898470188,42
564,2,894,436,458,0,0,0,1.0,1,1.0,1,1.0,1,0.2769930956196577,43
565,3,897,438,459,0,0,0,1.0,1,1.0,1,1.0,1,0.30505609226786223,44
566,2,899,438,461,0,0,0,1.0,1,1.0,1,1.0,1,0.27603884129645184,45
567,0,899,438,461,0,0,0,1.0,1,1.0,1,1.0,1,0.27603884129645184,45
568,3,902,438,464,0,0,0,1.0,1,1.0,1,1.0,1,0.1919342320005219,46
569,1,903,439,464,0,0,0,1.0,1,1.0,1,1.0,1,0.1855301823274916,47
570,2,905,440,465,0,0,0,1.0,1,1.0,1,1.0,1,0.2037774782108781,48
571,1,906,441,465,0,0,0,1.0,1,1.0,1,1.0,1,0.23092430229117308,48
572,0,906,441,465,0,0,0,1.0,1,1.0,1,1.0,1,0.22619615102233162,47
573,0,906,441,465,0,0,0,1.0,1,1.0,1,1.0,1,0.22733378007396407,49
574,0,906,441,465,0,0,0,1.0,1,1.0,1,1.0,1,0.22733378007396407,49
575,3,909,441,468,0,0,0,1.0,1,1.0,1,1.0,1,0.16333562023544318,50
576,0,909,441,468,0,0,0,1.0,1,1.0,1,1.0,1,0.17876875635527426,51
577,0,909,441,468,0,0,0,1.0,1,1.0,1,1.0,1,0.17876875635527426,51
578,0,909,441,468,0,0,0,1.0,1,1.0,1,1.0,1,0.17876875635527426,51
579,2,911,443,468,0,0,0,1.0,1,1.0,1,1.0,1,0.2099669219212762,52
580,1,912,443,469,0,0,0,1.0,1,1.0,1,1.0,1,0.2300325381414744,52
581,1,913,443,470,0,0,0,1.0,1,1.0,1,1.0,1,0.2144568102215451,52
582,3,916,443,473,0,0,0,1.0,1,1.0,1,1.0,1,0.19232094727635557,53
583,2,918,445,473,0,0,0,1.0,1,1.0,1,1.0,1,0.22869866320360335,51
584,7,925,449,476,0,0,0,1.0,1,1.0,1,1.0,1,0.22990403796187064,51
585,4,929,452,477,0,0,0,1.0,1,1.0,1,1.0,1,0.23821977776616146,49
586,5,934,456,478,0,0,0,1.0,1,1.0,1,1.0,1,0.22085597872686796,49
587,1,935,457,478,0,0,0,1.0,1,1.0,1,1.0,1,0.22183769249990445,48
588,2,937,459,478,0,0,0,1.0,1,1.0,1,1.0,1,0.22719584035314774,46
589,2,939,460,479,0,0,0,1.0,1,1.0,1,1.0,1,0.22148278547055042,48
590,2,941,461,480,0,0,0,1.0,1,1.0,1,1.0,1,0.21576267596888815,47
591,3,944,462,482,0,0,0,1.0,1,1.0,1,1.0,1,0.22439696205522508,48
592,0,944,462,482,0,0,0,1.0,1,1.0,1,1.0,1,0.20649908856475094,47
593,1,945,463,482,0,0,0,1.0,1,1.0,1,1.0,1,0.22872888251288553,45
594,1,946,464,482,0,0,0,1.0,1,1.0,1,1.0,1,0.22390220582714343,44
595,4,950,467,483,0,0,0,1.0,1,1.0,1,1.0,1,0.24265073655179836,43
596,5,955,469,486,0,0,0,1.0,1,1.0,1,1.0,1,0.27709550000204497,44
597,2,957,469,488,0,0,0,1.0,1,1.0,1,1.0,1,0.2586951187762645,43
598,1,958,470,488,0,0,0,1.0,1,1.0,1,1.0,1,0.24899219568048428,45
599,2,960,471,489,0,0,0,1.0,1,1.0,1,1.0,1,0.22976342239279243,44
600,0,960,471,489,0,0,0,1.0,1,1.0,1,1.0,1,0.22976342239279243,44
601,0,960,471,489,0,0,0,1.0,1,1.0,1,1.0,1,0.23833227982381963,45
602,2,962,473,489,0,0,0,1.0,1,1.0,1,1.0,1,0.29179831284143926,46
603,2,964,473,491,0,0,0,1.0,1,1.0,1,1.0,1,0.23665788085726502,46
604,3,967,475,492,0,0,0,1.0,1,1.0,1,1.0,1,0.24764344803515473,47
605,1,968,475,493,0,0,0,1.0,1,1.0,1,1.0,1,0.2283835037754752,47
606,0,968,475,493,0,0,0,1.0,1,1.0,1,1.0,1,0.2394776507611514,47
607,0,968,475,493,0,0,0,1.0,1,1.0,1,1.0,1,0.23982110204787127,48
608,0,968,475,493,0,0,0,1.0,1,1.0,1,1.0,1,0.26581580886991235,47
609,3,971,475,496,0,0,0,1.0,1,1.0,1,1.0,1,0.20928994619652047,48
610,1,972,475,497,0,0,0,1.0,1,1.0,1,1.0,1,0.19423775877479163,48
611,3,975,477,498,0,0,0,1.0,1,1.0,1,1.0,1,0.17309748317679963,49
612,0,975,477,498,0,0,0,1.0,1,1.0,1,1.0,1,0.20540470102721456,50
613,3,978,478,500,0,0,0,1.0,1,1.0,1,1.0,1,0.1811186136927566,50
614,0,978,478,500,0,0,0,1.0,1,1.0,1,1.0,1,0.1811186136927566,50
615,2,980,479,501,0,0,0,1.0,1,1.0,1,1.0,1,0.1810520492224631,50
616,2,982,480,502,0,0,0,1.0,1,1.0,1,1.0,1,0.17901473884788288,50
617,4,986,481,505,0,0,0,1.0,1,1.0,1,1.0,1,0.16249610558050062,52
618,0,986,481,505,0,0,0,1.0,1,1.0,1,1.0,1,0.16249610558050062,52
619,2,988,482,506,0,0,0,1.0,1,1.0,1,1.0,1,0.17433678865799512,50
620,0,988,482,506,0,0,0,1.0,1,1.0,1,1.0,1,0.16936034223546506,50
621,1,989,483,506,0,0,0,1.0,1,1.0,1,1.0,1,0.1831816144733864,49
622,0,989,483,506,0,0,0,1.0,1,1.0,1,1.0,1,0.18087481233910607,49
623,3,992,485,507,0,0,0,1.0,1,1.0,1,1.0,1,0.2170384688424331,48
624,4,996,487,509,0,0,0,1.0,1,1.0,1,1.0,1,0.2413258052685635,46
625,3,999,488,511,0,0,0,1.0,1,1.0,1,1.0,1,0.19838847306239685,45
626,3,1002,491,511,0,0,0,1.0,1,1.0,1,1.0,1,0.26291029770148056,44
627,5,1007,493,514,0,0,0,1.0,1,1.0,1,1.0,1,0.19890067135749878,44
628,2,1009,494,515,0,0,0,1.0,1,1.0,1,1.0,1,0.20412565562078724,44
629,0,1009,494,515,0,0,0,1.0,1,1.0,1,1.0,1,0.21799441233865927,41
630,1,1010,495,515,0,0,0,1.0,1,1.0,1,1.0,1,0.24517561020134226,40
631,2,1012,496,516,0,0,0,1.0,1,1.0,1,1.0,1,0.2791740114816253,38
632,4,1016,499,517,0,0,0,1.0,1,1.0,1,1.0,1,0.30387223904399807,38
633,1,1017,500,517,0,0,0,1.0,1,1.0,1,1.0,1,0.32693907292896907,36
634,1,1018,501,517,0,0,0,1.0,1,1.0,1,1.0,1,0.3426244135808594,35
635,0,1018,501,517,0,0,0,1.0,1,1.0,1,1.0,1,0.3426244135808594,35
636,0,1018,501,517,0,0,0,1.0,1,1.0,1,1.0,1,0.3479735053253186,36
637,0,1018,501,517,0,0,0,1.0,1,1.0,1,1.0,1,0.3459496529229047,35
638,3,1021,503,518,0,0,0,1.0,1,1.0,1,1.0,1,0.3442942927123262,34
639,1,1022,504,518,0,0,0,1.0,1,1.0,1,1.0,1,0.32550530951935314,36
640,5,1027,505,522,0,0,0,1.0,1,1.0,1,1.0,1,0.29373463070172406,37
641,0,1027,505,522,0,0,0,1.0,1,1.0,1,1.0,1,0.29373463070172406,37
642,0,1027,505,522,0,0,0,1.0,1,1.0,1,1.0,1,0.26657018937201143,38
643,2,1029,505,524,0,0,0,1.0,1,1.0,1,1.0,1,0.21344135549262808,39
644,1,1030,506,524,0,0,0,1.0,1,1.0,1,1.0,1,0.25156220831645126,39
645,1,1031,506,525,0,0,0,1.0,1,1.0,1,1.0,1,0.23881660663467869,39
646,2,1033,507,526,0,0,0,1.0,1,1.0,1,1.0,1,0.29555045893595183,40
647,2,1035,507,528,0,0,0,1.0,1,1.0,1,1.0,1,0.25348655922118735,40
648,1,1036,508,528,0,0,0,1.0,1,1.0,1,1.0,1,0.2583458507424464,40
649,1,1037,508,529,0,0,0,1.0,1,1.0,1,1.0,1,0.2523218971980832,40
650,4,1041,510,531,0,0,0,1.0,1,1.0,1,1.0,1,0.2502964814049666,41
651,1,1042,511,531,0,0,0,1.0,1,1.0,1,1.0,1,0.2447058587337553,42
652,1,1043,511,532,0,0,0,1.0,1,1.0,1,1.0,1,0.2500586838918461,41
653,1,1044,511,533,0,0,0,1.0,1,1.0,1,1.0,1,0.23855860547385435,41
654,1,1045,511,534,0,0,0,1.0,1,1.0,1,1.0,1,0.2376378089353942,42
655,2,1047,511,536,0,0,0,1.0,1,1.0,1,1.0,1,0.20773923843629924,45
656,3,1050,514,536,0,0,0,1.0,1,1.0,1,1.0,1,0.3177070566246612,45
657,3,1053,514,539,0,0,0,1.0,1,1.0,1,1.0,1,0.20061099228185358,43
658,3,1056,517,539,0,0,0,1.0,1,1.0,1,1.0,1,0.27944021900575927,43
659,0,1056,517,539,0,0,0,1.0,1,1.0,1,1.0,1,0.2801969171505653,43
660,2,1058,519,539,0,0,0,1.0,1,1.0,1,1.0,1,0.3460898026868593,43
661,0,1058,519,539,0,0,0,1.0,1,1.0,1,1.0,1,0.3565611681772341,41
662,3,1061,520,541,0,0,0,1.0,1,1.0,1,1.0,1,0.3871155458263067,40
663,3,1064,522,542,0,0,0,1.0,1,1.0,1,1.0,1,0.383523391239324,39
664,3,1067,524,543,0,0,0,1.0,1,1.0,1,1.0,1,0.42645250695148873,36
665,4,1071,525,546,0,0,0,1.0,1,1.0,1,1.0,1,0.3633777149134303,36
666,4,1075,527,548,0,0,0,1.0,1,1.0,1,1.0,1,0.3231440228177717,36
667,2,1077,527,550,0,0,0,1.0,1,1.0,1,1.0,1,0.2756100803263691,35
668,0,1077,527,550,0,0,0,1.0,1,1.0,1,1.0,1,0.2875955227429951,34
669,2,1079,528,551,0,0,0,1.0,1,1.0,1,1.0,1,0.3045474838853355,34
670,2,1081,529,552,0,0,0,1.0,1,1.0,1,1.0,1,0.33680962692603167,32
671,2,1083,530,553,0,0,0,1.0,1,1.0,1,1.0,1,0.30338578911548475,33
672,1,1084,530,554,0,0,0,1.0,1,1.0,1,1.0,1,0.3168034834471585,32
673,4,1088,531,557,0,0,0,1.0,1,1.0,1,1.0,1,0.2281089881118371,32
674,0,1088,531,557,0,0,0,1.0,1,1.0,1,1.0,1,0.25271768236840725,32
675,5,1093,533,560,0,0,0,1.0,1,1.0,1,1.0,1,0.23568925959708223,34
676,0,1093,533,560,0,0,0,1.0,1,1.0,1,1.0,1,0.24812363245780536,35
677,2,1095,534,561,0,0,0,1.0,1,1.0,1,1.0,1,0.22311108965891274,35
678,0,1095,534,561,0,0,0,1.0,1,1.0,1,1.0,1,0.22311108965891274,35
679,5,1100,536,564,0,0,0,1.0,1,1.0,1,1.0,1,0.17032274502638756,36
680,0,1100,536,564,0,0,0,1.0,1,1.0,1,1.0,1,0.16592942112237144,37
681,0,1100,536,564,0,0,0,1.0,1,1.0,1,1.0,1,0.16592942112237144,37
682,1,1101,537,564,0,0,0,1.0,1,1.0,1,1.0,1,0.19449445087766362,37
683,1,1102,537,565,0,0,0,1.0,1,1.0,1,1.0,1,0.16164245087704948,38
684,1,1103,538,565,0,0,0,1.0,1,1.0,1,1.0,1,0.2043991766423874,39
685,0,1103,538,565,0,0,0,1.0,1,1.0,1,1.0,1,0.19501047145499315,38
686,0,1103,538,565,0,0,0,1.0,1,1.0,1,1.0,1,0.18682099059992086,37
687,3,1106,539,567,0,0,0,1.0,1,1.0,1,1.0,1,0.21167991989504634,38
688,0,1106,539,567,0,0,0,1.0,1,1.0,1,1.0,1,0.24872293087471453,37
689,1,1107,540,567,0,0,0,1.0,1,1.0,1,1.0,1,0.2901294807468484,39
690,1,1108,540,568,0,0,0,1.0,1,1.0,1,1.0,1,0.2593040567100002,38
691,1,1109,541,568,0,0,0,1.0,1,1.0,1,1.0,1,0.25738779320727945,38
692,2,1111,543,568,0,0,0,1.0,1,1.0,1,1.0,1,0.28062164815484786,38
693,2,1113,545,568,0,0,0,1.0,1,1.0,1,1.0,1,0.31028699887844097,40
694,4,1117,547,570,0,0,0,1.0,1,1.0,1,1.0,1,0.32266955772779576,42
695,1,1118,547,571,0,0,0,1.0,1,1.0,1,1.0,1,0.27947391485597695,40
696,4,1122,549,573,0,0,0,1.0,1,1.0,1,1.0,1,0.2656813917068115,39
697,2,1124,549,575,0,0,0,1.0,1,1.0,1,1.0,1,0.23584854237739292,39
698,1,1125,550,575,0,0,0,1.0,1,1.0,1,1.0,1,0.23182971782966624,37
699,1,1126,550,576,0,0,0,1.0,1,1.0,1,1.0,1,0.18291380805888918,37
700,2,1128,551,577,0,0,0,1.0,1,1.0,1,1.0,1,0.2067282765651024,37
701,3,1131,553,578,0,0,0,1.0,1,1.0,1,1.0,1,0.21102031316324982,37
702,0,1131,553,578,0,0,0,1.0,1,1.0,1,1.0,1,0.21995375953803034,38
703,3,1134,555,579,0,0,0,1.0,1,1.0,1,1.0,1,0.22828977132259307,36
704,1,1135,556,579,0,0,0,1.0,1,1.0,1,1.0,1,0.2358527445408904,36
705,3,1138,559,579,0,0,0,1.0,1,1.0,1,1.0,1,0.23583342027481236,36
706,4,1142,562,580,0,0,0,1.0,1,1.0,1,1.0,1,0.23505352361037082,35
707,2,1144,563,581,0,0,0,1.0,1,1.0,1,1.0,1,0.25385982397945417,36
708,3,1147,565,582,0,0,0,1.0,1,1.0,1,1.0,1,0.2724571859333232,36
709,1,1148,566,582,0,0,0,1.0,1,1.0,1,1.0,1,0.21680584462539915,34
710,0,1148,566,582,0,0,0,1.0,1,1.0,1,1.0,1,0.21680584462539915,34
711,0,1148,566,582,0,0,0,1.0,1,1.0,1,1.0,1,0.2107650425491638,34
712,2,1150,568,582,0,0,0,1.0,1,1.0,1,1.0,1,0.2749807504347058,35
713,3,1153,569,584,0,0,0,1.0,1,1.0,1,1.0,1,0.2526850977177985,34
714,1,1154,570,584,0,0,0,1.0,1,1.0,1,1.0,1,0.24773801457824415,34
715,1,1155,571,584,0,0,0,1.0,1,1.0,1,1.0,1,0.3045284538950229,35
716,1,1156,572,584,0,0,0,1.0,1,1.0,1,1.0,1,0.33231357268613976,33
717,4,1160,574,586,0,0,0,1.0,1,1.0,1,1.0,1,0.3458485204726083,33
718,1,1161,574,587,0,0,0,1.0,1,1.0,1,1.0,1,0.3157003046737565,32
719,1,1162,574,588,0,0,0,1.0,1,1.0,1,1.0,1,0.300121537017945,32
720,2,1164,575,589,0,0,0,1.0,1,1.0,1,1.0,1,0.2770391234678881,33
721,2,1166,576,590,0,0,0,1.0,1,1.0,1,1.0,1,0.2668973569054703,33
722,3,1169,577,592,0,0,0,1.0,1,1.0,1,1.0,1,0.2845707109892718,34
723,1,1170,577,593,0,0,0,1.0,1,1.0,1,1.0,1,0.2545985919039739,34
724,3,1173,577,596,0,0,0,1.0,1,1.0,1,1.0,1,0.20498220943359832,36
725,1,1174,577,597,0,0,0,1.0,1,1.0,1,1.0,1,0.1744357439518296,36
726,0,1174,577,597,0,0,0,1.0,1,1.0,1,1.0,1,0.1744357439518296,36
727,0,1174,577,597,0,0,0,1.0,1,1.0,1,1.0,1,0.1744357439518296,36
728,2,1176,578,598,0,0,0,1.0,1,1.0,1,1.0,1,0.1750192985926689,37
729,1,1177,578,599,0,0,0,1.0,1,1.0,1,1.0,1,0.14972916519578572,37
730,0,1177,578,599,0,0,0,1.0,1,1.0,1,1.0,1,0.16390349477594313,38
731,0,1177,578,599,0,0,0,1.0,1,1.0,1,1.0,1,0.18455332491886897,39
732,2,1179,579,600,0,0,0,1.0,1,1.0,1,1.0,1,0.21085466627164667,41
733,0,1179,579,600,0,0,0,1.0,1,1.0,1,1.0,1,0.1717748565005028,39
734,2,1181,580,601,0,0,0,1.0,1,1.0,1,1.0,1,0.17080152617910352,39
735,1,1182,581,601,0,0,0,1.0,1,1.0,1,1.0,1,0.22356650800463293,39
736,0,1182,581,601,0,0,0,1.0,1,1.0,1,1.0,1,0.22909499277444645,38
737,1,1183,582,601,0,0,0,1.0,1,1.0,1,1.0,1,0.263242612174436,39
738,0,1183,582,601,0,0,0,1.0,1,1.0,1,1.0,1,0.2622948176172201,37
739,1,1184,583,601,0,0,0,1.0,1,1.0,1,1.0,1,0.29720044051042754,37
740,0,1184,583,601,0,0,0,1.0,1,1.0,1,1.0,1,0.313206797393779,35
741,1,1185,583,602,0,0,0,1.0,1,1.0,1,1.0,1,0.30098079863442234,33
742,1,1186,584,602,0,0,0,1.0,1,1.0,1,1.0,1,0.3314654118383623,35
743,3,1189,586,603,0,0,0,1.0,1,1.0,1,1.0,1,0.345606608355809,35
744,4,1193,589,604,0,0,0,1.0,1,1.0,1,1.0,1,0.272191299296105,34
745,1,1194,590,604,0,0,0,1.0,1,1.0,1,1.0,1,0.2919704893971239,34
746,3,1197,593,604,0,0,0,1.0,1,1.0,1,1.0,1,0.2630868038968366,33
747,1,1198,594,604,0,0,0,1.0,1,1.0,1,1.0,1,0.24612820601928811,32
748,1,1199,594,605,0,0,0,1.0,1,1.0,1,1.0,1,0.22944081838992772,33
749,0,1199,594,605,0,0,0,1.0,1,1.0,1,1.0,1,0.22944081838992772,33
750,1,1200,595,605,0,0,0,1.0,1,1.0,1,1.0,1,0.2565910436557518,34
751,0,1200,595,605,0,0,0,1.0,1,1.0,1,1.0,1,0.269660666361009,36
752,4,1204,598,606,0,0,0,1.0,1,1.0,1,1.0,1,0.2571491725795132,35
753,1,1205,599,606,0,0,0,1.0,1,1.0,1,1.0,1,0.28729633703511187,37
754,2,1207,601,606,0,0,0,1.0,1,1.0,1,1.0,1,0.3300669484648572,37
755,4,1211,602,609,0,0,0,1.0,1,1.0,1,1.0,1,0.2840109684947827,35
756,1,1212,603,609,0,0,0,1.0,1,1.0,1,1.0,1,0.3406752839671691,36
757,2,1214,603,611,0,0,0,1.0,1,1.0,1,1.0,1,0.3012160162770736,35
758,0,1214,603,611,0,0,0,1.0,1,1.0,1,1.0,1,0.31346966926228736,36
759,0,1214,603,611,0,0,0,1.0,1,1.0,1,1.0,1,0.3165101773478553,37
760,2,1216,603,613,0,0,0,1.0,1,1.0,1,1.0,1,0.30641132126564324,36
761,0,1216,603,613,0,0,0,1.0,1,1.0,1,1.0,1,0.30641132126564324,36
762,0,1216,603,613,0,0,0,1.0,1,1.0,1,1.0,1,0.3151365194689193,37
763,1,1217,603,614,0,0,0,1.0,1,1.0,1,1.0,1,0.310272591350066,38
764,0,1217,603,614,0,0,0,1.0,1,1.0,1,1.0,1,0.310272591350066,38
765,0,1217,603,614,0,0,0,1.0,1,1.0,1,1.0,1,0.310272591350066,38
766,0,1217,603,614,0,0,0,1.0,1,1.0,1,1.0,1,0.30144044226345673,40
767,0,1217,603,614,0,0,0,1.0,1,1.0,1,1.0,1,0.31435711638283026,41
768,2,1219,604,615,0,0,0,1.0,1,1.0,1,1.0,1,0.31787313763209,41
769,3,1222,604,618,0,0,0,1.0,1,1.0,1,1.0,1,0.28499077176150683,42
770,2,1224,605,619,0,0,0,1.0,1,1.0,1,1.0,1,0.29577919356701887,41
771,0,1224,605,619,0,0,0,1.0,1,1.0,1,1.0,1,0.2865309578853779,41
772,4,1228,607,621,0,0,0,1.0,1,1.0,1,1.0,1,0.24593549647748458,41
773,2,1230,607,623,0,0,0,1.0,1,1.0,1,1.0,1,0.2126408988852223,41
774,2,1232,609,623,0,0,0,1.0,1,1.0,1,1.0,1,0.2133501743956898,42
775,1,1233,609,624,0,0,0,1.0,1,1.0,1,1.0,1,0.19466292626876036,42
776,0,1233,609,624,0,0,0,1.0,1,1.0,1,1.0,1,0.19466292626876036,42
777,0,1233,609,624,0,0,0,1.0,1,1.0,1,1.0,1,0.19466292626876036,42
778,1,1234,609,625,0,0,0,1.0,1,1.0,1,1.0,1,0.21068057643492374,44
779,0,1234,609,625,0,0,0,1.0,1,1.0,1,1.0,1,0.21068057643492374,44
780,1,1235,609,626,0,0,0,1.0,1,1.0,1,1.0,1,0.18139870055725316,44
781,1,1236,609,627,0,0,0,1.0,1,1.0,1,1.0,1,0.17453207763252546,46
782,2,1238,611,627,0,0,0,1.0,1,1.0,1,1.0,1,0.20779660397212882,45
783,2,1240,612,628,0,0,0,1.0,1,1.0,1,1.0,1,0.23529038666489463,44
784,1,1241,613,628,0,0,0,1.0,1,1.0,1,1.0,1,0.27671689749558254,44
785,1,1242,614,628,0,0,0,1.0,1,1.0,1,1.0,1,0.2739793841535577,43
786,0,1242,614,628,0,0,0,1.0,1,1.0,1,1.0,1,0.2739793841535577,43
787,0,1242,614,628,0,0,0,1.0,1,1.0,1,1.0,1,0.2739793841535577,43
788,6,1248,616,632,0,0,0,1.0,1,1.0,1,1.0,1,0.2182647007683333,45
789,1,1249,617,632,0,0,0,1.0,1,1.0,1,1.0,1,0.21179312754016322,46
790,0,1249,617,632,0,0,0,1.0,1,1.0,1,1.0,1,0.2426171362213072,45
791,1,1250,617,633,0,0,0,1.0,1,1.0,1,1.0,1,0.23732457688505346,46
792,0,1250,617,633,0,0,0,1.0,1,1.0,1,1.0,1,0.260411883229144,46
793,3,1253,617,636,0,0,0,1.0,1,1.0,1,1.0,1,0.1999645150427993,46
794,0,1253,617,636,0,0,0,1.0,1,1.0,1,1.0,1,0.22654602873444754,47
795,1,1254,617,637,0,0,0,1.0,1,1.0,1,1.0,1,0.2029623974917556,47
796,1,1255,618,637,0,0,0,1.0,1,1.0,1,1.0,1,0.23590332154569602,46
797,5,1260,621,639,0,0,0,1.0,1,1.0,1,1.0,1,0.25541308679834634,47
798,4,1264,623,641,0,0,0,1.0,1,1.0,1,1.0,1,0.249364598794949,48
799,2,1266,623,643,0,0,0,1.0,1,1.0,1,1.0,1,0.1954878442932459,48
800,1,1267,624,643,0,0,0,1.0,1,1.0,1,1.0,1,0.2287966182549075,48
801,4,1271,625,646,0,0,0,1.0,1,1.0,1,1.0,1,0.1962100603831258,49
802,0,1271,625,646,0,0,0,1.0,1,1.0,1,1.0,1,0.18391431312702536,50
803,1,1272,625,647,0,0,0,1.0,1,1.0,1,1.0,1,0.15434596567818057,49
804,1,1273,626,647,0,0,0,1.0,1,1.0,1,1.0,1,0.1502911354006666,50
805,0,1273,626,647,0,0,0,1.0,1,1.0,1,1.0,1,0.1502911354006666,50
806,1,1274,626,648,0,0,0,1.0,1,1.0,1,1.0,1,0.12796157431349292,50
807,2,1276,626,650,0,0,0,1.0,1,1.0,1,1.0,1,0.10196199354556323,51
808,1,1277,627,650,0,0,0,1.0,1,1.0,1,1.0,1,0.12895194758004558,51
809,1,1278,628,650,0,0,0,1.0,1,1.0,1,1.0,1,0.13971574447509996,51
810,2,1280,628,652,0,0,0,1.0,1,1.0,1,1.0,1,0.11755991176347777,52
811,1,1281,629,652,0,0,0,1.0,1,1.0,1,1.0,1,0.14224197956940265,50
812,2,1283,630,653,0,0,0,1.0,1,1.0,1,1.0,1,0.15487755296310782,48
813,2,1285,631,654,0,0,0,1.0,1,1.0,1,1.0,1,0.17504087626875098,49
814,0,1285,631,654,0,0,0,1.0,1,1.0,1,1.0,1,0.189036974266991,48
815,4,1289,634,655,0,0,0,1.0,1,1.0,1,1.0,1,0.1791911209375695,48
816,1,1290,635,655,0,0,0,1.0,1,1.0,1,1.0,1,0.20487287657244363,46
817,1,1291,635,656,0,0,0,1.0,1,1.0,1,1.0,1,0.22857246961107794,44
818,0,1291,635,656,0,0,0,1.0,1,1.0,1,1.0,1,0.2047199646437418,46
819,0,1291,635,656,0,0,0,1.0,1,1.0,1,1.0,1,0.2390394030616347,44
820,0,1291,635,656,0,0,0,1.0,1,1.0,1,1.0,1,0.2675161311984227,44
821,0,1291,635,656,0,0,0,1.0,1,1.0,1,1.0,1,0.2675161311984227,44
822,3,1294,637,657,0,0,0,1.0,1,1.0,1,1.0,1,0.2778581722237071,44
823,5,1299,638,661,0,0,0,1.0,1,1.0,1,1.0,1,0.1691136208214424,42
824,2,1301,640,661,0,0,0,1.0,1,1.0,1,1.0,1,0.19214612888041302,42
825,1,1302,641,661,0,0,0,1.0,1,1.0,1,1.0,1,0.18796897496190063,40
826,3,1305,644,661,0,0,0,1.0,1,1.0,1,1.0,1,0.21750799452136207,41
827,1,1306,645,661,0,0,0,1.0,1,1.0,1,1.0,1,0.2186497619286339,40
828,4,1310,648,662,0,0,0,1.0,1,1.0,1,1.0,1,0.18921217495306616,40
829,5,1315,650,665,0,0,0,1.0,1,1.0,1,1.0,1,0.18370178366782045,42
830,4,1319,652,667,0,0,0,1.0,1,1.0,1,1.0,1,0.21301940924742638,42
831,4,1323,653,670,0,0,0,1.0,1,1.0,1,1.0,1,0.18515970356224212,43
832,0,1323,653,670,0,0,0,1.0,1,1.0,1,1.0,1,0.17334945672306873,42
833,1,1324,654,670,0,0,0,1.0,1,1.0,1,1.0,1,0.2073258553892277,41
834,2,1326,655,671,0,0,0,1.0,1,1.0,1,1.0,1,0.2040593081791895,41
835,2,1328,656,672,0,0,0,1.0,1,1.0,1,1.0,1,0.2217584454766989,41
836,0,1328,656,672,0,0,0,1.0,1,1.0,1,1.0,1,0.21949226583790885,40
837,0,1328,656,672,0,0,0,1.0,1,1.0,1,1.0,1,0.21974191173524654,41
838,1,1329,657,672,0,0,0,1.0,1,1.0,1,1.0,1,0.2410169698948984,41
839,2,1331,658,673,0,0,0,1.0,1,1.0,1,1.0,1,0.22937246929544955,41
840,4,1335,661,674,0,0,0,1.0,1,1.0,1,1.0,1,0.2619048967971139,42
841,3,1338,662,676,0,0,0,1.0,1,1.0,1,1.0,1,0.17138781238931647,42
842,1,1339,662,677,0,0,0,1.0,1,1.0,1,1.0,1,0.1461255401007649,42
843,2,1341,664,677,0,0,0,1.0,1,1.0,1,1.0,1,0.18171063871535334,42
844,0,1341,664,677,0,0,0,1.0,1,1.0,1,1.0,1,0.2029153981201956,42
845,1,1342,664,678,0,0,0,1.0,1,1.0,1,1.0,1,0.25556833143397717,44
846,1,1343,664,679,0,0,0,1.0,1,1.0,1,1.0,1,0.2266213810005759,44
847,1,1344,665,679,0,0,0,1.0,1,1.0,1,1.0,1,0.22468825625334174,42
848,0,1344,665,679,0,0,0,1.0,1,1.0,1,1.0,1,0.26120801990666204,43
849,1,1345,665,680,0,0,0,1.0,1,1.0,1,1.0,1,0.24003983339536134,43
850,4,1349,666,683,0,0,0,1.0,1,1.0,1,1.0,1,0.26695058149253237,41
851,3,1352,667,685,0,0,0,1.0,1,1.0,1,1.0,1,0.18841527508834385,40
852,0,1352,667,685,0,0,0,1.0,1,1.0,1,1.0,1,0.18841527508834385,40
853,1,1353,668,685,0,0,0,1.0,1,1.0,1,1.0,1,0.19402886314703863,40
854,2,1355,669,686,0,0,0,1.0,1,1.0,1,1.0,1,0.18743334028382788,40
855,1,1356,670,686,0,0,0,1.0,1,1.0,1,1.0,1,0.19203882762195656,41
856,1,1357,671,686,0,0,0,1.0,1,1.0,1,1.0,1,0.20435024562476778,41
857,1,1358,672,686,0,0,0,1.0,1,1.0,1,1.0,1,0.215796002486985,42
858,1,1359,672,687,0,0,0,1.0,1,1.0,1,1.0,1,0.18318382336741243,43
859,0,1359,672,687,0,0,0,1.0,1,1.0,1,1.0,1,0.18318382336741243,43
860,1,1360,673,687,0,0,0,1.0,1,1.0,1,1.0,1,0.1842942302692468,44
861,1,1361,674,687,0,0,0,1.0,1,1.0,1,1.0,1,0.1978751747253504,44
862,1,1362,675,687,0,0,0,1.0,1,1.0,1,1.0,1,0.2036911871835186,44
863,4,1366,678,688,0,0,0,1.0,1,1.0,1,1.0,1,0.2493692154263826,44
864,5,1371,680,691,0,0,0,1.0,1,1.0,1,1.0,1,0.23015272386189517,44
865,2,1373,682,691,0,0,0,1.0,1,1.0,1,1.0,1,0.22014936653390152,43
866,5,1378,685,693,0,0,0,1.0,1,1.0,1,1.0,1,0.2823643326752061,45
867,3,1381,685,696,0,0,0,1.0,1,1.0,1,1.0,1,0.21285713638861004,44
868,4,1385,686,699,0,0,0,1.0,1,1.0,1,1.0,1,0.24621279450368952,45
869,7,1392,689,703,0,0,0,1.0,1,1.0,1,1.0,1,0.16225648933613,44
870,1,1393,689,704,0,0,0,1.0,1,1.0,1,1.0,1,0.1382441192351738,44
871,2,1395,690,705,0,0,0,1.0,1,1.0,1,1.0,1,0.17846850521568064,43
872,1,1396,690,706,0,0,0,1.0,1,1.0,1,1.0,1,0.14209121155239435,43
873,1,1397,691,706,0,0,0,1.0,1,1.0,1,1.0,1,0.1890966693822041,43
874,5,1402,694,708,0,0,0,1.0,1,1.0,1,1.0,1,0.2089178497756092,46
875,4,1406,695,711,0,0,0,1.0,1,1.0,1,1.0,1,0.12595731898568882,43
876,1,1407,695,712,0,0,0,1.0,1,1.0,1,1.0,1,0.10800520345972706,44
877,0,1407,695,712,0,0,0,1.0,1,1.0,1,1.0,1,0.14508941750592538,44
878,1,1408,696,712,0,0,0,1.0,1,1.0,1,1.0,1,0.17779358189894862,44
879,2,1410,696,714,0,0,0,1.0,1,1.0,1,1.0,1,0.12892541514544756,44
880,3,1413,698,715,0,0,0,1.0,1,1.0,1,1.0,1,0.17161205663672818,44
881,0,1413,698,715,0,0,0,1.0,1,1.0,1,1.0,1,0.15687084636885212,43
882,1,1414,699,715,0,0,0,1.0,1,1.0,1,1.0,1,0.16660664255934496,45
883,1,1415,699,716,0,0,0,1.0,1,1.0,1,1.0,1,0.15653112009123032,45
884,1,1416,700,716,0,0,0,1.0,1,1.0,1,1.0,1,0.1674050324311261,45
885,2,1418,701,717,0,0,0,1.0,1,1.0,1,1.0,1,0.1152766627139473,43
886,1,1419,702,717,0,0,0,1.0,1,1.0,1,1.0,1,0.225798231770745,43
887,3,1422,703,719,0,0,0,1.0,1,1.0,1,1.0,1,0.16171855274000269,41
888,1,1423,703,720,0,0,0,1.0,1,1.0,1,1.0,1,0.21837068570215337,40
889,0,1423,703,720,0,0,0,1.0,1,1.0,1,1.0,1,0.21837068570215337,40
890,1,1424,704,720,0,0,0,1.0,1,1.0,1,1.0,1,0.18362791613311047,38
891,1,1425,705,720,0,0,0,1.0,1,1.0,1,1.0,1,0.18393882091298602,39
892,2,1427,707,720,0,0,0,1.0,1,1.0,1,1.0,1,0.24678106822687473,39
893,1,1428,708,720,0,0,0,1.0,1,1.0,1,1.0,1,0.21619357660831862,37
894,0,1428,708,720,0,0,0,1.0,1,1.0,1,1.0,1,0.23911204194862481,36
895,0,1428,708,720,0,0,0,1.0,1,1.0,1,1.0,1,0.255842878279731,37
896,2,1430,710,720,0,0,0,1.0,1,1.0,1,1.0,1,0.2744014377421441,36
897,1,1431,711,720,0,0,0,1.0,1,1.0,1,1.0,1,0.2720066066006955,36
898,0,1431,711,720,0,0,0,1.0,1,1.0,1,1.0,1,0.28584336547255285,35
899,2,1433,713,720,0,0,0,1.0,1,1.0,1,1.0,1,0.2861884917538848,35
900,1,1434,714,720,0,0,0,1.0,1,1.0,1,1.0,1,0.3256953402513073,36
901,2,1436,715,721,0,0,0,1.0,1,1.0,1,1.0,1,0.3146972752646082,36
902,3,1439,718,721,0,0,0,1.0,1,1.0,1,1.0,1,0.3684534283247579,36
903,3,1442,719,723,0,0,0,1.0,1,1.0,1,1.0,1,0.3163537045130794,35
904,5,1447,723,724,0,0,0,1.0,1,1.0,1,1.0,1,0.3031440666245896,37
905,5,1452,725,727,0,0,0,1.0,1,1.0,1,1.0,1,0.25975163744908164,36
906,2,1454,725,729,0,0,0,1.0,1,1.0,1,1.0,1,0.22428567910242359,37
907,1,1455,726,729,0,0,0,1.0,1,1.0,1,1.0,1,0.22332020112266546,37
908,2,1457,728,729,0,0,0,1.0,1,1.0,1,1.0,1,0.25995608751722954,36
909,3,1460,728,732,0,0,0,1.0,1,1.0,1,1.0,1,0.16517554809157703,36
910,1,1461,729,732,0,0,0,1.0,1,1.0,1,1.0,1,0.18860597227056372,37
911,2,1463,730,733,0,0,0,1.0,1,1.0,1,1.0,1,0.22869692578127399,36
912,1,1464,731,733,0,0,0,1.0,1,1.0,1,1.0,1,0.21942407248532175,34
913,2,1466,733,733,0,0,0,1.0,1,1.0,1,1.0,1,0.20698150461468498,34
914,1,1467,734,733,0,0,0,1.0,1,1.0,1,1.0,1,0.23980625338911396,33
915,1,1468,734,734,0,0,0,1.0,1,1.0,1,1.0,1,0.22268510929151847,33
916,0,1468,734,734,0,0,0,1.0,1,1.0,1,1.0,1,0.24272463202313,34
917,0,1468,734,734,0,0,0,1.0,1,1.0,1,1.0,1,0.24272463202313,34
918,1,1469,735,734,0,0,0,1.0,1,1.0,1,1.0,1,0.22581768226524448,36
919,0,1469,735,734,0,0,0,1.0,1,1.0,1,1.0,1,0.22581768226524448,36
920,1,1470,736,734,0,0,0,1.0,1,1.0,1,1.0,1,0.20166413134996422,37
921,1,1471,736,735,0,0,0,1.0,1,1.0,1,1.0,1,0.17367493298380393,37
922,1,1472,737,735,0,0,0,1.0,1,1.0,1,1.0,1,0.16567815184524254,38
923,1,1473,738,735,0,0,0,1.0,1,1.0,1,1.0,1,0.16702262750577132,36
924,1,1474,738,736,0,0,0,1.0,1,1.0,1,1.0,1,0.16391242730191358,35
925,4,1478,740,738,0,0,0,1.0,1,1.0,1,1.0,1,0.26858956726836014,35
926,3,1481,742,739,0,0,0,1.0,1,1.0,1,1.0,1,0.2794697684888005,34
927,1,1482,742,740,0,0,0,1.0,1,1.0,1,1.0,1,0.28049754098526264,32
928,1,1483,743,740,0,0,0,1.0,1,1.0,1,1.0,1,0.30445326485417107,32
929,1,1484,743,741,0,0,0,1.0,1,1.0,1,1.0,1,0.25261872865932294,31
930,0,1484,743,741,0,0,0,1.0,1,1.0,1,1.0,1,0.28676948670524305,30
931,1,1485,744,741,0,0,0,1.0,1,1.0,1,1.0,1,0.33995728766601435,29
932,3,1488,746,742,0,0,0,1.0,1,1.0,1,1.0,1,0.3097135237994955,29
933,1,1489,746,743,0,0,0,1.0,1,1.0,1,1.0,1,0.28150590215052823,29
934,1,1490,747,743,0,0,0,1.0,1,1.0,1,1.0,1,0.2929718616118898,29
935,1,1491,747,744,0,0,0,1.0,1,1.0,1,1.0,1,0.31767221965418885,31
936,1,1492,748,744,0,0,0,1.0,1,1.0,1,1.0,1,0.3486147539841582,31
937,3,1495,749,746,0,0,0,1.0,1,1.0,1,1.0,1,0.333176815827451,34
938,2,1497,749,748,0,0,0,1.0,1,1.0,1,1.0,1,0.2890536942928239,33
939,6,1503,749,754,0,0,0,1.0,1,1.0,1,1.0,1,0.21676119474858316,36
940,0,1503,749,754,0,0,0,1.0,1,1.0,1,1.0,1,0.2194210745935255,36
941,2,1505,751,754,0,0,0,1.0,1,1.0,1,1.0,1,0.2700996813447173,36
942,1,1506,752,754,0,0,0,1.0,1,1.0,1,1.0,1,0.2771207993762498,36
943,2,1508,753,755,0,0,0,1.0,1,1.0,1,1.0,1,0.25849381487233647,35
944,3,1511,755,756,0,0,0,1.0,1,1.0,1,1.0,1,0.2527168358580422,35
945,0,1511,755,756,0,0,0,1.0,1,1.0,1,1.0,1,0.2249988582361389,33
946,5,1516,757,759,0,0,0,1.0,1,1.0,1,1.0,1,0.2915895223596466,36
947,0,1516,757,759,0,0,0,1.0,1,1.0,1,1.0,1,0.26184046759612556,34
948,1,1517,758,759,0,0,0,1.0,1,1.0,1,1.0,1,0.280306812043311,33
949,0,1517,758,759,0,0,0,1.0,1,1.0,1,1.0,1,0.30721629505570847,34
950,0,1517,758,759,0,0,0,1.0,1,1.0,1,1.0,1,0.3267462524548463,33
951,0,1517,758,759,0,0,0,1.0,1,1.0,1,1.0,1,0.3267462524548463,33
952,0,1517,758,759,0,0,0,1.0,1,1.0,1,1.0,1,0.3318237281947305,32
953,0,1517,758,759,0,0,0,1.0,1,1.0,1,1.0,1,0.3318237281947305,32
954,1,1518,759,759,0,0,0,1.0,1,1.0,1,1.0,1,0.3331498915733318,31
955,1,1519,759,760,0,0,0,1.0,1,1.0,1,1.0,1,0.31851121832745327,32
956,1,1520,760,760,0,0,0,1.0,1,1.0,1,1.0,1,0.294265051431831,32
957,0,1520,760,760,0,0,0,1.0,1,1.0,1,1.0,1,0.29692773385634535,33
958,0,1520,760,760,0,0,0,1.0,1,1.0,1,1.0,1,0.30003790829876026,35
959,1,1521,761,760,0,0,0,1.0,1,1.0,1,1.0,1,0.3194914212829113,36
960,2,1523,761,762,0,0,0,1.0,1,1.0,1,1.0,1,0.3100480212609109,38
961,2,1525,763,762,0,0,0,1.0,1,1.0,1,1.0,1,0.38888054736268773,37
962,2,1527,764,763,0,0,0,1.0,1,1.0,1,1.0,1,0.3645986322154689,35
963,1,1528,764,764,0,0,0,1.0,1,1.0,1,1.0,1,0.3285272255928397,35
964,1,1529,764,765,0,0,0,1.0,1,1.0,1,1.0,1,0.328519165317003,34
965,1,1530,764,766,0,0,0,1.0,1,1.0,1,1.0,1,0.316505927536673,35
966,1,1531,765,766,0,0,0,1.0,1,1.0,1,1.0,1,0.29479523342292696,34
967,1,1532,765,767,0,0,0,1.0,1,1.0,1,1.0,1,0.2713998653562374,35
968,1,1533,766,767,0,0,0,1.0,1,1.0,1,1.0,1,0.28055341817293705,36
969,1,1534,766,768,0,0,0,1.0,1,1.0,1,1.0,1,0.28512948305262475,35
970,0,1534,766,768,0,0,0,1.0,1,1.0,1,1.0,1,0.31597249047390297,34
971,0,1534,766,768,0,0,0,1.0,1,1.0,1,1.0,1,0.32572882662342806,35
972,1,1535,767,768,0,0,0,1.0,1,1.0,1,1.0,1,0.31943310023660115,35
973,2,1537,767,770,0,0,0,1.0,1,1.0,1,1.0,1,0.29584592020809647,36
974,0,1537,767,770,0,0,0,1.0,1,1.0,1,1.0,1,0.3222830771864907,35
975,0,1537,767,770,0,0,0,1.0,1,1.0,1,1.0,1,0.30352545533033526,36
976,0,1537,767,770,0,0,0,1.0,1,1.0,1,1.0,1,0.3214580250587404,38
977,1,1538,768,770,0,0,0,1.0,1,1.0,1,1.0,1,0.3291408438739219,38
978,0,1538,768,770,0,0,0,1.0,1,1.0,1,1.0,1,0.3291408438739219,38
979,0,1538,768,770,0,0,0,1.0,1,1.0,1,1.0,1,0.33735029584619225,39
980,2,1540,770,770,0,0,0,1.0,1,1.0,1,1.0,1,0.38571621459145206,39
981,4,1544,771,773,0,0,0,1.0,1,1.0,1,1.0,1,0.33984732943423285,40
982,7,1551,774,777,0,0,0,1.0,1,1.0,1,1.0,1,0.3614309687378611,40
983,1,1552,774,778,0,0,0,1.0,1,1.0,1,1.0,1,0.3150147929458441,38
984,2,1554,775,779,0,0,0,1.0,1,1.0,1,1.0,1,0.31859434554186383,39
985,3,1557,778,779,0,0,0,1.0,1,1.0,1,1.0,1,0.3900093957835968,38
986,4,1561,780,781,0,0,0,1.0,1,1.0,1,1.0,1,0.409232352605385,38
987,3,1564,781,783,0,0,0,1.0,1,1.0,1,1.0,1,0.34324446361074107,38
988,0,1564,781,783,0,0,0,1.0,1,1.0,1,1.0,1,0.34324446361074107,38
989,3,1567,781,786,0,0,0,1.0,1,1.0,1,1.0,1,0.28529182548114634,38
990,0,1567,781,786,0,0,0,1.0,1,1.0,1,1.0,1,0.28529182548114634,38
991,3,1570,782,788,0,0,0,1.0,1,1.0,1,1.0,1,0.28959249065803067,40
992,1,1571,783,788,0,0,0,1.0,1,1.0,1,1.0,1,0.31509992078102333,39
993,1,1572,784,788,0,0,0,1.0,1,1.0,1,1.0,1,0.3215901472568417,38
994,1,1573,784,789,0,0,0,1.0,1,1.0,1,1.0,1,0.3175425897742745,39
995,0,1573,784,789,0,0,0,1.0,1,1.0,1,1.0,1,0.3165748102612788,41
996,0,1573,784,789,0,0,0,1.0,1,1.0,1,1.0,1,0.32620209929177024,40
997,0,1573,784,789,0,0,0,1.0,1,1.0,1,1.0,1,0.34327291543781485,41
998,0,1573,784,789,0,0,0,1.0,1,1.0,1,1.0,1,0.372513531603983,40
999,1,1574,784,790,0,0,0,1.0,1,1.0,1,1.0,1,0.39300846146236224,40
1000,0,1574,784,790,0,0,0,1.0,1,1.0,1,1.0,1,0.39300846146236224,40
1001,2,1576,784,792,0,0,0,1.0,1,1.0,1,1.0,1,0.36049357407706617,39
1002,0,1576,784,792,0,0,0,1.0,1,1.0,1,1.0,1,0.36049357407706617,39
1003,2,1578,784,794,0,0,0,1.0,1,1.0,1,1.0,1,0.33593041358419806,39
1004,1,1579,784,795,0,0,0,1.0,1,1.0,1,1.0,1,0.3198445802553407,39
1005,0,1579,784,795,0,0,0,1.0,1,1.0,1,1.0,1,0.32947371251696644,40
1006,0,1579,784,795,0,0,0,1.0,1,1.0,1,1.0,1,0.3242291328729064,41
1007,3,1582,784,798,0,0,0,1.0,1,1.0,1,1.0,1,0.27720859843342766,42
1008,0,1582,784,798,0,0,0,1.0,1,1.0,1,1.0,1,0.28924854881649625,43
1009,1,1583,784,799,0,0,0,1.0,1,1.0,1,1.0,1,0.2912726329035687,44
1010,1,1584,785,799,0,0,0,1.0,1,1.0,1,1.0,1,0.2722208124023102,44
1011,1,1585,785,800,0,0,0,1.0,1,1.0,1,1.0,1,0.24085560728343805,44
1012,3,1588,787,801,0,0,0,1.0,1,1.0,1,1.0,1,0.2430564331312358,46
1013,0,1588,787,801,0,0,0,1.0,1,1.0,1,1.0,1,0.2430564331312358,46
1014,2,1590,788,802,0,0,0,1.0,1,1.0,1,1.0,1,0.24565785282630684,46
1015,0,1590,788,802,0,0,0,1.0,1,1.0,1,1.0,1,0.24565785282630684,46
1016,2,1592,789,803,0,0,0,1.0,1,1.0,1,1.0,1,0.25401162229657004,47
1017,1,1593,789,804,0,0,0,1.0,1,1.0,1,1.0,1,0.24053839407109626,47
1018,4,1597,790,807,0,0,0,1.0,1,1.0,1,1.0,1,0.2012735000258343,48
1019,1,1598,790,808,0,0,0,1.0,1,1.0,1,1.0,1,0.203244674176306,49
1020,1,1599,790,809,0,0,0,1.0,1,1.0,1,1.0,1,0.1865266474271837,51
1021,1,1600,790,810,0,0,0,1.0,1,1.0,1,1.0,1,0.18318645478694026,51
1022,1,1601,791,810,0,0,0,1.0,1,1.0,1,1.0,1,0.19212724267463668,52
1023,3,1604,791,813,0,0,0,1.0,1,1.0,1,1.0,1,0.13210884979515758,52
1024,1,1605,792,813,0,0,0,1.0,1,1.0,1,1.0,1,0.15645410715952776,52
1025,2,1607,792,815,0,0,0,1.0,1,1.0,1,1.0,1,0.1441596669203368,54
1026,0,1607,792,815,0,0,0,1.0,1,1.0,1,1.0,1,0.1441596669203368,54
1027,0,1607,792,815,0,0,0,1.0,1,1.0,1,1.0,1,0.141797426961678,55
1028,3,1610,794,816,0,0,0,1.0,1,1.0,1,1.0,1,0.16966249479825418,56
1029,0,1610,794,816,0,0,0,1.0,1,1.0,1,1.0,1,0.16966249479825418,56
1030,3,1613,794,819,0,0,0,1.0,1,1.0,1,1.0,1,0.15895848068680518,57
1031,1,1614,794,820,0,0,0,1.0,1,1.0,1,1.0,1,0.14113613477003295,58
1032,2,1616,796,820,0,0,0,1.0,1,1.0,1,1.0,1,0.15840872013000476,58
1033,0,1616,796,820,0,0,0,1.0,1,1.0,1,1.0,1,0.14916157990080503,57
1034,5,1621,801,820,0,0,0,1.0,1,1.0,1,1.0,1,0.19839661763306296,57
1035,4,1625,803,822,0,0,0,1.0,1,1.0,1,1.0,1,0.1866586213097157,57
1036,3,1628,804,824,0,0,0,1.0,1,1.0,1,1.0,1,0.1631263961308302,59
1037,2,1630,806,824,0,0,0,1.0,1,1.0,1,1.0,1,0.1934507196347402,57
1038,6,1636,808,828,0,0,0,1.0,1,1.0,1,1.0,1,0.22194966764116872,59
1039,3,1639,811,828,0,0,0,1.0,1,1.0,1,1.0,1,0.21759937133197796,57
1040,4,1643,812,831,0,0,0,1.0,1,1.0,1,1.0,1,0.2501026109600863,56
1041,2,1645,814,831,0,0,0,1.0,1,1.0,1,1.0,1,0.2572336106626562,54
1042,0,1645,814,831,0,0,0,1.0,1,1.0,1,1.0,1,0.2238228262876773,52
1043,0,1645,814,831,0,0,0,1.0,1,1.0,1,1.0,1,0.2238228262876773,52
1044,1,1646,814,832,0,0,0,1.0,1,1.0,1,1.0,1,0.17261406784598066,50
1045,2,1648,815,833,0,0,0,1.0,1,1.0,1,1.0,1,0.17702186816329196,51
1046,2,1650,816,834,0,0,0,1.0,1,1.0,1,1.0,1,0.16282719621283268,50
1047,0,1650,816,834,0,0,0,1.0,1,1.0,1,1.0,1,0.15543354879770596,50
1048,1,1651,817,834,0,0,0,1.0,1,1.0,1,1.0,1,0.18841875948364833,50
1049,3,1654,819,835,0,0,0,1.0,1,1.0,1,1.0,1,0.19859191402920864,50
1050,0,1654,819,835,0,0,0,1.0,1,1.0,1,1.0,1,0.19859191402920864,50
1051,1,1655,819,836,0,0,0,1.0,1,1.0,1,1.0,1,0.17728130225843633,50
1052,1,1656,820,836,0,0,0,1.0,1,1.0,1,1.0,1,0.19101304166389746,51
1053,1,1657,820,837,0,0,0,1.0,1,1.0,1,1.0,1,0.17399074217188293,51
1054,0,1657,820,837,0,0,0,1.0,1,1.0,1,1.0,1,0.1642460568430345,53
1055,2,1659,820,839,0,0,0,1.0,1,1.0,1,1.0,1,0.15225505565970032,54
1056,0,1659,820,839,0,0,0,1.0,1,1.0,1,1.0,1,0.17427876469242665,54
1057,2,1661,821,840,0,0,0,1.0,1,1.0,1,1.0,1,0.18468103747787687,55
1058,0,1661,821,840,0,0,0,1.0,1,1.0,1,1.0,1,0.1865677743684416,54
1059,1,1662,822,840,0,0,0,1.0,1,1.0,1,1.0,1,0.19821393061687517,53
1060,0,1662,822,840,0,0,0,1.0,1,1.0,1,1.0,1,0.19821393061687517,53
1061,3,1665,825,840,0,0,0,1.0,1,1.0,1,1.0,1,0.20515625380298164,53
1062,4,1669,829,840,0,0,0,1.0,1,1.0,1,1.0,1,0.23161652706823288,54
1063,4,1673,829,844,0,0,0,1.0,1,1.0,1,1.0,1,0.21792407690193263,53
1064,3,1676,831,845,0,0,0,1.0,1,1.0,1,1.0,1,0.2059676580818166,55
1065,3,1679,832,847,0,0,0,1.0,1,1.0,1,1.0,1,0.20895749284425869,54
1066,3,1682,832,850,0,0,0,1.0,1,1.0,1,1.0,1,0.1867140617024381,55
1067,3,1685,833,852,0,0,0,1.0,1,1.0,1,1.0,1,0.17678389537111386,55
1068,0,1685,833,852,0,0,0,1.0,1,1.0,1,1.0,1,0.18715793186149451,55
1069,2,1687,833,854,0,0,0,1.0,1,1.0,1,1.0,1,0.19205874930878675,55
1070,0,1687,833,854,0,0,0,1.0,1,1.0,1,1.0,1,0.2048319417335493,54
1071,1,1688,834,854,0,0,0,1.0,1,1.0,1,1.0,1,0.22004652023075458,55
1072,0,1688,834,854,0,0,0,1.0,1,1.0,1,1.0,1,0.20961018820001115,54
1073,2,1690,836,854,0,0,0,1.0,1,1.0,1,1.0,1,0.21122170409603572,54
1074,1,1691,836,855,0,0,0,1.0,1,1.0,1,1.0,1,0.20887180321065546,52
1075,3,1694,837,857,0,0,0,1.0,1,1.0,1,1.0,1,0.1962778623779061,51
1076,4,1698,838,860,0,0,0,1.0,1,1.0,1,1.0,1,0.14588551579355763,52
1077,3,1701,841,860,0,0,0,1.0,1,1.0,1,1.0,1,0.15990889825418217,49
1078,1,1702,842,860,0,0,0,1.0,1,1.0,1,1.0,1,0.20123626928353164,48
1079,3,1705,844,861,0,0,0,1.0,1,1.0,1,1.0,1,0.1978761279361655,47
1080,1,1706,845,861,0,0,0,1.0,1,1.0,1,1.0,1,0.24314558869673097,47
1081,1,1707,846,861,0,0,0,1.0,1,1.0,1,1.0,1,0.26041091667649935,45
1082,2,1709,848,861,0,0,0,1.0,1,1.0,1,1.0,1,0.3364484882089774,42
1083,4,1713,849,864,0,0,0,1.0,1,1.0,1,1.0,1,0.3175504938732713,42
1084,1,1714,849,865,0,0,0,1.0,1,1.0,1,1.0,1,0.29962412100436253,40
1085,2,1716,849,867,0,0,0,1.0,1,1.0,1,1.0,1,0.2559009315180539,43
1086,2,1718,850,868,0,0,0,1.0,1,1.0,1,1.0,1,0.25925510580955186,41
1087,2,1720,850,870,0,0,0,1.0,1,1.0,1,1.0,1,0.24261497351453967,41
1088,0,1720,850,870,0,0,0,1.0,1,1.0,1,1.0,1,0.24261497351453967,41
1089,3,1723,852,871,0,0,0,1.0,1,1.0,1,1.0,1,0.22052249528453918,42
1090,0,1723,852,871,0,0,0,1.0,1,1.0,1,1.0,1,0.22970541426985483,43
1091,1,1724,853,871,0,0,0,1.0,1,1.0,1,1.0,1,0.26277387333700725,43
1092,2,1726,854,872,0,0,0,1.0,1,1.0,1,1.0,1,0.22680403168999644,43
1093,1,1727,855,872,0,0,0,1.0,1,1.0,1,1.0,1,0.230675160347972,43
1094,1,1728,855,873,0,0,0,1.0,1,1.0,1,1.0,1,0.21418453043648072,43
1095,0,1728,855,873,0,0,0,1.0,1,1.0,1,1.0,1,0.23047764789794642,44
1096,2,1730,857,873,0,0,0,1.0,1,1.0,1,1.0,1,0.26121988949838926,44
1097,4,1734,859,875,0,0,0,1.0,1,1.0,1,1.0,1,0.30837541128784823,45
1098,1,1735,859,876,0,0,0,1.0,1,1.0,1,1.0,1,0.2926054754638664,46
1099,2,1737,860,877,0,0,0,1.0,1,1.0,1,1.0,1,0.3101421880271701,48
1100,3,1740,861,879,0,0,0,1.0,1,1.0,1,1.0,1,0.2829964947214669,49
1101,3,1743,862,881,0,0,0,1.0,1,1.0,1,1.0,1,0.2747712786069758,49
1102,3,1746,864,882,0,0,0,1.0,1,1.0,1,1.0,1,0.26750963937933225,50
1103,4,1750,865,885,0,0,0,1.0,1,1.0,1,1.0,1,0.20703198628456368,48
1104,1,1751,866,885,0,0,0,1.0,1,1.0,1,1.0,1,0.18818253377420524,50
1105,1,1752,867,885,0,0,0,1.0,1,1.0,1,1.0,1,0.15996670379908232,48
1106,2,1754,868,886,0,0,0,1.0,1,1.0,1,1.0,1,0.16655338773179504,48
1107,2,1756,868,888,0,0,0,1.0,1,1.0,1,1.0,1,0.16918785582589854,47
1108,1,1757,869,888,0,0,0,1.0,1,1.0,1,1.0,1,0.19076974982751035,47
1109,4,1761,872,889,0,0,0,1.0,1,1.0,1,1.0,1,0.2265589158409263,46
1110,2,1763,873,890,0,0,0,1.0,1,1.0,1,1.0,1,0.2630654761503791,43
1111,5,1768,874,894,0,0,0,1.0,1,1.0,1,1.0,1,0.2205149183712061,44
1112,4,1772,877,895,0,0,0,1.0,1,1.0,1,1.0,1,0.2675209707408197,43
1113,4,1776,878,898,0,0,0,1.0,1,1.0,1,1.0,1,0.2609474594698275,39
1114,0,1776,878,898,0,0,0,1.0,1,1.0,1,1.0,1,0.2609474594698275,39
1115,3,1779,880,899,0,0,0,1.0,1,1.0,1,1.0,1,0.2147078221813292,37
1116,3,1782,882,900,0,0,0,1.0,1,1.0,1,1.0,1,0.20522929827624956,37
1117,2,1784,883,901,0,0,0,1.0,1,1.0,1,1.0,1,0.24109046320885005,36
1118,0,1784,883,901,0,0,0,1.0,1,1.0,1,1.0,1,0.24105424034580827,36
1119,0,1784,883,901,0,0,0,1.0,1,1.0,1,1.0,1,0.24105424034580827,36
1120,0,1784,883,901,0,0,0,1.0,1,1.0,1,1.0,1,0.24105424034580827,36
1121,0,1784,883,901,0,0,0,1.0,1,1.0,1,1.0,1,0.24105424034580827,36
1122,0,1784,883,901,0,0,0,1.0,1,1.0,1,1.0,1,0.2086555919236733,37
1123,0,1784,883,901,0,0,0,1.0,1,1.0,1,1.0,1,0.2086555919236733,37
1124,0,1784,883,901,0,0,0,1.0,1,1.0,1,1.0,1,0.2086555919236733,37
1125,2,1786,885,901,0,0,0,1.0,1,1.0,1,1.0,1,0.2835954188880924,38
1126,2,1788,886,902,0,0,0,1.0,1,1.0,1,1.0,1,0.2469245000208836,38
1127,3,1791,887,904,0,0,0,1.0,1,1.0,1,1.0,1,0.26481091500581694,39
1128,0,1791,887,904,0,0,0,1.0,1,1.0,1,1.0,1,0.26481091500581694,39
1129,0,1791,887,904,0,0,0,1.0,1,1.0,1,1.0,1,0.26481091500581694,39
1130,1,1792,888,904,0,0,0,1.0,1,1.0,1,1.0,1,0.2801758090779672,39
1131,1,1793,889,904,0,0,0,1.0,1,1.0,1,1.0,1,0.24666518466490542,39
1132,1,1794,890,904,0,0,0,1.0,1,1.0,1,1.0,1,0.25216010884895185,39
1133,1,1795,891,904,0,0,0,1.0,1,1.0,1,1.0,1,0.23319060661095647,42
1134,0,1795,891,904,0,0,0,1.0,1,1.0,1,1.0,1,0.23319060661095647,42
1135,3,1798,892,906,0,0,0,1.0,1,1.0,1,1.0,1,0.28900380974329637,44
1136,4,1802,893,909,0,0,0,1.0,1,1.0,1,1.0,1,0.29313106016604806,46
1137,1,1803,893,910,0,0,0,1.0,1,1.0,1,1.0,1,0.26102348022478433,45
1138,2,1805,895,910,0,0,0,1.0,1,1.0,1,1.0,1,0.3086767238345437,46
1139,3,1808,895,913,0,0,0,1.0,1,1.0,1,1.0,1,0.2789693810293374,47
1140,0,1808,895,913,0,0,0,1.0,1,1.0,1,1.0,1,0.29598928063967417,46
1141,4,1812,895,917,0,0,0,1.0,1,1.0,1,1.0,1,0.2328908664462102,45
1142,0,1812,895,917,0,0,0,1.0,1,1.0,1,1.0,1,0.2328908664462102,45
1143,3,1815,897,918,0,0,0,1.0,1,1.0,1,1.0,1,0.23215276344696936,43
1144,4,1819,900,919,0,0,0,1.0,1,1.0,1,1.0,1,0.2005824466540583,45
1145,4,1823,903,920,0,0,0,1.0,1,1.0,1,1.0,1,0.22996318244895222,44
1146,4,1827,904,923,0,0,0,1.0,1,1.0,1,1.0,1,0.1853509480647035,45
1147,2,1829,906,923,0,0,0,1.0,1,1.0,1,1.0,1,0.21391315570542857,44
1148,3,1832,909,923,0,0,0,1.0,1,1.0,1,1.0,1,0.2428012683580079,43
1149,4,1836,910,926,0,0,0,1.0,1,1.0,1,1.0,1,0.22194510205470283,42
1150,3,1839,911,928,0,0,0,1.0,1,1.0,1,1.0,1,0.22567251343541692,45
1151,1,1840,912,928,0,0,0,1.0,1,1.0,1,1.0,1,0.2660899760450115,40
1152,1,1841,913,928,0,0,0,1.0,1,1.0,1,1.0,1,0.2517146864889409,41
1153,2,1843,914,929,0,0,0,1.0,1,1.0,1,1.0,1,0.2485593518112645,38
1154,1,1844,915,929,0,0,0,1.0,1,1.0,1,1.0,1,0.2284449327840868,37
1155,1,1845,916,929,0,0,0,1.0,1,1.0,1,1.0,1,0.24080556395796304,38
1156,1,1846,917,929,0,0,0,1.0,1,1.0,1,1.0,1,0.2850106747970586,38
1157,1,1847,917,930,0,0,0,1.0,1,1.0,1,1.0,1,0.2891659516986519,37
1158,1,1848,917,931,0,0,0,1.0,1,1.0,1,1.0,1,0.2922121273478236,36
1159,0,1848,917,931,0,0,0,1.0,1,1.0,1,1.0,1,0.28375963513697366,35
1160,0,1848,917,931,0,0,0,1.0,1,1.0,1,1.0,1,0.28375963513697366,35
1161,0,1848,917,931,0,0,0,1.0,1,1.0,1,1.0,1,0.293104356775612,36
1162,0,1848,917,931,0,0,0,1.0,1,1.0,1,1.0,1,0.2917431686463477,37
1163,0,1848,917,931,0,0,0,1.0,1,1.0,1,1.0,1,0.2917431686463477,37
1164,0,1848,917,931,0,0,0,1.0,1,1.0,1,1.0,1,0.27855423923568606,38
1165,2,1850,917,933,0,0,0,1.0,1,1.0,1,1.0,1,0.25184378821937814,38
1166,0,1850,917,933,0,0,0,1.0,1,1.0,1,1.0,1,0.28088071211424903,40
1167,4,1854,919,935,0,0,0,1.0,1,1.0,1,1.0,1,0.26279789009210064,40
1168,3,1857,920,937,0,0,0,1.0,1,1.0,1,1.0,1,0.19860132662855076,40
1169,1,1858,920,938,0,0,0,1.0,1,1.0,1,1.0,1,0.22219987274554887,41
1170,2,1860,922,938,0,0,0,1.0,1,1.0,1,1.0,1,0.20876776551708,41
1171,3,1863,923,940,0,0,0,1.0,1,1.0,1,1.0,1,0.19851153460591373,43
1172,1,1864,924,940,0,0,0,1.0,1,1.0,1,1.0,1,0.189441563545397,43
1173,1,1865,924,941,0,0,0,1.0,1,1.0,1,1.0,1,0.1763518453643617,43
1174,0,1865,924,941,0,0,0,1.0,1,1.0,1,1.0,1,0.1763518453643617,43
1175,0,1865,924,941,0,0,0,1.0,1,1.0,1,1.0,1,0.19110048912040462,44
1176,1,1866,925,941,0,0,0,1.0,1,1.0,1,1.0,1,0.19160029704943188,45
1177,1,1867,926,941,0,0,0,1.0,1,1.0,1,1.0,1,0.2167774359224058,45
1178,1,1868,927,941,0,0,0,1.0,1,1.0,1,1.0,1,0.2123858391328701,45
1179,0,1868,927,941,0,0,0,1.0,1,1.0,1,1.0,1,0.23478903647589275,46
1180,0,1868,927,941,0,0,0,1.0,1,1.0,1,1.0,1,0.21698208386643297,47
1181,1,1869,927,942,0,0,0,1.0,1,1.0,1,1.0,1,0.22334800211036507,48
1182,2,1871,929,942,0,0,0,1.0,1,1.0,1,1.0,1,0.24185970982077717,48
1183,2,1873,930,943,0,0,0,1.0,1,1.0,1,1.0,1,0.2664348565813249,46
1184,4,1877,932,945,0,0,0,1.0,1,1.0,1,1.0,1,0.26140558159688315,47
1185,3,1880,933,947,0,0,0,1.0,1,1.0,1,1.0,1,0.2699341079282569,44
1186,0,1880,933,947,0,0,0,1.0,1,1.0,1,1.0,1,0.295316476137571,47
1187,6,1886,933,953,0,0,0,1.0,1,1.0,1,1.0,1,0.22095772813550582,49
1188,0,1886,933,953,0,0,0,1.0,1,1.0,1,1.0,1,0.22367189235310264,50
1189,0,1886,933,953,0,0,0,1.0,1,1.0,1,1.0,1,0.22671937024820044,48
1190,1,1887,934,953,0,0,0,1.0,1,1.0,1,1.0,1,0.2860034978788347,48
1191,2,1889,934,955,0,0,0,1.0,1,1.0,1,1.0,1,0.25190246915487563,46
1192,0,1889,934,955,0,0,0,1.0,1,1.0,1,1.0,1,0.25190246915487563,46
1193,1,1890,934,956,0,0,0,1.0,1,1.0,1,1.0,1,0.2562011893747923,45
1194,0,1890,934,956,0,0,0,1.0,1,1.0,1,1.0,1,0.2562011893747923,45
1195,2,1892,934,958,0,0,0,1.0,1,1.0,1,1.0,1,0.22863106314799922,47
1196,1,1893,935,958,0,0,0,1.0,1,1.0,1,1.0,1,0.21732210641100702,48
1197,1,1894,935,959,0,0,0,1.0,1,1.0,1,1.0,1,0.1981328357590073,49
1198,1,1895,936,959,0,0,0,1.0,1,1.0,1,1.0,1,0.1945570592448851,49
1199,1,1896,936,960,0,0,0,1.0,1,1.0,1,1.0,1,0.17904093648520503,50
1200,1,1897,937,960,0,0,0,1.0,1,1.0,1,1.0,1,0.18495041388120415,50
1201,0,1897,937,960,0,0,0,1.0,1,1.0,1,1.0,1,0.18495041388120415,50
1202,1,1898,938,960,0,0,0,1.0,1,1.0,1,1.0,1,0.1978359336998213,51
1203,0,1898,938,960,0,0,0,1.0,1,1.0,1,1.0,1,0.1886223602660325,52
1204,0,1898,938,960,0,0,0,1.0,1,1.0,1,1.0,1,0.1886223602660325,52
1205,3,1901,939,962,0,0,0,1.0,1,1.0,1,1.0,1,0.21762695131416415,53
1206,0,1901,939,962,0,0,0,1.0,1,1.0,1,1.0,1,0.21762695131416415,53
1207,1,1902,939,963,0,0,0,1.0,1,1.0,1,1.0,1,0.22343703837414755,55
1208,1,1903,939,964,0,0,0,1.0,1,1.0,1,1.0,1,0.21725119469635876,56
1209,0,1903,939,964,0,0,0,1.0,1,1.0,1,1.0,1,0.2280640595714654,55
1210,1,1904,940,964,0,0,0,1.0,1,1.0,1,1.0,1,0.22263240420236102,55
1211,1,1905,940,965,0,0,0,1.0,1,1.0,1,1.0,1,0.19623773473349115,57
1212,1,1906,941,965,0,0,0,1.0,1,1.0,1,1.0,1,0.19660202734678106,57
1213,2,1908,942,966,0,0,0,1.0,1,1.0,1,1.0,1,0.1693669176024817,57
1214,4,1912,945,967,0,0,0,1.0,1,1.0,1,1.0,1,0.23123812406248734,57
1215,4,1916,945,971,0,0,0,1.0,1,1.0,1,1.0,1,0.1931409005178622,59
1216,2,1918,946,972,0,0,0,1.0,1,1.0,1,1.0,1,0.1917253080617731,61
1217,1,1919,946,973,0,0,0,1.0,1,1.0,1,1.0,1,0.18110487900407132,61
1218,1,1920,947,973,0,0,0,1.0,1,1.0,1,1.0,1,0.21216635272392298,61
1219,1,1921,948,973,0,0,0,1.0,1,1.0,1,1.0,1,0.2130281994608236,61
1220,3,1924,949,975,0,0,0,1.0,1,1.0,1,1.0,1,0.21051741669208818,60
1221,1,1925,949,976,0,0,0,1.0,1,1.0,1,1.0,1,0.21389915477519977,61
1222,1,1926,949,977,0,0,0,1.0,1,1.0,1,1.0,1,0.18513646492877878,61
1223,0,1926,949,977,0,0,0,1.0,1,1.0,1,1.0,1,0.19726787966363973,59
1224,4,1930,953,977,0,0,0,1.0,1,1.0,1,1.0,1,0.20804912370488476,60
1225,6,1936,954,982,0,0,0,1.0,1,1.0,1,1.0,1,0.17923501623096305,60
1226,2,1938,955,983,0,0,0,1.0,1,1.0,1,1.0,1,0.17792367032048825,61
1227,2,1940,956,984,0,0,0,1.0,1,1.0,1,1.0,1,0.1597181535854815,59
1228,1,1941,957,984,0,0,0,1.0,1,1.0,1,1.0,1,0.16207377907592443,58
1229,4,1945,959,986,0,0,0,1.0,1,1.0,1,1.0,1,0.14021434372937588,57
1230,2,1947,961,986,0,0,0,1.0,1,1.0,1,1.0,1,0.14409859367728198,55
1231,4,1951,963,988,0,0,0,1.0,1,1.0,1,1.0,1,0.1607444625456041,54
1232,2,1953,965,988,0,0,0,1.0,1,1.0,1,1.0,1,0.18117470314119818,51
1233,2,1955,967,988,0,0,0,1.0,1,1.0,1,1.0,1,0.19924518528621354,49
1234,2,1957,969,988,0,0,0,1.0,1,1.0,1,1.0,1,0.22693608684104402,49
1235,2,1959,970,989,0,0,0,1.0,1,1.0,1,1.0,1,0.22307060841166923,48
1236,2,1961,970,991,0,0,0,1.0,1,1.0,1,1.0,1,0.21661811155791125,49
1237,2,1963,971,992,0,0,0,1.0,1,1.0,1,1.0,1,0.23939802085721884,48
1238,0,1963,971,992,0,0,0,1.0,1,1.0,1,1.0,1,0.23247061930645355,47
1239,0,1963,971,992,0,0,0,1.0,1,1.0,1,1.0,1,0.22258104566122242,48
1240,2,1965,972,993,0,0,0,1.0,1,1.0,1,1.0,1,0.22245208664314553,49
1241,0,1965,972,993,0,0,0,1.0,1,1.0,1,1.0,1,0.22245208664314553,49
1242,0,1965,972,993,0,0,0,1.0,1,1.0,1,1.0,1,0.22460223629174414,49
1243,1,1966,972,994,0,0,0,1.0,1,1.0,1,1.0,1,0.21402734896842432,50
1244,1,1967,973,994,0,0,0,1.0,1,1.0,1,1.0,1,0.27445403144784386,50
1245,5,1972,973,999,0,0,0,1.0,1,1.0,1,1.0,1,0.22609941024957916,51
1246,1,1973,974,999,0,0,0,1.0,1,1.0,1,1.0,1,0.24868095763090678,52
1247,1,1974,974,1000,0,0,0,1.0,1,1.0,1,1.0,1,0.2406529202744613,52
1248,0,1974,974,1000,0,0,0,1.0,1,1.0,1,1.0,1,0.25384901775390867,51
1249,3,1977,976,1001,0,0,0,1.0,1,1.0,1,1.0,1,0.2376763604292537,51
1250,4,1981,979,1002,0,0,0,1.0,1,1.0,1,1.0,1,0.22532862636205594,51
1251,4,1985,979,1006,0,0,0,1.0,1,1.0,1,1.0,1,0.19488112638973432,53
1252,2,1987,981,1006,0,0,0,1.0,1,1.0,1,1.0,1,0.17561383436243777,52
1253,0,1987,981,1006,0,0,0,1.0,1,1.0,1,1.0,1,0.17561383436243777,52
1254,0,1987,981,1006,0,0,0,1.0,1,1.0,1,1.0,1,0.16597787213548257,53
1255,1,1988,982,1006,0,0,0,1.0,1,1.0,1,1.0,1,0.18803041181749078,55
1256,0,1988,982,1006,0,0,0,1.0,1,1.0,1,1.0,1,0.18803041181749078,55
1257,2,1990,982,1008,0,0,0,1.0,1,1.0,1,1.0,1,0.18119900589542043,57
1258,0,1990,982,1008,0,0,0,1.0,1,1.0,1,1.0,1,0.1816402833280801,57
1259,0,1990,982,1008,0,0,0,1.0,1,1.0,1,1.0,1,0.1816402833280801,57
1260,0,1990,982,1008,0,0,0,1.0,1,1.0,1,1.0,1,0.18609380375759169,56
1261,0,1990,982,1008,0,0,0,1.0,1,1.0,1,1.0,1,0.18936946003071217,57
1262,4,1994,983,1011,0,0,0,1.0,1,1.0,1,1.0,1,0.17386290816000882,58
1263,4,1998,985,1013,0,0,0,1.0,1,1.0,1,1.0,1,0.1753873319392218,58
1264,2,2000,986,1014,0,0,0,1.0,1,1.0,1,1.0,1,0.17036780152242417,57
1265,6,2006,989,1017,0,0,0,1.0,1,1.0,1,1.0,1,0.17239526499292152,56
1266,5,2011,992,1019,0,0,0,1.0,1,1.0,1,1.0,1,0.23749298545407047,55
1267,2,2013,993,1020,0,0,0,1.0,1,1.0,1,1.0,1,0.21546097538233902,53
1268,1,2014,994,1020,0,0,0,1.0,1,1.0,1,1.0,1,0.24335266427657345,52
1269,1,2015,995,1020,0,0,0,1.0,1,1.0,1,1.0,1,0.2270944601858045,51
1270,0,2015,995,1020,0,0,0,1.0,1,1.0,1,1.0,1,0.21357633803726092,47
1271,1,2016,996,1020,0,0,0,1.0,1,1.0,1,1.0,1,0.2277743358800138,46
1272,0,2016,996,1020,0,0,0,1.0,1,1.0,1,1.0,1,0.2086670214707091,43
1273,2,2018,998,1020,0,0,0,1.0,1,1.0,1,1.0,1,0.21436032516100514,44
1274,3,2021,1000,1021,0,0,0,1.0,1,1.0,1,1.0,1,0.2569590948154788,44
1275,7,2028,1002,1026,0,0,0,1.0,1,1.0,1,1.0,1,0.19130565301439725,45
1276,2,2030,1002,1028,0,0,0,1.0,1,1.0,1,1.0,1,0.17019353183080604,43
1277,2,2032,1004,1028,0,0,0,1.0,1,1.0,1,1.0,1,0.18871013930595598,44
1278,4,2036,1007,1029,0,0,0,1.0,1,1.0,1,1.0,1,0.2258669466273762,45
1279,2,2038,1007,1031,0,0,0,1.0,1,1.0,1,1.0,1,0.1629163331943343,47
1280,1,2039,1008,1031,0,0,0,1.0,1,1.0,1,1.0,1,0.16532527231903538,47
1281,1,2040,1009,1031,0,0,0,1.0,1,1.0,1,1.0,1,0.1638721506976336,47
1282,1,2041,1010,1031,0,0,0,1.0,1,1.0,1,1.0,1,0.18404222849900728,46
1283,1,2042,1011,1031,0,0,0,1.0,1,1.0,1,1.0,1,0.18999121442363878,46
1284,2,2044,1011,1033,0,0,0,1.0,1,1.0,1,1.0,1,0.15960861493996212,46
1285,1,2045,1011,1034,0,0,0,1.0,1,1.0,1,1.0,1,0.1684617970083973,46
1286,0,2045,1011,1034,0,0,0,1.0,1,1.0,1,1.0,1,0.16468902973398053,45
1287,3,2048,1012,1036,0,0,0,1.0,1,1.0,1,1.0,1,0.18977482650826627,49
1288,0,2048,1012,1036,0,0,0,1.0,1,1.0,1,1.0,1,0.18977482650826627,49
1289,2,2050,1012,1038,0,0,0,1.0,1,1.0,1,1.0,1,0.168429927931197,52
1290,0,2050,1012,1038,0,0,0,1.0,1,1.0,1,1.0,1,0.168429927931197,52
1291,0,2050,1012,1038,0,0,0,1.0,1,1.0,1,1.0,1,0.168429927931197,52
1292,0,2050,1012,1038,0,0,0,1.0,1,1.0,1,1.0,1,0.17091113440961017,53
1293,1,2051,1013,1038,0,0,0,1.0,1,1.0,1,1.0,1,0.17384588976519544,53
1294,0,2051,1013,1038,0,0,0,1.0,1,1.0,1,1.0,1,0.17384588976519544,53
1295,1,2052,1013,1039,0,0,0,1.0,1,1.0,1,1.0,1,0.17085374796449707,54
1296,2,2054,1013,1041,0,0,0,1.0,1,1.0,1,1.0,1,0.14239250354765878,55
1297,1,2055,1013,1042,0,0,0,1.0,1,1.0,1,1.0,1,0.15293754732925893,54
1298,0,2055,1013,1042,0,0,0,1.0,1,1.0,1,1.0,1,0.16632864872472572,55
1299,1,2056,1013,1043,0,0,0,1.0,1,1.0,1,1.0,1,0.17050546046221085,54
1300,2,2058,1014,1044,0,0,0,1.0,1,1.0,1,1.0,1,0.17428037218682063,55
1301,0,2058,1014,1044,0,0,0,1.0,1,1.0,1,1.0,1,0.1767924922458551,54
1302,2,2060,1016,1044,0,0,0,1.0,1,1.0,1,1.0,1,0.19196995852910156,54
1303,7,2067,1019,1048,0,0,0,1.0,1,1.0,1,1.0,1,0.24468211718553012,50
1304,7,2074,1025,1049,0,0,0,1.0,1,1.0,1,1.0,1,0.23713133851270646,51
1305,2,2076,1027,1049,0,0,0,1.0,1,1.0,1,1.0,1,0.2497679225716064,48
1306,7,2083,1031,1052,0,0,0,1.0,1,1.0,1,1.0,1,0.3193367705694633,48
1307,3,2086,1031,1055,0,0,0,1.0,1,1.0,1,1.0,1,0.2099835392856756,48
1308,2,2088,1032,1056,0,0,0,1.0,1,1.0,1,1.0,1,0.22242843303752047,46
1309,3,2091,1034,1057,0,0,0,1.0,1,1.0,1,1.0,1,0.2259085686271552,47
1310,0,2091,1034,1057,0,0,0,1.0,1,1.0,1,1.0,1,0.2033505628472979,46
1311,2,2093,1036,1057,0,0,0,1.0,1,1.0,1,1.0,1,0.262391227031192,46
1312,1,2094,1037,1057,0,0,0,1.0,1,1.0,1,1.0,1,0.2775197218215527,45
1313,1,2095,1037,1058,0,0,0,1.0,1,1.0,1,1.0,1,0.2842029057129405,44
1314,1,2096,1037,1059,0,0,0,1.0,1,1.0,1,1.0,1,0.274076402128206,42
1315,0,2096,1037,1059,0,0,0,1.0,1,1.0,1,1.0,1,0.3306068875461986,40
1316,1,2097,1037,1060,0,0,0,1.0,1,1.0,1,1.0,1,0.2944164050208864,42
1317,1,2098,1037,1061,0,0,0,1.0,1,1.0,1,1.0,1,0.2842963935842488,42
1318,0,2098,1037,1061,0,0,0,1.0,1,1.0,1,1.0,1,0.2842963935842488,42
1319,2,2100,1038,1062,0,0,0,1.0,1,1.0,1,1.0,1,0.23920739999732224,42
1320,1,2101,1038,1063,0,0,0,1.0,1,1.0,1,1.0,1,0.23449099977579124,42
1321,0,2101,1038,1063,0,0,0,1.0,1,1.0,1,1.0,1,0.23507590452325633,45
1322,0,2101,1038,1063,0,0,0,1.0,1,1.0,1,1.0,1,0.23507590452325633,45
1323,2,2103,1039,1064,0,0,0,1.0,1,1.0,1,1.0,1,0.22562709503977982,46
1324,1,2104,1039,1065,0,0,0,1.0,1,1.0,1,1.0,1,0.23082802049023254,45
1325,3,2107,1040,1067,0,0,0,1.0,1,1.0,1,1.0,1,0.22983113124942142,46
1326,1,2108,1041,1067,0,0,0,1.0,1,1.0,1,1.0,1,0.2551320040123948,45
1327,0,2108,1041,1067,0,0,0,1.0,1,1.0,1,1.0,1,0.2798245920256512,46
1328,0,2108,1041,1067,0,0,0,1.0,1,1.0,1,1.0,1,0.28191269423491483,47
1329,1,2109,1042,1067,0,0,0,1.0,1,1.0,1,1.0,1,0.28809818251678376,47
1330,0,2109,1042,1067,0,0,0,1.0,1,1.0,1,1.0,1,0.30907208705789363,46
1331,4,2113,1044,1069,0,0,0,1.0,1,1.0,1,1.0,1,0.2677666061285456,46
1332,4,2117,1046,1071,0,0,0,1.0,1,1.0,1,1.0,1,0.28512531017969406,49
1333,2,2119,1046,1073,0,0,0,1.0,1,1.0,1,1.0,1,0.2845274404609771,50
1334,0,2119,1046,1073,0,0,0,1.0,1,1.0,1,1.0,1,0.2845274404609771,50
1335,1,2120,1046,1074,0,0,0,1.0,1,1.0,1,1.0,1,0.30417512489203513,52
1336,0,2120,1046,1074,0,0,0,1.0,1,1.0,1,1.0,1,0.29041906988489063,53
1337,3,2123,1047,1076,0,0,0,1.0,1,1.0,1,1.0,1,0.2963179232426417,54
1338,1,2124,1047,1077,0,0,0,1.0,1,1.0,1,1.0,1,0.2849661330436632,54
1339,2,2126,1048,1078,0,0,0,1.0,1,1.0,1,1.0,1,0.2913782297469371,54
1340,2,2128,1048,1080,0,0,0,1.0,1,1.0,1,1.0,1,0.25653406395011324,53
1341,0,2128,1048,1080,0,0,0,1.0,1,1.0,1,1.0,1,0.2734103571865449,53
1342,1,2129,1049,1080,0,0,0,1.0,1,1.0,1,1.0,1,0.3117962520231339,52
1343,2,2131,1050,1081,0,0,0,1.0,1,1.0,1,1.0,1,0.32217740242950965,50
1344,4,2135,1053,1082,0,0,0,1.0,1,1.0,1,1.0,1,0.33878097223440756,51
1345,1,2136,1053,1083,0,0,0,1.0,1,1.0,1,1.0,1,0.32324229799703,50
1346,1,2137,1054,1083,0,0,0,1.0,1,1.0,1,1.0,1,0.32100901739530296,50
1347,3,2140,1054,1086,0,0,0,1.0,1,1.0,1,1.0,1,0.2915331841969216,48
1348,1,2141,1054,1087,0,0,0,1.0,1,1.0,1,1.0,1,0.2774941332986637,49
1349,1,2142,1054,1088,0,0,0,1.0,1,1.0,1,1.0,1,0.2622038156625858,48
1350,1,2143,1055,1088,0,0,0,1.0,1,1.0,1,1.0,1,0.29583910756169013,49
1351,0,2143,1055,1088,0,0,0,1.0,1,1.0,1,1.0,1,0.28233452537162523,48
1352,2,2145,1056,1089,0,0,0,1.0,1,1.0,1,1.0,1,0.27454658214931293,49
1353,3,2148,1056,1092,0,0,0,1.0,1,1.0,1,1.0,1,0.2141365904001708,49
1354,3,2151,1057,1094,0,0,0,1.0,1,1.0,1,1.0,1,0.20337938359818777,49
1355,1,2152,1057,1095,0,0,0,1.0,1,1.0,1,1.0,1,0.18245191550553222,50
1356,1,2153,1058,1095,0,0,0,1.0,1,1.0,1,1.0,1,0.20264509058732852,50
1357,6,2159,1062,1097,0,0,0,1.0,1,1.0,1,1.0,1,0.20018262485111174,50
1358,3,2162,1063,1099,0,0,0,1.0,1,1.0,1,1.0,1,0.19693083080155468,51
1359,3,2165,1064,1101,0,0,0,1.0,1,1.0,1,1.0,1,0.2067414644959104,53
1360,0,2165,1064,1101,0,0,0,1.0,1,1.0,1,1.0,1,0.20699625621981466,54
1361,1,2166,1064,1102,0,0,0,1.0,1,1.0,1,1.0,1,0.1840307944724697,54
1362,0,2166,1064,1102,0,0,0,1.0,1,1.0,1,1.0,1,0.1720646143658998,55
1363,1,2167,1064,1103,0,0,0,1.0,1,1.0,1,1.0,1,0.15507571761798059,55
1364,0,2167,1064,1103,0,0,0,1.0,1,1.0,1,1.0,1,0.1637201549242903,55
1365,2,2169,1064,1105,0,0,0,1.0,1,1.0,1,1.0,1,0.15735416160690807,56
1366,0,2169,1064,1105,0,0,0,1.0,1,1.0,1,1.0,1,0.15735416160690807,56
1367,1,2170,1065,1105,0,0,0,1.0,1,1.0,1,1.0,1,0.170595900965976,56
1368,3,2173,1066,1107,0,0,0,1.0,1,1.0,1,1.0,1,0.1924727139302124,58
1369,3,2176,1066,1110,0,0,0,1.0,1,1.0,1,1.0,1,0.14822494120373844,59
1370,1,2177,1067,1110,0,0,0,1.0,1,1.0,1,1.0,1,0.14380703825015234,59
1371,1,2178,1067,1111,0,0,0,1.0,1,1.0,1,1.0,1,0.12525592549368522,59
1372,4,2182,1069,1113,0,0,0,1.0,1,1.0,1,1.0,1,0.11395655447725506,59
1373,0,2182,1069,1113,0,0,0,1.0,1,1.0,1,1.0,1,0.11395655447725506,59
1374,1,2183,1070,1113,0,0,0,1.0,1,1.0,1,1.0,1,0.13236646127196233,60
1375,1,2184,1070,1114,0,0,0,1.0,1,1.0,1,1.0,1,0.11690701639785081,61
1376,2,2186,1070,1116,0,0,0,1.0,1,1.0,1,1.0,1,0.13761651665339222,61
1377,3,2189,1072,1117,0,0,0,1.0,1,1.0,1,1.0,1,0.12576882075455403,61
1378,2,2191,1074,1117,0,0,0,1.0,1,1.0,1,1.0,1,0.19775763398178647,61
1379,2,2193,1075,1118,0,0,0,1.0,1,1.0,1,1.0,1,0.21596966866084016,60
1380,4,2197,1076,1121,0,0,0,1.0,1,1.0,1,1.0,1,0.2140037746824056,60
1381,3,2200,1077,1123,0,0,0,1.0,1,1.0,1,1.0,1,0.20692283463958563,58
1382,4,2204,1079,1125,0,0,0,1.0,1,1.0,1,1.0,1,0.21062585775771003,58
1383,5,2209,1081,1128,0,0,0,1.0,1,1.0,1,1.0,1,0.18763621424684224,57
1384,3,2212,1083,1129,0,0,0,1.0,1,1.0,1,1.0,1,0.1961513777369177,54
1385,2,2214,1084,1130,0,0,0,1.0,1,1.0,1,1.0,1,0.19381183806852095,52
1386,3,2217,1085,1132,0,0,0,1.0,1,1.0,1,1.0,1,0.17494834236656504,51
1387,6,2223,1086,1137,0,0,0,1.0,1,1.0,1,1.0,1,0.1513222427237217,51
1388,4,2227,1090,1137,0,0,0,1.0,1,1.0,1,1.0,1,0.21733621434874592,52
1389,3,2230,1090,1140,0,0,0,1.0,1,1.0,1,1.0,1,0.15749512980091557,50
1390,0,2230,1090,1140,0,0,0,1.0,1,1.0,1,1.0,1,0.16085608289687559,51
1391,1,2231,1090,1141,0,0,0,1.0,1,1.0,1,1.0,1,0.14971196451317936,50
1392,1,2232,1091,1141,0,0,0,1.0,1,1.0,1,1.0,1,0.17078492451769037,50
1393,2,2234,1091,1143,0,0,0,1.0,1,1.0,1,1.0,1,0.13812995432890723,49
1394,2,2236,1093,1143,0,0,0,1.0,1,1.0,1,1.0,1,0.17971290606338475,50
1395,0,2236,1093,1143,0,0,0,1.0,1,1.0,1,1.0,1,0.17771648088147118,51
1396,2,2238,1093,1145,0,0,0,1.0,1,1.0,1,1.0,1,0.17456440244157398,52
1397,0,2238,1093,1145,0,0,0,1.0,1,1.0,1,1.0,1,0.17456440244157398,52
1398,2,2240,1095,1145,0,0,0,1.0,1,1.0,1,1.0,1,0.1719161772197627,53
1399,2,2242,1096,1146,0,0,0,1.0,1,1.0,1,1.0,1,0.1853894143450452,54
1400,1,2243,1097,1146,0,0,0,1.0,1,1.0,1,1.0,1,0.2051496446044587,54
1401,2,2245,1099,1146,0,0,0,1.0,1,1.0,1,1.0,1,0.19631833442205895,54
1402,2,2247,1101,1146,0,0,0,1.0,1,1.0,1,1.0,1,0.207852789582194,53
1403,1,2248,1101,1147,0,0,0,1.0,1,1.0,1,1.0,1,0.21941460747839345,52
1404,0,2248,1101,1147,0,0,0,1.0,1,1.0,1,1.0,1,0.22762666186990735,53
1405,1,2249,1102,1147,0,0,0,1.0,1,1.0,1,1.0,1,0.2747103825751278,52
1406,1,2250,1102,1148,0,0,0,1.0,1,1.0,1,1.0,1,0.24930800406864742,53
1407,0,2250,1102,1148,0,0,0,1.0,1,1.0,1,1.0,1,0.2585388795097824,54
1408,0,2250,1102,1148,0,0,0,1.0,1,1.0,1,1.0,1,0.27951097613997744,53
1409,2,2252,1102,1150,0,0,0,1.0,1,1.0,1,1.0,1,0.2621100919178223,55
1410,0,2252,1102,1150,0,0,0,1.0,1,1.0,1,1.0,1,0.26289526755202297,54
1411,0,2252,1102,1150,0,0,0,1.0,1,1.0,1,1.0,1,0.26289526755202297,54
1412,0,2252,1102,1150,0,0,0,1.0,1,1.0,1,1.0,1,0.26708212236779855,53
1413,0,2252,1102,1150,0,0,0,1.0,1,1.0,1,1.0,1,0.2617053829671166,54
1414,2,2254,1102,1152,0,0,0,1.0,1,1.0,1,1.0,1,0.2548547048733654,55
1415,2,2256,1102,1154,0,0,0,1.0,1,1.0,1,1.0,1,0.22690707421464498,57
1416,3,2259,1103,1156,0,0,0,1.0,1,1.0,1,1.0,1,0.24519198106225085,59
1417,1,2260,1103,1157,0,0,0,1.0,1,1.0,1,1.0,1,0.22558743089095568,58
1418,2,2262,1104,1158,0,0,0,1.0,1,1.0,1,1.0,1,0.21039318892426126,57
1419,1,2263,1105,1158,0,0,0,1.0,1,1.0,1,1.0,1,0.2328672322294623,56
1420,1,2264,1105,1159,0,0,0,1.0,1,1.0,1,1.0,1,0.26869463101383456,54
1421,3,2267,1106,1161,0,0,0,1.0,1,1.0,1,1.0,1,0.23551489872254983,55
1422,1,2268,1107,1161,0,0,0,1.0,1,1.0,1,1.0,1,0.20838627697905038,52
1423,2,2270,1109,1161,0,0,0,1.0,1,1.0,1,1.0,1,0.250604783336632,52
1424,3,2273,1112,1161,0,0,0,1.0,1,1.0,1,1.0,1,0.2907286498454358,51
1425,6,2279,1112,1167,0,0,0,1.0,1,1.0,1,1.0,1,0.21634234018806114,50
1426,2,2281,1113,1168,0,0,0,1.0,1,1.0,1,1.0,1,0.24194761527930073,50
1427,2,2283,1113,1170,0,0,0,1.0,1,1.0,1,1.0,1,0.21830805905905196,48
1428,4,2287,1116,1171,0,0,0,1.0,1,1.0,1,1.0,1,0.21374873321664817,48
1429,0,2287,1116,1171,0,0,0,1.0,1,1.0,1,1.0,1,0.21839040125026687,48
1430,1,2288,1117,1171,0,0,0,1.0,1,1.0,1,1.0,1,0.22492676542040918,48
1431,1,2289,1117,1172,0,0,0,1.0,1,1.0,1,1.0,1,0.21158454186938636,48
1432,2,2291,1117,1174,0,0,0,1.0,1,1.0,1,1.0,1,0.16418693671782172,50
1433,2,2293,1118,1175,0,0,0,1.0,1,1.0,1,1.0,1,0.18233620347075427,51
1434,1,2294,1119,1175,0,0,0,1.0,1,1.0,1,1.0,1,0.17046539823431375,51
1435,4,2298,1121,1177,0,0,0,1.0,1,1.0,1,1.0,1,0.1643002330624067,50
1436,1,2299,1122,1177,0,0,0,1.0,1,1.0,1,1.0,1,0.17302836062034427,51
1437,0,2299,1122,1177,0,0,0,1.0,1,1.0,1,1.0,1,0.17302836062034427,51
1438,1,2300,1123,1177,0,0,0,1.0,1,1.0,1,1.0,1,0.19299625346996188,51
1439,3,2303,1125,1178,0,0,0,1.0,1,1.0,1,1.0,1,0.20656363916506668,50
1440,4,2307,1126,1181,0,0,0,1.0,1,1.0,1,1.0,1,0.21039610003300063,51
1441,0,2307,1126,1181,0,0,0,1.0,1,1.0,1,1.0,1,0.21039610003300063,51
1442,3,2310,1128,1182,0,0,0,1.0,1,1.0,1,1.0,1,0.22605044337099015,52
1443,4,2314,1128,1186,0,0,0,1.0,1,1.0,1,1.0,1,0.19941722486045557,53
1444,4,2318,1129,1189,0,0,0,1.0,1,1.0,1,1.0,1,0.17116456026791824,54
1445,1,2319,1129,1190,0,0,0,1.0,1,1.0,1,1.0,1,0.14915290433879147,54
1446,0,2319,1129,1190,0,0,0,1.0,1,1.0,1,1.0,1,0.16280588884567535,54
1447,0,2319,1129,1190,0,0,0,1.0,1,1.0,1,1.0,1,0.1534865589413085,55
1448,1,2320,1129,1191,0,0,0,1.0,1,1.0,1,1.0,1,0.14020063973336358,55
1449,1,2321,1130,1191,0,0,0,1.0,1,1.0,1,1.0,1,0.15425146627124514,55
1450,0,2321,1130,1191,0,0,0,1.0,1,1.0,1,1.0,1,0.15790474845646782,57
1451,1,2322,1130,1192,0,0,0,1.0,1,1.0,1,1.0,1,0.13381095249503464,57
1452,0,2322,1130,1192,0,0,0,1.0,1,1.0,1,1.0,1,0.13381095249503464,57
1453,1,2323,1131,1192,0,0,0,1.0,1,1.0,1,1.0,1,0.15913918514938713,57
1454,4,2327,1134,1193,0,0,0,1.0,1,1.0,1,1.0,1,0.1919777455856175,58
1455,4,2331,1135,1196,0,0,0,1.0,1,1.0,1,1.0,1,0.17506886366579244,56
1456,1,2332,1136,1196,0,0,0,1.0,1,1.0,1,1.0,1,0.1662905466372311,55
1457,0,2332,1136,1196,0,0,0,1.0,1,1.0,1,1.0,1,0.1887710312282976,54
1458,2,2334,1138,1196,0,0,0,1.0,1,1.0,1,1.0,1,0.21478659959144153,53
1459,3,2337,1138,1199,0,0,0,1.0,1,1.0,1,1.0,1,0.14688147396546625,52
1460,1,2338,1138,1200,0,0,0,1.0,1,1.0,1,1.0,1,0.11865704293153849,51
1461,1,2339,1139,1200,0,0,0,1.0,1,1.0,1,1.0,1,0.144132684563092,51
1462,6,2345,1143,1202,0,0,0,1.0,1,1.0,1,1.0,1,0.15938412394442375,51
1463,4,2349,1145,1204,0,0,0,1.0,1,1.0,1,1.0,1,0.18649717495526139,52
1464,4,2353,1148,1205,0,0,0,1.0,1,1.0,1,1.0,1,0.22695859289128717,52
1465,2,2355,1149,1206,0,0,0,1.0,1,1.0,1,1.0,1,0.2120912936869236,51
1466,6,2361,1152,1209,0,0,0,1.0,1,1.0,1,1.0,1,0.17228991141426026,50
1467,3,2364,1154,1210,0,0,0,1.0,1,1.0,1,1.0,1,0.16752235614229488,48
1468,2,2366,1156,1210,0,0,0,1.0,1,1.0,1,1.0,1,0.16643902290326854,48
1469,2,2368,1156,1212,0,0,0,1.0,1,1.0,1,1.0,1,0.1453503529156607,48
1470,2,2370,1157,1213,0,0,0,1.0,1,1.0,1,1.0,1,0.13674347415041663,48
1471,2,2372,1159,1213,0,0,0,1.0,1,1.0,1,1.0,1,0.14145447532841948,45
1472,1,2373,1160,1213,0,0,0,1.0,1,1.0,1,1.0,1,0.13241091910896455,45
1473,2,2375,1161,1214,0,0,0,1.0,1,1.0,1,1.0,1,0.14948723559553984,46
1474,0,2375,1161,1214,0,0,0,1.0,1,1.0,1,1.0,1,0.15200720328175787,46
1475,0,2375,1161,1214,0,0,0,1.0,1,1.0,1,1.0,1,0.15200720328175787,46
1476,1,2376,1161,1215,0,0,0,1.0,1,1.0,1,1.0,1,0.15806129565957336,47
1477,1,2377,1161,1216,0,0,0,1.0,1,1.0,1,1.0,1,0.12881648011094418,47
1478,2,2379,1162,1217,0,0,0,1.0,1,1.0,1,1.0,1,0.16626382237282525,47
1479,0,2379,1162,1217,0,0,0,1.0,1,1.0,1,1.0,1,0.1739420794618672,48
1480,1,2380,1163,1217,0,0,0,1.0,1,1.0,1,1.0,1,0.18569968554135638,47
1481,1,2381,1164,1217,0,0,0,1.0,1,1.0,1,1.0,1,0.21161173891598925,47
1482,4,2385,1166,1219,0,0,0,1.0,1,1.0,1,1.0,1,0.18355290172569122,46
1483,3,2388,1167,1221,0,0,0,1.0,1,1.0,1,1.0,1,0.19617472644164846,47
1484,0,2388,1167,1221,0,0,0,1.0,1,1.0,1,1.0,1,0.20342320813873543,47
1485,3,2391,1167,1224,0,0,0,1.0,1,1.0,1,1.0,1,0.19315233480375188,47
1486,0,2391,1167,1224,0,0,0,1.0,1,1.0,1,1.0,1,0.19028471380645684,49
1487,5,2396,1171,1225,0,0,0,1.0,1,1.0,1,1.0,1,0.16305904274325592,49
1488,1,2397,1172,1225,0,0,0,1.0,1,1.0,1,1.0,1,0.17459170371314406,51
1489,3,2400,1173,1227,0,0,0,1.0,1,1.0,1,1.0,1,0.1820438540926645,52
1490,0,2400,1173,1227,0,0,0,1.0,1,1.0,1,1.0,1,0.1820438540926645,52
1491,3,2403,1176,1227,0,0,0,1.0,1,1.0,1,1.0,1,0.20336105354213743,53
1492,8,2411,1180,1231,0,0,0,1.0,1,1.0,1,1.0,1,0.1870739394176485,53
1493,1,2412,1180,1232,0,0,0,1.0,1,1.0,1,1.0,1,0.1344599526425075,52
1494,2,2414,1182,1232,0,0,0,1.0,1,1.0,1,1.0,1,0.1433354147221864,50
1495,3,2417,1184,1233,0,0,0,1.0,1,1.0,1,1.0,1,0.10229809285065729,50
1496,1,2418,1185,1233,0,0,0,1.0,1,1.0,1,1.0,1,0.15434421891942143,52
1497,1,2419,1186,1233,0,0,0,1.0,1,1.0,1,1.0,1,0.17306357769717695,51
1498,1,2420,1187,1233,0,0,0,1.0,1,1.0,1,1.0,1,0.1864597216420888,50
1499,1,2421,1187,1234,0,0,0,1.0,1,1.0,1,1.0,1,0.14998911264231593,50
1500,3,2424,1189,1235,0,0,0,1.0,1,1.0,1,1.0,1,0.17921779828121112,49
1501,1,2425,1189,1236,0,0,0,1.0,1,1.0,1,1.0,1,0.15278386870782254,47
1502,3,2428,1192,1236,0,0,0,1.0,1,1.0,1,1.0,1,0.2159374498858516,47
1503,2,2430,1193,1237,0,0,0,1.0,1,1.0,1,1.0,1,0.17536185230110637,47
1504,2,2432,1195,1237,0,0,0,1.0,1,1.0,1,1.0,1,0.18474630876774276,48
1505,3,2435,1197,1238,0,0,0,1.0,1,1.0,1,1.0,1,0.17270816734961925,47
1506,2,2437,1199,1238,0,0,0,1.0,1,1.0,1,1.0,1,0.19164645191846297,47
1507,4,2441,1202,1239,0,0,0,1.0,1,1.0,1,1.0,1,0.2115998751051812,45
1508,1,2442,1203,1239,0,0,0,1.0,1,1.0,1,1.0,1,0.20774933447076543,45
1509,3,2445,1206,1239,0,0,0,1.0,1,1.0,1,1.0,1,0.24643944515556743,44
1510,2,2447,1208,1239,0,0,0,1.0,1,1.0,1,1.0,1,0.2991006226391027,42
1511,2,2449,1208,1241,0,0,0,1.0,1,1.0,1,1.0,1,0.26083965524201247,40
1512,4,2453,1212,1241,0,0,0,1.0,1,1.0,1,1.0,1,0.35109397138185766,39
1513,3,2456,1212,1244,0,0,0,1.0,1,1.0,1,1.0,1,0.27480321180802336,39
1514,1,2457,1212,1245,0,0,0,1.0,1,1.0,1,1.0,1,0.2466625939308205,38
1515,1,2458,1213,1245,0,0,0,1.0,1,1.0,1,1.0,1,0.27020693443801275,39
1516,3,2461,1213,1248,0,0,0,1.0,1,1.0,1,1.0,1,0.21312428366477215,39
1517,2,2463,1214,1249,0,0,0,1.0,1,1.0,1,1.0,1,0.21205023764652303,39
1518,1,2464,1215,1249,0,0,0,1.0,1,1.0,1,1.0,1,0.23741177518266213,39
1519,0,2464,1215,1249,0,0,0,1.0,1,1.0,1,1.0,1,0.23741177518266213,39
1520,3,2467,1216,1251,0,0,0,1.0,1,1.0,1,1.0,1,0.22383333599409855,39
1521,2,2469,1217,1252,0,0,0,1.0,1,1.0,1,1.0,1,0.24010757571291008,40
1522,1,2470,1218,1252,0,0,0,1.0,1,1.0,1,1.0,1,0.2608244618360341,40
1523,2,2472,1218,1254,0,0,0,1.0,1,1.0,1,1.0,1,0.2407617650606838,41
1524,1,2473,1219,1254,0,0,0,1.0,1,1.0,1,1.0,1,0.27773051491450695,42
1525,4,2477,1220,1257,0,0,0,1.0,1,1.0,1,1.0,1,0.2164165583787229,45
1526,1,2478,1220,1258,0,0,0,1.0,1,1.0,1,1.0,1,0.22137576651145727,46
1527,0,2478,1220,1258,0,0,0,1.0,1,1.0,1,1.0,1,0.22137576651145727,46
1528,0,2478,1220,1258,0,0,0,1.0,1,1.0,1,1.0,1,0.22617873791762555,47
1529,0,2478,1220,1258,0,0,0,1.0,1,1.0,1,1.0,1,0.22617873791762555,47
1530,0,2478,1220,1258,0,0,0,1.0,1,1.0,1,1.0,1,0.23910360830508404,48
1531,1,2479,1220,1259,0,0,0,1.0,1,1.0,1,1.0,1,0.21333809427267544,46
1532,1,2480,1220,1260,0,0,0,1.0,1,1.0,1,1.0,1,0.17333689332809027,47
1533,0,2480,1220,1260,0,0,0,1.0,1,1.0,1,1.0,1,0.17752863647667896,46
1534,1,2481,1221,1260,0,0,0,1.0,1,1.0,1,1.0,1,0.1567993894802778,47
1535,1,2482,1222,1260,0,0,0,1.0,1,1.0,1,1.0,1,0.15400964018217986,47
1536,0,2482,1222,1260,0,0,0,1.0,1,1.0,1,1.0,1,0.16342357659222637,48
1537,0,2482,1222,1260,0,0,0,1.0,1,1.0,1,1.0,1,0.16660127200522296,46
1538,1,2483,1223,1260,0,0,0,1.0,1,1.0,1,1.0,1,0.19151585668576968,47
1539,1,2484,1223,1261,0,0,0,1.0,1,1.0,1,1.0,1,0.19340143328429324,47
1540,1,2485,1224,1261,0,0,0,1.0,1,1.0,1,1.0,1,0.20829646098368731,47
1541,0,2485,1224,1261,0,0,0,1.0,1,1.0,1,1.0,1,0.20771378117703962,47
1542,3,2488,1226,1262,0,0,0,1.0,1,1.0,1,1.0,1,0.25542640375429726,50
1543,3,2491,1229,1262,0,0,0,1.0,1,1.0,1,1.0,1,0.2738693005600197,47
1544,4,2495,1233,1262,0,0,0,1.0,1,1.0,1,1.0,1,0.33155760060325756,48
1545,7,2502,1234,1268,0,0,0,1.0,1,1.0,1,1.0,1,0.2111728455010396,47
1546,2,2504,1234,1270,0,0,0,1.0,1,1.0,1,1.0,1,0.18102625166306605,47
1547,1,2505,1235,1270,0,0,0,1.0,1,1.0,1,1.0,1,0.2082158619488411,47
1548,4,2509,1239,1270,0,0,0,1.0,1,1.0,1,1.0,1,0.23049804263440568,47
1549,6,2515,1244,1271,0,0,0,1.0,1,1.0,1,1.0,1,0.22368072354421795,46
1550,3,2518,1245,1273,0,0,0,1.0,1,1.0,1,1.0,1,0.20762882947199113,44
1551,5,2523,1248,1275,0,0,0,1.0,1,1.0,1,1.0,1,0.21622204576503068,45
1552,3,2526,1251,1275,0,0,0,1.0,1,1.0,1,1.0,1,0.178375264640471,43
1553,2,2528,1252,1276,0,0,0,1.0,1,1.0,1,1.0,1,0.16029412617914457,43
1554,1,2529,1253,1276,0,0,0,1.0,1,1.0,1,1.0,1,0.17384072972410905,41
1555,2,2531,1254,1277,0,0,0,1.0,1,1.0,1,1.0,1,0.22740873657670885,44
1556,2,2533,1255,1278,0,0,0,1.0,1,1.0,1,1.0,1,0.1980460872603713,45
1557,0,2533,1255,1278,0,0,0,1.0,1,1.0,1,1.0,1,0.1980460872603713,45
1558,2,2535,1255,1280,0,0,0,1.0,1,1.0,1,1.0,1,0.17631333515504924,46
1559,0,2535,1255,1280,0,0,0,1.0,1,1.0,1,1.0,1,0.1728307350631708,47
1560,2,2537,1257,1280,0,0,0,1.0,1,1.0,1,1.0,1,0.11799120130708049,46
1561,0,2537,1257,1280,0,0,0,1.0,1,1.0,1,1.0,1,0.1148429340331465,47
1562,0,2537,1257,1280,0,0,0,1.0,1,1.0,1,1.0,1,0.12450864202093777,47
1563,1,2538,1258,1280,0,0,0,1.0,1,1.0,1,1.0,1,0.1435707832080051,47
1564,0,2538,1258,1280,0,0,0,1.0,1,1.0,1,1.0,1,0.1435707832080051,47
1565,1,2539,1258,1281,0,0,0,1.0,1,1.0,1,1.0,1,0.1767455953932387,48
1566,0,2539,1258,1281,0,0,0,1.0,1,1.0,1,1.0,1,0.1767455953932387,48
1567,2,2541,1259,1282,0,0,0,1.0,1,1.0,1,1.0,1,0.20102653394371756,48
1568,4,2545,1262,1283,0,0,0,1.0,1,1.0,1,1.0,1,0.24861073937224823,48
1569,0,2545,1262,1283,0,0,0,1.0,1,1.0,1,1.0,1,0.21749552315997933,45
1570,0,2545,1262,1283,0,0,0,1.0,1,1.0,1,1.0,1,0.20651390770759231,44
1571,4,2549,1265,1284,0,0,0,1.0,1,1.0,1,1.0,1,0.21289674523114835,42
1572,4,2553,1265,1288,0,0,0,1.0,1,1.0,1,1.0,1,0.21610060841045328,43
1573,3,2556,1266,1290,0,0,0,1.0,1,1.0,1,1.0,1,0.2124610233131431,43
1574,3,2559,1269,1290,0,0,0,1.0,1,1.0,1,1.0,1,0.19531923650262942,42
1575,2,2561,1270,1291,0,0,0,1.0,1,1.0,1,1.0,1,0.19613781625251842,43
1576,3,2564,1273,1291,0,0,0,1.0,1,1.0,1,1.0,1,0.18255597677319377,41
1577,2,2566,1274,1292,0,0,0,1.0,1,1.0,1,1.0,1,0.22668053577039576,40
1578,0,2566,1274,1292,0,0,0,1.0,1,1.0,1,1.0,1,0.21134686832551466,40
1579,0,2566,1274,1292,0,0,0,1.0,1,1.0,1,1.0,1,0.2103528646967266,40
1580,1,2567,1275,1292,0,0,0,1.0,1,1.0,1,1.0,1,0.2135142318483895,40
1581,2,2569,1276,1293,0,0,0,1.0,1,1.0,1,1.0,1,0.219596467226491,40
1582,7,2576,1280,1296,0,0,0,1.0,1,1.0,1,1.0,1,0.1978469749234052,40
1583,1,2577,1281,1296,0,0,0,1.0,1,1.0,1,1.0,1,0.213638140933196,38
1584,2,2579,1283,1296,0,0,0,1.0,1,1.0,1,1.0,1,0.20447314883921708,39
1585,3,2582,1286,1296,0,0,0,1.0,1,1.0,1,1.0,1,0.19568289975462128,38
1586,3,2585,1289,1296,0,0,0,1.0,1,1.0,1,1.0,1,0.2388660192138827,38
1587,2,2587,1290,1297,0,0,0,1.0,1,1.0,1,1.0,1,0.18107367135308233,37
1588,6,2593,1293,1300,0,0,0,1.0,1,1.0,1,1.0,1,0.20268170845646322,39
1589,2,2595,1295,1300,0,0,0,1.0,1,1.0,1,1.0,1,0.23188981907984374,37
1590,1,2596,1296,1300,0,0,0,1.0,1,1.0,1,1.0,1,0.24110444773262743,37
1591,0,2596,1296,1300,0,0,0,1.0,1,1.0,1,1.0,1,0.2748797260815874,36
1592,2,2598,1296,1302,0,0,0,1.0,1,1.0,1,1.0,1,0.25584155121284213,34
1593,1,2599,1297,1302,0,0,0,1.0,1,1.0,1,1.0,1,0.3169397524651632,33
1594,0,2599,1297,1302,0,0,0,1.0,1,1.0,1,1.0,1,0.3352838615895358,31
1595,3,2602,1298,1304,0,0,0,1.0,1,1.0,1,1.0,1,0.2825031439860687,34
1596,1,2603,1298,1305,0,0,0,1.0,1,1.0,1,1.0,1,0.25806062829808696,33
1597,0,2603,1298,1305,0,0,0,1.0,1,1.0,1,1.0,1,0.25806062829808696,33
1598,1,2604,1298,1306,0,0,0,1.0,1,1.0,1,1.0,1,0.20196979185568406,33
1599,1,2605,1298,1307,0,0,0,1.0,1,1.0,1,1.0,1,0.18580256446621232,33
1600,0,2605,1298,1307,0,0,0,1.0,1,1.0,1,1.0,1,0.20163415913449947,34
1601,3,2608,1300,1308,0,0,0,1.0,1,1.0,1,1.0,1,0.24048934288828058,35
1602,0,2608,1300,1308,0,0,0,1.0,1,1.0,1,1.0,1,0.21720222106974924,36
1603,2,2610,1301,1309,0,0,0,1.0,1,1.0,1,1.0,1,0.25909445257775543,38
1604,1,2611,1302,1309,0,0,0,1.0,1,1.0,1,1.0,1,0.24329796851548524,38
1605,1,2612,1302,1310,0,0,0,1.0,1,1.0,1,1.0,1,0.22505478724463687,38
1606,6,2618,1305,1313,0,0,0,1.0,1,1.0,1,1.0,1,0.236852103254646,39
1607,1,2619,1306,1313,0,0,0,1.0,1,1.0,1,1.0,1,0.2708774149936305,37
1608,2,2621,1307,1314,0,0,0,1.0,1,1.0,1,1.0,1,0.2925987011844307,36
1609,1,2622,1307,1315,0,0,0,1.0,1,1.0,1,1.0,1,0.2215019956332846,34
1610,2,2624,1308,1316,0,0,0,1.0,1,1.0,1,1.0,1,0.21945294169279833,34
1611,4,2628,1311,1317,0,0,0,1.0,1,1.0,1,1.0,1,0.23074732195606057,35
1612,0,2628,1311,1317,0,0,0,1.0,1,1.0,1,1.0,1,0.262530745774496,33
1613,5,2633,1312,1321,0,0,0,1.0,1,1.0,1,1.0,1,0.19764775335046983,34
1614,1,2634,1313,1321,0,0,0,1.0,1,1.0,1,1.0,1,0.21389490480773204,35
1615,1,2635,1313,1322,0,0,0,1.0,1,1.0,1,1.0,1,0.1855307579980996,35
1616,0,2635,1313,1322,0,0,0,1.0,1,1.0,1,1.0,1,0.17483663437996996,37
1617,1,2636,1314,1322,0,0,0,1.0,1,1.0,1,1.0,1,0.2126842598643351,38
1618,1,2637,1315,1322,0,0,0,1.0,1,1.0,1,1.0,1,0.2239738413909272,38
1619,1,2638,1316,1322,0,0,0,1.0,1,1.0,1,1.0,1,0.22396722927067048,38
1620,2,2640,1317,1323,0,0,0,1.0,1,1.0,1,1.0,1,0.21403896931211572,39
1621,1,2641,1318,1323,0,0,0,1.0,1,1.0,1,1.0,1,0.1985522902522159,37
1622,1,2642,1319,1323,0,0,0,1.0,1,1.0,1,1.0,1,0.2477652691521268,37
1623,2,2644,1321,1323,0,0,0,1.0,1,1.0,1,1.0,1,0.2803699868910688,37
1624,2,2646,1322,1324,0,0,0,1.0,1,1.0,1,1.0,1,0.27223583000335166,37
1625,0,2646,1322,1324,0,0,0,1.0,1,1.0,1,1.0,1,0.30071937791275666,35
1626,2,2648,1323,1325,0,0,0,1.0,1,1.0,1,1.0,1,0.3151170033942072,35
1627,0,2648,1323,1325,0,0,0,1.0,1,1.0,1,1.0,1,0.30114515995428476,34
1628,4,2652,1325,1327,0,0,0,1.0,1,1.0,1,1.0,1,0.30459270163542745,35
1629,3,2655,1328,1327,0,0,0,1.0,1,1.0,1,1.0,1,0.31864649020080055,34
1630,0,2655,1328,1327,0,0,0,1.0,1,1.0,1,1.0,1,0.29717158791300646,32
1631,2,2657,1328,1329,0,0,0,1.0,1,1.0,1,1.0,1,0.28781341410667427,33
1632,0,2657,1328,1329,0,0,0,1.0,1,1.0,1,1.0,1,0.2876615923064275,32
1633,0,2657,1328,1329,0,0,0,1.0,1,1.0,1,1.0,1,0.2807674179199429,31
1634,1,2658,1329,1329,0,0,0,1.0,1,1.0,1,1.0,1,0.3355233559249135,31
1635,0,2658,1329,1329,0,0,0,1.0,1,1.0,1,1.0,1,0.34378687375580963,31
1636,3,2661,1330,1331,0,0,0,1.0,1,1.0,1,1.0,1,0.3048566551023054,33
1637,1,2662,1330,1332,0,0,0,1.0,1,1.0,1,1.0,1,0.28932912699875046,33
1638,0,2662,1330,1332,0,0,0,1.0,1,1.0,1,1.0,1,0.30582487993101065,36
1639,0,2662,1330,1332,0,0,0,1.0,1,1.0,1,1.0,1,0.30582487993101065,36
1640,1,2663,1331,1332,0,0,0,1.0,1,1.0,1,1.0,1,0.3284805527565677,36
1641,2,2665,1332,1333,0,0,0,1.0,1,1.0,1,1.0,1,0.30230743641833524,38
1642,1,2666,1333,1333,0,0,0,1.0,1,1.0,1,1.0,1,0.2931008603694627,37
1643,2,2668,1335,1333,0,0,0,1.0,1,1.0,1,1.0,1,0.30769557897905425,37
1644,3,2671,1337,1334,0,0,0,1.0,1,1.0,1,1.0,1,0.37349022868278375,38
1645,1,2672,1337,1335,0,0,0,1.0,1,1.0,1,1.0,1,0.364362979464838,36
1646,0,2672,1337,1335,0,0,0,1.0,1,1.0,1,1.0,1,0.3757149336386259,37
1647,1,2673,1338,1335,0,0,0,1.0,1,1.0,1,1.0,1,0.44173176402005815,35
1648,6,2679,1338,1341,0,0,0,1.0,1,1.0,1,1.0,1,0.3420337849240096,38
1649,1,2680,1339,1341,0,0,0,1.0,1,1.0,1,1.0,1,0.35774677154684165,35
1650,0,2680,1339,1341,0,0,0,1.0,1,1.0,1,1.0,1,0.37126016255827443,34
1651,1,2681,1339,1342,0,0,0,1.0,1,1.0,1,1.0,1,0.3943225934972253,32
1652,2,2683,1339,1344,0,0,0,1.0,1,1.0,1,1.0,1,0.33102820454014925,33
1653,0,2683,1339,1344,0,0,0,1.0,1,1.0,1,1.0,1,0.33102820454014925,33
1654,0,2683,1339,1344,0,0,0,1.0,1,1.0,1,1.0,1,0.3471992302852611,34
1655,2,2685,1339,1346,0,0,0,1.0,1,1.0,1,1.0,1,0.26887670544243597,35
1656,1,2686,1339,1347,0,0,0,1.0,1,1.0,1,1.0,1,0.24341554016990202,35
1657,0,2686,1339,1347,0,0,0,1.0,1,1.0,1,1.0,1,0.2557362547587057,36
1658,2,2688,1341,1347,0,0,0,1.0,1,1.0,1,1.0,1,0.23023120034019728,36
1659,1,2689,1341,1348,0,0,0,1.0,1,1.0,1,1.0,1,0.18653104901567025,36
1660,5,2694,1345,1349,0,0,0,1.0,1,1.0,1,1.0,1,0.1876157162556418,38
1661,0,2694,1345,1349,0,0,0,1.0,1,1.0,1,1.0,1,0.1876157162556418,38
1662,3,2697,1348,1349,0,0,0,1.0,1,1.0,1,1.0,1,0.2266356315065829,39
1663,1,2698,1349,1349,0,0,0,1.0,1,1.0,1,1.0,1,0.2668340383115184,40
1664,2,2700,1349,1351,0,0,0,1.0,1,1.0,1,1.0,1,0.27020607353985243,39
1665,4,2704,1350,1354,0,0,0,1.0,1,1.0,1,1.0,1,0.2136672570159142,40
1666,0,2704,1350,1354,0,0,0,1.0,1,1.0,1,1.0,1,0.25109453100594453,40
1667,3,2707,1351,1356,0,0,0,1.0,1,1.0,1,1.0,1,0.23036280471529955,40
1668,3,2710,1353,1357,0,0,0,1.0,1,1.0,1,1.0,1,0.19078780047022123,41
1669,0,2710,1353,1357,0,0,0,1.0,1,1.0,1,1.0,1,0.1736864416256311,40
1670,2,2712,1355,1357,0,0,0,1.0,1,1.0,1,1.0,1,0.1879141525186686,40
1671,2,2714,1356,1358,0,0,0,1.0,1,1.0,1,1.0,1,0.18634109583463118,41
1672,1,2715,1357,1358,0,0,0,1.0,1,1.0,1,1.0,1,0.2329744616033065,40
1673,0,2715,1357,1358,0,0,0,1.0,1,1.0,1,1.0,1,0.22857963196011982,39
1674,2,2717,1357,1360,0,0,0,1.0,1,1.0,1,1.0,1,0.20670540943864782,40
1675,0,2717,1357,1360,0,0,0,1.0,1,1.0,1,1.0,1,0.21487652356319953,38
1676,1,2718,1358,1360,0,0,0,1.0,1,1.0,1,1.0,1,0.24186340453967675,39
1677,0,2718,1358,1360,0,0,0,1.0,1,1.0,1,1.0,1,0.2421481584332004,39
1678,0,2718,1358,1360,0,0,0,1.0,1,1.0,1,1.0,1,0.2421481584332004,39
1679,1,2719,1359,1360,0,0,0,1.0,1,1.0,1,1.0,1,0.2492257169116275,39
1680,4,2723,1360,1363,0,0,0,1.0,1,1.0,1,1.0,1,0.22695613448955548,41
1681,1,2724,1360,1364,0,0,0,1.0,1,1.0,1,1.0,1,0.19885030448982285,41
1682,3,2727,1361,1366,0,0,0,1.0,1,1.0,1,1.0,1,0.21859113619658954,43
1683,3,2730,1364,1366,0,0,0,1.0,1,1.0,1,1.0,1,0.23096083741461673,43
1684,1,2731,1365,1366,0,0,0,1.0,1,1.0,1,1.0,1,0.23648049481419506,42
1685,2,2733,1366,1367,0,0,0,1.0,1,1.0,1,1.0,1,0.2305091637934961,41
1686,5,2738,1368,1370,0,0,0,1.0,1,1.0,1,1.0,1,0.25148847972895355,41
1687,1,2739,1368,1371,0,0,0,1.0,1,1.0,1,1.0,1,0.21341391551564526,40
1688,2,2741,1370,1371,0,0,0,1.0,1,1.0,1,1.0,1,0.21811659452848953,39
1689,3,2744,1372,1372,0,0,0,1.0,1,1.0,1,1.0,1,0.23545653785545287,38
1690,1,2745,1373,1372,0,0,0,1.0,1,1.0,1,1.0,1,0.23624355249927195,38
1691,2,2747,1373,1374,0,0,0,1.0,1,1.0,1,1.0,1,0.23643926618254013,36
1692,0,2747,1373,1374,0,0,0,1.0,1,1.0,1,1.0,1,0.20162985697191357,36
1693,1,2748,1374,1374,0,0,0,1.0,1,1.0,1,1.0,1,0.21357283277028316,35
1694,1,2749,1375,1374,0,0,0,1.0,1,1.0,1,1.0,1,0.22766636307659063,33
1695,0,2749,1375,1374,0,0,0,1.0,1,1.0,1,1.0,1,0.24614857902754753,34
1696,1,2750,1376,1374,0,0,0,1.0,1,1.0,1,1.0,1,0.2941383638249252,35
1697,2,2752,1377,1375,0,0,0,1.0,1,1.0,1,1.0,1,0.2995026987289822,36
1698,4,2756,1379,1377,0,0,0,1.0,1,1.0,1,1.0,1,0.290075278340225,38
1699,2,2758,1380,1378,0,0,0,1.0,1,1.0,1,1.0,1,0.3016931970156521,38
1700,2,2760,1380,1380,0,0,0,1.0,1,1.0,1,1.0,1,0.28893263546610115,39
1701,1,2761,1380,1381,0,0,0,1.0,1,1.0,1,1.0,1,0.26539598216504323,40
1702,4,2765,1383,1382,0,0,0,1.0,1,1.0,1,1.0,1,0.33044082091882,41
1703,1,2766,1383,1383,0,0,0,1.0,1,1.0,1,1.0,1,0.3168384790554119,41
1704,4,2770,1385,1385,0,0,0,1.0,1,1.0,1,1.0,1,0.27902495695792523,41
1705,1,2771,1386,1385,0,0,0,1.0,1,1.0,1,1.0,1,0.2388694043147272,40
1706,0,2771,1386,1385,0,0,0,1.0,1,1.0,1,1.0,1,0.2388694043147272,40
1707,2,2773,1387,1386,0,0,0,1.0,1,1.0,1,1.0,1,0.2258878986423297,39
1708,0,2773,1387,1386,0,0,0,1.0,1,1.0,1,1.0,1,0.2258878986423297,39
1709,1,2774,1388,1386,0,0,0,1.0,1,1.0,1,1.0,1,0.24955789355468755,38
1710,5,2779,1392,1387,0,0,0,1.0,1,1.0,1,1.0,1,0.26615419670236157,39
1711,2,2781,1392,1389,0,0,0,1.0,1,1.0,1,1.0,1,0.24548838010772941,38
1712,3,2784,1394,1390,0,0,0,1.0,1,1.0,1,1.0,1,0.23829343645482315,38
1713,0,2784,1394,1390,0,0,0,1.0,1,1.0,1,1.0,1,0.23827842190459794,37
1714,0,2784,1394,1390,0,0,0,1.0,1,1.0,1,1.0,1,0.2537678267901404,38
1715,1,2785,1394,1391,0,0,0,1.0,1,1.0,1,1.0,1,0.2546290172209875,40
1716,0,2785,1394,1391,0,0,0,1.0,1,1.0,1,1.0,1,0.2557340346597594,39
1717,0,2785,1394,1391,0,0,0,1.0,1,1.0,1,1.0,1,0.2493424737402909,38
1718,3,2788,1394,1394,0,0,0,1.0,1,1.0,1,1.0,1,0.2377441137125734,38
1719,1,2789,1395,1394,0,0,0,1.0,1,1.0,1,1.0,1,0.25582891372340943,38
1720,0,2789,1395,1394,0,0,0,1.0,1,1.0,1,1.0,1,0.2586828413458392,41
1721,0,2789,1395,1394,0,0,0,1.0,1,1.0,1,1.0,1,0.2300718632247559,39
1722,1,2790,1396,1394,0,0,0,1.0,1,1.0,1,1.0,1,0.2564169752673769,40
1723,1,2791,1397,1394,0,0,0,1.0,1,1.0,1,1.0,1,0.2568613623856034,38
1724,1,2792,1398,1394,0,0,0,1.0,1,1.0,1,1.0,1,0.2966559396628252,37
1725,2,2794,1398,1396,0,0,0,1.0,1,1.0,1,1.0,1,0.24401260249284765,38
1726,2,2796,1399,1397,0,0,0,1.0,1,1.0,1,1.0,1,0.2774078907335195,37
1727,2,2798,1399,1399,0,0,0,1.0,1,1.0,1,1.0,1,0.21755042443024578,37
1728,0,2798,1399,1399,0,0,0,1.0,1,1.0,1,1.0,1,0.226561601740432,35
1729,1,2799,1400,1399,0,0,0,1.0,1,1.0,1,1.0,1,0.22786208140641487,37
1730,1,2800,1401,1399,0,0,0,1.0,1,1.0,1,1.0,1,0.3048390648537766,37
1731,2,2802,1402,1400,0,0,0,1.0,1,1.0,1,1.0,1,0.3095314106605002,37
1732,3,2805,1402,1403,0,0,0,1.0,1,1.0,1,1.0,1,0.2832983153140509,37
1733,2,2807,1404,1403,0,0,0,1.0,1,1.0,1,1.0,1,0.27819681830310916,36
1734,2,2809,1404,1405,0,0,0,1.0,1,1.0,1,1.0,1,0.25536699333880464,35
1735,1,2810,1405,1405,0,0,0,1.0,1,1.0,1,1.0,1,0.2458850585046129,34
1736,1,2811,1405,1406,0,0,0,1.0,1,1.0,1,1.0,1,0.23815722738567377,35
1737,2,2813,1407,1406,0,0,0,1.0,1,1.0,1,1.0,1,0.24393419418331172,36
1738,1,2814,1408,1406,0,0,0,1.0,1,1.0,1,1.0,1,0.3031146818448716,37
1739,2,2816,1409,1407,0,0,0,1.0,1,1.0,1,1.0,1,0.2660559084248177,38
1740,2,2818,1409,1409,0,0,0,1.0,1,1.0,1,1.0,1,0.23723014963662906,37
1741,1,2819,1409,1410,0,0,0,1.0,1,1.0,1,1.0,1,0.2492343807362185,38
1742,3,2822,1411,1411,0,0,0,1.0,1,1.0,1,1.0,1,0.2825132219957103,39
1743,2,2824,1412,1412,0,0,0,1.0,1,1.0,1,1.0,1,0.2780109470436426,37
1744,6,2830,1416,1414,0,0,0,1.0,1,1.0,1,1.0,1,0.3045019124760218,38
1745,2,2832,1416,1416,0,0,0,1.0,1,1.0,1,1.0,1,0.2661651497648508,37
1746,1,2833,1416,1417,0,0,0,1.0,1,1.0,1,1.0,1,0.23905689521284515,38
1747,3,2836,1417,1419,0,0,0,1.0,1,1.0,1,1.0,1,0.22990286442877594,38
1748,2,2838,1418,1420,0,0,0,1.0,1,1.0,1,1.0,1,0.23776845606434482,38
1749,1,2839,1418,1421,0,0,0,1.0,1,1.0,1,1.0,1,0.2015237508729681,37
1750,2,2841,1418,1423,0,0,0,1.0,1,1.0,1,1.0,1,0.19395576792996835,39
1751,0,2841,1418,1423,0,0,0,1.0,1,1.0,1,1.0,1,0.20105781445123058,38
1752,1,2842,1419,1423,0,0,0,1.0,1,1.0,1,1.0,1,0.17737898875472669,39
1753,0,2842,1419,1423,0,0,0,1.0,1,1.0,1,1.0,1,0.18020342248671348,40
1754,2,2844,1420,1424,0,0,0,1.0,1,1.0,1,1.0,1,0.22349671596677675,41
1755,2,2846,1420,1426,0,0,0,1.0,1,1.0,1,1.0,1,0.18889981091341754,41
1756,1,2847,1421,1426,0,0,0,1.0,1,1.0,1,1.0,1,0.2185431572738339,42
1757,2,2849,1421,1428,0,0,0,1.0,1,1.0,1,1.0,1,0.19979106551716,42
1758,1,2850,1422,1428,0,0,0,1.0,1,1.0,1,1.0,1,0.21842007415506662,42
1759,0,2850,1422,1428,0,0,0,1.0,1,1.0,1,1.0,1,0.24012612065837177,39
1760,1,2851,1423,1428,0,0,0,1.0,1,1.0,1,1.0,1,0.31040006162355654,39
1761,6,2857,1425,1432,0,0,0,1.0,1,1.0,1,1.0,1,0.23951332280340243,38
1762,0,2857,1425,1432,0,0,0,1.0,1,1.0,1,1.0,1,0.2374852844241285,37
1763,1,2858,1426,1432,0,0,0,1.0,1,1.0,1,1.0,1,0.26431266500740114,37
1764,1,2859,1427,1432,0,0,0,1.0,1,1.0,1,1.0,1,0.23225459444603241,36
1765,3,2862,1429,1433,0,0,0,1.0,1,1.0,1,1.0,1,0.2044975612347389,37
1766,2,2864,1429,1435,0,0,0,1.0,1,1.0,1,1.0,1,0.1578873159070693,36
1767,1,2865,1430,1435,0,0,0,1.0,1,1.0,1,1.0,1,0.18611795789341543,36
1768,0,2865,1430,1435,0,0,0,1.0,1,1.0,1,1.0,1,0.18611795789341543,36
1769,2,2867,1431,1436,0,0,0,1.0,1,1.0,1,1.0,1,0.1676785975266925,38
1770,2,2869,1432,1437,0,0,0,1.0,1,1.0,1,1.0,1,0.1744076030018743,38
1771,0,2869,1432,1437,0,0,0,1.0,1,1.0,1,1.0,1,0.1744076030018743,38
1772,1,2870,1433,1437,0,0,0,1.0,1,1.0,1,1.0,1,0.1742155988280266,40
1773,1,2871,1434,1437,0,0,0,1.0,1,1.0,1,1.0,1,0.21086172239485254,40
1774,1,2872,1434,1438,0,0,0,1.0,1,1.0,1,1.0,1,0.18283355915456057,40
1775,1,2873,1434,1439,0,0,0,1.0,1,1.0,1,1.0,1,0.1815490590537014,41
1776,1,2874,1435,1439,0,0,0,1.0,1,1.0,1,1.0,1,0.18222541694169012,43
1777,0,2874,1435,1439,0,0,0,1.0,1,1.0,1,1.0,1,0.19269997407216485,44
1778,2,2876,1437,1439,0,0,0,1.0,1,1.0,1,1.0,1,0.24240084738576353,44
1779,1,2877,1437,1440,0,0,0,1.0,1,1.0,1,1.0,1,0.21664290627012936,44
1780,2,2879,1438,1441,0,0,0,1.0,1,1.0,1,1.0,1,0.22460446142361495,46
1781,3,2882,1439,1443,0,0,0,1.0,1,1.0,1,1.0,1,0.1859763807070692,46
1782,3,2885,1441,1444,0,0,0,1.0,1,1.0,1,1.0,1,0.22446055495300618,45
1783,0,2885,1441,1444,0,0,0,1.0,1,1.0,1,1.0,1,0.21754355669170036,44
1784,1,2886,1442,1444,0,0,0,1.0,1,1.0,1,1.0,1,0.2508981492042927,44
1785,3,2889,1444,1445,0,0,0,1.0,1,1.0,1,1.0,1,0.23441308697287294,42
1786,2,2891,1445,1446,0,0,0,1.0,1,1.0,1,1.0,1,0.2455154806084914,42
1787,1,2892,1445,1447,0,0,0,1.0,1,1.0,1,1.0,1,0.23390512629051047,41
1788,4,2896,1447,1449,0,0,0,1.0,1,1.0,1,1.0,1,0.21478789902085743,41
1789,2,2898,1449,1449,0,0,0,1.0,1,1.0,1,1.0,1,0.22207803921082186,41
1790,2,2900,1451,1449,0,0,0,1.0,1,1.0,1,1.0,1,0.2733700881476798,41
1791,3,2903,1453,1450,0,0,0,1.0,1,1.0,1,1.0,1,0.2580078048517074,41
1792,2,2905,1454,1451,0,0,0,1.0,1,1.0,1,1.0,1,0.21545790588307112,43
1793,2,2907,1455,1452,0,0,0,1.0,1,1.0,1,1.0,1,0.15753052828788575,43
1794,2,2909,1457,1452,0,0,0,1.0,1,1.0,1,1.0,1,0.17701673539185891,41
1795,3,2912,1459,1453,0,0,0,1.0,1,1.0,1,1.0,1,0.22522227135620673,41
1796,3,2915,1460,1455,0,0,0,1.0,1,1.0,1,1.0,1,0.22713203764122003,40
1797,3,2918,1461,1457,0,0,0,1.0,1,1.0,1,1.0,1,0.2441769200625704,38
1798,0,2918,1461,1457,0,0,0,1.0,1,1.0,1,1.0,1,0.2441769200625704,38
1799,1,2919,1462,1457,0,0,0,1.0,1,1.0,1,1.0,1,0.26963847133147445,37
1800,2,2921,1463,1458,0,0,0,1.0,1,1.0,1,1.0,1,0.28509219370794764,35
1801,0,2921,1463,1458,0,0,0,1.0,1,1.0,1,1.0,1,0.28031610106024185,34
1802,0,2921,1463,1458,0,0,0,1.0,1,1.0,1,1.0,1,0.27599293445874123,33
1803,3,2924,1465,1459,0,0,0,1.0,1,1.0,1,1.0,1,0.2753561641720172,33
1804,1,2925,1466,1459,0,0,0,1.0,1,1.0,1,1.0,1,0.2848370913286731,33
1805,1,2926,1466,1460,0,0,0,1.0,1,1.0,1,1.0,1,0.2657148698342756,35
1806,1,2927,1466,1461,0,0,0,1.0,1,1.0,1,1.0,1,0.2323748979192406,36
1807,0,2927,1466,1461,0,0,0,1.0,1,1.0,1,1.0,1,0.2551424343252093,35
1808,2,2929,1467,1462,0,0,0,1.0,1,1.0,1,1.0,1,0.2841520217106378,37
1809,3,2932,1467,1465,0,0,0,1.0,1,1.0,1,1.0,1,0.2812227061223314,35
1810,1,2933,1468,1465,0,0,0,1.0,1,1.0,1,1.0,1,0.2761332856467812,36
1811,0,2933,1468,1465,0,0,0,1.0,1,1.0,1,1.0,1,0.2777909784044898,34
1812,0,2933,1468,1465,0,0,0,1.0,1,1.0,1,1.0,1,0.29786834881957547,36
1813,1,2934,1468,1466,0,0,0,1.0,1,1.0,1,1.0,1,0.30593566851243986,35
1814,1,2935,1468,1467,0,0,0,1.0,1,1.0,1,1.0,1,0.30815300238057697,36
1815,1,2936,1468,1468,0,0,0,1.0,1,1.0,1,1.0,1,0.28935556090113146,35
1816,1,2937,1469,1468,0,0,0,1.0,1,1.0,1,1.0,1,0.2758713512231771,35
1817,1,2938,1470,1468,0,0,0,1.0,1,1.0,1,1.0,1,0.26614552790072216,35
1818,3,2941,1473,1468,0,0,0,1.0,1,1.0,1,1.0,1,0.22890192278425003,36
1819,2,2943,1475,1468,0,0,0,1.0,1,1.0,1,1.0,1,0.22712500105125102,37
1820,2,2945,1475,1470,0,0,0,1.0,1,1.0,1,1.0,1,0.17083736448989992,37
1821,0,2945,1475,1470,0,0,0,1.0,1,1.0,1,1.0,1,0.17358491915031962,38
1822,6,2951,1479,1472,0,0,0,1.0,1,1.0,1,1.0,1,0.26294318296888897,37
1823,3,2954,1481,1473,0,0,0,1.0,1,1.0,1,1.0,1,0.2747968238737458,36
1824,1,2955,1482,1473,0,0,0,1.0,1,1.0,1,1.0,1,0.2568083690600625,36
1825,1,2956,1483,1473,0,0,0,1.0,1,1.0,1,1.0,1,0.2603939057965016,34
1826,3,2959,1485,1474,0,0,0,1.0,1,1.0,1,1.0,1,0.20959567718034725,35
1827,2,2961,1486,1475,0,0,0,1.0,1,1.0,1,1.0,1,0.20550636011726306,34
1828,2,2963,1488,1475,0,0,0,1.0,1,1.0,1,1.0,1,0.2146576665007515,33
1829,1,2964,1489,1475,0,0,0,1.0,1,1.0,1,1.0,1,0.20467387714908244,31
1830,0,2964,1489,1475,0,0,0,1.0,1,1.0,1,1.0,1,0.202705745494958,31
1831,1,2965,1490,1475,0,0,0,1.0,1,1.0,1,1.0,1,0.20062126886041878,30
1832,0,2965,1490,1475,0,0,0,1.0,1,1.0,1,1.0,1,0.19537599788861895,29
1833,4,2969,1494,1475,0,0,0,1.0,1,1.0,1,1.0,1,0.36296269617137056,28
1834,4,2973,1495,1478,0,0,0,1.0,1,1.0,1,1.0,1,0.3296071887160322,27
1835,4,2977,1498,1479,0,0,0,1.0,1,1.0,1,1.0,1,0.36654094967431755,26
1836,1,2978,1498,1480,0,0,0,1.0,1,1.0,1,1.0,1,0.39352493900911806,26
1837,4,2982,1498,1484,0,0,0,1.0,1,1.0,1,1.0,1,0.27088758659792633,25
1838,0,2982,1498,1484,0,0,0,1.0,1,1.0,1,1.0,1,0.2558020581543583,25
1839,0,2982,1498,1484,0,0,0,1.0,1,1.0,1,1.0,1,0.30869606761076895,24
1840,2,2984,1499,1485,0,0,0,1.0,1,1.0,1,1.0,1,0.40005960973325455,23
1841,2,2986,1499,1487,0,0,0,1.0,1,1.0,1,1.0,1,0.3136384499938786,22
1842,1,2987,1500,1487,0,0,0,1.0,1,1.0,1,1.0,1,0.35341290700056954,23
1843,1,2988,1501,1487,0,0,0,1.0,1,1.0,1,1.0,1,0.3464897183495339,23
1844,0,2988,1501,1487,0,0,0,1.0,1,1.0,1,1.0,1,0.3464897183495339,23
1845,2,2990,1503,1487,0,0,0,1.0,1,1.0,1,1.0,1,0.37243568803474825,23
1846,1,2991,1503,1488,0,0,0,1.0,1,1.0,1,1.0,1,0.33900341339897777,23
1847,0,2991,1503,1488,0,0,0,1.0,1,1.0,1,1.0,1,0.35790425506423745,24
1848,0,2991,1503,1488,0,0,0,1.0,1,1.0,1,1.0,1,0.35790425506423745,24
1849,0,2991,1503,1488,0,0,0,1.0,1,1.0,1,1.0,1,0.38054900102824496,25
1850,0,2991,1503,1488,0,0,0,1.0,1,1.0,1,1.0,1,0.38054900102824496,25
1851,0,2991,1503,1488,0,0,0,1.0,1,1.0,1,1.0,1,0.38054900102824496,25
1852,0,2991,1503,1488,0,0,0,1.0,1,1.0,1,1.0,1,0.38054900102824496,25
1853,0,2991,1503,1488,0,0,0,1.0,1,1.0,1,1.0,1,0.39902546624291885,25
1854,0,2991,1503,1488,0,0,0,1.0,1,1.0,1,1.0,1,0.39902546624291885,25
1855,0,2991,1503,1488,0,0,0,1.0,1,1.0,1,1.0,1,0.4089036257469483,26
1856,1,2992,1504,1488,0,0,0,1.0,1,1.0,1,1.0,1,0.3637831957281073,27
1857,0,2992,1504,1488,0,0,0,1.0,1,1.0,1,1.0,1,0.35104897455893835,28
1858,3,2995,1506,1489,0,0,0,1.0,1,1.0,1,1.0,1,0.3515005231654228,28
1859,4,2999,1508,1491,0,0,0,1.0,1,1.0,1,1.0,1,0.35440056647733276,28
1860,0,2999,1508,1491,0,0,0,1.0,1,1.0,1,1.0,1,0.35440056647733276,28
1861,0,2999,1508,1491,0,0,0,1.0,1,1.0,1,1.0,1,0.35440056647733276,28
1862,0,2999,1508,1491,0,0,0,1.0,1,1.0,1,1.0,1,0.35440056647733276,28
1863,1,3000,1509,1491,0,0,0,1.0,1,1.0,1,1.0,1,0.36803473253223995,29
1864,1,3001,1510,1491,0,0,0,1.0,1,1.0,1,1.0,1,0.3531512507381367,27
1865,2,3003,1511,1492,0,0,0,1.0,1,1.0,1,1.0,1,0.37502517459654533,26
1866,1,3004,1512,1492,0,0,0,1.0,1,1.0,1,1.0,1,0.41313886091495,26
1867,0,3004,1512,1492,0,0,0,1.0,1,1.0,1,1.0,1,0.41313886091495,26
1868,1,3005,1512,1493,0,0,0,1.0,1,1.0,1,1.0,1,0.36815733451802707,26
1869,1,3006,1512,1494,0,0,0,1.0,1,1.0,1,1.0,1,0.35033592699571253,26
1870,0,3006,1512,1494,0,0,0,1.0,1,1.0,1,1.0,1,0.3687377437403143,27
1871,1,3007,1513,1494,0,0,0,1.0,1,1.0,1,1.0,1,0.37556504226147125,27
1872,0,3007,1513,1494,0,0,0,1.0,1,1.0,1,1.0,1,0.3672861916843798,25
1873,1,3008,1513,1495,0,0,0,1.0,1,1.0,1,1.0,1,0.30800384151605875,25
1874,1,3009,1513,1496,0,0,0,1.0,1,1.0,1,1.0,1,0.3500562651497415,25
1875,1,3010,1513,1497,0,0,0,1.0,1,1.0,1,1.0,1,0.3092610922416167,25
1876,0,3010,1513,1497,0,0,0,1.0,1,1.0,1,1.0,1,0.3075186871229535,26
1877,0,3010,1513,1497,0,0,0,1.0,1,1.0,1,1.0,1,0.29464334228221745,27
1878,2,3012,1515,1497,0,0,0,1.0,1,1.0,1,1.0,1,0.31283517752731305,28
1879,1,3013,1515,1498,0,0,0,1.0,1,1.0,1,1.0,1,0.267604419794186,29
1880,0,3013,1515,1498,0,0,0,1.0,1,1.0,1,1.0,1,0.267604419794186,29
1881,0,3013,1515,1498,0,0,0,1.0,1,1.0,1,1.0,1,0.267604419794186,29
1882,0,3013,1515,1498,0,0,0,1.0,1,1.0,1,1.0,1,0.2583701068063382,28
1883,0,3013,1515,1498,0,0,0,1.0,1,1.0,1,1.0,1,0.2583701068063382,28
1884,1,3014,1516,1498,0,0,0,1.0,1,1.0,1,1.0,1,0.2656406769855585,28
1885,0,3014,1516,1498,0,0,0,1.0,1,1.0,1,1.0,1,0.2656406769855585,28
1886,0,3014,1516,1498,0,0,0,1.0,1,1.0,1,1.0,1,0.26156730160845654,29
1887,0,3014,1516,1498,0,0,0,1.0,1,1.0,1,1.0,1,0.26156730160845654,29
1888,0,3014,1516,1498,0,0,0,1.0,1,1.0,1,1.0,1,0.29464883511569223,31
1889,0,3014,1516,1498,0,0,0,1.0,1,1.0,1,1.0,1,0.29464883511569223,31
1890,1,3015,1517,1498,0,0,0,1.0,1,1.0,1,1.0,1,0.3105480726516754,31
1891,1,3016,1517,1499,0,0,0,1.0,1,1.0,1,1.0,1,0.3153418130634153,32
1892,0,3016,1517,1499,0,0,0,1.0,1,1.0,1,1.0,1,0.3153418130634153,32
1893,0,3016,1517,1499,0,0,0,1.0,1,1.0,1,1.0,1,0.3153418130634153,32
1894,0,3016,1517,1499,0,0,0,1.0,1,1.0,1,1.0,1,0.3054088235966136,33
1895,2,3018,1518,1500,0,0,0,1.0,1,1.0,1,1.0,1,0.2840644516929702,35
1896,0,3018,1518,1500,0,0,0,1.0,1,1.0,1,1.0,1,0.3115357027990656,34
1897,1,3019,1518,1501,0,0,0,1.0,1,1.0,1,1.0,1,0.29374093203850227,34
1898,0,3019,1518,1501,0,0,0,1.0,1,1.0,1,1.0,1,0.29374093203850227,34
1899,1,3020,1518,1502,0,0,0,1.0,1,1.0,1,1.0,1,0.2840295974889091,34
1900,2,3022,1518,1504,0,0,0,1.0,1,1.0,1,1.0,1,0.23164947543415831,35
1901,1,3023,1518,1505,0,0,0,1.0,1,1.0,1,1.0,1,0.2012980956229387,35
1902,0,3023,1518,1505,0,0,0,1.0,1,1.0,1,1.0,1,0.2012980956229387,35
1903,0,3023,1518,1505,0,0,0,1.0,1,1.0,1,1.0,1,0.2012980956229387,35
1904,0,3023,1518,1505,0,0,0,1.0,1,1.0,1,1.0,1,0.2012980956229387,35
1905,0,3023,1518,1505,0,0,0,1.0,1,1.0,1,1.0,1,0.19050384277875032,37
1906,0,3023,1518,1505,0,0,0,1.0,1,1.0,1,1.0,1,0.19050384277875032,37
1907,1,3024,1518,1506,0,0,0,1.0,1,1.0,1,1.0,1,0.1729542703858144,39
1908,0,3024,1518,1506,0,0,0,1.0,1,1.0,1,1.0,1,0.1729542703858144,39
1909,0,3024,1518,1506,0,0,0,1.0,1,1.0,1,1.0,1,0.18988328493080348,41
1910,0,3024,1518,1506,0,0,0,1.0,1,1.0,1,1.0,1,0.18988328493080348,41
1911,0,3024,1518,1506,0,0,0,1.0,1,1.0,1,1.0,1,0.22491270180122244,40
1912,3,3027,1521,1506,0,0,0,1.0,1,1.0,1,1.0,1,0.25969065801239355,39
1913,4,3031,1523,1508,0,0,0,1.0,1,1.0,1,1.0,1,0.25271041639205916,40
1914,1,3032,1524,1508,0,0,0,1.0,1,1.0,1,1.0,1,0.26042552633258303,41
1915,5,3037,1526,1511,0,0,0,1.0,1,1.0,1,1.0,1,0.24238531664175417,42
1916,2,3039,1527,1512,0,0,0,1.0,1,1.0,1,1.0,1,0.21367670004060593,42
1917,1,3040,1528,1512,0,0,0,1.0,1,1.0,1,1.0,1,0.2288695754442143,41
1918,2,3042,1530,1512,0,0,0,1.0,1,1.0,1,1.0,1,0.2314332706907394,38
1919,2,3044,1531,1513,0,0,0,1.0,1,1.0,1,1.0,1,0.27142932288442234,38
1920,0,3044,1531,1513,0,0,0,1.0,1,1.0,1,1.0,1,0.2947066668543989,38
1921,1,3045,1531,1514,0,0,0,1.0,1,1.0,1,1.0,1,0.24323673778246288,39
1922,0,3045,1531,1514,0,0,0,1.0,1,1.0,1,1.0,1,0.2343611698767209,40
1923,1,3046,1532,1514,0,0,0,1.0,1,1.0,1,1.0,1,0.22254124213989218,41
1924,4,3050,1535,1515,0,0,0,1.0,1,1.0,1,1.0,1,0.2850418711070648,41
1925,2,3052,1535,1517,0,0,0,1.0,1,1.0,1,1.0,1,0.20568371606877556,41
1926,0,3052,1535,1517,0,0,0,1.0,1,1.0,1,1.0,1,0.20568371606877556,41
1927,1,3053,1535,1518,0,0,0,1.0,1,1.0,1,1.0,1,0.19970512463469164,41
1928,2,3055,1537,1518,0,0,0,1.0,1,1.0,1,1.0,1,0.20103068866051538,42
1929,0,3055,1537,1518,0,0,0,1.0,1,1.0,1,1.0,1,0.2058288393965291,41
1930,0,3055,1537,1518,0,0,0,1.0,1,1.0,1,1.0,1,0.2058288393965291,41
1931,0,3055,1537,1518,0,0,0,1.0,1,1.0,1,1.0,1,0.2058288393965291,41
1932,0,3055,1537,1518,0,0,0,1.0,1,1.0,1,1.0,1,0.2058288393965291,41
1933,1,3056,1538,1518,0,0,0,1.0,1,1.0,1,1.0,1,0.2523198415070414,43
1934,0,3056,1538,1518,0,0,0,1.0,1,1.0,1,1.0,1,0.2617190022167601,44
1935,0,3056,1538,1518,0,0,0,1.0,1,1.0,1,1.0,1,0.24637046952226851,45
1936,2,3058,1538,1520,0,0,0,1.0,1,1.0,1,1.0,1,0.20288817128460424,48
1937,3,3061,1540,1521,0,0,0,1.0,1,1.0,1,1.0,1,0.21017075599660565,48
1938,1,3062,1541,1521,0,0,0,1.0,1,1.0,1,1.0,1,0.2140163373350501,48
1939,0,3062,1541,1521,0,0,0,1.0,1,1.0,1,1.0,1,0.2140163373350501,48
1940,0,3062,1541,1521,0,0,0,1.0,1,1.0,1,1.0,1,0.2140163373350501,48
1941,0,3062,1541,1521,0,0,0,1.0,1,1.0,1,1.0,1,0.2140163373350501,48
1942,3,3065,1542,1523,0,0,0,1.0,1,1.0,1,1.0,1,0.2405756832577917,49
1943,0,3065,1542,1523,0,0,0,1.0,1,1.0,1,1.0,1,0.23653122676092894,48
1944,4,3069,1545,1524,0,0,0,1.0,1,1.0,1,1.0,1,0.2811724728701725,47
1945,5,3074,1546,1528,0,0,0,1.0,1,1.0,1,1.0,1,0.24722579366419212,46
1946,3,3077,1547,1530,0,0,0,1.0,1,1.0,1,1.0,1,0.2664124116385519,46
1947,5,3082,1550,1532,0,0,0,1.0,1,1.0,1,1.0,1,0.32803672890825186,45
1948,2,3084,1550,1534,0,0,0,1.0,1,1.0,1,1.0,1,0.2726481632270775,46
1949,2,3086,1551,1535,0,0,0,1.0,1,1.0,1,1.0,1,0.2905505835583212,42
1950,0,3086,1551,1535,0,0,0,1.0,1,1.0,1,1.0,1,0.28731711694393275,40
1951,3,3089,1552,1537,0,0,0,1.0,1,1.0,1,1.0,1,0.3291430782147595,39
1952,1,3090,1553,1537,0,0,0,1.0,1,1.0,1,1.0,1,0.3670824243319237,35
1953,6,3096,1556,1540,0,0,0,1.0,1,1.0,1,1.0,1,0.3103150490073697,36
1954,1,3097,1557,1540,0,0,0,1.0,1,1.0,1,1.0,1,0.3294214486880281,34
1955,1,3098,1557,1541,0,0,0,1.0,1,1.0,1,1.0,1,0.3260554378275148,35
1956,7,3105,1559,1546,0,0,0,1.0,1,1.0,1,1.0,1,0.25148643416217753,37
1957,1,3106,1559,1547,0,0,0,1.0,1,1.0,1,1.0,1,0.23423364543922076,37
1958,0,3106,1559,1547,0,0,0,1.0,1,1.0,1,1.0,1,0.23129181160563675,39
1959,0,3106,1559,1547,0,0,0,1.0,1,1.0,1,1.0,1,0.2453099380947924,41
1960,1,3107,1560,1547,0,0,0,1.0,1,1.0,1,1.0,1,0.25022395297883426,40
1961,1,3108,1560,1548,0,0,0,1.0,1,1.0,1,1.0,1,0.22957709443284438,41
1962,1,3109,1561,1548,0,0,0,1.0,1,1.0,1,1.0,1,0.28605838476313705,40
1963,2,3111,1561,1550,0,0,0,1.0,1,1.0,1,1.0,1,0.2805159787011414,41
1964,1,3112,1562,1550,0,0,0,1.0,1,1.0,1,1.0,1,0.291063766623272,40
1965,1,3113,1562,1551,0,0,0,1.0,1,1.0,1,1.0,1,0.2636316834949484,41
1966,0,3113,1562,1551,0,0,0,1.0,1,1.0,1,1.0,1,0.2636316834949484,41
1967,1,3114,1563,1551,0,0,0,1.0,1,1.0,1,1.0,1,0.2948101160965443,42
1968,1,3115,1563,1552,0,0,0,1.0,1,1.0,1,1.0,1,0.29159438013963607,42
1969,2,3117,1563,1554,0,0,0,1.0,1,1.0,1,1.0,1,0.2352320948498728,43
1970,0,3117,1563,1554,0,0,0,1.0,1,1.0,1,1.0,1,0.25649786485682785,42
1971,0,3117,1563,1554,0,0,0,1.0,1,1.0,1,1.0,1,0.25649786485682785,42
1972,0,3117,1563,1554,0,0,0,1.0,1,1.0,1,1.0,1,0.25649786485682785,42
1973,1,3118,1563,1555,0,0,0,1.0,1,1.0,1,1.0,1,0.25361959046373017,43
1974,1,3119,1564,1555,0,0,0,1.0,1,1.0,1,1.0,1,0.28286617052921104,43
1975,2,3121,1564,1557,0,0,0,1.0,1,1.0,1,1.0,1,0.2588095059976675,43
1976,1,3122,1565,1557,0,0,0,1.0,1,1.0,1,1.0,1,0.24907928423174888,43
1977,2,3124,1565,1559,0,0,0,1.0,1,1.0,1,1.0,1,0.2693631103168086,48
1978,4,3128,1568,1560,0,0,0,1.0,1,1.0,1,1.0,1,0.28245179992106756,48
1979,2,3130,1568,1562,0,0,0,1.0,1,1.0,1,1.0,1,0.2654733070556008,49
1980,2,3132,1568,1564,0,0,0,1.0,1,1.0,1,1.0,1,0.24568992409534463,50
1981,1,3133,1568,1565,0,0,0,1.0,1,1.0,1,1.0,1,0.23427214630585183,50
1982,2,3135,1570,1565,0,0,0,1.0,1,1.0,1,1.0,1,0.21788706893703894,50
1983,4,3139,1572,1567,0,0,0,1.0,1,1.0,1,1.0,1,0.18369019652602642,49
1984,2,3141,1574,1567,0,0,0,1.0,1,1.0,1,1.0,1,0.22717136626217102,48
1985,0,3141,1574,1567,0,0,0,1.0,1,1.0,1,1.0,1,0.2068112020024018,46
1986,1,3142,1574,1568,0,0,0,1.0,1,1.0,1,1.0,1,0.19661281755041515,46
1987,3,3145,1576,1569,0,0,0,1.0,1,1.0,1,1.0,1,0.2175411819131207,42
1988,1,3146,1576,1570,0,0,0,1.0,1,1.0,1,1.0,1,0.17542854599507943,40
1989,2,3148,1578,1570,0,0,0,1.0,1,1.0,1,1.0,1,0.185073172694822,38
1990,0,3148,1578,1570,0,0,0,1.0,1,1.0,1,1.0,1,0.16959603866116202,38
1991,2,3150,1580,1570,0,0,0,1.0,1,1.0,1,1.0,1,0.23921897990696597,38
1992,0,3150,1580,1570,0,0,0,1.0,1,1.0,1,1.0,1,0.2569002985556007,39
1993,3,3153,1582,1571,0,0,0,1.0,1,1.0,1,1.0,1,0.34495828590895794,38
1994,2,3155,1583,1572,0,0,0,1.0,1,1.0,1,1.0,1,0.30741344115666996,37
1995,3,3158,1584,1574,0,0,0,1.0,1,1.0,1,1.0,1,0.279770210286522,37
1996,1,3159,1584,1575,0,0,0,1.0,1,1.0,1,1.0,1,0.25478916959976805,37
1997,1,3160,1584,1576,0,0,0,1.0,1,1.0,1,1.0,1,0.2613569768860774,35
1998,1,3161,1585,1576,0,0,0,1.0,1,1.0,1,1.0,1,0.29362549325289206,34
1999,1,3162,1586,1576,0,0,0,1.0,1,1.0,1,1.0,1,0.2712629667581868,35
2000,0,3162,1586,1576,0,0,0,1.0,1,1.0,1,1.0,1,0.29734537440455383,34
2001,0,3162,1586,1576,0,0,0,1.0,1,1.0,1,1.0,1,0.32187214617696647,35
2002,3,3165,1587,1578,0,0,0,1.0,1,1.0,1,1.0,1,0.2922976066231962,36
2003,2,3167,1587,1580,0,0,0,1.0,1,1.0,1,1.0,1,0.27908505436285497,37
2004,3,3170,1589,1581,0,0,0,1.0,1,1.0,1,1.0,1,0.27021801404415013,38
2005,1,3171,1590,1581,0,0,0,1.0,1,1.0,1,1.0,1,0.26089744791405284,38
2006,0,3171,1590,1581,0,0,0,1.0,1,1.0,1,1.0,1,0.26089744791405284,38
2007,2,3173,1591,1582,0,0,0,1.0,1,1.0,1,1.0,1,0.23351942710270157,40
2008,1,3174,1592,1582,0,0,0,1.0,1,1.0,1,1.0,1,0.22162100779628385,40
2009,3,3177,1594,1583,0,0,0,1.0,1,1.0,1,1.0,1,0.2099735609420969,41
2010,0,3177,1594,1583,0,0,0,1.0,1,1.0,1,1.0,1,0.2099735609420969,41
2011,0,3177,1594,1583,0,0,0,1.0,1,1.0,1,1.0,1,0.2099735609420969,41
2012,0,3177,1594,1583,0,0,0,1.0,1,1.0,1,1.0,1,0.2099735609420969,41
2013,0,3177,1594,1583,0,0,0,1.0,1,1.0,1,1.0,1,0.2338256423600573,43
2014,0,3177,1594,1583,0,0,0,1.0,1,1.0,1,1.0,1,0.2538515531447229,43
2015,1,3178,1595,1583,0,0,0,1.0,1,1.0,1,1.0,1,0.24682694490908602,43
2016,3,3181,1596,1585,0,0,0,1.0,1,1.0,1,1.0,1,0.23951783827563344,44
2017,0,3181,1596,1585,0,0,0,1.0,1,1.0,1,1.0,1,0.239093284873659,45
2018,3,3184,1599,1585,0,0,0,1.0,1,1.0,1,1.0,1,0.22319331890058747,46
2019,0,3184,1599,1585,0,0,0,1.0,1,1.0,1,1.0,1,0.21171735094126634,47
2020,1,3185,1599,1586,0,0,0,1.0,1,1.0,1,1.0,1,0.17457283021537817,47
2021,3,3188,1601,1587,0,0,0,1.0,1,1.0,1,1.0,1,0.17842623786228284,47
2022,2,3190,1602,1588,0,0,0,1.0,1,1.0,1,1.0,1,0.19257448459757762,48
2023,4,3194,1604,1590,0,0,0,1.0,1,1.0,1,1.0,1,0.20416703234463127,48
2024,3,3197,1607,1590,0,0,0,1.0,1,1.0,1,1.0,1,0.20110707781128007,45
2025,2,3199,1609,1590,0,0,0,1.0,1,1.0,1,1.0,1,0.2300411350852427,42
2026,4,3203,1612,1591,0,0,0,1.0,1,1.0,1,1.0,1,0.23686963122572696,44
2027,2,3205,1613,1592,0,0,0,1.0,1,1.0,1,1.0,1,0.2344308886714785,40
2028,2,3207,1614,1593,0,0,0,1.0,1,1.0,1,1.0,1,0.2843872813239467,39
2029,0,3207,1614,1593,0,0,0,1.0,1,1.0,1,1.0,1,0.31017646411928,37
2030,2,3209,1615,1594,0,0,0,1.0,1,1.0,1,1.0,1,0.3477760373169717,34
2031,2,3211,1615,1596,0,0,0,1.0,1,1.0,1,1.0,1,0.30060829234350056,35
2032,2,3213,1616,1597,0,0,0,1.0,1,1.0,1,1.0,1,0.28046710966591387,34
2033,5,3218,1618,1600,0,0,0,1.0,1,1.0,1,1.0,1,0.24635660185379285,36
2034,1,3219,1619,1600,0,0,0,1.0,1,1.0,1,1.0,1,0.28991360233218094,34
2035,4,3223,1620,1603,0,0,0,1.0,1,1.0,1,1.0,1,0.24343692048265636,35
2036,1,3224,1621,1603,0,0,0,1.0,1,1.0,1,1.0,1,0.24541582836176573,34
2037,1,3225,1621,1604,0,0,0,1.0,1,1.0,1,1.0,1,0.2271734780847113,35
2038,0,3225,1621,1604,0,0,0,1.0,1,1.0,1,1.0,1,0.21944118257670675,36
2039,1,3226,1622,1604,0,0,0,1.0,1,1.0,1,1.0,1,0.22861600109269942,38
2040,0,3226,1622,1604,0,0,0,1.0,1,1.0,1,1.0,1,0.22861600109269942,38
2041,0,3226,1622,1604,0,0,0,1.0,1,1.0,1,1.0,1,0.225801429319923,39
2042,0,3226,1622,1604,0,0,0,1.0,1,1.0,1,1.0,1,0.225801429319923,39
2043,1,3227,1622,1605,0,0,0,1.0,1,1.0,1,1.0,1,0.18287613509393472,39
2044,0,3227,1622,1605,0,0,0,1.0,1,1.0,1,1.0,1,0.18287613509393472,39
2045,1,3228,1622,1606,0,0,0,1.0,1,1.0,1,1.0,1,0.17041228196270766,41
2046,0,3228,1622,1606,0,0,0,1.0,1,1.0,1,1.0,1,0.19015127743930915,42
2047,0,3228,1622,1606,0,0,0,1.0,1,1.0,1,1.0,1,0.19015127743930915,42
2048,1,3229,1623,1606,0,0,0,1.0,1,1.0,1,1.0,1,0.21907121653686462,43
2049,3,3232,1624,1608,0,0,0,1.0,1,1.0,1,1.0,1,0.2163144689932662,44
2050,1,3233,1624,1609,0,0,0,1.0,1,1.0,1,1.0,1,0.19556814794927935,44
2051,4,3237,1625,1612,0,0,0,1.0,1,1.0,1,1.0,1,0.21693299150272832,45
2052,0,3237,1625,1612,0,0,0,1.0,1,1.0,1,1.0,1,0.21693299150272832,45
2053,3,3240,1626,1614,0,0,0,1.0,1,1.0,1,1.0,1,0.20115561241698915,45
2054,1,3241,1627,1614,0,0,0,1.0,1,1.0,1,1.0,1,0.21638186334918716,46
2055,2,3243,1627,1616,0,0,0,1.0,1,1.0,1,1.0,1,0.17464327877343522,46
2056,1,3244,1627,1617,0,0,0,1.0,1,1.0,1,1.0,1,0.16554786022642548,46
2057,4,3248,1631,1617,0,0,0,1.0,1,1.0,1,1.0,1,0.15912145661763027,47
2058,2,3250,1633,1617,0,0,0,1.0,1,1.0,1,1.0,1,0.21435583940163858,47
2059,3,3253,1634,1619,0,0,0,1.0,1,1.0,1,1.0,1,0.185111716125546,48
2060,4,3257,1635,1622,0,0,0,1.0,1,1.0,1,1.0,1,0.17331384544838646,50
2061,2,3259,1636,1623,0,0,0,1.0,1,1.0,1,1.0,1,0.1371408221675574,51
2062,2,3261,1638,1623,0,0,0,1.0,1,1.0,1,1.0,1,0.17653495479793355,49
2063,2,3263,1639,1624,0,0,0,1.0,1,1.0,1,1.0,1,0.1635545597234546,48
2064,2,3265,1640,1625,0,0,0,1.0,1,1.0,1,1.0,1,0.1705936309165074,45
2065,1,3266,1640,1626,0,0,0,1.0,1,1.0,1,1.0,1,0.16529205213117099,44
2066,0,3266,1640,1626,0,0,0,1.0,1,1.0,1,1.0,1,0.18858308902441892,42
2067,4,3270,1641,1629,0,0,0,1.0,1,1.0,1,1.0,1,0.15668725761209526,41
2068,1,3271,1642,1629,0,0,0,1.0,1,1.0,1,1.0,1,0.16297243904910547,40
2069,1,3272,1643,1629,0,0,0,1.0,1,1.0,1,1.0,1,0.1958842366089454,40
2070,2,3274,1643,1631,0,0,0,1.0,1,1.0,1,1.0,1,0.1557526797759096,40
2071,1,3275,1644,1631,0,0,0,1.0,1,1.0,1,1.0,1,0.17639311491825083,40
2072,2,3277,1644,1633,0,0,0,1.0,1,1.0,1,1.0,1,0.17211074013577773,41
2073,1,3278,1645,1633,0,0,0,1.0,1,1.0,1,1.0,1,0.19972658802208623,41
2074,2,3280,1645,1635,0,0,0,1.0,1,1.0,1,1.0,1,0.1453715794485142,41
2075,1,3281,1646,1635,0,0,0,1.0,1,1.0,1,1.0,1,0.15732222881979388,41
2076,3,3284,1648,1636,0,0,0,1.0,1,1.0,1,1.0,1,0.15263076520916494,41
2077,0,3284,1648,1636,0,0,0,1.0,1,1.0,1,1.0,1,0.14946526331410548,40
2078,1,3285,1649,1636,0,0,0,1.0,1,1.0,1,1.0,1,0.16960507639699104,40
2079,1,3286,1649,1637,0,0,0,1.0,1,1.0,1,1.0,1,0.14228644748230876,39
2080,0,3286,1649,1637,0,0,0,1.0,1,1.0,1,1.0,1,0.16893482027053502,38
2081,1,3287,1650,1637,0,0,0,1.0,1,1.0,1,1.0,1,0.18409915807158933,40
2082,1,3288,1651,1637,0,0,0,1.0,1,1.0,1,1.0,1,0.2516314567226246,41
2083,4,3292,1653,1639,0,0,0,1.0,1,1.0,1,1.0,1,0.19227714661402429,40
2084,4,3296,1656,1640,0,0,0,1.0,1,1.0,1,1.0,1,0.19553558448766103,42
2085,0,3296,1656,1640,0,0,0,1.0,1,1.0,1,1.0,1,0.19553558448766103,42
2086,1,3297,1657,1640,0,0,0,1.0,1,1.0,1,1.0,1,0.18586350134195265,43
2087,1,3298,1658,1640,0,0,0,1.0,1,1.0,1,1.0,1,0.20360465060688485,45
2088,3,3301,1660,1641,0,0,0,1.0,1,1.0,1,1.0,1,0.20628395597084273,46
2089,1,3302,1660,1642,0,0,0,1.0,1,1.0,1,1.0,1,0.17702813836094466,47
2090,0,3302,1660,1642,0,0,0,1.0,1,1.0,1,1.0,1,0.20610109332248955,49
2091,0,3302,1660,1642,0,0,0,1.0,1,1.0,1,1.0,1,0.20610109332248955,49
2092,0,3302,1660,1642,0,0,0,1.0,1,1.0,1,1.0,1,0.20610109332248955,49
2093,2,3304,1661,1643,0,0,0,1.0,1,1.0,1,1.0,1,0.20606058380656148,49
2094,0,3304,1661,1643,0,0,0,1.0,1,1.0,1,1.0,1,0.20606058380656148,49
2095,1,3305,1661,1644,0,0,0,1.0,1,1.0,1,1.0,1,0.19257466288111844,49
2096,1,3306,1661,1645,0,0,0,1.0,1,1.0,1,1.0,1,0.18742101974563133,51
2097,1,3307,1661,1646,0,0,0,1.0,1,1.0,1,1.0,1,0.16976361154539601,51
2098,1,3308,1662,1646,0,0,0,1.0,1,1.0,1,1.0,1,0.19003066769437862,52
2099,4,3312,1663,1649,0,0,0,1.0,1,1.0,1,1.0,1,0.15999112416167163,51
2100,3,3315,1665,1650,0,0,0,1.0,1,1.0,1,1.0,1,0.17050255417122595,51
2101,1,3316,1665,1651,0,0,0,1.0,1,1.0,1,1.0,1,0.19285399938303188,48
2102,2,3318,1667,1651,0,0,0,1.0,1,1.0,1,1.0,1,0.24140754384925034,49
2103,5,3323,1671,1652,0,0,0,1.0,1,1.0,1,1.0,1,0.30329283887324565,48
2104,1,3324,1671,1653,0,0,0,1.0,1,1.0,1,1.0,1,0.3032526466020903,43
2105,4,3328,1672,1656,0,0,0,1.0,1,1.0,1,1.0,1,0.3070974554590057,42
2106,3,3331,1674,1657,0,0,0,1.0,1,1.0,1,1.0,1,0.29037821189269025,40
2107,1,3332,1674,1658,0,0,0,1.0,1,1.0,1,1.0,1,0.28139455495709687,39
2108,2,3334,1676,1658,0,0,0,1.0,1,1.0,1,1.0,1,0.29201429057564343,38
2109,2,3336,1677,1659,0,0,0,1.0,1,1.0,1,1.0,1,0.2887089964568405,37
2110,3,3339,1679,1660,0,0,0,1.0,1,1.0,1,1.0,1,0.32837643500420516,38
2111,2,3341,1680,1661,0,0,0,1.0,1,1.0,1,1.0,1,0.340662827396586,37
2112,3,3344,1681,1663,0,0,0,1.0,1,1.0,1,1.0,1,0.283731563351421,36
2113,2,3346,1682,1664,0,0,0,1.0,1,1.0,1,1.0,1,0.34191385623666637,36
2114,1,3347,1682,1665,0,0,0,1.0,1,1.0,1,1.0,1,0.3011295948265301,36
2115,0,3347,1682,1665,0,0,0,1.0,1,1.0,1,1.0,1,0.2884957243751109,35
2116,0,3347,1682,1665,0,0,0,1.0,1,1.0,1,1.0,1,0.2993845046401603,37
2117,0,3347,1682,1665,0,0,0,1.0,1,1.0,1,1.0,1,0.26469539378718543,38
2118,1,3348,1682,1666,0,0,0,1.0,1,1.0,1,1.0,1,0.25728767089107973,40
2119,0,3348,1682,1666,0,0,0,1.0,1,1.0,1,1.0,1,0.25728767089107973,40
2120,1,3349,1683,1666,0,0,0,1.0,1,1.0,1,1.0,1,0.2963811329637863,41
2121,0,3349,1683,1666,0,0,0,1.0,1,1.0,1,1.0,1,0.2963811329637863,41
2122,1,3350,1684,1666,0,0,0,1.0,1,1.0,1,1.0,1,0.3198963185785089,42
2123,0,3350,1684,1666,0,0,0,1.0,1,1.0,1,1.0,1,0.3093611138689862,43
2124,0,3350,1684,1666,0,0,0,1.0,1,1.0,1,1.0,1,0.33802251566330627,41
2125,0,3350,1684,1666,0,0,0,1.0,1,1.0,1,1.0,1,0.33802251566330627,41
2126,0,3350,1684,1666,0,0,0,1.0,1,1.0,1,1.0,1,0.36391775205151405,40
2127,0,3350,1684,1666,0,0,0,1.0,1,1.0,1,1.0,1,0.36391775205151405,40
2128,0,3350,1684,1666,0,0,0,1.0,1,1.0,1,1.0,1,0.37934919952125884,41
2129,0,3350,1684,1666,0,0,0,1.0,1,1.0,1,1.0,1,0.3716912470846654,42
2130,3,3353,1684,1669,0,0,0,1.0,1,1.0,1,1.0,1,0.3460406818581412,45
2131,1,3354,1684,1670,0,0,0,1.0,1,1.0,1,1.0,1,0.33080024364429034,45
2132,3,3357,1684,1673,0,0,0,1.0,1,1.0,1,1.0,1,0.2950285176018838,46
2133,3,3360,1685,1675,0,0,0,1.0,1,1.0,1,1.0,1,0.29230597897148275,46
2134,2,3362,1685,1677,0,0,0,1.0,1,1.0,1,1.0,1,0.2759824454133995,47
2135,2,3364,1685,1679,0,0,0,1.0,1,1.0,1,1.0,1,0.2464904563743679,47
2136,0,3364,1685,1679,0,0,0,1.0,1,1.0,1,1.0,1,0.2464904563743679,47
2137,5,3369,1686,1683,0,0,0,1.0,1,1.0,1,1.0,1,0.1761973159640542,49
2138,2,3371,1686,1685,0,0,0,1.0,1,1.0,1,1.0,1,0.1403890137114851,49
2139,2,3373,1687,1686,0,0,0,1.0,1,1.0,1,1.0,1,0.11748267519112784,47
2140,5,3378,1689,1689,0,0,0,1.0,1,1.0,1,1.0,1,0.13986762933438765,48
2141,1,3379,1690,1689,0,0,0,1.0,1,1.0,1,1.0,1,0.14705738912415933,47
2142,0,3379,1690,1689,0,0,0,1.0,1,1.0,1,1.0,1,0.14705738912415933,47
2143,2,3381,1691,1690,0,0,0,1.0,1,1.0,1,1.0,1,0.13188656768772497,48
2144,4,3385,1695,1690,0,0,0,1.0,1,1.0,1,1.0,1,0.227777986099572,48
2145,4,3389,1697,1692,0,0,0,1.0,1,1.0,1,1.0,1,0.17223485816951187,46
2146,2,3391,1697,1694,0,0,0,1.0,1,1.0,1,1.0,1,0.15159846869036253,47
2147,4,3395,1701,1694,0,0,0,1.0,1,1.0,1,1.0,1,0.1681851703063141,48
2148,0,3395,1701,1694,0,0,0,1.0,1,1.0,1,1.0,1,0.16268341618966378,46
2149,6,3401,1705,1696,0,0,0,1.0,1,1.0,1,1.0,1,0.19204028016176028,46
2150,1,3402,1706,1696,0,0,0,1.0,1,1.0,1,1.0,1,0.19139309642897112,46
2151,0,3402,1706,1696,0,0,0,1.0,1,1.0,1,1.0,1,0.22619926690703085,44
2152,3,3405,1707,1698,0,0,0,1.0,1,1.0,1,1.0,1,0.24402544268941057,45
2153,3,3408,1708,1700,0,0,0,1.0,1,1.0,1,1.0,1,0.2436793920337646,48
2154,0,3408,1708,1700,0,0,0,1.0,1,1.0,1,1.0,1,0.2736102571662971,47
2155,4,3412,1710,1702,0,0,0,1.0,1,1.0,1,1.0,1,0.2993383376707458,48
2156,1,3413,1711,1702,0,0,0,1.0,1,1.0,1,1.0,1,0.3248567685044597,45
2157,2,3415,1711,1704,0,0,0,1.0,1,1.0,1,1.0,1,0.3075373338305279,43
2158,3,3418,1712,1706,0,0,0,1.0,1,1.0,1,1.0,1,0.25388598743932395,43
2159,3,3421,1714,1707,0,0,0,1.0,1,1.0,1,1.0,1,0.28807775432556837,43
2160,0,3421,1714,1707,0,0,0,1.0,1,1.0,1,1.0,1,0.2637040556931346,41
2161,2,3423,1714,1709,0,0,0,1.0,1,1.0,1,1.0,1,0.2206895236660971,41
2162,5,3428,1717,1711,0,0,0,1.0,1,1.0,1,1.0,1,0.14971377038087166,42
2163,3,3431,1718,1713,0,0,0,1.0,1,1.0,1,1.0,1,0.1367806186876414,43
2164,2,3433,1720,1713,0,0,0,1.0,1,1.0,1,1.0,1,0.2157330047871018,44
2165,1,3434,1720,1714,0,0,0,1.0,1,1.0,1,1.0,1,0.1936007418749493,44
2166,0,3434,1720,1714,0,0,0,1.0,1,1.0,1,1.0,1,0.19104786326064058,46
2167,1,3435,1721,1714,0,0,0,1.0,1,1.0,1,1.0,1,0.2276770036812129,46
2168,0,3435,1721,1714,0,0,0,1.0,1,1.0,1,1.0,1,0.21376686271370485,45
2169,4,3439,1722,1717,0,0,0,1.0,1,1.0,1,1.0,1,0.15893429002794354,49
2170,1,3440,1722,1718,0,0,0,1.0,1,1.0,1,1.0,1,0.14999481936736575,49
2171,2,3442,1723,1719,0,0,0,1.0,1,1.0,1,1.0,1,0.1573438168575254,51
2172,1,3443,1723,1720,0,0,0,1.0,1,1.0,1,1.0,1,0.1418906133091456,52
2173,0,3443,1723,1720,0,0,0,1.0,1,1.0,1,1.0,1,0.1418906133091456,52
2174,1,3444,1724,1720,0,0,0,1.0,1,1.0,1,1.0,1,0.1569998644316525,52
2175,2,3446,1724,1722,0,0,0,1.0,1,1.0,1,1.0,1,0.1308127540987733,53
2176,3,3449,1725,1724,0,0,0,1.0,1,1.0,1,1.0,1,0.10376286058733765,54
2177,2,3451,1727,1724,0,0,0,1.0,1,1.0,1,1.0,1,0.14296712818624813,55
2178,2,3453,1728,1725,0,0,0,1.0,1,1.0,1,1.0,1,0.11484714114832038,54
2179,1,3454,1729,1725,0,0,0,1.0,1,1.0,1,1.0,1,0.15365667576861924,52
2180,2,3456,1731,1725,0,0,0,1.0,1,1.0,1,1.0,1,0.18212155459782195,51
2181,1,3457,1731,1726,0,0,0,1.0,1,1.0,1,1.0,1,0.17426589042858265,49
2182,5,3462,1735,1727,0,0,0,1.0,1,1.0,1,1.0,1,0.23850480091156073,49
2183,4,3466,1738,1728,0,0,0,1.0,1,1.0,1,1.0,1,0.24631746421097506,46
2184,3,3469,1739,1730,0,0,0,1.0,1,1.0,1,1.0,1,0.22905317951444723,45
2185,3,3472,1740,1732,0,0,0,1.0,1,1.0,1,1.0,1,0.217084173923648,44
2186,1,3473,1741,1732,0,0,0,1.0,1,1.0,1,1.0,1,0.2605782286194935,42
2187,7,3480,1744,1736,0,0,0,1.0,1,1.0,1,1.0,1,0.25401210887341247,40
2188,6,3486,1748,1738,0,0,0,1.0,1,1.0,1,1.0,1,0.17248071920836772,38
2189,0,3486,1748,1738,0,0,0,1.0,1,1.0,1,1.0,1,0.15895266749979944,36
2190,4,3490,1750,1740,0,0,0,1.0,1,1.0,1,1.0,1,0.2336462816122637,34
2191,5,3495,1752,1743,0,0,0,1.0,1,1.0,1,1.0,1,0.10538032353976831,34
2192,3,3498,1755,1743,0,0,0,1.0,1,1.0,1,1.0,1,0.13610110855753593,33
2193,0,3498,1755,1743,0,0,0,1.0,1,1.0,1,1.0,1,0.1583592300142606,32
2194,0,3498,1755,1743,0,0,0,1.0,1,1.0,1,1.0,1,0.1583592300142606,32
2195,0,3498,1755,1743,0,0,0,1.0,1,1.0,1,1.0,1,0.16058183269210305,31
2196,1,3499,1756,1743,0,0,0,1.0,1,1.0,1,1.0,1,0.15568259483666153,32
2197,1,3500,1757,1743,0,0,0,1.0,1,1.0,1,1.0,1,0.1643772547445581,31
2198,0,3500,1757,1743,0,0,0,1.0,1,1.0,1,1.0,1,0.1643772547445581,31
2199,1,3501,1758,1743,0,0,0,1.0,1,1.0,1,1.0,1,0.1573699455433686,32
2200,1,3502,1758,1744,0,0,0,1.0,1,1.0,1,1.0,1,0.17678672872276582,35
2201,0,3502,1758,1744,0,0,0,1.0,1,1.0,1,1.0,1,0.17443692507273012,36
2202,1,3503,1759,1744,0,0,0,1.0,1,1.0,1,1.0,1,0.15717222490464433,36
2203,0,3503,1759,1744,0,0,0,1.0,1,1.0,1,1.0,1,0.17106690906470945,37
2204,1,3504,1760,1744,0,0,0,1.0,1,1.0,1,1.0,1,0.22467352710730643,36
2205,1,3505,1760,1745,0,0,0,1.0,1,1.0,1,1.0,1,0.18980009562317376,37
2206,2,3507,1762,1745,0,0,0,1.0,1,1.0,1,1.0,1,0.26618005230519765,35
2207,2,3509,1763,1746,0,0,0,1.0,1,1.0,1,1.0,1,0.2689523110666879,37
2208,1,3510,1764,1746,0,0,0,1.0,1,1.0,1,1.0,1,0.2791315260081969,36
2209,3,3513,1765,1748,0,0,0,1.0,1,1.0,1,1.0,1,0.2464604668667852,35
2210,1,3514,1765,1749,0,0,0,1.0,1,1.0,1,1.0,1,0.2396211940820612,38
2211,0,3514,1765,1749,0,0,0,1.0,1,1.0,1,1.0,1,0.26506221671322805,37
2212,2,3516,1765,1751,0,0,0,1.0,1,1.0,1,1.0,1,0.22271774042492415,38
2213,1,3517,1766,1751,0,0,0,1.0,1,1.0,1,1.0,1,0.21817644222834062,38
2214,0,3517,1766,1751,0,0,0,1.0,1,1.0,1,1.0,1,0.21794720503462192,39
2215,1,3518,1767,1751,0,0,0,1.0,1,1.0,1,1.0,1,0.2495711529973138,39
2216,1,3519,1768,1751,0,0,0,1.0,1,1.0,1,1.0,1,0.2777218441527251,39
2217,2,3521,1769,1752,0,0,0,1.0,1,1.0,1,1.0,1,0.20917883334040588,38
2218,2,3523,1771,1752,0,0,0,1.0,1,1.0,1,1.0,1,0.20481558370021277,37
2219,1,3524,1772,1752,0,0,0,1.0,1,1.0,1,1.0,1,0.2079629338133461,36
2220,0,3524,1772,1752,0,0,0,1.0,1,1.0,1,1.0,1,0.24869543894452284,34
2221,1,3525,1773,1752,0,0,0,1.0,1,1.0,1,1.0,1,0.2508028116396285,35
2222,0,3525,1773,1752,0,0,0,1.0,1,1.0,1,1.0,1,0.2727856249061202,33
2223,6,3531,1774,1757,0,0,0,1.0,1,1.0,1,1.0,1,0.13377523055681706,34
2224,1,3532,1775,1757,0,0,0,1.0,1,1.0,1,1.0,1,0.14309403302412851,32
2225,3,3535,1778,1757,0,0,0,1.0,1,1.0,1,1.0,1,0.24172700826460802,33
2226,2,3537,1780,1757,0,0,0,1.0,1,1.0,1,1.0,1,0.318922128833224,32
2227,1,3538,1780,1758,0,0,0,1.0,1,1.0,1,1.0,1,0.2268808019499291,31
2228,1,3539,1781,1758,0,0,0,1.0,1,1.0,1,1.0,1,0.21938991507771324,32
2229,0,3539,1781,1758,0,0,0,1.0,1,1.0,1,1.0,1,0.21938991507771324,32
2230,1,3540,1782,1758,0,0,0,1.0,1,1.0,1,1.0,1,0.21679563957511586,31
2231,0,3540,1782,1758,0,0,0,1.0,1,1.0,1,1.0,1,0.19650108937593666,32
2232,3,3543,1783,1760,0,0,0,1.0,1,1.0,1,1.0,1,0.18222108966889453,32
2233,1,3544,1783,1761,0,0,0,1.0,1,1.0,1,1.0,1,0.1653212391268518,31
2234,1,3545,1784,1761,0,0,0,1.0,1,1.0,1,1.0,1,0.23724916034467253,32
2235,1,3546,1784,1762,0,0,0,1.0,1,1.0,1,1.0,1,0.2500677376851897,31
2236,2,3548,1786,1762,0,0,0,1.0,1,1.0,1,1.0,1,0.30992959627337735,31
2237,0,3548,1786,1762,0,0,0,1.0,1,1.0,1,1.0,1,0.30992959627337735,31
2238,4,3552,1787,1765,0,0,0,1.0,1,1.0,1,1.0,1,0.2715996658484254,31
2239,0,3552,1787,1765,0,0,0,1.0,1,1.0,1,1.0,1,0.2715996658484254,31
2240,3,3555,1789,1766,0,0,0,1.0,1,1.0,1,1.0,1,0.2524586654047874,32
2241,1,3556,1790,1766,0,0,0,1.0,1,1.0,1,1.0,1,0.2773024064345854,32
2242,4,3560,1792,1768,0,0,0,1.0,1,1.0,1,1.0,1,0.21831918223936775,34
2243,0,3560,1792,1768,0,0,0,1.0,1,1.0,1,1.0,1,0.21831918223936775,34
2244,0,3560,1792,1768,0,0,0,1.0,1,1.0,1,1.0,1,0.23087565430507687,36
2245,0,3560,1792,1768,0,0,0,1.0,1,1.0,1,1.0,1,0.23087565430507687,36
2246,3,3563,1792,1771,0,0,0,1.0,1,1.0,1,1.0,1,0.17520114303597364,39
2247,0,3563,1792,1771,0,0,0,1.0,1,1.0,1,1.0,1,0.17718236788728894,40
2248,0,3563,1792,1771,0,0,0,1.0,1,1.0,1,1.0,1,0.17718236788728894,40
2249,0,3563,1792,1771,0,0,0,1.0,1,1.0,1,1.0,1,0.1736284246029366,41
2250,0,3563,1792,1771,0,0,0,1.0,1,1.0,1,1.0,1,0.1736284246029366,41
2251,0,3563,1792,1771,0,0,0,1.0,1,1.0,1,1.0,1,0.19346827801165192,42
2252,1,3564,1793,1771,0,0,0,1.0,1,1.0,1,1.0,1,0.20399903414976425,41
2253,0,3564,1793,1771,0,0,0,1.0,1,1.0,1,1.0,1,0.19024492824571884,40
2254,1,3565,1794,1771,0,0,0,1.0,1,1.0,1,1.0,1,0.22622588742762345,39
2255,2,3567,1794,1773,0,0,0,1.0,1,1.0,1,1.0,1,0.2502982980927905,39
2256,4,3571,1798,1773,0,0,0,1.0,1,1.0,1,1.0,1,0.2976928073042037,40
2257,5,3576,1800,1776,0,0,0,1.0,1,1.0,1,1.0,1,0.2703903448627345,40
2258,2,3578,1802,1776,0,0,0,1.0,1,1.0,1,1.0,1,0.24540558441139607,39
2259,3,3581,1804,1777,0,0,0,1.0,1,1.0,1,1.0,1,0.24265879520681927,41
2260,0,3581,1804,1777,0,0,0,1.0,1,1.0,1,1.0,1,0.22949922344011264,38
2261,1,3582,1805,1777,0,0,0,1.0,1,1.0,1,1.0,1,0.2428950567292884,38
2262,0,3582,1805,1777,0,0,0,1.0,1,1.0,1,1.0,1,0.2556825233204914,36
2263,4,3586,1808,1778,0,0,0,1.0,1,1.0,1,1.0,1,0.23479928972827852,35
2264,3,3589,1811,1778,0,0,0,1.0,1,1.0,1,1.0,1,0.33911064770389926,33
2265,5,3594,1813,1781,0,0,0,1.0,1,1.0,1,1.0,1,0.35378055456348534,33
2266,5,3599,1815,1784,0,0,0,1.0,1,1.0,1,1.0,1,0.3035691171961029,33
2267,4,3603,1817,1786,0,0,0,1.0,1,1.0,1,1.0,1,0.26222293314701567,33
2268,6,3609,1818,1791,0,0,0,1.0,1,1.0,1,1.0,1,0.1761379982970477,35
2269,2,3611,1819,1792,0,0,0,1.0,1,1.0,1,1.0,1,0.15839554084680388,36
2270,0,3611,1819,1792,0,0,0,1.0,1,1.0,1,1.0,1,0.1661348820164684,34
2271,3,3614,1822,1792,0,0,0,1.0,1,1.0,1,1.0,1,0.2605474324167647,34
2272,3,3617,1823,1794,0,0,0,1.0,1,1.0,1,1.0,1,0.21566051066263542,33
2273,1,3618,1824,1794,0,0,0,1.0,1,1.0,1,1.0,1,0.21837223841719267,32
2274,0,3618,1824,1794,0,0,0,1.0,1,1.0,1,1.0,1,0.21837223841719267,32
2275,1,3619,1824,1795,0,0,0,1.0,1,1.0,1,1.0,1,0.22391766626987714,32
2276,0,3619,1824,1795,0,0,0,1.0,1,1.0,1,1.0,1,0.20444569934608497,31
2277,1,3620,1825,1795,0,0,0,1.0,1,1.0,1,1.0,1,0.2113987349603287,30
2278,0,3620,1825,1795,0,0,0,1.0,1,1.0,1,1.0,1,0.21248430524198267,33
2279,0,3620,1825,1795,0,0,0,1.0,1,1.0,1,1.0,1,0.21248430524198267,33
2280,3,3623,1825,1798,0,0,0,1.0,1,1.0,1,1.0,1,0.1606694159170481,35
2281,1,3624,1825,1799,0,0,0,1.0,1,1.0,1,1.0,1,0.1583683968584859,36
2282,0,3624,1825,1799,0,0,0,1.0,1,1.0,1,1.0,1,0.1583683968584859,36
2283,1,3625,1826,1799,0,0,0,1.0,1,1.0,1,1.0,1,0.17685436635323512,36
2284,1,3626,1827,1799,0,0,0,1.0,1,1.0,1,1.0,1,0.19162888650534576,36
2285,1,3627,1827,1800,0,0,0,1.0,1,1.0,1,1.0,1,0.15807273947829326,37
2286,1,3628,1828,1800,0,0,0,1.0,1,1.0,1,1.0,1,0.18619230648602741,38
2287,0,3628,1828,1800,0,0,0,1.0,1,1.0,1,1.0,1,0.1714461858879318,38
2288,2,3630,1830,1800,0,0,0,1.0,1,1.0,1,1.0,1,0.2695143804686068,40
2289,2,3632,1830,1802,0,0,0,1.0,1,1.0,1,1.0,1,0.21968615718598175,40
2290,1,3633,1831,1802,0,0,0,1.0,1,1.0,1,1.0,1,0.25675858395697976,39
2291,1,3634,1832,1802,0,0,0,1.0,1,1.0,1,1.0,1,0.24912009698068807,37
2292,3,3637,1834,1803,0,0,0,1.0,1,1.0,1,1.0,1,0.3545621476907194,35
2293,5,3642,1837,1805,0,0,0,1.0,1,1.0,1,1.0,1,0.3915900163007722,35
2294,1,3643,1837,1806,0,0,0,1.0,1,1.0,1,1.0,1,0.36350772121165764,35
2295,3,3646,1837,1809,0,0,0,1.0,1,1.0,1,1.0,1,0.28906009271888167,36
2296,0,3646,1837,1809,0,0,0,1.0,1,1.0,1,1.0,1,0.28006704887380446,34
2297,0,3646,1837,1809,0,0,0,1.0,1,1.0,1,1.0,1,0.29596072118312355,35
2298,0,3646,1837,1809,0,0,0,1.0,1,1.0,1,1.0,1,0.299361412290478,34
2299,2,3648,1839,1809,0,0,0,1.0,1,1.0,1,1.0,1,0.29506945836166776,35
2300,1,3649,1840,1809,0,0,0,1.0,1,1.0,1,1.0,1,0.3038490775833249,35
2301,0,3649,1840,1809,0,0,0,1.0,1,1.0,1,1.0,1,0.3038490775833249,35
2302,4,3653,1843,1810,0,0,0,1.0,1,1.0,1,1.0,1,0.3666542834735898,37
2303,1,3654,1844,1810,0,0,0,1.0,1,1.0,1,1.0,1,0.2958946587871105,35
2304,2,3656,1845,1811,0,0,0,1.0,1,1.0,1,1.0,1,0.3286145488870743,36
2305,1,3657,1845,1812,0,0,0,1.0,1,1.0,1,1.0,1,0.33064368133855176,34
2306,1,3658,1845,1813,0,0,0,1.0,1,1.0,1,1.0,1,0.30842353964246183,35
2307,2,3660,1845,1815,0,0,0,1.0,1,1.0,1,1.0,1,0.2657545571419182,35
2308,0,3660,1845,1815,0,0,0,1.0,1,1.0,1,1.0,1,0.2657545571419182,35
2309,0,3660,1845,1815,0,0,0,1.0,1,1.0,1,1.0,1,0.2745889361959719,34
2310,1,3661,1845,1816,0,0,0,1.0,1,1.0,1,1.0,1,0.260552289611024,36
2311,1,3662,1845,1817,0,0,0,1.0,1,1.0,1,1.0,1,0.2506623030713892,38
2312,2,3664,1847,1817,0,0,0,1.0,1,1.0,1,1.0,1,0.3094660845837627,39
2313,5,3669,1849,1820,0,0,0,1.0,1,1.0,1,1.0,1,0.2145074070030656,39
2314,2,3671,1849,1822,0,0,0,1.0,1,1.0,1,1.0,1,0.1992508694957049,39
2315,6,3677,1851,1826,0,0,0,1.0,1,1.0,1,1.0,1,0.14724647122369589,40
2316,0,3677,1851,1826,0,0,0,1.0,1,1.0,1,1.0,1,0.14724647122369589,40
2317,1,3678,1852,1826,0,0,0,1.0,1,1.0,1,1.0,1,0.20520937006657247,41
2318,1,3679,1853,1826,0,0,0,1.0,1,1.0,1,1.0,1,0.20977723994823366,41
2319,1,3680,1853,1827,0,0,0,1.0,1,1.0,1,1.0,1,0.19593453947529774,41
2320,0,3680,1853,1827,0,0,0,1.0,1,1.0,1,1.0,1,0.21691540909606327,42
2321,0,3680,1853,1827,0,0,0,1.0,1,1.0,1,1.0,1,0.19613834557205612,43
2322,0,3680,1853,1827,0,0,0,1.0,1,1.0,1,1.0,1,0.1931856450183167,42
2323,1,3681,1854,1827,0,0,0,1.0,1,1.0,1,1.0,1,0.24128027998971605,43
2324,4,3685,1854,1831,0,0,0,1.0,1,1.0,1,1.0,1,0.22415203831661235,44
2325,1,3686,1854,1832,0,0,0,1.0,1,1.0,1,1.0,1,0.20419841369224648,44
2326,0,3686,1854,1832,0,0,0,1.0,1,1.0,1,1.0,1,0.1911302085493086,45
2327,0,3686,1854,1832,0,0,0,1.0,1,1.0,1,1.0,1,0.1911302085493086,45
2328,0,3686,1854,1832,0,0,0,1.0,1,1.0,1,1.0,1,0.19890166274336335,46
2329,1,3687,1855,1832,0,0,0,1.0,1,1.0,1,1.0,1,0.21193655816136078,45
2330,1,3688,1855,1833,0,0,0,1.0,1,1.0,1,1.0,1,0.20319925775782968,47
2331,0,3688,1855,1833,0,0,0,1.0,1,1.0,1,1.0,1,0.2036977921643966,48
2332,0,3688,1855,1833,0,0,0,1.0,1,1.0,1,1.0,1,0.2036977921643966,48
2333,1,3689,1856,1833,0,0,0,1.0,1,1.0,1,1.0,1,0.23717683991532146,49
2334,1,3690,1857,1833,0,0,0,1.0,1,1.0,1,1.0,1,0.2728274166177722,47
2335,2,3692,1858,1834,0,0,0,1.0,1,1.0,1,1.0,1,0.3035714774340837,46
2336,3,3695,1858,1837,0,0,0,1.0,1,1.0,1,1.0,1,0.28438456856222855,46
2337,2,3697,1858,1839,0,0,0,1.0,1,1.0,1,1.0,1,0.22984890119688364,45
2338,2,3699,1859,1840,0,0,0,1.0,1,1.0,1,1.0,1,0.20185272493882367,44
2339,1,3700,1860,1840,0,0,0,1.0,1,1.0,1,1.0,1,0.19003861388373494,45
2340,1,3701,1861,1840,0,0,0,1.0,1,1.0,1,1.0,1,0.20450597766766604,44
2341,3,3704,1861,1843,0,0,0,1.0,1,1.0,1,1.0,1,0.17721328136220255,45
2342,1,3705,1862,1843,0,0,0,1.0,1,1.0,1,1.0,1,0.18438575276091898,47
2343,1,3706,1863,1843,0,0,0,1.0,1,1.0,1,1.0,1,0.18909653811519256,46
2344,1,3707,1863,1844,0,0,0,1.0,1,1.0,1,1.0,1,0.2055311103392116,46
2345,2,3709,1863,1846,0,0,0,1.0,1,1.0,1,1.0,1,0.17760985666300802,45
2346,0,3709,1863,1846,0,0,0,1.0,1,1.0,1,1.0,1,0.16472232178584048,46
2347,0,3709,1863,1846,0,0,0,1.0,1,1.0,1,1.0,1,0.1822418752559335,47
2348,1,3710,1864,1846,0,0,0,1.0,1,1.0,1,1.0,1,0.20400567481692516,49
2349,3,3713,1865,1848,0,0,0,1.0,1,1.0,1,1.0,1,0.20892486444566039,49
2350,4,3717,1866,1851,0,0,0,1.0,1,1.0,1,1.0,1,0.18820022005617293,50
2351,1,3718,1867,1851,0,0,0,1.0,1,1.0,1,1.0,1,0.20281600437840408,50
2352,1,3719,1867,1852,0,0,0,1.0,1,1.0,1,1.0,1,0.19544558713041904,51
2353,0,3719,1867,1852,0,0,0,1.0,1,1.0,1,1.0,1,0.19544558713041904,51
2354,0,3719,1867,1852,0,0,0,1.0,1,1.0,1,1.0,1,0.2137266326517023,51
2355,2,3721,1868,1853,0,0,0,1.0,1,1.0,1,1.0,1,0.22084788258340518,50
2356,0,3721,1868,1853,0,0,0,1.0,1,1.0,1,1.0,1,0.22084788258340518,50
2357,0,3721,1868,1853,0,0,0,1.0,1,1.0,1,1.0,1,0.21887245492536675,49
2358,3,3724,1868,1856,0,0,0,1.0,1,1.0,1,1.0,1,0.19659014740234826,51
2359,1,3725,1868,1857,0,0,0,1.0,1,1.0,1,1.0,1,0.16381015432814633,51
2360,2,3727,1870,1857,0,0,0,1.0,1,1.0,1,1.0,1,0.22146672865433806,51
2361,2,3729,1871,1858,0,0,0,1.0,1,1.0,1,1.0,1,0.2504948434782522,52
2362,3,3732,1871,1861,0,0,0,1.0,1,1.0,1,1.0,1,0.20204812784217246,53
2363,2,3734,1872,1862,0,0,0,1.0,1,1.0,1,1.0,1,0.19507903416444766,54
2364,3,3737,1872,1865,0,0,0,1.0,1,1.0,1,1.0,1,0.159081904135324,55
2365,2,3739,1873,1866,0,0,0,1.0,1,1.0,1,1.0,1,0.16973140403844933,53
2366,2,3741,1874,1867,0,0,0,1.0,1,1.0,1,1.0,1,0.15465415425872142,53
2367,2,3743,1876,1867,0,0,0,1.0,1,1.0,1,1.0,1,0.19899875559665203,51
2368,3,3746,1878,1868,0,0,0,1.0,1,1.0,1,1.0,1,0.19081351236301192,50
2369,2,3748,1880,1868,0,0,0,1.0,1,1.0,1,1.0,1,0.23634788382167432,47
2370,1,3749,1880,1869,0,0,0,1.0,1,1.0,1,1.0,1,0.2498968014230579,48
2371,4,3753,1881,1872,0,0,0,1.0,1,1.0,1,1.0,1,0.22770939928343886,49
2372,0,3753,1881,1872,0,0,0,1.0,1,1.0,1,1.0,1,0.223529523939133,48
2373,0,3753,1881,1872,0,0,0,1.0,1,1.0,1,1.0,1,0.23212437534214972,49
2374,0,3753,1881,1872,0,0,0,1.0,1,1.0,1,1.0,1,0.23699512999247485,50
2375,1,3754,1882,1872,0,0,0,1.0,1,1.0,1,1.0,1,0.2609975576160787,50
2376,1,3755,1882,1873,0,0,0,1.0,1,1.0,1,1.0,1,0.24871916360034918,50
2377,1,3756,1882,1874,0,0,0,1.0,1,1.0,1,1.0,1,0.23304472349551278,49
2378,0,3756,1882,1874,0,0,0,1.0,1,1.0,1,1.0,1,0.23304472349551278,49
2379,1,3757,1883,1874,0,0,0,1.0,1,1.0,1,1.0,1,0.26765334191939827,50
2380,1,3758,1884,1874,0,0,0,1.0,1,1.0,1,1.0,1,0.290224063071881,50
2381,2,3760,1885,1875,0,0,0,1.0,1,1.0,1,1.0,1,0.3056004661510219,51
2382,3,3763,1886,1877,0,0,0,1.0,1,1.0,1,1.0,1,0.2788757222805604,51
2383,4,3767,1887,1880,0,0,0,1.0,1,1.0,1,1.0,1,0.2600381709404764,52
2384,1,3768,1888,1880,0,0,0,1.0,1,1.0,1,1.0,1,0.24187403682292716,52
2385,3,3771,1890,1881,0,0,0,1.0,1,1.0,1,1.0,1,0.26798586569077965,51
2386,4,3775,1891,1884,0,0,0,1.0,1,1.0,1,1.0,1,0.24525590338663672,52
2387,0,3775,1891,1884,0,0,0,1.0,1,1.0,1,1.0,1,0.26693607854631823,49
2388,2,3777,1892,1885,0,0,0,1.0,1,1.0,1,1.0,1,0.25660328575264285,48
2389,3,3780,1894,1886,0,0,0,1.0,1,1.0,1,1.0,1,0.2707449999474194,48
2390,2,3782,1895,1887,0,0,0,1.0,1,1.0,1,1.0,1,0.2622365182640523,49
2391,0,3782,1895,1887,0,0,0,1.0,1,1.0,1,1.0,1,0.2592356616144462,48
2392,3,3785,1898,1887,0,0,0,1.0,1,1.0,1,1.0,1,0.25511475983587956,49
2393,6,3791,1899,1892,0,0,0,1.0,1,1.0,1,1.0,1,0.21103029070679855,50
2394,2,3793,1900,1893,0,0,0,1.0,1,1.0,1,1.0,1,0.23082575606053546,50
2395,1,3794,1901,1893,0,0,0,1.0,1,1.0,1,1.0,1,0.22382542969866576,49
2396,3,3797,1902,1895,0,0,0,1.0,1,1.0,1,1.0,1,0.18759183682378974,50
2397,4,3801,1905,1896,0,0,0,1.0,1,1.0,1,1.0,1,0.21016225255868598,51
2398,1,3802,1906,1896,0,0,0,1.0,1,1.0,1,1.0,1,0.2061758034517705,49
2399,1,3803,1906,1897,0,0,0,1.0,1,1.0,1,1.0,1,0.18593466793201882,50
2400,0,3803,1906,1897,0,0,0,1.0,1,1.0,1,1.0,1,0.19845001584886746,51
2401,0,3803,1906,1897,0,0,0,1.0,1,1.0,1,1.0,1,0.20930816978758535,50
2402,0,3803,1906,1897,0,0,0,1.0,1,1.0,1,1.0,1,0.2123380574358444,51
2403,1,3804,1906,1898,0,0,0,1.0,1,1.0,1,1.0,1,0.19195640101493647,52
2404,2,3806,1906,1900,0,0,0,1.0,1,1.0,1,1.0,1,0.16628730507263434,53
2405,0,3806,1906,1900,0,0,0,1.0,1,1.0,1,1.0,1,0.1691022779062012,52
2406,2,3808,1908,1900,0,0,0,1.0,1,1.0,1,1.0,1,0.1865961427954712,52
2407,0,3808,1908,1900,0,0,0,1.0,1,1.0,1,1.0,1,0.21547341162619726,51
2408,2,3810,1909,1901,0,0,0,1.0,1,1.0,1,1.0,1,0.21371363748800662,50
2409,0,3810,1909,1901,0,0,0,1.0,1,1.0,1,1.0,1,0.22164149344170772,50
2410,1,3811,1910,1901,0,0,0,1.0,1,1.0,1,1.0,1,0.2609764110966246,49
2411,2,3813,1910,1903,0,0,0,1.0,1,1.0,1,1.0,1,0.25703931689925497,48
2412,1,3814,1910,1904,0,0,0,1.0,1,1.0,1,1.0,1,0.26704626181822316,47
2413,1,3815,1910,1905,0,0,0,1.0,1,1.0,1,1.0,1,0.2457958937697398,47
2414,1,3816,1911,1905,0,0,0,1.0,1,1.0,1,1.0,1,0.2865770676605262,47
2415,1,3817,1912,1905,0,0,0,1.0,1,1.0,1,1.0,1,0.30905716970270386,46
2416,1,3818,1912,1906,0,0,0,1.0,1,1.0,1,1.0,1,0.2826672032759351,47
2417,1,3819,1912,1907,0,0,0,1.0,1,1.0,1,1.0,1,0.27829655657495816,46
2418,4,3823,1913,1910,0,0,0,1.0,1,1.0,1,1.0,1,0.25791652239324453,48
2419,2,3825,1914,1911,0,0,0,1.0,1,1.0,1,1.0,1,0.2509027459045035,47
2420,2,3827,1915,1912,0,0,0,1.0,1,1.0,1,1.0,1,0.2328338535947825,49
2421,2,3829,1916,1913,0,0,0,1.0,1,1.0,1,1.0,1,0.222778426951904,50
2422,3,3832,1918,1914,0,0,0,1.0,1,1.0,1,1.0,1,0.19752552730659773,50
2423,2,3834,1918,1916,0,0,0,1.0,1,1.0,1,1.0,1,0.1818506648574088,51
2424,2,3836,1920,1916,0,0,0,1.0,1,1.0,1,1.0,1,0.17465491843623468,50
2425,0,3836,1920,1916,0,0,0,1.0,1,1.0,1,1.0,1,0.1773261279255074,48
2426,5,3841,1924,1917,0,0,0,1.0,1,1.0,1,1.0,1,0.2099516619056651,51
2427,3,3844,1926,1918,0,0,0,1.0,1,1.0,1,1.0,1,0.20288772900264915,50
2428,1,3845,1926,1919,0,0,0,1.0,1,1.0,1,1.0,1,0.1642441079564787,49
2429,2,3847,1927,1920,0,0,0,1.0,1,1.0,1,1.0,1,0.1782857460114491,49
2430,0,3847,1927,1920,0,0,0,1.0,1,1.0,1,1.0,1,0.19918215101057887,46
2431,1,3848,1928,1920,0,0,0,1.0,1,1.0,1,1.0,1,0.22220901888920672,45
2432,2,3850,1929,1921,0,0,0,1.0,1,1.0,1,1.0,1,0.28228580512133766,44
2433,2,3852,1930,1922,0,0,0,1.0,1,1.0,1,1.0,1,0.24362980851466173,45
2434,1,3853,1931,1922,0,0,0,1.0,1,1.0,1,1.0,1,0.262229862216215,44
2435,2,3855,1931,1924,0,0,0,1.0,1,1.0,1,1.0,1,0.22076506360833026,44
2436,2,3857,1931,1926,0,0,0,1.0,1,1.0,1,1.0,1,0.16638780602008238,44
2437,2,3859,1932,1927,0,0,0,1.0,1,1.0,1,1.0,1,0.1909449475177785,45
2438,1,3860,1933,1927,0,0,0,1.0,1,1.0,1,1.0,1,0.23546554580491802,45
2439,3,3863,1934,1929,0,0,0,1.0,1,1.0,1,1.0,1,0.19552560243610362,46
2440,0,3863,1934,1929,0,0,0,1.0,1,1.0,1,1.0,1,0.20990205346342386,45
2441,3,3866,1935,1931,0,0,0,1.0,1,1.0,1,1.0,1,0.1916020732423409,45
2442,0,3866,1935,1931,0,0,0,1.0,1,1.0,1,1.0,1,0.1837632472830838,46
2443,0,3866,1935,1931,0,0,0,1.0,1,1.0,1,1.0,1,0.22954924794602702,45
2444,5,3871,1938,1933,0,0,0,1.0,1,1.0,1,1.0,1,0.29805354066572337,46
2445,1,3872,1939,1933,0,0,0,1.0,1,1.0,1,1.0,1,0.3389725274228268,44
2446,1,3873,1940,1933,0,0,0,1.0,1,1.0,1,1.0,1,0.33467882691294565,44
2447,4,3877,1942,1935,0,0,0,1.0,1,1.0,1,1.0,1,0.2919221617800432,42
2448,4,3881,1945,1936,0,0,0,1.0,1,1.0,1,1.0,1,0.2619521029897174,41
2449,1,3882,1946,1936,0,0,0,1.0,1,1.0,1,1.0,1,0.2607149648509736,40
2450,4,3886,1950,1936,0,0,0,1.0,1,1.0,1,1.0,1,0.25601406587065134,42
2451,1,3887,1950,1937,0,0,0,1.0,1,1.0,1,1.0,1,0.21034276581907838,43
2452,0,3887,1950,1937,0,0,0,1.0,1,1.0,1,1.0,1,0.21034276581907838,43
2453,1,3888,1950,1938,0,0,0,1.0,1,1.0,1,1.0,1,0.219123107829788,45
2454,3,3891,1952,1939,0,0,0,1.0,1,1.0,1,1.0,1,0.2557322223519427,47
2455,0,3891,1952,1939,0,0,0,1.0,1,1.0,1,1.0,1,0.252039880106104,48
2456,1,3892,1953,1939,0,0,0,1.0,1,1.0,1,1.0,1,0.2890469521408443,49
2457,1,3893,1954,1939,0,0,0,1.0,1,1.0,1,1.0,1,0.3434685331355561,48
2458,3,3896,1955,1941,0,0,0,1.0,1,1.0,1,1.0,1,0.3001847008209739,49
2459,2,3898,1955,1943,0,0,0,1.0,1,1.0,1,1.0,1,0.2807269500969924,49
2460,2,3900,1957,1943,0,0,0,1.0,1,1.0,1,1.0,1,0.3137052397758696,50
2461,2,3902,1957,1945,0,0,0,1.0,1,1.0,1,1.0,1,0.29610285332772707,50
2462,6,3908,1959,1949,0,0,0,1.0,1,1.0,1,1.0,1,0.2573044138480822,51
2463,2,3910,1959,1951,0,0,0,1.0,1,1.0,1,1.0,1,0.24022247699291668,51
2464,2,3912,1961,1951,0,0,0,1.0,1,1.0,1,1.0,1,0.22773791172594063,50
2465,0,3912,1961,1951,0,0,0,1.0,1,1.0,1,1.0,1,0.23131472682948412,49
2466,2,3914,1962,1952,0,0,0,1.0,1,1.0,1,1.0,1,0.23143978953888653,49
2467,1,3915,1962,1953,0,0,0,1.0,1,1.0,1,1.0,1,0.22439360817875995,48
2468,1,3916,1963,1953,0,0,0,1.0,1,1.0,1,1.0,1,0.23668959200465012,47
2469,2,3918,1964,1954,0,0,0,1.0,1,1.0,1,1.0,1,0.20549858411432192,46
2470,1,3919,1965,1954,0,0,0,1.0,1,1.0,1,1.0,1,0.21812991600016332,44
2471,3,3922,1966,1956,0,0,0,1.0,1,1.0,1,1.0,1,0.206813090573953,44
2472,2,3924,1966,1958,0,0,0,1.0,1,1.0,1,1.0,1,0.22975708505672474,44
2473,2,3926,1967,1959,0,0,0,1.0,1,1.0,1,1.0,1,0.22780556399300372,43
2474,3,3929,1969,1960,0,0,0,1.0,1,1.0,1,1.0,1,0.25676454808178656,44
2475,6,3935,1970,1965,0,0,0,1.0,1,1.0,1,1.0,1,0.1616064153220035,46
2476,0,3935,1970,1965,0,0,0,1.0,1,1.0,1,1.0,1,0.1616064153220035,46
2477,0,3935,1970,1965,0,0,0,1.0,1,1.0,1,1.0,1,0.1616064153220035,46
2478,0,3935,1970,1965,0,0,0,1.0,1,1.0,1,1.0,1,0.1616064153220035,46
2479,1,3936,1971,1965,0,0,0,1.0,1,1.0,1,1.0,1,0.16617499493614096,46
2480,1,3937,1972,1965,0,0,0,1.0,1,1.0,1,1.0,1,0.19756894033424474,47
2481,1,3938,1973,1965,0,0,0,1.0,1,1.0,1,1.0,1,0.19234199684018383,47
2482,1,3939,1974,1965,0,0,0,1.0,1,1.0,1,1.0,1,0.19998487377367002,45
2483,2,3941,1974,1967,0,0,0,1.0,1,1.0,1,1.0,1,0.1756982881630693,45
2484,1,3942,1975,1967,0,0,0,1.0,1,1.0,1,1.0,1,0.21755695494363889,46
2485,2,3944,1976,1968,0,0,0,1.0,1,1.0,1,1.0,1,0.19354504845981368,44
2486,1,3945,1976,1969,0,0,0,1.0,1,1.0,1,1.0,1,0.15481544274994666,43
2487,1,3946,1977,1969,0,0,0,1.0,1,1.0,1,1.0,1,0.19741969613679328,44
2488,3,3949,1978,1971,0,0,0,1.0,1,1.0,1,1.0,1,0.1727316200879387,45
2489,0,3949,1978,1971,0,0,0,1.0,1,1.0,1,1.0,1,0.18796874134024227,44
2490,2,3951,1980,1971,0,0,0,1.0,1,1.0,1,1.0,1,0.2259147183775991,44
2491,2,3953,1981,1972,0,0,0,1.0,1,1.0,1,1.0,1,0.2011556614188251,44
2492,1,3954,1982,1972,0,0,0,1.0,1,1.0,1,1.0,1,0.2342620614478466,44
2493,0,3954,1982,1972,0,0,0,1.0,1,1.0,1,1.0,1,0.2538603289495665,42
2494,1,3955,1983,1972,0,0,0,1.0,1,1.0,1,1.0,1,0.26611999695685346,42
2495,2,3957,1983,1974,0,0,0,1.0,1,1.0,1,1.0,1,0.22770116568831852,42
2496,2,3959,1984,1975,0,0,0,1.0,1,1.0,1,1.0,1,0.22533349179962,42
2497,1,3960,1984,1976,0,0,0,1.0,1,1.0,1,1.0,1,0.24239216155302518,44
2498,1,3961,1985,1976,0,0,0,1.0,1,1.0,1,1.0,1,0.26328264268055884,43
2499,1,3962,1986,1976,0,0,0,1.0,1,1.0,1,1.0,1,0.24090350067870062,43
2500,3,3965,1988,1977,0,0,0,1.0,1,1.0,1,1.0,1,0.21884630522793147,44
2501,4,3969,1989,1980,0,0,0,1.0,1,1.0,1,1.0,1,0.1540588993209483,46
2502,0,3969,1989,1980,0,0,0,1.0,1,1.0,1,1.0,1,0.16905174945655696,47
2503,3,3972,1990,1982,0,0,0,1.0,1,1.0,1,1.0,1,0.17869499228855742,47
2504,2,3974,1991,1983,0,0,0,1.0,1,1.0,1,1.0,1,0.1977119757116165,46
2505,3,3977,1994,1983,0,0,0,1.0,1,1.0,1,1.0,1,0.1983656598660005,46
2506,1,3978,1995,1983,0,0,0,1.0,1,1.0,1,1.0,1,0.2075017609585476,45
2507,4,3982,1997,1985,0,0,0,1.0,1,1.0,1,1.0,1,0.19005996632020863,45
2508,2,3984,1998,1986,0,0,0,1.0,1,1.0,1,1.0,1,0.19929124613120183,46
2509,3,3987,1999,1988,0,0,0,1.0,1,1.0,1,1.0,1,0.2002017009453741,45
2510,2,3989,2001,1988,0,0,0,1.0,1,1.0,1,1.0,1,0.22891881147608867,46
2511,2,3991,2001,1990,0,0,0,1.0,1,1.0,1,1.0,1,0.17601328662375465,47
2512,0,3991,2001,1990,0,0,0,1.0,1,1.0,1,1.0,1,0.165045755321163,47
2513,1,3992,2002,1990,0,0,0,1.0,1,1.0,1,1.0,1,0.16881451731713032,48
2514,3,3995,2004,1991,0,0,0,1.0,1,1.0,1,1.0,1,0.21120472693851394,48
2515,2,3997,2004,1993,0,0,0,1.0,1,1.0,1,1.0,1,0.1614139821565936,49
2516,1,3998,2005,1993,0,0,0,1.0,1,1.0,1,1.0,1,0.1804658079288642,49
2517,2,4000,2006,1994,0,0,0,1.0,1,1.0,1,1.0,1,0.18459029009599845,49
2518,1,4001,2007,1994,0,0,0,1.0,1,1.0,1,1.0,1,0.2153950554838792,48
2519,1,4002,2008,1994,0,0,0,1.0,1,1.0,1,1.0,1,0.24862307733763683,48
2520,2,4004,2009,1995,0,0,0,1.0,1,1.0,1,1.0,1,0.29077959161407113,46
2521,5,4009,2011,1998,0,0,0,1.0,1,1.0,1,1.0,1,0.28005774985074994,47
2522,1,4010,2012,1998,0,0,0,1.0,1,1.0,1,1.0,1,0.32260842313288535,45
2523,3,4013,2013,2000,0,0,0,1.0,1,1.0,1,1.0,1,0.338796838278511,44
2524,0,4013,2013,2000,0,0,0,1.0,1,1.0,1,1.0,1,0.3138379210787384,42
2525,5,4018,2014,2004,0,0,0,1.0,1,1.0,1,1.0,1,0.2911289385039288,42
2526,0,4018,2014,2004,0,0,0,1.0,1,1.0,1,1.0,1,0.28983157594266634,41
2527,0,4018,2014,2004,0,0,0,1.0,1,1.0,1,1.0,1,0.28983157594266634,41
2528,0,4018,2014,2004,0,0,0,1.0,1,1.0,1,1.0,1,0.30917598469174823,41
2529,1,4019,2015,2004,0,0,0,1.0,1,1.0,1,1.0,1,0.32689132693955425,42
2530,0,4019,2015,2004,0,0,0,1.0,1,1.0,1,1.0,1,0.337785703151306,41
2531,1,4020,2015,2005,0,0,0,1.0,1,1.0,1,1.0,1,0.30676560961440286,41
2532,0,4020,2015,2005,0,0,0,1.0,1,1.0,1,1.0,1,0.32918513625472107,43
2533,0,4020,2015,2005,0,0,0,1.0,1,1.0,1,1.0,1,0.32918513625472107,43
2534,0,4020,2015,2005,0,0,0,1.0,1,1.0,1,1.0,1,0.32918513625472107,43
2535,2,4022,2016,2006,0,0,0,1.0,1,1.0,1,1.0,1,0.34787499397273525,44
2536,0,4022,2016,2006,0,0,0,1.0,1,1.0,1,1.0,1,0.34787499397273525,44
2537,1,4023,2016,2007,0,0,0,1.0,1,1.0,1,1.0,1,0.3496116381320587,45
2538,1,4024,2016,2008,0,0,0,1.0,1,1.0,1,1.0,1,0.3331771369045829,48
2539,2,4026,2017,2009,0,0,0,1.0,1,1.0,1,1.0,1,0.3052873438476707,48
2540,1,4027,2017,2010,0,0,0,1.0,1,1.0,1,1.0,1,0.3113142065977364,50
2541,4,4031,2018,2013,0,0,0,1.0,1,1.0,1,1.0,1,0.2572779381526804,52
2542,6,4037,2022,2015,0,0,0,1.0,1,1.0,1,1.0,1,0.3106026533064059,52
2543,4,4041,2024,2017,0,0,0,1.0,1,1.0,1,1.0,1,0.30395726710152215,51
2544,6,4047,2029,2018,0,0,0,1.0,1,1.0,1,1.0,1,0.33590971809766573,51
2545,8,4055,2029,2026,0,0,0,1.0,1,1.0,1,1.0,1,0.2464238650689646,50
2546,1,4056,2030,2026,0,0,0,1.0,1,1.0,1,1.0,1,0.26203163626141607,50
2547,1,4057,2030,2027,0,0,0,1.0,1,1.0,1,1.0,1,0.24321399659721823,47
2548,0,4057,2030,2027,0,0,0,1.0,1,1.0,1,1.0,1,0.23114052966175785,46
2549,2,4059,2031,2028,0,0,0,1.0,1,1.0,1,1.0,1,0.24339017519689302,46
2550,2,4061,2033,2028,0,0,0,1.0,1,1.0,1,1.0,1,0.2604599209799299,44
2551,1,4062,2033,2029,0,0,0,1.0,1,1.0,1,1.0,1,0.2325239503540361,43
2552,0,4062,2033,2029,0,0,0,1.0,1,1.0,1,1.0,1,0.2555484395796434,43
2553,0,4062,2033,2029,0,0,0,1.0,1,1.0,1,1.0,1,0.2627075264711438,44
2554,2,4064,2035,2029,0,0,0,1.0,1,1.0,1,1.0,1,0.2756661233662558,45
2555,3,4067,2036,2031,0,0,0,1.0,1,1.0,1,1.0,1,0.28933398132388144,44
2556,3,4070,2036,2034,0,0,0,1.0,1,1.0,1,1.0,1,0.2409263257033872,44
2557,2,4072,2037,2035,0,0,0,1.0,1,1.0,1,1.0,1,0.24205050332376862,41
2558,0,4072,2037,2035,0,0,0,1.0,1,1.0,1,1.0,1,0.24919428571569582,40
2559,2,4074,2037,2037,0,0,0,1.0,1,1.0,1,1.0,1,0.23134706722411683,41
2560,0,4074,2037,2037,0,0,0,1.0,1,1.0,1,1.0,1,0.23134706722411683,41
2561,1,4075,2037,2038,0,0,0,1.0,1,1.0,1,1.0,1,0.23519604242458328,43
2562,0,4075,2037,2038,0,0,0,1.0,1,1.0,1,1.0,1,0.25095646135334476,44
2563,2,4077,2037,2040,0,0,0,1.0,1,1.0,1,1.0,1,0.22451015444888514,44
2564,1,4078,2038,2040,0,0,0,1.0,1,1.0,1,1.0,1,0.241236525857718,44
2565,0,4078,2038,2040,0,0,0,1.0,1,1.0,1,1.0,1,0.24160500941051888,45
2566,3,4081,2040,2041,0,0,0,1.0,1,1.0,1,1.0,1,0.2541257729747165,46
2567,3,4084,2041,2043,0,0,0,1.0,1,1.0,1,1.0,1,0.23942929489497325,48
2568,1,4085,2042,2043,0,0,0,1.0,1,1.0,1,1.0,1,0.2568205381409225,48
2569,1,4086,2042,2044,0,0,0,1.0,1,1.0,1,1.0,1,0.261692535882519,49
2570,0,4086,2042,2044,0,0,0,1.0,1,1.0,1,1.0,1,0.2793103485735416,48
2571,0,4086,2042,2044,0,0,0,1.0,1,1.0,1,1.0,1,0.2793103485735416,48
2572,1,4087,2042,2045,0,0,0,1.0,1,1.0,1,1.0,1,0.24647678454538025,49
2573,2,4089,2042,2047,0,0,0,1.0,1,1.0,1,1.0,1,0.2278209684760829,50
2574,2,4091,2043,2048,0,0,0,1.0,1,1.0,1,1.0,1,0.22746502502816546,49
2575,0,4091,2043,2048,0,0,0,1.0,1,1.0,1,1.0,1,0.2327871292610738,48
2576,0,4091,2043,2048,0,0,0,1.0,1,1.0,1,1.0,1,0.2327871292610738,48
2577,2,4093,2043,2050,0,0,0,1.0,1,1.0,1,1.0,1,0.21682699507486838,50
2578,0,4093,2043,2050,0,0,0,1.0,1,1.0,1,1.0,1,0.21682699507486838,50
2579,3,4096,2044,2052,0,0,0,1.0,1,1.0,1,1.0,1,0.19140580824237063,51
2580,1,4097,2045,2052,0,0,0,1.0,1,1.0,1,1.0,1,0.2146161943239578,52
2581,1,4098,2045,2053,0,0,0,1.0,1,1.0,1,1.0,1,0.21687402765830513,51
2582,1,4099,2046,2053,0,0,0,1.0,1,1.0,1,1.0,1,0.23286020661915946,51
2583,4,4103,2048,2055,0,0,0,1.0,1,1.0,1,1.0,1,0.21944982234717444,51
2584,2,4105,2050,2055,0,0,0,1.0,1,1.0,1,1.0,1,0.2528193228603415,51
2585,2,4107,2050,2057,0,0,0,1.0,1,1.0,1,1.0,1,0.2171105236646665,50
2586,3,4110,2053,2057,0,0,0,1.0,1,1.0,1,1.0,1,0.2567755596479204,50
2587,1,4111,2053,2058,0,0,0,1.0,1,1.0,1,1.0,1,0.22064159947326983,48
2588,7,4118,2055,2063,0,0,0,1.0,1,1.0,1,1.0,1,0.1803038423907345,50
2589,2,4120,2056,2064,0,0,0,1.0,1,1.0,1,1.0,1,0.13745489425309998,48
2590,0,4120,2056,2064,0,0,0,1.0,1,1.0,1,1.0,1,0.14570921830924344,47
2591,0,4120,2056,2064,0,0,0,1.0,1,1.0,1,1.0,1,0.14570921830924344,47
2592,2,4122,2057,2065,0,0,0,1.0,1,1.0,1,1.0,1,0.14885575239118806,47
2593,2,4124,2058,2066,0,0,0,1.0,1,1.0,1,1.0,1,0.1670373582968974,47
2594,3,4127,2061,2066,0,0,0,1.0,1,1.0,1,1.0,1,0.23522902430259024,49
2595,5,4132,2063,2069,0,0,0,1.0,1,1.0,1,1.0,1,0.19239523399635564,48
2596,3,4135,2065,2070,0,0,0,1.0,1,1.0,1,1.0,1,0.16429578403417022,47
2597,2,4137,2066,2071,0,0,0,1.0,1,1.0,1,1.0,1,0.12496647832172651,48
2598,2,4139,2068,2071,0,0,0,1.0,1,1.0,1,1.0,1,0.13049514582601107,48
2599,1,4140,2069,2071,0,0,0,1.0,1,1.0,1,1.0,1,0.1281660980510052,49
2600,0,4140,2069,2071,0,0,0,1.0,1,1.0,1,1.0,1,0.14231443474739308,52
2601,3,4143,2071,2072,0,0,0,1.0,1,1.0,1,1.0,1,0.17942741285366962,51
2602,1,4144,2072,2072,0,0,0,1.0,1,1.0,1,1.0,1,0.19707650338771307,52
2603,1,4145,2072,2073,0,0,0,1.0,1,1.0,1,1.0,1,0.20573334706980959,53
2604,1,4146,2072,2074,0,0,0,1.0,1,1.0,1,1.0,1,0.17650647528324917,53
2605,1,4147,2073,2074,0,0,0,1.0,1,1.0,1,1.0,1,0.21004646632802385,52
2606,1,4148,2073,2075,0,0,0,1.0,1,1.0,1,1.0,1,0.1982001295496043,52
2607,1,4149,2074,2075,0,0,0,1.0,1,1.0,1,1.0,1,0.227583603338778,52
2608,1,4150,2074,2076,0,0,0,1.0,1,1.0,1,1.0,1,0.211348721561352,52
2609,0,4150,2074,2076,0,0,0,1.0,1,1.0,1,1.0,1,0.21441435591678565,53
2610,3,4153,2075,2078,0,0,0,1.0,1,1.0,1,1.0,1,0.2066341136988802,54
2611,4,4157,2076,2081,0,0,0,1.0,1,1.0,1,1.0,1,0.12868440259552608,54
2612,1,4158,2077,2081,0,0,0,1.0,1,1.0,1,1.0,1,0.13977158985715848,56
2613,0,4158,2077,2081,0,0,0,1.0,1,1.0,1,1.0,1,0.13977158985715848,56
2614,1,4159,2078,2081,0,0,0,1.0,1,1.0,1,1.0,1,0.12858664073508044,56
2615,1,4160,2079,2081,0,0,0,1.0,1,1.0,1,1.0,1,0.13018070305597187,57
2616,0,4160,2079,2081,0,0,0,1.0,1,1.0,1,1.0,1,0.13018070305597187,57
2617,1,4161,2080,2081,0,0,0,1.0,1,1.0,1,1.0,1,0.1422999408320318,58
2618,0,4161,2080,2081,0,0,0,1.0,1,1.0,1,1.0,1,0.1422999408320318,58
2619,1,4162,2080,2082,0,0,0,1.0,1,1.0,1,1.0,1,0.12903034095044022,58
2620,1,4163,2080,2083,0,0,0,1.0,1,1.0,1,1.0,1,0.13765073860896557,60
2621,2,4165,2080,2085,0,0,0,1.0,1,1.0,1,1.0,1,0.1096782991126352,59
2622,2,4167,2082,2085,0,0,0,1.0,1,1.0,1,1.0,1,0.1270342899160797,60
2623,4,4171,2083,2088,0,0,0,1.0,1,1.0,1,1.0,1,0.12733839699619756,59
2624,4,4175,2087,2088,0,0,0,1.0,1,1.0,1,1.0,1,0.16495509357815358,58
2625,3,4178,2090,2088,0,0,0,1.0,1,1.0,1,1.0,1,0.1830796667590024,58
2626,3,4181,2092,2089,0,0,0,1.0,1,1.0,1,1.0,1,0.18761901735051448,57
2627,3,4184,2093,2091,0,0,0,1.0,1,1.0,1,1.0,1,0.1323906053115301,55
2628,2,4186,2095,2091,0,0,0,1.0,1,1.0,1,1.0,1,0.15364098276259822,55
2629,0,4186,2095,2091,0,0,0,1.0,1,1.0,1,1.0,1,0.1351208943321697,54
2630,1,4187,2096,2091,0,0,0,1.0,1,1.0,1,1.0,1,0.19137738861819234,55
2631,0,4187,2096,2091,0,0,0,1.0,1,1.0,1,1.0,1,0.18608436869889983,55
2632,2,4189,2098,2091,0,0,0,1.0,1,1.0,1,1.0,1,0.23063319464076137,55
2633,2,4191,2099,2092,0,0,0,1.0,1,1.0,1,1.0,1,0.2270556971116912,53
2634,4,4195,2101,2094,0,0,0,1.0,1,1.0,1,1.0,1,0.2212876328083294,52
2635,3,4198,2102,2096,0,0,0,1.0,1,1.0,1,1.0,1,0.21890628938352452,52
2636,3,4201,2104,2097,0,0,0,1.0,1,1.0,1,1.0,1,0.271722021529289,51
2637,3,4204,2106,2098,0,0,0,1.0,1,1.0,1,1.0,1,0.24080695608615402,50
2638,4,4208,2109,2099,0,0,0,1.0,1,1.0,1,1.0,1,0.2586285748851925,48
2639,4,4212,2112,2100,0,0,0,1.0,1,1.0,1,1.0,1,0.28615502981696167,48
2640,9,4221,2116,2105,0,0,0,1.0,1,1.0,1,1.0,1,0.21333031910423048,46
2641,2,4223,2117,2106,0,0,0,1.0,1,1.0,1,1.0,1,0.19858921177182792,46
2642,5,4228,2120,2108,0,0,0,1.0,1,1.0,1,1.0,1,0.17265484710539883,47
2643,0,4228,2120,2108,0,0,0,1.0,1,1.0,1,1.0,1,0.18929195342012445,45
2644,1,4229,2121,2108,0,0,0,1.0,1,1.0,1,1.0,1,0.19946720458268996,44
2645,0,4229,2121,2108,0,0,0,1.0,1,1.0,1,1.0,1,0.21159854260487942,42
2646,2,4231,2122,2109,0,0,0,1.0,1,1.0,1,1.0,1,0.20069231320244682,43
2647,0,4231,2122,2109,0,0,0,1.0,1,1.0,1,1.0,1,0.19316970160366873,40
2648,1,4232,2123,2109,0,0,0,1.0,1,1.0,1,1.0,1,0.129101127121964,41
2649,2,4234,2123,2111,0,0,0,1.0,1,1.0,1,1.0,1,0.1037135559893599,43
2650,0,4234,2123,2111,0,0,0,1.0,1,1.0,1,1.0,1,0.1091189238474891,43
2651,0,4234,2123,2111,0,0,0,1.0,1,1.0,1,1.0,1,0.09621959314122737,44
2652,1,4235,2124,2111,0,0,0,1.0,1,1.0,1,1.0,1,0.09380420710339395,44
2653,0,4235,2124,2111,0,0,0,1.0,1,1.0,1,1.0,1,0.09380420710339395,44
2654,2,4237,2126,2111,0,0,0,1.0,1,1.0,1,1.0,1,0.13998497130532633,45
2655,1,4238,2127,2111,0,0,0,1.0,1,1.0,1,1.0,1,0.16234773614179257,45
2656,0,4238,2127,2111,0,0,0,1.0,1,1.0,1,1.0,1,0.16234773614179257,45
2657,2,4240,2127,2113,0,0,0,1.0,1,1.0,1,1.0,1,0.14017187768785583,45
2658,3,4243,2129,2114,0,0,0,1.0,1,1.0,1,1.0,1,0.15375030997160746,47
2659,1,4244,2129,2115,0,0,0,1.0,1,1.0,1,1.0,1,0.1493713578363734,46
2660,1,4245,2130,2115,0,0,0,1.0,1,1.0,1,1.0,1,0.17300567238616293,46
2661,4,4249,2131,2118,0,0,0,1.0,1,1.0,1,1.0,1,0.16743260534413543,46
2662,0,4249,2131,2118,0,0,0,1.0,1,1.0,1,1.0,1,0.18011800411798123,47
2663,3,4252,2134,2118,0,0,0,1.0,1,1.0,1,1.0,1,0.1977154285642205,46
2664,3,4255,2137,2118,0,0,0,1.0,1,1.0,1,1.0,1,0.2128685129261433,45
2665,4,4259,2139,2120,0,0,0,1.0,1,1.0,1,1.0,1,0.1998752607134546,47
2666,4,4263,2143,2120,0,0,0,1.0,1,1.0,1,1.0,1,0.21079503702876615,47
2667,6,4269,2145,2124,0,0,0,1.0,1,1.0,1,1.0,1,0.16847044379630846,45
2668,3,4272,2147,2125,0,0,0,1.0,1,1.0,1,1.0,1,0.16612832874982275,45
2669,1,4273,2148,2125,0,0,0,1.0,1,1.0,1,1.0,1,0.13653094042736094,45
2670,4,4277,2151,2126,0,0,0,1.0,1,1.0,1,1.0,1,0.1788326021184677,45
2671,0,4277,2151,2126,0,0,0,1.0,1,1.0,1,1.0,1,0.17307455713229516,41
2672,1,4278,2152,2126,0,0,0,1.0,1,1.0,1,1.0,1,0.21331978320414507,40
2673,0,4278,2152,2126,0,0,0,1.0,1,1.0,1,1.0,1,0.23431934507473995,39
2674,2,4280,2153,2127,0,0,0,1.0,1,1.0,1,1.0,1,0.25683482510074607,37
2675,2,4282,2155,2127,0,0,0,1.0,1,1.0,1,1.0,1,0.27306786407993855,35
2676,1,4283,2156,2127,0,0,0,1.0,1,1.0,1,1.0,1,0.27103449762944354,34
2677,4,4287,2159,2128,0,0,0,1.0,1,1.0,1,1.0,1,0.2420440278764758,32
2678,1,4288,2160,2128,0,0,0,1.0,1,1.0,1,1.0,1,0.24185937325623424,33
2679,1,4289,2161,2128,0,0,0,1.0,1,1.0,1,1.0,1,0.2909528713961212,33
2680,7,4296,2165,2131,0,0,0,1.0,1,1.0,1,1.0,1,0.26654122432419114,33
2681,2,4298,2166,2132,0,0,0,1.0,1,1.0,1,1.0,1,0.20129575026269161,32
2682,0,4298,2166,2132,0,0,0,1.0,1,1.0,1,1.0,1,0.20129575026269161,32
2683,1,4299,2167,2132,0,0,0,1.0,1,1.0,1,1.0,1,0.2931194610795447,32
2684,1,4300,2167,2133,0,0,0,1.0,1,1.0,1,1.0,1,0.2574489534819917,31
2685,2,4302,2168,2134,0,0,0,1.0,1,1.0,1,1.0,1,0.2988941526180327,30
2686,3,4305,2169,2136,0,0,0,1.0,1,1.0,1,1.0,1,0.25888813850590947,29
2687,0,4305,2169,2136,0,0,0,1.0,1,1.0,1,1.0,1,0.2498678406006606,28
2688,0,4305,2169,2136,0,0,0,1.0,1,1.0,1,1.0,1,0.2498678406006606,28
2689,1,4306,2169,2137,0,0,0,1.0,1,1.0,1,1.0,1,0.2419555024326312,29
2690,1,4307,2169,2138,0,0,0,1.0,1,1.0,1,1.0,1,0.21621645974507536,29
2691,2,4309,2171,2138,0,0,0,1.0,1,1.0,1,1.0,1,0.24024671555485114,29
2692,1,4310,2171,2139,0,0,0,1.0,1,1.0,1,1.0,1,0.22976948463974442,31
2693,2,4312,2173,2139,0,0,0,1.0,1,1.0,1,1.0,1,0.3026953879749553,32
2694,3,4315,2174,2141,0,0,0,1.0,1,1.0,1,1.0,1,0.24730914981937646,32
2695,1,4316,2174,2142,0,0,0,1.0,1,1.0,1,1.0,1,0.20928010041089481,33
2696,0,4316,2174,2142,0,0,0,1.0,1,1.0,1,1.0,1,0.20928010041089481,33
2697,1,4317,2175,2142,0,0,0,1.0,1,1.0,1,1.0,1,0.23124375276792447,34
2698,2,4319,2177,2142,0,0,0,1.0,1,1.0,1,1.0,1,0.23254768881192725,34
2699,3,4322,2178,2144,0,0,0,1.0,1,1.0,1,1.0,1,0.17940210795059666,36
2700,1,4323,2178,2145,0,0,0,1.0,1,1.0,1,1.0,1,0.167273170973846,36
2701,0,4323,2178,2145,0,0,0,1.0,1,1.0,1,1.0,1,0.167273170973846,36
2702,1,4324,2179,2145,0,0,0,1.0,1,1.0,1,1.0,1,0.19869390101727497,36
2703,2,4326,2180,2146,0,0,0,1.0,1,1.0,1,1.0,1,0.1809108078573322,38
2704,1,4327,2181,2146,0,0,0,1.0,1,1.0,1,1.0,1,0.2340898239932903,37
2705,3,4330,2183,2147,0,0,0,1.0,1,1.0,1,1.0,1,0.2164131201856775,36
2706,2,4332,2185,2147,0,0,0,1.0,1,1.0,1,1.0,1,0.2646285747216507,34
2707,2,4334,2186,2148,0,0,0,1.0,1,1.0,1,1.0,1,0.2799227642011975,36
2708,3,4337,2189,2148,0,0,0,1.0,1,1.0,1,1.0,1,0.2924625316499505,36
2709,3,4340,2191,2149,0,0,0,1.0,1,1.0,1,1.0,1,0.2767281054387036,33
2710,1,4341,2192,2149,0,0,0,1.0,1,1.0,1,1.0,1,0.2975873018052249,32
2711,1,4342,2193,2149,0,0,0,1.0,1,1.0,1,1.0,1,0.26909797448227596,29
2712,1,4343,2194,2149,0,0,0,1.0,1,1.0,1,1.0,1,0.32044069640734474,28
2713,1,4344,2194,2150,0,0,0,1.0,1,1.0,1,1.0,1,0.2903454934716419,28
2714,2,4346,2196,2150,0,0,0,1.0,1,1.0,1,1.0,1,0.3719032352244706,25
2715,1,4347,2197,2150,0,0,0,1.0,1,1.0,1,1.0,1,0.4158046667838083,24
2716,4,4351,2199,2152,0,0,0,1.0,1,1.0,1,1.0,1,0.4503797924087736,23
2717,5,4356,2200,2156,0,0,0,1.0,1,1.0,1,1.0,1,0.2513497996262381,24
2718,0,4356,2200,2156,0,0,0,1.0,1,1.0,1,1.0,1,0.2513497996262381,24
2719,1,4357,2200,2157,0,0,0,1.0,1,1.0,1,1.0,1,0.1765716404094369,25
2720,2,4359,2202,2157,0,0,0,1.0,1,1.0,1,1.0,1,0.1941503394561623,25
2721,2,4361,2204,2157,0,0,0,1.0,1,1.0,1,1.0,1,0.1943024835199038,26
2722,1,4362,2205,2157,0,0,0,1.0,1,1.0,1,1.0,1,0.2395557804447823,26
2723,1,4363,2206,2157,0,0,0,1.0,1,1.0,1,1.0,1,0.2209370924215747,26
2724,2,4365,2207,2158,0,0,0,1.0,1,1.0,1,1.0,1,0.24788059171691146,27
2725,1,4366,2208,2158,0,0,0,1.0,1,1.0,1,1.0,1,0.2466147770005152,27
2726,1,4367,2208,2159,0,0,0,1.0,1,1.0,1,1.0,1,0.20015678160127143,28
2727,0,4367,2208,2159,0,0,0,1.0,1,1.0,1,1.0,1,0.1814566971066818,29
2728,0,4367,2208,2159,0,0,0,1.0,1,1.0,1,1.0,1,0.17441422663121284,28
2729,0,4367,2208,2159,0,0,0,1.0,1,1.0,1,1.0,1,0.17441422663121284,28
2730,0,4367,2208,2159,0,0,0,1.0,1,1.0,1,1.0,1,0.1739987044106776,29
2731,1,4368,2209,2159,0,0,0,1.0,1,1.0,1,1.0,1,0.2420637408706149,30
2732,2,4370,2210,2160,0,0,0,1.0,1,1.0,1,1.0,1,0.22836118896111965,29
2733,0,4370,2210,2160,0,0,0,1.0,1,1.0,1,1.0,1,0.22836118896111965,29
2734,0,4370,2210,2160,0,0,0,1.0,1,1.0,1,1.0,1,0.22836118896111965,29
2735,1,4371,2211,2160,0,0,0,1.0,1,1.0,1,1.0,1,0.27760065646859655,29
2736,2,4373,2211,2162,0,0,0,1.0,1,1.0,1,1.0,1,0.2533036570183413,30
2737,0,4373,2211,2162,0,0,0,1.0,1,1.0,1,1.0,1,0.2533036570183413,30
2738,3,4376,2214,2162,0,0,0,1.0,1,1.0,1,1.0,1,0.3032540300505116,29
2739,0,4376,2214,2162,0,0,0,1.0,1,1.0,1,1.0,1,0.3113512485634911,30
2740,1,4377,2215,2162,0,0,0,1.0,1,1.0,1,1.0,1,0.3413311245831581,29
2741,3,4380,2216,2164,0,0,0,1.0,1,1.0,1,1.0,1,0.317994197830756,29
2742,2,4382,2217,2165,0,0,0,1.0,1,1.0,1,1.0,1,0.3142781873289887,29
2743,1,4383,2217,2166,0,0,0,1.0,1,1.0,1,1.0,1,0.32312658654593635,30
2744,3,4386,2219,2167,0,0,0,1.0,1,1.0,1,1.0,1,0.38222712851995605,28
2745,2,4388,2219,2169,0,0,0,1.0,1,1.0,1,1.0,1,0.29668764345524634,27
2746,1,4389,2220,2169,0,0,0,1.0,1,1.0,1,1.0,1,0.37257119612161776,26
2747,1,4390,2221,2169,0,0,0,1.0,1,1.0,1,1.0,1,0.4216514829729579,22
2748,2,4392,2221,2171,0,0,0,1.0,1,1.0,1,1.0,1,0.4062478732446464,22
2749,0,4392,2221,2171,0,0,0,1.0,1,1.0,1,1.0,1,0.4655328213286483,20
2750,0,4392,2221,2171,0,0,0,1.0,1,1.0,1,1.0,1,0.5011057179364303,17
2751,1,4393,2221,2172,0,0,0,1.0,1,1.0,1,1.0,1,0.45823724172292896,17
2752,0,4393,2221,2172,0,0,0,1.0,1,1.0,1,1.0,1,0.426714775987809,16
2753,0,4393,2221,2172,0,0,0,1.0,1,1.0,1,1.0,1,0.426714775987809,16
2754,1,4394,2222,2172,0,0,0,1.0,1,1.0,1,1.0,1,0.4469296026397662,16
2755,1,4395,2223,2172,0,0,0,1.0,1,1.0,1,1.0,1,0.4960399399861568,16
2756,1,4396,2223,2173,0,0,0,1.0,1,1.0,1,1.0,1,0.5014093572675358,17
2757,1,4397,2224,2173,0,0,0,1.0,1,1.0,1,1.0,1,0.4549566615714481,18
2758,0,4397,2224,2173,0,0,0,1.0,1,1.0,1,1.0,1,0.4549566615714481,18
2759,0,4397,2224,2173,0,0,0,1.0,1,1.0,1,1.0,1,0.47433393889312697,19
2760,0,4397,2224,2173,0,0,0,1.0,1,1.0,1,1.0,1,0.4436917171309933,18
2761,0,4397,2224,2173,0,0,0,1.0,1,1.0,1,1.0,1,0.4436917171309933,18
2762,0,4397,2224,2173,0,0,0,1.0,1,1.0,1,1.0,1,0.4436917171309933,18
2763,0,4397,2224,2173,0,0,0,1.0,1,1.0,1,1.0,1,0.4436917171309933,18
2764,1,4398,2225,2173,0,0,0,1.0,1,1.0,1,1.0,1,0.4291154554863579,18
2765,1,4399,2226,2173,0,0,0,1.0,1,1.0,1,1.0,1,0.4474066872903091,18
2766,0,4399,2226,2173,0,0,0,1.0,1,1.0,1,1.0,1,0.4474066872903091,18
2767,0,4399,2226,2173,0,0,0,1.0,1,1.0,1,1.0,1,0.4797576406442102,17
2768,0,4399,2226,2173,0,0,0,1.0,1,1.0,1,1.0,1,0.4797576406442102,17
2769,1,4400,2227,2173,0,0,0,1.0,1,1.0,1,1.0,1,0.4797576406442102,17
2770,0,4400,2227,2173,0,0,0,1.0,1,1.0,1,1.0,1,0.4797576406442102,17
2771,0,4400,2227,2173,0,0,0,1.0,1,1.0,1,1.0,1,0.4797576406442102,17
2772,1,4401,2227,2174,0,0,0,1.0,1,1.0,1,1.0,1,0.44066876847835545,17
2773,0,4401,2227,2174,0,0,0,1.0,1,1.0,1,1.0,1,0.44066876847835545,17
2774,0,4401,2227,2174,0,0,0,1.0,1,1.0,1,1.0,1,0.3946141296434338,18
2775,2,4403,2229,2174,0,0,0,1.0,1,1.0,1,1.0,1,0.41950639268877726,20
2776,0,4403,2229,2174,0,0,0,1.0,1,1.0,1,1.0,1,0.4046531399926829,21
2777,1,4404,2230,2174,0,0,0,1.0,1,1.0,1,1.0,1,0.43286927301831446,21
2778,3,4407,2231,2176,0,0,0,1.0,1,1.0,1,1.0,1,0.39361230847788703,21
2779,1,4408,2232,2176,0,0,0,1.0,1,1.0,1,1.0,1,0.4118520659610158,22
2780,0,4408,2232,2176,0,0,0,1.0,1,1.0,1,1.0,1,0.4118520659610158,22
2781,3,4411,2233,2178,0,0,0,1.0,1,1.0,1,1.0,1,0.40248112250491896,22
2782,3,4414,2234,2180,0,0,0,1.0,1,1.0,1,1.0,1,0.26226482904671544,23
2783,0,4414,2234,2180,0,0,0,1.0,1,1.0,1,1.0,1,0.2340269050975456,22
2784,3,4417,2236,2181,0,0,0,1.0,1,1.0,1,1.0,1,0.3137411889056041,21
2785,0,4417,2236,2181,0,0,0,1.0,1,1.0,1,1.0,1,0.31592140984364875,19
2786,0,4417,2236,2181,0,0,0,1.0,1,1.0,1,1.0,1,0.31592140984364875,19
2787,0,4417,2236,2181,0,0,0,1.0,1,1.0,1,1.0,1,0.3043618417881258,20
2788,1,4418,2237,2181,0,0,0,1.0,1,1.0,1,1.0,1,0.3282487404324746,20
2789,0,4418,2237,2181,0,0,0,1.0,1,1.0,1,1.0,1,0.33900103423380684,19
2790,0,4418,2237,2181,0,0,0,1.0,1,1.0,1,1.0,1,0.33180551134194375,20
2791,0,4418,2237,2181,0,0,0,1.0,1,1.0,1,1.0,1,0.33180551134194375,20
2792,0,4418,2237,2181,0,0,0,1.0,1,1.0,1,1.0,1,0.33180551134194375,20
2793,0,4418,2237,2181,0,0,0,1.0,1,1.0,1,1.0,1,0.3686690959064954,19
2794,0,4418,2237,2181,0,0,0,1.0,1,1.0,1,1.0,1,0.38820884191650684,20
2795,0,4418,2237,2181,0,0,0,1.0,1,1.0,1,1.0,1,0.3947334673291431,21
2796,0,4418,2237,2181,0,0,0,1.0,1,1.0,1,1.0,1,0.37992021838044465,22
2797,0,4418,2237,2181,0,0,0,1.0,1,1.0,1,1.0,1,0.4235973272756897,21
2798,1,4419,2238,2181,0,0,0,1.0,1,1.0,1,1.0,1,0.4768984102699198,21
2799,1,4420,2238,2182,0,0,0,1.0,1,1.0,1,1.0,1,0.4125366137394858,20
2800,0,4420,2238,2182,0,0,0,1.0,1,1.0,1,1.0,1,0.4125366137394858,20
2801,0,4420,2238,2182,0,0,0,1.0,1,1.0,1,1.0,1,0.4125366137394858,20
2802,1,4421,2238,2183,0,0,0,1.0,1,1.0,1,1.0,1,0.356509999243963,20
2803,0,4421,2238,2183,0,0,0,1.0,1,1.0,1,1.0,1,0.3601660025157347,21
2804,1,4422,2238,2184,0,0,0,1.0,1,1.0,1,1.0,1,0.32470210143780787,22
2805,1,4423,2239,2184,0,0,0,1.0,1,1.0,1,1.0,1,0.2923637989041192,22
2806,1,4424,2239,2185,0,0,0,1.0,1,1.0,1,1.0,1,0.2553355234461961,23
2807,4,4428,2242,2186,0,0,0,1.0,1,1.0,1,1.0,1,0.3474243227513792,24
2808,2,4430,2244,2186,0,0,0,1.0,1,1.0,1,1.0,1,0.40737107095699215,24
2809,4,4434,2244,2190,0,0,0,1.0,1,1.0,1,1.0,1,0.24673931709522517,26
2810,1,4435,2244,2191,0,0,0,1.0,1,1.0,1,1.0,1,0.16427112637099872,26
2811,0,4435,2244,2191,0,0,0,1.0,1,1.0,1,1.0,1,0.17626652496121742,27
2812,0,4435,2244,2191,0,0,0,1.0,1,1.0,1,1.0,1,0.17626652496121742,27
2813,0,4435,2244,2191,0,0,0,1.0,1,1.0,1,1.0,1,0.16688368279537363,28
2814,1,4436,2245,2191,0,0,0,1.0,1,1.0,1,1.0,1,0.2317459092410119,29
2815,0,4436,2245,2191,0,0,0,1.0,1,1.0,1,1.0,1,0.23668077783053948,30
2816,1,4437,2246,2191,0,0,0,1.0,1,1.0,1,1.0,1,0.2348440953981627,31
2817,0,4437,2246,2191,0,0,0,1.0,1,1.0,1,1.0,1,0.2348440953981627,31
2818,3,4440,2247,2193,0,0,0,1.0,1,1.0,1,1.0,1,0.1888518192987865,32
2819,0,4440,2247,2193,0,0,0,1.0,1,1.0,1,1.0,1,0.1888518192987865,32
2820,0,4440,2247,2193,0,0,0,1.0,1,1.0,1,1.0,1,0.20032006106717837,33
2821,0,4440,2247,2193,0,0,0,1.0,1,1.0,1,1.0,1,0.2205509030440399,34
2822,1,4441,2248,2193,0,0,0,1.0,1,1.0,1,1.0,1,0.23136569608517993,35
2823,1,4442,2249,2193,0,0,0,1.0,1,1.0,1,1.0,1,0.21970359618452825,31
2824,3,4445,2251,2194,0,0,0,1.0,1,1.0,1,1.0,1,0.3313635292037047,33
2825,1,4446,2251,2195,0,0,0,1.0,1,1.0,1,1.0,1,0.26467551126467437,31
2826,1,4447,2252,2195,0,0,0,1.0,1,1.0,1,1.0,1,0.3151551787547688,31
2827,4,4451,2254,2197,0,0,0,1.0,1,1.0,1,1.0,1,0.2597969992789147,32
2828,3,4454,2255,2199,0,0,0,1.0,1,1.0,1,1.0,1,0.2869278747636457,33
2829,5,4459,2257,2202,0,0,0,1.0,1,1.0,1,1.0,1,0.26428336876411057,33
2830,0,4459,2257,2202,0,0,0,1.0,1,1.0,1,1.0,1,0.25195937278220737,32
2831,1,4460,2258,2202,0,0,0,1.0,1,1.0,1,1.0,1,0.28388779466483927,31
2832,2,4462,2260,2202,0,0,0,1.0,1,1.0,1,1.0,1,0.3115238970508998,30
2833,4,4466,2262,2204,0,0,0,1.0,1,1.0,1,1.0,1,0.2881020565448298,29
2834,4,4470,2265,2205,0,0,0,1.0,1,1.0,1,1.0,1,0.31608489312817417,29
2835,3,4473,2267,2206,0,0,0,1.0,1,1.0,1,1.0,1,0.28421563456855053,27
2836,0,4473,2267,2206,0,0,0,1.0,1,1.0,1,1.0,1,0.2527073896033282,27
2837,0,4473,2267,2206,0,0,0,1.0,1,1.0,1,1.0,1,0.26485615964190473,28
2838,1,4474,2268,2206,0,0,0,1.0,1,1.0,1,1.0,1,0.3117905143335374,29
2839,1,4475,2268,2207,0,0,0,1.0,1,1.0,1,1.0,1,0.24936979614540383,29
2840,0,4475,2268,2207,0,0,0,1.0,1,1.0,1,1.0,1,0.24936979614540383,29
2841,1,4476,2269,2207,0,0,0,1.0,1,1.0,1,1.0,1,0.24544637455245152,31
2842,1,4477,2269,2208,0,0,0,1.0,1,1.0,1,1.0,1,0.2293056115508241,32
2843,0,4477,2269,2208,0,0,0,1.0,1,1.0,1,1.0,1,0.2293056115508241,32
2844,0,4477,2269,2208,0,0,0,1.0,1,1.0,1,1.0,1,0.25647037318400523,33
2845,2,4479,2271,2208,0,0,0,1.0,1,1.0,1,1.0,1,0.280502836353562,34
2846,2,4481,2272,2209,0,0,0,1.0,1,1.0,1,1.0,1,0.27128420897534494,34
2847,0,4481,2272,2209,0,0,0,1.0,1,1.0,1,1.0,1,0.2703054547692608,35
2848,3,4484,2273,2211,0,0,0,1.0,1,1.0,1,1.0,1,0.2561817087000265,37
2849,1,4485,2274,2211,0,0,0,1.0,1,1.0,1,1.0,1,0.30426379448186275,37
2850,1,4486,2275,2211,0,0,0,1.0,1,1.0,1,1.0,1,0.2981006362057858,37
2851,3,4489,2276,2213,0,0,0,1.0,1,1.0,1,1.0,1,0.2638278808791476,38
2852,1,4490,2277,2213,0,0,0,1.0,1,1.0,1,1.0,1,0.2755391473932834,36
2853,1,4491,2277,2214,0,0,0,1.0,1,1.0,1,1.0,1,0.2792943832348486,36
2854,1,4492,2277,2215,0,0,0,1.0,1,1.0,1,1.0,1,0.29031884677842795,37
2855,1,4493,2277,2216,0,0,0,1.0,1,1.0,1,1.0,1,0.2929426682584186,37
2856,2,4495,2277,2218,0,0,0,1.0,1,1.0,1,1.0,1,0.22186405143529142,38
2857,1,4496,2278,2218,0,0,0,1.0,1,1.0,1,1.0,1,0.28432722370868263,39
2858,2,4498,2278,2220,0,0,0,1.0,1,1.0,1,1.0,1,0.24737242380972319,39
2859,0,4498,2278,2220,0,0,0,1.0,1,1.0,1,1.0,1,0.24737242380972319,39
2860,1,4499,2279,2220,0,0,0,1.0,1,1.0,1,1.0,1,0.2456633014507187,40
2861,2,4501,2280,2221,0,0,0,1.0,1,1.0,1,1.0,1,0.16210954310152736,38
2862,5,4506,2285,2221,0,0,0,1.0,1,1.0,1,1.0,1,0.24997392421171705,38
2863,3,4509,2286,2223,0,0,0,1.0,1,1.0,1,1.0,1,0.18962732940229635,37
2864,4,4513,2290,2223,0,0,0,1.0,1,1.0,1,1.0,1,0.24076689288267092,35
2865,2,4515,2291,2224,0,0,0,1.0,1,1.0,1,1.0,1,0.23850371383705643,33
2866,2,4517,2292,2225,0,0,0,1.0,1,1.0,1,1.0,1,0.2363478989295248,31
2867,3,4520,2294,2226,0,0,0,1.0,1,1.0,1,1.0,1,0.25684037935361226,30
2868,1,4521,2295,2226,0,0,0,1.0,1,1.0,1,1.0,1,0.2923735600740542,31
2869,5,4526,2298,2228,0,0,0,1.0,1,1.0,1,1.0,1,0.3509985473721221,30
2870,0,4526,2298,2228,0,0,0,1.0,1,1.0,1,1.0,1,0.3346765728622334,26
2871,2,4528,2299,2229,0,0,0,1.0,1,1.0,1,1.0,1,0.37357659358998935,27
2872,0,4528,2299,2229,0,0,0,1.0,1,1.0,1,1.0,1,0.354959497098749,25
2873,0,4528,2299,2229,0,0,0,1.0,1,1.0,1,1.0,1,0.3453370276786603,24
2874,1,4529,2299,2230,0,0,0,1.0,1,1.0,1,1.0,1,0.28713157667828176,25
2875,1,4530,2300,2230,0,0,0,1.0,1,1.0,1,1.0,1,0.3230915069428174,26
2876,2,4532,2301,2231,0,0,0,1.0,1,1.0,1,1.0,1,0.33527623509868104,28
2877,0,4532,2301,2231,0,0,0,1.0,1,1.0,1,1.0,1,0.33524067328573676,29
2878,1,4533,2301,2232,0,0,0,1.0,1,1.0,1,1.0,1,0.30976702657232785,31
2879,1,4534,2301,2233,0,0,0,1.0,1,1.0,1,1.0,1,0.26371095639313774,31
2880,1,4535,2301,2234,0,0,0,1.0,1,1.0,1,1.0,1,0.22482219395147926,32
2881,0,4535,2301,2234,0,0,0,1.0,1,1.0,1,1.0,1,0.24881289563123973,31
2882,0,4535,2301,2234,0,0,0,1.0,1,1.0,1,1.0,1,0.24881289563123973,31
2883,1,4536,2301,2235,0,0,0,1.0,1,1.0,1,1.0,1,0.2503150843472073,32
2884,1,4537,2302,2235,0,0,0,1.0,1,1.0,1,1.0,1,0.25877947645676186,32
2885,3,4540,2303,2237,0,0,0,1.0,1,1.0,1,1.0,1,0.20743016257652022,33
2886,3,4543,2305,2238,0,0,0,1.0,1,1.0,1,1.0,1,0.20014232960063152,34
2887,0,4543,2305,2238,0,0,0,1.0,1,1.0,1,1.0,1,0.214533849649411,34
2888,2,4545,2307,2238,0,0,0,1.0,1,1.0,1,1.0,1,0.22871228026259574,34
2889,4,4549,2308,2241,0,0,0,1.0,1,1.0,1,1.0,1,0.1763155125407285,37
2890,0,4549,2308,2241,0,0,0,1.0,1,1.0,1,1.0,1,0.1763155125407285,37
2891,1,4550,2309,2241,0,0,0,1.0,1,1.0,1,1.0,1,0.2153483896096462,37
2892,0,4550,2309,2241,0,0,0,1.0,1,1.0,1,1.0,1,0.2153483896096462,37
2893,1,4551,2310,2241,0,0,0,1.0,1,1.0,1,1.0,1,0.24204210427051526,38
2894,2,4553,2310,2243,0,0,0,1.0,1,1.0,1,1.0,1,0.21439817036775424,39
2895,0,4553,2310,2243,0,0,0,1.0,1,1.0,1,1.0,1,0.1978064794971798,40
2896,1,4554,2311,2243,0,0,0,1.0,1,1.0,1,1.0,1,0.22188262348214213,41
2897,1,4555,2312,2243,0,0,0,1.0,1,1.0,1,1.0,1,0.22871223425096382,41
2898,3,4558,2314,2244,0,0,0,1.0,1,1.0,1,1.0,1,0.23293316967476152,41
2899,2,4560,2315,2245,0,0,0,1.0,1,1.0,1,1.0,1,0.199095200248521,39
2900,4,4564,2318,2246,0,0,0,1.0,1,1.0,1,1.0,1,0.31343489536973457,40
2901,1,4565,2318,2247,0,0,0,1.0,1,1.0,1,1.0,1,0.2662999946107699,40
2902,2,4567,2319,2248,0,0,0,1.0,1,1.0,1,1.0,1,0.2911609272888805,38
2903,0,4567,2319,2248,0,0,0,1.0,1,1.0,1,1.0,1,0.2599584424271033,36
2904,1,4568,2320,2248,0,0,0,1.0,1,1.0,1,1.0,1,0.29530555284936594,36
2905,1,4569,2321,2248,0,0,0,1.0,1,1.0,1,1.0,1,0.2883862432652724,35
2906,1,4570,2321,2249,0,0,0,1.0,1,1.0,1,1.0,1,0.27218465287774146,36
2907,2,4572,2322,2250,0,0,0,1.0,1,1.0,1,1.0,1,0.3084328298079318,37
2908,1,4573,2323,2250,0,0,0,1.0,1,1.0,1,1.0,1,0.33525195913032024,38
2909,0,4573,2323,2250,0,0,0,1.0,1,1.0,1,1.0,1,0.32540150860548844,37
2910,1,4574,2323,2251,0,0,0,1.0,1,1.0,1,1.0,1,0.30397206282257855,37
2911,0,4574,2323,2251,0,0,0,1.0,1,1.0,1,1.0,1,0.3134802218962122,36
2912,4,4578,2325,2253,0,0,0,1.0,1,1.0,1,1.0,1,0.32868864060474084,36
2913,2,4580,2326,2254,0,0,0,1.0,1,1.0,1,1.0,1,0.2946219926486665,36
2914,1,4581,2327,2254,0,0,0,1.0,1,1.0,1,1.0,1,0.33141850028764436,38
2915,1,4582,2327,2255,0,0,0,1.0,1,1.0,1,1.0,1,0.28666889109149996,37
2916,2,4584,2327,2257,0,0,0,1.0,1,1.0,1,1.0,1,0.2595335534562335,39
2917,3,4587,2328,2259,0,0,0,1.0,1,1.0,1,1.0,1,0.2251155101330629,40
2918,3,4590,2331,2259,0,0,0,1.0,1,1.0,1,1.0,1,0.23278984607164985,40
2919,2,4592,2332,2260,0,0,0,1.0,1,1.0,1,1.0,1,0.21290527395718178,42
2920,0,4592,2332,2260,0,0,0,1.0,1,1.0,1,1.0,1,0.21290527395718178,42
2921,0,4592,2332,2260,0,0,0,1.0,1,1.0,1,1.0,1,0.21290527395718178,42
2922,0,4592,2332,2260,0,0,0,1.0,1,1.0,1,1.0,1,0.19342093504261923,43
2923,1,4593,2332,2261,0,0,0,1.0,1,1.0,1,1.0,1,0.18971730226986055,45
2924,1,4594,2333,2261,0,0,0,1.0,1,1.0,1,1.0,1,0.19702777653642495,46
2925,1,4595,2333,2262,0,0,0,1.0,1,1.0,1,1.0,1,0.18586415828774253,46
2926,0,4595,2333,2262,0,0,0,1.0,1,1.0,1,1.0,1,0.18586415828774253,46
2927,2,4597,2334,2263,0,0,0,1.0,1,1.0,1,1.0,1,0.17393004954669833,48
2928,2,4599,2336,2263,0,0,0,1.0,1,1.0,1,1.0,1,0.20122474299996243,48
2929,0,4599,2336,2263,0,0,0,1.0,1,1.0,1,1.0,1,0.20122474299996243,48
2930,1,4600,2336,2264,0,0,0,1.0,1,1.0,1,1.0,1,0.20568842736472173,50
2931,1,4601,2337,2264,0,0,0,1.0,1,1.0,1,1.0,1,0.24208322239856236,51
2932,0,4601,2337,2264,0,0,0,1.0,1,1.0,1,1.0,1,0.2479153466851085,52
2933,3,4604,2337,2267,0,0,0,1.0,1,1.0,1,1.0,1,0.20859884749026142,53
2934,2,4606,2338,2268,0,0,0,1.0,1,1.0,1,1.0,1,0.22145915028268,54
2935,1,4607,2339,2268,0,0,0,1.0,1,1.0,1,1.0,1,0.23159480391985643,53
2936,0,4607,2339,2268,0,0,0,1.0,1,1.0,1,1.0,1,0.23159480391985643,53
2937,1,4608,2340,2268,0,0,0,1.0,1,1.0,1,1.0,1,0.2597580882800682,51
2938,4,4612,2342,2270,0,0,0,1.0,1,1.0,1,1.0,1,0.28889602385842517,53
2939,4,4616,2343,2273,0,0,0,1.0,1,1.0,1,1.0,1,0.25383450891921105,52
2940,2,4618,2345,2273,0,0,0,1.0,1,1.0,1,1.0,1,0.3088429646526979,52
2941,0,4618,2345,2273,0,0,0,1.0,1,1.0,1,1.0,1,0.2947570176564928,50
2942,1,4619,2345,2274,0,0,0,1.0,1,1.0,1,1.0,1,0.29643884555381067,50
2943,1,4620,2346,2274,0,0,0,1.0,1,1.0,1,1.0,1,0.28854467044317794,49
2944,3,4623,2346,2277,0,0,0,1.0,1,1.0,1,1.0,1,0.24487283855922873,48
2945,2,4625,2346,2279,0,0,0,1.0,1,1.0,1,1.0,1,0.21060144072057202,48
2946,3,4628,2349,2279,0,0,0,1.0,1,1.0,1,1.0,1,0.1929108898473027,47
2947,1,4629,2350,2279,0,0,0,1.0,1,1.0,1,1.0,1,0.19409771067844334,47
2948,3,4632,2351,2281,0,0,0,1.0,1,1.0,1,1.0,1,0.17866677172777767,48
2949,0,4632,2351,2281,0,0,0,1.0,1,1.0,1,1.0,1,0.17866677172777767,48
2950,0,4632,2351,2281,0,0,0,1.0,1,1.0,1,1.0,1,0.17866677172777767,48
2951,1,4633,2351,2282,0,0,0,1.0,1,1.0,1,1.0,1,0.19031559016356098,50
2952,0,4633,2351,2282,0,0,0,1.0,1,1.0,1,1.0,1,0.19031559016356098,50
2953,0,4633,2351,2282,0,0,0,1.0,1,1.0,1,1.0,1,0.20305320871416616,51
2954,1,4634,2351,2283,0,0,0,1.0,1,1.0,1,1.0,1,0.17855471515578825,51
2955,0,4634,2351,2283,0,0,0,1.0,1,1.0,1,1.0,1,0.17855471515578825,51
2956,1,4635,2352,2283,0,0,0,1.0,1,1.0,1,1.0,1,0.2057751959090385,51
2957,1,4636,2352,2284,0,0,0,1.0,1,1.0,1,1.0,1,0.20069930705713734,52
2958,0,4636,2352,2284,0,0,0,1.0,1,1.0,1,1.0,1,0.20069930705713734,52
2959,2,4638,2353,2285,0,0,0,1.0,1,1.0,1,1.0,1,0.2039419928532055,53
2960,0,4638,2353,2285,0,0,0,1.0,1,1.0,1,1.0,1,0.19625454849916618,52
2961,0,4638,2353,2285,0,0,0,1.0,1,1.0,1,1.0,1,0.19929994789603978,53
2962,0,4638,2353,2285,0,0,0,1.0,1,1.0,1,1.0,1,0.21675320209233429,54
2963,1,4639,2354,2285,0,0,0,1.0,1,1.0,1,1.0,1,0.23203396797904102,55
2964,4,4643,2354,2289,0,0,0,1.0,1,1.0,1,1.0,1,0.20836992044127425,55
2965,2,4645,2354,2291,0,0,0,1.0,1,1.0,1,1.0,1,0.18222936501088025,55
2966,0,4645,2354,2291,0,0,0,1.0,1,1.0,1,1.0,1,0.18222936501088025,55
2967,3,4648,2354,2294,0,0,0,1.0,1,1.0,1,1.0,1,0.19840587687936395,56
2968,0,4648,2354,2294,0,0,0,1.0,1,1.0,1,1.0,1,0.19840587687936395,56
2969,1,4649,2355,2294,0,0,0,1.0,1,1.0,1,1.0,1,0.20994225949536213,55
2970,2,4651,2355,2296,0,0,0,1.0,1,1.0,1,1.0,1,0.19347198875337107,57
2971,2,4653,2357,2296,0,0,0,1.0,1,1.0,1,1.0,1,0.1863034333027839,56
2972,1,4654,2358,2296,0,0,0,1.0,1,1.0,1,1.0,1,0.19927541522009293,57
2973,4,4658,2360,2298,0,0,0,1.0,1,1.0,1,1.0,1,0.20540345393028062,59
2974,0,4658,2360,2298,0,0,0,1.0,1,1.0,1,1.0,1,0.20205477761894705,60
2975,5,4663,2362,2301,0,0,0,1.0,1,1.0,1,1.0,1,0.23623411853290197,58
2976,2,4665,2363,2302,0,0,0,1.0,1,1.0,1,1.0,1,0.24583620769339898,59
2977,6,4671,2364,2307,0,0,0,1.0,1,1.0,1,1.0,1,0.19652411809133166,59
2978,1,4672,2365,2307,0,0,0,1.0,1,1.0,1,1.0,1,0.19227420346633806,58
2979,3,4675,2366,2309,0,0,0,1.0,1,1.0,1,1.0,1,0.17961025383931772,57
2980,0,4675,2366,2309,0,0,0,1.0,1,1.0,1,1.0,1,0.18971721123077392,56
2981,0,4675,2366,2309,0,0,0,1.0,1,1.0,1,1.0,1,0.18971721123077392,56
2982,1,4676,2367,2309,0,0,0,1.0,1,1.0,1,1.0,1,0.1906023973939663,57
2983,2,4678,2368,2310,0,0,0,1.0,1,1.0,1,1.0,1,0.1847173534086115,57
2984,0,4678,2368,2310,0,0,0,1.0,1,1.0,1,1.0,1,0.17425462394656546,56
2985,3,4681,2368,2313,0,0,0,1.0,1,1.0,1,1.0,1,0.2202986066202112,55
2986,7,4688,2372,2316,0,0,0,1.0,1,1.0,1,1.0,1,0.2116859013443103,55
2987,3,4691,2372,2319,0,0,0,1.0,1,1.0,1,1.0,1,0.2061860096443836,51
2988,2,4693,2373,2320,0,0,0,1.0,1,1.0,1,1.0,1,0.18061706234278363,52
2989,1,4694,2373,2321,0,0,0,1.0,1,1.0,1,1.0,1,0.17443675114276302,50
2990,3,4697,2375,2322,0,0,0,1.0,1,1.0,1,1.0,1,0.18003243774484107,50
2991,1,4698,2375,2323,0,0,0,1.0,1,1.0,1,1.0,1,0.15260625533263816,50
2992,0,4698,2375,2323,0,0,0,1.0,1,1.0,1,1.0,1,0.15260625533263816,50
2993,0,4698,2375,2323,0,0,0,1.0,1,1.0,1,1.0,1,0.1888758069239526,51
2994,2,4700,2377,2323,0,0,0,1.0,1,1.0,1,1.0,1,0.2330248018211135,51
2995,2,4702,2377,2325,0,0,0,1.0,1,1.0,1,1.0,1,0.2050279551758236,51
2996,4,4706,2379,2327,0,0,0,1.0,1,1.0,1,1.0,1,0.21219487981367582,52
2997,0,4706,2379,2327,0,0,0,1.0,1,1.0,1,1.0,1,0.2313414816952687,52
2998,5,4711,2383,2328,0,0,0,1.0,1,1.0,1,1.0,1,0.22320027140690638,51
2999,0,4711,2383,2328,0,0,0,1.0,1,1.0,1,1.0,1,0.22320027140690638,51
3000,2,4713,2385,2328,0,0,0,1.0,1,1.0,1,1.0,1,0.22242868618995,52
3001,0,4713,2385,2328,0,0,0,1.0,1,1.0,1,1.0,1,0.22242868618995,52
3002,1,4714,2386,2328,0,0,0,1.0,1,1.0,1,1.0,1,0.2529044063974022,53
3003,2,4716,2386,2330,0,0,0,1.0,1,1.0,1,1.0,1,0.2026720382495899,54
3004,0,4716,2386,2330,0,0,0,1.0,1,1.0,1,1.0,1,0.21129771865274583,55
3005,1,4717,2386,2331,0,0,0,1.0,1,1.0,1,1.0,1,0.19705383659990253,56
3006,0,4717,2386,2331,0,0,0,1.0,1,1.0,1,1.0,1,0.19155487186458614,57
3007,1,4718,2386,2332,0,0,0,1.0,1,1.0,1,1.0,1,0.18917472848902145,58
3008,2,4720,2388,2332,0,0,0,1.0,1,1.0,1,1.0,1,0.19738870820207516,59
3009,0,4720,2388,2332,0,0,0,1.0,1,1.0,1,1.0,1,0.19738870820207516,59
3010,1,4721,2388,2333,0,0,0,1.0,1,1.0,1,1.0,1,0.1813921205563702,59
3011,2,4723,2389,2334,0,0,0,1.0,1,1.0,1,1.0,1,0.16712454652892486,59
3012,0,4723,2389,2334,0,0,0,1.0,1,1.0,1,1.0,1,0.17410161527001444,61
3013,1,4724,2390,2334,0,0,0,1.0,1,1.0,1,1.0,1,0.18453879472076049,59
3014,0,4724,2390,2334,0,0,0,1.0,1,1.0,1,1.0,1,0.1932528831939005,60
3015,1,4725,2390,2335,0,0,0,1.0,1,1.0,1,1.0,1,0.18830924368560734,58
3016,2,4727,2392,2335,0,0,0,1.0,1,1.0,1,1.0,1,0.2351972766727579,57
3017,3,4730,2395,2335,0,0,0,1.0,1,1.0,1,1.0,1,0.2501818697195097,58
3018,1,4731,2396,2335,0,0,0,1.0,1,1.0,1,1.0,1,0.27944317880161035,55
3019,2,4733,2396,2337,0,0,0,1.0,1,1.0,1,1.0,1,0.2597569570865421,56
3020,2,4735,2397,2338,0,0,0,1.0,1,1.0,1,1.0,1,0.2917417365391032,55
3021,3,4738,2398,2340,0,0,0,1.0,1,1.0,1,1.0,1,0.2605096508461983,55
3022,4,4742,2401,2341,0,0,0,1.0,1,1.0,1,1.0,1,0.298182203381531,55
3023,2,4744,2401,2343,0,0,0,1.0,1,1.0,1,1.0,1,0.23180227684546617,54
3024,1,4745,2402,2343,0,0,0,1.0,1,1.0,1,1.0,1,0.24395234091825937,54
3025,5,4750,2405,2345,0,0,0,1.0,1,1.0,1,1.0,1,0.2427483410165298,54
3026,2,4752,2405,2347,0,0,0,1.0,1,1.0,1,1.0,1,0.17224352081780162,53
3027,1,4753,2405,2348,0,0,0,1.0,1,1.0,1,1.0,1,0.1539379803171772,53
3028,2,4755,2407,2348,0,0,0,1.0,1,1.0,1,1.0,1,0.14835449446180962,51
3029,3,4758,2408,2350,0,0,0,1.0,1,1.0,1,1.0,1,0.16153610801070867,51
3030,2,4760,2410,2350,0,0,0,1.0,1,1.0,1,1.0,1,0.19260356107600024,52
3031,4,4764,2412,2352,0,0,0,1.0,1,1.0,1,1.0,1,0.18701221388199907,51
3032,1,4765,2412,2353,0,0,0,1.0,1,1.0,1,1.0,1,0.16910738714738544,50
3033,1,4766,2413,2353,0,0,0,1.0,1,1.0,1,1.0,1,0.15815489583877274,52
3034,0,4766,2413,2353,0,0,0,1.0,1,1.0,1,1.0,1,0.1692789763558943,51
3035,0,4766,2413,2353,0,0,0,1.0,1,1.0,1,1.0,1,0.16765842399665973,51
3036,1,4767,2413,2354,0,0,0,1.0,1,1.0,1,1.0,1,0.15669671590790496,53
3037,0,4767,2413,2354,0,0,0,1.0,1,1.0,1,1.0,1,0.17168935265652072,52
3038,0,4767,2413,2354,0,0,0,1.0,1,1.0,1,1.0,1,0.17168935265652072,52
3039,2,4769,2413,2356,0,0,0,1.0,1,1.0,1,1.0,1,0.12917220258971038,54
3040,1,4770,2414,2356,0,0,0,1.0,1,1.0,1,1.0,1,0.12020514412886424,55
3041,2,4772,2415,2357,0,0,0,1.0,1,1.0,1,1.0,1,0.1399147583106253,56
3042,2,4774,2416,2358,0,0,0,1.0,1,1.0,1,1.0,1,0.13667492725046862,56
3043,1,4775,2416,2359,0,0,0,1.0,1,1.0,1,1.0,1,0.10760602633383183,57
3044,1,4776,2417,2359,0,0,0,1.0,1,1.0,1,1.0,1,0.13299870185692395,57
3045,1,4777,2417,2360,0,0,0,1.0,1,1.0,1,1.0,1,0.13600947442186984,56
3046,2,4779,2419,2360,0,0,0,1.0,1,1.0,1,1.0,1,0.14312981170398,57
3047,1,4780,2420,2360,0,0,0,1.0,1,1.0,1,1.0,1,0.16492449114732974,56
3048,3,4783,2420,2363,0,0,0,1.0,1,1.0,1,1.0,1,0.14672909503078843,58
3049,2,4785,2421,2364,0,0,0,1.0,1,1.0,1,1.0,1,0.1937085243513558,59
3050,1,4786,2421,2365,0,0,0,1.0,1,1.0,1,1.0,1,0.20525539111159982,60
3051,3,4789,2423,2366,0,0,0,1.0,1,1.0,1,1.0,1,0.2376070789481468,59
3052,5,4794,2424,2370,0,0,0,1.0,1,1.0,1,1.0,1,0.2230265799622849,58
3053,4,4798,2426,2372,0,0,0,1.0,1,1.0,1,1.0,1,0.2434963054513938,57
3054,4,4802,2428,2374,0,0,0,1.0,1,1.0,1,1.0,1,0.2627903048167179,55
3055,0,4802,2428,2374,0,0,0,1.0,1,1.0,1,1.0,1,0.2492512236817661,54
3056,2,4804,2429,2375,0,0,0,1.0,1,1.0,1,1.0,1,0.2610244870264725,55
3057,2,4806,2430,2376,0,0,0,1.0,1,1.0,1,1.0,1,0.27399106871402135,54
3058,1,4807,2430,2377,0,0,0,1.0,1,1.0,1,1.0,1,0.2854150532972994,55
3059,2,4809,2430,2379,0,0,0,1.0,1,1.0,1,1.0,1,0.2649414699436182,56
3060,0,4809,2430,2379,0,0,0,1.0,1,1.0,1,1.0,1,0.2649414699436182,56
3061,1,4810,2431,2379,0,0,0,1.0,1,1.0,1,1.0,1,0.27899304739850483,56
3062,6,4816,2433,2383,0,0,0,1.0,1,1.0,1,1.0,1,0.24851932846497865,57
3063,1,4817,2434,2383,0,0,0,1.0,1,1.0,1,1.0,1,0.23481808677048363,55
3064,3,4820,2437,2383,0,0,0,1.0,1,1.0,1,1.0,1,0.27203598495342807,56
3065,2,4822,2438,2384,0,0,0,1.0,1,1.0,1,1.0,1,0.25796789362485795,55
3066,1,4823,2439,2384,0,0,0,1.0,1,1.0,1,1.0,1,0.2735222449083174,55
3067,3,4826,2441,2385,0,0,0,1.0,1,1.0,1,1.0,1,0.2727831678519147,54
3068,4,4830,2443,2387,0,0,0,1.0,1,1.0,1,1.0,1,0.29046477104679086,53
3069,3,4833,2445,2388,0,0,0,1.0,1,1.0,1,1.0,1,0.2565433825684621,51
3070,1,4834,2445,2389,0,0,0,1.0,1,1.0,1,1.0,1,0.24164209105110848,50
3071,2,4836,2445,2391,0,0,0,1.0,1,1.0,1,1.0,1,0.20595825551140945,51
3072,1,4837,2446,2391,0,0,0,1.0,1,1.0,1,1.0,1,0.21810067139856,53
3073,1,4838,2446,2392,0,0,0,1.0,1,1.0,1,1.0,1,0.21551315569749505,51
3074,1,4839,2446,2393,0,0,0,1.0,1,1.0,1,1.0,1,0.2071733742023383,50
3075,2,4841,2447,2394,0,0,0,1.0,1,1.0,1,1.0,1,0.23123626981621734,52
3076,2,4843,2447,2396,0,0,0,1.0,1,1.0,1,1.0,1,0.23199027564442484,53
3077,0,4843,2447,2396,0,0,0,1.0,1,1.0,1,1.0,1,0.2158776823029349,52
3078,0,4843,2447,2396,0,0,0,1.0,1,1.0,1,1.0,1,0.24704485501554613,53
3079,1,4844,2447,2397,0,0,0,1.0,1,1.0,1,1.0,1,0.24395663388609504,53
3080,1,4845,2447,2398,0,0,0,1.0,1,1.0,1,1.0,1,0.25327847706505635,52
3081,1,4846,2448,2398,0,0,0,1.0,1,1.0,1,1.0,1,0.28873716222433893,54
3082,2,4848,2450,2398,0,0,0,1.0,1,1.0,1,1.0,1,0.31373974562421136,54
3083,3,4851,2450,2401,0,0,0,1.0,1,1.0,1,1.0,1,0.27899874452557727,54
3084,1,4852,2451,2401,0,0,0,1.0,1,1.0,1,1.0,1,0.29599625792539336,55
3085,1,4853,2451,2402,0,0,0,1.0,1,1.0,1,1.0,1,0.27895513672006444,55
3086,1,4854,2451,2403,0,0,0,1.0,1,1.0,1,1.0,1,0.2806524816160794,56
3087,1,4855,2451,2404,0,0,0,1.0,1,1.0,1,1.0,1,0.2767275183870592,57
3088,0,4855,2451,2404,0,0,0,1.0,1,1.0,1,1.0,1,0.2907442514225265,56
3089,2,4857,2453,2404,0,0,0,1.0,1,1.0,1,1.0,1,0.31042919892605264,55
3090,1,4858,2453,2405,0,0,0,1.0,1,1.0,1,1.0,1,0.2977334374642385,54
3091,0,4858,2453,2405,0,0,0,1.0,1,1.0,1,1.0,1,0.3167104416088638,53
3092,2,4860,2453,2407,0,0,0,1.0,1,1.0,1,1.0,1,0.2857279588576135,56
3093,1,4861,2454,2407,0,0,0,1.0,1,1.0,1,1.0,1,0.30344083616213896,56
3094,0,4861,2454,2407,0,0,0,1.0,1,1.0,1,1.0,1,0.315167307052945,58
3095,2,4863,2454,2409,0,0,0,1.0,1,1.0,1,1.0,1,0.2747108566941082,59
3096,0,4863,2454,2409,0,0,0,1.0,1,1.0,1,1.0,1,0.281927421549547,60
3097,2,4865,2455,2410,0,0,0,1.0,1,1.0,1,1.0,1,0.2659027464538947,60
3098,0,4865,2455,2410,0,0,0,1.0,1,1.0,1,1.0,1,0.2886020292807975,58
3099,0,4865,2455,2410,0,0,0,1.0,1,1.0,1,1.0,1,0.2997181452650842,57
3100,1,4866,2456,2410,0,0,0,1.0,1,1.0,1,1.0,1,0.3117746747928185,57
3101,3,4869,2458,2411,0,0,0,1.0,1,1.0,1,1.0,1,0.3210888107643233,58
3102,3,4872,2460,2412,0,0,0,1.0,1,1.0,1,1.0,1,0.36012823230765717,59
3103,3,4875,2461,2414,0,0,0,1.0,1,1.0,1,1.0,1,0.2920792371109641,58
3104,5,4880,2462,2418,0,0,0,1.0,1,1.0,1,1.0,1,0.2507642152412842,58
3105,2,4882,2463,2419,0,0,0,1.0,1,1.0,1,1.0,1,0.2237939709711775,56
3106,6,4888,2467,2421,0,0,0,1.0,1,1.0,1,1.0,1,0.23782064037800715,57
3107,5,4893,2469,2424,0,0,0,1.0,1,1.0,1,1.0,1,0.18689611386104255,55
3108,3,4896,2471,2425,0,0,0,1.0,1,1.0,1,1.0,1,0.19271679299893216,55
3109,3,4899,2472,2427,0,0,0,1.0,1,1.0,1,1.0,1,0.19141582709105148,54
3110,3,4902,2475,2427,0,0,0,1.0,1,1.0,1,1.0,1,0.1699582692902102,54
3111,1,4903,2475,2428,0,0,0,1.0,1,1.0,1,1.0,1,0.15844089635973993,54
3112,4,4907,2479,2428,0,0,0,1.0,1,1.0,1,1.0,1,0.20688998210337753,56
3113,3,4910,2481,2429,0,0,0,1.0,1,1.0,1,1.0,1,0.21388588829152017,55
3114,3,4913,2482,2431,0,0,0,1.0,1,1.0,1,1.0,1,0.1930890004276851,54
3115,0,4913,2482,2431,0,0,0,1.0,1,1.0,1,1.0,1,0.1808258270165742,56
3116,1,4914,2483,2431,0,0,0,1.0,1,1.0,1,1.0,1,0.1887706647302675,56
3117,1,4915,2483,2432,0,0,0,1.0,1,1.0,1,1.0,1,0.22234553614984132,58
3118,3,4918,2484,2434,0,0,0,1.0,1,1.0,1,1.0,1,0.2003745325257183,57
3119,1,4919,2485,2434,0,0,0,1.0,1,1.0,1,1.0,1,0.21160705101933705,57
3120,0,4919,2485,2434,0,0,0,1.0,1,1.0,1,1.0,1,0.20564331795995794,56
3121,3,4922,2488,2434,0,0,0,1.0,1,1.0,1,1.0,1,0.1898776472940125,57
3122,0,4922,2488,2434,0,0,0,1.0,1,1.0,1,1.0,1,0.1898776472940125,57
3123,1,4923,2488,2435,0,0,0,1.0,1,1.0,1,1.0,1,0.17389248160969253,57
3124,1,4924,2488,2436,0,0,0,1.0,1,1.0,1,1.0,1,0.18045201491677212,59
3125,5,4929,2490,2439,0,0,0,1.0,1,1.0,1,1.0,1,0.18866362883188656,61
3126,2,4931,2491,2440,0,0,0,1.0,1,1.0,1,1.0,1,0.18563124090622407,60
3127,2,4933,2492,2441,0,0,0,1.0,1,1.0,1,1.0,1,0.17700282793296604,58
3128,2,4935,2493,2442,0,0,0,1.0,1,1.0,1,1.0,1,0.2147966440904456,58
3129,3,4938,2494,2444,0,0,0,1.0,1,1.0,1,1.0,1,0.2138369251318327,56
3130,0,4938,2494,2444,0,0,0,1.0,1,1.0,1,1.0,1,0.21574367318825893,56
3131,2,4940,2494,2446,0,0,0,1.0,1,1.0,1,1.0,1,0.20822066350235496,55
3132,1,4941,2494,2447,0,0,0,1.0,1,1.0,1,1.0,1,0.18805158871145758,53
3133,2,4943,2494,2449,0,0,0,1.0,1,1.0,1,1.0,1,0.15032393286607793,52
3134,0,4943,2494,2449,0,0,0,1.0,1,1.0,1,1.0,1,0.17517804767173537,52
3135,2,4945,2495,2450,0,0,0,1.0,1,1.0,1,1.0,1,0.14719485590059886,53
3136,3,4948,2498,2450,0,0,0,1.0,1,1.0,1,1.0,1,0.16818867843267785,54
3137,2,4950,2500,2450,0,0,0,1.0,1,1.0,1,1.0,1,0.18449145093649352,55
3138,7,4957,2503,2454,0,0,0,1.0,1,1.0,1,1.0,1,0.18267807645300044,57
3139,3,4960,2504,2456,0,0,0,1.0,1,1.0,1,1.0,1,0.16593366305411245,56
3140,1,4961,2505,2456,0,0,0,1.0,1,1.0,1,1.0,1,0.15954065984991533,56
3141,1,4962,2506,2456,0,0,0,1.0,1,1.0,1,1.0,1,0.167772550444692,56
3142,2,4964,2507,2457,0,0,0,1.0,1,1.0,1,1.0,1,0.1731076490841635,56
3143,2,4966,2508,2458,0,0,0,1.0,1,1.0,1,1.0,1,0.16981294903572697,56
3144,1,4967,2509,2458,0,0,0,1.0,1,1.0,1,1.0,1,0.16682010227788924,54
3145,3,4970,2510,2460,0,0,0,1.0,1,1.0,1,1.0,1,0.14094074824576733,55
3146,1,4971,2510,2461,0,0,0,1.0,1,1.0,1,1.0,1,0.11736232195448111,53
3147,1,4972,2510,2462,0,0,0,1.0,1,1.0,1,1.0,1,0.12017217795810259,54
3148,2,4974,2512,2462,0,0,0,1.0,1,1.0,1,1.0,1,0.13185015143253484,54
3149,1,4975,2512,2463,0,0,0,1.0,1,1.0,1,1.0,1,0.10627740751430091,53
3150,1,4976,2512,2464,0,0,0,1.0,1,1.0,1,1.0,1,0.08048387994996752,53
3151,0,4976,2512,2464,0,0,0,1.0,1,1.0,1,1.0,1,0.09470287262615787,53
3152,0,4976,2512,2464,0,0,0,1.0,1,1.0,1,1.0,1,0.0922106813755217,54
3153,0,4976,2512,2464,0,0,0,1.0,1,1.0,1,1.0,1,0.11195218223040451,53
3154,1,4977,2513,2464,0,0,0,1.0,1,1.0,1,1.0,1,0.15772819391644347,55
3155,2,4979,2513,2466,0,0,0,1.0,1,1.0,1,1.0,1,0.1250599522875991,56
3156,1,4980,2514,2466,0,0,0,1.0,1,1.0,1,1.0,1,0.17174962068258073,56
3157,0,4980,2514,2466,0,0,0,1.0,1,1.0,1,1.0,1,0.17174962068258073,56
3158,0,4980,2514,2466,0,0,0,1.0,1,1.0,1,1.0,1,0.17604422883074075,57
3159,1,4981,2515,2466,0,0,0,1.0,1,1.0,1,1.0,1,0.19493075058757822,56
3160,3,4984,2515,2469,0,0,0,1.0,1,1.0,1,1.0,1,0.16022300617727886,58
3161,0,4984,2515,2469,0,0,0,1.0,1,1.0,1,1.0,1,0.1577524541679606,59
3162,1,4985,2516,2469,0,0,0,1.0,1,1.0,1,1.0,1,0.16905197635458177,59
3163,2,4987,2518,2469,0,0,0,1.0,1,1.0,1,1.0,1,0.21252511600094903,59
3164,6,4993,2519,2474,0,0,0,1.0,1,1.0,1,1.0,1,0.19219012235912528,60
3165,1,4994,2519,2475,0,0,0,1.0,1,1.0,1,1.0,1,0.1858385864819078,58
3166,3,4997,2520,2477,0,0,0,1.0,1,1.0,1,1.0,1,0.16564539133502337,59
3167,6,5003,2525,2478,0,0,0,1.0,1,1.0,1,1.0,1,0.1687749931850073,57
3168,2,5005,2526,2479,0,0,0,1.0,1,1.0,1,1.0,1,0.16743717895404145,58
3169,1,5006,2527,2479,0,0,0,1.0,1,1.0,1,1.0,1,0.17032879294849607,57
3170,1,5007,2527,2480,0,0,0,1.0,1,1.0,1,1.0,1,0.11966898037553185,55
3171,1,5008,2528,2480,0,0,0,1.0,1,1.0,1,1.0,1,0.1265848679123713,56
3172,0,5008,2528,2480,0,0,0,1.0,1,1.0,1,1.0,1,0.12010023698089736,54
3173,1,5009,2529,2480,0,0,0,1.0,1,1.0,1,1.0,1,0.16062793737125422,53
3174,2,5011,2531,2480,0,0,0,1.0,1,1.0,1,1.0,1,0.20753570754464415,53
3175,4,5015,2532,2483,0,0,0,1.0,1,1.0,1,1.0,1,0.19972705402373067,52
3176,3,5018,2535,2483,0,0,0,1.0,1,1.0,1,1.0,1,0.25110507957063294,53
3177,4,5022,2537,2485,0,0,0,1.0,1,1.0,1,1.0,1,0.26185905770586265,52
3178,2,5024,2538,2486,0,0,0,1.0,1,1.0,1,1.0,1,0.2668082260616164,53
3179,3,5027,2539,2488,0,0,0,1.0,1,1.0,1,1.0,1,0.19963263076629964,54
3180,0,5027,2539,2488,0,0,0,1.0,1,1.0,1,1.0,1,0.23456173863732982,54
3181,2,5029,2539,2490,0,0,0,1.0,1,1.0,1,1.0,1,0.20213382162329477,55
3182,0,5029,2539,2490,0,0,0,1.0,1,1.0,1,1.0,1,0.20777323498300976,54
3183,4,5033,2541,2492,0,0,0,1.0,1,1.0,1,1.0,1,0.2377119849261449,56
3184,7,5040,2542,2498,0,0,0,1.0,1,1.0,1,1.0,1,0.17543665265104427,54
3185,1,5041,2543,2498,0,0,0,1.0,1,1.0,1,1.0,1,0.19409526477051958,53
3186,1,5042,2544,2498,0,0,0,1.0,1,1.0,1,1.0,1,0.20720186272024277,52
3187,2,5044,2546,2498,0,0,0,1.0,1,1.0,1,1.0,1,0.20449928918967816,50
3188,3,5047,2548,2499,0,0,0,1.0,1,1.0,1,1.0,1,0.19916757224560963,50
3189,5,5052,2551,2501,0,0,0,1.0,1,1.0,1,1.0,1,0.21036260388432004,49
3190,1,5053,2552,2501,0,0,0,1.0,1,1.0,1,1.0,1,0.2373097283469831,50
3191,3,5056,2554,2502,0,0,0,1.0,1,1.0,1,1.0,1,0.2636738294545308,49
3192,0,5056,2554,2502,0,0,0,1.0,1,1.0,1,1.0,1,0.2636738294545308,49
3193,0,5056,2554,2502,0,0,0,1.0,1,1.0,1,1.0,1,0.26479938955503507,49
3194,3,5059,2556,2503,0,0,0,1.0,1,1.0,1,1.0,1,0.28240912116174244,50
3195,2,5061,2556,2505,0,0,0,1.0,1,1.0,1,1.0,1,0.2437897376705034,49
3196,0,5061,2556,2505,0,0,0,1.0,1,1.0,1,1.0,1,0.2437897376705034,49
3197,2,5063,2556,2507,0,0,0,1.0,1,1.0,1,1.0,1,0.19821370785312753,50
3198,2,5065,2556,2509,0,0,0,1.0,1,1.0,1,1.0,1,0.15717986582026514,50
3199,2,5067,2556,2511,0,0,0,1.0,1,1.0,1,1.0,1,0.14748913593954888,52
3200,1,5068,2556,2512,0,0,0,1.0,1,1.0,1,1.0,1,0.13167644739377593,53
3201,0,5068,2556,2512,0,0,0,1.0,1,1.0,1,1.0,1,0.1421150813319151,55
3202,1,5069,2556,2513,0,0,0,1.0,1,1.0,1,1.0,1,0.12564536635344012,55
3203,0,5069,2556,2513,0,0,0,1.0,1,1.0,1,1.0,1,0.12365630488060547,53
3204,0,5069,2556,2513,0,0,0,1.0,1,1.0,1,1.0,1,0.14189990811388137,53
3205,2,5071,2558,2513,0,0,0,1.0,1,1.0,1,1.0,1,0.12825780978268558,53
3206,0,5071,2558,2513,0,0,0,1.0,1,1.0,1,1.0,1,0.15106455912750485,52
3207,2,5073,2560,2513,0,0,0,1.0,1,1.0,1,1.0,1,0.18928514051753412,53
3208,0,5073,2560,2513,0,0,0,1.0,1,1.0,1,1.0,1,0.24123493532896648,51
3209,1,5074,2560,2514,0,0,0,1.0,1,1.0,1,1.0,1,0.21419336894445504,52
3210,0,5074,2560,2514,0,0,0,1.0,1,1.0,1,1.0,1,0.23477801005347007,49
3211,3,5077,2563,2514,0,0,0,1.0,1,1.0,1,1.0,1,0.27769034687069477,48
3212,1,5078,2563,2515,0,0,0,1.0,1,1.0,1,1.0,1,0.27523292051070614,48
3213,3,5081,2565,2516,0,0,0,1.0,1,1.0,1,1.0,1,0.2060007695060726,49
3214,3,5084,2567,2517,0,0,0,1.0,1,1.0,1,1.0,1,0.17544858812657993,51
3215,0,5084,2567,2517,0,0,0,1.0,1,1.0,1,1.0,1,0.17544858812657993,51
3216,3,5087,2569,2518,0,0,0,1.0,1,1.0,1,1.0,1,0.15486169452756643,51
3217,1,5088,2570,2518,0,0,0,1.0,1,1.0,1,1.0,1,0.17999905934773378,51
3218,0,5088,2570,2518,0,0,0,1.0,1,1.0,1,1.0,1,0.17999905934773378,51
3219,1,5089,2570,2519,0,0,0,1.0,1,1.0,1,1.0,1,0.187861593395231,52
3220,0,5089,2570,2519,0,0,0,1.0,1,1.0,1,1.0,1,0.187861593395231,52
3221,0,5089,2570,2519,0,0,0,1.0,1,1.0,1,1.0,1,0.18232445391455887,54
3222,0,5089,2570,2519,0,0,0,1.0,1,1.0,1,1.0,1,0.18166325919494486,54
3223,0,5089,2570,2519,0,0,0,1.0,1,1.0,1,1.0,1,0.19761744410905105,56
3224,1,5090,2571,2519,0,0,0,1.0,1,1.0,1,1.0,1,0.20371619098178853,57
3225,2,5092,2571,2521,0,0,0,1.0,1,1.0,1,1.0,1,0.19353038234145203,58
3226,0,5092,2571,2521,0,0,0,1.0,1,1.0,1,1.0,1,0.19353038234145203,58
3227,1,5093,2571,2522,0,0,0,1.0,1,1.0,1,1.0,1,0.18934328259193217,58
3228,1,5094,2571,2523,0,0,0,1.0,1,1.0,1,1.0,1,0.16991778182757078,58
3229,1,5095,2571,2524,0,0,0,1.0,1,1.0,1,1.0,1,0.17372746366237626,60
3230,0,5095,2571,2524,0,0,0,1.0,1,1.0,1,1.0,1,0.17184855003406055,61
3231,1,5096,2572,2524,0,0,0,1.0,1,1.0,1,1.0,1,0.19212570531990897,61
3232,0,5096,2572,2524,0,0,0,1.0,1,1.0,1,1.0,1,0.19212570531990897,61
3233,1,5097,2572,2525,0,0,0,1.0,1,1.0,1,1.0,1,0.20394627906819604,63
3234,1,5098,2573,2525,0,0,0,1.0,1,1.0,1,1.0,1,0.2406580812645292,64
3235,2,5100,2573,2527,0,0,0,1.0,1,1.0,1,1.0,1,0.21724571696350517,65
3236,1,5101,2573,2528,0,0,0,1.0,1,1.0,1,1.0,1,0.20672627950355177,66
3237,2,5103,2573,2530,0,0,0,1.0,1,1.0,1,1.0,1,0.19036039670091995,67
3238,1,5104,2573,2531,0,0,0,1.0,1,1.0,1,1.0,1,0.18155935620025615,67
3239,0,5104,2573,2531,0,0,0,1.0,1,1.0,1,1.0,1,0.19448347213673844,69
3240,1,5105,2574,2531,0,0,0,1.0,1,1.0,1,1.0,1,0.18979320385820844,69
3241,4,5109,2577,2532,0,0,0,1.0,1,1.0,1,1.0,1,0.18533771324407147,68
3242,1,5110,2577,2533,0,0,0,1.0,1,1.0,1,1.0,1,0.18046278655261405,67
3243,2,5112,2579,2533,0,0,0,1.0,1,1.0,1,1.0,1,0.21105555800302128,68
3244,1,5113,2579,2534,0,0,0,1.0,1,1.0,1,1.0,1,0.18739658740546802,68
3245,0,5113,2579,2534,0,0,0,1.0,1,1.0,1,1.0,1,0.20049001142367773,69
3246,1,5114,2580,2534,0,0,0,1.0,1,1.0,1,1.0,1,0.19976338635032442,68
3247,1,5115,2580,2535,0,0,0,1.0,1,1.0,1,1.0,1,0.19077077672654133,68
3248,5,5120,2582,2538,0,0,0,1.0,1,1.0,1,1.0,1,0.16667628331147727,68
3249,1,5121,2582,2539,0,0,0,1.0,1,1.0,1,1.0,1,0.1663262273722049,69
3250,1,5122,2582,2540,0,0,0,1.0,1,1.0,1,1.0,1,0.15161143216268827,69
3251,1,5123,2583,2540,0,0,0,1.0,1,1.0,1,1.0,1,0.1865538038142087,68
3252,0,5123,2583,2540,0,0,0,1.0,1,1.0,1,1.0,1,0.1680433800618642,68
3253,1,5124,2583,2541,0,0,0,1.0,1,1.0,1,1.0,1,0.17026278088000527,69
3254,0,5124,2583,2541,0,0,0,1.0,1,1.0,1,1.0,1,0.17026278088000527,69
3255,0,5124,2583,2541,0,0,0,1.0,1,1.0,1,1.0,1,0.1821399007612598,70
3256,2,5126,2583,2543,0,0,0,1.0,1,1.0,1,1.0,1,0.15722785449067078,70
3257,0,5126,2583,2543,0,0,0,1.0,1,1.0,1,1.0,1,0.16246109416284213,71
3258,2,5128,2585,2543,0,0,0,1.0,1,1.0,1,1.0,1,0.16334936540160425,72
3259,5,5133,2587,2546,0,0,0,1.0,1,1.0,1,1.0,1,0.16439745683801163,71
3260,2,5135,2588,2547,0,0,0,1.0,1,1.0,1,1.0,1,0.18112282433369922,72
3261,3,5138,2588,2550,0,0,0,1.0,1,1.0,1,1.0,1,0.15780389926634802,74
3262,1,5139,2589,2550,0,0,0,1.0,1,1.0,1,1.0,1,0.1725072461005931,73
3263,5,5144,2591,2553,0,0,0,1.0,1,1.0,1,1.0,1,0.1720512566594451,73
3264,2,5146,2592,2554,0,0,0,1.0,1,1.0,1,1.0,1,0.18943910902083178,71
3265,4,5150,2593,2557,0,0,0,1.0,1,1.0,1,1.0,1,0.16536210898744721,70
3266,3,5153,2596,2557,0,0,0,1.0,1,1.0,1,1.0,1,0.17614661558108188,69
3267,2,5155,2597,2558,0,0,0,1.0,1,1.0,1,1.0,1,0.17773593601150828,69
3268,3,5158,2600,2558,0,0,0,1.0,1,1.0,1,1.0,1,0.1715223533929556,68
3269,4,5162,2602,2560,0,0,0,1.0,1,1.0,1,1.0,1,0.18657414429174973,68
3270,0,5162,2602,2560,0,0,0,1.0,1,1.0,1,1.0,1,0.1998619291354604,67
3271,1,5163,2602,2561,0,0,0,1.0,1,1.0,1,1.0,1,0.20298492760299594,66
3272,0,5163,2602,2561,0,0,0,1.0,1,1.0,1,1.0,1,0.1865811978147971,67
3273,2,5165,2602,2563,0,0,0,1.0,1,1.0,1,1.0,1,0.1786065216823172,66
3274,1,5166,2603,2563,0,0,0,1.0,1,1.0,1,1.0,1,0.19768049737525523,68
3275,1,5167,2603,2564,0,0,0,1.0,1,1.0,1,1.0,1,0.19288322050835444,68
3276,2,5169,2604,2565,0,0,0,1.0,1,1.0,1,1.0,1,0.18199686849972244,69
3277,2,5171,2604,2567,0,0,0,1.0,1,1.0,1,1.0,1,0.16956815303315725,68
3278,3,5174,2604,2570,0,0,0,1.0,1,1.0,1,1.0,1,0.13571249375367964,69
3279,1,5175,2605,2570,0,0,0,1.0,1,1.0,1,1.0,1,0.12808324062263038,67
3280,1,5176,2606,2570,0,0,0,1.0,1,1.0,1,1.0,1,0.15490651343789646,66
3281,3,5179,2608,2571,0,0,0,1.0,1,1.0,1,1.0,1,0.1945172285925565,67
3282,4,5183,2609,2574,0,0,0,1.0,1,1.0,1,1.0,1,0.19631207597035838,66
3283,3,5186,2610,2576,0,0,0,1.0,1,1.0,1,1.0,1,0.20978807294662463,67
3284,3,5189,2611,2578,0,0,0,1.0,1,1.0,1,1.0,1,0.12996691404568528,66
3285,0,5189,2611,2578,0,0,0,1.0,1,1.0,1,1.0,1,0.12996691404568528,66
3286,0,5189,2611,2578,0,0,0,1.0,1,1.0,1,1.0,1,0.12916758282874966,63
3287,1,5190,2612,2578,0,0,0,1.0,1,1.0,1,1.0,1,0.17686027649451583,61
3288,0,5190,2612,2578,0,0,0,1.0,1,1.0,1,1.0,1,0.21195440555897663,63
3289,2,5192,2613,2579,0,0,0,1.0,1,1.0,1,1.0,1,0.22178009220805103,62
3290,1,5193,2614,2579,0,0,0,1.0,1,1.0,1,1.0,1,0.2327460005650744,63
3291,2,5195,2615,2580,0,0,0,1.0,1,1.0,1,1.0,1,0.23381115823301069,62
3292,2,5197,2616,2581,0,0,0,1.0,1,1.0,1,1.0,1,0.23807659924925123,63
3293,2,5199,2617,2582,0,0,0,1.0,1,1.0,1,1.0,1,0.24333948655803353,65
3294,0,5199,2617,2582,0,0,0,1.0,1,1.0,1,1.0,1,0.24333948655803353,65
3295,3,5202,2619,2583,0,0,0,1.0,1,1.0,1,1.0,1,0.24008176840982176,65
3296,0,5202,2619,2583,0,0,0,1.0,1,1.0,1,1.0,1,0.24008176840982176,65
3297,2,5204,2620,2584,0,0,0,1.0,1,1.0,1,1.0,1,0.23108047302677592,66
3298,0,5204,2620,2584,0,0,0,1.0,1,1.0,1,1.0,1,0.23108047302677592,66
3299,1,5205,2620,2585,0,0,0,1.0,1,1.0,1,1.0,1,0.21640805157675128,67
3300,2,5207,2622,2585,0,0,0,1.0,1,1.0,1,1.0,1,0.2381503674068076,67
3301,4,5211,2623,2588,0,0,0,1.0,1,1.0,1,1.0,1,0.24719248387237183,68
3302,1,5212,2623,2589,0,0,0,1.0,1,1.0,1,1.0,1,0.24719486340752553,67
3303,3,5215,2624,2591,0,0,0,1.0,1,1.0,1,1.0,1,0.25175064970946187,67
3304,1,5216,2625,2591,0,0,0,1.0,1,1.0,1,1.0,1,0.2568010765298419,67
3305,7,5223,2625,2598,0,0,0,1.0,1,1.0,1,1.0,1,0.1917808322894662,69
3306,0,5223,2625,2598,0,0,0,1.0,1,1.0,1,1.0,1,0.18425613323208254,70
3307,1,5224,2625,2599,0,0,0,1.0,1,1.0,1,1.0,1,0.17957909694004492,70
3308,0,5224,2625,2599,0,0,0,1.0,1,1.0,1,1.0,1,0.17957909694004492,70
3309,0,5224,2625,2599,0,0,0,1.0,1,1.0,1,1.0,1,0.19605787436964614,72
3310,2,5226,2625,2601,0,0,0,1.0,1,1.0,1,1.0,1,0.19461253766671852,74
3311,1,5227,2625,2602,0,0,0,1.0,1,1.0,1,1.0,1,0.1891977203010177,74
3312,0,5227,2625,2602,0,0,0,1.0,1,1.0,1,1.0,1,0.1891977203010177,74
3313,4,5231,2625,2606,0,0,0,1.0,1,1.0,1,1.0,1,0.16789541924696966,75
3314,3,5234,2625,2609,0,0,0,1.0,1,1.0,1,1.0,1,0.15715695131351343,76
3315,2,5236,2626,2610,0,0,0,1.0,1,1.0,1,1.0,1,0.18179549052607233,75
3316,3,5239,2629,2610,0,0,0,1.0,1,1.0,1,1.0,1,0.2250420824868579,76
3317,4,5243,2631,2612,0,0,0,1.0,1,1.0,1,1.0,1,0.223013089966002,73
3318,3,5246,2633,2613,0,0,0,1.0,1,1.0,1,1.0,1,0.24543019377232078,72
3319,3,5249,2634,2615,0,0,0,1.0,1,1.0,1,1.0,1,0.23027874741060927,71
3320,1,5250,2634,2616,0,0,0,1.0,1,1.0,1,1.0,1,0.21712166675532457,70
3321,2,5252,2635,2617,0,0,0,1.0,1,1.0,1,1.0,1,0.22441039509558264,69
3322,1,5253,2636,2617,0,0,0,1.0,1,1.0,1,1.0,1,0.212096498962681,68
3323,1,5254,2637,2617,0,0,0,1.0,1,1.0,1,1.0,1,0.2424229656914152,69
3324,1,5255,2638,2617,0,0,0,1.0,1,1.0,1,1.0,1,0.22411428186650556,69
3325,1,5256,2638,2618,0,0,0,1.0,1,1.0,1,1.0,1,0.219867363358348,70
3326,3,5259,2639,2620,0,0,0,1.0,1,1.0,1,1.0,1,0.22414973852963943,69
3327,1,5260,2639,2621,0,0,0,1.0,1,1.0,1,1.0,1,0.21203709131460857,70
3328,1,5261,2640,2621,0,0,0,1.0,1,1.0,1,1.0,1,0.22925393324765295,73
3329,1,5262,2641,2621,0,0,0,1.0,1,1.0,1,1.0,1,0.26577265600943234,72
3330,4,5266,2642,2624,0,0,0,1.0,1,1.0,1,1.0,1,0.2355326961429227,72
3331,4,5270,2644,2626,0,0,0,1.0,1,1.0,1,1.0,1,0.2259995531647086,72
3332,2,5272,2644,2628,0,0,0,1.0,1,1.0,1,1.0,1,0.2171482833261688,73
3333,0,5272,2644,2628,0,0,0,1.0,1,1.0,1,1.0,1,0.2202330737274382,72
3334,1,5273,2644,2629,0,0,0,1.0,1,1.0,1,1.0,1,0.20761031200652785,73
3335,0,5273,2644,2629,0,0,0,1.0,1,1.0,1,1.0,1,0.21681894090069873,74
3336,0,5273,2644,2629,0,0,0,1.0,1,1.0,1,1.0,1,0.21681894090069873,74
3337,0,5273,2644,2629,0,0,0,1.0,1,1.0,1,1.0,1,0.21681894090069873,74
3338,0,5273,2644,2629,0,0,0,1.0,1,1.0,1,1.0,1,0.21681894090069873,74
3339,2,5275,2645,2630,0,0,0,1.0,1,1.0,1,1.0,1,0.22532515961746022,75
3340,1,5276,2645,2631,0,0,0,1.0,1,1.0,1,1.0,1,0.22156054038954567,75
3341,0,5276,2645,2631,0,0,0,1.0,1,1.0,1,1.0,1,0.2283859986663956,76
3342,1,5277,2646,2631,0,0,0,1.0,1,1.0,1,1.0,1,0.24505959397540222,76
3343,5,5282,2648,2634,0,0,0,1.0,1,1.0,1,1.0,1,0.20516255781619963,75
3344,2,5284,2649,2635,0,0,0,1.0,1,1.0,1,1.0,1,0.20807359332005504,75
3345,4,5288,2651,2637,0,0,0,1.0,1,1.0,1,1.0,1,0.22718023139068688,72
3346,3,5291,2652,2639,0,0,0,1.0,1,1.0,1,1.0,1,0.23336489770514396,73
3347,5,5296,2654,2642,0,0,0,1.0,1,1.0,1,1.0,1,0.20527468675594826,73
3348,1,5297,2654,2643,0,0,0,1.0,1,1.0,1,1.0,1,0.1947517194823999,73
3349,2,5299,2655,2644,0,0,0,1.0,1,1.0,1,1.0,1,0.20246666301435784,74
3350,2,5301,2656,2645,0,0,0,1.0,1,1.0,1,1.0,1,0.19986079135441523,73
3351,3,5304,2657,2647,0,0,0,1.0,1,1.0,1,1.0,1,0.17781073533854386,72
3352,2,5306,2658,2648,0,0,0,1.0,1,1.0,1,1.0,1,0.18365631249538295,72
3353,1,5307,2659,2648,0,0,0,1.0,1,1.0,1,1.0,1,0.2085044044054626,72
3354,3,5310,2661,2649,0,0,0,1.0,1,1.0,1,1.0,1,0.205310468154575,70
3355,5,5315,2663,2652,0,0,0,1.0,1,1.0,1,1.0,1,0.231022714487079,69
3356,2,5317,2665,2652,0,0,0,1.0,1,1.0,1,1.0,1,0.23967239942919505,69
3357,2,5319,2666,2653,0,0,0,1.0,1,1.0,1,1.0,1,0.22864380029188633,68
3358,1,5320,2667,2653,0,0,0,1.0,1,1.0,1,1.0,1,0.24352866348259783,68
3359,2,5322,2667,2655,0,0,0,1.0,1,1.0,1,1.0,1,0.23336194267392812,66
3360,1,5323,2668,2655,0,0,0,1.0,1,1.0,1,1.0,1,0.2495452110466402,65
3361,0,5323,2668,2655,0,0,0,1.0,1,1.0,1,1.0,1,0.2649568849924154,64
3362,0,5323,2668,2655,0,0,0,1.0,1,1.0,1,1.0,1,0.2649568849924154,64
3363,0,5323,2668,2655,0,0,0,1.0,1,1.0,1,1.0,1,0.25793119671606857,65
3364,1,5324,2668,2656,0,0,0,1.0,1,1.0,1,1.0,1,0.25002982993373307,66
3365,0,5324,2668,2656,0,0,0,1.0,1,1.0,1,1.0,1,0.2522766419539646,68
3366,1,5325,2669,2656,0,0,0,1.0,1,1.0,1,1.0,1,0.27331110365232847,66
3367,1,5326,2669,2657,0,0,0,1.0,1,1.0,1,1.0,1,0.27295887948342545,68
3368,4,5330,2670,2660,0,0,0,1.0,1,1.0,1,1.0,1,0.23523880188411403,68
3369,2,5332,2670,2662,0,0,0,1.0,1,1.0,1,1.0,1,0.2305669742082015,69
3370,1,5333,2670,2663,0,0,0,1.0,1,1.0,1,1.0,1,0.20154043182754716,71
3371,1,5334,2670,2664,0,0,0,1.0,1,1.0,1,1.0,1,0.19853181702472436,71
3372,2,5336,2671,2665,0,0,0,1.0,1,1.0,1,1.0,1,0.19193227144556033,71
3373,0,5336,2671,2665,0,0,0,1.0,1,1.0,1,1.0,1,0.18976598160895106,72
3374,0,5336,2671,2665,0,0,0,1.0,1,1.0,1,1.0,1,0.18555282233081274,72
3375,1,5337,2672,2665,0,0,0,1.0,1,1.0,1,1.0,1,0.18793121666481516,73
3376,1,5338,2672,2666,0,0,0,1.0,1,1.0,1,1.0,1,0.17544018220180047,75
3377,0,5338,2672,2666,0,0,0,1.0,1,1.0,1,1.0,1,0.17605042989143974,77
3378,0,5338,2672,2666,0,0,0,1.0,1,1.0,1,1.0,1,0.17605042989143974,77
3379,3,5341,2675,2666,0,0,0,1.0,1,1.0,1,1.0,1,0.21775262641973686,77
3380,2,5343,2676,2667,0,0,0,1.0,1,1.0,1,1.0,1,0.21913626087221696,76
3381,4,5347,2678,2669,0,0,0,1.0,1,1.0,1,1.0,1,0.21880450691130396,76
3382,2,5349,2679,2670,0,0,0,1.0,1,1.0,1,1.0,1,0.21899519256128833,78
3383,1,5350,2680,2670,0,0,0,1.0,1,1.0,1,1.0,1,0.21491195769472818,77
3384,4,5354,2684,2670,0,0,0,1.0,1,1.0,1,1.0,1,0.25536922877809415,77
3385,4,5358,2685,2673,0,0,0,1.0,1,1.0,1,1.0,1,0.2255906799471258,75
3386,2,5360,2686,2674,0,0,0,1.0,1,1.0,1,1.0,1,0.24658941001348625,76
3387,1,5361,2686,2675,0,0,0,1.0,1,1.0,1,1.0,1,0.23768940910246586,75
3388,2,5363,2687,2676,0,0,0,1.0,1,1.0,1,1.0,1,0.24325078802921277,76
3389,2,5365,2687,2678,0,0,0,1.0,1,1.0,1,1.0,1,0.22966490201905532,77
3390,0,5365,2687,2678,0,0,0,1.0,1,1.0,1,1.0,1,0.22976403926288105,76
3391,1,5366,2688,2678,0,0,0,1.0,1,1.0,1,1.0,1,0.2149705031383977,77
3392,2,5368,2688,2680,0,0,0,1.0,1,1.0,1,1.0,1,0.1948241456267582,78
3393,2,5370,2689,2681,0,0,0,1.0,1,1.0,1,1.0,1,0.19250699443935243,76
3394,3,5373,2690,2683,0,0,0,1.0,1,1.0,1,1.0,1,0.20888857299624314,75
3395,2,5375,2690,2685,0,0,0,1.0,1,1.0,1,1.0,1,0.19848797902984042,73
3396,0,5375,2690,2685,0,0,0,1.0,1,1.0,1,1.0,1,0.19848797902984042,73
3397,2,5377,2691,2686,0,0,0,1.0,1,1.0,1,1.0,1,0.17935678601209926,74
3398,1,5378,2692,2686,0,0,0,1.0,1,1.0,1,1.0,1,0.1684739854063436,74
3399,4,5382,2694,2688,0,0,0,1.0,1,1.0,1,1.0,1,0.1601389447711278,75
3400,2,5384,2695,2689,0,0,0,1.0,1,1.0,1,1.0,1,0.16249759491595953,75
3401,2,5386,2696,2690,0,0,0,1.0,1,1.0,1,1.0,1,0.15506754245337379,77
3402,1,5387,2697,2690,0,0,0,1.0,1,1.0,1,1.0,1,0.1702403743123899,77
3403,1,5388,2698,2690,0,0,0,1.0,1,1.0,1,1.0,1,0.17234542946505024,78
3404,1,5389,2699,2690,0,0,0,1.0,1,1.0,1,1.0,1,0.17485211674722662,78
3405,1,5390,2699,2691,0,0,0,1.0,1,1.0,1,1.0,1,0.16310977365259674,78
3406,1,5391,2700,2691,0,0,0,1.0,1,1.0,1,1.0,1,0.1732219301472386,78
3407,1,5392,2700,2692,0,0,0,1.0,1,1.0,1,1.0,1,0.1627011656489536,78
3408,1,5393,2700,2693,0,0,0,1.0,1,1.0,1,1.0,1,0.149705768327494,79
3409,1,5394,2700,2694,0,0,0,1.0,1,1.0,1,1.0,1,0.1410435560654314,81
3410,0,5394,2700,2694,0,0,0,1.0,1,1.0,1,1.0,1,0.1495211013271265,82
3411,0,5394,2700,2694,0,0,0,1.0,1,1.0,1,1.0,1,0.1546386745863777,84
3412,0,5394,2700,2694,0,0,0,1.0,1,1.0,1,1.0,1,0.1546386745863777,84
3413,1,5395,2701,2694,0,0,0,1.0,1,1.0,1,1.0,1,0.15644769951995838,84
3414,0,5395,2701,2694,0,0,0,1.0,1,1.0,1,1.0,1,0.15644769951995838,84
3415,2,5397,2702,2695,0,0,0,1.0,1,1.0,1,1.0,1,0.1568981420307209,85
3416,0,5397,2702,2695,0,0,0,1.0,1,1.0,1,1.0,1,0.1568981420307209,85
3417,5,5402,2703,2699,0,0,0,1.0,1,1.0,1,1.0,1,0.14518955179535686,86
3418,1,5403,2704,2699,0,0,0,1.0,1,1.0,1,1.0,1,0.15079355349685317,86
3419,1,5404,2705,2699,0,0,0,1.0,1,1.0,1,1.0,1,0.16205633254688803,87
3420,0,5404,2705,2699,0,0,0,1.0,1,1.0,1,1.0,1,0.16979714207871419,88
3421,3,5407,2707,2700,0,0,0,1.0,1,1.0,1,1.0,1,0.17463094594873238,89
3422,2,5409,2707,2702,0,0,0,1.0,1,1.0,1,1.0,1,0.16611783512489314,90
3423,3,5412,2707,2705,0,0,0,1.0,1,1.0,1,1.0,1,0.15027410625532114,90
3424,1,5413,2707,2706,0,0,0,1.0,1,1.0,1,1.0,1,0.13898787910093877,91
3425,1,5414,2708,2706,0,0,0,1.0,1,1.0,1,1.0,1,0.13822887915895204,90
3426,2,5416,2710,2706,0,0,0,1.0,1,1.0,1,1.0,1,0.15614811982387647,92
3427,1,5417,2710,2707,0,0,0,1.0,1,1.0,1,1.0,1,0.15604639093272454,92
3428,1,5418,2710,2708,0,0,0,1.0,1,1.0,1,1.0,1,0.15305430866504735,91
3429,2,5420,2710,2710,0,0,0,1.0,1,1.0,1,1.0,1,0.14916385379010594,91
3430,1,5421,2711,2710,0,0,0,1.0,1,1.0,1,1.0,1,0.1598537104825804,91
3431,0,5421,2711,2710,0,0,0,1.0,1,1.0,1,1.0,1,0.1490604423498334,90
3432,7,5428,2714,2714,0,0,0,1.0,1,1.0,1,1.0,1,0.15950769286246194,91
3433,2,5430,2714,2716,0,0,0,1.0,1,1.0,1,1.0,1,0.14622621180414405,90
3434,0,5430,2714,2716,0,0,0,1.0,1,1.0,1,1.0,1,0.15133101576590988,89
3435,2,5432,2715,2717,0,0,0,1.0,1,1.0,1,1.0,1,0.15666879076794982,88
3436,0,5432,2715,2717,0,0,0,1.0,1,1.0,1,1.0,1,0.1581225168085391,86
3437,1,5433,2716,2717,0,0,0,1.0,1,1.0,1,1.0,1,0.16161818190635494,86
3438,1,5434,2716,2718,0,0,0,1.0,1,1.0,1,1.0,1,0.15814576712413245,87
3439,2,5436,2717,2719,0,0,0,1.0,1,1.0,1,1.0,1,0.17061286720913332,86
3440,2,5438,2717,2721,0,0,0,1.0,1,1.0,1,1.0,1,0.15791529777705568,86
3441,1,5439,2718,2721,0,0,0,1.0,1,1.0,1,1.0,1,0.1540972344685309,85
3442,0,5439,2718,2721,0,0,0,1.0,1,1.0,1,1.0,1,0.15459225839464802,85
3443,0,5439,2718,2721,0,0,0,1.0,1,1.0,1,1.0,1,0.16319855730529179,85
3444,3,5442,2720,2722,0,0,0,1.0,1,1.0,1,1.0,1,0.16803535445775247,85
3445,3,5445,2722,2723,0,0,0,1.0,1,1.0,1,1.0,1,0.18917946815388825,84
3446,4,5449,2724,2725,0,0,0,1.0,1,1.0,1,1.0,1,0.19694459524893843,85
3447,3,5452,2725,2727,0,0,0,1.0,1,1.0,1,1.0,1,0.1886953758168057,85
3448,4,5456,2728,2728,0,0,0,1.0,1,1.0,1,1.0,1,0.21111145602710635,85
3449,2,5458,2728,2730,0,0,0,1.0,1,1.0,1,1.0,1,0.21128028798566395,84
3450,0,5458,2728,2730,0,0,0,1.0,1,1.0,1,1.0,1,0.21128028798566395,84
3451,1,5459,2728,2731,0,0,0,1.0,1,1.0,1,1.0,1,0.20647660721568173,85
3452,3,5462,2730,2732,0,0,0,1.0,1,1.0,1,1.0,1,0.19319420876668186,86
3453,2,5464,2730,2734,0,0,0,1.0,1,1.0,1,1.0,1,0.18617567386702707,85
3454,3,5467,2730,2737,0,0,0,1.0,1,1.0,1,1.0,1,0.1563710441457322,88
3455,0,5467,2730,2737,0,0,0,1.0,1,1.0,1,1.0,1,0.1563710441457322,88
3456,1,5468,2731,2737,0,0,0,1.0,1,1.0,1,1.0,1,0.16033967012488984,88
3457,1,5469,2731,2738,0,0,0,1.0,1,1.0,1,1.0,1,0.15624815037934608,89
3458,0,5469,2731,2738,0,0,0,1.0,1,1.0,1,1.0,1,0.16374160458037332,88
3459,0,5469,2731,2738,0,0,0,1.0,1,1.0,1,1.0,1,0.16374160458037332,88
3460,0,5469,2731,2738,0,0,0,1.0,1,1.0,1,1.0,1,0.15778031131440118,89
3461,0,5469,2731,2738,0,0,0,1.0,1,1.0,1,1.0,1,0.15778031131440118,89
3462,1,5470,2732,2738,0,0,0,1.0,1,1.0,1,1.0,1,0.16006773141626865,90
3463,2,5472,2732,2740,0,0,0,1.0,1,1.0,1,1.0,1,0.14758084936813595,89
3464,0,5472,2732,2740,0,0,0,1.0,1,1.0,1,1.0,1,0.15313636817341528,88
3465,1,5473,2732,2741,0,0,0,1.0,1,1.0,1,1.0,1,0.1742945781401212,87
3466,1,5474,2732,2742,0,0,0,1.0,1,1.0,1,1.0,1,0.1667749560949002,87
3467,4,5478,2733,2745,0,0,0,1.0,1,1.0,1,1.0,1,0.15750668672697846,87
3468,3,5481,2734,2747,0,0,0,1.0,1,1.0,1,1.0,1,0.17404893930998955,88
3469,3,5484,2735,2749,0,0,0,1.0,1,1.0,1,1.0,1,0.18481224093024667,85
3470,2,5486,2736,2750,0,0,0,1.0,1,1.0,1,1.0,1,0.19791163585814456,86
3471,5,5491,2738,2753,0,0,0,1.0,1,1.0,1,1.0,1,0.2042469546954078,84
3472,1,5492,2739,2753,0,0,0,1.0,1,1.0,1,1.0,1,0.20952774578784536,83
3473,1,5493,2739,2754,0,0,0,1.0,1,1.0,1,1.0,1,0.203563844052614,81
3474,2,5495,2739,2756,0,0,0,1.0,1,1.0,1,1.0,1,0.16254058939295857,80
3475,3,5498,2741,2757,0,0,0,1.0,1,1.0,1,1.0,1,0.21120192364944143,82
3476,1,5499,2742,2757,0,0,0,1.0,1,1.0,1,1.0,1,0.19071827024118387,81
3477,4,5503,2744,2759,0,0,0,1.0,1,1.0,1,1.0,1,0.1951163006289019,83
3478,1,5504,2744,2760,0,0,0,1.0,1,1.0,1,1.0,1,0.18721992753047437,83
3479,3,5507,2745,2762,0,0,0,1.0,1,1.0,1,1.0,1,0.17450475726995487,83
3480,1,5508,2745,2763,0,0,0,1.0,1,1.0,1,1.0,1,0.17248703819931907,83
3481,4,5512,2746,2766,0,0,0,1.0,1,1.0,1,1.0,1,0.14429903863272683,83
3482,0,5512,2746,2766,0,0,0,1.0,1,1.0,1,1.0,1,0.14574524172175793,83
3483,4,5516,2748,2768,0,0,0,1.0,1,1.0,1,1.0,1,0.15708012720453216,82
3484,1,5517,2749,2768,0,0,0,1.0,1,1.0,1,1.0,1,0.17300175974867252,82
3485,2,5519,2750,2769,0,0,0,1.0,1,1.0,1,1.0,1,0.18692180397267844,83
3486,0,5519,2750,2769,0,0,0,1.0,1,1.0,1,1.0,1,0.18692180397267844,83
3487,1,5520,2750,2770,0,0,0,1.0,1,1.0,1,1.0,1,0.1785839152088793,84
3488,0,5520,2750,2770,0,0,0,1.0,1,1.0,1,1.0,1,0.18339931266291032,84
3489,1,5521,2750,2771,0,0,0,1.0,1,1.0,1,1.0,1,0.16280440692470222,84
3490,0,5521,2750,2771,0,0,0,1.0,1,1.0,1,1.0,1,0.16280440692470222,84
3491,1,5522,2750,2772,0,0,0,1.0,1,1.0,1,1.0,1,0.16344175271971415,86
3492,2,5524,2751,2773,0,0,0,1.0,1,1.0,1,1.0,1,0.1472405817367547,86
3493,0,5524,2751,2773,0,0,0,1.0,1,1.0,1,1.0,1,0.1472405817367547,86
3494,0,5524,2751,2773,0,0,0,1.0,1,1.0,1,1.0,1,0.1472405817367547,86
3495,0,5524,2751,2773,0,0,0,1.0,1,1.0,1,1.0,1,0.14418406744881843,87
3496,2,5526,2751,2775,0,0,0,1.0,1,1.0,1,1.0,1,0.13858136264064283,88
3497,3,5529,2752,2777,0,0,0,1.0,1,1.0,1,1.0,1,0.13712286985861,89
3498,0,5529,2752,2777,0,0,0,1.0,1,1.0,1,1.0,1,0.15344574026922098,89
3499,2,5531,2753,2778,0,0,0,1.0,1,1.0,1,1.0,1,0.15247406957535406,91
3500,2,5533,2754,2779,0,0,0,1.0,1,1.0,1,1.0,1,0.15434415241718497,90
3501,3,5536,2754,2782,0,0,0,1.0,1,1.0,1,1.0,1,0.13456360813010293,90
3502,0,5536,2754,2782,0,0,0,1.0,1,1.0,1,1.0,1,0.1416065053751728,91
3503,5,5541,2757,2784,0,0,0,1.0,1,1.0,1,1.0,1,0.1369285750813919,91
3504,3,5544,2760,2784,0,0,0,1.0,1,1.0,1,1.0,1,0.17502229483609183,89
3505,2,5546,2760,2786,0,0,0,1.0,1,1.0,1,1.0,1,0.16580139607848646,87
3506,5,5551,2762,2789,0,0,0,1.0,1,1.0,1,1.0,1,0.1352781837359048,87
3507,4,5555,2764,2791,0,0,0,1.0,1,1.0,1,1.0,1,0.12921477686496727,84
3508,3,5558,2767,2791,0,0,0,1.0,1,1.0,1,1.0,1,0.15573686508178444,83
3509,2,5560,2769,2791,0,0,0,1.0,1,1.0,1,1.0,1,0.17127820089061832,80
3510,1,5561,2770,2791,0,0,0,1.0,1,1.0,1,1.0,1,0.17285841468242596,78
3511,3,5564,2772,2792,0,0,0,1.0,1,1.0,1,1.0,1,0.16834181337755277,77
3512,0,5564,2772,2792,0,0,0,1.0,1,1.0,1,1.0,1,0.17596006897694486,74
3513,2,5566,2773,2793,0,0,0,1.0,1,1.0,1,1.0,1,0.16347215254176234,76
3514,0,5566,2773,2793,0,0,0,1.0,1,1.0,1,1.0,1,0.16391853159324224,76
3515,0,5566,2773,2793,0,0,0,1.0,1,1.0,1,1.0,1,0.16483677973847305,75
3516,1,5567,2774,2793,0,0,0,1.0,1,1.0,1,1.0,1,0.1834689426069051,73
3517,4,5571,2777,2794,0,0,0,1.0,1,1.0,1,1.0,1,0.20015230069769452,74
3518,0,5571,2777,2794,0,0,0,1.0,1,1.0,1,1.0,1,0.21639783775499272,74
3519,0,5571,2777,2794,0,0,0,1.0,1,1.0,1,1.0,1,0.22688994275288757,73
3520,1,5572,2777,2795,0,0,0,1.0,1,1.0,1,1.0,1,0.20996635630752003,74
3521,3,5575,2777,2798,0,0,0,1.0,1,1.0,1,1.0,1,0.18455671842985727,75
3522,0,5575,2777,2798,0,0,0,1.0,1,1.0,1,1.0,1,0.18455671842985727,75
3523,2,5577,2777,2800,0,0,0,1.0,1,1.0,1,1.0,1,0.16041724624375797,75
3524,1,5578,2778,2800,0,0,0,1.0,1,1.0,1,1.0,1,0.14903473960684815,75
3525,0,5578,2778,2800,0,0,0,1.0,1,1.0,1,1.0,1,0.15659739572576556,75
3526,2,5580,2780,2800,0,0,0,1.0,1,1.0,1,1.0,1,0.16527942253653502,76
3527,4,5584,2782,2802,0,0,0,1.0,1,1.0,1,1.0,1,0.20000534887119908,77
3528,3,5587,2783,2804,0,0,0,1.0,1,1.0,1,1.0,1,0.20685464319733787,77
3529,6,5593,2784,2809,0,0,0,1.0,1,1.0,1,1.0,1,0.1773947164217565,78
3530,0,5593,2784,2809,0,0,0,1.0,1,1.0,1,1.0,1,0.1979127292435478,78
3531,0,5593,2784,2809,0,0,0,1.0,1,1.0,1,1.0,1,0.20887261845810925,79
3532,2,5595,2785,2810,0,0,0,1.0,1,1.0,1,1.0,1,0.22468333316452807,79
3533,4,5599,2787,2812,0,0,0,1.0,1,1.0,1,1.0,1,0.23212719779948715,79
3534,3,5602,2790,2812,0,0,0,1.0,1,1.0,1,1.0,1,0.2574075815341998,80
3535,3,5605,2790,2815,0,0,0,1.0,1,1.0,1,1.0,1,0.23263177758403522,81
3536,1,5606,2790,2816,0,0,0,1.0,1,1.0,1,1.0,1,0.22618587666547474,82
3537,1,5607,2790,2817,0,0,0,1.0,1,1.0,1,1.0,1,0.2211420378187116,82
3538,1,5608,2791,2817,0,0,0,1.0,1,1.0,1,1.0,1,0.22972870026325795,83
3539,1,5609,2791,2818,0,0,0,1.0,1,1.0,1,1.0,1,0.21990912494560796,83
3540,1,5610,2792,2818,0,0,0,1.0,1,1.0,1,1.0,1,0.21798207160202063,85
3541,2,5612,2793,2819,0,0,0,1.0,1,1.0,1,1.0,1,0.21780379306158543,85
3542,3,5615,2794,2821,0,0,0,1.0,1,1.0,1,1.0,1,0.19441495433617043,88
3543,2,5617,2795,2822,0,0,0,1.0,1,1.0,1,1.0,1,0.18918776522650751,87
3544,1,5618,2796,2822,0,0,0,1.0,1,1.0,1,1.0,1,0.19103447068517926,87
3545,1,5619,2797,2822,0,0,0,1.0,1,1.0,1,1.0,1,0.196079951637388,85
3546,0,5619,2797,2822,0,0,0,1.0,1,1.0,1,1.0,1,0.18932182303572345,83
3547,1,5620,2797,2823,0,0,0,1.0,1,1.0,1,1.0,1,0.16989984005335781,82
3548,2,5622,2799,2823,0,0,0,1.0,1,1.0,1,1.0,1,0.17750749735735336,82
3549,0,5622,2799,2823,0,0,0,1.0,1,1.0,1,1.0,1,0.1699259996481522,81
3550,1,5623,2800,2823,0,0,0,1.0,1,1.0,1,1.0,1,0.1865331401179204,79
3551,3,5626,2802,2824,0,0,0,1.0,1,1.0,1,1.0,1,0.18654704918609624,80
3552,2,5628,2803,2825,0,0,0,1.0,1,1.0,1,1.0,1,0.18938168444256823,78
3553,1,5629,2803,2826,0,0,0,1.0,1,1.0,1,1.0,1,0.1854305267722849,79
3554,1,5630,2803,2827,0,0,0,1.0,1,1.0,1,1.0,1,0.17883148853602038,77
3555,1,5631,2804,2827,0,0,0,1.0,1,1.0,1,1.0,1,0.19060175445989977,77
3556,0,5631,2804,2827,0,0,0,1.0,1,1.0,1,1.0,1,0.20216236956608938,76
3557,2,5633,2804,2829,0,0,0,1.0,1,1.0,1,1.0,1,0.18259959409739746,76
3558,3,5636,2805,2831,0,0,0,1.0,1,1.0,1,1.0,1,0.1702597158078467,76
3559,0,5636,2805,2831,0,0,0,1.0,1,1.0,1,1.0,1,0.1702597158078467,76
3560,5,5641,2806,2835,0,0,0,1.0,1,1.0,1,1.0,1,0.15767463018821762,78
3561,4,5645,2807,2838,0,0,0,1.0,1,1.0,1,1.0,1,0.14924403217677457,79
3562,2,5647,2809,2838,0,0,0,1.0,1,1.0,1,1.0,1,0.16512239697434045,79
3563,4,5651,2811,2840,0,0,0,1.0,1,1.0,1,1.0,1,0.13857299230378048,79
3564,2,5653,2813,2840,0,0,0,1.0,1,1.0,1,1.0,1,0.14786884032621694,80
3565,1,5654,2814,2840,0,0,0,1.0,1,1.0,1,1.0,1,0.15777642838569,83
3566,1,5655,2815,2840,0,0,0,1.0,1,1.0,1,1.0,1,0.18048571211841524,84
3567,4,5659,2815,2844,0,0,0,1.0,1,1.0,1,1.0,1,0.1518856608649882,84
3568,2,5661,2817,2844,0,0,0,1.0,1,1.0,1,1.0,1,0.16576744230611826,84
3569,1,5662,2818,2844,0,0,0,1.0,1,1.0,1,1.0,1,0.17233893585600274,84
3570,4,5666,2820,2846,0,0,0,1.0,1,1.0,1,1.0,1,0.17643572021295253,87
3571,3,5669,2821,2848,0,0,0,1.0,1,1.0,1,1.0,1,0.18406996809468892,86
3572,2,5671,2822,2849,0,0,0,1.0,1,1.0,1,1.0,1,0.1784546939245405,87
3573,2,5673,2823,2850,0,0,0,1.0,1,1.0,1,1.0,1,0.18370858286272937,87
3574,1,5674,2824,2850,0,0,0,1.0,1,1.0,1,1.0,1,0.17680038284582955,88
3575,1,5675,2824,2851,0,0,0,1.0,1,1.0,1,1.0,1,0.1728659401898223,88
3576,2,5677,2825,2852,0,0,0,1.0,1,1.0,1,1.0,1,0.16738100081804258,90
3577,2,5679,2825,2854,0,0,0,1.0,1,1.0,1,1.0,1,0.14770212311221684,90
3578,0,5679,2825,2854,0,0,0,1.0,1,1.0,1,1.0,1,0.1559790901480262,91
3579,3,5682,2827,2855,0,0,0,1.0,1,1.0,1,1.0,1,0.143861946350439,91
3580,1,5683,2828,2855,0,0,0,1.0,1,1.0,1,1.0,1,0.1748315269115776,91
3581,4,5687,2829,2858,0,0,0,1.0,1,1.0,1,1.0,1,0.1579469988473306,91
3582,3,5690,2830,2860,0,0,0,1.0,1,1.0,1,1.0,1,0.15599018547701426,92
3583,1,5691,2831,2860,0,0,0,1.0,1,1.0,1,1.0,1,0.15336921336134585,88
3584,1,5692,2831,2861,0,0,0,1.0,1,1.0,1,1.0,1,0.14508645706973536,87
3585,6,5698,2835,2863,0,0,0,1.0,1,1.0,1,1.0,1,0.1502761096041911,84
3586,5,5703,2838,2865,0,0,0,1.0,1,1.0,1,1.0,1,0.1504765326348209,83
3587,2,5705,2838,2867,0,0,0,1.0,1,1.0,1,1.0,1,0.14174350528107021,82
3588,2,5707,2840,2867,0,0,0,1.0,1,1.0,1,1.0,1,0.16216372613063545,81
3589,5,5712,2845,2867,0,0,0,1.0,1,1.0,1,1.0,1,0.19600534415725085,80
3590,3,5715,2847,2868,0,0,0,1.0,1,1.0,1,1.0,1,0.20031044947803947,78
3591,8,5723,2849,2874,0,0,0,1.0,1,1.0,1,1.0,1,0.13758759663068754,77
3592,1,5724,2850,2874,0,0,0,1.0,1,1.0,1,1.0,1,0.15706386571451114,75
3593,1,5725,2850,2875,0,0,0,1.0,1,1.0,1,1.0,1,0.16751358408134773,76
3594,0,5725,2850,2875,0,0,0,1.0,1,1.0,1,1.0,1,0.17927791828553166,74
3595,3,5728,2852,2876,0,0,0,1.0,1,1.0,1,1.0,1,0.18810374757005965,74
3596,1,5729,2853,2876,0,0,0,1.0,1,1.0,1,1.0,1,0.1856960528011811,73
3597,5,5734,2855,2879,0,0,0,1.0,1,1.0,1,1.0,1,0.15735456463550473,73
3598,2,5736,2857,2879,0,0,0,1.0,1,1.0,1,1.0,1,0.16664827097702392,73
3599,4,5740,2858,2882,0,0,0,1.0,1,1.0,1,1.0,1,0.14312047853122664,73
3600,0,5740,2858,2882,0,0,0,1.0,1,1.0,1,1.0,1,0.1444804265009859,74
3601,2,5742,2859,2883,0,0,0,1.0,1,1.0,1,1.0,1,0.1466283810749406,75
3602,1,5743,2859,2884,0,0,0,1.0,1,1.0,1,1.0,1,0.12073910955427028,76
3603,1,5744,2860,2884,0,0,0,1.0,1,1.0,1,1.0,1,0.14008025988333672,77
3604,2,5746,2861,2885,0,0,0,1.0,1,1.0,1,1.0,1,0.143921240004513,78
3605,1,5747,2861,2886,0,0,0,1.0,1,1.0,1,1.0,1,0.12635561956526145,77
3606,2,5749,2862,2887,0,0,0,1.0,1,1.0,1,1.0,1,0.12074661010820914,79
3607,1,5750,2862,2888,0,0,0,1.0,1,1.0,1,1.0,1,0.11368261742557677,79
3608,0,5750,2862,2888,0,0,0,1.0,1,1.0,1,1.0,1,0.11368261742557677,79
3609,0,5750,2862,2888,0,0,0,1.0,1,1.0,1,1.0,1,0.11368261742557677,79
3610,2,5752,2864,2888,0,0,0,1.0,1,1.0,1,1.0,1,0.13357996404027989,80
3611,2,5754,2865,2889,0,0,0,1.0,1,1.0,1,1.0,1,0.12477474348529087,80
3612,0,5754,2865,2889,0,0,0,1.0,1,1.0,1,1.0,1,0.1418416504946476,79
3613,3,5757,2867,2890,0,0,0,1.0,1,1.0,1,1.0,1,0.14675313338428242,79
3614,3,5760,2870,2890,0,0,0,1.0,1,1.0,1,1.0,1,0.15831206753772054,78
3615,3,5763,2870,2893,0,0,0,1.0,1,1.0,1,1.0,1,0.127644542531124,79
3616,2,5765,2871,2894,0,0,0,1.0,1,1.0,1,1.0,1,0.14928254715148365,79
3617,4,5769,2873,2896,0,0,0,1.0,1,1.0,1,1.0,1,0.13629888972024168,80
3618,1,5770,2873,2897,0,0,0,1.0,1,1.0,1,1.0,1,0.14967502212911785,82
3619,1,5771,2873,2898,0,0,0,1.0,1,1.0,1,1.0,1,0.15392777869589258,82
3620,3,5774,2875,2899,0,0,0,1.0,1,1.0,1,1.0,1,0.1673594282120997,81
3621,3,5777,2876,2901,0,0,0,1.0,1,1.0,1,1.0,1,0.15870848690025752,83
3622,3,5780,2878,2902,0,0,0,1.0,1,1.0,1,1.0,1,0.19036347507767734,81
3623,7,5787,2881,2906,0,0,0,1.0,1,1.0,1,1.0,1,0.20990465436394834,81
3624,2,5789,2882,2907,0,0,0,1.0,1,1.0,1,1.0,1,0.21604702103714984,79
3625,4,5793,2884,2909,0,0,0,1.0,1,1.0,1,1.0,1,0.2268064218681851,80
3626,2,5795,2884,2911,0,0,0,1.0,1,1.0,1,1.0,1,0.18678283799200351,78
3627,1,5796,2884,2912,0,0,0,1.0,1,1.0,1,1.0,1,0.19353478341550936,78
3628,1,5797,2885,2912,0,0,0,1.0,1,1.0,1,1.0,1,0.18425173391383828,77
3629,2,5799,2885,2914,0,0,0,1.0,1,1.0,1,1.0,1,0.16060834457720283,76
3630,0,5799,2885,2914,0,0,0,1.0,1,1.0,1,1.0,1,0.16113261102576695,77
3631,3,5802,2887,2915,0,0,0,1.0,1,1.0,1,1.0,1,0.16686212170789508,75
3632,2,5804,2889,2915,0,0,0,1.0,1,1.0,1,1.0,1,0.18806477379105088,74
3633,3,5807,2890,2917,0,0,0,1.0,1,1.0,1,1.0,1,0.16173346151552834,75
3634,3,5810,2892,2918,0,0,0,1.0,1,1.0,1,1.0,1,0.18321706125731838,74
3635,4,5814,2893,2921,0,0,0,1.0,1,1.0,1,1.0,1,0.1353162701529726,74
3636,1,5815,2893,2922,0,0,0,1.0,1,1.0,1,1.0,1,0.13411834459613228,74
3637,1,5816,2893,2923,0,0,0,1.0,1,1.0,1,1.0,1,0.13307068714635195,74
3638,0,5816,2893,2923,0,0,0,1.0,1,1.0,1,1.0,1,0.14192044857253225,75
3639,4,5820,2895,2925,0,0,0,1.0,1,1.0,1,1.0,1,0.15423337898255948,76
3640,2,5822,2895,2927,0,0,0,1.0,1,1.0,1,1.0,1,0.12952263446255038,76
3641,4,5826,2897,2929,0,0,0,1.0,1,1.0,1,1.0,1,0.1572703313374124,75
3642,3,5829,2899,2930,0,0,0,1.0,1,1.0,1,1.0,1,0.18211249074386784,75
3643,1,5830,2899,2931,0,0,0,1.0,1,1.0,1,1.0,1,0.17474301271152645,74
3644,1,5831,2900,2931,0,0,0,1.0,1,1.0,1,1.0,1,0.169828346125625,74
3645,0,5831,2900,2931,0,0,0,1.0,1,1.0,1,1.0,1,0.169828346125625,74
3646,0,5831,2900,2931,0,0,0,1.0,1,1.0,1,1.0,1,0.16120685591767533,75
3647,1,5832,2900,2932,0,0,0,1.0,1,1.0,1,1.0,1,0.15810778386878668,77
3648,2,5834,2900,2934,0,0,0,1.0,1,1.0,1,1.0,1,0.1566941025857821,78
3649,1,5835,2900,2935,0,0,0,1.0,1,1.0,1,1.0,1,0.15043191674222758,80
3650,1,5836,2901,2935,0,0,0,1.0,1,1.0,1,1.0,1,0.16723019717681759,81
3651,1,5837,2901,2936,0,0,0,1.0,1,1.0,1,1.0,1,0.15644740682583827,81
3652,1,5838,2902,2936,0,0,0,1.0,1,1.0,1,1.0,1,0.1832784912413944,83
3653,2,5840,2902,2938,0,0,0,1.0,1,1.0,1,1.0,1,0.1602059135708201,83
3654,0,5840,2902,2938,0,0,0,1.0,1,1.0,1,1.0,1,0.1602059135708201,83
3655,0,5840,2902,2938,0,0,0,1.0,1,1.0,1,1.0,1,0.15401167380915726,84
3656,2,5842,2902,2940,0,0,0,1.0,1,1.0,1,1.0,1,0.1510300579363466,85
3657,1,5843,2903,2940,0,0,0,1.0,1,1.0,1,1.0,1,0.1632085218538551,86
3658,1,5844,2904,2940,0,0,0,1.0,1,1.0,1,1.0,1,0.1898197165514823,87
3659,1,5845,2904,2941,0,0,0,1.0,1,1.0,1,1.0,1,0.1776920332716816,87
3660,0,5845,2904,2941,0,0,0,1.0,1,1.0,1,1.0,1,0.1732746956867433,86
3661,2,5847,2905,2942,0,0,0,1.0,1,1.0,1,1.0,1,0.18375565811702677,86
3662,0,5847,2905,2942,0,0,0,1.0,1,1.0,1,1.0,1,0.1959470229091565,83
3663,9,5856,2909,2947,0,0,0,1.0,1,1.0,1,1.0,1,0.19903127982700858,85
3664,2,5858,2910,2948,0,0,0,1.0,1,1.0,1,1.0,1,0.1919881621533673,82
3665,2,5860,2910,2950,0,0,0,1.0,1,1.0,1,1.0,1,0.17851393350939224,81
3666,3,5863,2912,2951,0,0,0,1.0,1,1.0,1,1.0,1,0.20594939834151105,79
3667,4,5867,2912,2955,0,0,0,1.0,1,1.0,1,1.0,1,0.18552770653918943,79
3668,0,5867,2912,2955,0,0,0,1.0,1,1.0,1,1.0,1,0.18580378207476436,77
3669,3,5870,2912,2958,0,0,0,1.0,1,1.0,1,1.0,1,0.1682581666796034,75
3670,2,5872,2914,2958,0,0,0,1.0,1,1.0,1,1.0,1,0.15982526932474075,76
3671,3,5875,2915,2960,0,0,0,1.0,1,1.0,1,1.0,1,0.15118633797789308,74
3672,1,5876,2916,2960,0,0,0,1.0,1,1.0,1,1.0,1,0.16356486456417335,75
3673,1,5877,2916,2961,0,0,0,1.0,1,1.0,1,1.0,1,0.1560077815195277,75
3674,3,5880,2919,2961,0,0,0,1.0,1,1.0,1,1.0,1,0.1407067792048611,75
3675,1,5881,2919,2962,0,0,0,1.0,1,1.0,1,1.0,1,0.13569659801525763,75
3676,1,5882,2920,2962,0,0,0,1.0,1,1.0,1,1.0,1,0.14466090236584458,75
3677,0,5882,2920,2962,0,0,0,1.0,1,1.0,1,1.0,1,0.1485800970205413,75
3678,0,5882,2920,2962,0,0,0,1.0,1,1.0,1,1.0,1,0.15957800804451494,77
3679,2,5884,2921,2963,0,0,0,1.0,1,1.0,1,1.0,1,0.1810791999834858,78
3680,1,5885,2921,2964,0,0,0,1.0,1,1.0,1,1.0,1,0.1798512157939283,80
3681,2,5887,2921,2966,0,0,0,1.0,1,1.0,1,1.0,1,0.17835678515176193,81
3682,0,5887,2921,2966,0,0,0,1.0,1,1.0,1,1.0,1,0.17835678515176193,81
3683,1,5888,2922,2966,0,0,0,1.0,1,1.0,1,1.0,1,0.19147185832425756,81
3684,0,5888,2922,2966,0,0,0,1.0,1,1.0,1,1.0,1,0.19147185832425756,81
3685,0,5888,2922,2966,0,0,0,1.0,1,1.0,1,1.0,1,0.19147185832425756,81
3686,0,5888,2922,2966,0,0,0,1.0,1,1.0,1,1.0,1,0.19147185832425756,81
3687,0,5888,2922,2966,0,0,0,1.0,1,1.0,1,1.0,1,0.18486570283987727,82
3688,2,5890,2922,2968,0,0,0,1.0,1,1.0,1,1.0,1,0.19254053951738134,84
3689,0,5890,2922,2968,0,0,0,1.0,1,1.0,1,1.0,1,0.19254053951738134,84
3690,4,5894,2922,2972,0,0,0,1.0,1,1.0,1,1.0,1,0.1677509693176107,85
3691,2,5896,2922,2974,0,0,0,1.0,1,1.0,1,1.0,1,0.15389054710824268,86
3692,0,5896,2922,2974,0,0,0,1.0,1,1.0,1,1.0,1,0.15163257097010224,86
3693,0,5896,2922,2974,0,0,0,1.0,1,1.0,1,1.0,1,0.15163257097010224,86
3694,0,5896,2922,2974,0,0,0,1.0,1,1.0,1,1.0,1,0.15163257097010224,86
3695,3,5899,2925,2974,0,0,0,1.0,1,1.0,1,1.0,1,0.1813256956447875,86
3696,2,5901,2925,2976,0,0,0,1.0,1,1.0,1,1.0,1,0.15204030566256266,87
3697,1,5902,2926,2976,0,0,0,1.0,1,1.0,1,1.0,1,0.15818096895740466,85
3698,1,5903,2927,2976,0,0,0,1.0,1,1.0,1,1.0,1,0.15874803799898668,85
3699,1,5904,2928,2976,0,0,0,1.0,1,1.0,1,1.0,1,0.15104116054035796,85
3700,3,5907,2931,2976,0,0,0,1.0,1,1.0,1,1.0,1,0.17400234146894641,84
3701,2,5909,2931,2978,0,0,0,1.0,1,1.0,1,1.0,1,0.15474894333679806,85
3702,2,5911,2933,2978,0,0,0,1.0,1,1.0,1,1.0,1,0.16126373170724292,85
3703,0,5911,2933,2978,0,0,0,1.0,1,1.0,1,1.0,1,0.16126373170724292,85
3704,2,5913,2934,2979,0,0,0,1.0,1,1.0,1,1.0,1,0.17239655468456333,85
3705,2,5915,2934,2981,0,0,0,1.0,1,1.0,1,1.0,1,0.14949606621946807,86
3706,1,5916,2935,2981,0,0,0,1.0,1,1.0,1,1.0,1,0.157693904477626,86
3707,1,5917,2936,2981,0,0,0,1.0,1,1.0,1,1.0,1,0.16402124040146132,85
3708,2,5919,2936,2983,0,0,0,1.0,1,1.0,1,1.0,1,0.149086113328854,84
3709,0,5919,2936,2983,0,0,0,1.0,1,1.0,1,1.0,1,0.15553195760144134,85
3710,0,5919,2936,2983,0,0,0,1.0,1,1.0,1,1.0,1,0.14537648505732464,84
3711,0,5919,2936,2983,0,0,0,1.0,1,1.0,1,1.0,1,0.1534718444546894,85
3712,0,5919,2936,2983,0,0,0,1.0,1,1.0,1,1.0,1,0.1534718444546894,85
3713,0,5919,2936,2983,0,0,0,1.0,1,1.0,1,1.0,1,0.1534718444546894,85
3714,1,5920,2937,2983,0,0,0,1.0,1,1.0,1,1.0,1,0.17916811718877151,85
3715,2,5922,2938,2984,0,0,0,1.0,1,1.0,1,1.0,1,0.17251040715266353,85
3716,0,5922,2938,2984,0,0,0,1.0,1,1.0,1,1.0,1,0.18182723664493994,84
3717,2,5924,2938,2986,0,0,0,1.0,1,1.0,1,1.0,1,0.17779383208204355,86
3718,0,5924,2938,2986,0,0,0,1.0,1,1.0,1,1.0,1,0.18916358846585077,85
3719,5,5929,2940,2989,0,0,0,1.0,1,1.0,1,1.0,1,0.18439682380035652,84
3720,0,5929,2940,2989,0,0,0,1.0,1,1.0,1,1.0,1,0.2038716802712523,84
3721,6,5935,2944,2991,0,0,0,1.0,1,1.0,1,1.0,1,0.20438018147570378,85
3722,1,5936,2944,2992,0,0,0,1.0,1,1.0,1,1.0,1,0.19697680537383852,85
3723,2,5938,2945,2993,0,0,0,1.0,1,1.0,1,1.0,1,0.19662240200982994,85
3724,1,5939,2945,2994,0,0,0,1.0,1,1.0,1,1.0,1,0.18580285838543606,86
3725,4,5943,2946,2997,0,0,0,1.0,1,1.0,1,1.0,1,0.15899138326140863,86
3726,0,5943,2946,2997,0,0,0,1.0,1,1.0,1,1.0,1,0.15899138326140863,86
3727,1,5944,2946,2998,0,0,0,1.0,1,1.0,1,1.0,1,0.15132289556220063,86
3728,0,5944,2946,2998,0,0,0,1.0,1,1.0,1,1.0,1,0.15132289556220063,86
3729,2,5946,2947,2999,0,0,0,1.0,1,1.0,1,1.0,1,0.15934359246148305,86
3730,1,5947,2947,3000,0,0,0,1.0,1,1.0,1,1.0,1,0.16621493543987545,85
3731,2,5949,2947,3002,0,0,0,1.0,1,1.0,1,1.0,1,0.15418782617493904,86
3732,1,5950,2948,3002,0,0,0,1.0,1,1.0,1,1.0,1,0.16220205548901595,87
3733,2,5952,2949,3003,0,0,0,1.0,1,1.0,1,1.0,1,0.17156821453877968,87
3734,0,5952,2949,3003,0,0,0,1.0,1,1.0,1,1.0,1,0.17156821453877968,87
3735,3,5955,2950,3005,0,0,0,1.0,1,1.0,1,1.0,1,0.17802855086083474,86
3736,0,5955,2950,3005,0,0,0,1.0,1,1.0,1,1.0,1,0.16802772088164303,87
3737,3,5958,2951,3007,0,0,0,1.0,1,1.0,1,1.0,1,0.17181896742691008,87
3738,1,5959,2952,3007,0,0,0,1.0,1,1.0,1,1.0,1,0.17950761688281558,87
3739,2,5961,2952,3009,0,0,0,1.0,1,1.0,1,1.0,1,0.16373391084731387,88
3740,2,5963,2954,3009,0,0,0,1.0,1,1.0,1,1.0,1,0.1928825134728361,87
3741,3,5966,2954,3012,0,0,0,1.0,1,1.0,1,1.0,1,0.16713138828326765,87
3742,2,5968,2955,3013,0,0,0,1.0,1,1.0,1,1.0,1,0.16555067145723631,86
3743,2,5970,2955,3015,0,0,0,1.0,1,1.0,1,1.0,1,0.15469199640782794,84
3744,3,5973,2956,3017,0,0,0,1.0,1,1.0,1,1.0,1,0.16103756577131723,83
3745,1,5974,2956,3018,0,0,0,1.0,1,1.0,1,1.0,1,0.1510734980572782,83
3746,3,5977,2957,3020,0,0,0,1.0,1,1.0,1,1.0,1,0.17168029429075948,83
3747,3,5980,2958,3022,0,0,0,1.0,1,1.0,1,1.0,1,0.1666609255545273,81
3748,1,5981,2958,3023,0,0,0,1.0,1,1.0,1,1.0,1,0.16747395460345624,81
3749,1,5982,2958,3024,0,0,0,1.0,1,1.0,1,1.0,1,0.16933474582309435,80
3750,0,5982,2958,3024,0,0,0,1.0,1,1.0,1,1.0,1,0.17486892292499268,79
3751,5,5987,2962,3025,0,0,0,1.0,1,1.0,1,1.0,1,0.1929832986370255,80
3752,3,5990,2964,3026,0,0,0,1.0,1,1.0,1,1.0,1,0.21022822722122567,80
3753,6,5996,2967,3029,0,0,0,1.0,1,1.0,1,1.0,1,0.20735885893312453,81
3754,1,5997,2968,3029,0,0,0,1.0,1,1.0,1,1.0,1,0.21142243691372722,81
3755,2,5999,2969,3030,0,0,0,1.0,1,1.0,1,1.0,1,0.19918313528938086,80
3756,1,6000,2970,3030,0,0,0,1.0,1,1.0,1,1.0,1,0.20935494030011945,79
3757,5,6005,2970,3035,0,0,0,1.0,1,1.0,1,1.0,1,0.18364746901413453,80
3758,2,6007,2971,3036,0,0,0,1.0,1,1.0,1,1.0,1,0.19490075193704579,79
3759,1,6008,2972,3036,0,0,0,1.0,1,1.0,1,1.0,1,0.2122810834827202,79
3760,0,6008,2972,3036,0,0,0,1.0,1,1.0,1,1.0,1,0.2122810834827202,79
3761,1,6009,2972,3037,0,0,0,1.0,1,1.0,1,1.0,1,0.22126392406704107,78
3762,1,6010,2972,3038,0,0,0,1.0,1,1.0,1,1.0,1,0.2156338405771618,80
3763,0,6010,2972,3038,0,0,0,1.0,1,1.0,1,1.0,1,0.2156338405771618,80
3764,3,6013,2974,3039,0,0,0,1.0,1,1.0,1,1.0,1,0.24312800577003976,80
3765,5,6018,2975,3043,0,0,0,1.0,1,1.0,1,1.0,1,0.21863745910859841,81
3766,2,6020,2976,3044,0,0,0,1.0,1,1.0,1,1.0,1,0.2278657795438929,83
3767,1,6021,2977,3044,0,0,0,1.0,1,1.0,1,1.0,1,0.22051214740018452,83
3768,3,6024,2978,3046,0,0,0,1.0,1,1.0,1,1.0,1,0.20332279245710647,84
3769,2,6026,2978,3048,0,0,0,1.0,1,1.0,1,1.0,1,0.1691566093745601,86
3770,0,6026,2978,3048,0,0,0,1.0,1,1.0,1,1.0,1,0.17553360837452767,87
3771,1,6027,2979,3048,0,0,0,1.0,1,1.0,1,1.0,1,0.17723175407562725,87
3772,0,6027,2979,3048,0,0,0,1.0,1,1.0,1,1.0,1,0.1926348020173916,88
3773,2,6029,2979,3050,0,0,0,1.0,1,1.0,1,1.0,1,0.19478291849808152,85
3774,1,6030,2979,3051,0,0,0,1.0,1,1.0,1,1.0,1,0.19077908293655862,85
3775,2,6032,2980,3052,0,0,0,1.0,1,1.0,1,1.0,1,0.21545364391078456,83
3776,2,6034,2981,3053,0,0,0,1.0,1,1.0,1,1.0,1,0.23080973788111797,82
3777,6,6040,2983,3057,0,0,0,1.0,1,1.0,1,1.0,1,0.20367457201794398,81
3778,1,6041,2983,3058,0,0,0,1.0,1,1.0,1,1.0,1,0.20174883654506992,81
3779,2,6043,2985,3058,0,0,0,1.0,1,1.0,1,1.0,1,0.23321726137065804,80
3780,2,6045,2985,3060,0,0,0,1.0,1,1.0,1,1.0,1,0.2158697220341257,80
3781,1,6046,2985,3061,0,0,0,1.0,1,1.0,1,1.0,1,0.20925720103222833,80
3782,2,6048,2986,3062,0,0,0,1.0,1,1.0,1,1.0,1,0.2143280977041349,80
3783,3,6051,2988,3063,0,0,0,1.0,1,1.0,1,1.0,1,0.21962164016094254,80
3784,1,6052,2988,3064,0,0,0,1.0,1,1.0,1,1.0,1,0.20969647907396421,79
3785,1,6053,2988,3065,0,0,0,1.0,1,1.0,1,1.0,1,0.21695785587175784,77
3786,2,6055,2989,3066,0,0,0,1.0,1,1.0,1,1.0,1,0.19510500742230158,78
3787,1,6056,2989,3067,0,0,0,1.0,1,1.0,1,1.0,1,0.19026970974313,77
3788,1,6057,2989,3068,0,0,0,1.0,1,1.0,1,1.0,1,0.18756724904602828,78
3789,3,6060,2990,3070,0,0,0,1.0,1,1.0,1,1.0,1,0.1806638021478989,77
3790,1,6061,2991,3070,0,0,0,1.0,1,1.0,1,1.0,1,0.1958056265541239,77
3791,3,6064,2992,3072,0,0,0,1.0,1,1.0,1,1.0,1,0.1943746840935508,77
3792,1,6065,2992,3073,0,0,0,1.0,1,1.0,1,1.0,1,0.17297155771338354,78
3793,3,6068,2994,3074,0,0,0,1.0,1,1.0,1,1.0,1,0.18048242398511596,80
3794,4,6072,2994,3078,0,0,0,1.0,1,1.0,1,1.0,1,0.13670961827618888,82
3795,0,6072,2994,3078,0,0,0,1.0,1,1.0,1,1.0,1,0.14832028500564137,83
3796,1,6073,2995,3078,0,0,0,1.0,1,1.0,1,1.0,1,0.1421946746661805,83
3797,1,6074,2995,3079,0,0,0,1.0,1,1.0,1,1.0,1,0.14491873562823482,82
3798,1,6075,2996,3079,0,0,0,1.0,1,1.0,1,1.0,1,0.1469988592151074,82
3799,1,6076,2996,3080,0,0,0,1.0,1,1.0,1,1.0,1,0.1454431922649351,83
3800,2,6078,2997,3081,0,0,0,1.0,1,1.0,1,1.0,1,0.1686648255060545,83
3801,3,6081,2998,3083,0,0,0,1.0,1,1.0,1,1.0,1,0.15349420861226207,83
3802,0,6081,2998,3083,0,0,0,1.0,1,1.0,1,1.0,1,0.16617128463765604,82
3803,1,6082,2998,3084,0,0,0,1.0,1,1.0,1,1.0,1,0.1626750040991546,84
3804,1,6083,2998,3085,0,0,0,1.0,1,1.0,1,1.0,1,0.15106943090729436,84
3805,5,6088,2999,3089,0,0,0,1.0,1,1.0,1,1.0,1,0.16045317854272928,86
3806,0,6088,2999,3089,0,0,0,1.0,1,1.0,1,1.0,1,0.16045317854272928,86
3807,4,6092,3000,3092,0,0,0,1.0,1,1.0,1,1.0,1,0.15709682496943048,86
3808,0,6092,3000,3092,0,0,0,1.0,1,1.0,1,1.0,1,0.15846355574842036,85
3809,2,6094,3001,3093,0,0,0,1.0,1,1.0,1,1.0,1,0.16430907462733138,85
3810,2,6096,3002,3094,0,0,0,1.0,1,1.0,1,1.0,1,0.16679385351120174,85
3811,2,6098,3003,3095,0,0,0,1.0,1,1.0,1,1.0,1,0.15935850530700474,84
3812,0,6098,3003,3095,0,0,0,1.0,1,1.0,1,1.0,1,0.15715895570264057,83
3813,0,6098,3003,3095,0,0,0,1.0,1,1.0,1,1.0,1,0.14410199435744944,82
3814,2,6100,3005,3095,0,0,0,1.0,1,1.0,1,1.0,1,0.17425381313349375,81
3815,0,6100,3005,3095,0,0,0,1.0,1,1.0,1,1.0,1,0.17625157785770393,82
3816,2,6102,3006,3096,0,0,0,1.0,1,1.0,1,1.0,1,0.16815582675499227,81
3817,0,6102,3006,3096,0,0,0,1.0,1,1.0,1,1.0,1,0.16815582675499227,81
3818,3,6105,3008,3097,0,0,0,1.0,1,1.0,1,1.0,1,0.19939465760539982,81
3819,3,6108,3009,3099,0,0,0,1.0,1,1.0,1,1.0,1,0.20273023179488062,82
3820,3,6111,3009,3102,0,0,0,1.0,1,1.0,1,1.0,1,0.1829655266526318,84
3821,1,6112,3010,3102,0,0,0,1.0,1,1.0,1,1.0,1,0.21044832584031772,84
3822,1,6113,3010,3103,0,0,0,1.0,1,1.0,1,1.0,1,0.1874352107885619,82
3823,3,6116,3013,3103,0,0,0,1.0,1,1.0,1,1.0,1,0.18876942938126345,81
3824,0,6116,3013,3103,0,0,0,1.0,1,1.0,1,1.0,1,0.21008691230307014,78
3825,4,6120,3013,3107,0,0,0,1.0,1,1.0,1,1.0,1,0.19024958750104573,76
3826,1,6121,3014,3107,0,0,0,1.0,1,1.0,1,1.0,1,0.21451728746099138,76
3827,4,6125,3014,3111,0,0,0,1.0,1,1.0,1,1.0,1,0.16995664615337536,75
3828,2,6127,3015,3112,0,0,0,1.0,1,1.0,1,1.0,1,0.18008291061982543,74
3829,2,6129,3016,3113,0,0,0,1.0,1,1.0,1,1.0,1,0.2019122661769645,74
3830,0,6129,3016,3113,0,0,0,1.0,1,1.0,1,1.0,1,0.2019122661769645,74
3831,4,6133,3018,3115,0,0,0,1.0,1,1.0,1,1.0,1,0.20435976611079035,74
3832,2,6135,3018,3117,0,0,0,1.0,1,1.0,1,1.0,1,0.19383059082485124,73
3833,4,6139,3021,3118,0,0,0,1.0,1,1.0,1,1.0,1,0.19165580421758222,73
3834,0,6139,3021,3118,0,0,0,1.0,1,1.0,1,1.0,1,0.18582944106898044,74
3835,1,6140,3022,3118,0,0,0,1.0,1,1.0,1,1.0,1,0.20350509501685876,75
3836,1,6141,3022,3119,0,0,0,1.0,1,1.0,1,1.0,1,0.19372612796828495,75
3837,2,6143,3023,3120,0,0,0,1.0,1,1.0,1,1.0,1,0.22100897104206899,78
3838,2,6145,3025,3120,0,0,0,1.0,1,1.0,1,1.0,1,0.21837452992643164,78
3839,2,6147,3025,3122,0,0,0,1.0,1,1.0,1,1.0,1,0.20589176679810128,79
3840,4,6151,3026,3125,0,0,0,1.0,1,1.0,1,1.0,1,0.20006766150647265,82
3841,1,6152,3026,3126,0,0,0,1.0,1,1.0,1,1.0,1,0.19181038151040491,82
3842,0,6152,3026,3126,0,0,0,1.0,1,1.0,1,1.0,1,0.18960472466801645,82
3843,1,6153,3026,3127,0,0,0,1.0,1,1.0,1,1.0,1,0.18036394295198935,82
3844,0,6153,3026,3127,0,0,0,1.0,1,1.0,1,1.0,1,0.18585031128182697,83
3845,3,6156,3026,3130,0,0,0,1.0,1,1.0,1,1.0,1,0.17870443569991684,84
3846,1,6157,3026,3131,0,0,0,1.0,1,1.0,1,1.0,1,0.17567015162094698,85
3847,1,6158,3026,3132,0,0,0,1.0,1,1.0,1,1.0,1,0.1813171481821442,84
3848,3,6161,3029,3132,0,0,0,1.0,1,1.0,1,1.0,1,0.21085433935949024,84
3849,1,6162,3029,3133,0,0,0,1.0,1,1.0,1,1.0,1,0.18779055055440785,83
3850,0,6162,3029,3133,0,0,0,1.0,1,1.0,1,1.0,1,0.20676682835889135,80
3851,1,6163,3029,3134,0,0,0,1.0,1,1.0,1,1.0,1,0.19657873555259744,80
3852,0,6163,3029,3134,0,0,0,1.0,1,1.0,1,1.0,1,0.21448605458190517,79
3853,1,6164,3030,3134,0,0,0,1.0,1,1.0,1,1.0,1,0.22417489576186125,79
3854,3,6167,3032,3135,0,0,0,1.0,1,1.0,1,1.0,1,0.24387561233571728,78
3855,2,6169,3033,3136,0,0,0,1.0,1,1.0,1,1.0,1,0.2543614408959806,78
3856,2,6171,3034,3137,0,0,0,1.0,1,1.0,1,1.0,1,0.2698309378188858,80
3857,6,6177,3035,3142,0,0,0,1.0,1,1.0,1,1.0,1,0.23747799439172887,81
3858,1,6178,3036,3142,0,0,0,1.0,1,1.0,1,1.0,1,0.24324830306622006,81
3859,2,6180,3036,3144,0,0,0,1.0,1,1.0,1,1.0,1,0.23871007267855576,83
3860,2,6182,3038,3144,0,0,0,1.0,1,1.0,1,1.0,1,0.2680670363086863,82
3861,6,6188,3039,3149,0,0,0,1.0,1,1.0,1,1.0,1,0.25442932330307183,84
3862,3,6191,3042,3149,0,0,0,1.0,1,1.0,1,1.0,1,0.27822507420849146,85
3863,4,6195,3042,3153,0,0,0,1.0,1,1.0,1,1.0,1,0.24810097521991542,84
3864,1,6196,3043,3153,0,0,0,1.0,1,1.0,1,1.0,1,0.2444413013526436,83
3865,2,6198,3044,3154,0,0,0,1.0,1,1.0,1,1.0,1,0.23951677353138917,82
3866,0,6198,3044,3154,0,0,0,1.0,1,1.0,1,1.0,1,0.2358030583573635,81
3867,2,6200,3046,3154,0,0,0,1.0,1,1.0,1,1.0,1,0.23522607814668056,81
3868,1,6201,3047,3154,0,0,0,1.0,1,1.0,1,1.0,1,0.23901633098487765,81
3869,1,6202,3048,3154,0,0,0,1.0,1,1.0,1,1.0,1,0.24540568940403898,81
3870,1,6203,3049,3154,0,0,0,1.0,1,1.0,1,1.0,1,0.22011186025196805,80
3871,5,6208,3051,3157,0,0,0,1.0,1,1.0,1,1.0,1,0.19859138167388263,82
3872,0,6208,3051,3157,0,0,0,1.0,1,1.0,1,1.0,1,0.1920548295493513,81
3873,0,6208,3051,3157,0,0,0,1.0,1,1.0,1,1.0,1,0.1920548295493513,81
3874,2,6210,3052,3158,0,0,0,1.0,1,1.0,1,1.0,1,0.19108075080083115,78
3875,3,6213,3052,3161,0,0,0,1.0,1,1.0,1,1.0,1,0.15811343666611752,77
3876,3,6216,3054,3162,0,0,0,1.0,1,1.0,1,1.0,1,0.14509040363053016,78
3877,0,6216,3054,3162,0,0,0,1.0,1,1.0,1,1.0,1,0.15403816357892075,75
3878,2,6218,3056,3162,0,0,0,1.0,1,1.0,1,1.0,1,0.15497518269000185,75
3879,0,6218,3056,3162,0,0,0,1.0,1,1.0,1,1.0,1,0.17040758346832113,73
3880,0,6218,3056,3162,0,0,0,1.0,1,1.0,1,1.0,1,0.17133700487124498,74
3881,1,6219,3057,3162,0,0,0,1.0,1,1.0,1,1.0,1,0.19170646941997277,75
3882,0,6219,3057,3162,0,0,0,1.0,1,1.0,1,1.0,1,0.20226085052036677,76
3883,3,6222,3057,3165,0,0,0,1.0,1,1.0,1,1.0,1,0.17189789837663674,77
3884,4,6226,3058,3168,0,0,0,1.0,1,1.0,1,1.0,1,0.14794115904652308,78
3885,3,6229,3058,3171,0,0,0,1.0,1,1.0,1,1.0,1,0.12844054769316338,78
3886,2,6231,3059,3172,0,0,0,1.0,1,1.0,1,1.0,1,0.13581210271926406,79
3887,1,6232,3060,3172,0,0,0,1.0,1,1.0,1,1.0,1,0.146706935552846,78
3888,3,6235,3062,3173,0,0,0,1.0,1,1.0,1,1.0,1,0.15562972646712572,80
3889,1,6236,3062,3174,0,0,0,1.0,1,1.0,1,1.0,1,0.1519690324800072,82
3890,4,6240,3064,3176,0,0,0,1.0,1,1.0,1,1.0,1,0.13548633114370678,82
3891,4,6244,3067,3177,0,0,0,1.0,1,1.0,1,1.0,1,0.15089580619531878,85
3892,3,6247,3068,3179,0,0,0,1.0,1,1.0,1,1.0,1,0.15365973826839582,87
3893,1,6248,3068,3180,0,0,0,1.0,1,1.0,1,1.0,1,0.13619493067484,86
3894,1,6249,3068,3181,0,0,0,1.0,1,1.0,1,1.0,1,0.13858895197691362,87
3895,1,6250,3069,3181,0,0,0,1.0,1,1.0,1,1.0,1,0.15121019561372587,87
3896,1,6251,3070,3181,0,0,0,1.0,1,1.0,1,1.0,1,0.1648595895716963,85
3897,2,6253,3071,3182,0,0,0,1.0,1,1.0,1,1.0,1,0.15640361837036768,85
3898,4,6257,3074,3183,0,0,0,1.0,1,1.0,1,1.0,1,0.18166232340881733,86
3899,4,6261,3076,3185,0,0,0,1.0,1,1.0,1,1.0,1,0.17377616447387034,86
3900,0,6261,3076,3185,0,0,0,1.0,1,1.0,1,1.0,1,0.17377616447387034,86
3901,4,6265,3078,3187,0,0,0,1.0,1,1.0,1,1.0,1,0.1716134999243747,86
3902,0,6265,3078,3187,0,0,0,1.0,1,1.0,1,1.0,1,0.16972854006873897,87
3903,1,6266,3078,3188,0,0,0,1.0,1,1.0,1,1.0,1,0.16293471639077184,87
3904,1,6267,3079,3188,0,0,0,1.0,1,1.0,1,1.0,1,0.17036051133683588,85
3905,1,6268,3079,3189,0,0,0,1.0,1,1.0,1,1.0,1,0.15888996269691738,84
3906,3,6271,3080,3191,0,0,0,1.0,1,1.0,1,1.0,1,0.1402736160085297,86
3907,0,6271,3080,3191,0,0,0,1.0,1,1.0,1,1.0,1,0.14757640780711948,84
3908,1,6272,3081,3191,0,0,0,1.0,1,1.0,1,1.0,1,0.1504452527305451,83
3909,1,6273,3082,3191,0,0,0,1.0,1,1.0,1,1.0,1,0.1632213419744332,81
3910,4,6277,3085,3192,0,0,0,1.0,1,1.0,1,1.0,1,0.16743367399869968,82
3911,4,6281,3086,3195,0,0,0,1.0,1,1.0,1,1.0,1,0.15202905569876746,81
3912,1,6282,3086,3196,0,0,0,1.0,1,1.0,1,1.0,1,0.13567959910632993,80
3913,4,6286,3089,3197,0,0,0,1.0,1,1.0,1,1.0,1,0.1329648827463557,80
3914,2,6288,3090,3198,0,0,0,1.0,1,1.0,1,1.0,1,0.13874185776060147,81
3915,2,6290,3092,3198,0,0,0,1.0,1,1.0,1,1.0,1,0.1598979908005198,81
3916,5,6295,3093,3202,0,0,0,1.0,1,1.0,1,1.0,1,0.15700662990898695,81
3917,6,6301,3095,3206,0,0,0,1.0,1,1.0,1,1.0,1,0.14666420625619958,82
3918,5,6306,3097,3209,0,0,0,1.0,1,1.0,1,1.0,1,0.16569858815178598,85
3919,2,6308,3098,3210,0,0,0,1.0,1,1.0,1,1.0,1,0.16941021882208102,85
3920,3,6311,3099,3212,0,0,0,1.0,1,1.0,1,1.0,1,0.1548968334553127,85
3921,2,6313,3099,3214,0,0,0,1.0,1,1.0,1,1.0,1,0.1452758570376746,88
3922,0,6313,3099,3214,0,0,0,1.0,1,1.0,1,1.0,1,0.1452758570376746,88
3923,3,6316,3100,3216,0,0,0,1.0,1,1.0,1,1.0,1,0.1523189032863019,89
3924,1,6317,3100,3217,0,0,0,1.0,1,1.0,1,1.0,1,0.14036858492394652,90
3925,2,6319,3101,3218,0,0,0,1.0,1,1.0,1,1.0,1,0.13035361491371739,88
3926,0,6319,3101,3218,0,0,0,1.0,1,1.0,1,1.0,1,0.13308239281479062,89
3927,3,6322,3101,3221,0,0,0,1.0,1,1.0,1,1.0,1,0.1251766664849707,89
3928,0,6322,3101,3221,0,0,0,1.0,1,1.0,1,1.0,1,0.12758201732853744,88
3929,1,6323,3102,3221,0,0,0,1.0,1,1.0,1,1.0,1,0.13674412995258511,88
3930,0,6323,3102,3221,0,0,0,1.0,1,1.0,1,1.0,1,0.14583500369216698,87
3931,1,6324,3102,3222,0,0,0,1.0,1,1.0,1,1.0,1,0.14120811439344955,86
3932,1,6325,3103,3222,0,0,0,1.0,1,1.0,1,1.0,1,0.15324640467952244,85
3933,1,6326,3104,3222,0,0,0,1.0,1,1.0,1,1.0,1,0.16162345335833136,84
3934,1,6327,3105,3222,0,0,0,1.0,1,1.0,1,1.0,1,0.1767870422771474,85
3935,2,6329,3107,3222,0,0,0,1.0,1,1.0,1,1.0,1,0.20496942560482057,84
3936,2,6331,3107,3224,0,0,0,1.0,1,1.0,1,1.0,1,0.18251930827303897,84
3937,2,6333,3107,3226,0,0,0,1.0,1,1.0,1,1.0,1,0.15549723233562202,82
3938,0,6333,3107,3226,0,0,0,1.0,1,1.0,1,1.0,1,0.15549723233562202,82
3939,1,6334,3107,3227,0,0,0,1.0,1,1.0,1,1.0,1,0.1516059329321893,84
3940,3,6337,3108,3229,0,0,0,1.0,1,1.0,1,1.0,1,0.13541344395942914,84
3941,2,6339,3108,3231,0,0,0,1.0,1,1.0,1,1.0,1,0.11266769669854358,85
3942,3,6342,3109,3233,0,0,0,1.0,1,1.0,1,1.0,1,0.10114816590626845,85
3943,0,6342,3109,3233,0,0,0,1.0,1,1.0,1,1.0,1,0.09911041108073984,84
3944,5,6347,3113,3234,0,0,0,1.0,1,1.0,1,1.0,1,0.15724843965248056,83
3945,2,6349,3114,3235,0,0,0,1.0,1,1.0,1,1.0,1,0.13746291450093007,83
3946,2,6351,3116,3235,0,0,0,1.0,1,1.0,1,1.0,1,0.16541256328760284,83
3947,2,6353,3116,3237,0,0,0,1.0,1,1.0,1,1.0,1,0.14933762581184515,83
3948,2,6355,3117,3238,0,0,0,1.0,1,1.0,1,1.0,1,0.16890815325010966,84
3949,2,6357,3117,3240,0,0,0,1.0,1,1.0,1,1.0,1,0.17915108230087978,84
3950,2,6359,3118,3241,0,0,0,1.0,1,1.0,1,1.0,1,0.1810516008183731,86
3951,1,6360,3118,3242,0,0,0,1.0,1,1.0,1,1.0,1,0.1746675546101143,87
3952,1,6361,3119,3242,0,0,0,1.0,1,1.0,1,1.0,1,0.174007896779044,86
3953,3,6364,3121,3243,0,0,0,1.0,1,1.0,1,1.0,1,0.18804477365743696,86
3954,3,6367,3121,3246,0,0,0,1.0,1,1.0,1,1.0,1,0.16329454702633203,85
3955,2,6369,3121,3248,0,0,0,1.0,1,1.0,1,1.0,1,0.16917260168051326,85
3956,0,6369,3121,3248,0,0,0,1.0,1,1.0,1,1.0,1,0.17939732663860272,84
3957,0,6369,3121,3248,0,0,0,1.0,1,1.0,1,1.0,1,0.18202700337797253,85
3958,1,6370,3122,3248,0,0,0,1.0,1,1.0,1,1.0,1,0.18302674897562804,84
3959,1,6371,3122,3249,0,0,0,1.0,1,1.0,1,1.0,1,0.1837438124734095,83
3960,1,6372,3122,3250,0,0,0,1.0,1,1.0,1,1.0,1,0.1771364595304094,84
3961,0,6372,3122,3250,0,0,0,1.0,1,1.0,1,1.0,1,0.1850896927207195,83
3962,3,6375,3123,3252,0,0,0,1.0,1,1.0,1,1.0,1,0.16801876880387281,84
3963,0,6375,3123,3252,0,0,0,1.0,1,1.0,1,1.0,1,0.18276362620247422,81
3964,2,6377,3124,3253,0,0,0,1.0,1,1.0,1,1.0,1,0.17467075843651916,81
3965,1,6378,3124,3254,0,0,0,1.0,1,1.0,1,1.0,1,0.16317653303741228,81
3966,3,6381,3127,3254,0,0,0,1.0,1,1.0,1,1.0,1,0.2063444479449599,79
3967,6,6387,3129,3258,0,0,0,1.0,1,1.0,1,1.0,1,0.2066313120781374,81
3968,3,6390,3131,3259,0,0,0,1.0,1,1.0,1,1.0,1,0.18426242824255082,79
3969,4,6394,3134,3260,0,0,0,1.0,1,1.0,1,1.0,1,0.20150262117073223,79
3970,2,6396,3136,3260,0,0,0,1.0,1,1.0,1,1.0,1,0.20598974017813465,78
3971,1,6397,3136,3261,0,0,0,1.0,1,1.0,1,1.0,1,0.1939054289113805,77
3972,1,6398,3137,3261,0,0,0,1.0,1,1.0,1,1.0,1,0.1944881566193343,78
3973,0,6398,3137,3261,0,0,0,1.0,1,1.0,1,1.0,1,0.19011789658450445,77
3974,0,6398,3137,3261,0,0,0,1.0,1,1.0,1,1.0,1,0.19011789658450445,77
3975,1,6399,3138,3261,0,0,0,1.0,1,1.0,1,1.0,1,0.2185124860470136,76
3976,0,6399,3138,3261,0,0,0,1.0,1,1.0,1,1.0,1,0.23062175399484203,77
3977,1,6400,3138,3262,0,0,0,1.0,1,1.0,1,1.0,1,0.23069105222232653,78
3978,2,6402,3138,3264,0,0,0,1.0,1,1.0,1,1.0,1,0.21195181454645198,79
3979,3,6405,3138,3267,0,0,0,1.0,1,1.0,1,1.0,1,0.1939579469176164,79
3980,0,6405,3138,3267,0,0,0,1.0,1,1.0,1,1.0,1,0.1939579469176164,79
3981,5,6410,3140,3270,0,0,0,1.0,1,1.0,1,1.0,1,0.21555151923943833,83
3982,2,6412,3141,3271,0,0,0,1.0,1,1.0,1,1.0,1,0.2144551147801807,83
3983,3,6415,3142,3273,0,0,0,1.0,1,1.0,1,1.0,1,0.19219864712265547,82
3984,2,6417,3143,3274,0,0,0,1.0,1,1.0,1,1.0,1,0.20389825724242436,83
3985,6,6423,3145,3278,0,0,0,1.0,1,1.0,1,1.0,1,0.18794764970395064,84
3986,5,6428,3148,3280,0,0,0,1.0,1,1.0,1,1.0,1,0.2130738731791397,83
3987,3,6431,3150,3281,0,0,0,1.0,1,1.0,1,1.0,1,0.1988739114067514,82
3988,1,6432,3150,3282,0,0,0,1.0,1,1.0,1,1.0,1,0.19965016866949098,83
3989,1,6433,3150,3283,0,0,0,1.0,1,1.0,1,1.0,1,0.203636439124619,81
3990,3,6436,3150,3286,0,0,0,1.0,1,1.0,1,1.0,1,0.17515002974639024,81
3991,1,6437,3150,3287,0,0,0,1.0,1,1.0,1,1.0,1,0.1851931941974546,79
3992,1,6438,3151,3287,0,0,0,1.0,1,1.0,1,1.0,1,0.17295337068472508,81
3993,1,6439,3151,3288,0,0,0,1.0,1,1.0,1,1.0,1,0.173710706636409,80
3994,0,6439,3151,3288,0,0,0,1.0,1,1.0,1,1.0,1,0.173710706636409,80
3995,2,6441,3153,3288,0,0,0,1.0,1,1.0,1,1.0,1,0.18599527318273595,81
3996,1,6442,3153,3289,0,0,0,1.0,1,1.0,1,1.0,1,0.2084066773399429,80
3997,4,6446,3153,3293,0,0,0,1.0,1,1.0,1,1.0,1,0.16951872959379463,81
3998,2,6448,3154,3294,0,0,0,1.0,1,1.0,1,1.0,1,0.16461272389992085,82
3999,4,6452,3155,3297,0,0,0,1.0,1,1.0,1,1.0,1,0.13829231656849234,82
4000,4,6456,3158,3298,0,0,0,1.0,1,1.0,1,1.0,1,0.1622966125119253,82
4001,3,6459,3159,3300,0,0,0,1.0,1,1.0,1,1.0,1,0.16113485591870727,81
4002,1,6460,3160,3300,0,0,0,1.0,1,1.0,1,1.0,1,0.1735584172122863,81
4003,2,6462,3161,3301,0,0,0,1.0,1,1.0,1,1.0,1,0.17881490743115666,81
4004,4,6466,3163,3303,0,0,0,1.0,1,1.0,1,1.0,1,0.16656205732293636,80
4005,1,6467,3164,3303,0,0,0,1.0,1,1.0,1,1.0,1,0.1828623804501991,78
4006,1,6468,3165,3303,0,0,0,1.0,1,1.0,1,1.0,1,0.17150589463100316,76
4007,3,6471,3166,3305,0,0,0,1.0,1,1.0,1,1.0,1,0.16876363282571982,75
4008,3,6474,3168,3306,0,0,0,1.0,1,1.0,1,1.0,1,0.1682447558427263,74
4009,4,6478,3170,3308,0,0,0,1.0,1,1.0,1,1.0,1,0.19839695507412092,75
4010,1,6479,3170,3309,0,0,0,1.0,1,1.0,1,1.0,1,0.21576806348819333,75
4011,2,6481,3172,3309,0,0,0,1.0,1,1.0,1,1.0,1,0.2037228001350079,74
4012,1,6482,3173,3309,0,0,0,1.0,1,1.0,1,1.0,1,0.21357549121420946,74
4013,2,6484,3174,3310,0,0,0,1.0,1,1.0,1,1.0,1,0.20460627882384907,74
4014,1,6485,3175,3310,0,0,0,1.0,1,1.0,1,1.0,1,0.22490911165169802,73
4015,1,6486,3175,3311,0,0,0,1.0,1,1.0,1,1.0,1,0.22688702265932023,74
4016,2,6488,3176,3312,0,0,0,1.0,1,1.0,1,1.0,1,0.23320425284828158,74
4017,3,6491,3176,3315,0,0,0,1.0,1,1.0,1,1.0,1,0.20651983106061597,78
4018,1,6492,3177,3315,0,0,0,1.0,1,1.0,1,1.0,1,0.2211979552005656,78
4019,1,6493,3178,3315,0,0,0,1.0,1,1.0,1,1.0,1,0.22820651515977425,78
4020,0,6493,3178,3315,0,0,0,1.0,1,1.0,1,1.0,1,0.22820651515977425,78
4021,0,6493,3178,3315,0,0,0,1.0,1,1.0,1,1.0,1,0.22820651515977425,78
4022,1,6494,3179,3315,0,0,0,1.0,1,1.0,1,1.0,1,0.22792730359737715,79
4023,0,6494,3179,3315,0,0,0,1.0,1,1.0,1,1.0,1,0.22150035348249358,78
4024,1,6495,3180,3315,0,0,0,1.0,1,1.0,1,1.0,1,0.22276304904463576,77
4025,1,6496,3181,3315,0,0,0,1.0,1,1.0,1,1.0,1,0.24129849405446452,76
4026,2,6498,3183,3315,0,0,0,1.0,1,1.0,1,1.0,1,0.24403730998726297,76
4027,5,6503,3185,3318,0,0,0,1.0,1,1.0,1,1.0,1,0.22861442687835087,75
4028,4,6507,3186,3321,0,0,0,1.0,1,1.0,1,1.0,1,0.20926848358000488,76
4029,5,6512,3188,3324,0,0,0,1.0,1,1.0,1,1.0,1,0.2089318995184886,75
4030,2,6514,3189,3325,0,0,0,1.0,1,1.0,1,1.0,1,0.20495468526942742,74
4031,4,6518,3191,3327,0,0,0,1.0,1,1.0,1,1.0,1,0.20464506812914338,73
4032,0,6518,3191,3327,0,0,0,1.0,1,1.0,1,1.0,1,0.1918380775869934,71
4033,1,6519,3191,3328,0,0,0,1.0,1,1.0,1,1.0,1,0.17732343957963678,73
4034,3,6522,3193,3329,0,0,0,1.0,1,1.0,1,1.0,1,0.16451007086600372,72
4035,1,6523,3193,3330,0,0,0,1.0,1,1.0,1,1.0,1,0.1686186413517204,71
4036,2,6525,3194,3331,0,0,0,1.0,1,1.0,1,1.0,1,0.15922817852746296,71
4037,1,6526,3195,3331,0,0,0,1.0,1,1.0,1,1.0,1,0.18280652728766167,70
4038,0,6526,3195,3331,0,0,0,1.0,1,1.0,1,1.0,1,0.2014285551051691,69
4039,2,6528,3196,3332,0,0,0,1.0,1,1.0,1,1.0,1,0.24434161296789023,68
4040,3,6531,3198,3333,0,0,0,1.0,1,1.0,1,1.0,1,0.2551531249606436,69
4041,2,6533,3198,3335,0,0,0,1.0,1,1.0,1,1.0,1,0.2438519558709523,67
4042,2,6535,3199,3336,0,0,0,1.0,1,1.0,1,1.0,1,0.2846445902696981,67
4043,2,6537,3200,3337,0,0,0,1.0,1,1.0,1,1.0,1,0.315704260417055,66
4044,3,6540,3202,3338,0,0,0,1.0,1,1.0,1,1.0,1,0.31754921622836785,65
4045,0,6540,3202,3338,0,0,0,1.0,1,1.0,1,1.0,1,0.324172799852359,66
4046,0,6540,3202,3338,0,0,0,1.0,1,1.0,1,1.0,1,0.3390218203503906,68
4047,1,6541,3203,3338,0,0,0,1.0,1,1.0,1,1.0,1,0.3465100665511185,68
4048,3,6544,3203,3341,0,0,0,1.0,1,1.0,1,1.0,1,0.3270101346165025,69
4049,0,6544,3203,3341,0,0,0,1.0,1,1.0,1,1.0,1,0.3270101346165025,69
4050,0,6544,3203,3341,0,0,0,1.0,1,1.0,1,1.0,1,0.32099497353916784,69
4051,0,6544,3203,3341,0,0,0,1.0,1,1.0,1,1.0,1,0.32099497353916784,69
4052,2,6546,3204,3342,0,0,0,1.0,1,1.0,1,1.0,1,0.3027133438474991,69
4053,1,6547,3204,3343,0,0,0,1.0,1,1.0,1,1.0,1,0.2920111511712253,69
4054,0,6547,3204,3343,0,0,0,1.0,1,1.0,1,1.0,1,0.28881521643899044,70
4055,1,6548,3204,3344,0,0,0,1.0,1,1.0,1,1.0,1,0.2688248588949025,70
4056,0,6548,3204,3344,0,0,0,1.0,1,1.0,1,1.0,1,0.2688248588949025,70
4057,1,6549,3204,3345,0,0,0,1.0,1,1.0,1,1.0,1,0.26533856547408735,71
4058,0,6549,3204,3345,0,0,0,1.0,1,1.0,1,1.0,1,0.26533856547408735,71
4059,2,6551,3205,3346,0,0,0,1.0,1,1.0,1,1.0,1,0.2583246830908889,72
4060,2,6553,3206,3347,0,0,0,1.0,1,1.0,1,1.0,1,0.2705809315974922,71
4061,1,6554,3207,3347,0,0,0,1.0,1,1.0,1,1.0,1,0.29274116051794674,72
4062,6,6560,3209,3351,0,0,0,1.0,1,1.0,1,1.0,1,0.2519615851357676,72
4063,5,6565,3211,3354,0,0,0,1.0,1,1.0,1,1.0,1,0.21783000879964523,72
4064,2,6567,3213,3354,0,0,0,1.0,1,1.0,1,1.0,1,0.22042881450204402,71
4065,3,6570,3215,3355,0,0,0,1.0,1,1.0,1,1.0,1,0.20192896929980453,70
4066,3,6573,3217,3356,0,0,0,1.0,1,1.0,1,1.0,1,0.2071153224233591,70
4067,4,6577,3218,3359,0,0,0,1.0,1,1.0,1,1.0,1,0.17794546301882655,68
4068,2,6579,3218,3361,0,0,0,1.0,1,1.0,1,1.0,1,0.17982916258259782,70
4069,2,6581,3220,3361,0,0,0,1.0,1,1.0,1,1.0,1,0.19843771539629768,68
4070,1,6582,3221,3361,0,0,0,1.0,1,1.0,1,1.0,1,0.19690705045774035,67
4071,2,6584,3222,3362,0,0,0,1.0,1,1.0,1,1.0,1,0.19039132444367535,68
4072,4,6588,3224,3364,0,0,0,1.0,1,1.0,1,1.0,1,0.1794956583311318,70
4073,4,6592,3226,3366,0,0,0,1.0,1,1.0,1,1.0,1,0.14294624386872962,70
4074,8,6600,3231,3369,0,0,0,1.0,1,1.0,1,1.0,1,0.18314914051622608,71
4075,3,6603,3234,3369,0,0,0,1.0,1,1.0,1,1.0,1,0.1926634318802498,72
4076,5,6608,3237,3371,0,0,0,1.0,1,1.0,1,1.0,1,0.1991918146092309,73
4077,2,6610,3237,3373,0,0,0,1.0,1,1.0,1,1.0,1,0.19841195572744902,72
4078,3,6613,3240,3373,0,0,0,1.0,1,1.0,1,1.0,1,0.22806913927783062,71
4079,3,6616,3242,3374,0,0,0,1.0,1,1.0,1,1.0,1,0.24404908235070935,69
4080,1,6617,3243,3374,0,0,0,1.0,1,1.0,1,1.0,1,0.25409963974955296,67
4081,4,6621,3243,3378,0,0,0,1.0,1,1.0,1,1.0,1,0.2034627894849299,66
4082,0,6621,3243,3378,0,0,0,1.0,1,1.0,1,1.0,1,0.2231214925054349,65
4083,2,6623,3244,3379,0,0,0,1.0,1,1.0,1,1.0,1,0.22756260784141571,64
4084,2,6625,3246,3379,0,0,0,1.0,1,1.0,1,1.0,1,0.2568388532857892,64
4085,3,6628,3246,3382,0,0,0,1.0,1,1.0,1,1.0,1,0.21889761879936576,65
4086,1,6629,3247,3382,0,0,0,1.0,1,1.0,1,1.0,1,0.21114349153107598,66
4087,2,6631,3248,3383,0,0,0,1.0,1,1.0,1,1.0,1,0.19857843623584936,66
4088,0,6631,3248,3383,0,0,0,1.0,1,1.0,1,1.0,1,0.2145296749037159,65
4089,0,6631,3248,3383,0,0,0,1.0,1,1.0,1,1.0,1,0.2145296749037159,65
4090,0,6631,3248,3383,0,0,0,1.0,1,1.0,1,1.0,1,0.224453756928814,65
4091,1,6632,3248,3384,0,0,0,1.0,1,1.0,1,1.0,1,0.21773336678700123,65
4092,1,6633,3248,3385,0,0,0,1.0,1,1.0,1,1.0,1,0.2142511304019801,64
4093,2,6635,3248,3387,0,0,0,1.0,1,1.0,1,1.0,1,0.19198903917050408,66
4094,0,6635,3248,3387,0,0,0,1.0,1,1.0,1,1.0,1,0.21028372529216832,65
4095,0,6635,3248,3387,0,0,0,1.0,1,1.0,1,1.0,1,0.21028372529216832,65
4096,2,6637,3250,3387,0,0,0,1.0,1,1.0,1,1.0,1,0.21648306299211623,67
4097,9,6646,3254,3392,0,0,0,1.0,1,1.0,1,1.0,1,0.16566190290713442,67
4098,3,6649,3256,3393,0,0,0,1.0,1,1.0,1,1.0,1,0.18725286249664966,68
4099,5,6654,3257,3397,0,0,0,1.0,1,1.0,1,1.0,1,0.1626986641141599,69
4100,1,6655,3257,3398,0,0,0,1.0,1,1.0,1,1.0,1,0.1520290906349236,70
4101,3,6658,3258,3400,0,0,0,1.0,1,1.0,1,1.0,1,0.15353116734822783,71
4102,2,6660,3260,3400,0,0,0,1.0,1,1.0,1,1.0,1,0.15400959267107756,71
4103,0,6660,3260,3400,0,0,0,1.0,1,1.0,1,1.0,1,0.1537637107046698,71
4104,4,6664,3263,3401,0,0,0,1.0,1,1.0,1,1.0,1,0.1955832823633751,69
4105,0,6664,3263,3401,0,0,0,1.0,1,1.0,1,1.0,1,0.20008908667298098,67
4106,2,6666,3264,3402,0,0,0,1.0,1,1.0,1,1.0,1,0.20033744177589877,68
4107,4,6670,3264,3406,0,0,0,1.0,1,1.0,1,1.0,1,0.16738431261968498,70
4108,0,6670,3264,3406,0,0,0,1.0,1,1.0,1,1.0,1,0.16525443880651103,70
4109,0,6670,3264,3406,0,0,0,1.0,1,1.0,1,1.0,1,0.1732251660490078,69
4110,0,6670,3264,3406,0,0,0,1.0,1,1.0,1,1.0,1,0.15246112627596814,71
4111,1,6671,3264,3407,0,0,0,1.0,1,1.0,1,1.0,1,0.13687645705501145,70
4112,0,6671,3264,3407,0,0,0,1.0,1,1.0,1,1.0,1,0.13798610808852604,72
4113,0,6671,3264,3407,0,0,0,1.0,1,1.0,1,1.0,1,0.13798610808852604,72
4114,3,6674,3266,3408,0,0,0,1.0,1,1.0,1,1.0,1,0.170639861674288,72
4115,1,6675,3267,3408,0,0,0,1.0,1,1.0,1,1.0,1,0.16749731295199488,70
4116,1,6676,3268,3408,0,0,0,1.0,1,1.0,1,1.0,1,0.18588692823296835,67
4117,2,6678,3269,3409,0,0,0,1.0,1,1.0,1,1.0,1,0.2003142100497775,67
4118,1,6679,3269,3410,0,0,0,1.0,1,1.0,1,1.0,1,0.20673609241300747,66
4119,3,6682,3271,3411,0,0,0,1.0,1,1.0,1,1.0,1,0.24813238205556493,67
4120,1,6683,3271,3412,0,0,0,1.0,1,1.0,1,1.0,1,0.28184444940757347,64
4121,5,6688,3272,3416,0,0,0,1.0,1,1.0,1,1.0,1,0.2576528086088456,63
4122,3,6691,3274,3417,0,0,0,1.0,1,1.0,1,1.0,1,0.2506149603451907,63
4123,2,6693,3276,3417,0,0,0,1.0,1,1.0,1,1.0,1,0.23032655566711221,61
4124,3,6696,3279,3417,0,0,0,1.0,1,1.0,1,1.0,1,0.26425756053847227,62
4125,2,6698,3279,3419,0,0,0,1.0,1,1.0,1,1.0,1,0.22650660998761407,60
4126,2,6700,3281,3419,0,0,0,1.0,1,1.0,1,1.0,1,0.23791702615176516,59
4127,2,6702,3282,3420,0,0,0,1.0,1,1.0,1,1.0,1,0.25103273381653635,60
4128,2,6704,3283,3421,0,0,0,1.0,1,1.0,1,1.0,1,0.24546376485121277,60
4129,2,6706,3283,3423,0,0,0,1.0,1,1.0,1,1.0,1,0.23453589314907222,60
4130,2,6708,3284,3424,0,0,0,1.0,1,1.0,1,1.0,1,0.22004598994895147,61
4131,1,6709,3284,3425,0,0,0,1.0,1,1.0,1,1.0,1,0.20499855589643626,60
4132,1,6710,3285,3425,0,0,0,1.0,1,1.0,1,1.0,1,0.21725446701012516,60
4133,3,6713,3286,3427,0,0,0,1.0,1,1.0,1,1.0,1,0.21196331693628506,62
4134,0,6713,3286,3427,0,0,0,1.0,1,1.0,1,1.0,1,0.19602464297934669,63
4135,3,6716,3287,3429,0,0,0,1.0,1,1.0,1,1.0,1,0.16926033040051616,65
4136,1,6717,3288,3429,0,0,0,1.0,1,1.0,1,1.0,1,0.18610981471974947,65
4137,1,6718,3289,3429,0,0,0,1.0,1,1.0,1,1.0,1,0.1914935141299929,66
4138,1,6719,3290,3429,0,0,0,1.0,1,1.0,1,1.0,1,0.19627355547395883,67
4139,2,6721,3292,3429,0,0,0,1.0,1,1.0,1,1.0,1,0.23485256235599833,67
4140,0,6721,3292,3429,0,0,0,1.0,1,1.0,1,1.0,1,0.2225814415795693,66
4141,1,6722,3292,3430,0,0,0,1.0,1,1.0,1,1.0,1,0.207201289076877,67
4142,1,6723,3293,3430,0,0,0,1.0,1,1.0,1,1.0,1,0.21302397074265622,67
4143,2,6725,3294,3431,0,0,0,1.0,1,1.0,1,1.0,1,0.19277118816336028,66
4144,2,6727,3295,3432,0,0,0,1.0,1,1.0,1,1.0,1,0.19949659175947804,64
4145,3,6730,3296,3434,0,0,0,1.0,1,1.0,1,1.0,1,0.18499866341064877,63
4146,2,6732,3298,3434,0,0,0,1.0,1,1.0,1,1.0,1,0.20818215007481033,62
4147,1,6733,3298,3435,0,0,0,1.0,1,1.0,1,1.0,1,0.19236954623957891,60
4148,4,6737,3300,3437,0,0,0,1.0,1,1.0,1,1.0,1,0.1706240485652645,62
4149,2,6739,3302,3437,0,0,0,1.0,1,1.0,1,1.0,1,0.17650108933111228,61
4150,2,6741,3304,3437,0,0,0,1.0,1,1.0,1,1.0,1,0.19164716190397874,60
4151,5,6746,3306,3440,0,0,0,1.0,1,1.0,1,1.0,1,0.1705055311454848,60
4152,2,6748,3307,3441,0,0,0,1.0,1,1.0,1,1.0,1,0.16980451620104892,60
4153,2,6750,3308,3442,0,0,0,1.0,1,1.0,1,1.0,1,0.15252905887448712,58
4154,0,6750,3308,3442,0,0,0,1.0,1,1.0,1,1.0,1,0.17209307422903963,57
4155,4,6754,3310,3444,0,0,0,1.0,1,1.0,1,1.0,1,0.18926195663708523,57
4156,4,6758,3313,3445,0,0,0,1.0,1,1.0,1,1.0,1,0.20299897777672704,58
4157,0,6758,3313,3445,0,0,0,1.0,1,1.0,1,1.0,1,0.20453555533005124,57
4158,1,6759,3314,3445,0,0,0,1.0,1,1.0,1,1.0,1,0.22798218520585645,55
4159,1,6760,3314,3446,0,0,0,1.0,1,1.0,1,1.0,1,0.2264209007736026,57
4160,1,6761,3315,3446,0,0,0,1.0,1,1.0,1,1.0,1,0.22846971462104196,58
4161,2,6763,3315,3448,0,0,0,1.0,1,1.0,1,1.0,1,0.19897779729721138,58
4162,0,6763,3315,3448,0,0,0,1.0,1,1.0,1,1.0,1,0.2028311690267876,57
4163,1,6764,3316,3448,0,0,0,1.0,1,1.0,1,1.0,1,0.2237098277494397,58
4164,3,6767,3319,3448,0,0,0,1.0,1,1.0,1,1.0,1,0.29064067784331965,56
4165,4,6771,3320,3451,0,0,0,1.0,1,1.0,1,1.0,1,0.2925693075884808,58
4166,1,6772,3320,3452,0,0,0,1.0,1,1.0,1,1.0,1,0.2686497910563334,57
4167,2,6774,3320,3454,0,0,0,1.0,1,1.0,1,1.0,1,0.2798297263898014,57
4168,1,6775,3320,3455,0,0,0,1.0,1,1.0,1,1.0,1,0.266720199230344,58
4169,1,6776,3321,3455,0,0,0,1.0,1,1.0,1,1.0,1,0.2673157766453322,58
4170,2,6778,3322,3456,0,0,0,1.0,1,1.0,1,1.0,1,0.28020015782122343,58
4171,0,6778,3322,3456,0,0,0,1.0,1,1.0,1,1.0,1,0.29950356002638623,57
4172,0,6778,3322,3456,0,0,0,1.0,1,1.0,1,1.0,1,0.29950356002638623,57
4173,2,6780,3322,3458,0,0,0,1.0,1,1.0,1,1.0,1,0.3098139614191359,56
4174,0,6780,3322,3458,0,0,0,1.0,1,1.0,1,1.0,1,0.3098139614191359,56
4175,3,6783,3322,3461,0,0,0,1.0,1,1.0,1,1.0,1,0.28773295484363737,55
4176,1,6784,3322,3462,0,0,0,1.0,1,1.0,1,1.0,1,0.2955100524691722,57
4177,5,6789,3323,3466,0,0,0,1.0,1,1.0,1,1.0,1,0.2817087656495516,58
4178,5,6794,3325,3469,0,0,0,1.0,1,1.0,1,1.0,1,0.24335856320905233,60
4179,5,6799,3326,3473,0,0,0,1.0,1,1.0,1,1.0,1,0.18342986341111905,61
4180,0,6799,3326,3473,0,0,0,1.0,1,1.0,1,1.0,1,0.17958996440289454,62
4181,0,6799,3326,3473,0,0,0,1.0,1,1.0,1,1.0,1,0.1856928405675665,63
4182,1,6800,3327,3473,0,0,0,1.0,1,1.0,1,1.0,1,0.20544092085700685,63
4183,1,6801,3327,3474,0,0,0,1.0,1,1.0,1,1.0,1,0.1884311194509722,63
4184,4,6805,3330,3475,0,0,0,1.0,1,1.0,1,1.0,1,0.19886690476612268,63
4185,1,6806,3330,3476,0,0,0,1.0,1,1.0,1,1.0,1,0.18965223582299606,61
4186,6,6812,3333,3479,0,0,0,1.0,1,1.0,1,1.0,1,0.1594816434143785,62
4187,2,6814,3334,3480,0,0,0,1.0,1,1.0,1,1.0,1,0.16172413337134622,60
4188,1,6815,3335,3480,0,0,0,1.0,1,1.0,1,1.0,1,0.16799761991052553,60
4189,1,6816,3335,3481,0,0,0,1.0,1,1.0,1,1.0,1,0.14807506321146197,60
4190,1,6817,3336,3481,0,0,0,1.0,1,1.0,1,1.0,1,0.16266768409414342,61
4191,1,6818,3337,3481,0,0,0,1.0,1,1.0,1,1.0,1,0.17748208762700574,59
4192,1,6819,3338,3481,0,0,0,1.0,1,1.0,1,1.0,1,0.1957768666812108,58
4193,1,6820,3339,3481,0,0,0,1.0,1,1.0,1,1.0,1,0.20593438942961495,57
4194,1,6821,3340,3481,0,0,0,1.0,1,1.0,1,1.0,1,0.23138541805593152,54
4195,1,6822,3340,3482,0,0,0,1.0,1,1.0,1,1.0,1,0.21582059903002473,55
4196,0,6822,3340,3482,0,0,0,1.0,1,1.0,1,1.0,1,0.231805916271167,56
4197,1,6823,3341,3482,0,0,0,1.0,1,1.0,1,1.0,1,0.24381772340643762,55
4198,2,6825,3342,3483,0,0,0,1.0,1,1.0,1,1.0,1,0.2728144901601406,56
4199,2,6827,3343,3484,0,0,0,1.0,1,1.0,1,1.0,1,0.3013660960487045,55
4200,0,6827,3343,3484,0,0,0,1.0,1,1.0,1,1.0,1,0.30138568224846607,55
4201,0,6827,3343,3484,0,0,0,1.0,1,1.0,1,1.0,1,0.2849846011834057,56
4202,0,6827,3343,3484,0,0,0,1.0,1,1.0,1,1.0,1,0.2849846011834057,56
4203,1,6828,3343,3485,0,0,0,1.0,1,1.0,1,1.0,1,0.28918047667119495,57
4204,1,6829,3343,3486,0,0,0,1.0,1,1.0,1,1.0,1,0.27942983380253583,57
4205,1,6830,3344,3486,0,0,0,1.0,1,1.0,1,1.0,1,0.27143741085590983,58
4206,3,6833,3346,3487,0,0,0,1.0,1,1.0,1,1.0,1,0.2542959399427723,58
4207,6,6839,3348,3491,0,0,0,1.0,1,1.0,1,1.0,1,0.19923854789054785,58
4208,3,6842,3349,3493,0,0,0,1.0,1,1.0,1,1.0,1,0.19546932806745643,60
4209,3,6845,3351,3494,0,0,0,1.0,1,1.0,1,1.0,1,0.18978162711056415,61
4210,1,6846,3352,3494,0,0,0,1.0,1,1.0,1,1.0,1,0.18355029843606047,62
4211,0,6846,3352,3494,0,0,0,1.0,1,1.0,1,1.0,1,0.17938768878498143,63
4212,1,6847,3352,3495,0,0,0,1.0,1,1.0,1,1.0,1,0.16596144827283535,64
4213,0,6847,3352,3495,0,0,0,1.0,1,1.0,1,1.0,1,0.16649706753163462,65
4214,0,6847,3352,3495,0,0,0,1.0,1,1.0,1,1.0,1,0.17320763557244961,65
4215,0,6847,3352,3495,0,0,0,1.0,1,1.0,1,1.0,1,0.17320763557244961,65
4216,0,6847,3352,3495,0,0,0,1.0,1,1.0,1,1.0,1,0.1843087531141185,64
4217,1,6848,3353,3495,0,0,0,1.0,1,1.0,1,1.0,1,0.20357035630549458,65
4218,0,6848,3353,3495,0,0,0,1.0,1,1.0,1,1.0,1,0.20357035630549458,65
4219,3,6851,3354,3497,0,0,0,1.0,1,1.0,1,1.0,1,0.2049801703915526,65
4220,0,6851,3354,3497,0,0,0,1.0,1,1.0,1,1.0,1,0.2049801703915526,65
4221,2,6853,3355,3498,0,0,0,1.0,1,1.0,1,1.0,1,0.22790800614295367,67
4222,0,6853,3355,3498,0,0,0,1.0,1,1.0,1,1.0,1,0.23321682940116084,68
4223,2,6855,3357,3498,0,0,0,1.0,1,1.0,1,1.0,1,0.2565679460717474,68
4224,2,6857,3358,3499,0,0,0,1.0,1,1.0,1,1.0,1,0.2681749589657065,68
4225,2,6859,3358,3501,0,0,0,1.0,1,1.0,1,1.0,1,0.24777827533802635,66
4226,1,6860,3359,3501,0,0,0,1.0,1,1.0,1,1.0,1,0.26488326166469073,66
4227,1,6861,3359,3502,0,0,0,1.0,1,1.0,1,1.0,1,0.25632258674398667,66
4228,0,6861,3359,3502,0,0,0,1.0,1,1.0,1,1.0,1,0.24964236987827756,65
4229,1,6862,3360,3502,0,0,0,1.0,1,1.0,1,1.0,1,0.2547587436542775,65
4230,3,6865,3361,3504,0,0,0,1.0,1,1.0,1,1.0,1,0.2449339504631538,64
4231,1,6866,3361,3505,0,0,0,1.0,1,1.0,1,1.0,1,0.23784539933357562,64
4232,2,6868,3362,3506,0,0,0,1.0,1,1.0,1,1.0,1,0.23404556720943814,65
4233,2,6870,3362,3508,0,0,0,1.0,1,1.0,1,1.0,1,0.2213546167523516,64
4234,1,6871,3362,3509,0,0,0,1.0,1,1.0,1,1.0,1,0.211824044068529,63
4235,2,6873,3364,3509,0,0,0,1.0,1,1.0,1,1.0,1,0.2132041194132392,63
4236,0,6873,3364,3509,0,0,0,1.0,1,1.0,1,1.0,1,0.2132041194132392,63
4237,4,6877,3366,3511,0,0,0,1.0,1,1.0,1,1.0,1,0.21892824697578508,65
4238,1,6878,3366,3512,0,0,0,1.0,1,1.0,1,1.0,1,0.2113402869611514,65
4239,2,6880,3366,3514,0,0,0,1.0,1,1.0,1,1.0,1,0.19197599515051816,65
4240,1,6881,3367,3514,0,0,0,1.0,1,1.0,1,1.0,1,0.18052526994040086,66
4241,0,6881,3367,3514,0,0,0,1.0,1,1.0,1,1.0,1,0.18052526994040086,66
4242,1,6882,3367,3515,0,0,0,1.0,1,1.0,1,1.0,1,0.15166441702374373,69
4243,1,6883,3367,3516,0,0,0,1.0,1,1.0,1,1.0,1,0.16144285099162978,71
4244,0,6883,3367,3516,0,0,0,1.0,1,1.0,1,1.0,1,0.16144285099162978,71
4245,1,6884,3367,3517,0,0,0,1.0,1,1.0,1,1.0,1,0.15569079206749292,73
4246,1,6885,3367,3518,0,0,0,1.0,1,1.0,1,1.0,1,0.12997150771346125,74
4247,1,6886,3367,3519,0,0,0,1.0,1,1.0,1,1.0,1,0.1280430246011209,74
4248,0,6886,3367,3519,0,0,0,1.0,1,1.0,1,1.0,1,0.1280430246011209,74
4249,0,6886,3367,3519,0,0,0,1.0,1,1.0,1,1.0,1,0.1280430246011209,74
4250,0,6886,3367,3519,0,0,0,1.0,1,1.0,1,1.0,1,0.1280430246011209,74
4251,0,6886,3367,3519,0,0,0,1.0,1,1.0,1,1.0,1,0.1315145585015215,75
4252,2,6888,3369,3519,0,0,0,1.0,1,1.0,1,1.0,1,0.1759855165813742,75
4253,2,6890,3369,3521,0,0,0,1.0,1,1.0,1,1.0,1,0.16160476117976164,76
4254,2,6892,3371,3521,0,0,0,1.0,1,1.0,1,1.0,1,0.17494189285648543,75
4255,4,6896,3374,3522,0,0,0,1.0,1,1.0,1,1.0,1,0.1885259552962653,76
4256,2,6898,3375,3523,0,0,0,1.0,1,1.0,1,1.0,1,0.20090592583193845,78
4257,2,6900,3376,3524,0,0,0,1.0,1,1.0,1,1.0,1,0.17586720977550252,78
4258,0,6900,3376,3524,0,0,0,1.0,1,1.0,1,1.0,1,0.18772408859362016,77
4259,3,6903,3378,3525,0,0,0,1.0,1,1.0,1,1.0,1,0.203342448917898,78
4260,3,6906,3378,3528,0,0,0,1.0,1,1.0,1,1.0,1,0.1736564510770033,77
4261,1,6907,3379,3528,0,0,0,1.0,1,1.0,1,1.0,1,0.17625421892974816,76
4262,0,6907,3379,3528,0,0,0,1.0,1,1.0,1,1.0,1,0.18813939131952678,75
4263,4,6911,3383,3528,0,0,0,1.0,1,1.0,1,1.0,1,0.1810490707525586,74
4264,4,6915,3383,3532,0,0,0,1.0,1,1.0,1,1.0,1,0.1853293415489299,74
4265,3,6918,3385,3533,0,0,0,1.0,1,1.0,1,1.0,1,0.18122219140859339,73
4266,0,6918,3385,3533,0,0,0,1.0,1,1.0,1,1.0,1,0.208910312055217,71
4267,4,6922,3388,3534,0,0,0,1.0,1,1.0,1,1.0,1,0.20274600897465558,69
4268,2,6924,3390,3534,0,0,0,1.0,1,1.0,1,1.0,1,0.24877816708756212,67
4269,5,6929,3391,3538,0,0,0,1.0,1,1.0,1,1.0,1,0.2014214487986733,64
4270,2,6931,3392,3539,0,0,0,1.0,1,1.0,1,1.0,1,0.20576598737951723,63
4271,1,6932,3393,3539,0,0,0,1.0,1,1.0,1,1.0,1,0.22957683768137885,63
4272,1,6933,3394,3539,0,0,0,1.0,1,1.0,1,1.0,1,0.2341714815810543,62
4273,3,6936,3394,3542,0,0,0,1.0,1,1.0,1,1.0,1,0.20811240727978148,62
4274,1,6937,3394,3543,0,0,0,1.0,1,1.0,1,1.0,1,0.21572467198747505,62
4275,2,6939,3395,3544,0,0,0,1.0,1,1.0,1,1.0,1,0.19085009424226312,61
4276,0,6939,3395,3544,0,0,0,1.0,1,1.0,1,1.0,1,0.20139118349458687,62
4277,0,6939,3395,3544,0,0,0,1.0,1,1.0,1,1.0,1,0.21029086500243233,63
4278,0,6939,3395,3544,0,0,0,1.0,1,1.0,1,1.0,1,0.2011717086671969,64
4279,4,6943,3398,3545,0,0,0,1.0,1,1.0,1,1.0,1,0.21217438045417075,65
4280,1,6944,3399,3545,0,0,0,1.0,1,1.0,1,1.0,1,0.2099573889521437,65
4281,2,6946,3399,3547,0,0,0,1.0,1,1.0,1,1.0,1,0.19798809232803735,65
4282,5,6951,3403,3548,0,0,0,1.0,1,1.0,1,1.0,1,0.24451359651886834,66
4283,4,6955,3404,3551,0,0,0,1.0,1,1.0,1,1.0,1,0.2329370818666023,66
4284,2,6957,3405,3552,0,0,0,1.0,1,1.0,1,1.0,1,0.24811994320703729,66
4285,1,6958,3405,3553,0,0,0,1.0,1,1.0,1,1.0,1,0.24807992836077397,67
4286,0,6958,3405,3553,0,0,0,1.0,1,1.0,1,1.0,1,0.25904592639016655,67
4287,1,6959,3405,3554,0,0,0,1.0,1,1.0,1,1.0,1,0.25144319685397226,67
4288,2,6961,3405,3556,0,0,0,1.0,1,1.0,1,1.0,1,0.21838465951487032,68
4289,1,6962,3405,3557,0,0,0,1.0,1,1.0,1,1.0,1,0.2304899715830837,68
4290,1,6963,3405,3558,0,0,0,1.0,1,1.0,1,1.0,1,0.21912390188850672,70
4291,1,6964,3405,3559,0,0,0,1.0,1,1.0,1,1.0,1,0.2070702951188146,71
4292,1,6965,3405,3560,0,0,0,1.0,1,1.0,1,1.0,1,0.19859720973096806,71
4293,1,6966,3405,3561,0,0,0,1.0,1,1.0,1,1.0,1,0.19577284793501923,71
4294,0,6966,3405,3561,0,0,0,1.0,1,1.0,1,1.0,1,0.19577284793501923,71
4295,1,6967,3406,3561,0,0,0,1.0,1,1.0,1,1.0,1,0.21740634796069166,72
4296,1,6968,3406,3562,0,0,0,1.0,1,1.0,1,1.0,1,0.22079715360852054,73
4297,0,6968,3406,3562,0,0,0,1.0,1,1.0,1,1.0,1,0.22079715360852054,73
4298,1,6969,3406,3563,0,0,0,1.0,1,1.0,1,1.0,1,0.22007029736162417,74
4299,0,6969,3406,3563,0,0,0,1.0,1,1.0,1,1.0,1,0.2104441543321602,75
4300,1,6970,3406,3564,0,0,0,1.0,1,1.0,1,1.0,1,0.19597056241451843,75
4301,0,6970,3406,3564,0,0,0,1.0,1,1.0,1,1.0,1,0.19409722913654523,76
4302,1,6971,3407,3564,0,0,0,1.0,1,1.0,1,1.0,1,0.19278464973392656,76
4303,3,6974,3407,3567,0,0,0,1.0,1,1.0,1,1.0,1,0.1625769334534862,75
4304,1,6975,3408,3567,0,0,0,1.0,1,1.0,1,1.0,1,0.19104903161978823,75
4305,6,6981,3409,3572,0,0,0,1.0,1,1.0,1,1.0,1,0.18831194950732993,73
4306,6,6987,3413,3574,0,0,0,1.0,1,1.0,1,1.0,1,0.2103907656336465,74
4307,2,6989,3415,3574,0,0,0,1.0,1,1.0,1,1.0,1,0.22876212315237135,73
4308,0,6989,3415,3574,0,0,0,1.0,1,1.0,1,1.0,1,0.2529973911393236,71
4309,1,6990,3416,3574,0,0,0,1.0,1,1.0,1,1.0,1,0.2502327802565416,70
4310,2,6992,3417,3575,0,0,0,1.0,1,1.0,1,1.0,1,0.24998947882259356,69
4311,5,6997,3420,3577,0,0,0,1.0,1,1.0,1,1.0,1,0.2351131580596725,69
4312,2,6999,3421,3578,0,0,0,1.0,1,1.0,1,1.0,1,0.2495343578983008,66
4313,0,6999,3421,3578,0,0,0,1.0,1,1.0,1,1.0,1,0.253471345411026,64
4314,1,7000,3421,3579,0,0,0,1.0,1,1.0,1,1.0,1,0.27242423707286023,61
4315,2,7002,3423,3579,0,0,0,1.0,1,1.0,1,1.0,1,0.2679221920118343,61
4316,5,7007,3426,3581,0,0,0,1.0,1,1.0,1,1.0,1,0.261265570506223,60
4317,4,7011,3427,3584,0,0,0,1.0,1,1.0,1,1.0,1,0.21081931359025272,62
4318,0,7011,3427,3584,0,0,0,1.0,1,1.0,1,1.0,1,0.24866235651444224,59
4319,1,7012,3427,3585,0,0,0,1.0,1,1.0,1,1.0,1,0.2351386252057478,60
4320,0,7012,3427,3585,0,0,0,1.0,1,1.0,1,1.0,1,0.2351386252057478,60
4321,3,7015,3430,3585,0,0,0,1.0,1,1.0,1,1.0,1,0.24203252441371978,61
4322,3,7018,3432,3586,0,0,0,1.0,1,1.0,1,1.0,1,0.25453698496862126,61
4323,0,7018,3432,3586,0,0,0,1.0,1,1.0,1,1.0,1,0.25453698496862126,61
4324,0,7018,3432,3586,0,0,0,1.0,1,1.0,1,1.0,1,0.26376042271790373,60
4325,1,7019,3432,3587,0,0,0,1.0,1,1.0,1,1.0,1,0.24514619114293956,60
4326,1,7020,3433,3587,0,0,0,1.0,1,1.0,1,1.0,1,0.2504108334983499,61
4327,1,7021,3433,3588,0,0,0,1.0,1,1.0,1,1.0,1,0.23585105403047385,62
4328,0,7021,3433,3588,0,0,0,1.0,1,1.0,1,1.0,1,0.23585105403047385,62
4329,0,7021,3433,3588,0,0,0,1.0,1,1.0,1,1.0,1,0.22911939947116902,65
4330,1,7022,3433,3589,0,0,0,1.0,1,1.0,1,1.0,1,0.2163980707262745,65
4331,0,7022,3433,3589,0,0,0,1.0,1,1.0,1,1.0,1,0.2163980707262745,65
4332,2,7024,3434,3590,0,0,0,1.0,1,1.0,1,1.0,1,0.21872836982835445,66
4333,3,7027,3435,3592,0,0,0,1.0,1,1.0,1,1.0,1,0.19873816134986122,66
4334,1,7028,3436,3592,0,0,0,1.0,1,1.0,1,1.0,1,0.21313192520064764,66
4335,1,7029,3436,3593,0,0,0,1.0,1,1.0,1,1.0,1,0.22047854431616515,65
4336,4,7033,3438,3595,0,0,0,1.0,1,1.0,1,1.0,1,0.20417198668934256,67
4337,0,7033,3438,3595,0,0,0,1.0,1,1.0,1,1.0,1,0.22371262735875763,69
4338,1,7034,3438,3596,0,0,0,1.0,1,1.0,1,1.0,1,0.2178048207619143,70
4339,1,7035,3438,3597,0,0,0,1.0,1,1.0,1,1.0,1,0.22315202638002427,70
4340,2,7037,3438,3599,0,0,0,1.0,1,1.0,1,1.0,1,0.20656905517582155,71
4341,2,7039,3439,3600,0,0,0,1.0,1,1.0,1,1.0,1,0.2146517748503398,70
4342,2,7041,3440,3601,0,0,0,1.0,1,1.0,1,1.0,1,0.22658738330586664,71
4343,4,7045,3443,3602,0,0,0,1.0,1,1.0,1,1.0,1,0.22988087538548715,67
4344,6,7051,3447,3604,0,0,0,1.0,1,1.0,1,1.0,1,0.24716670222342157,67
4345,3,7054,3450,3604,0,0,0,1.0,1,1.0,1,1.0,1,0.26026637683675263,64
4346,5,7059,3453,3606,0,0,0,1.0,1,1.0,1,1.0,1,0.2680173970913135,64
4347,7,7066,3457,3609,0,0,0,1.0,1,1.0,1,1.0,1,0.2521781176295234,62
4348,4,7070,3459,3611,0,0,0,1.0,1,1.0,1,1.0,1,0.24825525969713572,62
4349,1,7071,3460,3611,0,0,0,1.0,1,1.0,1,1.0,1,0.2843018439611812,61
4350,2,7073,3462,3611,0,0,0,1.0,1,1.0,1,1.0,1,0.31567227098391176,60
4351,2,7075,3462,3613,0,0,0,1.0,1,1.0,1,1.0,1,0.3005049940823061,60
4352,0,7075,3462,3613,0,0,0,1.0,1,1.0,1,1.0,1,0.31475992616410087,57
4353,2,7077,3463,3614,0,0,0,1.0,1,1.0,1,1.0,1,0.2938066041634394,55
4354,2,7079,3464,3615,0,0,0,1.0,1,1.0,1,1.0,1,0.2605864064769512,55
4355,3,7082,3464,3618,0,0,0,1.0,1,1.0,1,1.0,1,0.25676668664896535,53
4356,2,7084,3464,3620,0,0,0,1.0,1,1.0,1,1.0,1,0.2177989793755735,55
4357,0,7084,3464,3620,0,0,0,1.0,1,1.0,1,1.0,1,0.23061070310908122,55
4358,2,7086,3465,3621,0,0,0,1.0,1,1.0,1,1.0,1,0.2304050467235587,55
4359,1,7087,3465,3622,0,0,0,1.0,1,1.0,1,1.0,1,0.2321074697081307,54
4360,1,7088,3466,3622,0,0,0,1.0,1,1.0,1,1.0,1,0.2329334188265284,55
4361,1,7089,3467,3622,0,0,0,1.0,1,1.0,1,1.0,1,0.2603855019812891,54
4362,3,7092,3467,3625,0,0,0,1.0,1,1.0,1,1.0,1,0.21163762056855803,55
4363,4,7096,3468,3628,0,0,0,1.0,1,1.0,1,1.0,1,0.19205583504799434,55
4364,2,7098,3470,3628,0,0,0,1.0,1,1.0,1,1.0,1,0.22790444294562867,55
4365,1,7099,3470,3629,0,0,0,1.0,1,1.0,1,1.0,1,0.21468909479093629,54
4366,1,7100,3471,3629,0,0,0,1.0,1,1.0,1,1.0,1,0.224329567474371,54
4367,1,7101,3471,3630,0,0,0,1.0,1,1.0,1,1.0,1,0.22076332882480118,57
4368,1,7102,3472,3630,0,0,0,1.0,1,1.0,1,1.0,1,0.26622826493120333,57
4369,3,7105,3472,3633,0,0,0,1.0,1,1.0,1,1.0,1,0.23132557078268848,58
4370,2,7107,3473,3634,0,0,0,1.0,1,1.0,1,1.0,1,0.23608118403968842,59
4371,1,7108,3473,3635,0,0,0,1.0,1,1.0,1,1.0,1,0.22186283811499136,60
4372,1,7109,3474,3635,0,0,0,1.0,1,1.0,1,1.0,1,0.23309699104995674,60
4373,1,7110,3474,3636,0,0,0,1.0,1,1.0,1,1.0,1,0.20496770132859654,60
4374,1,7111,3475,3636,0,0,0,1.0,1,1.0,1,1.0,1,0.24128167979739842,59
4375,1,7112,3475,3637,0,0,0,1.0,1,1.0,1,1.0,1,0.24299454093620843,60
4376,0,7112,3475,3637,0,0,0,1.0,1,1.0,1,1.0,1,0.25939768134999924,60
4377,1,7113,3475,3638,0,0,0,1.0,1,1.0,1,1.0,1,0.23672474490988593,61
4378,1,7114,3476,3638,0,0,0,1.0,1,1.0,1,1.0,1,0.23006372154244886,64
4379,1,7115,3476,3639,0,0,0,1.0,1,1.0,1,1.0,1,0.22300145526465548,64
4380,2,7117,3477,3640,0,0,0,1.0,1,1.0,1,1.0,1,0.23779358479912194,65
4381,0,7117,3477,3640,0,0,0,1.0,1,1.0,1,1.0,1,0.2504303688753309,64
4382,0,7117,3477,3640,0,0,0,1.0,1,1.0,1,1.0,1,0.2714401308297763,64
4383,1,7118,3478,3640,0,0,0,1.0,1,1.0,1,1.0,1,0.28594668566626136,64
4384,1,7119,3479,3640,0,0,0,1.0,1,1.0,1,1.0,1,0.3092277851482329,60
4385,1,7120,3479,3641,0,0,0,1.0,1,1.0,1,1.0,1,0.2799729270698589,58
4386,3,7123,3482,3641,0,0,0,1.0,1,1.0,1,1.0,1,0.2902263332197278,58
4387,2,7125,3482,3643,0,0,0,1.0,1,1.0,1,1.0,1,0.27021808053686913,55
4388,2,7127,3484,3643,0,0,0,1.0,1,1.0,1,1.0,1,0.29656283721800347,56
4389,2,7129,3485,3644,0,0,0,1.0,1,1.0,1,1.0,1,0.2624604978966103,55
4390,5,7134,3487,3647,0,0,0,1.0,1,1.0,1,1.0,1,0.24656681952715648,55
4391,3,7137,3489,3648,0,0,0,1.0,1,1.0,1,1.0,1,0.24965778672291458,56
4392,1,7138,3489,3649,0,0,0,1.0,1,1.0,1,1.0,1,0.2515960700339257,56
4393,2,7140,3490,3650,0,0,0,1.0,1,1.0,1,1.0,1,0.29204748998203395,55
4394,2,7142,3492,3650,0,0,0,1.0,1,1.0,1,1.0,1,0.29537304708953455,53
4395,3,7145,3494,3651,0,0,0,1.0,1,1.0,1,1.0,1,0.2967269677697179,53
4396,4,7149,3497,3652,0,0,0,1.0,1,1.0,1,1.0,1,0.32512493351810373,53
4397,2,7151,3498,3653,0,0,0,1.0,1,1.0,1,1.0,1,0.3240936357636825,50
4398,0,7151,3498,3653,0,0,0,1.0,1,1.0,1,1.0,1,0.34041576478800273,50
4399,0,7151,3498,3653,0,0,0,1.0,1,1.0,1,1.0,1,0.3445815715810769,52
4400,2,7153,3499,3654,0,0,0,1.0,1,1.0,1,1.0,1,0.35352918173837306,55
4401,2,7155,3499,3656,0,0,0,1.0,1,1.0,1,1.0,1,0.3244696423092841,56
4402,0,7155,3499,3656,0,0,0,1.0,1,1.0,1,1.0,1,0.3244696423092841,56
4403,3,7158,3501,3657,0,0,0,1.0,1,1.0,1,1.0,1,0.31224335000232517,57
4404,1,7159,3501,3658,0,0,0,1.0,1,1.0,1,1.0,1,0.3043096066925134,57
4405,0,7159,3501,3658,0,0,0,1.0,1,1.0,1,1.0,1,0.2977222757268945,58
4406,0,7159,3501,3658,0,0,0,1.0,1,1.0,1,1.0,1,0.2977222757268945,58
4407,0,7159,3501,3658,0,0,0,1.0,1,1.0,1,1.0,1,0.2977222757268945,58
4408,1,7160,3502,3658,0,0,0,1.0,1,1.0,1,1.0,1,0.3098812949343617,59
4409,0,7160,3502,3658,0,0,0,1.0,1,1.0,1,1.0,1,0.3098812949343617,59
4410,0,7160,3502,3658,0,0,0,1.0,1,1.0,1,1.0,1,0.3098812949343617,59
4411,0,7160,3502,3658,0,0,0,1.0,1,1.0,1,1.0,1,0.2968124251425701,62
4412,0,7160,3502,3658,0,0,0,1.0,1,1.0,1,1.0,1,0.2908902166812418,63
4413,0,7160,3502,3658,0,0,0,1.0,1,1.0,1,1.0,1,0.2908902166812418,63
4414,1,7161,3502,3659,0,0,0,1.0,1,1.0,1,1.0,1,0.28142076752357775,64
4415,1,7162,3502,3660,0,0,0,1.0,1,1.0,1,1.0,1,0.2693706787584521,64
4416,0,7162,3502,3660,0,0,0,1.0,1,1.0,1,1.0,1,0.2693706787584521,64
4417,3,7165,3502,3663,0,0,0,1.0,1,1.0,1,1.0,1,0.2597206013425256,65
4418,1,7166,3503,3663,0,0,0,1.0,1,1.0,1,1.0,1,0.2768056228650012,65
4419,0,7166,3503,3663,0,0,0,1.0,1,1.0,1,1.0,1,0.3227300005135921,62
4420,3,7169,3504,3665,0,0,0,1.0,1,1.0,1,1.0,1,0.30495778274811425,62
4421,6,7175,3505,3670,0,0,0,1.0,1,1.0,1,1.0,1,0.2890349809702641,65
4422,3,7178,3507,3671,0,0,0,1.0,1,1.0,1,1.0,1,0.3100304041915089,64
4423,2,7180,3508,3672,0,0,0,1.0,1,1.0,1,1.0,1,0.2948609189879022,63
4424,3,7183,3509,3674,0,0,0,1.0,1,1.0,1,1.0,1,0.276434304543614,63
4425,3,7186,3509,3677,0,0,0,1.0,1,1.0,1,1.0,1,0.27100081876664156,63
4426,1,7187,3510,3677,0,0,0,1.0,1,1.0,1,1.0,1,0.26333612794879435,63
4427,3,7190,3510,3680,0,0,0,1.0,1,1.0,1,1.0,1,0.21246279573977578,62
4428,2,7192,3510,3682,0,0,0,1.0,1,1.0,1,1.0,1,0.18327208884710977,61
4429,3,7195,3512,3683,0,0,0,1.0,1,1.0,1,1.0,1,0.2244248668664801,62
4430,2,7197,3513,3684,0,0,0,1.0,1,1.0,1,1.0,1,0.23155802686547267,60
4431,2,7199,3514,3685,0,0,0,1.0,1,1.0,1,1.0,1,0.19274992510661884,59
4432,4,7203,3515,3688,0,0,0,1.0,1,1.0,1,1.0,1,0.16834832965547297,60
4433,2,7205,3517,3688,0,0,0,1.0,1,1.0,1,1.0,1,0.1684991301963466,61
4434,3,7208,3519,3689,0,0,0,1.0,1,1.0,1,1.0,1,0.16999120402299348,61
4435,2,7210,3520,3690,0,0,0,1.0,1,1.0,1,1.0,1,0.16548948940136865,61
4436,2,7212,3521,3691,0,0,0,1.0,1,1.0,1,1.0,1,0.18234514322474335,61
4437,3,7215,3523,3692,0,0,0,1.0,1,1.0,1,1.0,1,0.2237140053883286,61
4438,1,7216,3523,3693,0,0,0,1.0,1,1.0,1,1.0,1,0.2119409693525407,62
4439,3,7219,3523,3696,0,0,0,1.0,1,1.0,1,1.0,1,0.19362197963126046,63
4440,3,7222,3523,3699,0,0,0,1.0,1,1.0,1,1.0,1,0.16760069744599412,64
4441,0,7222,3523,3699,0,0,0,1.0,1,1.0,1,1.0,1,0.16760069744599412,64
4442,2,7224,3525,3699,0,0,0,1.0,1,1.0,1,1.0,1,0.15422891959764856,67
4443,1,7225,3525,3700,0,0,0,1.0,1,1.0,1,1.0,1,0.139988952829049,68
4444,0,7225,3525,3700,0,0,0,1.0,1,1.0,1,1.0,1,0.13836815706841576,69
4445,1,7226,3526,3700,0,0,0,1.0,1,1.0,1,1.0,1,0.16341954828522837,71
4446,0,7226,3526,3700,0,0,0,1.0,1,1.0,1,1.0,1,0.16341954828522837,71
4447,2,7228,3526,3702,0,0,0,1.0,1,1.0,1,1.0,1,0.14891529651263363,72
4448,0,7228,3526,3702,0,0,0,1.0,1,1.0,1,1.0,1,0.15890831442920203,71
4449,3,7231,3527,3704,0,0,0,1.0,1,1.0,1,1.0,1,0.14777414811086184,70
4450,0,7231,3527,3704,0,0,0,1.0,1,1.0,1,1.0,1,0.15483571261150683,69
4451,0,7231,3527,3704,0,0,0,1.0,1,1.0,1,1.0,1,0.16020998590203187,69
4452,0,7231,3527,3704,0,0,0,1.0,1,1.0,1,1.0,1,0.16215459337495877,70
4453,1,7232,3527,3705,0,0,0,1.0,1,1.0,1,1.0,1,0.17802374778617022,70
4454,5,7237,3529,3708,0,0,0,1.0,1,1.0,1,1.0,1,0.16737527783564954,71
4455,1,7238,3529,3709,0,0,0,1.0,1,1.0,1,1.0,1,0.17243294568845263,71
4456,6,7244,3533,3711,0,0,0,1.0,1,1.0,1,1.0,1,0.1925956302767772,71
4457,3,7247,3535,3712,0,0,0,1.0,1,1.0,1,1.0,1,0.17999312346626747,69
4458,4,7251,3538,3713,0,0,0,1.0,1,1.0,1,1.0,1,0.21580186187878425,70
4459,3,7254,3539,3715,0,0,0,1.0,1,1.0,1,1.0,1,0.1963740394684295,68
4460,4,7258,3543,3715,0,0,0,1.0,1,1.0,1,1.0,1,0.22377109525817265,68
4461,3,7261,3543,3718,0,0,0,1.0,1,1.0,1,1.0,1,0.17386268534691068,67
4462,4,7265,3547,3718,0,0,0,1.0,1,1.0,1,1.0,1,0.18284749133727046,66
4463,5,7270,3550,3720,0,0,0,1.0,1,1.0,1,1.0,1,0.1758879388209018,65
4464,3,7273,3553,3720,0,0,0,1.0,1,1.0,1,1.0,1,0.22444187700112275,62
4465,6,7279,3557,3722,0,0,0,1.0,1,1.0,1,1.0,1,0.2201983900333734,61
4466,1,7280,3557,3723,0,0,0,1.0,1,1.0,1,1.0,1,0.22453566510552406,60
4467,3,7283,3558,3725,0,0,0,1.0,1,1.0,1,1.0,1,0.19941706878658616,58
4468,1,7284,3559,3725,0,0,0,1.0,1,1.0,1,1.0,1,0.2142389012675757,57
4469,4,7288,3561,3727,0,0,0,1.0,1,1.0,1,1.0,1,0.22429205270816127,56
4470,1,7289,3561,3728,0,0,0,1.0,1,1.0,1,1.0,1,0.19628444672090029,55
4471,0,7289,3561,3728,0,0,0,1.0,1,1.0,1,1.0,1,0.1941238156437663,55
4472,3,7292,3564,3728,0,0,0,1.0,1,1.0,1,1.0,1,0.22383488800230536,55
4473,2,7294,3565,3729,0,0,0,1.0,1,1.0,1,1.0,1,0.20406322135870195,55
4474,4,7298,3567,3731,0,0,0,1.0,1,1.0,1,1.0,1,0.2063441467959714,55
4475,2,7300,3567,3733,0,0,0,1.0,1,1.0,1,1.0,1,0.1557125732876454,56
4476,1,7301,3568,3733,0,0,0,1.0,1,1.0,1,1.0,1,0.16672421521592112,56
4477,1,7302,3568,3734,0,0,0,1.0,1,1.0,1,1.0,1,0.16462391470397889,57
4478,0,7302,3568,3734,0,0,0,1.0,1,1.0,1,1.0,1,0.1686978492729156,55
4479,1,7303,3569,3734,0,0,0,1.0,1,1.0,1,1.0,1,0.17526730498473125,55
4480,0,7303,3569,3734,0,0,0,1.0,1,1.0,1,1.0,1,0.1833283620461462,54
4481,0,7303,3569,3734,0,0,0,1.0,1,1.0,1,1.0,1,0.21292416218824364,53
4482,2,7305,3571,3734,0,0,0,1.0,1,1.0,1,1.0,1,0.21905142912826284,54
4483,1,7306,3571,3735,0,0,0,1.0,1,1.0,1,1.0,1,0.20143841758194522,55
4484,3,7309,3574,3735,0,0,0,1.0,1,1.0,1,1.0,1,0.20327801697336262,57
4485,2,7311,3576,3735,0,0,0,1.0,1,1.0,1,1.0,1,0.25028877452824994,60
4486,2,7313,3578,3735,0,0,0,1.0,1,1.0,1,1.0,1,0.23644707798692818,60
4487,2,7315,3578,3737,0,0,0,1.0,1,1.0,1,1.0,1,0.22126345075847492,60
4488,0,7315,3578,3737,0,0,0,1.0,1,1.0,1,1.0,1,0.22126345075847492,60
4489,2,7317,3579,3738,0,0,0,1.0,1,1.0,1,1.0,1,0.2148462742349951,60
4490,0,7317,3579,3738,0,0,0,1.0,1,1.0,1,1.0,1,0.2148462742349951,60
4491,2,7319,3580,3739,0,0,0,1.0,1,1.0,1,1.0,1,0.20257860066958785,61
4492,2,7321,3581,3740,0,0,0,1.0,1,1.0,1,1.0,1,0.16271844774760355,61
4493,1,7322,3582,3740,0,0,0,1.0,1,1.0,1,1.0,1,0.16096835906888035,60
4494,2,7324,3583,3741,0,0,0,1.0,1,1.0,1,1.0,1,0.16254494153205462,61
4495,2,7326,3584,3742,0,0,0,1.0,1,1.0,1,1.0,1,0.15451514931159752,59
4496,3,7329,3584,3745,0,0,0,1.0,1,1.0,1,1.0,1,0.15274729716440977,60
4497,1,7330,3585,3745,0,0,0,1.0,1,1.0,1,1.0,1,0.1856136012759183,59
4498,0,7330,3585,3745,0,0,0,1.0,1,1.0,1,1.0,1,0.16690636946083273,57
4499,3,7333,3587,3746,0,0,0,1.0,1,1.0,1,1.0,1,0.1923623416957826,58
4500,0,7333,3587,3746,0,0,0,1.0,1,1.0,1,1.0,1,0.1672372185512508,56
4501,1,7334,3587,3747,0,0,0,1.0,1,1.0,1,1.0,1,0.17137749751053372,57
4502,3,7337,3590,3747,0,0,0,1.0,1,1.0,1,1.0,1,0.2019904591334764,56
4503,3,7340,3591,3749,0,0,0,1.0,1,1.0,1,1.0,1,0.19627441003121415,54
4504,2,7342,3593,3749,0,0,0,1.0,1,1.0,1,1.0,1,0.22069392049854153,54
4505,3,7345,3595,3750,0,0,0,1.0,1,1.0,1,1.0,1,0.26049680932055336,51
4506,0,7345,3595,3750,0,0,0,1.0,1,1.0,1,1.0,1,0.24943937116778417,49
4507,2,7347,3597,3750,0,0,0,1.0,1,1.0,1,1.0,1,0.28434759832018547,48
4508,2,7349,3597,3752,0,0,0,1.0,1,1.0,1,1.0,1,0.25430086956893094,48
4509,4,7353,3600,3753,0,0,0,1.0,1,1.0,1,1.0,1,0.23556367927214183,46
4510,1,7354,3600,3754,0,0,0,1.0,1,1.0,1,1.0,1,0.23422889520126838,44
4511,3,7357,3601,3756,0,0,0,1.0,1,1.0,1,1.0,1,0.2332832246566638,45
4512,2,7359,3602,3757,0,0,0,1.0,1,1.0,1,1.0,1,0.2163265444793747,46
4513,1,7360,3602,3758,0,0,0,1.0,1,1.0,1,1.0,1,0.2294692014358172,45
4514,4,7364,3603,3761,0,0,0,1.0,1,1.0,1,1.0,1,0.1574219195267765,46
4515,1,7365,3603,3762,0,0,0,1.0,1,1.0,1,1.0,1,0.16228510596049608,48
4516,1,7366,3604,3762,0,0,0,1.0,1,1.0,1,1.0,1,0.18392285246043746,49
4517,1,7367,3604,3763,0,0,0,1.0,1,1.0,1,1.0,1,0.182938860800314,50
4518,1,7368,3605,3763,0,0,0,1.0,1,1.0,1,1.0,1,0.17805306147753183,50
4519,2,7370,3607,3763,0,0,0,1.0,1,1.0,1,1.0,1,0.2018802429552885,49
4520,0,7370,3607,3763,0,0,0,1.0,1,1.0,1,1.0,1,0.2141272953059379,50
4521,0,7370,3607,3763,0,0,0,1.0,1,1.0,1,1.0,1,0.2141272953059379,50
4522,1,7371,3607,3764,0,0,0,1.0,1,1.0,1,1.0,1,0.19474187767029982,50
4523,0,7371,3607,3764,0,0,0,1.0,1,1.0,1,1.0,1,0.19286182833452123,51
4524,2,7373,3608,3765,0,0,0,1.0,1,1.0,1,1.0,1,0.19449019927499966,52
4525,2,7375,3609,3766,0,0,0,1.0,1,1.0,1,1.0,1,0.19044120170430884,53
4526,0,7375,3609,3766,0,0,0,1.0,1,1.0,1,1.0,1,0.18106358816979135,54
4527,2,7377,3610,3767,0,0,0,1.0,1,1.0,1,1.0,1,0.18120327316188847,55
4528,0,7377,3610,3767,0,0,0,1.0,1,1.0,1,1.0,1,0.18120327316188847,55
4529,2,7379,3610,3769,0,0,0,1.0,1,1.0,1,1.0,1,0.1786097863061595,55
4530,0,7379,3610,3769,0,0,0,1.0,1,1.0,1,1.0,1,0.17716887213616933,56
4531,4,7383,3613,3770,0,0,0,1.0,1,1.0,1,1.0,1,0.19075375919924106,56
4532,2,7385,3614,3771,0,0,0,1.0,1,1.0,1,1.0,1,0.22844295346765725,55
4533,3,7388,3615,3773,0,0,0,1.0,1,1.0,1,1.0,1,0.21819123772792146,54
4534,0,7388,3615,3773,0,0,0,1.0,1,1.0,1,1.0,1,0.22583506598167674,55
4535,2,7390,3615,3775,0,0,0,1.0,1,1.0,1,1.0,1,0.20499726872817067,52
4536,3,7393,3617,3776,0,0,0,1.0,1,1.0,1,1.0,1,0.20131198331193814,53
4537,2,7395,3618,3777,0,0,0,1.0,1,1.0,1,1.0,1,0.20493494610752602,52
4538,1,7396,3619,3777,0,0,0,1.0,1,1.0,1,1.0,1,0.19451442820670517,52
4539,2,7398,3620,3778,0,0,0,1.0,1,1.0,1,1.0,1,0.20429173157437816,53
4540,2,7400,3621,3779,0,0,0,1.0,1,1.0,1,1.0,1,0.2188785052690281,54
4541,1,7401,3621,3780,0,0,0,1.0,1,1.0,1,1.0,1,0.23037990736753328,53
4542,4,7405,3624,3781,0,0,0,1.0,1,1.0,1,1.0,1,0.24538776606275112,53
4543,2,7407,3625,3782,0,0,0,1.0,1,1.0,1,1.0,1,0.2480892038877957,53
4544,2,7409,3626,3783,0,0,0,1.0,1,1.0,1,1.0,1,0.2516117160143937,52
4545,4,7413,3626,3787,0,0,0,1.0,1,1.0,1,1.0,1,0.2246187878678079,50
4546,1,7414,3627,3787,0,0,0,1.0,1,1.0,1,1.0,1,0.2186920980604711,49
4547,1,7415,3628,3787,0,0,0,1.0,1,1.0,1,1.0,1,0.22692057070537094,49
4548,0,7415,3628,3787,0,0,0,1.0,1,1.0,1,1.0,1,0.22692057070537094,49
4549,1,7416,3629,3787,0,0,0,1.0,1,1.0,1,1.0,1,0.23072699982812986,50
4550,1,7417,3630,3787,0,0,0,1.0,1,1.0,1,1.0,1,0.23890898400283805,49
4551,2,7419,3630,3789,0,0,0,1.0,1,1.0,1,1.0,1,0.2188846402878705,49
4552,0,7419,3630,3789,0,0,0,1.0,1,1.0,1,1.0,1,0.2188846402878705,49
4553,2,7421,3632,3789,0,0,0,1.0,1,1.0,1,1.0,1,0.25912214707370834,49
4554,1,7422,3632,3790,0,0,0,1.0,1,1.0,1,1.0,1,0.24073702202850072,49
4555,1,7423,3633,3790,0,0,0,1.0,1,1.0,1,1.0,1,0.24869738166185731,48
4556,1,7424,3634,3790,0,0,0,1.0,1,1.0,1,1.0,1,0.23152247895466097,48
4557,3,7427,3635,3792,0,0,0,1.0,1,1.0,1,1.0,1,0.24557683468863942,49
4558,2,7429,3636,3793,0,0,0,1.0,1,1.0,1,1.0,1,0.19186159444712303,49
4559,1,7430,3636,3794,0,0,0,1.0,1,1.0,1,1.0,1,0.18534195890496571,50
4560,1,7431,3637,3794,0,0,0,1.0,1,1.0,1,1.0,1,0.20876362038874896,51
4561,1,7432,3637,3795,0,0,0,1.0,1,1.0,1,1.0,1,0.19324908984843914,52
4562,1,7433,3638,3795,0,0,0,1.0,1,1.0,1,1.0,1,0.234154113947348,53
4563,0,7433,3638,3795,0,0,0,1.0,1,1.0,1,1.0,1,0.22459566378708712,52
4564,3,7436,3638,3798,0,0,0,1.0,1,1.0,1,1.0,1,0.1847413756382901,54
4565,0,7436,3638,3798,0,0,0,1.0,1,1.0,1,1.0,1,0.19727342957893962,55
4566,1,7437,3638,3799,0,0,0,1.0,1,1.0,1,1.0,1,0.18735982853989058,55
4567,3,7440,3640,3800,0,0,0,1.0,1,1.0,1,1.0,1,0.15858667176459956,56
4568,2,7442,3641,3801,0,0,0,1.0,1,1.0,1,1.0,1,0.16762804128773515,58
4569,0,7442,3641,3801,0,0,0,1.0,1,1.0,1,1.0,1,0.16986022269275655,59
4570,2,7444,3642,3802,0,0,0,1.0,1,1.0,1,1.0,1,0.1538196140893229,59
4571,0,7444,3642,3802,0,0,0,1.0,1,1.0,1,1.0,1,0.13452458524444094,57
4572,2,7446,3644,3802,0,0,0,1.0,1,1.0,1,1.0,1,0.17294807632562118,56
4573,3,7449,3646,3803,0,0,0,1.0,1,1.0,1,1.0,1,0.19431563378280617,56
4574,1,7450,3646,3804,0,0,0,1.0,1,1.0,1,1.0,1,0.2509698976378452,55
4575,2,7452,3647,3805,0,0,0,1.0,1,1.0,1,1.0,1,0.24160347221030423,55
4576,0,7452,3647,3805,0,0,0,1.0,1,1.0,1,1.0,1,0.2606980230216836,55
4577,2,7454,3647,3807,0,0,0,1.0,1,1.0,1,1.0,1,0.24222437694974935,54
4578,1,7455,3648,3807,0,0,0,1.0,1,1.0,1,1.0,1,0.2463291188931745,54
4579,2,7457,3648,3809,0,0,0,1.0,1,1.0,1,1.0,1,0.2105236862240295,54
4580,1,7458,3648,3810,0,0,0,1.0,1,1.0,1,1.0,1,0.1960950197286121,55
4581,1,7459,3649,3810,0,0,0,1.0,1,1.0,1,1.0,1,0.21748473508103414,56
4582,0,7459,3649,3810,0,0,0,1.0,1,1.0,1,1.0,1,0.21748473508103414,56
4583,1,7460,3650,3810,0,0,0,1.0,1,1.0,1,1.0,1,0.2223992672442518,57
4584,1,7461,3651,3810,0,0,0,1.0,1,1.0,1,1.0,1,0.24625690785882118,57
4585,0,7461,3651,3810,0,0,0,1.0,1,1.0,1,1.0,1,0.24625690785882118,57
4586,0,7461,3651,3810,0,0,0,1.0,1,1.0,1,1.0,1,0.24625690785882118,57
4587,0,7461,3651,3810,0,0,0,1.0,1,1.0,1,1.0,1,0.24625690785882118,57
4588,0,7461,3651,3810,0,0,0,1.0,1,1.0,1,1.0,1,0.25399451557141106,58
4589,0,7461,3651,3810,0,0,0,1.0,1,1.0,1,1.0,1,0.25574660341649147,59
4590,0,7461,3651,3810,0,0,0,1.0,1,1.0,1,1.0,1,0.2651382140447446,60
4591,0,7461,3651,3810,0,0,0,1.0,1,1.0,1,1.0,1,0.2722937918043981,61
4592,1,7462,3651,3811,0,0,0,1.0,1,1.0,1,1.0,1,0.26496194919377664,62
4593,3,7465,3651,3814,0,0,0,1.0,1,1.0,1,1.0,1,0.23000720096433278,64
4594,0,7465,3651,3814,0,0,0,1.0,1,1.0,1,1.0,1,0.23000720096433278,64
4595,0,7465,3651,3814,0,0,0,1.0,1,1.0,1,1.0,1,0.2423070269856772,63
4596,0,7465,3651,3814,0,0,0,1.0,1,1.0,1,1.0,1,0.2423070269856772,63
4597,2,7467,3653,3814,0,0,0,1.0,1,1.0,1,1.0,1,0.23862928104824166,63
4598,3,7470,3654,3816,0,0,0,1.0,1,1.0,1,1.0,1,0.2001497864499858,65
4599,3,7473,3655,3818,0,0,0,1.0,1,1.0,1,1.0,1,0.18327875990181342,66
4600,1,7474,3656,3818,0,0,0,1.0,1,1.0,1,1.0,1,0.1996247678188879,67
4601,1,7475,3656,3819,0,0,0,1.0,1,1.0,1,1.0,1,0.19279665521030714,67
4602,0,7475,3656,3819,0,0,0,1.0,1,1.0,1,1.0,1,0.1889264488707551,69
4603,2,7477,3657,3820,0,0,0,1.0,1,1.0,1,1.0,1,0.18107905673602256,69
4604,0,7477,3657,3820,0,0,0,1.0,1,1.0,1,1.0,1,0.18107905673602256,69
4605,0,7477,3657,3820,0,0,0,1.0,1,1.0,1,1.0,1,0.17420665660722814,70
4606,0,7477,3657,3820,0,0,0,1.0,1,1.0,1,1.0,1,0.17420665660722814,70
4607,1,7478,3658,3820,0,0,0,1.0,1,1.0,1,1.0,1,0.20356351304018339,72
4608,4,7482,3658,3824,0,0,0,1.0,1,1.0,1,1.0,1,0.1779810322414866,73
4609,0,7482,3658,3824,0,0,0,1.0,1,1.0,1,1.0,1,0.1734207925472456,72
4610,2,7484,3659,3825,0,0,0,1.0,1,1.0,1,1.0,1,0.1588112692706032,72
4611,0,7484,3659,3825,0,0,0,1.0,1,1.0,1,1.0,1,0.17269302715490367,71
4612,1,7485,3660,3825,0,0,0,1.0,1,1.0,1,1.0,1,0.19046833508735816,70
4613,0,7485,3660,3825,0,0,0,1.0,1,1.0,1,1.0,1,0.1836164067292968,69
4614,0,7485,3660,3825,0,0,0,1.0,1,1.0,1,1.0,1,0.2130221283111922,68
4615,3,7488,3662,3826,0,0,0,1.0,1,1.0,1,1.0,1,0.20987667298848825,68
4616,0,7488,3662,3826,0,0,0,1.0,1,1.0,1,1.0,1,0.243367504387285,65
4617,3,7491,3664,3827,0,0,0,1.0,1,1.0,1,1.0,1,0.2288218149651054,66
4618,1,7492,3665,3827,0,0,0,1.0,1,1.0,1,1.0,1,0.24868849099460397,66
4619,2,7494,3665,3829,0,0,0,1.0,1,1.0,1,1.0,1,0.23219904534212266,65
4620,1,7495,3665,3830,0,0,0,1.0,1,1.0,1,1.0,1,0.22264763632054332,65
4621,7,7502,3670,3832,0,0,0,1.0,1,1.0,1,1.0,1,0.24656282381494765,67
4622,0,7502,3670,3832,0,0,0,1.0,1,1.0,1,1.0,1,0.25010051141727974,65
4623,3,7505,3673,3832,0,0,0,1.0,1,1.0,1,1.0,1,0.27588502076619714,66
4624,2,7507,3675,3832,0,0,0,1.0,1,1.0,1,1.0,1,0.2780870802292606,65
4625,5,7512,3675,3837,0,0,0,1.0,1,1.0,1,1.0,1,0.22225084990509444,64
4626,2,7514,3677,3837,0,0,0,1.0,1,1.0,1,1.0,1,0.22463183164192577,63
4627,5,7519,3678,3841,0,0,0,1.0,1,1.0,1,1.0,1,0.19260611369246328,65
4628,1,7520,3678,3842,0,0,0,1.0,1,1.0,1,1.0,1,0.18904202209492652,64
4629,2,7522,3679,3843,0,0,0,1.0,1,1.0,1,1.0,1,0.18132100167908544,64
4630,1,7523,3679,3844,0,0,0,1.0,1,1.0,1,1.0,1,0.16239655491371519,64
4631,5,7528,3680,3848,0,0,0,1.0,1,1.0,1,1.0,1,0.18289232303543898,66
4632,2,7530,3680,3850,0,0,0,1.0,1,1.0,1,1.0,1,0.17126937640084933,65
4633,0,7530,3680,3850,0,0,0,1.0,1,1.0,1,1.0,1,0.16433157930557918,66
4634,0,7530,3680,3850,0,0,0,1.0,1,1.0,1,1.0,1,0.16433157930557918,66
4635,0,7530,3680,3850,0,0,0,1.0,1,1.0,1,1.0,1,0.16484190013285382,66
4636,0,7530,3680,3850,0,0,0,1.0,1,1.0,1,1.0,1,0.16484190013285382,66
4637,2,7532,3680,3852,0,0,0,1.0,1,1.0,1,1.0,1,0.14416575942974594,68
4638,0,7532,3680,3852,0,0,0,1.0,1,1.0,1,1.0,1,0.14416575942974594,68
4639,1,7533,3681,3852,0,0,0,1.0,1,1.0,1,1.0,1,0.1535352269804253,69
4640,0,7533,3681,3852,0,0,0,1.0,1,1.0,1,1.0,1,0.1535352269804253,69
4641,4,7537,3682,3855,0,0,0,1.0,1,1.0,1,1.0,1,0.13460935421880763,70
4642,1,7538,3682,3856,0,0,0,1.0,1,1.0,1,1.0,1,0.13521068551157728,69
4643,1,7539,3683,3856,0,0,0,1.0,1,1.0,1,1.0,1,0.15250278721991287,70
4644,1,7540,3684,3856,0,0,0,1.0,1,1.0,1,1.0,1,0.1844266727297661,69
4645,1,7541,3685,3856,0,0,0,1.0,1,1.0,1,1.0,1,0.19344590229402064,70
4646,1,7542,3686,3856,0,0,0,1.0,1,1.0,1,1.0,1,0.22960786216525472,68
4647,3,7545,3688,3857,0,0,0,1.0,1,1.0,1,1.0,1,0.2368135797105103,68
4648,3,7548,3688,3860,0,0,0,1.0,1,1.0,1,1.0,1,0.23896561745330047,67
4649,3,7551,3689,3862,0,0,0,1.0,1,1.0,1,1.0,1,0.25585392263800505,67
4650,1,7552,3689,3863,0,0,0,1.0,1,1.0,1,1.0,1,0.22416789935297257,67
4651,3,7555,3691,3864,0,0,0,1.0,1,1.0,1,1.0,1,0.24296896944042767,68
4652,1,7556,3692,3864,0,0,0,1.0,1,1.0,1,1.0,1,0.26480742926045114,66
4653,1,7557,3693,3864,0,0,0,1.0,1,1.0,1,1.0,1,0.24016578375517764,64
4654,2,7559,3694,3865,0,0,0,1.0,1,1.0,1,1.0,1,0.2568399912678652,65
4655,1,7560,3694,3866,0,0,0,1.0,1,1.0,1,1.0,1,0.24413555161020598,64
4656,1,7561,3694,3867,0,0,0,1.0,1,1.0,1,1.0,1,0.24593452309782227,65
4657,1,7562,3695,3867,0,0,0,1.0,1,1.0,1,1.0,1,0.25378349437023096,66
4658,4,7566,3696,3870,0,0,0,1.0,1,1.0,1,1.0,1,0.26236862858551785,65
4659,0,7566,3696,3870,0,0,0,1.0,1,1.0,1,1.0,1,0.26236862858551785,65
4660,3,7569,3698,3871,0,0,0,1.0,1,1.0,1,1.0,1,0.2827665658339783,66
4661,2,7571,3698,3873,0,0,0,1.0,1,1.0,1,1.0,1,0.28534104618839434,66
4662,3,7574,3699,3875,0,0,0,1.0,1,1.0,1,1.0,1,0.2703385749031545,68
4663,3,7577,3699,3878,0,0,0,1.0,1,1.0,1,1.0,1,0.24537166217744508,67
4664,4,7581,3700,3881,0,0,0,1.0,1,1.0,1,1.0,1,0.21855874758566166,67
4665,1,7582,3701,3881,0,0,0,1.0,1,1.0,1,1.0,1,0.2128387073936889,67
4666,0,7582,3701,3881,0,0,0,1.0,1,1.0,1,1.0,1,0.230458297380029,67
4667,1,7583,3702,3881,0,0,0,1.0,1,1.0,1,1.0,1,0.23461910649168702,66
4668,1,7584,3703,3881,0,0,0,1.0,1,1.0,1,1.0,1,0.23613153221719904,66
4669,4,7588,3705,3883,0,0,0,1.0,1,1.0,1,1.0,1,0.24536657786673233,66
4670,1,7589,3706,3883,0,0,0,1.0,1,1.0,1,1.0,1,0.27637707622946617,64
4671,1,7590,3706,3884,0,0,0,1.0,1,1.0,1,1.0,1,0.27119960685066663,64
4672,3,7593,3708,3885,0,0,0,1.0,1,1.0,1,1.0,1,0.29422802312909335,64
4673,2,7595,3708,3887,0,0,0,1.0,1,1.0,1,1.0,1,0.28073265129372016,65
4674,3,7598,3710,3888,0,0,0,1.0,1,1.0,1,1.0,1,0.2841645422935484,66
4675,3,7601,3710,3891,0,0,0,1.0,1,1.0,1,1.0,1,0.25229735060962416,65
4676,1,7602,3710,3892,0,0,0,1.0,1,1.0,1,1.0,1,0.25039778191050716,65
4677,2,7604,3712,3892,0,0,0,1.0,1,1.0,1,1.0,1,0.2531888952673555,65
4678,0,7604,3712,3892,0,0,0,1.0,1,1.0,1,1.0,1,0.2640058815539482,64
4679,2,7606,3713,3893,0,0,0,1.0,1,1.0,1,1.0,1,0.25086053818716947,66
4680,2,7608,3713,3895,0,0,0,1.0,1,1.0,1,1.0,1,0.24720996942586096,67
4681,2,7610,3714,3896,0,0,0,1.0,1,1.0,1,1.0,1,0.23884917728035665,67
4682,2,7612,3716,3896,0,0,0,1.0,1,1.0,1,1.0,1,0.24754199695113094,67
4683,4,7616,3717,3899,0,0,0,1.0,1,1.0,1,1.0,1,0.22180270169903377,67
4684,0,7616,3717,3899,0,0,0,1.0,1,1.0,1,1.0,1,0.21287152661083636,66
4685,1,7617,3717,3900,0,0,0,1.0,1,1.0,1,1.0,1,0.20335492303321515,65
4686,0,7617,3717,3900,0,0,0,1.0,1,1.0,1,1.0,1,0.21618769073248886,65
4687,1,7618,3717,3901,0,0,0,1.0,1,1.0,1,1.0,1,0.19531024129412838,65
4688,2,7620,3719,3901,0,0,0,1.0,1,1.0,1,1.0,1,0.2398133796666667,64
4689,5,7625,3721,3904,0,0,0,1.0,1,1.0,1,1.0,1,0.2712958661294446,65
4690,0,7625,3721,3904,0,0,0,1.0,1,1.0,1,1.0,1,0.29390463829166635,63
4691,5,7630,3724,3906,0,0,0,1.0,1,1.0,1,1.0,1,0.3070214436046311,64
4692,0,7630,3724,3906,0,0,0,1.0,1,1.0,1,1.0,1,0.2748646413732216,63
4693,2,7632,3724,3908,0,0,0,1.0,1,1.0,1,1.0,1,0.26317921787631005,64
4694,0,7632,3724,3908,0,0,0,1.0,1,1.0,1,1.0,1,0.24952419057233602,63
4695,0,7632,3724,3908,0,0,0,1.0,1,1.0,1,1.0,1,0.24868400976224758,62
4696,1,7633,3724,3909,0,0,0,1.0,1,1.0,1,1.0,1,0.2353606644437729,61
4697,3,7636,3725,3911,0,0,0,1.0,1,1.0,1,1.0,1,0.2060954773304734,63
4698,0,7636,3725,3911,0,0,0,1.0,1,1.0,1,1.0,1,0.22041784177280355,63
4699,1,7637,3725,3912,0,0,0,1.0,1,1.0,1,1.0,1,0.20406895455088475,65
4700,0,7637,3725,3912,0,0,0,1.0,1,1.0,1,1.0,1,0.21487388460513507,64
4701,0,7637,3725,3912,0,0,0,1.0,1,1.0,1,1.0,1,0.21487388460513507,64
4702,0,7637,3725,3912,0,0,0,1.0,1,1.0,1,1.0,1,0.22676249454922992,66
4703,1,7638,3726,3912,0,0,0,1.0,1,1.0,1,1.0,1,0.23046616389225033,65
4704,4,7642,3728,3914,0,0,0,1.0,1,1.0,1,1.0,1,0.21836346599662368,64
4705,6,7648,3730,3918,0,0,0,1.0,1,1.0,1,1.0,1,0.24159225902744527,65
4706,3,7651,3732,3919,0,0,0,1.0,1,1.0,1,1.0,1,0.24466945779805468,65
4707,4,7655,3733,3922,0,0,0,1.0,1,1.0,1,1.0,1,0.2337372305027759,63
4708,2,7657,3734,3923,0,0,0,1.0,1,1.0,1,1.0,1,0.22600701157018827,62
4709,3,7660,3736,3924,0,0,0,1.0,1,1.0,1,1.0,1,0.25204038213712987,61
4710,0,7660,3736,3924,0,0,0,1.0,1,1.0,1,1.0,1,0.2556238533899546,60
4711,2,7662,3738,3924,0,0,0,1.0,1,1.0,1,1.0,1,0.2531013472725111,59
4712,1,7663,3739,3924,0,0,0,1.0,1,1.0,1,1.0,1,0.2505680484803532,58
4713,3,7666,3741,3925,0,0,0,1.0,1,1.0,1,1.0,1,0.24949603985919896,58
4714,0,7666,3741,3925,0,0,0,1.0,1,1.0,1,1.0,1,0.24691565109613606,57
4715,1,7667,3741,3926,0,0,0,1.0,1,1.0,1,1.0,1,0.24784560286836985,57
4716,1,7668,3742,3926,0,0,0,1.0,1,1.0,1,1.0,1,0.26983275215450225,55
4717,3,7671,3742,3929,0,0,0,1.0,1,1.0,1,1.0,1,0.24560137524142597,57
4718,2,7673,3742,3931,0,0,0,1.0,1,1.0,1,1.0,1,0.221673638511736,56
4719,4,7677,3743,3934,0,0,0,1.0,1,1.0,1,1.0,1,0.23086866831820183,56
4720,3,7680,3743,3937,0,0,0,1.0,1,1.0,1,1.0,1,0.2058113347084618,57
4721,0,7680,3743,3937,0,0,0,1.0,1,1.0,1,1.0,1,0.2058113347084618,57
4722,1,7681,3744,3937,0,0,0,1.0,1,1.0,1,1.0,1,0.19864799026275956,57
4723,1,7682,3745,3937,0,0,0,1.0,1,1.0,1,1.0,1,0.21526906986883923,57
4724,0,7682,3745,3937,0,0,0,1.0,1,1.0,1,1.0,1,0.21686618749654546,57
4725,1,7683,3746,3937,0,0,0,1.0,1,1.0,1,1.0,1,0.26842313795462414,57
4726,1,7684,3747,3937,0,0,0,1.0,1,1.0,1,1.0,1,0.27972982961613085,57
4727,1,7685,3747,3938,0,0,0,1.0,1,1.0,1,1.0,1,0.27639200169150707,56
4728,1,7686,3747,3939,0,0,0,1.0,1,1.0,1,1.0,1,0.28017511345742924,57
4729,1,7687,3747,3940,0,0,0,1.0,1,1.0,1,1.0,1,0.2796090765649093,56
4730,1,7688,3748,3940,0,0,0,1.0,1,1.0,1,1.0,1,0.29945002772876,54
4731,2,7690,3749,3941,0,0,0,1.0,1,1.0,1,1.0,1,0.2893815599733177,54
4732,3,7693,3752,3941,0,0,0,1.0,1,1.0,1,1.0,1,0.35076236489369217,54
4733,5,7698,3753,3945,0,0,0,1.0,1,1.0,1,1.0,1,0.3281954843756172,55
4734,2,7700,3754,3946,0,0,0,1.0,1,1.0,1,1.0,1,0.3366986411043816,56
4735,2,7702,3755,3947,0,0,0,1.0,1,1.0,1,1.0,1,0.3436757628738596,56
4736,0,7702,3755,3947,0,0,0,1.0,1,1.0,1,1.0,1,0.34221068708690977,58
4737,2,7704,3755,3949,0,0,0,1.0,1,1.0,1,1.0,1,0.3110773858598668,59
4738,3,7707,3758,3949,0,0,0,1.0,1,1.0,1,1.0,1,0.36085526138835,60
4739,2,7709,3758,3951,0,0,0,1.0,1,1.0,1,1.0,1,0.33215415235195306,60
4740,0,7709,3758,3951,0,0,0,1.0,1,1.0,1,1.0,1,0.33215415235195306,60
4741,0,7709,3758,3951,0,0,0,1.0,1,1.0,1,1.0,1,0.34025322036897176,61
4742,2,7711,3759,3952,0,0,0,1.0,1,1.0,1,1.0,1,0.3292850537527862,61
4743,1,7712,3759,3953,0,0,0,1.0,1,1.0,1,1.0,1,0.31304042146842315,60
4744,3,7715,3761,3954,0,0,0,1.0,1,1.0,1,1.0,1,0.3158228847712296,60
4745,3,7718,3762,3956,0,0,0,1.0,1,1.0,1,1.0,1,0.2969449927743645,59
4746,2,7720,3764,3956,0,0,0,1.0,1,1.0,1,1.0,1,0.3239568316825954,59
4747,2,7722,3765,3957,0,0,0,1.0,1,1.0,1,1.0,1,0.27403331619043503,58
4748,2,7724,3766,3958,0,0,0,1.0,1,1.0,1,1.0,1,0.24722533512340647,58
4749,2,7726,3767,3959,0,0,0,1.0,1,1.0,1,1.0,1,0.24401138441488301,58
4750,2,7728,3768,3960,0,0,0,1.0,1,1.0,1,1.0,1,0.22392112138952402,56
4751,7,7735,3771,3964,0,0,0,1.0,1,1.0,1,1.0,1,0.2313953127594394,58
4752,1,7736,3772,3964,0,0,0,1.0,1,1.0,1,1.0,1,0.2354919726751001,55
4753,2,7738,3773,3965,0,0,0,1.0,1,1.0,1,1.0,1,0.21764734042516903,55
4754,0,7738,3773,3965,0,0,0,1.0,1,1.0,1,1.0,1,0.21987313614300133,54
4755,1,7739,3774,3965,0,0,0,1.0,1,1.0,1,1.0,1,0.22524030157185207,54
4756,3,7742,3776,3966,0,0,0,1.0,1,1.0,1,1.0,1,0.24077069015905533,54
4757,0,7742,3776,3966,0,0,0,1.0,1,1.0,1,1.0,1,0.2271573679321226,53
4758,0,7742,3776,3966,0,0,0,1.0,1,1.0,1,1.0,1,0.2271573679321226,53
4759,1,7743,3776,3967,0,0,0,1.0,1,1.0,1,1.0,1,0.21018500294695217,53
4760,1,7744,3777,3967,0,0,0,1.0,1,1.0,1,1.0,1,0.2546215036997161,53
4761,4,7748,3779,3969,0,0,0,1.0,1,1.0,1,1.0,1,0.26419086188963165,52
4762,4,7752,3779,3973,0,0,0,1.0,1,1.0,1,1.0,1,0.2146284565637818,54
4763,3,7755,3780,3975,0,0,0,1.0,1,1.0,1,1.0,1,0.20534125508019546,54
4764,1,7756,3781,3975,0,0,0,1.0,1,1.0,1,1.0,1,0.21913555065739226,55
4765,3,7759,3784,3975,0,0,0,1.0,1,1.0,1,1.0,1,0.29748475262392265,56
4766,3,7762,3785,3977,0,0,0,1.0,1,1.0,1,1.0,1,0.2725570177929568,58
4767,5,7767,3786,3981,0,0,0,1.0,1,1.0,1,1.0,1,0.22549444556843454,59
4768,5,7772,3788,3984,0,0,0,1.0,1,1.0,1,1.0,1,0.20737136703874104,60
4769,0,7772,3788,3984,0,0,0,1.0,1,1.0,1,1.0,1,0.2131543816855902,59
4770,1,7773,3788,3985,0,0,0,1.0,1,1.0,1,1.0,1,0.21118634026247854,60
4771,2,7775,3788,3987,0,0,0,1.0,1,1.0,1,1.0,1,0.2231735953502162,59
4772,0,7775,3788,3987,0,0,0,1.0,1,1.0,1,1.0,1,0.2231735953502162,59
4773,0,7775,3788,3987,0,0,0,1.0,1,1.0,1,1.0,1,0.20574798859048807,60
4774,0,7775,3788,3987,0,0,0,1.0,1,1.0,1,1.0,1,0.20574798859048807,60
4775,0,7775,3788,3987,0,0,0,1.0,1,1.0,1,1.0,1,0.208844752196107,62
4776,1,7776,3788,3988,0,0,0,1.0,1,1.0,1,1.0,1,0.1833463395457578,63
4777,1,7777,3788,3989,0,0,0,1.0,1,1.0,1,1.0,1,0.17286376376810197,63
4778,1,7778,3789,3989,0,0,0,1.0,1,1.0,1,1.0,1,0.1723232993392148,63
4779,0,7778,3789,3989,0,0,0,1.0,1,1.0,1,1.0,1,0.1723232993392148,63
4780,1,7779,3790,3989,0,0,0,1.0,1,1.0,1,1.0,1,0.17674568246710828,65
4781,1,7780,3790,3990,0,0,0,1.0,1,1.0,1,1.0,1,0.18975027367807615,64
4782,1,7781,3790,3991,0,0,0,1.0,1,1.0,1,1.0,1,0.1913180359021092,65
4783,3,7784,3792,3992,0,0,0,1.0,1,1.0,1,1.0,1,0.1934793426038164,66
4784,4,7788,3795,3993,0,0,0,1.0,1,1.0,1,1.0,1,0.17493290848308884,64
4785,5,7793,3797,3996,0,0,0,1.0,1,1.0,1,1.0,1,0.17645436901210404,65
4786,3,7796,3799,3997,0,0,0,1.0,1,1.0,1,1.0,1,0.21891127345489392,66
4787,5,7801,3801,4000,0,0,0,1.0,1,1.0,1,1.0,1,0.15142924676990419,63
4788,5,7806,3804,4002,0,0,0,1.0,1,1.0,1,1.0,1,0.15646294843903108,63
4789,4,7810,3807,4003,0,0,0,1.0,1,1.0,1,1.0,1,0.17379524161036022,60
4790,6,7816,3810,4006,0,0,0,1.0,1,1.0,1,1.0,1,0.14514373203993292,61
4791,5,7821,3814,4007,0,0,0,1.0,1,1.0,1,1.0,1,0.1635660893787842,59
4792,2,7823,3816,4007,0,0,0,1.0,1,1.0,1,1.0,1,0.16796978901744952,59
4793,2,7825,3816,4009,0,0,0,1.0,1,1.0,1,1.0,1,0.14862500511514007,61
4794,3,7828,3818,4010,0,0,0,1.0,1,1.0,1,1.0,1,0.14726278861791312,60
4795,3,7831,3819,4012,0,0,0,1.0,1,1.0,1,1.0,1,0.10986030049185642,61
4796,2,7833,3821,4012,0,0,0,1.0,1,1.0,1,1.0,1,0.13759885674570946,60
4797,4,7837,3822,4015,0,0,0,1.0,1,1.0,1,1.0,1,0.11549869695013328,61
4798,2,7839,3823,4016,0,0,0,1.0,1,1.0,1,1.0,1,0.1326348939772368,61
4799,3,7842,3823,4019,0,0,0,1.0,1,1.0,1,1.0,1,0.12567900951707522,59
4800,1,7843,3823,4020,0,0,0,1.0,1,1.0,1,1.0,1,0.12036105458347258,57
4801,0,7843,3823,4020,0,0,0,1.0,1,1.0,1,1.0,1,0.12440184308391246,58
4802,0,7843,3823,4020,0,0,0,1.0,1,1.0,1,1.0,1,0.12874940533432724,56
4803,1,7844,3824,4020,0,0,0,1.0,1,1.0,1,1.0,1,0.14056181336406953,57
4804,0,7844,3824,4020,0,0,0,1.0,1,1.0,1,1.0,1,0.12662594542078268,55
4805,1,7845,3825,4020,0,0,0,1.0,1,1.0,1,1.0,1,0.12051123715431727,56
4806,0,7845,3825,4020,0,0,0,1.0,1,1.0,1,1.0,1,0.12826390056976175,55
4807,1,7846,3825,4021,0,0,0,1.0,1,1.0,1,1.0,1,0.13818447603261982,53
4808,2,7848,3826,4022,0,0,0,1.0,1,1.0,1,1.0,1,0.14406880731942545,54
4809,0,7848,3826,4022,0,0,0,1.0,1,1.0,1,1.0,1,0.16760202180240316,53
4810,1,7849,3827,4022,0,0,0,1.0,1,1.0,1,1.0,1,0.16205135905674362,53
4811,1,7850,3827,4023,0,0,0,1.0,1,1.0,1,1.0,1,0.1456489080978419,54
4812,3,7853,3829,4024,0,0,0,1.0,1,1.0,1,1.0,1,0.13119721875063006,54
4813,0,7853,3829,4024,0,0,0,1.0,1,1.0,1,1.0,1,0.1297135442095158,55
4814,2,7855,3831,4024,0,0,0,1.0,1,1.0,1,1.0,1,0.16661971013062846,55
4815,4,7859,3831,4028,0,0,0,1.0,1,1.0,1,1.0,1,0.10907605393683356,56
4816,3,7862,3834,4028,0,0,0,1.0,1,1.0,1,1.0,1,0.16729375287520157,56
4817,3,7865,3836,4029,0,0,0,1.0,1,1.0,1,1.0,1,0.21461640616683592,58
4818,3,7868,3838,4030,0,0,0,1.0,1,1.0,1,1.0,1,0.2618090811130449,58
4819,5,7873,3839,4034,0,0,0,1.0,1,1.0,1,1.0,1,0.2220877816042875,58
4820,2,7875,3839,4036,0,0,0,1.0,1,1.0,1,1.0,1,0.21766513248975458,58
4821,4,7879,3839,4040,0,0,0,1.0,1,1.0,1,1.0,1,0.16962983440095472,58
4822,1,7880,3840,4040,0,0,0,1.0,1,1.0,1,1.0,1,0.18427253506892893,58
4823,2,7882,3841,4041,0,0,0,1.0,1,1.0,1,1.0,1,0.18893428187029826,57
4824,0,7882,3841,4041,0,0,0,1.0,1,1.0,1,1.0,1,0.18740692214242252,56
4825,3,7885,3841,4044,0,0,0,1.0,1,1.0,1,1.0,1,0.17254951418634945,57
4826,0,7885,3841,4044,0,0,0,1.0,1,1.0,1,1.0,1,0.17254951418634945,57
4827,2,7887,3841,4046,0,0,0,1.0,1,1.0,1,1.0,1,0.1725570265687787,56
4828,1,7888,3842,4046,0,0,0,1.0,1,1.0,1,1.0,1,0.15972817244042328,57
4829,1,7889,3843,4046,0,0,0,1.0,1,1.0,1,1.0,1,0.1858283796732121,56
4830,1,7890,3844,4046,0,0,0,1.0,1,1.0,1,1.0,1,0.1779586935625395,57
4831,2,7892,3846,4046,0,0,0,1.0,1,1.0,1,1.0,1,0.2320590705520893,57
4832,0,7892,3846,4046,0,0,0,1.0,1,1.0,1,1.0,1,0.23887951288841264,55
4833,2,7894,3848,4046,0,0,0,1.0,1,1.0,1,1.0,1,0.27359883361711934,55
4834,3,7897,3849,4048,0,0,0,1.0,1,1.0,1,1.0,1,0.26056457087786333,55
4835,3,7900,3849,4051,0,0,0,1.0,1,1.0,1,1.0,1,0.2336871782921911,55
4836,1,7901,3849,4052,0,0,0,1.0,1,1.0,1,1.0,1,0.21568086443010603,55
4837,1,7902,3850,4052,0,0,0,1.0,1,1.0,1,1.0,1,0.19090557702314637,53
4838,3,7905,3851,4054,0,0,0,1.0,1,1.0,1,1.0,1,0.1806344269395771,54
4839,5,7910,3854,4056,0,0,0,1.0,1,1.0,1,1.0,1,0.17362979833684664,53
4840,2,7912,3855,4057,0,0,0,1.0,1,1.0,1,1.0,1,0.1982449512824259,52
4841,3,7915,3856,4059,0,0,0,1.0,1,1.0,1,1.0,1,0.16693493305367907,51
4842,2,7917,3858,4059,0,0,0,1.0,1,1.0,1,1.0,1,0.19685697827506157,50
4843,2,7919,3860,4059,0,0,0,1.0,1,1.0,1,1.0,1,0.2432096705608,51
4844,1,7920,3860,4060,0,0,0,1.0,1,1.0,1,1.0,1,0.21383329620156954,50
4845,1,7921,3861,4060,0,0,0,1.0,1,1.0,1,1.0,1,0.25135799470904424,49
4846,2,7923,3863,4060,0,0,0,1.0,1,1.0,1,1.0,1,0.2725083388817256,49
4847,6,7929,3863,4066,0,0,0,1.0,1,1.0,1,1.0,1,0.1810774867329589,48
4848,1,7930,3864,4066,0,0,0,1.0,1,1.0,1,1.0,1,0.18432486203585005,48
4849,0,7930,3864,4066,0,0,0,1.0,1,1.0,1,1.0,1,0.16721891423057972,48
4850,1,7931,3865,4066,0,0,0,1.0,1,1.0,1,1.0,1,0.19448416221421613,49
4851,0,7931,3865,4066,0,0,0,1.0,1,1.0,1,1.0,1,0.17411727874014524,49
4852,1,7932,3865,4067,0,0,0,1.0,1,1.0,1,1.0,1,0.19132336895552296,49
4853,0,7932,3865,4067,0,0,0,1.0,1,1.0,1,1.0,1,0.18891485206984285,50
4854,1,7933,3866,4067,0,0,0,1.0,1,1.0,1,1.0,1,0.20140657983496635,51
4855,1,7934,3866,4068,0,0,0,1.0,1,1.0,1,1.0,1,0.1834788104726325,51
4856,0,7934,3866,4068,0,0,0,1.0,1,1.0,1,1.0,1,0.17688456877001124,50
4857,0,7934,3866,4068,0,0,0,1.0,1,1.0,1,1.0,1,0.17991521790788154,51
4858,0,7934,3866,4068,0,0,0,1.0,1,1.0,1,1.0,1,0.18585089372219116,51
4859,1,7935,3866,4069,0,0,0,1.0,1,1.0,1,1.0,1,0.1946371000997703,52
4860,0,7935,3866,4069,0,0,0,1.0,1,1.0,1,1.0,1,0.1946371000997703,52
4861,3,7938,3866,4072,0,0,0,1.0,1,1.0,1,1.0,1,0.17780468772070623,53
4862,2,7940,3868,4072,0,0,0,1.0,1,1.0,1,1.0,1,0.21963928281749906,53
4863,2,7942,3868,4074,0,0,0,1.0,1,1.0,1,1.0,1,0.15667920683507455,51
4864,2,7944,3869,4075,0,0,0,1.0,1,1.0,1,1.0,1,0.179862799545749,53
4865,1,7945,3869,4076,0,0,0,1.0,1,1.0,1,1.0,1,0.1586348354602199,52
4866,1,7946,3870,4076,0,0,0,1.0,1,1.0,1,1.0,1,0.2001334490734448,53
4867,1,7947,3871,4076,0,0,0,1.0,1,1.0,1,1.0,1,0.16687667015232327,51
4868,3,7950,3873,4077,0,0,0,1.0,1,1.0,1,1.0,1,0.1538071444772973,53
4869,1,7951,3873,4078,0,0,0,1.0,1,1.0,1,1.0,1,0.1329879478355603,53
4870,2,7953,3875,4078,0,0,0,1.0,1,1.0,1,1.0,1,0.15382641209949433,55
4871,1,7954,3876,4078,0,0,0,1.0,1,1.0,1,1.0,1,0.17006671566749276,55
4872,3,7957,3878,4079,0,0,0,1.0,1,1.0,1,1.0,1,0.19274053771088817,56
4873,4,7961,3878,4083,0,0,0,1.0,1,1.0,1,1.0,1,0.1430477465013319,56
4874,1,7962,3879,4083,0,0,0,1.0,1,1.0,1,1.0,1,0.16466226603495115,58
4875,5,7967,3880,4087,0,0,0,1.0,1,1.0,1,1.0,1,0.12286116101971799,56
4876,1,7968,3880,4088,0,0,0,1.0,1,1.0,1,1.0,1,0.12734232892526642,56
4877,2,7970,3882,4088,0,0,0,1.0,1,1.0,1,1.0,1,0.14623134473680505,54
4878,6,7976,3884,4092,0,0,0,1.0,1,1.0,1,1.0,1,0.14152427824870123,54
4879,6,7982,3888,4094,0,0,0,1.0,1,1.0,1,1.0,1,0.17523955908188973,54
4880,1,7983,3888,4095,0,0,0,1.0,1,1.0,1,1.0,1,0.1589187944724114,53
4881,0,7983,3888,4095,0,0,0,1.0,1,1.0,1,1.0,1,0.166212053183654,54
4882,0,7983,3888,4095,0,0,0,1.0,1,1.0,1,1.0,1,0.15384457041806415,52
4883,1,7984,3889,4095,0,0,0,1.0,1,1.0,1,1.0,1,0.176960327346358,54
4884,0,7984,3889,4095,0,0,0,1.0,1,1.0,1,1.0,1,0.17405007154893676,52
4885,1,7985,3890,4095,0,0,0,1.0,1,1.0,1,1.0,1,0.21305633920961017,51
4886,0,7985,3890,4095,0,0,0,1.0,1,1.0,1,1.0,1,0.21568749837651974,50
4887,0,7985,3890,4095,0,0,0,1.0,1,1.0,1,1.0,1,0.2395688317303143,49
4888,0,7985,3890,4095,0,0,0,1.0,1,1.0,1,1.0,1,0.24430565833439596,48
4889,0,7985,3890,4095,0,0,0,1.0,1,1.0,1,1.0,1,0.24430565833439596,48
4890,0,7985,3890,4095,0,0,0,1.0,1,1.0,1,1.0,1,0.24430565833439596,48
4891,2,7987,3892,4095,0,0,0,1.0,1,1.0,1,1.0,1,0.2719778723910763,49
4892,1,7988,3892,4096,0,0,0,1.0,1,1.0,1,1.0,1,0.2865997074884232,51
4893,1,7989,3892,4097,0,0,0,1.0,1,1.0,1,1.0,1,0.2846275393509083,51
4894,1,7990,3892,4098,0,0,0,1.0,1,1.0,1,1.0,1,0.26600198783471235,52
4895,1,7991,3892,4099,0,0,0,1.0,1,1.0,1,1.0,1,0.25124608001710597,52
4896,2,7993,3893,4100,0,0,0,1.0,1,1.0,1,1.0,1,0.2291623019408286,51
4897,0,7993,3893,4100,0,0,0,1.0,1,1.0,1,1.0,1,0.22491110228955252,52
4898,2,7995,3895,4100,0,0,0,1.0,1,1.0,1,1.0,1,0.21811406109052053,52
4899,1,7996,3895,4101,0,0,0,1.0,1,1.0,1,1.0,1,0.1964248007514192,53
4900,3,7999,3897,4102,0,0,0,1.0,1,1.0,1,1.0,1,0.15360305347851394,54
4901,4,8003,3899,4104,0,0,0,1.0,1,1.0,1,1.0,1,0.16584002926803093,54
4902,1,8004,3900,4104,0,0,0,1.0,1,1.0,1,1.0,1,0.1768502958771871,55
4903,2,8006,3901,4105,0,0,0,1.0,1,1.0,1,1.0,1,0.2037090445088687,56
4904,4,8010,3902,4108,0,0,0,1.0,1,1.0,1,1.0,1,0.19291623492948584,55
4905,0,8010,3902,4108,0,0,0,1.0,1,1.0,1,1.0,1,0.1931218977436643,54
4906,2,8012,3903,4109,0,0,0,1.0,1,1.0,1,1.0,1,0.20554262986984162,54
4907,2,8014,3903,4111,0,0,0,1.0,1,1.0,1,1.0,1,0.18110061369538635,54
4908,1,8015,3903,4112,0,0,0,1.0,1,1.0,1,1.0,1,0.1663590829174034,53
4909,2,8017,3904,4113,0,0,0,1.0,1,1.0,1,1.0,1,0.19551283661660915,54
4910,1,8018,3904,4114,0,0,0,1.0,1,1.0,1,1.0,1,0.1870504288286888,55
4911,5,8023,3906,4117,0,0,0,1.0,1,1.0,1,1.0,1,0.18201252801862416,57
4912,1,8024,3906,4118,0,0,0,1.0,1,1.0,1,1.0,1,0.16543207728863027,57
4913,3,8027,3907,4120,0,0,0,1.0,1,1.0,1,1.0,1,0.12266584676357396,56
4914,1,8028,3908,4120,0,0,0,1.0,1,1.0,1,1.0,1,0.14627489194289153,56
4915,3,8031,3910,4121,0,0,0,1.0,1,1.0,1,1.0,1,0.15857247616360182,56
4916,0,8031,3910,4121,0,0,0,1.0,1,1.0,1,1.0,1,0.16313977399806512,54
4917,3,8034,3910,4124,0,0,0,1.0,1,1.0,1,1.0,1,0.12289126268348959,53
4918,0,8034,3910,4124,0,0,0,1.0,1,1.0,1,1.0,1,0.14201668843515172,52
4919,0,8034,3910,4124,0,0,0,1.0,1,1.0,1,1.0,1,0.17264126008739533,49
4920,0,8034,3910,4124,0,0,0,1.0,1,1.0,1,1.0,1,0.17264126008739533,49
4921,2,8036,3912,4124,0,0,0,1.0,1,1.0,1,1.0,1,0.24279951066104719,50
4922,0,8036,3912,4124,0,0,0,1.0,1,1.0,1,1.0,1,0.24279951066104719,50
4923,2,8038,3914,4124,0,0,0,1.0,1,1.0,1,1.0,1,0.2463605727972556,52
4924,2,8040,3915,4125,0,0,0,1.0,1,1.0,1,1.0,1,0.25500308815580125,53
4925,3,8043,3916,4127,0,0,0,1.0,1,1.0,1,1.0,1,0.195331093353429,54
4926,1,8044,3916,4128,0,0,0,1.0,1,1.0,1,1.0,1,0.18340622982203889,54
4927,2,8046,3918,4128,0,0,0,1.0,1,1.0,1,1.0,1,0.19557155645898416,54
4928,0,8046,3918,4128,0,0,0,1.0,1,1.0,1,1.0,1,0.19557155645898416,54
4929,1,8047,3918,4129,0,0,0,1.0,1,1.0,1,1.0,1,0.17502991072475443,55
4930,2,8049,3919,4130,0,0,0,1.0,1,1.0,1,1.0,1,0.1863764027738169,58
4931,0,8049,3919,4130,0,0,0,1.0,1,1.0,1,1.0,1,0.1863764027738169,58
4932,1,8050,3919,4131,0,0,0,1.0,1,1.0,1,1.0,1,0.1902130135253779,59
4933,0,8050,3919,4131,0,0,0,1.0,1,1.0,1,1.0,1,0.1902130135253779,59
4934,0,8050,3919,4131,0,0,0,1.0,1,1.0,1,1.0,1,0.1902130135253779,59
4935,1,8051,3919,4132,0,0,0,1.0,1,1.0,1,1.0,1,0.17320062121513746,59
4936,1,8052,3920,4132,0,0,0,1.0,1,1.0,1,1.0,1,0.19924450279616157,59
4937,2,8054,3920,4134,0,0,0,1.0,1,1.0,1,1.0,1,0.18272681947337605,61
4938,0,8054,3920,4134,0,0,0,1.0,1,1.0,1,1.0,1,0.1923106461063569,62
4939,1,8055,3920,4135,0,0,0,1.0,1,1.0,1,1.0,1,0.16825943040689947,63
4940,3,8058,3920,4138,0,0,0,1.0,1,1.0,1,1.0,1,0.1761162956105157,65
4941,1,8059,3921,4138,0,0,0,1.0,1,1.0,1,1.0,1,0.18741179535177005,65
4942,4,8063,3923,4140,0,0,0,1.0,1,1.0,1,1.0,1,0.19017830837992192,67
4943,4,8067,3924,4143,0,0,0,1.0,1,1.0,1,1.0,1,0.16578907954329136,66
4944,3,8070,3927,4143,0,0,0,1.0,1,1.0,1,1.0,1,0.21343394616134678,63
4945,6,8076,3928,4148,0,0,0,1.0,1,1.0,1,1.0,1,0.13314482046103102,61
4946,2,8078,3930,4148,0,0,0,1.0,1,1.0,1,1.0,1,0.17451652703702214,60
4947,0,8078,3930,4148,0,0,0,1.0,1,1.0,1,1.0,1,0.15440820230453678,58
4948,2,8080,3931,4149,0,0,0,1.0,1,1.0,1,1.0,1,0.1744110865141066,57
4949,2,8082,3933,4149,0,0,0,1.0,1,1.0,1,1.0,1,0.17666494442158748,56
4950,3,8085,3935,4150,0,0,0,1.0,1,1.0,1,1.0,1,0.17299397535761266,57
4951,4,8089,3937,4152,0,0,0,1.0,1,1.0,1,1.0,1,0.19041355778396782,55
4952,4,8093,3941,4152,0,0,0,1.0,1,1.0,1,1.0,1,0.2394371574037529,55
4953,5,8098,3943,4155,0,0,0,1.0,1,1.0,1,1.0,1,0.20259910564144937,54
4954,2,8100,3944,4156,0,0,0,1.0,1,1.0,1,1.0,1,0.20785199051360745,54
4955,1,8101,3944,4157,0,0,0,1.0,1,1.0,1,1.0,1,0.16168797301910895,52
4956,0,8101,3944,4157,0,0,0,1.0,1,1.0,1,1.0,1,0.16168797301910895,52
4957,1,8102,3945,4157,0,0,0,1.0,1,1.0,1,1.0,1,0.14453275051444842,53
4958,1,8103,3946,4157,0,0,0,1.0,1,1.0,1,1.0,1,0.15962411120752204,52
4959,3,8106,3947,4159,0,0,0,1.0,1,1.0,1,1.0,1,0.13576154479249458,51
4960,1,8107,3947,4160,0,0,0,1.0,1,1.0,1,1.0,1,0.13328289544449712,53
4961,0,8107,3947,4160,0,0,0,1.0,1,1.0,1,1.0,1,0.13328289544449712,53
4962,1,8108,3947,4161,0,0,0,1.0,1,1.0,1,1.0,1,0.14386451998572247,55
4963,0,8108,3947,4161,0,0,0,1.0,1,1.0,1,1.0,1,0.1259518091428863,54
4964,1,8109,3948,4161,0,0,0,1.0,1,1.0,1,1.0,1,0.13052866459043802,54
4965,0,8109,3948,4161,0,0,0,1.0,1,1.0,1,1.0,1,0.13052866459043802,54
4966,1,8110,3949,4161,0,0,0,1.0,1,1.0,1,1.0,1,0.13201111335258073,54
4967,2,8112,3951,4161,0,0,0,1.0,1,1.0,1,1.0,1,0.147143555473263,55
4968,3,8115,3953,4162,0,0,0,1.0,1,1.0,1,1.0,1,0.1349204480191608,55
4969,2,8117,3954,4163,0,0,0,1.0,1,1.0,1,1.0,1,0.16552774274905027,57
4970,1,8118,3955,4163,0,0,0,1.0,1,1.0,1,1.0,1,0.19680532379971424,56
4971,4,8122,3956,4166,0,0,0,1.0,1,1.0,1,1.0,1,0.16673352182675474,57
4972,6,8128,3958,4170,0,0,0,1.0,1,1.0,1,1.0,1,0.18763378694013558,57
4973,0,8128,3958,4170,0,0,0,1.0,1,1.0,1,1.0,1,0.18389620367982396,60
4974,1,8129,3958,4171,0,0,0,1.0,1,1.0,1,1.0,1,0.1773590660704079,58
4975,2,8131,3959,4172,0,0,0,1.0,1,1.0,1,1.0,1,0.1825128653685099,59
4976,1,8132,3960,4172,0,0,0,1.0,1,1.0,1,1.0,1,0.182131477970832,59
4977,5,8137,3965,4172,0,0,0,1.0,1,1.0,1,1.0,1,0.20437658206123865,59
4978,1,8138,3966,4172,0,0,0,1.0,1,1.0,1,1.0,1,0.2092058519901887,59
4979,3,8141,3966,4175,0,0,0,1.0,1,1.0,1,1.0,1,0.17525442311139708,61
4980,2,8143,3967,4176,0,0,0,1.0,1,1.0,1,1.0,1,0.19583492061812377,62
4981,3,8146,3968,4178,0,0,0,1.0,1,1.0,1,1.0,1,0.18471612319438097,62
4982,4,8150,3970,4180,0,0,0,1.0,1,1.0,1,1.0,1,0.1619279749402142,63
4983,2,8152,3971,4181,0,0,0,1.0,1,1.0,1,1.0,1,0.15818167224234475,63
4984,1,8153,3972,4181,0,0,0,1.0,1,1.0,1,1.0,1,0.17843285301237116,61
4985,1,8154,3972,4182,0,0,0,1.0,1,1.0,1,1.0,1,0.1570319227177918,59
4986,5,8159,3974,4185,0,0,0,1.0,1,1.0,1,1.0,1,0.17347451483934775,62
4987,1,8160,3974,4186,0,0,0,1.0,1,1.0,1,1.0,1,0.1449980849946472,60
4988,1,8161,3975,4186,0,0,0,1.0,1,1.0,1,1.0,1,0.15630956067159435,59
4989,5,8166,3977,4189,0,0,0,1.0,1,1.0,1,1.0,1,0.1876573276944479,57
4990,0,8166,3977,4189,0,0,0,1.0,1,1.0,1,1.0,1,0.21054177605800312,55
4991,5,8171,3981,4190,0,0,0,1.0,1,1.0,1,1.0,1,0.18836688688768805,54
4992,2,8173,3981,4192,0,0,0,1.0,1,1.0,1,1.0,1,0.1723413104616688,52
4993,0,8173,3981,4192,0,0,0,1.0,1,1.0,1,1.0,1,0.15538958001911063,51
4994,1,8174,3982,4192,0,0,0,1.0,1,1.0,1,1.0,1,0.20085829325460064,49
4995,3,8177,3984,4193,0,0,0,1.0,1,1.0,1,1.0,1,0.20158580675742832,48
4996,3,8180,3986,4194,0,0,0,1.0,1,1.0,1,1.0,1,0.18677628659877138,48
4997,1,8181,3987,4194,0,0,0,1.0,1,1.0,1,1.0,1,0.19292836966857782,46
4998,1,8182,3988,4194,0,0,0,1.0,1,1.0,1,1.0,1,0.20142369039802324,48
4999,7,8189,3990,4199,0,0,0,1.0,1,1.0,1,1.0,1,0.20139106996193112,48
5000,1,8190,3991,4199,0,0,0,1.0,1,1.0,1,1.0,1,0.18812302367700703,47
5001,1,8191,3992,4199,0,0,0,1.0,1,1.0,1,1.0,1,0.22707073906853192,45
5002,3,8194,3995,4199,0,0,0,1.0,1,1.0,1,1.0,1,0.2660206004593611,46
5003,1,8195,3995,4200,0,0,0,1.0,1,1.0,1,1.0,1,0.27474895950799144,46
5004,2,8197,3995,4202,0,0,0,1.0,1,1.0,1,1.0,1,0.23820893892619024,46
5005,0,8197,3995,4202,0,0,0,1.0,1,1.0,1,1.0,1,0.26101609283217897,45
5006,0,8197,3995,4202,0,0,0,1.0,1,1.0,1,1.0,1,0.2938967404867444,45
5007,2,8199,3995,4204,0,0,0,1.0,1,1.0,1,1.0,1,0.24057494601168664,46
5008,0,8199,3995,4204,0,0,0,1.0,1,1.0,1,1.0,1,0.2329149986250204,49
5009,0,8199,3995,4204,0,0,0,1.0,1,1.0,1,1.0,1,0.22582028676329283,49
5010,0,8199,3995,4204,0,0,0,1.0,1,1.0,1,1.0,1,0.24205523559367562,50
5011,0,8199,3995,4204,0,0,0,1.0,1,1.0,1,1.0,1,0.24976119679395375,51
5012,0,8199,3995,4204,0,0,0,1.0,1,1.0,1,1.0,1,0.2615050037294739,52
5013,0,8199,3995,4204,0,0,0,1.0,1,1.0,1,1.0,1,0.2615050037294739,52
5014,0,8199,3995,4204,0,0,0,1.0,1,1.0,1,1.0,1,0.2643183683401719,53
5015,3,8202,3996,4206,0,0,0,1.0,1,1.0,1,1.0,1,0.27216536168000915,54
5016,1,8203,3996,4207,0,0,0,1.0,1,1.0,1,1.0,1,0.26559071170332016,55
5017,1,8204,3996,4208,0,0,0,1.0,1,1.0,1,1.0,1,0.25559439641145143,55
5018,1,8205,3996,4209,0,0,0,1.0,1,1.0,1,1.0,1,0.2569564092846756,56
5019,0,8205,3996,4209,0,0,0,1.0,1,1.0,1,1.0,1,0.2569564092846756,56
5020,1,8206,3997,4209,0,0,0,1.0,1,1.0,1,1.0,1,0.2534507561668186,55
5021,1,8207,3997,4210,0,0,0,1.0,1,1.0,1,1.0,1,0.2546169830368027,56
5022,3,8210,4000,4210,0,0,0,1.0,1,1.0,1,1.0,1,0.29172316912842877,56
5023,2,8212,4001,4211,0,0,0,1.0,1,1.0,1,1.0,1,0.27376907757908386,55
5024,4,8216,4005,4211,0,0,0,1.0,1,1.0,1,1.0,1,0.29510644777700723,55
5025,5,8221,4006,4215,0,0,0,1.0,1,1.0,1,1.0,1,0.2498769499529936,53
5026,3,8224,4009,4215,0,0,0,1.0,1,1.0,1,1.0,1,0.26887655253355375,52
5027,3,8227,4010,4217,0,0,0,1.0,1,1.0,1,1.0,1,0.28747588100956206,51
5028,4,8231,4012,4219,0,0,0,1.0,1,1.0,1,1.0,1,0.30782289498053794,51
5029,3,8234,4013,4221,0,0,0,1.0,1,1.0,1,1.0,1,0.3097226515380389,50
5030,2,8236,4015,4221,0,0,0,1.0,1,1.0,1,1.0,1,0.3211174760652145,49
5031,4,8240,4016,4224,0,0,0,1.0,1,1.0,1,1.0,1,0.2784809871333672,49
5032,1,8241,4017,4224,0,0,0,1.0,1,1.0,1,1.0,1,0.28865689620104795,48
5033,5,8246,4020,4226,0,0,0,1.0,1,1.0,1,1.0,1,0.32817603128203254,50
5034,3,8249,4020,4229,0,0,0,1.0,1,1.0,1,1.0,1,0.27602980046577313,49
5035,4,8253,4022,4231,0,0,0,1.0,1,1.0,1,1.0,1,0.27951202926281965,49
5036,0,8253,4022,4231,0,0,0,1.0,1,1.0,1,1.0,1,0.25379109035340996,47
5037,3,8256,4023,4233,0,0,0,1.0,1,1.0,1,1.0,1,0.24143940331955582,47
5038,0,8256,4023,4233,0,0,0,1.0,1,1.0,1,1.0,1,0.24015854428918473,47
5039,0,8256,4023,4233,0,0,0,1.0,1,1.0,1,1.0,1,0.2485527548370025,48
5040,0,8256,4023,4233,0,0,0,1.0,1,1.0,1,1.0,1,0.2485527548370025,48
5041,0,8256,4023,4233,0,0,0,1.0,1,1.0,1,1.0,1,0.2485527548370025,48
5042,0,8256,4023,4233,0,0,0,1.0,1,1.0,1,1.0,1,0.24859756022933976,50
5043,1,8257,4024,4233,0,0,0,1.0,1,1.0,1,1.0,1,0.22890393530119896,51
5044,0,8257,4024,4233,0,0,0,1.0,1,1.0,1,1.0,1,0.22890393530119896,51
5045,0,8257,4024,4233,0,0,0,1.0,1,1.0,1,1.0,1,0.24267275494735066,52
5046,1,8258,4025,4233,0,0,0,1.0,1,1.0,1,1.0,1,0.2643353156786133,51
5047,1,8259,4026,4233,0,0,0,1.0,1,1.0,1,1.0,1,0.25354456962177757,51
5048,2,8261,4027,4234,0,0,0,1.0,1,1.0,1,1.0,1,0.24010350722305843,52
5049,4,8265,4028,4237,0,0,0,1.0,1,1.0,1,1.0,1,0.2525758059501075,54
5050,0,8265,4028,4237,0,0,0,1.0,1,1.0,1,1.0,1,0.2743417133527614,56
5051,4,8269,4028,4241,0,0,0,1.0,1,1.0,1,1.0,1,0.2163939192675785,55
5052,0,8269,4028,4241,0,0,0,1.0,1,1.0,1,1.0,1,0.2163939192675785,55
5053,0,8269,4028,4241,0,0,0,1.0,1,1.0,1,1.0,1,0.2163939192675785,55
5054,2,8271,4030,4241,0,0,0,1.0,1,1.0,1,1.0,1,0.2285842401840378,55
5055,1,8272,4030,4242,0,0,0,1.0,1,1.0,1,1.0,1,0.2286744484298595,55
5056,3,8275,4031,4244,0,0,0,1.0,1,1.0,1,1.0,1,0.22228919623402826,56
5057,1,8276,4031,4245,0,0,0,1.0,1,1.0,1,1.0,1,0.214489001943609,58
5058,0,8276,4031,4245,0,0,0,1.0,1,1.0,1,1.0,1,0.22363976666825272,59
5059,2,8278,4031,4247,0,0,0,1.0,1,1.0,1,1.0,1,0.20968426987653524,59
5060,1,8279,4031,4248,0,0,0,1.0,1,1.0,1,1.0,1,0.19912099262067703,59
5061,0,8279,4031,4248,0,0,0,1.0,1,1.0,1,1.0,1,0.21205962376925108,59
5062,6,8285,4034,4251,0,0,0,1.0,1,1.0,1,1.0,1,0.258370365183462,59
5063,4,8289,4036,4253,0,0,0,1.0,1,1.0,1,1.0,1,0.2678469694808247,59
5064,5,8294,4040,4254,0,0,0,1.0,1,1.0,1,1.0,1,0.3253162286529671,57
5065,5,8299,4041,4258,0,0,0,1.0,1,1.0,1,1.0,1,0.2609756675050704,55
5066,2,8301,4042,4259,0,0,0,1.0,1,1.0,1,1.0,1,0.27517976995574905,55
5067,3,8304,4042,4262,0,0,0,1.0,1,1.0,1,1.0,1,0.23661382148306628,54
5068,1,8305,4042,4263,0,0,0,1.0,1,1.0,1,1.0,1,0.210471800178086,54
5069,1,8306,4043,4263,0,0,0,1.0,1,1.0,1,1.0,1,0.204246251195969,54
5070,3,8309,4044,4265,0,0,0,1.0,1,1.0,1,1.0,1,0.18708188095319858,52
5071,3,8312,4046,4266,0,0,0,1.0,1,1.0,1,1.0,1,0.21359472832199364,54
5072,0,8312,4046,4266,0,0,0,1.0,1,1.0,1,1.0,1,0.19088578175154955,52
5073,0,8312,4046,4266,0,0,0,1.0,1,1.0,1,1.0,1,0.20707215977295673,51
5074,1,8313,4046,4267,0,0,0,1.0,1,1.0,1,1.0,1,0.19097217929300683,52
5075,0,8313,4046,4267,0,0,0,1.0,1,1.0,1,1.0,1,0.2003848612741445,53
5076,0,8313,4046,4267,0,0,0,1.0,1,1.0,1,1.0,1,0.2003848612741445,53
5077,3,8316,4048,4268,0,0,0,1.0,1,1.0,1,1.0,1,0.22987023467083206,56
5078,1,8317,4048,4269,0,0,0,1.0,1,1.0,1,1.0,1,0.23161106542607252,55
5079,5,8322,4048,4274,0,0,0,1.0,1,1.0,1,1.0,1,0.18992440656709803,56
5080,0,8322,4048,4274,0,0,0,1.0,1,1.0,1,1.0,1,0.17904797942102804,57
5081,3,8325,4048,4277,0,0,0,1.0,1,1.0,1,1.0,1,0.1372383105195576,58
5082,0,8325,4048,4277,0,0,0,1.0,1,1.0,1,1.0,1,0.1372383105195576,58
5083,1,8326,4048,4278,0,0,0,1.0,1,1.0,1,1.0,1,0.14198778082123176,59
5084,1,8327,4048,4279,0,0,0,1.0,1,1.0,1,1.0,1,0.11167120390545464,59
5085,1,8328,4049,4279,0,0,0,1.0,1,1.0,1,1.0,1,0.15306562160378093,60
5086,0,8328,4049,4279,0,0,0,1.0,1,1.0,1,1.0,1,0.15490988434667846,61
5087,5,8333,4051,4282,0,0,0,1.0,1,1.0,1,1.0,1,0.11364022299583654,62
5088,1,8334,4051,4283,0,0,0,1.0,1,1.0,1,1.0,1,0.12363050594609165,64
5089,1,8335,4052,4283,0,0,0,1.0,1,1.0,1,1.0,1,0.13905849278618118,64
5090,0,8335,4052,4283,0,0,0,1.0,1,1.0,1,1.0,1,0.13905849278618118,64
5091,4,8339,4055,4284,0,0,0,1.0,1,1.0,1,1.0,1,0.17610463420744712,64
5092,2,8341,4057,4284,0,0,0,1.0,1,1.0,1,1.0,1,0.21401822945093968,64
5093,3,8344,4057,4287,0,0,0,1.0,1,1.0,1,1.0,1,0.19430623981219655,64
5094,1,8345,4058,4287,0,0,0,1.0,1,1.0,1,1.0,1,0.20577686612750995,65
5095,5,8350,4059,4291,0,0,0,1.0,1,1.0,1,1.0,1,0.18737900738443114,66
5096,1,8351,4059,4292,0,0,0,1.0,1,1.0,1,1.0,1,0.17000018146953488,66
5097,2,8353,4061,4292,0,0,0,1.0,1,1.0,1,1.0,1,0.16710324719614858,67
5098,2,8355,4062,4293,0,0,0,1.0,1,1.0,1,1.0,1,0.13467737814460182,67
5099,2,8357,4062,4295,0,0,0,1.0,1,1.0,1,1.0,1,0.12387447894022892,70
5100,1,8358,4063,4295,0,0,0,1.0,1,1.0,1,1.0,1,0.14980341775291958,71
5101,1,8359,4063,4296,0,0,0,1.0,1,1.0,1,1.0,1,0.14832358875171753,72
5102,3,8362,4065,4297,0,0,0,1.0,1,1.0,1,1.0,1,0.15046513026161054,72
5103,5,8367,4068,4299,0,0,0,1.0,1,1.0,1,1.0,1,0.15331224873160088,70
5104,3,8370,4070,4300,0,0,0,1.0,1,1.0,1,1.0,1,0.17309331136387823,67
5105,7,8377,4073,4304,0,0,0,1.0,1,1.0,1,1.0,1,0.1544176565034665,66
5106,4,8381,4077,4304,0,0,0,1.0,1,1.0,1,1.0,1,0.19792483854055454,64
5107,2,8383,4079,4304,0,0,0,1.0,1,1.0,1,1.0,1,0.19256204005560307,61
5108,2,8385,4080,4305,0,0,0,1.0,1,1.0,1,1.0,1,0.19053643156901823,57
5109,3,8388,4083,4305,0,0,0,1.0,1,1.0,1,1.0,1,0.22773177073978548,55
5110,3,8391,4085,4306,0,0,0,1.0,1,1.0,1,1.0,1,0.23174429342247727,53
5111,6,8397,4088,4309,0,0,0,1.0,1,1.0,1,1.0,1,0.23583066152423726,52
5112,2,8399,4089,4310,0,0,0,1.0,1,1.0,1,1.0,1,0.22469733710995346,52
5113,2,8401,4089,4312,0,0,0,1.0,1,1.0,1,1.0,1,0.1959624186570512,49
5114,4,8405,4093,4312,0,0,0,1.0,1,1.0,1,1.0,1,0.21191085366357199,49
5115,2,8407,4093,4314,0,0,0,1.0,1,1.0,1,1.0,1,0.1757425246114593,48
5116,2,8409,4094,4315,0,0,0,1.0,1,1.0,1,1.0,1,0.1776708173992054,47
5117,0,8409,4094,4315,0,0,0,1.0,1,1.0,1,1.0,1,0.18286824647772673,48
5118,0,8409,4094,4315,0,0,0,1.0,1,1.0,1,1.0,1,0.16149315694486333,49
5119,3,8412,4097,4315,0,0,0,1.0,1,1.0,1,1.0,1,0.18250564664064942,49
5120,0,8412,4097,4315,0,0,0,1.0,1,1.0,1,1.0,1,0.18461983931747622,48
5121,1,8413,4098,4315,0,0,0,1.0,1,1.0,1,1.0,1,0.17247594054226068,48
5122,1,8414,4099,4315,0,0,0,1.0,1,1.0,1,1.0,1,0.21293465179410936,46
5123,0,8414,4099,4315,0,0,0,1.0,1,1.0,1,1.0,1,0.21293465179410936,46
5124,0,8414,4099,4315,0,0,0,1.0,1,1.0,1,1.0,1,0.19945089474282313,47
5125,7,8421,4100,4321,0,0,0,1.0,1,1.0,1,1.0,1,0.15154166454611573,49
5126,0,8421,4100,4321,0,0,0,1.0,1,1.0,1,1.0,1,0.15154166454611573,49
5127,1,8422,4100,4322,0,0,0,1.0,1,1.0,1,1.0,1,0.1667959958951122,51
5128,3,8425,4101,4324,0,0,0,1.0,1,1.0,1,1.0,1,0.19705825878945415,53
5129,4,8429,4102,4327,0,0,0,1.0,1,1.0,1,1.0,1,0.15781951376626338,55
5130,0,8429,4102,4327,0,0,0,1.0,1,1.0,1,1.0,1,0.15781951376626338,55
5131,0,8429,4102,4327,0,0,0,1.0,1,1.0,1,1.0,1,0.15781951376626338,55
5132,0,8429,4102,4327,0,0,0,1.0,1,1.0,1,1.0,1,0.15781951376626338,55
5133,0,8429,4102,4327,0,0,0,1.0,1,1.0,1,1.0,1,0.16226933628298248,56
5134,1,8430,4102,4328,0,0,0,1.0,1,1.0,1,1.0,1,0.1824991903905162,56
5135,4,8434,4104,4330,0,0,0,1.0,1,1.0,1,1.0,1,0.17307104117080188,56
5136,0,8434,4104,4330,0,0,0,1.0,1,1.0,1,1.0,1,0.18361884784867424,55
5137,2,8436,4105,4331,0,0,0,1.0,1,1.0,1,1.0,1,0.17511746784951276,55
5138,0,8436,4105,4331,0,0,0,1.0,1,1.0,1,1.0,1,0.18411000403613292,54
5139,3,8439,4108,4331,0,0,0,1.0,1,1.0,1,1.0,1,0.1956073511874339,54
5140,1,8440,4109,4331,0,0,0,1.0,1,1.0,1,1.0,1,0.22109372449549802,54
5141,5,8445,4112,4333,0,0,0,1.0,1,1.0,1,1.0,1,0.22061179403445114,53
5142,8,8453,4115,4338,0,0,0,1.0,1,1.0,1,1.0,1,0.2112378450090896,55
5143,3,8456,4118,4338,0,0,0,1.0,1,1.0,1,1.0,1,0.18649634289820802,54
5144,5,8461,4121,4340,0,0,0,1.0,1,1.0,1,1.0,1,0.2209841219690087,50
5145,5,8466,4122,4344,0,0,0,1.0,1,1.0,1,1.0,1,0.1738743753095039,51
5146,1,8467,4123,4344,0,0,0,1.0,1,1.0,1,1.0,1,0.17405711837288515,48
5147,3,8470,4124,4346,0,0,0,1.0,1,1.0,1,1.0,1,0.17543766859328086,49
5148,0,8470,4124,4346,0,0,0,1.0,1,1.0,1,1.0,1,0.15566353340395658,47
5149,1,8471,4125,4346,0,0,0,1.0,1,1.0,1,1.0,1,0.18646184817361766,46
5150,5,8476,4129,4347,0,0,0,1.0,1,1.0,1,1.0,1,0.19668680706538413,46
5151,2,8478,4129,4349,0,0,0,1.0,1,1.0,1,1.0,1,0.1674285212276823,45
5152,2,8480,4131,4349,0,0,0,1.0,1,1.0,1,1.0,1,0.19469662639481009,45
5153,3,8483,4133,4350,0,0,0,1.0,1,1.0,1,1.0,1,0.2215813976652626,45
5154,1,8484,4134,4350,0,0,0,1.0,1,1.0,1,1.0,1,0.2490173505108196,45
5155,3,8487,4135,4352,0,0,0,1.0,1,1.0,1,1.0,1,0.24720234719994547,44
5156,0,8487,4135,4352,0,0,0,1.0,1,1.0,1,1.0,1,0.24607432419057512,44
5157,0,8487,4135,4352,0,0,0,1.0,1,1.0,1,1.0,1,0.23791456528317056,42
5158,1,8488,4136,4352,0,0,0,1.0,1,1.0,1,1.0,1,0.26455921807015903,43
5159,0,8488,4136,4352,0,0,0,1.0,1,1.0,1,1.0,1,0.2786492311891676,43
5160,0,8488,4136,4352,0,0,0,1.0,1,1.0,1,1.0,1,0.2786492311891676,43
5161,0,8488,4136,4352,0,0,0,1.0,1,1.0,1,1.0,1,0.2786492311891676,43
5162,1,8489,4136,4353,0,0,0,1.0,1,1.0,1,1.0,1,0.26324107637515287,44
5163,2,8491,4136,4355,0,0,0,1.0,1,1.0,1,1.0,1,0.2638272721121435,46
5164,2,8493,4137,4356,0,0,0,1.0,1,1.0,1,1.0,1,0.23575729267772777,46
5165,0,8493,4137,4356,0,0,0,1.0,1,1.0,1,1.0,1,0.23575729267772777,46
5166,8,8501,4140,4361,0,0,0,1.0,1,1.0,1,1.0,1,0.18266805940932446,47
5167,1,8502,4140,4362,0,0,0,1.0,1,1.0,1,1.0,1,0.16644882774894795,47
5168,2,8504,4141,4363,0,0,0,1.0,1,1.0,1,1.0,1,0.1861442494298365,47
5169,0,8504,4141,4363,0,0,0,1.0,1,1.0,1,1.0,1,0.1861442494298365,47
5170,1,8505,4142,4363,0,0,0,1.0,1,1.0,1,1.0,1,0.1936902834684924,48
5171,2,8507,4143,4364,0,0,0,1.0,1,1.0,1,1.0,1,0.20738479798075743,48
5172,0,8507,4143,4364,0,0,0,1.0,1,1.0,1,1.0,1,0.17778327789919224,49
5173,0,8507,4143,4364,0,0,0,1.0,1,1.0,1,1.0,1,0.18600902265571093,49
5174,0,8507,4143,4364,0,0,0,1.0,1,1.0,1,1.0,1,0.18820549570766343,52
5175,2,8509,4144,4365,0,0,0,1.0,1,1.0,1,1.0,1,0.17768817754677813,53
5176,2,8511,4144,4367,0,0,0,1.0,1,1.0,1,1.0,1,0.16501533441662006,54
5177,4,8515,4147,4368,0,0,0,1.0,1,1.0,1,1.0,1,0.1662846533507944,54
5178,2,8517,4149,4368,0,0,0,1.0,1,1.0,1,1.0,1,0.19208087638719454,55
5179,0,8517,4149,4368,0,0,0,1.0,1,1.0,1,1.0,1,0.18272238608810226,53
5180,1,8518,4149,4369,0,0,0,1.0,1,1.0,1,1.0,1,0.1761060486029703,52
5181,1,8519,4150,4369,0,0,0,1.0,1,1.0,1,1.0,1,0.16444414583804912,52
5182,1,8520,4151,4369,0,0,0,1.0,1,1.0,1,1.0,1,0.16277113048800948,52
5183,2,8522,4153,4369,0,0,0,1.0,1,1.0,1,1.0,1,0.21628370398164648,52
5184,1,8523,4154,4369,0,0,0,1.0,1,1.0,1,1.0,1,0.23394721154888928,52
5185,3,8526,4156,4370,0,0,0,1.0,1,1.0,1,1.0,1,0.25840837098977393,50
5186,1,8527,4157,4370,0,0,0,1.0,1,1.0,1,1.0,1,0.30433656644059076,48
5187,6,8533,4158,4375,0,0,0,1.0,1,1.0,1,1.0,1,0.20922264981556993,46
5188,0,8533,4158,4375,0,0,0,1.0,1,1.0,1,1.0,1,0.22637146120948407,44
5189,0,8533,4158,4375,0,0,0,1.0,1,1.0,1,1.0,1,0.23343645024083454,44
5190,1,8534,4159,4375,0,0,0,1.0,1,1.0,1,1.0,1,0.23619234705156375,45
5191,1,8535,4159,4376,0,0,0,1.0,1,1.0,1,1.0,1,0.2205585826887887,45
5192,1,8536,4160,4376,0,0,0,1.0,1,1.0,1,1.0,1,0.23514206182485203,45
5193,1,8537,4160,4377,0,0,0,1.0,1,1.0,1,1.0,1,0.2140922022055162,45
5194,2,8539,4160,4379,0,0,0,1.0,1,1.0,1,1.0,1,0.19272944654657775,45
5195,1,8540,4161,4379,0,0,0,1.0,1,1.0,1,1.0,1,0.2113334264371909,46
5196,0,8540,4161,4379,0,0,0,1.0,1,1.0,1,1.0,1,0.2113334264371909,46
5197,3,8543,4163,4380,0,0,0,1.0,1,1.0,1,1.0,1,0.22322941169576221,46
5198,1,8544,4163,4381,0,0,0,1.0,1,1.0,1,1.0,1,0.19626597838012858,47
5199,2,8546,4164,4382,0,0,0,1.0,1,1.0,1,1.0,1,0.219917240219601,49
5200,1,8547,4165,4382,0,0,0,1.0,1,1.0,1,1.0,1,0.22907839876347882,49
5201,3,8550,4167,4383,0,0,0,1.0,1,1.0,1,1.0,1,0.1976764254802452,50
5202,1,8551,4167,4384,0,0,0,1.0,1,1.0,1,1.0,1,0.17293853561762318,52
5203,0,8551,4167,4384,0,0,0,1.0,1,1.0,1,1.0,1,0.17293853561762318,52
5204,0,8551,4167,4384,0,0,0,1.0,1,1.0,1,1.0,1,0.1677166045238498,54
5205,0,8551,4167,4384,0,0,0,1.0,1,1.0,1,1.0,1,0.1677166045238498,54
5206,0,8551,4167,4384,0,0,0,1.0,1,1.0,1,1.0,1,0.17901763766845774,55
5207,0,8551,4167,4384,0,0,0,1.0,1,1.0,1,1.0,1,0.18417111358489238,54
5208,0,8551,4167,4384,0,0,0,1.0,1,1.0,1,1.0,1,0.18417111358489238,54
5209,1,8552,4167,4385,0,0,0,1.0,1,1.0,1,1.0,1,0.1633199894428107,54
5210,0,8552,4167,4385,0,0,0,1.0,1,1.0,1,1.0,1,0.1633199894428107,54
5211,3,8555,4168,4387,0,0,0,1.0,1,1.0,1,1.0,1,0.16182393246721322,56
5212,0,8555,4168,4387,0,0,0,1.0,1,1.0,1,1.0,1,0.1526229659948429,57
5213,1,8556,4169,4387,0,0,0,1.0,1,1.0,1,1.0,1,0.17408880363930382,57
5214,4,8560,4171,4389,0,0,0,1.0,1,1.0,1,1.0,1,0.22760165845473515,58
5215,2,8562,4171,4391,0,0,0,1.0,1,1.0,1,1.0,1,0.2214235769739523,57
5216,4,8566,4173,4393,0,0,0,1.0,1,1.0,1,1.0,1,0.2012525097760318,57
5217,2,8568,4174,4394,0,0,0,1.0,1,1.0,1,1.0,1,0.19615889208512916,56
5218,1,8569,4174,4395,0,0,0,1.0,1,1.0,1,1.0,1,0.18869003085080366,56
5219,1,8570,4174,4396,0,0,0,1.0,1,1.0,1,1.0,1,0.1928756560976424,54
5220,0,8570,4174,4396,0,0,0,1.0,1,1.0,1,1.0,1,0.1937918795165599,53
5221,1,8571,4174,4397,0,0,0,1.0,1,1.0,1,1.0,1,0.1872590064802772,52
5222,0,8571,4174,4397,0,0,0,1.0,1,1.0,1,1.0,1,0.20430674665357137,52
5223,2,8573,4176,4397,0,0,0,1.0,1,1.0,1,1.0,1,0.22181362815451544,52
5224,5,8578,4179,4399,0,0,0,1.0,1,1.0,1,1.0,1,0.23369027562204214,52
5225,2,8580,4179,4401,0,0,0,1.0,1,1.0,1,1.0,1,0.18919644544682687,50
5226,3,8583,4182,4401,0,0,0,1.0,1,1.0,1,1.0,1,0.2197972243162761,51
5227,3,8586,4183,4403,0,0,0,1.0,1,1.0,1,1.0,1,0.23600829164772968,49
5228,0,8586,4183,4403,0,0,0,1.0,1,1.0,1,1.0,1,0.2598360627552133,48
5229,1,8587,4183,4404,0,0,0,1.0,1,1.0,1,1.0,1,0.22637162577587622,49
5230,0,8587,4183,4404,0,0,0,1.0,1,1.0,1,1.0,1,0.22637162577587622,49
5231,1,8588,4184,4404,0,0,0,1.0,1,1.0,1,1.0,1,0.21056283480957314,49
5232,4,8592,4185,4407,0,0,0,1.0,1,1.0,1,1.0,1,0.18159302601282118,51
5233,2,8594,4186,4408,0,0,0,1.0,1,1.0,1,1.0,1,0.18716899817822574,51
5234,5,8599,4189,4410,0,0,0,1.0,1,1.0,1,1.0,1,0.1872586506494293,52
5235,0,8599,4189,4410,0,0,0,1.0,1,1.0,1,1.0,1,0.18617959140955942,52
5236,0,8599,4189,4410,0,0,0,1.0,1,1.0,1,1.0,1,0.18617959140955942,52
5237,3,8602,4189,4413,0,0,0,1.0,1,1.0,1,1.0,1,0.1725772125248241,53
5238,1,8603,4190,4413,0,0,0,1.0,1,1.0,1,1.0,1,0.1754063888314549,53
5239,1,8604,4190,4414,0,0,0,1.0,1,1.0,1,1.0,1,0.15129246241232902,53
5240,2,8606,4192,4414,0,0,0,1.0,1,1.0,1,1.0,1,0.18509003175356087,55
5241,2,8608,4192,4416,0,0,0,1.0,1,1.0,1,1.0,1,0.16022339542174788,56
5242,3,8611,4193,4418,0,0,0,1.0,1,1.0,1,1.0,1,0.1604137259196198,54
5243,2,8613,4194,4419,0,0,0,1.0,1,1.0,1,1.0,1,0.1789212047104778,55
5244,2,8615,4195,4420,0,0,0,1.0,1,1.0,1,1.0,1,0.17742970981711242,55
5245,1,8616,4195,4421,0,0,0,1.0,1,1.0,1,1.0,1,0.15949518231059048,55
5246,2,8618,4197,4421,0,0,0,1.0,1,1.0,1,1.0,1,0.22466573015812358,55
5247,3,8621,4198,4423,0,0,0,1.0,1,1.0,1,1.0,1,0.20373482578815338,54
5248,2,8623,4199,4424,0,0,0,1.0,1,1.0,1,1.0,1,0.2241333029364571,53
5249,1,8624,4200,4424,0,0,0,1.0,1,1.0,1,1.0,1,0.23328251504633152,55
5250,3,8627,4202,4425,0,0,0,1.0,1,1.0,1,1.0,1,0.22496937423353075,55
5251,5,8632,4203,4429,0,0,0,1.0,1,1.0,1,1.0,1,0.19097096875600206,57
5252,1,8633,4203,4430,0,0,0,1.0,1,1.0,1,1.0,1,0.1824580832838592,58
5253,2,8635,4204,4431,0,0,0,1.0,1,1.0,1,1.0,1,0.1922298352817908,59
5254,1,8636,4205,4431,0,0,0,1.0,1,1.0,1,1.0,1,0.19791711758879021,59
5255,1,8637,4206,4431,0,0,0,1.0,1,1.0,1,1.0,1,0.2020316559034946,58
5256,3,8640,4207,4433,0,0,0,1.0,1,1.0,1,1.0,1,0.19328094912298852,59
5257,0,8640,4207,4433,0,0,0,1.0,1,1.0,1,1.0,1,0.1873197891070934,58
5258,1,8641,4207,4434,0,0,0,1.0,1,1.0,1,1.0,1,0.17748020835927047,56
5259,0,8641,4207,4434,0,0,0,1.0,1,1.0,1,1.0,1,0.19006840183572235,56
5260,0,8641,4207,4434,0,0,0,1.0,1,1.0,1,1.0,1,0.19265044630219708,55
5261,2,8643,4208,4435,0,0,0,1.0,1,1.0,1,1.0,1,0.1657850006417582,54
5262,1,8644,4209,4435,0,0,0,1.0,1,1.0,1,1.0,1,0.1765139464441327,54
5263,4,8648,4211,4437,0,0,0,1.0,1,1.0,1,1.0,1,0.2180247632519676,53
5264,2,8650,4212,4438,0,0,0,1.0,1,1.0,1,1.0,1,0.21325112526879145,51
5265,3,8653,4214,4439,0,0,0,1.0,1,1.0,1,1.0,1,0.21396376205716777,50
5266,1,8654,4215,4439,0,0,0,1.0,1,1.0,1,1.0,1,0.22091032492330737,49
5267,3,8657,4216,4441,0,0,0,1.0,1,1.0,1,1.0,1,0.2135847943528984,48
5268,3,8660,4219,4441,0,0,0,1.0,1,1.0,1,1.0,1,0.2131280693982744,47
5269,2,8662,4219,4443,0,0,0,1.0,1,1.0,1,1.0,1,0.19258640493605161,45
5270,1,8663,4219,4444,0,0,0,1.0,1,1.0,1,1.0,1,0.19898863175355433,47
5271,1,8664,4219,4445,0,0,0,1.0,1,1.0,1,1.0,1,0.18187388322412387,45
5272,3,8667,4222,4445,0,0,0,1.0,1,1.0,1,1.0,1,0.20705863342524752,46
5273,0,8667,4222,4445,0,0,0,1.0,1,1.0,1,1.0,1,0.22975310410420974,44
5274,3,8670,4224,4446,0,0,0,1.0,1,1.0,1,1.0,1,0.2696414877877729,44
5275,5,8675,4225,4450,0,0,0,1.0,1,1.0,1,1.0,1,0.22832892345416345,46
5276,1,8676,4226,4450,0,0,0,1.0,1,1.0,1,1.0,1,0.20722476989418218,46
5277,2,8678,4227,4451,0,0,0,1.0,1,1.0,1,1.0,1,0.18929234198818073,46
5278,3,8681,4230,4451,0,0,0,1.0,1,1.0,1,1.0,1,0.20296221673325948,46
5279,3,8684,4231,4453,0,0,0,1.0,1,1.0,1,1.0,1,0.2201531240854852,47
5280,1,8685,4232,4453,0,0,0,1.0,1,1.0,1,1.0,1,0.2209281156942388,47
5281,0,8685,4232,4453,0,0,0,1.0,1,1.0,1,1.0,1,0.23134363524730317,48
5282,2,8687,4234,4453,0,0,0,1.0,1,1.0,1,1.0,1,0.26249674783032123,48
5283,2,8689,4234,4455,0,0,0,1.0,1,1.0,1,1.0,1,0.24654178059822718,49
5284,0,8689,4234,4455,0,0,0,1.0,1,1.0,1,1.0,1,0.24654178059822718,49
5285,1,8690,4234,4456,0,0,0,1.0,1,1.0,1,1.0,1,0.20008390184285274,50
5286,0,8690,4234,4456,0,0,0,1.0,1,1.0,1,1.0,1,0.2136667655886169,51
5287,0,8690,4234,4456,0,0,0,1.0,1,1.0,1,1.0,1,0.2136667655886169,51
5288,1,8691,4234,4457,0,0,0,1.0,1,1.0,1,1.0,1,0.19642391992975383,51
5289,2,8693,4234,4459,0,0,0,1.0,1,1.0,1,1.0,1,0.20139039144722676,53
5290,0,8693,4234,4459,0,0,0,1.0,1,1.0,1,1.0,1,0.20139039144722676,53
5291,2,8695,4235,4460,0,0,0,1.0,1,1.0,1,1.0,1,0.19361756562670726,53
5292,2,8697,4236,4461,0,0,0,1.0,1,1.0,1,1.0,1,0.19471763127553063,53
5293,4,8701,4239,4462,0,0,0,1.0,1,1.0,1,1.0,1,0.24026483334515605,53
5294,4,8705,4241,4464,0,0,0,1.0,1,1.0,1,1.0,1,0.2523218667700851,54
5295,4,8709,4242,4467,0,0,0,1.0,1,1.0,1,1.0,1,0.22105522814112627,52
5296,0,8709,4242,4467,0,0,0,1.0,1,1.0,1,1.0,1,0.22540429066054118,49
5297,4,8713,4244,4469,0,0,0,1.0,1,1.0,1,1.0,1,0.2335564090425982,49
5298,0,8713,4244,4469,0,0,0,1.0,1,1.0,1,1.0,1,0.2324580397683416,49
5299,2,8715,4246,4469,0,0,0,1.0,1,1.0,1,1.0,1,0.24060623210215232,50
5300,0,8715,4246,4469,0,0,0,1.0,1,1.0,1,1.0,1,0.2563921844948446,48
5301,1,8716,4247,4469,0,0,0,1.0,1,1.0,1,1.0,1,0.29284117168560814,46
5302,2,8718,4248,4470,0,0,0,1.0,1,1.0,1,1.0,1,0.28901362988047286,47
5303,3,8721,4250,4471,0,0,0,1.0,1,1.0,1,1.0,1,0.2529667005279821,46
5304,2,8723,4252,4471,0,0,0,1.0,1,1.0,1,1.0,1,0.29319936000839136,45
5305,1,8724,4252,4472,0,0,0,1.0,1,1.0,1,1.0,1,0.2773566628733438,44
5306,1,8725,4253,4472,0,0,0,1.0,1,1.0,1,1.0,1,0.3056181887509558,42
5307,1,8726,4254,4472,0,0,0,1.0,1,1.0,1,1.0,1,0.3310621786668023,42
5308,2,8728,4255,4473,0,0,0,1.0,1,1.0,1,1.0,1,0.33426123297898735,43
5309,1,8729,4256,4473,0,0,0,1.0,1,1.0,1,1.0,1,0.33135823249115715,41
5310,3,8732,4257,4475,0,0,0,1.0,1,1.0,1,1.0,1,0.33552690906273647,41
5311,2,8734,4258,4476,0,0,0,1.0,1,1.0,1,1.0,1,0.30277703391113336,42
5312,0,8734,4258,4476,0,0,0,1.0,1,1.0,1,1.0,1,0.317428387921589,43
5313,0,8734,4258,4476,0,0,0,1.0,1,1.0,1,1.0,1,0.31996795947738305,44
5314,1,8735,4258,4477,0,0,0,1.0,1,1.0,1,1.0,1,0.29261242140628435,44
5315,5,8740,4259,4481,0,0,0,1.0,1,1.0,1,1.0,1,0.27768487641262785,45
5316,1,8741,4259,4482,0,0,0,1.0,1,1.0,1,1.0,1,0.2650799495807324,46
5317,3,8744,4259,4485,0,0,0,1.0,1,1.0,1,1.0,1,0.24812368820818673,46
5318,1,8745,4260,4485,0,0,0,1.0,1,1.0,1,1.0,1,0.23311420891280463,46
5319,1,8746,4260,4486,0,0,0,1.0,1,1.0,1,1.0,1,0.23338259173186132,47
5320,2,8748,4261,4487,0,0,0,1.0,1,1.0,1,1.0,1,0.21107325277642755,48
5321,0,8748,4261,4487,0,0,0,1.0,1,1.0,1,1.0,1,0.22012091163440445,49
5322,0,8748,4261,4487,0,0,0,1.0,1,1.0,1,1.0,1,0.22012091163440445,49
5323,2,8750,4261,4489,0,0,0,1.0,1,1.0,1,1.0,1,0.2248846286961797,51
5324,0,8750,4261,4489,0,0,0,1.0,1,1.0,1,1.0,1,0.2220252879155711,53
5325,1,8751,4262,4489,0,0,0,1.0,1,1.0,1,1.0,1,0.23657524527910623,53
5326,1,8752,4263,4489,0,0,0,1.0,1,1.0,1,1.0,1,0.25742510087872017,53
5327,1,8753,4263,4490,0,0,0,1.0,1,1.0,1,1.0,1,0.2673982236497944,53
5328,1,8754,4263,4491,0,0,0,1.0,1,1.0,1,1.0,1,0.2613842168066355,54
5329,3,8757,4265,4492,0,0,0,1.0,1,1.0,1,1.0,1,0.2841549012572495,53
5330,2,8759,4267,4492,0,0,0,1.0,1,1.0,1,1.0,1,0.31514188067994153,52
5331,2,8761,4267,4494,0,0,0,1.0,1,1.0,1,1.0,1,0.3038257647922517,51
5332,3,8764,4267,4497,0,0,0,1.0,1,1.0,1,1.0,1,0.27548493839588284,52
5333,2,8766,4268,4498,0,0,0,1.0,1,1.0,1,1.0,1,0.3003770291392355,53
5334,3,8769,4269,4500,0,0,0,1.0,1,1.0,1,1.0,1,0.30175385416586564,54
5335,2,8771,4269,4502,0,0,0,1.0,1,1.0,1,1.0,1,0.2899566800210523,55
5336,0,8771,4269,4502,0,0,0,1.0,1,1.0,1,1.0,1,0.30080754511552377,54
5337,1,8772,4269,4503,0,0,0,1.0,1,1.0,1,1.0,1,0.2925289239450968,55
5338,2,8774,4270,4504,0,0,0,1.0,1,1.0,1,1.0,1,0.3065995102657084,55
5339,2,8776,4270,4506,0,0,0,1.0,1,1.0,1,1.0,1,0.2819215589419964,55
5340,0,8776,4270,4506,0,0,0,1.0,1,1.0,1,1.0,1,0.2819215589419964,55
5341,0,8776,4270,4506,0,0,0,1.0,1,1.0,1,1.0,1,0.32392189226427237,54
5342,1,8777,4271,4506,0,0,0,1.0,1,1.0,1,1.0,1,0.33478711616722867,55
5343,3,8780,4272,4508,0,0,0,1.0,1,1.0,1,1.0,1,0.30515556391343535,54
5344,3,8783,4275,4508,0,0,0,1.0,1,1.0,1,1.0,1,0.340746022740305,55
5345,5,8788,4275,4513,0,0,0,1.0,1,1.0,1,1.0,1,0.2684884341122932,53
5346,2,8790,4276,4514,0,0,0,1.0,1,1.0,1,1.0,1,0.2776370853556601,53
5347,4,8794,4278,4516,0,0,0,1.0,1,1.0,1,1.0,1,0.30301519906453417,51
5348,2,8796,4279,4517,0,0,0,1.0,1,1.0,1,1.0,1,0.2785039270661943,53
5349,7,8803,4281,4522,0,0,0,1.0,1,1.0,1,1.0,1,0.21153527573857106,52
5350,1,8804,4282,4522,0,0,0,1.0,1,1.0,1,1.0,1,0.22185594852558396,50
5351,3,8807,4284,4523,0,0,0,1.0,1,1.0,1,1.0,1,0.27794309265387235,52
5352,1,8808,4285,4523,0,0,0,1.0,1,1.0,1,1.0,1,0.2902029030628893,49
5353,2,8810,4285,4525,0,0,0,1.0,1,1.0,1,1.0,1,0.2488679368163913,49
5354,1,8811,4285,4526,0,0,0,1.0,1,1.0,1,1.0,1,0.21160342488089798,49
5355,0,8811,4285,4526,0,0,0,1.0,1,1.0,1,1.0,1,0.20328906947257874,48
5356,3,8814,4287,4527,0,0,0,1.0,1,1.0,1,1.0,1,0.24947803307186822,49
5357,1,8815,4287,4528,0,0,0,1.0,1,1.0,1,1.0,1,0.23161998865090191,47
5358,0,8815,4287,4528,0,0,0,1.0,1,1.0,1,1.0,1,0.23886989501965877,48
5359,1,8816,4287,4529,0,0,0,1.0,1,1.0,1,1.0,1,0.2323454970291766,48
5360,1,8817,4287,4530,0,0,0,1.0,1,1.0,1,1.0,1,0.22363340233958534,48
5361,1,8818,4287,4531,0,0,0,1.0,1,1.0,1,1.0,1,0.23310848916396523,50
5362,1,8819,4287,4532,0,0,0,1.0,1,1.0,1,1.0,1,0.21461816554463223,50
5363,0,8819,4287,4532,0,0,0,1.0,1,1.0,1,1.0,1,0.21461816554463223,50
5364,2,8821,4289,4532,0,0,0,1.0,1,1.0,1,1.0,1,0.20654134579040395,51
5365,2,8823,4289,4534,0,0,0,1.0,1,1.0,1,1.0,1,0.19782274775907618,52
5366,0,8823,4289,4534,0,0,0,1.0,1,1.0,1,1.0,1,0.19782274775907618,52
5367,3,8826,4290,4536,0,0,0,1.0,1,1.0,1,1.0,1,0.19412473497904303,54
5368,1,8827,4290,4537,0,0,0,1.0,1,1.0,1,1.0,1,0.19118275089204445,55
5369,2,8829,4291,4538,0,0,0,1.0,1,1.0,1,1.0,1,0.21909586694441047,53
5370,4,8833,4293,4540,0,0,0,1.0,1,1.0,1,1.0,1,0.23535416700661715,54
5371,3,8836,4295,4541,0,0,0,1.0,1,1.0,1,1.0,1,0.2438146393871879,53
5372,3,8839,4298,4541,0,0,0,1.0,1,1.0,1,1.0,1,0.31503545214176915,53
5373,4,8843,4298,4545,0,0,0,1.0,1,1.0,1,1.0,1,0.23848968746541946,52
5374,0,8843,4298,4545,0,0,0,1.0,1,1.0,1,1.0,1,0.22787995343260123,51
5375,1,8844,4298,4546,0,0,0,1.0,1,1.0,1,1.0,1,0.182502265793641,52
5376,3,8847,4300,4547,0,0,0,1.0,1,1.0,1,1.0,1,0.2143838456918088,51
5377,0,8847,4300,4547,0,0,0,1.0,1,1.0,1,1.0,1,0.2269956122273839,52
5378,2,8849,4302,4547,0,0,0,1.0,1,1.0,1,1.0,1,0.2720908013611756,50
5379,2,8851,4302,4549,0,0,0,1.0,1,1.0,1,1.0,1,0.23475351614080506,50
5380,1,8852,4302,4550,0,0,0,1.0,1,1.0,1,1.0,1,0.24755396188870518,52
5381,0,8852,4302,4550,0,0,0,1.0,1,1.0,1,1.0,1,0.24755396188870518,52
5382,0,8852,4302,4550,0,0,0,1.0,1,1.0,1,1.0,1,0.2471227568672141,52
5383,0,8852,4302,4550,0,0,0,1.0,1,1.0,1,1.0,1,0.23194557973754193,51
5384,3,8855,4303,4552,0,0,0,1.0,1,1.0,1,1.0,1,0.2236559860600243,52
5385,3,8858,4304,4554,0,0,0,1.0,1,1.0,1,1.0,1,0.2152636814383847,51
5386,3,8861,4305,4556,0,0,0,1.0,1,1.0,1,1.0,1,0.1809586157671461,52
5387,2,8863,4305,4558,0,0,0,1.0,1,1.0,1,1.0,1,0.14835914470113026,53
5388,1,8864,4305,4559,0,0,0,1.0,1,1.0,1,1.0,1,0.1367341908661931,54
5389,2,8866,4306,4560,0,0,0,1.0,1,1.0,1,1.0,1,0.12068517673073148,55
5390,1,8867,4307,4560,0,0,0,1.0,1,1.0,1,1.0,1,0.1325651346866098,56
5391,1,8868,4308,4560,0,0,0,1.0,1,1.0,1,1.0,1,0.1443036088399112,56
5392,5,8873,4311,4562,0,0,0,1.0,1,1.0,1,1.0,1,0.15864442516530036,56
5393,2,8875,4312,4563,0,0,0,1.0,1,1.0,1,1.0,1,0.17675296457147152,54
5394,1,8876,4313,4563,0,0,0,1.0,1,1.0,1,1.0,1,0.19239498636165714,53
5395,4,8880,4315,4565,0,0,0,1.0,1,1.0,1,1.0,1,0.17504484769579667,53
5396,3,8883,4316,4567,0,0,0,1.0,1,1.0,1,1.0,1,0.16187348804346183,54
5397,3,8886,4318,4568,0,0,0,1.0,1,1.0,1,1.0,1,0.14473676503171307,53
5398,1,8887,4319,4568,0,0,0,1.0,1,1.0,1,1.0,1,0.1316390561468303,53
5399,5,8892,4323,4569,0,0,0,1.0,1,1.0,1,1.0,1,0.20766045357436771,55
5400,3,8895,4323,4572,0,0,0,1.0,1,1.0,1,1.0,1,0.17359549426735965,55
5401,2,8897,4325,4572,0,0,0,1.0,1,1.0,1,1.0,1,0.2207246791874235,56
5402,0,8897,4325,4572,0,0,0,1.0,1,1.0,1,1.0,1,0.0,0
