,SuccessfulHandoverCount,TotalSuccessfulHandoverCount,TotalSuccessfulHandoverCountRange,TotalSuccessfulHandoverCountLoadBalancing,TotalSuccessfulHandoverCountOverload,FailedHandoverCount,TotalFailedHandoverCount,AvgQoS,MinQoS,AvgQoS_LoadBased,MinQoS_LoadBased,AvgQoS_RangeBased,MinQoS_RangeBased,GiniLoad,VehicleCount
0,0,0,0,0,0,0,0,1.0,1,1.0,1,1.0,1,0.0,0
1,21,21,0,21,0,0,0,1.0,1,1.0,1,1.0,1,0.21657892356170347,26
2,17,38,0,38,0,0,0,1.0,1,1.0,1,1.0,1,0.18791845812517585,27
3,17,55,0,55,0,0,0,1.0,1,1.0,1,1.0,1,0.25024752654601423,28
4,13,68,0,68,0,0,0,1.0,1,1.0,1,1.0,1,0.2282232856460528,29
5,15,83,0,83,0,0,0,1.0,1,1.0,1,1.0,1,0.2692221329804045,29
6,3,86,0,86,0,0,0,1.0,1,1.0,1,1.0,1,0.1874109978433517,32
7,3,89,0,89,0,0,0,1.0,1,1.0,1,1.0,1,0.11960822038621904,33
8,5,94,1,93,0,0,0,1.0,1,1.0,1,1.0,1,0.1095863075991039,35
9,3,97,1,96,0,0,0,1.0,1,1.0,1,1.0,1,0.07948716523596865,35
10,4,101,2,99,0,0,0,1.0,1,1.0,1,1.0,1,0.16361472228942248,35
11,1,102,3,99,0,0,0,1.0,1,1.0,1,1.0,1,0.14315869412321217,35
12,2,104,4,100,0,0,0,1.0,1,1.0,1,1.0,1,0.12260292553929064,34
13,1,105,5,100,0,0,0,1.0,1,1.0,1,1.0,1,0.14829072915174646,32
14,2,107,7,100,0,0,0,1.0,1,1.0,1,1.0,1,0.17486835320130575,31
15,0,107,7,100,0,0,0,1.0,1,1.0,1,1.0,1,0.19466302227594676,30
16,3,110,7,103,0,0,0,1.0,1,1.0,1,1.0,1,0.1577847758216263,30
17,0,110,7,103,0,0,0,1.0,1,1.0,1,1.0,1,0.18628834645349612,29
18,1,111,8,103,0,0,0,1.0,1,1.0,1,1.0,1,0.2408840519094969,29
19,0,111,8,103,0,0,0,1.0,1,1.0,1,1.0,1,0.22939266194848373,28
20,1,112,9,103,0,0,0,1.0,1,1.0,1,1.0,1,0.2775397133997,28
21,2,114,9,105,0,0,0,1.0,1,1.0,1,1.0,1,0.20321976290539262,28
22,6,120,13,107,0,0,0,1.0,1,1.0,1,1.0,1,0.24794970132049532,28
23,4,124,14,110,0,0,0,1.0,1,1.0,1,1.0,1,0.21578280846549353,27
24,1,125,15,110,0,0,0,1.0,1,1.0,1,1.0,1,0.25702231852652174,28
25,7,132,17,115,0,0,0,1.0,1,1.0,1,1.0,1,0.13323900300409172,28
26,3,135,19,116,0,0,0,1.0,1,1.0,1,1.0,1,0.15269733671142097,30
27,0,135,19,116,0,0,0,1.0,1,1.0,1,1.0,1,0.15647639314725348,30
28,1,136,20,116,0,0,0,1.0,1,1.0,1,1.0,1,0.15899767350035912,31
29,3,139,21,118,0,0,0,1.0,1,1.0,1,1.0,1,0.14516983302127587,30
30,0,139,21,118,0,0,0,1.0,1,1.0,1,1.0,1,0.14516983302127587,30
31,2,141,22,119,0,0,0,1.0,1,1.0,1,1.0,1,0.14898238689102808,31
32,0,141,22,119,0,0,0,1.0,1,1.0,1,1.0,1,0.15764629953601225,31
33,1,142,23,119,0,0,0,1.0,1,1.0,1,1.0,1,0.20163230014137803,31
34,3,145,25,120,0,0,0,1.0,1,1.0,1,1.0,1,0.2424970349767291,29
35,1,146,25,121,0,0,0,1.0,1,1.0,1,1.0,1,0.1590688533596421,30
36,3,149,26,123,0,0,0,1.0,1,1.0,1,1.0,1,0.20597036486916154,30
37,1,150,26,124,0,0,0,1.0,1,1.0,1,1.0,1,0.21452519157037725,31
38,2,152,27,125,0,0,0,1.0,1,1.0,1,1.0,1,0.16491520006296762,32
39,3,155,27,128,0,0,0,1.0,1,1.0,1,1.0,1,0.1445400967377749,36
40,0,155,27,128,0,0,0,1.0,1,1.0,1,1.0,1,0.15421002430689842,37
41,1,156,27,129,0,0,0,1.0,1,1.0,1,1.0,1,0.1294247763498302,37
42,0,156,27,129,0,0,0,1.0,1,1.0,1,1.0,1,0.11884942396178394,38
43,5,161,28,133,0,0,0,1.0,1,1.0,1,1.0,1,0.09525083361685098,40
44,0,161,28,133,0,0,0,1.0,1,1.0,1,1.0,1,0.105094721242573,39
45,1,162,29,133,0,0,0,1.0,1,1.0,1,1.0,1,0.15479420971587537,40
46,1,163,29,134,0,0,0,1.0,1,1.0,1,1.0,1,0.1076510298048766,39
47,1,164,30,134,0,0,0,1.0,1,1.0,1,1.0,1,0.12627687328011322,39
48,2,166,31,135,0,0,0,1.0,1,1.0,1,1.0,1,0.1309412641290217,39
49,1,167,32,135,0,0,0,1.0,1,1.0,1,1.0,1,0.11764234516652618,37
50,2,169,33,136,0,0,0,1.0,1,1.0,1,1.0,1,0.13358232106106976,35
51,1,170,33,137,0,0,0,1.0,1,1.0,1,1.0,1,0.1134088306652886,34
52,0,170,33,137,0,0,0,1.0,1,1.0,1,1.0,1,0.14225939000664933,34
53,1,171,33,138,0,0,0,1.0,1,1.0,1,1.0,1,0.11766739610796305,35
54,0,171,33,138,0,0,0,1.0,1,1.0,1,1.0,1,0.15249340020555505,36
55,1,172,34,138,0,0,0,1.0,1,1.0,1,1.0,1,0.14441429312288145,36
56,4,176,37,139,0,0,0,1.0,1,1.0,1,1.0,1,0.1343092017832129,36
57,1,177,37,140,0,0,0,1.0,1,1.0,1,1.0,1,0.14727716161380572,37
58,4,181,39,142,0,0,0,1.0,1,1.0,1,1.0,1,0.18113173370290947,38
59,2,183,40,143,0,0,0,1.0,1,1.0,1,1.0,1,0.20748212347661604,37
60,3,186,41,145,0,0,0,1.0,1,1.0,1,1.0,1,0.1713969107622342,38
61,3,189,41,148,0,0,0,1.0,1,1.0,1,1.0,1,0.1724204362250662,37
62,1,190,42,148,0,0,0,1.0,1,1.0,1,1.0,1,0.2185044280329689,39
63,1,191,43,148,0,0,0,1.0,1,1.0,1,1.0,1,0.23882555297104338,39
64,1,192,44,148,0,0,0,1.0,1,1.0,1,1.0,1,0.2312012043121915,38
65,5,197,46,151,0,0,0,1.0,1,1.0,1,1.0,1,0.2108897307696555,39
66,4,201,48,153,0,0,0,1.0,1,1.0,1,1.0,1,0.20770871666104515,39
67,1,202,48,154,0,0,0,1.0,1,1.0,1,1.0,1,0.1650155650089429,36
68,1,203,48,155,0,0,0,1.0,1,1.0,1,1.0,1,0.1767324235188545,36
69,1,204,48,156,0,0,0,1.0,1,1.0,1,1.0,1,0.1496921032821502,37
70,0,204,48,156,0,0,0,1.0,1,1.0,1,1.0,1,0.18257871905127065,36
71,1,205,48,157,0,0,0,1.0,1,1.0,1,1.0,1,0.16665888297878753,38
72,3,208,49,159,0,0,0,1.0,1,1.0,1,1.0,1,0.14941893813688223,38
73,0,208,49,159,0,0,0,1.0,1,1.0,1,1.0,1,0.1676238737520449,37
74,2,210,49,161,0,0,0,1.0,1,1.0,1,1.0,1,0.1485045059547142,38
75,0,210,49,161,0,0,0,1.0,1,1.0,1,1.0,1,0.1485045059547142,38
76,2,212,51,161,0,0,0,1.0,1,1.0,1,1.0,1,0.1633112927245531,39
77,2,214,51,163,0,0,0,1.0,1,1.0,1,1.0,1,0.16896974975707593,40
78,3,217,51,166,0,0,0,1.0,1,1.0,1,1.0,1,0.15269937079744406,41
79,0,217,51,166,0,0,0,1.0,1,1.0,1,1.0,1,0.15269937079744406,41
80,0,217,51,166,0,0,0,1.0,1,1.0,1,1.0,1,0.15269937079744406,41
81,3,220,51,169,0,0,0,1.0,1,1.0,1,1.0,1,0.11651394071887461,41
82,2,222,51,171,0,0,0,1.0,1,1.0,1,1.0,1,0.09766237843010211,44
83,1,223,51,172,0,0,0,1.0,1,1.0,1,1.0,1,0.10805576645160785,44
84,5,228,51,177,0,0,0,1.0,1,1.0,1,1.0,1,0.10116321039403223,45
85,2,230,51,179,0,0,0,1.0,1,1.0,1,1.0,1,0.107083485861949,45
86,0,230,51,179,0,0,0,1.0,1,1.0,1,1.0,1,0.107083485861949,45
87,1,231,52,179,0,0,0,1.0,1,1.0,1,1.0,1,0.14511373191346316,44
88,0,231,52,179,0,0,0,1.0,1,1.0,1,1.0,1,0.14511373191346316,44
89,0,231,52,179,0,0,0,1.0,1,1.0,1,1.0,1,0.19886635932916913,43
90,0,231,52,179,0,0,0,1.0,1,1.0,1,1.0,1,0.21641777589502986,44
91,2,233,53,180,0,0,0,1.0,1,1.0,1,1.0,1,0.2392173287456036,44
92,0,233,53,180,0,0,0,1.0,1,1.0,1,1.0,1,0.223101104911485,43
93,1,234,53,181,0,0,0,1.0,1,1.0,1,1.0,1,0.22362631803544528,44
94,1,235,54,181,0,0,0,1.0,1,1.0,1,1.0,1,0.23989490192707044,44
95,1,236,54,182,0,0,0,1.0,1,1.0,1,1.0,1,0.21877335218738866,43
96,3,239,54,185,0,0,0,1.0,1,1.0,1,1.0,1,0.16270453474882415,44
97,2,241,54,187,0,0,0,1.0,1,1.0,1,1.0,1,0.1417636188432896,44
98,0,241,54,187,0,0,0,1.0,1,1.0,1,1.0,1,0.15219979501801245,43
99,0,241,54,187,0,0,0,1.0,1,1.0,1,1.0,1,0.15219979501801245,43
100,2,243,55,188,0,0,0,1.0,1,1.0,1,1.0,1,0.12004906845549833,47
101,0,243,55,188,0,0,0,1.0,1,1.0,1,1.0,1,0.12004906845549833,47
102,1,244,56,188,0,0,0,1.0,1,1.0,1,1.0,1,0.14513489045765382,47
103,2,246,58,188,0,0,0,1.0,1,1.0,1,1.0,1,0.13979740023264425,46
104,3,249,61,188,0,0,0,1.0,1,1.0,1,1.0,1,0.14235478994516979,45
105,4,253,63,190,0,0,0,1.0,1,1.0,1,1.0,1,0.14002056222362017,44
106,5,258,67,191,0,0,0,1.0,1,1.0,1,1.0,1,0.15889849206403436,45
107,3,261,68,193,0,0,0,1.0,1,1.0,1,1.0,1,0.15096331556668247,44
108,2,263,69,194,0,0,0,1.0,1,1.0,1,1.0,1,0.13027689082680405,46
109,1,264,69,195,0,0,0,1.0,1,1.0,1,1.0,1,0.11926121437054933,46
110,4,268,71,197,0,0,0,1.0,1,1.0,1,1.0,1,0.11543702939494901,46
111,4,272,73,199,0,0,0,1.0,1,1.0,1,1.0,1,0.12966566275503352,46
112,2,274,75,199,0,0,0,1.0,1,1.0,1,1.0,1,0.13682734014555464,46
113,1,275,76,199,0,0,0,1.0,1,1.0,1,1.0,1,0.14642507505637822,46
114,1,276,76,200,0,0,0,1.0,1,1.0,1,1.0,1,0.14568948033790366,46
115,4,280,77,203,0,0,0,1.0,1,1.0,1,1.0,1,0.1429652781038982,47
116,6,286,80,206,0,0,0,1.0,1,1.0,1,1.0,1,0.13054386590323006,47
117,3,289,81,208,0,0,0,1.0,1,1.0,1,1.0,1,0.08616662938338208,45
118,1,290,81,209,0,0,0,1.0,1,1.0,1,1.0,1,0.07203603855363208,46
119,0,290,81,209,0,0,0,1.0,1,1.0,1,1.0,1,0.09402780955942834,46
120,1,291,82,209,0,0,0,1.0,1,1.0,1,1.0,1,0.08611828960082175,47
121,0,291,82,209,0,0,0,1.0,1,1.0,1,1.0,1,0.09331377958288928,46
122,1,292,83,209,0,0,0,1.0,1,1.0,1,1.0,1,0.09006157008708407,46
123,0,292,83,209,0,0,0,1.0,1,1.0,1,1.0,1,0.1112158812624458,45
124,1,293,83,210,0,0,0,1.0,1,1.0,1,1.0,1,0.10012149451580207,46
125,0,293,83,210,0,0,0,1.0,1,1.0,1,1.0,1,0.10946497769130545,44
126,5,298,84,214,0,0,0,1.0,1,1.0,1,1.0,1,0.0724335982286251,45
127,0,298,84,214,0,0,0,1.0,1,1.0,1,1.0,1,0.06716664436698877,45
128,0,298,84,214,0,0,0,1.0,1,1.0,1,1.0,1,0.0712109191725066,46
129,2,300,85,215,0,0,0,1.0,1,1.0,1,1.0,1,0.05894670645933117,48
130,1,301,86,215,0,0,0,1.0,1,1.0,1,1.0,1,0.0795314507316672,48
131,1,302,86,216,0,0,0,1.0,1,1.0,1,1.0,1,0.05120940664807405,49
132,7,309,90,219,0,0,0,1.0,1,1.0,1,1.0,1,0.10247162151313094,51
133,5,314,93,221,0,0,0,1.0,1,1.0,1,1.0,1,0.1212786850410406,49
134,3,317,95,222,0,0,0,1.0,1,1.0,1,1.0,1,0.1602513257743012,49
135,3,320,95,225,0,0,0,1.0,1,1.0,1,1.0,1,0.14005369469279197,49
136,7,327,99,228,0,0,0,1.0,1,1.0,1,1.0,1,0.04559899184582318,48
137,1,328,100,228,0,0,0,1.0,1,1.0,1,1.0,1,0.086352937723669,47
138,3,331,103,228,0,0,0,1.0,1,1.0,1,1.0,1,0.0994405744494376,48
139,1,332,104,228,0,0,0,1.0,1,1.0,1,1.0,1,0.08438515744360156,48
140,1,333,105,228,0,0,0,1.0,1,1.0,1,1.0,1,0.12410770802994377,49
141,2,335,106,229,0,0,0,1.0,1,1.0,1,1.0,1,0.12516074619619896,49
142,1,336,107,229,0,0,0,1.0,1,1.0,1,1.0,1,0.12259787090540152,49
143,2,338,109,229,0,0,0,1.0,1,1.0,1,1.0,1,0.13016445331561421,47
144,2,340,111,229,0,0,0,1.0,1,1.0,1,1.0,1,0.1497649451912187,46
145,3,343,112,231,0,0,0,1.0,1,1.0,1,1.0,1,0.18485789426846636,44
146,5,348,113,235,0,0,0,1.0,1,1.0,1,1.0,1,0.08083002971707595,44
147,0,348,113,235,0,0,0,1.0,1,1.0,1,1.0,1,0.07290784443976368,43
148,1,349,114,235,0,0,0,1.0,1,1.0,1,1.0,1,0.10673895722472847,43
149,2,351,115,236,0,0,0,1.0,1,1.0,1,1.0,1,0.10732701660076761,43
150,0,351,115,236,0,0,0,1.0,1,1.0,1,1.0,1,0.12174173650668409,42
151,3,354,116,238,0,0,0,1.0,1,1.0,1,1.0,1,0.10084121619606834,42
152,0,354,116,238,0,0,0,1.0,1,1.0,1,1.0,1,0.10084121619606834,42
153,0,354,116,238,0,0,0,1.0,1,1.0,1,1.0,1,0.12058520962349542,42
154,4,358,118,240,0,0,0,1.0,1,1.0,1,1.0,1,0.17109440665219341,43
155,1,359,118,241,0,0,0,1.0,1,1.0,1,1.0,1,0.1766394961087329,43
156,4,363,118,245,0,0,0,1.0,1,1.0,1,1.0,1,0.10143147045130718,42
157,2,365,118,247,0,0,0,1.0,1,1.0,1,1.0,1,0.1517499159935905,41
158,5,370,118,252,0,0,0,1.0,1,1.0,1,1.0,1,0.09445536842182761,42
159,2,372,118,254,0,0,0,1.0,1,1.0,1,1.0,1,0.06622828085515735,43
160,8,380,121,259,0,0,0,1.0,1,1.0,1,1.0,1,0.18382881091781336,44
161,3,383,122,261,0,0,0,1.0,1,1.0,1,1.0,1,0.16129313805354087,44
162,6,389,123,266,0,0,0,1.0,1,1.0,1,1.0,1,0.1726939964233055,45
163,4,393,124,269,0,0,0,1.0,1,1.0,1,1.0,1,0.24616301944312902,43
164,4,397,125,272,0,0,0,1.0,1,1.0,1,1.0,1,0.21106733805623465,42
165,1,398,126,272,0,0,0,1.0,1,1.0,1,1.0,1,0.15522880336097503,42
166,3,401,126,275,0,0,0,1.0,1,1.0,1,1.0,1,0.11197811066032765,42
167,7,408,130,278,0,0,0,1.0,1,1.0,1,1.0,1,0.12115318192458732,41
168,1,409,131,278,0,0,0,1.0,1,1.0,1,1.0,1,0.1421620403189616,40
169,2,411,131,280,0,0,0,1.0,1,1.0,1,1.0,1,0.061805248821058666,40
170,2,413,131,282,0,0,0,1.0,1,1.0,1,1.0,1,0.08778087122358588,38
171,1,414,131,283,0,0,0,1.0,1,1.0,1,1.0,1,0.05887695901433652,37
172,2,416,133,283,0,0,0,1.0,1,1.0,1,1.0,1,0.14763757681770617,35
173,4,420,135,285,0,0,0,1.0,1,1.0,1,1.0,1,0.17668883901831753,36
174,0,420,135,285,0,0,0,1.0,1,1.0,1,1.0,1,0.16501529837443007,34
175,0,420,135,285,0,0,0,1.0,1,1.0,1,1.0,1,0.17981460658191675,33
176,3,423,136,287,0,0,0,1.0,1,1.0,1,1.0,1,0.10498783979673153,34
177,1,424,136,288,0,0,0,1.0,1,1.0,1,1.0,1,0.11278110135013453,36
178,0,424,136,288,0,0,0,1.0,1,1.0,1,1.0,1,0.14064472955333213,37
179,0,424,136,288,0,0,0,1.0,1,1.0,1,1.0,1,0.14064472955333213,37
180,0,424,136,288,0,0,0,1.0,1,1.0,1,1.0,1,0.16366315986538035,36
181,1,425,136,289,0,0,0,1.0,1,1.0,1,1.0,1,0.1339805298536424,36
182,1,426,137,289,0,0,0,1.0,1,1.0,1,1.0,1,0.1559338044879927,38
183,1,427,138,289,0,0,0,1.0,1,1.0,1,1.0,1,0.16249830288289965,37
184,4,431,140,291,0,0,0,1.0,1,1.0,1,1.0,1,0.17484362917204732,36
185,2,433,140,293,0,0,0,1.0,1,1.0,1,1.0,1,0.16777878346611952,35
186,4,437,141,296,0,0,0,1.0,1,1.0,1,1.0,1,0.13967894599208586,34
187,1,438,142,296,0,0,0,1.0,1,1.0,1,1.0,1,0.14562740210222316,33
188,2,440,143,297,0,0,0,1.0,1,1.0,1,1.0,1,0.15346037019633998,33
189,4,444,147,297,0,0,0,1.0,1,1.0,1,1.0,1,0.23854557756925637,33
190,1,445,148,297,0,0,0,1.0,1,1.0,1,1.0,1,0.26292276529523084,32
191,5,450,148,302,0,0,0,1.0,1,1.0,1,1.0,1,0.13636920298856336,34
192,3,453,148,305,0,0,0,1.0,1,1.0,1,1.0,1,0.1163518887775596,34
193,2,455,148,307,0,0,0,1.0,1,1.0,1,1.0,1,0.13463877737513466,35
194,4,459,149,310,0,0,0,1.0,1,1.0,1,1.0,1,0.1518490119553002,37
195,3,462,149,313,0,0,0,1.0,1,1.0,1,1.0,1,0.19135389464423302,36
196,1,463,149,314,0,0,0,1.0,1,1.0,1,1.0,1,0.1561085781481388,36
197,1,464,149,315,0,0,0,1.0,1,1.0,1,1.0,1,0.1590148780140341,37
198,2,466,150,316,0,0,0,1.0,1,1.0,1,1.0,1,0.16369382249298603,37
199,0,466,150,316,0,0,0,1.0,1,1.0,1,1.0,1,0.16369382249298603,37
200,1,467,151,316,0,0,0,1.0,1,1.0,1,1.0,1,0.17961403477966625,37
201,1,468,151,317,0,0,0,1.0,1,1.0,1,1.0,1,0.1210147819489315,36
202,0,468,151,317,0,0,0,1.0,1,1.0,1,1.0,1,0.0997337622162114,36
203,1,469,152,317,0,0,0,1.0,1,1.0,1,1.0,1,0.12373897192524685,35
204,2,471,154,317,0,0,0,1.0,1,1.0,1,1.0,1,0.19824830930511372,35
205,4,475,156,319,0,0,0,1.0,1,1.0,1,1.0,1,0.169526132077359,35
206,6,481,158,323,0,0,0,1.0,1,1.0,1,1.0,1,0.14477057759833212,34
207,3,484,160,324,0,0,0,1.0,1,1.0,1,1.0,1,0.16971145589275705,34
208,5,489,161,328,0,0,0,1.0,1,1.0,1,1.0,1,0.2270134855562143,33
209,1,490,161,329,0,0,0,1.0,1,1.0,1,1.0,1,0.25108279013676105,33
210,3,493,162,331,0,0,0,1.0,1,1.0,1,1.0,1,0.2774432711846628,34
211,7,500,163,337,0,0,0,1.0,1,1.0,1,1.0,1,0.1724204676723782,33
212,0,500,163,337,0,0,0,1.0,1,1.0,1,1.0,1,0.1724204676723782,33
213,1,501,163,338,0,0,0,1.0,1,1.0,1,1.0,1,0.181968959254934,35
214,3,504,163,341,0,0,0,1.0,1,1.0,1,1.0,1,0.17209376818206903,34
215,2,506,163,343,0,0,0,1.0,1,1.0,1,1.0,1,0.17525484796232102,35
216,6,512,163,349,0,0,0,1.0,1,1.0,1,1.0,1,0.08720481500734996,36
217,1,513,164,349,0,0,0,1.0,1,1.0,1,1.0,1,0.08975359240035918,36
218,1,514,165,349,0,0,0,1.0,1,1.0,1,1.0,1,0.14397699723654314,36
219,3,517,165,352,0,0,0,1.0,1,1.0,1,1.0,1,0.11185074849789062,37
220,1,518,165,353,0,0,0,1.0,1,1.0,1,1.0,1,0.11547356324928709,38
221,2,520,166,354,0,0,0,1.0,1,1.0,1,1.0,1,0.1066730738748593,37
222,4,524,167,357,0,0,0,1.0,1,1.0,1,1.0,1,0.13226097719773805,38
223,4,528,168,360,0,0,0,1.0,1,1.0,1,1.0,1,0.13262081763047298,38
224,4,532,170,362,0,0,0,1.0,1,1.0,1,1.0,1,0.14079343752455314,38
225,2,534,171,363,0,0,0,1.0,1,1.0,1,1.0,1,0.1531860023903159,36
226,5,539,172,367,0,0,0,1.0,1,1.0,1,1.0,1,0.13312086296105205,37
227,1,540,172,368,0,0,0,1.0,1,1.0,1,1.0,1,0.10908739099711354,35
228,2,542,173,369,0,0,0,1.0,1,1.0,1,1.0,1,0.08851069067983564,35
229,3,545,175,370,0,0,0,1.0,1,1.0,1,1.0,1,0.11521146316871535,35
230,3,548,177,371,0,0,0,1.0,1,1.0,1,1.0,1,0.13713259968295308,35
231,0,548,177,371,0,0,0,1.0,1,1.0,1,1.0,1,0.1156163960782343,35
232,3,551,179,372,0,0,0,1.0,1,1.0,1,1.0,1,0.15364222438194963,36
233,1,552,179,373,0,0,0,1.0,1,1.0,1,1.0,1,0.11431583283412376,36
234,3,555,180,375,0,0,0,1.0,1,1.0,1,1.0,1,0.1706463941286644,34
235,4,559,183,376,0,0,0,1.0,1,1.0,1,1.0,1,0.2477738936445523,33
236,2,561,184,377,0,0,0,1.0,1,1.0,1,1.0,1,0.20550711802387045,31
237,1,562,185,377,0,0,0,1.0,1,1.0,1,1.0,1,0.23300364797920695,32
238,3,565,186,379,0,0,0,1.0,1,1.0,1,1.0,1,0.2169169859239125,31
239,2,567,186,381,0,0,0,1.0,1,1.0,1,1.0,1,0.1474170732789164,30
240,1,568,187,381,0,0,0,1.0,1,1.0,1,1.0,1,0.20303288069003242,27
241,2,570,187,383,0,0,0,1.0,1,1.0,1,1.0,1,0.13413891414552184,27
242,0,570,187,383,0,0,0,1.0,1,1.0,1,1.0,1,0.1329457152118429,28
243,0,570,187,383,0,0,0,1.0,1,1.0,1,1.0,1,0.1329457152118429,28
244,2,572,188,384,0,0,0,1.0,1,1.0,1,1.0,1,0.1602867892785616,27
245,3,575,190,385,0,0,0,1.0,1,1.0,1,1.0,1,0.21452903171923504,27
246,3,578,191,387,0,0,0,1.0,1,1.0,1,1.0,1,0.14890931769451185,25
247,1,579,191,388,0,0,0,1.0,1,1.0,1,1.0,1,0.14076098307563564,24
248,2,581,191,390,0,0,0,1.0,1,1.0,1,1.0,1,0.12586073801239991,24
249,1,582,191,391,0,0,0,1.0,1,1.0,1,1.0,1,0.1826760648116121,25
250,2,584,191,393,0,0,0,1.0,1,1.0,1,1.0,1,0.14869517350408606,27
251,0,584,191,393,0,0,0,1.0,1,1.0,1,1.0,1,0.14869517350408606,27
252,0,584,191,393,0,0,0,1.0,1,1.0,1,1.0,1,0.14869517350408606,27
253,0,584,191,393,0,0,0,1.0,1,1.0,1,1.0,1,0.14876989090475315,29
254,1,585,192,393,0,0,0,1.0,1,1.0,1,1.0,1,0.12668461882514176,30
255,1,586,192,394,0,0,0,1.0,1,1.0,1,1.0,1,0.113441080606268,31
256,1,587,193,394,0,0,0,1.0,1,1.0,1,1.0,1,0.1535155632095239,31
257,1,588,193,395,0,0,0,1.0,1,1.0,1,1.0,1,0.16331999674170483,33
258,0,588,193,395,0,0,0,1.0,1,1.0,1,1.0,1,0.16331999674170483,33
259,1,589,193,396,0,0,0,1.0,1,1.0,1,1.0,1,0.14672083006769535,33
260,3,592,194,398,0,0,0,1.0,1,1.0,1,1.0,1,0.21403396070337025,35
261,5,597,197,400,0,0,0,1.0,1,1.0,1,1.0,1,0.2001530138461541,35
262,3,600,199,401,0,0,0,1.0,1,1.0,1,1.0,1,0.24576393078322667,35
263,1,601,199,402,0,0,0,1.0,1,1.0,1,1.0,1,0.22177225781587895,34
264,2,603,201,402,0,0,0,1.0,1,1.0,1,1.0,1,0.2713281398224101,32
265,0,603,201,402,0,0,0,1.0,1,1.0,1,1.0,1,0.23094152514538197,30
266,3,606,203,403,0,0,0,1.0,1,1.0,1,1.0,1,0.23212641332817308,31
267,1,607,204,403,0,0,0,1.0,1,1.0,1,1.0,1,0.21353419633677292,30
268,2,609,205,404,0,0,0,1.0,1,1.0,1,1.0,1,0.16095732798023488,31
269,4,613,207,406,0,0,0,1.0,1,1.0,1,1.0,1,0.18985152455959395,31
270,1,614,208,406,0,0,0,1.0,1,1.0,1,1.0,1,0.2437658019990265,32
271,1,615,208,407,0,0,0,1.0,1,1.0,1,1.0,1,0.22469834732218627,31
272,2,617,209,408,0,0,0,1.0,1,1.0,1,1.0,1,0.31937163722628487,32
273,0,617,209,408,0,0,0,1.0,1,1.0,1,1.0,1,0.31937163722628487,32
274,2,619,210,409,0,0,0,1.0,1,1.0,1,1.0,1,0.32008714842336955,32
275,0,619,210,409,0,0,0,1.0,1,1.0,1,1.0,1,0.28024898514965124,33
276,2,621,211,410,0,0,0,1.0,1,1.0,1,1.0,1,0.2829015517141886,34
277,2,623,212,411,0,0,0,1.0,1,1.0,1,1.0,1,0.30269979944982145,32
278,0,623,212,411,0,0,0,1.0,1,1.0,1,1.0,1,0.32296288522327893,31
279,3,626,213,413,0,0,0,1.0,1,1.0,1,1.0,1,0.30875080231472707,31
280,4,630,214,416,0,0,0,1.0,1,1.0,1,1.0,1,0.3113836761658268,30
281,7,637,214,423,0,0,0,1.0,1,1.0,1,1.0,1,0.08633320427649026,31
282,3,640,214,426,0,0,0,1.0,1,1.0,1,1.0,1,0.1202605095395478,30
283,5,645,215,430,0,0,0,1.0,1,1.0,1,1.0,1,0.10054631402650512,31
284,5,650,216,434,0,0,0,1.0,1,1.0,1,1.0,1,0.19449128137935187,31
285,6,656,216,440,0,0,0,1.0,1,1.0,1,1.0,1,0.12990804121733843,31
286,1,657,216,441,0,0,0,1.0,1,1.0,1,1.0,1,0.1095025722911698,31
287,0,657,216,441,0,0,0,1.0,1,1.0,1,1.0,1,0.14281657721485386,33
288,0,657,216,441,0,0,0,1.0,1,1.0,1,1.0,1,0.1204674276006926,32
289,1,658,217,441,0,0,0,1.0,1,1.0,1,1.0,1,0.20705231384381,32
290,1,659,217,442,0,0,0,1.0,1,1.0,1,1.0,1,0.18448625156373324,31
291,0,659,217,442,0,0,0,1.0,1,1.0,1,1.0,1,0.1789737267162307,30
292,1,660,218,442,0,0,0,1.0,1,1.0,1,1.0,1,0.17502221142173321,32
293,0,660,218,442,0,0,0,1.0,1,1.0,1,1.0,1,0.17502221142173321,32
294,0,660,218,442,0,0,0,1.0,1,1.0,1,1.0,1,0.17502221142173321,32
295,2,662,218,444,0,0,0,1.0,1,1.0,1,1.0,1,0.16707702083425438,34
296,2,664,219,445,0,0,0,1.0,1,1.0,1,1.0,1,0.15355356612538984,34
297,4,668,220,448,0,0,0,1.0,1,1.0,1,1.0,1,0.08145254671900959,34
298,0,668,220,448,0,0,0,1.0,1,1.0,1,1.0,1,0.10493292785296489,35
299,0,668,220,448,0,0,0,1.0,1,1.0,1,1.0,1,0.14203114510321047,35
300,1,669,221,448,0,0,0,1.0,1,1.0,1,1.0,1,0.16042089837090934,35
301,6,675,221,454,0,0,0,1.0,1,1.0,1,1.0,1,0.12534740000184252,38
302,3,678,222,456,0,0,0,1.0,1,1.0,1,1.0,1,0.13548620746886192,38
303,3,681,224,457,0,0,0,1.0,1,1.0,1,1.0,1,0.15484065588766874,37
304,3,684,225,459,0,0,0,1.0,1,1.0,1,1.0,1,0.19808223704681022,37
305,4,688,227,461,0,0,0,1.0,1,1.0,1,1.0,1,0.24499244912932278,36
306,5,693,228,465,0,0,0,1.0,1,1.0,1,1.0,1,0.2161556242242854,36
307,1,694,228,466,0,0,0,1.0,1,1.0,1,1.0,1,0.19296033637718696,35
308,1,695,228,467,0,0,0,1.0,1,1.0,1,1.0,1,0.18049998426221725,37
309,2,697,228,469,0,0,0,1.0,1,1.0,1,1.0,1,0.18049998426221725,37
310,1,698,228,470,0,0,0,1.0,1,1.0,1,1.0,1,0.19252396740073968,37
311,3,701,228,473,0,0,0,1.0,1,1.0,1,1.0,1,0.14622633189252396,39
312,2,703,229,474,0,0,0,1.0,1,1.0,1,1.0,1,0.15058879138495435,40
313,0,703,229,474,0,0,0,1.0,1,1.0,1,1.0,1,0.14940175932184616,39
314,1,704,230,474,0,0,0,1.0,1,1.0,1,1.0,1,0.1974900949660025,40
315,1,705,230,475,0,0,0,1.0,1,1.0,1,1.0,1,0.143676676141904,39
316,0,705,230,475,0,0,0,1.0,1,1.0,1,1.0,1,0.143676676141904,39
317,2,707,230,477,0,0,0,1.0,1,1.0,1,1.0,1,0.15702455225639406,40
318,0,707,230,477,0,0,0,1.0,1,1.0,1,1.0,1,0.16028645112224196,41
319,0,707,230,477,0,0,0,1.0,1,1.0,1,1.0,1,0.20270136832676186,41
320,0,707,230,477,0,0,0,1.0,1,1.0,1,1.0,1,0.21653235859849077,41
321,4,711,230,481,0,0,0,1.0,1,1.0,1,1.0,1,0.15293179315667793,41
322,2,713,232,481,0,0,0,1.0,1,1.0,1,1.0,1,0.15422530491092346,41
323,2,715,232,483,0,0,0,1.0,1,1.0,1,1.0,1,0.15422530491092346,41
324,4,719,234,485,0,0,0,1.0,1,1.0,1,1.0,1,0.14993368508863267,42
325,4,723,235,488,0,0,0,1.0,1,1.0,1,1.0,1,0.16448327631917578,42
326,5,728,236,492,0,0,0,1.0,1,1.0,1,1.0,1,0.08675149243274409,42
327,0,728,236,492,0,0,0,1.0,1,1.0,1,1.0,1,0.08675149243274409,42
328,0,728,236,492,0,0,0,1.0,1,1.0,1,1.0,1,0.08536270130246383,43
329,0,728,236,492,0,0,0,1.0,1,1.0,1,1.0,1,0.08536270130246383,43
330,2,730,237,493,0,0,0,1.0,1,1.0,1,1.0,1,0.0926190302516722,45
331,2,732,237,495,0,0,0,1.0,1,1.0,1,1.0,1,0.06449492246638601,45
332,0,732,237,495,0,0,0,1.0,1,1.0,1,1.0,1,0.06894283456153154,45
333,3,735,238,497,0,0,0,1.0,1,1.0,1,1.0,1,0.08584796686508683,46
334,1,736,238,498,0,0,0,1.0,1,1.0,1,1.0,1,0.09886753308392782,48
335,1,737,238,499,0,0,0,1.0,1,1.0,1,1.0,1,0.081451102772763,48
336,2,739,239,500,0,0,0,1.0,1,1.0,1,1.0,1,0.05994659374357977,48
337,0,739,239,500,0,0,0,1.0,1,1.0,1,1.0,1,0.07791296547711707,49
338,0,739,239,500,0,0,0,1.0,1,1.0,1,1.0,1,0.08451370932774424,50
339,0,739,239,500,0,0,0,1.0,1,1.0,1,1.0,1,0.08451370932774424,50
340,0,739,239,500,0,0,0,1.0,1,1.0,1,1.0,1,0.08451370932774424,50
341,1,740,239,501,0,0,0,1.0,1,1.0,1,1.0,1,0.07317558223424778,51
342,3,743,240,503,0,0,0,1.0,1,1.0,1,1.0,1,0.09325130246491442,51
343,1,744,241,503,0,0,0,1.0,1,1.0,1,1.0,1,0.08100023318296481,51
344,0,744,241,503,0,0,0,1.0,1,1.0,1,1.0,1,0.0871255019819365,50
345,1,745,242,503,0,0,0,1.0,1,1.0,1,1.0,1,0.10072038160208925,51
346,4,749,243,506,0,0,0,1.0,1,1.0,1,1.0,1,0.0845997403114336,51
347,2,751,245,506,0,0,0,1.0,1,1.0,1,1.0,1,0.0978422504076585,51
348,3,754,247,507,0,0,0,1.0,1,1.0,1,1.0,1,0.12748290690774786,53
349,3,757,248,509,0,0,0,1.0,1,1.0,1,1.0,1,0.1138128528477434,55
350,0,757,248,509,0,0,0,1.0,1,1.0,1,1.0,1,0.125757857377931,54
351,5,762,249,513,0,0,0,1.0,1,1.0,1,1.0,1,0.10697200861493364,54
352,2,764,250,514,0,0,0,1.0,1,1.0,1,1.0,1,0.09330935535984604,53
353,3,767,252,515,0,0,0,1.0,1,1.0,1,1.0,1,0.12797278018705283,53
354,0,767,252,515,0,0,0,1.0,1,1.0,1,1.0,1,0.14087390212664633,50
355,1,768,252,516,0,0,0,1.0,1,1.0,1,1.0,1,0.15229890561956513,51
356,3,771,252,519,0,0,0,1.0,1,1.0,1,1.0,1,0.16094823976282885,51
357,4,775,255,520,0,0,0,1.0,1,1.0,1,1.0,1,0.15897109441391957,50
358,4,779,256,523,0,0,0,1.0,1,1.0,1,1.0,1,0.14122764961893502,48
359,1,780,256,524,0,0,0,1.0,1,1.0,1,1.0,1,0.11578048927542293,47
360,0,780,256,524,0,0,0,1.0,1,1.0,1,1.0,1,0.14054537037735762,45
361,1,781,257,524,0,0,0,1.0,1,1.0,1,1.0,1,0.14118528111964182,44
362,1,782,257,525,0,0,0,1.0,1,1.0,1,1.0,1,0.15408217452192163,44
363,3,785,258,527,0,0,0,1.0,1,1.0,1,1.0,1,0.1366155446403238,44
364,1,786,258,528,0,0,0,1.0,1,1.0,1,1.0,1,0.13900496208211138,43
365,0,786,258,528,0,0,0,1.0,1,1.0,1,1.0,1,0.13900496208211138,43
366,3,789,259,530,0,0,0,1.0,1,1.0,1,1.0,1,0.10979357927416071,45
367,1,790,260,530,0,0,0,1.0,1,1.0,1,1.0,1,0.14801823072472087,44
368,2,792,261,531,0,0,0,1.0,1,1.0,1,1.0,1,0.14745064013312137,46
369,2,794,261,533,0,0,0,1.0,1,1.0,1,1.0,1,0.17323339211341135,45
370,2,796,262,534,0,0,0,1.0,1,1.0,1,1.0,1,0.18928739815896922,46
371,6,802,262,540,0,0,0,1.0,1,1.0,1,1.0,1,0.15558955333891483,47
372,1,803,262,541,0,0,0,1.0,1,1.0,1,1.0,1,0.13774181004828825,48
373,1,804,263,541,0,0,0,1.0,1,1.0,1,1.0,1,0.1368209810312955,48
374,2,806,264,542,0,0,0,1.0,1,1.0,1,1.0,1,0.1446656258405891,49
375,3,809,264,545,0,0,0,1.0,1,1.0,1,1.0,1,0.11230633733678624,49
376,3,812,266,546,0,0,0,1.0,1,1.0,1,1.0,1,0.12101506904093391,49
377,2,814,267,547,0,0,0,1.0,1,1.0,1,1.0,1,0.12626933016692904,49
378,1,815,268,547,0,0,0,1.0,1,1.0,1,1.0,1,0.12250047649861105,49
379,0,815,268,547,0,0,0,1.0,1,1.0,1,1.0,1,0.12505727886354218,50
380,2,817,270,547,0,0,0,1.0,1,1.0,1,1.0,1,0.16649209488865263,50
381,6,823,272,551,0,0,0,1.0,1,1.0,1,1.0,1,0.11902810804917775,51
382,1,824,272,552,0,0,0,1.0,1,1.0,1,1.0,1,0.11471477204869657,50
383,2,826,274,552,0,0,0,1.0,1,1.0,1,1.0,1,0.17046442291342667,51
384,4,830,276,554,0,0,0,1.0,1,1.0,1,1.0,1,0.17611996535072036,50
385,4,834,277,557,0,0,0,1.0,1,1.0,1,1.0,1,0.15759169569158255,50
386,1,835,277,558,0,0,0,1.0,1,1.0,1,1.0,1,0.12180768902307243,48
387,1,836,277,559,0,0,0,1.0,1,1.0,1,1.0,1,0.11518127415286826,47
388,3,839,278,561,0,0,0,1.0,1,1.0,1,1.0,1,0.0824495321123443,48
389,1,840,279,561,0,0,0,1.0,1,1.0,1,1.0,1,0.09740720234073232,47
390,6,846,281,565,0,0,0,1.0,1,1.0,1,1.0,1,0.09068245786080643,49
391,4,850,284,566,0,0,0,1.0,1,1.0,1,1.0,1,0.10096739303218741,46
392,1,851,285,566,0,0,0,1.0,1,1.0,1,1.0,1,0.1324913607770284,46
393,2,853,287,566,0,0,0,1.0,1,1.0,1,1.0,1,0.18619439381568692,44
394,0,853,287,566,0,0,0,1.0,1,1.0,1,1.0,1,0.17492155187324498,43
395,1,854,288,566,0,0,0,1.0,1,1.0,1,1.0,1,0.19342133684265603,42
396,3,857,289,568,0,0,0,1.0,1,1.0,1,1.0,1,0.19559591394315787,39
397,5,862,291,571,0,0,0,1.0,1,1.0,1,1.0,1,0.2198761593440973,39
398,0,862,291,571,0,0,0,1.0,1,1.0,1,1.0,1,0.22836150464685603,36
399,1,863,291,572,0,0,0,1.0,1,1.0,1,1.0,1,0.1847012565718844,36
400,2,865,293,572,0,0,0,1.0,1,1.0,1,1.0,1,0.22215646366576666,34
401,4,869,294,575,0,0,0,1.0,1,1.0,1,1.0,1,0.13051722902991744,33
402,0,869,294,575,0,0,0,1.0,1,1.0,1,1.0,1,0.14173744759272283,34
403,0,869,294,575,0,0,0,1.0,1,1.0,1,1.0,1,0.13181875263771392,36
404,2,871,296,575,0,0,0,1.0,1,1.0,1,1.0,1,0.15621231158319068,36
405,2,873,297,576,0,0,0,1.0,1,1.0,1,1.0,1,0.1718010169830689,37
406,1,874,297,577,0,0,0,1.0,1,1.0,1,1.0,1,0.14989543233238703,37
407,3,877,299,578,0,0,0,1.0,1,1.0,1,1.0,1,0.1873673196419417,39
408,4,881,301,580,0,0,0,1.0,1,1.0,1,1.0,1,0.21926317234578638,40
409,4,885,303,582,0,0,0,1.0,1,1.0,1,1.0,1,0.2720920968319116,41
410,5,890,305,585,0,0,0,1.0,1,1.0,1,1.0,1,0.3183119529536516,42
411,5,895,305,590,0,0,0,1.0,1,1.0,1,1.0,1,0.21767138272367328,43
412,2,897,307,590,0,0,0,1.0,1,1.0,1,1.0,1,0.2547934159209961,44
413,0,897,307,590,0,0,0,1.0,1,1.0,1,1.0,1,0.2547934159209961,44
414,2,899,307,592,0,0,0,1.0,1,1.0,1,1.0,1,0.22960412386331178,45
415,2,901,307,594,0,0,0,1.0,1,1.0,1,1.0,1,0.20946752152677853,45
416,0,901,307,594,0,0,0,1.0,1,1.0,1,1.0,1,0.213849878089165,46
417,0,901,307,594,0,0,0,1.0,1,1.0,1,1.0,1,0.213849878089165,46
418,0,901,307,594,0,0,0,1.0,1,1.0,1,1.0,1,0.20293918384238396,47
419,0,901,307,594,0,0,0,1.0,1,1.0,1,1.0,1,0.20293918384238396,47
420,0,901,307,594,0,0,0,1.0,1,1.0,1,1.0,1,0.20293918384238396,47
421,0,901,307,594,0,0,0,1.0,1,1.0,1,1.0,1,0.20293918384238396,47
422,3,904,308,596,0,0,0,1.0,1,1.0,1,1.0,1,0.1887958411959578,49
423,1,905,308,597,0,0,0,1.0,1,1.0,1,1.0,1,0.16366616347948387,47
424,4,909,311,598,0,0,0,1.0,1,1.0,1,1.0,1,0.1842392977315079,45
425,3,912,312,600,0,0,0,1.0,1,1.0,1,1.0,1,0.18898872543194978,46
426,5,917,313,604,0,0,0,1.0,1,1.0,1,1.0,1,0.11624763946407789,46
427,4,921,314,607,0,0,0,1.0,1,1.0,1,1.0,1,0.10495074433950792,45
428,2,923,314,609,0,0,0,1.0,1,1.0,1,1.0,1,0.09932772812048914,45
429,4,927,317,610,0,0,0,1.0,1,1.0,1,1.0,1,0.20254723808225816,42
430,2,929,317,612,0,0,0,1.0,1,1.0,1,1.0,1,0.19165558771080712,40
431,10,939,320,619,0,0,0,1.0,1,1.0,1,1.0,1,0.07871079822638062,39
432,3,942,322,620,0,0,0,1.0,1,1.0,1,1.0,1,0.10882278618872256,37
433,1,943,323,620,0,0,0,1.0,1,1.0,1,1.0,1,0.1511549204059578,35
434,3,946,323,623,0,0,0,1.0,1,1.0,1,1.0,1,0.14658459240641886,33
435,1,947,323,624,0,0,0,1.0,1,1.0,1,1.0,1,0.15183992469507232,33
436,2,949,323,626,0,0,0,1.0,1,1.0,1,1.0,1,0.0964806618775252,33
437,0,949,323,626,0,0,0,1.0,1,1.0,1,1.0,1,0.11040600597984815,33
438,0,949,323,626,0,0,0,1.0,1,1.0,1,1.0,1,0.09379287876151005,32
439,2,951,324,627,0,0,0,1.0,1,1.0,1,1.0,1,0.15921610720792878,34
440,5,956,325,631,0,0,0,1.0,1,1.0,1,1.0,1,0.17832368442368163,34
441,3,959,326,633,0,0,0,1.0,1,1.0,1,1.0,1,0.17796041293369175,35
442,6,965,328,637,0,0,0,1.0,1,1.0,1,1.0,1,0.14105680121051617,37
443,5,970,331,639,0,0,0,1.0,1,1.0,1,1.0,1,0.20082771626745324,37
444,4,974,332,642,0,0,0,1.0,1,1.0,1,1.0,1,0.14271659642841653,38
445,4,978,333,645,0,0,0,1.0,1,1.0,1,1.0,1,0.16197259486322194,39
446,2,980,333,647,0,0,0,1.0,1,1.0,1,1.0,1,0.11303854800887969,39
447,2,982,334,648,0,0,0,1.0,1,1.0,1,1.0,1,0.1350830796076957,41
448,1,983,334,649,0,0,0,1.0,1,1.0,1,1.0,1,0.12793919345769048,41
449,1,984,335,649,0,0,0,1.0,1,1.0,1,1.0,1,0.16343831403288517,40
450,1,985,335,650,0,0,0,1.0,1,1.0,1,1.0,1,0.17356316659813692,40
451,1,986,335,651,0,0,0,1.0,1,1.0,1,1.0,1,0.17956918776651234,41
452,1,987,335,652,0,0,0,1.0,1,1.0,1,1.0,1,0.1647321111936271,41
453,0,987,335,652,0,0,0,1.0,1,1.0,1,1.0,1,0.1930158148142497,40
454,1,988,335,653,0,0,0,1.0,1,1.0,1,1.0,1,0.1780820541174267,41
455,3,991,336,655,0,0,0,1.0,1,1.0,1,1.0,1,0.17723620533833492,41
456,3,994,336,658,0,0,0,1.0,1,1.0,1,1.0,1,0.14724157631695442,43
457,2,996,337,659,0,0,0,1.0,1,1.0,1,1.0,1,0.11160319530091763,43
458,0,996,337,659,0,0,0,1.0,1,1.0,1,1.0,1,0.11160319530091763,43
459,0,996,337,659,0,0,0,1.0,1,1.0,1,1.0,1,0.0899014405244167,44
460,1,997,337,660,0,0,0,1.0,1,1.0,1,1.0,1,0.10797194907509566,47
461,1,998,338,660,0,0,0,1.0,1,1.0,1,1.0,1,0.12251527203732558,48
462,3,1001,340,661,0,0,0,1.0,1,1.0,1,1.0,1,0.1505578679974902,49
463,0,1001,340,661,0,0,0,1.0,1,1.0,1,1.0,1,0.13370045576049613,47
464,5,1006,342,664,0,0,0,1.0,1,1.0,1,1.0,1,0.09507470980654845,48
465,4,1010,344,666,0,0,0,1.0,1,1.0,1,1.0,1,0.11694087237835311,47
466,5,1015,347,668,0,0,0,1.0,1,1.0,1,1.0,1,0.115934657617497,46
467,2,1017,348,669,0,0,0,1.0,1,1.0,1,1.0,1,0.10788422243021348,44
468,5,1022,353,669,0,0,0,1.0,1,1.0,1,1.0,1,0.2044133071444233,41
469,2,1024,355,669,0,0,0,1.0,1,1.0,1,1.0,1,0.13930445136836597,40
470,2,1026,356,670,0,0,0,1.0,1,1.0,1,1.0,1,0.18727549690589454,39
471,4,1030,358,672,0,0,0,1.0,1,1.0,1,1.0,1,0.14789728568901414,38
472,4,1034,361,673,0,0,0,1.0,1,1.0,1,1.0,1,0.2445489910568634,36
473,3,1037,362,675,0,0,0,1.0,1,1.0,1,1.0,1,0.19265444645117666,36
474,1,1038,363,675,0,0,0,1.0,1,1.0,1,1.0,1,0.1923880373193972,34
475,3,1041,365,676,0,0,0,1.0,1,1.0,1,1.0,1,0.24661788864047482,34
476,1,1042,365,677,0,0,0,1.0,1,1.0,1,1.0,1,0.17702241307349234,32
477,2,1044,366,678,0,0,0,1.0,1,1.0,1,1.0,1,0.22256901282981598,32
478,0,1044,366,678,0,0,0,1.0,1,1.0,1,1.0,1,0.21932996690688228,30
479,1,1045,366,679,0,0,0,1.0,1,1.0,1,1.0,1,0.20717796247517858,31
480,0,1045,366,679,0,0,0,1.0,1,1.0,1,1.0,1,0.31994348534068184,27
481,4,1049,367,682,0,0,0,1.0,1,1.0,1,1.0,1,0.2350873547689858,28
482,0,1049,367,682,0,0,0,1.0,1,1.0,1,1.0,1,0.24332414164184413,28
483,2,1051,368,683,0,0,0,1.0,1,1.0,1,1.0,1,0.18886530268483473,29
484,0,1051,368,683,0,0,0,1.0,1,1.0,1,1.0,1,0.18886530268483473,29
485,3,1054,368,686,0,0,0,1.0,1,1.0,1,1.0,1,0.203221813800138,29
486,4,1058,368,690,0,0,0,1.0,1,1.0,1,1.0,1,0.11557194582432573,31
487,2,1060,368,692,0,0,0,1.0,1,1.0,1,1.0,1,0.07275352480513639,33
488,1,1061,368,693,0,0,0,1.0,1,1.0,1,1.0,1,0.09891979416778739,34
489,3,1064,370,694,0,0,0,1.0,1,1.0,1,1.0,1,0.17737756845475572,34
490,1,1065,370,695,0,0,0,1.0,1,1.0,1,1.0,1,0.1716294636503347,34
491,2,1067,371,696,0,0,0,1.0,1,1.0,1,1.0,1,0.17586568178222467,34
492,2,1069,371,698,0,0,0,1.0,1,1.0,1,1.0,1,0.1307542665714018,34
493,1,1070,372,698,0,0,0,1.0,1,1.0,1,1.0,1,0.17653821732572506,34
494,1,1071,373,698,0,0,0,1.0,1,1.0,1,1.0,1,0.197308143338038,36
495,2,1073,373,700,0,0,0,1.0,1,1.0,1,1.0,1,0.17529446175221827,36
496,1,1074,373,701,0,0,0,1.0,1,1.0,1,1.0,1,0.1697720899445041,37
497,2,1076,373,703,0,0,0,1.0,1,1.0,1,1.0,1,0.13411260981699405,39
498,1,1077,373,704,0,0,0,1.0,1,1.0,1,1.0,1,0.15134094195724024,40
499,2,1079,374,705,0,0,0,1.0,1,1.0,1,1.0,1,0.16176792335782905,40
500,9,1088,376,712,0,0,0,1.0,1,1.0,1,1.0,1,0.20259480151454512,42
501,7,1095,376,719,0,0,0,1.0,1,1.0,1,1.0,1,0.0746699620105175,42
502,4,1099,378,721,0,0,0,1.0,1,1.0,1,1.0,1,0.18347640404156662,42
503,1,1100,378,722,0,0,0,1.0,1,1.0,1,1.0,1,0.17195429560569875,41
504,1,1101,379,722,0,0,0,1.0,1,1.0,1,1.0,1,0.19303491442590123,42
505,3,1104,380,724,0,0,0,1.0,1,1.0,1,1.0,1,0.20912832201581696,38
506,4,1108,380,728,0,0,0,1.0,1,1.0,1,1.0,1,0.11367043000151139,37
507,2,1110,380,730,0,0,0,1.0,1,1.0,1,1.0,1,0.1017682458571905,35
508,4,1114,383,731,0,0,0,1.0,1,1.0,1,1.0,1,0.17191415434314328,35
509,2,1116,383,733,0,0,0,1.0,1,1.0,1,1.0,1,0.21101415057584397,34
510,4,1120,384,736,0,0,0,1.0,1,1.0,1,1.0,1,0.22758540425460796,34
511,3,1123,385,738,0,0,0,1.0,1,1.0,1,1.0,1,0.17371158973944492,32
512,0,1123,385,738,0,0,0,1.0,1,1.0,1,1.0,1,0.2239456221100642,30
513,2,1125,385,740,0,0,0,1.0,1,1.0,1,1.0,1,0.21580794953039933,31
514,1,1126,385,741,0,0,0,1.0,1,1.0,1,1.0,1,0.204021403543031,31
515,4,1130,386,744,0,0,0,1.0,1,1.0,1,1.0,1,0.19282402940181426,32
516,0,1130,386,744,0,0,0,1.0,1,1.0,1,1.0,1,0.1736520628620455,31
517,2,1132,387,745,0,0,0,1.0,1,1.0,1,1.0,1,0.1267070175528351,32
518,1,1133,388,745,0,0,0,1.0,1,1.0,1,1.0,1,0.14485931775151673,31
519,2,1135,389,746,0,0,0,1.0,1,1.0,1,1.0,1,0.13420875232651835,31
520,3,1138,392,746,0,0,0,1.0,1,1.0,1,1.0,1,0.11351939588144712,33
521,0,1138,392,746,0,0,0,1.0,1,1.0,1,1.0,1,0.13568520513827298,34
522,3,1141,394,747,0,0,0,1.0,1,1.0,1,1.0,1,0.11569827369369026,34
523,0,1141,394,747,0,0,0,1.0,1,1.0,1,1.0,1,0.10157044085814168,33
524,0,1141,394,747,0,0,0,1.0,1,1.0,1,1.0,1,0.11747988088069414,34
525,0,1141,394,747,0,0,0,1.0,1,1.0,1,1.0,1,0.14267354723645886,32
526,0,1141,394,747,0,0,0,1.0,1,1.0,1,1.0,1,0.14267354723645886,32
527,2,1143,394,749,0,0,0,1.0,1,1.0,1,1.0,1,0.13607079710057454,31
528,1,1144,395,749,0,0,0,1.0,1,1.0,1,1.0,1,0.13588887954592685,31
529,0,1144,395,749,0,0,0,1.0,1,1.0,1,1.0,1,0.15394123432958537,30
530,1,1145,396,749,0,0,0,1.0,1,1.0,1,1.0,1,0.20873598192782172,30
531,1,1146,396,750,0,0,0,1.0,1,1.0,1,1.0,1,0.2020187545377998,32
532,6,1152,399,753,0,0,0,1.0,1,1.0,1,1.0,1,0.19802910443672198,32
533,0,1152,399,753,0,0,0,1.0,1,1.0,1,1.0,1,0.1957636395006939,34
534,1,1153,400,753,0,0,0,1.0,1,1.0,1,1.0,1,0.21125638287693332,34
535,5,1158,401,757,0,0,0,1.0,1,1.0,1,1.0,1,0.2646952362219267,37
536,3,1161,401,760,0,0,0,1.0,1,1.0,1,1.0,1,0.22536380554681387,37
537,1,1162,402,760,0,0,0,1.0,1,1.0,1,1.0,1,0.244054704660358,37
538,1,1163,402,761,0,0,0,1.0,1,1.0,1,1.0,1,0.22513185824493837,38
539,0,1163,402,761,0,0,0,1.0,1,1.0,1,1.0,1,0.22513185824493837,38
540,0,1163,402,761,0,0,0,1.0,1,1.0,1,1.0,1,0.22513185824493837,38
541,1,1164,402,762,0,0,0,1.0,1,1.0,1,1.0,1,0.1800593128224052,39
542,1,1165,403,762,0,0,0,1.0,1,1.0,1,1.0,1,0.19353474072768329,40
543,1,1166,404,762,0,0,0,1.0,1,1.0,1,1.0,1,0.19454399617001544,37
544,4,1170,406,764,0,0,0,1.0,1,1.0,1,1.0,1,0.22583086896597235,35
545,1,1171,407,764,0,0,0,1.0,1,1.0,1,1.0,1,0.18238166052755111,35
546,7,1178,411,767,0,0,0,1.0,1,1.0,1,1.0,1,0.1502715225212138,35
547,2,1180,413,767,0,0,0,1.0,1,1.0,1,1.0,1,0.16650509761999033,34
548,3,1183,414,769,0,0,0,1.0,1,1.0,1,1.0,1,0.14697644180277877,34
549,2,1185,416,769,0,0,0,1.0,1,1.0,1,1.0,1,0.2112582349249964,31
550,1,1186,416,770,0,0,0,1.0,1,1.0,1,1.0,1,0.16267166016733658,30
551,2,1188,418,770,0,0,0,1.0,1,1.0,1,1.0,1,0.21782078966211063,31
552,1,1189,418,771,0,0,0,1.0,1,1.0,1,1.0,1,0.15725339320699508,29
553,1,1190,419,771,0,0,0,1.0,1,1.0,1,1.0,1,0.19844980534851872,30
554,3,1193,420,773,0,0,0,1.0,1,1.0,1,1.0,1,0.175274153306836,30
555,2,1195,420,775,0,0,0,1.0,1,1.0,1,1.0,1,0.12260889113899734,30
556,1,1196,420,776,0,0,0,1.0,1,1.0,1,1.0,1,0.11255127696600442,31
557,0,1196,420,776,0,0,0,1.0,1,1.0,1,1.0,1,0.16388225861729408,31
558,1,1197,420,777,0,0,0,1.0,1,1.0,1,1.0,1,0.11798532791227354,31
559,1,1198,420,778,0,0,0,1.0,1,1.0,1,1.0,1,0.11632755838869961,31
560,1,1199,420,779,0,0,0,1.0,1,1.0,1,1.0,1,0.11315087311910565,32
561,1,1200,421,779,0,0,0,1.0,1,1.0,1,1.0,1,0.11757162248646955,33
562,1,1201,421,780,0,0,0,1.0,1,1.0,1,1.0,1,0.1069123278273881,33
563,1,1202,422,780,0,0,0,1.0,1,1.0,1,1.0,1,0.15655394859136393,33
564,5,1207,423,784,0,0,0,1.0,1,1.0,1,1.0,1,0.1728716406058186,34
565,5,1212,424,788,0,0,0,1.0,1,1.0,1,1.0,1,0.1567516706619643,35
566,3,1215,424,791,0,0,0,1.0,1,1.0,1,1.0,1,0.10786287851174904,36
567,2,1217,426,791,0,0,0,1.0,1,1.0,1,1.0,1,0.14117265598932296,37
568,0,1217,426,791,0,0,0,1.0,1,1.0,1,1.0,1,0.16817655957743244,36
569,2,1219,427,792,0,0,0,1.0,1,1.0,1,1.0,1,0.1660898040904592,37
570,1,1220,428,792,0,0,0,1.0,1,1.0,1,1.0,1,0.1524600015666089,38
571,0,1220,428,792,0,0,0,1.0,1,1.0,1,1.0,1,0.1524600015666089,38
572,0,1220,428,792,0,0,0,1.0,1,1.0,1,1.0,1,0.16633741542259803,39
573,0,1220,428,792,0,0,0,1.0,1,1.0,1,1.0,1,0.16633741542259803,39
574,2,1222,428,794,0,0,0,1.0,1,1.0,1,1.0,1,0.16356612639784415,41
575,1,1223,428,795,0,0,0,1.0,1,1.0,1,1.0,1,0.15359161838015098,41
576,4,1227,428,799,0,0,0,1.0,1,1.0,1,1.0,1,0.11701999476807863,42
577,0,1227,428,799,0,0,0,1.0,1,1.0,1,1.0,1,0.11701999476807863,42
578,0,1227,428,799,0,0,0,1.0,1,1.0,1,1.0,1,0.13286788982895809,41
579,0,1227,428,799,0,0,0,1.0,1,1.0,1,1.0,1,0.12277414199389734,42
580,1,1228,429,799,0,0,0,1.0,1,1.0,1,1.0,1,0.17542974004256223,43
581,8,1236,433,803,0,0,0,1.0,1,1.0,1,1.0,1,0.1375897730702398,42
582,2,1238,434,804,0,0,0,1.0,1,1.0,1,1.0,1,0.16860133791408569,41
583,3,1241,435,806,0,0,0,1.0,1,1.0,1,1.0,1,0.12661093847425076,40
584,9,1250,439,811,0,0,0,1.0,1,1.0,1,1.0,1,0.15567447589093336,38
585,5,1255,441,814,0,0,0,1.0,1,1.0,1,1.0,1,0.14368791348519572,38
586,5,1260,442,818,0,0,0,1.0,1,1.0,1,1.0,1,0.11501399714700451,37
587,2,1262,443,819,0,0,0,1.0,1,1.0,1,1.0,1,0.1465464476441584,35
588,2,1264,445,819,0,0,0,1.0,1,1.0,1,1.0,1,0.14042431469497585,35
589,1,1265,445,820,0,0,0,1.0,1,1.0,1,1.0,1,0.13399575183028598,34
590,1,1266,445,821,0,0,0,1.0,1,1.0,1,1.0,1,0.11905109415079564,36
591,5,1271,448,823,0,0,0,1.0,1,1.0,1,1.0,1,0.0969969115682559,35
592,2,1273,448,825,0,0,0,1.0,1,1.0,1,1.0,1,0.11663818795478527,37
593,2,1275,448,827,0,0,0,1.0,1,1.0,1,1.0,1,0.1207303867237994,36
594,3,1278,450,828,0,0,0,1.0,1,1.0,1,1.0,1,0.19118550983370125,35
595,1,1279,450,829,0,0,0,1.0,1,1.0,1,1.0,1,0.19796523593377616,34
596,3,1282,450,832,0,0,0,1.0,1,1.0,1,1.0,1,0.1441333036022301,34
597,4,1286,453,833,0,0,0,1.0,1,1.0,1,1.0,1,0.19443490940515032,33
598,1,1287,453,834,0,0,0,1.0,1,1.0,1,1.0,1,0.219947244747093,33
599,0,1287,453,834,0,0,0,1.0,1,1.0,1,1.0,1,0.219947244747093,33
600,2,1289,454,835,0,0,0,1.0,1,1.0,1,1.0,1,0.2175525806679032,33
601,2,1291,455,836,0,0,0,1.0,1,1.0,1,1.0,1,0.17715387868485663,34
602,2,1293,455,838,0,0,0,1.0,1,1.0,1,1.0,1,0.1751646376856196,35
603,3,1296,455,841,0,0,0,1.0,1,1.0,1,1.0,1,0.14396302524363588,35
604,0,1296,455,841,0,0,0,1.0,1,1.0,1,1.0,1,0.14680057930053222,35
605,1,1297,455,842,0,0,0,1.0,1,1.0,1,1.0,1,0.13325406900655273,35
606,2,1299,455,844,0,0,0,1.0,1,1.0,1,1.0,1,0.12001082902351673,35
607,1,1300,456,844,0,0,0,1.0,1,1.0,1,1.0,1,0.15245161894720827,35
608,1,1301,456,845,0,0,0,1.0,1,1.0,1,1.0,1,0.15119868999611172,36
609,2,1303,456,847,0,0,0,1.0,1,1.0,1,1.0,1,0.15041335551093488,37
610,2,1305,456,849,0,0,0,1.0,1,1.0,1,1.0,1,0.11155409150467198,37
611,1,1306,456,850,0,0,0,1.0,1,1.0,1,1.0,1,0.09979554177823584,39
612,1,1307,457,850,0,0,0,1.0,1,1.0,1,1.0,1,0.12144533156606672,39
613,3,1310,459,851,0,0,0,1.0,1,1.0,1,1.0,1,0.11180668996242239,39
614,1,1311,460,851,0,0,0,1.0,1,1.0,1,1.0,1,0.15209612519500249,39
615,0,1311,460,851,0,0,0,1.0,1,1.0,1,1.0,1,0.15209612519500249,39
616,5,1316,461,855,0,0,0,1.0,1,1.0,1,1.0,1,0.1312754106735422,38
617,4,1320,464,856,0,0,0,1.0,1,1.0,1,1.0,1,0.08272964072145408,39
618,0,1320,464,856,0,0,0,1.0,1,1.0,1,1.0,1,0.08596077103476626,40
619,1,1321,464,857,0,0,0,1.0,1,1.0,1,1.0,1,0.09178722912286237,39
620,0,1321,464,857,0,0,0,1.0,1,1.0,1,1.0,1,0.1093034366616065,38
621,3,1324,465,859,0,0,0,1.0,1,1.0,1,1.0,1,0.09412858809900558,38
622,3,1327,468,859,0,0,0,1.0,1,1.0,1,1.0,1,0.16727087069363217,38
623,3,1330,470,860,0,0,0,1.0,1,1.0,1,1.0,1,0.15424832152269552,37
624,2,1332,471,861,0,0,0,1.0,1,1.0,1,1.0,1,0.16385461535506268,33
625,1,1333,472,861,0,0,0,1.0,1,1.0,1,1.0,1,0.14650754029457774,32
626,6,1339,477,862,0,0,0,1.0,1,1.0,1,1.0,1,0.23141119189319614,31
627,1,1340,477,863,0,0,0,1.0,1,1.0,1,1.0,1,0.16860957979810803,30
628,4,1344,479,865,0,0,0,1.0,1,1.0,1,1.0,1,0.18147472771433834,32
629,3,1347,480,867,0,0,0,1.0,1,1.0,1,1.0,1,0.17855485245911068,29
630,2,1349,480,869,0,0,0,1.0,1,1.0,1,1.0,1,0.17873914541711147,29
631,1,1350,481,869,0,0,0,1.0,1,1.0,1,1.0,1,0.2241248372059872,25
632,0,1350,481,869,0,0,0,1.0,1,1.0,1,1.0,1,0.24824544246364763,24
633,2,1352,482,870,0,0,0,1.0,1,1.0,1,1.0,1,0.2546012545837567,23
634,0,1352,482,870,0,0,0,1.0,1,1.0,1,1.0,1,0.2546012545837567,23
635,3,1355,483,872,0,0,0,1.0,1,1.0,1,1.0,1,0.27848900594771275,22
636,2,1357,483,874,0,0,0,1.0,1,1.0,1,1.0,1,0.24104999386068635,22
637,2,1359,484,875,0,0,0,1.0,1,1.0,1,1.0,1,0.1729158115762274,23
638,0,1359,484,875,0,0,0,1.0,1,1.0,1,1.0,1,0.1729158115762274,23
639,2,1361,484,877,0,0,0,1.0,1,1.0,1,1.0,1,0.1875429316199462,24
640,2,1363,485,878,0,0,0,1.0,1,1.0,1,1.0,1,0.18033789518257537,24
641,1,1364,485,879,0,0,0,1.0,1,1.0,1,1.0,1,0.17690123963671198,25
642,0,1364,485,879,0,0,0,1.0,1,1.0,1,1.0,1,0.1357099364419223,26
643,0,1364,485,879,0,0,0,1.0,1,1.0,1,1.0,1,0.1379311295813292,28
644,3,1367,487,880,0,0,0,1.0,1,1.0,1,1.0,1,0.20739459908971103,28
645,2,1369,487,882,0,0,0,1.0,1,1.0,1,1.0,1,0.25147822635047773,28
646,3,1372,487,885,0,0,0,1.0,1,1.0,1,1.0,1,0.15946141934888128,29
647,2,1374,488,886,0,0,0,1.0,1,1.0,1,1.0,1,0.18852451526528372,30
648,0,1374,488,886,0,0,0,1.0,1,1.0,1,1.0,1,0.18852451526528372,30
649,3,1377,489,888,0,0,0,1.0,1,1.0,1,1.0,1,0.19210211869901633,31
650,3,1380,489,891,0,0,0,1.0,1,1.0,1,1.0,1,0.18821112168930523,31
651,3,1383,491,892,0,0,0,1.0,1,1.0,1,1.0,1,0.1620147040183035,32
652,1,1384,491,893,0,0,0,1.0,1,1.0,1,1.0,1,0.14917300784646528,32
653,1,1385,491,894,0,0,0,1.0,1,1.0,1,1.0,1,0.13864808407968815,33
654,0,1385,491,894,0,0,0,1.0,1,1.0,1,1.0,1,0.13864808407968815,33
655,4,1389,493,896,0,0,0,1.0,1,1.0,1,1.0,1,0.20806212173140018,36
656,6,1395,495,900,0,0,0,1.0,1,1.0,1,1.0,1,0.13439366498692606,36
657,1,1396,495,901,0,0,0,1.0,1,1.0,1,1.0,1,0.17491023768412084,35
658,2,1398,497,901,0,0,0,1.0,1,1.0,1,1.0,1,0.16818865696088253,33
659,1,1399,498,901,0,0,0,1.0,1,1.0,1,1.0,1,0.15746293304231973,35
660,1,1400,498,902,0,0,0,1.0,1,1.0,1,1.0,1,0.18989032679666437,34
661,1,1401,499,902,0,0,0,1.0,1,1.0,1,1.0,1,0.2291156588458202,33
662,3,1404,501,903,0,0,0,1.0,1,1.0,1,1.0,1,0.27324710976010635,31
663,3,1407,503,904,0,0,0,1.0,1,1.0,1,1.0,1,0.3146190158521129,29
664,3,1410,504,906,0,0,0,1.0,1,1.0,1,1.0,1,0.32369403557818943,27
665,2,1412,504,908,0,0,0,1.0,1,1.0,1,1.0,1,0.20989632551421097,27
666,6,1418,505,913,0,0,0,1.0,1,1.0,1,1.0,1,0.11689444522970018,28
667,2,1420,506,914,0,0,0,1.0,1,1.0,1,1.0,1,0.12248874219261204,26
668,1,1421,507,914,0,0,0,1.0,1,1.0,1,1.0,1,0.14890185607326245,26
669,2,1423,509,914,0,0,0,1.0,1,1.0,1,1.0,1,0.12885726782613593,25
670,0,1423,509,914,0,0,0,1.0,1,1.0,1,1.0,1,0.1616212650998146,24
671,0,1423,509,914,0,0,0,1.0,1,1.0,1,1.0,1,0.1616212650998146,24
672,1,1424,510,914,0,0,0,1.0,1,1.0,1,1.0,1,0.20963660959232164,25
673,3,1427,512,915,0,0,0,1.0,1,1.0,1,1.0,1,0.1999155228412451,25
674,1,1428,513,915,0,0,0,1.0,1,1.0,1,1.0,1,0.17506601932198923,25
675,3,1431,514,917,0,0,0,1.0,1,1.0,1,1.0,1,0.21104156578967173,26
676,3,1434,516,918,0,0,0,1.0,1,1.0,1,1.0,1,0.21428659024662744,27
677,2,1436,516,920,0,0,0,1.0,1,1.0,1,1.0,1,0.18246593604195716,28
678,3,1439,517,922,0,0,0,1.0,1,1.0,1,1.0,1,0.18316021471640623,28
679,2,1441,517,924,0,0,0,1.0,1,1.0,1,1.0,1,0.2234396628414142,30
680,3,1444,517,927,0,0,0,1.0,1,1.0,1,1.0,1,0.22582336654881502,29
681,2,1446,517,929,0,0,0,1.0,1,1.0,1,1.0,1,0.13764395858042824,29
682,0,1446,517,929,0,0,0,1.0,1,1.0,1,1.0,1,0.15429997170584633,30
683,0,1446,517,929,0,0,0,1.0,1,1.0,1,1.0,1,0.15429997170584633,30
684,1,1447,517,930,0,0,0,1.0,1,1.0,1,1.0,1,0.1675021751588878,31
685,0,1447,517,930,0,0,0,1.0,1,1.0,1,1.0,1,0.16433816071255952,30
686,0,1447,517,930,0,0,0,1.0,1,1.0,1,1.0,1,0.16433816071255952,30
687,2,1449,519,930,0,0,0,1.0,1,1.0,1,1.0,1,0.2546761654545064,30
688,2,1451,519,932,0,0,0,1.0,1,1.0,1,1.0,1,0.21260329232550584,31
689,1,1452,520,932,0,0,0,1.0,1,1.0,1,1.0,1,0.27212128117602746,32
690,1,1453,520,933,0,0,0,1.0,1,1.0,1,1.0,1,0.25544080658117485,32
691,3,1456,521,935,0,0,0,1.0,1,1.0,1,1.0,1,0.16279915730303765,32
692,1,1457,521,936,0,0,0,1.0,1,1.0,1,1.0,1,0.13273874488595336,32
693,1,1458,521,937,0,0,0,1.0,1,1.0,1,1.0,1,0.12989283083731523,34
694,3,1461,522,939,0,0,0,1.0,1,1.0,1,1.0,1,0.12432679047721672,36
695,3,1464,525,939,0,0,0,1.0,1,1.0,1,1.0,1,0.20421890200256881,34
696,6,1470,527,943,0,0,0,1.0,1,1.0,1,1.0,1,0.16567358299124335,33
697,2,1472,528,944,0,0,0,1.0,1,1.0,1,1.0,1,0.1667417231985094,33
698,3,1475,528,947,0,0,0,1.0,1,1.0,1,1.0,1,0.1298660043722552,34
699,0,1475,528,947,0,0,0,1.0,1,1.0,1,1.0,1,0.10737321153243921,33
700,0,1475,528,947,0,0,0,1.0,1,1.0,1,1.0,1,0.09279991571885948,32
701,0,1475,528,947,0,0,0,1.0,1,1.0,1,1.0,1,0.1096915563092308,33
702,3,1478,531,947,0,0,0,1.0,1,1.0,1,1.0,1,0.22919769627792358,34
703,2,1480,532,948,0,0,0,1.0,1,1.0,1,1.0,1,0.20944401465026807,32
704,1,1481,532,949,0,0,0,1.0,1,1.0,1,1.0,1,0.14994705356762594,31
705,4,1485,535,950,0,0,0,1.0,1,1.0,1,1.0,1,0.17436246378396364,33
706,4,1489,538,951,0,0,0,1.0,1,1.0,1,1.0,1,0.2556029849428604,33
707,2,1491,539,952,0,0,0,1.0,1,1.0,1,1.0,1,0.17044150508204864,31
708,1,1492,540,952,0,0,0,1.0,1,1.0,1,1.0,1,0.22243689000213782,31
709,1,1493,541,952,0,0,0,1.0,1,1.0,1,1.0,1,0.22669606880012907,30
710,1,1494,542,952,0,0,0,1.0,1,1.0,1,1.0,1,0.2527615927264155,30
711,1,1495,542,953,0,0,0,1.0,1,1.0,1,1.0,1,0.22838753654860297,30
712,1,1496,542,954,0,0,0,1.0,1,1.0,1,1.0,1,0.21209296511215783,30
713,0,1496,542,954,0,0,0,1.0,1,1.0,1,1.0,1,0.23522404796634389,31
714,5,1501,544,957,0,0,0,1.0,1,1.0,1,1.0,1,0.2367433184126709,31
715,2,1503,544,959,0,0,0,1.0,1,1.0,1,1.0,1,0.25705544186297175,30
716,2,1505,545,960,0,0,0,1.0,1,1.0,1,1.0,1,0.29153835511741744,31
717,2,1507,545,962,0,0,0,1.0,1,1.0,1,1.0,1,0.25670715516203696,32
718,1,1508,545,963,0,0,0,1.0,1,1.0,1,1.0,1,0.2305498123098434,32
719,0,1508,545,963,0,0,0,1.0,1,1.0,1,1.0,1,0.2305498123098434,32
720,1,1509,545,964,0,0,0,1.0,1,1.0,1,1.0,1,0.2017206257333765,34
721,1,1510,545,965,0,0,0,1.0,1,1.0,1,1.0,1,0.16692750162378422,34
722,0,1510,545,965,0,0,0,1.0,1,1.0,1,1.0,1,0.16692750162378422,34
723,1,1511,545,966,0,0,0,1.0,1,1.0,1,1.0,1,0.16653317217467173,35
724,3,1514,546,968,0,0,0,1.0,1,1.0,1,1.0,1,0.18968497585071364,36
725,3,1517,546,971,0,0,0,1.0,1,1.0,1,1.0,1,0.1313363039421876,37
726,1,1518,546,972,0,0,0,1.0,1,1.0,1,1.0,1,0.12040911652237817,37
727,1,1519,546,973,0,0,0,1.0,1,1.0,1,1.0,1,0.13103429171120798,38
728,0,1519,546,973,0,0,0,1.0,1,1.0,1,1.0,1,0.1332479433298791,39
729,1,1520,546,974,0,0,0,1.0,1,1.0,1,1.0,1,0.10607935287512435,39
730,0,1520,546,974,0,0,0,1.0,1,1.0,1,1.0,1,0.11288767528563998,40
731,0,1520,546,974,0,0,0,1.0,1,1.0,1,1.0,1,0.11288767528563998,40
732,0,1520,546,974,0,0,0,1.0,1,1.0,1,1.0,1,0.13506658231196753,41
733,2,1522,547,975,0,0,0,1.0,1,1.0,1,1.0,1,0.10270417526040088,41
734,1,1523,548,975,0,0,0,1.0,1,1.0,1,1.0,1,0.1329614189976051,42
735,0,1523,548,975,0,0,0,1.0,1,1.0,1,1.0,1,0.1392878521577046,42
736,2,1525,548,977,0,0,0,1.0,1,1.0,1,1.0,1,0.13458903457739782,41
737,5,1530,550,980,0,0,0,1.0,1,1.0,1,1.0,1,0.15795201338195525,41
738,2,1532,551,981,0,0,0,1.0,1,1.0,1,1.0,1,0.202187382867578,39
739,1,1533,551,982,0,0,0,1.0,1,1.0,1,1.0,1,0.1906294370076186,39
740,0,1533,551,982,0,0,0,1.0,1,1.0,1,1.0,1,0.2160320018185351,39
741,4,1537,551,986,0,0,0,1.0,1,1.0,1,1.0,1,0.12616939659316487,38
742,2,1539,552,987,0,0,0,1.0,1,1.0,1,1.0,1,0.12319818189112869,39
743,2,1541,554,987,0,0,0,1.0,1,1.0,1,1.0,1,0.14562964555433772,39
744,3,1544,556,988,0,0,0,1.0,1,1.0,1,1.0,1,0.1067345698998489,39
745,4,1548,559,989,0,0,0,1.0,1,1.0,1,1.0,1,0.20077901913994442,39
746,8,1556,561,995,0,0,0,1.0,1,1.0,1,1.0,1,0.09417020373485134,40
747,3,1559,562,997,0,0,0,1.0,1,1.0,1,1.0,1,0.1068104930968449,41
748,2,1561,563,998,0,0,0,1.0,1,1.0,1,1.0,1,0.10460994989281337,41
749,2,1563,564,999,0,0,0,1.0,1,1.0,1,1.0,1,0.09587114322297392,41
750,3,1566,565,1001,0,0,0,1.0,1,1.0,1,1.0,1,0.10926150448520904,39
751,3,1569,565,1004,0,0,0,1.0,1,1.0,1,1.0,1,0.08393949636970206,41
752,0,1569,565,1004,0,0,0,1.0,1,1.0,1,1.0,1,0.08393949636970206,41
753,0,1569,565,1004,0,0,0,1.0,1,1.0,1,1.0,1,0.10701355172760657,41
754,4,1573,569,1004,0,0,0,1.0,1,1.0,1,1.0,1,0.14966201645761795,41
755,2,1575,570,1005,0,0,0,1.0,1,1.0,1,1.0,1,0.18015306449801446,41
756,6,1581,570,1011,0,0,0,1.0,1,1.0,1,1.0,1,0.11868839335775619,41
757,4,1585,572,1013,0,0,0,1.0,1,1.0,1,1.0,1,0.21023682826331294,39
758,3,1588,572,1016,0,0,0,1.0,1,1.0,1,1.0,1,0.1579101241899057,39
759,2,1590,572,1018,0,0,0,1.0,1,1.0,1,1.0,1,0.1580655697691702,39
760,2,1592,572,1020,0,0,0,1.0,1,1.0,1,1.0,1,0.1815158893869346,40
761,3,1595,572,1023,0,0,0,1.0,1,1.0,1,1.0,1,0.11692806892329796,41
762,0,1595,572,1023,0,0,0,1.0,1,1.0,1,1.0,1,0.11574491785429852,42
763,1,1596,572,1024,0,0,0,1.0,1,1.0,1,1.0,1,0.11490026203896458,43
764,0,1596,572,1024,0,0,0,1.0,1,1.0,1,1.0,1,0.11490026203896458,43
765,1,1597,572,1025,0,0,0,1.0,1,1.0,1,1.0,1,0.10406381204597046,45
766,2,1599,573,1026,0,0,0,1.0,1,1.0,1,1.0,1,0.09802473564765678,45
767,0,1599,573,1026,0,0,0,1.0,1,1.0,1,1.0,1,0.1073796225715359,46
768,0,1599,573,1026,0,0,0,1.0,1,1.0,1,1.0,1,0.10565069723273705,45
769,1,1600,574,1026,0,0,0,1.0,1,1.0,1,1.0,1,0.13642914442103474,46
770,0,1600,574,1026,0,0,0,1.0,1,1.0,1,1.0,1,0.1227595543251526,47
771,3,1603,577,1026,0,0,0,1.0,1,1.0,1,1.0,1,0.13243269305033895,47
772,2,1605,578,1027,0,0,0,1.0,1,1.0,1,1.0,1,0.14490767696120813,46
773,3,1608,580,1028,0,0,0,1.0,1,1.0,1,1.0,1,0.13709927613608633,45
774,0,1608,580,1028,0,0,0,1.0,1,1.0,1,1.0,1,0.11775802675594729,45
775,4,1612,583,1029,0,0,0,1.0,1,1.0,1,1.0,1,0.1628666522819091,45
776,3,1615,583,1032,0,0,0,1.0,1,1.0,1,1.0,1,0.10465492879308184,43
777,0,1615,583,1032,0,0,0,1.0,1,1.0,1,1.0,1,0.11176182760965157,44
778,0,1615,583,1032,0,0,0,1.0,1,1.0,1,1.0,1,0.10806998407782448,45
779,0,1615,583,1032,0,0,0,1.0,1,1.0,1,1.0,1,0.10806998407782448,45
780,2,1617,585,1032,0,0,0,1.0,1,1.0,1,1.0,1,0.17301305645961818,45
781,4,1621,586,1035,0,0,0,1.0,1,1.0,1,1.0,1,0.11461431511513988,46
782,4,1625,588,1037,0,0,0,1.0,1,1.0,1,1.0,1,0.19734670922782868,47
783,2,1627,588,1039,0,0,0,1.0,1,1.0,1,1.0,1,0.1309942141448538,46
784,0,1627,588,1039,0,0,0,1.0,1,1.0,1,1.0,1,0.1369367981478102,45
785,1,1628,588,1040,0,0,0,1.0,1,1.0,1,1.0,1,0.12314724095543768,43
786,3,1631,589,1042,0,0,0,1.0,1,1.0,1,1.0,1,0.11149142553215781,43
787,3,1634,591,1043,0,0,0,1.0,1,1.0,1,1.0,1,0.13641308158779925,43
788,1,1635,592,1043,0,0,0,1.0,1,1.0,1,1.0,1,0.1646313420238419,44
789,1,1636,593,1043,0,0,0,1.0,1,1.0,1,1.0,1,0.18148953984019217,46
790,3,1639,594,1045,0,0,0,1.0,1,1.0,1,1.0,1,0.15683706583696053,46
791,4,1643,595,1048,0,0,0,1.0,1,1.0,1,1.0,1,0.10367045132610585,46
792,0,1643,595,1048,0,0,0,1.0,1,1.0,1,1.0,1,0.09850763400218593,47
793,2,1645,595,1050,0,0,0,1.0,1,1.0,1,1.0,1,0.07319373518873049,48
794,0,1645,595,1050,0,0,0,1.0,1,1.0,1,1.0,1,0.0913416995558063,48
795,0,1645,595,1050,0,0,0,1.0,1,1.0,1,1.0,1,0.09922279369987456,47
796,2,1647,596,1051,0,0,0,1.0,1,1.0,1,1.0,1,0.15547226633169983,45
797,2,1649,596,1053,0,0,0,1.0,1,1.0,1,1.0,1,0.1606049836521788,47
798,2,1651,597,1054,0,0,0,1.0,1,1.0,1,1.0,1,0.15202839010632524,48
799,2,1653,598,1055,0,0,0,1.0,1,1.0,1,1.0,1,0.135395464949869,48
800,2,1655,600,1055,0,0,0,1.0,1,1.0,1,1.0,1,0.15063022015558292,48
801,3,1658,601,1057,0,0,0,1.0,1,1.0,1,1.0,1,0.13401110191187868,49
802,4,1662,603,1059,0,0,0,1.0,1,1.0,1,1.0,1,0.15755661527473866,50
803,0,1662,603,1059,0,0,0,1.0,1,1.0,1,1.0,1,0.15755661527473866,50
804,0,1662,603,1059,0,0,0,1.0,1,1.0,1,1.0,1,0.15755661527473866,50
805,0,1662,603,1059,0,0,0,1.0,1,1.0,1,1.0,1,0.15755661527473866,50
806,1,1663,603,1060,0,0,0,1.0,1,1.0,1,1.0,1,0.14871275962327868,51
807,0,1663,603,1060,0,0,0,1.0,1,1.0,1,1.0,1,0.14871275962327868,51
808,3,1666,604,1062,0,0,0,1.0,1,1.0,1,1.0,1,0.1591880490214511,53
809,1,1667,604,1063,0,0,0,1.0,1,1.0,1,1.0,1,0.10642950145792467,51
810,0,1667,604,1063,0,0,0,1.0,1,1.0,1,1.0,1,0.11892724941352396,52
811,5,1672,606,1066,0,0,0,1.0,1,1.0,1,1.0,1,0.10468395596563641,50
812,3,1675,607,1068,0,0,0,1.0,1,1.0,1,1.0,1,0.07934092865445666,51
813,1,1676,608,1068,0,0,0,1.0,1,1.0,1,1.0,1,0.10851901307962246,51
814,2,1678,609,1069,0,0,0,1.0,1,1.0,1,1.0,1,0.13948668488528806,52
815,1,1679,610,1069,0,0,0,1.0,1,1.0,1,1.0,1,0.15497915486820354,50
816,3,1682,610,1072,0,0,0,1.0,1,1.0,1,1.0,1,0.13412787784001148,50
817,0,1682,610,1072,0,0,0,1.0,1,1.0,1,1.0,1,0.1417051000869528,49
818,2,1684,612,1072,0,0,0,1.0,1,1.0,1,1.0,1,0.19872442432130685,49
819,1,1685,612,1073,0,0,0,1.0,1,1.0,1,1.0,1,0.17638311542508317,50
820,1,1686,613,1073,0,0,0,1.0,1,1.0,1,1.0,1,0.2206851820131563,49
821,4,1690,613,1077,0,0,0,1.0,1,1.0,1,1.0,1,0.1556088890210914,49
822,2,1692,614,1078,0,0,0,1.0,1,1.0,1,1.0,1,0.14005743711363997,49
823,3,1695,616,1079,0,0,0,1.0,1,1.0,1,1.0,1,0.17855648290309462,47
824,7,1702,620,1082,0,0,0,1.0,1,1.0,1,1.0,1,0.15370390122378566,45
825,0,1702,620,1082,0,0,0,1.0,1,1.0,1,1.0,1,0.1542082045795861,43
826,4,1706,621,1085,0,0,0,1.0,1,1.0,1,1.0,1,0.08984694107587497,44
827,1,1707,622,1085,0,0,0,1.0,1,1.0,1,1.0,1,0.06895473222523346,43
828,3,1710,625,1085,0,0,0,1.0,1,1.0,1,1.0,1,0.07591626086504105,43
829,3,1713,627,1086,0,0,0,1.0,1,1.0,1,1.0,1,0.09800709719417713,45
830,2,1715,628,1087,0,0,0,1.0,1,1.0,1,1.0,1,0.12981916597129314,46
831,8,1723,629,1094,0,0,0,1.0,1,1.0,1,1.0,1,0.10691579129185372,48
832,3,1726,630,1096,0,0,0,1.0,1,1.0,1,1.0,1,0.09423732386726484,47
833,0,1726,630,1096,0,0,0,1.0,1,1.0,1,1.0,1,0.09430676500683709,47
834,1,1727,630,1097,0,0,0,1.0,1,1.0,1,1.0,1,0.13455696499198438,46
835,0,1727,630,1097,0,0,0,1.0,1,1.0,1,1.0,1,0.14311291355268257,45
836,4,1731,630,1101,0,0,0,1.0,1,1.0,1,1.0,1,0.06713805240028883,46
837,3,1734,631,1103,0,0,0,1.0,1,1.0,1,1.0,1,0.04391378741785725,46
838,1,1735,632,1103,0,0,0,1.0,1,1.0,1,1.0,1,0.10153246469111436,45
839,3,1738,634,1104,0,0,0,1.0,1,1.0,1,1.0,1,0.15030277847958667,46
840,2,1740,634,1106,0,0,0,1.0,1,1.0,1,1.0,1,0.11526945373534825,46
841,5,1745,636,1109,0,0,0,1.0,1,1.0,1,1.0,1,0.17666865632133177,46
842,4,1749,638,1111,0,0,0,1.0,1,1.0,1,1.0,1,0.19895770309476962,46
843,3,1752,639,1113,0,0,0,1.0,1,1.0,1,1.0,1,0.1888015304709616,46
844,4,1756,642,1114,0,0,0,1.0,1,1.0,1,1.0,1,0.21708442879059178,47
845,4,1760,644,1116,0,0,0,1.0,1,1.0,1,1.0,1,0.2644488944733657,48
846,3,1763,644,1119,0,0,0,1.0,1,1.0,1,1.0,1,0.18697990579205237,47
847,2,1765,644,1121,0,0,0,1.0,1,1.0,1,1.0,1,0.14087041134310982,48
848,4,1769,645,1124,0,0,0,1.0,1,1.0,1,1.0,1,0.12664818608340755,48
849,5,1774,646,1128,0,0,0,1.0,1,1.0,1,1.0,1,0.10624088528667461,48
850,2,1776,646,1130,0,0,0,1.0,1,1.0,1,1.0,1,0.10962591816808606,46
851,0,1776,646,1130,0,0,0,1.0,1,1.0,1,1.0,1,0.12577739862757564,45
852,0,1776,646,1130,0,0,0,1.0,1,1.0,1,1.0,1,0.13533592236703518,44
853,1,1777,647,1130,0,0,0,1.0,1,1.0,1,1.0,1,0.13582390692170968,44
854,2,1779,649,1130,0,0,0,1.0,1,1.0,1,1.0,1,0.14625135031931494,45
855,2,1781,649,1132,0,0,0,1.0,1,1.0,1,1.0,1,0.12604406647450142,46
856,1,1782,649,1133,0,0,0,1.0,1,1.0,1,1.0,1,0.10847639024019766,46
857,0,1782,649,1133,0,0,0,1.0,1,1.0,1,1.0,1,0.10898240243991876,47
858,2,1784,651,1133,0,0,0,1.0,1,1.0,1,1.0,1,0.16345478292011537,48
859,1,1785,651,1134,0,0,0,1.0,1,1.0,1,1.0,1,0.1653530292937587,48
860,4,1789,651,1138,0,0,0,1.0,1,1.0,1,1.0,1,0.17946925320290763,49
861,4,1793,652,1141,0,0,0,1.0,1,1.0,1,1.0,1,0.15618129052172583,49
862,3,1796,653,1143,0,0,0,1.0,1,1.0,1,1.0,1,0.12400025958953825,49
863,1,1797,654,1143,0,0,0,1.0,1,1.0,1,1.0,1,0.11968558979017231,48
864,3,1800,654,1146,0,0,0,1.0,1,1.0,1,1.0,1,0.11316584250536812,49
865,2,1802,654,1148,0,0,0,1.0,1,1.0,1,1.0,1,0.1213680802673221,48
866,3,1805,655,1150,0,0,0,1.0,1,1.0,1,1.0,1,0.08183291079506815,50
867,3,1808,656,1152,0,0,0,1.0,1,1.0,1,1.0,1,0.10478935649726134,50
868,5,1813,659,1154,0,0,0,1.0,1,1.0,1,1.0,1,0.1383184796360422,51
869,2,1815,660,1155,0,0,0,1.0,1,1.0,1,1.0,1,0.1058243288708082,49
870,5,1820,663,1157,0,0,0,1.0,1,1.0,1,1.0,1,0.11615264613675652,49
871,5,1825,664,1161,0,0,0,1.0,1,1.0,1,1.0,1,0.09424652253304935,49
872,3,1828,666,1162,0,0,0,1.0,1,1.0,1,1.0,1,0.09419957282036738,48
873,2,1830,667,1163,0,0,0,1.0,1,1.0,1,1.0,1,0.1295323104876092,49
874,0,1830,667,1163,0,0,0,1.0,1,1.0,1,1.0,1,0.13452207040678069,49
875,2,1832,668,1164,0,0,0,1.0,1,1.0,1,1.0,1,0.1336861393616243,50
876,3,1835,669,1166,0,0,0,1.0,1,1.0,1,1.0,1,0.12306432602388526,50
877,3,1838,671,1167,0,0,0,1.0,1,1.0,1,1.0,1,0.11774168044308879,50
878,2,1840,672,1168,0,0,0,1.0,1,1.0,1,1.0,1,0.1302935640725182,49
879,0,1840,672,1168,0,0,0,1.0,1,1.0,1,1.0,1,0.1302935640725182,49
880,1,1841,672,1169,0,0,0,1.0,1,1.0,1,1.0,1,0.13658329571226552,48
881,5,1846,673,1173,0,0,0,1.0,1,1.0,1,1.0,1,0.09497658526273627,49
882,1,1847,673,1174,0,0,0,1.0,1,1.0,1,1.0,1,0.11574614780295737,48
883,4,1851,674,1177,0,0,0,1.0,1,1.0,1,1.0,1,0.12201247707414753,50
884,2,1853,675,1178,0,0,0,1.0,1,1.0,1,1.0,1,0.14134112800405424,50
885,1,1854,675,1179,0,0,0,1.0,1,1.0,1,1.0,1,0.11503989609811544,49
886,3,1857,676,1181,0,0,0,1.0,1,1.0,1,1.0,1,0.13765330885107904,49
887,0,1857,676,1181,0,0,0,1.0,1,1.0,1,1.0,1,0.1367499866969698,49
888,2,1859,677,1182,0,0,0,1.0,1,1.0,1,1.0,1,0.13365298041661722,47
889,1,1860,678,1182,0,0,0,1.0,1,1.0,1,1.0,1,0.12128292578657135,46
890,1,1861,678,1183,0,0,0,1.0,1,1.0,1,1.0,1,0.1591024871742996,44
891,4,1865,679,1186,0,0,0,1.0,1,1.0,1,1.0,1,0.14458253963650583,45
892,3,1868,680,1188,0,0,0,1.0,1,1.0,1,1.0,1,0.12547814908754074,45
893,0,1868,680,1188,0,0,0,1.0,1,1.0,1,1.0,1,0.12547814908754074,45
894,1,1869,680,1189,0,0,0,1.0,1,1.0,1,1.0,1,0.1153292740993583,44
895,1,1870,680,1190,0,0,0,1.0,1,1.0,1,1.0,1,0.12392828977825927,45
896,3,1873,681,1192,0,0,0,1.0,1,1.0,1,1.0,1,0.09287148220860604,44
897,1,1874,681,1193,0,0,0,1.0,1,1.0,1,1.0,1,0.08352083940797506,44
898,1,1875,681,1194,0,0,0,1.0,1,1.0,1,1.0,1,0.0767799770750264,45
899,0,1875,681,1194,0,0,0,1.0,1,1.0,1,1.0,1,0.10147885172414757,44
900,1,1876,681,1195,0,0,0,1.0,1,1.0,1,1.0,1,0.11605398601228577,46
901,3,1879,682,1197,0,0,0,1.0,1,1.0,1,1.0,1,0.10666750645101435,45
902,2,1881,684,1197,0,0,0,1.0,1,1.0,1,1.0,1,0.09973560664796738,45
903,3,1884,687,1197,0,0,0,1.0,1,1.0,1,1.0,1,0.2137915454486866,44
904,2,1886,687,1199,0,0,0,1.0,1,1.0,1,1.0,1,0.16213654465815713,45
905,2,1888,688,1200,0,0,0,1.0,1,1.0,1,1.0,1,0.1873069696186718,45
906,3,1891,688,1203,0,0,0,1.0,1,1.0,1,1.0,1,0.14821172076232697,45
907,5,1896,689,1207,0,0,0,1.0,1,1.0,1,1.0,1,0.12296613813118434,46
908,2,1898,689,1209,0,0,0,1.0,1,1.0,1,1.0,1,0.09963172964281389,46
909,7,1905,692,1213,0,0,0,1.0,1,1.0,1,1.0,1,0.13508621632680337,46
910,3,1908,692,1216,0,0,0,1.0,1,1.0,1,1.0,1,0.16199993264022974,44
911,5,1913,693,1220,0,0,0,1.0,1,1.0,1,1.0,1,0.08703458093405125,45
912,0,1913,693,1220,0,0,0,1.0,1,1.0,1,1.0,1,0.09833415947841007,44
913,0,1913,693,1220,0,0,0,1.0,1,1.0,1,1.0,1,0.11528344902568025,45
914,2,1915,695,1220,0,0,0,1.0,1,1.0,1,1.0,1,0.1506871891708136,45
915,3,1918,696,1222,0,0,0,1.0,1,1.0,1,1.0,1,0.14268121132672448,45
916,2,1920,696,1224,0,0,0,1.0,1,1.0,1,1.0,1,0.10507675428855416,45
917,0,1920,696,1224,0,0,0,1.0,1,1.0,1,1.0,1,0.1236209374285229,46
918,2,1922,697,1225,0,0,0,1.0,1,1.0,1,1.0,1,0.13218419928785796,47
919,1,1923,698,1225,0,0,0,1.0,1,1.0,1,1.0,1,0.14916707497320045,47
920,0,1923,698,1225,0,0,0,1.0,1,1.0,1,1.0,1,0.14916707497320045,47
921,7,1930,701,1229,0,0,0,1.0,1,1.0,1,1.0,1,0.13095602641675175,49
922,2,1932,702,1230,0,0,0,1.0,1,1.0,1,1.0,1,0.1251748566193517,49
923,2,1934,704,1230,0,0,0,1.0,1,1.0,1,1.0,1,0.16501988186037655,47
924,1,1935,705,1230,0,0,0,1.0,1,1.0,1,1.0,1,0.19111622413759266,47
925,2,1937,705,1232,0,0,0,1.0,1,1.0,1,1.0,1,0.1711239198194733,47
926,4,1941,707,1234,0,0,0,1.0,1,1.0,1,1.0,1,0.1609607181482527,46
927,4,1945,708,1237,0,0,0,1.0,1,1.0,1,1.0,1,0.12402522764414307,45
928,0,1945,708,1237,0,0,0,1.0,1,1.0,1,1.0,1,0.14161498033929687,43
929,1,1946,708,1238,0,0,0,1.0,1,1.0,1,1.0,1,0.14558188255227492,42
930,0,1946,708,1238,0,0,0,1.0,1,1.0,1,1.0,1,0.17140299511355775,41
931,9,1955,709,1246,0,0,0,1.0,1,1.0,1,1.0,1,0.07559649069417171,40
932,2,1957,709,1248,0,0,0,1.0,1,1.0,1,1.0,1,0.13272889800696713,40
933,2,1959,710,1249,0,0,0,1.0,1,1.0,1,1.0,1,0.16623335002299222,39
934,2,1961,711,1250,0,0,0,1.0,1,1.0,1,1.0,1,0.16903139171680107,39
935,8,1969,712,1257,0,0,0,1.0,1,1.0,1,1.0,1,0.24067121485564083,41
936,5,1974,712,1262,0,0,0,1.0,1,1.0,1,1.0,1,0.1637197400353351,42
937,2,1976,712,1264,0,0,0,1.0,1,1.0,1,1.0,1,0.15071189669612195,43
938,1,1977,712,1265,0,0,0,1.0,1,1.0,1,1.0,1,0.1624970932140158,44
939,6,1983,712,1271,0,0,0,1.0,1,1.0,1,1.0,1,0.15181445946168534,46
940,5,1988,712,1276,0,0,0,1.0,1,1.0,1,1.0,1,0.21039854012923473,46
941,4,1992,712,1280,0,0,0,1.0,1,1.0,1,1.0,1,0.13199539071359992,46
942,2,1994,713,1281,0,0,0,1.0,1,1.0,1,1.0,1,0.12917517587144453,46
943,0,1994,713,1281,0,0,0,1.0,1,1.0,1,1.0,1,0.10968386306647586,45
944,3,1997,713,1284,0,0,0,1.0,1,1.0,1,1.0,1,0.1039663400718771,45
945,4,2001,713,1288,0,0,0,1.0,1,1.0,1,1.0,1,0.1315764595858403,44
946,4,2005,714,1291,0,0,0,1.0,1,1.0,1,1.0,1,0.1065516194123808,46
947,0,2005,714,1291,0,0,0,1.0,1,1.0,1,1.0,1,0.09917107172249291,44
948,1,2006,715,1291,0,0,0,1.0,1,1.0,1,1.0,1,0.11471612799706343,44
949,3,2009,717,1292,0,0,0,1.0,1,1.0,1,1.0,1,0.1846232253879824,44
950,0,2009,717,1292,0,0,0,1.0,1,1.0,1,1.0,1,0.18679178518119163,43
951,3,2012,717,1295,0,0,0,1.0,1,1.0,1,1.0,1,0.16066727231878541,42
952,0,2012,717,1295,0,0,0,1.0,1,1.0,1,1.0,1,0.16066727231878541,42
953,1,2013,717,1296,0,0,0,1.0,1,1.0,1,1.0,1,0.13537592100407458,41
954,0,2013,717,1296,0,0,0,1.0,1,1.0,1,1.0,1,0.14490799080843836,40
955,2,2015,717,1298,0,0,0,1.0,1,1.0,1,1.0,1,0.11596260346677675,42
956,3,2018,719,1299,0,0,0,1.0,1,1.0,1,1.0,1,0.14008270770201078,43
957,1,2019,719,1300,0,0,0,1.0,1,1.0,1,1.0,1,0.11172704620025928,42
958,0,2019,719,1300,0,0,0,1.0,1,1.0,1,1.0,1,0.14021327043125323,43
959,2,2021,720,1301,0,0,0,1.0,1,1.0,1,1.0,1,0.19537888242554113,45
960,4,2025,721,1304,0,0,0,1.0,1,1.0,1,1.0,1,0.194213457287568,47
961,0,2025,721,1304,0,0,0,1.0,1,1.0,1,1.0,1,0.17722593541017986,45
962,2,2027,723,1304,0,0,0,1.0,1,1.0,1,1.0,1,0.21055707906423948,45
963,2,2029,724,1305,0,0,0,1.0,1,1.0,1,1.0,1,0.22417396243106336,44
964,1,2030,724,1306,0,0,0,1.0,1,1.0,1,1.0,1,0.2113485680653173,44
965,3,2033,724,1309,0,0,0,1.0,1,1.0,1,1.0,1,0.14681522396439833,45
966,1,2034,725,1309,0,0,0,1.0,1,1.0,1,1.0,1,0.18792259247172804,43
967,1,2035,725,1310,0,0,0,1.0,1,1.0,1,1.0,1,0.18021135132997967,43
968,2,2037,725,1312,0,0,0,1.0,1,1.0,1,1.0,1,0.1549496773024082,43
969,0,2037,725,1312,0,0,0,1.0,1,1.0,1,1.0,1,0.15875190398189412,42
970,0,2037,725,1312,0,0,0,1.0,1,1.0,1,1.0,1,0.16830215145663233,42
971,1,2038,725,1313,0,0,0,1.0,1,1.0,1,1.0,1,0.15457386073480367,42
972,1,2039,726,1313,0,0,0,1.0,1,1.0,1,1.0,1,0.13211550465121377,42
973,0,2039,726,1313,0,0,0,1.0,1,1.0,1,1.0,1,0.13242758436043114,43
974,1,2040,727,1313,0,0,0,1.0,1,1.0,1,1.0,1,0.12825887366163438,43
975,1,2041,727,1314,0,0,0,1.0,1,1.0,1,1.0,1,0.1016322296339914,43
976,0,2041,727,1314,0,0,0,1.0,1,1.0,1,1.0,1,0.10714419387750915,45
977,0,2041,727,1314,0,0,0,1.0,1,1.0,1,1.0,1,0.12508569466003738,44
978,1,2042,728,1314,0,0,0,1.0,1,1.0,1,1.0,1,0.1319421519996487,44
979,1,2043,728,1315,0,0,0,1.0,1,1.0,1,1.0,1,0.13432913701787125,45
980,1,2044,729,1315,0,0,0,1.0,1,1.0,1,1.0,1,0.15690745436768058,45
981,2,2046,729,1317,0,0,0,1.0,1,1.0,1,1.0,1,0.12554286421896077,45
982,6,2052,732,1320,0,0,0,1.0,1,1.0,1,1.0,1,0.2274515106503804,46
983,6,2058,734,1324,0,0,0,1.0,1,1.0,1,1.0,1,0.21445313780408962,45
984,1,2059,735,1324,0,0,0,1.0,1,1.0,1,1.0,1,0.21760419910998707,45
985,7,2066,739,1327,0,0,0,1.0,1,1.0,1,1.0,1,0.23660189905245926,45
986,9,2075,740,1335,0,0,0,1.0,1,1.0,1,1.0,1,0.13462785169463407,44
987,1,2076,740,1336,0,0,0,1.0,1,1.0,1,1.0,1,0.11998770458244915,45
988,3,2079,743,1336,0,0,0,1.0,1,1.0,1,1.0,1,0.19537099140420294,44
989,3,2082,744,1338,0,0,0,1.0,1,1.0,1,1.0,1,0.18336827816006476,43
990,2,2084,745,1339,0,0,0,1.0,1,1.0,1,1.0,1,0.18288415450189918,42
991,1,2085,745,1340,0,0,0,1.0,1,1.0,1,1.0,1,0.16136408214471154,42
992,1,2086,745,1341,0,0,0,1.0,1,1.0,1,1.0,1,0.14415837974302412,43
993,2,2088,746,1342,0,0,0,1.0,1,1.0,1,1.0,1,0.1344185791264858,43
994,2,2090,747,1343,0,0,0,1.0,1,1.0,1,1.0,1,0.15142373589899358,43
995,1,2091,747,1344,0,0,0,1.0,1,1.0,1,1.0,1,0.131112592715585,43
996,1,2092,747,1345,0,0,0,1.0,1,1.0,1,1.0,1,0.12680845497824855,44
997,0,2092,747,1345,0,0,0,1.0,1,1.0,1,1.0,1,0.12680845497824855,44
998,0,2092,747,1345,0,0,0,1.0,1,1.0,1,1.0,1,0.14182509741181476,45
999,0,2092,747,1345,0,0,0,1.0,1,1.0,1,1.0,1,0.12714500627334946,42
1000,0,2092,747,1345,0,0,0,1.0,1,1.0,1,1.0,1,0.11229870613065841,43
1001,1,2093,747,1346,0,0,0,1.0,1,1.0,1,1.0,1,0.12117443524723912,42
1002,1,2094,747,1347,0,0,0,1.0,1,1.0,1,1.0,1,0.1331891644590128,43
1003,0,2094,747,1347,0,0,0,1.0,1,1.0,1,1.0,1,0.1331891644590128,43
1004,0,2094,747,1347,0,0,0,1.0,1,1.0,1,1.0,1,0.1331891644590128,43
1005,0,2094,747,1347,0,0,0,1.0,1,1.0,1,1.0,1,0.1371192268633997,44
1006,0,2094,747,1347,0,0,0,1.0,1,1.0,1,1.0,1,0.14500959227551224,46
1007,0,2094,747,1347,0,0,0,1.0,1,1.0,1,1.0,1,0.14500959227551224,46
1008,2,2096,747,1349,0,0,0,1.0,1,1.0,1,1.0,1,0.14522564094794263,47
1009,2,2098,748,1350,0,0,0,1.0,1,1.0,1,1.0,1,0.127107654585024,48
1010,0,2098,748,1350,0,0,0,1.0,1,1.0,1,1.0,1,0.127107654585024,48
1011,0,2098,748,1350,0,0,0,1.0,1,1.0,1,1.0,1,0.127107654585024,48
1012,3,2101,749,1352,0,0,0,1.0,1,1.0,1,1.0,1,0.12096204859742415,49
1013,0,2101,749,1352,0,0,0,1.0,1,1.0,1,1.0,1,0.10389161480920805,50
1014,1,2102,750,1352,0,0,0,1.0,1,1.0,1,1.0,1,0.11416656769093138,50
1015,1,2103,750,1353,0,0,0,1.0,1,1.0,1,1.0,1,0.11342903885221672,51
1016,1,2104,751,1353,0,0,0,1.0,1,1.0,1,1.0,1,0.13123290133457854,51
1017,2,2106,751,1355,0,0,0,1.0,1,1.0,1,1.0,1,0.11041457554806548,52
1018,1,2107,752,1355,0,0,0,1.0,1,1.0,1,1.0,1,0.14616529925899974,52
1019,3,2110,753,1357,0,0,0,1.0,1,1.0,1,1.0,1,0.14114102438957915,52
1020,1,2111,754,1357,0,0,0,1.0,1,1.0,1,1.0,1,0.11832155843156397,53
1021,2,2113,754,1359,0,0,0,1.0,1,1.0,1,1.0,1,0.1023033295936301,53
1022,0,2113,754,1359,0,0,0,1.0,1,1.0,1,1.0,1,0.10721947781768626,54
1023,1,2114,755,1359,0,0,0,1.0,1,1.0,1,1.0,1,0.11614088390201054,55
1024,3,2117,756,1361,0,0,0,1.0,1,1.0,1,1.0,1,0.13082844570123855,55
1025,1,2118,756,1362,0,0,0,1.0,1,1.0,1,1.0,1,0.12499498782278963,56
1026,1,2119,756,1363,0,0,0,1.0,1,1.0,1,1.0,1,0.13217996834866555,57
1027,0,2119,756,1363,0,0,0,1.0,1,1.0,1,1.0,1,0.13581488646318865,58
1028,2,2121,758,1363,0,0,0,1.0,1,1.0,1,1.0,1,0.18142085761057133,58
1029,7,2128,761,1367,0,0,0,1.0,1,1.0,1,1.0,1,0.1639380643513134,59
1030,2,2130,762,1368,0,0,0,1.0,1,1.0,1,1.0,1,0.18224949987568526,60
1031,7,2137,762,1375,0,0,0,1.0,1,1.0,1,1.0,1,0.11411612395177188,60
1032,3,2140,762,1378,0,0,0,1.0,1,1.0,1,1.0,1,0.11447047591906376,61
1033,3,2143,762,1381,0,0,0,1.0,1,1.0,1,1.0,1,0.12239918923467653,60
1034,3,2146,763,1383,0,0,0,1.0,1,1.0,1,1.0,1,0.13711557144084893,60
1035,5,2151,764,1387,0,0,0,1.0,1,1.0,1,1.0,1,0.16205308287460546,59
1036,10,2161,766,1395,0,0,0,1.0,1,1.0,1,1.0,1,0.0789350725852612,60
1037,1,2162,766,1396,0,0,0,1.0,1,1.0,1,1.0,1,0.0723626725111299,59
1038,3,2165,769,1396,0,0,0,1.0,1,1.0,1,1.0,1,0.10807826744262865,60
1039,3,2168,770,1398,0,0,0,1.0,1,1.0,1,1.0,1,0.09865243468881767,60
1040,3,2171,771,1400,0,0,0,1.0,1,1.0,1,1.0,1,0.12808842995276762,58
1041,4,2175,773,1402,0,0,0,1.0,1,1.0,1,1.0,1,0.07086537374392275,56
1042,0,2175,773,1402,0,0,0,1.0,1,1.0,1,1.0,1,0.08401571550938401,55
1043,1,2176,774,1402,0,0,0,1.0,1,1.0,1,1.0,1,0.09057827545600194,55
1044,1,2177,775,1402,0,0,0,1.0,1,1.0,1,1.0,1,0.08503444313780283,52
1045,0,2177,775,1402,0,0,0,1.0,1,1.0,1,1.0,1,0.0912055100384304,52
1046,2,2179,775,1404,0,0,0,1.0,1,1.0,1,1.0,1,0.06271652647594807,53
1047,0,2179,775,1404,0,0,0,1.0,1,1.0,1,1.0,1,0.06777074979155323,54
1048,2,2181,777,1404,0,0,0,1.0,1,1.0,1,1.0,1,0.07835431450648184,56
1049,4,2185,780,1405,0,0,0,1.0,1,1.0,1,1.0,1,0.10077976174060642,55
1050,4,2189,780,1409,0,0,0,1.0,1,1.0,1,1.0,1,0.09599728910591603,56
1051,1,2190,780,1410,0,0,0,1.0,1,1.0,1,1.0,1,0.0597265953634409,55
1052,0,2190,780,1410,0,0,0,1.0,1,1.0,1,1.0,1,0.07313995435421465,56
1053,2,2192,782,1410,0,0,0,1.0,1,1.0,1,1.0,1,0.10287203560462503,56
1054,2,2194,783,1411,0,0,0,1.0,1,1.0,1,1.0,1,0.06386843046947215,57
1055,0,2194,783,1411,0,0,0,1.0,1,1.0,1,1.0,1,0.061938360563487185,58
1056,1,2195,783,1412,0,0,0,1.0,1,1.0,1,1.0,1,0.062053247349610485,59
1057,1,2196,784,1412,0,0,0,1.0,1,1.0,1,1.0,1,0.10409114958537816,60
1058,4,2200,785,1415,0,0,0,1.0,1,1.0,1,1.0,1,0.11615766120330706,60
1059,1,2201,785,1416,0,0,0,1.0,1,1.0,1,1.0,1,0.12062182774375169,60
1060,4,2205,787,1418,0,0,0,1.0,1,1.0,1,1.0,1,0.16096812647488587,60
1061,8,2213,791,1422,0,0,0,1.0,1,1.0,1,1.0,1,0.1581104400806116,59
1062,5,2218,791,1427,0,0,0,1.0,1,1.0,1,1.0,1,0.14094807947055668,59
1063,2,2220,793,1427,0,0,0,1.0,1,1.0,1,1.0,1,0.13936625821976698,58
1064,6,2226,797,1429,0,0,0,1.0,1,1.0,1,1.0,1,0.16222049607253622,58
1065,2,2228,799,1429,0,0,0,1.0,1,1.0,1,1.0,1,0.17509441624490057,60
1066,8,2236,800,1436,0,0,0,1.0,1,1.0,1,1.0,1,0.15038522792660072,58
1067,4,2240,801,1439,0,0,0,1.0,1,1.0,1,1.0,1,0.14812961292616036,59
1068,2,2242,803,1439,0,0,0,1.0,1,1.0,1,1.0,1,0.1716005673579945,59
1069,1,2243,804,1439,0,0,0,1.0,1,1.0,1,1.0,1,0.17881289197797,58
1070,3,2246,806,1440,0,0,0,1.0,1,1.0,1,1.0,1,0.17769100999435197,58
1071,5,2251,806,1445,0,0,0,1.0,1,1.0,1,1.0,1,0.12793723926424283,57
1072,1,2252,806,1446,0,0,0,1.0,1,1.0,1,1.0,1,0.12769807289595236,56
1073,1,2253,806,1447,0,0,0,1.0,1,1.0,1,1.0,1,0.1499840442238286,54
1074,3,2256,806,1450,0,0,0,1.0,1,1.0,1,1.0,1,0.15159157975842977,54
1075,2,2258,806,1452,0,0,0,1.0,1,1.0,1,1.0,1,0.13612827871183047,51
1076,6,2264,807,1457,0,0,0,1.0,1,1.0,1,1.0,1,0.12156149787123054,51
1077,1,2265,807,1458,0,0,0,1.0,1,1.0,1,1.0,1,0.128151747473614,51
1078,0,2265,807,1458,0,0,0,1.0,1,1.0,1,1.0,1,0.1448801486070561,52
1079,6,2271,811,1460,0,0,0,1.0,1,1.0,1,1.0,1,0.20374929646117532,51
1080,2,2273,812,1461,0,0,0,1.0,1,1.0,1,1.0,1,0.21677244414698413,51
1081,5,2278,812,1466,0,0,0,1.0,1,1.0,1,1.0,1,0.1479980044215459,48
1082,5,2283,814,1469,0,0,0,1.0,1,1.0,1,1.0,1,0.17880380545950053,47
1083,1,2284,815,1469,0,0,0,1.0,1,1.0,1,1.0,1,0.21752382387523833,46
1084,0,2284,815,1469,0,0,0,1.0,1,1.0,1,1.0,1,0.20624999708953654,45
1085,1,2285,816,1469,0,0,0,1.0,1,1.0,1,1.0,1,0.21870483968268115,46
1086,2,2287,816,1471,0,0,0,1.0,1,1.0,1,1.0,1,0.1707441311135025,45
1087,1,2288,816,1472,0,0,0,1.0,1,1.0,1,1.0,1,0.18695919134839678,44
1088,1,2289,816,1473,0,0,0,1.0,1,1.0,1,1.0,1,0.17092368321035065,45
1089,2,2291,816,1475,0,0,0,1.0,1,1.0,1,1.0,1,0.14212121956610618,46
1090,1,2292,816,1476,0,0,0,1.0,1,1.0,1,1.0,1,0.12819616325429134,47
1091,3,2295,817,1478,0,0,0,1.0,1,1.0,1,1.0,1,0.0910187110060996,47
1092,0,2295,817,1478,0,0,0,1.0,1,1.0,1,1.0,1,0.09262943836518119,48
1093,1,2296,818,1478,0,0,0,1.0,1,1.0,1,1.0,1,0.08694595494400587,48
1094,1,2297,819,1478,0,0,0,1.0,1,1.0,1,1.0,1,0.1067058141299862,48
1095,3,2300,819,1481,0,0,0,1.0,1,1.0,1,1.0,1,0.09655997034919907,49
1096,1,2301,820,1481,0,0,0,1.0,1,1.0,1,1.0,1,0.11331114741947626,49
1097,2,2303,821,1482,0,0,0,1.0,1,1.0,1,1.0,1,0.11640162603868547,50
1098,0,2303,821,1482,0,0,0,1.0,1,1.0,1,1.0,1,0.12393857047869412,51
1099,0,2303,821,1482,0,0,0,1.0,1,1.0,1,1.0,1,0.12428540289018125,54
1100,3,2306,821,1485,0,0,0,1.0,1,1.0,1,1.0,1,0.12995520149282394,54
1101,2,2308,821,1487,0,0,0,1.0,1,1.0,1,1.0,1,0.10325228228745596,54
1102,1,2309,822,1487,0,0,0,1.0,1,1.0,1,1.0,1,0.12031817292551612,54
1103,1,2310,823,1487,0,0,0,1.0,1,1.0,1,1.0,1,0.1316175355317314,53
1104,4,2314,826,1488,0,0,0,1.0,1,1.0,1,1.0,1,0.12583254348845657,53
1105,2,2316,827,1489,0,0,0,1.0,1,1.0,1,1.0,1,0.14333091133188733,52
1106,5,2321,827,1494,0,0,0,1.0,1,1.0,1,1.0,1,0.09911661960015933,52
1107,7,2328,829,1499,0,0,0,1.0,1,1.0,1,1.0,1,0.15075028394878764,52
1108,3,2331,831,1500,0,0,0,1.0,1,1.0,1,1.0,1,0.1513118040051337,51
1109,2,2333,832,1501,0,0,0,1.0,1,1.0,1,1.0,1,0.1744329514589252,49
1110,1,2334,833,1501,0,0,0,1.0,1,1.0,1,1.0,1,0.17308472454504423,48
1111,2,2336,834,1502,0,0,0,1.0,1,1.0,1,1.0,1,0.22224057184117982,47
1112,5,2341,836,1505,0,0,0,1.0,1,1.0,1,1.0,1,0.24976273570787538,46
1113,2,2343,836,1507,0,0,0,1.0,1,1.0,1,1.0,1,0.23817746645544122,43
1114,2,2345,837,1508,0,0,0,1.0,1,1.0,1,1.0,1,0.25899735311882827,41
1115,0,2345,837,1508,0,0,0,1.0,1,1.0,1,1.0,1,0.2662154348820961,40
1116,4,2349,838,1511,0,0,0,1.0,1,1.0,1,1.0,1,0.19248614367478942,39
1117,4,2353,840,1513,0,0,0,1.0,1,1.0,1,1.0,1,0.1988832984366941,40
1118,5,2358,842,1516,0,0,0,1.0,1,1.0,1,1.0,1,0.2617937022618676,40
1119,5,2363,843,1520,0,0,0,1.0,1,1.0,1,1.0,1,0.24517949154477897,40
1120,3,2366,843,1523,0,0,0,1.0,1,1.0,1,1.0,1,0.2922073464048417,40
1121,6,2372,843,1529,0,0,0,1.0,1,1.0,1,1.0,1,0.1838363533163817,40
1122,1,2373,843,1530,0,0,0,1.0,1,1.0,1,1.0,1,0.1702082689058872,41
1123,1,2374,844,1530,0,0,0,1.0,1,1.0,1,1.0,1,0.2046402898968572,41
1124,2,2376,844,1532,0,0,0,1.0,1,1.0,1,1.0,1,0.17101724743925067,41
1125,2,2378,845,1533,0,0,0,1.0,1,1.0,1,1.0,1,0.21676700208243044,41
1126,1,2379,845,1534,0,0,0,1.0,1,1.0,1,1.0,1,0.17714826338116063,41
1127,1,2380,845,1535,0,0,0,1.0,1,1.0,1,1.0,1,0.15081771502187105,41
1128,0,2380,845,1535,0,0,0,1.0,1,1.0,1,1.0,1,0.17162978230565143,42
1129,1,2381,846,1535,0,0,0,1.0,1,1.0,1,1.0,1,0.19625297286521765,42
1130,2,2383,846,1537,0,0,0,1.0,1,1.0,1,1.0,1,0.1841951282815548,42
1131,0,2383,846,1537,0,0,0,1.0,1,1.0,1,1.0,1,0.1841951282815548,42
1132,0,2383,846,1537,0,0,0,1.0,1,1.0,1,1.0,1,0.15133712769133076,43
1133,3,2386,846,1540,0,0,0,1.0,1,1.0,1,1.0,1,0.1165873179151564,45
1134,2,2388,846,1542,0,0,0,1.0,1,1.0,1,1.0,1,0.10959817911390424,46
1135,0,2388,846,1542,0,0,0,1.0,1,1.0,1,1.0,1,0.12426216926036016,45
1136,1,2389,846,1543,0,0,0,1.0,1,1.0,1,1.0,1,0.11676990665375872,48
1137,1,2390,846,1544,0,0,0,1.0,1,1.0,1,1.0,1,0.13569177575871144,49
1138,0,2390,846,1544,0,0,0,1.0,1,1.0,1,1.0,1,0.13569177575871144,49
1139,1,2391,846,1545,0,0,0,1.0,1,1.0,1,1.0,1,0.16609664017317347,49
1140,1,2392,847,1545,0,0,0,1.0,1,1.0,1,1.0,1,0.17155761205963252,49
1141,6,2398,849,1549,0,0,0,1.0,1,1.0,1,1.0,1,0.18195981914339865,48
1142,2,2400,851,1549,0,0,0,1.0,1,1.0,1,1.0,1,0.1869310981571881,48
1143,8,2408,855,1553,0,0,0,1.0,1,1.0,1,1.0,1,0.2032420626641497,48
1144,5,2413,857,1556,0,0,0,1.0,1,1.0,1,1.0,1,0.18799346172307982,48
1145,6,2419,859,1560,0,0,0,1.0,1,1.0,1,1.0,1,0.18683994431362627,48
1146,9,2428,861,1567,0,0,0,1.0,1,1.0,1,1.0,1,0.09734310774516067,48
1147,2,2430,862,1568,0,0,0,1.0,1,1.0,1,1.0,1,0.14673860264684718,46
1148,3,2433,863,1570,0,0,0,1.0,1,1.0,1,1.0,1,0.14500787904038923,46
1149,0,2433,863,1570,0,0,0,1.0,1,1.0,1,1.0,1,0.18788806190709256,45
1150,2,2435,865,1570,0,0,0,1.0,1,1.0,1,1.0,1,0.1762907010151061,46
1151,3,2438,866,1572,0,0,0,1.0,1,1.0,1,1.0,1,0.14809249726918997,44
1152,1,2439,866,1573,0,0,0,1.0,1,1.0,1,1.0,1,0.11511107955375918,44
1153,3,2442,869,1573,0,0,0,1.0,1,1.0,1,1.0,1,0.18413735328798758,43
1154,2,2444,869,1575,0,0,0,1.0,1,1.0,1,1.0,1,0.15428457518798458,43
1155,1,2445,869,1576,0,0,0,1.0,1,1.0,1,1.0,1,0.16602950972063768,43
1156,0,2445,869,1576,0,0,0,1.0,1,1.0,1,1.0,1,0.1783363529775003,42
1157,1,2446,870,1576,0,0,0,1.0,1,1.0,1,1.0,1,0.1878717819601874,42
1158,0,2446,870,1576,0,0,0,1.0,1,1.0,1,1.0,1,0.17210561519077164,41
1159,0,2446,870,1576,0,0,0,1.0,1,1.0,1,1.0,1,0.17467353205810857,41
1160,0,2446,870,1576,0,0,0,1.0,1,1.0,1,1.0,1,0.17467353205810857,41
1161,1,2447,870,1577,0,0,0,1.0,1,1.0,1,1.0,1,0.1659234971539065,42
1162,2,2449,870,1579,0,0,0,1.0,1,1.0,1,1.0,1,0.14887828501038236,43
1163,0,2449,870,1579,0,0,0,1.0,1,1.0,1,1.0,1,0.14887828501038236,43
1164,0,2449,870,1579,0,0,0,1.0,1,1.0,1,1.0,1,0.13942116209227726,44
1165,0,2449,870,1579,0,0,0,1.0,1,1.0,1,1.0,1,0.13942116209227726,44
1166,2,2451,871,1580,0,0,0,1.0,1,1.0,1,1.0,1,0.13269625639772473,46
1167,2,2453,872,1581,0,0,0,1.0,1,1.0,1,1.0,1,0.10944064827651923,46
1168,3,2456,872,1584,0,0,0,1.0,1,1.0,1,1.0,1,0.08673561816529651,47
1169,1,2457,873,1584,0,0,0,1.0,1,1.0,1,1.0,1,0.06888563994382281,46
1170,0,2457,873,1584,0,0,0,1.0,1,1.0,1,1.0,1,0.06759659767218847,48
1171,2,2459,875,1584,0,0,0,1.0,1,1.0,1,1.0,1,0.11511156862164018,49
1172,1,2460,875,1585,0,0,0,1.0,1,1.0,1,1.0,1,0.0897997748661879,49
1173,0,2460,875,1585,0,0,0,1.0,1,1.0,1,1.0,1,0.0897997748661879,49
1174,1,2461,876,1585,0,0,0,1.0,1,1.0,1,1.0,1,0.11131539346886893,49
1175,0,2461,876,1585,0,0,0,1.0,1,1.0,1,1.0,1,0.12128880370677778,50
1176,6,2467,876,1591,0,0,0,1.0,1,1.0,1,1.0,1,0.11474390404527895,52
1177,4,2471,878,1593,0,0,0,1.0,1,1.0,1,1.0,1,0.12596019491202254,52
1178,0,2471,878,1593,0,0,0,1.0,1,1.0,1,1.0,1,0.12596019491202254,52
1179,1,2472,879,1593,0,0,0,1.0,1,1.0,1,1.0,1,0.10973735786727826,53
1180,0,2472,879,1593,0,0,0,1.0,1,1.0,1,1.0,1,0.11005715734803521,54
1181,0,2472,879,1593,0,0,0,1.0,1,1.0,1,1.0,1,0.12268770391985244,55
1182,2,2474,881,1593,0,0,0,1.0,1,1.0,1,1.0,1,0.1695220007200787,55
1183,3,2477,882,1595,0,0,0,1.0,1,1.0,1,1.0,1,0.17273952614986282,53
1184,2,2479,883,1596,0,0,0,1.0,1,1.0,1,1.0,1,0.16009056694052942,54
1185,0,2479,883,1596,0,0,0,1.0,1,1.0,1,1.0,1,0.1671365759520388,53
1186,5,2484,884,1600,0,0,0,1.0,1,1.0,1,1.0,1,0.16244566171076827,54
1187,1,2485,884,1601,0,0,0,1.0,1,1.0,1,1.0,1,0.15979761803757714,55
1188,0,2485,884,1601,0,0,0,1.0,1,1.0,1,1.0,1,0.15979761803757714,55
1189,2,2487,884,1603,0,0,0,1.0,1,1.0,1,1.0,1,0.1448007963463647,54
1190,2,2489,885,1604,0,0,0,1.0,1,1.0,1,1.0,1,0.11891863783798526,55
1191,1,2490,885,1605,0,0,0,1.0,1,1.0,1,1.0,1,0.09693440613090755,54
1192,1,2491,886,1605,0,0,0,1.0,1,1.0,1,1.0,1,0.09382085052872871,52
1193,0,2491,886,1605,0,0,0,1.0,1,1.0,1,1.0,1,0.09537405452811015,53
1194,1,2492,887,1605,0,0,0,1.0,1,1.0,1,1.0,1,0.09635177803995659,53
1195,0,2492,887,1605,0,0,0,1.0,1,1.0,1,1.0,1,0.09010095922360267,54
1196,4,2496,887,1609,0,0,0,1.0,1,1.0,1,1.0,1,0.07199726346230537,56
1197,2,2498,889,1609,0,0,0,1.0,1,1.0,1,1.0,1,0.09417059269519655,56
1198,2,2500,890,1610,0,0,0,1.0,1,1.0,1,1.0,1,0.10043523309649767,58
1199,1,2501,891,1610,0,0,0,1.0,1,1.0,1,1.0,1,0.10967075370008486,58
1200,0,2501,891,1610,0,0,0,1.0,1,1.0,1,1.0,1,0.10967075370008486,58
1201,4,2505,893,1612,0,0,0,1.0,1,1.0,1,1.0,1,0.10328813212296602,58
1202,2,2507,893,1614,0,0,0,1.0,1,1.0,1,1.0,1,0.08604640501294131,60
1203,2,2509,893,1616,0,0,0,1.0,1,1.0,1,1.0,1,0.08427228187920405,58
1204,4,2513,894,1619,0,0,0,1.0,1,1.0,1,1.0,1,0.09276217608677684,59
1205,3,2516,895,1621,0,0,0,1.0,1,1.0,1,1.0,1,0.11949145588883932,59
1206,5,2521,895,1626,0,0,0,1.0,1,1.0,1,1.0,1,0.10170181911481906,58
1207,0,2521,895,1626,0,0,0,1.0,1,1.0,1,1.0,1,0.10396116136409528,60
1208,1,2522,895,1627,0,0,0,1.0,1,1.0,1,1.0,1,0.0965830932377855,60
1209,1,2523,895,1628,0,0,0,1.0,1,1.0,1,1.0,1,0.09425287056761782,61
1210,1,2524,895,1629,0,0,0,1.0,1,1.0,1,1.0,1,0.09832769015886234,61
1211,2,2526,895,1631,0,0,0,1.0,1,1.0,1,1.0,1,0.05714449820698518,63
1212,1,2527,896,1631,0,0,0,1.0,1,1.0,1,1.0,1,0.060448703011173686,63
1213,1,2528,897,1631,0,0,0,1.0,1,1.0,1,1.0,1,0.07621408985554139,63
1214,1,2529,898,1631,0,0,0,1.0,1,1.0,1,1.0,1,0.11957098555191124,62
1215,0,2529,898,1631,0,0,0,1.0,1,1.0,1,1.0,1,0.1164726137712073,63
1216,5,2534,899,1635,0,0,0,1.0,1,1.0,1,1.0,1,0.13639826184608275,64
1217,1,2535,899,1636,0,0,0,1.0,1,1.0,1,1.0,1,0.1251849212973119,65
1218,1,2536,900,1636,0,0,0,1.0,1,1.0,1,1.0,1,0.14021338005214612,64
1219,0,2536,900,1636,0,0,0,1.0,1,1.0,1,1.0,1,0.1515960390833754,65
1220,2,2538,900,1638,0,0,0,1.0,1,1.0,1,1.0,1,0.15267418940781127,64
1221,7,2545,901,1644,0,0,0,1.0,1,1.0,1,1.0,1,0.12172014761000231,65
1222,3,2548,903,1645,0,0,0,1.0,1,1.0,1,1.0,1,0.16709141218091164,66
1223,3,2551,904,1647,0,0,0,1.0,1,1.0,1,1.0,1,0.11841582749005984,64
1224,3,2554,905,1649,0,0,0,1.0,1,1.0,1,1.0,1,0.11590065306791057,66
1225,2,2556,906,1650,0,0,0,1.0,1,1.0,1,1.0,1,0.1098930908946818,66
1226,5,2561,906,1655,0,0,0,1.0,1,1.0,1,1.0,1,0.06612383649357553,68
1227,1,2562,907,1655,0,0,0,1.0,1,1.0,1,1.0,1,0.08034464604968793,64
1228,1,2563,908,1655,0,0,0,1.0,1,1.0,1,1.0,1,0.09400874871958981,62
1229,3,2566,910,1656,0,0,0,1.0,1,1.0,1,1.0,1,0.05718445565326593,61
1230,2,2568,912,1656,0,0,0,1.0,1,1.0,1,1.0,1,0.08072788563777519,58
1231,2,2570,913,1657,0,0,0,1.0,1,1.0,1,1.0,1,0.05086590847018785,57
1232,2,2572,914,1658,0,0,0,1.0,1,1.0,1,1.0,1,0.10338470522076375,53
1233,2,2574,916,1658,0,0,0,1.0,1,1.0,1,1.0,1,0.10552867631809802,53
1234,0,2574,916,1658,0,0,0,1.0,1,1.0,1,1.0,1,0.0981014364253921,54
1235,0,2574,916,1658,0,0,0,1.0,1,1.0,1,1.0,1,0.12146323296224341,55
1236,3,2577,917,1660,0,0,0,1.0,1,1.0,1,1.0,1,0.1238929445768889,55
1237,1,2578,918,1660,0,0,0,1.0,1,1.0,1,1.0,1,0.12925729986447418,55
1238,1,2579,919,1660,0,0,0,1.0,1,1.0,1,1.0,1,0.12962625841819914,54
1239,4,2583,919,1664,0,0,0,1.0,1,1.0,1,1.0,1,0.10469269878823537,55
1240,1,2584,920,1664,0,0,0,1.0,1,1.0,1,1.0,1,0.10026477833645289,55
1241,2,2586,921,1665,0,0,0,1.0,1,1.0,1,1.0,1,0.09744079684591264,54
1242,0,2586,921,1665,0,0,0,1.0,1,1.0,1,1.0,1,0.10397222208435279,54
1243,2,2588,923,1665,0,0,0,1.0,1,1.0,1,1.0,1,0.1633064009921418,55
1244,2,2590,923,1667,0,0,0,1.0,1,1.0,1,1.0,1,0.16386531282818909,55
1245,5,2595,924,1671,0,0,0,1.0,1,1.0,1,1.0,1,0.17746561350236445,55
1246,3,2598,924,1674,0,0,0,1.0,1,1.0,1,1.0,1,0.1569766325747521,55
1247,1,2599,925,1674,0,0,0,1.0,1,1.0,1,1.0,1,0.18638758366842814,57
1248,1,2600,925,1675,0,0,0,1.0,1,1.0,1,1.0,1,0.19286005114222918,56
1249,3,2603,928,1675,0,0,0,1.0,1,1.0,1,1.0,1,0.22188862908691956,56
1250,6,2609,931,1678,0,0,0,1.0,1,1.0,1,1.0,1,0.187676380306698,56
1251,8,2617,931,1686,0,0,0,1.0,1,1.0,1,1.0,1,0.11584752354694731,58
1252,5,2622,933,1689,0,0,0,1.0,1,1.0,1,1.0,1,0.18931435923634948,58
1253,5,2627,934,1693,0,0,0,1.0,1,1.0,1,1.0,1,0.1973059448076521,58
1254,4,2631,934,1697,0,0,0,1.0,1,1.0,1,1.0,1,0.1538148989302593,60
1255,5,2636,934,1702,0,0,0,1.0,1,1.0,1,1.0,1,0.1377623463945082,61
1256,3,2639,934,1705,0,0,0,1.0,1,1.0,1,1.0,1,0.08537904517028314,61
1257,2,2641,936,1705,0,0,0,1.0,1,1.0,1,1.0,1,0.1294117032324737,62
1258,0,2641,936,1705,0,0,0,1.0,1,1.0,1,1.0,1,0.13479690516513693,63
1259,1,2642,936,1706,0,0,0,1.0,1,1.0,1,1.0,1,0.10594984685502559,63
1260,0,2642,936,1706,0,0,0,1.0,1,1.0,1,1.0,1,0.12525569840133863,63
1261,2,2644,936,1708,0,0,0,1.0,1,1.0,1,1.0,1,0.08789027634993024,63
1262,2,2646,937,1709,0,0,0,1.0,1,1.0,1,1.0,1,0.1130855596249084,64
1263,1,2647,938,1709,0,0,0,1.0,1,1.0,1,1.0,1,0.12779174402876267,63
1264,3,2650,940,1710,0,0,0,1.0,1,1.0,1,1.0,1,0.13046230363811417,63
1265,5,2655,944,1711,0,0,0,1.0,1,1.0,1,1.0,1,0.14656806549379042,60
1266,10,2665,947,1718,0,0,0,1.0,1,1.0,1,1.0,1,0.09607308577644742,61
1267,3,2668,949,1719,0,0,0,1.0,1,1.0,1,1.0,1,0.09295696330180407,58
1268,5,2673,952,1721,0,0,0,1.0,1,1.0,1,1.0,1,0.1727693628244571,54
1269,2,2675,953,1722,0,0,0,1.0,1,1.0,1,1.0,1,0.12911528825366067,54
1270,6,2681,954,1727,0,0,0,1.0,1,1.0,1,1.0,1,0.154632009764849,51
1271,4,2685,955,1730,0,0,0,1.0,1,1.0,1,1.0,1,0.09349734416765482,50
1272,0,2685,955,1730,0,0,0,1.0,1,1.0,1,1.0,1,0.12233260697260746,47
1273,1,2686,956,1730,0,0,0,1.0,1,1.0,1,1.0,1,0.10833133557030199,47
1274,1,2687,957,1730,0,0,0,1.0,1,1.0,1,1.0,1,0.14467964848958237,49
1275,3,2690,959,1731,0,0,0,1.0,1,1.0,1,1.0,1,0.14840696135417533,48
1276,5,2695,960,1735,0,0,0,1.0,1,1.0,1,1.0,1,0.12070513632769718,49
1277,6,2701,963,1738,0,0,0,1.0,1,1.0,1,1.0,1,0.111770393154924,50
1278,1,2702,963,1739,0,0,0,1.0,1,1.0,1,1.0,1,0.1086597118222248,51
1279,1,2703,964,1739,0,0,0,1.0,1,1.0,1,1.0,1,0.14173426747726242,51
1280,1,2704,964,1740,0,0,0,1.0,1,1.0,1,1.0,1,0.11667764446546203,52
1281,0,2704,964,1740,0,0,0,1.0,1,1.0,1,1.0,1,0.11667764446546203,52
1282,2,2706,966,1740,0,0,0,1.0,1,1.0,1,1.0,1,0.11177629026772065,52
1283,1,2707,966,1741,0,0,0,1.0,1,1.0,1,1.0,1,0.09364045348964231,52
1284,3,2710,968,1742,0,0,0,1.0,1,1.0,1,1.0,1,0.12122786848516837,52
1285,0,2710,968,1742,0,0,0,1.0,1,1.0,1,1.0,1,0.15112998586505166,51
1286,3,2713,968,1745,0,0,0,1.0,1,1.0,1,1.0,1,0.11717587893853716,52
1287,2,2715,969,1746,0,0,0,1.0,1,1.0,1,1.0,1,0.1355415901508598,54
1288,2,2717,969,1748,0,0,0,1.0,1,1.0,1,1.0,1,0.10053985152894404,55
1289,1,2718,969,1749,0,0,0,1.0,1,1.0,1,1.0,1,0.0998637196458082,56
1290,2,2720,970,1750,0,0,0,1.0,1,1.0,1,1.0,1,0.08251443889245773,57
1291,0,2720,970,1750,0,0,0,1.0,1,1.0,1,1.0,1,0.09943650384368528,58
1292,1,2721,971,1750,0,0,0,1.0,1,1.0,1,1.0,1,0.10782559866549565,59
1293,1,2722,971,1751,0,0,0,1.0,1,1.0,1,1.0,1,0.09552023989944283,59
1294,0,2722,971,1751,0,0,0,1.0,1,1.0,1,1.0,1,0.09552023989944283,59
1295,1,2723,972,1751,0,0,0,1.0,1,1.0,1,1.0,1,0.10100866254172576,59
1296,3,2726,972,1754,0,0,0,1.0,1,1.0,1,1.0,1,0.06494240161356547,59
1297,1,2727,973,1754,0,0,0,1.0,1,1.0,1,1.0,1,0.08631411420933506,61
1298,3,2730,973,1757,0,0,0,1.0,1,1.0,1,1.0,1,0.0710738890450097,61
1299,0,2730,973,1757,0,0,0,1.0,1,1.0,1,1.0,1,0.08196827010371664,60
1300,1,2731,973,1758,0,0,0,1.0,1,1.0,1,1.0,1,0.06405627855803878,59
1301,2,2733,974,1759,0,0,0,1.0,1,1.0,1,1.0,1,0.10487677771511293,59
1302,8,2741,978,1763,0,0,0,1.0,1,1.0,1,1.0,1,0.08716263622075482,59
1303,4,2745,982,1763,0,0,0,1.0,1,1.0,1,1.0,1,0.19342377707545358,55
1304,4,2749,985,1764,0,0,0,1.0,1,1.0,1,1.0,1,0.16787411794426502,56
1305,2,2751,987,1764,0,0,0,1.0,1,1.0,1,1.0,1,0.19613092304984941,54
1306,9,2760,988,1772,0,0,0,1.0,1,1.0,1,1.0,1,0.12074574896103964,53
1307,4,2764,990,1774,0,0,0,1.0,1,1.0,1,1.0,1,0.13997543120318431,52
1308,4,2768,992,1776,0,0,0,1.0,1,1.0,1,1.0,1,0.19026812212330002,52
1309,6,2774,994,1780,0,0,0,1.0,1,1.0,1,1.0,1,0.1808553524288874,54
1310,4,2778,994,1784,0,0,0,1.0,1,1.0,1,1.0,1,0.17767189069290582,52
1311,3,2781,995,1786,0,0,0,1.0,1,1.0,1,1.0,1,0.12460697732315755,51
1312,1,2782,996,1786,0,0,0,1.0,1,1.0,1,1.0,1,0.16725944067564524,49
1313,0,2782,996,1786,0,0,0,1.0,1,1.0,1,1.0,1,0.18431837428181944,47
1314,1,2783,997,1786,0,0,0,1.0,1,1.0,1,1.0,1,0.18068527993937622,46
1315,2,2785,998,1787,0,0,0,1.0,1,1.0,1,1.0,1,0.1597489508829743,45
1316,4,2789,999,1790,0,0,0,1.0,1,1.0,1,1.0,1,0.10672259233982473,46
1317,1,2790,999,1791,0,0,0,1.0,1,1.0,1,1.0,1,0.09607171680572396,45
1318,4,2794,1002,1792,0,0,0,1.0,1,1.0,1,1.0,1,0.1178312693519087,46
1319,2,2796,1002,1794,0,0,0,1.0,1,1.0,1,1.0,1,0.09324146766440634,46
1320,1,2797,1002,1795,0,0,0,1.0,1,1.0,1,1.0,1,0.08621289970677756,46
1321,1,2798,1002,1796,0,0,0,1.0,1,1.0,1,1.0,1,0.0891279217297479,48
1322,1,2799,1003,1796,0,0,0,1.0,1,1.0,1,1.0,1,0.10972863825890648,49
1323,0,2799,1003,1796,0,0,0,1.0,1,1.0,1,1.0,1,0.12344515254217817,49
1324,2,2801,1003,1798,0,0,0,1.0,1,1.0,1,1.0,1,0.11496914234152061,50
1325,0,2801,1003,1798,0,0,0,1.0,1,1.0,1,1.0,1,0.12467090683600762,49
1326,2,2803,1004,1799,0,0,0,1.0,1,1.0,1,1.0,1,0.16889077574191427,50
1327,5,2808,1005,1803,0,0,0,1.0,1,1.0,1,1.0,1,0.17505922187223186,50
1328,0,2808,1005,1803,0,0,0,1.0,1,1.0,1,1.0,1,0.19678216753565309,49
1329,1,2809,1005,1804,0,0,0,1.0,1,1.0,1,1.0,1,0.1584248177592436,50
1330,0,2809,1005,1804,0,0,0,1.0,1,1.0,1,1.0,1,0.1584248177592436,50
1331,4,2813,1006,1807,0,0,0,1.0,1,1.0,1,1.0,1,0.16076317402061022,50
1332,0,2813,1006,1807,0,0,0,1.0,1,1.0,1,1.0,1,0.15215809944411346,51
1333,1,2814,1007,1807,0,0,0,1.0,1,1.0,1,1.0,1,0.1674692042673707,52
1334,2,2816,1007,1809,0,0,0,1.0,1,1.0,1,1.0,1,0.16457199957948604,54
1335,0,2816,1007,1809,0,0,0,1.0,1,1.0,1,1.0,1,0.16457199957948604,54
1336,2,2818,1007,1811,0,0,0,1.0,1,1.0,1,1.0,1,0.13467853024186163,56
1337,2,2820,1008,1812,0,0,0,1.0,1,1.0,1,1.0,1,0.17591746156146282,57
1338,3,2823,1009,1814,0,0,0,1.0,1,1.0,1,1.0,1,0.18261193275138388,57
1339,5,2828,1011,1817,0,0,0,1.0,1,1.0,1,1.0,1,0.22632581144501676,58
1340,9,2837,1012,1825,0,0,0,1.0,1,1.0,1,1.0,1,0.22275242841015058,59
1341,5,2842,1013,1829,0,0,0,1.0,1,1.0,1,1.0,1,0.1541812004696569,57
1342,5,2847,1016,1831,0,0,0,1.0,1,1.0,1,1.0,1,0.17491341592227963,57
1343,0,2847,1016,1831,0,0,0,1.0,1,1.0,1,1.0,1,0.1582173233952805,55
1344,3,2850,1019,1831,0,0,0,1.0,1,1.0,1,1.0,1,0.18362041541101998,54
1345,0,2850,1019,1831,0,0,0,1.0,1,1.0,1,1.0,1,0.18234558361921738,53
1346,2,2852,1019,1833,0,0,0,1.0,1,1.0,1,1.0,1,0.14077688477590755,53
1347,1,2853,1019,1834,0,0,0,1.0,1,1.0,1,1.0,1,0.1524770906992351,51
1348,2,2855,1021,1834,0,0,0,1.0,1,1.0,1,1.0,1,0.1557450098079937,52
1349,0,2855,1021,1834,0,0,0,1.0,1,1.0,1,1.0,1,0.16837182029200268,50
1350,4,2859,1023,1836,0,0,0,1.0,1,1.0,1,1.0,1,0.14685916854064812,51
1351,4,2863,1024,1839,0,0,0,1.0,1,1.0,1,1.0,1,0.11204391089537381,50
1352,0,2863,1024,1839,0,0,0,1.0,1,1.0,1,1.0,1,0.10557898681073619,50
1353,2,2865,1025,1840,0,0,0,1.0,1,1.0,1,1.0,1,0.09564592280440706,50
1354,3,2868,1026,1842,0,0,0,1.0,1,1.0,1,1.0,1,0.11788915335967834,51
1355,2,2870,1027,1843,0,0,0,1.0,1,1.0,1,1.0,1,0.102176696727005,53
1356,2,2872,1028,1844,0,0,0,1.0,1,1.0,1,1.0,1,0.09979626208743127,52
1357,2,2874,1029,1845,0,0,0,1.0,1,1.0,1,1.0,1,0.13238515858737226,52
1358,1,2875,1029,1846,0,0,0,1.0,1,1.0,1,1.0,1,0.1390897467038638,53
1359,3,2878,1031,1847,0,0,0,1.0,1,1.0,1,1.0,1,0.19376982870186532,54
1360,2,2880,1031,1849,0,0,0,1.0,1,1.0,1,1.0,1,0.17007399207493723,55
1361,6,2886,1032,1854,0,0,0,1.0,1,1.0,1,1.0,1,0.163714235061558,55
1362,4,2890,1032,1858,0,0,0,1.0,1,1.0,1,1.0,1,0.1307072263839139,56
1363,3,2893,1032,1861,0,0,0,1.0,1,1.0,1,1.0,1,0.14125942618634077,56
1364,4,2897,1032,1865,0,0,0,1.0,1,1.0,1,1.0,1,0.11651522440170715,55
1365,5,2902,1033,1869,0,0,0,1.0,1,1.0,1,1.0,1,0.1278121601839101,56
1366,4,2906,1034,1872,0,0,0,1.0,1,1.0,1,1.0,1,0.10612703494105225,57
1367,4,2910,1034,1876,0,0,0,1.0,1,1.0,1,1.0,1,0.11109775857872915,57
1368,2,2912,1035,1877,0,0,0,1.0,1,1.0,1,1.0,1,0.11136406937791317,58
1369,5,2917,1037,1880,0,0,0,1.0,1,1.0,1,1.0,1,0.11765647859445692,59
1370,3,2920,1038,1882,0,0,0,1.0,1,1.0,1,1.0,1,0.12139860541386169,60
1371,2,2922,1038,1884,0,0,0,1.0,1,1.0,1,1.0,1,0.09823239536833679,59
1372,2,2924,1040,1884,0,0,0,1.0,1,1.0,1,1.0,1,0.1333963447462503,59
1373,1,2925,1040,1885,0,0,0,1.0,1,1.0,1,1.0,1,0.1141001767230071,59
1374,0,2925,1040,1885,0,0,0,1.0,1,1.0,1,1.0,1,0.1141001767230071,59
1375,1,2926,1040,1886,0,0,0,1.0,1,1.0,1,1.0,1,0.1209069344210426,62
1376,6,2932,1042,1890,0,0,0,1.0,1,1.0,1,1.0,1,0.12262747440435923,61
1377,2,2934,1044,1890,0,0,0,1.0,1,1.0,1,1.0,1,0.12492378828184549,63
1378,1,2935,1045,1890,0,0,0,1.0,1,1.0,1,1.0,1,0.1711939834040716,62
1379,4,2939,1046,1893,0,0,0,1.0,1,1.0,1,1.0,1,0.17897919658977623,61
1380,0,2939,1046,1893,0,0,0,1.0,1,1.0,1,1.0,1,0.1690993332912556,60
1381,3,2942,1046,1896,0,0,0,1.0,1,1.0,1,1.0,1,0.15474692835532422,58
1382,5,2947,1049,1898,0,0,0,1.0,1,1.0,1,1.0,1,0.11582396811318682,56
1383,2,2949,1050,1899,0,0,0,1.0,1,1.0,1,1.0,1,0.11272514125642606,57
1384,1,2950,1050,1900,0,0,0,1.0,1,1.0,1,1.0,1,0.13562537944522116,55
1385,3,2953,1051,1902,0,0,0,1.0,1,1.0,1,1.0,1,0.14284347237115527,55
1386,6,2959,1052,1907,0,0,0,1.0,1,1.0,1,1.0,1,0.07588975415164129,54
1387,1,2960,1053,1907,0,0,0,1.0,1,1.0,1,1.0,1,0.08998214656009186,53
1388,2,2962,1055,1907,0,0,0,1.0,1,1.0,1,1.0,1,0.12116962550545986,52
1389,3,2965,1055,1910,0,0,0,1.0,1,1.0,1,1.0,1,0.13611263103587046,52
1390,1,2966,1055,1911,0,0,0,1.0,1,1.0,1,1.0,1,0.14019243095919914,51
1391,2,2968,1055,1913,0,0,0,1.0,1,1.0,1,1.0,1,0.11933171702998245,52
1392,1,2969,1056,1913,0,0,0,1.0,1,1.0,1,1.0,1,0.10930083406305757,51
1393,1,2970,1057,1913,0,0,0,1.0,1,1.0,1,1.0,1,0.13416058311849574,51
1394,3,2973,1057,1916,0,0,0,1.0,1,1.0,1,1.0,1,0.1284040756673658,52
1395,0,2973,1057,1916,0,0,0,1.0,1,1.0,1,1.0,1,0.1284040756673658,52
1396,3,2976,1059,1917,0,0,0,1.0,1,1.0,1,1.0,1,0.13896696135230013,53
1397,3,2979,1059,1920,0,0,0,1.0,1,1.0,1,1.0,1,0.1378859206763531,56
1398,3,2982,1060,1922,0,0,0,1.0,1,1.0,1,1.0,1,0.14893894838306962,56
1399,1,2983,1060,1923,0,0,0,1.0,1,1.0,1,1.0,1,0.14437542137657708,57
1400,1,2984,1060,1924,0,0,0,1.0,1,1.0,1,1.0,1,0.14184469116303886,57
1401,4,2988,1060,1928,0,0,0,1.0,1,1.0,1,1.0,1,0.12977823656249582,57
1402,2,2990,1061,1929,0,0,0,1.0,1,1.0,1,1.0,1,0.14060915608754926,57
1403,1,2991,1061,1930,0,0,0,1.0,1,1.0,1,1.0,1,0.1405986413995718,56
1404,2,2993,1061,1932,0,0,0,1.0,1,1.0,1,1.0,1,0.12382608249349922,58
1405,3,2996,1062,1934,0,0,0,1.0,1,1.0,1,1.0,1,0.1650144122142212,58
1406,2,2998,1062,1936,0,0,0,1.0,1,1.0,1,1.0,1,0.15364766833166982,58
1407,0,2998,1062,1936,0,0,0,1.0,1,1.0,1,1.0,1,0.17021409524592915,57
1408,0,2998,1062,1936,0,0,0,1.0,1,1.0,1,1.0,1,0.18360010960352674,58
1409,0,2998,1062,1936,0,0,0,1.0,1,1.0,1,1.0,1,0.18154252966497592,57
1410,0,2998,1062,1936,0,0,0,1.0,1,1.0,1,1.0,1,0.18154252966497592,57
1411,1,2999,1062,1937,0,0,0,1.0,1,1.0,1,1.0,1,0.18463398094424027,56
1412,0,2999,1062,1937,0,0,0,1.0,1,1.0,1,1.0,1,0.18882028503056358,55
1413,0,2999,1062,1937,0,0,0,1.0,1,1.0,1,1.0,1,0.19384938328802395,57
1414,0,2999,1062,1937,0,0,0,1.0,1,1.0,1,1.0,1,0.19384938328802395,57
1415,4,3003,1063,1940,0,0,0,1.0,1,1.0,1,1.0,1,0.16818578386653382,60
1416,8,3011,1065,1946,0,0,0,1.0,1,1.0,1,1.0,1,0.12222291553771755,61
1417,3,3014,1066,1948,0,0,0,1.0,1,1.0,1,1.0,1,0.12119557902916317,59
1418,3,3017,1067,1950,0,0,0,1.0,1,1.0,1,1.0,1,0.11773956592782554,60
1419,4,3021,1068,1953,0,0,0,1.0,1,1.0,1,1.0,1,0.11703922305219902,59
1420,3,3024,1068,1956,0,0,0,1.0,1,1.0,1,1.0,1,0.1289064351423449,58
1421,0,3024,1068,1956,0,0,0,1.0,1,1.0,1,1.0,1,0.11414019397689093,57
1422,2,3026,1069,1957,0,0,0,1.0,1,1.0,1,1.0,1,0.11312852242126227,57
1423,2,3028,1070,1958,0,0,0,1.0,1,1.0,1,1.0,1,0.1011670108990325,56
1424,1,3029,1071,1958,0,0,0,1.0,1,1.0,1,1.0,1,0.10685021045587707,57
1425,1,3030,1072,1958,0,0,0,1.0,1,1.0,1,1.0,1,0.10904815256931964,54
1426,6,3036,1074,1962,0,0,0,1.0,1,1.0,1,1.0,1,0.07739235793045184,54
1427,4,3040,1077,1963,0,0,0,1.0,1,1.0,1,1.0,1,0.1267670811080886,53
1428,0,3040,1077,1963,0,0,0,1.0,1,1.0,1,1.0,1,0.13160253761598775,52
1429,1,3041,1078,1963,0,0,0,1.0,1,1.0,1,1.0,1,0.12647228552054507,52
1430,4,3045,1081,1964,0,0,0,1.0,1,1.0,1,1.0,1,0.18811851207244554,51
1431,9,3054,1081,1973,0,0,0,1.0,1,1.0,1,1.0,1,0.13594463258458178,51
1432,3,3057,1082,1975,0,0,0,1.0,1,1.0,1,1.0,1,0.12990965951828437,52
1433,5,3062,1083,1979,0,0,0,1.0,1,1.0,1,1.0,1,0.1262340368040035,52
1434,6,3068,1085,1983,0,0,0,1.0,1,1.0,1,1.0,1,0.13856068701965266,52
1435,2,3070,1087,1983,0,0,0,1.0,1,1.0,1,1.0,1,0.17267879918332385,50
1436,5,3075,1089,1986,0,0,0,1.0,1,1.0,1,1.0,1,0.11208085703285794,50
1437,1,3076,1089,1987,0,0,0,1.0,1,1.0,1,1.0,1,0.11786705861564636,49
1438,3,3079,1092,1987,0,0,0,1.0,1,1.0,1,1.0,1,0.15405314026191136,49
1439,5,3084,1094,1990,0,0,0,1.0,1,1.0,1,1.0,1,0.1966124453600597,50
1440,9,3093,1096,1997,0,0,0,1.0,1,1.0,1,1.0,1,0.21820849329468553,50
1441,2,3095,1096,1999,0,0,0,1.0,1,1.0,1,1.0,1,0.19136100152712635,51
1442,0,3095,1096,1999,0,0,0,1.0,1,1.0,1,1.0,1,0.21564511411526358,50
1443,3,3098,1096,2002,0,0,0,1.0,1,1.0,1,1.0,1,0.20255044935733063,51
1444,2,3100,1096,2004,0,0,0,1.0,1,1.0,1,1.0,1,0.20255044935733063,51
1445,3,3103,1096,2007,0,0,0,1.0,1,1.0,1,1.0,1,0.1729139237311006,51
1446,1,3104,1096,2008,0,0,0,1.0,1,1.0,1,1.0,1,0.16440370545495867,51
1447,1,3105,1096,2009,0,0,0,1.0,1,1.0,1,1.0,1,0.147425436640767,51
1448,1,3106,1096,2010,0,0,0,1.0,1,1.0,1,1.0,1,0.14051643820946913,51
1449,1,3107,1096,2011,0,0,0,1.0,1,1.0,1,1.0,1,0.1323850069569474,51
1450,1,3108,1096,2012,0,0,0,1.0,1,1.0,1,1.0,1,0.11906518890217405,52
1451,2,3110,1096,2014,0,0,0,1.0,1,1.0,1,1.0,1,0.10157298663418238,54
1452,3,3113,1096,2017,0,0,0,1.0,1,1.0,1,1.0,1,0.1167649717761437,56
1453,2,3115,1096,2019,0,0,0,1.0,1,1.0,1,1.0,1,0.1077427894806117,56
1454,4,3119,1097,2022,0,0,0,1.0,1,1.0,1,1.0,1,0.1205946157814191,58
1455,4,3123,1099,2024,0,0,0,1.0,1,1.0,1,1.0,1,0.1685213210488768,55
1456,3,3126,1099,2027,0,0,0,1.0,1,1.0,1,1.0,1,0.1428866398622826,56
1457,2,3128,1100,2028,0,0,0,1.0,1,1.0,1,1.0,1,0.17729122311241333,54
1458,3,3131,1102,2029,0,0,0,1.0,1,1.0,1,1.0,1,0.19895705085556073,52
1459,3,3134,1102,2032,0,0,0,1.0,1,1.0,1,1.0,1,0.1670562124093224,52
1460,0,3134,1102,2032,0,0,0,1.0,1,1.0,1,1.0,1,0.15913914023625322,50
1461,3,3137,1103,2034,0,0,0,1.0,1,1.0,1,1.0,1,0.1557027466992108,53
1462,7,3144,1107,2037,0,0,0,1.0,1,1.0,1,1.0,1,0.1463843927542222,51
1463,4,3148,1107,2041,0,0,0,1.0,1,1.0,1,1.0,1,0.16505576544383146,51
1464,2,3150,1108,2042,0,0,0,1.0,1,1.0,1,1.0,1,0.2036654249570445,51
1465,2,3152,1108,2044,0,0,0,1.0,1,1.0,1,1.0,1,0.23886992932922868,49
1466,8,3160,1111,2049,0,0,0,1.0,1,1.0,1,1.0,1,0.20075153717796587,49
1467,5,3165,1113,2052,0,0,0,1.0,1,1.0,1,1.0,1,0.1947340396929297,47
1468,3,3168,1114,2054,0,0,0,1.0,1,1.0,1,1.0,1,0.18272543853858686,48
1469,6,3174,1116,2058,0,0,0,1.0,1,1.0,1,1.0,1,0.20319976387208594,47
1470,8,3182,1116,2066,0,0,0,1.0,1,1.0,1,1.0,1,0.15589174192072144,49
1471,3,3185,1116,2069,0,0,0,1.0,1,1.0,1,1.0,1,0.16045819254517527,48
1472,2,3187,1116,2071,0,0,0,1.0,1,1.0,1,1.0,1,0.13240740552620492,48
1473,0,3187,1116,2071,0,0,0,1.0,1,1.0,1,1.0,1,0.14440087573737098,49
1474,0,3187,1116,2071,0,0,0,1.0,1,1.0,1,1.0,1,0.14440087573737098,49
1475,0,3187,1116,2071,0,0,0,1.0,1,1.0,1,1.0,1,0.14440087573737098,49
1476,2,3189,1117,2072,0,0,0,1.0,1,1.0,1,1.0,1,0.14363316955583796,51
1477,1,3190,1117,2073,0,0,0,1.0,1,1.0,1,1.0,1,0.1220218327645483,51
1478,1,3191,1117,2074,0,0,0,1.0,1,1.0,1,1.0,1,0.09438566055514193,52
1479,2,3193,1118,2075,0,0,0,1.0,1,1.0,1,1.0,1,0.1363158404062327,53
1480,1,3194,1119,2075,0,0,0,1.0,1,1.0,1,1.0,1,0.15649411579061248,53
1481,2,3196,1119,2077,0,0,0,1.0,1,1.0,1,1.0,1,0.13320511445227945,53
1482,0,3196,1119,2077,0,0,0,1.0,1,1.0,1,1.0,1,0.15068454998679762,52
1483,1,3197,1119,2078,0,0,0,1.0,1,1.0,1,1.0,1,0.13097809849102432,52
1484,2,3199,1119,2080,0,0,0,1.0,1,1.0,1,1.0,1,0.14417540870813883,53
1485,1,3200,1119,2081,0,0,0,1.0,1,1.0,1,1.0,1,0.12155889576664954,53
1486,2,3202,1119,2083,0,0,0,1.0,1,1.0,1,1.0,1,0.13568075507952385,54
1487,3,3205,1119,2086,0,0,0,1.0,1,1.0,1,1.0,1,0.14146161149227177,55
1488,2,3207,1119,2088,0,0,0,1.0,1,1.0,1,1.0,1,0.14332595857485667,57
1489,1,3208,1120,2088,0,0,0,1.0,1,1.0,1,1.0,1,0.1314660047679322,58
1490,1,3209,1121,2088,0,0,0,1.0,1,1.0,1,1.0,1,0.13636547410157654,58
1491,3,3212,1122,2090,0,0,0,1.0,1,1.0,1,1.0,1,0.13646619816303734,59
1492,1,3213,1123,2090,0,0,0,1.0,1,1.0,1,1.0,1,0.16849297980384847,59
1493,4,3217,1125,2092,0,0,0,1.0,1,1.0,1,1.0,1,0.15650350477614197,58
1494,6,3223,1127,2096,0,0,0,1.0,1,1.0,1,1.0,1,0.16893848331002922,58
1495,5,3228,1129,2099,0,0,0,1.0,1,1.0,1,1.0,1,0.18560237300575955,57
1496,5,3233,1129,2104,0,0,0,1.0,1,1.0,1,1.0,1,0.11197766239975504,59
1497,1,3234,1130,2104,0,0,0,1.0,1,1.0,1,1.0,1,0.12639482328886745,58
1498,1,3235,1130,2105,0,0,0,1.0,1,1.0,1,1.0,1,0.11712319649988792,58
1499,1,3236,1130,2106,0,0,0,1.0,1,1.0,1,1.0,1,0.12346863835744748,56
1500,1,3237,1131,2106,0,0,0,1.0,1,1.0,1,1.0,1,0.11416301309798357,57
1501,3,3240,1131,2109,0,0,0,1.0,1,1.0,1,1.0,1,0.09430270126803383,55
1502,1,3241,1132,2109,0,0,0,1.0,1,1.0,1,1.0,1,0.12204023976687688,55
1503,2,3243,1133,2110,0,0,0,1.0,1,1.0,1,1.0,1,0.13323332553838432,54
1504,3,3246,1135,2111,0,0,0,1.0,1,1.0,1,1.0,1,0.12047863363101613,55
1505,3,3249,1137,2112,0,0,0,1.0,1,1.0,1,1.0,1,0.09858651699597581,53
1506,7,3256,1139,2117,0,0,0,1.0,1,1.0,1,1.0,1,0.1125983491927657,55
1507,1,3257,1140,2117,0,0,0,1.0,1,1.0,1,1.0,1,0.12304287433785446,53
1508,3,3260,1142,2118,0,0,0,1.0,1,1.0,1,1.0,1,0.1395917186638015,53
1509,0,3260,1142,2118,0,0,0,1.0,1,1.0,1,1.0,1,0.11999796591362287,52
1510,2,3262,1143,2119,0,0,0,1.0,1,1.0,1,1.0,1,0.12712083628076856,50
1511,3,3265,1144,2121,0,0,0,1.0,1,1.0,1,1.0,1,0.10608290783043385,49
1512,4,3269,1147,2122,0,0,0,1.0,1,1.0,1,1.0,1,0.14641258632539045,48
1513,2,3271,1148,2123,0,0,0,1.0,1,1.0,1,1.0,1,0.175638881724335,47
1514,2,3273,1149,2124,0,0,0,1.0,1,1.0,1,1.0,1,0.1446261895429261,48
1515,2,3275,1150,2125,0,0,0,1.0,1,1.0,1,1.0,1,0.14530536409101064,48
1516,2,3277,1150,2127,0,0,0,1.0,1,1.0,1,1.0,1,0.12927750895901086,47
1517,0,3277,1150,2127,0,0,0,1.0,1,1.0,1,1.0,1,0.1479076004057395,48
1518,0,3277,1150,2127,0,0,0,1.0,1,1.0,1,1.0,1,0.1479076004057395,48
1519,0,3277,1150,2127,0,0,0,1.0,1,1.0,1,1.0,1,0.16361088700813584,47
1520,5,3282,1153,2129,0,0,0,1.0,1,1.0,1,1.0,1,0.16013233191915746,48
1521,3,3285,1153,2132,0,0,0,1.0,1,1.0,1,1.0,1,0.1183768643915966,49
1522,1,3286,1154,2132,0,0,0,1.0,1,1.0,1,1.0,1,0.1398199977069851,48
1523,1,3287,1155,2132,0,0,0,1.0,1,1.0,1,1.0,1,0.1356865759164705,49
1524,0,3287,1155,2132,0,0,0,1.0,1,1.0,1,1.0,1,0.1356865759164705,49
1525,2,3289,1155,2134,0,0,0,1.0,1,1.0,1,1.0,1,0.11970184416245258,51
1526,2,3291,1155,2136,0,0,0,1.0,1,1.0,1,1.0,1,0.08097027566349944,52
1527,2,3293,1156,2137,0,0,0,1.0,1,1.0,1,1.0,1,0.11805052864221015,54
1528,1,3294,1157,2137,0,0,0,1.0,1,1.0,1,1.0,1,0.13799852978958588,54
1529,0,3294,1157,2137,0,0,0,1.0,1,1.0,1,1.0,1,0.13799852978958588,54
1530,0,3294,1157,2137,0,0,0,1.0,1,1.0,1,1.0,1,0.16021333798080178,54
1531,4,3298,1157,2141,0,0,0,1.0,1,1.0,1,1.0,1,0.1209433949212776,54
1532,2,3300,1158,2142,0,0,0,1.0,1,1.0,1,1.0,1,0.1131166435719284,54
1533,0,3300,1158,2142,0,0,0,1.0,1,1.0,1,1.0,1,0.11053050673148652,54
1534,1,3301,1158,2143,0,0,0,1.0,1,1.0,1,1.0,1,0.09734299431407711,54
1535,1,3302,1158,2144,0,0,0,1.0,1,1.0,1,1.0,1,0.09080325014906933,54
1536,0,3302,1158,2144,0,0,0,1.0,1,1.0,1,1.0,1,0.094249768899919,55
1537,1,3303,1159,2144,0,0,0,1.0,1,1.0,1,1.0,1,0.10514094446439524,53
1538,1,3304,1160,2144,0,0,0,1.0,1,1.0,1,1.0,1,0.11799920803392114,54
1539,3,3307,1161,2146,0,0,0,1.0,1,1.0,1,1.0,1,0.14400043062981815,54
1540,2,3309,1162,2147,0,0,0,1.0,1,1.0,1,1.0,1,0.14641696174938168,54
1541,7,3316,1162,2154,0,0,0,1.0,1,1.0,1,1.0,1,0.08934978043343011,54
1542,4,3320,1164,2156,0,0,0,1.0,1,1.0,1,1.0,1,0.08831235056854694,57
1543,2,3322,1166,2156,0,0,0,1.0,1,1.0,1,1.0,1,0.10002397812650532,55
1544,5,3327,1169,2158,0,0,0,1.0,1,1.0,1,1.0,1,0.1532008854985306,54
1545,5,3332,1170,2162,0,0,0,1.0,1,1.0,1,1.0,1,0.13262164330377965,54
1546,3,3335,1170,2165,0,0,0,1.0,1,1.0,1,1.0,1,0.08777599326652852,53
1547,4,3339,1173,2166,0,0,0,1.0,1,1.0,1,1.0,1,0.09811834723783952,53
1548,2,3341,1175,2166,0,0,0,1.0,1,1.0,1,1.0,1,0.11781940203709082,54
1549,4,3345,1177,2168,0,0,0,1.0,1,1.0,1,1.0,1,0.09439306221044916,52
1550,8,3353,1181,2172,0,0,0,1.0,1,1.0,1,1.0,1,0.12113032961476111,52
1551,8,3361,1184,2177,0,0,0,1.0,1,1.0,1,1.0,1,0.06298379201899097,52
1552,7,3368,1188,2180,0,0,0,1.0,1,1.0,1,1.0,1,0.07884321396867917,51
1553,7,3375,1190,2185,0,0,0,1.0,1,1.0,1,1.0,1,0.16738945814901948,51
1554,7,3382,1194,2188,0,0,0,1.0,1,1.0,1,1.0,1,0.14645566210426578,51
1555,5,3387,1195,2192,0,0,0,1.0,1,1.0,1,1.0,1,0.18735994504878012,50
1556,7,3394,1196,2198,0,0,0,1.0,1,1.0,1,1.0,1,0.10944343791555071,51
1557,6,3400,1198,2202,0,0,0,1.0,1,1.0,1,1.0,1,0.13217602750544222,51
1558,6,3406,1198,2208,0,0,0,1.0,1,1.0,1,1.0,1,0.1091902182210891,52
1559,6,3412,1200,2212,0,0,0,1.0,1,1.0,1,1.0,1,0.11326165381279538,53
1560,3,3415,1201,2214,0,0,0,1.0,1,1.0,1,1.0,1,0.11687804670763503,51
1561,1,3416,1201,2215,0,0,0,1.0,1,1.0,1,1.0,1,0.10603456114667197,51
1562,0,3416,1201,2215,0,0,0,1.0,1,1.0,1,1.0,1,0.11599945612391145,52
1563,2,3418,1202,2216,0,0,0,1.0,1,1.0,1,1.0,1,0.08324000751760839,52
1564,0,3418,1202,2216,0,0,0,1.0,1,1.0,1,1.0,1,0.10298022980911631,51
1565,1,3419,1203,2216,0,0,0,1.0,1,1.0,1,1.0,1,0.11574903353065695,53
1566,4,3423,1203,2220,0,0,0,1.0,1,1.0,1,1.0,1,0.10877460907963146,53
1567,0,3423,1203,2220,0,0,0,1.0,1,1.0,1,1.0,1,0.104026113342383,52
1568,1,3424,1203,2221,0,0,0,1.0,1,1.0,1,1.0,1,0.09460776685825487,52
1569,0,3424,1203,2221,0,0,0,1.0,1,1.0,1,1.0,1,0.11057644092661541,49
1570,1,3425,1204,2221,0,0,0,1.0,1,1.0,1,1.0,1,0.12414891923221838,48
1571,8,3433,1207,2226,0,0,0,1.0,1,1.0,1,1.0,1,0.11663719506625163,46
1572,0,3433,1207,2226,0,0,0,1.0,1,1.0,1,1.0,1,0.11733851970698037,47
1573,0,3433,1207,2226,0,0,0,1.0,1,1.0,1,1.0,1,0.10840350527213644,48
1574,4,3437,1211,2226,0,0,0,1.0,1,1.0,1,1.0,1,0.18103749973069203,46
1575,4,3441,1211,2230,0,0,0,1.0,1,1.0,1,1.0,1,0.16396198951515734,47
1576,8,3449,1214,2235,0,0,0,1.0,1,1.0,1,1.0,1,0.10951481710739891,46
1577,1,3450,1215,2235,0,0,0,1.0,1,1.0,1,1.0,1,0.15710554561603113,45
1578,2,3452,1215,2237,0,0,0,1.0,1,1.0,1,1.0,1,0.11767697305147325,44
1579,0,3452,1215,2237,0,0,0,1.0,1,1.0,1,1.0,1,0.11849470996514096,43
1580,1,3453,1216,2237,0,0,0,1.0,1,1.0,1,1.0,1,0.13290388131570532,43
1581,5,3458,1217,2241,0,0,0,1.0,1,1.0,1,1.0,1,0.14341054758955338,42
1582,1,3459,1217,2242,0,0,0,1.0,1,1.0,1,1.0,1,0.13808936813460473,42
1583,2,3461,1218,2243,0,0,0,1.0,1,1.0,1,1.0,1,0.14097303889318963,43
1584,3,3464,1220,2244,0,0,0,1.0,1,1.0,1,1.0,1,0.14146380818155554,41
1585,4,3468,1222,2246,0,0,0,1.0,1,1.0,1,1.0,1,0.1740540778951442,43
1586,4,3472,1224,2248,0,0,0,1.0,1,1.0,1,1.0,1,0.13811182818124515,42
1587,3,3475,1225,2250,0,0,0,1.0,1,1.0,1,1.0,1,0.1329168511117245,42
1588,9,3484,1229,2255,0,0,0,1.0,1,1.0,1,1.0,1,0.13179948562621405,42
1589,4,3488,1230,2258,0,0,0,1.0,1,1.0,1,1.0,1,0.08205546460117132,42
1590,1,3489,1231,2258,0,0,0,1.0,1,1.0,1,1.0,1,0.14449360165644556,41
1591,2,3491,1232,2259,0,0,0,1.0,1,1.0,1,1.0,1,0.12396316864794052,40
1592,2,3493,1232,2261,0,0,0,1.0,1,1.0,1,1.0,1,0.12334287718263767,39
1593,0,3493,1232,2261,0,0,0,1.0,1,1.0,1,1.0,1,0.12992302268430483,39
1594,0,3493,1232,2261,0,0,0,1.0,1,1.0,1,1.0,1,0.12117006511767282,39
1595,2,3495,1233,2262,0,0,0,1.0,1,1.0,1,1.0,1,0.12557408260703737,42
1596,1,3496,1233,2263,0,0,0,1.0,1,1.0,1,1.0,1,0.12932177236583373,41
1597,1,3497,1234,2263,0,0,0,1.0,1,1.0,1,1.0,1,0.1422610983822254,41
1598,1,3498,1235,2263,0,0,0,1.0,1,1.0,1,1.0,1,0.1683109620568892,39
1599,0,3498,1235,2263,0,0,0,1.0,1,1.0,1,1.0,1,0.1683109620568892,39
1600,4,3502,1237,2265,0,0,0,1.0,1,1.0,1,1.0,1,0.1904073911605,40
1601,6,3508,1239,2269,0,0,0,1.0,1,1.0,1,1.0,1,0.21845068138006743,41
1602,3,3511,1240,2271,0,0,0,1.0,1,1.0,1,1.0,1,0.19604266579445884,41
1603,6,3517,1241,2276,0,0,0,1.0,1,1.0,1,1.0,1,0.17485306535183415,43
1604,2,3519,1241,2278,0,0,0,1.0,1,1.0,1,1.0,1,0.17485306535183415,43
1605,2,3521,1242,2279,0,0,0,1.0,1,1.0,1,1.0,1,0.18582567206842376,44
1606,5,3526,1243,2283,0,0,0,1.0,1,1.0,1,1.0,1,0.11370959710074051,44
1607,2,3528,1244,2284,0,0,0,1.0,1,1.0,1,1.0,1,0.11955478436266381,42
1608,2,3530,1246,2284,0,0,0,1.0,1,1.0,1,1.0,1,0.19095495256270018,41
1609,1,3531,1246,2285,0,0,0,1.0,1,1.0,1,1.0,1,0.12104856763257464,39
1610,0,3531,1246,2285,0,0,0,1.0,1,1.0,1,1.0,1,0.15189563062832592,39
1611,1,3532,1246,2286,0,0,0,1.0,1,1.0,1,1.0,1,0.1323248496796027,40
1612,1,3533,1246,2287,0,0,0,1.0,1,1.0,1,1.0,1,0.12597319021207684,39
1613,1,3534,1247,2287,0,0,0,1.0,1,1.0,1,1.0,1,0.1807225729478469,41
1614,0,3534,1247,2287,0,0,0,1.0,1,1.0,1,1.0,1,0.1807225729478469,41
1615,1,3535,1248,2287,0,0,0,1.0,1,1.0,1,1.0,1,0.17248424728115266,41
1616,3,3538,1248,2290,0,0,0,1.0,1,1.0,1,1.0,1,0.14599828019044908,43
1617,2,3540,1249,2291,0,0,0,1.0,1,1.0,1,1.0,1,0.1571916650905915,44
1618,0,3540,1249,2291,0,0,0,1.0,1,1.0,1,1.0,1,0.1571916650905915,44
1619,0,3540,1249,2291,0,0,0,1.0,1,1.0,1,1.0,1,0.17865433718049184,44
1620,0,3540,1249,2291,0,0,0,1.0,1,1.0,1,1.0,1,0.19246794428039252,45
1621,3,3543,1249,2294,0,0,0,1.0,1,1.0,1,1.0,1,0.12959652029692925,44
1622,1,3544,1250,2294,0,0,0,1.0,1,1.0,1,1.0,1,0.15363654365900323,44
1623,2,3546,1251,2295,0,0,0,1.0,1,1.0,1,1.0,1,0.13712587326864942,43
1624,3,3549,1252,2297,0,0,0,1.0,1,1.0,1,1.0,1,0.08196762101799003,43
1625,6,3555,1255,2300,0,0,0,1.0,1,1.0,1,1.0,1,0.08666031907327079,43
1626,2,3557,1256,2301,0,0,0,1.0,1,1.0,1,1.0,1,0.12322061503166495,42
1627,0,3557,1256,2301,0,0,0,1.0,1,1.0,1,1.0,1,0.1227453077655307,42
1628,1,3558,1257,2301,0,0,0,1.0,1,1.0,1,1.0,1,0.15196140401059224,42
1629,0,3558,1257,2301,0,0,0,1.0,1,1.0,1,1.0,1,0.1598376853659082,41
1630,5,3563,1260,2303,0,0,0,1.0,1,1.0,1,1.0,1,0.15362836777411953,41
1631,5,3568,1261,2307,0,0,0,1.0,1,1.0,1,1.0,1,0.11415233426477488,40
1632,1,3569,1261,2308,0,0,0,1.0,1,1.0,1,1.0,1,0.11671376251971714,39
1633,0,3569,1261,2308,0,0,0,1.0,1,1.0,1,1.0,1,0.11671376251971714,39
1634,1,3570,1261,2309,0,0,0,1.0,1,1.0,1,1.0,1,0.1069497122729542,39
1635,2,3572,1261,2311,0,0,0,1.0,1,1.0,1,1.0,1,0.12617675131989534,40
1636,2,3574,1261,2313,0,0,0,1.0,1,1.0,1,1.0,1,0.09772636156666817,41
1637,1,3575,1262,2313,0,0,0,1.0,1,1.0,1,1.0,1,0.1292661744748352,41
1638,3,3578,1263,2315,0,0,0,1.0,1,1.0,1,1.0,1,0.08465130657267878,42
1639,2,3580,1264,2316,0,0,0,1.0,1,1.0,1,1.0,1,0.12603614820751283,43
1640,2,3582,1265,2317,0,0,0,1.0,1,1.0,1,1.0,1,0.118379867354086,43
1641,3,3585,1266,2319,0,0,0,1.0,1,1.0,1,1.0,1,0.07988697030690503,44
1642,4,3589,1269,2320,0,0,0,1.0,1,1.0,1,1.0,1,0.13698151966843902,45
1643,3,3592,1270,2322,0,0,0,1.0,1,1.0,1,1.0,1,0.11939789916988632,44
1644,1,3593,1271,2322,0,0,0,1.0,1,1.0,1,1.0,1,0.09559335770520837,45
1645,0,3593,1271,2322,0,0,0,1.0,1,1.0,1,1.0,1,0.10561902363226561,44
1646,5,3598,1273,2325,0,0,0,1.0,1,1.0,1,1.0,1,0.11803951285075731,43
1647,2,3600,1274,2326,0,0,0,1.0,1,1.0,1,1.0,1,0.14172436426088172,43
1648,0,3600,1274,2326,0,0,0,1.0,1,1.0,1,1.0,1,0.17134985827763188,42
1649,0,3600,1274,2326,0,0,0,1.0,1,1.0,1,1.0,1,0.19799777121378073,41
1650,0,3600,1274,2326,0,0,0,1.0,1,1.0,1,1.0,1,0.19799777121378073,41
1651,4,3604,1276,2328,0,0,0,1.0,1,1.0,1,1.0,1,0.15955140310519814,40
1652,1,3605,1276,2329,0,0,0,1.0,1,1.0,1,1.0,1,0.14896734225695882,39
1653,1,3606,1276,2330,0,0,0,1.0,1,1.0,1,1.0,1,0.17269207702927905,39
1654,0,3606,1276,2330,0,0,0,1.0,1,1.0,1,1.0,1,0.17269207702927905,39
1655,6,3612,1279,2333,0,0,0,1.0,1,1.0,1,1.0,1,0.24928215966981293,40
1656,5,3617,1279,2338,0,0,0,1.0,1,1.0,1,1.0,1,0.18565803487026508,40
1657,0,3617,1279,2338,0,0,0,1.0,1,1.0,1,1.0,1,0.18565803487026508,40
1658,2,3619,1280,2339,0,0,0,1.0,1,1.0,1,1.0,1,0.18589962263732682,40
1659,2,3621,1281,2340,0,0,0,1.0,1,1.0,1,1.0,1,0.17670638424450516,40
1660,3,3624,1281,2343,0,0,0,1.0,1,1.0,1,1.0,1,0.13633921782478903,41
1661,4,3628,1284,2344,0,0,0,1.0,1,1.0,1,1.0,1,0.15510549975666632,42
1662,2,3630,1284,2346,0,0,0,1.0,1,1.0,1,1.0,1,0.1321568914896385,44
1663,1,3631,1285,2346,0,0,0,1.0,1,1.0,1,1.0,1,0.15324080403131038,43
1664,3,3634,1287,2347,0,0,0,1.0,1,1.0,1,1.0,1,0.1585912444813118,42
1665,1,3635,1288,2347,0,0,0,1.0,1,1.0,1,1.0,1,0.16629261671409581,42
1666,6,3641,1290,2351,0,0,0,1.0,1,1.0,1,1.0,1,0.11256123779196396,43
1667,3,3644,1293,2351,0,0,0,1.0,1,1.0,1,1.0,1,0.1624653211894962,40
1668,1,3645,1294,2351,0,0,0,1.0,1,1.0,1,1.0,1,0.15343376806042075,40
1669,0,3645,1294,2351,0,0,0,1.0,1,1.0,1,1.0,1,0.1394809741094373,40
1670,1,3646,1295,2351,0,0,0,1.0,1,1.0,1,1.0,1,0.16001309268491243,39
1671,3,3649,1295,2354,0,0,0,1.0,1,1.0,1,1.0,1,0.08689679922511599,39
1672,2,3651,1297,2354,0,0,0,1.0,1,1.0,1,1.0,1,0.11539405763575653,38
1673,0,3651,1297,2354,0,0,0,1.0,1,1.0,1,1.0,1,0.11539405763575653,38
1674,3,3654,1298,2356,0,0,0,1.0,1,1.0,1,1.0,1,0.1444372003132184,38
1675,1,3655,1299,2356,0,0,0,1.0,1,1.0,1,1.0,1,0.13228538095297226,39
1676,0,3655,1299,2356,0,0,0,1.0,1,1.0,1,1.0,1,0.14206348898441756,39
1677,1,3656,1299,2357,0,0,0,1.0,1,1.0,1,1.0,1,0.12197130687447595,40
1678,0,3656,1299,2357,0,0,0,1.0,1,1.0,1,1.0,1,0.1462651396699743,39
1679,3,3659,1300,2359,0,0,0,1.0,1,1.0,1,1.0,1,0.1379503114948568,39
1680,0,3659,1300,2359,0,0,0,1.0,1,1.0,1,1.0,1,0.1437184884889378,40
1681,0,3659,1300,2359,0,0,0,1.0,1,1.0,1,1.0,1,0.12185969144316473,41
1682,0,3659,1300,2359,0,0,0,1.0,1,1.0,1,1.0,1,0.11624290210539015,40
1683,2,3661,1302,2359,0,0,0,1.0,1,1.0,1,1.0,1,0.14139672892281918,43
1684,1,3662,1303,2359,0,0,0,1.0,1,1.0,1,1.0,1,0.1781776349468832,42
1685,2,3664,1304,2360,0,0,0,1.0,1,1.0,1,1.0,1,0.15103069555693985,41
1686,4,3668,1304,2364,0,0,0,1.0,1,1.0,1,1.0,1,0.13824004692779937,39
1687,3,3671,1305,2366,0,0,0,1.0,1,1.0,1,1.0,1,0.12242189885966673,41
1688,2,3673,1307,2366,0,0,0,1.0,1,1.0,1,1.0,1,0.15626957332862162,39
1689,3,3676,1310,2366,0,0,0,1.0,1,1.0,1,1.0,1,0.20991545531871933,37
1690,1,3677,1310,2367,0,0,0,1.0,1,1.0,1,1.0,1,0.20226609931001815,36
1691,3,3680,1311,2369,0,0,0,1.0,1,1.0,1,1.0,1,0.1731786542035697,36
1692,0,3680,1311,2369,0,0,0,1.0,1,1.0,1,1.0,1,0.15500722286406288,34
1693,2,3682,1312,2370,0,0,0,1.0,1,1.0,1,1.0,1,0.14118946943006813,33
1694,1,3683,1313,2370,0,0,0,1.0,1,1.0,1,1.0,1,0.11223192720564575,32
1695,0,3683,1313,2370,0,0,0,1.0,1,1.0,1,1.0,1,0.1287152596282958,32
1696,2,3685,1314,2371,0,0,0,1.0,1,1.0,1,1.0,1,0.15077253470054075,34
1697,1,3686,1315,2371,0,0,0,1.0,1,1.0,1,1.0,1,0.18706959273927848,34
1698,6,3692,1317,2375,0,0,0,1.0,1,1.0,1,1.0,1,0.24171514227899546,36
1699,3,3695,1318,2377,0,0,0,1.0,1,1.0,1,1.0,1,0.26586994992134455,36
1700,4,3699,1318,2381,0,0,0,1.0,1,1.0,1,1.0,1,0.2681342760759514,37
1701,5,3704,1318,2386,0,0,0,1.0,1,1.0,1,1.0,1,0.19037525902444552,39
1702,2,3706,1320,2386,0,0,0,1.0,1,1.0,1,1.0,1,0.2332382505185016,39
1703,0,3706,1320,2386,0,0,0,1.0,1,1.0,1,1.0,1,0.2170897328041103,38
1704,2,3708,1322,2386,0,0,0,1.0,1,1.0,1,1.0,1,0.1761093950141533,38
1705,2,3710,1322,2388,0,0,0,1.0,1,1.0,1,1.0,1,0.15101229631804103,37
1706,3,3713,1323,2390,0,0,0,1.0,1,1.0,1,1.0,1,0.11804207293285236,37
1707,3,3716,1325,2391,0,0,0,1.0,1,1.0,1,1.0,1,0.1544831991159484,36
1708,1,3717,1326,2391,0,0,0,1.0,1,1.0,1,1.0,1,0.2286308794526454,34
1709,3,3720,1328,2392,0,0,0,1.0,1,1.0,1,1.0,1,0.237378113900435,34
1710,3,3723,1328,2395,0,0,0,1.0,1,1.0,1,1.0,1,0.28428097221516724,33
1711,3,3726,1329,2397,0,0,0,1.0,1,1.0,1,1.0,1,0.2550131605554349,32
1712,0,3726,1329,2397,0,0,0,1.0,1,1.0,1,1.0,1,0.2687426219895231,31
1713,1,3727,1329,2398,0,0,0,1.0,1,1.0,1,1.0,1,0.22512731444900036,32
1714,0,3727,1329,2398,0,0,0,1.0,1,1.0,1,1.0,1,0.22512731444900036,32
1715,0,3727,1329,2398,0,0,0,1.0,1,1.0,1,1.0,1,0.22512731444900036,32
1716,1,3728,1330,2398,0,0,0,1.0,1,1.0,1,1.0,1,0.2434144074190251,34
1717,5,3733,1331,2402,0,0,0,1.0,1,1.0,1,1.0,1,0.2141071314874504,34
1718,1,3734,1331,2403,0,0,0,1.0,1,1.0,1,1.0,1,0.19430723224170213,34
1719,2,3736,1332,2404,0,0,0,1.0,1,1.0,1,1.0,1,0.21927598611301732,34
1720,0,3736,1332,2404,0,0,0,1.0,1,1.0,1,1.0,1,0.22253145999297513,34
1721,1,3737,1333,2404,0,0,0,1.0,1,1.0,1,1.0,1,0.23031201879457205,35
1722,1,3738,1333,2405,0,0,0,1.0,1,1.0,1,1.0,1,0.23277425759956238,35
1723,2,3740,1334,2406,0,0,0,1.0,1,1.0,1,1.0,1,0.2602473979161588,34
1724,2,3742,1334,2408,0,0,0,1.0,1,1.0,1,1.0,1,0.1672235703656267,33
1725,0,3742,1334,2408,0,0,0,1.0,1,1.0,1,1.0,1,0.1943282275113125,35
1726,1,3743,1334,2409,0,0,0,1.0,1,1.0,1,1.0,1,0.1340873450660316,34
1727,1,3744,1335,2409,0,0,0,1.0,1,1.0,1,1.0,1,0.1609463771317861,34
1728,1,3745,1335,2410,0,0,0,1.0,1,1.0,1,1.0,1,0.14838466930074592,35
1729,0,3745,1335,2410,0,0,0,1.0,1,1.0,1,1.0,1,0.16046901867569108,35
1730,1,3746,1336,2410,0,0,0,1.0,1,1.0,1,1.0,1,0.18611026807117864,35
1731,1,3747,1337,2410,0,0,0,1.0,1,1.0,1,1.0,1,0.20440370417442147,35
1732,1,3748,1337,2411,0,0,0,1.0,1,1.0,1,1.0,1,0.18525272635863518,35
1733,1,3749,1337,2412,0,0,0,1.0,1,1.0,1,1.0,1,0.21630206567477916,33
1734,5,3754,1340,2414,0,0,0,1.0,1,1.0,1,1.0,1,0.2094113543300863,34
1735,2,3756,1340,2416,0,0,0,1.0,1,1.0,1,1.0,1,0.20911608169463194,33
1736,3,3759,1342,2417,0,0,0,1.0,1,1.0,1,1.0,1,0.20047634716814783,33
1737,4,3763,1342,2421,0,0,0,1.0,1,1.0,1,1.0,1,0.10317531742302417,35
1738,2,3765,1343,2422,0,0,0,1.0,1,1.0,1,1.0,1,0.09821269286589007,36
1739,3,3768,1344,2424,0,0,0,1.0,1,1.0,1,1.0,1,0.1300865446833587,36
1740,3,3771,1345,2426,0,0,0,1.0,1,1.0,1,1.0,1,0.12790120435394803,37
1741,2,3773,1345,2428,0,0,0,1.0,1,1.0,1,1.0,1,0.0986249811082679,36
1742,1,3774,1346,2428,0,0,0,1.0,1,1.0,1,1.0,1,0.10824997856993165,36
1743,3,3777,1347,2430,0,0,0,1.0,1,1.0,1,1.0,1,0.09594358905620638,37
1744,1,3778,1347,2431,0,0,0,1.0,1,1.0,1,1.0,1,0.0867722902270562,37
1745,4,3782,1349,2433,0,0,0,1.0,1,1.0,1,1.0,1,0.18561893986992511,38
1746,0,3782,1349,2433,0,0,0,1.0,1,1.0,1,1.0,1,0.1878163002908401,38
1747,0,3782,1349,2433,0,0,0,1.0,1,1.0,1,1.0,1,0.21164754607456482,37
1748,1,3783,1350,2433,0,0,0,1.0,1,1.0,1,1.0,1,0.19224719843869348,38
1749,2,3785,1352,2433,0,0,0,1.0,1,1.0,1,1.0,1,0.18871209439197778,38
1750,1,3786,1352,2434,0,0,0,1.0,1,1.0,1,1.0,1,0.18341769392660678,39
1751,6,3792,1352,2440,0,0,0,1.0,1,1.0,1,1.0,1,0.0855315143355788,41
1752,0,3792,1352,2440,0,0,0,1.0,1,1.0,1,1.0,1,0.0855315143355788,41
1753,0,3792,1352,2440,0,0,0,1.0,1,1.0,1,1.0,1,0.10377657247791144,41
1754,0,3792,1352,2440,0,0,0,1.0,1,1.0,1,1.0,1,0.1185285311691467,40
1755,1,3793,1353,2440,0,0,0,1.0,1,1.0,1,1.0,1,0.11803763446424394,41
1756,3,3796,1353,2443,0,0,0,1.0,1,1.0,1,1.0,1,0.1231294757625929,41
1757,0,3796,1353,2443,0,0,0,1.0,1,1.0,1,1.0,1,0.13748473017793125,40
1758,2,3798,1355,2443,0,0,0,1.0,1,1.0,1,1.0,1,0.164418129335713,41
1759,0,3798,1355,2443,0,0,0,1.0,1,1.0,1,1.0,1,0.18446161108037165,38
1760,1,3799,1356,2443,0,0,0,1.0,1,1.0,1,1.0,1,0.21952376209088043,38
1761,4,3803,1358,2445,0,0,0,1.0,1,1.0,1,1.0,1,0.2197526063250625,37
1762,4,3807,1360,2447,0,0,0,1.0,1,1.0,1,1.0,1,0.21886264900945027,37
1763,1,3808,1361,2447,0,0,0,1.0,1,1.0,1,1.0,1,0.26562128736709273,37
1764,4,3812,1362,2450,0,0,0,1.0,1,1.0,1,1.0,1,0.25407273076915704,36
1765,3,3815,1363,2452,0,0,0,1.0,1,1.0,1,1.0,1,0.2577191342018082,36
1766,8,3823,1364,2459,0,0,0,1.0,1,1.0,1,1.0,1,0.1794774449428334,37
1767,6,3829,1366,2463,0,0,0,1.0,1,1.0,1,1.0,1,0.19493214380523485,37
1768,4,3833,1366,2467,0,0,0,1.0,1,1.0,1,1.0,1,0.18684785865247003,37
1769,6,3839,1367,2472,0,0,0,1.0,1,1.0,1,1.0,1,0.1708374433501371,38
1770,2,3841,1367,2474,0,0,0,1.0,1,1.0,1,1.0,1,0.18115430728521031,39
1771,1,3842,1367,2475,0,0,0,1.0,1,1.0,1,1.0,1,0.17221008035702562,39
1772,0,3842,1367,2475,0,0,0,1.0,1,1.0,1,1.0,1,0.17221008035702562,39
1773,2,3844,1367,2477,0,0,0,1.0,1,1.0,1,1.0,1,0.12730905911312337,41
1774,0,3844,1367,2477,0,0,0,1.0,1,1.0,1,1.0,1,0.12730905911312337,41
1775,2,3846,1367,2479,0,0,0,1.0,1,1.0,1,1.0,1,0.12897666909550679,42
1776,3,3849,1368,2481,0,0,0,1.0,1,1.0,1,1.0,1,0.13351221934597254,43
1777,0,3849,1368,2481,0,0,0,1.0,1,1.0,1,1.0,1,0.13351221934597254,43
1778,1,3850,1368,2482,0,0,0,1.0,1,1.0,1,1.0,1,0.11231715502221556,44
1779,2,3852,1368,2484,0,0,0,1.0,1,1.0,1,1.0,1,0.08930740605757208,46
1780,0,3852,1368,2484,0,0,0,1.0,1,1.0,1,1.0,1,0.08930740605757208,46
1781,1,3853,1369,2484,0,0,0,1.0,1,1.0,1,1.0,1,0.09556129876648205,46
1782,2,3855,1370,2485,0,0,0,1.0,1,1.0,1,1.0,1,0.14592178220205196,46
1783,2,3857,1372,2485,0,0,0,1.0,1,1.0,1,1.0,1,0.167294666484518,44
1784,7,3864,1375,2489,0,0,0,1.0,1,1.0,1,1.0,1,0.09951536109135319,45
1785,0,3864,1375,2489,0,0,0,1.0,1,1.0,1,1.0,1,0.08689620863115362,42
1786,4,3868,1377,2491,0,0,0,1.0,1,1.0,1,1.0,1,0.09972030155361877,43
1787,1,3869,1378,2491,0,0,0,1.0,1,1.0,1,1.0,1,0.08036188667038795,41
1788,1,3870,1378,2492,0,0,0,1.0,1,1.0,1,1.0,1,0.13778431960136928,41
1789,4,3874,1381,2493,0,0,0,1.0,1,1.0,1,1.0,1,0.1737031125653477,41
1790,2,3876,1382,2494,0,0,0,1.0,1,1.0,1,1.0,1,0.15940982497209116,41
1791,5,3881,1384,2497,0,0,0,1.0,1,1.0,1,1.0,1,0.11009109109379873,40
1792,2,3883,1385,2498,0,0,0,1.0,1,1.0,1,1.0,1,0.13689125985328188,40
1793,2,3885,1385,2500,0,0,0,1.0,1,1.0,1,1.0,1,0.10262775405163463,41
1794,4,3889,1386,2503,0,0,0,1.0,1,1.0,1,1.0,1,0.12826442975317517,41
1795,2,3891,1387,2504,0,0,0,1.0,1,1.0,1,1.0,1,0.10420542555181021,40
1796,1,3892,1388,2504,0,0,0,1.0,1,1.0,1,1.0,1,0.119491021326996,40
1797,2,3894,1389,2505,0,0,0,1.0,1,1.0,1,1.0,1,0.15881877516241197,37
1798,1,3895,1390,2505,0,0,0,1.0,1,1.0,1,1.0,1,0.1927985548821231,37
1799,3,3898,1391,2507,0,0,0,1.0,1,1.0,1,1.0,1,0.19233344034272895,36
1800,1,3899,1392,2507,0,0,0,1.0,1,1.0,1,1.0,1,0.23067325438020422,36
1801,3,3902,1393,2509,0,0,0,1.0,1,1.0,1,1.0,1,0.1821505488240885,34
1802,0,3902,1393,2509,0,0,0,1.0,1,1.0,1,1.0,1,0.19423916337529884,33
1803,1,3903,1393,2510,0,0,0,1.0,1,1.0,1,1.0,1,0.16760272161212442,33
1804,1,3904,1394,2510,0,0,0,1.0,1,1.0,1,1.0,1,0.1897599138217431,33
1805,1,3905,1394,2511,0,0,0,1.0,1,1.0,1,1.0,1,0.15164054467701638,35
1806,1,3906,1394,2512,0,0,0,1.0,1,1.0,1,1.0,1,0.1207211938049501,35
1807,3,3909,1394,2515,0,0,0,1.0,1,1.0,1,1.0,1,0.129248166952167,35
1808,1,3910,1394,2516,0,0,0,1.0,1,1.0,1,1.0,1,0.11167321739726258,36
1809,0,3910,1394,2516,0,0,0,1.0,1,1.0,1,1.0,1,0.14013275305130424,36
1810,0,3910,1394,2516,0,0,0,1.0,1,1.0,1,1.0,1,0.1453193862859197,35
1811,5,3915,1395,2520,0,0,0,1.0,1,1.0,1,1.0,1,0.1776869533128116,36
1812,0,3915,1395,2520,0,0,0,1.0,1,1.0,1,1.0,1,0.17023290998914334,36
1813,0,3915,1395,2520,0,0,0,1.0,1,1.0,1,1.0,1,0.17023290998914334,36
1814,1,3916,1396,2520,0,0,0,1.0,1,1.0,1,1.0,1,0.19664342695102893,34
1815,0,3916,1396,2520,0,0,0,1.0,1,1.0,1,1.0,1,0.21048751780178593,35
1816,5,3921,1397,2524,0,0,0,1.0,1,1.0,1,1.0,1,0.17284661442988036,34
1817,0,3921,1397,2524,0,0,0,1.0,1,1.0,1,1.0,1,0.17284661442988036,34
1818,0,3921,1397,2524,0,0,0,1.0,1,1.0,1,1.0,1,0.17284661442988036,34
1819,4,3925,1399,2526,0,0,0,1.0,1,1.0,1,1.0,1,0.14672634785629765,35
1820,1,3926,1400,2526,0,0,0,1.0,1,1.0,1,1.0,1,0.13341326994698977,36
1821,1,3927,1400,2527,0,0,0,1.0,1,1.0,1,1.0,1,0.10901015031352616,36
1822,1,3928,1401,2527,0,0,0,1.0,1,1.0,1,1.0,1,0.13426300660144955,37
1823,4,3932,1403,2529,0,0,0,1.0,1,1.0,1,1.0,1,0.12195158735308852,38
1824,2,3934,1405,2529,0,0,0,1.0,1,1.0,1,1.0,1,0.1442988892108303,37
1825,6,3940,1406,2534,0,0,0,1.0,1,1.0,1,1.0,1,0.13660807619950843,36
1826,2,3942,1407,2535,0,0,0,1.0,1,1.0,1,1.0,1,0.11443898442421654,35
1827,1,3943,1407,2536,0,0,0,1.0,1,1.0,1,1.0,1,0.09307920374292161,35
1828,1,3944,1408,2536,0,0,0,1.0,1,1.0,1,1.0,1,0.12164024506026704,33
1829,1,3945,1408,2537,0,0,0,1.0,1,1.0,1,1.0,1,0.13256895718886177,32
1830,2,3947,1410,2537,0,0,0,1.0,1,1.0,1,1.0,1,0.19353898139823908,32
1831,2,3949,1411,2538,0,0,0,1.0,1,1.0,1,1.0,1,0.22172522725607957,30
1832,3,3952,1413,2539,0,0,0,1.0,1,1.0,1,1.0,1,0.251871034543751,30
1833,3,3955,1413,2542,0,0,0,1.0,1,1.0,1,1.0,1,0.17130247380336178,29
1834,2,3957,1415,2542,0,0,0,1.0,1,1.0,1,1.0,1,0.21865238649760393,28
1835,4,3961,1417,2544,0,0,0,1.0,1,1.0,1,1.0,1,0.3771723554771232,28
1836,5,3966,1418,2548,0,0,0,1.0,1,1.0,1,1.0,1,0.2546439951147049,29
1837,1,3967,1418,2549,0,0,0,1.0,1,1.0,1,1.0,1,0.2572973349856254,28
1838,2,3969,1419,2550,0,0,0,1.0,1,1.0,1,1.0,1,0.23319163091171813,28
1839,0,3969,1419,2550,0,0,0,1.0,1,1.0,1,1.0,1,0.25658979455125286,27
1840,2,3971,1419,2552,0,0,0,1.0,1,1.0,1,1.0,1,0.27429851712136233,26
1841,1,3972,1419,2553,0,0,0,1.0,1,1.0,1,1.0,1,0.2776993560710958,25
1842,1,3973,1420,2553,0,0,0,1.0,1,1.0,1,1.0,1,0.24561167135490655,26
1843,0,3973,1420,2553,0,0,0,1.0,1,1.0,1,1.0,1,0.24561167135490655,26
1844,2,3975,1420,2555,0,0,0,1.0,1,1.0,1,1.0,1,0.19079474855577067,26
1845,2,3977,1421,2556,0,0,0,1.0,1,1.0,1,1.0,1,0.20967658942930814,26
1846,2,3979,1421,2558,0,0,0,1.0,1,1.0,1,1.0,1,0.14404186109652806,26
1847,0,3979,1421,2558,0,0,0,1.0,1,1.0,1,1.0,1,0.14404186109652806,26
1848,0,3979,1421,2558,0,0,0,1.0,1,1.0,1,1.0,1,0.13729453666787322,27
1849,0,3979,1421,2558,0,0,0,1.0,1,1.0,1,1.0,1,0.13729453666787322,27
1850,0,3979,1421,2558,0,0,0,1.0,1,1.0,1,1.0,1,0.15575212913713893,28
1851,0,3979,1421,2558,0,0,0,1.0,1,1.0,1,1.0,1,0.15575212913713893,28
1852,0,3979,1421,2558,0,0,0,1.0,1,1.0,1,1.0,1,0.15575212913713893,28
1853,0,3979,1421,2558,0,0,0,1.0,1,1.0,1,1.0,1,0.18103080919851303,27
1854,1,3980,1421,2559,0,0,0,1.0,1,1.0,1,1.0,1,0.18727178321977894,28
1855,0,3980,1421,2559,0,0,0,1.0,1,1.0,1,1.0,1,0.18727178321977894,28
1856,2,3982,1422,2560,0,0,0,1.0,1,1.0,1,1.0,1,0.21172044430759898,30
1857,1,3983,1423,2560,0,0,0,1.0,1,1.0,1,1.0,1,0.2768234831592697,31
1858,3,3986,1424,2562,0,0,0,1.0,1,1.0,1,1.0,1,0.2612274910377413,31
1859,1,3987,1424,2563,0,0,0,1.0,1,1.0,1,1.0,1,0.27416826896452906,31
1860,1,3988,1424,2564,0,0,0,1.0,1,1.0,1,1.0,1,0.26104160214898947,31
1861,0,3988,1424,2564,0,0,0,1.0,1,1.0,1,1.0,1,0.26104160214898947,31
1862,1,3989,1425,2564,0,0,0,1.0,1,1.0,1,1.0,1,0.2692001373252289,31
1863,3,3992,1426,2566,0,0,0,1.0,1,1.0,1,1.0,1,0.26151687506409466,31
1864,1,3993,1427,2566,0,0,0,1.0,1,1.0,1,1.0,1,0.2662617946951255,30
1865,0,3993,1427,2566,0,0,0,1.0,1,1.0,1,1.0,1,0.26516596852468577,27
1866,5,3998,1429,2569,0,0,0,1.0,1,1.0,1,1.0,1,0.23896971659627303,28
1867,1,3999,1430,2569,0,0,0,1.0,1,1.0,1,1.0,1,0.21816715411414553,26
1868,1,4000,1431,2569,0,0,0,1.0,1,1.0,1,1.0,1,0.27770840634387417,26
1869,0,4000,1431,2569,0,0,0,1.0,1,1.0,1,1.0,1,0.2800014845091164,25
1870,2,4002,1432,2570,0,0,0,1.0,1,1.0,1,1.0,1,0.265895024588898,25
1871,3,4005,1432,2573,0,0,0,1.0,1,1.0,1,1.0,1,0.20061065856694377,26
1872,0,4005,1432,2573,0,0,0,1.0,1,1.0,1,1.0,1,0.24242784450707375,25
1873,0,4005,1432,2573,0,0,0,1.0,1,1.0,1,1.0,1,0.29286385529304254,23
1874,0,4005,1432,2573,0,0,0,1.0,1,1.0,1,1.0,1,0.2787027788515647,23
1875,0,4005,1432,2573,0,0,0,1.0,1,1.0,1,1.0,1,0.31067471441299443,21
1876,6,4011,1433,2578,0,0,0,1.0,1,1.0,1,1.0,1,0.20926121772600267,24
1877,1,4012,1434,2578,0,0,0,1.0,1,1.0,1,1.0,1,0.20537992462233787,24
1878,2,4014,1435,2579,0,0,0,1.0,1,1.0,1,1.0,1,0.2253185111582374,26
1879,1,4015,1435,2580,0,0,0,1.0,1,1.0,1,1.0,1,0.18783293541924279,26
1880,1,4016,1435,2581,0,0,0,1.0,1,1.0,1,1.0,1,0.13808776054171118,26
1881,0,4016,1435,2581,0,0,0,1.0,1,1.0,1,1.0,1,0.13808776054171118,26
1882,0,4016,1435,2581,0,0,0,1.0,1,1.0,1,1.0,1,0.13191403011326946,25
1883,0,4016,1435,2581,0,0,0,1.0,1,1.0,1,1.0,1,0.13191403011326946,25
1884,0,4016,1435,2581,0,0,0,1.0,1,1.0,1,1.0,1,0.13191403011326946,25
1885,0,4016,1435,2581,0,0,0,1.0,1,1.0,1,1.0,1,0.13191403011326946,25
1886,0,4016,1435,2581,0,0,0,1.0,1,1.0,1,1.0,1,0.1532840112439635,26
1887,0,4016,1435,2581,0,0,0,1.0,1,1.0,1,1.0,1,0.1532840112439635,26
1888,1,4017,1435,2582,0,0,0,1.0,1,1.0,1,1.0,1,0.13501525102922593,27
1889,0,4017,1435,2582,0,0,0,1.0,1,1.0,1,1.0,1,0.15880604168930865,28
1890,0,4017,1435,2582,0,0,0,1.0,1,1.0,1,1.0,1,0.15880604168930865,28
1891,1,4018,1435,2583,0,0,0,1.0,1,1.0,1,1.0,1,0.17380560294343436,29
1892,0,4018,1435,2583,0,0,0,1.0,1,1.0,1,1.0,1,0.17380560294343436,29
1893,0,4018,1435,2583,0,0,0,1.0,1,1.0,1,1.0,1,0.17380560294343436,29
1894,0,4018,1435,2583,0,0,0,1.0,1,1.0,1,1.0,1,0.17380560294343436,29
1895,2,4020,1436,2584,0,0,0,1.0,1,1.0,1,1.0,1,0.19013950642002853,31
1896,1,4021,1436,2585,0,0,0,1.0,1,1.0,1,1.0,1,0.1699100156591571,31
1897,0,4021,1436,2585,0,0,0,1.0,1,1.0,1,1.0,1,0.1699100156591571,31
1898,0,4021,1436,2585,0,0,0,1.0,1,1.0,1,1.0,1,0.1699100156591571,31
1899,0,4021,1436,2585,0,0,0,1.0,1,1.0,1,1.0,1,0.18469672790578037,32
1900,1,4022,1436,2586,0,0,0,1.0,1,1.0,1,1.0,1,0.17195266963355443,32
1901,0,4022,1436,2586,0,0,0,1.0,1,1.0,1,1.0,1,0.17195266963355443,32
1902,0,4022,1436,2586,0,0,0,1.0,1,1.0,1,1.0,1,0.17195266963355443,32
1903,0,4022,1436,2586,0,0,0,1.0,1,1.0,1,1.0,1,0.17195266963355443,32
1904,1,4023,1436,2587,0,0,0,1.0,1,1.0,1,1.0,1,0.14945708621795054,34
1905,0,4023,1436,2587,0,0,0,1.0,1,1.0,1,1.0,1,0.14945708621795054,34
1906,0,4023,1436,2587,0,0,0,1.0,1,1.0,1,1.0,1,0.16365967569932147,35
1907,0,4023,1436,2587,0,0,0,1.0,1,1.0,1,1.0,1,0.16921343551754314,36
1908,0,4023,1436,2587,0,0,0,1.0,1,1.0,1,1.0,1,0.16921343551754314,36
1909,1,4024,1436,2588,0,0,0,1.0,1,1.0,1,1.0,1,0.162097531502258,37
1910,3,4027,1437,2590,0,0,0,1.0,1,1.0,1,1.0,1,0.17211319489395432,38
1911,4,4031,1437,2594,0,0,0,1.0,1,1.0,1,1.0,1,0.14088399285450476,37
1912,1,4032,1438,2594,0,0,0,1.0,1,1.0,1,1.0,1,0.13912936075354446,37
1913,0,4032,1438,2594,0,0,0,1.0,1,1.0,1,1.0,1,0.14360829836036176,36
1914,1,4033,1439,2594,0,0,0,1.0,1,1.0,1,1.0,1,0.15144273725022622,37
1915,0,4033,1439,2594,0,0,0,1.0,1,1.0,1,1.0,1,0.15144273725022622,37
1916,2,4035,1440,2595,0,0,0,1.0,1,1.0,1,1.0,1,0.11805047382787424,39
1917,3,4038,1442,2596,0,0,0,1.0,1,1.0,1,1.0,1,0.19158467615487948,38
1918,1,4039,1443,2596,0,0,0,1.0,1,1.0,1,1.0,1,0.1923239652752257,38
1919,1,4040,1444,2596,0,0,0,1.0,1,1.0,1,1.0,1,0.23231827320989878,38
1920,2,4042,1445,2597,0,0,0,1.0,1,1.0,1,1.0,1,0.22238166804316448,39
1921,2,4044,1445,2599,0,0,0,1.0,1,1.0,1,1.0,1,0.1672045947478025,38
1922,1,4045,1446,2599,0,0,0,1.0,1,1.0,1,1.0,1,0.13159454565507114,39
1923,2,4047,1448,2599,0,0,0,1.0,1,1.0,1,1.0,1,0.19135029198023512,40
1924,0,4047,1448,2599,0,0,0,1.0,1,1.0,1,1.0,1,0.19135029198023512,40
1925,1,4048,1449,2599,0,0,0,1.0,1,1.0,1,1.0,1,0.22370110396240275,40
1926,8,4056,1449,2607,0,0,0,1.0,1,1.0,1,1.0,1,0.1456165176875184,40
1927,5,4061,1449,2612,0,0,0,1.0,1,1.0,1,1.0,1,0.13771943045081395,41
1928,2,4063,1449,2614,0,0,0,1.0,1,1.0,1,1.0,1,0.11646511525982023,41
1929,2,4065,1449,2616,0,0,0,1.0,1,1.0,1,1.0,1,0.16172678974565685,40
1930,2,4067,1449,2618,0,0,0,1.0,1,1.0,1,1.0,1,0.13997543983193245,40
1931,3,4070,1451,2619,0,0,0,1.0,1,1.0,1,1.0,1,0.15149510024866206,40
1932,2,4072,1451,2621,0,0,0,1.0,1,1.0,1,1.0,1,0.09451865089721313,40
1933,0,4072,1451,2621,0,0,0,1.0,1,1.0,1,1.0,1,0.11622544366760096,42
1934,1,4073,1451,2622,0,0,0,1.0,1,1.0,1,1.0,1,0.0985660663433262,44
1935,1,4074,1451,2623,0,0,0,1.0,1,1.0,1,1.0,1,0.09232018348837269,44
1936,0,4074,1451,2623,0,0,0,1.0,1,1.0,1,1.0,1,0.10900943454318524,46
1937,2,4076,1452,2624,0,0,0,1.0,1,1.0,1,1.0,1,0.0901327757690224,47
1938,2,4078,1453,2625,0,0,0,1.0,1,1.0,1,1.0,1,0.10137639624900373,47
1939,1,4079,1453,2626,0,0,0,1.0,1,1.0,1,1.0,1,0.07599015870924614,47
1940,1,4080,1454,2626,0,0,0,1.0,1,1.0,1,1.0,1,0.07941800087842078,47
1941,3,4083,1456,2627,0,0,0,1.0,1,1.0,1,1.0,1,0.10274020538666438,47
1942,2,4085,1457,2628,0,0,0,1.0,1,1.0,1,1.0,1,0.15257447598457943,49
1943,5,4090,1459,2631,0,0,0,1.0,1,1.0,1,1.0,1,0.14225073953214298,47
1944,3,4093,1461,2632,0,0,0,1.0,1,1.0,1,1.0,1,0.19377643566914954,47
1945,3,4096,1462,2634,0,0,0,1.0,1,1.0,1,1.0,1,0.1537485807424056,45
1946,3,4099,1463,2636,0,0,0,1.0,1,1.0,1,1.0,1,0.12872185761126936,45
1947,4,4103,1465,2638,0,0,0,1.0,1,1.0,1,1.0,1,0.16208031637452755,45
1948,2,4105,1466,2639,0,0,0,1.0,1,1.0,1,1.0,1,0.21299416645957517,45
1949,2,4107,1468,2639,0,0,0,1.0,1,1.0,1,1.0,1,0.31267576048053614,42
1950,11,4118,1473,2645,0,0,0,1.0,1,1.0,1,1.0,1,0.18656854614515844,42
1951,4,4122,1474,2648,0,0,0,1.0,1,1.0,1,1.0,1,0.16443850037159227,38
1952,1,4123,1475,2648,0,0,0,1.0,1,1.0,1,1.0,1,0.1938175543019819,36
1953,1,4124,1476,2648,0,0,0,1.0,1,1.0,1,1.0,1,0.2071434646030512,35
1954,1,4125,1477,2648,0,0,0,1.0,1,1.0,1,1.0,1,0.23228650259371295,32
1955,2,4127,1478,2649,0,0,0,1.0,1,1.0,1,1.0,1,0.22879935763224737,33
1956,5,4132,1479,2653,0,0,0,1.0,1,1.0,1,1.0,1,0.12484675617566132,31
1957,6,4138,1480,2658,0,0,0,1.0,1,1.0,1,1.0,1,0.15091625156938374,33
1958,6,4144,1481,2663,0,0,0,1.0,1,1.0,1,1.0,1,0.16713186456452045,34
1959,3,4147,1481,2666,0,0,0,1.0,1,1.0,1,1.0,1,0.216652574016615,35
1960,7,4154,1483,2671,0,0,0,1.0,1,1.0,1,1.0,1,0.23925735502635648,36
1961,4,4158,1485,2673,0,0,0,1.0,1,1.0,1,1.0,1,0.1956318397810181,36
1962,1,4159,1485,2674,0,0,0,1.0,1,1.0,1,1.0,1,0.17753315182234003,35
1963,1,4160,1485,2675,0,0,0,1.0,1,1.0,1,1.0,1,0.18036889535841782,36
1964,4,4164,1485,2679,0,0,0,1.0,1,1.0,1,1.0,1,0.15564240133787047,35
1965,0,4164,1485,2679,0,0,0,1.0,1,1.0,1,1.0,1,0.13027346708114496,36
1966,2,4166,1485,2681,0,0,0,1.0,1,1.0,1,1.0,1,0.09581389374946903,36
1967,1,4167,1486,2681,0,0,0,1.0,1,1.0,1,1.0,1,0.13057165652163785,36
1968,0,4167,1486,2681,0,0,0,1.0,1,1.0,1,1.0,1,0.14006373849892306,37
1969,1,4168,1487,2681,0,0,0,1.0,1,1.0,1,1.0,1,0.14646423873872924,37
1970,2,4170,1487,2683,0,0,0,1.0,1,1.0,1,1.0,1,0.14359758674314269,38
1971,0,4170,1487,2683,0,0,0,1.0,1,1.0,1,1.0,1,0.15406254755131804,37
1972,0,4170,1487,2683,0,0,0,1.0,1,1.0,1,1.0,1,0.15406254755131804,37
1973,1,4171,1488,2683,0,0,0,1.0,1,1.0,1,1.0,1,0.20709776194564822,37
1974,2,4173,1489,2684,0,0,0,1.0,1,1.0,1,1.0,1,0.2088822229717836,38
1975,0,4173,1489,2684,0,0,0,1.0,1,1.0,1,1.0,1,0.22035742429868632,37
1976,7,4180,1491,2689,0,0,0,1.0,1,1.0,1,1.0,1,0.16114260879596717,39
1977,2,4182,1491,2691,0,0,0,1.0,1,1.0,1,1.0,1,0.12292532582063753,42
1978,0,4182,1491,2691,0,0,0,1.0,1,1.0,1,1.0,1,0.12292532582063753,42
1979,0,4182,1491,2691,0,0,0,1.0,1,1.0,1,1.0,1,0.12292532582063753,42
1980,1,4183,1492,2691,0,0,0,1.0,1,1.0,1,1.0,1,0.16387174358196516,43
1981,4,4187,1492,2695,0,0,0,1.0,1,1.0,1,1.0,1,0.09274390140672904,44
1982,3,4190,1494,2696,0,0,0,1.0,1,1.0,1,1.0,1,0.10364028998682287,44
1983,2,4192,1495,2697,0,0,0,1.0,1,1.0,1,1.0,1,0.12267529596620026,44
1984,3,4195,1495,2700,0,0,0,1.0,1,1.0,1,1.0,1,0.09878285114073622,42
1985,5,4200,1496,2704,0,0,0,1.0,1,1.0,1,1.0,1,0.12261611681239291,41
1986,5,4205,1498,2707,0,0,0,1.0,1,1.0,1,1.0,1,0.07837772425076646,40
1987,4,4209,1500,2709,0,0,0,1.0,1,1.0,1,1.0,1,0.09844140396823246,37
1988,2,4211,1502,2709,0,0,0,1.0,1,1.0,1,1.0,1,0.1625947298955456,35
1989,2,4213,1503,2710,0,0,0,1.0,1,1.0,1,1.0,1,0.18787073661591852,32
1990,0,4213,1503,2710,0,0,0,1.0,1,1.0,1,1.0,1,0.20004283037070114,31
1991,3,4216,1504,2712,0,0,0,1.0,1,1.0,1,1.0,1,0.1983606870389854,32
1992,4,4220,1506,2714,0,0,0,1.0,1,1.0,1,1.0,1,0.2348238897023756,32
1993,2,4222,1507,2715,0,0,0,1.0,1,1.0,1,1.0,1,0.22752965588718566,32
1994,0,4222,1507,2715,0,0,0,1.0,1,1.0,1,1.0,1,0.2192181958348185,31
1995,0,4222,1507,2715,0,0,0,1.0,1,1.0,1,1.0,1,0.2523376427406146,32
1996,2,4224,1507,2717,0,0,0,1.0,1,1.0,1,1.0,1,0.19385873685703958,32
1997,1,4225,1507,2718,0,0,0,1.0,1,1.0,1,1.0,1,0.205011319152431,31
1998,2,4227,1507,2720,0,0,0,1.0,1,1.0,1,1.0,1,0.16167065544116146,32
1999,0,4227,1507,2720,0,0,0,1.0,1,1.0,1,1.0,1,0.18314756171010368,31
2000,0,4227,1507,2720,0,0,0,1.0,1,1.0,1,1.0,1,0.17691161443873396,30
2001,2,4229,1507,2722,0,0,0,1.0,1,1.0,1,1.0,1,0.16632079307969036,29
2002,1,4230,1507,2723,0,0,0,1.0,1,1.0,1,1.0,1,0.17688616835789295,31
2003,1,4231,1507,2724,0,0,0,1.0,1,1.0,1,1.0,1,0.19586572262490842,33
2004,7,4238,1508,2730,0,0,0,1.0,1,1.0,1,1.0,1,0.23653738467577468,34
2005,5,4243,1508,2735,0,0,0,1.0,1,1.0,1,1.0,1,0.2011519365721519,35
2006,4,4247,1510,2737,0,0,0,1.0,1,1.0,1,1.0,1,0.18456618431148464,36
2007,1,4248,1510,2738,0,0,0,1.0,1,1.0,1,1.0,1,0.15718448443961885,36
2008,0,4248,1510,2738,0,0,0,1.0,1,1.0,1,1.0,1,0.15718448443961885,36
2009,1,4249,1510,2739,0,0,0,1.0,1,1.0,1,1.0,1,0.16406307449464258,37
2010,4,4253,1511,2742,0,0,0,1.0,1,1.0,1,1.0,1,0.1330995467739573,37
2011,2,4255,1511,2744,0,0,0,1.0,1,1.0,1,1.0,1,0.09708184167821016,37
2012,0,4255,1511,2744,0,0,0,1.0,1,1.0,1,1.0,1,0.09708184167821016,37
2013,1,4256,1511,2745,0,0,0,1.0,1,1.0,1,1.0,1,0.11752141091431924,39
2014,1,4257,1511,2746,0,0,0,1.0,1,1.0,1,1.0,1,0.1511107126201491,39
2015,2,4259,1511,2748,0,0,0,1.0,1,1.0,1,1.0,1,0.1511107126201491,39
2016,2,4261,1511,2750,0,0,0,1.0,1,1.0,1,1.0,1,0.09676256452425383,41
2017,0,4261,1511,2750,0,0,0,1.0,1,1.0,1,1.0,1,0.09676256452425383,41
2018,2,4263,1512,2751,0,0,0,1.0,1,1.0,1,1.0,1,0.10806237121252296,42
2019,0,4263,1512,2751,0,0,0,1.0,1,1.0,1,1.0,1,0.09023376603754318,43
2020,6,4269,1516,2753,0,0,0,1.0,1,1.0,1,1.0,1,0.13631558652784298,43
2021,2,4271,1517,2754,0,0,0,1.0,1,1.0,1,1.0,1,0.13744914426338645,43
2022,3,4274,1518,2756,0,0,0,1.0,1,1.0,1,1.0,1,0.09184475740330042,44
2023,3,4277,1521,2756,0,0,0,1.0,1,1.0,1,1.0,1,0.1824403316403482,42
2024,1,4278,1521,2757,0,0,0,1.0,1,1.0,1,1.0,1,0.14743313959750518,41
2025,5,4283,1524,2759,0,0,0,1.0,1,1.0,1,1.0,1,0.17741595565997284,39
2026,4,4287,1525,2762,0,0,0,1.0,1,1.0,1,1.0,1,0.1371700553157469,39
2027,5,4292,1527,2765,0,0,0,1.0,1,1.0,1,1.0,1,0.20045487754757801,38
2028,1,4293,1528,2765,0,0,0,1.0,1,1.0,1,1.0,1,0.2244990769424019,37
2029,1,4294,1528,2766,0,0,0,1.0,1,1.0,1,1.0,1,0.19142584645380023,35
2030,0,4294,1528,2766,0,0,0,1.0,1,1.0,1,1.0,1,0.22362964571144447,32
2031,3,4297,1528,2769,0,0,0,1.0,1,1.0,1,1.0,1,0.22838510715781843,34
2032,3,4300,1528,2772,0,0,0,1.0,1,1.0,1,1.0,1,0.21867787511478715,35
2033,3,4303,1530,2773,0,0,0,1.0,1,1.0,1,1.0,1,0.17250791615270963,35
2034,1,4304,1530,2774,0,0,0,1.0,1,1.0,1,1.0,1,0.1652142343558368,35
2035,2,4306,1532,2774,0,0,0,1.0,1,1.0,1,1.0,1,0.17838506149433456,36
2036,1,4307,1532,2775,0,0,0,1.0,1,1.0,1,1.0,1,0.13555621167687298,35
2037,4,4311,1534,2777,0,0,0,1.0,1,1.0,1,1.0,1,0.19763833848932646,36
2038,2,4313,1535,2778,0,0,0,1.0,1,1.0,1,1.0,1,0.22583953294793782,38
2039,5,4318,1536,2782,0,0,0,1.0,1,1.0,1,1.0,1,0.17111941245389073,38
2040,1,4319,1536,2783,0,0,0,1.0,1,1.0,1,1.0,1,0.1539292608284151,37
2041,1,4320,1537,2783,0,0,0,1.0,1,1.0,1,1.0,1,0.21857923145254504,38
2042,1,4321,1537,2784,0,0,0,1.0,1,1.0,1,1.0,1,0.19084758577077515,38
2043,1,4322,1538,2784,0,0,0,1.0,1,1.0,1,1.0,1,0.18115874155684888,38
2044,1,4323,1538,2785,0,0,0,1.0,1,1.0,1,1.0,1,0.14852822275467314,39
2045,0,4323,1538,2785,0,0,0,1.0,1,1.0,1,1.0,1,0.15120809891479017,40
2046,2,4325,1538,2787,0,0,0,1.0,1,1.0,1,1.0,1,0.10688836673999551,41
2047,0,4325,1538,2787,0,0,0,1.0,1,1.0,1,1.0,1,0.10688836673999551,41
2048,0,4325,1538,2787,0,0,0,1.0,1,1.0,1,1.0,1,0.11236230765441206,43
2049,1,4326,1539,2787,0,0,0,1.0,1,1.0,1,1.0,1,0.1035383676745354,43
2050,2,4328,1539,2789,0,0,0,1.0,1,1.0,1,1.0,1,0.12049810873794771,43
2051,2,4330,1540,2790,0,0,0,1.0,1,1.0,1,1.0,1,0.1564588152423582,43
2052,1,4331,1540,2791,0,0,0,1.0,1,1.0,1,1.0,1,0.14602850118907187,44
2053,1,4332,1541,2791,0,0,0,1.0,1,1.0,1,1.0,1,0.1944529628549653,43
2054,1,4333,1542,2791,0,0,0,1.0,1,1.0,1,1.0,1,0.1928320662769917,44
2055,1,4334,1542,2792,0,0,0,1.0,1,1.0,1,1.0,1,0.17672592318547412,43
2056,8,4342,1543,2799,0,0,0,1.0,1,1.0,1,1.0,1,0.106095496289467,44
2057,3,4345,1543,2802,0,0,0,1.0,1,1.0,1,1.0,1,0.10186944470538904,44
2058,1,4346,1544,2802,0,0,0,1.0,1,1.0,1,1.0,1,0.08749779775642984,44
2059,1,4347,1545,2802,0,0,0,1.0,1,1.0,1,1.0,1,0.10782015193162393,45
2060,2,4349,1545,2804,0,0,0,1.0,1,1.0,1,1.0,1,0.11327841985624636,46
2061,8,4357,1547,2810,0,0,0,1.0,1,1.0,1,1.0,1,0.09164438500480246,48
2062,7,4364,1549,2815,0,0,0,1.0,1,1.0,1,1.0,1,0.13818169433465602,48
2063,2,4366,1549,2817,0,0,0,1.0,1,1.0,1,1.0,1,0.101178512097445,45
2064,3,4369,1551,2818,0,0,0,1.0,1,1.0,1,1.0,1,0.1819190754536488,44
2065,2,4371,1551,2820,0,0,0,1.0,1,1.0,1,1.0,1,0.15797413292414353,42
2066,5,4376,1553,2823,0,0,0,1.0,1,1.0,1,1.0,1,0.17757720092951348,42
2067,4,4380,1554,2826,0,0,0,1.0,1,1.0,1,1.0,1,0.16162768494074203,38
2068,0,4380,1554,2826,0,0,0,1.0,1,1.0,1,1.0,1,0.18559592292093233,37
2069,0,4380,1554,2826,0,0,0,1.0,1,1.0,1,1.0,1,0.21854127595976486,35
2070,2,4382,1556,2826,0,0,0,1.0,1,1.0,1,1.0,1,0.21650428364143123,35
2071,7,4389,1557,2832,0,0,0,1.0,1,1.0,1,1.0,1,0.1702987262126351,34
2072,3,4392,1558,2834,0,0,0,1.0,1,1.0,1,1.0,1,0.2074574016269899,35
2073,5,4397,1558,2839,0,0,0,1.0,1,1.0,1,1.0,1,0.20446189241552537,37
2074,2,4399,1558,2841,0,0,0,1.0,1,1.0,1,1.0,1,0.19076257844466415,36
2075,3,4402,1558,2844,0,0,0,1.0,1,1.0,1,1.0,1,0.18756682183499584,38
2076,5,4407,1558,2849,0,0,0,1.0,1,1.0,1,1.0,1,0.13100762023634827,37
2077,0,4407,1558,2849,0,0,0,1.0,1,1.0,1,1.0,1,0.13100762023634827,37
2078,0,4407,1558,2849,0,0,0,1.0,1,1.0,1,1.0,1,0.13100762023634827,37
2079,3,4410,1559,2851,0,0,0,1.0,1,1.0,1,1.0,1,0.13020188312450154,37
2080,1,4411,1560,2851,0,0,0,1.0,1,1.0,1,1.0,1,0.15553553859089492,36
2081,7,4418,1561,2857,0,0,0,1.0,1,1.0,1,1.0,1,0.09281784996162028,37
2082,2,4420,1562,2858,0,0,0,1.0,1,1.0,1,1.0,1,0.10288159895235087,38
2083,0,4420,1562,2858,0,0,0,1.0,1,1.0,1,1.0,1,0.10213312541995591,39
2084,0,4420,1562,2858,0,0,0,1.0,1,1.0,1,1.0,1,0.10684937920001096,41
2085,3,4423,1565,2858,0,0,0,1.0,1,1.0,1,1.0,1,0.128839896220883,41
2086,1,4424,1565,2859,0,0,0,1.0,1,1.0,1,1.0,1,0.10422678769830036,44
2087,2,4426,1566,2860,0,0,0,1.0,1,1.0,1,1.0,1,0.1299786302447474,44
2088,1,4427,1566,2861,0,0,0,1.0,1,1.0,1,1.0,1,0.12985737365361774,45
2089,1,4428,1566,2862,0,0,0,1.0,1,1.0,1,1.0,1,0.12135540814207049,46
2090,2,4430,1566,2864,0,0,0,1.0,1,1.0,1,1.0,1,0.13982973836248866,47
2091,2,4432,1566,2866,0,0,0,1.0,1,1.0,1,1.0,1,0.10078960515268195,48
2092,0,4432,1566,2866,0,0,0,1.0,1,1.0,1,1.0,1,0.10078960515268195,48
2093,2,4434,1567,2867,0,0,0,1.0,1,1.0,1,1.0,1,0.1196762499666289,48
2094,0,4434,1567,2867,0,0,0,1.0,1,1.0,1,1.0,1,0.11016540951640814,47
2095,1,4435,1567,2868,0,0,0,1.0,1,1.0,1,1.0,1,0.10771857296789661,49
2096,1,4436,1568,2868,0,0,0,1.0,1,1.0,1,1.0,1,0.13466192070117114,50
2097,0,4436,1568,2868,0,0,0,1.0,1,1.0,1,1.0,1,0.13466192070117114,50
2098,3,4439,1569,2870,0,0,0,1.0,1,1.0,1,1.0,1,0.11689563921706228,51
2099,2,4441,1570,2871,0,0,0,1.0,1,1.0,1,1.0,1,0.08968906025138682,50
2100,5,4446,1574,2872,0,0,0,1.0,1,1.0,1,1.0,1,0.13914379969898677,49
2101,4,4450,1575,2875,0,0,0,1.0,1,1.0,1,1.0,1,0.13869501180740362,48
2102,7,4457,1579,2878,0,0,0,1.0,1,1.0,1,1.0,1,0.14937932859783534,49
2103,1,4458,1579,2879,0,0,0,1.0,1,1.0,1,1.0,1,0.1352184772118148,44
2104,3,4461,1581,2880,0,0,0,1.0,1,1.0,1,1.0,1,0.2175868597521582,42
2105,2,4463,1583,2880,0,0,0,1.0,1,1.0,1,1.0,1,0.21917269118596006,40
2106,5,4468,1584,2884,0,0,0,1.0,1,1.0,1,1.0,1,0.20053762440521367,39
2107,3,4471,1586,2885,0,0,0,1.0,1,1.0,1,1.0,1,0.24455761272841084,37
2108,4,4475,1588,2887,0,0,0,1.0,1,1.0,1,1.0,1,0.20977301600950019,37
2109,2,4477,1588,2889,0,0,0,1.0,1,1.0,1,1.0,1,0.16707632364777647,36
2110,1,4478,1588,2890,0,0,0,1.0,1,1.0,1,1.0,1,0.16341714854333475,35
2111,2,4480,1589,2891,0,0,0,1.0,1,1.0,1,1.0,1,0.11599446505703757,35
2112,0,4480,1589,2891,0,0,0,1.0,1,1.0,1,1.0,1,0.11599446505703757,35
2113,1,4481,1589,2892,0,0,0,1.0,1,1.0,1,1.0,1,0.10480176739369063,35
2114,1,4482,1590,2892,0,0,0,1.0,1,1.0,1,1.0,1,0.1201314273891655,36
2115,1,4483,1591,2892,0,0,0,1.0,1,1.0,1,1.0,1,0.11006007902557488,37
2116,3,4486,1593,2893,0,0,0,1.0,1,1.0,1,1.0,1,0.14043258750444376,39
2117,1,4487,1593,2894,0,0,0,1.0,1,1.0,1,1.0,1,0.11221917660404507,39
2118,3,4490,1593,2897,0,0,0,1.0,1,1.0,1,1.0,1,0.12159125630466212,41
2119,4,4494,1594,2900,0,0,0,1.0,1,1.0,1,1.0,1,0.10591306021933997,42
2120,0,4494,1594,2900,0,0,0,1.0,1,1.0,1,1.0,1,0.10591306021933997,42
2121,0,4494,1594,2900,0,0,0,1.0,1,1.0,1,1.0,1,0.10591306021933997,42
2122,2,4496,1595,2901,0,0,0,1.0,1,1.0,1,1.0,1,0.12422211637393706,43
2123,3,4499,1597,2902,0,0,0,1.0,1,1.0,1,1.0,1,0.13982781409427572,42
2124,0,4499,1597,2902,0,0,0,1.0,1,1.0,1,1.0,1,0.13982781409427572,42
2125,0,4499,1597,2902,0,0,0,1.0,1,1.0,1,1.0,1,0.14337922479674287,41
2126,1,4500,1597,2903,0,0,0,1.0,1,1.0,1,1.0,1,0.13501559702436455,41
2127,0,4500,1597,2903,0,0,0,1.0,1,1.0,1,1.0,1,0.13501559702436455,41
2128,0,4500,1597,2903,0,0,0,1.0,1,1.0,1,1.0,1,0.1233703746086905,42
2129,1,4501,1597,2904,0,0,0,1.0,1,1.0,1,1.0,1,0.1413966825423043,43
2130,2,4503,1597,2906,0,0,0,1.0,1,1.0,1,1.0,1,0.139947838579476,45
2131,2,4505,1598,2907,0,0,0,1.0,1,1.0,1,1.0,1,0.12516258868413896,44
2132,0,4505,1598,2907,0,0,0,1.0,1,1.0,1,1.0,1,0.12516258868413896,44
2133,1,4506,1598,2908,0,0,0,1.0,1,1.0,1,1.0,1,0.12865009361904164,45
2134,1,4507,1598,2909,0,0,0,1.0,1,1.0,1,1.0,1,0.10668446371892576,45
2135,2,4509,1599,2910,0,0,0,1.0,1,1.0,1,1.0,1,0.10788758521740761,46
2136,1,4510,1599,2911,0,0,0,1.0,1,1.0,1,1.0,1,0.09914620899590637,47
2137,3,4513,1601,2912,0,0,0,1.0,1,1.0,1,1.0,1,0.08189448978498397,47
2138,1,4514,1602,2912,0,0,0,1.0,1,1.0,1,1.0,1,0.14617611705465114,45
2139,0,4514,1602,2912,0,0,0,1.0,1,1.0,1,1.0,1,0.14617611705465114,45
2140,1,4515,1603,2912,0,0,0,1.0,1,1.0,1,1.0,1,0.17839722626183885,44
2141,5,4520,1604,2916,0,0,0,1.0,1,1.0,1,1.0,1,0.1128736684980237,45
2142,5,4525,1607,2918,0,0,0,1.0,1,1.0,1,1.0,1,0.14299760869079203,46
2143,2,4527,1607,2920,0,0,0,1.0,1,1.0,1,1.0,1,0.09473859504299414,46
2144,6,4533,1610,2923,0,0,0,1.0,1,1.0,1,1.0,1,0.09277066057320717,48
2145,5,4538,1612,2926,0,0,0,1.0,1,1.0,1,1.0,1,0.13019903331949015,46
2146,2,4540,1613,2927,0,0,0,1.0,1,1.0,1,1.0,1,0.1088249786049094,45
2147,3,4543,1616,2927,0,0,0,1.0,1,1.0,1,1.0,1,0.11728658763062856,44
2148,5,4548,1618,2930,0,0,0,1.0,1,1.0,1,1.0,1,0.18909802005014817,44
2149,4,4552,1620,2932,0,0,0,1.0,1,1.0,1,1.0,1,0.21940212562603992,42
2150,1,4553,1621,2932,0,0,0,1.0,1,1.0,1,1.0,1,0.20884718950622894,40
2151,4,4557,1622,2935,0,0,0,1.0,1,1.0,1,1.0,1,0.1655061018436114,39
2152,2,4559,1622,2937,0,0,0,1.0,1,1.0,1,1.0,1,0.12511740273152833,40
2153,2,4561,1623,2938,0,0,0,1.0,1,1.0,1,1.0,1,0.1296914690870542,42
2154,1,4562,1623,2939,0,0,0,1.0,1,1.0,1,1.0,1,0.18628465803099492,42
2155,3,4565,1624,2941,0,0,0,1.0,1,1.0,1,1.0,1,0.1319552315893435,41
2156,2,4567,1624,2943,0,0,0,1.0,1,1.0,1,1.0,1,0.11009219246845649,40
2157,1,4568,1625,2943,0,0,0,1.0,1,1.0,1,1.0,1,0.11406111781656858,40
2158,1,4569,1625,2944,0,0,0,1.0,1,1.0,1,1.0,1,0.12967380955811406,38
2159,0,4569,1625,2944,0,0,0,1.0,1,1.0,1,1.0,1,0.12234555890134234,38
2160,0,4569,1625,2944,0,0,0,1.0,1,1.0,1,1.0,1,0.12234555890134234,38
2161,2,4571,1626,2945,0,0,0,1.0,1,1.0,1,1.0,1,0.10119898382339976,38
2162,1,4572,1627,2945,0,0,0,1.0,1,1.0,1,1.0,1,0.1351436694316078,38
2163,6,4578,1629,2949,0,0,0,1.0,1,1.0,1,1.0,1,0.12427808128954061,40
2164,2,4580,1631,2949,0,0,0,1.0,1,1.0,1,1.0,1,0.1399880520533181,41
2165,2,4582,1632,2950,0,0,0,1.0,1,1.0,1,1.0,1,0.12826097891605268,42
2166,4,4586,1632,2954,0,0,0,1.0,1,1.0,1,1.0,1,0.10286166932552535,42
2167,2,4588,1632,2956,0,0,0,1.0,1,1.0,1,1.0,1,0.11828925241386726,43
2168,2,4590,1632,2958,0,0,0,1.0,1,1.0,1,1.0,1,0.09405515626731137,43
2169,4,4594,1632,2962,0,0,0,1.0,1,1.0,1,1.0,1,0.07504516066256094,45
2170,2,4596,1633,2963,0,0,0,1.0,1,1.0,1,1.0,1,0.0738185972906835,46
2171,1,4597,1633,2964,0,0,0,1.0,1,1.0,1,1.0,1,0.05691130454106632,48
2172,2,4599,1633,2966,0,0,0,1.0,1,1.0,1,1.0,1,0.07577318529471373,49
2173,3,4602,1635,2967,0,0,0,1.0,1,1.0,1,1.0,1,0.06078790195800821,49
2174,2,4604,1636,2968,0,0,0,1.0,1,1.0,1,1.0,1,0.074855057321836,49
2175,0,4604,1636,2968,0,0,0,1.0,1,1.0,1,1.0,1,0.074855057321836,49
2176,2,4606,1637,2969,0,0,0,1.0,1,1.0,1,1.0,1,0.11541227131560007,51
2177,4,4610,1639,2971,0,0,0,1.0,1,1.0,1,1.0,1,0.1324382016473641,51
2178,3,4613,1640,2973,0,0,0,1.0,1,1.0,1,1.0,1,0.13726890059732244,50
2179,2,4615,1641,2974,0,0,0,1.0,1,1.0,1,1.0,1,0.15588039638131185,49
2180,1,4616,1642,2974,0,0,0,1.0,1,1.0,1,1.0,1,0.19746500463977984,47
2181,8,4624,1644,2980,0,0,0,1.0,1,1.0,1,1.0,1,0.10529640860448557,47
2182,3,4627,1646,2981,0,0,0,1.0,1,1.0,1,1.0,1,0.1475501199968267,45
2183,1,4628,1647,2981,0,0,0,1.0,1,1.0,1,1.0,1,0.1450971391680892,44
2184,3,4631,1649,2982,0,0,0,1.0,1,1.0,1,1.0,1,0.14719562050017465,43
2185,5,4636,1651,2985,0,0,0,1.0,1,1.0,1,1.0,1,0.13189646159850266,40
2186,3,4639,1653,2986,0,0,0,1.0,1,1.0,1,1.0,1,0.15369008807211296,38
2187,3,4642,1655,2987,0,0,0,1.0,1,1.0,1,1.0,1,0.19636573759457226,35
2188,6,4648,1660,2988,0,0,0,1.0,1,1.0,1,1.0,1,0.21794730305478893,34
2189,0,4648,1660,2988,0,0,0,1.0,1,1.0,1,1.0,1,0.2094208062216261,31
2190,1,4649,1661,2988,0,0,0,1.0,1,1.0,1,1.0,1,0.21564914205723726,29
2191,1,4650,1661,2989,0,0,0,1.0,1,1.0,1,1.0,1,0.17875252384960943,28
2192,4,4654,1663,2991,0,0,0,1.0,1,1.0,1,1.0,1,0.19223679551852482,29
2193,2,4656,1665,2991,0,0,0,1.0,1,1.0,1,1.0,1,0.21090373370707852,28
2194,0,4656,1665,2991,0,0,0,1.0,1,1.0,1,1.0,1,0.21392522493811345,27
2195,4,4660,1667,2993,0,0,0,1.0,1,1.0,1,1.0,1,0.18895652506889618,27
2196,5,4665,1668,2997,0,0,0,1.0,1,1.0,1,1.0,1,0.22179213722913438,27
2197,0,4665,1668,2997,0,0,0,1.0,1,1.0,1,1.0,1,0.22179213722913438,27
2198,0,4665,1668,2997,0,0,0,1.0,1,1.0,1,1.0,1,0.21090446347520042,28
2199,2,4667,1669,2998,0,0,0,1.0,1,1.0,1,1.0,1,0.17167007649132512,29
2200,1,4668,1669,2999,0,0,0,1.0,1,1.0,1,1.0,1,0.17144701523231348,31
2201,3,4671,1670,3001,0,0,0,1.0,1,1.0,1,1.0,1,0.1323448434588572,32
2202,4,4675,1673,3002,0,0,0,1.0,1,1.0,1,1.0,1,0.21810144802056988,31
2203,3,4678,1673,3005,0,0,0,1.0,1,1.0,1,1.0,1,0.17828242845000697,32
2204,1,4679,1674,3005,0,0,0,1.0,1,1.0,1,1.0,1,0.22939873247956108,32
2205,2,4681,1675,3006,0,0,0,1.0,1,1.0,1,1.0,1,0.26018547921292967,33
2206,0,4681,1675,3006,0,0,0,1.0,1,1.0,1,1.0,1,0.24381787572670557,32
2207,0,4681,1675,3006,0,0,0,1.0,1,1.0,1,1.0,1,0.23212168787027074,33
2208,2,4683,1676,3007,0,0,0,1.0,1,1.0,1,1.0,1,0.221187482052348,35
2209,1,4684,1676,3008,0,0,0,1.0,1,1.0,1,1.0,1,0.22832376593346002,36
2210,5,4689,1676,3013,0,0,0,1.0,1,1.0,1,1.0,1,0.2331844599964698,35
2211,3,4692,1676,3016,0,0,0,1.0,1,1.0,1,1.0,1,0.18431058920868224,36
2212,3,4695,1676,3019,0,0,0,1.0,1,1.0,1,1.0,1,0.16244798432392696,37
2213,0,4695,1676,3019,0,0,0,1.0,1,1.0,1,1.0,1,0.16244798432392696,37
2214,2,4697,1677,3020,0,0,0,1.0,1,1.0,1,1.0,1,0.1738712314522358,39
2215,5,4702,1679,3023,0,0,0,1.0,1,1.0,1,1.0,1,0.21959331002716911,36
2216,6,4708,1680,3028,0,0,0,1.0,1,1.0,1,1.0,1,0.08059060723601269,37
2217,1,4709,1681,3028,0,0,0,1.0,1,1.0,1,1.0,1,0.1003328426758109,35
2218,2,4711,1682,3029,0,0,0,1.0,1,1.0,1,1.0,1,0.09856643255679683,35
2219,0,4711,1682,3029,0,0,0,1.0,1,1.0,1,1.0,1,0.12225543565431349,33
2220,0,4711,1682,3029,0,0,0,1.0,1,1.0,1,1.0,1,0.16101182775027473,31
2221,1,4712,1682,3030,0,0,0,1.0,1,1.0,1,1.0,1,0.11985083873404498,31
2222,2,4714,1683,3031,0,0,0,1.0,1,1.0,1,1.0,1,0.15353655708812322,30
2223,3,4717,1685,3032,0,0,0,1.0,1,1.0,1,1.0,1,0.17422605504341465,28
2224,4,4721,1688,3033,0,0,0,1.0,1,1.0,1,1.0,1,0.2835183095146907,29
2225,1,4722,1689,3033,0,0,0,1.0,1,1.0,1,1.0,1,0.2622775570078101,28
2226,8,4730,1691,3039,0,0,0,1.0,1,1.0,1,1.0,1,0.19207580252463047,30
2227,5,4735,1691,3044,0,0,0,1.0,1,1.0,1,1.0,1,0.198188464981537,28
2228,2,4737,1691,3046,0,0,0,1.0,1,1.0,1,1.0,1,0.22032983017539706,29
2229,2,4739,1692,3047,0,0,0,1.0,1,1.0,1,1.0,1,0.17595363878884437,28
2230,2,4741,1692,3049,0,0,0,1.0,1,1.0,1,1.0,1,0.17265832027156594,28
2231,3,4744,1693,3051,0,0,0,1.0,1,1.0,1,1.0,1,0.10049342999941072,27
2232,0,4744,1693,3051,0,0,0,1.0,1,1.0,1,1.0,1,0.10904085878157344,27
2233,3,4747,1695,3052,0,0,0,1.0,1,1.0,1,1.0,1,0.10415783788577936,28
2234,1,4748,1696,3052,0,0,0,1.0,1,1.0,1,1.0,1,0.17185741761935172,26
2235,1,4749,1697,3052,0,0,0,1.0,1,1.0,1,1.0,1,0.15523995476512742,26
2236,3,4752,1699,3053,0,0,0,1.0,1,1.0,1,1.0,1,0.25897776737512557,26
2237,1,4753,1699,3054,0,0,0,1.0,1,1.0,1,1.0,1,0.21280502461004097,26
2238,2,4755,1699,3056,0,0,0,1.0,1,1.0,1,1.0,1,0.21382733115427363,27
2239,2,4757,1699,3058,0,0,0,1.0,1,1.0,1,1.0,1,0.20660323679523332,28
2240,3,4760,1700,3060,0,0,0,1.0,1,1.0,1,1.0,1,0.32499367025968895,30
2241,6,4766,1701,3065,0,0,0,1.0,1,1.0,1,1.0,1,0.210230907747493,29
2242,1,4767,1701,3066,0,0,0,1.0,1,1.0,1,1.0,1,0.2042890337665679,29
2243,0,4767,1701,3066,0,0,0,1.0,1,1.0,1,1.0,1,0.2042890337665679,29
2244,1,4768,1701,3067,0,0,0,1.0,1,1.0,1,1.0,1,0.16459850721019578,29
2245,4,4772,1702,3070,0,0,0,1.0,1,1.0,1,1.0,1,0.17351578930590683,30
2246,1,4773,1702,3071,0,0,0,1.0,1,1.0,1,1.0,1,0.13376768038776682,33
2247,0,4773,1702,3071,0,0,0,1.0,1,1.0,1,1.0,1,0.13119512028239577,34
2248,0,4773,1702,3071,0,0,0,1.0,1,1.0,1,1.0,1,0.13119512028239577,34
2249,0,4773,1702,3071,0,0,0,1.0,1,1.0,1,1.0,1,0.12423108071854308,35
2250,1,4774,1703,3071,0,0,0,1.0,1,1.0,1,1.0,1,0.14770942390757247,35
2251,2,4776,1703,3073,0,0,0,1.0,1,1.0,1,1.0,1,0.1249509126191388,36
2252,1,4777,1704,3073,0,0,0,1.0,1,1.0,1,1.0,1,0.17678665518436523,37
2253,2,4779,1705,3074,0,0,0,1.0,1,1.0,1,1.0,1,0.19982124736630721,35
2254,1,4780,1705,3075,0,0,0,1.0,1,1.0,1,1.0,1,0.19401392068035328,33
2255,0,4780,1705,3075,0,0,0,1.0,1,1.0,1,1.0,1,0.1859441853552144,35
2256,2,4782,1706,3076,0,0,0,1.0,1,1.0,1,1.0,1,0.18687222108279908,34
2257,7,4789,1709,3080,0,0,0,1.0,1,1.0,1,1.0,1,0.13648283322806534,36
2258,2,4791,1709,3082,0,0,0,1.0,1,1.0,1,1.0,1,0.0958900121754343,35
2259,2,4793,1711,3082,0,0,0,1.0,1,1.0,1,1.0,1,0.12415508207903397,35
2260,0,4793,1711,3082,0,0,0,1.0,1,1.0,1,1.0,1,0.15298719744222297,33
2261,2,4795,1712,3083,0,0,0,1.0,1,1.0,1,1.0,1,0.16414038000137005,33
2262,2,4797,1713,3084,0,0,0,1.0,1,1.0,1,1.0,1,0.2274467902857178,32
2263,1,4798,1714,3084,0,0,0,1.0,1,1.0,1,1.0,1,0.24022164694696851,31
2264,2,4800,1716,3084,0,0,0,1.0,1,1.0,1,1.0,1,0.25082525716414367,30
2265,0,4800,1716,3084,0,0,0,1.0,1,1.0,1,1.0,1,0.18539545752933095,29
2266,7,4807,1720,3087,0,0,0,1.0,1,1.0,1,1.0,1,0.24647028202144952,30
2267,3,4810,1722,3088,0,0,0,1.0,1,1.0,1,1.0,1,0.27457375776569987,29
2268,3,4813,1723,3090,0,0,0,1.0,1,1.0,1,1.0,1,0.23228897158543674,30
2269,5,4818,1724,3094,0,0,0,1.0,1,1.0,1,1.0,1,0.24168717586145227,31
2270,0,4818,1724,3094,0,0,0,1.0,1,1.0,1,1.0,1,0.24168717586145227,31
2271,8,4826,1727,3099,0,0,0,1.0,1,1.0,1,1.0,1,0.13378764195378098,31
2272,3,4829,1729,3100,0,0,0,1.0,1,1.0,1,1.0,1,0.14540189431839912,31
2273,3,4832,1730,3102,0,0,0,1.0,1,1.0,1,1.0,1,0.2095188823151669,30
2274,2,4834,1730,3104,0,0,0,1.0,1,1.0,1,1.0,1,0.2026747448150329,31
2275,0,4834,1730,3104,0,0,0,1.0,1,1.0,1,1.0,1,0.2062763370335582,32
2276,6,4840,1732,3108,0,0,0,1.0,1,1.0,1,1.0,1,0.15956255323562465,31
2277,2,4842,1732,3110,0,0,0,1.0,1,1.0,1,1.0,1,0.1033231244239527,31
2278,0,4842,1732,3110,0,0,0,1.0,1,1.0,1,1.0,1,0.11624192512667264,32
2279,1,4843,1732,3111,0,0,0,1.0,1,1.0,1,1.0,1,0.13475794714143927,32
2280,0,4843,1732,3111,0,0,0,1.0,1,1.0,1,1.0,1,0.14187501674144096,33
2281,1,4844,1732,3112,0,0,0,1.0,1,1.0,1,1.0,1,0.1319564345569067,34
2282,0,4844,1732,3112,0,0,0,1.0,1,1.0,1,1.0,1,0.1319564345569067,34
2283,0,4844,1732,3112,0,0,0,1.0,1,1.0,1,1.0,1,0.1319564345569067,34
2284,2,4846,1733,3113,0,0,0,1.0,1,1.0,1,1.0,1,0.1312890658036676,34
2285,0,4846,1733,3113,0,0,0,1.0,1,1.0,1,1.0,1,0.12822325206440469,35
2286,0,4846,1733,3113,0,0,0,1.0,1,1.0,1,1.0,1,0.1440123157913111,34
2287,1,4847,1734,3113,0,0,0,1.0,1,1.0,1,1.0,1,0.1346062627907781,35
2288,0,4847,1734,3113,0,0,0,1.0,1,1.0,1,1.0,1,0.19490325374752784,35
2289,3,4850,1735,3115,0,0,0,1.0,1,1.0,1,1.0,1,0.16556454792930844,37
2290,4,4854,1736,3118,0,0,0,1.0,1,1.0,1,1.0,1,0.20805198925616772,37
2291,1,4855,1736,3119,0,0,0,1.0,1,1.0,1,1.0,1,0.16577434492269408,35
2292,0,4855,1736,3119,0,0,0,1.0,1,1.0,1,1.0,1,0.1872444276451431,35
2293,0,4855,1736,3119,0,0,0,1.0,1,1.0,1,1.0,1,0.16636626676281177,34
2294,1,4856,1736,3120,0,0,0,1.0,1,1.0,1,1.0,1,0.1917069348580037,33
2295,0,4856,1736,3120,0,0,0,1.0,1,1.0,1,1.0,1,0.18064712907867972,34
2296,0,4856,1736,3120,0,0,0,1.0,1,1.0,1,1.0,1,0.25385408976074497,33
2297,4,4860,1737,3123,0,0,0,1.0,1,1.0,1,1.0,1,0.22944757537638322,32
2298,1,4861,1737,3124,0,0,0,1.0,1,1.0,1,1.0,1,0.2542401117315189,32
2299,1,4862,1737,3125,0,0,0,1.0,1,1.0,1,1.0,1,0.24226461688178352,33
2300,2,4864,1737,3127,0,0,0,1.0,1,1.0,1,1.0,1,0.19975083198571492,33
2301,0,4864,1737,3127,0,0,0,1.0,1,1.0,1,1.0,1,0.19975083198571492,33
2302,7,4871,1741,3130,0,0,0,1.0,1,1.0,1,1.0,1,0.275888821166959,34
2303,5,4876,1745,3131,0,0,0,1.0,1,1.0,1,1.0,1,0.32583456901596697,34
2304,4,4880,1747,3133,0,0,0,1.0,1,1.0,1,1.0,1,0.2770410839569312,33
2305,3,4883,1748,3135,0,0,0,1.0,1,1.0,1,1.0,1,0.2736989773380056,33
2306,4,4887,1748,3139,0,0,0,1.0,1,1.0,1,1.0,1,0.15894953010372323,33
2307,3,4890,1748,3142,0,0,0,1.0,1,1.0,1,1.0,1,0.15224035699265834,35
2308,2,4892,1748,3144,0,0,0,1.0,1,1.0,1,1.0,1,0.1293701328038864,34
2309,1,4893,1748,3145,0,0,0,1.0,1,1.0,1,1.0,1,0.13325273743901062,34
2310,3,4896,1748,3148,0,0,0,1.0,1,1.0,1,1.0,1,0.11342495435047732,34
2311,3,4899,1749,3150,0,0,0,1.0,1,1.0,1,1.0,1,0.08159385135851,35
2312,2,4901,1751,3150,0,0,0,1.0,1,1.0,1,1.0,1,0.16455715029731993,34
2313,3,4904,1752,3152,0,0,0,1.0,1,1.0,1,1.0,1,0.17920385394642285,35
2314,1,4905,1753,3152,0,0,0,1.0,1,1.0,1,1.0,1,0.18486317638128438,35
2315,3,4908,1753,3155,0,0,0,1.0,1,1.0,1,1.0,1,0.16914806604817947,34
2316,6,4914,1755,3159,0,0,0,1.0,1,1.0,1,1.0,1,0.1657433184346784,35
2317,0,4914,1755,3159,0,0,0,1.0,1,1.0,1,1.0,1,0.1971923023565187,32
2318,3,4917,1756,3161,0,0,0,1.0,1,1.0,1,1.0,1,0.20958762074610757,32
2319,2,4919,1757,3162,0,0,0,1.0,1,1.0,1,1.0,1,0.27568174037933396,32
2320,2,4921,1757,3164,0,0,0,1.0,1,1.0,1,1.0,1,0.2452752915107568,32
2321,4,4925,1757,3168,0,0,0,1.0,1,1.0,1,1.0,1,0.15145701662285038,33
2322,0,4925,1757,3168,0,0,0,1.0,1,1.0,1,1.0,1,0.15145701662285038,33
2323,0,4925,1757,3168,0,0,0,1.0,1,1.0,1,1.0,1,0.15145701662285038,33
2324,2,4927,1758,3169,0,0,0,1.0,1,1.0,1,1.0,1,0.14638792082180177,34
2325,0,4927,1758,3169,0,0,0,1.0,1,1.0,1,1.0,1,0.13522613472089412,35
2326,0,4927,1758,3169,0,0,0,1.0,1,1.0,1,1.0,1,0.13522613472089412,35
2327,1,4928,1758,3170,0,0,0,1.0,1,1.0,1,1.0,1,0.1326957763190456,36
2328,0,4928,1758,3170,0,0,0,1.0,1,1.0,1,1.0,1,0.15243193642629438,37
2329,1,4929,1758,3171,0,0,0,1.0,1,1.0,1,1.0,1,0.13754022470137067,37
2330,0,4929,1758,3171,0,0,0,1.0,1,1.0,1,1.0,1,0.14418358858115696,38
2331,0,4929,1758,3171,0,0,0,1.0,1,1.0,1,1.0,1,0.14694338470693172,40
2332,0,4929,1758,3171,0,0,0,1.0,1,1.0,1,1.0,1,0.14694338470693172,40
2333,0,4929,1758,3171,0,0,0,1.0,1,1.0,1,1.0,1,0.13560658499475242,41
2334,0,4929,1758,3171,0,0,0,1.0,1,1.0,1,1.0,1,0.13560658499475242,41
2335,0,4929,1758,3171,0,0,0,1.0,1,1.0,1,1.0,1,0.13560658499475242,41
2336,1,4930,1758,3172,0,0,0,1.0,1,1.0,1,1.0,1,0.11170599699151314,41
2337,0,4930,1758,3172,0,0,0,1.0,1,1.0,1,1.0,1,0.12457596398613205,42
2338,1,4931,1759,3172,0,0,0,1.0,1,1.0,1,1.0,1,0.14272935251828692,43
2339,0,4931,1759,3172,0,0,0,1.0,1,1.0,1,1.0,1,0.14272935251828692,43
2340,0,4931,1759,3172,0,0,0,1.0,1,1.0,1,1.0,1,0.16085372724810423,45
2341,5,4936,1759,3177,0,0,0,1.0,1,1.0,1,1.0,1,0.0853901722805629,45
2342,4,4940,1760,3180,0,0,0,1.0,1,1.0,1,1.0,1,0.11698656645223847,46
2343,3,4943,1761,3182,0,0,0,1.0,1,1.0,1,1.0,1,0.10712366651570678,45
2344,3,4946,1763,3183,0,0,0,1.0,1,1.0,1,1.0,1,0.1295742050701736,44
2345,2,4948,1764,3184,0,0,0,1.0,1,1.0,1,1.0,1,0.12841515886956384,44
2346,3,4951,1765,3186,0,0,0,1.0,1,1.0,1,1.0,1,0.09341424505392437,44
2347,1,4952,1765,3187,0,0,0,1.0,1,1.0,1,1.0,1,0.07833784713049041,44
2348,1,4953,1765,3188,0,0,0,1.0,1,1.0,1,1.0,1,0.08213672731367647,45
2349,2,4955,1766,3189,0,0,0,1.0,1,1.0,1,1.0,1,0.09602640216919252,46
2350,4,4959,1767,3192,0,0,0,1.0,1,1.0,1,1.0,1,0.11715754494230979,47
2351,4,4963,1767,3196,0,0,0,1.0,1,1.0,1,1.0,1,0.0791112479045833,47
2352,1,4964,1768,3196,0,0,0,1.0,1,1.0,1,1.0,1,0.08445605971757104,47
2353,1,4965,1768,3197,0,0,0,1.0,1,1.0,1,1.0,1,0.06828360310542397,46
2354,2,4967,1769,3198,0,0,0,1.0,1,1.0,1,1.0,1,0.06134938408981696,47
2355,1,4968,1770,3198,0,0,0,1.0,1,1.0,1,1.0,1,0.08368303293357174,47
2356,2,4970,1771,3199,0,0,0,1.0,1,1.0,1,1.0,1,0.08763554288997727,47
2357,1,4971,1772,3199,0,0,0,1.0,1,1.0,1,1.0,1,0.0995495734148115,47
2358,0,4971,1772,3199,0,0,0,1.0,1,1.0,1,1.0,1,0.08270932166499216,48
2359,2,4973,1773,3200,0,0,0,1.0,1,1.0,1,1.0,1,0.11771079946763299,49
2360,1,4974,1773,3201,0,0,0,1.0,1,1.0,1,1.0,1,0.09468557659625979,49
2361,2,4976,1774,3202,0,0,0,1.0,1,1.0,1,1.0,1,0.12364693079921575,50
2362,0,4976,1774,3202,0,0,0,1.0,1,1.0,1,1.0,1,0.1207595259241187,51
2363,0,4976,1774,3202,0,0,0,1.0,1,1.0,1,1.0,1,0.1207595259241187,51
2364,4,4980,1774,3206,0,0,0,1.0,1,1.0,1,1.0,1,0.08162022009665679,52
2365,3,4983,1777,3206,0,0,0,1.0,1,1.0,1,1.0,1,0.12206116737161989,53
2366,6,4989,1778,3211,0,0,0,1.0,1,1.0,1,1.0,1,0.07437751428167502,54
2367,4,4993,1780,3213,0,0,0,1.0,1,1.0,1,1.0,1,0.0731223431302978,52
2368,1,4994,1781,3213,0,0,0,1.0,1,1.0,1,1.0,1,0.09102015696938333,51
2369,3,4997,1783,3214,0,0,0,1.0,1,1.0,1,1.0,1,0.12499625534786164,51
2370,5,5002,1786,3216,0,0,0,1.0,1,1.0,1,1.0,1,0.12363560255421566,52
2371,5,5007,1788,3219,0,0,0,1.0,1,1.0,1,1.0,1,0.05592929399059759,52
2372,3,5010,1790,3220,0,0,0,1.0,1,1.0,1,1.0,1,0.09777729757688455,49
2373,1,5011,1791,3220,0,0,0,1.0,1,1.0,1,1.0,1,0.10152173600825463,47
2374,0,5011,1791,3220,0,0,0,1.0,1,1.0,1,1.0,1,0.08891317292862957,45
2375,0,5011,1791,3220,0,0,0,1.0,1,1.0,1,1.0,1,0.0855732947700004,45
2376,1,5012,1791,3221,0,0,0,1.0,1,1.0,1,1.0,1,0.07298106159250728,43
2377,1,5013,1792,3221,0,0,0,1.0,1,1.0,1,1.0,1,0.12083542019185432,44
2378,0,5013,1792,3221,0,0,0,1.0,1,1.0,1,1.0,1,0.10716084832257868,43
2379,0,5013,1792,3221,0,0,0,1.0,1,1.0,1,1.0,1,0.10716084832257868,43
2380,4,5017,1794,3223,0,0,0,1.0,1,1.0,1,1.0,1,0.13257958299249115,43
2381,4,5021,1797,3224,0,0,0,1.0,1,1.0,1,1.0,1,0.11379374900182695,44
2382,4,5025,1800,3225,0,0,0,1.0,1,1.0,1,1.0,1,0.10719901285045526,44
2383,6,5031,1801,3230,0,0,0,1.0,1,1.0,1,1.0,1,0.11427044691875737,45
2384,11,5042,1804,3238,0,0,0,1.0,1,1.0,1,1.0,1,0.16453047446514218,45
2385,5,5047,1804,3243,0,0,0,1.0,1,1.0,1,1.0,1,0.16401117262937176,45
2386,8,5055,1807,3248,0,0,0,1.0,1,1.0,1,1.0,1,0.13741767121367643,46
2387,5,5060,1809,3251,0,0,0,1.0,1,1.0,1,1.0,1,0.1345297262112779,44
2388,4,5064,1811,3253,0,0,0,1.0,1,1.0,1,1.0,1,0.11835097048344807,44
2389,3,5067,1811,3256,0,0,0,1.0,1,1.0,1,1.0,1,0.11367333794455137,43
2390,4,5071,1813,3258,0,0,0,1.0,1,1.0,1,1.0,1,0.09232230421572109,44
2391,3,5074,1814,3260,0,0,0,1.0,1,1.0,1,1.0,1,0.09243101880384984,43
2392,6,5080,1817,3263,0,0,0,1.0,1,1.0,1,1.0,1,0.18372380975461935,44
2393,1,5081,1817,3264,0,0,0,1.0,1,1.0,1,1.0,1,0.16742719640334827,45
2394,3,5084,1818,3266,0,0,0,1.0,1,1.0,1,1.0,1,0.17416926867788052,44
2395,2,5086,1818,3268,0,0,0,1.0,1,1.0,1,1.0,1,0.13349858521605712,44
2396,2,5088,1819,3269,0,0,0,1.0,1,1.0,1,1.0,1,0.12333931391338697,45
2397,1,5089,1819,3270,0,0,0,1.0,1,1.0,1,1.0,1,0.1366410815870031,44
2398,2,5091,1820,3271,0,0,0,1.0,1,1.0,1,1.0,1,0.1711437439148313,44
2399,3,5094,1820,3274,0,0,0,1.0,1,1.0,1,1.0,1,0.17581447994335214,45
2400,3,5097,1820,3277,0,0,0,1.0,1,1.0,1,1.0,1,0.1476860362660837,45
2401,3,5100,1820,3280,0,0,0,1.0,1,1.0,1,1.0,1,0.10603476616829152,46
2402,1,5101,1820,3281,0,0,0,1.0,1,1.0,1,1.0,1,0.10426188841120472,47
2403,2,5103,1820,3283,0,0,0,1.0,1,1.0,1,1.0,1,0.10124460592072249,48
2404,2,5105,1820,3285,0,0,0,1.0,1,1.0,1,1.0,1,0.1083041720748705,47
2405,2,5107,1820,3287,0,0,0,1.0,1,1.0,1,1.0,1,0.08876286860948884,45
2406,2,5109,1821,3288,0,0,0,1.0,1,1.0,1,1.0,1,0.08226412585735123,45
2407,0,5109,1821,3288,0,0,0,1.0,1,1.0,1,1.0,1,0.11416307644664234,42
2408,1,5110,1822,3288,0,0,0,1.0,1,1.0,1,1.0,1,0.11708527906244692,41
2409,1,5111,1822,3289,0,0,0,1.0,1,1.0,1,1.0,1,0.12769581048392598,41
2410,2,5113,1822,3291,0,0,0,1.0,1,1.0,1,1.0,1,0.12970709482047618,40
2411,2,5115,1822,3293,0,0,0,1.0,1,1.0,1,1.0,1,0.10964772275346112,40
2412,1,5116,1823,3293,0,0,0,1.0,1,1.0,1,1.0,1,0.20420346457780525,38
2413,7,5123,1826,3297,0,0,0,1.0,1,1.0,1,1.0,1,0.20007780756347507,38
2414,2,5125,1827,3298,0,0,0,1.0,1,1.0,1,1.0,1,0.21049830424243157,36
2415,2,5127,1828,3299,0,0,0,1.0,1,1.0,1,1.0,1,0.24060101296805675,36
2416,5,5132,1829,3303,0,0,0,1.0,1,1.0,1,1.0,1,0.17690557463193277,35
2417,1,5133,1829,3304,0,0,0,1.0,1,1.0,1,1.0,1,0.20002225150193662,33
2418,2,5135,1830,3305,0,0,0,1.0,1,1.0,1,1.0,1,0.2239892918026591,33
2419,0,5135,1830,3305,0,0,0,1.0,1,1.0,1,1.0,1,0.2618018705440166,33
2420,1,5136,1830,3306,0,0,0,1.0,1,1.0,1,1.0,1,0.19087264107101248,34
2421,4,5140,1831,3309,0,0,0,1.0,1,1.0,1,1.0,1,0.18611121890751156,34
2422,7,5147,1834,3313,0,0,0,1.0,1,1.0,1,1.0,1,0.1663859763743423,35
2423,8,5155,1836,3319,0,0,0,1.0,1,1.0,1,1.0,1,0.17659812046766835,36
2424,3,5158,1837,3321,0,0,0,1.0,1,1.0,1,1.0,1,0.17558251743437833,35
2425,0,5158,1837,3321,0,0,0,1.0,1,1.0,1,1.0,1,0.14496598044696393,33
2426,2,5160,1838,3322,0,0,0,1.0,1,1.0,1,1.0,1,0.12375272221851273,34
2427,1,5161,1838,3323,0,0,0,1.0,1,1.0,1,1.0,1,0.10395323839035381,34
2428,4,5165,1840,3325,0,0,0,1.0,1,1.0,1,1.0,1,0.1347797932539381,34
2429,2,5167,1841,3326,0,0,0,1.0,1,1.0,1,1.0,1,0.15900757449729114,34
2430,0,5167,1841,3326,0,0,0,1.0,1,1.0,1,1.0,1,0.17770554452601997,33
2431,1,5168,1842,3326,0,0,0,1.0,1,1.0,1,1.0,1,0.1564002307420346,33
2432,0,5168,1842,3326,0,0,0,1.0,1,1.0,1,1.0,1,0.2045104416775222,33
2433,0,5168,1842,3326,0,0,0,1.0,1,1.0,1,1.0,1,0.1697397727688045,34
2434,1,5169,1842,3327,0,0,0,1.0,1,1.0,1,1.0,1,0.12564594470468857,34
2435,3,5172,1843,3329,0,0,0,1.0,1,1.0,1,1.0,1,0.09164216225255697,34
2436,1,5173,1844,3329,0,0,0,1.0,1,1.0,1,1.0,1,0.10379943958395803,33
2437,2,5175,1845,3330,0,0,0,1.0,1,1.0,1,1.0,1,0.11762423562085254,33
2438,1,5176,1846,3330,0,0,0,1.0,1,1.0,1,1.0,1,0.05114922513170067,34
2439,0,5176,1846,3330,0,0,0,1.0,1,1.0,1,1.0,1,0.06905445855433981,35
2440,0,5176,1846,3330,0,0,0,1.0,1,1.0,1,1.0,1,0.06905445855433981,35
2441,1,5177,1847,3330,0,0,0,1.0,1,1.0,1,1.0,1,0.10354131750102935,35
2442,0,5177,1847,3330,0,0,0,1.0,1,1.0,1,1.0,1,0.10510297449576582,35
2443,3,5180,1849,3331,0,0,0,1.0,1,1.0,1,1.0,1,0.17229746102325594,35
2444,3,5183,1850,3333,0,0,0,1.0,1,1.0,1,1.0,1,0.23043858793208408,34
2445,4,5187,1852,3335,0,0,0,1.0,1,1.0,1,1.0,1,0.27221671041483325,33
2446,6,5193,1854,3339,0,0,0,1.0,1,1.0,1,1.0,1,0.24058468472087188,30
2447,2,5195,1854,3341,0,0,0,1.0,1,1.0,1,1.0,1,0.13899527979976384,29
2448,1,5196,1855,3341,0,0,0,1.0,1,1.0,1,1.0,1,0.22397858984811805,27
2449,2,5198,1855,3343,0,0,0,1.0,1,1.0,1,1.0,1,0.2239762006718491,26
2450,4,5202,1857,3345,0,0,0,1.0,1,1.0,1,1.0,1,0.27177141019135365,28
2451,3,5205,1857,3348,0,0,0,1.0,1,1.0,1,1.0,1,0.19343751778608723,28
2452,1,5206,1857,3349,0,0,0,1.0,1,1.0,1,1.0,1,0.20838440137182335,29
2453,2,5208,1858,3350,0,0,0,1.0,1,1.0,1,1.0,1,0.16572470762054534,30
2454,5,5213,1858,3355,0,0,0,1.0,1,1.0,1,1.0,1,0.15464729738306573,32
2455,4,5217,1858,3359,0,0,0,1.0,1,1.0,1,1.0,1,0.21396070344878235,33
2456,6,5223,1858,3365,0,0,0,1.0,1,1.0,1,1.0,1,0.10731643725399924,34
2457,0,5223,1858,3365,0,0,0,1.0,1,1.0,1,1.0,1,0.10731643725399924,34
2458,2,5225,1860,3365,0,0,0,1.0,1,1.0,1,1.0,1,0.16501557673453743,36
2459,0,5225,1860,3365,0,0,0,1.0,1,1.0,1,1.0,1,0.16501557673453743,36
2460,3,5228,1862,3366,0,0,0,1.0,1,1.0,1,1.0,1,0.14961090108031916,37
2461,2,5230,1863,3367,0,0,0,1.0,1,1.0,1,1.0,1,0.14338203221527904,37
2462,6,5236,1865,3371,0,0,0,1.0,1,1.0,1,1.0,1,0.12704027649776062,38
2463,1,5237,1866,3371,0,0,0,1.0,1,1.0,1,1.0,1,0.1263120999203323,38
2464,3,5240,1869,3371,0,0,0,1.0,1,1.0,1,1.0,1,0.20221773112478034,37
2465,0,5240,1869,3371,0,0,0,1.0,1,1.0,1,1.0,1,0.1778395042559233,36
2466,3,5243,1871,3372,0,0,0,1.0,1,1.0,1,1.0,1,0.11973200613968196,36
2467,0,5243,1871,3372,0,0,0,1.0,1,1.0,1,1.0,1,0.14986787707666896,34
2468,2,5245,1872,3373,0,0,0,1.0,1,1.0,1,1.0,1,0.18895665542019957,33
2469,1,5246,1873,3373,0,0,0,1.0,1,1.0,1,1.0,1,0.20283812904218154,32
2470,3,5249,1876,3373,0,0,0,1.0,1,1.0,1,1.0,1,0.2686123193737994,33
2471,4,5253,1876,3377,0,0,0,1.0,1,1.0,1,1.0,1,0.19175134090301676,31
2472,2,5255,1876,3379,0,0,0,1.0,1,1.0,1,1.0,1,0.19341108845824637,32
2473,0,5255,1876,3379,0,0,0,1.0,1,1.0,1,1.0,1,0.20585675884619442,31
2474,6,5261,1877,3384,0,0,0,1.0,1,1.0,1,1.0,1,0.17250171846709866,33
2475,4,5265,1878,3387,0,0,0,1.0,1,1.0,1,1.0,1,0.18580191697219572,33
2476,3,5268,1879,3389,0,0,0,1.0,1,1.0,1,1.0,1,0.14985900112816217,33
2477,2,5270,1880,3390,0,0,0,1.0,1,1.0,1,1.0,1,0.14099285774805215,33
2478,1,5271,1880,3391,0,0,0,1.0,1,1.0,1,1.0,1,0.16002527249474688,33
2479,4,5275,1882,3393,0,0,0,1.0,1,1.0,1,1.0,1,0.16304946696273862,33
2480,5,5280,1883,3397,0,0,0,1.0,1,1.0,1,1.0,1,0.16602739715989254,34
2481,6,5286,1885,3401,0,0,0,1.0,1,1.0,1,1.0,1,0.14051551533573878,33
2482,0,5286,1885,3401,0,0,0,1.0,1,1.0,1,1.0,1,0.13006441042489186,34
2483,3,5289,1887,3402,0,0,0,1.0,1,1.0,1,1.0,1,0.17714663726686167,33
2484,0,5289,1887,3402,0,0,0,1.0,1,1.0,1,1.0,1,0.15816110165122868,32
2485,1,5290,1887,3403,0,0,0,1.0,1,1.0,1,1.0,1,0.2051604606144903,31
2486,5,5295,1887,3408,0,0,0,1.0,1,1.0,1,1.0,1,0.10521411168505507,29
2487,1,5296,1887,3409,0,0,0,1.0,1,1.0,1,1.0,1,0.07563378277007728,29
2488,1,5297,1887,3410,0,0,0,1.0,1,1.0,1,1.0,1,0.1369793916228455,30
2489,1,5298,1887,3411,0,0,0,1.0,1,1.0,1,1.0,1,0.16220449514056032,29
2490,1,5299,1888,3411,0,0,0,1.0,1,1.0,1,1.0,1,0.23375107245534985,30
2491,1,5300,1888,3412,0,0,0,1.0,1,1.0,1,1.0,1,0.20991479992501053,30
2492,1,5301,1889,3412,0,0,0,1.0,1,1.0,1,1.0,1,0.2405960831710961,29
2493,0,5301,1889,3412,0,0,0,1.0,1,1.0,1,1.0,1,0.2405960831710961,29
2494,1,5302,1890,3412,0,0,0,1.0,1,1.0,1,1.0,1,0.28839988396090616,28
2495,3,5305,1891,3414,0,0,0,1.0,1,1.0,1,1.0,1,0.2809546537207924,29
2496,3,5308,1891,3417,0,0,0,1.0,1,1.0,1,1.0,1,0.14829916673002272,28
2497,0,5308,1891,3417,0,0,0,1.0,1,1.0,1,1.0,1,0.1912967590718221,28
2498,1,5309,1891,3418,0,0,0,1.0,1,1.0,1,1.0,1,0.18452045971534745,29
2499,2,5311,1891,3420,0,0,0,1.0,1,1.0,1,1.0,1,0.135910299812819,30
2500,3,5314,1891,3423,0,0,0,1.0,1,1.0,1,1.0,1,0.10942246286129956,29
2501,4,5318,1893,3425,0,0,0,1.0,1,1.0,1,1.0,1,0.15152421073100297,33
2502,3,5321,1894,3427,0,0,0,1.0,1,1.0,1,1.0,1,0.1190577968087997,33
2503,0,5321,1894,3427,0,0,0,1.0,1,1.0,1,1.0,1,0.10461125604972123,31
2504,8,5329,1899,3430,0,0,0,1.0,1,1.0,1,1.0,1,0.23348185278974248,31
2505,4,5333,1900,3433,0,0,0,1.0,1,1.0,1,1.0,1,0.2050498655496757,32
2506,4,5337,1901,3436,0,0,0,1.0,1,1.0,1,1.0,1,0.16721840033300361,31
2507,0,5337,1901,3436,0,0,0,1.0,1,1.0,1,1.0,1,0.1940061445578035,29
2508,2,5339,1903,3436,0,0,0,1.0,1,1.0,1,1.0,1,0.1992016143358368,31
2509,0,5339,1903,3436,0,0,0,1.0,1,1.0,1,1.0,1,0.2085437424004476,30
2510,3,5342,1905,3437,0,0,0,1.0,1,1.0,1,1.0,1,0.2609838057532856,31
2511,6,5348,1905,3443,0,0,0,1.0,1,1.0,1,1.0,1,0.15364407190135776,32
2512,2,5350,1907,3443,0,0,0,1.0,1,1.0,1,1.0,1,0.15671514682816065,32
2513,4,5354,1909,3445,0,0,0,1.0,1,1.0,1,1.0,1,0.16855133896833246,34
2514,4,5358,1909,3449,0,0,0,1.0,1,1.0,1,1.0,1,0.1325318905292753,35
2515,7,5365,1911,3454,0,0,0,1.0,1,1.0,1,1.0,1,0.16284811277252928,35
2516,2,5367,1912,3455,0,0,0,1.0,1,1.0,1,1.0,1,0.18171201600895903,34
2517,3,5370,1913,3457,0,0,0,1.0,1,1.0,1,1.0,1,0.16311710309891014,34
2518,2,5372,1914,3458,0,0,0,1.0,1,1.0,1,1.0,1,0.17844338138282476,33
2519,0,5372,1914,3458,0,0,0,1.0,1,1.0,1,1.0,1,0.1906385014642014,32
2520,1,5373,1915,3458,0,0,0,1.0,1,1.0,1,1.0,1,0.17414567815329077,31
2521,0,5373,1915,3458,0,0,0,1.0,1,1.0,1,1.0,1,0.12582182420988555,31
2522,1,5374,1916,3458,0,0,0,1.0,1,1.0,1,1.0,1,0.15940636380998568,30
2523,0,5374,1916,3458,0,0,0,1.0,1,1.0,1,1.0,1,0.13186698966060145,30
2524,0,5374,1916,3458,0,0,0,1.0,1,1.0,1,1.0,1,0.17758880341392633,29
2525,1,5375,1917,3458,0,0,0,1.0,1,1.0,1,1.0,1,0.24790209450720316,29
2526,3,5378,1917,3461,0,0,0,1.0,1,1.0,1,1.0,1,0.14302118900802865,27
2527,0,5378,1917,3461,0,0,0,1.0,1,1.0,1,1.0,1,0.16362934622418376,28
2528,0,5378,1917,3461,0,0,0,1.0,1,1.0,1,1.0,1,0.16362934622418376,28
2529,0,5378,1917,3461,0,0,0,1.0,1,1.0,1,1.0,1,0.16362934622418376,28
2530,0,5378,1917,3461,0,0,0,1.0,1,1.0,1,1.0,1,0.17162471195926812,29
2531,2,5380,1917,3463,0,0,0,1.0,1,1.0,1,1.0,1,0.15332260594456254,30
2532,0,5380,1917,3463,0,0,0,1.0,1,1.0,1,1.0,1,0.15592959060170436,31
2533,0,5380,1917,3463,0,0,0,1.0,1,1.0,1,1.0,1,0.15592959060170436,31
2534,0,5380,1917,3463,0,0,0,1.0,1,1.0,1,1.0,1,0.15592959060170436,31
2535,1,5381,1918,3463,0,0,0,1.0,1,1.0,1,1.0,1,0.20294189059221407,31
2536,1,5382,1918,3464,0,0,0,1.0,1,1.0,1,1.0,1,0.1998080712487969,32
2537,0,5382,1918,3464,0,0,0,1.0,1,1.0,1,1.0,1,0.18476796451117647,33
2538,3,5385,1919,3466,0,0,0,1.0,1,1.0,1,1.0,1,0.20699736364968993,35
2539,9,5394,1921,3473,0,0,0,1.0,1,1.0,1,1.0,1,0.22126772687919682,37
2540,5,5399,1922,3477,0,0,0,1.0,1,1.0,1,1.0,1,0.2308888709372695,38
2541,3,5402,1922,3480,0,0,0,1.0,1,1.0,1,1.0,1,0.16223449777572532,39
2542,2,5404,1923,3481,0,0,0,1.0,1,1.0,1,1.0,1,0.19936845674447512,38
2543,4,5408,1925,3483,0,0,0,1.0,1,1.0,1,1.0,1,0.20695906320474558,41
2544,3,5411,1928,3483,0,0,0,1.0,1,1.0,1,1.0,1,0.2218210056091609,39
2545,3,5414,1929,3485,0,0,0,1.0,1,1.0,1,1.0,1,0.23029957439854942,40
2546,5,5419,1930,3489,0,0,0,1.0,1,1.0,1,1.0,1,0.15007901451886177,38
2547,5,5424,1932,3492,0,0,0,1.0,1,1.0,1,1.0,1,0.18067129488145478,38
2548,1,5425,1932,3493,0,0,0,1.0,1,1.0,1,1.0,1,0.10116596091200974,35
2549,4,5429,1935,3494,0,0,0,1.0,1,1.0,1,1.0,1,0.15183752303950712,35
2550,0,5429,1935,3494,0,0,0,1.0,1,1.0,1,1.0,1,0.1340069968337418,33
2551,2,5431,1937,3494,0,0,0,1.0,1,1.0,1,1.0,1,0.18233524365559564,31
2552,0,5431,1937,3494,0,0,0,1.0,1,1.0,1,1.0,1,0.21797729786113287,30
2553,0,5431,1937,3494,0,0,0,1.0,1,1.0,1,1.0,1,0.21797729786113287,30
2554,3,5434,1938,3496,0,0,0,1.0,1,1.0,1,1.0,1,0.2083200404880544,32
2555,0,5434,1938,3496,0,0,0,1.0,1,1.0,1,1.0,1,0.22595525106567801,32
2556,2,5436,1939,3497,0,0,0,1.0,1,1.0,1,1.0,1,0.1629170560512897,32
2557,0,5436,1939,3497,0,0,0,1.0,1,1.0,1,1.0,1,0.2087946395272532,30
2558,2,5438,1940,3498,0,0,0,1.0,1,1.0,1,1.0,1,0.21083152239667924,31
2559,1,5439,1940,3499,0,0,0,1.0,1,1.0,1,1.0,1,0.1860117853263077,30
2560,0,5439,1940,3499,0,0,0,1.0,1,1.0,1,1.0,1,0.1860117853263077,30
2561,0,5439,1940,3499,0,0,0,1.0,1,1.0,1,1.0,1,0.1860117853263077,30
2562,3,5442,1940,3502,0,0,0,1.0,1,1.0,1,1.0,1,0.170687951308713,33
2563,1,5443,1940,3503,0,0,0,1.0,1,1.0,1,1.0,1,0.16496149055819484,33
2564,1,5444,1940,3504,0,0,0,1.0,1,1.0,1,1.0,1,0.14746239986171952,33
2565,0,5444,1940,3504,0,0,0,1.0,1,1.0,1,1.0,1,0.14746239986171952,33
2566,1,5445,1940,3505,0,0,0,1.0,1,1.0,1,1.0,1,0.15224779088331009,35
2567,1,5446,1941,3505,0,0,0,1.0,1,1.0,1,1.0,1,0.15866479152435248,36
2568,2,5448,1941,3507,0,0,0,1.0,1,1.0,1,1.0,1,0.1467879349718743,37
2569,0,5448,1941,3507,0,0,0,1.0,1,1.0,1,1.0,1,0.1467879349718743,37
2570,1,5449,1941,3508,0,0,0,1.0,1,1.0,1,1.0,1,0.17877055875919687,37
2571,3,5452,1941,3511,0,0,0,1.0,1,1.0,1,1.0,1,0.12823331213097094,37
2572,0,5452,1941,3511,0,0,0,1.0,1,1.0,1,1.0,1,0.12064832096829452,39
2573,1,5453,1941,3512,0,0,0,1.0,1,1.0,1,1.0,1,0.10175401654234592,39
2574,0,5453,1941,3512,0,0,0,1.0,1,1.0,1,1.0,1,0.11390949134739686,38
2575,0,5453,1941,3512,0,0,0,1.0,1,1.0,1,1.0,1,0.11390949134739686,38
2576,1,5454,1941,3513,0,0,0,1.0,1,1.0,1,1.0,1,0.11835178754100784,37
2577,0,5454,1941,3513,0,0,0,1.0,1,1.0,1,1.0,1,0.1476670077467315,39
2578,0,5454,1941,3513,0,0,0,1.0,1,1.0,1,1.0,1,0.16073345345410844,40
2579,0,5454,1941,3513,0,0,0,1.0,1,1.0,1,1.0,1,0.14077791427358954,41
2580,2,5456,1941,3515,0,0,0,1.0,1,1.0,1,1.0,1,0.12275908859546592,42
2581,4,5460,1941,3519,0,0,0,1.0,1,1.0,1,1.0,1,0.08551684350963404,43
2582,2,5462,1942,3520,0,0,0,1.0,1,1.0,1,1.0,1,0.11334700248522159,43
2583,3,5465,1943,3522,0,0,0,1.0,1,1.0,1,1.0,1,0.13308530791450446,43
2584,2,5467,1943,3524,0,0,0,1.0,1,1.0,1,1.0,1,0.11403955871807166,43
2585,4,5471,1944,3527,0,0,0,1.0,1,1.0,1,1.0,1,0.11786732422412928,44
2586,2,5473,1946,3527,0,0,0,1.0,1,1.0,1,1.0,1,0.10651322479093246,43
2587,4,5477,1948,3529,0,0,0,1.0,1,1.0,1,1.0,1,0.0721650511667373,44
2588,2,5479,1948,3531,0,0,0,1.0,1,1.0,1,1.0,1,0.06764113952563039,44
2589,4,5483,1950,3533,0,0,0,1.0,1,1.0,1,1.0,1,0.12767783259903187,44
2590,0,5483,1950,3533,0,0,0,1.0,1,1.0,1,1.0,1,0.12767783259903187,44
2591,2,5485,1950,3535,0,0,0,1.0,1,1.0,1,1.0,1,0.06977978900499501,44
2592,2,5487,1951,3536,0,0,0,1.0,1,1.0,1,1.0,1,0.08467576110188835,44
2593,0,5487,1951,3536,0,0,0,1.0,1,1.0,1,1.0,1,0.06504163196897753,43
2594,3,5490,1952,3538,0,0,0,1.0,1,1.0,1,1.0,1,0.12481719468251946,48
2595,2,5492,1952,3540,0,0,0,1.0,1,1.0,1,1.0,1,0.1649382976043924,45
2596,9,5501,1953,3548,0,0,0,1.0,1,1.0,1,1.0,1,0.09787848426180233,46
2597,2,5503,1954,3549,0,0,0,1.0,1,1.0,1,1.0,1,0.09816354918021238,45
2598,1,5504,1955,3549,0,0,0,1.0,1,1.0,1,1.0,1,0.11192673617341728,45
2599,4,5508,1958,3550,0,0,0,1.0,1,1.0,1,1.0,1,0.17795264651149037,45
2600,6,5514,1960,3554,0,0,0,1.0,1,1.0,1,1.0,1,0.12829281225073552,48
2601,1,5515,1960,3555,0,0,0,1.0,1,1.0,1,1.0,1,0.11454000920002026,47
2602,2,5517,1960,3557,0,0,0,1.0,1,1.0,1,1.0,1,0.12995404623319956,48
2603,0,5517,1960,3557,0,0,0,1.0,1,1.0,1,1.0,1,0.12995404623319956,48
2604,0,5517,1960,3557,0,0,0,1.0,1,1.0,1,1.0,1,0.1474029589434015,47
2605,3,5520,1963,3557,0,0,0,1.0,1,1.0,1,1.0,1,0.1955998945120503,47
2606,6,5526,1964,3562,0,0,0,1.0,1,1.0,1,1.0,1,0.13714324352715787,46
2607,0,5526,1964,3562,0,0,0,1.0,1,1.0,1,1.0,1,0.11649027873992522,45
2608,4,5530,1964,3566,0,0,0,1.0,1,1.0,1,1.0,1,0.09643974695340979,45
2609,0,5530,1964,3566,0,0,0,1.0,1,1.0,1,1.0,1,0.11459974318100076,44
2610,3,5533,1965,3568,0,0,0,1.0,1,1.0,1,1.0,1,0.1164192584982513,45
2611,3,5536,1967,3569,0,0,0,1.0,1,1.0,1,1.0,1,0.12985197378077623,46
2612,3,5539,1968,3571,0,0,0,1.0,1,1.0,1,1.0,1,0.11098469859415529,47
2613,4,5543,1968,3575,0,0,0,1.0,1,1.0,1,1.0,1,0.08594291518829551,48
2614,4,5547,1970,3577,0,0,0,1.0,1,1.0,1,1.0,1,0.12004996561929429,48
2615,3,5550,1971,3579,0,0,0,1.0,1,1.0,1,1.0,1,0.10953122334980518,49
2616,0,5550,1971,3579,0,0,0,1.0,1,1.0,1,1.0,1,0.10953122334980518,49
2617,0,5550,1971,3579,0,0,0,1.0,1,1.0,1,1.0,1,0.09390244174254059,48
2618,1,5551,1972,3579,0,0,0,1.0,1,1.0,1,1.0,1,0.14680965877628743,47
2619,4,5555,1972,3583,0,0,0,1.0,1,1.0,1,1.0,1,0.08004209044319602,50
2620,2,5557,1973,3584,0,0,0,1.0,1,1.0,1,1.0,1,0.10466048821987368,51
2621,2,5559,1974,3585,0,0,0,1.0,1,1.0,1,1.0,1,0.11533509295192362,52
2622,0,5559,1974,3585,0,0,0,1.0,1,1.0,1,1.0,1,0.09511561901513774,52
2623,3,5562,1975,3587,0,0,0,1.0,1,1.0,1,1.0,1,0.08889585152005805,53
2624,2,5564,1977,3587,0,0,0,1.0,1,1.0,1,1.0,1,0.11514736161898369,51
2625,2,5566,1979,3587,0,0,0,1.0,1,1.0,1,1.0,1,0.10870876461216317,50
2626,3,5569,1981,3588,0,0,0,1.0,1,1.0,1,1.0,1,0.1296394796419568,49
2627,3,5572,1982,3590,0,0,0,1.0,1,1.0,1,1.0,1,0.10542020240691227,48
2628,5,5577,1984,3593,0,0,0,1.0,1,1.0,1,1.0,1,0.12670391497195763,48
2629,0,5577,1984,3593,0,0,0,1.0,1,1.0,1,1.0,1,0.14659608660889425,47
2630,4,5581,1986,3595,0,0,0,1.0,1,1.0,1,1.0,1,0.12487526486784235,47
2631,2,5583,1987,3596,0,0,0,1.0,1,1.0,1,1.0,1,0.11853793473530265,47
2632,3,5586,1989,3597,0,0,0,1.0,1,1.0,1,1.0,1,0.13240678161173441,47
2633,1,5587,1990,3597,0,0,0,1.0,1,1.0,1,1.0,1,0.09136469649143399,44
2634,1,5588,1991,3597,0,0,0,1.0,1,1.0,1,1.0,1,0.13019294807670018,44
2635,5,5593,1993,3600,0,0,0,1.0,1,1.0,1,1.0,1,0.16998641509075604,45
2636,4,5597,1995,3602,0,0,0,1.0,1,1.0,1,1.0,1,0.13178287229610505,40
2637,4,5601,1997,3604,0,0,0,1.0,1,1.0,1,1.0,1,0.17009363089936547,41
2638,5,5606,2000,3606,0,0,0,1.0,1,1.0,1,1.0,1,0.17030228814357073,38
2639,2,5608,2000,3608,0,0,0,1.0,1,1.0,1,1.0,1,0.1249758633304203,39
2640,0,5608,2000,3608,0,0,0,1.0,1,1.0,1,1.0,1,0.1085527646953418,38
2641,3,5611,2003,3608,0,0,0,1.0,1,1.0,1,1.0,1,0.1296671744651853,37
2642,5,5616,2006,3610,0,0,0,1.0,1,1.0,1,1.0,1,0.16813785742649645,38
2643,0,5616,2006,3610,0,0,0,1.0,1,1.0,1,1.0,1,0.1352647351711399,37
2644,0,5616,2006,3610,0,0,0,1.0,1,1.0,1,1.0,1,0.1551435607989019,36
2645,2,5618,2007,3611,0,0,0,1.0,1,1.0,1,1.0,1,0.11662631241472524,35
2646,1,5619,2007,3612,0,0,0,1.0,1,1.0,1,1.0,1,0.0888316212161621,35
2647,0,5619,2007,3612,0,0,0,1.0,1,1.0,1,1.0,1,0.11527367083382915,35
2648,0,5619,2007,3612,0,0,0,1.0,1,1.0,1,1.0,1,0.12400300089315511,36
2649,1,5620,2007,3613,0,0,0,1.0,1,1.0,1,1.0,1,0.08953516642167478,37
2650,1,5621,2007,3614,0,0,0,1.0,1,1.0,1,1.0,1,0.09813161067334703,39
2651,0,5621,2007,3614,0,0,0,1.0,1,1.0,1,1.0,1,0.09813161067334703,39
2652,0,5621,2007,3614,0,0,0,1.0,1,1.0,1,1.0,1,0.09813161067334703,39
2653,0,5621,2007,3614,0,0,0,1.0,1,1.0,1,1.0,1,0.09813161067334703,39
2654,0,5621,2007,3614,0,0,0,1.0,1,1.0,1,1.0,1,0.09538431155496396,40
2655,0,5621,2007,3614,0,0,0,1.0,1,1.0,1,1.0,1,0.09538431155496396,40
2656,2,5623,2008,3615,0,0,0,1.0,1,1.0,1,1.0,1,0.1326061882755217,39
2657,2,5625,2008,3617,0,0,0,1.0,1,1.0,1,1.0,1,0.12655279183712376,40
2658,2,5627,2008,3619,0,0,0,1.0,1,1.0,1,1.0,1,0.16168936398471584,41
2659,3,5630,2011,3619,0,0,0,1.0,1,1.0,1,1.0,1,0.22865011887624173,41
2660,3,5633,2012,3621,0,0,0,1.0,1,1.0,1,1.0,1,0.2091493021226597,40
2661,7,5640,2013,3627,0,0,0,1.0,1,1.0,1,1.0,1,0.08070946470101428,40
2662,7,5647,2017,3630,0,0,0,1.0,1,1.0,1,1.0,1,0.1585095409812065,42
2663,2,5649,2018,3631,0,0,0,1.0,1,1.0,1,1.0,1,0.12878524632693625,41
2664,1,5650,2018,3632,0,0,0,1.0,1,1.0,1,1.0,1,0.13715160841655202,42
2665,5,5655,2020,3635,0,0,0,1.0,1,1.0,1,1.0,1,0.11437264729155693,43
2666,6,5661,2023,3638,0,0,0,1.0,1,1.0,1,1.0,1,0.1244898451313422,44
2667,3,5664,2025,3639,0,0,0,1.0,1,1.0,1,1.0,1,0.173125254281542,42
2668,5,5669,2027,3642,0,0,0,1.0,1,1.0,1,1.0,1,0.20053824954588817,41
2669,4,5673,2027,3646,0,0,0,1.0,1,1.0,1,1.0,1,0.21260653963919865,42
2670,2,5675,2027,3648,0,0,0,1.0,1,1.0,1,1.0,1,0.2534658863782825,40
2671,6,5681,2030,3651,0,0,0,1.0,1,1.0,1,1.0,1,0.22894822371745022,39
2672,1,5682,2030,3652,0,0,0,1.0,1,1.0,1,1.0,1,0.26238682954090037,36
2673,3,5685,2031,3654,0,0,0,1.0,1,1.0,1,1.0,1,0.22954074050112214,35
2674,0,5685,2031,3654,0,0,0,1.0,1,1.0,1,1.0,1,0.21546144305372078,33
2675,2,5687,2032,3655,0,0,0,1.0,1,1.0,1,1.0,1,0.21612844725781194,34
2676,1,5688,2032,3656,0,0,0,1.0,1,1.0,1,1.0,1,0.17286236000498015,32
2677,2,5690,2033,3657,0,0,0,1.0,1,1.0,1,1.0,1,0.20318661165827573,33
2678,3,5693,2034,3659,0,0,0,1.0,1,1.0,1,1.0,1,0.19474245283110567,33
2679,1,5694,2034,3660,0,0,0,1.0,1,1.0,1,1.0,1,0.15321253468068805,32
2680,0,5694,2034,3660,0,0,0,1.0,1,1.0,1,1.0,1,0.15321253468068805,32
2681,2,5696,2034,3662,0,0,0,1.0,1,1.0,1,1.0,1,0.13907616066759107,32
2682,3,5699,2036,3663,0,0,0,1.0,1,1.0,1,1.0,1,0.12005235091220419,33
2683,0,5699,2036,3663,0,0,0,1.0,1,1.0,1,1.0,1,0.14917421042489032,32
2684,1,5700,2036,3664,0,0,0,1.0,1,1.0,1,1.0,1,0.15814525650476177,31
2685,3,5703,2036,3667,0,0,0,1.0,1,1.0,1,1.0,1,0.15343887221308367,31
2686,0,5703,2036,3667,0,0,0,1.0,1,1.0,1,1.0,1,0.17727824286579444,30
2687,1,5704,2037,3667,0,0,0,1.0,1,1.0,1,1.0,1,0.21721595446624156,30
2688,4,5708,2038,3670,0,0,0,1.0,1,1.0,1,1.0,1,0.19773482554296878,30
2689,3,5711,2039,3672,0,0,0,1.0,1,1.0,1,1.0,1,0.18572139599114912,31
2690,3,5714,2041,3673,0,0,0,1.0,1,1.0,1,1.0,1,0.1435197372155912,31
2691,1,5715,2041,3674,0,0,0,1.0,1,1.0,1,1.0,1,0.10870030016938782,32
2692,1,5716,2042,3674,0,0,0,1.0,1,1.0,1,1.0,1,0.09741188785449832,32
2693,1,5717,2043,3674,0,0,0,1.0,1,1.0,1,1.0,1,0.1132004894014564,33
2694,1,5718,2043,3675,0,0,0,1.0,1,1.0,1,1.0,1,0.09411832168573726,34
2695,0,5718,2043,3675,0,0,0,1.0,1,1.0,1,1.0,1,0.08762223427840464,35
2696,0,5718,2043,3675,0,0,0,1.0,1,1.0,1,1.0,1,0.08762223427840464,35
2697,0,5718,2043,3675,0,0,0,1.0,1,1.0,1,1.0,1,0.08762223427840464,35
2698,1,5719,2044,3675,0,0,0,1.0,1,1.0,1,1.0,1,0.13472878330482418,36
2699,1,5720,2044,3676,0,0,0,1.0,1,1.0,1,1.0,1,0.1385780010731044,36
2700,0,5720,2044,3676,0,0,0,1.0,1,1.0,1,1.0,1,0.1486155863982127,37
2701,3,5723,2045,3678,0,0,0,1.0,1,1.0,1,1.0,1,0.13908081653170165,37
2702,6,5729,2049,3680,0,0,0,1.0,1,1.0,1,1.0,1,0.20728284994224253,37
2703,3,5732,2050,3682,0,0,0,1.0,1,1.0,1,1.0,1,0.19992672222733576,38
2704,3,5735,2052,3683,0,0,0,1.0,1,1.0,1,1.0,1,0.24159984987816557,37
2705,3,5738,2053,3685,0,0,0,1.0,1,1.0,1,1.0,1,0.22173004527062287,36
2706,6,5744,2054,3690,0,0,0,1.0,1,1.0,1,1.0,1,0.1436264058492837,36
2707,0,5744,2054,3690,0,0,0,1.0,1,1.0,1,1.0,1,0.17078119827446922,35
2708,8,5752,2058,3694,0,0,0,1.0,1,1.0,1,1.0,1,0.1617437427085485,36
2709,2,5754,2058,3696,0,0,0,1.0,1,1.0,1,1.0,1,0.17572770260107762,32
2710,2,5756,2059,3697,0,0,0,1.0,1,1.0,1,1.0,1,0.16595464582965005,29
2711,3,5759,2061,3698,0,0,0,1.0,1,1.0,1,1.0,1,0.23929469382189883,29
2712,2,5761,2062,3699,0,0,0,1.0,1,1.0,1,1.0,1,0.2991557385892981,28
2713,1,5762,2062,3700,0,0,0,1.0,1,1.0,1,1.0,1,0.2635477458011459,28
2714,0,5762,2062,3700,0,0,0,1.0,1,1.0,1,1.0,1,0.3044225270134405,26
2715,1,5763,2062,3701,0,0,0,1.0,1,1.0,1,1.0,1,0.3035713761108462,24
2716,2,5765,2062,3703,0,0,0,1.0,1,1.0,1,1.0,1,0.25766044899560653,24
2717,3,5768,2062,3706,0,0,0,1.0,1,1.0,1,1.0,1,0.19584970291923184,25
2718,4,5772,2063,3709,0,0,0,1.0,1,1.0,1,1.0,1,0.3042905214191788,25
2719,4,5776,2065,3711,0,0,0,1.0,1,1.0,1,1.0,1,0.3229310707525196,25
2720,3,5779,2066,3713,0,0,0,1.0,1,1.0,1,1.0,1,0.3099216028055281,25
2721,4,5783,2068,3715,0,0,0,1.0,1,1.0,1,1.0,1,0.20170147605389982,25
2722,2,5785,2069,3716,0,0,0,1.0,1,1.0,1,1.0,1,0.2307239619419443,26
2723,2,5787,2069,3718,0,0,0,1.0,1,1.0,1,1.0,1,0.18502380602835802,26
2724,4,5791,2070,3721,0,0,0,1.0,1,1.0,1,1.0,1,0.1766385128865065,27
2725,2,5793,2070,3723,0,0,0,1.0,1,1.0,1,1.0,1,0.15361304663782124,28
2726,1,5794,2071,3723,0,0,0,1.0,1,1.0,1,1.0,1,0.1458604552203492,28
2727,1,5795,2071,3724,0,0,0,1.0,1,1.0,1,1.0,1,0.11272560871683988,29
2728,1,5796,2072,3724,0,0,0,1.0,1,1.0,1,1.0,1,0.15257007986057067,29
2729,2,5798,2073,3725,0,0,0,1.0,1,1.0,1,1.0,1,0.1676647904076959,29
2730,2,5800,2073,3727,0,0,0,1.0,1,1.0,1,1.0,1,0.1676647904076959,29
2731,1,5801,2073,3728,0,0,0,1.0,1,1.0,1,1.0,1,0.1476123240888214,30
2732,1,5802,2074,3728,0,0,0,1.0,1,1.0,1,1.0,1,0.15651369013921024,29
2733,0,5802,2074,3728,0,0,0,1.0,1,1.0,1,1.0,1,0.15651369013921024,29
2734,0,5802,2074,3728,0,0,0,1.0,1,1.0,1,1.0,1,0.15651369013921024,29
2735,0,5802,2074,3728,0,0,0,1.0,1,1.0,1,1.0,1,0.15651369013921024,29
2736,1,5803,2075,3728,0,0,0,1.0,1,1.0,1,1.0,1,0.19101693279513599,30
2737,1,5804,2075,3729,0,0,0,1.0,1,1.0,1,1.0,1,0.2061120372945601,30
2738,2,5806,2076,3730,0,0,0,1.0,1,1.0,1,1.0,1,0.20354422406780448,30
2739,4,5810,2077,3733,0,0,0,1.0,1,1.0,1,1.0,1,0.20561595876477642,29
2740,1,5811,2078,3733,0,0,0,1.0,1,1.0,1,1.0,1,0.24026092416591707,29
2741,4,5815,2079,3736,0,0,0,1.0,1,1.0,1,1.0,1,0.17433276590487032,28
2742,3,5818,2080,3738,0,0,0,1.0,1,1.0,1,1.0,1,0.14234191383875996,28
2743,2,5820,2081,3739,0,0,0,1.0,1,1.0,1,1.0,1,0.17176103702578946,29
2744,2,5822,2082,3740,0,0,0,1.0,1,1.0,1,1.0,1,0.12382791797638429,27
2745,1,5823,2083,3740,0,0,0,1.0,1,1.0,1,1.0,1,0.12056390964197555,25
2746,2,5825,2084,3741,0,0,0,1.0,1,1.0,1,1.0,1,0.13432681546242567,25
2747,2,5827,2086,3741,0,0,0,1.0,1,1.0,1,1.0,1,0.1495266233014046,23
2748,1,5828,2086,3742,0,0,0,1.0,1,1.0,1,1.0,1,0.14777462165012187,22
2749,0,5828,2086,3742,0,0,0,1.0,1,1.0,1,1.0,1,0.29817974547464293,19
2750,2,5830,2088,3742,0,0,0,1.0,1,1.0,1,1.0,1,0.3112918463032917,18
2751,2,5832,2088,3744,0,0,0,1.0,1,1.0,1,1.0,1,0.2455964400052178,16
2752,0,5832,2088,3744,0,0,0,1.0,1,1.0,1,1.0,1,0.23685723459045463,15
2753,0,5832,2088,3744,0,0,0,1.0,1,1.0,1,1.0,1,0.23685723459045463,15
2754,0,5832,2088,3744,0,0,0,1.0,1,1.0,1,1.0,1,0.23685723459045463,15
2755,0,5832,2088,3744,0,0,0,1.0,1,1.0,1,1.0,1,0.23685723459045463,15
2756,0,5832,2088,3744,0,0,0,1.0,1,1.0,1,1.0,1,0.23660095290331373,16
2757,0,5832,2088,3744,0,0,0,1.0,1,1.0,1,1.0,1,0.2006860520846258,17
2758,0,5832,2088,3744,0,0,0,1.0,1,1.0,1,1.0,1,0.2006860520846258,17
2759,0,5832,2088,3744,0,0,0,1.0,1,1.0,1,1.0,1,0.204581227319692,18
2760,0,5832,2088,3744,0,0,0,1.0,1,1.0,1,1.0,1,0.204581227319692,18
2761,0,5832,2088,3744,0,0,0,1.0,1,1.0,1,1.0,1,0.204581227319692,18
2762,0,5832,2088,3744,0,0,0,1.0,1,1.0,1,1.0,1,0.204581227319692,18
2763,0,5832,2088,3744,0,0,0,1.0,1,1.0,1,1.0,1,0.20133804632688523,17
2764,1,5833,2089,3744,0,0,0,1.0,1,1.0,1,1.0,1,0.2924757924136496,17
2765,0,5833,2089,3744,0,0,0,1.0,1,1.0,1,1.0,1,0.3148231821618095,18
2766,2,5835,2089,3746,0,0,0,1.0,1,1.0,1,1.0,1,0.23366752532005045,18
2767,1,5836,2089,3747,0,0,0,1.0,1,1.0,1,1.0,1,0.27088892376010404,18
2768,0,5836,2089,3747,0,0,0,1.0,1,1.0,1,1.0,1,0.27088892376010404,18
2769,2,5838,2090,3748,0,0,0,1.0,1,1.0,1,1.0,1,0.31267519648600633,18
2770,0,5838,2090,3748,0,0,0,1.0,1,1.0,1,1.0,1,0.31267519648600633,18
2771,3,5841,2090,3751,0,0,0,1.0,1,1.0,1,1.0,1,0.23089521602317,18
2772,1,5842,2090,3752,0,0,0,1.0,1,1.0,1,1.0,1,0.24484485692830446,18
2773,0,5842,2090,3752,0,0,0,1.0,1,1.0,1,1.0,1,0.24484485692830446,18
2774,2,5844,2091,3753,0,0,0,1.0,1,1.0,1,1.0,1,0.31274089821967516,20
2775,3,5847,2091,3756,0,0,0,1.0,1,1.0,1,1.0,1,0.29853783252837457,21
2776,1,5848,2091,3757,0,0,0,1.0,1,1.0,1,1.0,1,0.2770513328628156,21
2777,1,5849,2091,3758,0,0,0,1.0,1,1.0,1,1.0,1,0.2412519041160458,22
2778,3,5852,2092,3760,0,0,0,1.0,1,1.0,1,1.0,1,0.17258197321205065,24
2779,0,5852,2092,3760,0,0,0,1.0,1,1.0,1,1.0,1,0.17258197321205065,24
2780,0,5852,2092,3760,0,0,0,1.0,1,1.0,1,1.0,1,0.17258197321205065,24
2781,1,5853,2092,3761,0,0,0,1.0,1,1.0,1,1.0,1,0.13712420523156796,24
2782,1,5854,2092,3762,0,0,0,1.0,1,1.0,1,1.0,1,0.10817802736620086,24
2783,0,5854,2092,3762,0,0,0,1.0,1,1.0,1,1.0,1,0.10817802736620086,24
2784,2,5856,2093,3763,0,0,0,1.0,1,1.0,1,1.0,1,0.17454947197014997,24
2785,1,5857,2094,3763,0,0,0,1.0,1,1.0,1,1.0,1,0.14435776848851944,22
2786,2,5859,2095,3764,0,0,0,1.0,1,1.0,1,1.0,1,0.17588676307633033,22
2787,1,5860,2095,3765,0,0,0,1.0,1,1.0,1,1.0,1,0.18281685070394577,21
2788,0,5860,2095,3765,0,0,0,1.0,1,1.0,1,1.0,1,0.22663053124387478,20
2789,1,5861,2096,3765,0,0,0,1.0,1,1.0,1,1.0,1,0.22833237619148544,20
2790,0,5861,2096,3765,0,0,0,1.0,1,1.0,1,1.0,1,0.2585120085768751,21
2791,2,5863,2097,3766,0,0,0,1.0,1,1.0,1,1.0,1,0.25976331181607676,21
2792,0,5863,2097,3766,0,0,0,1.0,1,1.0,1,1.0,1,0.25976331181607676,21
2793,0,5863,2097,3766,0,0,0,1.0,1,1.0,1,1.0,1,0.3210807787168822,18
2794,0,5863,2097,3766,0,0,0,1.0,1,1.0,1,1.0,1,0.3210807787168822,18
2795,1,5864,2097,3767,0,0,0,1.0,1,1.0,1,1.0,1,0.20075757593960852,20
2796,1,5865,2097,3768,0,0,0,1.0,1,1.0,1,1.0,1,0.15755905229338749,21
2797,2,5867,2097,3770,0,0,0,1.0,1,1.0,1,1.0,1,0.15897720362030082,21
2798,0,5867,2097,3770,0,0,0,1.0,1,1.0,1,1.0,1,0.15897720362030082,21
2799,0,5867,2097,3770,0,0,0,1.0,1,1.0,1,1.0,1,0.15260801805545782,22
2800,0,5867,2097,3770,0,0,0,1.0,1,1.0,1,1.0,1,0.15260801805545782,22
2801,1,5868,2098,3770,0,0,0,1.0,1,1.0,1,1.0,1,0.17976212345061915,22
2802,0,5868,2098,3770,0,0,0,1.0,1,1.0,1,1.0,1,0.17976212345061915,22
2803,1,5869,2099,3770,0,0,0,1.0,1,1.0,1,1.0,1,0.20467924527281475,22
2804,0,5869,2099,3770,0,0,0,1.0,1,1.0,1,1.0,1,0.22035138643035027,23
2805,0,5869,2099,3770,0,0,0,1.0,1,1.0,1,1.0,1,0.22035138643035027,23
2806,1,5870,2099,3771,0,0,0,1.0,1,1.0,1,1.0,1,0.1911921771981831,23
2807,0,5870,2099,3771,0,0,0,1.0,1,1.0,1,1.0,1,0.18391480876844338,24
2808,0,5870,2099,3771,0,0,0,1.0,1,1.0,1,1.0,1,0.18391480876844338,24
2809,1,5871,2100,3771,0,0,0,1.0,1,1.0,1,1.0,1,0.21605584522310456,25
2810,0,5871,2100,3771,0,0,0,1.0,1,1.0,1,1.0,1,0.2121866013199729,24
2811,1,5872,2100,3772,0,0,0,1.0,1,1.0,1,1.0,1,0.2049934931643545,26
2812,2,5874,2101,3773,0,0,0,1.0,1,1.0,1,1.0,1,0.2352596494429636,26
2813,0,5874,2101,3773,0,0,0,1.0,1,1.0,1,1.0,1,0.2507928487481804,27
2814,4,5878,2102,3776,0,0,0,1.0,1,1.0,1,1.0,1,0.2185016584068286,29
2815,0,5878,2102,3776,0,0,0,1.0,1,1.0,1,1.0,1,0.2185016584068286,29
2816,3,5881,2102,3779,0,0,0,1.0,1,1.0,1,1.0,1,0.14533026725218595,29
2817,0,5881,2102,3779,0,0,0,1.0,1,1.0,1,1.0,1,0.14533026725218595,29
2818,1,5882,2102,3780,0,0,0,1.0,1,1.0,1,1.0,1,0.13982160426335635,29
2819,0,5882,2102,3780,0,0,0,1.0,1,1.0,1,1.0,1,0.1539497766799582,30
2820,0,5882,2102,3780,0,0,0,1.0,1,1.0,1,1.0,1,0.17732620835136867,30
2821,3,5885,2104,3781,0,0,0,1.0,1,1.0,1,1.0,1,0.21837515109486086,31
2822,5,5890,2106,3784,0,0,0,1.0,1,1.0,1,1.0,1,0.1768240204929129,30
2823,2,5892,2108,3784,0,0,0,1.0,1,1.0,1,1.0,1,0.183039096817754,27
2824,1,5893,2109,3784,0,0,0,1.0,1,1.0,1,1.0,1,0.20445379484094187,28
2825,3,5896,2111,3785,0,0,0,1.0,1,1.0,1,1.0,1,0.14325141712446593,28
2826,2,5898,2112,3786,0,0,0,1.0,1,1.0,1,1.0,1,0.19612100792095824,27
2827,2,5900,2113,3787,0,0,0,1.0,1,1.0,1,1.0,1,0.20437786660412216,28
2828,0,5900,2113,3787,0,0,0,1.0,1,1.0,1,1.0,1,0.2314853269755202,28
2829,1,5901,2114,3787,0,0,0,1.0,1,1.0,1,1.0,1,0.24814790382218765,27
2830,3,5904,2115,3789,0,0,0,1.0,1,1.0,1,1.0,1,0.27720223034353775,27
2831,1,5905,2115,3790,0,0,0,1.0,1,1.0,1,1.0,1,0.25789848355514794,27
2832,4,5909,2116,3793,0,0,0,1.0,1,1.0,1,1.0,1,0.2748376223414178,27
2833,2,5911,2116,3795,0,0,0,1.0,1,1.0,1,1.0,1,0.22266190313382137,26
2834,1,5912,2117,3795,0,0,0,1.0,1,1.0,1,1.0,1,0.19461853691536055,26
2835,2,5914,2118,3796,0,0,0,1.0,1,1.0,1,1.0,1,0.1631945165871554,25
2836,0,5914,2118,3796,0,0,0,1.0,1,1.0,1,1.0,1,0.14741518835776155,27
2837,0,5914,2118,3796,0,0,0,1.0,1,1.0,1,1.0,1,0.15239559608362266,27
2838,3,5917,2119,3798,0,0,0,1.0,1,1.0,1,1.0,1,0.1749731016135435,27
2839,0,5917,2119,3798,0,0,0,1.0,1,1.0,1,1.0,1,0.15492535573867192,29
2840,1,5918,2119,3799,0,0,0,1.0,1,1.0,1,1.0,1,0.14285976501747438,29
2841,2,5920,2120,3800,0,0,0,1.0,1,1.0,1,1.0,1,0.10335493725932453,31
2842,0,5920,2120,3800,0,0,0,1.0,1,1.0,1,1.0,1,0.10335493725932453,31
2843,0,5920,2120,3800,0,0,0,1.0,1,1.0,1,1.0,1,0.14564498567402345,32
2844,1,5921,2121,3800,0,0,0,1.0,1,1.0,1,1.0,1,0.17333246751508458,33
2845,3,5924,2122,3802,0,0,0,1.0,1,1.0,1,1.0,1,0.20975436483754212,32
2846,2,5926,2123,3803,0,0,0,1.0,1,1.0,1,1.0,1,0.19859473961333446,33
2847,3,5929,2125,3804,0,0,0,1.0,1,1.0,1,1.0,1,0.27867987660119786,32
2848,0,5929,2125,3804,0,0,0,1.0,1,1.0,1,1.0,1,0.2741305045467946,33
2849,2,5931,2125,3806,0,0,0,1.0,1,1.0,1,1.0,1,0.24860682640415005,34
2850,0,5931,2125,3806,0,0,0,1.0,1,1.0,1,1.0,1,0.24860682640415005,34
2851,3,5934,2125,3809,0,0,0,1.0,1,1.0,1,1.0,1,0.1927261091414282,34
2852,4,5938,2128,3810,0,0,0,1.0,1,1.0,1,1.0,1,0.17605223986823693,35
2853,1,5939,2129,3810,0,0,0,1.0,1,1.0,1,1.0,1,0.1741198351470771,36
2854,0,5939,2129,3810,0,0,0,1.0,1,1.0,1,1.0,1,0.1891387286981529,37
2855,1,5940,2130,3810,0,0,0,1.0,1,1.0,1,1.0,1,0.15696509212313617,38
2856,1,5941,2130,3811,0,0,0,1.0,1,1.0,1,1.0,1,0.13371175577826555,38
2857,1,5942,2131,3811,0,0,0,1.0,1,1.0,1,1.0,1,0.11810803342152379,39
2858,5,5947,2134,3813,0,0,0,1.0,1,1.0,1,1.0,1,0.15679263377461825,40
2859,3,5950,2135,3815,0,0,0,1.0,1,1.0,1,1.0,1,0.11655184736441103,40
2860,1,5951,2136,3815,0,0,0,1.0,1,1.0,1,1.0,1,0.14163723942899614,40
2861,4,5955,2137,3818,0,0,0,1.0,1,1.0,1,1.0,1,0.07476041930465568,38
2862,4,5959,2140,3819,0,0,0,1.0,1,1.0,1,1.0,1,0.11739886502957655,38
2863,6,5965,2142,3823,0,0,0,1.0,1,1.0,1,1.0,1,0.14878286656821738,38
2864,5,5970,2145,3825,0,0,0,1.0,1,1.0,1,1.0,1,0.23152858048304678,36
2865,4,5974,2147,3827,0,0,0,1.0,1,1.0,1,1.0,1,0.32134845872633316,34
2866,4,5978,2148,3830,0,0,0,1.0,1,1.0,1,1.0,1,0.1537490981731486,31
2867,1,5979,2148,3831,0,0,0,1.0,1,1.0,1,1.0,1,0.12630244579898248,30
2868,4,5983,2151,3832,0,0,0,1.0,1,1.0,1,1.0,1,0.19207971332306412,27
2869,1,5984,2152,3832,0,0,0,1.0,1,1.0,1,1.0,1,0.21114470288582238,27
2870,2,5986,2154,3832,0,0,0,1.0,1,1.0,1,1.0,1,0.2695985595113988,25
2871,1,5987,2154,3833,0,0,0,1.0,1,1.0,1,1.0,1,0.22034000754838173,25
2872,1,5988,2155,3833,0,0,0,1.0,1,1.0,1,1.0,1,0.3117010681905456,23
2873,4,5992,2156,3836,0,0,0,1.0,1,1.0,1,1.0,1,0.2719968440001632,24
2874,1,5993,2156,3837,0,0,0,1.0,1,1.0,1,1.0,1,0.19909072203012093,24
2875,0,5993,2156,3837,0,0,0,1.0,1,1.0,1,1.0,1,0.24777939789118375,23
2876,5,5998,2157,3841,0,0,0,1.0,1,1.0,1,1.0,1,0.2069168253485275,24
2877,2,6000,2158,3842,0,0,0,1.0,1,1.0,1,1.0,1,0.27411254262169293,24
2878,1,6001,2158,3843,0,0,0,1.0,1,1.0,1,1.0,1,0.24421753635133253,24
2879,2,6003,2160,3843,0,0,0,1.0,1,1.0,1,1.0,1,0.27800092256922826,25
2880,1,6004,2160,3844,0,0,0,1.0,1,1.0,1,1.0,1,0.26827810686102327,26
2881,1,6005,2160,3845,0,0,0,1.0,1,1.0,1,1.0,1,0.22689022636108733,26
2882,0,6005,2160,3845,0,0,0,1.0,1,1.0,1,1.0,1,0.2031582314837032,27
2883,0,6005,2160,3845,0,0,0,1.0,1,1.0,1,1.0,1,0.18096560030711398,28
2884,4,6009,2161,3848,0,0,0,1.0,1,1.0,1,1.0,1,0.23317554889959247,29
2885,2,6011,2161,3850,0,0,0,1.0,1,1.0,1,1.0,1,0.22111333763608232,31
2886,4,6015,2163,3852,0,0,0,1.0,1,1.0,1,1.0,1,0.2808235180530725,31
2887,2,6017,2163,3854,0,0,0,1.0,1,1.0,1,1.0,1,0.2170404251394147,33
2888,2,6019,2164,3855,0,0,0,1.0,1,1.0,1,1.0,1,0.22346527908095454,34
2889,3,6022,2164,3858,0,0,0,1.0,1,1.0,1,1.0,1,0.16624954641321077,35
2890,1,6023,2165,3858,0,0,0,1.0,1,1.0,1,1.0,1,0.17238928661738412,35
2891,1,6024,2165,3859,0,0,0,1.0,1,1.0,1,1.0,1,0.15320594800211154,35
2892,0,6024,2165,3859,0,0,0,1.0,1,1.0,1,1.0,1,0.15320594800211154,35
2893,2,6026,2165,3861,0,0,0,1.0,1,1.0,1,1.0,1,0.15251021541671891,37
2894,0,6026,2165,3861,0,0,0,1.0,1,1.0,1,1.0,1,0.15251021541671891,37
2895,1,6027,2166,3861,0,0,0,1.0,1,1.0,1,1.0,1,0.19747342886064412,37
2896,2,6029,2166,3863,0,0,0,1.0,1,1.0,1,1.0,1,0.19033054074418598,38
2897,0,6029,2166,3863,0,0,0,1.0,1,1.0,1,1.0,1,0.2258847094130299,37
2898,0,6029,2166,3863,0,0,0,1.0,1,1.0,1,1.0,1,0.24366639691530784,38
2899,1,6030,2167,3863,0,0,0,1.0,1,1.0,1,1.0,1,0.23466358389470868,37
2900,0,6030,2167,3863,0,0,0,1.0,1,1.0,1,1.0,1,0.24528633864450153,36
2901,4,6034,2168,3866,0,0,0,1.0,1,1.0,1,1.0,1,0.19156505746074784,37
2902,2,6036,2169,3867,0,0,0,1.0,1,1.0,1,1.0,1,0.18407901022381792,35
2903,0,6036,2169,3867,0,0,0,1.0,1,1.0,1,1.0,1,0.1955585747146401,35
2904,0,6036,2169,3867,0,0,0,1.0,1,1.0,1,1.0,1,0.17489254684243816,33
2905,0,6036,2169,3867,0,0,0,1.0,1,1.0,1,1.0,1,0.1718138483475872,34
2906,2,6038,2171,3867,0,0,0,1.0,1,1.0,1,1.0,1,0.2330832917672854,34
2907,1,6039,2171,3868,0,0,0,1.0,1,1.0,1,1.0,1,0.20940100901813002,35
2908,1,6040,2171,3869,0,0,0,1.0,1,1.0,1,1.0,1,0.20646949690316133,36
2909,3,6043,2171,3872,0,0,0,1.0,1,1.0,1,1.0,1,0.203143432117816,38
2910,0,6043,2171,3872,0,0,0,1.0,1,1.0,1,1.0,1,0.203143432117816,38
2911,0,6043,2171,3872,0,0,0,1.0,1,1.0,1,1.0,1,0.1845946063642676,37
2912,0,6043,2171,3872,0,0,0,1.0,1,1.0,1,1.0,1,0.1845946063642676,37
2913,0,6043,2171,3872,0,0,0,1.0,1,1.0,1,1.0,1,0.2000347416162423,38
2914,0,6043,2171,3872,0,0,0,1.0,1,1.0,1,1.0,1,0.2000347416162423,38
2915,1,6044,2171,3873,0,0,0,1.0,1,1.0,1,1.0,1,0.1992911392785915,39
2916,3,6047,2171,3876,0,0,0,1.0,1,1.0,1,1.0,1,0.18280360676280466,40
2917,3,6050,2173,3877,0,0,0,1.0,1,1.0,1,1.0,1,0.18090020762146536,41
2918,1,6051,2174,3877,0,0,0,1.0,1,1.0,1,1.0,1,0.2078479054154561,41
2919,0,6051,2174,3877,0,0,0,1.0,1,1.0,1,1.0,1,0.2078479054154561,41
2920,2,6053,2174,3879,0,0,0,1.0,1,1.0,1,1.0,1,0.22382975382795536,43
2921,7,6060,2174,3886,0,0,0,1.0,1,1.0,1,1.0,1,0.1336784872350015,42
2922,3,6063,2175,3888,0,0,0,1.0,1,1.0,1,1.0,1,0.12033623531623663,43
2923,1,6064,2175,3889,0,0,0,1.0,1,1.0,1,1.0,1,0.1300643264371507,44
2924,3,6067,2175,3892,0,0,0,1.0,1,1.0,1,1.0,1,0.11016379849126394,45
2925,3,6070,2175,3895,0,0,0,1.0,1,1.0,1,1.0,1,0.08342714262239494,45
2926,0,6070,2175,3895,0,0,0,1.0,1,1.0,1,1.0,1,0.08463564897677556,47
2927,1,6071,2176,3895,0,0,0,1.0,1,1.0,1,1.0,1,0.11451661472129156,47
2928,1,6072,2177,3895,0,0,0,1.0,1,1.0,1,1.0,1,0.10597512758371,48
2929,0,6072,2177,3895,0,0,0,1.0,1,1.0,1,1.0,1,0.10597512758371,48
2930,1,6073,2177,3896,0,0,0,1.0,1,1.0,1,1.0,1,0.11871305367706161,50
2931,1,6074,2177,3897,0,0,0,1.0,1,1.0,1,1.0,1,0.11181460593774906,51
2932,0,6074,2177,3897,0,0,0,1.0,1,1.0,1,1.0,1,0.11181460593774906,51
2933,1,6075,2178,3897,0,0,0,1.0,1,1.0,1,1.0,1,0.14229332219719465,52
2934,2,6077,2179,3898,0,0,0,1.0,1,1.0,1,1.0,1,0.14539395000707087,52
2935,1,6078,2180,3898,0,0,0,1.0,1,1.0,1,1.0,1,0.16600811256011863,51
2936,1,6079,2180,3899,0,0,0,1.0,1,1.0,1,1.0,1,0.15345294440619775,49
2937,2,6081,2180,3901,0,0,0,1.0,1,1.0,1,1.0,1,0.15278434808721775,50
2938,3,6084,2181,3903,0,0,0,1.0,1,1.0,1,1.0,1,0.14097558402650567,50
2939,1,6085,2181,3904,0,0,0,1.0,1,1.0,1,1.0,1,0.1457481087733871,51
2940,3,6088,2182,3906,0,0,0,1.0,1,1.0,1,1.0,1,0.1459327067945961,52
2941,1,6089,2182,3907,0,0,0,1.0,1,1.0,1,1.0,1,0.13688852277221256,53
2942,2,6091,2184,3907,0,0,0,1.0,1,1.0,1,1.0,1,0.16744373753480857,52
2943,4,6095,2186,3909,0,0,0,1.0,1,1.0,1,1.0,1,0.1511564214683179,51
2944,2,6097,2187,3910,0,0,0,1.0,1,1.0,1,1.0,1,0.12988863264413736,52
2945,3,6100,2188,3912,0,0,0,1.0,1,1.0,1,1.0,1,0.14468501201805514,50
2946,4,6104,2189,3915,0,0,0,1.0,1,1.0,1,1.0,1,0.11236893188368563,51
2947,3,6107,2191,3916,0,0,0,1.0,1,1.0,1,1.0,1,0.09249532169739966,50
2948,4,6111,2193,3918,0,0,0,1.0,1,1.0,1,1.0,1,0.07376975683229613,50
2949,0,6111,2193,3918,0,0,0,1.0,1,1.0,1,1.0,1,0.06262323066042805,49
2950,2,6113,2194,3919,0,0,0,1.0,1,1.0,1,1.0,1,0.0773038514703283,48
2951,1,6114,2195,3919,0,0,0,1.0,1,1.0,1,1.0,1,0.11225797784638214,48
2952,1,6115,2195,3920,0,0,0,1.0,1,1.0,1,1.0,1,0.1367126052674515,46
2953,0,6115,2195,3920,0,0,0,1.0,1,1.0,1,1.0,1,0.1367126052674515,46
2954,0,6115,2195,3920,0,0,0,1.0,1,1.0,1,1.0,1,0.1295687270982859,48
2955,1,6116,2195,3921,0,0,0,1.0,1,1.0,1,1.0,1,0.12040475706907139,48
2956,1,6117,2195,3922,0,0,0,1.0,1,1.0,1,1.0,1,0.1189836192553567,47
2957,3,6120,2197,3923,0,0,0,1.0,1,1.0,1,1.0,1,0.14744717822007758,48
2958,0,6120,2197,3923,0,0,0,1.0,1,1.0,1,1.0,1,0.15423423893767724,49
2959,5,6125,2198,3927,0,0,0,1.0,1,1.0,1,1.0,1,0.12350138595577063,49
2960,6,6131,2199,3932,0,0,0,1.0,1,1.0,1,1.0,1,0.12195264702516632,49
2961,8,6139,2201,3938,0,0,0,1.0,1,1.0,1,1.0,1,0.1514784024440115,51
2962,4,6143,2202,3941,0,0,0,1.0,1,1.0,1,1.0,1,0.12681355074265976,51
2963,2,6145,2202,3943,0,0,0,1.0,1,1.0,1,1.0,1,0.12681355074265976,51
2964,3,6148,2202,3946,0,0,0,1.0,1,1.0,1,1.0,1,0.0990278870196962,52
2965,0,6148,2202,3946,0,0,0,1.0,1,1.0,1,1.0,1,0.10682708376155256,53
2966,3,6151,2203,3948,0,0,0,1.0,1,1.0,1,1.0,1,0.09008843745814414,53
2967,0,6151,2203,3948,0,0,0,1.0,1,1.0,1,1.0,1,0.09576044593245318,53
2968,1,6152,2203,3949,0,0,0,1.0,1,1.0,1,1.0,1,0.06852363846290946,54
2969,1,6153,2204,3949,0,0,0,1.0,1,1.0,1,1.0,1,0.08477892831760112,55
2970,3,6156,2204,3952,0,0,0,1.0,1,1.0,1,1.0,1,0.07729837602076071,55
2971,5,6161,2205,3956,0,0,0,1.0,1,1.0,1,1.0,1,0.09796077803614067,55
2972,3,6164,2205,3959,0,0,0,1.0,1,1.0,1,1.0,1,0.08497780464984182,55
2973,3,6167,2205,3962,0,0,0,1.0,1,1.0,1,1.0,1,0.11744780850737371,55
2974,4,6171,2205,3966,0,0,0,1.0,1,1.0,1,1.0,1,0.12417668106490938,56
2975,4,6175,2205,3970,0,0,0,1.0,1,1.0,1,1.0,1,0.1200793250065314,55
2976,3,6178,2205,3973,0,0,0,1.0,1,1.0,1,1.0,1,0.09234096623066665,57
2977,3,6181,2205,3976,0,0,0,1.0,1,1.0,1,1.0,1,0.08508936519711018,59
2978,5,6186,2207,3979,0,0,0,1.0,1,1.0,1,1.0,1,0.1032596095715735,59
2979,5,6191,2208,3983,0,0,0,1.0,1,1.0,1,1.0,1,0.06975356786682077,59
2980,3,6194,2210,3984,0,0,0,1.0,1,1.0,1,1.0,1,0.08886105647084937,59
2981,0,6194,2210,3984,0,0,0,1.0,1,1.0,1,1.0,1,0.08886105647084937,59
2982,2,6196,2210,3986,0,0,0,1.0,1,1.0,1,1.0,1,0.09146310334949188,61
2983,7,6203,2214,3989,0,0,0,1.0,1,1.0,1,1.0,1,0.07356321482870548,61
2984,3,6206,2217,3989,0,0,0,1.0,1,1.0,1,1.0,1,0.11476769345352868,61
2985,4,6210,2220,3990,0,0,0,1.0,1,1.0,1,1.0,1,0.11896651477121158,57
2986,6,6216,2225,3991,0,0,0,1.0,1,1.0,1,1.0,1,0.09951941683542796,58
2987,8,6224,2229,3995,0,0,0,1.0,1,1.0,1,1.0,1,0.12056254744623265,56
2988,3,6227,2230,3997,0,0,0,1.0,1,1.0,1,1.0,1,0.1190895378735414,55
2989,3,6230,2233,3997,0,0,0,1.0,1,1.0,1,1.0,1,0.17262287077734345,53
2990,5,6235,2234,4001,0,0,0,1.0,1,1.0,1,1.0,1,0.17448897026532947,52
2991,9,6244,2234,4010,0,0,0,1.0,1,1.0,1,1.0,1,0.09017270376580674,54
2992,4,6248,2235,4013,0,0,0,1.0,1,1.0,1,1.0,1,0.12125368277925622,55
2993,2,6250,2236,4014,0,0,0,1.0,1,1.0,1,1.0,1,0.13319965829049718,53
2994,6,6256,2237,4019,0,0,0,1.0,1,1.0,1,1.0,1,0.1119126341258122,53
2995,2,6258,2238,4020,0,0,0,1.0,1,1.0,1,1.0,1,0.12939374114615795,51
2996,4,6262,2239,4023,0,0,0,1.0,1,1.0,1,1.0,1,0.09983123699347964,52
2997,4,6266,2241,4025,0,0,0,1.0,1,1.0,1,1.0,1,0.1380468445096501,50
2998,1,6267,2241,4026,0,0,0,1.0,1,1.0,1,1.0,1,0.1312755640902418,51
2999,0,6267,2241,4026,0,0,0,1.0,1,1.0,1,1.0,1,0.14563901826173392,48
3000,1,6268,2242,4026,0,0,0,1.0,1,1.0,1,1.0,1,0.13530247373536697,48
3001,1,6269,2242,4027,0,0,0,1.0,1,1.0,1,1.0,1,0.12307544522726184,49
3002,1,6270,2242,4028,0,0,0,1.0,1,1.0,1,1.0,1,0.12526726959319262,50
3003,1,6271,2242,4029,0,0,0,1.0,1,1.0,1,1.0,1,0.11668181107105058,50
3004,1,6272,2242,4030,0,0,0,1.0,1,1.0,1,1.0,1,0.09791773328974722,51
3005,1,6273,2242,4031,0,0,0,1.0,1,1.0,1,1.0,1,0.1000083990574569,50
3006,1,6274,2242,4032,0,0,0,1.0,1,1.0,1,1.0,1,0.09909728396089404,51
3007,0,6274,2242,4032,0,0,0,1.0,1,1.0,1,1.0,1,0.11444430410262656,51
3008,1,6275,2242,4033,0,0,0,1.0,1,1.0,1,1.0,1,0.11595426026934239,53
3009,0,6275,2242,4033,0,0,0,1.0,1,1.0,1,1.0,1,0.1253235553045139,52
3010,0,6275,2242,4033,0,0,0,1.0,1,1.0,1,1.0,1,0.1253235553045139,52
3011,4,6279,2242,4037,0,0,0,1.0,1,1.0,1,1.0,1,0.11430009162439982,51
3012,1,6280,2243,4037,0,0,0,1.0,1,1.0,1,1.0,1,0.1050202196909189,54
3013,1,6281,2244,4037,0,0,0,1.0,1,1.0,1,1.0,1,0.10212692328463348,52
3014,2,6283,2246,4037,0,0,0,1.0,1,1.0,1,1.0,1,0.12031056071273828,51
3015,3,6286,2248,4038,0,0,0,1.0,1,1.0,1,1.0,1,0.09348468590368333,50
3016,7,6293,2253,4040,0,0,0,1.0,1,1.0,1,1.0,1,0.10925162544558728,50
3017,5,6298,2257,4041,0,0,0,1.0,1,1.0,1,1.0,1,0.17216610154534015,48
3018,1,6299,2257,4042,0,0,0,1.0,1,1.0,1,1.0,1,0.14233876826633793,48
3019,1,6300,2258,4042,0,0,0,1.0,1,1.0,1,1.0,1,0.126178141325816,47
3020,1,6301,2259,4042,0,0,0,1.0,1,1.0,1,1.0,1,0.11130658174495939,47
3021,8,6309,2262,4047,0,0,0,1.0,1,1.0,1,1.0,1,0.12303082853652461,46
3022,7,6316,2266,4050,0,0,0,1.0,1,1.0,1,1.0,1,0.14519131219501843,45
3023,1,6317,2266,4051,0,0,0,1.0,1,1.0,1,1.0,1,0.1432732470372234,41
3024,4,6321,2269,4052,0,0,0,1.0,1,1.0,1,1.0,1,0.17940046340048374,43
3025,1,6322,2270,4052,0,0,0,1.0,1,1.0,1,1.0,1,0.16346370080354525,39
3026,2,6324,2271,4053,0,0,0,1.0,1,1.0,1,1.0,1,0.17920294486840235,38
3027,5,6329,2273,4056,0,0,0,1.0,1,1.0,1,1.0,1,0.16719485210151344,38
3028,6,6335,2275,4060,0,0,0,1.0,1,1.0,1,1.0,1,0.12633437898699454,38
3029,1,6336,2276,4060,0,0,0,1.0,1,1.0,1,1.0,1,0.12554640191588284,37
3030,0,6336,2276,4060,0,0,0,1.0,1,1.0,1,1.0,1,0.13933923083128777,38
3031,2,6338,2277,4061,0,0,0,1.0,1,1.0,1,1.0,1,0.1531124026146948,39
3032,1,6339,2278,4061,0,0,0,1.0,1,1.0,1,1.0,1,0.15643141316414216,39
3033,1,6340,2278,4062,0,0,0,1.0,1,1.0,1,1.0,1,0.15263585145464786,39
3034,0,6340,2278,4062,0,0,0,1.0,1,1.0,1,1.0,1,0.1561746791111322,38
3035,1,6341,2279,4062,0,0,0,1.0,1,1.0,1,1.0,1,0.1360550322080533,39
3036,1,6342,2279,4063,0,0,0,1.0,1,1.0,1,1.0,1,0.11886071855011472,39
3037,3,6345,2279,4066,0,0,0,1.0,1,1.0,1,1.0,1,0.1055485990352238,39
3038,1,6346,2280,4066,0,0,0,1.0,1,1.0,1,1.0,1,0.09443220407727339,40
3039,2,6348,2281,4067,0,0,0,1.0,1,1.0,1,1.0,1,0.11122256627451882,41
3040,2,6350,2282,4068,0,0,0,1.0,1,1.0,1,1.0,1,0.12694241312535634,42
3041,4,6354,2284,4070,0,0,0,1.0,1,1.0,1,1.0,1,0.13727320203644308,43
3042,2,6356,2284,4072,0,0,0,1.0,1,1.0,1,1.0,1,0.12051843473913458,45
3043,4,6360,2286,4074,0,0,0,1.0,1,1.0,1,1.0,1,0.15115003797796156,45
3044,3,6363,2288,4075,0,0,0,1.0,1,1.0,1,1.0,1,0.15761497432572316,45
3045,2,6365,2289,4076,0,0,0,1.0,1,1.0,1,1.0,1,0.15694705461445574,45
3046,7,6372,2291,4081,0,0,0,1.0,1,1.0,1,1.0,1,0.11079728724098764,46
3047,3,6375,2292,4083,0,0,0,1.0,1,1.0,1,1.0,1,0.12422193999689467,46
3048,5,6380,2292,4088,0,0,0,1.0,1,1.0,1,1.0,1,0.10713838682053042,49
3049,1,6381,2292,4089,0,0,0,1.0,1,1.0,1,1.0,1,0.10228586545378518,50
3050,1,6382,2292,4090,0,0,0,1.0,1,1.0,1,1.0,1,0.09896475009060512,50
3051,4,6386,2292,4094,0,0,0,1.0,1,1.0,1,1.0,1,0.0820652865930731,50
3052,3,6389,2293,4096,0,0,0,1.0,1,1.0,1,1.0,1,0.09831939075722534,50
3053,2,6391,2294,4097,0,0,0,1.0,1,1.0,1,1.0,1,0.11649012887916076,49
3054,1,6392,2294,4098,0,0,0,1.0,1,1.0,1,1.0,1,0.12441578606691164,47
3055,0,6392,2294,4098,0,0,0,1.0,1,1.0,1,1.0,1,0.12801655523998515,48
3056,3,6395,2296,4099,0,0,0,1.0,1,1.0,1,1.0,1,0.1497062794506555,47
3057,2,6397,2298,4099,0,0,0,1.0,1,1.0,1,1.0,1,0.19450695140521992,48
3058,1,6398,2299,4099,0,0,0,1.0,1,1.0,1,1.0,1,0.1964972792244044,46
3059,1,6399,2300,4099,0,0,0,1.0,1,1.0,1,1.0,1,0.22449270134390348,44
3060,0,6399,2300,4099,0,0,0,1.0,1,1.0,1,1.0,1,0.2244892221533943,44
3061,4,6403,2300,4103,0,0,0,1.0,1,1.0,1,1.0,1,0.16234060043577095,42
3062,3,6406,2302,4104,0,0,0,1.0,1,1.0,1,1.0,1,0.12920516636420323,42
3063,4,6410,2305,4105,0,0,0,1.0,1,1.0,1,1.0,1,0.1417583176336737,41
3064,6,6416,2307,4109,0,0,0,1.0,1,1.0,1,1.0,1,0.11754381155006537,42
3065,4,6420,2308,4112,0,0,0,1.0,1,1.0,1,1.0,1,0.08418678279025886,40
3066,3,6423,2311,4112,0,0,0,1.0,1,1.0,1,1.0,1,0.15304292151068208,42
3067,4,6427,2314,4113,0,0,0,1.0,1,1.0,1,1.0,1,0.1550769183415133,40
3068,1,6428,2315,4113,0,0,0,1.0,1,1.0,1,1.0,1,0.1664864012429839,39
3069,0,6428,2315,4113,0,0,0,1.0,1,1.0,1,1.0,1,0.19685183952558166,38
3070,3,6431,2315,4116,0,0,0,1.0,1,1.0,1,1.0,1,0.1303943692167608,39
3071,3,6434,2315,4119,0,0,0,1.0,1,1.0,1,1.0,1,0.13294212805771538,39
3072,2,6436,2316,4120,0,0,0,1.0,1,1.0,1,1.0,1,0.1258796893237155,40
3073,1,6437,2317,4120,0,0,0,1.0,1,1.0,1,1.0,1,0.1004138920908591,38
3074,1,6438,2317,4121,0,0,0,1.0,1,1.0,1,1.0,1,0.12131671312868726,38
3075,3,6441,2319,4122,0,0,0,1.0,1,1.0,1,1.0,1,0.14815800067841509,41
3076,1,6442,2319,4123,0,0,0,1.0,1,1.0,1,1.0,1,0.13369996436501466,42
3077,3,6445,2321,4124,0,0,0,1.0,1,1.0,1,1.0,1,0.13478527835451773,42
3078,2,6447,2321,4126,0,0,0,1.0,1,1.0,1,1.0,1,0.13446043914066108,42
3079,1,6448,2321,4127,0,0,0,1.0,1,1.0,1,1.0,1,0.1499163248129102,42
3080,3,6451,2322,4129,0,0,0,1.0,1,1.0,1,1.0,1,0.1748227941478535,43
3081,4,6455,2323,4132,0,0,0,1.0,1,1.0,1,1.0,1,0.1311734671536672,44
3082,4,6459,2324,4135,0,0,0,1.0,1,1.0,1,1.0,1,0.11019230212043953,45
3083,2,6461,2324,4137,0,0,0,1.0,1,1.0,1,1.0,1,0.07750105956102873,45
3084,0,6461,2324,4137,0,0,0,1.0,1,1.0,1,1.0,1,0.07750105956102873,45
3085,2,6463,2324,4139,0,0,0,1.0,1,1.0,1,1.0,1,0.10362681899139237,46
3086,0,6463,2324,4139,0,0,0,1.0,1,1.0,1,1.0,1,0.10362681899139237,46
3087,2,6465,2325,4140,0,0,0,1.0,1,1.0,1,1.0,1,0.11744981068042759,47
3088,4,6469,2327,4142,0,0,0,1.0,1,1.0,1,1.0,1,0.16543631403381837,48
3089,0,6469,2327,4142,0,0,0,1.0,1,1.0,1,1.0,1,0.16355698501463795,46
3090,1,6470,2327,4143,0,0,0,1.0,1,1.0,1,1.0,1,0.18968625499361705,46
3091,5,6475,2327,4148,0,0,0,1.0,1,1.0,1,1.0,1,0.15071427354074746,46
3092,3,6478,2328,4150,0,0,0,1.0,1,1.0,1,1.0,1,0.1014940788088092,47
3093,2,6480,2328,4152,0,0,0,1.0,1,1.0,1,1.0,1,0.09353241358785404,47
3094,4,6484,2328,4156,0,0,0,1.0,1,1.0,1,1.0,1,0.14506117463209434,45
3095,2,6486,2328,4158,0,0,0,1.0,1,1.0,1,1.0,1,0.12628684306601323,46
3096,3,6489,2328,4161,0,0,0,1.0,1,1.0,1,1.0,1,0.11400672120480236,46
3097,2,6491,2330,4161,0,0,0,1.0,1,1.0,1,1.0,1,0.14439634399925785,47
3098,3,6494,2330,4164,0,0,0,1.0,1,1.0,1,1.0,1,0.1333285335717803,47
3099,2,6496,2330,4166,0,0,0,1.0,1,1.0,1,1.0,1,0.1333285335717803,47
3100,2,6498,2330,4168,0,0,0,1.0,1,1.0,1,1.0,1,0.1333285335717803,47
3101,5,6503,2330,4173,0,0,0,1.0,1,1.0,1,1.0,1,0.07677789103540875,48
3102,3,6506,2331,4175,0,0,0,1.0,1,1.0,1,1.0,1,0.07374183905878119,48
3103,4,6510,2332,4178,0,0,0,1.0,1,1.0,1,1.0,1,0.08810511093132792,49
3104,3,6513,2334,4179,0,0,0,1.0,1,1.0,1,1.0,1,0.10638156609210192,48
3105,1,6514,2335,4179,0,0,0,1.0,1,1.0,1,1.0,1,0.13590202093109446,45
3106,3,6517,2336,4181,0,0,0,1.0,1,1.0,1,1.0,1,0.1555547886977644,46
3107,1,6518,2336,4182,0,0,0,1.0,1,1.0,1,1.0,1,0.1481651067638502,44
3108,1,6519,2337,4182,0,0,0,1.0,1,1.0,1,1.0,1,0.11281128178794246,45
3109,1,6520,2337,4183,0,0,0,1.0,1,1.0,1,1.0,1,0.12083421573132977,44
3110,3,6523,2339,4184,0,0,0,1.0,1,1.0,1,1.0,1,0.12953030977267727,46
3111,2,6525,2340,4185,0,0,0,1.0,1,1.0,1,1.0,1,0.12123178807737772,46
3112,2,6527,2340,4187,0,0,0,1.0,1,1.0,1,1.0,1,0.11224683767846813,47
3113,1,6528,2341,4187,0,0,0,1.0,1,1.0,1,1.0,1,0.09605117682552976,48
3114,0,6528,2341,4187,0,0,0,1.0,1,1.0,1,1.0,1,0.1043548403470099,48
3115,0,6528,2341,4187,0,0,0,1.0,1,1.0,1,1.0,1,0.12061824135118762,49
3116,2,6530,2341,4189,0,0,0,1.0,1,1.0,1,1.0,1,0.13206957867195968,48
3117,2,6532,2343,4189,0,0,0,1.0,1,1.0,1,1.0,1,0.14109800920106283,49
3118,0,6532,2343,4189,0,0,0,1.0,1,1.0,1,1.0,1,0.1700362038659995,50
3119,2,6534,2343,4191,0,0,0,1.0,1,1.0,1,1.0,1,0.1286923921990749,50
3120,3,6537,2343,4194,0,0,0,1.0,1,1.0,1,1.0,1,0.11951428988891684,50
3121,1,6538,2343,4195,0,0,0,1.0,1,1.0,1,1.0,1,0.10718961812964935,50
3122,0,6538,2343,4195,0,0,0,1.0,1,1.0,1,1.0,1,0.10718961812964935,50
3123,1,6539,2344,4195,0,0,0,1.0,1,1.0,1,1.0,1,0.0950721456183157,51
3124,1,6540,2345,4195,0,0,0,1.0,1,1.0,1,1.0,1,0.13518924146184672,51
3125,3,6543,2346,4197,0,0,0,1.0,1,1.0,1,1.0,1,0.10905320866230366,51
3126,3,6546,2347,4199,0,0,0,1.0,1,1.0,1,1.0,1,0.08466195667749327,54
3127,2,6548,2349,4199,0,0,0,1.0,1,1.0,1,1.0,1,0.12154960451402137,53
3128,2,6550,2350,4200,0,0,0,1.0,1,1.0,1,1.0,1,0.10886782237868417,52
3129,1,6551,2351,4200,0,0,0,1.0,1,1.0,1,1.0,1,0.09921134276135386,51
3130,0,6551,2351,4200,0,0,0,1.0,1,1.0,1,1.0,1,0.11314167122867912,50
3131,3,6554,2352,4202,0,0,0,1.0,1,1.0,1,1.0,1,0.0801372803339073,50
3132,2,6556,2354,4202,0,0,0,1.0,1,1.0,1,1.0,1,0.10757093338586098,49
3133,1,6557,2355,4202,0,0,0,1.0,1,1.0,1,1.0,1,0.10521987553570471,49
3134,1,6558,2356,4202,0,0,0,1.0,1,1.0,1,1.0,1,0.15323380915543755,46
3135,1,6559,2356,4203,0,0,0,1.0,1,1.0,1,1.0,1,0.13112362334303687,47
3136,2,6561,2356,4205,0,0,0,1.0,1,1.0,1,1.0,1,0.09438005928445399,46
3137,1,6562,2357,4205,0,0,0,1.0,1,1.0,1,1.0,1,0.12187956621098951,49
3138,0,6562,2357,4205,0,0,0,1.0,1,1.0,1,1.0,1,0.12187956621098951,49
3139,5,6567,2359,4208,0,0,0,1.0,1,1.0,1,1.0,1,0.13085606280378337,50
3140,6,6573,2361,4212,0,0,0,1.0,1,1.0,1,1.0,1,0.13793080903544316,51
3141,4,6577,2361,4216,0,0,0,1.0,1,1.0,1,1.0,1,0.08353757578838929,50
3142,0,6577,2361,4216,0,0,0,1.0,1,1.0,1,1.0,1,0.08353757578838929,50
3143,1,6578,2362,4216,0,0,0,1.0,1,1.0,1,1.0,1,0.12115169402227928,49
3144,0,6578,2362,4216,0,0,0,1.0,1,1.0,1,1.0,1,0.12115169402227928,49
3145,1,6579,2363,4216,0,0,0,1.0,1,1.0,1,1.0,1,0.1668287712338562,48
3146,3,6582,2365,4217,0,0,0,1.0,1,1.0,1,1.0,1,0.14120493914428092,49
3147,3,6585,2366,4219,0,0,0,1.0,1,1.0,1,1.0,1,0.14008401268406398,48
3148,3,6588,2368,4220,0,0,0,1.0,1,1.0,1,1.0,1,0.09131113172805738,48
3149,1,6589,2369,4220,0,0,0,1.0,1,1.0,1,1.0,1,0.08825832209099516,47
3150,0,6589,2369,4220,0,0,0,1.0,1,1.0,1,1.0,1,0.08825832209099516,47
3151,1,6590,2369,4221,0,0,0,1.0,1,1.0,1,1.0,1,0.09647965955577348,48
3152,0,6590,2369,4221,0,0,0,1.0,1,1.0,1,1.0,1,0.09471907957530908,47
3153,1,6591,2370,4221,0,0,0,1.0,1,1.0,1,1.0,1,0.1099549785011032,47
3154,5,6596,2373,4223,0,0,0,1.0,1,1.0,1,1.0,1,0.15397103945267554,48
3155,1,6597,2374,4223,0,0,0,1.0,1,1.0,1,1.0,1,0.16427073381299304,48
3156,8,6605,2375,4230,0,0,0,1.0,1,1.0,1,1.0,1,0.0736399437793548,48
3157,1,6606,2375,4231,0,0,0,1.0,1,1.0,1,1.0,1,0.10108457725543425,48
3158,0,6606,2375,4231,0,0,0,1.0,1,1.0,1,1.0,1,0.10108457725543425,48
3159,1,6607,2375,4232,0,0,0,1.0,1,1.0,1,1.0,1,0.10325089505971623,49
3160,3,6610,2375,4235,0,0,0,1.0,1,1.0,1,1.0,1,0.12772858800869216,51
3161,3,6613,2375,4238,0,0,0,1.0,1,1.0,1,1.0,1,0.08608027909966952,52
3162,2,6615,2376,4239,0,0,0,1.0,1,1.0,1,1.0,1,0.10675675137130416,51
3163,3,6618,2376,4242,0,0,0,1.0,1,1.0,1,1.0,1,0.06483558776588033,51
3164,2,6620,2377,4243,0,0,0,1.0,1,1.0,1,1.0,1,0.07057687841079881,52
3165,4,6624,2379,4245,0,0,0,1.0,1,1.0,1,1.0,1,0.08775017996956558,50
3166,2,6626,2380,4246,0,0,0,1.0,1,1.0,1,1.0,1,0.0809325954321888,50
3167,3,6629,2382,4247,0,0,0,1.0,1,1.0,1,1.0,1,0.08210943412202965,49
3168,1,6630,2383,4247,0,0,0,1.0,1,1.0,1,1.0,1,0.11265284801245817,47
3169,0,6630,2383,4247,0,0,0,1.0,1,1.0,1,1.0,1,0.09719710869017374,48
3170,2,6632,2385,4247,0,0,0,1.0,1,1.0,1,1.0,1,0.15561887263662397,47
3171,5,6637,2386,4251,0,0,0,1.0,1,1.0,1,1.0,1,0.12231884018140583,47
3172,0,6637,2386,4251,0,0,0,1.0,1,1.0,1,1.0,1,0.14578754968972574,46
3173,3,6640,2386,4254,0,0,0,1.0,1,1.0,1,1.0,1,0.13571826022483258,45
3174,2,6642,2386,4256,0,0,0,1.0,1,1.0,1,1.0,1,0.11492360750844471,43
3175,0,6642,2386,4256,0,0,0,1.0,1,1.0,1,1.0,1,0.11401899198588998,43
3176,1,6643,2386,4257,0,0,0,1.0,1,1.0,1,1.0,1,0.09174289672650693,44
3177,1,6644,2387,4257,0,0,0,1.0,1,1.0,1,1.0,1,0.10842042626450707,44
3178,1,6645,2387,4258,0,0,0,1.0,1,1.0,1,1.0,1,0.07954012283499912,47
3179,5,6650,2390,4260,0,0,0,1.0,1,1.0,1,1.0,1,0.11511587110909417,48
3180,1,6651,2391,4260,0,0,0,1.0,1,1.0,1,1.0,1,0.1188221756494673,48
3181,4,6655,2391,4264,0,0,0,1.0,1,1.0,1,1.0,1,0.10705013184679503,48
3182,5,6660,2393,4267,0,0,0,1.0,1,1.0,1,1.0,1,0.15120503626240228,51
3183,8,6668,2395,4273,0,0,0,1.0,1,1.0,1,1.0,1,0.14545227904620242,50
3184,4,6672,2395,4277,0,0,0,1.0,1,1.0,1,1.0,1,0.13024649637970928,50
3185,0,6672,2395,4277,0,0,0,1.0,1,1.0,1,1.0,1,0.13763968755802553,48
3186,4,6676,2395,4281,0,0,0,1.0,1,1.0,1,1.0,1,0.09299416495729625,48
3187,2,6678,2395,4283,0,0,0,1.0,1,1.0,1,1.0,1,0.08139733085646608,48
3188,1,6679,2396,4283,0,0,0,1.0,1,1.0,1,1.0,1,0.09845634683431984,48
3189,2,6681,2396,4285,0,0,0,1.0,1,1.0,1,1.0,1,0.07175270449760496,49
3190,0,6681,2396,4285,0,0,0,1.0,1,1.0,1,1.0,1,0.10140417851811154,51
3191,4,6685,2396,4289,0,0,0,1.0,1,1.0,1,1.0,1,0.07142662008087665,52
3192,0,6685,2396,4289,0,0,0,1.0,1,1.0,1,1.0,1,0.07142662008087665,52
3193,1,6686,2396,4290,0,0,0,1.0,1,1.0,1,1.0,1,0.07661664850687089,52
3194,2,6688,2397,4291,0,0,0,1.0,1,1.0,1,1.0,1,0.09359079192927204,54
3195,2,6690,2397,4293,0,0,0,1.0,1,1.0,1,1.0,1,0.09470496527153907,54
3196,1,6691,2398,4293,0,0,0,1.0,1,1.0,1,1.0,1,0.11646090065346955,54
3197,3,6694,2398,4296,0,0,0,1.0,1,1.0,1,1.0,1,0.10533104618501841,54
3198,1,6695,2399,4296,0,0,0,1.0,1,1.0,1,1.0,1,0.11386513740549051,54
3199,2,6697,2400,4297,0,0,0,1.0,1,1.0,1,1.0,1,0.07806086376176948,56
3200,2,6699,2402,4297,0,0,0,1.0,1,1.0,1,1.0,1,0.15277507224073575,56
3201,5,6704,2402,4302,0,0,0,1.0,1,1.0,1,1.0,1,0.09269885706354163,56
3202,0,6704,2402,4302,0,0,0,1.0,1,1.0,1,1.0,1,0.10169464145184545,57
3203,0,6704,2402,4302,0,0,0,1.0,1,1.0,1,1.0,1,0.10625357546306612,56
3204,5,6709,2406,4303,0,0,0,1.0,1,1.0,1,1.0,1,0.15486776721600023,55
3205,0,6709,2406,4303,0,0,0,1.0,1,1.0,1,1.0,1,0.1623633082740653,54
3206,8,6717,2409,4308,0,0,0,1.0,1,1.0,1,1.0,1,0.1379137917782825,56
3207,1,6718,2410,4308,0,0,0,1.0,1,1.0,1,1.0,1,0.15642401687522198,54
3208,2,6720,2410,4310,0,0,0,1.0,1,1.0,1,1.0,1,0.13566671611949652,53
3209,0,6720,2410,4310,0,0,0,1.0,1,1.0,1,1.0,1,0.13074632672018222,54
3210,1,6721,2411,4310,0,0,0,1.0,1,1.0,1,1.0,1,0.1649427862841055,53
3211,4,6725,2412,4313,0,0,0,1.0,1,1.0,1,1.0,1,0.17895120597540615,53
3212,2,6727,2412,4315,0,0,0,1.0,1,1.0,1,1.0,1,0.1853631256524578,54
3213,2,6729,2412,4317,0,0,0,1.0,1,1.0,1,1.0,1,0.16368585824684803,54
3214,4,6733,2412,4321,0,0,0,1.0,1,1.0,1,1.0,1,0.1817361164151435,55
3215,2,6735,2412,4323,0,0,0,1.0,1,1.0,1,1.0,1,0.1776474213866767,55
3216,1,6736,2413,4323,0,0,0,1.0,1,1.0,1,1.0,1,0.18900233796876922,55
3217,3,6739,2415,4324,0,0,0,1.0,1,1.0,1,1.0,1,0.2096525218409516,54
3218,0,6739,2415,4324,0,0,0,1.0,1,1.0,1,1.0,1,0.2096525218409516,54
3219,2,6741,2415,4326,0,0,0,1.0,1,1.0,1,1.0,1,0.20223031453947724,55
3220,1,6742,2415,4327,0,0,0,1.0,1,1.0,1,1.0,1,0.19127220657073946,56
3221,3,6745,2416,4329,0,0,0,1.0,1,1.0,1,1.0,1,0.17804773847302485,57
3222,0,6745,2416,4329,0,0,0,1.0,1,1.0,1,1.0,1,0.17804773847302485,57
3223,1,6746,2416,4330,0,0,0,1.0,1,1.0,1,1.0,1,0.1740717856558331,56
3224,5,6751,2420,4331,0,0,0,1.0,1,1.0,1,1.0,1,0.1651653296623288,58
3225,3,6754,2421,4333,0,0,0,1.0,1,1.0,1,1.0,1,0.1571350333873081,55
3226,5,6759,2423,4336,0,0,0,1.0,1,1.0,1,1.0,1,0.13113818757291681,54
3227,2,6761,2424,4337,0,0,0,1.0,1,1.0,1,1.0,1,0.0950585724836917,53
3228,2,6763,2426,4337,0,0,0,1.0,1,1.0,1,1.0,1,0.14688164009136928,52
3229,4,6767,2429,4338,0,0,0,1.0,1,1.0,1,1.0,1,0.17868694288772274,52
3230,2,6769,2431,4338,0,0,0,1.0,1,1.0,1,1.0,1,0.20463639178061022,50
3231,5,6774,2432,4342,0,0,0,1.0,1,1.0,1,1.0,1,0.16795648381940145,50
3232,5,6779,2434,4345,0,0,0,1.0,1,1.0,1,1.0,1,0.1538557554935952,50
3233,2,6781,2435,4346,0,0,0,1.0,1,1.0,1,1.0,1,0.15939650104166606,50
3234,1,6782,2436,4346,0,0,0,1.0,1,1.0,1,1.0,1,0.1671744559759747,49
3235,4,6786,2439,4347,0,0,0,1.0,1,1.0,1,1.0,1,0.19449726747524979,49
3236,0,6786,2439,4347,0,0,0,1.0,1,1.0,1,1.0,1,0.1950057909558487,51
3237,1,6787,2440,4347,0,0,0,1.0,1,1.0,1,1.0,1,0.22495428999749312,53
3238,3,6790,2440,4350,0,0,0,1.0,1,1.0,1,1.0,1,0.19015443902069717,53
3239,0,6790,2440,4350,0,0,0,1.0,1,1.0,1,1.0,1,0.19015443902069717,53
3240,0,6790,2440,4350,0,0,0,1.0,1,1.0,1,1.0,1,0.19389530861814758,53
3241,1,6791,2440,4351,0,0,0,1.0,1,1.0,1,1.0,1,0.19804446054242136,53
3242,2,6793,2440,4353,0,0,0,1.0,1,1.0,1,1.0,1,0.18021870094546305,53
3243,1,6794,2440,4354,0,0,0,1.0,1,1.0,1,1.0,1,0.16506082459573232,56
3244,1,6795,2440,4355,0,0,0,1.0,1,1.0,1,1.0,1,0.17466693224907343,57
3245,7,6802,2440,4362,0,0,0,1.0,1,1.0,1,1.0,1,0.1614500412754849,59
3246,4,6806,2440,4366,0,0,0,1.0,1,1.0,1,1.0,1,0.10903484183146285,59
3247,1,6807,2441,4366,0,0,0,1.0,1,1.0,1,1.0,1,0.12298578853925272,59
3248,1,6808,2442,4366,0,0,0,1.0,1,1.0,1,1.0,1,0.1200741553581091,59
3249,2,6810,2442,4368,0,0,0,1.0,1,1.0,1,1.0,1,0.1490239480489122,58
3250,0,6810,2442,4368,0,0,0,1.0,1,1.0,1,1.0,1,0.1490239480489122,58
3251,2,6812,2442,4370,0,0,0,1.0,1,1.0,1,1.0,1,0.13506030880274347,57
3252,1,6813,2443,4370,0,0,0,1.0,1,1.0,1,1.0,1,0.15454510928003426,57
3253,1,6814,2443,4371,0,0,0,1.0,1,1.0,1,1.0,1,0.15683474380490442,56
3254,2,6816,2444,4372,0,0,0,1.0,1,1.0,1,1.0,1,0.1534804743930657,57
3255,1,6817,2444,4373,0,0,0,1.0,1,1.0,1,1.0,1,0.14423844602612723,57
3256,3,6820,2444,4376,0,0,0,1.0,1,1.0,1,1.0,1,0.12227917679450465,57
3257,2,6822,2444,4378,0,0,0,1.0,1,1.0,1,1.0,1,0.09147684037567938,57
3258,2,6824,2444,4380,0,0,0,1.0,1,1.0,1,1.0,1,0.09257564183298254,58
3259,2,6826,2446,4380,0,0,0,1.0,1,1.0,1,1.0,1,0.11320419331351249,59
3260,3,6829,2447,4382,0,0,0,1.0,1,1.0,1,1.0,1,0.09826891902619084,60
3261,4,6833,2447,4386,0,0,0,1.0,1,1.0,1,1.0,1,0.06878603789156301,60
3262,1,6834,2448,4386,0,0,0,1.0,1,1.0,1,1.0,1,0.09950636653127025,61
3263,5,6839,2453,4386,0,0,0,1.0,1,1.0,1,1.0,1,0.10688463752653636,62
3264,6,6845,2457,4388,0,0,0,1.0,1,1.0,1,1.0,1,0.11225796332100454,60
3265,2,6847,2459,4388,0,0,0,1.0,1,1.0,1,1.0,1,0.1017233989156566,58
3266,5,6852,2463,4389,0,0,0,1.0,1,1.0,1,1.0,1,0.12430115346332772,59
3267,7,6859,2466,4393,0,0,0,1.0,1,1.0,1,1.0,1,0.1193183556082178,60
3268,5,6864,2469,4395,0,0,0,1.0,1,1.0,1,1.0,1,0.1267035329670721,58
3269,1,6865,2469,4396,0,0,0,1.0,1,1.0,1,1.0,1,0.11764795159350044,57
3270,3,6868,2471,4397,0,0,0,1.0,1,1.0,1,1.0,1,0.11604345818023684,56
3271,4,6872,2473,4399,0,0,0,1.0,1,1.0,1,1.0,1,0.05609174438646008,55
3272,0,6872,2473,4399,0,0,0,1.0,1,1.0,1,1.0,1,0.05507928149910108,55
3273,9,6881,2476,4405,0,0,0,1.0,1,1.0,1,1.0,1,0.08824686661245203,55
3274,2,6883,2477,4406,0,0,0,1.0,1,1.0,1,1.0,1,0.11694749857427642,55
3275,1,6884,2478,4406,0,0,0,1.0,1,1.0,1,1.0,1,0.11670249188462035,55
3276,5,6889,2478,4411,0,0,0,1.0,1,1.0,1,1.0,1,0.08779523759681833,55
3277,3,6892,2480,4412,0,0,0,1.0,1,1.0,1,1.0,1,0.10583836835105719,57
3278,1,6893,2480,4413,0,0,0,1.0,1,1.0,1,1.0,1,0.10546830523226762,56
3279,2,6895,2480,4415,0,0,0,1.0,1,1.0,1,1.0,1,0.08162806446121264,54
3280,3,6898,2481,4417,0,0,0,1.0,1,1.0,1,1.0,1,0.07886334096539602,53
3281,3,6901,2482,4419,0,0,0,1.0,1,1.0,1,1.0,1,0.09541244188210211,52
3282,1,6902,2482,4420,0,0,0,1.0,1,1.0,1,1.0,1,0.09642909170062997,50
3283,1,6903,2483,4420,0,0,0,1.0,1,1.0,1,1.0,1,0.09840367778552887,50
3284,1,6904,2484,4420,0,0,0,1.0,1,1.0,1,1.0,1,0.16288607339595215,47
3285,1,6905,2484,4421,0,0,0,1.0,1,1.0,1,1.0,1,0.1357185190199411,48
3286,8,6913,2486,4427,0,0,0,1.0,1,1.0,1,1.0,1,0.05586732279016537,46
3287,7,6920,2489,4431,0,0,0,1.0,1,1.0,1,1.0,1,0.18390694064828123,46
3288,6,6926,2492,4434,0,0,0,1.0,1,1.0,1,1.0,1,0.17324184330603737,46
3289,3,6929,2492,4437,0,0,0,1.0,1,1.0,1,1.0,1,0.20190390095570893,48
3290,6,6935,2494,4441,0,0,0,1.0,1,1.0,1,1.0,1,0.22766918302030886,48
3291,8,6943,2495,4448,0,0,0,1.0,1,1.0,1,1.0,1,0.09158748704085125,50
3292,2,6945,2496,4449,0,0,0,1.0,1,1.0,1,1.0,1,0.10124147520853549,50
3293,3,6948,2496,4452,0,0,0,1.0,1,1.0,1,1.0,1,0.08277142336076988,51
3294,4,6952,2496,4456,0,0,0,1.0,1,1.0,1,1.0,1,0.10119848056102572,50
3295,5,6957,2497,4460,0,0,0,1.0,1,1.0,1,1.0,1,0.11351773328666949,50
3296,0,6957,2497,4460,0,0,0,1.0,1,1.0,1,1.0,1,0.11351773328666949,50
3297,2,6959,2497,4462,0,0,0,1.0,1,1.0,1,1.0,1,0.06815846376521104,51
3298,1,6960,2498,4462,0,0,0,1.0,1,1.0,1,1.0,1,0.08464784022511565,52
3299,5,6965,2500,4465,0,0,0,1.0,1,1.0,1,1.0,1,0.09325791594396518,53
3300,0,6965,2500,4465,0,0,0,1.0,1,1.0,1,1.0,1,0.09325791594396518,53
3301,1,6966,2501,4465,0,0,0,1.0,1,1.0,1,1.0,1,0.13129721646441286,53
3302,6,6972,2505,4467,0,0,0,1.0,1,1.0,1,1.0,1,0.15017356255224196,53
3303,4,6976,2506,4470,0,0,0,1.0,1,1.0,1,1.0,1,0.14674109922275874,52
3304,3,6979,2507,4472,0,0,0,1.0,1,1.0,1,1.0,1,0.17304146720790017,52
3305,5,6984,2509,4475,0,0,0,1.0,1,1.0,1,1.0,1,0.2081996155688497,51
3306,10,6994,2510,4484,0,0,0,1.0,1,1.0,1,1.0,1,0.11589777393784223,51
3307,1,6995,2510,4485,0,0,0,1.0,1,1.0,1,1.0,1,0.15988825799822923,48
3308,2,6997,2512,4485,0,0,0,1.0,1,1.0,1,1.0,1,0.13089669863668815,48
3309,0,6997,2512,4485,0,0,0,1.0,1,1.0,1,1.0,1,0.16537316706294558,48
3310,4,7001,2512,4489,0,0,0,1.0,1,1.0,1,1.0,1,0.2240576824169434,47
3311,6,7007,2513,4494,0,0,0,1.0,1,1.0,1,1.0,1,0.1603734560923876,49
3312,2,7009,2514,4495,0,0,0,1.0,1,1.0,1,1.0,1,0.18867272244445069,48
3313,4,7013,2515,4498,0,0,0,1.0,1,1.0,1,1.0,1,0.2097735273513793,49
3314,2,7015,2515,4500,0,0,0,1.0,1,1.0,1,1.0,1,0.23188595952794466,47
3315,1,7016,2515,4501,0,0,0,1.0,1,1.0,1,1.0,1,0.2275045326907264,47
3316,4,7020,2515,4505,0,0,0,1.0,1,1.0,1,1.0,1,0.175035196801272,47
3317,0,7020,2515,4505,0,0,0,1.0,1,1.0,1,1.0,1,0.15689704692823633,46
3318,5,7025,2516,4509,0,0,0,1.0,1,1.0,1,1.0,1,0.09504544072566237,45
3319,3,7028,2517,4511,0,0,0,1.0,1,1.0,1,1.0,1,0.12713865575750719,44
3320,2,7030,2517,4513,0,0,0,1.0,1,1.0,1,1.0,1,0.14034152407244457,43
3321,2,7032,2518,4514,0,0,0,1.0,1,1.0,1,1.0,1,0.14482728172972242,43
3322,0,7032,2518,4514,0,0,0,1.0,1,1.0,1,1.0,1,0.14735411728010334,40
3323,1,7033,2518,4515,0,0,0,1.0,1,1.0,1,1.0,1,0.16376027409547894,40
3324,2,7035,2518,4517,0,0,0,1.0,1,1.0,1,1.0,1,0.10147575580024469,40
3325,4,7039,2522,4517,0,0,0,1.0,1,1.0,1,1.0,1,0.23237965704339533,40
3326,3,7042,2523,4519,0,0,0,1.0,1,1.0,1,1.0,1,0.13652569782862412,41
3327,2,7044,2524,4520,0,0,0,1.0,1,1.0,1,1.0,1,0.18795389109036678,39
3328,5,7049,2529,4520,0,0,0,1.0,1,1.0,1,1.0,1,0.29275467411259404,41
3329,7,7056,2530,4526,0,0,0,1.0,1,1.0,1,1.0,1,0.1794550474159972,39
3330,2,7058,2531,4527,0,0,0,1.0,1,1.0,1,1.0,1,0.21874196251203118,40
3331,2,7060,2532,4528,0,0,0,1.0,1,1.0,1,1.0,1,0.20904696922574503,38
3332,1,7061,2532,4529,0,0,0,1.0,1,1.0,1,1.0,1,0.18097511994923554,38
3333,0,7061,2532,4529,0,0,0,1.0,1,1.0,1,1.0,1,0.18097511994923554,38
3334,0,7061,2532,4529,0,0,0,1.0,1,1.0,1,1.0,1,0.2060993493641544,40
3335,2,7063,2532,4531,0,0,0,1.0,1,1.0,1,1.0,1,0.15701583497040303,40
3336,0,7063,2532,4531,0,0,0,1.0,1,1.0,1,1.0,1,0.15089378871292447,39
3337,2,7065,2533,4532,0,0,0,1.0,1,1.0,1,1.0,1,0.1107259621872394,40
3338,3,7068,2534,4534,0,0,0,1.0,1,1.0,1,1.0,1,0.11089612553105903,41
3339,1,7069,2535,4534,0,0,0,1.0,1,1.0,1,1.0,1,0.1377234658390961,42
3340,3,7072,2537,4535,0,0,0,1.0,1,1.0,1,1.0,1,0.14231430059005942,43
3341,0,7072,2537,4535,0,0,0,1.0,1,1.0,1,1.0,1,0.14231430059005942,43
3342,2,7074,2538,4536,0,0,0,1.0,1,1.0,1,1.0,1,0.16073446993075013,44
3343,2,7076,2540,4536,0,0,0,1.0,1,1.0,1,1.0,1,0.17340339312622127,44
3344,2,7078,2541,4537,0,0,0,1.0,1,1.0,1,1.0,1,0.2040808359322561,44
3345,0,7078,2541,4537,0,0,0,1.0,1,1.0,1,1.0,1,0.2179872487311098,43
3346,1,7079,2541,4538,0,0,0,1.0,1,1.0,1,1.0,1,0.20423720531396422,42
3347,2,7081,2541,4540,0,0,0,1.0,1,1.0,1,1.0,1,0.1718075091443919,44
3348,1,7082,2541,4541,0,0,0,1.0,1,1.0,1,1.0,1,0.18090680524797334,45
3349,1,7083,2542,4541,0,0,0,1.0,1,1.0,1,1.0,1,0.18517413932339336,45
3350,1,7084,2542,4542,0,0,0,1.0,1,1.0,1,1.0,1,0.14649413220311955,46
3351,3,7087,2544,4543,0,0,0,1.0,1,1.0,1,1.0,1,0.15550346482496227,47
3352,2,7089,2544,4545,0,0,0,1.0,1,1.0,1,1.0,1,0.12604923030229734,47
3353,0,7089,2544,4545,0,0,0,1.0,1,1.0,1,1.0,1,0.13777365631052618,48
3354,0,7089,2544,4545,0,0,0,1.0,1,1.0,1,1.0,1,0.13777365631052618,48
3355,0,7089,2544,4545,0,0,0,1.0,1,1.0,1,1.0,1,0.12188952754615294,48
3356,1,7090,2544,4546,0,0,0,1.0,1,1.0,1,1.0,1,0.07968826696258643,48
3357,2,7092,2545,4547,0,0,0,1.0,1,1.0,1,1.0,1,0.07200454361222478,47
3358,4,7096,2547,4549,0,0,0,1.0,1,1.0,1,1.0,1,0.1271525567771238,46
3359,2,7098,2548,4550,0,0,0,1.0,1,1.0,1,1.0,1,0.11259722442272051,45
3360,1,7099,2549,4550,0,0,0,1.0,1,1.0,1,1.0,1,0.10922194615189068,44
3361,0,7099,2549,4550,0,0,0,1.0,1,1.0,1,1.0,1,0.10239785714239304,43
3362,3,7102,2552,4550,0,0,0,1.0,1,1.0,1,1.0,1,0.11543897983951129,42
3363,2,7104,2553,4551,0,0,0,1.0,1,1.0,1,1.0,1,0.17642535897047604,41
3364,2,7106,2553,4553,0,0,0,1.0,1,1.0,1,1.0,1,0.15923237412087304,41
3365,0,7106,2553,4553,0,0,0,1.0,1,1.0,1,1.0,1,0.16034102775086567,41
3366,1,7107,2553,4554,0,0,0,1.0,1,1.0,1,1.0,1,0.13551242453966467,40
3367,1,7108,2553,4555,0,0,0,1.0,1,1.0,1,1.0,1,0.11933442013398761,39
3368,1,7109,2554,4555,0,0,0,1.0,1,1.0,1,1.0,1,0.1198745990718512,39
3369,1,7110,2555,4555,0,0,0,1.0,1,1.0,1,1.0,1,0.09849398717137935,40
3370,3,7113,2557,4556,0,0,0,1.0,1,1.0,1,1.0,1,0.10081096457439712,41
3371,2,7115,2557,4558,0,0,0,1.0,1,1.0,1,1.0,1,0.07321179624805729,41
3372,2,7117,2559,4558,0,0,0,1.0,1,1.0,1,1.0,1,0.1399588693241063,40
3373,0,7117,2559,4558,0,0,0,1.0,1,1.0,1,1.0,1,0.14947057613690498,41
3374,0,7117,2559,4558,0,0,0,1.0,1,1.0,1,1.0,1,0.13542563349617057,42
3375,6,7123,2559,4564,0,0,0,1.0,1,1.0,1,1.0,1,0.09174739798031083,44
3376,1,7124,2559,4565,0,0,0,1.0,1,1.0,1,1.0,1,0.05861740118557079,46
3377,1,7125,2559,4566,0,0,0,1.0,1,1.0,1,1.0,1,0.05104185137772665,47
3378,1,7126,2560,4566,0,0,0,1.0,1,1.0,1,1.0,1,0.09622431307837898,48
3379,0,7126,2560,4566,0,0,0,1.0,1,1.0,1,1.0,1,0.09622431307837898,48
3380,1,7127,2561,4566,0,0,0,1.0,1,1.0,1,1.0,1,0.11277012759917912,48
3381,0,7127,2561,4566,0,0,0,1.0,1,1.0,1,1.0,1,0.11277012759917912,48
3382,2,7129,2562,4567,0,0,0,1.0,1,1.0,1,1.0,1,0.1386046930440397,49
3383,0,7129,2562,4567,0,0,0,1.0,1,1.0,1,1.0,1,0.10647877385522402,47
3384,7,7136,2564,4572,0,0,0,1.0,1,1.0,1,1.0,1,0.10094599651219491,48
3385,0,7136,2564,4572,0,0,0,1.0,1,1.0,1,1.0,1,0.10807723500046512,47
3386,2,7138,2565,4573,0,0,0,1.0,1,1.0,1,1.0,1,0.11433032536085008,49
3387,2,7140,2565,4575,0,0,0,1.0,1,1.0,1,1.0,1,0.09455417957575181,48
3388,1,7141,2566,4575,0,0,0,1.0,1,1.0,1,1.0,1,0.12741407256046328,48
3389,0,7141,2566,4575,0,0,0,1.0,1,1.0,1,1.0,1,0.1528366641505288,50
3390,0,7141,2566,4575,0,0,0,1.0,1,1.0,1,1.0,1,0.1353730560750803,51
3391,2,7143,2567,4576,0,0,0,1.0,1,1.0,1,1.0,1,0.15942720597745,51
3392,6,7149,2568,4581,0,0,0,1.0,1,1.0,1,1.0,1,0.11825235173006192,52
3393,5,7154,2569,4585,0,0,0,1.0,1,1.0,1,1.0,1,0.10381580950880756,52
3394,1,7155,2569,4586,0,0,0,1.0,1,1.0,1,1.0,1,0.06300980729331289,52
3395,1,7156,2570,4586,0,0,0,1.0,1,1.0,1,1.0,1,0.07859222242917423,50
3396,3,7159,2570,4589,0,0,0,1.0,1,1.0,1,1.0,1,0.030798069082331347,49
3397,0,7159,2570,4589,0,0,0,1.0,1,1.0,1,1.0,1,0.02662017185414758,49
3398,0,7159,2570,4589,0,0,0,1.0,1,1.0,1,1.0,1,0.02960681643764773,48
3399,1,7160,2571,4589,0,0,0,1.0,1,1.0,1,1.0,1,0.04923143476435556,49
3400,1,7161,2572,4589,0,0,0,1.0,1,1.0,1,1.0,1,0.057851521337963646,50
3401,0,7161,2572,4589,0,0,0,1.0,1,1.0,1,1.0,1,0.06862516980482879,51
3402,2,7163,2573,4590,0,0,0,1.0,1,1.0,1,1.0,1,0.10511765470380927,51
3403,0,7163,2573,4590,0,0,0,1.0,1,1.0,1,1.0,1,0.10511765470380927,51
3404,1,7164,2574,4590,0,0,0,1.0,1,1.0,1,1.0,1,0.09277072633629153,51
3405,2,7166,2576,4590,0,0,0,1.0,1,1.0,1,1.0,1,0.11856156214973833,51
3406,3,7169,2576,4593,0,0,0,1.0,1,1.0,1,1.0,1,0.0851446602076592,51
3407,0,7169,2576,4593,0,0,0,1.0,1,1.0,1,1.0,1,0.09571733293254836,52
3408,0,7169,2576,4593,0,0,0,1.0,1,1.0,1,1.0,1,0.10980122875934062,53
3409,1,7170,2576,4594,0,0,0,1.0,1,1.0,1,1.0,1,0.10634069092817194,54
3410,2,7172,2578,4594,0,0,0,1.0,1,1.0,1,1.0,1,0.10679014079378842,54
3411,3,7175,2578,4597,0,0,0,1.0,1,1.0,1,1.0,1,0.08908188014301874,54
3412,4,7179,2579,4600,0,0,0,1.0,1,1.0,1,1.0,1,0.09847095309154996,55
3413,4,7183,2580,4603,0,0,0,1.0,1,1.0,1,1.0,1,0.10105752051766212,55
3414,5,7188,2580,4608,0,0,0,1.0,1,1.0,1,1.0,1,0.15161097495472875,55
3415,3,7191,2581,4610,0,0,0,1.0,1,1.0,1,1.0,1,0.13315741924741006,56
3416,2,7193,2581,4612,0,0,0,1.0,1,1.0,1,1.0,1,0.14152546602823537,55
3417,1,7194,2582,4612,0,0,0,1.0,1,1.0,1,1.0,1,0.14207036256341213,56
3418,3,7197,2583,4614,0,0,0,1.0,1,1.0,1,1.0,1,0.1562399954748958,55
3419,3,7200,2583,4617,0,0,0,1.0,1,1.0,1,1.0,1,0.15786329137602498,56
3420,1,7201,2583,4618,0,0,0,1.0,1,1.0,1,1.0,1,0.1567827600162244,55
3421,3,7204,2584,4620,0,0,0,1.0,1,1.0,1,1.0,1,0.13004670632535667,57
3422,3,7207,2587,4620,0,0,0,1.0,1,1.0,1,1.0,1,0.12770176104795003,56
3423,1,7208,2587,4621,0,0,0,1.0,1,1.0,1,1.0,1,0.12633182352298786,56
3424,1,7209,2588,4621,0,0,0,1.0,1,1.0,1,1.0,1,0.14318821429187295,56
3425,1,7210,2589,4621,0,0,0,1.0,1,1.0,1,1.0,1,0.13707538894289442,56
3426,5,7215,2589,4626,0,0,0,1.0,1,1.0,1,1.0,1,0.10872756267920355,55
3427,1,7216,2590,4626,0,0,0,1.0,1,1.0,1,1.0,1,0.13477856964829657,55
3428,2,7218,2592,4626,0,0,0,1.0,1,1.0,1,1.0,1,0.1573787315221685,55
3429,3,7221,2593,4628,0,0,0,1.0,1,1.0,1,1.0,1,0.16769292615306028,54
3430,2,7223,2593,4630,0,0,0,1.0,1,1.0,1,1.0,1,0.14655684551850034,56
3431,3,7226,2593,4633,0,0,0,1.0,1,1.0,1,1.0,1,0.08348386065201578,54
3432,3,7229,2595,4634,0,0,0,1.0,1,1.0,1,1.0,1,0.15672819560590903,56
3433,3,7232,2596,4636,0,0,0,1.0,1,1.0,1,1.0,1,0.11529655580255514,53
3434,1,7233,2597,4636,0,0,0,1.0,1,1.0,1,1.0,1,0.09845114654993288,51
3435,1,7234,2598,4636,0,0,0,1.0,1,1.0,1,1.0,1,0.10912869980215616,51
3436,6,7240,2599,4641,0,0,0,1.0,1,1.0,1,1.0,1,0.10820985640270757,51
3437,2,7242,2600,4642,0,0,0,1.0,1,1.0,1,1.0,1,0.07913180867902071,53
3438,0,7242,2600,4642,0,0,0,1.0,1,1.0,1,1.0,1,0.0960698390524729,52
3439,5,7247,2601,4646,0,0,0,1.0,1,1.0,1,1.0,1,0.11076666151857506,54
3440,2,7249,2601,4648,0,0,0,1.0,1,1.0,1,1.0,1,0.10498973468621578,52
3441,1,7250,2601,4649,0,0,0,1.0,1,1.0,1,1.0,1,0.09473187073653715,53
3442,2,7252,2602,4650,0,0,0,1.0,1,1.0,1,1.0,1,0.07833930864184524,53
3443,2,7254,2602,4652,0,0,0,1.0,1,1.0,1,1.0,1,0.0776459326721019,53
3444,3,7257,2604,4653,0,0,0,1.0,1,1.0,1,1.0,1,0.10901821058439702,52
3445,3,7260,2606,4654,0,0,0,1.0,1,1.0,1,1.0,1,0.11666248499054561,53
3446,2,7262,2607,4655,0,0,0,1.0,1,1.0,1,1.0,1,0.1118849350323917,53
3447,3,7265,2608,4657,0,0,0,1.0,1,1.0,1,1.0,1,0.12938668070411935,53
3448,3,7268,2609,4659,0,0,0,1.0,1,1.0,1,1.0,1,0.09494821957018962,52
3449,0,7268,2609,4659,0,0,0,1.0,1,1.0,1,1.0,1,0.09494821957018962,52
3450,2,7270,2611,4659,0,0,0,1.0,1,1.0,1,1.0,1,0.08833920735816808,52
3451,4,7274,2615,4659,0,0,0,1.0,1,1.0,1,1.0,1,0.12205185626587947,54
3452,2,7276,2617,4659,0,0,0,1.0,1,1.0,1,1.0,1,0.16040593163774056,54
3453,4,7280,2619,4661,0,0,0,1.0,1,1.0,1,1.0,1,0.1837404430390363,54
3454,4,7284,2619,4665,0,0,0,1.0,1,1.0,1,1.0,1,0.14933300710860478,57
3455,1,7285,2619,4666,0,0,0,1.0,1,1.0,1,1.0,1,0.15498692579168885,57
3456,3,7288,2619,4669,0,0,0,1.0,1,1.0,1,1.0,1,0.13895588700928638,58
3457,1,7289,2619,4670,0,0,0,1.0,1,1.0,1,1.0,1,0.13350980814086175,57
3458,0,7289,2619,4670,0,0,0,1.0,1,1.0,1,1.0,1,0.1409052835117907,57
3459,1,7290,2619,4671,0,0,0,1.0,1,1.0,1,1.0,1,0.12175939643876318,57
3460,0,7290,2619,4671,0,0,0,1.0,1,1.0,1,1.0,1,0.1168862607397489,58
3461,3,7293,2619,4674,0,0,0,1.0,1,1.0,1,1.0,1,0.09749392864977076,59
3462,1,7294,2620,4674,0,0,0,1.0,1,1.0,1,1.0,1,0.1153562043557674,59
3463,1,7295,2621,4674,0,0,0,1.0,1,1.0,1,1.0,1,0.13401805310207668,59
3464,4,7299,2623,4676,0,0,0,1.0,1,1.0,1,1.0,1,0.16302247548249602,59
3465,5,7304,2625,4679,0,0,0,1.0,1,1.0,1,1.0,1,0.12865732044575606,57
3466,7,7311,2625,4686,0,0,0,1.0,1,1.0,1,1.0,1,0.059933488382550755,57
3467,4,7315,2625,4690,0,0,0,1.0,1,1.0,1,1.0,1,0.11980010123787836,57
3468,6,7321,2626,4695,0,0,0,1.0,1,1.0,1,1.0,1,0.11165709661413183,57
3469,4,7325,2628,4697,0,0,0,1.0,1,1.0,1,1.0,1,0.116995727377313,53
3470,4,7329,2630,4699,0,0,0,1.0,1,1.0,1,1.0,1,0.23537044369320467,50
3471,8,7337,2630,4707,0,0,0,1.0,1,1.0,1,1.0,1,0.07929212339783387,49
3472,0,7337,2630,4707,0,0,0,1.0,1,1.0,1,1.0,1,0.11317343111709013,47
3473,4,7341,2633,4708,0,0,0,1.0,1,1.0,1,1.0,1,0.14829056852078248,45
3474,1,7342,2633,4709,0,0,0,1.0,1,1.0,1,1.0,1,0.15235756152885452,42
3475,5,7347,2637,4710,0,0,0,1.0,1,1.0,1,1.0,1,0.24609012194789212,43
3476,7,7354,2638,4716,0,0,0,1.0,1,1.0,1,1.0,1,0.12456045455171624,41
3477,8,7362,2640,4722,0,0,0,1.0,1,1.0,1,1.0,1,0.09081575148446108,42
3478,2,7364,2640,4724,0,0,0,1.0,1,1.0,1,1.0,1,0.10337911871373798,40
3479,2,7366,2640,4726,0,0,0,1.0,1,1.0,1,1.0,1,0.15559104847151461,40
3480,2,7368,2640,4728,0,0,0,1.0,1,1.0,1,1.0,1,0.15185055541281792,40
3481,4,7372,2640,4732,0,0,0,1.0,1,1.0,1,1.0,1,0.11694612307666719,40
3482,3,7375,2641,4734,0,0,0,1.0,1,1.0,1,1.0,1,0.17590336950926724,40
3483,3,7378,2641,4737,0,0,0,1.0,1,1.0,1,1.0,1,0.14476933264972497,39
3484,7,7385,2642,4743,0,0,0,1.0,1,1.0,1,1.0,1,0.1843006166885851,39
3485,4,7389,2642,4747,0,0,0,1.0,1,1.0,1,1.0,1,0.20668256861820428,40
3486,6,7395,2642,4753,0,0,0,1.0,1,1.0,1,1.0,1,0.1123362306980813,41
3487,1,7396,2643,4753,0,0,0,1.0,1,1.0,1,1.0,1,0.11111238354499374,41
3488,0,7396,2643,4753,0,0,0,1.0,1,1.0,1,1.0,1,0.11018699871227329,42
3489,3,7399,2643,4756,0,0,0,1.0,1,1.0,1,1.0,1,0.11903842897287062,44
3490,1,7400,2643,4757,0,0,0,1.0,1,1.0,1,1.0,1,0.10165524847900187,44
3491,2,7402,2643,4759,0,0,0,1.0,1,1.0,1,1.0,1,0.09243114005706035,45
3492,1,7403,2644,4759,0,0,0,1.0,1,1.0,1,1.0,1,0.10631846374186651,45
3493,1,7404,2645,4759,0,0,0,1.0,1,1.0,1,1.0,1,0.11516801706325006,45
3494,0,7404,2645,4759,0,0,0,1.0,1,1.0,1,1.0,1,0.11516801706325006,45
3495,0,7404,2645,4759,0,0,0,1.0,1,1.0,1,1.0,1,0.11516801706325006,45
3496,2,7406,2645,4761,0,0,0,1.0,1,1.0,1,1.0,1,0.10183625940568533,46
3497,4,7410,2647,4763,0,0,0,1.0,1,1.0,1,1.0,1,0.11531612915574718,47
3498,0,7410,2647,4763,0,0,0,1.0,1,1.0,1,1.0,1,0.1197820777251811,48
3499,1,7411,2647,4764,0,0,0,1.0,1,1.0,1,1.0,1,0.1318195483808583,47
3500,1,7412,2647,4765,0,0,0,1.0,1,1.0,1,1.0,1,0.13352901162385258,50
3501,2,7414,2648,4766,0,0,0,1.0,1,1.0,1,1.0,1,0.15423794390273363,50
3502,1,7415,2648,4767,0,0,0,1.0,1,1.0,1,1.0,1,0.13040158613389005,50
3503,2,7417,2650,4767,0,0,0,1.0,1,1.0,1,1.0,1,0.1654914689517879,50
3504,6,7423,2654,4769,0,0,0,1.0,1,1.0,1,1.0,1,0.23583717951295124,47
3505,3,7426,2655,4771,0,0,0,1.0,1,1.0,1,1.0,1,0.2377540196527043,48
3506,4,7430,2656,4774,0,0,0,1.0,1,1.0,1,1.0,1,0.21480117592799014,49
3507,1,7431,2656,4775,0,0,0,1.0,1,1.0,1,1.0,1,0.19836328335292128,46
3508,3,7434,2658,4776,0,0,0,1.0,1,1.0,1,1.0,1,0.2359589603555798,47
3509,0,7434,2658,4776,0,0,0,1.0,1,1.0,1,1.0,1,0.22211478287219638,44
3510,0,7434,2658,4776,0,0,0,1.0,1,1.0,1,1.0,1,0.22006696664608635,45
3511,1,7435,2658,4777,0,0,0,1.0,1,1.0,1,1.0,1,0.20003736921860266,44
3512,0,7435,2658,4777,0,0,0,1.0,1,1.0,1,1.0,1,0.2052049655147969,42
3513,1,7436,2658,4778,0,0,0,1.0,1,1.0,1,1.0,1,0.19017281827932525,42
3514,1,7437,2658,4779,0,0,0,1.0,1,1.0,1,1.0,1,0.18813814309798194,42
3515,4,7441,2659,4782,0,0,0,1.0,1,1.0,1,1.0,1,0.1709896381510256,42
3516,2,7443,2659,4784,0,0,0,1.0,1,1.0,1,1.0,1,0.1395238489373432,41
3517,4,7447,2661,4786,0,0,0,1.0,1,1.0,1,1.0,1,0.13289735901228594,44
3518,0,7447,2661,4786,0,0,0,1.0,1,1.0,1,1.0,1,0.15220173174129256,43
3519,1,7448,2662,4786,0,0,0,1.0,1,1.0,1,1.0,1,0.18782302972359935,44
3520,0,7448,2662,4786,0,0,0,1.0,1,1.0,1,1.0,1,0.20502464130006745,45
3521,5,7453,2662,4791,0,0,0,1.0,1,1.0,1,1.0,1,0.10237021610106253,45
3522,0,7453,2662,4791,0,0,0,1.0,1,1.0,1,1.0,1,0.11583076885421228,46
3523,0,7453,2662,4791,0,0,0,1.0,1,1.0,1,1.0,1,0.11583076885421228,46
3524,0,7453,2662,4791,0,0,0,1.0,1,1.0,1,1.0,1,0.0967085821944584,47
3525,0,7453,2662,4791,0,0,0,1.0,1,1.0,1,1.0,1,0.13416832290811695,48
3526,1,7454,2663,4791,0,0,0,1.0,1,1.0,1,1.0,1,0.13092641824738527,49
3527,2,7456,2664,4792,0,0,0,1.0,1,1.0,1,1.0,1,0.14805063650764036,49
3528,3,7459,2664,4795,0,0,0,1.0,1,1.0,1,1.0,1,0.13027505998132655,51
3529,0,7459,2664,4795,0,0,0,1.0,1,1.0,1,1.0,1,0.13027505998132655,51
3530,1,7460,2665,4795,0,0,0,1.0,1,1.0,1,1.0,1,0.1590382879657045,52
3531,5,7465,2665,4800,0,0,0,1.0,1,1.0,1,1.0,1,0.09640729362912492,52
3532,0,7465,2665,4800,0,0,0,1.0,1,1.0,1,1.0,1,0.09640729362912492,52
3533,0,7465,2665,4800,0,0,0,1.0,1,1.0,1,1.0,1,0.09640729362912492,52
3534,0,7465,2665,4800,0,0,0,1.0,1,1.0,1,1.0,1,0.09640729362912492,52
3535,2,7467,2666,4801,0,0,0,1.0,1,1.0,1,1.0,1,0.09910718633369217,52
3536,3,7470,2666,4804,0,0,0,1.0,1,1.0,1,1.0,1,0.10746654659268154,54
3537,0,7470,2666,4804,0,0,0,1.0,1,1.0,1,1.0,1,0.11488866531441906,55
3538,0,7470,2666,4804,0,0,0,1.0,1,1.0,1,1.0,1,0.11488866531441906,55
3539,1,7471,2666,4805,0,0,0,1.0,1,1.0,1,1.0,1,0.11420929834822352,58
3540,3,7474,2668,4806,0,0,0,1.0,1,1.0,1,1.0,1,0.1282865966333707,59
3541,0,7474,2668,4806,0,0,0,1.0,1,1.0,1,1.0,1,0.1282865966333707,59
3542,3,7477,2669,4808,0,0,0,1.0,1,1.0,1,1.0,1,0.12487728392579196,61
3543,6,7483,2671,4812,0,0,0,1.0,1,1.0,1,1.0,1,0.0985185537128107,62
3544,5,7488,2674,4814,0,0,0,1.0,1,1.0,1,1.0,1,0.11992918545004398,59
3545,0,7488,2674,4814,0,0,0,1.0,1,1.0,1,1.0,1,0.12084757756210086,59
3546,5,7493,2676,4817,0,0,0,1.0,1,1.0,1,1.0,1,0.06914710988583556,57
3547,1,7494,2677,4817,0,0,0,1.0,1,1.0,1,1.0,1,0.08778543955029901,53
3548,1,7495,2678,4817,0,0,0,1.0,1,1.0,1,1.0,1,0.1080955452704702,53
3549,1,7496,2678,4818,0,0,0,1.0,1,1.0,1,1.0,1,0.09006556259251396,52
3550,1,7497,2679,4818,0,0,0,1.0,1,1.0,1,1.0,1,0.12560612776796665,51
3551,1,7498,2680,4818,0,0,0,1.0,1,1.0,1,1.0,1,0.12583169354610874,51
3552,2,7500,2680,4820,0,0,0,1.0,1,1.0,1,1.0,1,0.12473965966358513,51
3553,0,7500,2680,4820,0,0,0,1.0,1,1.0,1,1.0,1,0.13505387957153836,49
3554,0,7500,2680,4820,0,0,0,1.0,1,1.0,1,1.0,1,0.13505387957153836,49
3555,1,7501,2680,4821,0,0,0,1.0,1,1.0,1,1.0,1,0.13646697647737166,51
3556,1,7502,2680,4822,0,0,0,1.0,1,1.0,1,1.0,1,0.12526168817622715,51
3557,2,7504,2681,4823,0,0,0,1.0,1,1.0,1,1.0,1,0.13541140382155162,52
3558,3,7507,2683,4824,0,0,0,1.0,1,1.0,1,1.0,1,0.16393592758643,52
3559,5,7512,2685,4827,0,0,0,1.0,1,1.0,1,1.0,1,0.1694716144657227,52
3560,1,7513,2686,4827,0,0,0,1.0,1,1.0,1,1.0,1,0.16019975960539065,53
3561,4,7517,2686,4831,0,0,0,1.0,1,1.0,1,1.0,1,0.12576860580327895,54
3562,1,7518,2686,4832,0,0,0,1.0,1,1.0,1,1.0,1,0.11277426657827755,54
3563,1,7519,2687,4832,0,0,0,1.0,1,1.0,1,1.0,1,0.14874572313629209,55
3564,1,7520,2687,4833,0,0,0,1.0,1,1.0,1,1.0,1,0.11294788873690195,57
3565,1,7521,2687,4834,0,0,0,1.0,1,1.0,1,1.0,1,0.13356563170375818,56
3566,2,7523,2687,4836,0,0,0,1.0,1,1.0,1,1.0,1,0.12915301680519803,57
3567,2,7525,2688,4837,0,0,0,1.0,1,1.0,1,1.0,1,0.1180827141102554,57
3568,1,7526,2688,4838,0,0,0,1.0,1,1.0,1,1.0,1,0.1053072061116826,57
3569,0,7526,2688,4838,0,0,0,1.0,1,1.0,1,1.0,1,0.1053072061116826,57
3570,2,7528,2689,4839,0,0,0,1.0,1,1.0,1,1.0,1,0.12260706820504344,59
3571,2,7530,2689,4841,0,0,0,1.0,1,1.0,1,1.0,1,0.09293613247702413,60
3572,1,7531,2690,4841,0,0,0,1.0,1,1.0,1,1.0,1,0.09066125385648006,61
3573,4,7535,2691,4844,0,0,0,1.0,1,1.0,1,1.0,1,0.0908832714942007,62
3574,0,7535,2691,4844,0,0,0,1.0,1,1.0,1,1.0,1,0.09103174577941663,63
3575,3,7538,2693,4845,0,0,0,1.0,1,1.0,1,1.0,1,0.1349217701916475,63
3576,5,7543,2695,4848,0,0,0,1.0,1,1.0,1,1.0,1,0.1474979124803314,63
3577,1,7544,2695,4849,0,0,0,1.0,1,1.0,1,1.0,1,0.13243521854221801,64
3578,1,7545,2696,4849,0,0,0,1.0,1,1.0,1,1.0,1,0.15190565413419968,64
3579,1,7546,2696,4850,0,0,0,1.0,1,1.0,1,1.0,1,0.14460006673756853,64
3580,0,7546,2696,4850,0,0,0,1.0,1,1.0,1,1.0,1,0.15402251468371156,65
3581,5,7551,2697,4854,0,0,0,1.0,1,1.0,1,1.0,1,0.13125596571654563,68
3582,4,7555,2700,4855,0,0,0,1.0,1,1.0,1,1.0,1,0.14019102150157162,68
3583,2,7557,2702,4855,0,0,0,1.0,1,1.0,1,1.0,1,0.14328302673100612,65
3584,3,7560,2705,4855,0,0,0,1.0,1,1.0,1,1.0,1,0.16546004034497475,64
3585,4,7564,2707,4857,0,0,0,1.0,1,1.0,1,1.0,1,0.15250104604927553,64
3586,7,7571,2709,4862,0,0,0,1.0,1,1.0,1,1.0,1,0.10396629521622268,65
3587,4,7575,2710,4865,0,0,0,1.0,1,1.0,1,1.0,1,0.09161719332699254,64
3588,3,7578,2710,4868,0,0,0,1.0,1,1.0,1,1.0,1,0.09726033644351786,62
3589,3,7581,2711,4870,0,0,0,1.0,1,1.0,1,1.0,1,0.13243189668853864,63
3590,2,7583,2712,4871,0,0,0,1.0,1,1.0,1,1.0,1,0.10834075920834113,63
3591,6,7589,2715,4874,0,0,0,1.0,1,1.0,1,1.0,1,0.08828977152431075,62
3592,0,7589,2715,4874,0,0,0,1.0,1,1.0,1,1.0,1,0.07959490814512697,59
3593,4,7593,2718,4875,0,0,0,1.0,1,1.0,1,1.0,1,0.07059504131119555,58
3594,0,7593,2718,4875,0,0,0,1.0,1,1.0,1,1.0,1,0.07755185312714051,57
3595,1,7594,2719,4875,0,0,0,1.0,1,1.0,1,1.0,1,0.10305407975433702,59
3596,3,7597,2720,4877,0,0,0,1.0,1,1.0,1,1.0,1,0.06569973447614741,57
3597,2,7599,2722,4877,0,0,0,1.0,1,1.0,1,1.0,1,0.09535854326947195,57
3598,5,7604,2723,4881,0,0,0,1.0,1,1.0,1,1.0,1,0.09216365830664558,57
3599,5,7609,2726,4883,0,0,0,1.0,1,1.0,1,1.0,1,0.12074553603541634,58
3600,2,7611,2726,4885,0,0,0,1.0,1,1.0,1,1.0,1,0.10753755157153458,58
3601,7,7618,2728,4890,0,0,0,1.0,1,1.0,1,1.0,1,0.09896199287309974,58
3602,0,7618,2728,4890,0,0,0,1.0,1,1.0,1,1.0,1,0.0859936804978352,60
3603,0,7618,2728,4890,0,0,0,1.0,1,1.0,1,1.0,1,0.0859936804978352,60
3604,0,7618,2728,4890,0,0,0,1.0,1,1.0,1,1.0,1,0.0859936804978352,60
3605,0,7618,2728,4890,0,0,0,1.0,1,1.0,1,1.0,1,0.10176481208945044,61
3606,7,7625,2729,4896,0,0,0,1.0,1,1.0,1,1.0,1,0.05441963982076211,63
3607,4,7629,2731,4898,0,0,0,1.0,1,1.0,1,1.0,1,0.0690233419555148,63
3608,2,7631,2731,4900,0,0,0,1.0,1,1.0,1,1.0,1,0.06304137012383948,64
3609,5,7636,2731,4905,0,0,0,1.0,1,1.0,1,1.0,1,0.08136476913137851,66
3610,5,7641,2733,4908,0,0,0,1.0,1,1.0,1,1.0,1,0.11357335435014763,67
3611,5,7646,2735,4911,0,0,0,1.0,1,1.0,1,1.0,1,0.10443517536856436,67
3612,3,7649,2736,4913,0,0,0,1.0,1,1.0,1,1.0,1,0.11735132535909157,66
3613,1,7650,2737,4913,0,0,0,1.0,1,1.0,1,1.0,1,0.1397789122336627,66
3614,3,7653,2739,4914,0,0,0,1.0,1,1.0,1,1.0,1,0.12398948454104812,65
3615,0,7653,2739,4914,0,0,0,1.0,1,1.0,1,1.0,1,0.13372431308317587,65
3616,3,7656,2739,4917,0,0,0,1.0,1,1.0,1,1.0,1,0.10527551814350881,65
3617,2,7658,2740,4918,0,0,0,1.0,1,1.0,1,1.0,1,0.11219559018022982,66
3618,2,7660,2740,4920,0,0,0,1.0,1,1.0,1,1.0,1,0.09882939839075804,66
3619,0,7660,2740,4920,0,0,0,1.0,1,1.0,1,1.0,1,0.10081357848722401,65
3620,3,7663,2742,4921,0,0,0,1.0,1,1.0,1,1.0,1,0.14021252296609582,66
3621,7,7670,2743,4927,0,0,0,1.0,1,1.0,1,1.0,1,0.09812015077535542,65
3622,2,7672,2744,4928,0,0,0,1.0,1,1.0,1,1.0,1,0.08387819604592027,65
3623,2,7674,2746,4928,0,0,0,1.0,1,1.0,1,1.0,1,0.12387955916167426,62
3624,5,7679,2750,4929,0,0,0,1.0,1,1.0,1,1.0,1,0.16099187608453566,62
3625,1,7680,2750,4930,0,0,0,1.0,1,1.0,1,1.0,1,0.16886282498818916,61
3626,7,7687,2751,4936,0,0,0,1.0,1,1.0,1,1.0,1,0.06818190387390052,58
3627,3,7690,2752,4938,0,0,0,1.0,1,1.0,1,1.0,1,0.10838874140748295,58
3628,2,7692,2754,4938,0,0,0,1.0,1,1.0,1,1.0,1,0.08528848141226975,57
3629,5,7697,2755,4942,0,0,0,1.0,1,1.0,1,1.0,1,0.14078486960928543,57
3630,7,7704,2758,4946,0,0,0,1.0,1,1.0,1,1.0,1,0.15875807888242388,56
3631,11,7715,2763,4952,0,0,0,1.0,1,1.0,1,1.0,1,0.11248534685719801,54
3632,2,7717,2763,4954,0,0,0,1.0,1,1.0,1,1.0,1,0.0990180391853948,52
3633,9,7726,2768,4958,0,0,0,1.0,1,1.0,1,1.0,1,0.22139797252866497,52
3634,11,7737,2770,4967,0,0,0,1.0,1,1.0,1,1.0,1,0.1810996530022464,49
3635,3,7740,2770,4970,0,0,0,1.0,1,1.0,1,1.0,1,0.19573400699586846,47
3636,6,7746,2770,4976,0,0,0,1.0,1,1.0,1,1.0,1,0.1032151836637491,48
3637,1,7747,2770,4977,0,0,0,1.0,1,1.0,1,1.0,1,0.13801084208311365,49
3638,1,7748,2770,4978,0,0,0,1.0,1,1.0,1,1.0,1,0.12100896417667005,50
3639,2,7750,2770,4980,0,0,0,1.0,1,1.0,1,1.0,1,0.11569527191459895,52
3640,4,7754,2771,4983,0,0,0,1.0,1,1.0,1,1.0,1,0.13376506446793326,52
3641,2,7756,2771,4985,0,0,0,1.0,1,1.0,1,1.0,1,0.11580502739438642,52
3642,0,7756,2771,4985,0,0,0,1.0,1,1.0,1,1.0,1,0.11580502739438642,52
3643,0,7756,2771,4985,0,0,0,1.0,1,1.0,1,1.0,1,0.11580502739438642,52
3644,0,7756,2771,4985,0,0,0,1.0,1,1.0,1,1.0,1,0.11580502739438642,52
3645,1,7757,2771,4986,0,0,0,1.0,1,1.0,1,1.0,1,0.09234660032410984,53
3646,0,7757,2771,4986,0,0,0,1.0,1,1.0,1,1.0,1,0.09234660032410984,53
3647,1,7758,2771,4987,0,0,0,1.0,1,1.0,1,1.0,1,0.09323158411501385,55
3648,0,7758,2771,4987,0,0,0,1.0,1,1.0,1,1.0,1,0.10205842258286284,57
3649,2,7760,2772,4988,0,0,0,1.0,1,1.0,1,1.0,1,0.08743105818842874,57
3650,2,7762,2772,4990,0,0,0,1.0,1,1.0,1,1.0,1,0.08666849166349935,59
3651,1,7763,2773,4990,0,0,0,1.0,1,1.0,1,1.0,1,0.08306775932925994,59
3652,0,7763,2773,4990,0,0,0,1.0,1,1.0,1,1.0,1,0.08306775932925994,59
3653,0,7763,2773,4990,0,0,0,1.0,1,1.0,1,1.0,1,0.08306775932925994,59
3654,1,7764,2773,4991,0,0,0,1.0,1,1.0,1,1.0,1,0.07416047033492439,59
3655,1,7765,2773,4992,0,0,0,1.0,1,1.0,1,1.0,1,0.0653070535497846,62
3656,1,7766,2773,4993,0,0,0,1.0,1,1.0,1,1.0,1,0.05460648275221156,62
3657,0,7766,2773,4993,0,0,0,1.0,1,1.0,1,1.0,1,0.06736570460880768,63
3658,1,7767,2774,4993,0,0,0,1.0,1,1.0,1,1.0,1,0.1086897406291085,63
3659,0,7767,2774,4993,0,0,0,1.0,1,1.0,1,1.0,1,0.0962800564069281,62
3660,3,7770,2777,4993,0,0,0,1.0,1,1.0,1,1.0,1,0.15260544580650437,62
3661,5,7775,2779,4996,0,0,0,1.0,1,1.0,1,1.0,1,0.11718239006591796,61
3662,6,7781,2782,4999,0,0,0,1.0,1,1.0,1,1.0,1,0.14664622173405922,60
3663,2,7783,2782,5001,0,0,0,1.0,1,1.0,1,1.0,1,0.12402835860619361,61
3664,1,7784,2783,5001,0,0,0,1.0,1,1.0,1,1.0,1,0.12383328010959997,58
3665,3,7787,2785,5002,0,0,0,1.0,1,1.0,1,1.0,1,0.11337012377357317,58
3666,5,7792,2786,5006,0,0,0,1.0,1,1.0,1,1.0,1,0.07527454838883516,58
3667,3,7795,2789,5006,0,0,0,1.0,1,1.0,1,1.0,1,0.07958965681632008,58
3668,0,7795,2789,5006,0,0,0,1.0,1,1.0,1,1.0,1,0.07963553358945778,58
3669,1,7796,2790,5006,0,0,0,1.0,1,1.0,1,1.0,1,0.09792324857378437,57
3670,1,7797,2791,5006,0,0,0,1.0,1,1.0,1,1.0,1,0.1081966514213134,56
3671,2,7799,2792,5007,0,0,0,1.0,1,1.0,1,1.0,1,0.11201111958045033,57
3672,4,7803,2794,5009,0,0,0,1.0,1,1.0,1,1.0,1,0.1467970116542786,57
3673,3,7806,2795,5011,0,0,0,1.0,1,1.0,1,1.0,1,0.13852212540457198,58
3674,1,7807,2795,5012,0,0,0,1.0,1,1.0,1,1.0,1,0.1570209110691895,57
3675,4,7811,2795,5016,0,0,0,1.0,1,1.0,1,1.0,1,0.16799472816490452,58
3676,4,7815,2796,5019,0,0,0,1.0,1,1.0,1,1.0,1,0.16418542766011648,59
3677,4,7819,2797,5022,0,0,0,1.0,1,1.0,1,1.0,1,0.1574158596887927,60
3678,3,7822,2797,5025,0,0,0,1.0,1,1.0,1,1.0,1,0.1501541534607926,62
3679,0,7822,2797,5025,0,0,0,1.0,1,1.0,1,1.0,1,0.1501541534607926,62
3680,0,7822,2797,5025,0,0,0,1.0,1,1.0,1,1.0,1,0.13332632960869087,63
3681,4,7826,2797,5029,0,0,0,1.0,1,1.0,1,1.0,1,0.09888652959756679,64
3682,0,7826,2797,5029,0,0,0,1.0,1,1.0,1,1.0,1,0.09888652959756679,64
3683,0,7826,2797,5029,0,0,0,1.0,1,1.0,1,1.0,1,0.09888652959756679,64
3684,1,7827,2798,5029,0,0,0,1.0,1,1.0,1,1.0,1,0.11300893966082046,64
3685,0,7827,2798,5029,0,0,0,1.0,1,1.0,1,1.0,1,0.11300893966082046,64
3686,0,7827,2798,5029,0,0,0,1.0,1,1.0,1,1.0,1,0.10378328416266423,65
3687,0,7827,2798,5029,0,0,0,1.0,1,1.0,1,1.0,1,0.10378328416266423,65
3688,1,7828,2798,5030,0,0,0,1.0,1,1.0,1,1.0,1,0.09996048110768545,66
3689,0,7828,2798,5030,0,0,0,1.0,1,1.0,1,1.0,1,0.09996048110768545,66
3690,1,7829,2798,5031,0,0,0,1.0,1,1.0,1,1.0,1,0.1056367510614754,67
3691,0,7829,2798,5031,0,0,0,1.0,1,1.0,1,1.0,1,0.09668824155471664,68
3692,1,7830,2798,5032,0,0,0,1.0,1,1.0,1,1.0,1,0.0851308104242186,69
3693,1,7831,2798,5033,0,0,0,1.0,1,1.0,1,1.0,1,0.0836110730663973,69
3694,1,7832,2799,5033,0,0,0,1.0,1,1.0,1,1.0,1,0.10503998936998897,70
3695,0,7832,2799,5033,0,0,0,1.0,1,1.0,1,1.0,1,0.10503998936998897,70
3696,1,7833,2799,5034,0,0,0,1.0,1,1.0,1,1.0,1,0.08488085942837967,71
3697,3,7836,2801,5035,0,0,0,1.0,1,1.0,1,1.0,1,0.09722436832862247,70
3698,0,7836,2801,5035,0,0,0,1.0,1,1.0,1,1.0,1,0.09911450406366457,70
3699,2,7838,2803,5035,0,0,0,1.0,1,1.0,1,1.0,1,0.12346136348196173,70
3700,5,7843,2807,5036,0,0,0,1.0,1,1.0,1,1.0,1,0.1532208276753157,68
3701,7,7850,2808,5042,0,0,0,1.0,1,1.0,1,1.0,1,0.15451146410074396,69
3702,2,7852,2808,5044,0,0,0,1.0,1,1.0,1,1.0,1,0.13745587367069168,69
3703,4,7856,2808,5048,0,0,0,1.0,1,1.0,1,1.0,1,0.15627854533832483,70
3704,4,7860,2810,5050,0,0,0,1.0,1,1.0,1,1.0,1,0.17718849829760416,69
3705,3,7863,2810,5053,0,0,0,1.0,1,1.0,1,1.0,1,0.14578485095844818,69
3706,6,7869,2812,5057,0,0,0,1.0,1,1.0,1,1.0,1,0.13948180917192532,69
3707,0,7869,2812,5057,0,0,0,1.0,1,1.0,1,1.0,1,0.12132649553341739,67
3708,1,7870,2813,5057,0,0,0,1.0,1,1.0,1,1.0,1,0.11241251957416487,67
3709,2,7872,2813,5059,0,0,0,1.0,1,1.0,1,1.0,1,0.08689206030514497,67
3710,0,7872,2813,5059,0,0,0,1.0,1,1.0,1,1.0,1,0.08730807308383126,67
3711,2,7874,2813,5061,0,0,0,1.0,1,1.0,1,1.0,1,0.07228931868507016,68
3712,0,7874,2813,5061,0,0,0,1.0,1,1.0,1,1.0,1,0.07228931868507016,68
3713,2,7876,2815,5061,0,0,0,1.0,1,1.0,1,1.0,1,0.08433960034206653,68
3714,0,7876,2815,5061,0,0,0,1.0,1,1.0,1,1.0,1,0.10207293269295402,67
3715,1,7877,2816,5061,0,0,0,1.0,1,1.0,1,1.0,1,0.11058128724872135,68
3716,3,7880,2816,5064,0,0,0,1.0,1,1.0,1,1.0,1,0.09551391905671468,67
3717,0,7880,2816,5064,0,0,0,1.0,1,1.0,1,1.0,1,0.1151588481274872,68
3718,1,7881,2816,5065,0,0,0,1.0,1,1.0,1,1.0,1,0.1287448926420931,68
3719,3,7884,2817,5067,0,0,0,1.0,1,1.0,1,1.0,1,0.1634869642616721,68
3720,1,7885,2817,5068,0,0,0,1.0,1,1.0,1,1.0,1,0.14731212908524965,68
3721,4,7889,2821,5068,0,0,0,1.0,1,1.0,1,1.0,1,0.14932692479633589,70
3722,1,7890,2821,5069,0,0,0,1.0,1,1.0,1,1.0,1,0.1520790553159257,71
3723,3,7893,2822,5071,0,0,0,1.0,1,1.0,1,1.0,1,0.14598812427570723,71
3724,3,7896,2823,5073,0,0,0,1.0,1,1.0,1,1.0,1,0.14887922948961219,72
3725,4,7900,2824,5076,0,0,0,1.0,1,1.0,1,1.0,1,0.13952619717633594,72
3726,7,7907,2825,5082,0,0,0,1.0,1,1.0,1,1.0,1,0.11071286831841864,71
3727,2,7909,2826,5083,0,0,0,1.0,1,1.0,1,1.0,1,0.13133335954055578,71
3728,1,7910,2826,5084,0,0,0,1.0,1,1.0,1,1.0,1,0.1480148256589016,70
3729,3,7913,2827,5086,0,0,0,1.0,1,1.0,1,1.0,1,0.1440786564096464,70
3730,6,7919,2828,5091,0,0,0,1.0,1,1.0,1,1.0,1,0.1592155875294671,71
3731,3,7922,2828,5094,0,0,0,1.0,1,1.0,1,1.0,1,0.13268832292933677,71
3732,0,7922,2828,5094,0,0,0,1.0,1,1.0,1,1.0,1,0.1298497358714611,72
3733,0,7922,2828,5094,0,0,0,1.0,1,1.0,1,1.0,1,0.12706323618171556,73
3734,5,7927,2830,5097,0,0,0,1.0,1,1.0,1,1.0,1,0.14902289389336648,74
3735,2,7929,2831,5098,0,0,0,1.0,1,1.0,1,1.0,1,0.13774420304479154,72
3736,1,7930,2831,5099,0,0,0,1.0,1,1.0,1,1.0,1,0.11514559501123069,72
3737,1,7931,2831,5100,0,0,0,1.0,1,1.0,1,1.0,1,0.10538045008449652,73
3738,0,7931,2831,5100,0,0,0,1.0,1,1.0,1,1.0,1,0.1021828752700254,72
3739,0,7931,2831,5100,0,0,0,1.0,1,1.0,1,1.0,1,0.10047134138545065,73
3740,0,7931,2831,5100,0,0,0,1.0,1,1.0,1,1.0,1,0.11478335086566861,70
3741,0,7931,2831,5100,0,0,0,1.0,1,1.0,1,1.0,1,0.11478335086566861,70
3742,2,7933,2833,5100,0,0,0,1.0,1,1.0,1,1.0,1,0.12535467856673985,70
3743,1,7934,2833,5101,0,0,0,1.0,1,1.0,1,1.0,1,0.12675486268307556,69
3744,7,7941,2837,5104,0,0,0,1.0,1,1.0,1,1.0,1,0.18413049031573467,69
3745,4,7945,2838,5107,0,0,0,1.0,1,1.0,1,1.0,1,0.14943800303534835,68
3746,6,7951,2838,5113,0,0,0,1.0,1,1.0,1,1.0,1,0.12920609357653112,66
3747,2,7953,2838,5115,0,0,0,1.0,1,1.0,1,1.0,1,0.12487219842996813,66
3748,1,7954,2838,5116,0,0,0,1.0,1,1.0,1,1.0,1,0.08976036073630114,65
3749,1,7955,2839,5116,0,0,0,1.0,1,1.0,1,1.0,1,0.09572558243829121,64
3750,1,7956,2840,5116,0,0,0,1.0,1,1.0,1,1.0,1,0.11139614719386694,63
3751,4,7960,2841,5119,0,0,0,1.0,1,1.0,1,1.0,1,0.10165765601856469,64
3752,4,7964,2844,5120,0,0,0,1.0,1,1.0,1,1.0,1,0.11110039806726557,64
3753,3,7967,2845,5122,0,0,0,1.0,1,1.0,1,1.0,1,0.11753034452128845,65
3754,4,7971,2848,5123,0,0,0,1.0,1,1.0,1,1.0,1,0.15973042705182292,65
3755,3,7974,2848,5126,0,0,0,1.0,1,1.0,1,1.0,1,0.15019366047815746,65
3756,4,7978,2849,5129,0,0,0,1.0,1,1.0,1,1.0,1,0.13251782082923205,65
3757,4,7982,2850,5132,0,0,0,1.0,1,1.0,1,1.0,1,0.12978339360221375,65
3758,0,7982,2850,5132,0,0,0,1.0,1,1.0,1,1.0,1,0.13743797868138227,64
3759,1,7983,2851,5132,0,0,0,1.0,1,1.0,1,1.0,1,0.1363826171385772,64
3760,3,7986,2851,5135,0,0,0,1.0,1,1.0,1,1.0,1,0.15922448620936705,63
3761,7,7993,2852,5141,0,0,0,1.0,1,1.0,1,1.0,1,0.12311564092355863,63
3762,3,7996,2852,5144,0,0,0,1.0,1,1.0,1,1.0,1,0.12139591162654556,65
3763,3,7999,2853,5146,0,0,0,1.0,1,1.0,1,1.0,1,0.16087554843234214,65
3764,5,8004,2853,5151,0,0,0,1.0,1,1.0,1,1.0,1,0.1175754622759168,66
3765,3,8007,2853,5154,0,0,0,1.0,1,1.0,1,1.0,1,0.13390980601621014,67
3766,2,8009,2854,5155,0,0,0,1.0,1,1.0,1,1.0,1,0.13746241693254505,67
3767,3,8012,2855,5157,0,0,0,1.0,1,1.0,1,1.0,1,0.1129978911958692,68
3768,3,8015,2857,5158,0,0,0,1.0,1,1.0,1,1.0,1,0.16865693840292503,67
3769,3,8018,2857,5161,0,0,0,1.0,1,1.0,1,1.0,1,0.12266677674928164,69
3770,0,8018,2857,5161,0,0,0,1.0,1,1.0,1,1.0,1,0.12266677674928164,69
3771,2,8020,2857,5163,0,0,0,1.0,1,1.0,1,1.0,1,0.11676914719361808,69
3772,0,8020,2857,5163,0,0,0,1.0,1,1.0,1,1.0,1,0.12548145315207365,70
3773,1,8021,2857,5164,0,0,0,1.0,1,1.0,1,1.0,1,0.10806666642125093,68
3774,2,8023,2859,5164,0,0,0,1.0,1,1.0,1,1.0,1,0.1050024836862195,68
3775,3,8026,2860,5166,0,0,0,1.0,1,1.0,1,1.0,1,0.13389295173356688,68
3776,2,8028,2860,5168,0,0,0,1.0,1,1.0,1,1.0,1,0.10179160290748675,66
3777,1,8029,2861,5168,0,0,0,1.0,1,1.0,1,1.0,1,0.09164777015205432,65
3778,0,8029,2861,5168,0,0,0,1.0,1,1.0,1,1.0,1,0.08949820595210797,65
3779,2,8031,2863,5168,0,0,0,1.0,1,1.0,1,1.0,1,0.11500022633520457,65
3780,3,8034,2865,5169,0,0,0,1.0,1,1.0,1,1.0,1,0.12612732858530276,64
3781,2,8036,2865,5171,0,0,0,1.0,1,1.0,1,1.0,1,0.10266071368922093,64
3782,1,8037,2866,5171,0,0,0,1.0,1,1.0,1,1.0,1,0.14381106687540965,67
3783,4,8041,2867,5174,0,0,0,1.0,1,1.0,1,1.0,1,0.12600570448369156,65
3784,4,8045,2869,5176,0,0,0,1.0,1,1.0,1,1.0,1,0.12799210743487593,65
3785,2,8047,2870,5177,0,0,0,1.0,1,1.0,1,1.0,1,0.15127510665460323,63
3786,4,8051,2870,5181,0,0,0,1.0,1,1.0,1,1.0,1,0.10366285425517457,66
3787,3,8054,2872,5182,0,0,0,1.0,1,1.0,1,1.0,1,0.11830348099373271,65
3788,3,8057,2873,5184,0,0,0,1.0,1,1.0,1,1.0,1,0.10177457602698725,65
3789,5,8062,2875,5187,0,0,0,1.0,1,1.0,1,1.0,1,0.11844716577663834,65
3790,4,8066,2876,5190,0,0,0,1.0,1,1.0,1,1.0,1,0.15147155300480983,64
3791,3,8069,2878,5191,0,0,0,1.0,1,1.0,1,1.0,1,0.1590265710031296,64
3792,3,8072,2879,5193,0,0,0,1.0,1,1.0,1,1.0,1,0.1526676096694667,65
3793,5,8077,2880,5197,0,0,0,1.0,1,1.0,1,1.0,1,0.15304673771990798,68
3794,4,8081,2881,5200,0,0,0,1.0,1,1.0,1,1.0,1,0.1680293407192383,68
3795,3,8084,2881,5203,0,0,0,1.0,1,1.0,1,1.0,1,0.1425151088984787,69
3796,1,8085,2881,5204,0,0,0,1.0,1,1.0,1,1.0,1,0.13667230199475155,69
3797,0,8085,2881,5204,0,0,0,1.0,1,1.0,1,1.0,1,0.14786002228747216,70
3798,2,8087,2881,5206,0,0,0,1.0,1,1.0,1,1.0,1,0.14143032115054238,70
3799,0,8087,2881,5206,0,0,0,1.0,1,1.0,1,1.0,1,0.1531525502590116,69
3800,1,8088,2881,5207,0,0,0,1.0,1,1.0,1,1.0,1,0.14234615301736292,69
3801,5,8093,2881,5212,0,0,0,1.0,1,1.0,1,1.0,1,0.12051777656191946,67
3802,0,8093,2881,5212,0,0,0,1.0,1,1.0,1,1.0,1,0.12051777656191946,67
3803,2,8095,2882,5213,0,0,0,1.0,1,1.0,1,1.0,1,0.11068312842346634,69
3804,0,8095,2882,5213,0,0,0,1.0,1,1.0,1,1.0,1,0.11453344231906558,70
3805,2,8097,2883,5214,0,0,0,1.0,1,1.0,1,1.0,1,0.11801431975300747,71
3806,2,8099,2884,5215,0,0,0,1.0,1,1.0,1,1.0,1,0.10762043773308198,71
3807,3,8102,2885,5217,0,0,0,1.0,1,1.0,1,1.0,1,0.10477828840403425,72
3808,1,8103,2885,5218,0,0,0,1.0,1,1.0,1,1.0,1,0.10828429867071555,72
3809,1,8104,2885,5219,0,0,0,1.0,1,1.0,1,1.0,1,0.09645147816541133,72
3810,3,8107,2886,5221,0,0,0,1.0,1,1.0,1,1.0,1,0.11075157063029999,72
3811,0,8107,2886,5221,0,0,0,1.0,1,1.0,1,1.0,1,0.09578580148606104,71
3812,1,8108,2886,5222,0,0,0,1.0,1,1.0,1,1.0,1,0.09014488902534988,72
3813,3,8111,2887,5224,0,0,0,1.0,1,1.0,1,1.0,1,0.12258131198525546,71
3814,5,8116,2890,5226,0,0,0,1.0,1,1.0,1,1.0,1,0.16049744133521748,72
3815,3,8119,2891,5228,0,0,0,1.0,1,1.0,1,1.0,1,0.16165099016968218,71
3816,3,8122,2891,5231,0,0,0,1.0,1,1.0,1,1.0,1,0.11100497862800962,69
3817,1,8123,2891,5232,0,0,0,1.0,1,1.0,1,1.0,1,0.11922914854038312,72
3818,1,8124,2891,5233,0,0,0,1.0,1,1.0,1,1.0,1,0.10376346919606495,72
3819,2,8126,2892,5234,0,0,0,1.0,1,1.0,1,1.0,1,0.11356721252678621,72
3820,3,8129,2893,5236,0,0,0,1.0,1,1.0,1,1.0,1,0.12174492689788054,72
3821,2,8131,2895,5236,0,0,0,1.0,1,1.0,1,1.0,1,0.16582806273447004,72
3822,1,8132,2895,5237,0,0,0,1.0,1,1.0,1,1.0,1,0.15074188912035433,69
3823,3,8135,2897,5238,0,0,0,1.0,1,1.0,1,1.0,1,0.13627248896199318,69
3824,1,8136,2898,5238,0,0,0,1.0,1,1.0,1,1.0,1,0.15931332134232892,65
3825,1,8137,2899,5238,0,0,0,1.0,1,1.0,1,1.0,1,0.1560308130650879,64
3826,4,8141,2900,5241,0,0,0,1.0,1,1.0,1,1.0,1,0.1483607395686885,65
3827,5,8146,2901,5245,0,0,0,1.0,1,1.0,1,1.0,1,0.12821818214661945,64
3828,0,8146,2901,5245,0,0,0,1.0,1,1.0,1,1.0,1,0.11765102199292977,65
3829,1,8147,2902,5245,0,0,0,1.0,1,1.0,1,1.0,1,0.13694411403779178,65
3830,0,8147,2902,5245,0,0,0,1.0,1,1.0,1,1.0,1,0.14413423429839647,64
3831,4,8151,2904,5247,0,0,0,1.0,1,1.0,1,1.0,1,0.12317616209074297,63
3832,2,8153,2905,5248,0,0,0,1.0,1,1.0,1,1.0,1,0.14106868288334645,64
3833,3,8156,2907,5249,0,0,0,1.0,1,1.0,1,1.0,1,0.14674660898897693,64
3834,7,8163,2910,5253,0,0,0,1.0,1,1.0,1,1.0,1,0.17364123759290515,63
3835,4,8167,2912,5255,0,0,0,1.0,1,1.0,1,1.0,1,0.16212717774749308,63
3836,7,8174,2914,5260,0,0,0,1.0,1,1.0,1,1.0,1,0.14508548512679043,63
3837,6,8180,2916,5264,0,0,0,1.0,1,1.0,1,1.0,1,0.1469994024771543,62
3838,1,8181,2917,5264,0,0,0,1.0,1,1.0,1,1.0,1,0.1302032492815646,62
3839,1,8182,2918,5264,0,0,0,1.0,1,1.0,1,1.0,1,0.17980725796881836,60
3840,2,8184,2918,5266,0,0,0,1.0,1,1.0,1,1.0,1,0.17955291241366111,62
3841,4,8188,2919,5269,0,0,0,1.0,1,1.0,1,1.0,1,0.17366084582752378,62
3842,0,8188,2919,5269,0,0,0,1.0,1,1.0,1,1.0,1,0.1572994688764946,63
3843,1,8189,2919,5270,0,0,0,1.0,1,1.0,1,1.0,1,0.15814584283035174,64
3844,1,8190,2919,5271,0,0,0,1.0,1,1.0,1,1.0,1,0.14766588058278182,65
3845,5,8195,2919,5276,0,0,0,1.0,1,1.0,1,1.0,1,0.1376035658513266,66
3846,5,8200,2919,5281,0,0,0,1.0,1,1.0,1,1.0,1,0.11333421370310397,67
3847,0,8200,2919,5281,0,0,0,1.0,1,1.0,1,1.0,1,0.11333421370310397,67
3848,1,8201,2919,5282,0,0,0,1.0,1,1.0,1,1.0,1,0.10308990852894924,67
3849,3,8204,2919,5285,0,0,0,1.0,1,1.0,1,1.0,1,0.14001426551864377,67
3850,4,8208,2921,5287,0,0,0,1.0,1,1.0,1,1.0,1,0.1283056236621419,68
3851,5,8213,2921,5292,0,0,0,1.0,1,1.0,1,1.0,1,0.08226973423587171,68
3852,3,8216,2922,5294,0,0,0,1.0,1,1.0,1,1.0,1,0.09473361936313682,70
3853,8,8224,2925,5299,0,0,0,1.0,1,1.0,1,1.0,1,0.12970975549766223,70
3854,3,8227,2925,5302,0,0,0,1.0,1,1.0,1,1.0,1,0.16208244156034327,70
3855,1,8228,2925,5303,0,0,0,1.0,1,1.0,1,1.0,1,0.1586901651438729,69
3856,7,8235,2927,5308,0,0,0,1.0,1,1.0,1,1.0,1,0.13867353308445013,70
3857,0,8235,2927,5308,0,0,0,1.0,1,1.0,1,1.0,1,0.14589180343151345,68
3858,2,8237,2928,5309,0,0,0,1.0,1,1.0,1,1.0,1,0.15379183167391397,67
3859,1,8238,2928,5310,0,0,0,1.0,1,1.0,1,1.0,1,0.15694835262658768,66
3860,4,8242,2929,5313,0,0,0,1.0,1,1.0,1,1.0,1,0.16800413153022914,66
3861,4,8246,2930,5316,0,0,0,1.0,1,1.0,1,1.0,1,0.15825674204592652,66
3862,6,8252,2933,5319,0,0,0,1.0,1,1.0,1,1.0,1,0.1643819668728519,66
3863,1,8253,2933,5320,0,0,0,1.0,1,1.0,1,1.0,1,0.1410426604201759,63
3864,1,8254,2934,5320,0,0,0,1.0,1,1.0,1,1.0,1,0.14235866206997252,63
3865,0,8254,2934,5320,0,0,0,1.0,1,1.0,1,1.0,1,0.135600407667052,61
3866,2,8256,2935,5321,0,0,0,1.0,1,1.0,1,1.0,1,0.11054953184483565,61
3867,3,8259,2937,5322,0,0,0,1.0,1,1.0,1,1.0,1,0.11520794407688814,60
3868,1,8260,2938,5322,0,0,0,1.0,1,1.0,1,1.0,1,0.1405074799472607,59
3869,2,8262,2939,5323,0,0,0,1.0,1,1.0,1,1.0,1,0.13156032190074682,61
3870,4,8266,2939,5327,0,0,0,1.0,1,1.0,1,1.0,1,0.11274379612398269,61
3871,4,8270,2940,5330,0,0,0,1.0,1,1.0,1,1.0,1,0.10659634283844203,64
3872,1,8271,2941,5330,0,0,0,1.0,1,1.0,1,1.0,1,0.09522115279482221,63
3873,0,8271,2941,5330,0,0,0,1.0,1,1.0,1,1.0,1,0.09991402403484205,62
3874,1,8272,2942,5330,0,0,0,1.0,1,1.0,1,1.0,1,0.10303494028691842,63
3875,2,8274,2943,5331,0,0,0,1.0,1,1.0,1,1.0,1,0.1000254684690751,61
3876,4,8278,2943,5335,0,0,0,1.0,1,1.0,1,1.0,1,0.05664668000157878,62
3877,0,8278,2943,5335,0,0,0,1.0,1,1.0,1,1.0,1,0.07651955085435407,63
3878,0,8278,2943,5335,0,0,0,1.0,1,1.0,1,1.0,1,0.07651955085435407,63
3879,1,8279,2944,5335,0,0,0,1.0,1,1.0,1,1.0,1,0.08657574941521028,63
3880,4,8283,2946,5337,0,0,0,1.0,1,1.0,1,1.0,1,0.09909341173376089,65
3881,2,8285,2947,5338,0,0,0,1.0,1,1.0,1,1.0,1,0.11270373310397148,65
3882,0,8285,2947,5338,0,0,0,1.0,1,1.0,1,1.0,1,0.10736415282264616,66
3883,0,8285,2947,5338,0,0,0,1.0,1,1.0,1,1.0,1,0.10736415282264616,66
3884,0,8285,2947,5338,0,0,0,1.0,1,1.0,1,1.0,1,0.10736415282264616,66
3885,4,8289,2949,5340,0,0,0,1.0,1,1.0,1,1.0,1,0.1299230806233926,66
3886,6,8295,2951,5344,0,0,0,1.0,1,1.0,1,1.0,1,0.11679263664890704,65
3887,0,8295,2951,5344,0,0,0,1.0,1,1.0,1,1.0,1,0.09844968957429925,65
3888,1,8296,2952,5344,0,0,0,1.0,1,1.0,1,1.0,1,0.11736729796830035,66
3889,2,8298,2953,5345,0,0,0,1.0,1,1.0,1,1.0,1,0.12115684569423545,64
3890,1,8299,2954,5345,0,0,0,1.0,1,1.0,1,1.0,1,0.1172293629011482,63
3891,4,8303,2955,5348,0,0,0,1.0,1,1.0,1,1.0,1,0.1010285974382172,66
3892,5,8308,2955,5353,0,0,0,1.0,1,1.0,1,1.0,1,0.09108996690919301,67
3893,4,8312,2955,5357,0,0,0,1.0,1,1.0,1,1.0,1,0.09244835902217693,66
3894,4,8316,2955,5361,0,0,0,1.0,1,1.0,1,1.0,1,0.08758328889184823,67
3895,0,8316,2955,5361,0,0,0,1.0,1,1.0,1,1.0,1,0.09213835487068558,66
3896,2,8318,2956,5362,0,0,0,1.0,1,1.0,1,1.0,1,0.096625089442661,66
3897,0,8318,2956,5362,0,0,0,1.0,1,1.0,1,1.0,1,0.10142140739230714,65
3898,6,8324,2960,5364,0,0,0,1.0,1,1.0,1,1.0,1,0.12443027823034593,65
3899,3,8327,2962,5365,0,0,0,1.0,1,1.0,1,1.0,1,0.11543330436051796,64
3900,1,8328,2963,5365,0,0,0,1.0,1,1.0,1,1.0,1,0.14487533298003266,63
3901,5,8333,2965,5368,0,0,0,1.0,1,1.0,1,1.0,1,0.13354454973409235,63
3902,2,8335,2965,5370,0,0,0,1.0,1,1.0,1,1.0,1,0.14057696615103638,64
3903,2,8337,2965,5372,0,0,0,1.0,1,1.0,1,1.0,1,0.12560931204043532,64
3904,0,8337,2965,5372,0,0,0,1.0,1,1.0,1,1.0,1,0.13713850064381436,63
3905,0,8337,2965,5372,0,0,0,1.0,1,1.0,1,1.0,1,0.16318050806999285,63
3906,4,8341,2967,5374,0,0,0,1.0,1,1.0,1,1.0,1,0.12864111959225102,64
3907,1,8342,2968,5374,0,0,0,1.0,1,1.0,1,1.0,1,0.14347263698358695,64
3908,0,8342,2968,5374,0,0,0,1.0,1,1.0,1,1.0,1,0.14437694200661774,63
3909,1,8343,2969,5374,0,0,0,1.0,1,1.0,1,1.0,1,0.1740038522861038,62
3910,2,8345,2969,5376,0,0,0,1.0,1,1.0,1,1.0,1,0.15029562674293848,62
3911,7,8352,2972,5380,0,0,0,1.0,1,1.0,1,1.0,1,0.1613370423415039,64
3912,5,8357,2973,5384,0,0,0,1.0,1,1.0,1,1.0,1,0.1519739011577961,64
3913,3,8360,2973,5387,0,0,0,1.0,1,1.0,1,1.0,1,0.15693626326236787,65
3914,4,8364,2973,5391,0,0,0,1.0,1,1.0,1,1.0,1,0.1749695316332403,65
3915,5,8369,2973,5396,0,0,0,1.0,1,1.0,1,1.0,1,0.1747671421813642,66
3916,4,8373,2973,5400,0,0,0,1.0,1,1.0,1,1.0,1,0.11476056496659143,66
3917,1,8374,2973,5401,0,0,0,1.0,1,1.0,1,1.0,1,0.10222109545087496,66
3918,3,8377,2973,5404,0,0,0,1.0,1,1.0,1,1.0,1,0.08216735735681792,67
3919,1,8378,2974,5404,0,0,0,1.0,1,1.0,1,1.0,1,0.08884508399863211,68
3920,1,8379,2974,5405,0,0,0,1.0,1,1.0,1,1.0,1,0.07354708402142646,69
3921,1,8380,2975,5405,0,0,0,1.0,1,1.0,1,1.0,1,0.08796245520523777,68
3922,3,8383,2978,5405,0,0,0,1.0,1,1.0,1,1.0,1,0.11907123218618755,68
3923,0,8383,2978,5405,0,0,0,1.0,1,1.0,1,1.0,1,0.12860702770739635,69
3924,0,8383,2978,5405,0,0,0,1.0,1,1.0,1,1.0,1,0.14013090738579195,69
3925,2,8385,2980,5405,0,0,0,1.0,1,1.0,1,1.0,1,0.1478062655721243,67
3926,4,8389,2981,5408,0,0,0,1.0,1,1.0,1,1.0,1,0.1347462732692125,67
3927,2,8391,2981,5410,0,0,0,1.0,1,1.0,1,1.0,1,0.12981029108410502,65
3928,2,8393,2981,5412,0,0,0,1.0,1,1.0,1,1.0,1,0.12929559650134018,65
3929,2,8395,2982,5413,0,0,0,1.0,1,1.0,1,1.0,1,0.132133126462464,64
3930,0,8395,2982,5413,0,0,0,1.0,1,1.0,1,1.0,1,0.14758170648688668,64
3931,3,8398,2982,5416,0,0,0,1.0,1,1.0,1,1.0,1,0.12616972746750138,62
3932,1,8399,2982,5417,0,0,0,1.0,1,1.0,1,1.0,1,0.11048217082211548,62
3933,0,8399,2982,5417,0,0,0,1.0,1,1.0,1,1.0,1,0.11048217082211548,62
3934,1,8400,2983,5417,0,0,0,1.0,1,1.0,1,1.0,1,0.10409507733151177,61
3935,1,8401,2984,5417,0,0,0,1.0,1,1.0,1,1.0,1,0.12562438642135831,64
3936,3,8404,2985,5419,0,0,0,1.0,1,1.0,1,1.0,1,0.14645542954369528,65
3937,1,8405,2986,5419,0,0,0,1.0,1,1.0,1,1.0,1,0.16936364722143715,66
3938,0,8405,2986,5419,0,0,0,1.0,1,1.0,1,1.0,1,0.16936364722143715,66
3939,1,8406,2986,5420,0,0,0,1.0,1,1.0,1,1.0,1,0.16214458743311172,67
3940,3,8409,2987,5422,0,0,0,1.0,1,1.0,1,1.0,1,0.16150247849066748,69
3941,5,8414,2987,5427,0,0,0,1.0,1,1.0,1,1.0,1,0.08800998900337788,69
3942,2,8416,2988,5428,0,0,0,1.0,1,1.0,1,1.0,1,0.09616880189130454,69
3943,2,8418,2990,5428,0,0,0,1.0,1,1.0,1,1.0,1,0.10378016520456264,68
3944,0,8418,2990,5428,0,0,0,1.0,1,1.0,1,1.0,1,0.10968521792151632,68
3945,6,8424,2995,5429,0,0,0,1.0,1,1.0,1,1.0,1,0.18200984685385782,67
3946,6,8430,2997,5433,0,0,0,1.0,1,1.0,1,1.0,1,0.1299568298203634,67
3947,0,8430,2997,5433,0,0,0,1.0,1,1.0,1,1.0,1,0.1365724355977795,66
3948,1,8431,2998,5433,0,0,0,1.0,1,1.0,1,1.0,1,0.13997853162113774,67
3949,5,8436,3001,5435,0,0,0,1.0,1,1.0,1,1.0,1,0.21157537676023425,66
3950,3,8439,3001,5438,0,0,0,1.0,1,1.0,1,1.0,1,0.21989399505497106,65
3951,8,8447,3001,5446,0,0,0,1.0,1,1.0,1,1.0,1,0.14767706814472517,65
3952,3,8450,3002,5448,0,0,0,1.0,1,1.0,1,1.0,1,0.143921143359104,65
3953,2,8452,3002,5450,0,0,0,1.0,1,1.0,1,1.0,1,0.14853627351035129,65
3954,1,8453,3002,5451,0,0,0,1.0,1,1.0,1,1.0,1,0.15900972418932804,64
3955,0,8453,3002,5451,0,0,0,1.0,1,1.0,1,1.0,1,0.18148675509616327,64
3956,5,8458,3003,5455,0,0,0,1.0,1,1.0,1,1.0,1,0.1640913578823232,63
3957,2,8460,3003,5457,0,0,0,1.0,1,1.0,1,1.0,1,0.1595704207673813,63
3958,2,8462,3004,5458,0,0,0,1.0,1,1.0,1,1.0,1,0.180730846739779,63
3959,0,8462,3004,5458,0,0,0,1.0,1,1.0,1,1.0,1,0.18361244772015345,62
3960,1,8463,3004,5459,0,0,0,1.0,1,1.0,1,1.0,1,0.1840332750144164,62
3961,5,8468,3005,5463,0,0,0,1.0,1,1.0,1,1.0,1,0.13078286280536774,64
3962,2,8470,3007,5463,0,0,0,1.0,1,1.0,1,1.0,1,0.15362314513363187,64
3963,5,8475,3008,5467,0,0,0,1.0,1,1.0,1,1.0,1,0.15853454121359561,62
3964,3,8478,3010,5468,0,0,0,1.0,1,1.0,1,1.0,1,0.19174767179991725,63
3965,5,8483,3010,5473,0,0,0,1.0,1,1.0,1,1.0,1,0.18279035099134747,63
3966,6,8489,3011,5478,0,0,0,1.0,1,1.0,1,1.0,1,0.16158036030335612,62
3967,1,8490,3011,5479,0,0,0,1.0,1,1.0,1,1.0,1,0.16955280384415347,64
3968,5,8495,3012,5483,0,0,0,1.0,1,1.0,1,1.0,1,0.13957716961247207,63
3969,0,8495,3012,5483,0,0,0,1.0,1,1.0,1,1.0,1,0.15614799754184963,63
3970,0,8495,3012,5483,0,0,0,1.0,1,1.0,1,1.0,1,0.1523850807664623,65
3971,3,8498,3012,5486,0,0,0,1.0,1,1.0,1,1.0,1,0.11847590031469099,65
3972,5,8503,3014,5489,0,0,0,1.0,1,1.0,1,1.0,1,0.12029173983212063,66
3973,1,8504,3014,5490,0,0,0,1.0,1,1.0,1,1.0,1,0.1104157971845774,66
3974,1,8505,3015,5490,0,0,0,1.0,1,1.0,1,1.0,1,0.1287373174395634,66
3975,1,8506,3016,5490,0,0,0,1.0,1,1.0,1,1.0,1,0.12358786433036585,66
3976,4,8510,3017,5493,0,0,0,1.0,1,1.0,1,1.0,1,0.12065806502066365,66
3977,0,8510,3017,5493,0,0,0,1.0,1,1.0,1,1.0,1,0.12210372201945172,64
3978,1,8511,3018,5493,0,0,0,1.0,1,1.0,1,1.0,1,0.1510469516599492,63
3979,4,8515,3019,5496,0,0,0,1.0,1,1.0,1,1.0,1,0.1616640305875548,63
3980,1,8516,3019,5497,0,0,0,1.0,1,1.0,1,1.0,1,0.14237849157104923,63
3981,4,8520,3020,5500,0,0,0,1.0,1,1.0,1,1.0,1,0.13403845008509332,64
3982,2,8522,3021,5501,0,0,0,1.0,1,1.0,1,1.0,1,0.14840921198383816,65
3983,0,8522,3021,5501,0,0,0,1.0,1,1.0,1,1.0,1,0.13391955878257458,64
3984,2,8524,3022,5502,0,0,0,1.0,1,1.0,1,1.0,1,0.1328556659321084,65
3985,3,8527,3024,5503,0,0,0,1.0,1,1.0,1,1.0,1,0.1274058387170833,64
3986,3,8530,3024,5506,0,0,0,1.0,1,1.0,1,1.0,1,0.11777674932533065,63
3987,2,8532,3025,5507,0,0,0,1.0,1,1.0,1,1.0,1,0.12806170063419844,63
3988,4,8536,3027,5509,0,0,0,1.0,1,1.0,1,1.0,1,0.11550892649891391,63
3989,4,8540,3029,5511,0,0,0,1.0,1,1.0,1,1.0,1,0.12809355436146824,63
3990,0,8540,3029,5511,0,0,0,1.0,1,1.0,1,1.0,1,0.1406397113514414,62
3991,4,8544,3029,5515,0,0,0,1.0,1,1.0,1,1.0,1,0.10601726679497765,62
3992,1,8545,3029,5516,0,0,0,1.0,1,1.0,1,1.0,1,0.09633405825653774,65
3993,0,8545,3029,5516,0,0,0,1.0,1,1.0,1,1.0,1,0.09633405825653774,65
3994,0,8545,3029,5516,0,0,0,1.0,1,1.0,1,1.0,1,0.10373583125273547,64
3995,0,8545,3029,5516,0,0,0,1.0,1,1.0,1,1.0,1,0.10373583125273547,64
3996,3,8548,3029,5519,0,0,0,1.0,1,1.0,1,1.0,1,0.0810963485823444,67
3997,0,8548,3029,5519,0,0,0,1.0,1,1.0,1,1.0,1,0.09064048312549712,69
3998,3,8551,3030,5521,0,0,0,1.0,1,1.0,1,1.0,1,0.09933508157996963,69
3999,1,8552,3030,5522,0,0,0,1.0,1,1.0,1,1.0,1,0.09058519159195902,69
4000,1,8553,3030,5523,0,0,0,1.0,1,1.0,1,1.0,1,0.10899260145851072,69
4001,4,8557,3030,5527,0,0,0,1.0,1,1.0,1,1.0,1,0.07123655641389874,68
4002,2,8559,3032,5527,0,0,0,1.0,1,1.0,1,1.0,1,0.08736555793291265,68
4003,3,8562,3033,5529,0,0,0,1.0,1,1.0,1,1.0,1,0.11511709934468253,68
4004,3,8565,3035,5530,0,0,0,1.0,1,1.0,1,1.0,1,0.12861626168450477,67
4005,0,8565,3035,5530,0,0,0,1.0,1,1.0,1,1.0,1,0.12861626168450477,67
4006,5,8570,3037,5533,0,0,0,1.0,1,1.0,1,1.0,1,0.11315803624592106,67
4007,2,8572,3037,5535,0,0,0,1.0,1,1.0,1,1.0,1,0.09492191324239302,67
4008,1,8573,3037,5536,0,0,0,1.0,1,1.0,1,1.0,1,0.09594789555136174,67
4009,0,8573,3037,5536,0,0,0,1.0,1,1.0,1,1.0,1,0.09594789555136174,67
4010,2,8575,3039,5536,0,0,0,1.0,1,1.0,1,1.0,1,0.1319281124255912,66
4011,3,8578,3041,5537,0,0,0,1.0,1,1.0,1,1.0,1,0.1323802749566378,66
4012,2,8580,3043,5537,0,0,0,1.0,1,1.0,1,1.0,1,0.15522939405977842,66
4013,1,8581,3043,5538,0,0,0,1.0,1,1.0,1,1.0,1,0.13258606260425063,66
4014,2,8583,3044,5539,0,0,0,1.0,1,1.0,1,1.0,1,0.1450595041495996,66
4015,0,8583,3044,5539,0,0,0,1.0,1,1.0,1,1.0,1,0.16465049718708694,64
4016,2,8585,3045,5540,0,0,0,1.0,1,1.0,1,1.0,1,0.2043743810625916,64
4017,3,8588,3045,5543,0,0,0,1.0,1,1.0,1,1.0,1,0.16911778134426475,66
4018,2,8590,3045,5545,0,0,0,1.0,1,1.0,1,1.0,1,0.17709459025188123,67
4019,4,8594,3046,5548,0,0,0,1.0,1,1.0,1,1.0,1,0.17581777936434265,67
4020,2,8596,3046,5550,0,0,0,1.0,1,1.0,1,1.0,1,0.19140154645929486,66
4021,5,8601,3048,5553,0,0,0,1.0,1,1.0,1,1.0,1,0.1846713396038792,66
4022,0,8601,3048,5553,0,0,0,1.0,1,1.0,1,1.0,1,0.1846713396038792,66
4023,2,8603,3050,5553,0,0,0,1.0,1,1.0,1,1.0,1,0.18751359011543964,66
4024,0,8603,3050,5553,0,0,0,1.0,1,1.0,1,1.0,1,0.1960475936016726,66
4025,1,8604,3050,5554,0,0,0,1.0,1,1.0,1,1.0,1,0.1798231500208707,66
4026,6,8610,3051,5559,0,0,0,1.0,1,1.0,1,1.0,1,0.1621693187061273,66
4027,1,8611,3052,5559,0,0,0,1.0,1,1.0,1,1.0,1,0.15386007826907974,64
4028,4,8615,3054,5561,0,0,0,1.0,1,1.0,1,1.0,1,0.15806743724783923,63
4029,1,8616,3055,5561,0,0,0,1.0,1,1.0,1,1.0,1,0.1479359221999502,62
4030,4,8620,3057,5563,0,0,0,1.0,1,1.0,1,1.0,1,0.1687932503340927,63
4031,6,8626,3058,5568,0,0,0,1.0,1,1.0,1,1.0,1,0.14119254065686046,62
4032,3,8629,3061,5568,0,0,0,1.0,1,1.0,1,1.0,1,0.18583667086855268,62
4033,3,8632,3062,5570,0,0,0,1.0,1,1.0,1,1.0,1,0.17194178650229827,61
4034,2,8634,3063,5571,0,0,0,1.0,1,1.0,1,1.0,1,0.15742031108536486,60
4035,1,8635,3064,5571,0,0,0,1.0,1,1.0,1,1.0,1,0.16806034022039537,59
4036,3,8638,3065,5573,0,0,0,1.0,1,1.0,1,1.0,1,0.13600397987613771,58
4037,1,8639,3066,5573,0,0,0,1.0,1,1.0,1,1.0,1,0.13503387233846204,59
4038,1,8640,3066,5574,0,0,0,1.0,1,1.0,1,1.0,1,0.1326591880550056,58
4039,2,8642,3068,5574,0,0,0,1.0,1,1.0,1,1.0,1,0.166438285088287,56
4040,0,8642,3068,5574,0,0,0,1.0,1,1.0,1,1.0,1,0.1828654070353469,55
4041,2,8644,3069,5575,0,0,0,1.0,1,1.0,1,1.0,1,0.20427297431619573,54
4042,4,8648,3071,5577,0,0,0,1.0,1,1.0,1,1.0,1,0.22854143547190103,56
4043,7,8655,3074,5581,0,0,0,1.0,1,1.0,1,1.0,1,0.30893730743578807,56
4044,8,8663,3074,5589,0,0,0,1.0,1,1.0,1,1.0,1,0.28021716069358205,56
4045,8,8671,3076,5595,0,0,0,1.0,1,1.0,1,1.0,1,0.2846009962141387,57
4046,6,8677,3076,5601,0,0,0,1.0,1,1.0,1,1.0,1,0.26219994455680046,59
4047,1,8678,3076,5602,0,0,0,1.0,1,1.0,1,1.0,1,0.253609100503031,59
4048,0,8678,3076,5602,0,0,0,1.0,1,1.0,1,1.0,1,0.253609100503031,59
4049,2,8680,3076,5604,0,0,0,1.0,1,1.0,1,1.0,1,0.24155677630315586,60
4050,4,8684,3076,5608,0,0,0,1.0,1,1.0,1,1.0,1,0.21937749415844898,60
4051,1,8685,3076,5609,0,0,0,1.0,1,1.0,1,1.0,1,0.2093255201260387,60
4052,0,8685,3076,5609,0,0,0,1.0,1,1.0,1,1.0,1,0.2093255201260387,60
4053,0,8685,3076,5609,0,0,0,1.0,1,1.0,1,1.0,1,0.2093255201260387,60
4054,0,8685,3076,5609,0,0,0,1.0,1,1.0,1,1.0,1,0.1979092776110099,61
4055,0,8685,3076,5609,0,0,0,1.0,1,1.0,1,1.0,1,0.1979092776110099,61
4056,1,8686,3076,5610,0,0,0,1.0,1,1.0,1,1.0,1,0.20135869604240994,62
4057,0,8686,3076,5610,0,0,0,1.0,1,1.0,1,1.0,1,0.20161114242295144,63
4058,1,8687,3076,5611,0,0,0,1.0,1,1.0,1,1.0,1,0.2186897057497593,64
4059,0,8687,3076,5611,0,0,0,1.0,1,1.0,1,1.0,1,0.23417020800991398,63
4060,0,8687,3076,5611,0,0,0,1.0,1,1.0,1,1.0,1,0.23417020800991398,63
4061,1,8688,3076,5612,0,0,0,1.0,1,1.0,1,1.0,1,0.23532073860221459,63
4062,2,8690,3077,5613,0,0,0,1.0,1,1.0,1,1.0,1,0.23132043397742685,65
4063,1,8691,3077,5614,0,0,0,1.0,1,1.0,1,1.0,1,0.19275830077255643,64
4064,3,8694,3079,5615,0,0,0,1.0,1,1.0,1,1.0,1,0.20419677877469636,65
4065,5,8699,3080,5619,0,0,0,1.0,1,1.0,1,1.0,1,0.16985708763718171,64
4066,4,8703,3081,5622,0,0,0,1.0,1,1.0,1,1.0,1,0.12785569161325028,64
4067,4,8707,3082,5625,0,0,0,1.0,1,1.0,1,1.0,1,0.13112135806076386,63
4068,2,8709,3082,5627,0,0,0,1.0,1,1.0,1,1.0,1,0.12425718157627151,64
4069,7,8716,3087,5629,0,0,0,1.0,1,1.0,1,1.0,1,0.20052311830175326,62
4070,2,8718,3088,5630,0,0,0,1.0,1,1.0,1,1.0,1,0.1923290778482243,61
4071,6,8724,3090,5634,0,0,0,1.0,1,1.0,1,1.0,1,0.17623725335819934,61
4072,7,8731,3094,5637,0,0,0,1.0,1,1.0,1,1.0,1,0.19882134514671418,60
4073,2,8733,3095,5638,0,0,0,1.0,1,1.0,1,1.0,1,0.17714375896608425,60
4074,3,8736,3098,5638,0,0,0,1.0,1,1.0,1,1.0,1,0.1811090007349217,60
4075,2,8738,3098,5640,0,0,0,1.0,1,1.0,1,1.0,1,0.16928520887711065,59
4076,3,8741,3099,5642,0,0,0,1.0,1,1.0,1,1.0,1,0.15255690149111473,60
4077,1,8742,3099,5643,0,0,0,1.0,1,1.0,1,1.0,1,0.16303721119392206,61
4078,0,8742,3099,5643,0,0,0,1.0,1,1.0,1,1.0,1,0.17284000802686356,60
4079,2,8744,3100,5644,0,0,0,1.0,1,1.0,1,1.0,1,0.19674098594983871,58
4080,2,8746,3101,5645,0,0,0,1.0,1,1.0,1,1.0,1,0.20453352633110072,56
4081,2,8748,3101,5647,0,0,0,1.0,1,1.0,1,1.0,1,0.1828833093448662,56
4082,0,8748,3101,5647,0,0,0,1.0,1,1.0,1,1.0,1,0.19914539491402392,55
4083,1,8749,3102,5647,0,0,0,1.0,1,1.0,1,1.0,1,0.21548478245008654,55
4084,1,8750,3103,5647,0,0,0,1.0,1,1.0,1,1.0,1,0.23330508387455476,55
4085,5,8755,3105,5650,0,0,0,1.0,1,1.0,1,1.0,1,0.21633936529062903,56
4086,3,8758,3106,5652,0,0,0,1.0,1,1.0,1,1.0,1,0.18645965667155387,57
4087,4,8762,3107,5655,0,0,0,1.0,1,1.0,1,1.0,1,0.18462410742614843,57
4088,2,8764,3107,5657,0,0,0,1.0,1,1.0,1,1.0,1,0.16415863335813588,57
4089,0,8764,3107,5657,0,0,0,1.0,1,1.0,1,1.0,1,0.19501803735255316,56
4090,1,8765,3108,5657,0,0,0,1.0,1,1.0,1,1.0,1,0.19724548561166697,56
4091,4,8769,3108,5661,0,0,0,1.0,1,1.0,1,1.0,1,0.1768895511192851,56
4092,2,8771,3108,5663,0,0,0,1.0,1,1.0,1,1.0,1,0.1706036130507711,57
4093,5,8776,3109,5667,0,0,0,1.0,1,1.0,1,1.0,1,0.13901999236419413,58
4094,3,8779,3110,5669,0,0,0,1.0,1,1.0,1,1.0,1,0.13171333558704373,57
4095,0,8779,3110,5669,0,0,0,1.0,1,1.0,1,1.0,1,0.13171333558704373,57
4096,1,8780,3111,5669,0,0,0,1.0,1,1.0,1,1.0,1,0.1290928783950711,59
4097,2,8782,3112,5670,0,0,0,1.0,1,1.0,1,1.0,1,0.12302637420771056,59
4098,1,8783,3113,5670,0,0,0,1.0,1,1.0,1,1.0,1,0.1384144086336613,59
4099,3,8786,3114,5672,0,0,0,1.0,1,1.0,1,1.0,1,0.1607653908738191,60
4100,3,8789,3114,5675,0,0,0,1.0,1,1.0,1,1.0,1,0.1484270257511023,60
4101,6,8795,3116,5679,0,0,0,1.0,1,1.0,1,1.0,1,0.11044001647151162,60
4102,6,8801,3121,5680,0,0,0,1.0,1,1.0,1,1.0,1,0.11837378208235884,60
4103,2,8803,3122,5681,0,0,0,1.0,1,1.0,1,1.0,1,0.13494583781849487,58
4104,3,8806,3124,5682,0,0,0,1.0,1,1.0,1,1.0,1,0.12122294659383605,60
4105,3,8809,3125,5684,0,0,0,1.0,1,1.0,1,1.0,1,0.1245994549119276,59
4106,6,8815,3126,5689,0,0,0,1.0,1,1.0,1,1.0,1,0.11461736891278052,61
4107,1,8816,3126,5690,0,0,0,1.0,1,1.0,1,1.0,1,0.10942700537899352,59
4108,0,8816,3126,5690,0,0,0,1.0,1,1.0,1,1.0,1,0.10427337003507167,60
4109,0,8816,3126,5690,0,0,0,1.0,1,1.0,1,1.0,1,0.10867828808703771,59
4110,2,8818,3127,5691,0,0,0,1.0,1,1.0,1,1.0,1,0.0825334276859402,60
4111,4,8822,3127,5695,0,0,0,1.0,1,1.0,1,1.0,1,0.06358604998080628,61
4112,0,8822,3127,5695,0,0,0,1.0,1,1.0,1,1.0,1,0.06843959866817975,60
4113,1,8823,3127,5696,0,0,0,1.0,1,1.0,1,1.0,1,0.04762193904088348,61
4114,0,8823,3127,5696,0,0,0,1.0,1,1.0,1,1.0,1,0.06959299901176094,62
4115,3,8826,3130,5696,0,0,0,1.0,1,1.0,1,1.0,1,0.10030224460432265,60
4116,2,8828,3130,5698,0,0,0,1.0,1,1.0,1,1.0,1,0.05360112757777102,59
4117,3,8831,3133,5698,0,0,0,1.0,1,1.0,1,1.0,1,0.0866815295687366,56
4118,1,8832,3134,5698,0,0,0,1.0,1,1.0,1,1.0,1,0.09979101222428649,55
4119,3,8835,3135,5700,0,0,0,1.0,1,1.0,1,1.0,1,0.09931995192291818,53
4120,1,8836,3136,5700,0,0,0,1.0,1,1.0,1,1.0,1,0.10792931191161828,52
4121,7,8843,3140,5703,0,0,0,1.0,1,1.0,1,1.0,1,0.09816807591416205,53
4122,1,8844,3141,5703,0,0,0,1.0,1,1.0,1,1.0,1,0.0823486132996357,52
4123,3,8847,3144,5703,0,0,0,1.0,1,1.0,1,1.0,1,0.08998592480270512,51
4124,1,8848,3145,5703,0,0,0,1.0,1,1.0,1,1.0,1,0.13186876155439714,51
4125,2,8850,3146,5704,0,0,0,1.0,1,1.0,1,1.0,1,0.13570955117104883,50
4126,5,8855,3148,5707,0,0,0,1.0,1,1.0,1,1.0,1,0.10804760128751037,50
4127,0,8855,3148,5707,0,0,0,1.0,1,1.0,1,1.0,1,0.09831498696614492,49
4128,0,8855,3148,5707,0,0,0,1.0,1,1.0,1,1.0,1,0.09831498696614492,49
4129,0,8855,3148,5707,0,0,0,1.0,1,1.0,1,1.0,1,0.09831498696614492,49
4130,1,8856,3149,5707,0,0,0,1.0,1,1.0,1,1.0,1,0.11019630302701737,50
4131,4,8860,3150,5710,0,0,0,1.0,1,1.0,1,1.0,1,0.08737994917880196,50
4132,0,8860,3150,5710,0,0,0,1.0,1,1.0,1,1.0,1,0.08737994917880196,50
4133,0,8860,3150,5710,0,0,0,1.0,1,1.0,1,1.0,1,0.09985660328011602,51
4134,3,8863,3151,5712,0,0,0,1.0,1,1.0,1,1.0,1,0.08578113516913685,53
4135,1,8864,3151,5713,0,0,0,1.0,1,1.0,1,1.0,1,0.0926723732260316,54
4136,1,8865,3151,5714,0,0,0,1.0,1,1.0,1,1.0,1,0.06981582406105019,54
4137,2,8867,3153,5714,0,0,0,1.0,1,1.0,1,1.0,1,0.10358862464976738,55
4138,0,8867,3153,5714,0,0,0,1.0,1,1.0,1,1.0,1,0.1098299811859905,54
4139,0,8867,3153,5714,0,0,0,1.0,1,1.0,1,1.0,1,0.1098299811859905,54
4140,2,8869,3154,5715,0,0,0,1.0,1,1.0,1,1.0,1,0.12924209492529626,55
4141,1,8870,3154,5716,0,0,0,1.0,1,1.0,1,1.0,1,0.1310019672906576,55
4142,0,8870,3154,5716,0,0,0,1.0,1,1.0,1,1.0,1,0.1310019672906576,55
4143,0,8870,3154,5716,0,0,0,1.0,1,1.0,1,1.0,1,0.162554449324566,53
4144,5,8875,3158,5717,0,0,0,1.0,1,1.0,1,1.0,1,0.18081912097564876,52
4145,3,8878,3160,5718,0,0,0,1.0,1,1.0,1,1.0,1,0.18806771322586893,51
4146,6,8884,3161,5723,0,0,0,1.0,1,1.0,1,1.0,1,0.1378299451568704,51
4147,5,8889,3163,5726,0,0,0,1.0,1,1.0,1,1.0,1,0.1735379760873176,50
4148,4,8893,3163,5730,0,0,0,1.0,1,1.0,1,1.0,1,0.17087673668511982,52
4149,1,8894,3163,5731,0,0,0,1.0,1,1.0,1,1.0,1,0.15490296860764358,53
4150,4,8898,3165,5733,0,0,0,1.0,1,1.0,1,1.0,1,0.1653959704003802,53
4151,4,8902,3165,5737,0,0,0,1.0,1,1.0,1,1.0,1,0.11807046616203698,53
4152,4,8906,3168,5738,0,0,0,1.0,1,1.0,1,1.0,1,0.11426524155923644,54
4153,0,8906,3168,5738,0,0,0,1.0,1,1.0,1,1.0,1,0.1277127396614293,51
4154,1,8907,3168,5739,0,0,0,1.0,1,1.0,1,1.0,1,0.12527101738376814,51
4155,2,8909,3170,5739,0,0,0,1.0,1,1.0,1,1.0,1,0.14347250509642273,51
4156,4,8913,3172,5741,0,0,0,1.0,1,1.0,1,1.0,1,0.16908151541345529,52
4157,3,8916,3174,5742,0,0,0,1.0,1,1.0,1,1.0,1,0.15929341570184538,52
4158,2,8918,3174,5744,0,0,0,1.0,1,1.0,1,1.0,1,0.17530328322028835,52
4159,1,8919,3175,5744,0,0,0,1.0,1,1.0,1,1.0,1,0.1651734304227876,52
4160,1,8920,3176,5744,0,0,0,1.0,1,1.0,1,1.0,1,0.19467499884237183,50
4161,2,8922,3176,5746,0,0,0,1.0,1,1.0,1,1.0,1,0.14361137145224107,50
4162,0,8922,3176,5746,0,0,0,1.0,1,1.0,1,1.0,1,0.1407619984916325,51
4163,0,8922,3176,5746,0,0,0,1.0,1,1.0,1,1.0,1,0.1824833708586424,48
4164,2,8924,3178,5746,0,0,0,1.0,1,1.0,1,1.0,1,0.23533318082574795,50
4165,1,8925,3178,5747,0,0,0,1.0,1,1.0,1,1.0,1,0.2233204522924946,49
4166,7,8932,3179,5753,0,0,0,1.0,1,1.0,1,1.0,1,0.14454462070264504,50
4167,1,8933,3179,5754,0,0,0,1.0,1,1.0,1,1.0,1,0.16721867443606928,50
4168,2,8935,3179,5756,0,0,0,1.0,1,1.0,1,1.0,1,0.16981098920404247,50
4169,2,8937,3180,5757,0,0,0,1.0,1,1.0,1,1.0,1,0.1671840791830521,51
4170,0,8937,3180,5757,0,0,0,1.0,1,1.0,1,1.0,1,0.17983331848319667,50
4171,3,8940,3182,5758,0,0,0,1.0,1,1.0,1,1.0,1,0.1898669038686355,50
4172,2,8942,3183,5759,0,0,0,1.0,1,1.0,1,1.0,1,0.22939966008231835,49
4173,2,8944,3184,5760,0,0,0,1.0,1,1.0,1,1.0,1,0.24681853175222593,48
4174,2,8946,3185,5761,0,0,0,1.0,1,1.0,1,1.0,1,0.25626418215949603,48
4175,4,8950,3185,5765,0,0,0,1.0,1,1.0,1,1.0,1,0.20616887412006552,48
4176,4,8954,3185,5769,0,0,0,1.0,1,1.0,1,1.0,1,0.17246881762363994,50
4177,2,8956,3185,5771,0,0,0,1.0,1,1.0,1,1.0,1,0.15994406283008594,52
4178,1,8957,3185,5772,0,0,0,1.0,1,1.0,1,1.0,1,0.14493662104232863,53
4179,0,8957,3185,5772,0,0,0,1.0,1,1.0,1,1.0,1,0.14689472452570682,54
4180,2,8959,3185,5774,0,0,0,1.0,1,1.0,1,1.0,1,0.15946788030256798,55
4181,3,8962,3185,5777,0,0,0,1.0,1,1.0,1,1.0,1,0.12456095586209304,56
4182,0,8962,3185,5777,0,0,0,1.0,1,1.0,1,1.0,1,0.12456095586209304,56
4183,3,8965,3187,5778,0,0,0,1.0,1,1.0,1,1.0,1,0.12541726035366826,57
4184,3,8968,3190,5778,0,0,0,1.0,1,1.0,1,1.0,1,0.1471047110869742,57
4185,1,8969,3190,5779,0,0,0,1.0,1,1.0,1,1.0,1,0.13394808608959682,54
4186,4,8973,3192,5781,0,0,0,1.0,1,1.0,1,1.0,1,0.10824542528695218,55
4187,2,8975,3193,5782,0,0,0,1.0,1,1.0,1,1.0,1,0.10110705114761252,53
4188,2,8977,3194,5783,0,0,0,1.0,1,1.0,1,1.0,1,0.09945681397511645,53
4189,1,8978,3194,5784,0,0,0,1.0,1,1.0,1,1.0,1,0.09530375239819322,53
4190,2,8980,3196,5784,0,0,0,1.0,1,1.0,1,1.0,1,0.09523428661293915,53
4191,1,8981,3196,5785,0,0,0,1.0,1,1.0,1,1.0,1,0.08243990522368155,51
4192,1,8982,3197,5785,0,0,0,1.0,1,1.0,1,1.0,1,0.11071057544697026,51
4193,3,8985,3200,5785,0,0,0,1.0,1,1.0,1,1.0,1,0.1559373986270612,50
4194,2,8987,3201,5786,0,0,0,1.0,1,1.0,1,1.0,1,0.15346652672380864,50
4195,1,8988,3201,5787,0,0,0,1.0,1,1.0,1,1.0,1,0.1510818821221372,50
4196,5,8993,3202,5791,0,0,0,1.0,1,1.0,1,1.0,1,0.16123339182848334,51
4197,4,8997,3203,5794,0,0,0,1.0,1,1.0,1,1.0,1,0.16998649272000732,50
4198,2,8999,3204,5795,0,0,0,1.0,1,1.0,1,1.0,1,0.1562954476411172,48
4199,5,9004,3204,5800,0,0,0,1.0,1,1.0,1,1.0,1,0.15732328692991365,48
4200,3,9007,3204,5803,0,0,0,1.0,1,1.0,1,1.0,1,0.1740454475774135,48
4201,0,9007,3204,5803,0,0,0,1.0,1,1.0,1,1.0,1,0.18812408798411082,47
4202,1,9008,3205,5803,0,0,0,1.0,1,1.0,1,1.0,1,0.20686312071964855,47
4203,1,9009,3206,5803,0,0,0,1.0,1,1.0,1,1.0,1,0.24354690701946005,47
4204,4,9013,3207,5806,0,0,0,1.0,1,1.0,1,1.0,1,0.22289953989777062,48
4205,1,9014,3207,5807,0,0,0,1.0,1,1.0,1,1.0,1,0.20943196014232227,49
4206,1,9015,3207,5808,0,0,0,1.0,1,1.0,1,1.0,1,0.20190324530880543,49
4207,0,9015,3207,5808,0,0,0,1.0,1,1.0,1,1.0,1,0.20771629355010723,48
4208,2,9017,3209,5808,0,0,0,1.0,1,1.0,1,1.0,1,0.22004112129265174,49
4209,3,9020,3210,5810,0,0,0,1.0,1,1.0,1,1.0,1,0.2066245398987975,51
4210,1,9021,3210,5811,0,0,0,1.0,1,1.0,1,1.0,1,0.204171477720905,52
4211,3,9024,3210,5814,0,0,0,1.0,1,1.0,1,1.0,1,0.1939436564828615,53
4212,2,9026,3211,5815,0,0,0,1.0,1,1.0,1,1.0,1,0.2078076352706673,53
4213,2,9028,3211,5817,0,0,0,1.0,1,1.0,1,1.0,1,0.1940685234045749,54
4214,5,9033,3212,5821,0,0,0,1.0,1,1.0,1,1.0,1,0.20619425201638664,54
4215,4,9037,3213,5824,0,0,0,1.0,1,1.0,1,1.0,1,0.20412568196739972,54
4216,4,9041,3213,5828,0,0,0,1.0,1,1.0,1,1.0,1,0.18969337978425846,53
4217,5,9046,3215,5831,0,0,0,1.0,1,1.0,1,1.0,1,0.24116405114369585,54
4218,2,9048,3215,5833,0,0,0,1.0,1,1.0,1,1.0,1,0.2551387693773376,53
4219,1,9049,3215,5834,0,0,0,1.0,1,1.0,1,1.0,1,0.25684077922937837,53
4220,4,9053,3216,5837,0,0,0,1.0,1,1.0,1,1.0,1,0.29596302156618604,53
4221,4,9057,3216,5841,0,0,0,1.0,1,1.0,1,1.0,1,0.26172207093748034,54
4222,6,9063,3219,5844,0,0,0,1.0,1,1.0,1,1.0,1,0.2531300007274915,55
4223,4,9067,3220,5847,0,0,0,1.0,1,1.0,1,1.0,1,0.25631117131393305,56
4224,4,9071,3221,5850,0,0,0,1.0,1,1.0,1,1.0,1,0.22757797603338872,55
4225,1,9072,3221,5851,0,0,0,1.0,1,1.0,1,1.0,1,0.2096998110578105,53
4226,7,9079,3224,5855,0,0,0,1.0,1,1.0,1,1.0,1,0.18458255867025045,54
4227,0,9079,3224,5855,0,0,0,1.0,1,1.0,1,1.0,1,0.18342210587430333,52
4228,1,9080,3225,5855,0,0,0,1.0,1,1.0,1,1.0,1,0.19852239219472992,51
4229,2,9082,3227,5855,0,0,0,1.0,1,1.0,1,1.0,1,0.19960158035418105,48
4230,2,9084,3229,5855,0,0,0,1.0,1,1.0,1,1.0,1,0.2353632381582686,48
4231,5,9089,3229,5860,0,0,0,1.0,1,1.0,1,1.0,1,0.14309437667738104,48
4232,5,9094,3230,5864,0,0,0,1.0,1,1.0,1,1.0,1,0.14951209183159958,48
4233,3,9097,3230,5867,0,0,0,1.0,1,1.0,1,1.0,1,0.10493580342840914,48
4234,5,9102,3231,5871,0,0,0,1.0,1,1.0,1,1.0,1,0.07999011568141669,49
4235,3,9105,3232,5873,0,0,0,1.0,1,1.0,1,1.0,1,0.14424561834380778,47
4236,5,9110,3233,5877,0,0,0,1.0,1,1.0,1,1.0,1,0.07521141563105782,47
4237,3,9113,3234,5879,0,0,0,1.0,1,1.0,1,1.0,1,0.07944854998485226,48
4238,2,9115,3234,5881,0,0,0,1.0,1,1.0,1,1.0,1,0.08714205556207777,47
4239,2,9117,3234,5883,0,0,0,1.0,1,1.0,1,1.0,1,0.08335702902088103,48
4240,1,9118,3234,5884,0,0,0,1.0,1,1.0,1,1.0,1,0.0699128056449962,47
4241,1,9119,3234,5885,0,0,0,1.0,1,1.0,1,1.0,1,0.059747854170342535,49
4242,0,9119,3234,5885,0,0,0,1.0,1,1.0,1,1.0,1,0.06201797076149214,49
4243,1,9120,3235,5885,0,0,0,1.0,1,1.0,1,1.0,1,0.07332369128968189,50
4244,2,9122,3235,5887,0,0,0,1.0,1,1.0,1,1.0,1,0.09772958270206314,51
4245,3,9125,3235,5890,0,0,0,1.0,1,1.0,1,1.0,1,0.1324778269657178,51
4246,4,9129,3235,5894,0,0,0,1.0,1,1.0,1,1.0,1,0.04124468390478015,51
4247,0,9129,3235,5894,0,0,0,1.0,1,1.0,1,1.0,1,0.0531971365117213,52
4248,1,9130,3236,5894,0,0,0,1.0,1,1.0,1,1.0,1,0.07891671137877648,52
4249,1,9131,3236,5895,0,0,0,1.0,1,1.0,1,1.0,1,0.06265843339311866,52
4250,1,9132,3236,5896,0,0,0,1.0,1,1.0,1,1.0,1,0.07256737059468608,52
4251,1,9133,3237,5896,0,0,0,1.0,1,1.0,1,1.0,1,0.06971490956225089,53
4252,5,9138,3240,5898,0,0,0,1.0,1,1.0,1,1.0,1,0.09185289589850221,53
4253,1,9139,3241,5898,0,0,0,1.0,1,1.0,1,1.0,1,0.08228480976069312,54
4254,0,9139,3241,5898,0,0,0,1.0,1,1.0,1,1.0,1,0.08228480976069312,54
4255,3,9142,3242,5900,0,0,0,1.0,1,1.0,1,1.0,1,0.1243589644797544,55
4256,8,9150,3245,5905,0,0,0,1.0,1,1.0,1,1.0,1,0.07236601788426916,57
4257,5,9155,3246,5909,0,0,0,1.0,1,1.0,1,1.0,1,0.09042768953956452,57
4258,3,9158,3246,5912,0,0,0,1.0,1,1.0,1,1.0,1,0.09707722470295532,57
4259,3,9161,3246,5915,0,0,0,1.0,1,1.0,1,1.0,1,0.11579113371434932,57
4260,3,9164,3246,5918,0,0,0,1.0,1,1.0,1,1.0,1,0.1044362084914028,58
4261,3,9167,3247,5920,0,0,0,1.0,1,1.0,1,1.0,1,0.10594239664393186,59
4262,2,9169,3248,5921,0,0,0,1.0,1,1.0,1,1.0,1,0.12909709619567564,60
4263,4,9173,3251,5922,0,0,0,1.0,1,1.0,1,1.0,1,0.14752607873102888,59
4264,3,9176,3253,5923,0,0,0,1.0,1,1.0,1,1.0,1,0.1659542942292966,58
4265,8,9184,3256,5928,0,0,0,1.0,1,1.0,1,1.0,1,0.14366042496945455,58
4266,5,9189,3256,5933,0,0,0,1.0,1,1.0,1,1.0,1,0.07550671102257576,58
4267,4,9193,3258,5935,0,0,0,1.0,1,1.0,1,1.0,1,0.09495846988342525,55
4268,3,9196,3260,5936,0,0,0,1.0,1,1.0,1,1.0,1,0.11158018218039598,55
4269,1,9197,3261,5936,0,0,0,1.0,1,1.0,1,1.0,1,0.14453630138493737,50
4270,1,9198,3262,5936,0,0,0,1.0,1,1.0,1,1.0,1,0.145182407212534,47
4271,3,9201,3262,5939,0,0,0,1.0,1,1.0,1,1.0,1,0.0706545478649266,47
4272,0,9201,3262,5939,0,0,0,1.0,1,1.0,1,1.0,1,0.08412360776931631,46
4273,0,9201,3262,5939,0,0,0,1.0,1,1.0,1,1.0,1,0.0985423935884568,47
4274,4,9205,3264,5941,0,0,0,1.0,1,1.0,1,1.0,1,0.11643067539455083,45
4275,3,9208,3267,5941,0,0,0,1.0,1,1.0,1,1.0,1,0.18604338143006097,44
4276,7,9215,3268,5947,0,0,0,1.0,1,1.0,1,1.0,1,0.13409324097615732,43
4277,3,9218,3271,5947,0,0,0,1.0,1,1.0,1,1.0,1,0.12832557412862722,42
4278,2,9220,3271,5949,0,0,0,1.0,1,1.0,1,1.0,1,0.1777388923333211,43
4279,4,9224,3272,5952,0,0,0,1.0,1,1.0,1,1.0,1,0.1934898296683172,42
4280,5,9229,3274,5955,0,0,0,1.0,1,1.0,1,1.0,1,0.18563361720499186,44
4281,5,9234,3275,5959,0,0,0,1.0,1,1.0,1,1.0,1,0.08288985015678507,44
4282,1,9235,3275,5960,0,0,0,1.0,1,1.0,1,1.0,1,0.08563741354933128,44
4283,5,9240,3276,5964,0,0,0,1.0,1,1.0,1,1.0,1,0.14768822185744465,45
4284,3,9243,3276,5967,0,0,0,1.0,1,1.0,1,1.0,1,0.08818788603422886,45
4285,6,9249,3276,5973,0,0,0,1.0,1,1.0,1,1.0,1,0.11233819462541902,47
4286,3,9252,3277,5975,0,0,0,1.0,1,1.0,1,1.0,1,0.09113613789280589,47
4287,2,9254,3278,5976,0,0,0,1.0,1,1.0,1,1.0,1,0.06635906282400247,49
4288,1,9255,3279,5976,0,0,0,1.0,1,1.0,1,1.0,1,0.0794245579459691,49
4289,2,9257,3280,5977,0,0,0,1.0,1,1.0,1,1.0,1,0.06632765177142382,50
4290,1,9258,3281,5977,0,0,0,1.0,1,1.0,1,1.0,1,0.105008237554598,51
4291,1,9259,3282,5977,0,0,0,1.0,1,1.0,1,1.0,1,0.1414435272428826,50
4292,3,9262,3283,5979,0,0,0,1.0,1,1.0,1,1.0,1,0.1447166084450311,51
4293,2,9264,3284,5980,0,0,0,1.0,1,1.0,1,1.0,1,0.15943419263339212,51
4294,2,9266,3284,5982,0,0,0,1.0,1,1.0,1,1.0,1,0.15775335161098203,50
4295,1,9267,3285,5982,0,0,0,1.0,1,1.0,1,1.0,1,0.17454233589820778,50
4296,6,9273,3285,5988,0,0,0,1.0,1,1.0,1,1.0,1,0.10397698289844036,49
4297,0,9273,3285,5988,0,0,0,1.0,1,1.0,1,1.0,1,0.12529929939154402,49
4298,1,9274,3285,5989,0,0,0,1.0,1,1.0,1,1.0,1,0.09912416124738087,49
4299,1,9275,3285,5990,0,0,0,1.0,1,1.0,1,1.0,1,0.09806885167647976,48
4300,1,9276,3286,5990,0,0,0,1.0,1,1.0,1,1.0,1,0.10136933308857378,49
4301,12,9288,3288,6000,0,0,0,1.0,1,1.0,1,1.0,1,0.0786143010115131,50
4302,4,9292,3288,6004,0,0,0,1.0,1,1.0,1,1.0,1,0.12803611115269603,51
4303,9,9301,3289,6012,0,0,0,1.0,1,1.0,1,1.0,1,0.08322979515110934,51
4304,11,9312,3291,6021,0,0,0,1.0,1,1.0,1,1.0,1,0.11757099282663928,51
4305,8,9320,3292,6028,0,0,0,1.0,1,1.0,1,1.0,1,0.1297528014112901,49
4306,6,9326,3294,6032,0,0,0,1.0,1,1.0,1,1.0,1,0.10423104917150093,49
4307,1,9327,3294,6033,0,0,0,1.0,1,1.0,1,1.0,1,0.09223390765215046,46
4308,2,9329,3295,6034,0,0,0,1.0,1,1.0,1,1.0,1,0.12015526341746362,44
4309,5,9334,3299,6035,0,0,0,1.0,1,1.0,1,1.0,1,0.14226326517182153,44
4310,1,9335,3300,6035,0,0,0,1.0,1,1.0,1,1.0,1,0.17372198315417878,42
4311,7,9342,3303,6039,0,0,0,1.0,1,1.0,1,1.0,1,0.08892179469168404,42
4312,0,9342,3303,6039,0,0,0,1.0,1,1.0,1,1.0,1,0.11229022074917598,40
4313,4,9346,3305,6041,0,0,0,1.0,1,1.0,1,1.0,1,0.12012830848510654,40
4314,2,9348,3305,6043,0,0,0,1.0,1,1.0,1,1.0,1,0.1600667308249938,36
4315,1,9349,3305,6044,0,0,0,1.0,1,1.0,1,1.0,1,0.18114904713756647,37
4316,5,9354,3308,6046,0,0,0,1.0,1,1.0,1,1.0,1,0.14766475819415695,37
4317,6,9360,3311,6049,0,0,0,1.0,1,1.0,1,1.0,1,0.13290643595365859,36
4318,2,9362,3312,6050,0,0,0,1.0,1,1.0,1,1.0,1,0.13059460763005462,34
4319,1,9363,3312,6051,0,0,0,1.0,1,1.0,1,1.0,1,0.17009913704541793,34
4320,1,9364,3312,6052,0,0,0,1.0,1,1.0,1,1.0,1,0.16108909650263215,34
4321,3,9367,3312,6055,0,0,0,1.0,1,1.0,1,1.0,1,0.15496275306438323,35
4322,0,9367,3312,6055,0,0,0,1.0,1,1.0,1,1.0,1,0.15496275306438323,35
4323,1,9368,3312,6056,0,0,0,1.0,1,1.0,1,1.0,1,0.1475096524953872,35
4324,1,9369,3312,6057,0,0,0,1.0,1,1.0,1,1.0,1,0.12602389143809423,34
4325,2,9371,3312,6059,0,0,0,1.0,1,1.0,1,1.0,1,0.09335473243492157,34
4326,2,9373,3313,6060,0,0,0,1.0,1,1.0,1,1.0,1,0.13703808828062167,36
4327,0,9373,3313,6060,0,0,0,1.0,1,1.0,1,1.0,1,0.1434756319510756,35
4328,1,9374,3314,6060,0,0,0,1.0,1,1.0,1,1.0,1,0.15849802162774376,35
4329,7,9381,3316,6065,0,0,0,1.0,1,1.0,1,1.0,1,0.1912215038663857,38
4330,4,9385,3317,6068,0,0,0,1.0,1,1.0,1,1.0,1,0.23647440435134404,38
4331,4,9389,3317,6072,0,0,0,1.0,1,1.0,1,1.0,1,0.17511516437558886,39
4332,3,9392,3317,6075,0,0,0,1.0,1,1.0,1,1.0,1,0.12595194454671804,40
4333,0,9392,3317,6075,0,0,0,1.0,1,1.0,1,1.0,1,0.1081076129003735,41
4334,0,9392,3317,6075,0,0,0,1.0,1,1.0,1,1.0,1,0.1081076129003735,41
4335,1,9393,3317,6076,0,0,0,1.0,1,1.0,1,1.0,1,0.08431264238762236,42
4336,0,9393,3317,6076,0,0,0,1.0,1,1.0,1,1.0,1,0.09505535374718288,43
4337,1,9394,3318,6076,0,0,0,1.0,1,1.0,1,1.0,1,0.06837518577298081,44
4338,0,9394,3318,6076,0,0,0,1.0,1,1.0,1,1.0,1,0.06837518577298081,44
4339,2,9396,3319,6077,0,0,0,1.0,1,1.0,1,1.0,1,0.09225605606583055,46
4340,2,9398,3319,6079,0,0,0,1.0,1,1.0,1,1.0,1,0.07981258388267046,47
4341,2,9400,3321,6079,0,0,0,1.0,1,1.0,1,1.0,1,0.12067309427453693,47
4342,4,9404,3324,6080,0,0,0,1.0,1,1.0,1,1.0,1,0.17544640003292447,47
4343,0,9404,3324,6080,0,0,0,1.0,1,1.0,1,1.0,1,0.12518515245609746,42
4344,5,9409,3327,6082,0,0,0,1.0,1,1.0,1,1.0,1,0.21443925262783867,42
4345,1,9410,3328,6082,0,0,0,1.0,1,1.0,1,1.0,1,0.21831565466076547,39
4346,5,9415,3330,6085,0,0,0,1.0,1,1.0,1,1.0,1,0.245492749481878,37
4347,3,9418,3332,6086,0,0,0,1.0,1,1.0,1,1.0,1,0.29694873331063315,37
4348,7,9425,3334,6091,0,0,0,1.0,1,1.0,1,1.0,1,0.1963370943192638,38
4349,2,9427,3334,6093,0,0,0,1.0,1,1.0,1,1.0,1,0.17931785962447092,36
4350,1,9428,3335,6093,0,0,0,1.0,1,1.0,1,1.0,1,0.1788416810403334,37
4351,1,9429,3336,6093,0,0,0,1.0,1,1.0,1,1.0,1,0.17107289097804287,35
4352,1,9430,3336,6094,0,0,0,1.0,1,1.0,1,1.0,1,0.19188468012641635,34
4353,1,9431,3336,6095,0,0,0,1.0,1,1.0,1,1.0,1,0.18064216658044147,34
4354,1,9432,3336,6096,0,0,0,1.0,1,1.0,1,1.0,1,0.2076442626579383,32
4355,1,9433,3336,6097,0,0,0,1.0,1,1.0,1,1.0,1,0.15851603759168753,32
4356,3,9436,3338,6098,0,0,0,1.0,1,1.0,1,1.0,1,0.14141536412962852,34
4357,0,9436,3338,6098,0,0,0,1.0,1,1.0,1,1.0,1,0.1389846784054879,35
4358,4,9440,3341,6099,0,0,0,1.0,1,1.0,1,1.0,1,0.18754458991917408,35
4359,2,9442,3341,6101,0,0,0,1.0,1,1.0,1,1.0,1,0.17278228091870373,37
4360,3,9445,3341,6104,0,0,0,1.0,1,1.0,1,1.0,1,0.19960605617988064,38
4361,4,9449,3342,6107,0,0,0,1.0,1,1.0,1,1.0,1,0.12492169933619908,39
4362,2,9451,3344,6107,0,0,0,1.0,1,1.0,1,1.0,1,0.14525095732190194,38
4363,2,9453,3344,6109,0,0,0,1.0,1,1.0,1,1.0,1,0.11585076902243657,38
4364,6,9459,3346,6113,0,0,0,1.0,1,1.0,1,1.0,1,0.1517590512801961,39
4365,4,9463,3346,6117,0,0,0,1.0,1,1.0,1,1.0,1,0.16026229565517466,39
4366,6,9469,3348,6121,0,0,0,1.0,1,1.0,1,1.0,1,0.13798387961107925,39
4367,3,9472,3348,6124,0,0,0,1.0,1,1.0,1,1.0,1,0.15423339105257924,41
4368,3,9475,3348,6127,0,0,0,1.0,1,1.0,1,1.0,1,0.14885096235559278,41
4369,3,9478,3348,6130,0,0,0,1.0,1,1.0,1,1.0,1,0.14325201349169178,42
4370,0,9478,3348,6130,0,0,0,1.0,1,1.0,1,1.0,1,0.14325201349169178,42
4371,3,9481,3348,6133,0,0,0,1.0,1,1.0,1,1.0,1,0.11577549628091477,43
4372,0,9481,3348,6133,0,0,0,1.0,1,1.0,1,1.0,1,0.11577549628091477,43
4373,1,9482,3349,6133,0,0,0,1.0,1,1.0,1,1.0,1,0.13804129160152825,43
4374,2,9484,3350,6134,0,0,0,1.0,1,1.0,1,1.0,1,0.15453881198128627,44
4375,4,9488,3350,6138,0,0,0,1.0,1,1.0,1,1.0,1,0.16926478632389064,45
4376,2,9490,3350,6140,0,0,0,1.0,1,1.0,1,1.0,1,0.12998122179526156,46
4377,1,9491,3351,6140,0,0,0,1.0,1,1.0,1,1.0,1,0.16608949640621007,47
4378,0,9491,3351,6140,0,0,0,1.0,1,1.0,1,1.0,1,0.16866397408983738,49
4379,4,9495,3354,6141,0,0,0,1.0,1,1.0,1,1.0,1,0.17582475703689276,51
4380,5,9500,3355,6145,0,0,0,1.0,1,1.0,1,1.0,1,0.17958977905461357,50
4381,1,9501,3355,6146,0,0,0,1.0,1,1.0,1,1.0,1,0.1764455858079166,49
4382,3,9504,3358,6146,0,0,0,1.0,1,1.0,1,1.0,1,0.2163327604690323,47
4383,4,9508,3360,6148,0,0,0,1.0,1,1.0,1,1.0,1,0.21995461036572264,47
4384,2,9510,3361,6149,0,0,0,1.0,1,1.0,1,1.0,1,0.24480184748652706,44
4385,1,9511,3362,6149,0,0,0,1.0,1,1.0,1,1.0,1,0.22594689407106144,42
4386,7,9518,3363,6155,0,0,0,1.0,1,1.0,1,1.0,1,0.24048804821550676,41
4387,0,9518,3363,6155,0,0,0,1.0,1,1.0,1,1.0,1,0.2165966533233515,39
4388,2,9520,3363,6157,0,0,0,1.0,1,1.0,1,1.0,1,0.2165966533233515,39
4389,5,9525,3366,6159,0,0,0,1.0,1,1.0,1,1.0,1,0.22570900593590174,38
4390,2,9527,3366,6161,0,0,0,1.0,1,1.0,1,1.0,1,0.23225882475149484,38
4391,7,9534,3366,6168,0,0,0,1.0,1,1.0,1,1.0,1,0.14236650671288778,39
4392,4,9538,3366,6172,0,0,0,1.0,1,1.0,1,1.0,1,0.09554022764892002,39
4393,4,9542,3366,6176,0,0,0,1.0,1,1.0,1,1.0,1,0.110515732159133,40
4394,2,9544,3366,6178,0,0,0,1.0,1,1.0,1,1.0,1,0.07001599508718818,39
4395,1,9545,3366,6179,0,0,0,1.0,1,1.0,1,1.0,1,0.10876466631312477,39
4396,2,9547,3367,6180,0,0,0,1.0,1,1.0,1,1.0,1,0.1207612730990171,39
4397,2,9549,3368,6181,0,0,0,1.0,1,1.0,1,1.0,1,0.10838237232275051,38
4398,0,9549,3368,6181,0,0,0,1.0,1,1.0,1,1.0,1,0.12953238107721657,39
4399,3,9552,3368,6184,0,0,0,1.0,1,1.0,1,1.0,1,0.12739018425830012,42
4400,0,9552,3368,6184,0,0,0,1.0,1,1.0,1,1.0,1,0.1218970605601055,43
4401,1,9553,3368,6185,0,0,0,1.0,1,1.0,1,1.0,1,0.09408494176705029,44
4402,0,9553,3368,6185,0,0,0,1.0,1,1.0,1,1.0,1,0.09408494176705029,44
4403,1,9554,3368,6186,0,0,0,1.0,1,1.0,1,1.0,1,0.07849924129119064,45
4404,0,9554,3368,6186,0,0,0,1.0,1,1.0,1,1.0,1,0.07849924129119064,45
4405,0,9554,3368,6186,0,0,0,1.0,1,1.0,1,1.0,1,0.08861663039551068,46
4406,0,9554,3368,6186,0,0,0,1.0,1,1.0,1,1.0,1,0.08861663039551068,46
4407,0,9554,3368,6186,0,0,0,1.0,1,1.0,1,1.0,1,0.08861663039551068,46
4408,1,9555,3368,6187,0,0,0,1.0,1,1.0,1,1.0,1,0.0917695606506776,47
4409,0,9555,3368,6187,0,0,0,1.0,1,1.0,1,1.0,1,0.1124322319027141,48
4410,0,9555,3368,6187,0,0,0,1.0,1,1.0,1,1.0,1,0.1124322319027141,48
4411,0,9555,3368,6187,0,0,0,1.0,1,1.0,1,1.0,1,0.12334060249711028,50
4412,0,9555,3368,6187,0,0,0,1.0,1,1.0,1,1.0,1,0.12334060249711028,50
4413,2,9557,3368,6189,0,0,0,1.0,1,1.0,1,1.0,1,0.1414345450199121,50
4414,1,9558,3368,6190,0,0,0,1.0,1,1.0,1,1.0,1,0.14638539780316653,51
4415,2,9560,3368,6192,0,0,0,1.0,1,1.0,1,1.0,1,0.1342874134783932,51
4416,4,9564,3369,6195,0,0,0,1.0,1,1.0,1,1.0,1,0.08806483684039175,51
4417,2,9566,3370,6196,0,0,0,1.0,1,1.0,1,1.0,1,0.08181500552736017,51
4418,1,9567,3370,6197,0,0,0,1.0,1,1.0,1,1.0,1,0.09929839041741889,51
4419,0,9567,3370,6197,0,0,0,1.0,1,1.0,1,1.0,1,0.09394795758588621,50
4420,1,9568,3371,6197,0,0,0,1.0,1,1.0,1,1.0,1,0.15033066153586114,50
4421,5,9573,3371,6202,0,0,0,1.0,1,1.0,1,1.0,1,0.12197884259905678,52
4422,1,9574,3371,6203,0,0,0,1.0,1,1.0,1,1.0,1,0.12420174557866517,51
4423,2,9576,3371,6205,0,0,0,1.0,1,1.0,1,1.0,1,0.1371272820764002,51
4424,2,9578,3371,6207,0,0,0,1.0,1,1.0,1,1.0,1,0.10672509597022828,53
4425,1,9579,3371,6208,0,0,0,1.0,1,1.0,1,1.0,1,0.11505866665061704,54
4426,3,9582,3372,6210,0,0,0,1.0,1,1.0,1,1.0,1,0.07333284061558877,55
4427,0,9582,3372,6210,0,0,0,1.0,1,1.0,1,1.0,1,0.07333284061558877,55
4428,0,9582,3372,6210,0,0,0,1.0,1,1.0,1,1.0,1,0.07333284061558877,55
4429,1,9583,3372,6211,0,0,0,1.0,1,1.0,1,1.0,1,0.07361323858429651,56
4430,1,9584,3372,6212,0,0,0,1.0,1,1.0,1,1.0,1,0.06614351350415136,55
4431,2,9586,3372,6214,0,0,0,1.0,1,1.0,1,1.0,1,0.046912117810972966,56
4432,0,9586,3372,6214,0,0,0,1.0,1,1.0,1,1.0,1,0.046912117810972966,56
4433,0,9586,3372,6214,0,0,0,1.0,1,1.0,1,1.0,1,0.046805636295328475,57
4434,2,9588,3373,6215,0,0,0,1.0,1,1.0,1,1.0,1,0.08169431420472077,56
4435,2,9590,3374,6216,0,0,0,1.0,1,1.0,1,1.0,1,0.09134837500527886,56
4436,4,9594,3376,6218,0,0,0,1.0,1,1.0,1,1.0,1,0.08578694532699939,55
4437,2,9596,3376,6220,0,0,0,1.0,1,1.0,1,1.0,1,0.07904603296892135,54
4438,2,9598,3378,6220,0,0,0,1.0,1,1.0,1,1.0,1,0.11246234591365722,54
4439,0,9598,3378,6220,0,0,0,1.0,1,1.0,1,1.0,1,0.14886468181344792,55
4440,3,9601,3379,6222,0,0,0,1.0,1,1.0,1,1.0,1,0.1619036198404574,55
4441,7,9608,3380,6228,0,0,0,1.0,1,1.0,1,1.0,1,0.11296460744891952,59
4442,2,9610,3380,6230,0,0,0,1.0,1,1.0,1,1.0,1,0.09874706356891691,61
4443,3,9613,3381,6232,0,0,0,1.0,1,1.0,1,1.0,1,0.10732688104426141,60
4444,4,9617,3381,6236,0,0,0,1.0,1,1.0,1,1.0,1,0.1286938774702324,61
4445,3,9620,3381,6239,0,0,0,1.0,1,1.0,1,1.0,1,0.1328048249251876,61
4446,8,9628,3381,6247,0,0,0,1.0,1,1.0,1,1.0,1,0.07586317048535964,62
4447,2,9630,3381,6249,0,0,0,1.0,1,1.0,1,1.0,1,0.09115158954714872,63
4448,3,9633,3381,6252,0,0,0,1.0,1,1.0,1,1.0,1,0.07283875124237119,63
4449,4,9637,3381,6256,0,0,0,1.0,1,1.0,1,1.0,1,0.07283875124237119,63
4450,4,9641,3381,6260,0,0,0,1.0,1,1.0,1,1.0,1,0.08806383086221975,62
4451,1,9642,3382,6260,0,0,0,1.0,1,1.0,1,1.0,1,0.10316474996838122,63
4452,0,9642,3382,6260,0,0,0,1.0,1,1.0,1,1.0,1,0.10741896099071291,64
4453,3,9645,3383,6262,0,0,0,1.0,1,1.0,1,1.0,1,0.12279224456319734,65
4454,1,9646,3383,6263,0,0,0,1.0,1,1.0,1,1.0,1,0.11521523551538057,66
4455,2,9648,3383,6265,0,0,0,1.0,1,1.0,1,1.0,1,0.09899235072991037,67
4456,3,9651,3384,6267,0,0,0,1.0,1,1.0,1,1.0,1,0.10119694981491804,67
4457,1,9652,3384,6268,0,0,0,1.0,1,1.0,1,1.0,1,0.09258437777634855,65
4458,1,9653,3384,6269,0,0,0,1.0,1,1.0,1,1.0,1,0.10206287605448396,65
4459,3,9656,3387,6269,0,0,0,1.0,1,1.0,1,1.0,1,0.14458642124391996,64
4460,0,9656,3387,6269,0,0,0,1.0,1,1.0,1,1.0,1,0.16497964911923055,63
4461,4,9660,3388,6272,0,0,0,1.0,1,1.0,1,1.0,1,0.18076691880810672,62
4462,9,9669,3393,6276,0,0,0,1.0,1,1.0,1,1.0,1,0.1984642139132855,61
4463,5,9674,3395,6279,0,0,0,1.0,1,1.0,1,1.0,1,0.21986063586220342,61
4464,3,9677,3397,6280,0,0,0,1.0,1,1.0,1,1.0,1,0.21126722162149006,58
4465,3,9680,3398,6282,0,0,0,1.0,1,1.0,1,1.0,1,0.20185518666750893,57
4466,7,9687,3401,6286,0,0,0,1.0,1,1.0,1,1.0,1,0.19611701961487177,54
4467,3,9690,3401,6289,0,0,0,1.0,1,1.0,1,1.0,1,0.17334366247268654,52
4468,4,9694,3402,6292,0,0,0,1.0,1,1.0,1,1.0,1,0.15753522479134688,52
4469,4,9698,3403,6295,0,0,0,1.0,1,1.0,1,1.0,1,0.1687871937270975,51
4470,5,9703,3406,6297,0,0,0,1.0,1,1.0,1,1.0,1,0.1313305048714296,51
4471,4,9707,3408,6299,0,0,0,1.0,1,1.0,1,1.0,1,0.0785280135173997,50
4472,0,9707,3408,6299,0,0,0,1.0,1,1.0,1,1.0,1,0.07637098939050121,48
4473,1,9708,3409,6299,0,0,0,1.0,1,1.0,1,1.0,1,0.13253642537977658,47
4474,0,9708,3409,6299,0,0,0,1.0,1,1.0,1,1.0,1,0.12823184227798604,49
4475,4,9712,3411,6301,0,0,0,1.0,1,1.0,1,1.0,1,0.21141590593210918,47
4476,6,9718,3413,6305,0,0,0,1.0,1,1.0,1,1.0,1,0.1388458990709083,49
4477,3,9721,3414,6307,0,0,0,1.0,1,1.0,1,1.0,1,0.12883985384784924,48
4478,0,9721,3414,6307,0,0,0,1.0,1,1.0,1,1.0,1,0.12883985384784924,48
4479,0,9721,3414,6307,0,0,0,1.0,1,1.0,1,1.0,1,0.12883985384784924,48
4480,0,9721,3414,6307,0,0,0,1.0,1,1.0,1,1.0,1,0.1370262642883017,49
4481,5,9726,3414,6312,0,0,0,1.0,1,1.0,1,1.0,1,0.1118510242214711,49
4482,0,9726,3414,6312,0,0,0,1.0,1,1.0,1,1.0,1,0.1118510242214711,49
4483,0,9726,3414,6312,0,0,0,1.0,1,1.0,1,1.0,1,0.10609519435471246,50
4484,3,9729,3416,6313,0,0,0,1.0,1,1.0,1,1.0,1,0.13039545407921174,52
4485,5,9734,3416,6318,0,0,0,1.0,1,1.0,1,1.0,1,0.12307067744927752,53
4486,6,9740,3420,6320,0,0,0,1.0,1,1.0,1,1.0,1,0.09873165346711894,55
4487,2,9742,3422,6320,0,0,0,1.0,1,1.0,1,1.0,1,0.09518942911595482,55
4488,1,9743,3423,6320,0,0,0,1.0,1,1.0,1,1.0,1,0.11032368973433566,54
4489,0,9743,3423,6320,0,0,0,1.0,1,1.0,1,1.0,1,0.13730901305863305,53
4490,0,9743,3423,6320,0,0,0,1.0,1,1.0,1,1.0,1,0.13730901305863305,53
4491,1,9744,3423,6321,0,0,0,1.0,1,1.0,1,1.0,1,0.1306354432672473,52
4492,0,9744,3423,6321,0,0,0,1.0,1,1.0,1,1.0,1,0.1306354432672473,52
4493,3,9747,3424,6323,0,0,0,1.0,1,1.0,1,1.0,1,0.15304600125664228,52
4494,3,9750,3424,6326,0,0,0,1.0,1,1.0,1,1.0,1,0.1042626500205326,53
4495,2,9752,3426,6326,0,0,0,1.0,1,1.0,1,1.0,1,0.17456866996740739,50
4496,6,9758,3428,6330,0,0,0,1.0,1,1.0,1,1.0,1,0.12590402899041148,51
4497,1,9759,3429,6330,0,0,0,1.0,1,1.0,1,1.0,1,0.13284062023983242,50
4498,2,9761,3430,6331,0,0,0,1.0,1,1.0,1,1.0,1,0.1199746561780351,49
4499,2,9763,3432,6331,0,0,0,1.0,1,1.0,1,1.0,1,0.14061157594412957,48
4500,6,9769,3435,6334,0,0,0,1.0,1,1.0,1,1.0,1,0.1727927046047967,48
4501,4,9773,3436,6337,0,0,0,1.0,1,1.0,1,1.0,1,0.14681094835405442,48
4502,1,9774,3436,6338,0,0,0,1.0,1,1.0,1,1.0,1,0.12146385194366673,49
4503,4,9778,3439,6339,0,0,0,1.0,1,1.0,1,1.0,1,0.15895275910622436,49
4504,2,9780,3441,6339,0,0,0,1.0,1,1.0,1,1.0,1,0.18344449175376193,45
4505,0,9780,3441,6339,0,0,0,1.0,1,1.0,1,1.0,1,0.1843602137098778,46
4506,8,9788,3444,6344,0,0,0,1.0,1,1.0,1,1.0,1,0.18792970117807706,45
4507,6,9794,3445,6349,0,0,0,1.0,1,1.0,1,1.0,1,0.16040396201614796,45
4508,3,9797,3447,6350,0,0,0,1.0,1,1.0,1,1.0,1,0.14941090542474897,43
4509,1,9798,3447,6351,0,0,0,1.0,1,1.0,1,1.0,1,0.14849264929162684,41
4510,1,9799,3448,6351,0,0,0,1.0,1,1.0,1,1.0,1,0.15983948006860565,42
4511,4,9803,3448,6355,0,0,0,1.0,1,1.0,1,1.0,1,0.0946437612623289,41
4512,2,9805,3448,6357,0,0,0,1.0,1,1.0,1,1.0,1,0.06314585201296746,41
4513,0,9805,3448,6357,0,0,0,1.0,1,1.0,1,1.0,1,0.06314585201296746,41
4514,4,9809,3451,6358,0,0,0,1.0,1,1.0,1,1.0,1,0.10634655303889207,42
4515,2,9811,3452,6359,0,0,0,1.0,1,1.0,1,1.0,1,0.08937176111759215,41
4516,0,9811,3452,6359,0,0,0,1.0,1,1.0,1,1.0,1,0.10550254449265487,42
4517,2,9813,3453,6360,0,0,0,1.0,1,1.0,1,1.0,1,0.13190748462117924,43
4518,0,9813,3453,6360,0,0,0,1.0,1,1.0,1,1.0,1,0.14027434477090403,42
4519,2,9815,3455,6360,0,0,0,1.0,1,1.0,1,1.0,1,0.1910646568914228,42
4520,3,9818,3455,6363,0,0,0,1.0,1,1.0,1,1.0,1,0.1911137073429109,42
4521,3,9821,3456,6365,0,0,0,1.0,1,1.0,1,1.0,1,0.17136023488176014,42
4522,0,9821,3456,6365,0,0,0,1.0,1,1.0,1,1.0,1,0.17136023488176014,42
4523,1,9822,3456,6366,0,0,0,1.0,1,1.0,1,1.0,1,0.1542429135091147,42
4524,2,9824,3458,6366,0,0,0,1.0,1,1.0,1,1.0,1,0.18961589271005155,43
4525,2,9826,3458,6368,0,0,0,1.0,1,1.0,1,1.0,1,0.16918075770394844,46
4526,7,9833,3461,6372,0,0,0,1.0,1,1.0,1,1.0,1,0.1660587061698569,46
4527,3,9836,3463,6373,0,0,0,1.0,1,1.0,1,1.0,1,0.1634332912876627,47
4528,2,9838,3463,6375,0,0,0,1.0,1,1.0,1,1.0,1,0.16567330886511805,49
4529,1,9839,3463,6376,0,0,0,1.0,1,1.0,1,1.0,1,0.15160756693716965,50
4530,1,9840,3463,6377,0,0,0,1.0,1,1.0,1,1.0,1,0.1558880093126463,51
4531,3,9843,3463,6380,0,0,0,1.0,1,1.0,1,1.0,1,0.12762167446843123,51
4532,0,9843,3463,6380,0,0,0,1.0,1,1.0,1,1.0,1,0.12762167446843123,51
4533,1,9844,3464,6380,0,0,0,1.0,1,1.0,1,1.0,1,0.18086167336784298,50
4534,4,9848,3464,6384,0,0,0,1.0,1,1.0,1,1.0,1,0.1256255371708723,51
4535,2,9850,3465,6385,0,0,0,1.0,1,1.0,1,1.0,1,0.15267068555353283,50
4536,4,9854,3465,6389,0,0,0,1.0,1,1.0,1,1.0,1,0.13036975785748525,48
4537,1,9855,3465,6390,0,0,0,1.0,1,1.0,1,1.0,1,0.11569857259843372,49
4538,3,9858,3465,6393,0,0,0,1.0,1,1.0,1,1.0,1,0.13790286605326837,48
4539,1,9859,3466,6393,0,0,0,1.0,1,1.0,1,1.0,1,0.20243967916982014,50
4540,1,9860,3466,6394,0,0,0,1.0,1,1.0,1,1.0,1,0.16405499404044208,49
4541,4,9864,3468,6396,0,0,0,1.0,1,1.0,1,1.0,1,0.1527926711121532,49
4542,2,9866,3470,6396,0,0,0,1.0,1,1.0,1,1.0,1,0.2045034696373181,47
4543,2,9868,3471,6397,0,0,0,1.0,1,1.0,1,1.0,1,0.18905090877682074,45
4544,1,9869,3472,6397,0,0,0,1.0,1,1.0,1,1.0,1,0.19614139037920644,45
4545,1,9870,3473,6397,0,0,0,1.0,1,1.0,1,1.0,1,0.21401345606988062,43
4546,5,9875,3475,6400,0,0,0,1.0,1,1.0,1,1.0,1,0.2173156039768684,43
4547,4,9879,3476,6403,0,0,0,1.0,1,1.0,1,1.0,1,0.18368184968752863,41
4548,3,9882,3477,6405,0,0,0,1.0,1,1.0,1,1.0,1,0.187821302106604,42
4549,0,9882,3477,6405,0,0,0,1.0,1,1.0,1,1.0,1,0.18726413134177006,41
4550,3,9885,3480,6405,0,0,0,1.0,1,1.0,1,1.0,1,0.17330304783492767,41
4551,1,9886,3481,6405,0,0,0,1.0,1,1.0,1,1.0,1,0.16785766089331855,39
4552,1,9887,3482,6405,0,0,0,1.0,1,1.0,1,1.0,1,0.16506583572974828,38
4553,1,9888,3483,6405,0,0,0,1.0,1,1.0,1,1.0,1,0.19004475231129392,39
4554,2,9890,3485,6405,0,0,0,1.0,1,1.0,1,1.0,1,0.23557283927870634,38
4555,0,9890,3485,6405,0,0,0,1.0,1,1.0,1,1.0,1,0.2267756372763943,37
4556,2,9892,3487,6405,0,0,0,1.0,1,1.0,1,1.0,1,0.22898008777351858,36
4557,3,9895,3487,6408,0,0,0,1.0,1,1.0,1,1.0,1,0.17768690491070993,38
4558,2,9897,3489,6408,0,0,0,1.0,1,1.0,1,1.0,1,0.20761633834666351,39
4559,3,9900,3490,6410,0,0,0,1.0,1,1.0,1,1.0,1,0.21766358305969002,38
4560,6,9906,3491,6415,0,0,0,1.0,1,1.0,1,1.0,1,0.22069649545350498,41
4561,3,9909,3491,6418,0,0,0,1.0,1,1.0,1,1.0,1,0.185347289450047,41
4562,1,9910,3491,6419,0,0,0,1.0,1,1.0,1,1.0,1,0.17674111131697082,43
4563,1,9911,3491,6420,0,0,0,1.0,1,1.0,1,1.0,1,0.1570254251889939,42
4564,0,9911,3491,6420,0,0,0,1.0,1,1.0,1,1.0,1,0.17625322081998182,43
4565,3,9914,3491,6423,0,0,0,1.0,1,1.0,1,1.0,1,0.1166071887245231,44
4566,1,9915,3491,6424,0,0,0,1.0,1,1.0,1,1.0,1,0.08994545708188513,45
4567,2,9917,3492,6425,0,0,0,1.0,1,1.0,1,1.0,1,0.10779935569822645,47
4568,1,9918,3493,6425,0,0,0,1.0,1,1.0,1,1.0,1,0.07992484822861443,47
4569,2,9920,3494,6426,0,0,0,1.0,1,1.0,1,1.0,1,0.07672306589298429,49
4570,1,9921,3495,6426,0,0,0,1.0,1,1.0,1,1.0,1,0.10539200512675112,49
4571,2,9923,3496,6427,0,0,0,1.0,1,1.0,1,1.0,1,0.0923450973426167,48
4572,0,9923,3496,6427,0,0,0,1.0,1,1.0,1,1.0,1,0.0923450973426167,48
4573,0,9923,3496,6427,0,0,0,1.0,1,1.0,1,1.0,1,0.0923450973426167,48
4574,1,9924,3497,6427,0,0,0,1.0,1,1.0,1,1.0,1,0.14047659946775953,50
4575,2,9926,3499,6427,0,0,0,1.0,1,1.0,1,1.0,1,0.16574309365829545,51
4576,4,9930,3499,6431,0,0,0,1.0,1,1.0,1,1.0,1,0.14013810753401124,48
4577,0,9930,3499,6431,0,0,0,1.0,1,1.0,1,1.0,1,0.16262894519735982,47
4578,2,9932,3500,6432,0,0,0,1.0,1,1.0,1,1.0,1,0.17708069335739485,46
4579,2,9934,3501,6433,0,0,0,1.0,1,1.0,1,1.0,1,0.18320022104733336,46
4580,1,9935,3501,6434,0,0,0,1.0,1,1.0,1,1.0,1,0.158770580870791,47
4581,2,9937,3502,6435,0,0,0,1.0,1,1.0,1,1.0,1,0.14428229376337862,47
4582,0,9937,3502,6435,0,0,0,1.0,1,1.0,1,1.0,1,0.1562510193277843,48
4583,0,9937,3502,6435,0,0,0,1.0,1,1.0,1,1.0,1,0.1562510193277843,48
4584,0,9937,3502,6435,0,0,0,1.0,1,1.0,1,1.0,1,0.16349072273386883,50
4585,1,9938,3503,6435,0,0,0,1.0,1,1.0,1,1.0,1,0.1815467101119716,50
4586,1,9939,3503,6436,0,0,0,1.0,1,1.0,1,1.0,1,0.1732806894341892,50
4587,0,9939,3503,6436,0,0,0,1.0,1,1.0,1,1.0,1,0.1732806894341892,50
4588,0,9939,3503,6436,0,0,0,1.0,1,1.0,1,1.0,1,0.1732806894341892,50
4589,3,9942,3504,6438,0,0,0,1.0,1,1.0,1,1.0,1,0.1729815197838232,52
4590,0,9942,3504,6438,0,0,0,1.0,1,1.0,1,1.0,1,0.1729815197838232,52
4591,1,9943,3504,6439,0,0,0,1.0,1,1.0,1,1.0,1,0.15165868912319452,53
4592,0,9943,3504,6439,0,0,0,1.0,1,1.0,1,1.0,1,0.1656060429294764,54
4593,1,9944,3504,6440,0,0,0,1.0,1,1.0,1,1.0,1,0.146830265018217,56
4594,1,9945,3504,6441,0,0,0,1.0,1,1.0,1,1.0,1,0.14617176972328716,57
4595,0,9945,3504,6441,0,0,0,1.0,1,1.0,1,1.0,1,0.15513860548364689,56
4596,1,9946,3504,6442,0,0,0,1.0,1,1.0,1,1.0,1,0.14110947762413162,56
4597,1,9947,3505,6442,0,0,0,1.0,1,1.0,1,1.0,1,0.14380324499220606,56
4598,6,9953,3507,6446,0,0,0,1.0,1,1.0,1,1.0,1,0.13202576658278595,57
4599,2,9955,3508,6447,0,0,0,1.0,1,1.0,1,1.0,1,0.12031623982019589,59
4600,1,9956,3508,6448,0,0,0,1.0,1,1.0,1,1.0,1,0.13290158434786617,60
4601,5,9961,3510,6451,0,0,0,1.0,1,1.0,1,1.0,1,0.12764180646872236,60
4602,0,9961,3510,6451,0,0,0,1.0,1,1.0,1,1.0,1,0.11219323213588081,62
4603,0,9961,3510,6451,0,0,0,1.0,1,1.0,1,1.0,1,0.11219323213588081,62
4604,0,9961,3510,6451,0,0,0,1.0,1,1.0,1,1.0,1,0.10688103075407988,63
4605,0,9961,3510,6451,0,0,0,1.0,1,1.0,1,1.0,1,0.10688103075407988,63
4606,2,9963,3510,6453,0,0,0,1.0,1,1.0,1,1.0,1,0.08496155857118948,64
4607,1,9964,3511,6453,0,0,0,1.0,1,1.0,1,1.0,1,0.08814989821512768,65
4608,4,9968,3512,6456,0,0,0,1.0,1,1.0,1,1.0,1,0.09561369334973598,66
4609,1,9969,3512,6457,0,0,0,1.0,1,1.0,1,1.0,1,0.08668961551490167,65
4610,0,9969,3512,6457,0,0,0,1.0,1,1.0,1,1.0,1,0.09803538299888566,63
4611,0,9969,3512,6457,0,0,0,1.0,1,1.0,1,1.0,1,0.10004910701327321,64
4612,0,9969,3512,6457,0,0,0,1.0,1,1.0,1,1.0,1,0.11190691392360125,62
4613,2,9971,3514,6457,0,0,0,1.0,1,1.0,1,1.0,1,0.14304913464317573,63
4614,2,9973,3516,6457,0,0,0,1.0,1,1.0,1,1.0,1,0.14121828998604705,61
4615,2,9975,3517,6458,0,0,0,1.0,1,1.0,1,1.0,1,0.17052340069371422,59
4616,4,9979,3519,6460,0,0,0,1.0,1,1.0,1,1.0,1,0.15461402394893162,58
4617,2,9981,3519,6462,0,0,0,1.0,1,1.0,1,1.0,1,0.14801757858743358,58
4618,3,9984,3520,6464,0,0,0,1.0,1,1.0,1,1.0,1,0.14128323062199286,57
4619,1,9985,3521,6464,0,0,0,1.0,1,1.0,1,1.0,1,0.15609755307677708,57
4620,0,9985,3521,6464,0,0,0,1.0,1,1.0,1,1.0,1,0.15609755307677708,57
4621,3,9988,3523,6465,0,0,0,1.0,1,1.0,1,1.0,1,0.15798050025151678,59
4622,1,9989,3524,6465,0,0,0,1.0,1,1.0,1,1.0,1,0.17950257320285623,60
4623,2,9991,3525,6466,0,0,0,1.0,1,1.0,1,1.0,1,0.18252439760509165,59
4624,3,9994,3527,6467,0,0,0,1.0,1,1.0,1,1.0,1,0.18148224547651334,59
4625,1,9995,3528,6467,0,0,0,1.0,1,1.0,1,1.0,1,0.19047098979650112,57
4626,9,10004,3530,6474,0,0,0,1.0,1,1.0,1,1.0,1,0.12588452064440586,56
4627,0,10004,3530,6474,0,0,0,1.0,1,1.0,1,1.0,1,0.12745547326251824,56
4628,2,10006,3531,6475,0,0,0,1.0,1,1.0,1,1.0,1,0.1405757439438588,56
4629,4,10010,3532,6478,0,0,0,1.0,1,1.0,1,1.0,1,0.17370477509743842,56
4630,4,10014,3534,6480,0,0,0,1.0,1,1.0,1,1.0,1,0.17238333258803215,57
4631,5,10019,3534,6485,0,0,0,1.0,1,1.0,1,1.0,1,0.16937804796338193,56
4632,2,10021,3535,6486,0,0,0,1.0,1,1.0,1,1.0,1,0.21068006490146293,57
4633,2,10023,3535,6488,0,0,0,1.0,1,1.0,1,1.0,1,0.19703560616266763,58
4634,0,10023,3535,6488,0,0,0,1.0,1,1.0,1,1.0,1,0.19703560616266763,58
4635,4,10027,3535,6492,0,0,0,1.0,1,1.0,1,1.0,1,0.15860547327400262,59
4636,2,10029,3535,6494,0,0,0,1.0,1,1.0,1,1.0,1,0.1275511752955556,60
4637,0,10029,3535,6494,0,0,0,1.0,1,1.0,1,1.0,1,0.1275511752955556,60
4638,4,10033,3535,6498,0,0,0,1.0,1,1.0,1,1.0,1,0.1289259707694141,61
4639,0,10033,3535,6498,0,0,0,1.0,1,1.0,1,1.0,1,0.1390897114419251,62
4640,1,10034,3535,6499,0,0,0,1.0,1,1.0,1,1.0,1,0.13744031673496904,63
4641,2,10036,3536,6500,0,0,0,1.0,1,1.0,1,1.0,1,0.12881015841193505,63
4642,0,10036,3536,6500,0,0,0,1.0,1,1.0,1,1.0,1,0.13907731593169137,62
4643,4,10040,3539,6501,0,0,0,1.0,1,1.0,1,1.0,1,0.13951865549903478,63
4644,1,10041,3540,6501,0,0,0,1.0,1,1.0,1,1.0,1,0.1607418833069172,62
4645,4,10045,3541,6504,0,0,0,1.0,1,1.0,1,1.0,1,0.15640607388638986,63
4646,6,10051,3543,6508,0,0,0,1.0,1,1.0,1,1.0,1,0.14087403525732478,63
4647,2,10053,3543,6510,0,0,0,1.0,1,1.0,1,1.0,1,0.15046861045253598,62
4648,3,10056,3544,6512,0,0,0,1.0,1,1.0,1,1.0,1,0.17877661688805357,63
4649,1,10057,3544,6513,0,0,0,1.0,1,1.0,1,1.0,1,0.17042757854759133,61
4650,0,10057,3544,6513,0,0,0,1.0,1,1.0,1,1.0,1,0.15756702917430992,63
4651,5,10062,3545,6517,0,0,0,1.0,1,1.0,1,1.0,1,0.13878273715316117,62
4652,0,10062,3545,6517,0,0,0,1.0,1,1.0,1,1.0,1,0.1470199585534927,59
4653,3,10065,3546,6519,0,0,0,1.0,1,1.0,1,1.0,1,0.1488626168575816,60
4654,1,10066,3547,6519,0,0,0,1.0,1,1.0,1,1.0,1,0.1546105883515003,60
4655,0,10066,3547,6519,0,0,0,1.0,1,1.0,1,1.0,1,0.1546105883515003,60
4656,7,10073,3550,6523,0,0,0,1.0,1,1.0,1,1.0,1,0.18965243426804257,61
4657,1,10074,3550,6524,0,0,0,1.0,1,1.0,1,1.0,1,0.18024426138996105,62
4658,5,10079,3551,6528,0,0,0,1.0,1,1.0,1,1.0,1,0.18364671668764856,62
4659,0,10079,3551,6528,0,0,0,1.0,1,1.0,1,1.0,1,0.19373922905501115,61
4660,4,10083,3552,6531,0,0,0,1.0,1,1.0,1,1.0,1,0.2221731939587845,61
4661,2,10085,3552,6533,0,0,0,1.0,1,1.0,1,1.0,1,0.21356096458920282,61
4662,2,10087,3553,6534,0,0,0,1.0,1,1.0,1,1.0,1,0.20194883217982218,62
4663,2,10089,3553,6536,0,0,0,1.0,1,1.0,1,1.0,1,0.14578388985487903,61
4664,3,10092,3554,6538,0,0,0,1.0,1,1.0,1,1.0,1,0.14859257543865662,62
4665,4,10096,3555,6541,0,0,0,1.0,1,1.0,1,1.0,1,0.14642430155541505,61
4666,3,10099,3556,6543,0,0,0,1.0,1,1.0,1,1.0,1,0.13653013536851635,61
4667,0,10099,3556,6543,0,0,0,1.0,1,1.0,1,1.0,1,0.14225415301264305,59
4668,4,10103,3559,6544,0,0,0,1.0,1,1.0,1,1.0,1,0.12844977862343862,59
4669,1,10104,3560,6544,0,0,0,1.0,1,1.0,1,1.0,1,0.13453034664990865,58
4670,5,10109,3564,6545,0,0,0,1.0,1,1.0,1,1.0,1,0.1735517357775581,57
4671,3,10112,3564,6548,0,0,0,1.0,1,1.0,1,1.0,1,0.11400077727904126,55
4672,1,10113,3565,6548,0,0,0,1.0,1,1.0,1,1.0,1,0.12529336917740788,56
4673,1,10114,3565,6549,0,0,0,1.0,1,1.0,1,1.0,1,0.0903316163160355,58
4674,1,10115,3566,6549,0,0,0,1.0,1,1.0,1,1.0,1,0.11518938127133377,58
4675,1,10116,3566,6550,0,0,0,1.0,1,1.0,1,1.0,1,0.14181133939405322,57
4676,1,10117,3566,6551,0,0,0,1.0,1,1.0,1,1.0,1,0.14963793701009162,58
4677,0,10117,3566,6551,0,0,0,1.0,1,1.0,1,1.0,1,0.16890675508286224,57
4678,1,10118,3567,6551,0,0,0,1.0,1,1.0,1,1.0,1,0.15705746281261143,57
4679,0,10118,3567,6551,0,0,0,1.0,1,1.0,1,1.0,1,0.15705746281261143,57
4680,4,10122,3568,6554,0,0,0,1.0,1,1.0,1,1.0,1,0.17141472570959612,59
4681,7,10129,3570,6559,0,0,0,1.0,1,1.0,1,1.0,1,0.15084474369268144,60
4682,0,10129,3570,6559,0,0,0,1.0,1,1.0,1,1.0,1,0.15084474369268144,60
4683,3,10132,3571,6561,0,0,0,1.0,1,1.0,1,1.0,1,0.1525322406969832,60
4684,2,10134,3573,6561,0,0,0,1.0,1,1.0,1,1.0,1,0.17658596432393406,60
4685,2,10136,3575,6561,0,0,0,1.0,1,1.0,1,1.0,1,0.21034235454853203,59
4686,7,10143,3577,6566,0,0,0,1.0,1,1.0,1,1.0,1,0.18967423324495997,60
4687,4,10147,3578,6569,0,0,0,1.0,1,1.0,1,1.0,1,0.18214707792793794,59
4688,3,10150,3578,6572,0,0,0,1.0,1,1.0,1,1.0,1,0.1763983766400939,59
4689,0,10150,3578,6572,0,0,0,1.0,1,1.0,1,1.0,1,0.17745028717003877,59
4690,1,10151,3579,6572,0,0,0,1.0,1,1.0,1,1.0,1,0.20161016987293198,58
4691,6,10157,3580,6577,0,0,0,1.0,1,1.0,1,1.0,1,0.1438654506707118,57
4692,1,10158,3580,6578,0,0,0,1.0,1,1.0,1,1.0,1,0.14478276901783263,58
4693,1,10159,3580,6579,0,0,0,1.0,1,1.0,1,1.0,1,0.15195868022870918,57
4694,1,10160,3581,6579,0,0,0,1.0,1,1.0,1,1.0,1,0.17592112001926952,57
4695,0,10160,3581,6579,0,0,0,1.0,1,1.0,1,1.0,1,0.1999997762352173,56
4696,4,10164,3582,6582,0,0,0,1.0,1,1.0,1,1.0,1,0.1977893659013776,57
4697,5,10169,3582,6587,0,0,0,1.0,1,1.0,1,1.0,1,0.1645287163136469,58
4698,1,10170,3582,6588,0,0,0,1.0,1,1.0,1,1.0,1,0.14777890130406038,59
4699,0,10170,3582,6588,0,0,0,1.0,1,1.0,1,1.0,1,0.15415876028859923,58
4700,1,10171,3583,6588,0,0,0,1.0,1,1.0,1,1.0,1,0.1523512030792338,59
4701,2,10173,3583,6590,0,0,0,1.0,1,1.0,1,1.0,1,0.14657531327942636,60
4702,0,10173,3583,6590,0,0,0,1.0,1,1.0,1,1.0,1,0.15614775924311586,61
4703,3,10176,3585,6591,0,0,0,1.0,1,1.0,1,1.0,1,0.17306434541972843,59
4704,2,10178,3587,6591,0,0,0,1.0,1,1.0,1,1.0,1,0.18806819656933185,58
4705,5,10183,3590,6593,0,0,0,1.0,1,1.0,1,1.0,1,0.2127031975030709,58
4706,8,10191,3593,6598,0,0,0,1.0,1,1.0,1,1.0,1,0.1839994066865532,60
4707,3,10194,3594,6600,0,0,0,1.0,1,1.0,1,1.0,1,0.17373216323739682,57
4708,2,10196,3595,6601,0,0,0,1.0,1,1.0,1,1.0,1,0.22050552672262264,57
4709,5,10201,3597,6604,0,0,0,1.0,1,1.0,1,1.0,1,0.2347891955066243,55
4710,3,10204,3598,6606,0,0,0,1.0,1,1.0,1,1.0,1,0.24963045994533314,53
4711,7,10211,3599,6612,0,0,0,1.0,1,1.0,1,1.0,1,0.19164924543931944,52
4712,2,10213,3601,6612,0,0,0,1.0,1,1.0,1,1.0,1,0.22093017229271877,52
4713,4,10217,3602,6615,0,0,0,1.0,1,1.0,1,1.0,1,0.2002843121902358,51
4714,1,10218,3602,6616,0,0,0,1.0,1,1.0,1,1.0,1,0.19028499633516313,50
4715,1,10219,3603,6616,0,0,0,1.0,1,1.0,1,1.0,1,0.18416364259535906,50
4716,2,10221,3603,6618,0,0,0,1.0,1,1.0,1,1.0,1,0.132094425003092,49
4717,3,10224,3605,6619,0,0,0,1.0,1,1.0,1,1.0,1,0.17386550324303898,49
4718,3,10227,3605,6622,0,0,0,1.0,1,1.0,1,1.0,1,0.152943870551736,50
4719,0,10227,3605,6622,0,0,0,1.0,1,1.0,1,1.0,1,0.16134919507804843,49
4720,0,10227,3605,6622,0,0,0,1.0,1,1.0,1,1.0,1,0.16134919507804843,49
4721,2,10229,3605,6624,0,0,0,1.0,1,1.0,1,1.0,1,0.1426972929307519,50
4722,2,10231,3605,6626,0,0,0,1.0,1,1.0,1,1.0,1,0.1295556286409475,51
4723,0,10231,3605,6626,0,0,0,1.0,1,1.0,1,1.0,1,0.11611658545398916,50
4724,1,10232,3606,6626,0,0,0,1.0,1,1.0,1,1.0,1,0.14529349310931983,50
4725,3,10235,3607,6628,0,0,0,1.0,1,1.0,1,1.0,1,0.14620932153498678,52
4726,0,10235,3607,6628,0,0,0,1.0,1,1.0,1,1.0,1,0.16844809587738566,51
4727,1,10236,3607,6629,0,0,0,1.0,1,1.0,1,1.0,1,0.13783804586780327,52
4728,0,10236,3607,6629,0,0,0,1.0,1,1.0,1,1.0,1,0.13783804586780327,52
4729,1,10237,3608,6629,0,0,0,1.0,1,1.0,1,1.0,1,0.16158131101484033,52
4730,0,10237,3608,6629,0,0,0,1.0,1,1.0,1,1.0,1,0.20084720676152476,50
4731,4,10241,3611,6630,0,0,0,1.0,1,1.0,1,1.0,1,0.22735983718491168,51
4732,2,10243,3613,6630,0,0,0,1.0,1,1.0,1,1.0,1,0.2749380362068445,52
4733,3,10246,3613,6633,0,0,0,1.0,1,1.0,1,1.0,1,0.2631047941553836,53
4734,4,10250,3614,6636,0,0,0,1.0,1,1.0,1,1.0,1,0.2598458639161901,53
4735,1,10251,3615,6636,0,0,0,1.0,1,1.0,1,1.0,1,0.2721415473989986,53
4736,6,10257,3615,6642,0,0,0,1.0,1,1.0,1,1.0,1,0.20186132806594687,55
4737,3,10260,3615,6645,0,0,0,1.0,1,1.0,1,1.0,1,0.17365410847463186,57
4738,2,10262,3616,6646,0,0,0,1.0,1,1.0,1,1.0,1,0.16768969027464836,57
4739,1,10263,3617,6646,0,0,0,1.0,1,1.0,1,1.0,1,0.17371303458151702,57
4740,1,10264,3617,6647,0,0,0,1.0,1,1.0,1,1.0,1,0.1632750001788056,57
4741,3,10267,3617,6650,0,0,0,1.0,1,1.0,1,1.0,1,0.15983824020219412,58
4742,2,10269,3618,6651,0,0,0,1.0,1,1.0,1,1.0,1,0.1659850854893568,58
4743,2,10271,3619,6652,0,0,0,1.0,1,1.0,1,1.0,1,0.12829165277458163,56
4744,3,10274,3621,6653,0,0,0,1.0,1,1.0,1,1.0,1,0.12449324204908457,57
4745,2,10276,3621,6655,0,0,0,1.0,1,1.0,1,1.0,1,0.11112739992169379,56
4746,5,10281,3623,6658,0,0,0,1.0,1,1.0,1,1.0,1,0.1037312607377218,56
4747,1,10282,3624,6658,0,0,0,1.0,1,1.0,1,1.0,1,0.09612883377115287,55
4748,3,10285,3624,6661,0,0,0,1.0,1,1.0,1,1.0,1,0.07600140915210046,55
4749,5,10290,3626,6664,0,0,0,1.0,1,1.0,1,1.0,1,0.06809596484435408,54
4750,1,10291,3627,6664,0,0,0,1.0,1,1.0,1,1.0,1,0.08106651544711921,53
4751,2,10293,3629,6664,0,0,0,1.0,1,1.0,1,1.0,1,0.11574631418297153,53
4752,1,10294,3630,6664,0,0,0,1.0,1,1.0,1,1.0,1,0.09079080810728819,53
4753,1,10295,3631,6664,0,0,0,1.0,1,1.0,1,1.0,1,0.1151826971094172,52
4754,1,10296,3632,6664,0,0,0,1.0,1,1.0,1,1.0,1,0.14464900533053912,52
4755,1,10297,3632,6665,0,0,0,1.0,1,1.0,1,1.0,1,0.14115367413108224,51
4756,5,10302,3632,6670,0,0,0,1.0,1,1.0,1,1.0,1,0.06629378307799211,52
4757,0,10302,3632,6670,0,0,0,1.0,1,1.0,1,1.0,1,0.06733896836295887,51
4758,0,10302,3632,6670,0,0,0,1.0,1,1.0,1,1.0,1,0.06733896836295887,51
4759,1,10303,3633,6670,0,0,0,1.0,1,1.0,1,1.0,1,0.08723023596445119,51
4760,1,10304,3634,6670,0,0,0,1.0,1,1.0,1,1.0,1,0.12606805110456745,52
4761,6,10310,3636,6674,0,0,0,1.0,1,1.0,1,1.0,1,0.13071567380104326,50
4762,3,10313,3638,6675,0,0,0,1.0,1,1.0,1,1.0,1,0.16114251744789138,51
4763,7,10320,3639,6681,0,0,0,1.0,1,1.0,1,1.0,1,0.12756398362635363,51
4764,4,10324,3641,6683,0,0,0,1.0,1,1.0,1,1.0,1,0.1562124563466584,53
4765,3,10327,3642,6685,0,0,0,1.0,1,1.0,1,1.0,1,0.15029697638250505,53
4766,5,10332,3644,6688,0,0,0,1.0,1,1.0,1,1.0,1,0.1310567849524208,55
4767,0,10332,3644,6688,0,0,0,1.0,1,1.0,1,1.0,1,0.11481651969080013,56
4768,2,10334,3644,6690,0,0,0,1.0,1,1.0,1,1.0,1,0.11131555803492986,56
4769,1,10335,3644,6691,0,0,0,1.0,1,1.0,1,1.0,1,0.10822983282917019,56
4770,2,10337,3644,6693,0,0,0,1.0,1,1.0,1,1.0,1,0.08867705734409148,56
4771,0,10337,3644,6693,0,0,0,1.0,1,1.0,1,1.0,1,0.08694190226620177,55
4772,2,10339,3645,6694,0,0,0,1.0,1,1.0,1,1.0,1,0.09818126735300212,56
4773,0,10339,3645,6694,0,0,0,1.0,1,1.0,1,1.0,1,0.09818126735300212,56
4774,0,10339,3645,6694,0,0,0,1.0,1,1.0,1,1.0,1,0.079897596318739,58
4775,3,10342,3646,6696,0,0,0,1.0,1,1.0,1,1.0,1,0.0825526376470031,59
4776,0,10342,3646,6696,0,0,0,1.0,1,1.0,1,1.0,1,0.0825526376470031,59
4777,2,10344,3647,6697,0,0,0,1.0,1,1.0,1,1.0,1,0.09444280617312442,60
4778,1,10345,3647,6698,0,0,0,1.0,1,1.0,1,1.0,1,0.08316723300039629,60
4779,1,10346,3647,6699,0,0,0,1.0,1,1.0,1,1.0,1,0.06303622807594775,61
4780,1,10347,3648,6699,0,0,0,1.0,1,1.0,1,1.0,1,0.09911803324935706,63
4781,2,10349,3649,6700,0,0,0,1.0,1,1.0,1,1.0,1,0.12205856110077709,62
4782,6,10355,3652,6703,0,0,0,1.0,1,1.0,1,1.0,1,0.11073730161822279,63
4783,4,10359,3654,6705,0,0,0,1.0,1,1.0,1,1.0,1,0.07130167062369254,62
4784,4,10363,3656,6707,0,0,0,1.0,1,1.0,1,1.0,1,0.09031270670059525,62
4785,3,10366,3658,6708,0,0,0,1.0,1,1.0,1,1.0,1,0.08794455814440995,62
4786,6,10372,3661,6711,0,0,0,1.0,1,1.0,1,1.0,1,0.11161821291830085,63
4787,2,10374,3662,6712,0,0,0,1.0,1,1.0,1,1.0,1,0.09375869531885409,62
4788,5,10379,3667,6712,0,0,0,1.0,1,1.0,1,1.0,1,0.10974669849105938,62
4789,3,10382,3668,6714,0,0,0,1.0,1,1.0,1,1.0,1,0.10771752746749352,60
4790,3,10385,3671,6714,0,0,0,1.0,1,1.0,1,1.0,1,0.12546747439720318,61
4791,6,10391,3673,6718,0,0,0,1.0,1,1.0,1,1.0,1,0.06582485185306207,60
4792,3,10394,3676,6718,0,0,0,1.0,1,1.0,1,1.0,1,0.11828411799346142,60
4793,2,10396,3678,6718,0,0,0,1.0,1,1.0,1,1.0,1,0.11133791676672289,61
4794,2,10398,3680,6718,0,0,0,1.0,1,1.0,1,1.0,1,0.14520661721052622,59
4795,6,10404,3681,6723,0,0,0,1.0,1,1.0,1,1.0,1,0.11327883325212543,61
4796,1,10405,3682,6723,0,0,0,1.0,1,1.0,1,1.0,1,0.10524073043165794,59
4797,2,10407,3683,6724,0,0,0,1.0,1,1.0,1,1.0,1,0.06780523651034466,58
4798,2,10409,3684,6725,0,0,0,1.0,1,1.0,1,1.0,1,0.059372160659542844,59
4799,0,10409,3684,6725,0,0,0,1.0,1,1.0,1,1.0,1,0.060005802010100445,57
4800,0,10409,3684,6725,0,0,0,1.0,1,1.0,1,1.0,1,0.058100905540586306,58
4801,7,10416,3686,6730,0,0,0,1.0,1,1.0,1,1.0,1,0.08909661987618316,57
4802,3,10419,3687,6732,0,0,0,1.0,1,1.0,1,1.0,1,0.09031698482516877,57
4803,1,10420,3688,6732,0,0,0,1.0,1,1.0,1,1.0,1,0.08868832629121302,56
4804,0,10420,3688,6732,0,0,0,1.0,1,1.0,1,1.0,1,0.11338980658871178,54
4805,4,10424,3689,6735,0,0,0,1.0,1,1.0,1,1.0,1,0.10157615657053982,56
4806,1,10425,3689,6736,0,0,0,1.0,1,1.0,1,1.0,1,0.07606496085620211,55
4807,3,10428,3691,6737,0,0,0,1.0,1,1.0,1,1.0,1,0.10124804767839266,54
4808,1,10429,3692,6737,0,0,0,1.0,1,1.0,1,1.0,1,0.11099132873971923,53
4809,1,10430,3692,6738,0,0,0,1.0,1,1.0,1,1.0,1,0.09501610819585787,53
4810,0,10430,3692,6738,0,0,0,1.0,1,1.0,1,1.0,1,0.11455829594871096,51
4811,2,10432,3693,6739,0,0,0,1.0,1,1.0,1,1.0,1,0.08866583150861024,52
4812,0,10432,3693,6739,0,0,0,1.0,1,1.0,1,1.0,1,0.09716801293252103,52
4813,0,10432,3693,6739,0,0,0,1.0,1,1.0,1,1.0,1,0.09716801293252103,52
4814,7,10439,3697,6742,0,0,0,1.0,1,1.0,1,1.0,1,0.11799412772027676,53
4815,6,10445,3700,6745,0,0,0,1.0,1,1.0,1,1.0,1,0.13434277682346726,54
4816,8,10453,3702,6751,0,0,0,1.0,1,1.0,1,1.0,1,0.1106990850582271,54
4817,7,10460,3705,6755,0,0,0,1.0,1,1.0,1,1.0,1,0.15092102840798138,55
4818,4,10464,3707,6757,0,0,0,1.0,1,1.0,1,1.0,1,0.156039286202052,55
4819,5,10469,3708,6761,0,0,0,1.0,1,1.0,1,1.0,1,0.18027109709353517,55
4820,3,10472,3708,6764,0,0,0,1.0,1,1.0,1,1.0,1,0.1554984169246717,55
4821,5,10477,3709,6768,0,0,0,1.0,1,1.0,1,1.0,1,0.11111967119739913,55
4822,0,10477,3709,6768,0,0,0,1.0,1,1.0,1,1.0,1,0.1193816860147492,54
4823,2,10479,3709,6770,0,0,0,1.0,1,1.0,1,1.0,1,0.1126705917984943,54
4824,3,10482,3709,6773,0,0,0,1.0,1,1.0,1,1.0,1,0.0457617568906077,55
4825,0,10482,3709,6773,0,0,0,1.0,1,1.0,1,1.0,1,0.07066123964253442,53
4826,4,10486,3712,6774,0,0,0,1.0,1,1.0,1,1.0,1,0.06042042440178004,54
4827,2,10488,3712,6776,0,0,0,1.0,1,1.0,1,1.0,1,0.07638098051545077,53
4828,2,10490,3713,6777,0,0,0,1.0,1,1.0,1,1.0,1,0.06644432620086013,54
4829,0,10490,3713,6777,0,0,0,1.0,1,1.0,1,1.0,1,0.06729704325048627,54
4830,0,10490,3713,6777,0,0,0,1.0,1,1.0,1,1.0,1,0.0710266562622842,53
4831,2,10492,3714,6778,0,0,0,1.0,1,1.0,1,1.0,1,0.07023237645168276,52
4832,0,10492,3714,6778,0,0,0,1.0,1,1.0,1,1.0,1,0.08276994010721199,50
4833,0,10492,3714,6778,0,0,0,1.0,1,1.0,1,1.0,1,0.10003409121509507,51
4834,2,10494,3715,6779,0,0,0,1.0,1,1.0,1,1.0,1,0.14365111725718385,51
4835,0,10494,3715,6779,0,0,0,1.0,1,1.0,1,1.0,1,0.14240270931500026,50
4836,5,10499,3717,6782,0,0,0,1.0,1,1.0,1,1.0,1,0.14582701696819458,50
4837,2,10501,3717,6784,0,0,0,1.0,1,1.0,1,1.0,1,0.12997422047985435,46
4838,2,10503,3719,6784,0,0,0,1.0,1,1.0,1,1.0,1,0.1458774133093427,47
4839,3,10506,3721,6785,0,0,0,1.0,1,1.0,1,1.0,1,0.14597202984550114,45
4840,1,10507,3722,6785,0,0,0,1.0,1,1.0,1,1.0,1,0.17924286485420787,45
4841,6,10513,3723,6790,0,0,0,1.0,1,1.0,1,1.0,1,0.17637328842812738,43
4842,4,10517,3725,6792,0,0,0,1.0,1,1.0,1,1.0,1,0.19311117945527148,43
4843,6,10523,3726,6797,0,0,0,1.0,1,1.0,1,1.0,1,0.1764241522526845,44
4844,1,10524,3726,6798,0,0,0,1.0,1,1.0,1,1.0,1,0.1989464606399465,43
4845,2,10526,3728,6798,0,0,0,1.0,1,1.0,1,1.0,1,0.2430225637319297,44
4846,6,10532,3729,6803,0,0,0,1.0,1,1.0,1,1.0,1,0.13899537931587136,43
4847,2,10534,3731,6803,0,0,0,1.0,1,1.0,1,1.0,1,0.15638850092927314,42
4848,9,10543,3734,6809,0,0,0,1.0,1,1.0,1,1.0,1,0.22237645700713649,41
4849,4,10547,3734,6813,0,0,0,1.0,1,1.0,1,1.0,1,0.18568283988927525,41
4850,5,10552,3734,6818,0,0,0,1.0,1,1.0,1,1.0,1,0.21239922134959244,41
4851,3,10555,3734,6821,0,0,0,1.0,1,1.0,1,1.0,1,0.16467694637120311,41
4852,1,10556,3734,6822,0,0,0,1.0,1,1.0,1,1.0,1,0.15445796831428424,43
4853,0,10556,3734,6822,0,0,0,1.0,1,1.0,1,1.0,1,0.17273278730796615,44
4854,1,10557,3735,6822,0,0,0,1.0,1,1.0,1,1.0,1,0.1907513659332604,45
4855,0,10557,3735,6822,0,0,0,1.0,1,1.0,1,1.0,1,0.1736737917549336,44
4856,1,10558,3735,6823,0,0,0,1.0,1,1.0,1,1.0,1,0.165052503717089,44
4857,1,10559,3735,6824,0,0,0,1.0,1,1.0,1,1.0,1,0.16846194862669472,44
4858,0,10559,3735,6824,0,0,0,1.0,1,1.0,1,1.0,1,0.16976448202192657,45
4859,1,10560,3735,6825,0,0,0,1.0,1,1.0,1,1.0,1,0.15218869922555833,46
4860,0,10560,3735,6825,0,0,0,1.0,1,1.0,1,1.0,1,0.15218869922555833,46
4861,1,10561,3735,6826,0,0,0,1.0,1,1.0,1,1.0,1,0.12871315331704422,46
4862,0,10561,3735,6826,0,0,0,1.0,1,1.0,1,1.0,1,0.14028917033849317,47
4863,1,10562,3736,6826,0,0,0,1.0,1,1.0,1,1.0,1,0.14717494724069433,47
4864,1,10563,3736,6827,0,0,0,1.0,1,1.0,1,1.0,1,0.13784668972503075,47
4865,2,10565,3736,6829,0,0,0,1.0,1,1.0,1,1.0,1,0.12485064613918861,48
4866,4,10569,3738,6831,0,0,0,1.0,1,1.0,1,1.0,1,0.11239684659768016,49
4867,1,10570,3738,6832,0,0,0,1.0,1,1.0,1,1.0,1,0.11410290885976654,50
4868,1,10571,3739,6832,0,0,0,1.0,1,1.0,1,1.0,1,0.11042324733103914,50
4869,0,10571,3739,6832,0,0,0,1.0,1,1.0,1,1.0,1,0.11042324733103914,50
4870,2,10573,3741,6832,0,0,0,1.0,1,1.0,1,1.0,1,0.14812351433045226,52
4871,3,10576,3741,6835,0,0,0,1.0,1,1.0,1,1.0,1,0.11199684004880239,52
4872,2,10578,3742,6836,0,0,0,1.0,1,1.0,1,1.0,1,0.12237390443872954,53
4873,4,10582,3742,6840,0,0,0,1.0,1,1.0,1,1.0,1,0.10080987768059829,55
4874,0,10582,3742,6840,0,0,0,1.0,1,1.0,1,1.0,1,0.09314366221468902,56
4875,0,10582,3742,6840,0,0,0,1.0,1,1.0,1,1.0,1,0.08056326933994888,55
4876,3,10585,3745,6840,0,0,0,1.0,1,1.0,1,1.0,1,0.13907874533682082,55
4877,4,10589,3747,6842,0,0,0,1.0,1,1.0,1,1.0,1,0.1816540294419247,54
4878,2,10591,3747,6844,0,0,0,1.0,1,1.0,1,1.0,1,0.16639464025044745,53
4879,3,10594,3749,6845,0,0,0,1.0,1,1.0,1,1.0,1,0.22625947020638082,54
4880,4,10598,3749,6849,0,0,0,1.0,1,1.0,1,1.0,1,0.18546818547579774,54
4881,3,10601,3750,6851,0,0,0,1.0,1,1.0,1,1.0,1,0.1596003848031962,53
4882,2,10603,3750,6853,0,0,0,1.0,1,1.0,1,1.0,1,0.15783559275192008,53
4883,0,10603,3750,6853,0,0,0,1.0,1,1.0,1,1.0,1,0.15553922730535535,53
4884,3,10606,3751,6855,0,0,0,1.0,1,1.0,1,1.0,1,0.15212020413571278,51
4885,1,10607,3752,6855,0,0,0,1.0,1,1.0,1,1.0,1,0.1737653891431626,50
4886,1,10608,3752,6856,0,0,0,1.0,1,1.0,1,1.0,1,0.1726719958218218,48
4887,0,10608,3752,6856,0,0,0,1.0,1,1.0,1,1.0,1,0.1726719958218218,48
4888,2,10610,3753,6857,0,0,0,1.0,1,1.0,1,1.0,1,0.17243900573121698,48
4889,0,10610,3753,6857,0,0,0,1.0,1,1.0,1,1.0,1,0.17243900573121698,48
4890,1,10611,3753,6858,0,0,0,1.0,1,1.0,1,1.0,1,0.16242345433602884,49
4891,1,10612,3754,6858,0,0,0,1.0,1,1.0,1,1.0,1,0.18934601241361668,50
4892,0,10612,3754,6858,0,0,0,1.0,1,1.0,1,1.0,1,0.19898142271625005,49
4893,0,10612,3754,6858,0,0,0,1.0,1,1.0,1,1.0,1,0.20178867285048804,50
4894,2,10614,3754,6860,0,0,0,1.0,1,1.0,1,1.0,1,0.17385856718032486,51
4895,3,10617,3754,6863,0,0,0,1.0,1,1.0,1,1.0,1,0.16090942375053052,52
4896,2,10619,3754,6865,0,0,0,1.0,1,1.0,1,1.0,1,0.14131508346772237,53
4897,1,10620,3754,6866,0,0,0,1.0,1,1.0,1,1.0,1,0.12097104330039105,53
4898,1,10621,3754,6867,0,0,0,1.0,1,1.0,1,1.0,1,0.11639898888698127,53
4899,2,10623,3756,6867,0,0,0,1.0,1,1.0,1,1.0,1,0.09883178546487031,55
4900,1,10624,3757,6867,0,0,0,1.0,1,1.0,1,1.0,1,0.10044423747078117,55
4901,1,10625,3758,6867,0,0,0,1.0,1,1.0,1,1.0,1,0.09167056140467636,56
4902,3,10628,3761,6867,0,0,0,1.0,1,1.0,1,1.0,1,0.15140315718011846,58
4903,4,10632,3763,6869,0,0,0,1.0,1,1.0,1,1.0,1,0.1306654849152736,58
4904,4,10636,3765,6871,0,0,0,1.0,1,1.0,1,1.0,1,0.13937657162230588,57
4905,0,10636,3765,6871,0,0,0,1.0,1,1.0,1,1.0,1,0.15023324441362162,54
4906,2,10638,3765,6873,0,0,0,1.0,1,1.0,1,1.0,1,0.15095363309061838,55
4907,2,10640,3765,6875,0,0,0,1.0,1,1.0,1,1.0,1,0.1373079408220997,52
4908,4,10644,3767,6877,0,0,0,1.0,1,1.0,1,1.0,1,0.12809906667041301,53
4909,0,10644,3767,6877,0,0,0,1.0,1,1.0,1,1.0,1,0.13336213963875726,52
4910,2,10646,3768,6878,0,0,0,1.0,1,1.0,1,1.0,1,0.14689073958880636,53
4911,3,10649,3768,6881,0,0,0,1.0,1,1.0,1,1.0,1,0.12127063890490054,55
4912,2,10651,3769,6882,0,0,0,1.0,1,1.0,1,1.0,1,0.13183044215772788,54
4913,0,10651,3769,6882,0,0,0,1.0,1,1.0,1,1.0,1,0.12386999836142992,53
4914,2,10653,3769,6884,0,0,0,1.0,1,1.0,1,1.0,1,0.12185547565665643,53
4915,2,10655,3770,6885,0,0,0,1.0,1,1.0,1,1.0,1,0.11867982979230825,54
4916,1,10656,3771,6885,0,0,0,1.0,1,1.0,1,1.0,1,0.12957177630941238,52
4917,0,10656,3771,6885,0,0,0,1.0,1,1.0,1,1.0,1,0.13271306723104967,52
4918,2,10658,3773,6885,0,0,0,1.0,1,1.0,1,1.0,1,0.1921701174608282,51
4919,4,10662,3774,6888,0,0,0,1.0,1,1.0,1,1.0,1,0.20345950301634447,50
4920,5,10667,3774,6893,0,0,0,1.0,1,1.0,1,1.0,1,0.17218772700690135,51
4921,3,10670,3775,6895,0,0,0,1.0,1,1.0,1,1.0,1,0.18073072645423655,51
4922,3,10673,3776,6897,0,0,0,1.0,1,1.0,1,1.0,1,0.14092281105397375,53
4923,0,10673,3776,6897,0,0,0,1.0,1,1.0,1,1.0,1,0.14092281105397375,53
4924,3,10676,3777,6899,0,0,0,1.0,1,1.0,1,1.0,1,0.1402730623762086,55
4925,1,10677,3778,6899,0,0,0,1.0,1,1.0,1,1.0,1,0.13912222400212687,56
4926,4,10681,3778,6903,0,0,0,1.0,1,1.0,1,1.0,1,0.11132464156889967,55
4927,3,10684,3780,6904,0,0,0,1.0,1,1.0,1,1.0,1,0.11433677260527553,55
4928,0,10684,3780,6904,0,0,0,1.0,1,1.0,1,1.0,1,0.11433677260527553,55
4929,0,10684,3780,6904,0,0,0,1.0,1,1.0,1,1.0,1,0.1127317349315926,56
4930,1,10685,3781,6904,0,0,0,1.0,1,1.0,1,1.0,1,0.12505360332123827,58
4931,3,10688,3781,6907,0,0,0,1.0,1,1.0,1,1.0,1,0.09295129254599656,59
4932,0,10688,3781,6907,0,0,0,1.0,1,1.0,1,1.0,1,0.10496468059707886,60
4933,0,10688,3781,6907,0,0,0,1.0,1,1.0,1,1.0,1,0.10496468059707886,60
4934,1,10689,3782,6907,0,0,0,1.0,1,1.0,1,1.0,1,0.13265092983284651,60
4935,2,10691,3782,6909,0,0,0,1.0,1,1.0,1,1.0,1,0.10627577509013907,60
4936,4,10695,3784,6911,0,0,0,1.0,1,1.0,1,1.0,1,0.13944864398472037,61
4937,2,10697,3784,6913,0,0,0,1.0,1,1.0,1,1.0,1,0.13309026328955134,62
4938,3,10700,3784,6916,0,0,0,1.0,1,1.0,1,1.0,1,0.11809708590067632,62
4939,4,10704,3786,6918,0,0,0,1.0,1,1.0,1,1.0,1,0.14394259883024504,64
4940,3,10707,3786,6921,0,0,0,1.0,1,1.0,1,1.0,1,0.13891638328160535,67
4941,3,10710,3787,6923,0,0,0,1.0,1,1.0,1,1.0,1,0.11682502593308394,66
4942,1,10711,3788,6923,0,0,0,1.0,1,1.0,1,1.0,1,0.12180173507855832,67
4943,1,10712,3788,6924,0,0,0,1.0,1,1.0,1,1.0,1,0.1278520714287455,65
4944,1,10713,3789,6924,0,0,0,1.0,1,1.0,1,1.0,1,0.1455066586593156,65
4945,0,10713,3789,6924,0,0,0,1.0,1,1.0,1,1.0,1,0.15287353035882,62
4946,8,10721,3790,6931,0,0,0,1.0,1,1.0,1,1.0,1,0.11199372515417264,61
4947,2,10723,3791,6932,0,0,0,1.0,1,1.0,1,1.0,1,0.11185815821133578,59
4948,1,10724,3792,6932,0,0,0,1.0,1,1.0,1,1.0,1,0.1264275412323395,59
4949,0,10724,3792,6932,0,0,0,1.0,1,1.0,1,1.0,1,0.13523436199161776,57
4950,5,10729,3796,6933,0,0,0,1.0,1,1.0,1,1.0,1,0.1423526708769776,58
4951,5,10734,3799,6935,0,0,0,1.0,1,1.0,1,1.0,1,0.10227544273249452,55
4952,2,10736,3801,6935,0,0,0,1.0,1,1.0,1,1.0,1,0.13488110605662798,53
4953,5,10741,3805,6936,0,0,0,1.0,1,1.0,1,1.0,1,0.1680370030418998,54
4954,1,10742,3805,6937,0,0,0,1.0,1,1.0,1,1.0,1,0.12254093380802265,52
4955,0,10742,3805,6937,0,0,0,1.0,1,1.0,1,1.0,1,0.12730125732376651,51
4956,3,10745,3805,6940,0,0,0,1.0,1,1.0,1,1.0,1,0.1256734920935284,47
4957,3,10748,3806,6942,0,0,0,1.0,1,1.0,1,1.0,1,0.1080141765124347,48
4958,0,10748,3806,6942,0,0,0,1.0,1,1.0,1,1.0,1,0.09388776888339044,47
4959,0,10748,3806,6942,0,0,0,1.0,1,1.0,1,1.0,1,0.09388776888339044,47
4960,1,10749,3806,6943,0,0,0,1.0,1,1.0,1,1.0,1,0.10571902036532926,48
4961,3,10752,3808,6944,0,0,0,1.0,1,1.0,1,1.0,1,0.10201938626383117,49
4962,0,10752,3808,6944,0,0,0,1.0,1,1.0,1,1.0,1,0.10201938626383117,49
4963,0,10752,3808,6944,0,0,0,1.0,1,1.0,1,1.0,1,0.12169719297412791,51
4964,3,10755,3810,6945,0,0,0,1.0,1,1.0,1,1.0,1,0.16634890856465062,51
4965,3,10758,3811,6947,0,0,0,1.0,1,1.0,1,1.0,1,0.11082152301878631,51
4966,4,10762,3811,6951,0,0,0,1.0,1,1.0,1,1.0,1,0.06820854490044133,51
4967,1,10763,3812,6951,0,0,0,1.0,1,1.0,1,1.0,1,0.08762531273973607,51
4968,2,10765,3814,6951,0,0,0,1.0,1,1.0,1,1.0,1,0.10068442814690162,52
4969,2,10767,3815,6952,0,0,0,1.0,1,1.0,1,1.0,1,0.127191828455046,53
4970,3,10770,3816,6954,0,0,0,1.0,1,1.0,1,1.0,1,0.15987874380846998,54
4971,6,10776,3816,6960,0,0,0,1.0,1,1.0,1,1.0,1,0.10740581075206884,55
4972,4,10780,3818,6962,0,0,0,1.0,1,1.0,1,1.0,1,0.1845320911202863,56
4973,7,10787,3819,6968,0,0,0,1.0,1,1.0,1,1.0,1,0.1492675599754582,57
4974,2,10789,3819,6970,0,0,0,1.0,1,1.0,1,1.0,1,0.16740240980201984,56
4975,4,10793,3819,6974,0,0,0,1.0,1,1.0,1,1.0,1,0.10590453946915995,57
4976,2,10795,3819,6976,0,0,0,1.0,1,1.0,1,1.0,1,0.08550116394593864,57
4977,1,10796,3819,6977,0,0,0,1.0,1,1.0,1,1.0,1,0.08349832883613331,57
4978,2,10798,3821,6977,0,0,0,1.0,1,1.0,1,1.0,1,0.128741233019478,58
4979,1,10799,3822,6977,0,0,0,1.0,1,1.0,1,1.0,1,0.13936041748548134,58
4980,0,10799,3822,6977,0,0,0,1.0,1,1.0,1,1.0,1,0.14687496737337263,59
4981,11,10810,3823,6987,0,0,0,1.0,1,1.0,1,1.0,1,0.08340250361224624,60
4982,1,10811,3823,6988,0,0,0,1.0,1,1.0,1,1.0,1,0.06863386654108536,61
4983,7,10818,3826,6992,0,0,0,1.0,1,1.0,1,1.0,1,0.06618625985203383,61
4984,2,10820,3828,6992,0,0,0,1.0,1,1.0,1,1.0,1,0.07985107784091044,59
4985,1,10821,3828,6993,0,0,0,1.0,1,1.0,1,1.0,1,0.07683451593458684,58
4986,2,10823,3828,6995,0,0,0,1.0,1,1.0,1,1.0,1,0.06618025348913381,59
4987,3,10826,3830,6996,0,0,0,1.0,1,1.0,1,1.0,1,0.09294645838975503,58
4988,2,10828,3831,6997,0,0,0,1.0,1,1.0,1,1.0,1,0.0899191603913944,57
4989,3,10831,3834,6997,0,0,0,1.0,1,1.0,1,1.0,1,0.15735564301257027,54
4990,4,10835,3835,7000,0,0,0,1.0,1,1.0,1,1.0,1,0.16521923305358732,53
4991,7,10842,3839,7003,0,0,0,1.0,1,1.0,1,1.0,1,0.1324425313880425,52
4992,2,10844,3841,7003,0,0,0,1.0,1,1.0,1,1.0,1,0.18301894467135454,48
4993,2,10846,3843,7003,0,0,0,1.0,1,1.0,1,1.0,1,0.1948419647300239,48
4994,5,10851,3846,7005,0,0,0,1.0,1,1.0,1,1.0,1,0.20751273013464805,45
4995,2,10853,3848,7005,0,0,0,1.0,1,1.0,1,1.0,1,0.22113891503302432,45
4996,6,10859,3849,7010,0,0,0,1.0,1,1.0,1,1.0,1,0.12445413013471501,45
4997,1,10860,3849,7011,0,0,0,1.0,1,1.0,1,1.0,1,0.1382091667275678,42
4998,0,10860,3849,7011,0,0,0,1.0,1,1.0,1,1.0,1,0.12249477950415788,44
4999,3,10863,3851,7012,0,0,0,1.0,1,1.0,1,1.0,1,0.16623159860565154,44
5000,2,10865,3852,7013,0,0,0,1.0,1,1.0,1,1.0,1,0.21774954685178616,42
5001,3,10868,3852,7016,0,0,0,1.0,1,1.0,1,1.0,1,0.167449105659284,42
5002,2,10870,3853,7017,0,0,0,1.0,1,1.0,1,1.0,1,0.13714429069616965,41
5003,1,10871,3854,7017,0,0,0,1.0,1,1.0,1,1.0,1,0.20516566166083794,41
5004,0,10871,3854,7017,0,0,0,1.0,1,1.0,1,1.0,1,0.2127502788364109,41
5005,0,10871,3854,7017,0,0,0,1.0,1,1.0,1,1.0,1,0.2127502788364109,41
5006,2,10873,3854,7019,0,0,0,1.0,1,1.0,1,1.0,1,0.17656520159490124,42
5007,1,10874,3854,7020,0,0,0,1.0,1,1.0,1,1.0,1,0.16199174620804135,43
5008,2,10876,3854,7022,0,0,0,1.0,1,1.0,1,1.0,1,0.14867358257837063,46
5009,4,10880,3855,7025,0,0,0,1.0,1,1.0,1,1.0,1,0.14967012264585997,46
5010,2,10882,3855,7027,0,0,0,1.0,1,1.0,1,1.0,1,0.15494015320050336,46
5011,1,10883,3855,7028,0,0,0,1.0,1,1.0,1,1.0,1,0.13894364330349088,47
5012,0,10883,3855,7028,0,0,0,1.0,1,1.0,1,1.0,1,0.14626116687427967,48
5013,0,10883,3855,7028,0,0,0,1.0,1,1.0,1,1.0,1,0.14626116687427967,48
5014,0,10883,3855,7028,0,0,0,1.0,1,1.0,1,1.0,1,0.15362197550550688,49
5015,2,10885,3856,7029,0,0,0,1.0,1,1.0,1,1.0,1,0.17599367197619145,50
5016,4,10889,3857,7032,0,0,0,1.0,1,1.0,1,1.0,1,0.18727520634017128,51
5017,2,10891,3857,7034,0,0,0,1.0,1,1.0,1,1.0,1,0.1584717614992609,51
5018,0,10891,3857,7034,0,0,0,1.0,1,1.0,1,1.0,1,0.1584717614992609,51
5019,3,10894,3860,7034,0,0,0,1.0,1,1.0,1,1.0,1,0.17978740110693775,51
5020,0,10894,3860,7034,0,0,0,1.0,1,1.0,1,1.0,1,0.17978740110693775,51
5021,5,10899,3861,7038,0,0,0,1.0,1,1.0,1,1.0,1,0.15998417504226675,52
5022,0,10899,3861,7038,0,0,0,1.0,1,1.0,1,1.0,1,0.15998417504226675,52
5023,4,10903,3864,7039,0,0,0,1.0,1,1.0,1,1.0,1,0.16262138461108847,52
5024,2,10905,3866,7039,0,0,0,1.0,1,1.0,1,1.0,1,0.17696237109928772,51
5025,0,10905,3866,7039,0,0,0,1.0,1,1.0,1,1.0,1,0.16213267573319076,50
5026,9,10914,3867,7047,0,0,0,1.0,1,1.0,1,1.0,1,0.13501893232351736,49
5027,1,10915,3868,7047,0,0,0,1.0,1,1.0,1,1.0,1,0.14563940117904153,47
5028,1,10916,3869,7047,0,0,0,1.0,1,1.0,1,1.0,1,0.1169742425611751,47
5029,3,10919,3870,7049,0,0,0,1.0,1,1.0,1,1.0,1,0.13856532382979966,46
5030,1,10920,3871,7049,0,0,0,1.0,1,1.0,1,1.0,1,0.1396577867068493,48
5031,1,10921,3871,7050,0,0,0,1.0,1,1.0,1,1.0,1,0.12623868460642815,46
5032,1,10922,3872,7050,0,0,0,1.0,1,1.0,1,1.0,1,0.1385270357379768,46
5033,5,10927,3875,7052,0,0,0,1.0,1,1.0,1,1.0,1,0.16782303928878267,47
5034,4,10931,3876,7055,0,0,0,1.0,1,1.0,1,1.0,1,0.1777734059220638,48
5035,2,10933,3876,7057,0,0,0,1.0,1,1.0,1,1.0,1,0.15559427023348113,47
5036,2,10935,3876,7059,0,0,0,1.0,1,1.0,1,1.0,1,0.11027322794951881,47
5037,0,10935,3876,7059,0,0,0,1.0,1,1.0,1,1.0,1,0.0970601999303766,47
5038,1,10936,3876,7060,0,0,0,1.0,1,1.0,1,1.0,1,0.0984702211296285,48
5039,2,10938,3876,7062,0,0,0,1.0,1,1.0,1,1.0,1,0.11248409848828894,47
5040,1,10939,3876,7063,0,0,0,1.0,1,1.0,1,1.0,1,0.10417020660943663,48
5041,0,10939,3876,7063,0,0,0,1.0,1,1.0,1,1.0,1,0.11660175489354,49
5042,2,10941,3876,7065,0,0,0,1.0,1,1.0,1,1.0,1,0.09045694769979523,50
5043,0,10941,3876,7065,0,0,0,1.0,1,1.0,1,1.0,1,0.07347065450404804,51
5044,0,10941,3876,7065,0,0,0,1.0,1,1.0,1,1.0,1,0.07347065450404804,51
5045,0,10941,3876,7065,0,0,0,1.0,1,1.0,1,1.0,1,0.07347065450404804,51
5046,2,10943,3878,7065,0,0,0,1.0,1,1.0,1,1.0,1,0.08498432676180592,52
5047,2,10945,3878,7067,0,0,0,1.0,1,1.0,1,1.0,1,0.10092355118953414,52
5048,0,10945,3878,7067,0,0,0,1.0,1,1.0,1,1.0,1,0.10092355118953414,52
5049,2,10947,3878,7069,0,0,0,1.0,1,1.0,1,1.0,1,0.10796675370872919,52
5050,2,10949,3879,7070,0,0,0,1.0,1,1.0,1,1.0,1,0.08239665715526587,55
5051,2,10951,3879,7072,0,0,0,1.0,1,1.0,1,1.0,1,0.08653016855474943,55
5052,0,10951,3879,7072,0,0,0,1.0,1,1.0,1,1.0,1,0.08653016855474943,55
5053,0,10951,3879,7072,0,0,0,1.0,1,1.0,1,1.0,1,0.09710302282442868,54
5054,1,10952,3880,7072,0,0,0,1.0,1,1.0,1,1.0,1,0.10605198368243741,54
5055,1,10953,3880,7073,0,0,0,1.0,1,1.0,1,1.0,1,0.10814402873490322,54
5056,1,10954,3880,7074,0,0,0,1.0,1,1.0,1,1.0,1,0.10719679976952817,55
5057,1,10955,3880,7075,0,0,0,1.0,1,1.0,1,1.0,1,0.1098030587778782,56
5058,2,10957,3881,7076,0,0,0,1.0,1,1.0,1,1.0,1,0.10768129398433351,58
5059,2,10959,3881,7078,0,0,0,1.0,1,1.0,1,1.0,1,0.09358857312740784,58
5060,2,10961,3882,7079,0,0,0,1.0,1,1.0,1,1.0,1,0.08296328097023675,59
5061,1,10962,3882,7080,0,0,0,1.0,1,1.0,1,1.0,1,0.06736774721621781,58
5062,1,10963,3883,7080,0,0,0,1.0,1,1.0,1,1.0,1,0.09045556445542031,58
5063,4,10967,3886,7081,0,0,0,1.0,1,1.0,1,1.0,1,0.10365722569521926,57
5064,4,10971,3889,7082,0,0,0,1.0,1,1.0,1,1.0,1,0.14170927167704492,57
5065,5,10976,3892,7084,0,0,0,1.0,1,1.0,1,1.0,1,0.15495405274690346,56
5066,3,10979,3894,7085,0,0,0,1.0,1,1.0,1,1.0,1,0.21057152356155812,55
5067,2,10981,3894,7087,0,0,0,1.0,1,1.0,1,1.0,1,0.17130730007474726,54
5068,5,10986,3896,7090,0,0,0,1.0,1,1.0,1,1.0,1,0.15833923840714323,54
5069,4,10990,3897,7093,0,0,0,1.0,1,1.0,1,1.0,1,0.16549392000371965,53
5070,1,10991,3897,7094,0,0,0,1.0,1,1.0,1,1.0,1,0.18432468829761076,53
5071,7,10998,3897,7101,0,0,0,1.0,1,1.0,1,1.0,1,0.10057079080507575,53
5072,4,11002,3897,7105,0,0,0,1.0,1,1.0,1,1.0,1,0.07467737946853165,53
5073,1,11003,3897,7106,0,0,0,1.0,1,1.0,1,1.0,1,0.08085883816891537,53
5074,1,11004,3897,7107,0,0,0,1.0,1,1.0,1,1.0,1,0.09313126110122748,52
5075,0,11004,3897,7107,0,0,0,1.0,1,1.0,1,1.0,1,0.09313126110122748,52
5076,2,11006,3897,7109,0,0,0,1.0,1,1.0,1,1.0,1,0.059161341238045166,55
5077,5,11011,3899,7112,0,0,0,1.0,1,1.0,1,1.0,1,0.09725678452694395,55
5078,1,11012,3899,7113,0,0,0,1.0,1,1.0,1,1.0,1,0.09409989164343192,55
5079,2,11014,3899,7115,0,0,0,1.0,1,1.0,1,1.0,1,0.10940683570650221,54
5080,2,11016,3900,7116,0,0,0,1.0,1,1.0,1,1.0,1,0.1339421862491278,55
5081,10,11026,3900,7126,0,0,0,1.0,1,1.0,1,1.0,1,0.08622531829524131,57
5082,1,11027,3900,7127,0,0,0,1.0,1,1.0,1,1.0,1,0.09533768280951191,57
5083,2,11029,3900,7129,0,0,0,1.0,1,1.0,1,1.0,1,0.07901728096066814,58
5084,2,11031,3900,7131,0,0,0,1.0,1,1.0,1,1.0,1,0.09536101760525957,58
5085,3,11034,3901,7133,0,0,0,1.0,1,1.0,1,1.0,1,0.0788226982066512,59
5086,1,11035,3902,7133,0,0,0,1.0,1,1.0,1,1.0,1,0.10325020819530675,60
5087,3,11038,3904,7134,0,0,0,1.0,1,1.0,1,1.0,1,0.15965590892542514,61
5088,4,11042,3905,7137,0,0,0,1.0,1,1.0,1,1.0,1,0.14363093247210898,62
5089,4,11046,3907,7139,0,0,0,1.0,1,1.0,1,1.0,1,0.12512629301324746,63
5090,0,11046,3907,7139,0,0,0,1.0,1,1.0,1,1.0,1,0.12512629301324746,63
5091,4,11050,3908,7142,0,0,0,1.0,1,1.0,1,1.0,1,0.11275415418983407,63
5092,1,11051,3908,7143,0,0,0,1.0,1,1.0,1,1.0,1,0.10263385499292944,63
5093,3,11054,3910,7144,0,0,0,1.0,1,1.0,1,1.0,1,0.09872272305945697,63
5094,3,11057,3913,7144,0,0,0,1.0,1,1.0,1,1.0,1,0.1250467851139317,64
5095,1,11058,3913,7145,0,0,0,1.0,1,1.0,1,1.0,1,0.1157725369679135,64
5096,6,11064,3914,7150,0,0,0,1.0,1,1.0,1,1.0,1,0.06418142825341325,67
5097,0,11064,3914,7150,0,0,0,1.0,1,1.0,1,1.0,1,0.07474308266365307,67
5098,1,11065,3915,7150,0,0,0,1.0,1,1.0,1,1.0,1,0.09312257732858692,68
5099,1,11066,3915,7151,0,0,0,1.0,1,1.0,1,1.0,1,0.09219782510492401,70
5100,3,11069,3915,7154,0,0,0,1.0,1,1.0,1,1.0,1,0.09444710154801672,71
5101,0,11069,3915,7154,0,0,0,1.0,1,1.0,1,1.0,1,0.09444710154801672,71
5102,8,11077,3919,7158,0,0,0,1.0,1,1.0,1,1.0,1,0.1134109440066827,70
5103,1,11078,3920,7158,0,0,0,1.0,1,1.0,1,1.0,1,0.09782589940798463,67
5104,5,11083,3923,7160,0,0,0,1.0,1,1.0,1,1.0,1,0.11835070477405732,67
5105,6,11089,3927,7162,0,0,0,1.0,1,1.0,1,1.0,1,0.10138059630826785,63
5106,2,11091,3928,7163,0,0,0,1.0,1,1.0,1,1.0,1,0.11736626979327604,63
5107,4,11095,3932,7163,0,0,0,1.0,1,1.0,1,1.0,1,0.12757583536582667,60
5108,3,11098,3934,7164,0,0,0,1.0,1,1.0,1,1.0,1,0.15009832893788103,56
5109,5,11103,3937,7166,0,0,0,1.0,1,1.0,1,1.0,1,0.1585432841939633,56
5110,1,11104,3938,7166,0,0,0,1.0,1,1.0,1,1.0,1,0.14022639356088792,52
5111,8,11112,3941,7171,0,0,0,1.0,1,1.0,1,1.0,1,0.13069593025929166,51
5112,1,11113,3942,7171,0,0,0,1.0,1,1.0,1,1.0,1,0.13667687403821707,50
5113,3,11116,3945,7171,0,0,0,1.0,1,1.0,1,1.0,1,0.16097043104723027,48
5114,0,11116,3945,7171,0,0,0,1.0,1,1.0,1,1.0,1,0.16956643383977996,46
5115,0,11116,3945,7171,0,0,0,1.0,1,1.0,1,1.0,1,0.1594417552429065,44
5116,4,11120,3947,7173,0,0,0,1.0,1,1.0,1,1.0,1,0.1732297955894448,44
5117,3,11123,3947,7176,0,0,0,1.0,1,1.0,1,1.0,1,0.12295957584614002,46
5118,3,11126,3947,7179,0,0,0,1.0,1,1.0,1,1.0,1,0.10495726449206642,46
5119,1,11127,3947,7180,0,0,0,1.0,1,1.0,1,1.0,1,0.12283671850644945,46
5120,2,11129,3947,7182,0,0,0,1.0,1,1.0,1,1.0,1,0.09343464109812556,46
5121,2,11131,3948,7183,0,0,0,1.0,1,1.0,1,1.0,1,0.08309156084580539,46
5122,3,11134,3951,7183,0,0,0,1.0,1,1.0,1,1.0,1,0.14949139490358626,46
5123,3,11137,3953,7184,0,0,0,1.0,1,1.0,1,1.0,1,0.1738969253097468,45
5124,4,11141,3955,7186,0,0,0,1.0,1,1.0,1,1.0,1,0.150009490551217,47
5125,3,11144,3955,7189,0,0,0,1.0,1,1.0,1,1.0,1,0.1775073265178105,50
5126,6,11150,3957,7193,0,0,0,1.0,1,1.0,1,1.0,1,0.10265370243317848,50
5127,2,11152,3957,7195,0,0,0,1.0,1,1.0,1,1.0,1,0.09387050846285357,52
5128,1,11153,3957,7196,0,0,0,1.0,1,1.0,1,1.0,1,0.08869623286756376,53
5129,0,11153,3957,7196,0,0,0,1.0,1,1.0,1,1.0,1,0.09969101368239758,55
5130,1,11154,3958,7196,0,0,0,1.0,1,1.0,1,1.0,1,0.09642250099971757,55
5131,2,11156,3958,7198,0,0,0,1.0,1,1.0,1,1.0,1,0.08718032338134499,54
5132,0,11156,3958,7198,0,0,0,1.0,1,1.0,1,1.0,1,0.10262281986743958,54
5133,0,11156,3958,7198,0,0,0,1.0,1,1.0,1,1.0,1,0.10262281986743958,54
5134,0,11156,3958,7198,0,0,0,1.0,1,1.0,1,1.0,1,0.11924506782604455,53
5135,0,11156,3958,7198,0,0,0,1.0,1,1.0,1,1.0,1,0.13220590951150699,54
5136,2,11158,3958,7200,0,0,0,1.0,1,1.0,1,1.0,1,0.14041906978604882,54
5137,2,11160,3958,7202,0,0,0,1.0,1,1.0,1,1.0,1,0.09645638578662312,54
5138,3,11163,3960,7203,0,0,0,1.0,1,1.0,1,1.0,1,0.13544887372389824,54
5139,1,11164,3961,7203,0,0,0,1.0,1,1.0,1,1.0,1,0.11581702836470491,55
5140,4,11168,3964,7204,0,0,0,1.0,1,1.0,1,1.0,1,0.16791960673870793,55
5141,5,11173,3964,7209,0,0,0,1.0,1,1.0,1,1.0,1,0.11788097872258343,53
5142,4,11177,3966,7211,0,0,0,1.0,1,1.0,1,1.0,1,0.07854587943514502,54
5143,6,11183,3969,7214,0,0,0,1.0,1,1.0,1,1.0,1,0.08522073822831198,52
5144,3,11186,3970,7216,0,0,0,1.0,1,1.0,1,1.0,1,0.049060867085844465,50
5145,4,11190,3971,7219,0,0,0,1.0,1,1.0,1,1.0,1,0.050577571017140464,49
5146,0,11190,3971,7219,0,0,0,1.0,1,1.0,1,1.0,1,0.053465955288226216,49
5147,1,11191,3972,7219,0,0,0,1.0,1,1.0,1,1.0,1,0.057837502969717104,46
5148,1,11192,3973,7219,0,0,0,1.0,1,1.0,1,1.0,1,0.06758465148392051,46
5149,0,11192,3973,7219,0,0,0,1.0,1,1.0,1,1.0,1,0.08569415087406483,45
5150,3,11195,3976,7219,0,0,0,1.0,1,1.0,1,1.0,1,0.13424320975189305,47
5151,4,11199,3976,7223,0,0,0,1.0,1,1.0,1,1.0,1,0.0921584874222557,46
5152,4,11203,3980,7223,0,0,0,1.0,1,1.0,1,1.0,1,0.13308471014451276,46
5153,0,11203,3980,7223,0,0,0,1.0,1,1.0,1,1.0,1,0.13464364722235503,45
5154,2,11205,3981,7224,0,0,0,1.0,1,1.0,1,1.0,1,0.15226892746636708,47
5155,4,11209,3982,7227,0,0,0,1.0,1,1.0,1,1.0,1,0.17040060323599954,47
5156,4,11213,3983,7230,0,0,0,1.0,1,1.0,1,1.0,1,0.10428394663590124,47
5157,1,11214,3984,7230,0,0,0,1.0,1,1.0,1,1.0,1,0.1326303121290359,46
5158,2,11216,3984,7232,0,0,0,1.0,1,1.0,1,1.0,1,0.11634713977331927,47
5159,1,11217,3984,7233,0,0,0,1.0,1,1.0,1,1.0,1,0.12837969473284894,49
5160,1,11218,3984,7234,0,0,0,1.0,1,1.0,1,1.0,1,0.13363115471365156,48
5161,1,11219,3984,7235,0,0,0,1.0,1,1.0,1,1.0,1,0.1128744467107662,48
5162,0,11219,3984,7235,0,0,0,1.0,1,1.0,1,1.0,1,0.10045436092856662,49
5163,1,11220,3984,7236,0,0,0,1.0,1,1.0,1,1.0,1,0.10936005048462759,51
5164,1,11221,3985,7236,0,0,0,1.0,1,1.0,1,1.0,1,0.10452285786309683,51
5165,2,11223,3986,7237,0,0,0,1.0,1,1.0,1,1.0,1,0.09293378968690655,52
5166,4,11227,3988,7239,0,0,0,1.0,1,1.0,1,1.0,1,0.10841149043683629,52
5167,3,11230,3990,7240,0,0,0,1.0,1,1.0,1,1.0,1,0.12235504201237746,52
5168,0,11230,3990,7240,0,0,0,1.0,1,1.0,1,1.0,1,0.12235504201237746,52
5169,2,11232,3992,7240,0,0,0,1.0,1,1.0,1,1.0,1,0.11684727090649777,53
5170,0,11232,3992,7240,0,0,0,1.0,1,1.0,1,1.0,1,0.11684727090649777,53
5171,2,11234,3992,7242,0,0,0,1.0,1,1.0,1,1.0,1,0.09942578992550191,52
5172,1,11235,3993,7242,0,0,0,1.0,1,1.0,1,1.0,1,0.10700916467564553,53
5173,2,11237,3993,7244,0,0,0,1.0,1,1.0,1,1.0,1,0.09846323007282765,54
5174,0,11237,3993,7244,0,0,0,1.0,1,1.0,1,1.0,1,0.09976603287398578,56
5175,5,11242,3994,7248,0,0,0,1.0,1,1.0,1,1.0,1,0.11850275426550282,58
5176,3,11245,3994,7251,0,0,0,1.0,1,1.0,1,1.0,1,0.06617304332111323,58
5177,0,11245,3994,7251,0,0,0,1.0,1,1.0,1,1.0,1,0.08480705055441637,59
5178,3,11248,3996,7252,0,0,0,1.0,1,1.0,1,1.0,1,0.09700387562548816,57
5179,2,11250,3997,7253,0,0,0,1.0,1,1.0,1,1.0,1,0.10527500275376889,58
5180,6,11256,4000,7256,0,0,0,1.0,1,1.0,1,1.0,1,0.1346325108501991,56
5181,5,11261,4001,7260,0,0,0,1.0,1,1.0,1,1.0,1,0.07524325969621093,57
5182,3,11264,4002,7262,0,0,0,1.0,1,1.0,1,1.0,1,0.055428625097555105,56
5183,2,11266,4004,7262,0,0,0,1.0,1,1.0,1,1.0,1,0.10162413017665925,57
5184,1,11267,4005,7262,0,0,0,1.0,1,1.0,1,1.0,1,0.11035724010391379,56
5185,5,11272,4006,7266,0,0,0,1.0,1,1.0,1,1.0,1,0.10814643410888446,56
5186,5,11277,4009,7268,0,0,0,1.0,1,1.0,1,1.0,1,0.1222706536545705,54
5187,1,11278,4009,7269,0,0,0,1.0,1,1.0,1,1.0,1,0.08393607617166735,51
5188,2,11280,4011,7269,0,0,0,1.0,1,1.0,1,1.0,1,0.14922777778176474,50
5189,2,11282,4011,7271,0,0,0,1.0,1,1.0,1,1.0,1,0.08673249561609536,49
5190,1,11283,4012,7271,0,0,0,1.0,1,1.0,1,1.0,1,0.08717742347504853,50
5191,2,11285,4012,7273,0,0,0,1.0,1,1.0,1,1.0,1,0.04345504682168604,50
5192,2,11287,4013,7274,0,0,0,1.0,1,1.0,1,1.0,1,0.06437895677122424,49
5193,0,11287,4013,7274,0,0,0,1.0,1,1.0,1,1.0,1,0.08136776851457565,50
5194,3,11290,4015,7275,0,0,0,1.0,1,1.0,1,1.0,1,0.1547275356819503,51
5195,0,11290,4015,7275,0,0,0,1.0,1,1.0,1,1.0,1,0.1547275356819503,51
5196,4,11294,4015,7279,0,0,0,1.0,1,1.0,1,1.0,1,0.10101547137701018,51
5197,0,11294,4015,7279,0,0,0,1.0,1,1.0,1,1.0,1,0.10101547137701018,51
5198,0,11294,4015,7279,0,0,0,1.0,1,1.0,1,1.0,1,0.10101547137701018,51
5199,1,11295,4015,7280,0,0,0,1.0,1,1.0,1,1.0,1,0.08574285201134198,54
5200,0,11295,4015,7280,0,0,0,1.0,1,1.0,1,1.0,1,0.08574285201134198,54
5201,3,11298,4017,7281,0,0,0,1.0,1,1.0,1,1.0,1,0.09547608041442654,55
5202,0,11298,4017,7281,0,0,0,1.0,1,1.0,1,1.0,1,0.10210758734871013,56
5203,0,11298,4017,7281,0,0,0,1.0,1,1.0,1,1.0,1,0.10210758734871013,56
5204,3,11301,4017,7284,0,0,0,1.0,1,1.0,1,1.0,1,0.1076698401842675,58
5205,2,11303,4017,7286,0,0,0,1.0,1,1.0,1,1.0,1,0.1076698401842675,58
5206,2,11305,4018,7287,0,0,0,1.0,1,1.0,1,1.0,1,0.08250004449767975,58
5207,2,11307,4018,7289,0,0,0,1.0,1,1.0,1,1.0,1,0.0653938506111338,59
5208,2,11309,4019,7290,0,0,0,1.0,1,1.0,1,1.0,1,0.07556285063514714,58
5209,0,11309,4019,7290,0,0,0,1.0,1,1.0,1,1.0,1,0.07556285063514714,58
5210,1,11310,4019,7291,0,0,0,1.0,1,1.0,1,1.0,1,0.08217144051190758,57
5211,1,11311,4020,7291,0,0,0,1.0,1,1.0,1,1.0,1,0.11037140411248827,57
5212,3,11314,4020,7294,0,0,0,1.0,1,1.0,1,1.0,1,0.06722365263243903,59
5213,3,11317,4023,7294,0,0,0,1.0,1,1.0,1,1.0,1,0.11386601527913383,59
5214,3,11320,4025,7295,0,0,0,1.0,1,1.0,1,1.0,1,0.18015724564411947,59
5215,13,11333,4029,7304,0,0,0,1.0,1,1.0,1,1.0,1,0.21377408721387406,58
5216,4,11337,4029,7308,0,0,0,1.0,1,1.0,1,1.0,1,0.17629872346784295,59
5217,5,11342,4031,7311,0,0,0,1.0,1,1.0,1,1.0,1,0.16643303954035937,58
5218,4,11346,4033,7313,0,0,0,1.0,1,1.0,1,1.0,1,0.14054906628260525,58
5219,2,11348,4033,7315,0,0,0,1.0,1,1.0,1,1.0,1,0.1303130978844585,57
5220,4,11352,4036,7316,0,0,0,1.0,1,1.0,1,1.0,1,0.16757237526935517,56
5221,7,11359,4039,7320,0,0,0,1.0,1,1.0,1,1.0,1,0.16867076724542646,58
5222,2,11361,4040,7321,0,0,0,1.0,1,1.0,1,1.0,1,0.1494566465761275,56
5223,0,11361,4040,7321,0,0,0,1.0,1,1.0,1,1.0,1,0.16273382107032108,55
5224,1,11362,4041,7321,0,0,0,1.0,1,1.0,1,1.0,1,0.15460799864002492,56
5225,1,11363,4041,7322,0,0,0,1.0,1,1.0,1,1.0,1,0.14769767221042013,55
5226,3,11366,4042,7324,0,0,0,1.0,1,1.0,1,1.0,1,0.13153312273198028,55
5227,1,11367,4043,7324,0,0,0,1.0,1,1.0,1,1.0,1,0.14725900092480637,53
5228,1,11368,4043,7325,0,0,0,1.0,1,1.0,1,1.0,1,0.13711137037340482,51
5229,2,11370,4044,7326,0,0,0,1.0,1,1.0,1,1.0,1,0.13251967235629877,51
5230,0,11370,4044,7326,0,0,0,1.0,1,1.0,1,1.0,1,0.13393798585329103,51
5231,4,11374,4045,7329,0,0,0,1.0,1,1.0,1,1.0,1,0.10867615748969825,52
5232,3,11377,4046,7331,0,0,0,1.0,1,1.0,1,1.0,1,0.11412433799845877,52
5233,0,11377,4046,7331,0,0,0,1.0,1,1.0,1,1.0,1,0.13267157104481633,53
5234,3,11380,4049,7331,0,0,0,1.0,1,1.0,1,1.0,1,0.15524150914560816,53
5235,2,11382,4050,7332,0,0,0,1.0,1,1.0,1,1.0,1,0.15325096640275657,53
5236,5,11387,4050,7337,0,0,0,1.0,1,1.0,1,1.0,1,0.09798032570054888,52
5237,0,11387,4050,7337,0,0,0,1.0,1,1.0,1,1.0,1,0.1270898182529206,52
5238,1,11388,4051,7337,0,0,0,1.0,1,1.0,1,1.0,1,0.12961793731622728,52
5239,0,11388,4051,7337,0,0,0,1.0,1,1.0,1,1.0,1,0.14209832162569672,51
5240,2,11390,4052,7338,0,0,0,1.0,1,1.0,1,1.0,1,0.1534661432901995,53
5241,5,11395,4052,7343,0,0,0,1.0,1,1.0,1,1.0,1,0.11467106662125852,53
5242,1,11396,4053,7343,0,0,0,1.0,1,1.0,1,1.0,1,0.14219620413969586,51
5243,3,11399,4055,7344,0,0,0,1.0,1,1.0,1,1.0,1,0.17740889403405274,51
5244,2,11401,4056,7345,0,0,0,1.0,1,1.0,1,1.0,1,0.1738657514065097,52
5245,3,11404,4058,7346,0,0,0,1.0,1,1.0,1,1.0,1,0.17718093430663734,53
5246,4,11408,4059,7349,0,0,0,1.0,1,1.0,1,1.0,1,0.12551768634655974,53
5247,2,11410,4060,7350,0,0,0,1.0,1,1.0,1,1.0,1,0.14779310836358556,54
5248,1,11411,4060,7351,0,0,0,1.0,1,1.0,1,1.0,1,0.12717121015073923,54
5249,2,11413,4060,7353,0,0,0,1.0,1,1.0,1,1.0,1,0.12399624166037586,55
5250,2,11415,4061,7354,0,0,0,1.0,1,1.0,1,1.0,1,0.1574040710641884,57
5251,3,11418,4061,7357,0,0,0,1.0,1,1.0,1,1.0,1,0.11044461346558782,58
5252,1,11419,4062,7357,0,0,0,1.0,1,1.0,1,1.0,1,0.12286833787402923,58
5253,3,11422,4065,7357,0,0,0,1.0,1,1.0,1,1.0,1,0.18260100878849997,58
5254,1,11423,4065,7358,0,0,0,1.0,1,1.0,1,1.0,1,0.18955175330702156,59
5255,4,11427,4068,7359,0,0,0,1.0,1,1.0,1,1.0,1,0.1872987307981116,58
5256,3,11430,4068,7362,0,0,0,1.0,1,1.0,1,1.0,1,0.1631965811360411,58
5257,1,11431,4068,7363,0,0,0,1.0,1,1.0,1,1.0,1,0.13483559732184544,57
5258,0,11431,4068,7363,0,0,0,1.0,1,1.0,1,1.0,1,0.14663160617556256,55
5259,0,11431,4068,7363,0,0,0,1.0,1,1.0,1,1.0,1,0.1506449160948909,56
5260,0,11431,4068,7363,0,0,0,1.0,1,1.0,1,1.0,1,0.1597564757877861,55
5261,1,11432,4068,7364,0,0,0,1.0,1,1.0,1,1.0,1,0.1568350678315383,54
5262,2,11434,4070,7364,0,0,0,1.0,1,1.0,1,1.0,1,0.17506400824730797,54
5263,5,11439,4073,7366,0,0,0,1.0,1,1.0,1,1.0,1,0.1813949853234259,55
5264,1,11440,4074,7366,0,0,0,1.0,1,1.0,1,1.0,1,0.20922984341139103,53
5265,7,11447,4079,7368,0,0,0,1.0,1,1.0,1,1.0,1,0.2584104301044189,52
5266,4,11451,4079,7372,0,0,0,1.0,1,1.0,1,1.0,1,0.23542149454958833,49
5267,7,11458,4082,7376,0,0,0,1.0,1,1.0,1,1.0,1,0.20964581589942344,49
5268,2,11460,4083,7377,0,0,0,1.0,1,1.0,1,1.0,1,0.2193286088045025,46
5269,0,11460,4083,7377,0,0,0,1.0,1,1.0,1,1.0,1,0.23348197035510546,45
5270,3,11463,4084,7379,0,0,0,1.0,1,1.0,1,1.0,1,0.21137328620605758,46
5271,10,11473,4087,7386,0,0,0,1.0,1,1.0,1,1.0,1,0.15056386966162438,46
5272,2,11475,4088,7387,0,0,0,1.0,1,1.0,1,1.0,1,0.1200471762092385,45
5273,7,11482,4090,7392,0,0,0,1.0,1,1.0,1,1.0,1,0.19503195760085515,45
5274,5,11487,4091,7396,0,0,0,1.0,1,1.0,1,1.0,1,0.15355286172411137,45
5275,6,11493,4093,7400,0,0,0,1.0,1,1.0,1,1.0,1,0.1816142740499491,46
5276,4,11497,4095,7402,0,0,0,1.0,1,1.0,1,1.0,1,0.1541971085207217,45
5277,0,11497,4095,7402,0,0,0,1.0,1,1.0,1,1.0,1,0.1535975935912494,45
5278,1,11498,4096,7402,0,0,0,1.0,1,1.0,1,1.0,1,0.1734006300365492,44
5279,1,11499,4097,7402,0,0,0,1.0,1,1.0,1,1.0,1,0.18816748689318297,45
5280,0,11499,4097,7402,0,0,0,1.0,1,1.0,1,1.0,1,0.19792353026724918,46
5281,2,11501,4097,7404,0,0,0,1.0,1,1.0,1,1.0,1,0.16928107658589062,46
5282,2,11503,4098,7405,0,0,0,1.0,1,1.0,1,1.0,1,0.19525549447970822,47
5283,2,11505,4098,7407,0,0,0,1.0,1,1.0,1,1.0,1,0.19070824355111882,48
5284,1,11506,4098,7408,0,0,0,1.0,1,1.0,1,1.0,1,0.19380596504556025,48
5285,0,11506,4098,7408,0,0,0,1.0,1,1.0,1,1.0,1,0.18172114371999049,48
5286,4,11510,4098,7412,0,0,0,1.0,1,1.0,1,1.0,1,0.1482744324367133,50
5287,1,11511,4098,7413,0,0,0,1.0,1,1.0,1,1.0,1,0.10935193531680774,50
5288,2,11513,4098,7415,0,0,0,1.0,1,1.0,1,1.0,1,0.10087354882751468,51
5289,1,11514,4098,7416,0,0,0,1.0,1,1.0,1,1.0,1,0.0886075505206043,51
5290,0,11514,4098,7416,0,0,0,1.0,1,1.0,1,1.0,1,0.10122892358037552,52
5291,2,11516,4099,7417,0,0,0,1.0,1,1.0,1,1.0,1,0.13836813139432033,52
5292,3,11519,4099,7420,0,0,0,1.0,1,1.0,1,1.0,1,0.11584941469792887,53
5293,1,11520,4100,7420,0,0,0,1.0,1,1.0,1,1.0,1,0.15305961632843693,51
5294,1,11521,4101,7420,0,0,0,1.0,1,1.0,1,1.0,1,0.18157198888700593,50
5295,3,11524,4101,7423,0,0,0,1.0,1,1.0,1,1.0,1,0.21407127176382573,49
5296,3,11527,4102,7425,0,0,0,1.0,1,1.0,1,1.0,1,0.18903971983902756,48
5297,0,11527,4102,7425,0,0,0,1.0,1,1.0,1,1.0,1,0.22437803322026126,46
5298,0,11527,4102,7425,0,0,0,1.0,1,1.0,1,1.0,1,0.22509081953122118,46
5299,0,11527,4102,7425,0,0,0,1.0,1,1.0,1,1.0,1,0.2321548740674839,47
5300,0,11527,4102,7425,0,0,0,1.0,1,1.0,1,1.0,1,0.2062093574571851,48
5301,1,11528,4103,7425,0,0,0,1.0,1,1.0,1,1.0,1,0.21926100078612387,48
5302,4,11532,4105,7427,0,0,0,1.0,1,1.0,1,1.0,1,0.23225588746605927,49
5303,2,11534,4106,7428,0,0,0,1.0,1,1.0,1,1.0,1,0.21211861168488844,48
5304,2,11536,4106,7430,0,0,0,1.0,1,1.0,1,1.0,1,0.2103905091884262,48
5305,2,11538,4107,7431,0,0,0,1.0,1,1.0,1,1.0,1,0.22106912288388947,47
5306,5,11543,4109,7434,0,0,0,1.0,1,1.0,1,1.0,1,0.1821576086160114,48
5307,1,11544,4109,7435,0,0,0,1.0,1,1.0,1,1.0,1,0.1631481441590799,48
5308,1,11545,4110,7435,0,0,0,1.0,1,1.0,1,1.0,1,0.17673226530173647,47
5309,1,11546,4111,7435,0,0,0,1.0,1,1.0,1,1.0,1,0.2137862181542239,46
5310,4,11550,4112,7438,0,0,0,1.0,1,1.0,1,1.0,1,0.18818189887682632,46
5311,5,11555,4112,7443,0,0,0,1.0,1,1.0,1,1.0,1,0.1300746407942805,46
5312,3,11558,4113,7445,0,0,0,1.0,1,1.0,1,1.0,1,0.147376339670237,46
5313,2,11560,4113,7447,0,0,0,1.0,1,1.0,1,1.0,1,0.1022670145726504,46
5314,0,11560,4113,7447,0,0,0,1.0,1,1.0,1,1.0,1,0.1022670145726504,46
5315,4,11564,4116,7448,0,0,0,1.0,1,1.0,1,1.0,1,0.19356064404690546,47
5316,8,11572,4117,7455,0,0,0,1.0,1,1.0,1,1.0,1,0.09542244636825245,48
5317,2,11574,4119,7455,0,0,0,1.0,1,1.0,1,1.0,1,0.06628766730663183,49
5318,6,11580,4121,7459,0,0,0,1.0,1,1.0,1,1.0,1,0.09615996463435365,49
5319,8,11588,4122,7466,0,0,0,1.0,1,1.0,1,1.0,1,0.11794180052559476,50
5320,7,11595,4123,7472,0,0,0,1.0,1,1.0,1,1.0,1,0.14258413891750762,51
5321,4,11599,4123,7476,0,0,0,1.0,1,1.0,1,1.0,1,0.08985729561277707,52
5322,1,11600,4123,7477,0,0,0,1.0,1,1.0,1,1.0,1,0.0871351689165374,53
5323,1,11601,4123,7478,0,0,0,1.0,1,1.0,1,1.0,1,0.10108561133316495,53
5324,2,11603,4123,7480,0,0,0,1.0,1,1.0,1,1.0,1,0.08068080170422609,55
5325,3,11606,4124,7482,0,0,0,1.0,1,1.0,1,1.0,1,0.09708655780268952,55
5326,1,11607,4125,7482,0,0,0,1.0,1,1.0,1,1.0,1,0.07153126298403853,55
5327,2,11609,4125,7484,0,0,0,1.0,1,1.0,1,1.0,1,0.05588076520928224,56
5328,4,11613,4127,7486,0,0,0,1.0,1,1.0,1,1.0,1,0.10745834372204924,57
5329,1,11614,4127,7487,0,0,0,1.0,1,1.0,1,1.0,1,0.10117214288132655,57
5330,3,11617,4128,7489,0,0,0,1.0,1,1.0,1,1.0,1,0.12398825513783518,56
5331,4,11621,4129,7492,0,0,0,1.0,1,1.0,1,1.0,1,0.0948695328815772,57
5332,1,11622,4129,7493,0,0,0,1.0,1,1.0,1,1.0,1,0.07412121448971343,58
5333,0,11622,4129,7493,0,0,0,1.0,1,1.0,1,1.0,1,0.08590820595261117,59
5334,0,11622,4129,7493,0,0,0,1.0,1,1.0,1,1.0,1,0.08590820595261117,59
5335,1,11623,4130,7493,0,0,0,1.0,1,1.0,1,1.0,1,0.1232109418078695,58
5336,5,11628,4130,7498,0,0,0,1.0,1,1.0,1,1.0,1,0.07203442375294238,59
5337,4,11632,4131,7501,0,0,0,1.0,1,1.0,1,1.0,1,0.10828599278438795,60
5338,2,11634,4131,7503,0,0,0,1.0,1,1.0,1,1.0,1,0.0948930201459103,60
5339,1,11635,4131,7504,0,0,0,1.0,1,1.0,1,1.0,1,0.1049549821120415,60
5340,3,11638,4132,7506,0,0,0,1.0,1,1.0,1,1.0,1,0.12057280884465568,60
5341,3,11641,4133,7508,0,0,0,1.0,1,1.0,1,1.0,1,0.10099540348367674,61
5342,1,11642,4134,7508,0,0,0,1.0,1,1.0,1,1.0,1,0.12364353911487601,59
5343,4,11646,4135,7511,0,0,0,1.0,1,1.0,1,1.0,1,0.07440471132026519,58
5344,2,11648,4137,7511,0,0,0,1.0,1,1.0,1,1.0,1,0.1425912091546159,58
5345,1,11649,4138,7511,0,0,0,1.0,1,1.0,1,1.0,1,0.15312724711871087,54
5346,4,11653,4138,7515,0,0,0,1.0,1,1.0,1,1.0,1,0.09446034105712092,54
5347,2,11655,4140,7515,0,0,0,1.0,1,1.0,1,1.0,1,0.08848958088390582,54
5348,4,11659,4141,7518,0,0,0,1.0,1,1.0,1,1.0,1,0.08278771056000943,55
5349,4,11663,4143,7520,0,0,0,1.0,1,1.0,1,1.0,1,0.11382774235908737,56
5350,2,11665,4144,7521,0,0,0,1.0,1,1.0,1,1.0,1,0.12772913236523825,56
5351,7,11672,4145,7527,0,0,0,1.0,1,1.0,1,1.0,1,0.05025522772378264,57
5352,2,11674,4146,7528,0,0,0,1.0,1,1.0,1,1.0,1,0.09791749992085683,57
5353,0,11674,4146,7528,0,0,0,1.0,1,1.0,1,1.0,1,0.09791749992085683,57
5354,0,11674,4146,7528,0,0,0,1.0,1,1.0,1,1.0,1,0.09171599395014247,56
5355,1,11675,4147,7528,0,0,0,1.0,1,1.0,1,1.0,1,0.09308196364516604,57
5356,0,11675,4147,7528,0,0,0,1.0,1,1.0,1,1.0,1,0.1075863453042376,56
5357,0,11675,4147,7528,0,0,0,1.0,1,1.0,1,1.0,1,0.12007135029765281,56
5358,0,11675,4147,7528,0,0,0,1.0,1,1.0,1,1.0,1,0.10682130791781572,57
5359,1,11676,4148,7528,0,0,0,1.0,1,1.0,1,1.0,1,0.11407866256321615,57
5360,0,11676,4148,7528,0,0,0,1.0,1,1.0,1,1.0,1,0.13720810474595366,55
5361,4,11680,4150,7530,0,0,0,1.0,1,1.0,1,1.0,1,0.14189189787580325,56
5362,1,11681,4151,7530,0,0,0,1.0,1,1.0,1,1.0,1,0.14762466703510516,57
5363,0,11681,4151,7530,0,0,0,1.0,1,1.0,1,1.0,1,0.14762466703510516,57
5364,1,11682,4151,7531,0,0,0,1.0,1,1.0,1,1.0,1,0.14276599681603097,58
5365,4,11686,4152,7534,0,0,0,1.0,1,1.0,1,1.0,1,0.13680998383257403,59
5366,4,11690,4154,7536,0,0,0,1.0,1,1.0,1,1.0,1,0.13420543487418832,60
5367,1,11691,4154,7537,0,0,0,1.0,1,1.0,1,1.0,1,0.11301723429400379,60
5368,2,11693,4155,7538,0,0,0,1.0,1,1.0,1,1.0,1,0.11125402420713305,58
5369,3,11696,4156,7540,0,0,0,1.0,1,1.0,1,1.0,1,0.12506761752194645,58
5370,5,11701,4157,7544,0,0,0,1.0,1,1.0,1,1.0,1,0.15087119758346382,57
5371,5,11706,4159,7547,0,0,0,1.0,1,1.0,1,1.0,1,0.13466888132760327,56
5372,3,11709,4162,7547,0,0,0,1.0,1,1.0,1,1.0,1,0.12000810896560023,55
5373,6,11715,4166,7549,0,0,0,1.0,1,1.0,1,1.0,1,0.20212812707153968,54
5374,3,11718,4168,7550,0,0,0,1.0,1,1.0,1,1.0,1,0.2144312887726908,53
5375,3,11721,4170,7551,0,0,0,1.0,1,1.0,1,1.0,1,0.24548354773262707,52
5376,7,11728,4170,7558,0,0,0,1.0,1,1.0,1,1.0,1,0.1307269267573166,52
5377,3,11731,4171,7560,0,0,0,1.0,1,1.0,1,1.0,1,0.07755169926923788,51
5378,0,11731,4171,7560,0,0,0,1.0,1,1.0,1,1.0,1,0.07149357919441719,52
5379,3,11734,4172,7562,0,0,0,1.0,1,1.0,1,1.0,1,0.1081574004551955,50
5380,5,11739,4173,7566,0,0,0,1.0,1,1.0,1,1.0,1,0.15548102271985825,51
5381,4,11743,4175,7568,0,0,0,1.0,1,1.0,1,1.0,1,0.13690594773477022,50
5382,0,11743,4175,7568,0,0,0,1.0,1,1.0,1,1.0,1,0.14757435529841298,48
5383,2,11745,4175,7570,0,0,0,1.0,1,1.0,1,1.0,1,0.1504201321485962,48
5384,0,11745,4175,7570,0,0,0,1.0,1,1.0,1,1.0,1,0.1504201321485962,48
5385,0,11745,4175,7570,0,0,0,1.0,1,1.0,1,1.0,1,0.1466895590207366,47
5386,4,11749,4177,7572,0,0,0,1.0,1,1.0,1,1.0,1,0.11956196161827015,48
5387,0,11749,4177,7572,0,0,0,1.0,1,1.0,1,1.0,1,0.12292064205986153,48
5388,2,11751,4178,7573,0,0,0,1.0,1,1.0,1,1.0,1,0.0924401133988965,48
5389,2,11753,4178,7575,0,0,0,1.0,1,1.0,1,1.0,1,0.07370816846237387,50
5390,1,11754,4179,7575,0,0,0,1.0,1,1.0,1,1.0,1,0.09828214223652074,52
5391,3,11757,4180,7577,0,0,0,1.0,1,1.0,1,1.0,1,0.10395818910665516,52
5392,1,11758,4180,7578,0,0,0,1.0,1,1.0,1,1.0,1,0.09585683317947574,51
5393,3,11761,4183,7578,0,0,0,1.0,1,1.0,1,1.0,1,0.17209285055677387,50
5394,2,11763,4183,7580,0,0,0,1.0,1,1.0,1,1.0,1,0.13204389469342645,50
5395,2,11765,4185,7580,0,0,0,1.0,1,1.0,1,1.0,1,0.16007188680306794,49
5396,5,11770,4186,7584,0,0,0,1.0,1,1.0,1,1.0,1,0.0984011755329317,48
5397,1,11771,4187,7584,0,0,0,1.0,1,1.0,1,1.0,1,0.09689934148889373,48
5398,4,11775,4188,7587,0,0,0,1.0,1,1.0,1,1.0,1,0.1352877882500684,46
5399,1,11776,4189,7587,0,0,0,1.0,1,1.0,1,1.0,1,0.13782435510271537,46
5400,4,11780,4191,7589,0,0,0,1.0,1,1.0,1,1.0,1,0.17764366621688724,48
5401,5,11785,4191,7594,0,0,0,1.0,1,1.0,1,1.0,1,0.06106511059933715,49
5402,0,11785,4191,7594,0,0,0,1.0,1,1.0,1,1.0,1,0.0,0
