,SuccessfulHandoverCount,TotalSuccessfulHandoverCount,TotalSuccessfulHandoverCountRange,TotalSuccessfulHandoverCountLoadBalancing,TotalSuccessfulHandoverCountOverload,FailedHandoverCount,TotalFailedHandoverCount,AvgQoS,MinQoS,AvgQoS_LoadBased,MinQoS_LoadBased,AvgQoS_RangeBased,MinQoS_RangeBased,GiniLoad,VehicleCount
0,0,0,0,0,0,0,0,1.0,1,1.0,1,1.0,1,0.0,0
1,21,21,0,21,0,0,0,1.0,1,1.0,1,1.0,1,0.2165790718897854,26
2,15,36,0,36,0,0,0,1.0,1,1.0,1,1.0,1,0.16846339338089764,27
3,13,49,0,49,0,0,0,1.0,1,1.0,1,1.0,1,0.22257496808157784,28
4,11,60,0,60,0,0,0,1.0,1,1.0,1,1.0,1,0.21762892822371374,29
5,13,73,0,73,0,0,0,1.0,1,1.0,1,1.0,1,0.22162179893446707,29
6,13,86,0,86,0,0,0,1.0,1,1.0,1,1.0,1,0.2310758305948742,32
7,18,104,0,104,0,0,0,1.0,1,1.0,1,1.0,1,0.26531077316506707,33
8,16,120,0,120,0,0,0,1.0,1,1.0,1,1.0,1,0.18264913540548158,35
9,22,142,0,142,0,0,0,1.0,1,1.0,1,1.0,1,0.234851616090903,35
10,25,167,0,167,0,0,0,1.0,1,1.0,1,1.0,1,0.3013088598631001,35
11,13,180,0,180,0,0,0,1.0,1,1.0,1,1.0,1,0.19352747530693087,35
12,10,190,0,190,0,0,0,1.0,1,1.0,1,1.0,1,0.2994613448895453,34
13,10,200,0,200,0,0,0,1.0,1,1.0,1,1.0,1,0.23392887654516503,32
14,11,211,0,211,0,0,0,1.0,1,1.0,1,1.0,1,0.2889083848284657,31
15,5,216,0,216,0,0,0,1.0,1,1.0,1,1.0,1,0.29854072495163164,30
16,8,224,0,224,0,0,0,1.0,1,1.0,1,1.0,1,0.1012908262664982,30
17,0,224,0,224,0,0,0,1.0,1,1.0,1,1.0,1,0.1374615023643437,29
18,1,225,1,224,0,0,0,1.0,1,1.0,1,1.0,1,0.1246343622018082,29
19,0,225,1,224,0,0,0,1.0,1,1.0,1,1.0,1,0.15503063009654977,28
20,0,225,1,224,0,0,0,1.0,1,1.0,1,1.0,1,0.17686089847123257,28
21,2,227,2,225,0,0,0,1.0,1,1.0,1,1.0,1,0.19722666211462983,28
22,2,229,3,226,0,0,0,1.0,1,1.0,1,1.0,1,0.1882366710402255,28
23,2,231,5,226,0,0,0,1.0,1,1.0,1,1.0,1,0.266666170452314,27
24,3,234,8,226,0,0,0,1.0,1,1.0,1,1.0,1,0.2811664831904458,28
25,3,237,9,228,0,0,0,1.0,1,1.0,1,1.0,1,0.18479353322830017,28
26,6,243,12,231,0,0,0,1.0,1,1.0,1,1.0,1,0.17557264860611943,30
27,2,245,12,233,0,0,0,1.0,1,1.0,1,1.0,1,0.13213613198955074,30
28,2,247,13,234,0,0,0,1.0,1,1.0,1,1.0,1,0.175462914676453,31
29,0,247,13,234,0,0,0,1.0,1,1.0,1,1.0,1,0.17437789457964578,30
30,1,248,14,234,0,0,0,1.0,1,1.0,1,1.0,1,0.1988198284117771,30
31,4,252,15,237,0,0,0,1.0,1,1.0,1,1.0,1,0.14426032450015455,31
32,0,252,15,237,0,0,0,1.0,1,1.0,1,1.0,1,0.14631882421770956,31
33,2,254,17,237,0,0,0,1.0,1,1.0,1,1.0,1,0.25285684874937864,31
34,2,256,18,238,0,0,0,1.0,1,1.0,1,1.0,1,0.2130716312612384,29
35,3,259,19,240,0,0,0,1.0,1,1.0,1,1.0,1,0.20980145922453144,30
36,3,262,20,242,0,0,0,1.0,1,1.0,1,1.0,1,0.256496343537084,30
37,3,265,20,245,0,0,0,1.0,1,1.0,1,1.0,1,0.2038812577624085,31
38,2,267,20,247,0,0,0,1.0,1,1.0,1,1.0,1,0.19647338381654705,32
39,5,272,20,252,0,0,0,1.0,1,1.0,1,1.0,1,0.23697530798849098,36
40,6,278,20,258,0,0,0,1.0,1,1.0,1,1.0,1,0.2191595997388389,37
41,6,284,20,264,0,0,0,1.0,1,1.0,1,1.0,1,0.17545774502425215,37
42,4,288,20,268,0,0,0,1.0,1,1.0,1,1.0,1,0.21530516205064448,38
43,8,296,20,276,0,0,0,1.0,1,1.0,1,1.0,1,0.24277359398712112,40
44,3,299,20,279,0,0,0,1.0,1,1.0,1,1.0,1,0.2137639521742487,39
45,7,306,21,285,0,0,0,1.0,1,1.0,1,1.0,1,0.24023174592910843,40
46,5,311,21,290,0,0,0,1.0,1,1.0,1,1.0,1,0.1462487879021768,39
47,0,311,21,290,0,0,0,1.0,1,1.0,1,1.0,1,0.1462487879021768,39
48,0,311,21,290,0,0,0,1.0,1,1.0,1,1.0,1,0.1462487879021768,39
49,1,312,22,290,0,0,0,1.0,1,1.0,1,1.0,1,0.13366015124326588,37
50,1,313,23,290,0,0,0,1.0,1,1.0,1,1.0,1,0.1631814245702039,35
51,0,313,23,290,0,0,0,1.0,1,1.0,1,1.0,1,0.16028414462784327,34
52,0,313,23,290,0,0,0,1.0,1,1.0,1,1.0,1,0.18571945945809945,34
53,1,314,23,291,0,0,0,1.0,1,1.0,1,1.0,1,0.1695590920600338,35
54,1,315,23,292,0,0,0,1.0,1,1.0,1,1.0,1,0.16790954399671548,36
55,3,318,24,294,0,0,0,1.0,1,1.0,1,1.0,1,0.16032443891402015,36
56,6,324,27,297,0,0,0,1.0,1,1.0,1,1.0,1,0.24692644230115404,36
57,5,329,27,302,0,0,0,1.0,1,1.0,1,1.0,1,0.2211976801275985,37
58,6,335,28,307,0,0,0,1.0,1,1.0,1,1.0,1,0.19145652870573235,38
59,3,338,28,310,0,0,0,1.0,1,1.0,1,1.0,1,0.19065917150416328,37
60,1,339,28,311,0,0,0,1.0,1,1.0,1,1.0,1,0.17087165374438018,38
61,4,343,28,315,0,0,0,1.0,1,1.0,1,1.0,1,0.17218929016429155,37
62,4,347,30,317,0,0,0,1.0,1,1.0,1,1.0,1,0.2046150993768398,39
63,3,350,31,319,0,0,0,1.0,1,1.0,1,1.0,1,0.23043737156903282,39
64,1,351,32,319,0,0,0,1.0,1,1.0,1,1.0,1,0.22883865153235525,38
65,4,355,34,321,0,0,0,1.0,1,1.0,1,1.0,1,0.21890104674285704,39
66,3,358,36,322,0,0,0,1.0,1,1.0,1,1.0,1,0.265000400578046,39
67,1,359,36,323,0,0,0,1.0,1,1.0,1,1.0,1,0.23987879099048284,36
68,3,362,36,326,0,0,0,1.0,1,1.0,1,1.0,1,0.28304177047431595,36
69,5,367,36,331,0,0,0,1.0,1,1.0,1,1.0,1,0.25611073344993224,37
70,2,369,36,333,0,0,0,1.0,1,1.0,1,1.0,1,0.28461220487100675,36
71,2,371,36,335,0,0,0,1.0,1,1.0,1,1.0,1,0.24252197434617004,38
72,4,375,37,338,0,0,0,1.0,1,1.0,1,1.0,1,0.30860901479185004,38
73,3,378,37,341,0,0,0,1.0,1,1.0,1,1.0,1,0.2974129629332179,37
74,4,382,38,344,0,0,0,1.0,1,1.0,1,1.0,1,0.2803152678725151,38
75,6,388,39,349,0,0,0,1.0,1,1.0,1,1.0,1,0.24027940323783875,38
76,8,396,40,356,0,0,0,1.0,1,1.0,1,1.0,1,0.10762888238951983,39
77,0,396,40,356,0,0,0,1.0,1,1.0,1,1.0,1,0.10956252808814904,40
78,0,396,40,356,0,0,0,1.0,1,1.0,1,1.0,1,0.1318877349018283,41
79,0,396,40,356,0,0,0,1.0,1,1.0,1,1.0,1,0.1318877349018283,41
80,0,396,40,356,0,0,0,1.0,1,1.0,1,1.0,1,0.1318877349018283,41
81,1,397,41,356,0,0,0,1.0,1,1.0,1,1.0,1,0.1602023888366915,41
82,4,401,41,360,0,0,0,1.0,1,1.0,1,1.0,1,0.08401307114379628,44
83,0,401,41,360,0,0,0,1.0,1,1.0,1,1.0,1,0.08401307114379628,44
84,1,402,41,361,0,0,0,1.0,1,1.0,1,1.0,1,0.10207709447223025,45
85,1,403,42,361,0,0,0,1.0,1,1.0,1,1.0,1,0.13974419432272256,45
86,0,403,42,361,0,0,0,1.0,1,1.0,1,1.0,1,0.13974419432272256,45
87,3,406,43,363,0,0,0,1.0,1,1.0,1,1.0,1,0.17478000189913576,44
88,1,407,43,364,0,0,0,1.0,1,1.0,1,1.0,1,0.18091811806733576,44
89,2,409,43,366,0,0,0,1.0,1,1.0,1,1.0,1,0.18272868612655235,43
90,0,409,43,366,0,0,0,1.0,1,1.0,1,1.0,1,0.20995265511351974,44
91,4,413,44,369,0,0,0,1.0,1,1.0,1,1.0,1,0.18527381965343853,44
92,0,413,44,369,0,0,0,1.0,1,1.0,1,1.0,1,0.16709554712978733,43
93,2,415,44,371,0,0,0,1.0,1,1.0,1,1.0,1,0.16567210326545853,44
94,0,415,44,371,0,0,0,1.0,1,1.0,1,1.0,1,0.16567210326545853,44
95,0,415,44,371,0,0,0,1.0,1,1.0,1,1.0,1,0.1685185646179821,43
96,1,416,45,371,0,0,0,1.0,1,1.0,1,1.0,1,0.15476574813712082,44
97,1,417,46,371,0,0,0,1.0,1,1.0,1,1.0,1,0.17337652432490117,44
98,0,417,46,371,0,0,0,1.0,1,1.0,1,1.0,1,0.1894160789218185,43
99,0,417,46,371,0,0,0,1.0,1,1.0,1,1.0,1,0.1894160789218185,43
100,2,419,46,373,0,0,0,1.0,1,1.0,1,1.0,1,0.18313063827671783,47
101,2,421,46,375,0,0,0,1.0,1,1.0,1,1.0,1,0.18313063827671783,47
102,3,424,47,377,0,0,0,1.0,1,1.0,1,1.0,1,0.17065380389263826,47
103,4,428,49,379,0,0,0,1.0,1,1.0,1,1.0,1,0.1662054452270528,46
104,2,430,51,379,0,0,0,1.0,1,1.0,1,1.0,1,0.1831811977782351,45
105,5,435,53,382,0,0,0,1.0,1,1.0,1,1.0,1,0.18341282211029303,44
106,5,440,56,384,0,0,0,1.0,1,1.0,1,1.0,1,0.18327552064017316,45
107,2,442,57,385,0,0,0,1.0,1,1.0,1,1.0,1,0.19396484326487515,44
108,4,446,60,386,0,0,0,1.0,1,1.0,1,1.0,1,0.21133848657050414,46
109,4,450,60,390,0,0,0,1.0,1,1.0,1,1.0,1,0.16490728112557748,46
110,2,452,60,392,0,0,0,1.0,1,1.0,1,1.0,1,0.12055938230556544,46
111,2,454,61,393,0,0,0,1.0,1,1.0,1,1.0,1,0.1985174447813714,46
112,1,455,62,393,0,0,0,1.0,1,1.0,1,1.0,1,0.16083006784751208,46
113,3,458,63,395,0,0,0,1.0,1,1.0,1,1.0,1,0.2052946611192348,46
114,4,462,64,398,0,0,0,1.0,1,1.0,1,1.0,1,0.1766245708115321,46
115,3,465,65,400,0,0,0,1.0,1,1.0,1,1.0,1,0.11469110980035709,47
116,4,469,69,400,0,0,0,1.0,1,1.0,1,1.0,1,0.09296661508105016,47
117,2,471,69,402,0,0,0,1.0,1,1.0,1,1.0,1,0.08629076777502864,45
118,2,473,70,403,0,0,0,1.0,1,1.0,1,1.0,1,0.09025966609885919,46
119,1,474,70,404,0,0,0,1.0,1,1.0,1,1.0,1,0.12127636054170007,46
120,4,478,71,407,0,0,0,1.0,1,1.0,1,1.0,1,0.14671898471027095,47
121,4,482,71,411,0,0,0,1.0,1,1.0,1,1.0,1,0.111795413204702,46
122,0,482,71,411,0,0,0,1.0,1,1.0,1,1.0,1,0.111795413204702,46
123,0,482,71,411,0,0,0,1.0,1,1.0,1,1.0,1,0.1341033288193554,45
124,2,484,72,412,0,0,0,1.0,1,1.0,1,1.0,1,0.13132384766969082,46
125,2,486,72,414,0,0,0,1.0,1,1.0,1,1.0,1,0.12670740370764,44
126,3,489,72,417,0,0,0,1.0,1,1.0,1,1.0,1,0.06741042634694648,45
127,0,489,72,417,0,0,0,1.0,1,1.0,1,1.0,1,0.06447439915940015,45
128,4,493,74,419,0,0,0,1.0,1,1.0,1,1.0,1,0.12326439370363898,46
129,4,497,74,423,0,0,0,1.0,1,1.0,1,1.0,1,0.07649245380424946,48
130,1,498,75,423,0,0,0,1.0,1,1.0,1,1.0,1,0.10433730398190628,48
131,2,500,75,425,0,0,0,1.0,1,1.0,1,1.0,1,0.11229228171985942,49
132,5,505,77,428,0,0,0,1.0,1,1.0,1,1.0,1,0.09171481749760911,51
133,8,513,80,433,0,0,0,1.0,1,1.0,1,1.0,1,0.1440489059861924,49
134,9,522,84,438,0,0,0,1.0,1,1.0,1,1.0,1,0.13120398193012098,49
135,5,527,84,443,0,0,0,1.0,1,1.0,1,1.0,1,0.158757628066646,49
136,10,537,87,450,0,0,0,1.0,1,1.0,1,1.0,1,0.1192382959266677,48
137,2,539,87,452,0,0,0,1.0,1,1.0,1,1.0,1,0.10278543599995506,47
138,1,540,87,453,0,0,0,1.0,1,1.0,1,1.0,1,0.08802827349989635,48
139,0,540,87,453,0,0,0,1.0,1,1.0,1,1.0,1,0.08307303057150492,48
140,2,542,88,454,0,0,0,1.0,1,1.0,1,1.0,1,0.06071910732169804,49
141,2,544,90,454,0,0,0,1.0,1,1.0,1,1.0,1,0.11594496756318917,49
142,6,550,93,457,0,0,0,1.0,1,1.0,1,1.0,1,0.09892598149225,49
143,1,551,94,457,0,0,0,1.0,1,1.0,1,1.0,1,0.10095251201232684,47
144,1,552,95,457,0,0,0,1.0,1,1.0,1,1.0,1,0.11669235860933232,46
145,1,553,95,458,0,0,0,1.0,1,1.0,1,1.0,1,0.13036204643644836,44
146,4,557,97,460,0,0,0,1.0,1,1.0,1,1.0,1,0.11184231030878473,44
147,4,561,98,463,0,0,0,1.0,1,1.0,1,1.0,1,0.10819559475181971,43
148,5,566,99,467,0,0,0,1.0,1,1.0,1,1.0,1,0.10245304805782633,43
149,2,568,100,468,0,0,0,1.0,1,1.0,1,1.0,1,0.09537586406134567,43
150,2,570,100,470,0,0,0,1.0,1,1.0,1,1.0,1,0.10556341057738539,42
151,0,570,100,470,0,0,0,1.0,1,1.0,1,1.0,1,0.10556341057738539,42
152,2,572,101,471,0,0,0,1.0,1,1.0,1,1.0,1,0.12573123172525982,42
153,0,572,101,471,0,0,0,1.0,1,1.0,1,1.0,1,0.11535329112072018,42
154,3,575,103,472,0,0,0,1.0,1,1.0,1,1.0,1,0.16559711837986266,43
155,1,576,103,473,0,0,0,1.0,1,1.0,1,1.0,1,0.13064810294954718,43
156,1,577,104,473,0,0,0,1.0,1,1.0,1,1.0,1,0.15258161015644167,42
157,0,577,104,473,0,0,0,1.0,1,1.0,1,1.0,1,0.2055992893066136,41
158,0,577,104,473,0,0,0,1.0,1,1.0,1,1.0,1,0.21352911959986118,42
159,1,578,104,474,0,0,0,1.0,1,1.0,1,1.0,1,0.22595623753233038,43
160,3,581,106,475,0,0,0,1.0,1,1.0,1,1.0,1,0.2638317029534127,44
161,2,583,107,476,0,0,0,1.0,1,1.0,1,1.0,1,0.3053668745468513,44
162,11,594,108,486,0,0,0,1.0,1,1.0,1,1.0,1,0.2760093321402941,45
163,4,598,109,489,0,0,0,1.0,1,1.0,1,1.0,1,0.3065996155378353,43
164,4,602,110,492,0,0,0,1.0,1,1.0,1,1.0,1,0.300918753240274,42
165,8,610,113,497,0,0,0,1.0,1,1.0,1,1.0,1,0.24319651182904775,42
166,8,618,113,505,0,0,0,1.0,1,1.0,1,1.0,1,0.14620452292920216,42
167,5,623,116,507,0,0,0,1.0,1,1.0,1,1.0,1,0.16422035112445163,41
168,3,626,117,509,0,0,0,1.0,1,1.0,1,1.0,1,0.11066941995813787,40
169,2,628,117,511,0,0,0,1.0,1,1.0,1,1.0,1,0.11216904123904375,40
170,2,630,117,513,0,0,0,1.0,1,1.0,1,1.0,1,0.1554675178696204,38
171,2,632,117,515,0,0,0,1.0,1,1.0,1,1.0,1,0.12672265441145072,37
172,2,634,119,515,0,0,0,1.0,1,1.0,1,1.0,1,0.19787914704292794,35
173,3,637,121,516,0,0,0,1.0,1,1.0,1,1.0,1,0.14396073440574028,36
174,2,639,123,516,0,0,0,1.0,1,1.0,1,1.0,1,0.17970551365602075,34
175,0,639,123,516,0,0,0,1.0,1,1.0,1,1.0,1,0.18439050521318462,33
176,0,639,123,516,0,0,0,1.0,1,1.0,1,1.0,1,0.18299694991175003,34
177,2,641,123,518,0,0,0,1.0,1,1.0,1,1.0,1,0.14142920104301088,36
178,1,642,123,519,0,0,0,1.0,1,1.0,1,1.0,1,0.16294772802574695,37
179,1,643,123,520,0,0,0,1.0,1,1.0,1,1.0,1,0.1419604569299137,37
180,3,646,123,523,0,0,0,1.0,1,1.0,1,1.0,1,0.13463858926636377,36
181,2,648,124,524,0,0,0,1.0,1,1.0,1,1.0,1,0.11222711881629117,36
182,3,651,125,526,0,0,0,1.0,1,1.0,1,1.0,1,0.11279016971748222,38
183,1,652,126,526,0,0,0,1.0,1,1.0,1,1.0,1,0.10984798130354342,37
184,0,652,126,526,0,0,0,1.0,1,1.0,1,1.0,1,0.10671823951279914,36
185,3,655,127,528,0,0,0,1.0,1,1.0,1,1.0,1,0.14300047599497137,35
186,3,658,128,530,0,0,0,1.0,1,1.0,1,1.0,1,0.14822940392495962,34
187,4,662,130,532,0,0,0,1.0,1,1.0,1,1.0,1,0.20357129917500055,33
188,2,664,130,534,0,0,0,1.0,1,1.0,1,1.0,1,0.16661058890555236,33
189,4,668,134,534,0,0,0,1.0,1,1.0,1,1.0,1,0.26607565087852875,33
190,4,672,134,538,0,0,0,1.0,1,1.0,1,1.0,1,0.2739086728143161,32
191,2,674,135,539,0,0,0,1.0,1,1.0,1,1.0,1,0.27603899907516294,34
192,4,678,136,542,0,0,0,1.0,1,1.0,1,1.0,1,0.29266331569605725,34
193,2,680,136,544,0,0,0,1.0,1,1.0,1,1.0,1,0.29935620694640847,35
194,5,685,136,549,0,0,0,1.0,1,1.0,1,1.0,1,0.30091495484698055,37
195,5,690,136,554,0,0,0,1.0,1,1.0,1,1.0,1,0.28875292880450126,36
196,5,695,137,558,0,0,0,1.0,1,1.0,1,1.0,1,0.19373963486339435,36
197,2,697,137,560,0,0,0,1.0,1,1.0,1,1.0,1,0.19608415061867027,37
198,4,701,138,563,0,0,0,1.0,1,1.0,1,1.0,1,0.13974835946763528,37
199,1,702,138,564,0,0,0,1.0,1,1.0,1,1.0,1,0.11813356163041434,37
200,1,703,139,564,0,0,0,1.0,1,1.0,1,1.0,1,0.1270176544253368,37
201,0,703,139,564,0,0,0,1.0,1,1.0,1,1.0,1,0.09442066928199494,36
202,3,706,140,566,0,0,0,1.0,1,1.0,1,1.0,1,0.06521220743457369,36
203,3,709,141,568,0,0,0,1.0,1,1.0,1,1.0,1,0.056089370508882255,35
204,3,712,142,570,0,0,0,1.0,1,1.0,1,1.0,1,0.1618608873122267,35
205,3,715,144,571,0,0,0,1.0,1,1.0,1,1.0,1,0.19008894682058894,35
206,4,719,146,573,0,0,0,1.0,1,1.0,1,1.0,1,0.247712306919123,34
207,3,722,147,575,0,0,0,1.0,1,1.0,1,1.0,1,0.3213528790202191,34
208,6,728,147,581,0,0,0,1.0,1,1.0,1,1.0,1,0.28628453642502805,33
209,3,731,147,584,0,0,0,1.0,1,1.0,1,1.0,1,0.30235916363109583,33
210,9,740,149,591,0,0,0,1.0,1,1.0,1,1.0,1,0.35105098232700943,34
211,10,750,150,600,0,0,0,1.0,1,1.0,1,1.0,1,0.17935297196320535,33
212,1,751,150,601,0,0,0,1.0,1,1.0,1,1.0,1,0.14857467104112831,33
213,1,752,150,602,0,0,0,1.0,1,1.0,1,1.0,1,0.14307360257432725,35
214,2,754,150,604,0,0,0,1.0,1,1.0,1,1.0,1,0.1510466430090613,34
215,3,757,151,606,0,0,0,1.0,1,1.0,1,1.0,1,0.15970777376924783,35
216,6,763,152,611,0,0,0,1.0,1,1.0,1,1.0,1,0.16034221909713292,36
217,3,766,153,613,0,0,0,1.0,1,1.0,1,1.0,1,0.18693742849290668,36
218,5,771,155,616,0,0,0,1.0,1,1.0,1,1.0,1,0.27620442137965756,36
219,6,777,155,622,0,0,0,1.0,1,1.0,1,1.0,1,0.25764658923784806,37
220,7,784,156,628,0,0,0,1.0,1,1.0,1,1.0,1,0.2537205878515061,38
221,2,786,156,630,0,0,0,1.0,1,1.0,1,1.0,1,0.2561483699701376,37
222,5,791,157,634,0,0,0,1.0,1,1.0,1,1.0,1,0.21876662305454023,38
223,6,797,158,639,0,0,0,1.0,1,1.0,1,1.0,1,0.21150144354811543,38
224,7,804,160,644,0,0,0,1.0,1,1.0,1,1.0,1,0.22243560237696236,38
225,4,808,162,646,0,0,0,1.0,1,1.0,1,1.0,1,0.2198824175234022,36
226,10,818,165,653,0,0,0,1.0,1,1.0,1,1.0,1,0.15682071251233354,37
227,4,822,167,655,0,0,0,1.0,1,1.0,1,1.0,1,0.14793752111860056,35
228,3,825,167,658,0,0,0,1.0,1,1.0,1,1.0,1,0.0913865338831512,35
229,2,827,168,659,0,0,0,1.0,1,1.0,1,1.0,1,0.14124906732089035,35
230,3,830,171,659,0,0,0,1.0,1,1.0,1,1.0,1,0.2279996542425693,35
231,4,834,173,661,0,0,0,1.0,1,1.0,1,1.0,1,0.19023256820343187,35
232,4,838,176,662,0,0,0,1.0,1,1.0,1,1.0,1,0.19029280204184731,36
233,2,840,176,664,0,0,0,1.0,1,1.0,1,1.0,1,0.18534844420598756,36
234,0,840,176,664,0,0,0,1.0,1,1.0,1,1.0,1,0.19456932340961483,34
235,1,841,177,664,0,0,0,1.0,1,1.0,1,1.0,1,0.23064834325907793,33
236,0,841,177,664,0,0,0,1.0,1,1.0,1,1.0,1,0.25676413704562856,31
237,3,844,178,666,0,0,0,1.0,1,1.0,1,1.0,1,0.2379381929506554,32
238,1,845,179,666,0,0,0,1.0,1,1.0,1,1.0,1,0.284915697514918,31
239,1,846,180,666,0,0,0,1.0,1,1.0,1,1.0,1,0.2455610451832653,30
240,3,849,182,667,0,0,0,1.0,1,1.0,1,1.0,1,0.28903723511594226,27
241,6,855,182,673,0,0,0,1.0,1,1.0,1,1.0,1,0.10253538901551226,27
242,2,857,182,675,0,0,0,1.0,1,1.0,1,1.0,1,0.1292173489170611,28
243,3,860,183,677,0,0,0,1.0,1,1.0,1,1.0,1,0.1500103810346829,28
244,3,863,184,679,0,0,0,1.0,1,1.0,1,1.0,1,0.24172340782984342,27
245,4,867,184,683,0,0,0,1.0,1,1.0,1,1.0,1,0.23886795787073606,27
246,3,870,185,685,0,0,0,1.0,1,1.0,1,1.0,1,0.2419859399311447,25
247,2,872,185,687,0,0,0,1.0,1,1.0,1,1.0,1,0.2558367897043381,24
248,4,876,185,691,0,0,0,1.0,1,1.0,1,1.0,1,0.2566917607567064,24
249,5,881,186,695,0,0,0,1.0,1,1.0,1,1.0,1,0.2322109790921129,25
250,4,885,186,699,0,0,0,1.0,1,1.0,1,1.0,1,0.2566109872541708,27
251,7,892,187,705,0,0,0,1.0,1,1.0,1,1.0,1,0.21300014815426424,27
252,3,895,188,707,0,0,0,1.0,1,1.0,1,1.0,1,0.21558162262990027,27
253,4,899,188,711,0,0,0,1.0,1,1.0,1,1.0,1,0.23176278188973687,29
254,7,906,191,715,0,0,0,1.0,1,1.0,1,1.0,1,0.29550504641830305,30
255,5,911,191,720,0,0,0,1.0,1,1.0,1,1.0,1,0.24679517683206983,31
256,3,914,191,723,0,0,0,1.0,1,1.0,1,1.0,1,0.1853343572870578,31
257,2,916,192,724,0,0,0,1.0,1,1.0,1,1.0,1,0.18544009297946,33
258,0,916,192,724,0,0,0,1.0,1,1.0,1,1.0,1,0.18544009297946,33
259,0,916,192,724,0,0,0,1.0,1,1.0,1,1.0,1,0.18544009297946,33
260,2,918,193,725,0,0,0,1.0,1,1.0,1,1.0,1,0.2346424289474722,35
261,3,921,195,726,0,0,0,1.0,1,1.0,1,1.0,1,0.29251660728887535,35
262,6,927,196,731,0,0,0,1.0,1,1.0,1,1.0,1,0.2423916351701071,35
263,1,928,196,732,0,0,0,1.0,1,1.0,1,1.0,1,0.24457241534491428,34
264,2,930,198,732,0,0,0,1.0,1,1.0,1,1.0,1,0.30841937776259815,32
265,0,930,198,732,0,0,0,1.0,1,1.0,1,1.0,1,0.2664385880768363,30
266,2,932,200,732,0,0,0,1.0,1,1.0,1,1.0,1,0.2996625894600272,31
267,3,935,201,734,0,0,0,1.0,1,1.0,1,1.0,1,0.2794636004162934,30
268,3,938,201,737,0,0,0,1.0,1,1.0,1,1.0,1,0.21275532710589243,31
269,1,939,202,737,0,0,0,1.0,1,1.0,1,1.0,1,0.2580091403238919,31
270,5,944,204,740,0,0,0,1.0,1,1.0,1,1.0,1,0.26716316855948485,32
271,2,946,204,742,0,0,0,1.0,1,1.0,1,1.0,1,0.1977157037350925,31
272,2,948,205,743,0,0,0,1.0,1,1.0,1,1.0,1,0.28337088998942045,32
273,1,949,205,744,0,0,0,1.0,1,1.0,1,1.0,1,0.23547521106039768,32
274,0,949,205,744,0,0,0,1.0,1,1.0,1,1.0,1,0.23547521106039768,32
275,0,949,205,744,0,0,0,1.0,1,1.0,1,1.0,1,0.2044560952995171,33
276,0,949,205,744,0,0,0,1.0,1,1.0,1,1.0,1,0.21544962701579665,34
277,0,949,205,744,0,0,0,1.0,1,1.0,1,1.0,1,0.19676967292984024,32
278,0,949,205,744,0,0,0,1.0,1,1.0,1,1.0,1,0.19531380870553952,31
279,2,951,205,746,0,0,0,1.0,1,1.0,1,1.0,1,0.1586539011562292,31
280,4,955,206,749,0,0,0,1.0,1,1.0,1,1.0,1,0.20866747519265474,30
281,1,956,207,749,0,0,0,1.0,1,1.0,1,1.0,1,0.2264111153004697,31
282,3,959,208,751,0,0,0,1.0,1,1.0,1,1.0,1,0.24555268319122298,30
283,5,964,208,756,0,0,0,1.0,1,1.0,1,1.0,1,0.20200160164109246,31
284,3,967,210,757,0,0,0,1.0,1,1.0,1,1.0,1,0.24834986544132617,31
285,2,969,210,759,0,0,0,1.0,1,1.0,1,1.0,1,0.22710293657853398,31
286,2,971,210,761,0,0,0,1.0,1,1.0,1,1.0,1,0.14888317883938215,31
287,3,974,213,761,0,0,0,1.0,1,1.0,1,1.0,1,0.2921110900364595,33
288,2,976,213,763,0,0,0,1.0,1,1.0,1,1.0,1,0.11435465249721484,32
289,1,977,213,764,0,0,0,1.0,1,1.0,1,1.0,1,0.11666331657919733,32
290,0,977,213,764,0,0,0,1.0,1,1.0,1,1.0,1,0.11583006550883487,31
291,1,978,214,764,0,0,0,1.0,1,1.0,1,1.0,1,0.1665605127826279,30
292,0,978,214,764,0,0,0,1.0,1,1.0,1,1.0,1,0.13920272382437446,32
293,0,978,214,764,0,0,0,1.0,1,1.0,1,1.0,1,0.13920272382437446,32
294,0,978,214,764,0,0,0,1.0,1,1.0,1,1.0,1,0.13920272382437446,32
295,1,979,214,765,0,0,0,1.0,1,1.0,1,1.0,1,0.11199471516130426,34
296,2,981,214,767,0,0,0,1.0,1,1.0,1,1.0,1,0.11199471516130426,34
297,3,984,215,769,0,0,0,1.0,1,1.0,1,1.0,1,0.165682401959981,34
298,1,985,215,770,0,0,0,1.0,1,1.0,1,1.0,1,0.16886480544811117,35
299,1,986,215,771,0,0,0,1.0,1,1.0,1,1.0,1,0.15476288178031952,35
300,0,986,215,771,0,0,0,1.0,1,1.0,1,1.0,1,0.15476288178031952,35
301,3,989,216,773,0,0,0,1.0,1,1.0,1,1.0,1,0.15248912617709118,38
302,2,991,218,773,0,0,0,1.0,1,1.0,1,1.0,1,0.18796587056899167,38
303,4,995,221,774,0,0,0,1.0,1,1.0,1,1.0,1,0.15888419907292492,37
304,2,997,223,774,0,0,0,1.0,1,1.0,1,1.0,1,0.2471887462308397,37
305,1,998,224,774,0,0,0,1.0,1,1.0,1,1.0,1,0.28569262601641965,36
306,8,1006,226,780,0,0,0,1.0,1,1.0,1,1.0,1,0.273526358859157,36
307,2,1008,226,782,0,0,0,1.0,1,1.0,1,1.0,1,0.27948629679047593,35
308,4,1012,227,785,0,0,0,1.0,1,1.0,1,1.0,1,0.2768087791300673,37
309,2,1014,227,787,0,0,0,1.0,1,1.0,1,1.0,1,0.2768087791300673,37
310,2,1016,227,789,0,0,0,1.0,1,1.0,1,1.0,1,0.2768087791300673,37
311,3,1019,227,792,0,0,0,1.0,1,1.0,1,1.0,1,0.24924811381299616,39
312,3,1022,227,795,0,0,0,1.0,1,1.0,1,1.0,1,0.24342880138472928,40
313,4,1026,227,799,0,0,0,1.0,1,1.0,1,1.0,1,0.2266505258666707,39
314,4,1030,227,803,0,0,0,1.0,1,1.0,1,1.0,1,0.23825077656989654,40
315,1,1031,227,804,0,0,0,1.0,1,1.0,1,1.0,1,0.19377908346878628,39
316,1,1032,227,805,0,0,0,1.0,1,1.0,1,1.0,1,0.1790135697832734,39
317,1,1033,227,806,0,0,0,1.0,1,1.0,1,1.0,1,0.17752509672340402,40
318,2,1035,227,808,0,0,0,1.0,1,1.0,1,1.0,1,0.15051773684542907,41
319,1,1036,227,809,0,0,0,1.0,1,1.0,1,1.0,1,0.183075028459342,41
320,2,1038,227,811,0,0,0,1.0,1,1.0,1,1.0,1,0.14687951944246286,41
321,2,1040,228,812,0,0,0,1.0,1,1.0,1,1.0,1,0.13733519078662548,41
322,2,1042,230,812,0,0,0,1.0,1,1.0,1,1.0,1,0.1543746927467386,41
323,1,1043,230,813,0,0,0,1.0,1,1.0,1,1.0,1,0.15711503217958678,41
324,5,1048,232,816,0,0,0,1.0,1,1.0,1,1.0,1,0.19719924760751886,42
325,4,1052,233,819,0,0,0,1.0,1,1.0,1,1.0,1,0.21130427152078018,42
326,6,1058,234,824,0,0,0,1.0,1,1.0,1,1.0,1,0.16619937318940678,42
327,4,1062,234,828,0,0,0,1.0,1,1.0,1,1.0,1,0.13239779955924363,42
328,2,1064,234,830,0,0,0,1.0,1,1.0,1,1.0,1,0.14497288057306928,43
329,2,1066,234,832,0,0,0,1.0,1,1.0,1,1.0,1,0.14497288057306928,43
330,2,1068,234,834,0,0,0,1.0,1,1.0,1,1.0,1,0.13791153043878474,45
331,4,1072,234,838,0,0,0,1.0,1,1.0,1,1.0,1,0.08022166032730882,45
332,0,1072,234,838,0,0,0,1.0,1,1.0,1,1.0,1,0.0722224620913762,45
333,1,1073,235,838,0,0,0,1.0,1,1.0,1,1.0,1,0.10297385351998617,46
334,1,1074,235,839,0,0,0,1.0,1,1.0,1,1.0,1,0.09531114511554215,48
335,0,1074,235,839,0,0,0,1.0,1,1.0,1,1.0,1,0.09531114511554215,48
336,0,1074,235,839,0,0,0,1.0,1,1.0,1,1.0,1,0.09531114511554215,48
337,1,1075,235,840,0,0,0,1.0,1,1.0,1,1.0,1,0.1094783489020171,49
338,1,1076,236,840,0,0,0,1.0,1,1.0,1,1.0,1,0.11180296836155619,50
339,1,1077,236,841,0,0,0,1.0,1,1.0,1,1.0,1,0.09400391305647102,50
340,0,1077,236,841,0,0,0,1.0,1,1.0,1,1.0,1,0.09400391305647102,50
341,0,1077,236,841,0,0,0,1.0,1,1.0,1,1.0,1,0.09161472232465334,51
342,2,1079,237,842,0,0,0,1.0,1,1.0,1,1.0,1,0.09879746898975235,51
343,1,1080,238,842,0,0,0,1.0,1,1.0,1,1.0,1,0.08631972378996534,51
344,1,1081,238,843,0,0,0,1.0,1,1.0,1,1.0,1,0.10930176168158913,50
345,0,1081,238,843,0,0,0,1.0,1,1.0,1,1.0,1,0.12275677008990837,51
346,4,1085,239,846,0,0,0,1.0,1,1.0,1,1.0,1,0.11118403354099873,51
347,4,1089,241,848,0,0,0,1.0,1,1.0,1,1.0,1,0.08120646319068142,51
348,2,1091,243,848,0,0,0,1.0,1,1.0,1,1.0,1,0.10079688098285974,53
349,5,1096,244,852,0,0,0,1.0,1,1.0,1,1.0,1,0.09299777230969505,55
350,1,1097,244,853,0,0,0,1.0,1,1.0,1,1.0,1,0.10163408341071566,54
351,4,1101,247,854,0,0,0,1.0,1,1.0,1,1.0,1,0.1514992591165084,54
352,6,1107,250,857,0,0,0,1.0,1,1.0,1,1.0,1,0.18460638721708242,53
353,5,1112,251,861,0,0,0,1.0,1,1.0,1,1.0,1,0.18127189861091123,53
354,3,1115,251,864,0,0,0,1.0,1,1.0,1,1.0,1,0.15382358438568755,50
355,2,1117,251,866,0,0,0,1.0,1,1.0,1,1.0,1,0.16824411228263506,51
356,3,1120,252,868,0,0,0,1.0,1,1.0,1,1.0,1,0.16028122987309898,51
357,1,1121,253,868,0,0,0,1.0,1,1.0,1,1.0,1,0.1623693247445487,50
358,1,1122,254,868,0,0,0,1.0,1,1.0,1,1.0,1,0.1952016087624492,48
359,1,1123,255,868,0,0,0,1.0,1,1.0,1,1.0,1,0.20638057425893755,47
360,1,1124,256,868,0,0,0,1.0,1,1.0,1,1.0,1,0.2824380736491656,45
361,7,1131,257,874,0,0,0,1.0,1,1.0,1,1.0,1,0.19018878919422563,44
362,2,1133,257,876,0,0,0,1.0,1,1.0,1,1.0,1,0.19767888537452774,44
363,3,1136,258,878,0,0,0,1.0,1,1.0,1,1.0,1,0.17763880121196332,44
364,3,1139,258,881,0,0,0,1.0,1,1.0,1,1.0,1,0.16697585439348583,43
365,3,1142,258,884,0,0,0,1.0,1,1.0,1,1.0,1,0.14938082198313,43
366,2,1144,258,886,0,0,0,1.0,1,1.0,1,1.0,1,0.11907367825718701,45
367,4,1148,258,890,0,0,0,1.0,1,1.0,1,1.0,1,0.1562611514346645,44
368,0,1148,258,890,0,0,0,1.0,1,1.0,1,1.0,1,0.14427882312191803,46
369,2,1150,259,891,0,0,0,1.0,1,1.0,1,1.0,1,0.16605670987924306,45
370,1,1151,259,892,0,0,0,1.0,1,1.0,1,1.0,1,0.17615119572847307,46
371,2,1153,259,894,0,0,0,1.0,1,1.0,1,1.0,1,0.17722184988333162,47
372,4,1157,259,898,0,0,0,1.0,1,1.0,1,1.0,1,0.1866159288308742,48
373,8,1165,259,906,0,0,0,1.0,1,1.0,1,1.0,1,0.12871659154787154,48
374,4,1169,259,910,0,0,0,1.0,1,1.0,1,1.0,1,0.15658408929473744,49
375,4,1173,259,914,0,0,0,1.0,1,1.0,1,1.0,1,0.10495563541660813,49
376,4,1177,261,916,0,0,0,1.0,1,1.0,1,1.0,1,0.0910763457555321,49
377,2,1179,263,916,0,0,0,1.0,1,1.0,1,1.0,1,0.10842783358703839,49
378,1,1180,264,916,0,0,0,1.0,1,1.0,1,1.0,1,0.11138753941324905,49
379,2,1182,265,917,0,0,0,1.0,1,1.0,1,1.0,1,0.13108487673425043,50
380,4,1186,268,918,0,0,0,1.0,1,1.0,1,1.0,1,0.1297331594092391,50
381,1,1187,268,919,0,0,0,1.0,1,1.0,1,1.0,1,0.1157662906545164,51
382,0,1187,268,919,0,0,0,1.0,1,1.0,1,1.0,1,0.133077661389248,50
383,2,1189,269,920,0,0,0,1.0,1,1.0,1,1.0,1,0.12255008593643676,51
384,1,1190,270,920,0,0,0,1.0,1,1.0,1,1.0,1,0.14143641216611547,50
385,2,1192,272,920,0,0,0,1.0,1,1.0,1,1.0,1,0.1429920810175524,50
386,4,1196,274,922,0,0,0,1.0,1,1.0,1,1.0,1,0.17211169093890838,48
387,0,1196,274,922,0,0,0,1.0,1,1.0,1,1.0,1,0.2006841917782917,47
388,2,1198,275,923,0,0,0,1.0,1,1.0,1,1.0,1,0.18538843977084996,48
389,2,1200,276,924,0,0,0,1.0,1,1.0,1,1.0,1,0.17546591069228426,47
390,3,1203,277,926,0,0,0,1.0,1,1.0,1,1.0,1,0.14793621453936734,49
391,5,1208,279,929,0,0,0,1.0,1,1.0,1,1.0,1,0.0974000031874664,46
392,2,1210,280,930,0,0,0,1.0,1,1.0,1,1.0,1,0.08361928612182822,46
393,5,1215,283,932,0,0,0,1.0,1,1.0,1,1.0,1,0.18126625297529408,44
394,1,1216,284,932,0,0,0,1.0,1,1.0,1,1.0,1,0.1994974113508055,43
395,3,1219,284,935,0,0,0,1.0,1,1.0,1,1.0,1,0.1892537066551619,42
396,2,1221,285,936,0,0,0,1.0,1,1.0,1,1.0,1,0.22717879866041546,39
397,2,1223,286,937,0,0,0,1.0,1,1.0,1,1.0,1,0.28656984470081814,39
398,3,1226,286,940,0,0,0,1.0,1,1.0,1,1.0,1,0.26573956348619227,36
399,3,1229,287,942,0,0,0,1.0,1,1.0,1,1.0,1,0.2533563239619995,36
400,3,1232,289,943,0,0,0,1.0,1,1.0,1,1.0,1,0.24044996972937466,34
401,1,1233,290,943,0,0,0,1.0,1,1.0,1,1.0,1,0.23864757827278962,33
402,0,1233,290,943,0,0,0,1.0,1,1.0,1,1.0,1,0.2344356633721967,34
403,0,1233,290,943,0,0,0,1.0,1,1.0,1,1.0,1,0.23272789079216444,36
404,2,1235,292,943,0,0,0,1.0,1,1.0,1,1.0,1,0.24563788442749548,36
405,3,1238,294,944,0,0,0,1.0,1,1.0,1,1.0,1,0.2497375137782442,37
406,4,1242,294,948,0,0,0,1.0,1,1.0,1,1.0,1,0.19869358314345803,37
407,5,1247,297,950,0,0,0,1.0,1,1.0,1,1.0,1,0.20409282045657282,39
408,4,1251,298,953,0,0,0,1.0,1,1.0,1,1.0,1,0.19520076129617592,40
409,6,1257,300,957,0,0,0,1.0,1,1.0,1,1.0,1,0.20439317461844494,41
410,1,1258,300,958,0,0,0,1.0,1,1.0,1,1.0,1,0.18788628195843765,42
411,2,1260,300,960,0,0,0,1.0,1,1.0,1,1.0,1,0.19804148732061133,43
412,9,1269,301,968,0,0,0,1.0,1,1.0,1,1.0,1,0.20601919040843136,44
413,7,1276,302,974,0,0,0,1.0,1,1.0,1,1.0,1,0.21574807911493943,44
414,5,1281,302,979,0,0,0,1.0,1,1.0,1,1.0,1,0.20096114096511353,45
415,4,1285,302,983,0,0,0,1.0,1,1.0,1,1.0,1,0.19100159393817326,45
416,7,1292,302,990,0,0,0,1.0,1,1.0,1,1.0,1,0.20582393121061798,46
417,7,1299,302,997,0,0,0,1.0,1,1.0,1,1.0,1,0.20410565520840834,46
418,8,1307,302,1005,0,0,0,1.0,1,1.0,1,1.0,1,0.1947102546995142,47
419,3,1310,302,1008,0,0,0,1.0,1,1.0,1,1.0,1,0.17916445573582443,47
420,5,1315,302,1013,0,0,0,1.0,1,1.0,1,1.0,1,0.18258620417602917,47
421,3,1318,303,1015,0,0,0,1.0,1,1.0,1,1.0,1,0.16956224769659087,47
422,2,1320,304,1016,0,0,0,1.0,1,1.0,1,1.0,1,0.1659196382821979,49
423,2,1322,304,1018,0,0,0,1.0,1,1.0,1,1.0,1,0.11672874025299568,47
424,0,1322,304,1018,0,0,0,1.0,1,1.0,1,1.0,1,0.12337607298842534,45
425,3,1325,304,1021,0,0,0,1.0,1,1.0,1,1.0,1,0.11873763166524684,46
426,1,1326,305,1021,0,0,0,1.0,1,1.0,1,1.0,1,0.12488811006838658,46
427,2,1328,307,1021,0,0,0,1.0,1,1.0,1,1.0,1,0.1452660164138242,45
428,2,1330,308,1022,0,0,0,1.0,1,1.0,1,1.0,1,0.1603467110805626,45
429,4,1334,311,1023,0,0,0,1.0,1,1.0,1,1.0,1,0.21176832550463576,42
430,0,1334,311,1023,0,0,0,1.0,1,1.0,1,1.0,1,0.20478150224305813,40
431,2,1336,312,1024,0,0,0,1.0,1,1.0,1,1.0,1,0.26880885339627275,39
432,2,1338,314,1024,0,0,0,1.0,1,1.0,1,1.0,1,0.3202129693312787,37
433,3,1341,317,1024,0,0,0,1.0,1,1.0,1,1.0,1,0.3571940042177038,35
434,3,1344,318,1026,0,0,0,1.0,1,1.0,1,1.0,1,0.40116592773261556,33
435,2,1346,318,1028,0,0,0,1.0,1,1.0,1,1.0,1,0.40116592773261556,33
436,14,1360,318,1042,0,0,0,1.0,1,1.0,1,1.0,1,0.17150647807671063,33
437,4,1364,318,1046,0,0,0,1.0,1,1.0,1,1.0,1,0.20166060017139978,33
438,5,1369,319,1050,0,0,0,1.0,1,1.0,1,1.0,1,0.2242875377561575,32
439,7,1376,320,1056,0,0,0,1.0,1,1.0,1,1.0,1,0.27366978575954803,34
440,4,1380,320,1060,0,0,0,1.0,1,1.0,1,1.0,1,0.3000046432117922,34
441,8,1388,321,1067,0,0,0,1.0,1,1.0,1,1.0,1,0.2654275357460444,35
442,9,1397,321,1076,0,0,0,1.0,1,1.0,1,1.0,1,0.2553988755776136,37
443,6,1403,322,1081,0,0,0,1.0,1,1.0,1,1.0,1,0.25643876364686163,37
444,9,1412,322,1090,0,0,0,1.0,1,1.0,1,1.0,1,0.27814612678377154,38
445,11,1423,322,1101,0,0,0,1.0,1,1.0,1,1.0,1,0.23363795324524947,39
446,6,1429,322,1107,0,0,0,1.0,1,1.0,1,1.0,1,0.24863461986219812,39
447,8,1437,322,1115,0,0,0,1.0,1,1.0,1,1.0,1,0.2550909987441269,41
448,12,1449,322,1127,0,0,0,1.0,1,1.0,1,1.0,1,0.2552893558360564,41
449,10,1459,323,1136,0,0,0,1.0,1,1.0,1,1.0,1,0.3061879673214622,40
450,10,1469,324,1145,0,0,0,1.0,1,1.0,1,1.0,1,0.3200725256253628,40
451,9,1478,324,1154,0,0,0,1.0,1,1.0,1,1.0,1,0.29169663992098666,41
452,6,1484,324,1160,0,0,0,1.0,1,1.0,1,1.0,1,0.1807315903702507,41
453,3,1487,324,1163,0,0,0,1.0,1,1.0,1,1.0,1,0.24458105551579862,40
454,10,1497,324,1173,0,0,0,1.0,1,1.0,1,1.0,1,0.21156457483822264,41
455,6,1503,324,1179,0,0,0,1.0,1,1.0,1,1.0,1,0.2368367974970201,41
456,9,1512,324,1188,0,0,0,1.0,1,1.0,1,1.0,1,0.13001082507081563,43
457,13,1525,324,1201,0,0,0,1.0,1,1.0,1,1.0,1,0.1511778810851061,43
458,10,1535,324,1211,0,0,0,1.0,1,1.0,1,1.0,1,0.18956113994005996,43
459,10,1545,324,1221,0,0,0,1.0,1,1.0,1,1.0,1,0.06507746348508377,44
460,14,1559,324,1235,0,0,0,1.0,1,1.0,1,1.0,1,0.218265678056566,47
461,14,1573,324,1249,0,0,0,1.0,1,1.0,1,1.0,1,0.22093401852459935,48
462,18,1591,325,1266,0,0,0,1.0,1,1.0,1,1.0,1,0.2203771737625744,49
463,6,1597,325,1272,0,0,0,1.0,1,1.0,1,1.0,1,0.12880789357224776,47
464,7,1604,326,1278,0,0,0,1.0,1,1.0,1,1.0,1,0.21993846306008663,48
465,14,1618,327,1291,0,0,0,1.0,1,1.0,1,1.0,1,0.21838288467177192,47
466,10,1628,329,1299,0,0,0,1.0,1,1.0,1,1.0,1,0.09126875838649882,46
467,2,1630,329,1301,0,0,0,1.0,1,1.0,1,1.0,1,0.078277247697736,44
468,3,1633,330,1303,0,0,0,1.0,1,1.0,1,1.0,1,0.14422202168604525,41
469,1,1634,330,1304,0,0,0,1.0,1,1.0,1,1.0,1,0.15366508283750793,40
470,2,1636,331,1305,0,0,0,1.0,1,1.0,1,1.0,1,0.1179472273297242,39
471,5,1641,335,1306,0,0,0,1.0,1,1.0,1,1.0,1,0.11455316304175171,38
472,2,1643,337,1306,0,0,0,1.0,1,1.0,1,1.0,1,0.19244617124250427,36
473,4,1647,340,1307,0,0,0,1.0,1,1.0,1,1.0,1,0.17958271462868303,36
474,4,1651,342,1309,0,0,0,1.0,1,1.0,1,1.0,1,0.20215673653802302,34
475,2,1653,344,1309,0,0,0,1.0,1,1.0,1,1.0,1,0.22439877340535722,34
476,1,1654,345,1309,0,0,0,1.0,1,1.0,1,1.0,1,0.3250378850528629,32
477,3,1657,347,1310,0,0,0,1.0,1,1.0,1,1.0,1,0.27903170157903484,32
478,1,1658,347,1311,0,0,0,1.0,1,1.0,1,1.0,1,0.231458817395538,30
479,2,1660,348,1312,0,0,0,1.0,1,1.0,1,1.0,1,0.2359723019082761,31
480,0,1660,348,1312,0,0,0,1.0,1,1.0,1,1.0,1,0.26401772863600986,27
481,3,1663,350,1313,0,0,0,1.0,1,1.0,1,1.0,1,0.2446377812987163,28
482,2,1665,350,1315,0,0,0,1.0,1,1.0,1,1.0,1,0.21856542376610952,28
483,2,1667,351,1316,0,0,0,1.0,1,1.0,1,1.0,1,0.22516380251542345,29
484,3,1670,352,1318,0,0,0,1.0,1,1.0,1,1.0,1,0.2399420095759436,29
485,3,1673,353,1320,0,0,0,1.0,1,1.0,1,1.0,1,0.19096750908921753,29
486,1,1674,353,1321,0,0,0,1.0,1,1.0,1,1.0,1,0.21158149398264325,31
487,3,1677,353,1324,0,0,0,1.0,1,1.0,1,1.0,1,0.16576913504680565,33
488,1,1678,353,1325,0,0,0,1.0,1,1.0,1,1.0,1,0.17684146024004652,34
489,5,1683,355,1328,0,0,0,1.0,1,1.0,1,1.0,1,0.2374353649035198,34
490,4,1687,355,1332,0,0,0,1.0,1,1.0,1,1.0,1,0.19060104298493832,34
491,1,1688,355,1333,0,0,0,1.0,1,1.0,1,1.0,1,0.19163287287311864,34
492,2,1690,355,1335,0,0,0,1.0,1,1.0,1,1.0,1,0.19163287287311864,34
493,1,1691,356,1335,0,0,0,1.0,1,1.0,1,1.0,1,0.2339352039141393,34
494,4,1695,358,1337,0,0,0,1.0,1,1.0,1,1.0,1,0.2469604385323364,36
495,3,1698,358,1340,0,0,0,1.0,1,1.0,1,1.0,1,0.1913909261289499,36
496,5,1703,358,1345,0,0,0,1.0,1,1.0,1,1.0,1,0.12518977695502315,37
497,2,1705,358,1347,0,0,0,1.0,1,1.0,1,1.0,1,0.08709852548965837,39
498,2,1707,358,1349,0,0,0,1.0,1,1.0,1,1.0,1,0.09450476003397744,40
499,3,1710,359,1351,0,0,0,1.0,1,1.0,1,1.0,1,0.11654119086892176,40
500,8,1718,361,1357,0,0,0,1.0,1,1.0,1,1.0,1,0.13220615741655292,42
501,7,1725,361,1364,0,0,0,1.0,1,1.0,1,1.0,1,0.11836630688438754,42
502,5,1730,363,1367,0,0,0,1.0,1,1.0,1,1.0,1,0.13505774406862883,42
503,5,1735,364,1371,0,0,0,1.0,1,1.0,1,1.0,1,0.13918001255193246,41
504,4,1739,365,1374,0,0,0,1.0,1,1.0,1,1.0,1,0.18446192643766418,42
505,4,1743,366,1377,0,0,0,1.0,1,1.0,1,1.0,1,0.13783755018187394,38
506,1,1744,367,1377,0,0,0,1.0,1,1.0,1,1.0,1,0.16038541296655245,37
507,1,1745,367,1378,0,0,0,1.0,1,1.0,1,1.0,1,0.1870391211395883,35
508,4,1749,371,1378,0,0,0,1.0,1,1.0,1,1.0,1,0.26750950558837727,35
509,6,1755,373,1382,0,0,0,1.0,1,1.0,1,1.0,1,0.23275808574851165,34
510,0,1755,373,1382,0,0,0,1.0,1,1.0,1,1.0,1,0.24313053513142932,34
511,3,1758,374,1384,0,0,0,1.0,1,1.0,1,1.0,1,0.17360132061810493,32
512,0,1758,374,1384,0,0,0,1.0,1,1.0,1,1.0,1,0.22477591797781174,30
513,0,1758,374,1384,0,0,0,1.0,1,1.0,1,1.0,1,0.19890705227313724,31
514,0,1758,374,1384,0,0,0,1.0,1,1.0,1,1.0,1,0.19890705227313724,31
515,5,1763,376,1387,0,0,0,1.0,1,1.0,1,1.0,1,0.21625601395323063,32
516,2,1765,376,1389,0,0,0,1.0,1,1.0,1,1.0,1,0.18034216720157834,31
517,2,1767,377,1390,0,0,0,1.0,1,1.0,1,1.0,1,0.19925703818768264,32
518,1,1768,377,1391,0,0,0,1.0,1,1.0,1,1.0,1,0.16091313551150613,31
519,3,1771,378,1393,0,0,0,1.0,1,1.0,1,1.0,1,0.15704785886792538,31
520,3,1774,380,1394,0,0,0,1.0,1,1.0,1,1.0,1,0.17528366272362966,33
521,4,1778,381,1397,0,0,0,1.0,1,1.0,1,1.0,1,0.20707380624603475,34
522,5,1783,383,1400,0,0,0,1.0,1,1.0,1,1.0,1,0.20715523013542514,34
523,2,1785,383,1402,0,0,0,1.0,1,1.0,1,1.0,1,0.19459857612166917,33
524,6,1791,384,1407,0,0,0,1.0,1,1.0,1,1.0,1,0.18095922637396303,34
525,3,1794,384,1410,0,0,0,1.0,1,1.0,1,1.0,1,0.12871776583347175,32
526,0,1794,384,1410,0,0,0,1.0,1,1.0,1,1.0,1,0.12871776583347175,32
527,0,1794,384,1410,0,0,0,1.0,1,1.0,1,1.0,1,0.17388597900945701,31
528,2,1796,386,1410,0,0,0,1.0,1,1.0,1,1.0,1,0.20556386125185355,31
529,0,1796,386,1410,0,0,0,1.0,1,1.0,1,1.0,1,0.22405869152163443,30
530,0,1796,386,1410,0,0,0,1.0,1,1.0,1,1.0,1,0.22405869152163443,30
531,1,1797,387,1410,0,0,0,1.0,1,1.0,1,1.0,1,0.22143086486073105,32
532,5,1802,390,1412,0,0,0,1.0,1,1.0,1,1.0,1,0.21379599099664595,32
533,3,1805,392,1413,0,0,0,1.0,1,1.0,1,1.0,1,0.25575204946603847,34
534,6,1811,392,1419,0,0,0,1.0,1,1.0,1,1.0,1,0.2067870953222928,34
535,5,1816,394,1422,0,0,0,1.0,1,1.0,1,1.0,1,0.2573626666480798,37
536,1,1817,394,1423,0,0,0,1.0,1,1.0,1,1.0,1,0.26059260654470445,37
537,4,1821,395,1426,0,0,0,1.0,1,1.0,1,1.0,1,0.2818252911523587,37
538,2,1823,395,1428,0,0,0,1.0,1,1.0,1,1.0,1,0.2527429113210709,38
539,3,1826,395,1431,0,0,0,1.0,1,1.0,1,1.0,1,0.25068812424231907,38
540,3,1829,395,1434,0,0,0,1.0,1,1.0,1,1.0,1,0.2542227486870266,38
541,0,1829,395,1434,0,0,0,1.0,1,1.0,1,1.0,1,0.23732404273083568,39
542,2,1831,396,1435,0,0,0,1.0,1,1.0,1,1.0,1,0.20460340428425836,40
543,3,1834,398,1436,0,0,0,1.0,1,1.0,1,1.0,1,0.25936771055382896,37
544,6,1840,401,1439,0,0,0,1.0,1,1.0,1,1.0,1,0.2760325985038941,35
545,1,1841,401,1440,0,0,0,1.0,1,1.0,1,1.0,1,0.21125724411842461,35
546,3,1844,404,1440,0,0,0,1.0,1,1.0,1,1.0,1,0.23731539261804452,35
547,3,1847,407,1440,0,0,0,1.0,1,1.0,1,1.0,1,0.2869634414235128,34
548,3,1850,408,1442,0,0,0,1.0,1,1.0,1,1.0,1,0.32631694396405564,34
549,4,1854,411,1443,0,0,0,1.0,1,1.0,1,1.0,1,0.43011194827704485,31
550,1,1855,411,1444,0,0,0,1.0,1,1.0,1,1.0,1,0.3875737100635062,30
551,1,1856,412,1444,0,0,0,1.0,1,1.0,1,1.0,1,0.36934669121434793,31
552,3,1859,412,1447,0,0,0,1.0,1,1.0,1,1.0,1,0.3443776901332693,29
553,2,1861,412,1449,0,0,0,1.0,1,1.0,1,1.0,1,0.28775265682343626,30
554,2,1863,412,1451,0,0,0,1.0,1,1.0,1,1.0,1,0.30562978808694224,30
555,3,1866,412,1454,0,0,0,1.0,1,1.0,1,1.0,1,0.2346983201697096,30
556,4,1870,412,1458,0,0,0,1.0,1,1.0,1,1.0,1,0.15375569563463443,31
557,0,1870,412,1458,0,0,0,1.0,1,1.0,1,1.0,1,0.19067904214755982,31
558,1,1871,412,1459,0,0,0,1.0,1,1.0,1,1.0,1,0.18838092666345005,31
559,1,1872,412,1460,0,0,0,1.0,1,1.0,1,1.0,1,0.14165844543386222,31
560,2,1874,412,1462,0,0,0,1.0,1,1.0,1,1.0,1,0.15783546342414914,32
561,3,1877,413,1464,0,0,0,1.0,1,1.0,1,1.0,1,0.16585516321917015,33
562,1,1878,413,1465,0,0,0,1.0,1,1.0,1,1.0,1,0.156167397227486,33
563,2,1880,415,1465,0,0,0,1.0,1,1.0,1,1.0,1,0.15730963341499662,33
564,2,1882,416,1466,0,0,0,1.0,1,1.0,1,1.0,1,0.1356875399694581,34
565,5,1887,417,1470,0,0,0,1.0,1,1.0,1,1.0,1,0.20366638844518747,35
566,4,1891,418,1473,0,0,0,1.0,1,1.0,1,1.0,1,0.17482016075826684,36
567,1,1892,419,1473,0,0,0,1.0,1,1.0,1,1.0,1,0.168176511032372,37
568,1,1893,419,1474,0,0,0,1.0,1,1.0,1,1.0,1,0.19077839656041615,36
569,3,1896,420,1476,0,0,0,1.0,1,1.0,1,1.0,1,0.1928292889440185,37
570,2,1898,420,1478,0,0,0,1.0,1,1.0,1,1.0,1,0.18867211976850437,38
571,4,1902,421,1481,0,0,0,1.0,1,1.0,1,1.0,1,0.15072970324740187,38
572,3,1905,421,1484,0,0,0,1.0,1,1.0,1,1.0,1,0.14925677645635133,39
573,4,1909,421,1488,0,0,0,1.0,1,1.0,1,1.0,1,0.128187907168394,39
574,2,1911,421,1490,0,0,0,1.0,1,1.0,1,1.0,1,0.15398090515164758,41
575,4,1915,421,1494,0,0,0,1.0,1,1.0,1,1.0,1,0.11197616063182986,41
576,2,1917,421,1496,0,0,0,1.0,1,1.0,1,1.0,1,0.0990692159361382,42
577,2,1919,421,1498,0,0,0,1.0,1,1.0,1,1.0,1,0.0990692159361382,42
578,3,1922,422,1500,0,0,0,1.0,1,1.0,1,1.0,1,0.14275467597865543,41
579,3,1925,422,1503,0,0,0,1.0,1,1.0,1,1.0,1,0.13543136624474508,42
580,5,1930,423,1507,0,0,0,1.0,1,1.0,1,1.0,1,0.1856206253860488,43
581,5,1935,424,1511,0,0,0,1.0,1,1.0,1,1.0,1,0.1614486146507164,42
582,4,1939,424,1515,0,0,0,1.0,1,1.0,1,1.0,1,0.17332527632065306,41
583,5,1944,425,1519,0,0,0,1.0,1,1.0,1,1.0,1,0.18942939603354486,40
584,6,1950,427,1523,0,0,0,1.0,1,1.0,1,1.0,1,0.19723055672467124,38
585,5,1955,429,1526,0,0,0,1.0,1,1.0,1,1.0,1,0.23259390147530493,38
586,8,1963,431,1532,0,0,0,1.0,1,1.0,1,1.0,1,0.09587352791303917,37
587,7,1970,434,1536,0,0,0,1.0,1,1.0,1,1.0,1,0.11145789345594023,35
588,1,1971,435,1536,0,0,0,1.0,1,1.0,1,1.0,1,0.1121924858695284,35
589,0,1971,435,1536,0,0,0,1.0,1,1.0,1,1.0,1,0.128406946717705,34
590,3,1974,436,1538,0,0,0,1.0,1,1.0,1,1.0,1,0.1324510121902731,36
591,2,1976,436,1540,0,0,0,1.0,1,1.0,1,1.0,1,0.17020053168768237,35
592,4,1980,438,1542,0,0,0,1.0,1,1.0,1,1.0,1,0.14425263861005327,37
593,0,1980,438,1542,0,0,0,1.0,1,1.0,1,1.0,1,0.13925399155051138,36
594,0,1980,438,1542,0,0,0,1.0,1,1.0,1,1.0,1,0.1523120674395514,35
595,3,1983,439,1544,0,0,0,1.0,1,1.0,1,1.0,1,0.132611858462852,34
596,3,1986,441,1545,0,0,0,1.0,1,1.0,1,1.0,1,0.13052069499039384,34
597,2,1988,443,1545,0,0,0,1.0,1,1.0,1,1.0,1,0.13922749868659992,33
598,2,1990,443,1547,0,0,0,1.0,1,1.0,1,1.0,1,0.15616508194254528,33
599,2,1992,444,1548,0,0,0,1.0,1,1.0,1,1.0,1,0.1740934594760089,33
600,4,1996,446,1550,0,0,0,1.0,1,1.0,1,1.0,1,0.20702781611495763,33
601,2,1998,447,1551,0,0,0,1.0,1,1.0,1,1.0,1,0.21606276722346612,34
602,2,2000,447,1553,0,0,0,1.0,1,1.0,1,1.0,1,0.19567840153287788,35
603,2,2002,447,1555,0,0,0,1.0,1,1.0,1,1.0,1,0.21555855714963695,35
604,4,2006,447,1559,0,0,0,1.0,1,1.0,1,1.0,1,0.17751535941977814,35
605,2,2008,447,1561,0,0,0,1.0,1,1.0,1,1.0,1,0.14497070570855503,35
606,1,2009,447,1562,0,0,0,1.0,1,1.0,1,1.0,1,0.15127020616261544,35
607,1,2010,448,1562,0,0,0,1.0,1,1.0,1,1.0,1,0.16022924002557065,35
608,1,2011,448,1563,0,0,0,1.0,1,1.0,1,1.0,1,0.17551409040961846,36
609,2,2013,449,1564,0,0,0,1.0,1,1.0,1,1.0,1,0.16956203262128192,37
610,1,2014,449,1565,0,0,0,1.0,1,1.0,1,1.0,1,0.1603238271242466,37
611,1,2015,450,1565,0,0,0,1.0,1,1.0,1,1.0,1,0.180223334246073,39
612,7,2022,452,1570,0,0,0,1.0,1,1.0,1,1.0,1,0.1894873143794143,39
613,1,2023,452,1571,0,0,0,1.0,1,1.0,1,1.0,1,0.18099337859020517,39
614,3,2026,453,1573,0,0,0,1.0,1,1.0,1,1.0,1,0.18844965793246365,39
615,3,2029,454,1575,0,0,0,1.0,1,1.0,1,1.0,1,0.18866411016323023,39
616,5,2034,455,1579,0,0,0,1.0,1,1.0,1,1.0,1,0.12831136926015746,38
617,1,2035,456,1579,0,0,0,1.0,1,1.0,1,1.0,1,0.11800399824705475,39
618,2,2037,457,1580,0,0,0,1.0,1,1.0,1,1.0,1,0.15984070381538507,40
619,4,2041,458,1583,0,0,0,1.0,1,1.0,1,1.0,1,0.15717479482097702,39
620,2,2043,459,1584,0,0,0,1.0,1,1.0,1,1.0,1,0.10828655456127814,38
621,2,2045,461,1584,0,0,0,1.0,1,1.0,1,1.0,1,0.12197804802302442,38
622,3,2048,463,1585,0,0,0,1.0,1,1.0,1,1.0,1,0.18824122639699176,38
623,4,2052,465,1587,0,0,0,1.0,1,1.0,1,1.0,1,0.1817352174812832,37
624,2,2054,466,1588,0,0,0,1.0,1,1.0,1,1.0,1,0.23646500974683413,33
625,2,2056,468,1588,0,0,0,1.0,1,1.0,1,1.0,1,0.2620028383405468,32
626,2,2058,469,1589,0,0,0,1.0,1,1.0,1,1.0,1,0.24701983662267882,31
627,2,2060,470,1590,0,0,0,1.0,1,1.0,1,1.0,1,0.20093007348595288,30
628,4,2064,474,1590,0,0,0,1.0,1,1.0,1,1.0,1,0.18579881580294516,32
629,1,2065,475,1590,0,0,0,1.0,1,1.0,1,1.0,1,0.21975988326407478,29
630,0,2065,475,1590,0,0,0,1.0,1,1.0,1,1.0,1,0.22536926374135482,29
631,2,2067,477,1590,0,0,0,1.0,1,1.0,1,1.0,1,0.3030878103853368,25
632,1,2068,478,1590,0,0,0,1.0,1,1.0,1,1.0,1,0.3049330687611281,24
633,1,2069,478,1591,0,0,0,1.0,1,1.0,1,1.0,1,0.28199722629027746,23
634,0,2069,478,1591,0,0,0,1.0,1,1.0,1,1.0,1,0.28199722629027746,23
635,2,2071,478,1593,0,0,0,1.0,1,1.0,1,1.0,1,0.26829885031753,22
636,1,2072,478,1594,0,0,0,1.0,1,1.0,1,1.0,1,0.2443121776663479,22
637,1,2073,479,1594,0,0,0,1.0,1,1.0,1,1.0,1,0.22915048227905574,23
638,1,2074,480,1594,0,0,0,1.0,1,1.0,1,1.0,1,0.2702727161025887,23
639,1,2075,480,1595,0,0,0,1.0,1,1.0,1,1.0,1,0.23734019257059094,24
640,1,2076,481,1595,0,0,0,1.0,1,1.0,1,1.0,1,0.29561484018601913,24
641,0,2076,481,1595,0,0,0,1.0,1,1.0,1,1.0,1,0.3132992897392686,25
642,0,2076,481,1595,0,0,0,1.0,1,1.0,1,1.0,1,0.26385361446064254,26
643,1,2077,481,1596,0,0,0,1.0,1,1.0,1,1.0,1,0.18285159769216874,28
644,2,2079,483,1596,0,0,0,1.0,1,1.0,1,1.0,1,0.11469260733980897,28
645,4,2083,485,1598,0,0,0,1.0,1,1.0,1,1.0,1,0.14859053478020698,28
646,0,2083,485,1598,0,0,0,1.0,1,1.0,1,1.0,1,0.14462008474465737,29
647,1,2084,486,1598,0,0,0,1.0,1,1.0,1,1.0,1,0.16715514417615251,30
648,0,2084,486,1598,0,0,0,1.0,1,1.0,1,1.0,1,0.16715514417615251,30
649,6,2090,488,1602,0,0,0,1.0,1,1.0,1,1.0,1,0.20396859746077453,31
650,1,2091,488,1603,0,0,0,1.0,1,1.0,1,1.0,1,0.21443425694961402,31
651,3,2094,489,1605,0,0,0,1.0,1,1.0,1,1.0,1,0.22331358654476358,32
652,3,2097,489,1608,0,0,0,1.0,1,1.0,1,1.0,1,0.22226917596569326,32
653,2,2099,489,1610,0,0,0,1.0,1,1.0,1,1.0,1,0.2260245111297284,33
654,2,2101,489,1612,0,0,0,1.0,1,1.0,1,1.0,1,0.2260245111297284,33
655,6,2107,491,1616,0,0,0,1.0,1,1.0,1,1.0,1,0.1936991121795903,36
656,2,2109,492,1617,0,0,0,1.0,1,1.0,1,1.0,1,0.23958187700857395,36
657,6,2115,494,1621,0,0,0,1.0,1,1.0,1,1.0,1,0.26619906716766417,35
658,5,2120,496,1624,0,0,0,1.0,1,1.0,1,1.0,1,0.2957276314821164,33
659,1,2121,496,1625,0,0,0,1.0,1,1.0,1,1.0,1,0.2716279234455145,35
660,3,2124,496,1628,0,0,0,1.0,1,1.0,1,1.0,1,0.2879978266606421,34
661,7,2131,497,1634,0,0,0,1.0,1,1.0,1,1.0,1,0.1903356627863975,33
662,4,2135,498,1637,0,0,0,1.0,1,1.0,1,1.0,1,0.2205246628204496,31
663,2,2137,500,1637,0,0,0,1.0,1,1.0,1,1.0,1,0.22880411129102532,29
664,2,2139,501,1638,0,0,0,1.0,1,1.0,1,1.0,1,0.31280427264593963,27
665,4,2143,502,1641,0,0,0,1.0,1,1.0,1,1.0,1,0.2388046541740742,27
666,2,2145,503,1642,0,0,0,1.0,1,1.0,1,1.0,1,0.23872695609613268,28
667,6,2151,504,1647,0,0,0,1.0,1,1.0,1,1.0,1,0.17786220283967497,26
668,1,2152,505,1647,0,0,0,1.0,1,1.0,1,1.0,1,0.17578705464497665,26
669,1,2153,506,1647,0,0,0,1.0,1,1.0,1,1.0,1,0.1329536971298322,25
670,0,2153,506,1647,0,0,0,1.0,1,1.0,1,1.0,1,0.16584959454337642,24
671,0,2153,506,1647,0,0,0,1.0,1,1.0,1,1.0,1,0.16584959454337642,24
672,2,2155,507,1648,0,0,0,1.0,1,1.0,1,1.0,1,0.22651110887263493,25
673,1,2156,507,1649,0,0,0,1.0,1,1.0,1,1.0,1,0.26074540978103034,25
674,4,2160,509,1651,0,0,0,1.0,1,1.0,1,1.0,1,0.22184293569546792,25
675,5,2165,512,1653,0,0,0,1.0,1,1.0,1,1.0,1,0.2124598517857083,26
676,4,2169,513,1656,0,0,0,1.0,1,1.0,1,1.0,1,0.12638208548685698,27
677,0,2169,513,1656,0,0,0,1.0,1,1.0,1,1.0,1,0.14168882427977275,28
678,2,2171,514,1657,0,0,0,1.0,1,1.0,1,1.0,1,0.13274525348487498,28
679,4,2175,515,1660,0,0,0,1.0,1,1.0,1,1.0,1,0.1735085079201243,30
680,4,2179,515,1664,0,0,0,1.0,1,1.0,1,1.0,1,0.19797170820524757,29
681,3,2182,516,1666,0,0,0,1.0,1,1.0,1,1.0,1,0.2564774545377502,29
682,3,2185,516,1669,0,0,0,1.0,1,1.0,1,1.0,1,0.25277355835697124,30
683,1,2186,516,1670,0,0,0,1.0,1,1.0,1,1.0,1,0.21747894867554302,30
684,2,2188,516,1672,0,0,0,1.0,1,1.0,1,1.0,1,0.23999639726927638,31
685,1,2189,516,1673,0,0,0,1.0,1,1.0,1,1.0,1,0.2849003832568756,30
686,3,2192,517,1675,0,0,0,1.0,1,1.0,1,1.0,1,0.27729642997536547,30
687,9,2201,519,1682,0,0,0,1.0,1,1.0,1,1.0,1,0.29674490986077745,30
688,6,2207,520,1687,0,0,0,1.0,1,1.0,1,1.0,1,0.2701267856683376,31
689,8,2215,521,1694,0,0,0,1.0,1,1.0,1,1.0,1,0.3495538942474217,32
690,6,2221,521,1700,0,0,0,1.0,1,1.0,1,1.0,1,0.32310565598437246,32
691,7,2228,522,1706,0,0,0,1.0,1,1.0,1,1.0,1,0.0986458727854189,32
692,0,2228,522,1706,0,0,0,1.0,1,1.0,1,1.0,1,0.0986458727854189,32
693,0,2228,522,1706,0,0,0,1.0,1,1.0,1,1.0,1,0.11667589437049385,34
694,0,2228,522,1706,0,0,0,1.0,1,1.0,1,1.0,1,0.14224161205044195,36
695,3,2231,525,1706,0,0,0,1.0,1,1.0,1,1.0,1,0.1858231238024934,34
696,4,2235,526,1709,0,0,0,1.0,1,1.0,1,1.0,1,0.21305854303762756,33
697,0,2235,526,1709,0,0,0,1.0,1,1.0,1,1.0,1,0.21486610991293625,33
698,1,2236,526,1710,0,0,0,1.0,1,1.0,1,1.0,1,0.22494950324390195,34
699,4,2240,527,1713,0,0,0,1.0,1,1.0,1,1.0,1,0.20576469942270553,33
700,1,2241,527,1714,0,0,0,1.0,1,1.0,1,1.0,1,0.18595893474649008,32
701,0,2241,527,1714,0,0,0,1.0,1,1.0,1,1.0,1,0.20574444826068028,33
702,6,2247,530,1717,0,0,0,1.0,1,1.0,1,1.0,1,0.20692196958537865,34
703,2,2249,530,1719,0,0,0,1.0,1,1.0,1,1.0,1,0.22653088668615892,32
704,0,2249,530,1719,0,0,0,1.0,1,1.0,1,1.0,1,0.2057744594956213,31
705,4,2253,532,1721,0,0,0,1.0,1,1.0,1,1.0,1,0.24023775688138177,33
706,10,2263,534,1729,0,0,0,1.0,1,1.0,1,1.0,1,0.15992151299577076,33
707,2,2265,534,1731,0,0,0,1.0,1,1.0,1,1.0,1,0.16494637491470854,31
708,3,2268,536,1732,0,0,0,1.0,1,1.0,1,1.0,1,0.2393707558284957,31
709,2,2270,537,1733,0,0,0,1.0,1,1.0,1,1.0,1,0.22766001245305337,30
710,2,2272,538,1734,0,0,0,1.0,1,1.0,1,1.0,1,0.212493507543709,30
711,1,2273,538,1735,0,0,0,1.0,1,1.0,1,1.0,1,0.23141388348862968,30
712,1,2274,538,1736,0,0,0,1.0,1,1.0,1,1.0,1,0.19634852989906657,30
713,1,2275,538,1737,0,0,0,1.0,1,1.0,1,1.0,1,0.24540890941923332,31
714,6,2281,539,1742,0,0,0,1.0,1,1.0,1,1.0,1,0.25840557652376217,31
715,0,2281,539,1742,0,0,0,1.0,1,1.0,1,1.0,1,0.2818436134899461,30
716,0,2281,539,1742,0,0,0,1.0,1,1.0,1,1.0,1,0.27333288748796397,31
717,3,2284,539,1745,0,0,0,1.0,1,1.0,1,1.0,1,0.2781187520532177,32
718,1,2285,540,1745,0,0,0,1.0,1,1.0,1,1.0,1,0.30294200882336325,32
719,2,2287,540,1747,0,0,0,1.0,1,1.0,1,1.0,1,0.30294200882336325,32
720,1,2288,540,1748,0,0,0,1.0,1,1.0,1,1.0,1,0.3208572666202857,34
721,4,2292,540,1752,0,0,0,1.0,1,1.0,1,1.0,1,0.20761516744498415,34
722,1,2293,541,1752,0,0,0,1.0,1,1.0,1,1.0,1,0.22859377923213484,34
723,4,2297,541,1756,0,0,0,1.0,1,1.0,1,1.0,1,0.20585110071386922,35
724,1,2298,541,1757,0,0,0,1.0,1,1.0,1,1.0,1,0.17588740267338177,36
725,3,2301,541,1760,0,0,0,1.0,1,1.0,1,1.0,1,0.17492385673860442,37
726,2,2303,541,1762,0,0,0,1.0,1,1.0,1,1.0,1,0.17492385673860442,37
727,1,2304,541,1763,0,0,0,1.0,1,1.0,1,1.0,1,0.17903693590103367,38
728,1,2305,541,1764,0,0,0,1.0,1,1.0,1,1.0,1,0.18145258007956105,39
729,2,2307,541,1766,0,0,0,1.0,1,1.0,1,1.0,1,0.18145258007956105,39
730,1,2308,541,1767,0,0,0,1.0,1,1.0,1,1.0,1,0.1731295132591729,40
731,2,2310,541,1769,0,0,0,1.0,1,1.0,1,1.0,1,0.1731295132591729,40
732,3,2313,541,1772,0,0,0,1.0,1,1.0,1,1.0,1,0.18674688540413054,41
733,1,2314,541,1773,0,0,0,1.0,1,1.0,1,1.0,1,0.12815541413009934,41
734,2,2316,542,1774,0,0,0,1.0,1,1.0,1,1.0,1,0.1554234551071111,42
735,5,2321,542,1779,0,0,0,1.0,1,1.0,1,1.0,1,0.107713932522588,42
736,1,2322,542,1780,0,0,0,1.0,1,1.0,1,1.0,1,0.1466730776935711,41
737,2,2324,544,1780,0,0,0,1.0,1,1.0,1,1.0,1,0.2038375381913571,41
738,3,2327,544,1783,0,0,0,1.0,1,1.0,1,1.0,1,0.16060615813329826,39
739,2,2329,545,1784,0,0,0,1.0,1,1.0,1,1.0,1,0.15398325404872584,39
740,0,2329,545,1784,0,0,0,1.0,1,1.0,1,1.0,1,0.14935071561031543,39
741,1,2330,546,1784,0,0,0,1.0,1,1.0,1,1.0,1,0.16855016528375413,38
742,1,2331,547,1784,0,0,0,1.0,1,1.0,1,1.0,1,0.196388813131233,39
743,4,2335,549,1786,0,0,0,1.0,1,1.0,1,1.0,1,0.1694955935194712,39
744,2,2337,550,1787,0,0,0,1.0,1,1.0,1,1.0,1,0.1473694502779468,39
745,6,2343,553,1790,0,0,0,1.0,1,1.0,1,1.0,1,0.15475952004345564,39
746,6,2349,556,1793,0,0,0,1.0,1,1.0,1,1.0,1,0.17128594019913257,40
747,3,2352,557,1795,0,0,0,1.0,1,1.0,1,1.0,1,0.19587913620830646,41
748,2,2354,559,1795,0,0,0,1.0,1,1.0,1,1.0,1,0.19589407870518935,41
749,1,2355,559,1796,0,0,0,1.0,1,1.0,1,1.0,1,0.2047107177706152,41
750,4,2359,561,1798,0,0,0,1.0,1,1.0,1,1.0,1,0.23881400186591825,39
751,6,2365,561,1804,0,0,0,1.0,1,1.0,1,1.0,1,0.11106259547494833,41
752,3,2368,562,1806,0,0,0,1.0,1,1.0,1,1.0,1,0.11214283530730827,41
753,0,2368,562,1806,0,0,0,1.0,1,1.0,1,1.0,1,0.1300520005516041,41
754,2,2370,563,1807,0,0,0,1.0,1,1.0,1,1.0,1,0.1331459478425293,41
755,4,2374,564,1810,0,0,0,1.0,1,1.0,1,1.0,1,0.14593427636947126,41
756,1,2375,564,1811,0,0,0,1.0,1,1.0,1,1.0,1,0.14531306104103167,41
757,2,2377,564,1813,0,0,0,1.0,1,1.0,1,1.0,1,0.18748827870324422,39
758,2,2379,564,1815,0,0,0,1.0,1,1.0,1,1.0,1,0.17058805236778218,39
759,0,2379,564,1815,0,0,0,1.0,1,1.0,1,1.0,1,0.1443553250669949,39
760,1,2380,564,1816,0,0,0,1.0,1,1.0,1,1.0,1,0.1598067075421401,40
761,1,2381,564,1817,0,0,0,1.0,1,1.0,1,1.0,1,0.15079465548387666,41
762,2,2383,564,1819,0,0,0,1.0,1,1.0,1,1.0,1,0.12902298843337776,42
763,3,2386,564,1822,0,0,0,1.0,1,1.0,1,1.0,1,0.1495882420450146,43
764,5,2391,564,1827,0,0,0,1.0,1,1.0,1,1.0,1,0.15093890344197247,43
765,7,2398,564,1834,0,0,0,1.0,1,1.0,1,1.0,1,0.12739268816306987,45
766,0,2398,564,1834,0,0,0,1.0,1,1.0,1,1.0,1,0.12739268816306987,45
767,0,2398,564,1834,0,0,0,1.0,1,1.0,1,1.0,1,0.13598288141184722,46
768,0,2398,564,1834,0,0,0,1.0,1,1.0,1,1.0,1,0.12575328130288327,45
769,2,2400,565,1835,0,0,0,1.0,1,1.0,1,1.0,1,0.14248554770053515,46
770,0,2400,565,1835,0,0,0,1.0,1,1.0,1,1.0,1,0.13501871974425603,47
771,3,2403,567,1836,0,0,0,1.0,1,1.0,1,1.0,1,0.17566309827024618,47
772,1,2404,567,1837,0,0,0,1.0,1,1.0,1,1.0,1,0.17841826660299243,46
773,3,2407,569,1838,0,0,0,1.0,1,1.0,1,1.0,1,0.1943626682889209,45
774,1,2408,569,1839,0,0,0,1.0,1,1.0,1,1.0,1,0.14985986004696406,45
775,3,2411,572,1839,0,0,0,1.0,1,1.0,1,1.0,1,0.19010744438064905,45
776,1,2412,572,1840,0,0,0,1.0,1,1.0,1,1.0,1,0.16618297370554153,43
777,3,2415,572,1843,0,0,0,1.0,1,1.0,1,1.0,1,0.16922993119207208,44
778,4,2419,574,1845,0,0,0,1.0,1,1.0,1,1.0,1,0.22448560675133203,45
779,3,2422,574,1848,0,0,0,1.0,1,1.0,1,1.0,1,0.22087242490519884,45
780,5,2427,575,1852,0,0,0,1.0,1,1.0,1,1.0,1,0.25276880473309676,45
781,7,2434,575,1859,0,0,0,1.0,1,1.0,1,1.0,1,0.13545393286928634,46
782,0,2434,575,1859,0,0,0,1.0,1,1.0,1,1.0,1,0.16362456327923677,47
783,0,2434,575,1859,0,0,0,1.0,1,1.0,1,1.0,1,0.14756452341896897,46
784,0,2434,575,1859,0,0,0,1.0,1,1.0,1,1.0,1,0.1555913607127732,45
785,0,2434,575,1859,0,0,0,1.0,1,1.0,1,1.0,1,0.17019099446419783,43
786,3,2437,576,1861,0,0,0,1.0,1,1.0,1,1.0,1,0.1399677459408641,43
787,4,2441,577,1864,0,0,0,1.0,1,1.0,1,1.0,1,0.13823021143626874,43
788,2,2443,578,1865,0,0,0,1.0,1,1.0,1,1.0,1,0.12852050348825314,44
789,2,2445,578,1867,0,0,0,1.0,1,1.0,1,1.0,1,0.13101134761200348,46
790,3,2448,579,1869,0,0,0,1.0,1,1.0,1,1.0,1,0.15531026520643787,46
791,1,2449,579,1870,0,0,0,1.0,1,1.0,1,1.0,1,0.16250042418232816,46
792,1,2450,579,1871,0,0,0,1.0,1,1.0,1,1.0,1,0.15128203866964274,47
793,1,2451,579,1872,0,0,0,1.0,1,1.0,1,1.0,1,0.17775205396618393,48
794,2,2453,580,1873,0,0,0,1.0,1,1.0,1,1.0,1,0.16614102398551003,48
795,0,2453,580,1873,0,0,0,1.0,1,1.0,1,1.0,1,0.15886720691082454,47
796,1,2454,581,1873,0,0,0,1.0,1,1.0,1,1.0,1,0.1439513448507869,45
797,1,2455,581,1874,0,0,0,1.0,1,1.0,1,1.0,1,0.1533267192831096,47
798,3,2458,582,1876,0,0,0,1.0,1,1.0,1,1.0,1,0.1496988581064692,48
799,5,2463,583,1880,0,0,0,1.0,1,1.0,1,1.0,1,0.15532396345352456,48
800,4,2467,584,1883,0,0,0,1.0,1,1.0,1,1.0,1,0.13224872326517476,48
801,2,2469,585,1884,0,0,0,1.0,1,1.0,1,1.0,1,0.12236581456616437,49
802,2,2471,587,1884,0,0,0,1.0,1,1.0,1,1.0,1,0.1752638545506915,50
803,2,2473,587,1886,0,0,0,1.0,1,1.0,1,1.0,1,0.16821530987559394,50
804,0,2473,587,1886,0,0,0,1.0,1,1.0,1,1.0,1,0.16821530987559394,50
805,4,2477,588,1889,0,0,0,1.0,1,1.0,1,1.0,1,0.17053970819559164,50
806,2,2479,588,1891,0,0,0,1.0,1,1.0,1,1.0,1,0.16113303194937273,51
807,1,2480,588,1892,0,0,0,1.0,1,1.0,1,1.0,1,0.17043926512070037,51
808,4,2484,588,1896,0,0,0,1.0,1,1.0,1,1.0,1,0.1726352672801853,53
809,1,2485,588,1897,0,0,0,1.0,1,1.0,1,1.0,1,0.1369595179122793,51
810,1,2486,589,1897,0,0,0,1.0,1,1.0,1,1.0,1,0.17385791773652948,52
811,7,2493,591,1902,0,0,0,1.0,1,1.0,1,1.0,1,0.17203936160302488,50
812,3,2496,591,1905,0,0,0,1.0,1,1.0,1,1.0,1,0.10756907688446571,51
813,2,2498,593,1905,0,0,0,1.0,1,1.0,1,1.0,1,0.14461564494062784,51
814,3,2501,594,1907,0,0,0,1.0,1,1.0,1,1.0,1,0.19148733351236522,52
815,1,2502,594,1908,0,0,0,1.0,1,1.0,1,1.0,1,0.18464934107084224,50
816,0,2502,594,1908,0,0,0,1.0,1,1.0,1,1.0,1,0.18464934107084224,50
817,0,2502,594,1908,0,0,0,1.0,1,1.0,1,1.0,1,0.17975480580010916,49
818,4,2506,597,1909,0,0,0,1.0,1,1.0,1,1.0,1,0.19499514689568131,49
819,2,2508,597,1911,0,0,0,1.0,1,1.0,1,1.0,1,0.20806787777642471,50
820,1,2509,597,1912,0,0,0,1.0,1,1.0,1,1.0,1,0.22195917658738484,49
821,0,2509,597,1912,0,0,0,1.0,1,1.0,1,1.0,1,0.2333584500407661,49
822,1,2510,597,1913,0,0,0,1.0,1,1.0,1,1.0,1,0.24446892362783554,49
823,7,2517,599,1918,0,0,0,1.0,1,1.0,1,1.0,1,0.223335530589924,47
824,5,2522,602,1920,0,0,0,1.0,1,1.0,1,1.0,1,0.2536184088965264,45
825,1,2523,602,1921,0,0,0,1.0,1,1.0,1,1.0,1,0.2100344960616705,43
826,8,2531,604,1927,0,0,0,1.0,1,1.0,1,1.0,1,0.14793412488255994,44
827,4,2535,604,1931,0,0,0,1.0,1,1.0,1,1.0,1,0.09276141682027711,43
828,1,2536,605,1931,0,0,0,1.0,1,1.0,1,1.0,1,0.11364676283016287,43
829,2,2538,606,1932,0,0,0,1.0,1,1.0,1,1.0,1,0.08196598200159545,45
830,1,2539,607,1932,0,0,0,1.0,1,1.0,1,1.0,1,0.08942727870307098,46
831,3,2542,609,1933,0,0,0,1.0,1,1.0,1,1.0,1,0.08883911720743036,48
832,1,2543,610,1933,0,0,0,1.0,1,1.0,1,1.0,1,0.09295055820419353,47
833,1,2544,611,1933,0,0,0,1.0,1,1.0,1,1.0,1,0.11283168187467987,47
834,0,2544,611,1933,0,0,0,1.0,1,1.0,1,1.0,1,0.1157311213164507,46
835,1,2545,611,1934,0,0,0,1.0,1,1.0,1,1.0,1,0.10485537485627199,45
836,4,2549,613,1936,0,0,0,1.0,1,1.0,1,1.0,1,0.09477457972619222,46
837,1,2550,613,1937,0,0,0,1.0,1,1.0,1,1.0,1,0.10536032917535491,46
838,0,2550,613,1937,0,0,0,1.0,1,1.0,1,1.0,1,0.11707879784707609,45
839,3,2553,614,1939,0,0,0,1.0,1,1.0,1,1.0,1,0.12076010631304922,46
840,3,2556,616,1940,0,0,0,1.0,1,1.0,1,1.0,1,0.127901138343693,46
841,9,2565,619,1946,0,0,0,1.0,1,1.0,1,1.0,1,0.14108903371750056,46
842,4,2569,620,1949,0,0,0,1.0,1,1.0,1,1.0,1,0.16273252316083853,46
843,2,2571,622,1949,0,0,0,1.0,1,1.0,1,1.0,1,0.20879448961993682,46
844,7,2578,623,1955,0,0,0,1.0,1,1.0,1,1.0,1,0.23143436137523102,47
845,5,2583,623,1960,0,0,0,1.0,1,1.0,1,1.0,1,0.23698184439864783,48
846,4,2587,623,1964,0,0,0,1.0,1,1.0,1,1.0,1,0.20147890595332119,47
847,5,2592,623,1969,0,0,0,1.0,1,1.0,1,1.0,1,0.20893307777344344,48
848,4,2596,623,1973,0,0,0,1.0,1,1.0,1,1.0,1,0.21323416191884748,48
849,2,2598,624,1974,0,0,0,1.0,1,1.0,1,1.0,1,0.22019473809101803,48
850,0,2598,624,1974,0,0,0,1.0,1,1.0,1,1.0,1,0.22938115538242715,46
851,2,2600,624,1976,0,0,0,1.0,1,1.0,1,1.0,1,0.2011693047730624,45
852,0,2600,624,1976,0,0,0,1.0,1,1.0,1,1.0,1,0.20595232313170558,44
853,1,2601,625,1976,0,0,0,1.0,1,1.0,1,1.0,1,0.19640225386642005,44
854,2,2603,627,1976,0,0,0,1.0,1,1.0,1,1.0,1,0.22191506684150233,45
855,4,2607,627,1980,0,0,0,1.0,1,1.0,1,1.0,1,0.22085620359660715,46
856,9,2616,627,1989,0,0,0,1.0,1,1.0,1,1.0,1,0.205274490149693,46
857,7,2623,627,1996,0,0,0,1.0,1,1.0,1,1.0,1,0.19345121005127802,47
858,3,2626,627,1999,0,0,0,1.0,1,1.0,1,1.0,1,0.20551823083562162,48
859,8,2634,627,2007,0,0,0,1.0,1,1.0,1,1.0,1,0.24913546322491376,48
860,5,2639,627,2012,0,0,0,1.0,1,1.0,1,1.0,1,0.17232949074995343,49
861,9,2648,629,2019,0,0,0,1.0,1,1.0,1,1.0,1,0.2327980773152065,49
862,9,2657,630,2027,0,0,0,1.0,1,1.0,1,1.0,1,0.19605166856941836,49
863,8,2665,630,2035,0,0,0,1.0,1,1.0,1,1.0,1,0.2053418352306152,48
864,7,2672,631,2041,0,0,0,1.0,1,1.0,1,1.0,1,0.21753334383312398,49
865,7,2679,631,2048,0,0,0,1.0,1,1.0,1,1.0,1,0.20405290430316578,48
866,8,2687,632,2055,0,0,0,1.0,1,1.0,1,1.0,1,0.10933644581434779,50
867,13,2700,633,2067,0,0,0,1.0,1,1.0,1,1.0,1,0.15394741111344,50
868,8,2708,635,2073,0,0,0,1.0,1,1.0,1,1.0,1,0.18739530272516358,51
869,7,2715,635,2080,0,0,0,1.0,1,1.0,1,1.0,1,0.16463066622472347,49
870,6,2721,636,2085,0,0,0,1.0,1,1.0,1,1.0,1,0.16507070453283582,49
871,2,2723,637,2086,0,0,0,1.0,1,1.0,1,1.0,1,0.13554218588691996,49
872,2,2725,638,2087,0,0,0,1.0,1,1.0,1,1.0,1,0.09797287047355682,48
873,3,2728,640,2088,0,0,0,1.0,1,1.0,1,1.0,1,0.12445224296863974,49
874,2,2730,641,2089,0,0,0,1.0,1,1.0,1,1.0,1,0.09654383595588605,49
875,4,2734,643,2091,0,0,0,1.0,1,1.0,1,1.0,1,0.10627313255702074,50
876,4,2738,644,2094,0,0,0,1.0,1,1.0,1,1.0,1,0.13183150430131843,50
877,3,2741,645,2096,0,0,0,1.0,1,1.0,1,1.0,1,0.1315473446781506,50
878,5,2746,646,2100,0,0,0,1.0,1,1.0,1,1.0,1,0.1603897178666607,49
879,1,2747,647,2100,0,0,0,1.0,1,1.0,1,1.0,1,0.18953115717098876,49
880,2,2749,647,2102,0,0,0,1.0,1,1.0,1,1.0,1,0.20147054032201975,48
881,0,2749,647,2102,0,0,0,1.0,1,1.0,1,1.0,1,0.18169575513590325,49
882,1,2750,647,2103,0,0,0,1.0,1,1.0,1,1.0,1,0.19331283746261876,48
883,1,2751,647,2104,0,0,0,1.0,1,1.0,1,1.0,1,0.18175553515077947,50
884,0,2751,647,2104,0,0,0,1.0,1,1.0,1,1.0,1,0.16978596995647507,50
885,1,2752,647,2105,0,0,0,1.0,1,1.0,1,1.0,1,0.16866267457753126,49
886,6,2758,648,2110,0,0,0,1.0,1,1.0,1,1.0,1,0.13835160040244382,49
887,1,2759,648,2111,0,0,0,1.0,1,1.0,1,1.0,1,0.09833256255255532,49
888,1,2760,649,2111,0,0,0,1.0,1,1.0,1,1.0,1,0.12745332215965058,47
889,0,2760,649,2111,0,0,0,1.0,1,1.0,1,1.0,1,0.12033377160396724,46
890,1,2761,650,2111,0,0,0,1.0,1,1.0,1,1.0,1,0.18318780667425788,44
891,3,2764,651,2113,0,0,0,1.0,1,1.0,1,1.0,1,0.19721348621084944,45
892,3,2767,652,2115,0,0,0,1.0,1,1.0,1,1.0,1,0.19964719707067122,45
893,0,2767,652,2115,0,0,0,1.0,1,1.0,1,1.0,1,0.19964719707067122,45
894,0,2767,652,2115,0,0,0,1.0,1,1.0,1,1.0,1,0.1801373293177856,44
895,2,2769,653,2116,0,0,0,1.0,1,1.0,1,1.0,1,0.2164693691617161,45
896,4,2773,654,2119,0,0,0,1.0,1,1.0,1,1.0,1,0.2181074666691922,44
897,2,2775,654,2121,0,0,0,1.0,1,1.0,1,1.0,1,0.2181074666691922,44
898,2,2777,654,2123,0,0,0,1.0,1,1.0,1,1.0,1,0.22257049132171153,45
899,4,2781,654,2127,0,0,0,1.0,1,1.0,1,1.0,1,0.2194162662219271,44
900,4,2785,655,2130,0,0,0,1.0,1,1.0,1,1.0,1,0.2546825344575893,46
901,10,2795,656,2139,0,0,0,1.0,1,1.0,1,1.0,1,0.17280127095578024,45
902,5,2800,658,2142,0,0,0,1.0,1,1.0,1,1.0,1,0.13614205081623384,45
903,3,2803,661,2142,0,0,0,1.0,1,1.0,1,1.0,1,0.18331072555047173,44
904,1,2804,662,2142,0,0,0,1.0,1,1.0,1,1.0,1,0.16927430929019296,45
905,2,2806,662,2144,0,0,0,1.0,1,1.0,1,1.0,1,0.19666887807873135,45
906,2,2808,662,2146,0,0,0,1.0,1,1.0,1,1.0,1,0.15158431827986696,45
907,5,2813,665,2148,0,0,0,1.0,1,1.0,1,1.0,1,0.18605754321506376,46
908,6,2819,667,2152,0,0,0,1.0,1,1.0,1,1.0,1,0.09250886608811894,46
909,4,2823,670,2153,0,0,0,1.0,1,1.0,1,1.0,1,0.12449819661733347,46
910,2,2825,670,2155,0,0,0,1.0,1,1.0,1,1.0,1,0.1532822716259203,44
911,2,2827,670,2157,0,0,0,1.0,1,1.0,1,1.0,1,0.15982107473020715,45
912,1,2828,670,2158,0,0,0,1.0,1,1.0,1,1.0,1,0.178024319838212,44
913,2,2830,671,2159,0,0,0,1.0,1,1.0,1,1.0,1,0.16717729838210962,45
914,1,2831,672,2159,0,0,0,1.0,1,1.0,1,1.0,1,0.2048705630961334,45
915,4,2835,672,2163,0,0,0,1.0,1,1.0,1,1.0,1,0.17925549845593003,45
916,4,2839,672,2167,0,0,0,1.0,1,1.0,1,1.0,1,0.10644917207712325,45
917,4,2843,673,2170,0,0,0,1.0,1,1.0,1,1.0,1,0.11629128555654647,46
918,0,2843,673,2170,0,0,0,1.0,1,1.0,1,1.0,1,0.12016318034381349,47
919,2,2845,673,2172,0,0,0,1.0,1,1.0,1,1.0,1,0.11606955611929083,47
920,1,2846,673,2173,0,0,0,1.0,1,1.0,1,1.0,1,0.09223573502343128,47
921,6,2852,674,2178,0,0,0,1.0,1,1.0,1,1.0,1,0.10142262107279135,49
922,5,2857,675,2182,0,0,0,1.0,1,1.0,1,1.0,1,0.11156002224733563,49
923,5,2862,677,2185,0,0,0,1.0,1,1.0,1,1.0,1,0.10320565623023946,47
924,3,2865,678,2187,0,0,0,1.0,1,1.0,1,1.0,1,0.08854224502354031,47
925,8,2873,680,2193,0,0,0,1.0,1,1.0,1,1.0,1,0.13259085708668097,47
926,3,2876,681,2195,0,0,0,1.0,1,1.0,1,1.0,1,0.19621035634867856,46
927,4,2880,682,2198,0,0,0,1.0,1,1.0,1,1.0,1,0.17641990734904348,45
928,2,2882,682,2200,0,0,0,1.0,1,1.0,1,1.0,1,0.19663421491776956,43
929,1,2883,682,2201,0,0,0,1.0,1,1.0,1,1.0,1,0.20061808830291483,42
930,3,2886,683,2203,0,0,0,1.0,1,1.0,1,1.0,1,0.1963707852518766,41
931,8,2894,685,2209,0,0,0,1.0,1,1.0,1,1.0,1,0.11305566331273796,40
932,0,2894,685,2209,0,0,0,1.0,1,1.0,1,1.0,1,0.11305566331273796,40
933,4,2898,687,2211,0,0,0,1.0,1,1.0,1,1.0,1,0.12332815401163919,39
934,4,2902,687,2215,0,0,0,1.0,1,1.0,1,1.0,1,0.12332815401163919,39
935,4,2906,689,2217,0,0,0,1.0,1,1.0,1,1.0,1,0.2278208439023625,41
936,5,2911,689,2222,0,0,0,1.0,1,1.0,1,1.0,1,0.18630478078732823,42
937,6,2917,689,2228,0,0,0,1.0,1,1.0,1,1.0,1,0.21909806846940197,43
938,11,2928,690,2238,0,0,0,1.0,1,1.0,1,1.0,1,0.26275697227759587,44
939,10,2938,690,2248,0,0,0,1.0,1,1.0,1,1.0,1,0.2524312533304691,46
940,7,2945,690,2255,0,0,0,1.0,1,1.0,1,1.0,1,0.2489432236321098,46
941,9,2954,690,2264,0,0,0,1.0,1,1.0,1,1.0,1,0.21185551007647063,46
942,8,2962,692,2270,0,0,0,1.0,1,1.0,1,1.0,1,0.2514716849368818,46
943,7,2969,693,2276,0,0,0,1.0,1,1.0,1,1.0,1,0.19801831463132843,45
944,10,2979,695,2284,0,0,0,1.0,1,1.0,1,1.0,1,0.23431968160613856,45
945,8,2987,697,2290,0,0,0,1.0,1,1.0,1,1.0,1,0.2098576285455661,44
946,7,2994,700,2294,0,0,0,1.0,1,1.0,1,1.0,1,0.1895768492903183,46
947,3,2997,700,2297,0,0,0,1.0,1,1.0,1,1.0,1,0.12278396651434634,44
948,2,2999,701,2298,0,0,0,1.0,1,1.0,1,1.0,1,0.14146562849441055,44
949,4,3003,703,2300,0,0,0,1.0,1,1.0,1,1.0,1,0.18113195621024364,44
950,1,3004,703,2301,0,0,0,1.0,1,1.0,1,1.0,1,0.1889421667869736,43
951,0,3004,703,2301,0,0,0,1.0,1,1.0,1,1.0,1,0.214328706050608,42
952,2,3006,704,2302,0,0,0,1.0,1,1.0,1,1.0,1,0.22583107920640919,42
953,1,3007,704,2303,0,0,0,1.0,1,1.0,1,1.0,1,0.19550505331266851,41
954,0,3007,704,2303,0,0,0,1.0,1,1.0,1,1.0,1,0.2073358602965264,40
955,1,3008,704,2304,0,0,0,1.0,1,1.0,1,1.0,1,0.1735910539059645,42
956,3,3011,706,2305,0,0,0,1.0,1,1.0,1,1.0,1,0.16731117098719567,43
957,1,3012,706,2306,0,0,0,1.0,1,1.0,1,1.0,1,0.14658853761451573,42
958,1,3013,707,2306,0,0,0,1.0,1,1.0,1,1.0,1,0.19662574430101495,43
959,3,3016,708,2308,0,0,0,1.0,1,1.0,1,1.0,1,0.2152181253780777,45
960,3,3019,709,2310,0,0,0,1.0,1,1.0,1,1.0,1,0.21606289281878596,47
961,2,3021,709,2312,0,0,0,1.0,1,1.0,1,1.0,1,0.1798149423099093,45
962,2,3023,711,2312,0,0,0,1.0,1,1.0,1,1.0,1,0.21107242600492154,45
963,5,3028,712,2316,0,0,0,1.0,1,1.0,1,1.0,1,0.21269601990402873,44
964,2,3030,712,2318,0,0,0,1.0,1,1.0,1,1.0,1,0.1887244523548483,44
965,4,3034,713,2321,0,0,0,1.0,1,1.0,1,1.0,1,0.17050806053069975,45
966,3,3037,713,2324,0,0,0,1.0,1,1.0,1,1.0,1,0.17734539531183968,43
967,4,3041,713,2328,0,0,0,1.0,1,1.0,1,1.0,1,0.17734539531183968,43
968,2,3043,713,2330,0,0,0,1.0,1,1.0,1,1.0,1,0.18152414692474408,43
969,5,3048,713,2335,0,0,0,1.0,1,1.0,1,1.0,1,0.16466845300473062,42
970,2,3050,713,2337,0,0,0,1.0,1,1.0,1,1.0,1,0.13629204572947448,42
971,2,3052,713,2339,0,0,0,1.0,1,1.0,1,1.0,1,0.09997559412278173,42
972,0,3052,713,2339,0,0,0,1.0,1,1.0,1,1.0,1,0.09997559412278173,42
973,1,3053,713,2340,0,0,0,1.0,1,1.0,1,1.0,1,0.09555036076266742,43
974,4,3057,715,2342,0,0,0,1.0,1,1.0,1,1.0,1,0.08107003335432814,43
975,2,3059,715,2344,0,0,0,1.0,1,1.0,1,1.0,1,0.08221390665588643,43
976,2,3061,716,2345,0,0,0,1.0,1,1.0,1,1.0,1,0.12053105441586073,45
977,0,3061,716,2345,0,0,0,1.0,1,1.0,1,1.0,1,0.13871370004067385,44
978,1,3062,716,2346,0,0,0,1.0,1,1.0,1,1.0,1,0.10086771492249044,44
979,1,3063,716,2347,0,0,0,1.0,1,1.0,1,1.0,1,0.11914010320576413,45
980,3,3066,717,2349,0,0,0,1.0,1,1.0,1,1.0,1,0.1340289477321751,45
981,1,3067,717,2350,0,0,0,1.0,1,1.0,1,1.0,1,0.13868888014935665,45
982,4,3071,719,2352,0,0,0,1.0,1,1.0,1,1.0,1,0.2395018040010699,46
983,7,3078,721,2357,0,0,0,1.0,1,1.0,1,1.0,1,0.2515987108442857,45
984,4,3082,723,2359,0,0,0,1.0,1,1.0,1,1.0,1,0.30263079478347893,45
985,9,3091,726,2365,0,0,0,1.0,1,1.0,1,1.0,1,0.313998940056987,45
986,5,3096,727,2369,0,0,0,1.0,1,1.0,1,1.0,1,0.2551165478485444,44
987,3,3099,727,2372,0,0,0,1.0,1,1.0,1,1.0,1,0.2426553972815274,45
988,8,3107,728,2379,0,0,0,1.0,1,1.0,1,1.0,1,0.24349836162405572,44
989,4,3111,729,2382,0,0,0,1.0,1,1.0,1,1.0,1,0.2772894475596851,43
990,5,3116,730,2386,0,0,0,1.0,1,1.0,1,1.0,1,0.28473264656264513,42
991,7,3123,731,2392,0,0,0,1.0,1,1.0,1,1.0,1,0.20712989524488384,42
992,5,3128,731,2397,0,0,0,1.0,1,1.0,1,1.0,1,0.20648118874593094,43
993,3,3131,732,2399,0,0,0,1.0,1,1.0,1,1.0,1,0.19189857135161495,43
994,4,3135,733,2402,0,0,0,1.0,1,1.0,1,1.0,1,0.17150517526067044,43
995,0,3135,733,2402,0,0,0,1.0,1,1.0,1,1.0,1,0.1893659581587299,43
996,1,3136,733,2403,0,0,0,1.0,1,1.0,1,1.0,1,0.17978043221889273,44
997,1,3137,734,2403,0,0,0,1.0,1,1.0,1,1.0,1,0.19683579329587705,44
998,4,3141,734,2407,0,0,0,1.0,1,1.0,1,1.0,1,0.17894814530032124,45
999,1,3142,734,2408,0,0,0,1.0,1,1.0,1,1.0,1,0.15654791094009135,42
1000,3,3145,734,2411,0,0,0,1.0,1,1.0,1,1.0,1,0.15104905902691168,43
1001,1,3146,734,2412,0,0,0,1.0,1,1.0,1,1.0,1,0.14774283615314066,42
1002,3,3149,734,2415,0,0,0,1.0,1,1.0,1,1.0,1,0.15384556517416292,43
1003,3,3152,734,2418,0,0,0,1.0,1,1.0,1,1.0,1,0.15027156958106172,43
1004,1,3153,734,2419,0,0,0,1.0,1,1.0,1,1.0,1,0.1311655960705749,43
1005,2,3155,734,2421,0,0,0,1.0,1,1.0,1,1.0,1,0.144322561707385,44
1006,1,3156,734,2422,0,0,0,1.0,1,1.0,1,1.0,1,0.14245708392345174,46
1007,0,3156,734,2422,0,0,0,1.0,1,1.0,1,1.0,1,0.14245708392345174,46
1008,2,3158,735,2423,0,0,0,1.0,1,1.0,1,1.0,1,0.1735553468349117,47
1009,1,3159,735,2424,0,0,0,1.0,1,1.0,1,1.0,1,0.15625877548606187,48
1010,1,3160,735,2425,0,0,0,1.0,1,1.0,1,1.0,1,0.1573400334084437,48
1011,1,3161,735,2426,0,0,0,1.0,1,1.0,1,1.0,1,0.1444328816525898,48
1012,2,3163,736,2427,0,0,0,1.0,1,1.0,1,1.0,1,0.16065036522407386,49
1013,0,3163,736,2427,0,0,0,1.0,1,1.0,1,1.0,1,0.14642919161090467,50
1014,1,3164,737,2427,0,0,0,1.0,1,1.0,1,1.0,1,0.16574625082287933,50
1015,2,3166,737,2429,0,0,0,1.0,1,1.0,1,1.0,1,0.14424711740260812,51
1016,4,3170,739,2431,0,0,0,1.0,1,1.0,1,1.0,1,0.1757236337555043,51
1017,5,3175,739,2436,0,0,0,1.0,1,1.0,1,1.0,1,0.17316344448412335,52
1018,8,3183,741,2442,0,0,0,1.0,1,1.0,1,1.0,1,0.16033269531854757,52
1019,4,3187,742,2445,0,0,0,1.0,1,1.0,1,1.0,1,0.18079334847192124,52
1020,7,3194,742,2452,0,0,0,1.0,1,1.0,1,1.0,1,0.14951727883129104,53
1021,3,3197,742,2455,0,0,0,1.0,1,1.0,1,1.0,1,0.10188502961256994,53
1022,1,3198,742,2456,0,0,0,1.0,1,1.0,1,1.0,1,0.10338545488909572,54
1023,1,3199,743,2456,0,0,0,1.0,1,1.0,1,1.0,1,0.1256024539562216,55
1024,0,3199,743,2456,0,0,0,1.0,1,1.0,1,1.0,1,0.10544969791770273,55
1025,0,3199,743,2456,0,0,0,1.0,1,1.0,1,1.0,1,0.10141288475238275,56
1026,0,3199,743,2456,0,0,0,1.0,1,1.0,1,1.0,1,0.10800456152674491,57
1027,1,3200,744,2456,0,0,0,1.0,1,1.0,1,1.0,1,0.14435909924859514,58
1028,2,3202,745,2457,0,0,0,1.0,1,1.0,1,1.0,1,0.14482621793555778,58
1029,4,3206,746,2460,0,0,0,1.0,1,1.0,1,1.0,1,0.14558315614086384,59
1030,6,3212,747,2465,0,0,0,1.0,1,1.0,1,1.0,1,0.13863691083040236,60
1031,5,3217,749,2468,0,0,0,1.0,1,1.0,1,1.0,1,0.13975493993299568,60
1032,6,3223,749,2474,0,0,0,1.0,1,1.0,1,1.0,1,0.13660856185074371,61
1033,9,3232,750,2482,0,0,0,1.0,1,1.0,1,1.0,1,0.14150286960572372,60
1034,4,3236,752,2484,0,0,0,1.0,1,1.0,1,1.0,1,0.14174186864021154,60
1035,6,3242,754,2488,0,0,0,1.0,1,1.0,1,1.0,1,0.1706478085757111,59
1036,4,3246,755,2491,0,0,0,1.0,1,1.0,1,1.0,1,0.14755239293398822,60
1037,3,3249,757,2492,0,0,0,1.0,1,1.0,1,1.0,1,0.14257025416744692,59
1038,2,3251,758,2493,0,0,0,1.0,1,1.0,1,1.0,1,0.1571460616848716,60
1039,2,3253,759,2494,0,0,0,1.0,1,1.0,1,1.0,1,0.17704316885033625,60
1040,2,3255,760,2495,0,0,0,1.0,1,1.0,1,1.0,1,0.14043295598539138,58
1041,0,3255,760,2495,0,0,0,1.0,1,1.0,1,1.0,1,0.13511492758762136,56
1042,0,3255,760,2495,0,0,0,1.0,1,1.0,1,1.0,1,0.14034981867023888,55
1043,1,3256,761,2495,0,0,0,1.0,1,1.0,1,1.0,1,0.16404462499515293,55
1044,1,3257,761,2496,0,0,0,1.0,1,1.0,1,1.0,1,0.1792839710707526,52
1045,0,3257,761,2496,0,0,0,1.0,1,1.0,1,1.0,1,0.17755050060580885,52
1046,2,3259,762,2497,0,0,0,1.0,1,1.0,1,1.0,1,0.18894724458888698,53
1047,1,3260,762,2498,0,0,0,1.0,1,1.0,1,1.0,1,0.15775360802098343,54
1048,4,3264,763,2501,0,0,0,1.0,1,1.0,1,1.0,1,0.16808337320358416,56
1049,3,3267,764,2503,0,0,0,1.0,1,1.0,1,1.0,1,0.1784327078005322,55
1050,3,3270,764,2506,0,0,0,1.0,1,1.0,1,1.0,1,0.16676618722802047,56
1051,8,3278,764,2514,0,0,0,1.0,1,1.0,1,1.0,1,0.10166658772514534,55
1052,1,3279,764,2515,0,0,0,1.0,1,1.0,1,1.0,1,0.09922414802108716,56
1053,5,3284,765,2519,0,0,0,1.0,1,1.0,1,1.0,1,0.0997332530993235,56
1054,2,3286,765,2521,0,0,0,1.0,1,1.0,1,1.0,1,0.1073380646502595,57
1055,3,3289,765,2524,0,0,0,1.0,1,1.0,1,1.0,1,0.1257620396953734,58
1056,3,3292,765,2527,0,0,0,1.0,1,1.0,1,1.0,1,0.11119104136472702,59
1057,10,3302,765,2537,0,0,0,1.0,1,1.0,1,1.0,1,0.11233024988375669,60
1058,7,3309,767,2542,0,0,0,1.0,1,1.0,1,1.0,1,0.1860965821252667,60
1059,6,3315,767,2548,0,0,0,1.0,1,1.0,1,1.0,1,0.1714795464977149,60
1060,9,3324,768,2556,0,0,0,1.0,1,1.0,1,1.0,1,0.225750724940082,60
1061,9,3333,771,2562,0,0,0,1.0,1,1.0,1,1.0,1,0.18794359302104746,59
1062,7,3340,772,2568,0,0,0,1.0,1,1.0,1,1.0,1,0.2128286313996946,59
1063,4,3344,773,2571,0,0,0,1.0,1,1.0,1,1.0,1,0.20672369808057642,58
1064,10,3354,775,2579,0,0,0,1.0,1,1.0,1,1.0,1,0.2360527720756696,58
1065,7,3361,776,2585,0,0,0,1.0,1,1.0,1,1.0,1,0.21787543111416036,60
1066,12,3373,777,2596,0,0,0,1.0,1,1.0,1,1.0,1,0.12049452837595181,58
1067,3,3376,777,2599,0,0,0,1.0,1,1.0,1,1.0,1,0.14621748625035266,59
1068,5,3381,779,2602,0,0,0,1.0,1,1.0,1,1.0,1,0.13160611315581797,59
1069,1,3382,779,2603,0,0,0,1.0,1,1.0,1,1.0,1,0.15302656829435118,58
1070,1,3383,780,2603,0,0,0,1.0,1,1.0,1,1.0,1,0.15388207370307752,58
1071,2,3385,782,2603,0,0,0,1.0,1,1.0,1,1.0,1,0.20298736181644264,57
1072,1,3386,782,2604,0,0,0,1.0,1,1.0,1,1.0,1,0.18341576467365112,56
1073,1,3387,782,2605,0,0,0,1.0,1,1.0,1,1.0,1,0.21117697668612537,54
1074,5,3392,783,2609,0,0,0,1.0,1,1.0,1,1.0,1,0.17730949740507657,54
1075,0,3392,783,2609,0,0,0,1.0,1,1.0,1,1.0,1,0.2026979779701981,51
1076,2,3394,784,2610,0,0,0,1.0,1,1.0,1,1.0,1,0.16596736364861503,51
1077,1,3395,785,2610,0,0,0,1.0,1,1.0,1,1.0,1,0.17154188778824456,51
1078,5,3400,786,2614,0,0,0,1.0,1,1.0,1,1.0,1,0.19476147304900687,52
1079,4,3404,788,2616,0,0,0,1.0,1,1.0,1,1.0,1,0.20481708767904636,51
1080,7,3411,791,2620,0,0,0,1.0,1,1.0,1,1.0,1,0.2140653598245542,51
1081,4,3415,791,2624,0,0,0,1.0,1,1.0,1,1.0,1,0.15346639484502236,48
1082,1,3416,792,2624,0,0,0,1.0,1,1.0,1,1.0,1,0.17176050780663032,47
1083,2,3418,794,2624,0,0,0,1.0,1,1.0,1,1.0,1,0.22015994638055014,46
1084,0,3418,794,2624,0,0,0,1.0,1,1.0,1,1.0,1,0.20839405321858492,45
1085,2,3420,795,2625,0,0,0,1.0,1,1.0,1,1.0,1,0.20874248287665026,46
1086,3,3423,795,2628,0,0,0,1.0,1,1.0,1,1.0,1,0.16094396973438324,45
1087,0,3423,795,2628,0,0,0,1.0,1,1.0,1,1.0,1,0.19111522623745922,44
1088,3,3426,795,2631,0,0,0,1.0,1,1.0,1,1.0,1,0.17521355319005394,45
1089,2,3428,795,2633,0,0,0,1.0,1,1.0,1,1.0,1,0.15728240277634997,46
1090,2,3430,795,2635,0,0,0,1.0,1,1.0,1,1.0,1,0.15872908014976478,47
1091,1,3431,796,2635,0,0,0,1.0,1,1.0,1,1.0,1,0.1346538630903426,47
1092,0,3431,796,2635,0,0,0,1.0,1,1.0,1,1.0,1,0.134785276081293,48
1093,1,3432,797,2635,0,0,0,1.0,1,1.0,1,1.0,1,0.1439003947891904,48
1094,2,3434,799,2635,0,0,0,1.0,1,1.0,1,1.0,1,0.17270554879612635,48
1095,3,3437,799,2638,0,0,0,1.0,1,1.0,1,1.0,1,0.17119927776230015,49
1096,2,3439,800,2639,0,0,0,1.0,1,1.0,1,1.0,1,0.163307953321347,49
1097,4,3443,801,2642,0,0,0,1.0,1,1.0,1,1.0,1,0.15640258722913292,50
1098,3,3446,801,2645,0,0,0,1.0,1,1.0,1,1.0,1,0.13632995681001206,51
1099,0,3446,801,2645,0,0,0,1.0,1,1.0,1,1.0,1,0.11835215936820373,54
1100,2,3448,801,2647,0,0,0,1.0,1,1.0,1,1.0,1,0.11351504135566859,54
1101,2,3450,801,2649,0,0,0,1.0,1,1.0,1,1.0,1,0.09790285319298464,54
1102,0,3450,801,2649,0,0,0,1.0,1,1.0,1,1.0,1,0.0970926384745335,54
1103,3,3453,803,2650,0,0,0,1.0,1,1.0,1,1.0,1,0.09305073271585049,53
1104,2,3455,804,2651,0,0,0,1.0,1,1.0,1,1.0,1,0.10361429516344371,53
1105,1,3456,805,2651,0,0,0,1.0,1,1.0,1,1.0,1,0.12047535769835818,52
1106,4,3460,806,2654,0,0,0,1.0,1,1.0,1,1.0,1,0.13626970758263116,52
1107,3,3463,808,2655,0,0,0,1.0,1,1.0,1,1.0,1,0.15877828159807622,52
1108,2,3465,810,2655,0,0,0,1.0,1,1.0,1,1.0,1,0.1839205773043994,51
1109,4,3469,812,2657,0,0,0,1.0,1,1.0,1,1.0,1,0.1927543122459693,49
1110,2,3471,813,2658,0,0,0,1.0,1,1.0,1,1.0,1,0.18300572644457627,48
1111,7,3478,815,2663,0,0,0,1.0,1,1.0,1,1.0,1,0.15663503118609481,47
1112,3,3481,817,2664,0,0,0,1.0,1,1.0,1,1.0,1,0.24840118346765575,46
1113,3,3484,819,2665,0,0,0,1.0,1,1.0,1,1.0,1,0.26600205006671307,43
1114,3,3487,820,2667,0,0,0,1.0,1,1.0,1,1.0,1,0.2807401241258211,41
1115,3,3490,822,2668,0,0,0,1.0,1,1.0,1,1.0,1,0.2600295992509123,40
1116,2,3492,823,2669,0,0,0,1.0,1,1.0,1,1.0,1,0.27259795321429015,39
1117,3,3495,826,2669,0,0,0,1.0,1,1.0,1,1.0,1,0.27284648170852016,40
1118,3,3498,827,2671,0,0,0,1.0,1,1.0,1,1.0,1,0.2585905184628255,40
1119,2,3500,827,2673,0,0,0,1.0,1,1.0,1,1.0,1,0.19831325720938642,40
1120,2,3502,828,2674,0,0,0,1.0,1,1.0,1,1.0,1,0.23652835298690156,40
1121,5,3507,830,2677,0,0,0,1.0,1,1.0,1,1.0,1,0.24763962223612676,40
1122,4,3511,830,2681,0,0,0,1.0,1,1.0,1,1.0,1,0.2653041626351487,41
1123,5,3516,832,2684,0,0,0,1.0,1,1.0,1,1.0,1,0.2801799018421598,41
1124,4,3520,833,2687,0,0,0,1.0,1,1.0,1,1.0,1,0.2808883180953046,41
1125,4,3524,834,2690,0,0,0,1.0,1,1.0,1,1.0,1,0.2894132828729241,41
1126,4,3528,834,2694,0,0,0,1.0,1,1.0,1,1.0,1,0.19630884398880172,41
1127,3,3531,834,2697,0,0,0,1.0,1,1.0,1,1.0,1,0.16476162518110254,41
1128,1,3532,834,2698,0,0,0,1.0,1,1.0,1,1.0,1,0.1815824371587401,42
1129,2,3534,834,2700,0,0,0,1.0,1,1.0,1,1.0,1,0.1815824371587401,42
1130,5,3539,834,2705,0,0,0,1.0,1,1.0,1,1.0,1,0.1535149867622154,42
1131,1,3540,834,2706,0,0,0,1.0,1,1.0,1,1.0,1,0.16298447174481928,42
1132,1,3541,834,2707,0,0,0,1.0,1,1.0,1,1.0,1,0.14708966247380784,43
1133,4,3545,834,2711,0,0,0,1.0,1,1.0,1,1.0,1,0.1096502315493793,45
1134,4,3549,835,2714,0,0,0,1.0,1,1.0,1,1.0,1,0.0930347745574052,46
1135,2,3551,835,2716,0,0,0,1.0,1,1.0,1,1.0,1,0.09466074472347986,45
1136,0,3551,835,2716,0,0,0,1.0,1,1.0,1,1.0,1,0.11815244780426433,48
1137,2,3553,835,2718,0,0,0,1.0,1,1.0,1,1.0,1,0.11917746917835051,49
1138,4,3557,835,2722,0,0,0,1.0,1,1.0,1,1.0,1,0.10339394358983048,49
1139,4,3561,836,2725,0,0,0,1.0,1,1.0,1,1.0,1,0.17030435315107212,49
1140,3,3564,836,2728,0,0,0,1.0,1,1.0,1,1.0,1,0.17542403000996745,49
1141,7,3571,838,2733,0,0,0,1.0,1,1.0,1,1.0,1,0.19125612618199297,48
1142,5,3576,841,2735,0,0,0,1.0,1,1.0,1,1.0,1,0.19943681924329437,48
1143,5,3581,842,2739,0,0,0,1.0,1,1.0,1,1.0,1,0.1425466292958511,48
1144,3,3584,843,2741,0,0,0,1.0,1,1.0,1,1.0,1,0.1320835616524791,48
1145,2,3586,843,2743,0,0,0,1.0,1,1.0,1,1.0,1,0.1720610838710462,48
1146,4,3590,844,2746,0,0,0,1.0,1,1.0,1,1.0,1,0.1829298252882194,48
1147,7,3597,846,2751,0,0,0,1.0,1,1.0,1,1.0,1,0.2446919298486366,46
1148,4,3601,848,2753,0,0,0,1.0,1,1.0,1,1.0,1,0.17120815669736048,46
1149,0,3601,848,2753,0,0,0,1.0,1,1.0,1,1.0,1,0.23124477840374902,45
1150,3,3604,849,2755,0,0,0,1.0,1,1.0,1,1.0,1,0.25135340436725834,46
1151,2,3606,851,2755,0,0,0,1.0,1,1.0,1,1.0,1,0.2815398727990955,44
1152,0,3606,851,2755,0,0,0,1.0,1,1.0,1,1.0,1,0.24545016862418317,44
1153,3,3609,854,2755,0,0,0,1.0,1,1.0,1,1.0,1,0.2738998647767143,43
1154,3,3612,855,2757,0,0,0,1.0,1,1.0,1,1.0,1,0.28455049080015304,43
1155,0,3612,855,2757,0,0,0,1.0,1,1.0,1,1.0,1,0.31706541256693915,43
1156,8,3620,855,2765,0,0,0,1.0,1,1.0,1,1.0,1,0.16972245963168045,42
1157,3,3623,858,2765,0,0,0,1.0,1,1.0,1,1.0,1,0.18591917831004226,42
1158,1,3624,858,2766,0,0,0,1.0,1,1.0,1,1.0,1,0.1509025724660786,41
1159,1,3625,858,2767,0,0,0,1.0,1,1.0,1,1.0,1,0.17268416020156832,41
1160,1,3626,858,2768,0,0,0,1.0,1,1.0,1,1.0,1,0.15354645163476413,41
1161,2,3628,858,2770,0,0,0,1.0,1,1.0,1,1.0,1,0.16346046106915385,42
1162,2,3630,858,2772,0,0,0,1.0,1,1.0,1,1.0,1,0.16574910603362045,43
1163,2,3632,858,2774,0,0,0,1.0,1,1.0,1,1.0,1,0.16574910603362045,43
1164,2,3634,858,2776,0,0,0,1.0,1,1.0,1,1.0,1,0.15248101227649183,44
1165,2,3636,858,2778,0,0,0,1.0,1,1.0,1,1.0,1,0.19051487304783626,44
1166,7,3643,859,2784,0,0,0,1.0,1,1.0,1,1.0,1,0.21119488575093637,46
1167,11,3654,860,2794,0,0,0,1.0,1,1.0,1,1.0,1,0.24298277953096545,46
1168,7,3661,860,2801,0,0,0,1.0,1,1.0,1,1.0,1,0.22425894626707596,47
1169,7,3668,861,2807,0,0,0,1.0,1,1.0,1,1.0,1,0.20595789361450262,46
1170,9,3677,862,2815,0,0,0,1.0,1,1.0,1,1.0,1,0.19083737597433786,48
1171,8,3685,863,2822,0,0,0,1.0,1,1.0,1,1.0,1,0.1280672326681219,49
1172,4,3689,863,2826,0,0,0,1.0,1,1.0,1,1.0,1,0.1326482536076677,49
1173,6,3695,863,2832,0,0,0,1.0,1,1.0,1,1.0,1,0.11853050585645145,49
1174,2,3697,864,2833,0,0,0,1.0,1,1.0,1,1.0,1,0.1371256398270329,49
1175,2,3699,864,2835,0,0,0,1.0,1,1.0,1,1.0,1,0.14825654299134425,50
1176,3,3702,864,2838,0,0,0,1.0,1,1.0,1,1.0,1,0.14405719969208666,52
1177,2,3704,864,2840,0,0,0,1.0,1,1.0,1,1.0,1,0.14405719969208666,52
1178,2,3706,864,2842,0,0,0,1.0,1,1.0,1,1.0,1,0.14405719969208666,52
1179,3,3709,866,2843,0,0,0,1.0,1,1.0,1,1.0,1,0.15417473290568595,53
1180,6,3715,866,2849,0,0,0,1.0,1,1.0,1,1.0,1,0.1849513567867033,54
1181,4,3719,866,2853,0,0,0,1.0,1,1.0,1,1.0,1,0.1624113279883732,55
1182,10,3729,868,2861,0,0,0,1.0,1,1.0,1,1.0,1,0.17061434810949389,55
1183,7,3736,869,2867,0,0,0,1.0,1,1.0,1,1.0,1,0.20530863638011942,53
1184,7,3743,870,2873,0,0,0,1.0,1,1.0,1,1.0,1,0.18699993407638466,54
1185,3,3746,870,2876,0,0,0,1.0,1,1.0,1,1.0,1,0.1811916129770833,53
1186,4,3750,871,2879,0,0,0,1.0,1,1.0,1,1.0,1,0.16228966125557648,54
1187,6,3756,872,2884,0,0,0,1.0,1,1.0,1,1.0,1,0.16377226568518427,55
1188,3,3759,872,2887,0,0,0,1.0,1,1.0,1,1.0,1,0.14572486000329982,55
1189,2,3761,872,2889,0,0,0,1.0,1,1.0,1,1.0,1,0.13428873890291,54
1190,4,3765,873,2892,0,0,0,1.0,1,1.0,1,1.0,1,0.15697596511531534,55
1191,2,3767,873,2894,0,0,0,1.0,1,1.0,1,1.0,1,0.10904079845157705,54
1192,0,3767,873,2894,0,0,0,1.0,1,1.0,1,1.0,1,0.0937723392192184,52
1193,0,3767,873,2894,0,0,0,1.0,1,1.0,1,1.0,1,0.09185020737569134,53
1194,5,3772,876,2896,0,0,0,1.0,1,1.0,1,1.0,1,0.11131275192440569,53
1195,2,3774,876,2898,0,0,0,1.0,1,1.0,1,1.0,1,0.09483542138325052,54
1196,0,3774,876,2898,0,0,0,1.0,1,1.0,1,1.0,1,0.10968939474923577,56
1197,2,3776,878,2898,0,0,0,1.0,1,1.0,1,1.0,1,0.15867213356039223,56
1198,2,3778,879,2899,0,0,0,1.0,1,1.0,1,1.0,1,0.1536534613383583,58
1199,2,3780,880,2900,0,0,0,1.0,1,1.0,1,1.0,1,0.1876884089107989,58
1200,4,3784,880,2904,0,0,0,1.0,1,1.0,1,1.0,1,0.16360790553899848,58
1201,7,3791,881,2910,0,0,0,1.0,1,1.0,1,1.0,1,0.09269385260640797,58
1202,0,3791,881,2910,0,0,0,1.0,1,1.0,1,1.0,1,0.08528904627506803,60
1203,1,3792,881,2911,0,0,0,1.0,1,1.0,1,1.0,1,0.11541702039641169,58
1204,6,3798,882,2916,0,0,0,1.0,1,1.0,1,1.0,1,0.07908633700812348,59
1205,2,3800,883,2917,0,0,0,1.0,1,1.0,1,1.0,1,0.10702142056066413,59
1206,1,3801,883,2918,0,0,0,1.0,1,1.0,1,1.0,1,0.1279087075299579,58
1207,7,3808,883,2925,0,0,0,1.0,1,1.0,1,1.0,1,0.13017173934682458,60
1208,3,3811,883,2928,0,0,0,1.0,1,1.0,1,1.0,1,0.1124900120881657,60
1209,5,3816,883,2933,0,0,0,1.0,1,1.0,1,1.0,1,0.1046178566644921,61
1210,3,3819,883,2936,0,0,0,1.0,1,1.0,1,1.0,1,0.13828621643227573,61
1211,6,3825,883,2942,0,0,0,1.0,1,1.0,1,1.0,1,0.10737030636817797,63
1212,5,3830,884,2946,0,0,0,1.0,1,1.0,1,1.0,1,0.1218746664949342,63
1213,3,3833,885,2948,0,0,0,1.0,1,1.0,1,1.0,1,0.11950333803888774,63
1214,9,3842,887,2955,0,0,0,1.0,1,1.0,1,1.0,1,0.19293103950464066,62
1215,6,3848,887,2961,0,0,0,1.0,1,1.0,1,1.0,1,0.22003935046862377,63
1216,7,3855,887,2968,0,0,0,1.0,1,1.0,1,1.0,1,0.13510033822161976,64
1217,3,3858,887,2971,0,0,0,1.0,1,1.0,1,1.0,1,0.1275121522288203,65
1218,4,3862,887,2975,0,0,0,1.0,1,1.0,1,1.0,1,0.13485820029622228,64
1219,2,3864,887,2977,0,0,0,1.0,1,1.0,1,1.0,1,0.1417140591129439,65
1220,5,3869,888,2981,0,0,0,1.0,1,1.0,1,1.0,1,0.1604378079257721,64
1221,2,3871,888,2983,0,0,0,1.0,1,1.0,1,1.0,1,0.1697498226351274,65
1222,4,3875,888,2987,0,0,0,1.0,1,1.0,1,1.0,1,0.15549055270702136,66
1223,4,3879,889,2990,0,0,0,1.0,1,1.0,1,1.0,1,0.16302763008158605,64
1224,9,3888,892,2996,0,0,0,1.0,1,1.0,1,1.0,1,0.1530315269520024,66
1225,4,3892,894,2998,0,0,0,1.0,1,1.0,1,1.0,1,0.19083763516106553,66
1226,7,3899,894,3005,0,0,0,1.0,1,1.0,1,1.0,1,0.1581396720459418,68
1227,4,3903,895,3008,0,0,0,1.0,1,1.0,1,1.0,1,0.14814227631181867,64
1228,2,3905,895,3010,0,0,0,1.0,1,1.0,1,1.0,1,0.17728766202814183,62
1229,2,3907,897,3010,0,0,0,1.0,1,1.0,1,1.0,1,0.15299024464584426,61
1230,2,3909,899,3010,0,0,0,1.0,1,1.0,1,1.0,1,0.18934705758965345,58
1231,9,3918,900,3018,0,0,0,1.0,1,1.0,1,1.0,1,0.07218828208009195,57
1232,1,3919,900,3019,0,0,0,1.0,1,1.0,1,1.0,1,0.09415424346385998,53
1233,2,3921,901,3020,0,0,0,1.0,1,1.0,1,1.0,1,0.09699133201071589,53
1234,1,3922,901,3021,0,0,0,1.0,1,1.0,1,1.0,1,0.07400843591196823,54
1235,2,3924,901,3023,0,0,0,1.0,1,1.0,1,1.0,1,0.08288216495485136,55
1236,1,3925,902,3023,0,0,0,1.0,1,1.0,1,1.0,1,0.117631652084221,55
1237,1,3926,902,3024,0,0,0,1.0,1,1.0,1,1.0,1,0.10237627351019601,55
1238,3,3929,904,3025,0,0,0,1.0,1,1.0,1,1.0,1,0.10238559269846335,54
1239,1,3930,904,3026,0,0,0,1.0,1,1.0,1,1.0,1,0.08639110810318776,55
1240,0,3930,904,3026,0,0,0,1.0,1,1.0,1,1.0,1,0.08639110810318776,55
1241,0,3930,904,3026,0,0,0,1.0,1,1.0,1,1.0,1,0.06711086633140752,54
1242,2,3932,905,3027,0,0,0,1.0,1,1.0,1,1.0,1,0.07329448762569632,54
1243,1,3933,906,3027,0,0,0,1.0,1,1.0,1,1.0,1,0.10581571695910463,55
1244,0,3933,906,3027,0,0,0,1.0,1,1.0,1,1.0,1,0.12069857186413531,55
1245,1,3934,906,3028,0,0,0,1.0,1,1.0,1,1.0,1,0.12605851467720763,55
1246,3,3937,907,3030,0,0,0,1.0,1,1.0,1,1.0,1,0.11792806177818926,55
1247,2,3939,908,3031,0,0,0,1.0,1,1.0,1,1.0,1,0.12315781517408815,57
1248,0,3939,908,3031,0,0,0,1.0,1,1.0,1,1.0,1,0.13332360697937695,56
1249,4,3943,912,3031,0,0,0,1.0,1,1.0,1,1.0,1,0.18453544351951895,56
1250,4,3947,915,3032,0,0,0,1.0,1,1.0,1,1.0,1,0.1755702372397159,56
1251,4,3951,915,3036,0,0,0,1.0,1,1.0,1,1.0,1,0.13020191529227726,58
1252,3,3954,916,3038,0,0,0,1.0,1,1.0,1,1.0,1,0.13573829399712625,58
1253,3,3957,918,3039,0,0,0,1.0,1,1.0,1,1.0,1,0.15594319734082293,58
1254,3,3960,918,3042,0,0,0,1.0,1,1.0,1,1.0,1,0.12477804050738323,60
1255,5,3965,918,3047,0,0,0,1.0,1,1.0,1,1.0,1,0.13802149037542413,61
1256,5,3970,918,3052,0,0,0,1.0,1,1.0,1,1.0,1,0.10011272235159478,61
1257,5,3975,920,3055,0,0,0,1.0,1,1.0,1,1.0,1,0.1333463516990287,62
1258,3,3978,920,3058,0,0,0,1.0,1,1.0,1,1.0,1,0.130110512547376,63
1259,1,3979,920,3059,0,0,0,1.0,1,1.0,1,1.0,1,0.1399960873023856,63
1260,4,3983,920,3063,0,0,0,1.0,1,1.0,1,1.0,1,0.1395983031110563,63
1261,2,3985,920,3065,0,0,0,1.0,1,1.0,1,1.0,1,0.10260478443851236,63
1262,3,3988,921,3067,0,0,0,1.0,1,1.0,1,1.0,1,0.1057823833137552,64
1263,2,3990,922,3068,0,0,0,1.0,1,1.0,1,1.0,1,0.10924127114581884,63
1264,1,3991,923,3068,0,0,0,1.0,1,1.0,1,1.0,1,0.10681449322690989,63
1265,7,3998,926,3072,0,0,0,1.0,1,1.0,1,1.0,1,0.15956648947580626,60
1266,3,4001,928,3073,0,0,0,1.0,1,1.0,1,1.0,1,0.1478520035957361,61
1267,3,4004,930,3074,0,0,0,1.0,1,1.0,1,1.0,1,0.15213688643491752,58
1268,3,4007,932,3075,0,0,0,1.0,1,1.0,1,1.0,1,0.19156877386734142,54
1269,3,4010,935,3075,0,0,0,1.0,1,1.0,1,1.0,1,0.13532438584297835,54
1270,1,4011,935,3076,0,0,0,1.0,1,1.0,1,1.0,1,0.14480559652421368,51
1271,1,4012,936,3076,0,0,0,1.0,1,1.0,1,1.0,1,0.15925576599619634,50
1272,1,4013,937,3076,0,0,0,1.0,1,1.0,1,1.0,1,0.19133761424326287,47
1273,0,4013,937,3076,0,0,0,1.0,1,1.0,1,1.0,1,0.19133761424326287,47
1274,2,4015,938,3077,0,0,0,1.0,1,1.0,1,1.0,1,0.18523715072967525,49
1275,2,4017,939,3078,0,0,0,1.0,1,1.0,1,1.0,1,0.21913185601935836,48
1276,8,4025,940,3085,0,0,0,1.0,1,1.0,1,1.0,1,0.14824507859895258,49
1277,6,4031,943,3088,0,0,0,1.0,1,1.0,1,1.0,1,0.1229862556716881,50
1278,3,4034,943,3091,0,0,0,1.0,1,1.0,1,1.0,1,0.14505786007668417,51
1279,4,4038,944,3094,0,0,0,1.0,1,1.0,1,1.0,1,0.2203836396136854,51
1280,9,4047,944,3103,0,0,0,1.0,1,1.0,1,1.0,1,0.18289288754211683,52
1281,6,4053,945,3108,0,0,0,1.0,1,1.0,1,1.0,1,0.17391202090473737,52
1282,8,4061,946,3115,0,0,0,1.0,1,1.0,1,1.0,1,0.17734928967119093,52
1283,4,4065,946,3119,0,0,0,1.0,1,1.0,1,1.0,1,0.2077913173554414,52
1284,5,4070,947,3123,0,0,0,1.0,1,1.0,1,1.0,1,0.13987063457656476,52
1285,6,4076,947,3129,0,0,0,1.0,1,1.0,1,1.0,1,0.15666280888200462,51
1286,5,4081,947,3134,0,0,0,1.0,1,1.0,1,1.0,1,0.1698850147814061,52
1287,8,4089,948,3141,0,0,0,1.0,1,1.0,1,1.0,1,0.1938038871157001,54
1288,7,4096,948,3148,0,0,0,1.0,1,1.0,1,1.0,1,0.2234917146973819,55
1289,7,4103,948,3155,0,0,0,1.0,1,1.0,1,1.0,1,0.1624435064615773,56
1290,9,4112,949,3163,0,0,0,1.0,1,1.0,1,1.0,1,0.12939449905424324,57
1291,4,4116,949,3167,0,0,0,1.0,1,1.0,1,1.0,1,0.10837114923622532,58
1292,3,4119,951,3168,0,0,0,1.0,1,1.0,1,1.0,1,0.10420972317879021,59
1293,2,4121,951,3170,0,0,0,1.0,1,1.0,1,1.0,1,0.10420972317879021,59
1294,2,4123,951,3172,0,0,0,1.0,1,1.0,1,1.0,1,0.10451851157390242,59
1295,3,4126,952,3174,0,0,0,1.0,1,1.0,1,1.0,1,0.12220168155240473,59
1296,2,4128,952,3176,0,0,0,1.0,1,1.0,1,1.0,1,0.11211165974798823,59
1297,2,4130,953,3177,0,0,0,1.0,1,1.0,1,1.0,1,0.12091921062784994,61
1298,1,4131,953,3178,0,0,0,1.0,1,1.0,1,1.0,1,0.10958062439571234,61
1299,0,4131,953,3178,0,0,0,1.0,1,1.0,1,1.0,1,0.12091201252479958,60
1300,0,4131,953,3178,0,0,0,1.0,1,1.0,1,1.0,1,0.11820393741630655,59
1301,1,4132,954,3178,0,0,0,1.0,1,1.0,1,1.0,1,0.16909057361592802,59
1302,5,4137,958,3179,0,0,0,1.0,1,1.0,1,1.0,1,0.16345835973633857,59
1303,5,4142,961,3181,0,0,0,1.0,1,1.0,1,1.0,1,0.18319396680641353,55
1304,6,4148,965,3183,0,0,0,1.0,1,1.0,1,1.0,1,0.17562925479225375,56
1305,4,4152,967,3185,0,0,0,1.0,1,1.0,1,1.0,1,0.19054205789640472,54
1306,8,4160,969,3191,0,0,0,1.0,1,1.0,1,1.0,1,0.17441187394938407,53
1307,3,4163,970,3193,0,0,0,1.0,1,1.0,1,1.0,1,0.1592871906968387,52
1308,5,4168,974,3194,0,0,0,1.0,1,1.0,1,1.0,1,0.2014648341073128,52
1309,3,4171,974,3197,0,0,0,1.0,1,1.0,1,1.0,1,0.20357238866410124,54
1310,5,4176,976,3200,0,0,0,1.0,1,1.0,1,1.0,1,0.221509110308868,52
1311,3,4179,977,3202,0,0,0,1.0,1,1.0,1,1.0,1,0.19039995568078458,51
1312,3,4182,979,3203,0,0,0,1.0,1,1.0,1,1.0,1,0.22565015248542222,49
1313,0,4182,979,3203,0,0,0,1.0,1,1.0,1,1.0,1,0.22927607341370496,47
1314,0,4182,979,3203,0,0,0,1.0,1,1.0,1,1.0,1,0.21025773358995384,46
1315,1,4183,979,3204,0,0,0,1.0,1,1.0,1,1.0,1,0.21689120804012801,45
1316,2,4185,980,3205,0,0,0,1.0,1,1.0,1,1.0,1,0.2228067887832354,46
1317,3,4188,980,3208,0,0,0,1.0,1,1.0,1,1.0,1,0.25956135280159237,45
1318,6,4194,981,3213,0,0,0,1.0,1,1.0,1,1.0,1,0.23697999643024018,46
1319,2,4196,981,3215,0,0,0,1.0,1,1.0,1,1.0,1,0.21805467133395393,46
1320,3,4199,982,3217,0,0,0,1.0,1,1.0,1,1.0,1,0.19893199266573258,46
1321,5,4204,982,3222,0,0,0,1.0,1,1.0,1,1.0,1,0.11350547892772511,48
1322,2,4206,982,3224,0,0,0,1.0,1,1.0,1,1.0,1,0.1048538184226735,49
1323,1,4207,982,3225,0,0,0,1.0,1,1.0,1,1.0,1,0.12124919992950463,49
1324,6,4213,983,3230,0,0,0,1.0,1,1.0,1,1.0,1,0.11049092433096332,50
1325,5,4218,983,3235,0,0,0,1.0,1,1.0,1,1.0,1,0.1445952928246682,49
1326,6,4224,984,3240,0,0,0,1.0,1,1.0,1,1.0,1,0.15352486932408635,50
1327,0,4224,984,3240,0,0,0,1.0,1,1.0,1,1.0,1,0.1769854566249607,50
1328,2,4226,984,3242,0,0,0,1.0,1,1.0,1,1.0,1,0.19191848488525243,49
1329,3,4229,985,3244,0,0,0,1.0,1,1.0,1,1.0,1,0.18000604496709965,50
1330,3,4232,985,3247,0,0,0,1.0,1,1.0,1,1.0,1,0.20750805161159827,50
1331,4,4236,986,3250,0,0,0,1.0,1,1.0,1,1.0,1,0.2033269862735749,50
1332,3,4239,986,3253,0,0,0,1.0,1,1.0,1,1.0,1,0.20233680967029288,51
1333,2,4241,986,3255,0,0,0,1.0,1,1.0,1,1.0,1,0.19263097011482372,52
1334,3,4244,986,3258,0,0,0,1.0,1,1.0,1,1.0,1,0.19930508801723248,54
1335,4,4248,986,3262,0,0,0,1.0,1,1.0,1,1.0,1,0.19930508801723248,54
1336,9,4257,986,3271,0,0,0,1.0,1,1.0,1,1.0,1,0.0741873073830538,56
1337,3,4260,988,3272,0,0,0,1.0,1,1.0,1,1.0,1,0.12832738713396274,57
1338,0,4260,988,3272,0,0,0,1.0,1,1.0,1,1.0,1,0.12832738713396274,57
1339,2,4262,990,3272,0,0,0,1.0,1,1.0,1,1.0,1,0.19247675736426034,58
1340,3,4265,990,3275,0,0,0,1.0,1,1.0,1,1.0,1,0.1755009276466326,59
1341,2,4267,990,3277,0,0,0,1.0,1,1.0,1,1.0,1,0.13843345487868117,57
1342,7,4274,992,3282,0,0,0,1.0,1,1.0,1,1.0,1,0.12609361942369673,57
1343,2,4276,992,3284,0,0,0,1.0,1,1.0,1,1.0,1,0.11543099749528184,55
1344,4,4280,994,3286,0,0,0,1.0,1,1.0,1,1.0,1,0.1466171076499653,54
1345,3,4283,994,3289,0,0,0,1.0,1,1.0,1,1.0,1,0.16541021571729503,53
1346,5,4288,996,3292,0,0,0,1.0,1,1.0,1,1.0,1,0.13020109662022614,53
1347,4,4292,997,3295,0,0,0,1.0,1,1.0,1,1.0,1,0.156935300487184,51
1348,4,4296,999,3297,0,0,0,1.0,1,1.0,1,1.0,1,0.15338489554098608,52
1349,2,4298,1000,3298,0,0,0,1.0,1,1.0,1,1.0,1,0.17438022527120187,50
1350,3,4301,1002,3299,0,0,0,1.0,1,1.0,1,1.0,1,0.16521988195164847,51
1351,4,4305,1002,3303,0,0,0,1.0,1,1.0,1,1.0,1,0.11282304946682946,50
1352,2,4307,1003,3304,0,0,0,1.0,1,1.0,1,1.0,1,0.09232231344763264,50
1353,2,4309,1003,3306,0,0,0,1.0,1,1.0,1,1.0,1,0.09143338942085322,50
1354,6,4315,1003,3312,0,0,0,1.0,1,1.0,1,1.0,1,0.1146030284550907,51
1355,4,4319,1004,3315,0,0,0,1.0,1,1.0,1,1.0,1,0.08118995259775326,53
1356,4,4323,1005,3318,0,0,0,1.0,1,1.0,1,1.0,1,0.11202005514796065,52
1357,5,4328,1005,3323,0,0,0,1.0,1,1.0,1,1.0,1,0.12281104992381058,52
1358,2,4330,1005,3325,0,0,0,1.0,1,1.0,1,1.0,1,0.14863279857847403,53
1359,5,4335,1006,3329,0,0,0,1.0,1,1.0,1,1.0,1,0.1809326531702159,54
1360,5,4340,1007,3333,0,0,0,1.0,1,1.0,1,1.0,1,0.16199207616841207,55
1361,4,4344,1008,3336,0,0,0,1.0,1,1.0,1,1.0,1,0.19092324975725197,55
1362,3,4347,1008,3339,0,0,0,1.0,1,1.0,1,1.0,1,0.15667925117411943,56
1363,1,4348,1008,3340,0,0,0,1.0,1,1.0,1,1.0,1,0.13711041633053964,56
1364,3,4351,1008,3343,0,0,0,1.0,1,1.0,1,1.0,1,0.14247593899578612,55
1365,5,4356,1009,3347,0,0,0,1.0,1,1.0,1,1.0,1,0.18202940150418087,56
1366,7,4363,1009,3354,0,0,0,1.0,1,1.0,1,1.0,1,0.09965736580266508,57
1367,2,4365,1010,3355,0,0,0,1.0,1,1.0,1,1.0,1,0.12254897119769127,57
1368,9,4374,1010,3364,0,0,0,1.0,1,1.0,1,1.0,1,0.09153369969758586,58
1369,4,4378,1011,3367,0,0,0,1.0,1,1.0,1,1.0,1,0.07006534639219462,59
1370,2,4380,1012,3368,0,0,0,1.0,1,1.0,1,1.0,1,0.09457908969726231,60
1371,3,4383,1012,3371,0,0,0,1.0,1,1.0,1,1.0,1,0.07171041042940555,59
1372,4,4387,1013,3374,0,0,0,1.0,1,1.0,1,1.0,1,0.10776039078017163,59
1373,5,4392,1013,3379,0,0,0,1.0,1,1.0,1,1.0,1,0.11375676048069804,59
1374,3,4395,1013,3382,0,0,0,1.0,1,1.0,1,1.0,1,0.09882060190581793,59
1375,3,4398,1013,3385,0,0,0,1.0,1,1.0,1,1.0,1,0.11669427002569409,62
1376,7,4405,1014,3391,0,0,0,1.0,1,1.0,1,1.0,1,0.1427045657933989,61
1377,12,4417,1015,3402,0,0,0,1.0,1,1.0,1,1.0,1,0.1503810901518995,63
1378,7,4424,1015,3409,0,0,0,1.0,1,1.0,1,1.0,1,0.1539126511037695,62
1379,8,4432,1016,3416,0,0,0,1.0,1,1.0,1,1.0,1,0.18951620623344628,61
1380,6,4438,1016,3422,0,0,0,1.0,1,1.0,1,1.0,1,0.1818968424430724,60
1381,8,4446,1018,3428,0,0,0,1.0,1,1.0,1,1.0,1,0.19167080474235137,58
1382,5,4451,1019,3432,0,0,0,1.0,1,1.0,1,1.0,1,0.1573778449428019,56
1383,1,4452,1019,3433,0,0,0,1.0,1,1.0,1,1.0,1,0.15393392326701338,57
1384,4,4456,1021,3435,0,0,0,1.0,1,1.0,1,1.0,1,0.11258382812532126,55
1385,1,4457,1022,3435,0,0,0,1.0,1,1.0,1,1.0,1,0.11728473136412144,55
1386,4,4461,1024,3437,0,0,0,1.0,1,1.0,1,1.0,1,0.10452088344181265,54
1387,2,4463,1024,3439,0,0,0,1.0,1,1.0,1,1.0,1,0.14684356036485605,53
1388,2,4465,1026,3439,0,0,0,1.0,1,1.0,1,1.0,1,0.16889399209215533,52
1389,0,4465,1026,3439,0,0,0,1.0,1,1.0,1,1.0,1,0.194529017035628,52
1390,0,4465,1026,3439,0,0,0,1.0,1,1.0,1,1.0,1,0.19375235233122148,51
1391,1,4466,1026,3440,0,0,0,1.0,1,1.0,1,1.0,1,0.18371876474244583,52
1392,1,4467,1027,3440,0,0,0,1.0,1,1.0,1,1.0,1,0.18385308771655887,51
1393,2,4469,1028,3441,0,0,0,1.0,1,1.0,1,1.0,1,0.17777905158146504,51
1394,1,4470,1028,3442,0,0,0,1.0,1,1.0,1,1.0,1,0.19287726271517505,52
1395,1,4471,1028,3443,0,0,0,1.0,1,1.0,1,1.0,1,0.19488257712274143,52
1396,9,4480,1029,3451,0,0,0,1.0,1,1.0,1,1.0,1,0.09704907708118908,53
1397,4,4484,1029,3455,0,0,0,1.0,1,1.0,1,1.0,1,0.10286347619006225,56
1398,3,4487,1030,3457,0,0,0,1.0,1,1.0,1,1.0,1,0.11705915568856053,56
1399,7,4494,1032,3462,0,0,0,1.0,1,1.0,1,1.0,1,0.1411094210890713,57
1400,6,4500,1033,3467,0,0,0,1.0,1,1.0,1,1.0,1,0.1680301439128857,57
1401,5,4505,1034,3471,0,0,0,1.0,1,1.0,1,1.0,1,0.17991292988863833,57
1402,4,4509,1036,3473,0,0,0,1.0,1,1.0,1,1.0,1,0.1948565479174833,57
1403,2,4511,1036,3475,0,0,0,1.0,1,1.0,1,1.0,1,0.2090729961176296,56
1404,4,4515,1037,3478,0,0,0,1.0,1,1.0,1,1.0,1,0.19780590104231074,58
1405,4,4519,1037,3482,0,0,0,1.0,1,1.0,1,1.0,1,0.22305939899940525,58
1406,6,4525,1037,3488,0,0,0,1.0,1,1.0,1,1.0,1,0.209613168629622,58
1407,2,4527,1037,3490,0,0,0,1.0,1,1.0,1,1.0,1,0.2271752861713422,57
1408,7,4534,1037,3497,0,0,0,1.0,1,1.0,1,1.0,1,0.24344784481238674,58
1409,10,4544,1037,3507,0,0,0,1.0,1,1.0,1,1.0,1,0.20086661001167136,57
1410,5,4549,1037,3512,0,0,0,1.0,1,1.0,1,1.0,1,0.20042293089375732,57
1411,10,4559,1038,3521,0,0,0,1.0,1,1.0,1,1.0,1,0.13932485652736282,56
1412,1,4560,1038,3522,0,0,0,1.0,1,1.0,1,1.0,1,0.1480890591720744,55
1413,1,4561,1038,3523,0,0,0,1.0,1,1.0,1,1.0,1,0.13150139489301635,57
1414,0,4561,1038,3523,0,0,0,1.0,1,1.0,1,1.0,1,0.13150139489301635,57
1415,2,4563,1039,3524,0,0,0,1.0,1,1.0,1,1.0,1,0.1541499219912066,60
1416,5,4568,1040,3528,0,0,0,1.0,1,1.0,1,1.0,1,0.14284204567064532,61
1417,2,4570,1040,3530,0,0,0,1.0,1,1.0,1,1.0,1,0.1432763189056165,59
1418,2,4572,1040,3532,0,0,0,1.0,1,1.0,1,1.0,1,0.1368742556922572,60
1419,3,4575,1041,3534,0,0,0,1.0,1,1.0,1,1.0,1,0.15827248952177528,59
1420,3,4578,1042,3536,0,0,0,1.0,1,1.0,1,1.0,1,0.1672071064797206,58
1421,2,4580,1043,3537,0,0,0,1.0,1,1.0,1,1.0,1,0.14465253121496474,57
1422,4,4584,1044,3540,0,0,0,1.0,1,1.0,1,1.0,1,0.12573928881398147,57
1423,4,4588,1046,3542,0,0,0,1.0,1,1.0,1,1.0,1,0.10977350947343494,56
1424,3,4591,1047,3544,0,0,0,1.0,1,1.0,1,1.0,1,0.1103002879691758,57
1425,1,4592,1048,3544,0,0,0,1.0,1,1.0,1,1.0,1,0.1273166075335994,54
1426,6,4598,1049,3549,0,0,0,1.0,1,1.0,1,1.0,1,0.0650675786174162,54
1427,2,4600,1051,3549,0,0,0,1.0,1,1.0,1,1.0,1,0.12642797428331712,53
1428,4,4604,1053,3551,0,0,0,1.0,1,1.0,1,1.0,1,0.1276037386963681,52
1429,3,4607,1053,3554,0,0,0,1.0,1,1.0,1,1.0,1,0.12335513030274768,52
1430,3,4610,1056,3554,0,0,0,1.0,1,1.0,1,1.0,1,0.16979508327174472,51
1431,2,4612,1056,3556,0,0,0,1.0,1,1.0,1,1.0,1,0.1343128562252715,51
1432,1,4613,1057,3556,0,0,0,1.0,1,1.0,1,1.0,1,0.15199284907339805,52
1433,3,4616,1060,3556,0,0,0,1.0,1,1.0,1,1.0,1,0.11877243479212994,52
1434,3,4619,1062,3557,0,0,0,1.0,1,1.0,1,1.0,1,0.14438958229407697,52
1435,4,4623,1063,3560,0,0,0,1.0,1,1.0,1,1.0,1,0.16275650502459435,50
1436,3,4626,1065,3561,0,0,0,1.0,1,1.0,1,1.0,1,0.2033587026453657,50
1437,2,4628,1067,3561,0,0,0,1.0,1,1.0,1,1.0,1,0.23486412007754756,49
1438,5,4633,1068,3565,0,0,0,1.0,1,1.0,1,1.0,1,0.23791954628633577,49
1439,3,4636,1069,3567,0,0,0,1.0,1,1.0,1,1.0,1,0.24756453134954576,50
1440,5,4641,1073,3568,0,0,0,1.0,1,1.0,1,1.0,1,0.28924613268428323,50
1441,9,4650,1074,3576,0,0,0,1.0,1,1.0,1,1.0,1,0.2292480129026465,51
1442,2,4652,1074,3578,0,0,0,1.0,1,1.0,1,1.0,1,0.23287140640830328,50
1443,2,4654,1074,3580,0,0,0,1.0,1,1.0,1,1.0,1,0.2404779532875735,51
1444,2,4656,1074,3582,0,0,0,1.0,1,1.0,1,1.0,1,0.22123632988515857,51
1445,3,4659,1075,3584,0,0,0,1.0,1,1.0,1,1.0,1,0.2236476211126419,51
1446,2,4661,1075,3586,0,0,0,1.0,1,1.0,1,1.0,1,0.199456464995555,51
1447,3,4664,1076,3588,0,0,0,1.0,1,1.0,1,1.0,1,0.19541686138951211,51
1448,1,4665,1076,3589,0,0,0,1.0,1,1.0,1,1.0,1,0.17657447568033555,51
1449,1,4666,1076,3590,0,0,0,1.0,1,1.0,1,1.0,1,0.1699237047107825,51
1450,2,4668,1076,3592,0,0,0,1.0,1,1.0,1,1.0,1,0.14178193884829968,52
1451,4,4672,1077,3595,0,0,0,1.0,1,1.0,1,1.0,1,0.12456681698762369,54
1452,8,4680,1077,3603,0,0,0,1.0,1,1.0,1,1.0,1,0.10133964879040418,56
1453,6,4686,1077,3609,0,0,0,1.0,1,1.0,1,1.0,1,0.16575901258345377,56
1454,9,4695,1078,3617,0,0,0,1.0,1,1.0,1,1.0,1,0.14419281142383808,58
1455,8,4703,1079,3624,0,0,0,1.0,1,1.0,1,1.0,1,0.13726346967957923,55
1456,1,4704,1079,3625,0,0,0,1.0,1,1.0,1,1.0,1,0.1406668490628915,56
1457,1,4705,1080,3625,0,0,0,1.0,1,1.0,1,1.0,1,0.18698623309045664,54
1458,1,4706,1081,3625,0,0,0,1.0,1,1.0,1,1.0,1,0.22175531782196053,52
1459,1,4707,1082,3625,0,0,0,1.0,1,1.0,1,1.0,1,0.22159348522592204,52
1460,0,4707,1082,3625,0,0,0,1.0,1,1.0,1,1.0,1,0.20540332381115922,50
1461,2,4709,1083,3626,0,0,0,1.0,1,1.0,1,1.0,1,0.2016950931420985,53
1462,3,4712,1085,3627,0,0,0,1.0,1,1.0,1,1.0,1,0.2047047205452635,51
1463,1,4713,1086,3627,0,0,0,1.0,1,1.0,1,1.0,1,0.19957484763293493,51
1464,2,4715,1088,3627,0,0,0,1.0,1,1.0,1,1.0,1,0.2547568914004937,51
1465,2,4717,1089,3628,0,0,0,1.0,1,1.0,1,1.0,1,0.23481040782340712,49
1466,1,4718,1090,3628,0,0,0,1.0,1,1.0,1,1.0,1,0.24058083721566267,49
1467,1,4719,1091,3628,0,0,0,1.0,1,1.0,1,1.0,1,0.28247903763304477,47
1468,0,4719,1091,3628,0,0,0,1.0,1,1.0,1,1.0,1,0.2655297396204658,48
1469,1,4720,1092,3628,0,0,0,1.0,1,1.0,1,1.0,1,0.28608833442092196,47
1470,0,4720,1092,3628,0,0,0,1.0,1,1.0,1,1.0,1,0.27267591884189457,49
1471,9,4729,1092,3637,0,0,0,1.0,1,1.0,1,1.0,1,0.21785110078716713,48
1472,1,4730,1092,3638,0,0,0,1.0,1,1.0,1,1.0,1,0.1736193470210684,48
1473,0,4730,1092,3638,0,0,0,1.0,1,1.0,1,1.0,1,0.18440051632756854,49
1474,0,4730,1092,3638,0,0,0,1.0,1,1.0,1,1.0,1,0.18440051632756854,49
1475,4,4734,1092,3642,0,0,0,1.0,1,1.0,1,1.0,1,0.18114425297648987,49
1476,5,4739,1093,3646,0,0,0,1.0,1,1.0,1,1.0,1,0.15510958650358458,51
1477,4,4743,1093,3650,0,0,0,1.0,1,1.0,1,1.0,1,0.19146226254955798,51
1478,4,4747,1093,3654,0,0,0,1.0,1,1.0,1,1.0,1,0.09529814544656558,52
1479,3,4750,1093,3657,0,0,0,1.0,1,1.0,1,1.0,1,0.13261048440270146,53
1480,3,4753,1094,3659,0,0,0,1.0,1,1.0,1,1.0,1,0.15386389676792028,53
1481,2,4755,1094,3661,0,0,0,1.0,1,1.0,1,1.0,1,0.12571285708697202,53
1482,4,4759,1095,3664,0,0,0,1.0,1,1.0,1,1.0,1,0.1812062441738569,52
1483,4,4763,1095,3668,0,0,0,1.0,1,1.0,1,1.0,1,0.1841718069387143,52
1484,5,4768,1095,3673,0,0,0,1.0,1,1.0,1,1.0,1,0.192654611252893,53
1485,4,4772,1095,3677,0,0,0,1.0,1,1.0,1,1.0,1,0.192654611252893,53
1486,10,4782,1095,3687,0,0,0,1.0,1,1.0,1,1.0,1,0.10225084401159634,54
1487,3,4785,1095,3690,0,0,0,1.0,1,1.0,1,1.0,1,0.10035172619709369,55
1488,1,4786,1095,3691,0,0,0,1.0,1,1.0,1,1.0,1,0.08829380244192687,57
1489,2,4788,1096,3692,0,0,0,1.0,1,1.0,1,1.0,1,0.12259786220485998,58
1490,2,4790,1098,3692,0,0,0,1.0,1,1.0,1,1.0,1,0.12833722254407842,58
1491,6,4796,1100,3696,0,0,0,1.0,1,1.0,1,1.0,1,0.14131014748777748,59
1492,2,4798,1100,3698,0,0,0,1.0,1,1.0,1,1.0,1,0.12801706853263875,59
1493,3,4801,1102,3699,0,0,0,1.0,1,1.0,1,1.0,1,0.17789106427853243,58
1494,6,4807,1104,3703,0,0,0,1.0,1,1.0,1,1.0,1,0.18005397376406237,58
1495,7,4814,1106,3708,0,0,0,1.0,1,1.0,1,1.0,1,0.19471926174197715,57
1496,1,4815,1106,3709,0,0,0,1.0,1,1.0,1,1.0,1,0.20718262051108166,59
1497,2,4817,1107,3710,0,0,0,1.0,1,1.0,1,1.0,1,0.19164794968513751,58
1498,4,4821,1108,3713,0,0,0,1.0,1,1.0,1,1.0,1,0.18932799947391973,58
1499,3,4824,1108,3716,0,0,0,1.0,1,1.0,1,1.0,1,0.17811125713782355,56
1500,6,4830,1109,3721,0,0,0,1.0,1,1.0,1,1.0,1,0.16923542576842943,57
1501,1,4831,1109,3722,0,0,0,1.0,1,1.0,1,1.0,1,0.16950308110419632,55
1502,1,4832,1110,3722,0,0,0,1.0,1,1.0,1,1.0,1,0.1759757221463322,55
1503,3,4835,1110,3725,0,0,0,1.0,1,1.0,1,1.0,1,0.12439563872413979,54
1504,3,4838,1111,3727,0,0,0,1.0,1,1.0,1,1.0,1,0.11016271333618056,55
1505,1,4839,1111,3728,0,0,0,1.0,1,1.0,1,1.0,1,0.11070145195074738,53
1506,4,4843,1112,3731,0,0,0,1.0,1,1.0,1,1.0,1,0.10510046255121672,55
1507,2,4845,1113,3732,0,0,0,1.0,1,1.0,1,1.0,1,0.10464917710924998,53
1508,4,4849,1115,3734,0,0,0,1.0,1,1.0,1,1.0,1,0.11038638484064472,53
1509,2,4851,1116,3735,0,0,0,1.0,1,1.0,1,1.0,1,0.13873600073564238,52
1510,4,4855,1118,3737,0,0,0,1.0,1,1.0,1,1.0,1,0.15434641774347949,50
1511,2,4857,1118,3739,0,0,0,1.0,1,1.0,1,1.0,1,0.1675170072449892,49
1512,3,4860,1120,3740,0,0,0,1.0,1,1.0,1,1.0,1,0.22357642162133293,48
1513,5,4865,1121,3744,0,0,0,1.0,1,1.0,1,1.0,1,0.2576704167176507,47
1514,3,4868,1122,3746,0,0,0,1.0,1,1.0,1,1.0,1,0.23231764342574832,48
1515,2,4870,1122,3748,0,0,0,1.0,1,1.0,1,1.0,1,0.23714333451159786,48
1516,8,4878,1123,3755,0,0,0,1.0,1,1.0,1,1.0,1,0.149373093999843,47
1517,7,4885,1123,3762,0,0,0,1.0,1,1.0,1,1.0,1,0.16074369956646103,48
1518,6,4891,1124,3767,0,0,0,1.0,1,1.0,1,1.0,1,0.13629945091104745,48
1519,2,4893,1124,3769,0,0,0,1.0,1,1.0,1,1.0,1,0.13241465426039165,47
1520,7,4900,1127,3773,0,0,0,1.0,1,1.0,1,1.0,1,0.19916481375409242,48
1521,8,4908,1127,3781,0,0,0,1.0,1,1.0,1,1.0,1,0.20206520704367043,49
1522,4,4912,1128,3784,0,0,0,1.0,1,1.0,1,1.0,1,0.1819343496759059,48
1523,5,4917,1128,3789,0,0,0,1.0,1,1.0,1,1.0,1,0.18912351153173126,49
1524,2,4919,1128,3791,0,0,0,1.0,1,1.0,1,1.0,1,0.18892817854963273,49
1525,9,4928,1129,3799,0,0,0,1.0,1,1.0,1,1.0,1,0.20482918178131138,51
1526,9,4937,1129,3808,0,0,0,1.0,1,1.0,1,1.0,1,0.1777365022988154,52
1527,14,4951,1130,3821,0,0,0,1.0,1,1.0,1,1.0,1,0.194314836007107,54
1528,15,4966,1131,3835,0,0,0,1.0,1,1.0,1,1.0,1,0.2122067210063914,54
1529,9,4975,1131,3844,0,0,0,1.0,1,1.0,1,1.0,1,0.2727679993480077,54
1530,12,4987,1132,3855,0,0,0,1.0,1,1.0,1,1.0,1,0.2683716584409897,54
1531,9,4996,1132,3864,0,0,0,1.0,1,1.0,1,1.0,1,0.18623523251808488,54
1532,5,5001,1133,3868,0,0,0,1.0,1,1.0,1,1.0,1,0.16004101109832564,54
1533,4,5005,1133,3872,0,0,0,1.0,1,1.0,1,1.0,1,0.156894956019299,54
1534,5,5010,1133,3877,0,0,0,1.0,1,1.0,1,1.0,1,0.11910170438440121,54
1535,6,5016,1133,3883,0,0,0,1.0,1,1.0,1,1.0,1,0.12439332594650704,54
1536,8,5024,1133,3891,0,0,0,1.0,1,1.0,1,1.0,1,0.11778032274134984,55
1537,3,5027,1133,3894,0,0,0,1.0,1,1.0,1,1.0,1,0.13810105131046801,53
1538,5,5032,1133,3899,0,0,0,1.0,1,1.0,1,1.0,1,0.09611489755866938,54
1539,2,5034,1133,3901,0,0,0,1.0,1,1.0,1,1.0,1,0.15107266091430527,54
1540,6,5040,1134,3906,0,0,0,1.0,1,1.0,1,1.0,1,0.15278833730021255,54
1541,2,5042,1134,3908,0,0,0,1.0,1,1.0,1,1.0,1,0.13480336127530312,54
1542,9,5051,1136,3915,0,0,0,1.0,1,1.0,1,1.0,1,0.11142685558553973,57
1543,9,5060,1137,3923,0,0,0,1.0,1,1.0,1,1.0,1,0.16130090716121936,55
1544,7,5067,1139,3928,0,0,0,1.0,1,1.0,1,1.0,1,0.11116835107112828,54
1545,5,5072,1139,3933,0,0,0,1.0,1,1.0,1,1.0,1,0.08618695778048405,54
1546,2,5074,1139,3935,0,0,0,1.0,1,1.0,1,1.0,1,0.06386927628747353,53
1547,0,5074,1139,3935,0,0,0,1.0,1,1.0,1,1.0,1,0.06386927628747353,53
1548,1,5075,1140,3935,0,0,0,1.0,1,1.0,1,1.0,1,0.07719873119264481,54
1549,0,5075,1140,3935,0,0,0,1.0,1,1.0,1,1.0,1,0.09963268768191248,52
1550,4,5079,1143,3936,0,0,0,1.0,1,1.0,1,1.0,1,0.08827767906739742,52
1551,3,5082,1146,3936,0,0,0,1.0,1,1.0,1,1.0,1,0.12514526520263547,52
1552,6,5088,1150,3938,0,0,0,1.0,1,1.0,1,1.0,1,0.16975984129264274,51
1553,10,5098,1155,3943,0,0,0,1.0,1,1.0,1,1.0,1,0.19066945459885556,51
1554,4,5102,1158,3944,0,0,0,1.0,1,1.0,1,1.0,1,0.12977228190057433,51
1555,2,5104,1159,3945,0,0,0,1.0,1,1.0,1,1.0,1,0.13816995239219063,50
1556,4,5108,1162,3946,0,0,0,1.0,1,1.0,1,1.0,1,0.19354986803753324,51
1557,3,5111,1164,3947,0,0,0,1.0,1,1.0,1,1.0,1,0.2027902275446871,51
1558,5,5116,1165,3951,0,0,0,1.0,1,1.0,1,1.0,1,0.18176828471963585,52
1559,6,5122,1168,3954,0,0,0,1.0,1,1.0,1,1.0,1,0.24835327716463906,53
1560,5,5127,1169,3958,0,0,0,1.0,1,1.0,1,1.0,1,0.2508010914766178,51
1561,9,5136,1169,3967,0,0,0,1.0,1,1.0,1,1.0,1,0.11339339670874281,51
1562,0,5136,1169,3967,0,0,0,1.0,1,1.0,1,1.0,1,0.1204359738041591,52
1563,2,5138,1169,3969,0,0,0,1.0,1,1.0,1,1.0,1,0.11157515969885011,52
1564,1,5139,1169,3970,0,0,0,1.0,1,1.0,1,1.0,1,0.11452610748896995,51
1565,3,5142,1169,3973,0,0,0,1.0,1,1.0,1,1.0,1,0.10781355258681626,53
1566,2,5144,1169,3975,0,0,0,1.0,1,1.0,1,1.0,1,0.11560230478601508,53
1567,1,5145,1169,3976,0,0,0,1.0,1,1.0,1,1.0,1,0.12287870781135184,52
1568,6,5151,1170,3981,0,0,0,1.0,1,1.0,1,1.0,1,0.15164083897123354,52
1569,6,5157,1170,3987,0,0,0,1.0,1,1.0,1,1.0,1,0.1280644671080325,49
1570,7,5164,1170,3994,0,0,0,1.0,1,1.0,1,1.0,1,0.12885305657138518,48
1571,5,5169,1173,3996,0,0,0,1.0,1,1.0,1,1.0,1,0.1181361656346731,46
1572,1,5170,1174,3996,0,0,0,1.0,1,1.0,1,1.0,1,0.12858868786332026,47
1573,1,5171,1175,3996,0,0,0,1.0,1,1.0,1,1.0,1,0.12959803369737763,48
1574,1,5172,1176,3996,0,0,0,1.0,1,1.0,1,1.0,1,0.14330144161797675,46
1575,2,5174,1177,3997,0,0,0,1.0,1,1.0,1,1.0,1,0.11765708410351011,47
1576,8,5182,1182,4000,0,0,0,1.0,1,1.0,1,1.0,1,0.14961948953241433,46
1577,1,5183,1183,4000,0,0,0,1.0,1,1.0,1,1.0,1,0.1725214688596455,45
1578,0,5183,1183,4000,0,0,0,1.0,1,1.0,1,1.0,1,0.17585304702786417,44
1579,0,5183,1183,4000,0,0,0,1.0,1,1.0,1,1.0,1,0.18967911573020782,43
1580,0,5183,1183,4000,0,0,0,1.0,1,1.0,1,1.0,1,0.18967911573020782,43
1581,0,5183,1183,4000,0,0,0,1.0,1,1.0,1,1.0,1,0.22005749322150536,42
1582,1,5184,1184,4000,0,0,0,1.0,1,1.0,1,1.0,1,0.23273130661460584,42
1583,1,5185,1185,4000,0,0,0,1.0,1,1.0,1,1.0,1,0.22772692243257028,43
1584,4,5189,1187,4002,0,0,0,1.0,1,1.0,1,1.0,1,0.19536585516316843,41
1585,4,5193,1190,4003,0,0,0,1.0,1,1.0,1,1.0,1,0.20779897116899593,43
1586,5,5198,1193,4005,0,0,0,1.0,1,1.0,1,1.0,1,0.1627829567367723,42
1587,1,5199,1194,4005,0,0,0,1.0,1,1.0,1,1.0,1,0.18232049672339193,42
1588,6,5205,1198,4007,0,0,0,1.0,1,1.0,1,1.0,1,0.26957032470939546,42
1589,6,5211,1199,4012,0,0,0,1.0,1,1.0,1,1.0,1,0.22989210425916898,42
1590,5,5216,1200,4016,0,0,0,1.0,1,1.0,1,1.0,1,0.2994228230889693,41
1591,7,5223,1201,4022,0,0,0,1.0,1,1.0,1,1.0,1,0.18861685088595334,40
1592,2,5225,1201,4024,0,0,0,1.0,1,1.0,1,1.0,1,0.20704320290093023,39
1593,3,5228,1202,4026,0,0,0,1.0,1,1.0,1,1.0,1,0.19654867896855036,39
1594,1,5229,1202,4027,0,0,0,1.0,1,1.0,1,1.0,1,0.17583270066854315,39
1595,4,5233,1202,4031,0,0,0,1.0,1,1.0,1,1.0,1,0.16555233688405235,42
1596,2,5235,1202,4033,0,0,0,1.0,1,1.0,1,1.0,1,0.1888749882034923,41
1597,2,5237,1203,4034,0,0,0,1.0,1,1.0,1,1.0,1,0.17167627094733717,41
1598,3,5240,1205,4035,0,0,0,1.0,1,1.0,1,1.0,1,0.17111284597467524,39
1599,0,5240,1205,4035,0,0,0,1.0,1,1.0,1,1.0,1,0.17111284597467524,39
1600,1,5241,1206,4035,0,0,0,1.0,1,1.0,1,1.0,1,0.17508572045430965,40
1601,7,5248,1207,4041,0,0,0,1.0,1,1.0,1,1.0,1,0.1533032057401676,41
1602,1,5249,1207,4042,0,0,0,1.0,1,1.0,1,1.0,1,0.15610389640513148,41
1603,3,5252,1208,4044,0,0,0,1.0,1,1.0,1,1.0,1,0.18154908634653105,43
1604,3,5255,1208,4047,0,0,0,1.0,1,1.0,1,1.0,1,0.13099392572574567,43
1605,4,5259,1209,4050,0,0,0,1.0,1,1.0,1,1.0,1,0.17648131259584432,44
1606,6,5265,1211,4054,0,0,0,1.0,1,1.0,1,1.0,1,0.12350217610325968,44
1607,2,5267,1212,4055,0,0,0,1.0,1,1.0,1,1.0,1,0.14029524990297862,42
1608,2,5269,1213,4056,0,0,0,1.0,1,1.0,1,1.0,1,0.11729551262323218,41
1609,0,5269,1213,4056,0,0,0,1.0,1,1.0,1,1.0,1,0.11751267205117714,39
1610,1,5270,1213,4057,0,0,0,1.0,1,1.0,1,1.0,1,0.14854336749510447,39
1611,3,5273,1213,4060,0,0,0,1.0,1,1.0,1,1.0,1,0.16431491819186217,40
1612,1,5274,1213,4061,0,0,0,1.0,1,1.0,1,1.0,1,0.1756020767857646,39
1613,7,5281,1215,4066,0,0,0,1.0,1,1.0,1,1.0,1,0.21025503329705658,41
1614,7,5288,1215,4073,0,0,0,1.0,1,1.0,1,1.0,1,0.19562402969501408,41
1615,5,5293,1216,4077,0,0,0,1.0,1,1.0,1,1.0,1,0.21912223955413726,41
1616,4,5297,1218,4079,0,0,0,1.0,1,1.0,1,1.0,1,0.1979094472296104,43
1617,4,5301,1219,4082,0,0,0,1.0,1,1.0,1,1.0,1,0.23432315106555351,44
1618,4,5305,1220,4085,0,0,0,1.0,1,1.0,1,1.0,1,0.18244989366799513,44
1619,5,5310,1220,4090,0,0,0,1.0,1,1.0,1,1.0,1,0.24650378080817864,44
1620,12,5322,1221,4101,0,0,0,1.0,1,1.0,1,1.0,1,0.2871031682128856,45
1621,8,5330,1221,4109,0,0,0,1.0,1,1.0,1,1.0,1,0.10910829745281495,44
1622,5,5335,1223,4112,0,0,0,1.0,1,1.0,1,1.0,1,0.11883516368624143,44
1623,2,5337,1224,4113,0,0,0,1.0,1,1.0,1,1.0,1,0.18627012798445658,43
1624,1,5338,1224,4114,0,0,0,1.0,1,1.0,1,1.0,1,0.11794980720348335,43
1625,2,5340,1225,4115,0,0,0,1.0,1,1.0,1,1.0,1,0.13255075962571516,43
1626,6,5346,1225,4121,0,0,0,1.0,1,1.0,1,1.0,1,0.16399276080824024,42
1627,3,5349,1225,4124,0,0,0,1.0,1,1.0,1,1.0,1,0.18126396843658807,42
1628,8,5357,1227,4130,0,0,0,1.0,1,1.0,1,1.0,1,0.1688267665662245,42
1629,7,5364,1228,4136,0,0,0,1.0,1,1.0,1,1.0,1,0.20670436136002224,41
1630,8,5372,1231,4141,0,0,0,1.0,1,1.0,1,1.0,1,0.2405180778639838,41
1631,11,5383,1233,4150,0,0,0,1.0,1,1.0,1,1.0,1,0.2738306604698617,40
1632,6,5389,1233,4156,0,0,0,1.0,1,1.0,1,1.0,1,0.3044125697218851,39
1633,7,5396,1233,4163,0,0,0,1.0,1,1.0,1,1.0,1,0.26308835204006537,39
1634,3,5399,1233,4166,0,0,0,1.0,1,1.0,1,1.0,1,0.2405198163492604,39
1635,6,5405,1233,4172,0,0,0,1.0,1,1.0,1,1.0,1,0.24522745754543374,40
1636,7,5412,1233,4179,0,0,0,1.0,1,1.0,1,1.0,1,0.11247131098109084,41
1637,2,5414,1234,4180,0,0,0,1.0,1,1.0,1,1.0,1,0.12487237425102102,41
1638,5,5419,1235,4184,0,0,0,1.0,1,1.0,1,1.0,1,0.10864195088858085,42
1639,2,5421,1235,4186,0,0,0,1.0,1,1.0,1,1.0,1,0.11845192031200587,43
1640,5,5426,1235,4191,0,0,0,1.0,1,1.0,1,1.0,1,0.1343232874989902,43
1641,4,5430,1235,4195,0,0,0,1.0,1,1.0,1,1.0,1,0.13224637292997155,44
1642,3,5433,1235,4198,0,0,0,1.0,1,1.0,1,1.0,1,0.15877806404945227,45
1643,6,5439,1236,4203,0,0,0,1.0,1,1.0,1,1.0,1,0.17321770432824737,44
1644,7,5446,1237,4209,0,0,0,1.0,1,1.0,1,1.0,1,0.14229865929628083,45
1645,7,5453,1238,4215,0,0,0,1.0,1,1.0,1,1.0,1,0.1533719081970044,44
1646,9,5462,1240,4222,0,0,0,1.0,1,1.0,1,1.0,1,0.17501300201957895,43
1647,10,5472,1243,4229,0,0,0,1.0,1,1.0,1,1.0,1,0.13478005474481353,43
1648,2,5474,1243,4231,0,0,0,1.0,1,1.0,1,1.0,1,0.13630798271408712,42
1649,2,5476,1243,4233,0,0,0,1.0,1,1.0,1,1.0,1,0.16237382056234315,41
1650,4,5480,1243,4237,0,0,0,1.0,1,1.0,1,1.0,1,0.16000782859061496,41
1651,4,5484,1244,4240,0,0,0,1.0,1,1.0,1,1.0,1,0.14438070958595917,40
1652,1,5485,1244,4241,0,0,0,1.0,1,1.0,1,1.0,1,0.1529769107427454,39
1653,0,5485,1244,4241,0,0,0,1.0,1,1.0,1,1.0,1,0.18870756354337398,39
1654,1,5486,1245,4241,0,0,0,1.0,1,1.0,1,1.0,1,0.21036047403299354,39
1655,2,5488,1246,4242,0,0,0,1.0,1,1.0,1,1.0,1,0.2084565822304401,40
1656,0,5488,1246,4242,0,0,0,1.0,1,1.0,1,1.0,1,0.23426367005109808,40
1657,1,5489,1246,4243,0,0,0,1.0,1,1.0,1,1.0,1,0.1979373816282387,40
1658,0,5489,1246,4243,0,0,0,1.0,1,1.0,1,1.0,1,0.1979373816282387,40
1659,1,5490,1247,4243,0,0,0,1.0,1,1.0,1,1.0,1,0.1809742976529169,40
1660,2,5492,1248,4244,0,0,0,1.0,1,1.0,1,1.0,1,0.19618391743386376,41
1661,1,5493,1249,4244,0,0,0,1.0,1,1.0,1,1.0,1,0.2308629776836426,42
1662,2,5495,1250,4245,0,0,0,1.0,1,1.0,1,1.0,1,0.17201442131873712,44
1663,2,5497,1251,4246,0,0,0,1.0,1,1.0,1,1.0,1,0.15816848726523286,43
1664,4,5501,1253,4248,0,0,0,1.0,1,1.0,1,1.0,1,0.19217250485641102,42
1665,3,5504,1254,4250,0,0,0,1.0,1,1.0,1,1.0,1,0.16779693660158795,42
1666,9,5513,1259,4254,0,0,0,1.0,1,1.0,1,1.0,1,0.21196320000772406,43
1667,2,5515,1260,4255,0,0,0,1.0,1,1.0,1,1.0,1,0.16931931300450945,40
1668,3,5518,1261,4257,0,0,0,1.0,1,1.0,1,1.0,1,0.14811220120030436,40
1669,0,5518,1261,4257,0,0,0,1.0,1,1.0,1,1.0,1,0.1554528130894166,40
1670,2,5520,1263,4257,0,0,0,1.0,1,1.0,1,1.0,1,0.17438266016916756,39
1671,2,5522,1264,4258,0,0,0,1.0,1,1.0,1,1.0,1,0.17711609975848647,39
1672,3,5525,1266,4259,0,0,0,1.0,1,1.0,1,1.0,1,0.18614156838751986,38
1673,1,5526,1267,4259,0,0,0,1.0,1,1.0,1,1.0,1,0.2109776077753711,38
1674,2,5528,1269,4259,0,0,0,1.0,1,1.0,1,1.0,1,0.19073114564289245,38
1675,2,5530,1271,4259,0,0,0,1.0,1,1.0,1,1.0,1,0.2508025144777323,39
1676,4,5534,1271,4263,0,0,0,1.0,1,1.0,1,1.0,1,0.16312800760080534,39
1677,1,5535,1271,4264,0,0,0,1.0,1,1.0,1,1.0,1,0.17744273286953266,40
1678,2,5537,1271,4266,0,0,0,1.0,1,1.0,1,1.0,1,0.17163241724694098,39
1679,2,5539,1271,4268,0,0,0,1.0,1,1.0,1,1.0,1,0.17163241724694098,39
1680,1,5540,1271,4269,0,0,0,1.0,1,1.0,1,1.0,1,0.1773623035759611,40
1681,2,5542,1271,4271,0,0,0,1.0,1,1.0,1,1.0,1,0.1468491702903802,41
1682,1,5543,1271,4272,0,0,0,1.0,1,1.0,1,1.0,1,0.1099609351375943,40
1683,2,5545,1272,4273,0,0,0,1.0,1,1.0,1,1.0,1,0.12533330896221537,43
1684,4,5549,1274,4275,0,0,0,1.0,1,1.0,1,1.0,1,0.14719299004247932,42
1685,1,5550,1275,4275,0,0,0,1.0,1,1.0,1,1.0,1,0.13711282740468012,41
1686,4,5554,1277,4277,0,0,0,1.0,1,1.0,1,1.0,1,0.1672429191517316,39
1687,6,5560,1280,4280,0,0,0,1.0,1,1.0,1,1.0,1,0.220226498574487,41
1688,1,5561,1281,4280,0,0,0,1.0,1,1.0,1,1.0,1,0.21391915089091462,39
1689,3,5564,1284,4280,0,0,0,1.0,1,1.0,1,1.0,1,0.22658616909713986,37
1690,3,5567,1285,4282,0,0,0,1.0,1,1.0,1,1.0,1,0.2219800690151264,36
1691,2,5569,1287,4282,0,0,0,1.0,1,1.0,1,1.0,1,0.27262230428443707,36
1692,0,5569,1287,4282,0,0,0,1.0,1,1.0,1,1.0,1,0.2853660721540616,34
1693,1,5570,1288,4282,0,0,0,1.0,1,1.0,1,1.0,1,0.2762893322380676,33
1694,2,5572,1288,4284,0,0,0,1.0,1,1.0,1,1.0,1,0.2881508165076119,32
1695,0,5572,1288,4284,0,0,0,1.0,1,1.0,1,1.0,1,0.28801632948392836,32
1696,6,5578,1289,4289,0,0,0,1.0,1,1.0,1,1.0,1,0.22505782712516792,34
1697,2,5580,1289,4291,0,0,0,1.0,1,1.0,1,1.0,1,0.1795399759523644,34
1698,2,5582,1290,4292,0,0,0,1.0,1,1.0,1,1.0,1,0.2065471969448713,36
1699,4,5586,1292,4294,0,0,0,1.0,1,1.0,1,1.0,1,0.208330026747594,36
1700,0,5586,1292,4294,0,0,0,1.0,1,1.0,1,1.0,1,0.22327443212960618,37
1701,2,5588,1293,4295,0,0,0,1.0,1,1.0,1,1.0,1,0.24681002076131373,39
1702,2,5590,1295,4295,0,0,0,1.0,1,1.0,1,1.0,1,0.2769911263801822,39
1703,1,5591,1295,4296,0,0,0,1.0,1,1.0,1,1.0,1,0.24199804772762765,38
1704,7,5598,1298,4300,0,0,0,1.0,1,1.0,1,1.0,1,0.20077850242508655,38
1705,4,5602,1298,4304,0,0,0,1.0,1,1.0,1,1.0,1,0.19759544386611855,37
1706,3,5605,1299,4306,0,0,0,1.0,1,1.0,1,1.0,1,0.16914111821935462,37
1707,3,5608,1299,4309,0,0,0,1.0,1,1.0,1,1.0,1,0.18261781940210506,36
1708,3,5611,1299,4312,0,0,0,1.0,1,1.0,1,1.0,1,0.25916269513656154,34
1709,9,5620,1302,4318,0,0,0,1.0,1,1.0,1,1.0,1,0.27640694245653114,34
1710,8,5628,1302,4326,0,0,0,1.0,1,1.0,1,1.0,1,0.2930092975249609,33
1711,2,5630,1303,4327,0,0,0,1.0,1,1.0,1,1.0,1,0.27274418033445275,32
1712,0,5630,1303,4327,0,0,0,1.0,1,1.0,1,1.0,1,0.28670631073905967,31
1713,1,5631,1303,4328,0,0,0,1.0,1,1.0,1,1.0,1,0.2692607655502751,32
1714,1,5632,1303,4329,0,0,0,1.0,1,1.0,1,1.0,1,0.2572718934261983,32
1715,0,5632,1303,4329,0,0,0,1.0,1,1.0,1,1.0,1,0.2572718934261983,32
1716,3,5635,1303,4332,0,0,0,1.0,1,1.0,1,1.0,1,0.24259766661697474,34
1717,0,5635,1303,4332,0,0,0,1.0,1,1.0,1,1.0,1,0.24259766661697474,34
1718,0,5635,1303,4332,0,0,0,1.0,1,1.0,1,1.0,1,0.25903242692771405,34
1719,0,5635,1303,4332,0,0,0,1.0,1,1.0,1,1.0,1,0.25903242692771405,34
1720,1,5636,1304,4332,0,0,0,1.0,1,1.0,1,1.0,1,0.26320793633588263,34
1721,1,5637,1304,4333,0,0,0,1.0,1,1.0,1,1.0,1,0.2462129737156042,35
1722,0,5637,1304,4333,0,0,0,1.0,1,1.0,1,1.0,1,0.24039392872777193,35
1723,0,5637,1304,4333,0,0,0,1.0,1,1.0,1,1.0,1,0.24133767143613657,34
1724,2,5639,1305,4334,0,0,0,1.0,1,1.0,1,1.0,1,0.2588213898060505,33
1725,5,5644,1306,4338,0,0,0,1.0,1,1.0,1,1.0,1,0.275111462321578,35
1726,3,5647,1306,4341,0,0,0,1.0,1,1.0,1,1.0,1,0.18059654942216682,34
1727,5,5652,1307,4345,0,0,0,1.0,1,1.0,1,1.0,1,0.16058407356671056,34
1728,1,5653,1307,4346,0,0,0,1.0,1,1.0,1,1.0,1,0.12569742816230925,35
1729,1,5654,1307,4347,0,0,0,1.0,1,1.0,1,1.0,1,0.10590048062090941,35
1730,2,5656,1308,4348,0,0,0,1.0,1,1.0,1,1.0,1,0.10877149142653351,35
1731,2,5658,1309,4349,0,0,0,1.0,1,1.0,1,1.0,1,0.1478261791700556,35
1732,4,5662,1309,4353,0,0,0,1.0,1,1.0,1,1.0,1,0.11365946726283263,35
1733,3,5665,1309,4356,0,0,0,1.0,1,1.0,1,1.0,1,0.14888655387297,33
1734,3,5668,1311,4357,0,0,0,1.0,1,1.0,1,1.0,1,0.1862662705601658,34
1735,3,5671,1311,4360,0,0,0,1.0,1,1.0,1,1.0,1,0.18018666448012605,33
1736,3,5674,1313,4361,0,0,0,1.0,1,1.0,1,1.0,1,0.1712675648242032,33
1737,0,5674,1313,4361,0,0,0,1.0,1,1.0,1,1.0,1,0.17427441199870924,35
1738,5,5679,1317,4362,0,0,0,1.0,1,1.0,1,1.0,1,0.2401395535871173,36
1739,2,5681,1318,4363,0,0,0,1.0,1,1.0,1,1.0,1,0.25774534338738603,36
1740,6,5687,1319,4368,0,0,0,1.0,1,1.0,1,1.0,1,0.2308453941322246,37
1741,6,5693,1319,4374,0,0,0,1.0,1,1.0,1,1.0,1,0.13888847970322823,36
1742,0,5693,1319,4374,0,0,0,1.0,1,1.0,1,1.0,1,0.13888847970322823,36
1743,2,5695,1320,4375,0,0,0,1.0,1,1.0,1,1.0,1,0.14808642640110076,37
1744,0,5695,1320,4375,0,0,0,1.0,1,1.0,1,1.0,1,0.14839169771654523,37
1745,5,5700,1323,4377,0,0,0,1.0,1,1.0,1,1.0,1,0.2489877629444673,38
1746,3,5703,1323,4380,0,0,0,1.0,1,1.0,1,1.0,1,0.2284396841822208,38
1747,5,5708,1323,4385,0,0,0,1.0,1,1.0,1,1.0,1,0.22371439953865238,37
1748,5,5713,1323,4390,0,0,0,1.0,1,1.0,1,1.0,1,0.23222538723444502,38
1749,4,5717,1325,4392,0,0,0,1.0,1,1.0,1,1.0,1,0.2541681436158415,38
1750,7,5724,1325,4399,0,0,0,1.0,1,1.0,1,1.0,1,0.2698774967177927,39
1751,15,5739,1325,4414,0,0,0,1.0,1,1.0,1,1.0,1,0.2174554023108153,41
1752,5,5744,1325,4419,0,0,0,1.0,1,1.0,1,1.0,1,0.21200076164847115,41
1753,5,5749,1326,4423,0,0,0,1.0,1,1.0,1,1.0,1,0.21606577951904665,41
1754,5,5754,1326,4428,0,0,0,1.0,1,1.0,1,1.0,1,0.22252774005599246,40
1755,10,5764,1327,4437,0,0,0,1.0,1,1.0,1,1.0,1,0.24946479445445768,41
1756,7,5771,1327,4444,0,0,0,1.0,1,1.0,1,1.0,1,0.15607518834769143,41
1757,1,5772,1327,4445,0,0,0,1.0,1,1.0,1,1.0,1,0.17563275617194327,40
1758,6,5778,1329,4449,0,0,0,1.0,1,1.0,1,1.0,1,0.23420166236667792,41
1759,6,5784,1329,4455,0,0,0,1.0,1,1.0,1,1.0,1,0.23672758673852518,38
1760,4,5788,1329,4459,0,0,0,1.0,1,1.0,1,1.0,1,0.2110872040119699,38
1761,5,5793,1330,4463,0,0,0,1.0,1,1.0,1,1.0,1,0.24615128957867552,37
1762,6,5799,1331,4468,0,0,0,1.0,1,1.0,1,1.0,1,0.25978188308682787,37
1763,8,5807,1332,4475,0,0,0,1.0,1,1.0,1,1.0,1,0.27255481433216144,37
1764,8,5815,1332,4483,0,0,0,1.0,1,1.0,1,1.0,1,0.2819316377507401,36
1765,8,5823,1334,4489,0,0,0,1.0,1,1.0,1,1.0,1,0.2929761042931878,36
1766,8,5831,1335,4496,0,0,0,1.0,1,1.0,1,1.0,1,0.26023048467408183,37
1767,7,5838,1336,4502,0,0,0,1.0,1,1.0,1,1.0,1,0.25585312242323427,37
1768,4,5842,1337,4505,0,0,0,1.0,1,1.0,1,1.0,1,0.33474035439162336,37
1769,5,5847,1338,4509,0,0,0,1.0,1,1.0,1,1.0,1,0.2676295076390046,38
1770,6,5853,1338,4515,0,0,0,1.0,1,1.0,1,1.0,1,0.26363146827264594,39
1771,6,5859,1338,4521,0,0,0,1.0,1,1.0,1,1.0,1,0.17594002025489963,39
1772,0,5859,1338,4521,0,0,0,1.0,1,1.0,1,1.0,1,0.17594002025489963,39
1773,0,5859,1338,4521,0,0,0,1.0,1,1.0,1,1.0,1,0.16632524414408534,41
1774,1,5860,1339,4521,0,0,0,1.0,1,1.0,1,1.0,1,0.15961460641599054,41
1775,0,5860,1339,4521,0,0,0,1.0,1,1.0,1,1.0,1,0.15420610047259858,42
1776,2,5862,1340,4522,0,0,0,1.0,1,1.0,1,1.0,1,0.161271006315728,43
1777,0,5862,1340,4522,0,0,0,1.0,1,1.0,1,1.0,1,0.161271006315728,43
1778,4,5866,1340,4526,0,0,0,1.0,1,1.0,1,1.0,1,0.1183956316515592,44
1779,0,5866,1340,4526,0,0,0,1.0,1,1.0,1,1.0,1,0.1323735089928741,46
1780,0,5866,1340,4526,0,0,0,1.0,1,1.0,1,1.0,1,0.1323735089928741,46
1781,0,5866,1340,4526,0,0,0,1.0,1,1.0,1,1.0,1,0.1323735089928741,46
1782,0,5866,1340,4526,0,0,0,1.0,1,1.0,1,1.0,1,0.16237090516406932,46
1783,3,5869,1342,4527,0,0,0,1.0,1,1.0,1,1.0,1,0.15984332288739403,44
1784,1,5870,1343,4527,0,0,0,1.0,1,1.0,1,1.0,1,0.15667196980718895,45
1785,2,5872,1345,4527,0,0,0,1.0,1,1.0,1,1.0,1,0.18259150455108195,42
1786,6,5878,1349,4529,0,0,0,1.0,1,1.0,1,1.0,1,0.1813735462519453,43
1787,2,5880,1350,4530,0,0,0,1.0,1,1.0,1,1.0,1,0.16344332635986017,41
1788,3,5883,1351,4532,0,0,0,1.0,1,1.0,1,1.0,1,0.1592042604115098,41
1789,2,5885,1352,4533,0,0,0,1.0,1,1.0,1,1.0,1,0.2140210315108072,41
1790,3,5888,1353,4535,0,0,0,1.0,1,1.0,1,1.0,1,0.1725998750779452,41
1791,2,5890,1355,4535,0,0,0,1.0,1,1.0,1,1.0,1,0.17773293396918177,40
1792,4,5894,1357,4537,0,0,0,1.0,1,1.0,1,1.0,1,0.17543828822335875,40
1793,1,5895,1358,4537,0,0,0,1.0,1,1.0,1,1.0,1,0.23921646315434386,41
1794,6,5901,1361,4540,0,0,0,1.0,1,1.0,1,1.0,1,0.19163685407633635,41
1795,2,5903,1363,4540,0,0,0,1.0,1,1.0,1,1.0,1,0.2579243537354415,40
1796,3,5906,1365,4541,0,0,0,1.0,1,1.0,1,1.0,1,0.2328439832898785,40
1797,2,5908,1367,4541,0,0,0,1.0,1,1.0,1,1.0,1,0.26897228121815003,37
1798,1,5909,1368,4541,0,0,0,1.0,1,1.0,1,1.0,1,0.2881635495723013,37
1799,1,5910,1369,4541,0,0,0,1.0,1,1.0,1,1.0,1,0.3071695147822248,36
1800,2,5912,1370,4542,0,0,0,1.0,1,1.0,1,1.0,1,0.32500329272104156,36
1801,5,5917,1370,4547,0,0,0,1.0,1,1.0,1,1.0,1,0.1979356017076563,34
1802,1,5918,1370,4548,0,0,0,1.0,1,1.0,1,1.0,1,0.20514359989221606,33
1803,3,5921,1370,4551,0,0,0,1.0,1,1.0,1,1.0,1,0.17967249120793305,33
1804,4,5925,1371,4554,0,0,0,1.0,1,1.0,1,1.0,1,0.19599023793645742,33
1805,2,5927,1371,4556,0,0,0,1.0,1,1.0,1,1.0,1,0.18756282185717763,35
1806,4,5931,1373,4558,0,0,0,1.0,1,1.0,1,1.0,1,0.23767175600815488,35
1807,10,5941,1373,4568,0,0,0,1.0,1,1.0,1,1.0,1,0.22819528392825036,35
1808,4,5945,1373,4572,0,0,0,1.0,1,1.0,1,1.0,1,0.14112693066435528,36
1809,1,5946,1373,4573,0,0,0,1.0,1,1.0,1,1.0,1,0.1542912865440532,36
1810,2,5948,1373,4575,0,0,0,1.0,1,1.0,1,1.0,1,0.1696619439479108,35
1811,3,5951,1373,4578,0,0,0,1.0,1,1.0,1,1.0,1,0.18468764660377573,36
1812,5,5956,1374,4582,0,0,0,1.0,1,1.0,1,1.0,1,0.21371076907677883,36
1813,4,5960,1376,4584,0,0,0,1.0,1,1.0,1,1.0,1,0.24135883520004414,36
1814,5,5965,1377,4588,0,0,0,1.0,1,1.0,1,1.0,1,0.2792737044568054,34
1815,5,5970,1377,4593,0,0,0,1.0,1,1.0,1,1.0,1,0.2708517629873449,35
1816,5,5975,1378,4597,0,0,0,1.0,1,1.0,1,1.0,1,0.22505720125395257,34
1817,1,5976,1378,4598,0,0,0,1.0,1,1.0,1,1.0,1,0.19861397610305098,34
1818,0,5976,1378,4598,0,0,0,1.0,1,1.0,1,1.0,1,0.19861397610305098,34
1819,4,5980,1378,4602,0,0,0,1.0,1,1.0,1,1.0,1,0.12522498470164356,35
1820,2,5982,1378,4604,0,0,0,1.0,1,1.0,1,1.0,1,0.1457161816317236,36
1821,0,5982,1378,4604,0,0,0,1.0,1,1.0,1,1.0,1,0.1457161816317236,36
1822,4,5986,1380,4606,0,0,0,1.0,1,1.0,1,1.0,1,0.188282688077292,37
1823,3,5989,1382,4607,0,0,0,1.0,1,1.0,1,1.0,1,0.2495994768299688,38
1824,5,5994,1383,4611,0,0,0,1.0,1,1.0,1,1.0,1,0.16311179603264941,37
1825,5,5999,1385,4614,0,0,0,1.0,1,1.0,1,1.0,1,0.2098980240880104,36
1826,3,6002,1386,4616,0,0,0,1.0,1,1.0,1,1.0,1,0.2183020722450235,35
1827,1,6003,1386,4617,0,0,0,1.0,1,1.0,1,1.0,1,0.20746606915604832,35
1828,3,6006,1387,4619,0,0,0,1.0,1,1.0,1,1.0,1,0.22658599340728658,33
1829,1,6007,1387,4620,0,0,0,1.0,1,1.0,1,1.0,1,0.29213499038281693,32
1830,4,6011,1388,4623,0,0,0,1.0,1,1.0,1,1.0,1,0.2982135125979596,32
1831,7,6018,1389,4629,0,0,0,1.0,1,1.0,1,1.0,1,0.25220807803782647,30
1832,2,6020,1390,4630,0,0,0,1.0,1,1.0,1,1.0,1,0.18078717006343814,30
1833,2,6022,1390,4632,0,0,0,1.0,1,1.0,1,1.0,1,0.1580497853252535,29
1834,0,6022,1390,4632,0,0,0,1.0,1,1.0,1,1.0,1,0.13536740313194262,28
1835,1,6023,1390,4633,0,0,0,1.0,1,1.0,1,1.0,1,0.10922427611194128,28
1836,0,6023,1390,4633,0,0,0,1.0,1,1.0,1,1.0,1,0.10578526458480882,29
1837,6,6029,1393,4636,0,0,0,1.0,1,1.0,1,1.0,1,0.23866968458454374,28
1838,1,6030,1393,4637,0,0,0,1.0,1,1.0,1,1.0,1,0.2865264234741964,28
1839,1,6031,1393,4638,0,0,0,1.0,1,1.0,1,1.0,1,0.29786905937760305,27
1840,2,6033,1393,4640,0,0,0,1.0,1,1.0,1,1.0,1,0.3246144587259201,26
1841,1,6034,1393,4641,0,0,0,1.0,1,1.0,1,1.0,1,0.3167098000041622,25
1842,4,6038,1394,4644,0,0,0,1.0,1,1.0,1,1.0,1,0.27043549720366633,26
1843,2,6040,1394,4646,0,0,0,1.0,1,1.0,1,1.0,1,0.27043549720366633,26
1844,1,6041,1394,4647,0,0,0,1.0,1,1.0,1,1.0,1,0.2731930872036743,26
1845,2,6043,1395,4648,0,0,0,1.0,1,1.0,1,1.0,1,0.31617560273685974,26
1846,3,6046,1396,4650,0,0,0,1.0,1,1.0,1,1.0,1,0.20962265335765304,26
1847,1,6047,1396,4651,0,0,0,1.0,1,1.0,1,1.0,1,0.19194009821062902,26
1848,3,6050,1397,4653,0,0,0,1.0,1,1.0,1,1.0,1,0.22457835474794627,27
1849,2,6052,1397,4655,0,0,0,1.0,1,1.0,1,1.0,1,0.11118229856165916,27
1850,0,6052,1397,4655,0,0,0,1.0,1,1.0,1,1.0,1,0.1185031656867528,28
1851,0,6052,1397,4655,0,0,0,1.0,1,1.0,1,1.0,1,0.1185031656867528,28
1852,0,6052,1397,4655,0,0,0,1.0,1,1.0,1,1.0,1,0.1185031656867528,28
1853,0,6052,1397,4655,0,0,0,1.0,1,1.0,1,1.0,1,0.1464419013367138,27
1854,0,6052,1397,4655,0,0,0,1.0,1,1.0,1,1.0,1,0.1751820367515927,28
1855,0,6052,1397,4655,0,0,0,1.0,1,1.0,1,1.0,1,0.1751820367515927,28
1856,0,6052,1397,4655,0,0,0,1.0,1,1.0,1,1.0,1,0.20765950831661517,30
1857,3,6055,1399,4656,0,0,0,1.0,1,1.0,1,1.0,1,0.31565241558941315,31
1858,5,6060,1401,4659,0,0,0,1.0,1,1.0,1,1.0,1,0.3349878426146562,31
1859,3,6063,1401,4662,0,0,0,1.0,1,1.0,1,1.0,1,0.2781051919151613,31
1860,3,6066,1401,4665,0,0,0,1.0,1,1.0,1,1.0,1,0.28137720618376677,31
1861,1,6067,1401,4666,0,0,0,1.0,1,1.0,1,1.0,1,0.26779420074422366,31
1862,1,6068,1402,4666,0,0,0,1.0,1,1.0,1,1.0,1,0.25826005188023654,31
1863,1,6069,1402,4667,0,0,0,1.0,1,1.0,1,1.0,1,0.2575422853824887,31
1864,1,6070,1403,4667,0,0,0,1.0,1,1.0,1,1.0,1,0.26682652154077396,30
1865,1,6071,1404,4667,0,0,0,1.0,1,1.0,1,1.0,1,0.26667632867484276,27
1866,4,6075,1407,4668,0,0,0,1.0,1,1.0,1,1.0,1,0.3363768680131894,28
1867,2,6077,1408,4669,0,0,0,1.0,1,1.0,1,1.0,1,0.2726909988225522,26
1868,1,6078,1409,4669,0,0,0,1.0,1,1.0,1,1.0,1,0.2938458373844785,26
1869,0,6078,1409,4669,0,0,0,1.0,1,1.0,1,1.0,1,0.2988421432175088,25
1870,1,6079,1410,4669,0,0,0,1.0,1,1.0,1,1.0,1,0.2705539501713489,25
1871,1,6080,1411,4669,0,0,0,1.0,1,1.0,1,1.0,1,0.25773078236542096,26
1872,1,6081,1412,4669,0,0,0,1.0,1,1.0,1,1.0,1,0.35680616692774475,25
1873,0,6081,1412,4669,0,0,0,1.0,1,1.0,1,1.0,1,0.356865802205577,23
1874,1,6082,1413,4669,0,0,0,1.0,1,1.0,1,1.0,1,0.3297700774179374,23
1875,0,6082,1413,4669,0,0,0,1.0,1,1.0,1,1.0,1,0.39497284026356977,21
1876,5,6087,1414,4673,0,0,0,1.0,1,1.0,1,1.0,1,0.29216081020251333,24
1877,1,6088,1415,4673,0,0,0,1.0,1,1.0,1,1.0,1,0.3205137803823038,24
1878,3,6091,1415,4676,0,0,0,1.0,1,1.0,1,1.0,1,0.23200706112044156,26
1879,2,6093,1415,4678,0,0,0,1.0,1,1.0,1,1.0,1,0.23200706112044156,26
1880,2,6095,1415,4680,0,0,0,1.0,1,1.0,1,1.0,1,0.23200706112044156,26
1881,0,6095,1415,4680,0,0,0,1.0,1,1.0,1,1.0,1,0.23200706112044156,26
1882,0,6095,1415,4680,0,0,0,1.0,1,1.0,1,1.0,1,0.24383760671265475,25
1883,0,6095,1415,4680,0,0,0,1.0,1,1.0,1,1.0,1,0.24383760671265475,25
1884,0,6095,1415,4680,0,0,0,1.0,1,1.0,1,1.0,1,0.24383760671265475,25
1885,0,6095,1415,4680,0,0,0,1.0,1,1.0,1,1.0,1,0.24383760671265475,25
1886,0,6095,1415,4680,0,0,0,1.0,1,1.0,1,1.0,1,0.2281868183908944,26
1887,0,6095,1415,4680,0,0,0,1.0,1,1.0,1,1.0,1,0.2281868183908944,26
1888,3,6098,1416,4682,0,0,0,1.0,1,1.0,1,1.0,1,0.28385987466704743,27
1889,3,6101,1416,4685,0,0,0,1.0,1,1.0,1,1.0,1,0.20617809845847426,28
1890,2,6103,1416,4687,0,0,0,1.0,1,1.0,1,1.0,1,0.20617809845847426,28
1891,2,6105,1416,4689,0,0,0,1.0,1,1.0,1,1.0,1,0.19471525902262699,29
1892,0,6105,1416,4689,0,0,0,1.0,1,1.0,1,1.0,1,0.19471525902262699,29
1893,0,6105,1416,4689,0,0,0,1.0,1,1.0,1,1.0,1,0.19471525902262699,29
1894,1,6106,1416,4690,0,0,0,1.0,1,1.0,1,1.0,1,0.1784379961717281,29
1895,0,6106,1416,4690,0,0,0,1.0,1,1.0,1,1.0,1,0.20580732001619592,31
1896,1,6107,1416,4691,0,0,0,1.0,1,1.0,1,1.0,1,0.19195947235036614,31
1897,0,6107,1416,4691,0,0,0,1.0,1,1.0,1,1.0,1,0.19195947235036614,31
1898,0,6107,1416,4691,0,0,0,1.0,1,1.0,1,1.0,1,0.19195947235036614,31
1899,0,6107,1416,4691,0,0,0,1.0,1,1.0,1,1.0,1,0.20417698867848494,32
1900,0,6107,1416,4691,0,0,0,1.0,1,1.0,1,1.0,1,0.20417698867848494,32
1901,0,6107,1416,4691,0,0,0,1.0,1,1.0,1,1.0,1,0.20417698867848494,32
1902,0,6107,1416,4691,0,0,0,1.0,1,1.0,1,1.0,1,0.20417698867848494,32
1903,0,6107,1416,4691,0,0,0,1.0,1,1.0,1,1.0,1,0.20417698867848494,32
1904,1,6108,1416,4692,0,0,0,1.0,1,1.0,1,1.0,1,0.20441620121273785,34
1905,1,6109,1416,4693,0,0,0,1.0,1,1.0,1,1.0,1,0.20458559922300135,34
1906,2,6111,1416,4695,0,0,0,1.0,1,1.0,1,1.0,1,0.17299556703317515,35
1907,1,6112,1417,4695,0,0,0,1.0,1,1.0,1,1.0,1,0.18036984980184612,36
1908,1,6113,1417,4696,0,0,0,1.0,1,1.0,1,1.0,1,0.1502388544428996,36
1909,4,6117,1418,4699,0,0,0,1.0,1,1.0,1,1.0,1,0.14096121169859566,37
1910,3,6120,1419,4701,0,0,0,1.0,1,1.0,1,1.0,1,0.10573858268743279,38
1911,2,6122,1419,4703,0,0,0,1.0,1,1.0,1,1.0,1,0.10936294775171898,37
1912,1,6123,1420,4703,0,0,0,1.0,1,1.0,1,1.0,1,0.12470303867934374,37
1913,0,6123,1420,4703,0,0,0,1.0,1,1.0,1,1.0,1,0.1286663783440773,36
1914,1,6124,1421,4703,0,0,0,1.0,1,1.0,1,1.0,1,0.1427290302887147,37
1915,3,6127,1423,4704,0,0,0,1.0,1,1.0,1,1.0,1,0.13927474308078314,37
1916,0,6127,1423,4704,0,0,0,1.0,1,1.0,1,1.0,1,0.11966833871401288,39
1917,3,6130,1425,4705,0,0,0,1.0,1,1.0,1,1.0,1,0.18040346066920962,38
1918,3,6133,1425,4708,0,0,0,1.0,1,1.0,1,1.0,1,0.1991677374336298,38
1919,5,6138,1426,4712,0,0,0,1.0,1,1.0,1,1.0,1,0.26066205872535825,38
1920,5,6143,1426,4717,0,0,0,1.0,1,1.0,1,1.0,1,0.2666856284949082,39
1921,2,6145,1426,4719,0,0,0,1.0,1,1.0,1,1.0,1,0.18119499962988528,38
1922,1,6146,1427,4719,0,0,0,1.0,1,1.0,1,1.0,1,0.15513328936565618,39
1923,3,6149,1429,4720,0,0,0,1.0,1,1.0,1,1.0,1,0.19417105896432987,40
1924,1,6150,1429,4721,0,0,0,1.0,1,1.0,1,1.0,1,0.18190659128797185,40
1925,3,6153,1430,4723,0,0,0,1.0,1,1.0,1,1.0,1,0.19815933370714042,40
1926,4,6157,1430,4727,0,0,0,1.0,1,1.0,1,1.0,1,0.18259605923973002,40
1927,2,6159,1430,4729,0,0,0,1.0,1,1.0,1,1.0,1,0.1983612352601001,41
1928,3,6162,1431,4731,0,0,0,1.0,1,1.0,1,1.0,1,0.21141180402623871,41
1929,1,6163,1431,4732,0,0,0,1.0,1,1.0,1,1.0,1,0.1956085476183355,40
1930,2,6165,1433,4732,0,0,0,1.0,1,1.0,1,1.0,1,0.2398192362931352,40
1931,0,6165,1433,4732,0,0,0,1.0,1,1.0,1,1.0,1,0.2398192362931352,40
1932,2,6167,1433,4734,0,0,0,1.0,1,1.0,1,1.0,1,0.20717474568843508,40
1933,2,6169,1433,4736,0,0,0,1.0,1,1.0,1,1.0,1,0.19341943373540793,42
1934,2,6171,1433,4738,0,0,0,1.0,1,1.0,1,1.0,1,0.19963899764372964,44
1935,3,6174,1433,4741,0,0,0,1.0,1,1.0,1,1.0,1,0.2053797940671217,44
1936,6,6180,1434,4746,0,0,0,1.0,1,1.0,1,1.0,1,0.1769445919909635,46
1937,3,6183,1434,4749,0,0,0,1.0,1,1.0,1,1.0,1,0.14925333413964087,47
1938,1,6184,1434,4750,0,0,0,1.0,1,1.0,1,1.0,1,0.15514529502391164,47
1939,1,6185,1434,4751,0,0,0,1.0,1,1.0,1,1.0,1,0.12200155662249151,47
1940,0,6185,1434,4751,0,0,0,1.0,1,1.0,1,1.0,1,0.12200155662249151,47
1941,2,6187,1435,4752,0,0,0,1.0,1,1.0,1,1.0,1,0.14917230461234876,47
1942,4,6191,1437,4754,0,0,0,1.0,1,1.0,1,1.0,1,0.1912687562721579,49
1943,6,6197,1439,4758,0,0,0,1.0,1,1.0,1,1.0,1,0.1895490013457347,47
1944,8,6205,1441,4764,0,0,0,1.0,1,1.0,1,1.0,1,0.17619080971750375,47
1945,7,6212,1444,4768,0,0,0,1.0,1,1.0,1,1.0,1,0.19556378799467003,45
1946,4,6216,1445,4771,0,0,0,1.0,1,1.0,1,1.0,1,0.199066813564929,45
1947,9,6225,1447,4778,0,0,0,1.0,1,1.0,1,1.0,1,0.2075578355681887,45
1948,5,6230,1447,4783,0,0,0,1.0,1,1.0,1,1.0,1,0.22041551053507685,45
1949,2,6232,1449,4783,0,0,0,1.0,1,1.0,1,1.0,1,0.2468026008577003,42
1950,2,6234,1450,4784,0,0,0,1.0,1,1.0,1,1.0,1,0.2045717208939577,42
1951,6,6240,1451,4789,0,0,0,1.0,1,1.0,1,1.0,1,0.1507392767115724,38
1952,2,6242,1452,4790,0,0,0,1.0,1,1.0,1,1.0,1,0.1359869362071421,36
1953,0,6242,1452,4790,0,0,0,1.0,1,1.0,1,1.0,1,0.13794170625359495,35
1954,0,6242,1452,4790,0,0,0,1.0,1,1.0,1,1.0,1,0.16537914351876662,32
1955,3,6245,1454,4791,0,0,0,1.0,1,1.0,1,1.0,1,0.16912514043408278,33
1956,1,6246,1455,4791,0,0,0,1.0,1,1.0,1,1.0,1,0.20832741249256856,31
1957,1,6247,1456,4791,0,0,0,1.0,1,1.0,1,1.0,1,0.22657720653712876,33
1958,4,6251,1457,4794,0,0,0,1.0,1,1.0,1,1.0,1,0.21909207162643554,34
1959,1,6252,1457,4795,0,0,0,1.0,1,1.0,1,1.0,1,0.24529973251400267,35
1960,5,6257,1459,4798,0,0,0,1.0,1,1.0,1,1.0,1,0.25801108047330784,36
1961,2,6259,1460,4799,0,0,0,1.0,1,1.0,1,1.0,1,0.21576275521322952,36
1962,2,6261,1460,4801,0,0,0,1.0,1,1.0,1,1.0,1,0.2549443074127652,35
1963,1,6262,1460,4802,0,0,0,1.0,1,1.0,1,1.0,1,0.2398461903219968,36
1964,1,6263,1461,4802,0,0,0,1.0,1,1.0,1,1.0,1,0.2534704068794033,35
1965,2,6265,1461,4804,0,0,0,1.0,1,1.0,1,1.0,1,0.2328289907362782,36
1966,6,6271,1462,4809,0,0,0,1.0,1,1.0,1,1.0,1,0.1812766415610113,36
1967,2,6273,1463,4810,0,0,0,1.0,1,1.0,1,1.0,1,0.18708938066778466,36
1968,1,6274,1463,4811,0,0,0,1.0,1,1.0,1,1.0,1,0.16209720506644484,37
1969,1,6275,1464,4811,0,0,0,1.0,1,1.0,1,1.0,1,0.17395597027860155,37
1970,1,6276,1464,4812,0,0,0,1.0,1,1.0,1,1.0,1,0.18805944621927928,38
1971,0,6276,1464,4812,0,0,0,1.0,1,1.0,1,1.0,1,0.20722513029100945,37
1972,0,6276,1464,4812,0,0,0,1.0,1,1.0,1,1.0,1,0.20722513029100945,37
1973,2,6278,1465,4813,0,0,0,1.0,1,1.0,1,1.0,1,0.260037306868833,37
1974,4,6282,1466,4816,0,0,0,1.0,1,1.0,1,1.0,1,0.28639600379186997,38
1975,3,6285,1466,4819,0,0,0,1.0,1,1.0,1,1.0,1,0.2542023642437355,37
1976,3,6288,1467,4821,0,0,0,1.0,1,1.0,1,1.0,1,0.2625895229905449,39
1977,2,6290,1467,4823,0,0,0,1.0,1,1.0,1,1.0,1,0.2798024908490549,42
1978,6,6296,1467,4829,0,0,0,1.0,1,1.0,1,1.0,1,0.2377731558125367,42
1979,1,6297,1467,4830,0,0,0,1.0,1,1.0,1,1.0,1,0.25308980318268853,42
1980,3,6300,1467,4833,0,0,0,1.0,1,1.0,1,1.0,1,0.26307365476357847,43
1981,6,6306,1467,4839,0,0,0,1.0,1,1.0,1,1.0,1,0.1550402616353253,44
1982,1,6307,1468,4839,0,0,0,1.0,1,1.0,1,1.0,1,0.17025622246046027,44
1983,2,6309,1468,4841,0,0,0,1.0,1,1.0,1,1.0,1,0.12232884679676193,44
1984,1,6310,1469,4841,0,0,0,1.0,1,1.0,1,1.0,1,0.1538489725301532,42
1985,0,6310,1469,4841,0,0,0,1.0,1,1.0,1,1.0,1,0.1365054697797101,41
1986,4,6314,1471,4843,0,0,0,1.0,1,1.0,1,1.0,1,0.14087517711937214,40
1987,0,6314,1471,4843,0,0,0,1.0,1,1.0,1,1.0,1,0.15106333858057192,37
1988,6,6320,1474,4846,0,0,0,1.0,1,1.0,1,1.0,1,0.1466465900462603,35
1989,1,6321,1475,4846,0,0,0,1.0,1,1.0,1,1.0,1,0.22185139377536184,32
1990,3,6324,1476,4848,0,0,0,1.0,1,1.0,1,1.0,1,0.22222257385609062,31
1991,3,6327,1477,4850,0,0,0,1.0,1,1.0,1,1.0,1,0.22693411222829596,32
1992,2,6329,1478,4851,0,0,0,1.0,1,1.0,1,1.0,1,0.21014157492054944,32
1993,1,6330,1479,4851,0,0,0,1.0,1,1.0,1,1.0,1,0.30348120369835285,32
1994,0,6330,1479,4851,0,0,0,1.0,1,1.0,1,1.0,1,0.328585942985281,31
1995,0,6330,1479,4851,0,0,0,1.0,1,1.0,1,1.0,1,0.3161370656352556,32
1996,7,6337,1479,4858,0,0,0,1.0,1,1.0,1,1.0,1,0.16336442153020425,32
1997,2,6339,1479,4860,0,0,0,1.0,1,1.0,1,1.0,1,0.1286443818435529,31
1998,2,6341,1479,4862,0,0,0,1.0,1,1.0,1,1.0,1,0.08913723662112345,32
1999,2,6343,1479,4864,0,0,0,1.0,1,1.0,1,1.0,1,0.1884905047704843,31
2000,3,6346,1479,4867,0,0,0,1.0,1,1.0,1,1.0,1,0.1637707865620307,30
2001,4,6350,1479,4871,0,0,0,1.0,1,1.0,1,1.0,1,0.1356162561887504,29
2002,3,6353,1479,4874,0,0,0,1.0,1,1.0,1,1.0,1,0.1408704438461555,31
2003,4,6357,1479,4878,0,0,0,1.0,1,1.0,1,1.0,1,0.1434946855193274,33
2004,3,6360,1480,4880,0,0,0,1.0,1,1.0,1,1.0,1,0.23047157419229727,34
2005,6,6366,1480,4886,0,0,0,1.0,1,1.0,1,1.0,1,0.24118394921427988,35
2006,5,6371,1482,4889,0,0,0,1.0,1,1.0,1,1.0,1,0.234659925429474,36
2007,3,6374,1482,4892,0,0,0,1.0,1,1.0,1,1.0,1,0.23272714249396204,36
2008,2,6376,1483,4893,0,0,0,1.0,1,1.0,1,1.0,1,0.24073516913164233,36
2009,0,6376,1483,4893,0,0,0,1.0,1,1.0,1,1.0,1,0.22300552588393274,37
2010,5,6381,1484,4897,0,0,0,1.0,1,1.0,1,1.0,1,0.17539477384946311,37
2011,3,6384,1484,4900,0,0,0,1.0,1,1.0,1,1.0,1,0.11199234442724239,37
2012,0,6384,1484,4900,0,0,0,1.0,1,1.0,1,1.0,1,0.11199234442724239,37
2013,2,6386,1484,4902,0,0,0,1.0,1,1.0,1,1.0,1,0.0821846480897278,39
2014,0,6386,1484,4902,0,0,0,1.0,1,1.0,1,1.0,1,0.1255741817221089,39
2015,0,6386,1484,4902,0,0,0,1.0,1,1.0,1,1.0,1,0.1255741817221089,39
2016,1,6387,1484,4903,0,0,0,1.0,1,1.0,1,1.0,1,0.1436170218346057,41
2017,1,6388,1484,4904,0,0,0,1.0,1,1.0,1,1.0,1,0.12057659684649528,41
2018,3,6391,1486,4905,0,0,0,1.0,1,1.0,1,1.0,1,0.17725463946352518,42
2019,1,6392,1486,4906,0,0,0,1.0,1,1.0,1,1.0,1,0.15299266953421264,43
2020,3,6395,1487,4908,0,0,0,1.0,1,1.0,1,1.0,1,0.14901915516080863,43
2021,5,6400,1487,4913,0,0,0,1.0,1,1.0,1,1.0,1,0.15726337984809846,43
2022,5,6405,1488,4917,0,0,0,1.0,1,1.0,1,1.0,1,0.17230504629898657,44
2023,6,6411,1489,4922,0,0,0,1.0,1,1.0,1,1.0,1,0.19533251299319404,42
2024,4,6415,1491,4924,0,0,0,1.0,1,1.0,1,1.0,1,0.20663526686696973,41
2025,2,6417,1493,4924,0,0,0,1.0,1,1.0,1,1.0,1,0.23873195192567057,39
2026,6,6423,1494,4929,0,0,0,1.0,1,1.0,1,1.0,1,0.12617913451144688,39
2027,2,6425,1495,4930,0,0,0,1.0,1,1.0,1,1.0,1,0.20379310704889417,38
2028,0,6425,1495,4930,0,0,0,1.0,1,1.0,1,1.0,1,0.2313693181839369,37
2029,3,6428,1496,4932,0,0,0,1.0,1,1.0,1,1.0,1,0.1919064420999782,35
2030,1,6429,1497,4932,0,0,0,1.0,1,1.0,1,1.0,1,0.25256620908009014,32
2031,4,6433,1498,4935,0,0,0,1.0,1,1.0,1,1.0,1,0.296417674890359,34
2032,4,6437,1499,4938,0,0,0,1.0,1,1.0,1,1.0,1,0.2933112211493619,35
2033,4,6441,1501,4940,0,0,0,1.0,1,1.0,1,1.0,1,0.2798807734309795,35
2034,2,6443,1501,4942,0,0,0,1.0,1,1.0,1,1.0,1,0.3080409009926859,35
2035,3,6446,1503,4943,0,0,0,1.0,1,1.0,1,1.0,1,0.30518680461917524,36
2036,3,6449,1503,4946,0,0,0,1.0,1,1.0,1,1.0,1,0.2573839716597204,35
2037,2,6451,1504,4947,0,0,0,1.0,1,1.0,1,1.0,1,0.29315777783543956,36
2038,3,6454,1505,4949,0,0,0,1.0,1,1.0,1,1.0,1,0.2770255223257858,38
2039,2,6456,1506,4950,0,0,0,1.0,1,1.0,1,1.0,1,0.3218047632009563,38
2040,1,6457,1506,4951,0,0,0,1.0,1,1.0,1,1.0,1,0.2599825856593675,37
2041,7,6464,1507,4957,0,0,0,1.0,1,1.0,1,1.0,1,0.21615000994204225,38
2042,1,6465,1507,4958,0,0,0,1.0,1,1.0,1,1.0,1,0.18940045758397545,38
2043,0,6465,1507,4958,0,0,0,1.0,1,1.0,1,1.0,1,0.18940045758397545,38
2044,0,6465,1507,4958,0,0,0,1.0,1,1.0,1,1.0,1,0.17792957957266103,39
2045,2,6467,1507,4960,0,0,0,1.0,1,1.0,1,1.0,1,0.1612982077359335,40
2046,3,6470,1507,4963,0,0,0,1.0,1,1.0,1,1.0,1,0.14736794570676492,41
2047,3,6473,1507,4966,0,0,0,1.0,1,1.0,1,1.0,1,0.1265039104969694,41
2048,3,6476,1507,4969,0,0,0,1.0,1,1.0,1,1.0,1,0.1621843448876479,43
2049,2,6478,1508,4970,0,0,0,1.0,1,1.0,1,1.0,1,0.15473475187833796,43
2050,3,6481,1508,4973,0,0,0,1.0,1,1.0,1,1.0,1,0.14172193918144596,43
2051,1,6482,1508,4974,0,0,0,1.0,1,1.0,1,1.0,1,0.17966194594842164,43
2052,1,6483,1508,4975,0,0,0,1.0,1,1.0,1,1.0,1,0.1852120708861491,44
2053,0,6483,1508,4975,0,0,0,1.0,1,1.0,1,1.0,1,0.1984406439328646,43
2054,4,6487,1509,4978,0,0,0,1.0,1,1.0,1,1.0,1,0.21791792320848688,44
2055,6,6493,1509,4984,0,0,0,1.0,1,1.0,1,1.0,1,0.21148645866433538,43
2056,9,6502,1511,4991,0,0,0,1.0,1,1.0,1,1.0,1,0.15649793040287668,44
2057,4,6506,1512,4994,0,0,0,1.0,1,1.0,1,1.0,1,0.11651017436029465,44
2058,3,6509,1513,4996,0,0,0,1.0,1,1.0,1,1.0,1,0.11663559757565985,44
2059,2,6511,1513,4998,0,0,0,1.0,1,1.0,1,1.0,1,0.09917993108608245,45
2060,2,6513,1513,5000,0,0,0,1.0,1,1.0,1,1.0,1,0.12473084956725251,46
2061,9,6522,1515,5007,0,0,0,1.0,1,1.0,1,1.0,1,0.1727323483199279,48
2062,7,6529,1517,5012,0,0,0,1.0,1,1.0,1,1.0,1,0.14299483980035615,48
2063,2,6531,1517,5014,0,0,0,1.0,1,1.0,1,1.0,1,0.12503628783205248,45
2064,3,6534,1519,5015,0,0,0,1.0,1,1.0,1,1.0,1,0.16127153113661907,44
2065,2,6536,1520,5016,0,0,0,1.0,1,1.0,1,1.0,1,0.14209326097911884,42
2066,6,6542,1526,5016,0,0,0,1.0,1,1.0,1,1.0,1,0.31801637940892585,42
2067,11,6553,1527,5026,0,0,0,1.0,1,1.0,1,1.0,1,0.18611060582233113,38
2068,3,6556,1527,5029,0,0,0,1.0,1,1.0,1,1.0,1,0.19315977890800967,37
2069,1,6557,1527,5030,0,0,0,1.0,1,1.0,1,1.0,1,0.22691594702057186,35
2070,1,6558,1528,5030,0,0,0,1.0,1,1.0,1,1.0,1,0.2124062279013679,35
2071,4,6562,1529,5033,0,0,0,1.0,1,1.0,1,1.0,1,0.18567698454618792,34
2072,4,6566,1529,5037,0,0,0,1.0,1,1.0,1,1.0,1,0.15634360287063193,35
2073,3,6569,1529,5040,0,0,0,1.0,1,1.0,1,1.0,1,0.14892560338222738,37
2074,3,6572,1529,5043,0,0,0,1.0,1,1.0,1,1.0,1,0.08231455400562791,36
2075,3,6575,1529,5046,0,0,0,1.0,1,1.0,1,1.0,1,0.08987467291988961,38
2076,3,6578,1529,5049,0,0,0,1.0,1,1.0,1,1.0,1,0.047733441191792556,37
2077,2,6580,1529,5051,0,0,0,1.0,1,1.0,1,1.0,1,0.0499270184803194,37
2078,4,6584,1530,5054,0,0,0,1.0,1,1.0,1,1.0,1,0.08042031813885601,37
2079,5,6589,1532,5057,0,0,0,1.0,1,1.0,1,1.0,1,0.15584381486165905,37
2080,2,6591,1533,5058,0,0,0,1.0,1,1.0,1,1.0,1,0.15349082220540847,36
2081,5,6596,1535,5061,0,0,0,1.0,1,1.0,1,1.0,1,0.21015307494230406,37
2082,5,6601,1538,5063,0,0,0,1.0,1,1.0,1,1.0,1,0.26416334030965416,38
2083,5,6606,1539,5067,0,0,0,1.0,1,1.0,1,1.0,1,0.27989998016940615,39
2084,7,6613,1539,5074,0,0,0,1.0,1,1.0,1,1.0,1,0.29377949128996644,41
2085,8,6621,1540,5081,0,0,0,1.0,1,1.0,1,1.0,1,0.2806620540513098,41
2086,9,6630,1540,5090,0,0,0,1.0,1,1.0,1,1.0,1,0.1213422811066125,44
2087,0,6630,1540,5090,0,0,0,1.0,1,1.0,1,1.0,1,0.1213422811066125,44
2088,0,6630,1540,5090,0,0,0,1.0,1,1.0,1,1.0,1,0.10303462504123943,45
2089,1,6631,1540,5091,0,0,0,1.0,1,1.0,1,1.0,1,0.08969668026396162,46
2090,2,6633,1540,5093,0,0,0,1.0,1,1.0,1,1.0,1,0.11108924438759567,47
2091,6,6639,1540,5099,0,0,0,1.0,1,1.0,1,1.0,1,0.10718452889839976,48
2092,2,6641,1540,5101,0,0,0,1.0,1,1.0,1,1.0,1,0.0749516715809186,48
2093,2,6643,1540,5103,0,0,0,1.0,1,1.0,1,1.0,1,0.0749516715809186,48
2094,0,6643,1540,5103,0,0,0,1.0,1,1.0,1,1.0,1,0.0715965654712997,47
2095,1,6644,1540,5104,0,0,0,1.0,1,1.0,1,1.0,1,0.08145074224861233,49
2096,1,6645,1541,5104,0,0,0,1.0,1,1.0,1,1.0,1,0.08169157382321615,50
2097,0,6645,1541,5104,0,0,0,1.0,1,1.0,1,1.0,1,0.08169157382321615,50
2098,1,6646,1541,5105,0,0,0,1.0,1,1.0,1,1.0,1,0.07590877826024237,51
2099,0,6646,1541,5105,0,0,0,1.0,1,1.0,1,1.0,1,0.07837740314723511,50
2100,3,6649,1544,5105,0,0,0,1.0,1,1.0,1,1.0,1,0.10015429736976356,49
2101,2,6651,1545,5106,0,0,0,1.0,1,1.0,1,1.0,1,0.08703907371642568,48
2102,5,6656,1548,5108,0,0,0,1.0,1,1.0,1,1.0,1,0.14263673569682664,49
2103,2,6658,1549,5109,0,0,0,1.0,1,1.0,1,1.0,1,0.14283320441606642,44
2104,4,6662,1552,5110,0,0,0,1.0,1,1.0,1,1.0,1,0.2433258743869068,42
2105,3,6665,1554,5111,0,0,0,1.0,1,1.0,1,1.0,1,0.2518792612512739,40
2106,1,6666,1555,5111,0,0,0,1.0,1,1.0,1,1.0,1,0.29987675899339417,39
2107,3,6669,1557,5112,0,0,0,1.0,1,1.0,1,1.0,1,0.33206545822458555,37
2108,3,6672,1558,5114,0,0,0,1.0,1,1.0,1,1.0,1,0.289317902960167,37
2109,1,6673,1559,5114,0,0,0,1.0,1,1.0,1,1.0,1,0.30686755557503487,36
2110,1,6674,1559,5115,0,0,0,1.0,1,1.0,1,1.0,1,0.3236275869996679,35
2111,3,6677,1560,5117,0,0,0,1.0,1,1.0,1,1.0,1,0.28070346043049155,35
2112,0,6677,1560,5117,0,0,0,1.0,1,1.0,1,1.0,1,0.28070346043049155,35
2113,4,6681,1561,5120,0,0,0,1.0,1,1.0,1,1.0,1,0.24502414835209227,35
2114,2,6683,1562,5121,0,0,0,1.0,1,1.0,1,1.0,1,0.24920189594919867,36
2115,3,6686,1563,5123,0,0,0,1.0,1,1.0,1,1.0,1,0.25802286228365084,37
2116,8,6694,1563,5131,0,0,0,1.0,1,1.0,1,1.0,1,0.10048810074621917,39
2117,0,6694,1563,5131,0,0,0,1.0,1,1.0,1,1.0,1,0.08236124642484859,39
2118,3,6697,1564,5133,0,0,0,1.0,1,1.0,1,1.0,1,0.1105705039703505,41
2119,1,6698,1564,5134,0,0,0,1.0,1,1.0,1,1.0,1,0.08522779804095702,42
2120,1,6699,1564,5135,0,0,0,1.0,1,1.0,1,1.0,1,0.1029492519162299,42
2121,1,6700,1564,5136,0,0,0,1.0,1,1.0,1,1.0,1,0.06336986852341224,42
2122,2,6702,1565,5137,0,0,0,1.0,1,1.0,1,1.0,1,0.07119933436880312,43
2123,1,6703,1565,5138,0,0,0,1.0,1,1.0,1,1.0,1,0.1195814550153015,42
2124,1,6704,1566,5138,0,0,0,1.0,1,1.0,1,1.0,1,0.10438494386847616,42
2125,0,6704,1566,5138,0,0,0,1.0,1,1.0,1,1.0,1,0.118323094919653,41
2126,0,6704,1566,5138,0,0,0,1.0,1,1.0,1,1.0,1,0.118323094919653,41
2127,0,6704,1566,5138,0,0,0,1.0,1,1.0,1,1.0,1,0.118323094919653,41
2128,0,6704,1566,5138,0,0,0,1.0,1,1.0,1,1.0,1,0.1173735342678636,42
2129,0,6704,1566,5138,0,0,0,1.0,1,1.0,1,1.0,1,0.1371471976029395,43
2130,1,6705,1566,5139,0,0,0,1.0,1,1.0,1,1.0,1,0.15834364670587311,45
2131,5,6710,1567,5143,0,0,0,1.0,1,1.0,1,1.0,1,0.14299298720096346,44
2132,1,6711,1567,5144,0,0,0,1.0,1,1.0,1,1.0,1,0.13754672891299224,44
2133,5,6716,1568,5148,0,0,0,1.0,1,1.0,1,1.0,1,0.13301623579127303,45
2134,2,6718,1568,5150,0,0,0,1.0,1,1.0,1,1.0,1,0.14252617509948703,45
2135,5,6723,1569,5154,0,0,0,1.0,1,1.0,1,1.0,1,0.1315031375188211,46
2136,6,6729,1570,5159,0,0,0,1.0,1,1.0,1,1.0,1,0.18556191622172374,47
2137,2,6731,1570,5161,0,0,0,1.0,1,1.0,1,1.0,1,0.16101184661206475,47
2138,2,6733,1571,5162,0,0,0,1.0,1,1.0,1,1.0,1,0.17931757249792513,45
2139,2,6735,1572,5163,0,0,0,1.0,1,1.0,1,1.0,1,0.16030200323397148,45
2140,3,6738,1573,5165,0,0,0,1.0,1,1.0,1,1.0,1,0.16790915347785793,44
2141,3,6741,1573,5168,0,0,0,1.0,1,1.0,1,1.0,1,0.16266772381811476,45
2142,4,6745,1576,5169,0,0,0,1.0,1,1.0,1,1.0,1,0.20608348767356297,46
2143,1,6746,1576,5170,0,0,0,1.0,1,1.0,1,1.0,1,0.19892879299136904,46
2144,4,6750,1577,5173,0,0,0,1.0,1,1.0,1,1.0,1,0.1895716418586258,48
2145,6,6756,1582,5174,0,0,0,1.0,1,1.0,1,1.0,1,0.20868453548866386,46
2146,11,6767,1583,5184,0,0,0,1.0,1,1.0,1,1.0,1,0.11145485902145996,45
2147,7,6774,1585,5189,0,0,0,1.0,1,1.0,1,1.0,1,0.09561179963854341,44
2148,4,6778,1587,5191,0,0,0,1.0,1,1.0,1,1.0,1,0.14880547032077895,44
2149,4,6782,1590,5192,0,0,0,1.0,1,1.0,1,1.0,1,0.18348146737098933,42
2150,0,6782,1590,5192,0,0,0,1.0,1,1.0,1,1.0,1,0.18310086804271952,40
2151,1,6783,1591,5192,0,0,0,1.0,1,1.0,1,1.0,1,0.22481491117595892,39
2152,3,6786,1592,5194,0,0,0,1.0,1,1.0,1,1.0,1,0.27165803150426454,40
2153,3,6789,1593,5196,0,0,0,1.0,1,1.0,1,1.0,1,0.2419745717879,42
2154,4,6793,1594,5199,0,0,0,1.0,1,1.0,1,1.0,1,0.2630200230898188,42
2155,4,6797,1595,5202,0,0,0,1.0,1,1.0,1,1.0,1,0.2582957179498056,41
2156,1,6798,1595,5203,0,0,0,1.0,1,1.0,1,1.0,1,0.2797892259927733,40
2157,2,6800,1596,5204,0,0,0,1.0,1,1.0,1,1.0,1,0.2733057683486593,40
2158,1,6801,1597,5204,0,0,0,1.0,1,1.0,1,1.0,1,0.2944387628899945,38
2159,2,6803,1597,5206,0,0,0,1.0,1,1.0,1,1.0,1,0.2811269473404524,38
2160,2,6805,1598,5207,0,0,0,1.0,1,1.0,1,1.0,1,0.30328450198707524,38
2161,5,6810,1599,5211,0,0,0,1.0,1,1.0,1,1.0,1,0.20065917603756092,38
2162,7,6817,1602,5215,0,0,0,1.0,1,1.0,1,1.0,1,0.15372659663951607,38
2163,2,6819,1603,5216,0,0,0,1.0,1,1.0,1,1.0,1,0.16195129158888194,40
2164,2,6821,1604,5217,0,0,0,1.0,1,1.0,1,1.0,1,0.1498661060237704,41
2165,3,6824,1604,5220,0,0,0,1.0,1,1.0,1,1.0,1,0.18112099028801265,42
2166,3,6827,1604,5223,0,0,0,1.0,1,1.0,1,1.0,1,0.16282076417847438,42
2167,2,6829,1604,5225,0,0,0,1.0,1,1.0,1,1.0,1,0.1433373502342876,43
2168,1,6830,1604,5226,0,0,0,1.0,1,1.0,1,1.0,1,0.13049073870200287,43
2169,2,6832,1604,5228,0,0,0,1.0,1,1.0,1,1.0,1,0.15954482109318333,45
2170,3,6835,1604,5231,0,0,0,1.0,1,1.0,1,1.0,1,0.14491410936952115,46
2171,3,6838,1604,5234,0,0,0,1.0,1,1.0,1,1.0,1,0.1625819627446517,48
2172,13,6851,1604,5247,0,0,0,1.0,1,1.0,1,1.0,1,0.2039493626286224,49
2173,6,6857,1604,5253,0,0,0,1.0,1,1.0,1,1.0,1,0.15134451554067846,49
2174,7,6864,1606,5258,0,0,0,1.0,1,1.0,1,1.0,1,0.16435816167694278,49
2175,6,6870,1606,5264,0,0,0,1.0,1,1.0,1,1.0,1,0.1517735875748136,49
2176,10,6880,1606,5274,0,0,0,1.0,1,1.0,1,1.0,1,0.11223959531836776,51
2177,6,6886,1607,5279,0,0,0,1.0,1,1.0,1,1.0,1,0.11037904581927656,51
2178,6,6892,1608,5284,0,0,0,1.0,1,1.0,1,1.0,1,0.13752069705296666,50
2179,2,6894,1608,5286,0,0,0,1.0,1,1.0,1,1.0,1,0.12066035287692933,49
2180,4,6898,1608,5290,0,0,0,1.0,1,1.0,1,1.0,1,0.14009396846054822,47
2181,6,6904,1609,5295,0,0,0,1.0,1,1.0,1,1.0,1,0.14556424424229497,47
2182,3,6907,1609,5298,0,0,0,1.0,1,1.0,1,1.0,1,0.18293567460114848,45
2183,5,6912,1612,5300,0,0,0,1.0,1,1.0,1,1.0,1,0.22301367887174178,44
2184,5,6917,1615,5302,0,0,0,1.0,1,1.0,1,1.0,1,0.2616112739287901,43
2185,5,6922,1617,5305,0,0,0,1.0,1,1.0,1,1.0,1,0.2224125205711466,40
2186,6,6928,1621,5307,0,0,0,1.0,1,1.0,1,1.0,1,0.21152550392882735,38
2187,3,6931,1623,5308,0,0,0,1.0,1,1.0,1,1.0,1,0.26589879145817535,35
2188,3,6934,1626,5308,0,0,0,1.0,1,1.0,1,1.0,1,0.30224410913761784,34
2189,1,6935,1627,5308,0,0,0,1.0,1,1.0,1,1.0,1,0.31615731769816335,31
2190,5,6940,1630,5310,0,0,0,1.0,1,1.0,1,1.0,1,0.31930394925923217,29
2191,4,6944,1631,5313,0,0,0,1.0,1,1.0,1,1.0,1,0.23695887530599008,28
2192,1,6945,1632,5313,0,0,0,1.0,1,1.0,1,1.0,1,0.24266675934303322,29
2193,3,6948,1632,5316,0,0,0,1.0,1,1.0,1,1.0,1,0.2211150378383915,28
2194,0,6948,1632,5316,0,0,0,1.0,1,1.0,1,1.0,1,0.2096090792606393,27
2195,6,6954,1635,5319,0,0,0,1.0,1,1.0,1,1.0,1,0.21903224461701018,27
2196,0,6954,1635,5319,0,0,0,1.0,1,1.0,1,1.0,1,0.25509295358778117,27
2197,1,6955,1635,5320,0,0,0,1.0,1,1.0,1,1.0,1,0.251290137507453,27
2198,1,6956,1635,5321,0,0,0,1.0,1,1.0,1,1.0,1,0.25784920706580067,28
2199,2,6958,1635,5323,0,0,0,1.0,1,1.0,1,1.0,1,0.24493567203531885,29
2200,3,6961,1635,5326,0,0,0,1.0,1,1.0,1,1.0,1,0.254548736565621,31
2201,1,6962,1635,5327,0,0,0,1.0,1,1.0,1,1.0,1,0.2529648784965571,32
2202,0,6962,1635,5327,0,0,0,1.0,1,1.0,1,1.0,1,0.27958828842355965,31
2203,1,6963,1635,5328,0,0,0,1.0,1,1.0,1,1.0,1,0.24392957491931952,32
2204,3,6966,1636,5330,0,0,0,1.0,1,1.0,1,1.0,1,0.25743836773603074,32
2205,2,6968,1637,5331,0,0,0,1.0,1,1.0,1,1.0,1,0.24019313673745962,33
2206,5,6973,1637,5336,0,0,0,1.0,1,1.0,1,1.0,1,0.14304975511300144,32
2207,1,6974,1637,5337,0,0,0,1.0,1,1.0,1,1.0,1,0.1371275510592851,33
2208,6,6980,1638,5342,0,0,0,1.0,1,1.0,1,1.0,1,0.21910085735855803,35
2209,10,6990,1640,5350,0,0,0,1.0,1,1.0,1,1.0,1,0.23821134669060623,36
2210,2,6992,1640,5352,0,0,0,1.0,1,1.0,1,1.0,1,0.25508145250920244,35
2211,5,6997,1641,5356,0,0,0,1.0,1,1.0,1,1.0,1,0.3022460714955975,36
2212,7,7004,1641,5363,0,0,0,1.0,1,1.0,1,1.0,1,0.2491278136104176,37
2213,7,7011,1642,5369,0,0,0,1.0,1,1.0,1,1.0,1,0.22947172120880263,37
2214,4,7015,1642,5373,0,0,0,1.0,1,1.0,1,1.0,1,0.22256219896147422,39
2215,8,7023,1643,5380,0,0,0,1.0,1,1.0,1,1.0,1,0.25274198211818105,36
2216,4,7027,1645,5382,0,0,0,1.0,1,1.0,1,1.0,1,0.3057874325828567,37
2217,3,7030,1646,5384,0,0,0,1.0,1,1.0,1,1.0,1,0.2359321122187465,35
2218,2,7032,1647,5385,0,0,0,1.0,1,1.0,1,1.0,1,0.27529902700112435,35
2219,2,7034,1647,5387,0,0,0,1.0,1,1.0,1,1.0,1,0.27489502132477894,33
2220,2,7036,1648,5388,0,0,0,1.0,1,1.0,1,1.0,1,0.30467416114639373,31
2221,6,7042,1649,5393,0,0,0,1.0,1,1.0,1,1.0,1,0.2154949681013699,31
2222,0,7042,1649,5393,0,0,0,1.0,1,1.0,1,1.0,1,0.2439770009310045,30
2223,1,7043,1650,5393,0,0,0,1.0,1,1.0,1,1.0,1,0.22828833791276695,28
2224,4,7047,1653,5394,0,0,0,1.0,1,1.0,1,1.0,1,0.1914253492898692,29
2225,1,7048,1654,5394,0,0,0,1.0,1,1.0,1,1.0,1,0.21097007032482937,28
2226,3,7051,1655,5396,0,0,0,1.0,1,1.0,1,1.0,1,0.23502838493872677,30
2227,2,7053,1655,5398,0,0,0,1.0,1,1.0,1,1.0,1,0.18336897963581422,28
2228,1,7054,1656,5398,0,0,0,1.0,1,1.0,1,1.0,1,0.19271887286819633,29
2229,3,7057,1657,5400,0,0,0,1.0,1,1.0,1,1.0,1,0.21127221406055693,28
2230,0,7057,1657,5400,0,0,0,1.0,1,1.0,1,1.0,1,0.2105765739524081,28
2231,0,7057,1657,5400,0,0,0,1.0,1,1.0,1,1.0,1,0.20545072186897043,27
2232,0,7057,1657,5400,0,0,0,1.0,1,1.0,1,1.0,1,0.23980607906772633,27
2233,1,7058,1658,5400,0,0,0,1.0,1,1.0,1,1.0,1,0.27617955663394106,28
2234,4,7062,1660,5402,0,0,0,1.0,1,1.0,1,1.0,1,0.2600851820510935,26
2235,1,7063,1661,5402,0,0,0,1.0,1,1.0,1,1.0,1,0.19551658656641197,26
2236,3,7066,1663,5403,0,0,0,1.0,1,1.0,1,1.0,1,0.2606679720938238,26
2237,3,7069,1665,5404,0,0,0,1.0,1,1.0,1,1.0,1,0.3392933191554923,26
2238,3,7072,1667,5405,0,0,0,1.0,1,1.0,1,1.0,1,0.3294102806928645,27
2239,2,7074,1667,5407,0,0,0,1.0,1,1.0,1,1.0,1,0.302982612293315,28
2240,4,7078,1669,5409,0,0,0,1.0,1,1.0,1,1.0,1,0.3126631620787346,30
2241,4,7082,1671,5411,0,0,0,1.0,1,1.0,1,1.0,1,0.30580037469690874,29
2242,3,7085,1672,5413,0,0,0,1.0,1,1.0,1,1.0,1,0.30053045189988514,29
2243,4,7089,1673,5416,0,0,0,1.0,1,1.0,1,1.0,1,0.34228404067703966,29
2244,1,7090,1673,5417,0,0,0,1.0,1,1.0,1,1.0,1,0.2798626464311072,29
2245,2,7092,1673,5419,0,0,0,1.0,1,1.0,1,1.0,1,0.29333231567657003,30
2246,4,7096,1673,5423,0,0,0,1.0,1,1.0,1,1.0,1,0.2731729606258048,33
2247,2,7098,1673,5425,0,0,0,1.0,1,1.0,1,1.0,1,0.2218316312806714,34
2248,3,7101,1673,5428,0,0,0,1.0,1,1.0,1,1.0,1,0.23504171009646568,34
2249,2,7103,1673,5430,0,0,0,1.0,1,1.0,1,1.0,1,0.24454623263368783,35
2250,5,7108,1674,5434,0,0,0,1.0,1,1.0,1,1.0,1,0.25181550390376517,35
2251,4,7112,1674,5438,0,0,0,1.0,1,1.0,1,1.0,1,0.12772532855629917,36
2252,1,7113,1675,5438,0,0,0,1.0,1,1.0,1,1.0,1,0.15657636756967758,37
2253,3,7116,1676,5440,0,0,0,1.0,1,1.0,1,1.0,1,0.19724055704596732,35
2254,0,7116,1676,5440,0,0,0,1.0,1,1.0,1,1.0,1,0.2496642544637258,33
2255,0,7116,1676,5440,0,0,0,1.0,1,1.0,1,1.0,1,0.24716888210831356,35
2256,4,7120,1678,5442,0,0,0,1.0,1,1.0,1,1.0,1,0.21688240518495802,34
2257,2,7122,1680,5442,0,0,0,1.0,1,1.0,1,1.0,1,0.21207208886705756,36
2258,0,7122,1680,5442,0,0,0,1.0,1,1.0,1,1.0,1,0.20480756784293452,35
2259,2,7124,1681,5443,0,0,0,1.0,1,1.0,1,1.0,1,0.21488248859885065,35
2260,1,7125,1681,5444,0,0,0,1.0,1,1.0,1,1.0,1,0.23691841645691655,33
2261,0,7125,1681,5444,0,0,0,1.0,1,1.0,1,1.0,1,0.23691841645691655,33
2262,2,7127,1683,5444,0,0,0,1.0,1,1.0,1,1.0,1,0.3501067631993543,32
2263,6,7133,1685,5448,0,0,0,1.0,1,1.0,1,1.0,1,0.26430492586532306,31
2264,2,7135,1686,5449,0,0,0,1.0,1,1.0,1,1.0,1,0.32148740863721326,30
2265,0,7135,1686,5449,0,0,0,1.0,1,1.0,1,1.0,1,0.2989718087279107,29
2266,8,7143,1688,5455,0,0,0,1.0,1,1.0,1,1.0,1,0.24643499107474334,30
2267,2,7145,1689,5456,0,0,0,1.0,1,1.0,1,1.0,1,0.1924603072925912,29
2268,6,7151,1691,5460,0,0,0,1.0,1,1.0,1,1.0,1,0.1668294840078142,30
2269,4,7155,1693,5462,0,0,0,1.0,1,1.0,1,1.0,1,0.15503725532566995,31
2270,4,7159,1693,5466,0,0,0,1.0,1,1.0,1,1.0,1,0.14081046805062686,31
2271,4,7163,1694,5469,0,0,0,1.0,1,1.0,1,1.0,1,0.14346715121727857,31
2272,3,7166,1696,5470,0,0,0,1.0,1,1.0,1,1.0,1,0.20089712406006416,31
2273,2,7168,1696,5472,0,0,0,1.0,1,1.0,1,1.0,1,0.2091679710580476,30
2274,1,7169,1696,5473,0,0,0,1.0,1,1.0,1,1.0,1,0.20137206386951464,31
2275,0,7169,1696,5473,0,0,0,1.0,1,1.0,1,1.0,1,0.21389478195789002,32
2276,2,7171,1698,5473,0,0,0,1.0,1,1.0,1,1.0,1,0.23848029945818708,31
2277,2,7173,1699,5474,0,0,0,1.0,1,1.0,1,1.0,1,0.2514459012862021,31
2278,4,7177,1700,5477,0,0,0,1.0,1,1.0,1,1.0,1,0.27315079743983617,32
2279,0,7177,1700,5477,0,0,0,1.0,1,1.0,1,1.0,1,0.28660113828703887,32
2280,4,7181,1701,5480,0,0,0,1.0,1,1.0,1,1.0,1,0.2862259744699268,33
2281,8,7189,1701,5488,0,0,0,1.0,1,1.0,1,1.0,1,0.17892423606371094,34
2282,1,7190,1701,5489,0,0,0,1.0,1,1.0,1,1.0,1,0.1950217391354674,34
2283,2,7192,1701,5491,0,0,0,1.0,1,1.0,1,1.0,1,0.1950217391354674,34
2284,3,7195,1701,5494,0,0,0,1.0,1,1.0,1,1.0,1,0.16958538211528082,34
2285,3,7198,1701,5497,0,0,0,1.0,1,1.0,1,1.0,1,0.14445006488880513,35
2286,1,7199,1701,5498,0,0,0,1.0,1,1.0,1,1.0,1,0.14456778137012696,34
2287,3,7202,1701,5501,0,0,0,1.0,1,1.0,1,1.0,1,0.11309079662413424,35
2288,3,7205,1701,5504,0,0,0,1.0,1,1.0,1,1.0,1,0.21057820879880276,35
2289,4,7209,1702,5507,0,0,0,1.0,1,1.0,1,1.0,1,0.21134887997971252,37
2290,5,7214,1702,5512,0,0,0,1.0,1,1.0,1,1.0,1,0.2193448538716987,37
2291,3,7217,1702,5515,0,0,0,1.0,1,1.0,1,1.0,1,0.22553007457671356,35
2292,3,7220,1703,5517,0,0,0,1.0,1,1.0,1,1.0,1,0.25816446755562716,35
2293,4,7224,1704,5520,0,0,0,1.0,1,1.0,1,1.0,1,0.2302769540716726,34
2294,3,7227,1704,5523,0,0,0,1.0,1,1.0,1,1.0,1,0.2757495608608188,33
2295,4,7231,1704,5527,0,0,0,1.0,1,1.0,1,1.0,1,0.27276443761074964,34
2296,6,7237,1704,5533,0,0,0,1.0,1,1.0,1,1.0,1,0.11992299059742792,33
2297,0,7237,1704,5533,0,0,0,1.0,1,1.0,1,1.0,1,0.12118518083096722,32
2298,2,7239,1705,5534,0,0,0,1.0,1,1.0,1,1.0,1,0.14402484869299897,32
2299,3,7242,1706,5536,0,0,0,1.0,1,1.0,1,1.0,1,0.17204177921022726,33
2300,0,7242,1706,5536,0,0,0,1.0,1,1.0,1,1.0,1,0.17204177921022726,33
2301,0,7242,1706,5536,0,0,0,1.0,1,1.0,1,1.0,1,0.17204177921022726,33
2302,3,7245,1707,5538,0,0,0,1.0,1,1.0,1,1.0,1,0.15026201026390135,34
2303,6,7251,1709,5542,0,0,0,1.0,1,1.0,1,1.0,1,0.18714821355221825,34
2304,4,7255,1711,5544,0,0,0,1.0,1,1.0,1,1.0,1,0.13858289234738455,33
2305,6,7261,1713,5548,0,0,0,1.0,1,1.0,1,1.0,1,0.18378926784172328,33
2306,7,7268,1715,5553,0,0,0,1.0,1,1.0,1,1.0,1,0.24909963220284947,33
2307,4,7272,1717,5555,0,0,0,1.0,1,1.0,1,1.0,1,0.21827510171853806,35
2308,4,7276,1718,5558,0,0,0,1.0,1,1.0,1,1.0,1,0.23878834981230188,34
2309,4,7280,1718,5562,0,0,0,1.0,1,1.0,1,1.0,1,0.26398634417473293,34
2310,5,7285,1718,5567,0,0,0,1.0,1,1.0,1,1.0,1,0.2265291249515931,34
2311,13,7298,1719,5579,0,0,0,1.0,1,1.0,1,1.0,1,0.12139900321113226,35
2312,9,7307,1720,5587,0,0,0,1.0,1,1.0,1,1.0,1,0.16830303169599078,34
2313,9,7316,1720,5596,0,0,0,1.0,1,1.0,1,1.0,1,0.28173492485572615,35
2314,8,7324,1720,5604,0,0,0,1.0,1,1.0,1,1.0,1,0.2553802764235613,35
2315,6,7330,1720,5610,0,0,0,1.0,1,1.0,1,1.0,1,0.2654046872795378,34
2316,8,7338,1722,5616,0,0,0,1.0,1,1.0,1,1.0,1,0.19718458206218506,35
2317,3,7341,1722,5619,0,0,0,1.0,1,1.0,1,1.0,1,0.2445573935547149,32
2318,3,7344,1722,5622,0,0,0,1.0,1,1.0,1,1.0,1,0.2365604038951191,32
2319,7,7351,1722,5629,0,0,0,1.0,1,1.0,1,1.0,1,0.21677435358393876,32
2320,4,7355,1722,5633,0,0,0,1.0,1,1.0,1,1.0,1,0.2689545234612509,32
2321,5,7360,1722,5638,0,0,0,1.0,1,1.0,1,1.0,1,0.27501991442284096,33
2322,5,7365,1722,5643,0,0,0,1.0,1,1.0,1,1.0,1,0.28068589549091216,33
2323,4,7369,1722,5647,0,0,0,1.0,1,1.0,1,1.0,1,0.2666390280772856,33
2324,7,7376,1723,5653,0,0,0,1.0,1,1.0,1,1.0,1,0.26740886678788905,34
2325,8,7384,1723,5661,0,0,0,1.0,1,1.0,1,1.0,1,0.28232692633163026,35
2326,7,7391,1723,5668,0,0,0,1.0,1,1.0,1,1.0,1,0.0885831983035422,35
2327,2,7393,1723,5670,0,0,0,1.0,1,1.0,1,1.0,1,0.09827093923292013,36
2328,2,7395,1724,5671,0,0,0,1.0,1,1.0,1,1.0,1,0.1694766854541602,37
2329,2,7397,1724,5673,0,0,0,1.0,1,1.0,1,1.0,1,0.17267877094608142,37
2330,4,7401,1724,5677,0,0,0,1.0,1,1.0,1,1.0,1,0.1787255247118013,38
2331,2,7403,1724,5679,0,0,0,1.0,1,1.0,1,1.0,1,0.18740495451749586,40
2332,3,7406,1724,5682,0,0,0,1.0,1,1.0,1,1.0,1,0.19096778872765513,40
2333,5,7411,1724,5687,0,0,0,1.0,1,1.0,1,1.0,1,0.16075949408663984,41
2334,3,7414,1724,5690,0,0,0,1.0,1,1.0,1,1.0,1,0.14096943504969178,41
2335,3,7417,1724,5693,0,0,0,1.0,1,1.0,1,1.0,1,0.16075949408663984,41
2336,3,7420,1724,5696,0,0,0,1.0,1,1.0,1,1.0,1,0.14096943504969178,41
2337,6,7426,1724,5702,0,0,0,1.0,1,1.0,1,1.0,1,0.15740642176775457,42
2338,4,7430,1724,5706,0,0,0,1.0,1,1.0,1,1.0,1,0.16478174812375027,43
2339,2,7432,1724,5708,0,0,0,1.0,1,1.0,1,1.0,1,0.18462869675771115,43
2340,4,7436,1724,5712,0,0,0,1.0,1,1.0,1,1.0,1,0.19051734891195665,45
2341,4,7440,1724,5716,0,0,0,1.0,1,1.0,1,1.0,1,0.08881011281812957,45
2342,4,7444,1726,5718,0,0,0,1.0,1,1.0,1,1.0,1,0.13931111503216834,46
2343,7,7451,1727,5724,0,0,0,1.0,1,1.0,1,1.0,1,0.1382678959762003,45
2344,7,7458,1728,5730,0,0,0,1.0,1,1.0,1,1.0,1,0.13374426437579534,44
2345,6,7464,1728,5736,0,0,0,1.0,1,1.0,1,1.0,1,0.16526808267574497,44
2346,8,7472,1729,5743,0,0,0,1.0,1,1.0,1,1.0,1,0.17130976612534296,44
2347,7,7479,1730,5749,0,0,0,1.0,1,1.0,1,1.0,1,0.12316779000159697,44
2348,8,7487,1730,5757,0,0,0,1.0,1,1.0,1,1.0,1,0.12460996881734444,45
2349,11,7498,1730,5768,0,0,0,1.0,1,1.0,1,1.0,1,0.13593356125366185,46
2350,9,7507,1730,5777,0,0,0,1.0,1,1.0,1,1.0,1,0.18777247109606016,47
2351,7,7514,1730,5784,0,0,0,1.0,1,1.0,1,1.0,1,0.2249841113000633,47
2352,9,7523,1732,5791,0,0,0,1.0,1,1.0,1,1.0,1,0.21621505355862064,47
2353,8,7531,1732,5799,0,0,0,1.0,1,1.0,1,1.0,1,0.21922996872651115,46
2354,9,7540,1732,5808,0,0,0,1.0,1,1.0,1,1.0,1,0.21964778787822126,47
2355,13,7553,1733,5820,0,0,0,1.0,1,1.0,1,1.0,1,0.17104217633537716,47
2356,6,7559,1734,5825,0,0,0,1.0,1,1.0,1,1.0,1,0.08793395157215235,47
2357,1,7560,1735,5825,0,0,0,1.0,1,1.0,1,1.0,1,0.10936906983722265,47
2358,0,7560,1735,5825,0,0,0,1.0,1,1.0,1,1.0,1,0.10468163549874997,48
2359,0,7560,1735,5825,0,0,0,1.0,1,1.0,1,1.0,1,0.13140745280481306,49
2360,0,7560,1735,5825,0,0,0,1.0,1,1.0,1,1.0,1,0.13140745280481306,49
2361,0,7560,1735,5825,0,0,0,1.0,1,1.0,1,1.0,1,0.1212110846214179,50
2362,2,7562,1735,5827,0,0,0,1.0,1,1.0,1,1.0,1,0.07651088980921955,51
2363,1,7563,1736,5827,0,0,0,1.0,1,1.0,1,1.0,1,0.09055320677649606,51
2364,1,7564,1736,5828,0,0,0,1.0,1,1.0,1,1.0,1,0.06930269717161082,52
2365,1,7565,1736,5829,0,0,0,1.0,1,1.0,1,1.0,1,0.05895040524813243,53
2366,5,7570,1738,5832,0,0,0,1.0,1,1.0,1,1.0,1,0.08499938973176517,54
2367,7,7577,1742,5835,0,0,0,1.0,1,1.0,1,1.0,1,0.1439226992329746,52
2368,7,7584,1746,5838,0,0,0,1.0,1,1.0,1,1.0,1,0.19565960808038074,51
2369,7,7591,1747,5844,0,0,0,1.0,1,1.0,1,1.0,1,0.1962474221421862,51
2370,6,7597,1749,5848,0,0,0,1.0,1,1.0,1,1.0,1,0.16528985399660817,52
2371,8,7605,1751,5854,0,0,0,1.0,1,1.0,1,1.0,1,0.07257948398865358,52
2372,3,7608,1753,5855,0,0,0,1.0,1,1.0,1,1.0,1,0.09705712913504203,49
2373,4,7612,1754,5858,0,0,0,1.0,1,1.0,1,1.0,1,0.13682180635072091,47
2374,6,7618,1755,5863,0,0,0,1.0,1,1.0,1,1.0,1,0.13894347623574804,45
2375,2,7620,1755,5865,0,0,0,1.0,1,1.0,1,1.0,1,0.17285453186953123,45
2376,4,7624,1755,5869,0,0,0,1.0,1,1.0,1,1.0,1,0.1682168950022745,43
2377,2,7626,1755,5871,0,0,0,1.0,1,1.0,1,1.0,1,0.19013965562429172,44
2378,3,7629,1756,5873,0,0,0,1.0,1,1.0,1,1.0,1,0.17281288891280697,43
2379,6,7635,1756,5879,0,0,0,1.0,1,1.0,1,1.0,1,0.17597297014661545,43
2380,3,7638,1757,5881,0,0,0,1.0,1,1.0,1,1.0,1,0.18507688151069762,43
2381,5,7643,1760,5883,0,0,0,1.0,1,1.0,1,1.0,1,0.14320043562722498,44
2382,5,7648,1760,5888,0,0,0,1.0,1,1.0,1,1.0,1,0.17328706818972517,44
2383,7,7655,1763,5892,0,0,0,1.0,1,1.0,1,1.0,1,0.19999512747630135,45
2384,6,7661,1766,5895,0,0,0,1.0,1,1.0,1,1.0,1,0.2991160833906868,45
2385,5,7666,1767,5899,0,0,0,1.0,1,1.0,1,1.0,1,0.26676392664457793,45
2386,11,7677,1771,5906,0,0,0,1.0,1,1.0,1,1.0,1,0.13922075789210853,46
2387,2,7679,1772,5907,0,0,0,1.0,1,1.0,1,1.0,1,0.13995524724535105,44
2388,1,7680,1772,5908,0,0,0,1.0,1,1.0,1,1.0,1,0.1337514829592945,44
2389,5,7685,1772,5913,0,0,0,1.0,1,1.0,1,1.0,1,0.09429289857824547,43
2390,3,7688,1775,5913,0,0,0,1.0,1,1.0,1,1.0,1,0.1092611696887317,44
2391,1,7689,1775,5914,0,0,0,1.0,1,1.0,1,1.0,1,0.10501906643779103,43
2392,3,7692,1777,5915,0,0,0,1.0,1,1.0,1,1.0,1,0.11117142423193473,44
2393,5,7697,1779,5918,0,0,0,1.0,1,1.0,1,1.0,1,0.12132200884779595,45
2394,5,7702,1780,5922,0,0,0,1.0,1,1.0,1,1.0,1,0.08269513587922879,44
2395,6,7708,1781,5927,0,0,0,1.0,1,1.0,1,1.0,1,0.1466074804827874,44
2396,6,7714,1782,5932,0,0,0,1.0,1,1.0,1,1.0,1,0.12137192371223095,45
2397,5,7719,1782,5937,0,0,0,1.0,1,1.0,1,1.0,1,0.16971071827450346,44
2398,4,7723,1783,5940,0,0,0,1.0,1,1.0,1,1.0,1,0.15345316570562517,44
2399,2,7725,1783,5942,0,0,0,1.0,1,1.0,1,1.0,1,0.18777765055981388,45
2400,8,7733,1786,5947,0,0,0,1.0,1,1.0,1,1.0,1,0.19609541850390114,45
2401,5,7738,1786,5952,0,0,0,1.0,1,1.0,1,1.0,1,0.1142674124201887,46
2402,3,7741,1786,5955,0,0,0,1.0,1,1.0,1,1.0,1,0.0940345190593524,47
2403,3,7744,1786,5958,0,0,0,1.0,1,1.0,1,1.0,1,0.08699493926710523,48
2404,2,7746,1786,5960,0,0,0,1.0,1,1.0,1,1.0,1,0.11078832884569399,47
2405,2,7748,1786,5962,0,0,0,1.0,1,1.0,1,1.0,1,0.11364296481801463,45
2406,1,7749,1786,5963,0,0,0,1.0,1,1.0,1,1.0,1,0.1309496802263353,45
2407,3,7752,1786,5966,0,0,0,1.0,1,1.0,1,1.0,1,0.15516715425275643,42
2408,1,7753,1786,5967,0,0,0,1.0,1,1.0,1,1.0,1,0.1448399230001302,41
2409,3,7756,1787,5969,0,0,0,1.0,1,1.0,1,1.0,1,0.13068312871220158,41
2410,1,7757,1787,5970,0,0,0,1.0,1,1.0,1,1.0,1,0.16282109497804872,40
2411,2,7759,1788,5971,0,0,0,1.0,1,1.0,1,1.0,1,0.1534111771429138,40
2412,2,7761,1789,5972,0,0,0,1.0,1,1.0,1,1.0,1,0.20304843565322092,38
2413,2,7763,1791,5972,0,0,0,1.0,1,1.0,1,1.0,1,0.2626041402731036,38
2414,3,7766,1792,5974,0,0,0,1.0,1,1.0,1,1.0,1,0.2834606098660036,36
2415,8,7774,1795,5979,0,0,0,1.0,1,1.0,1,1.0,1,0.36426056645012106,36
2416,10,7784,1796,5988,0,0,0,1.0,1,1.0,1,1.0,1,0.1816102077361695,35
2417,1,7785,1796,5989,0,0,0,1.0,1,1.0,1,1.0,1,0.22477310608786044,33
2418,0,7785,1796,5989,0,0,0,1.0,1,1.0,1,1.0,1,0.22477310608786044,33
2419,3,7788,1798,5990,0,0,0,1.0,1,1.0,1,1.0,1,0.2537889964994304,33
2420,6,7794,1798,5996,0,0,0,1.0,1,1.0,1,1.0,1,0.11086438886016599,34
2421,3,7797,1798,5999,0,0,0,1.0,1,1.0,1,1.0,1,0.11474905159206145,34
2422,3,7800,1798,6002,0,0,0,1.0,1,1.0,1,1.0,1,0.10843899456745763,35
2423,5,7805,1800,6005,0,0,0,1.0,1,1.0,1,1.0,1,0.16459087075418566,36
2424,6,7811,1802,6009,0,0,0,1.0,1,1.0,1,1.0,1,0.19972066769600025,35
2425,3,7814,1803,6011,0,0,0,1.0,1,1.0,1,1.0,1,0.15584430293212875,33
2426,1,7815,1804,6011,0,0,0,1.0,1,1.0,1,1.0,1,0.15964577009247868,34
2427,1,7816,1804,6012,0,0,0,1.0,1,1.0,1,1.0,1,0.1661538101494966,34
2428,2,7818,1806,6012,0,0,0,1.0,1,1.0,1,1.0,1,0.15152201782635136,34
2429,1,7819,1807,6012,0,0,0,1.0,1,1.0,1,1.0,1,0.17574621662069442,34
2430,0,7819,1807,6012,0,0,0,1.0,1,1.0,1,1.0,1,0.2020610893769456,33
2431,6,7825,1809,6016,0,0,0,1.0,1,1.0,1,1.0,1,0.1239404404485141,33
2432,0,7825,1809,6016,0,0,0,1.0,1,1.0,1,1.0,1,0.15112505539753449,33
2433,3,7828,1809,6019,0,0,0,1.0,1,1.0,1,1.0,1,0.1477142186742612,34
2434,0,7828,1809,6019,0,0,0,1.0,1,1.0,1,1.0,1,0.1477142186742612,34
2435,1,7829,1810,6019,0,0,0,1.0,1,1.0,1,1.0,1,0.17873936485134928,34
2436,0,7829,1810,6019,0,0,0,1.0,1,1.0,1,1.0,1,0.19579765590931913,33
2437,0,7829,1810,6019,0,0,0,1.0,1,1.0,1,1.0,1,0.19579765590931913,33
2438,5,7834,1812,6022,0,0,0,1.0,1,1.0,1,1.0,1,0.197562318017823,34
2439,3,7837,1812,6025,0,0,0,1.0,1,1.0,1,1.0,1,0.15999933346484108,35
2440,0,7837,1812,6025,0,0,0,1.0,1,1.0,1,1.0,1,0.15999933346484108,35
2441,3,7840,1814,6026,0,0,0,1.0,1,1.0,1,1.0,1,0.17015382270467977,35
2442,5,7845,1814,6031,0,0,0,1.0,1,1.0,1,1.0,1,0.14299286354899307,35
2443,5,7850,1815,6035,0,0,0,1.0,1,1.0,1,1.0,1,0.19050508764199095,35
2444,9,7859,1817,6042,0,0,0,1.0,1,1.0,1,1.0,1,0.2641187026161296,34
2445,5,7864,1818,6046,0,0,0,1.0,1,1.0,1,1.0,1,0.2225141729792655,33
2446,4,7868,1819,6049,0,0,0,1.0,1,1.0,1,1.0,1,0.2070105663170144,30
2447,4,7872,1820,6052,0,0,0,1.0,1,1.0,1,1.0,1,0.12161015458912379,29
2448,2,7874,1820,6054,0,0,0,1.0,1,1.0,1,1.0,1,0.18530574186738902,27
2449,0,7874,1820,6054,0,0,0,1.0,1,1.0,1,1.0,1,0.1732130560434794,26
2450,3,7877,1822,6055,0,0,0,1.0,1,1.0,1,1.0,1,0.25519099346251317,28
2451,1,7878,1822,6056,0,0,0,1.0,1,1.0,1,1.0,1,0.2383583386546975,28
2452,0,7878,1822,6056,0,0,0,1.0,1,1.0,1,1.0,1,0.1972245109961231,29
2453,1,7879,1823,6056,0,0,0,1.0,1,1.0,1,1.0,1,0.2167445294668286,30
2454,1,7880,1823,6057,0,0,0,1.0,1,1.0,1,1.0,1,0.24419846332954015,32
2455,2,7882,1823,6059,0,0,0,1.0,1,1.0,1,1.0,1,0.21371785820240638,33
2456,2,7884,1823,6061,0,0,0,1.0,1,1.0,1,1.0,1,0.23868234334927252,34
2457,2,7886,1824,6062,0,0,0,1.0,1,1.0,1,1.0,1,0.21836175989756465,34
2458,3,7889,1824,6065,0,0,0,1.0,1,1.0,1,1.0,1,0.20809704970688192,36
2459,4,7893,1824,6069,0,0,0,1.0,1,1.0,1,1.0,1,0.1992749681655495,36
2460,5,7898,1825,6073,0,0,0,1.0,1,1.0,1,1.0,1,0.21189204101676215,37
2461,2,7900,1825,6075,0,0,0,1.0,1,1.0,1,1.0,1,0.15997915065560206,37
2462,5,7905,1827,6078,0,0,0,1.0,1,1.0,1,1.0,1,0.15440947847766154,38
2463,2,7907,1828,6079,0,0,0,1.0,1,1.0,1,1.0,1,0.15723821694542678,38
2464,1,7908,1829,6079,0,0,0,1.0,1,1.0,1,1.0,1,0.14308879094327684,37
2465,1,7909,1830,6079,0,0,0,1.0,1,1.0,1,1.0,1,0.1278717049270458,36
2466,3,7912,1833,6079,0,0,0,1.0,1,1.0,1,1.0,1,0.1596573441667094,36
2467,2,7914,1834,6080,0,0,0,1.0,1,1.0,1,1.0,1,0.18575546914934757,34
2468,1,7915,1835,6080,0,0,0,1.0,1,1.0,1,1.0,1,0.2104916398071016,33
2469,1,7916,1836,6080,0,0,0,1.0,1,1.0,1,1.0,1,0.2292563972402145,32
2470,3,7919,1838,6081,0,0,0,1.0,1,1.0,1,1.0,1,0.27574639885479457,33
2471,0,7919,1838,6081,0,0,0,1.0,1,1.0,1,1.0,1,0.3136726446887884,31
2472,1,7920,1839,6081,0,0,0,1.0,1,1.0,1,1.0,1,0.31133763780659207,32
2473,0,7920,1839,6081,0,0,0,1.0,1,1.0,1,1.0,1,0.32081399306185565,31
2474,3,7923,1840,6083,0,0,0,1.0,1,1.0,1,1.0,1,0.3018959864343708,33
2475,4,7927,1842,6085,0,0,0,1.0,1,1.0,1,1.0,1,0.30728977448838707,33
2476,9,7936,1844,6092,0,0,0,1.0,1,1.0,1,1.0,1,0.1930965172803956,33
2477,1,7937,1844,6093,0,0,0,1.0,1,1.0,1,1.0,1,0.171778197928801,33
2478,1,7938,1845,6093,0,0,0,1.0,1,1.0,1,1.0,1,0.18722442787597235,33
2479,6,7944,1847,6097,0,0,0,1.0,1,1.0,1,1.0,1,0.20666081110260978,33
2480,5,7949,1849,6100,0,0,0,1.0,1,1.0,1,1.0,1,0.22596242678802447,34
2481,1,7950,1850,6100,0,0,0,1.0,1,1.0,1,1.0,1,0.25454143440360855,33
2482,0,7950,1850,6100,0,0,0,1.0,1,1.0,1,1.0,1,0.2462645737008194,34
2483,2,7952,1850,6102,0,0,0,1.0,1,1.0,1,1.0,1,0.271376713224806,33
2484,3,7955,1852,6103,0,0,0,1.0,1,1.0,1,1.0,1,0.3392389937612556,32
2485,5,7960,1853,6107,0,0,0,1.0,1,1.0,1,1.0,1,0.3568377986617313,31
2486,6,7966,1855,6111,0,0,0,1.0,1,1.0,1,1.0,1,0.375444631938622,29
2487,2,7968,1855,6113,0,0,0,1.0,1,1.0,1,1.0,1,0.35005635185620193,29
2488,5,7973,1856,6117,0,0,0,1.0,1,1.0,1,1.0,1,0.33791264873591814,30
2489,3,7976,1857,6119,0,0,0,1.0,1,1.0,1,1.0,1,0.3433860558448301,29
2490,2,7978,1858,6120,0,0,0,1.0,1,1.0,1,1.0,1,0.29792926388021296,30
2491,5,7983,1858,6125,0,0,0,1.0,1,1.0,1,1.0,1,0.20877773370554922,30
2492,0,7983,1858,6125,0,0,0,1.0,1,1.0,1,1.0,1,0.24300480439801242,29
2493,1,7984,1858,6126,0,0,0,1.0,1,1.0,1,1.0,1,0.2283587311234643,29
2494,0,7984,1858,6126,0,0,0,1.0,1,1.0,1,1.0,1,0.2653809482702248,28
2495,2,7986,1858,6128,0,0,0,1.0,1,1.0,1,1.0,1,0.2737145578982747,29
2496,0,7986,1858,6128,0,0,0,1.0,1,1.0,1,1.0,1,0.2635201604777407,28
2497,0,7986,1858,6128,0,0,0,1.0,1,1.0,1,1.0,1,0.2760211141119521,28
2498,0,7986,1858,6128,0,0,0,1.0,1,1.0,1,1.0,1,0.24170166906167684,29
2499,3,7989,1858,6131,0,0,0,1.0,1,1.0,1,1.0,1,0.24415745183427912,30
2500,1,7990,1858,6132,0,0,0,1.0,1,1.0,1,1.0,1,0.2441244999506631,29
2501,6,7996,1859,6137,0,0,0,1.0,1,1.0,1,1.0,1,0.27832678514970566,33
2502,7,8003,1862,6141,0,0,0,1.0,1,1.0,1,1.0,1,0.2833852246801901,33
2503,2,8005,1863,6142,0,0,0,1.0,1,1.0,1,1.0,1,0.26222649853019064,31
2504,5,8010,1867,6143,0,0,0,1.0,1,1.0,1,1.0,1,0.28041943399868635,31
2505,1,8011,1868,6143,0,0,0,1.0,1,1.0,1,1.0,1,0.28828137193007924,32
2506,9,8020,1870,6150,0,0,0,1.0,1,1.0,1,1.0,1,0.133926282834268,31
2507,2,8022,1871,6151,0,0,0,1.0,1,1.0,1,1.0,1,0.23610090434554093,29
2508,5,8027,1873,6154,0,0,0,1.0,1,1.0,1,1.0,1,0.12768310514997896,31
2509,1,8028,1873,6155,0,0,0,1.0,1,1.0,1,1.0,1,0.15085644176800472,30
2510,4,8032,1873,6159,0,0,0,1.0,1,1.0,1,1.0,1,0.21794032278022293,31
2511,4,8036,1873,6163,0,0,0,1.0,1,1.0,1,1.0,1,0.1832795289414705,32
2512,3,8039,1873,6166,0,0,0,1.0,1,1.0,1,1.0,1,0.16918662671936333,32
2513,5,8044,1874,6170,0,0,0,1.0,1,1.0,1,1.0,1,0.11965206589327317,34
2514,1,8045,1874,6171,0,0,0,1.0,1,1.0,1,1.0,1,0.10603774958529626,35
2515,3,8048,1876,6172,0,0,0,1.0,1,1.0,1,1.0,1,0.11261971128411814,35
2516,1,8049,1876,6173,0,0,0,1.0,1,1.0,1,1.0,1,0.09486705012426175,34
2517,3,8052,1878,6174,0,0,0,1.0,1,1.0,1,1.0,1,0.1469546419780263,34
2518,7,8059,1881,6178,0,0,0,1.0,1,1.0,1,1.0,1,0.15489573466505602,33
2519,1,8060,1881,6179,0,0,0,1.0,1,1.0,1,1.0,1,0.1473699284114103,32
2520,2,8062,1883,6179,0,0,0,1.0,1,1.0,1,1.0,1,0.19019209598692136,31
2521,1,8063,1883,6180,0,0,0,1.0,1,1.0,1,1.0,1,0.14577364431279707,31
2522,1,8064,1884,6180,0,0,0,1.0,1,1.0,1,1.0,1,0.21927251477623816,30
2523,2,8066,1885,6181,0,0,0,1.0,1,1.0,1,1.0,1,0.18247832699756167,30
2524,0,8066,1885,6181,0,0,0,1.0,1,1.0,1,1.0,1,0.26019571068398917,29
2525,1,8067,1885,6182,0,0,0,1.0,1,1.0,1,1.0,1,0.2281903941378562,29
2526,0,8067,1885,6182,0,0,0,1.0,1,1.0,1,1.0,1,0.2610685777688729,27
2527,0,8067,1885,6182,0,0,0,1.0,1,1.0,1,1.0,1,0.25055749696101653,28
2528,0,8067,1885,6182,0,0,0,1.0,1,1.0,1,1.0,1,0.25055749696101653,28
2529,0,8067,1885,6182,0,0,0,1.0,1,1.0,1,1.0,1,0.25055749696101653,28
2530,0,8067,1885,6182,0,0,0,1.0,1,1.0,1,1.0,1,0.2653264678308609,29
2531,1,8068,1885,6183,0,0,0,1.0,1,1.0,1,1.0,1,0.23251844609704242,30
2532,1,8069,1885,6184,0,0,0,1.0,1,1.0,1,1.0,1,0.24501185642002907,31
2533,0,8069,1885,6184,0,0,0,1.0,1,1.0,1,1.0,1,0.24501185642002907,31
2534,0,8069,1885,6184,0,0,0,1.0,1,1.0,1,1.0,1,0.24501185642002907,31
2535,2,8071,1886,6185,0,0,0,1.0,1,1.0,1,1.0,1,0.2932820950343234,31
2536,2,8073,1886,6187,0,0,0,1.0,1,1.0,1,1.0,1,0.26375190489808364,32
2537,3,8076,1887,6189,0,0,0,1.0,1,1.0,1,1.0,1,0.21591087125124292,33
2538,3,8079,1887,6192,0,0,0,1.0,1,1.0,1,1.0,1,0.15319926153908206,35
2539,1,8080,1887,6193,0,0,0,1.0,1,1.0,1,1.0,1,0.1521336750390738,37
2540,1,8081,1888,6193,0,0,0,1.0,1,1.0,1,1.0,1,0.183503845798829,38
2541,6,8087,1890,6197,0,0,0,1.0,1,1.0,1,1.0,1,0.17783826450119503,39
2542,9,8096,1892,6204,0,0,0,1.0,1,1.0,1,1.0,1,0.25343133081052954,38
2543,10,8106,1895,6211,0,0,0,1.0,1,1.0,1,1.0,1,0.23444580538139076,41
2544,6,8112,1897,6215,0,0,0,1.0,1,1.0,1,1.0,1,0.1999876662375038,39
2545,11,8123,1898,6225,0,0,0,1.0,1,1.0,1,1.0,1,0.1439746141863629,40
2546,4,8127,1898,6229,0,0,0,1.0,1,1.0,1,1.0,1,0.16884528888803566,38
2547,7,8134,1900,6234,0,0,0,1.0,1,1.0,1,1.0,1,0.15123443817239576,38
2548,3,8137,1900,6237,0,0,0,1.0,1,1.0,1,1.0,1,0.19771435908102405,35
2549,5,8142,1902,6240,0,0,0,1.0,1,1.0,1,1.0,1,0.20958702006305957,35
2550,4,8146,1903,6243,0,0,0,1.0,1,1.0,1,1.0,1,0.2016073770290583,33
2551,2,8148,1904,6244,0,0,0,1.0,1,1.0,1,1.0,1,0.21462327094217276,31
2552,2,8150,1904,6246,0,0,0,1.0,1,1.0,1,1.0,1,0.16365781795261689,30
2553,0,8150,1904,6246,0,0,0,1.0,1,1.0,1,1.0,1,0.16365781795261689,30
2554,1,8151,1905,6246,0,0,0,1.0,1,1.0,1,1.0,1,0.12053220875743065,32
2555,1,8152,1906,6246,0,0,0,1.0,1,1.0,1,1.0,1,0.1473207996385905,32
2556,2,8154,1906,6248,0,0,0,1.0,1,1.0,1,1.0,1,0.09946321307540296,32
2557,0,8154,1906,6248,0,0,0,1.0,1,1.0,1,1.0,1,0.14205333780997076,30
2558,3,8157,1907,6250,0,0,0,1.0,1,1.0,1,1.0,1,0.1376730398165699,31
2559,0,8157,1907,6250,0,0,0,1.0,1,1.0,1,1.0,1,0.1601114118658571,30
2560,0,8157,1907,6250,0,0,0,1.0,1,1.0,1,1.0,1,0.1601114118658571,30
2561,0,8157,1907,6250,0,0,0,1.0,1,1.0,1,1.0,1,0.1601114118658571,30
2562,0,8157,1907,6250,0,0,0,1.0,1,1.0,1,1.0,1,0.13859035102038236,33
2563,1,8158,1907,6251,0,0,0,1.0,1,1.0,1,1.0,1,0.15895660108635465,33
2564,1,8159,1907,6252,0,0,0,1.0,1,1.0,1,1.0,1,0.17197150947501633,33
2565,4,8163,1908,6255,0,0,0,1.0,1,1.0,1,1.0,1,0.12004386592362898,33
2566,0,8163,1908,6255,0,0,0,1.0,1,1.0,1,1.0,1,0.11824668788837386,35
2567,0,8163,1908,6255,0,0,0,1.0,1,1.0,1,1.0,1,0.12670494571506616,36
2568,3,8166,1909,6257,0,0,0,1.0,1,1.0,1,1.0,1,0.1723854148916212,37
2569,2,8168,1910,6258,0,0,0,1.0,1,1.0,1,1.0,1,0.1571832688558835,37
2570,1,8169,1910,6259,0,0,0,1.0,1,1.0,1,1.0,1,0.14283686533466197,37
2571,0,8169,1910,6259,0,0,0,1.0,1,1.0,1,1.0,1,0.14283686533466197,37
2572,1,8170,1910,6260,0,0,0,1.0,1,1.0,1,1.0,1,0.10078043097223544,39
2573,0,8170,1910,6260,0,0,0,1.0,1,1.0,1,1.0,1,0.10078043097223544,39
2574,0,8170,1910,6260,0,0,0,1.0,1,1.0,1,1.0,1,0.11202376838632808,38
2575,2,8172,1911,6261,0,0,0,1.0,1,1.0,1,1.0,1,0.11112277656381543,38
2576,0,8172,1911,6261,0,0,0,1.0,1,1.0,1,1.0,1,0.14086775917512556,37
2577,4,8176,1912,6264,0,0,0,1.0,1,1.0,1,1.0,1,0.203594515422084,39
2578,2,8178,1912,6266,0,0,0,1.0,1,1.0,1,1.0,1,0.20693508907661876,40
2579,0,8178,1912,6266,0,0,0,1.0,1,1.0,1,1.0,1,0.1858059189996208,41
2580,2,8180,1912,6268,0,0,0,1.0,1,1.0,1,1.0,1,0.15146319862646107,42
2581,4,8184,1912,6272,0,0,0,1.0,1,1.0,1,1.0,1,0.09350422815671447,43
2582,0,8184,1912,6272,0,0,0,1.0,1,1.0,1,1.0,1,0.09350422815671447,43
2583,1,8185,1913,6272,0,0,0,1.0,1,1.0,1,1.0,1,0.13271259984849662,43
2584,3,8188,1914,6274,0,0,0,1.0,1,1.0,1,1.0,1,0.13363766695289392,43
2585,6,8194,1915,6279,0,0,0,1.0,1,1.0,1,1.0,1,0.11462574370118228,44
2586,1,8195,1915,6280,0,0,0,1.0,1,1.0,1,1.0,1,0.09796011397760965,43
2587,0,8195,1915,6280,0,0,0,1.0,1,1.0,1,1.0,1,0.10418329303408867,44
2588,1,8196,1915,6281,0,0,0,1.0,1,1.0,1,1.0,1,0.1116588810559603,44
2589,4,8200,1917,6283,0,0,0,1.0,1,1.0,1,1.0,1,0.15087295511236695,44
2590,1,8201,1917,6284,0,0,0,1.0,1,1.0,1,1.0,1,0.11687968120213331,44
2591,1,8202,1917,6285,0,0,0,1.0,1,1.0,1,1.0,1,0.1303756160453922,44
2592,3,8205,1918,6287,0,0,0,1.0,1,1.0,1,1.0,1,0.16728820274893288,44
2593,2,8207,1918,6289,0,0,0,1.0,1,1.0,1,1.0,1,0.15150925528147105,43
2594,9,8216,1922,6294,0,0,0,1.0,1,1.0,1,1.0,1,0.12355986211120869,48
2595,3,8219,1923,6296,0,0,0,1.0,1,1.0,1,1.0,1,0.1227435229497196,45
2596,6,8225,1925,6300,0,0,0,1.0,1,1.0,1,1.0,1,0.08928693600480316,46
2597,0,8225,1925,6300,0,0,0,1.0,1,1.0,1,1.0,1,0.08048959372336094,45
2598,1,8226,1926,6300,0,0,0,1.0,1,1.0,1,1.0,1,0.07460038921967516,45
2599,2,8228,1927,6301,0,0,0,1.0,1,1.0,1,1.0,1,0.11125465490598016,45
2600,2,8230,1929,6301,0,0,0,1.0,1,1.0,1,1.0,1,0.11083450790198873,48
2601,0,8230,1929,6301,0,0,0,1.0,1,1.0,1,1.0,1,0.12143546693584492,47
2602,1,8231,1929,6302,0,0,0,1.0,1,1.0,1,1.0,1,0.13183792440165856,48
2603,1,8232,1929,6303,0,0,0,1.0,1,1.0,1,1.0,1,0.12536699900922896,48
2604,3,8235,1930,6305,0,0,0,1.0,1,1.0,1,1.0,1,0.1270032722842987,47
2605,4,8239,1932,6307,0,0,0,1.0,1,1.0,1,1.0,1,0.14074656112474035,47
2606,0,8239,1932,6307,0,0,0,1.0,1,1.0,1,1.0,1,0.14367082088419383,46
2607,3,8242,1933,6309,0,0,0,1.0,1,1.0,1,1.0,1,0.1852723219551548,45
2608,3,8245,1934,6311,0,0,0,1.0,1,1.0,1,1.0,1,0.1740147449854062,45
2609,3,8248,1936,6312,0,0,0,1.0,1,1.0,1,1.0,1,0.21816106963452966,44
2610,3,8251,1936,6315,0,0,0,1.0,1,1.0,1,1.0,1,0.1944728051636402,45
2611,9,8260,1939,6321,0,0,0,1.0,1,1.0,1,1.0,1,0.12520633708911377,46
2612,2,8262,1939,6323,0,0,0,1.0,1,1.0,1,1.0,1,0.09837861315900949,47
2613,3,8265,1940,6325,0,0,0,1.0,1,1.0,1,1.0,1,0.11605181028768921,48
2614,2,8267,1942,6325,0,0,0,1.0,1,1.0,1,1.0,1,0.12854080785836453,48
2615,5,8272,1945,6327,0,0,0,1.0,1,1.0,1,1.0,1,0.15034510856847208,49
2616,5,8277,1946,6331,0,0,0,1.0,1,1.0,1,1.0,1,0.1745389782115302,49
2617,0,8277,1946,6331,0,0,0,1.0,1,1.0,1,1.0,1,0.18993062521972845,48
2618,0,8277,1946,6331,0,0,0,1.0,1,1.0,1,1.0,1,0.19110864681577538,47
2619,2,8279,1946,6333,0,0,0,1.0,1,1.0,1,1.0,1,0.1548818234279188,50
2620,4,8283,1946,6337,0,0,0,1.0,1,1.0,1,1.0,1,0.15429143085828143,51
2621,2,8285,1947,6338,0,0,0,1.0,1,1.0,1,1.0,1,0.1463738769001533,52
2622,4,8289,1949,6340,0,0,0,1.0,1,1.0,1,1.0,1,0.13735902101149897,52
2623,5,8294,1951,6343,0,0,0,1.0,1,1.0,1,1.0,1,0.1373274876824887,53
2624,7,8301,1954,6347,0,0,0,1.0,1,1.0,1,1.0,1,0.13275302757670657,51
2625,4,8305,1956,6349,0,0,0,1.0,1,1.0,1,1.0,1,0.1404803580951527,50
2626,3,8308,1957,6351,0,0,0,1.0,1,1.0,1,1.0,1,0.1323026769746383,49
2627,3,8311,1959,6352,0,0,0,1.0,1,1.0,1,1.0,1,0.15545272799239707,48
2628,4,8315,1961,6354,0,0,0,1.0,1,1.0,1,1.0,1,0.16790922213851514,48
2629,1,8316,1962,6354,0,0,0,1.0,1,1.0,1,1.0,1,0.20641254074718451,47
2630,3,8319,1963,6356,0,0,0,1.0,1,1.0,1,1.0,1,0.22906991647884142,47
2631,2,8321,1964,6357,0,0,0,1.0,1,1.0,1,1.0,1,0.23981965585061718,47
2632,3,8324,1965,6359,0,0,0,1.0,1,1.0,1,1.0,1,0.20108632314889002,47
2633,3,8327,1966,6361,0,0,0,1.0,1,1.0,1,1.0,1,0.1810146598924597,44
2634,0,8327,1966,6361,0,0,0,1.0,1,1.0,1,1.0,1,0.1810789036782638,44
2635,2,8329,1966,6363,0,0,0,1.0,1,1.0,1,1.0,1,0.17675141897192356,45
2636,3,8332,1967,6365,0,0,0,1.0,1,1.0,1,1.0,1,0.20795798487905545,40
2637,3,8335,1968,6367,0,0,0,1.0,1,1.0,1,1.0,1,0.20532504401113466,41
2638,2,8337,1969,6368,0,0,0,1.0,1,1.0,1,1.0,1,0.2573175871826616,38
2639,3,8340,1969,6371,0,0,0,1.0,1,1.0,1,1.0,1,0.26340523383743025,39
2640,2,8342,1971,6371,0,0,0,1.0,1,1.0,1,1.0,1,0.2619620998012275,38
2641,7,8349,1973,6376,0,0,0,1.0,1,1.0,1,1.0,1,0.19599983926635334,37
2642,4,8353,1974,6379,0,0,0,1.0,1,1.0,1,1.0,1,0.13974254336830325,38
2643,2,8355,1975,6380,0,0,0,1.0,1,1.0,1,1.0,1,0.15932660530088036,37
2644,0,8355,1975,6380,0,0,0,1.0,1,1.0,1,1.0,1,0.13750453520575884,36
2645,1,8356,1975,6381,0,0,0,1.0,1,1.0,1,1.0,1,0.11832378337326237,35
2646,0,8356,1975,6381,0,0,0,1.0,1,1.0,1,1.0,1,0.11863162533359352,35
2647,3,8359,1977,6382,0,0,0,1.0,1,1.0,1,1.0,1,0.10059925720547014,35
2648,0,8359,1977,6382,0,0,0,1.0,1,1.0,1,1.0,1,0.10749397863809002,36
2649,1,8360,1977,6383,0,0,0,1.0,1,1.0,1,1.0,1,0.07941559530256563,37
2650,5,8365,1977,6388,0,0,0,1.0,1,1.0,1,1.0,1,0.07509790303649978,39
2651,1,8366,1977,6389,0,0,0,1.0,1,1.0,1,1.0,1,0.07134454689134029,39
2652,0,8366,1977,6389,0,0,0,1.0,1,1.0,1,1.0,1,0.07134454689134029,39
2653,0,8366,1977,6389,0,0,0,1.0,1,1.0,1,1.0,1,0.07134454689134029,39
2654,0,8366,1977,6389,0,0,0,1.0,1,1.0,1,1.0,1,0.09394509695841592,40
2655,0,8366,1977,6389,0,0,0,1.0,1,1.0,1,1.0,1,0.09394509695841592,40
2656,1,8367,1978,6389,0,0,0,1.0,1,1.0,1,1.0,1,0.1381811843410074,39
2657,1,8368,1978,6390,0,0,0,1.0,1,1.0,1,1.0,1,0.13747871084675523,40
2658,3,8371,1979,6392,0,0,0,1.0,1,1.0,1,1.0,1,0.19885205049449903,41
2659,6,8377,1981,6396,0,0,0,1.0,1,1.0,1,1.0,1,0.21248652550985997,41
2660,3,8380,1982,6398,0,0,0,1.0,1,1.0,1,1.0,1,0.28098032980206566,40
2661,4,8384,1982,6402,0,0,0,1.0,1,1.0,1,1.0,1,0.2306330380281355,40
2662,5,8389,1984,6405,0,0,0,1.0,1,1.0,1,1.0,1,0.22305257063677764,42
2663,2,8391,1984,6407,0,0,0,1.0,1,1.0,1,1.0,1,0.1362205228961718,41
2664,4,8395,1986,6409,0,0,0,1.0,1,1.0,1,1.0,1,0.1962178356255758,42
2665,4,8399,1986,6413,0,0,0,1.0,1,1.0,1,1.0,1,0.17352673595704582,43
2666,2,8401,1987,6414,0,0,0,1.0,1,1.0,1,1.0,1,0.1633758846440512,44
2667,4,8405,1989,6416,0,0,0,1.0,1,1.0,1,1.0,1,0.18097631964234595,42
2668,2,8407,1989,6418,0,0,0,1.0,1,1.0,1,1.0,1,0.17751097483195732,41
2669,7,8414,1992,6422,0,0,0,1.0,1,1.0,1,1.0,1,0.20474268390856049,42
2670,0,8414,1992,6422,0,0,0,1.0,1,1.0,1,1.0,1,0.21166486555914377,40
2671,4,8418,1994,6424,0,0,0,1.0,1,1.0,1,1.0,1,0.18055167166436123,39
2672,0,8418,1994,6424,0,0,0,1.0,1,1.0,1,1.0,1,0.2030184327283399,36
2673,1,8419,1995,6424,0,0,0,1.0,1,1.0,1,1.0,1,0.21580651162519668,35
2674,3,8422,1996,6426,0,0,0,1.0,1,1.0,1,1.0,1,0.1931704579076305,33
2675,1,8423,1996,6427,0,0,0,1.0,1,1.0,1,1.0,1,0.13396674127632902,34
2676,0,8423,1996,6427,0,0,0,1.0,1,1.0,1,1.0,1,0.1258677522437237,32
2677,1,8424,1997,6427,0,0,0,1.0,1,1.0,1,1.0,1,0.19843832041556422,33
2678,2,8426,1998,6428,0,0,0,1.0,1,1.0,1,1.0,1,0.18450207836631888,33
2679,3,8429,1999,6430,0,0,0,1.0,1,1.0,1,1.0,1,0.3269181766566923,32
2680,0,8429,1999,6430,0,0,0,1.0,1,1.0,1,1.0,1,0.3269181766566923,32
2681,0,8429,1999,6430,0,0,0,1.0,1,1.0,1,1.0,1,0.3275844335353281,32
2682,2,8431,2000,6431,0,0,0,1.0,1,1.0,1,1.0,1,0.30061415015632886,33
2683,2,8433,2000,6433,0,0,0,1.0,1,1.0,1,1.0,1,0.2642037739672409,32
2684,1,8434,2000,6434,0,0,0,1.0,1,1.0,1,1.0,1,0.28083178188920743,31
2685,2,8436,2000,6436,0,0,0,1.0,1,1.0,1,1.0,1,0.28083178188920743,31
2686,3,8439,2000,6439,0,0,0,1.0,1,1.0,1,1.0,1,0.2781614702252524,30
2687,0,8439,2000,6439,0,0,0,1.0,1,1.0,1,1.0,1,0.2781614702252524,30
2688,3,8442,2001,6441,0,0,0,1.0,1,1.0,1,1.0,1,0.2499899905859093,30
2689,3,8445,2002,6443,0,0,0,1.0,1,1.0,1,1.0,1,0.2014264028733283,31
2690,5,8450,2004,6446,0,0,0,1.0,1,1.0,1,1.0,1,0.23034573070024947,31
2691,6,8456,2006,6450,0,0,0,1.0,1,1.0,1,1.0,1,0.21218237730767645,32
2692,1,8457,2006,6451,0,0,0,1.0,1,1.0,1,1.0,1,0.18532870235711751,32
2693,5,8462,2007,6455,0,0,0,1.0,1,1.0,1,1.0,1,0.17483302199987963,33
2694,3,8465,2007,6458,0,0,0,1.0,1,1.0,1,1.0,1,0.19205187483837827,34
2695,2,8467,2007,6460,0,0,0,1.0,1,1.0,1,1.0,1,0.18025420220519905,35
2696,2,8469,2007,6462,0,0,0,1.0,1,1.0,1,1.0,1,0.1807245129527023,35
2697,2,8471,2007,6464,0,0,0,1.0,1,1.0,1,1.0,1,0.1807245129527023,35
2698,1,8472,2007,6465,0,0,0,1.0,1,1.0,1,1.0,1,0.16554078495415542,36
2699,3,8475,2007,6468,0,0,0,1.0,1,1.0,1,1.0,1,0.16216266205165147,36
2700,3,8478,2008,6470,0,0,0,1.0,1,1.0,1,1.0,1,0.1592596649843769,37
2701,2,8480,2008,6472,0,0,0,1.0,1,1.0,1,1.0,1,0.11345479185915758,37
2702,5,8485,2012,6473,0,0,0,1.0,1,1.0,1,1.0,1,0.20560772930225257,37
2703,4,8489,2014,6475,0,0,0,1.0,1,1.0,1,1.0,1,0.20228792782934288,38
2704,6,8495,2016,6479,0,0,0,1.0,1,1.0,1,1.0,1,0.26273245401040185,37
2705,5,8500,2016,6484,0,0,0,1.0,1,1.0,1,1.0,1,0.21444439291058673,36
2706,4,8504,2017,6487,0,0,0,1.0,1,1.0,1,1.0,1,0.220331187259256,36
2707,4,8508,2018,6490,0,0,0,1.0,1,1.0,1,1.0,1,0.24828392594855228,35
2708,4,8512,2021,6491,0,0,0,1.0,1,1.0,1,1.0,1,0.2594597281925321,36
2709,4,8516,2023,6493,0,0,0,1.0,1,1.0,1,1.0,1,0.2594982787133323,32
2710,1,8517,2024,6493,0,0,0,1.0,1,1.0,1,1.0,1,0.2309838615966207,29
2711,1,8518,2025,6493,0,0,0,1.0,1,1.0,1,1.0,1,0.20667240038308363,29
2712,1,8519,2026,6493,0,0,0,1.0,1,1.0,1,1.0,1,0.3242634934095223,28
2713,1,8520,2026,6494,0,0,0,1.0,1,1.0,1,1.0,1,0.3010111324007441,28
2714,2,8522,2028,6494,0,0,0,1.0,1,1.0,1,1.0,1,0.303556733108226,26
2715,1,8523,2029,6494,0,0,0,1.0,1,1.0,1,1.0,1,0.33671494880992947,24
2716,5,8528,2029,6499,0,0,0,1.0,1,1.0,1,1.0,1,0.2168566657897322,24
2717,4,8532,2031,6501,0,0,0,1.0,1,1.0,1,1.0,1,0.2749742929607667,25
2718,5,8537,2033,6504,0,0,0,1.0,1,1.0,1,1.0,1,0.309861888781084,25
2719,2,8539,2033,6506,0,0,0,1.0,1,1.0,1,1.0,1,0.3564921132346325,25
2720,3,8542,2034,6508,0,0,0,1.0,1,1.0,1,1.0,1,0.35360275542054975,25
2721,5,8547,2035,6512,0,0,0,1.0,1,1.0,1,1.0,1,0.33394377891960636,25
2722,3,8550,2035,6515,0,0,0,1.0,1,1.0,1,1.0,1,0.35427471101557245,26
2723,4,8554,2035,6519,0,0,0,1.0,1,1.0,1,1.0,1,0.3176284822174372,26
2724,1,8555,2035,6520,0,0,0,1.0,1,1.0,1,1.0,1,0.27655862626795585,27
2725,5,8560,2035,6525,0,0,0,1.0,1,1.0,1,1.0,1,0.25328621516990607,28
2726,2,8562,2035,6527,0,0,0,1.0,1,1.0,1,1.0,1,0.2786324597451895,28
2727,5,8567,2035,6532,0,0,0,1.0,1,1.0,1,1.0,1,0.26930129929874164,29
2728,3,8570,2036,6534,0,0,0,1.0,1,1.0,1,1.0,1,0.27909306448725024,29
2729,4,8574,2036,6538,0,0,0,1.0,1,1.0,1,1.0,1,0.29013907692760793,29
2730,3,8577,2036,6541,0,0,0,1.0,1,1.0,1,1.0,1,0.2876961298026964,29
2731,4,8581,2037,6544,0,0,0,1.0,1,1.0,1,1.0,1,0.2140118680569103,30
2732,2,8583,2037,6546,0,0,0,1.0,1,1.0,1,1.0,1,0.19632086212961283,29
2733,2,8585,2038,6547,0,0,0,1.0,1,1.0,1,1.0,1,0.20380039572301523,29
2734,3,8588,2038,6550,0,0,0,1.0,1,1.0,1,1.0,1,0.2238418125235703,29
2735,1,8589,2038,6551,0,0,0,1.0,1,1.0,1,1.0,1,0.23572293786413534,29
2736,5,8594,2039,6555,0,0,0,1.0,1,1.0,1,1.0,1,0.21161489724682667,30
2737,1,8595,2039,6556,0,0,0,1.0,1,1.0,1,1.0,1,0.21683469039196357,30
2738,0,8595,2039,6556,0,0,0,1.0,1,1.0,1,1.0,1,0.21683469039196357,30
2739,2,8597,2040,6557,0,0,0,1.0,1,1.0,1,1.0,1,0.22375900434254586,29
2740,0,8597,2040,6557,0,0,0,1.0,1,1.0,1,1.0,1,0.22375900434254586,29
2741,0,8597,2040,6557,0,0,0,1.0,1,1.0,1,1.0,1,0.26092908800980974,28
2742,2,8599,2041,6558,0,0,0,1.0,1,1.0,1,1.0,1,0.25893714001170426,28
2743,3,8602,2042,6560,0,0,0,1.0,1,1.0,1,1.0,1,0.26303907804787247,29
2744,1,8603,2043,6560,0,0,0,1.0,1,1.0,1,1.0,1,0.2528621967540678,27
2745,1,8604,2044,6560,0,0,0,1.0,1,1.0,1,1.0,1,0.3004449023569111,25
2746,7,8611,2045,6566,0,0,0,1.0,1,1.0,1,1.0,1,0.2165433710847955,25
2747,2,8613,2046,6567,0,0,0,1.0,1,1.0,1,1.0,1,0.2732346319217271,23
2748,2,8615,2047,6568,0,0,0,1.0,1,1.0,1,1.0,1,0.21616147204331604,22
2749,0,8615,2047,6568,0,0,0,1.0,1,1.0,1,1.0,1,0.26809668766396544,19
2750,1,8616,2048,6568,0,0,0,1.0,1,1.0,1,1.0,1,0.29204868902882136,18
2751,0,8616,2048,6568,0,0,0,1.0,1,1.0,1,1.0,1,0.3207521452387466,16
2752,0,8616,2048,6568,0,0,0,1.0,1,1.0,1,1.0,1,0.3365334350010936,15
2753,0,8616,2048,6568,0,0,0,1.0,1,1.0,1,1.0,1,0.3365334350010936,15
2754,0,8616,2048,6568,0,0,0,1.0,1,1.0,1,1.0,1,0.3365334350010936,15
2755,0,8616,2048,6568,0,0,0,1.0,1,1.0,1,1.0,1,0.3365334350010936,15
2756,0,8616,2048,6568,0,0,0,1.0,1,1.0,1,1.0,1,0.3410888404752009,16
2757,0,8616,2048,6568,0,0,0,1.0,1,1.0,1,1.0,1,0.30474799436970634,17
2758,0,8616,2048,6568,0,0,0,1.0,1,1.0,1,1.0,1,0.30474799436970634,17
2759,1,8617,2048,6569,0,0,0,1.0,1,1.0,1,1.0,1,0.34086061921780864,18
2760,0,8617,2048,6569,0,0,0,1.0,1,1.0,1,1.0,1,0.34086061921780864,18
2761,2,8619,2048,6571,0,0,0,1.0,1,1.0,1,1.0,1,0.2397814957585362,18
2762,1,8620,2049,6571,0,0,0,1.0,1,1.0,1,1.0,1,0.3114217949210304,18
2763,3,8623,2049,6574,0,0,0,1.0,1,1.0,1,1.0,1,0.21674480292654577,17
2764,2,8625,2050,6575,0,0,0,1.0,1,1.0,1,1.0,1,0.25261625327245685,17
2765,2,8627,2050,6577,0,0,0,1.0,1,1.0,1,1.0,1,0.23903423138775215,18
2766,0,8627,2050,6577,0,0,0,1.0,1,1.0,1,1.0,1,0.23903423138775215,18
2767,0,8627,2050,6577,0,0,0,1.0,1,1.0,1,1.0,1,0.23903423138775215,18
2768,1,8628,2050,6578,0,0,0,1.0,1,1.0,1,1.0,1,0.18462382961800844,18
2769,2,8630,2051,6579,0,0,0,1.0,1,1.0,1,1.0,1,0.2633741007059547,18
2770,1,8631,2051,6580,0,0,0,1.0,1,1.0,1,1.0,1,0.25418757029626055,18
2771,0,8631,2051,6580,0,0,0,1.0,1,1.0,1,1.0,1,0.25418757029626055,18
2772,0,8631,2051,6580,0,0,0,1.0,1,1.0,1,1.0,1,0.25418757029626055,18
2773,0,8631,2051,6580,0,0,0,1.0,1,1.0,1,1.0,1,0.25418757029626055,18
2774,1,8632,2051,6581,0,0,0,1.0,1,1.0,1,1.0,1,0.24208757538083184,20
2775,0,8632,2051,6581,0,0,0,1.0,1,1.0,1,1.0,1,0.19760954725317367,21
2776,0,8632,2051,6581,0,0,0,1.0,1,1.0,1,1.0,1,0.19760954725317367,21
2777,1,8633,2051,6582,0,0,0,1.0,1,1.0,1,1.0,1,0.17867865061591612,22
2778,2,8635,2052,6583,0,0,0,1.0,1,1.0,1,1.0,1,0.1892119851035367,24
2779,2,8637,2054,6583,0,0,0,1.0,1,1.0,1,1.0,1,0.2739011129379169,24
2780,3,8640,2055,6585,0,0,0,1.0,1,1.0,1,1.0,1,0.2975845962659461,24
2781,3,8643,2055,6588,0,0,0,1.0,1,1.0,1,1.0,1,0.2469387059625178,24
2782,3,8646,2055,6591,0,0,0,1.0,1,1.0,1,1.0,1,0.18119090095744791,24
2783,0,8646,2055,6591,0,0,0,1.0,1,1.0,1,1.0,1,0.18119090095744791,24
2784,0,8646,2055,6591,0,0,0,1.0,1,1.0,1,1.0,1,0.19527244315998948,24
2785,0,8646,2055,6591,0,0,0,1.0,1,1.0,1,1.0,1,0.18490208938272998,22
2786,0,8646,2055,6591,0,0,0,1.0,1,1.0,1,1.0,1,0.22803069290261468,22
2787,2,8648,2055,6593,0,0,0,1.0,1,1.0,1,1.0,1,0.2283387354827321,21
2788,1,8649,2055,6594,0,0,0,1.0,1,1.0,1,1.0,1,0.28589523443662657,20
2789,3,8652,2056,6596,0,0,0,1.0,1,1.0,1,1.0,1,0.28396786546175573,20
2790,1,8653,2056,6597,0,0,0,1.0,1,1.0,1,1.0,1,0.2938782873376296,21
2791,3,8656,2056,6600,0,0,0,1.0,1,1.0,1,1.0,1,0.20330166673596142,21
2792,0,8656,2056,6600,0,0,0,1.0,1,1.0,1,1.0,1,0.20330166673596142,21
2793,1,8657,2056,6601,0,0,0,1.0,1,1.0,1,1.0,1,0.20276496627207913,18
2794,0,8657,2056,6601,0,0,0,1.0,1,1.0,1,1.0,1,0.20276496627207913,18
2795,2,8659,2056,6603,0,0,0,1.0,1,1.0,1,1.0,1,0.1528009829910135,20
2796,0,8659,2056,6603,0,0,0,1.0,1,1.0,1,1.0,1,0.14370968585760358,21
2797,0,8659,2056,6603,0,0,0,1.0,1,1.0,1,1.0,1,0.14370968585760358,21
2798,0,8659,2056,6603,0,0,0,1.0,1,1.0,1,1.0,1,0.14370968585760358,21
2799,1,8660,2057,6603,0,0,0,1.0,1,1.0,1,1.0,1,0.17495923710653957,22
2800,0,8660,2057,6603,0,0,0,1.0,1,1.0,1,1.0,1,0.17495923710653957,22
2801,1,8661,2058,6603,0,0,0,1.0,1,1.0,1,1.0,1,0.18159688477942393,22
2802,0,8661,2058,6603,0,0,0,1.0,1,1.0,1,1.0,1,0.18159688477942393,22
2803,0,8661,2058,6603,0,0,0,1.0,1,1.0,1,1.0,1,0.18159688477942393,22
2804,1,8662,2058,6604,0,0,0,1.0,1,1.0,1,1.0,1,0.18865910146163015,23
2805,0,8662,2058,6604,0,0,0,1.0,1,1.0,1,1.0,1,0.18865910146163015,23
2806,0,8662,2058,6604,0,0,0,1.0,1,1.0,1,1.0,1,0.18865910146163015,23
2807,0,8662,2058,6604,0,0,0,1.0,1,1.0,1,1.0,1,0.1984846557792352,24
2808,0,8662,2058,6604,0,0,0,1.0,1,1.0,1,1.0,1,0.1984846557792352,24
2809,2,8664,2059,6605,0,0,0,1.0,1,1.0,1,1.0,1,0.2136372296282028,25
2810,0,8664,2059,6605,0,0,0,1.0,1,1.0,1,1.0,1,0.2040132549875447,24
2811,2,8666,2059,6607,0,0,0,1.0,1,1.0,1,1.0,1,0.19541426645103424,26
2812,3,8669,2061,6608,0,0,0,1.0,1,1.0,1,1.0,1,0.25742368947175237,26
2813,0,8669,2061,6608,0,0,0,1.0,1,1.0,1,1.0,1,0.27215886301682396,27
2814,1,8670,2061,6609,0,0,0,1.0,1,1.0,1,1.0,1,0.24232000280795446,29
2815,3,8673,2061,6612,0,0,0,1.0,1,1.0,1,1.0,1,0.17478324263472156,29
2816,2,8675,2061,6614,0,0,0,1.0,1,1.0,1,1.0,1,0.1883703903351071,29
2817,3,8678,2062,6616,0,0,0,1.0,1,1.0,1,1.0,1,0.23431240130396308,29
2818,4,8682,2063,6619,0,0,0,1.0,1,1.0,1,1.0,1,0.280863880279746,29
2819,5,8687,2063,6624,0,0,0,1.0,1,1.0,1,1.0,1,0.24604626342504562,30
2820,5,8692,2064,6628,0,0,0,1.0,1,1.0,1,1.0,1,0.2236658211556173,30
2821,1,8693,2064,6629,0,0,0,1.0,1,1.0,1,1.0,1,0.18196610934661397,31
2822,2,8695,2066,6629,0,0,0,1.0,1,1.0,1,1.0,1,0.23592241178536724,30
2823,2,8697,2067,6630,0,0,0,1.0,1,1.0,1,1.0,1,0.2062393753670381,27
2824,2,8699,2068,6631,0,0,0,1.0,1,1.0,1,1.0,1,0.2204420751839237,28
2825,2,8701,2070,6631,0,0,0,1.0,1,1.0,1,1.0,1,0.22495001606298495,28
2826,1,8702,2071,6631,0,0,0,1.0,1,1.0,1,1.0,1,0.2603961064785788,27
2827,3,8705,2072,6633,0,0,0,1.0,1,1.0,1,1.0,1,0.19546364099112903,28
2828,1,8706,2072,6634,0,0,0,1.0,1,1.0,1,1.0,1,0.2159410973083606,28
2829,1,8707,2073,6634,0,0,0,1.0,1,1.0,1,1.0,1,0.2389284928324917,27
2830,2,8709,2075,6634,0,0,0,1.0,1,1.0,1,1.0,1,0.3022632028496394,27
2831,6,8715,2075,6640,0,0,0,1.0,1,1.0,1,1.0,1,0.15301802764413472,27
2832,2,8717,2076,6641,0,0,0,1.0,1,1.0,1,1.0,1,0.22770777065098932,27
2833,1,8718,2076,6642,0,0,0,1.0,1,1.0,1,1.0,1,0.2174483088043264,26
2834,0,8718,2076,6642,0,0,0,1.0,1,1.0,1,1.0,1,0.19279194130976204,26
2835,0,8718,2076,6642,0,0,0,1.0,1,1.0,1,1.0,1,0.20782654929030392,25
2836,2,8720,2077,6643,0,0,0,1.0,1,1.0,1,1.0,1,0.15175215873010175,27
2837,0,8720,2077,6643,0,0,0,1.0,1,1.0,1,1.0,1,0.17276090045697431,27
2838,1,8721,2077,6644,0,0,0,1.0,1,1.0,1,1.0,1,0.10171879769109812,27
2839,2,8723,2079,6644,0,0,0,1.0,1,1.0,1,1.0,1,0.1629304291927225,29
2840,1,8724,2080,6644,0,0,0,1.0,1,1.0,1,1.0,1,0.14900653987071416,29
2841,6,8730,2080,6650,0,0,0,1.0,1,1.0,1,1.0,1,0.15370763095683998,31
2842,1,8731,2080,6651,0,0,0,1.0,1,1.0,1,1.0,1,0.16022448426941924,31
2843,2,8733,2080,6653,0,0,0,1.0,1,1.0,1,1.0,1,0.1887548634534483,32
2844,3,8736,2082,6654,0,0,0,1.0,1,1.0,1,1.0,1,0.21396143119662078,33
2845,0,8736,2082,6654,0,0,0,1.0,1,1.0,1,1.0,1,0.2131711639854471,32
2846,2,8738,2082,6656,0,0,0,1.0,1,1.0,1,1.0,1,0.23807819626323684,33
2847,4,8742,2083,6659,0,0,0,1.0,1,1.0,1,1.0,1,0.3143962212623852,32
2848,5,8747,2084,6663,0,0,0,1.0,1,1.0,1,1.0,1,0.30508396119706876,33
2849,6,8753,2084,6669,0,0,0,1.0,1,1.0,1,1.0,1,0.3140350969256191,34
2850,4,8757,2084,6673,0,0,0,1.0,1,1.0,1,1.0,1,0.2903326901885217,34
2851,2,8759,2084,6675,0,0,0,1.0,1,1.0,1,1.0,1,0.23751508035700974,34
2852,5,8764,2087,6677,0,0,0,1.0,1,1.0,1,1.0,1,0.22561062793353096,35
2853,1,8765,2087,6678,0,0,0,1.0,1,1.0,1,1.0,1,0.1973282469272627,36
2854,1,8766,2087,6679,0,0,0,1.0,1,1.0,1,1.0,1,0.19575706990383163,37
2855,3,8769,2089,6680,0,0,0,1.0,1,1.0,1,1.0,1,0.2142782479260753,38
2856,1,8770,2089,6681,0,0,0,1.0,1,1.0,1,1.0,1,0.19539795742528182,38
2857,2,8772,2090,6682,0,0,0,1.0,1,1.0,1,1.0,1,0.17115439049272538,39
2858,3,8775,2090,6685,0,0,0,1.0,1,1.0,1,1.0,1,0.15366264266282706,40
2859,1,8776,2091,6685,0,0,0,1.0,1,1.0,1,1.0,1,0.16881391906153134,40
2860,1,8777,2091,6686,0,0,0,1.0,1,1.0,1,1.0,1,0.14720893744824445,40
2861,1,8778,2092,6686,0,0,0,1.0,1,1.0,1,1.0,1,0.1514105401640477,38
2862,1,8779,2093,6686,0,0,0,1.0,1,1.0,1,1.0,1,0.14400974415991233,38
2863,4,8783,2094,6689,0,0,0,1.0,1,1.0,1,1.0,1,0.15213071832097372,38
2864,1,8784,2095,6689,0,0,0,1.0,1,1.0,1,1.0,1,0.17058969306555397,36
2865,6,8790,2099,6691,0,0,0,1.0,1,1.0,1,1.0,1,0.22909780872375227,34
2866,2,8792,2101,6691,0,0,0,1.0,1,1.0,1,1.0,1,0.24296855740404671,31
2867,4,8796,2102,6694,0,0,0,1.0,1,1.0,1,1.0,1,0.2051574411552119,30
2868,3,8799,2104,6695,0,0,0,1.0,1,1.0,1,1.0,1,0.23846463977436302,27
2869,2,8801,2105,6696,0,0,0,1.0,1,1.0,1,1.0,1,0.24297807640377622,27
2870,2,8803,2107,6696,0,0,0,1.0,1,1.0,1,1.0,1,0.2582807196227572,25
2871,1,8804,2108,6696,0,0,0,1.0,1,1.0,1,1.0,1,0.2809928071682366,25
2872,2,8806,2109,6697,0,0,0,1.0,1,1.0,1,1.0,1,0.20170227642828617,23
2873,1,8807,2110,6697,0,0,0,1.0,1,1.0,1,1.0,1,0.28184689434502624,24
2874,0,8807,2110,6697,0,0,0,1.0,1,1.0,1,1.0,1,0.30072432165866264,24
2875,1,8808,2110,6698,0,0,0,1.0,1,1.0,1,1.0,1,0.3001960385617904,23
2876,1,8809,2111,6698,0,0,0,1.0,1,1.0,1,1.0,1,0.3203101959860114,24
2877,2,8811,2112,6699,0,0,0,1.0,1,1.0,1,1.0,1,0.3537840795179494,24
2878,1,8812,2113,6699,0,0,0,1.0,1,1.0,1,1.0,1,0.3569867035937953,24
2879,4,8816,2115,6701,0,0,0,1.0,1,1.0,1,1.0,1,0.37360582085153904,25
2880,1,8817,2115,6702,0,0,0,1.0,1,1.0,1,1.0,1,0.3816508698654536,26
2881,5,8822,2115,6707,0,0,0,1.0,1,1.0,1,1.0,1,0.2763927868703877,26
2882,1,8823,2115,6708,0,0,0,1.0,1,1.0,1,1.0,1,0.22718277880214563,27
2883,2,8825,2115,6710,0,0,0,1.0,1,1.0,1,1.0,1,0.20885445958978827,28
2884,2,8827,2115,6712,0,0,0,1.0,1,1.0,1,1.0,1,0.1895624203896349,29
2885,3,8830,2115,6715,0,0,0,1.0,1,1.0,1,1.0,1,0.1763913543845468,31
2886,2,8832,2115,6717,0,0,0,1.0,1,1.0,1,1.0,1,0.1763913543845468,31
2887,5,8837,2115,6722,0,0,0,1.0,1,1.0,1,1.0,1,0.17418381291229015,33
2888,6,8843,2117,6726,0,0,0,1.0,1,1.0,1,1.0,1,0.19889397230827313,34
2889,4,8847,2117,6730,0,0,0,1.0,1,1.0,1,1.0,1,0.2052897231338239,35
2890,5,8852,2117,6735,0,0,0,1.0,1,1.0,1,1.0,1,0.19649505873829803,35
2891,8,8860,2118,6742,0,0,0,1.0,1,1.0,1,1.0,1,0.210883099285358,35
2892,5,8865,2119,6746,0,0,0,1.0,1,1.0,1,1.0,1,0.23605026637192164,35
2893,7,8872,2119,6753,0,0,0,1.0,1,1.0,1,1.0,1,0.25385518505407534,37
2894,5,8877,2119,6758,0,0,0,1.0,1,1.0,1,1.0,1,0.24279312445158605,37
2895,5,8882,2120,6762,0,0,0,1.0,1,1.0,1,1.0,1,0.24807323703854833,37
2896,2,8884,2120,6764,0,0,0,1.0,1,1.0,1,1.0,1,0.23599605272088836,38
2897,0,8884,2120,6764,0,0,0,1.0,1,1.0,1,1.0,1,0.2714047870890848,37
2898,0,8884,2120,6764,0,0,0,1.0,1,1.0,1,1.0,1,0.28068194742508135,38
2899,1,8885,2120,6765,0,0,0,1.0,1,1.0,1,1.0,1,0.24188935411853707,37
2900,0,8885,2120,6765,0,0,0,1.0,1,1.0,1,1.0,1,0.2509912658871454,36
2901,0,8885,2120,6765,0,0,0,1.0,1,1.0,1,1.0,1,0.24443563536970037,37
2902,1,8886,2121,6765,0,0,0,1.0,1,1.0,1,1.0,1,0.2653224167540955,35
2903,0,8886,2121,6765,0,0,0,1.0,1,1.0,1,1.0,1,0.2557545570125829,35
2904,0,8886,2121,6765,0,0,0,1.0,1,1.0,1,1.0,1,0.27059870530880564,33
2905,2,8888,2121,6767,0,0,0,1.0,1,1.0,1,1.0,1,0.25537187680844775,34
2906,2,8890,2122,6768,0,0,0,1.0,1,1.0,1,1.0,1,0.24114700560524058,34
2907,1,8891,2122,6769,0,0,0,1.0,1,1.0,1,1.0,1,0.21581379097059422,35
2908,0,8891,2122,6769,0,0,0,1.0,1,1.0,1,1.0,1,0.211811521389489,36
2909,0,8891,2122,6769,0,0,0,1.0,1,1.0,1,1.0,1,0.21056878663343928,38
2910,0,8891,2122,6769,0,0,0,1.0,1,1.0,1,1.0,1,0.21056878663343928,38
2911,5,8896,2123,6773,0,0,0,1.0,1,1.0,1,1.0,1,0.15999533037610816,37
2912,0,8896,2123,6773,0,0,0,1.0,1,1.0,1,1.0,1,0.15999533037610816,37
2913,0,8896,2123,6773,0,0,0,1.0,1,1.0,1,1.0,1,0.1661322677256936,38
2914,0,8896,2123,6773,0,0,0,1.0,1,1.0,1,1.0,1,0.1661322677256936,38
2915,3,8899,2123,6776,0,0,0,1.0,1,1.0,1,1.0,1,0.11513327544957329,39
2916,1,8900,2123,6777,0,0,0,1.0,1,1.0,1,1.0,1,0.13864035137868075,40
2917,1,8901,2123,6778,0,0,0,1.0,1,1.0,1,1.0,1,0.13739180654951597,41
2918,0,8901,2123,6778,0,0,0,1.0,1,1.0,1,1.0,1,0.15239560179370654,41
2919,1,8902,2123,6779,0,0,0,1.0,1,1.0,1,1.0,1,0.16664142088058637,41
2920,1,8903,2123,6780,0,0,0,1.0,1,1.0,1,1.0,1,0.1687571677784696,43
2921,0,8903,2123,6780,0,0,0,1.0,1,1.0,1,1.0,1,0.18340994696439453,42
2922,3,8906,2124,6782,0,0,0,1.0,1,1.0,1,1.0,1,0.1799584665719685,43
2923,2,8908,2124,6784,0,0,0,1.0,1,1.0,1,1.0,1,0.16587503218419453,44
2924,2,8910,2124,6786,0,0,0,1.0,1,1.0,1,1.0,1,0.1748431941290057,45
2925,4,8914,2124,6790,0,0,0,1.0,1,1.0,1,1.0,1,0.17173613184478143,45
2926,5,8919,2124,6795,0,0,0,1.0,1,1.0,1,1.0,1,0.10143501525945081,47
2927,2,8921,2124,6797,0,0,0,1.0,1,1.0,1,1.0,1,0.10143501525945081,47
2928,4,8925,2124,6801,0,0,0,1.0,1,1.0,1,1.0,1,0.07533476767681407,48
2929,5,8930,2125,6805,0,0,0,1.0,1,1.0,1,1.0,1,0.09005439137838858,48
2930,2,8932,2125,6807,0,0,0,1.0,1,1.0,1,1.0,1,0.10283319978078087,50
2931,0,8932,2125,6807,0,0,0,1.0,1,1.0,1,1.0,1,0.11435714487479977,51
2932,1,8933,2125,6808,0,0,0,1.0,1,1.0,1,1.0,1,0.12118602923152988,51
2933,2,8935,2126,6809,0,0,0,1.0,1,1.0,1,1.0,1,0.13949049467599953,52
2934,2,8937,2127,6810,0,0,0,1.0,1,1.0,1,1.0,1,0.13910411370768588,52
2935,0,8937,2127,6810,0,0,0,1.0,1,1.0,1,1.0,1,0.1513522340747074,51
2936,0,8937,2127,6810,0,0,0,1.0,1,1.0,1,1.0,1,0.153676840173901,49
2937,1,8938,2127,6811,0,0,0,1.0,1,1.0,1,1.0,1,0.14769578428918603,50
2938,2,8940,2128,6812,0,0,0,1.0,1,1.0,1,1.0,1,0.15123810948803929,50
2939,1,8941,2128,6813,0,0,0,1.0,1,1.0,1,1.0,1,0.16380047653140817,51
2940,3,8944,2128,6816,0,0,0,1.0,1,1.0,1,1.0,1,0.17793634332470712,52
2941,10,8954,2131,6823,0,0,0,1.0,1,1.0,1,1.0,1,0.16087912231878485,53
2942,4,8958,2133,6825,0,0,0,1.0,1,1.0,1,1.0,1,0.1326796064509554,52
2943,2,8960,2134,6826,0,0,0,1.0,1,1.0,1,1.0,1,0.15168623129896483,51
2944,5,8965,2136,6829,0,0,0,1.0,1,1.0,1,1.0,1,0.16653492955101795,52
2945,5,8970,2137,6833,0,0,0,1.0,1,1.0,1,1.0,1,0.17192184547828163,50
2946,4,8974,2139,6835,0,0,0,1.0,1,1.0,1,1.0,1,0.1833848056409874,51
2947,7,8981,2141,6840,0,0,0,1.0,1,1.0,1,1.0,1,0.15618774647746622,50
2948,7,8988,2143,6845,0,0,0,1.0,1,1.0,1,1.0,1,0.16999137265279102,50
2949,1,8989,2143,6846,0,0,0,1.0,1,1.0,1,1.0,1,0.18022469073751232,49
2950,0,8989,2143,6846,0,0,0,1.0,1,1.0,1,1.0,1,0.18536955036026845,48
2951,3,8992,2144,6848,0,0,0,1.0,1,1.0,1,1.0,1,0.17675626273610093,48
2952,0,8992,2144,6848,0,0,0,1.0,1,1.0,1,1.0,1,0.2072451425476533,46
2953,2,8994,2146,6848,0,0,0,1.0,1,1.0,1,1.0,1,0.18511984400790377,46
2954,1,8995,2146,6849,0,0,0,1.0,1,1.0,1,1.0,1,0.1405377580056893,48
2955,0,8995,2146,6849,0,0,0,1.0,1,1.0,1,1.0,1,0.1405377580056893,48
2956,6,9001,2147,6854,0,0,0,1.0,1,1.0,1,1.0,1,0.10330453435285603,47
2957,4,9005,2148,6857,0,0,0,1.0,1,1.0,1,1.0,1,0.0964889935184906,48
2958,4,9009,2150,6859,0,0,0,1.0,1,1.0,1,1.0,1,0.14357466009365785,49
2959,6,9015,2151,6864,0,0,0,1.0,1,1.0,1,1.0,1,0.12827816961400862,49
2960,4,9019,2152,6867,0,0,0,1.0,1,1.0,1,1.0,1,0.14389731471720332,49
2961,3,9022,2153,6869,0,0,0,1.0,1,1.0,1,1.0,1,0.160762110082269,51
2962,1,9023,2153,6870,0,0,0,1.0,1,1.0,1,1.0,1,0.14608158640396188,51
2963,2,9025,2153,6872,0,0,0,1.0,1,1.0,1,1.0,1,0.16140307490716657,51
2964,2,9027,2153,6874,0,0,0,1.0,1,1.0,1,1.0,1,0.15273022004336778,52
2965,6,9033,2153,6880,0,0,0,1.0,1,1.0,1,1.0,1,0.1775835051311023,53
2966,6,9039,2154,6885,0,0,0,1.0,1,1.0,1,1.0,1,0.18064239404886318,53
2967,6,9045,2155,6890,0,0,0,1.0,1,1.0,1,1.0,1,0.21187932738772047,53
2968,7,9052,2155,6897,0,0,0,1.0,1,1.0,1,1.0,1,0.22219656363966667,54
2969,9,9061,2155,6906,0,0,0,1.0,1,1.0,1,1.0,1,0.18389375730644947,55
2970,4,9065,2155,6910,0,0,0,1.0,1,1.0,1,1.0,1,0.17111247494433626,55
2971,6,9071,2155,6916,0,0,0,1.0,1,1.0,1,1.0,1,0.09379708157878738,55
2972,1,9072,2156,6916,0,0,0,1.0,1,1.0,1,1.0,1,0.08201980351115422,55
2973,1,9073,2156,6917,0,0,0,1.0,1,1.0,1,1.0,1,0.09534083153081038,55
2974,4,9077,2157,6920,0,0,0,1.0,1,1.0,1,1.0,1,0.0925264447351946,56
2975,0,9077,2157,6920,0,0,0,1.0,1,1.0,1,1.0,1,0.09904252986497204,55
2976,0,9077,2157,6920,0,0,0,1.0,1,1.0,1,1.0,1,0.10145478804101177,57
2977,2,9079,2157,6922,0,0,0,1.0,1,1.0,1,1.0,1,0.12440411479904688,59
2978,3,9082,2158,6924,0,0,0,1.0,1,1.0,1,1.0,1,0.10882417278075653,59
2979,2,9084,2158,6926,0,0,0,1.0,1,1.0,1,1.0,1,0.09993498444741448,59
2980,3,9087,2159,6928,0,0,0,1.0,1,1.0,1,1.0,1,0.0924981426490534,59
2981,4,9091,2159,6932,0,0,0,1.0,1,1.0,1,1.0,1,0.08780079972608168,59
2982,6,9097,2160,6937,0,0,0,1.0,1,1.0,1,1.0,1,0.10315172224388156,61
2983,9,9106,2164,6942,0,0,0,1.0,1,1.0,1,1.0,1,0.12192151995886703,61
2984,5,9111,2166,6945,0,0,0,1.0,1,1.0,1,1.0,1,0.09633472770646712,61
2985,8,9119,2171,6948,0,0,0,1.0,1,1.0,1,1.0,1,0.15907904423672492,57
2986,7,9126,2172,6954,0,0,0,1.0,1,1.0,1,1.0,1,0.08061371862920308,58
2987,4,9130,2176,6954,0,0,0,1.0,1,1.0,1,1.0,1,0.11151429715987213,56
2988,4,9134,2177,6957,0,0,0,1.0,1,1.0,1,1.0,1,0.09827668232744483,55
2989,3,9137,2179,6958,0,0,0,1.0,1,1.0,1,1.0,1,0.1091365362458104,53
2990,4,9141,2182,6959,0,0,0,1.0,1,1.0,1,1.0,1,0.12889761167428013,52
2991,1,9142,2182,6960,0,0,0,1.0,1,1.0,1,1.0,1,0.16829090497406404,54
2992,4,9146,2183,6963,0,0,0,1.0,1,1.0,1,1.0,1,0.17603729454782724,55
2993,4,9150,2185,6965,0,0,0,1.0,1,1.0,1,1.0,1,0.15735351981009724,53
2994,5,9155,2187,6968,0,0,0,1.0,1,1.0,1,1.0,1,0.18278243399242095,53
2995,3,9158,2187,6971,0,0,0,1.0,1,1.0,1,1.0,1,0.21513785969145893,51
2996,5,9163,2188,6975,0,0,0,1.0,1,1.0,1,1.0,1,0.23251997660692864,52
2997,5,9168,2188,6980,0,0,0,1.0,1,1.0,1,1.0,1,0.22131469466587977,50
2998,2,9170,2189,6981,0,0,0,1.0,1,1.0,1,1.0,1,0.19842977956715502,51
2999,2,9172,2189,6983,0,0,0,1.0,1,1.0,1,1.0,1,0.22174807309802688,48
3000,3,9175,2189,6986,0,0,0,1.0,1,1.0,1,1.0,1,0.2172255695305421,48
3001,6,9181,2189,6992,0,0,0,1.0,1,1.0,1,1.0,1,0.10165547247752803,49
3002,0,9181,2189,6992,0,0,0,1.0,1,1.0,1,1.0,1,0.10903609068036707,50
3003,2,9183,2189,6994,0,0,0,1.0,1,1.0,1,1.0,1,0.05796330957604735,50
3004,3,9186,2189,6997,0,0,0,1.0,1,1.0,1,1.0,1,0.08435858520011502,51
3005,4,9190,2189,7001,0,0,0,1.0,1,1.0,1,1.0,1,0.09375235511487198,50
3006,2,9192,2189,7003,0,0,0,1.0,1,1.0,1,1.0,1,0.10222050249384279,51
3007,5,9197,2189,7008,0,0,0,1.0,1,1.0,1,1.0,1,0.1440072838101641,51
3008,8,9205,2190,7015,0,0,0,1.0,1,1.0,1,1.0,1,0.18825280568630037,53
3009,5,9210,2190,7020,0,0,0,1.0,1,1.0,1,1.0,1,0.22648738282765574,52
3010,5,9215,2191,7024,0,0,0,1.0,1,1.0,1,1.0,1,0.25978407878749266,52
3011,6,9221,2191,7030,0,0,0,1.0,1,1.0,1,1.0,1,0.2612527078842661,51
3012,11,9232,2193,7039,0,0,0,1.0,1,1.0,1,1.0,1,0.21131561382089198,54
3013,6,9238,2193,7045,0,0,0,1.0,1,1.0,1,1.0,1,0.23973929760559204,52
3014,5,9243,2194,7049,0,0,0,1.0,1,1.0,1,1.0,1,0.2507291839712754,51
3015,12,9255,2197,7058,0,0,0,1.0,1,1.0,1,1.0,1,0.24287567191316248,50
3016,10,9265,2200,7065,0,0,0,1.0,1,1.0,1,1.0,1,0.1958317243252664,50
3017,3,9268,2200,7068,0,0,0,1.0,1,1.0,1,1.0,1,0.15138280964300682,48
3018,4,9272,2202,7070,0,0,0,1.0,1,1.0,1,1.0,1,0.1255117678589592,48
3019,3,9275,2204,7071,0,0,0,1.0,1,1.0,1,1.0,1,0.1187723706520674,47
3020,2,9277,2205,7072,0,0,0,1.0,1,1.0,1,1.0,1,0.11041693228788423,47
3021,2,9279,2207,7072,0,0,0,1.0,1,1.0,1,1.0,1,0.10880726799579163,46
3022,4,9283,2211,7072,0,0,0,1.0,1,1.0,1,1.0,1,0.16203472965399632,45
3023,0,9283,2211,7072,0,0,0,1.0,1,1.0,1,1.0,1,0.11707681527459501,41
3024,5,9288,2214,7074,0,0,0,1.0,1,1.0,1,1.0,1,0.17646408208894815,43
3025,0,9288,2214,7074,0,0,0,1.0,1,1.0,1,1.0,1,0.16527866785235565,39
3026,3,9291,2216,7075,0,0,0,1.0,1,1.0,1,1.0,1,0.2136857998566264,38
3027,1,9292,2217,7075,0,0,0,1.0,1,1.0,1,1.0,1,0.2066641846624935,38
3028,2,9294,2219,7075,0,0,0,1.0,1,1.0,1,1.0,1,0.26344807746443033,38
3029,1,9295,2220,7075,0,0,0,1.0,1,1.0,1,1.0,1,0.24419948033688452,37
3030,2,9297,2221,7076,0,0,0,1.0,1,1.0,1,1.0,1,0.26762261199393167,38
3031,8,9305,2222,7083,0,0,0,1.0,1,1.0,1,1.0,1,0.169714130861442,39
3032,3,9308,2222,7086,0,0,0,1.0,1,1.0,1,1.0,1,0.2100661111710583,39
3033,2,9310,2222,7088,0,0,0,1.0,1,1.0,1,1.0,1,0.16502059937885796,39
3034,4,9314,2222,7092,0,0,0,1.0,1,1.0,1,1.0,1,0.15678819878170536,38
3035,5,9319,2223,7096,0,0,0,1.0,1,1.0,1,1.0,1,0.16382187663701425,39
3036,5,9324,2223,7101,0,0,0,1.0,1,1.0,1,1.0,1,0.19195199975992727,39
3037,4,9328,2223,7105,0,0,0,1.0,1,1.0,1,1.0,1,0.22450114837301027,39
3038,7,9335,2224,7111,0,0,0,1.0,1,1.0,1,1.0,1,0.21798106219840868,40
3039,7,9342,2226,7116,0,0,0,1.0,1,1.0,1,1.0,1,0.21693641440071051,41
3040,6,9348,2228,7120,0,0,0,1.0,1,1.0,1,1.0,1,0.23964515152259133,42
3041,8,9356,2229,7127,0,0,0,1.0,1,1.0,1,1.0,1,0.28667604286799603,43
3042,10,9366,2231,7135,0,0,0,1.0,1,1.0,1,1.0,1,0.23118972593739914,45
3043,13,9379,2232,7147,0,0,0,1.0,1,1.0,1,1.0,1,0.24623703228015234,45
3044,11,9390,2232,7158,0,0,0,1.0,1,1.0,1,1.0,1,0.26625238748870095,45
3045,9,9399,2232,7167,0,0,0,1.0,1,1.0,1,1.0,1,0.27970740952303075,45
3046,7,9406,2232,7174,0,0,0,1.0,1,1.0,1,1.0,1,0.12264813580922056,46
3047,3,9409,2232,7177,0,0,0,1.0,1,1.0,1,1.0,1,0.13322702808082212,46
3048,4,9413,2232,7181,0,0,0,1.0,1,1.0,1,1.0,1,0.11688978326024083,49
3049,4,9417,2233,7184,0,0,0,1.0,1,1.0,1,1.0,1,0.12851663127148544,50
3050,5,9422,2234,7188,0,0,0,1.0,1,1.0,1,1.0,1,0.13799152146035676,50
3051,8,9430,2234,7196,0,0,0,1.0,1,1.0,1,1.0,1,0.14709193130626674,50
3052,3,9433,2235,7198,0,0,0,1.0,1,1.0,1,1.0,1,0.16003802502773667,50
3053,4,9437,2236,7201,0,0,0,1.0,1,1.0,1,1.0,1,0.12534813409422446,49
3054,4,9441,2238,7203,0,0,0,1.0,1,1.0,1,1.0,1,0.1553305823858149,47
3055,4,9445,2240,7205,0,0,0,1.0,1,1.0,1,1.0,1,0.20690598793952852,48
3056,4,9449,2241,7208,0,0,0,1.0,1,1.0,1,1.0,1,0.23646569468863252,47
3057,6,9455,2243,7212,0,0,0,1.0,1,1.0,1,1.0,1,0.28054028867283975,48
3058,2,9457,2243,7214,0,0,0,1.0,1,1.0,1,1.0,1,0.28959463156153203,46
3059,2,9459,2243,7216,0,0,0,1.0,1,1.0,1,1.0,1,0.2520895774932052,44
3060,2,9461,2243,7218,0,0,0,1.0,1,1.0,1,1.0,1,0.2520438099446689,44
3061,4,9465,2243,7222,0,0,0,1.0,1,1.0,1,1.0,1,0.14692291052463002,42
3062,0,9465,2243,7222,0,0,0,1.0,1,1.0,1,1.0,1,0.14692291052463002,42
3063,1,9466,2244,7222,0,0,0,1.0,1,1.0,1,1.0,1,0.14554247432304437,41
3064,5,9471,2245,7226,0,0,0,1.0,1,1.0,1,1.0,1,0.11349626298672838,42
3065,4,9475,2246,7229,0,0,0,1.0,1,1.0,1,1.0,1,0.11227263002318538,40
3066,3,9478,2248,7230,0,0,0,1.0,1,1.0,1,1.0,1,0.11105416997391891,42
3067,1,9479,2249,7230,0,0,0,1.0,1,1.0,1,1.0,1,0.10585492666444489,40
3068,2,9481,2251,7230,0,0,0,1.0,1,1.0,1,1.0,1,0.12861440388236306,39
3069,0,9481,2251,7230,0,0,0,1.0,1,1.0,1,1.0,1,0.16370763679399994,38
3070,2,9483,2252,7231,0,0,0,1.0,1,1.0,1,1.0,1,0.14613382891994248,39
3071,0,9483,2252,7231,0,0,0,1.0,1,1.0,1,1.0,1,0.1713292202507892,39
3072,7,9490,2255,7235,0,0,0,1.0,1,1.0,1,1.0,1,0.2022077430210982,40
3073,3,9493,2255,7238,0,0,0,1.0,1,1.0,1,1.0,1,0.2340210974326242,38
3074,2,9495,2255,7240,0,0,0,1.0,1,1.0,1,1.0,1,0.21173952605724272,38
3075,3,9498,2256,7242,0,0,0,1.0,1,1.0,1,1.0,1,0.22240493153420365,41
3076,5,9503,2256,7247,0,0,0,1.0,1,1.0,1,1.0,1,0.11186453930022217,42
3077,4,9507,2258,7249,0,0,0,1.0,1,1.0,1,1.0,1,0.11866366042345529,42
3078,1,9508,2258,7250,0,0,0,1.0,1,1.0,1,1.0,1,0.12310717291654644,42
3079,4,9512,2258,7254,0,0,0,1.0,1,1.0,1,1.0,1,0.12310717291654644,42
3080,2,9514,2258,7256,0,0,0,1.0,1,1.0,1,1.0,1,0.11910443692970765,43
3081,4,9518,2258,7260,0,0,0,1.0,1,1.0,1,1.0,1,0.11933006094091285,44
3082,4,9522,2258,7264,0,0,0,1.0,1,1.0,1,1.0,1,0.1429758277826482,45
3083,7,9529,2259,7270,0,0,0,1.0,1,1.0,1,1.0,1,0.15977765997107737,45
3084,4,9533,2260,7273,0,0,0,1.0,1,1.0,1,1.0,1,0.1998143330663998,45
3085,10,9543,2261,7282,0,0,0,1.0,1,1.0,1,1.0,1,0.2860468217818595,46
3086,5,9548,2262,7286,0,0,0,1.0,1,1.0,1,1.0,1,0.25656136451924905,46
3087,8,9556,2263,7293,0,0,0,1.0,1,1.0,1,1.0,1,0.2560008466323824,47
3088,12,9568,2264,7304,0,0,0,1.0,1,1.0,1,1.0,1,0.24838754727565804,48
3089,6,9574,2264,7310,0,0,0,1.0,1,1.0,1,1.0,1,0.2954224094409788,46
3090,6,9580,2264,7316,0,0,0,1.0,1,1.0,1,1.0,1,0.2377087905486256,46
3091,5,9585,2264,7321,0,0,0,1.0,1,1.0,1,1.0,1,0.18487670113160146,46
3092,5,9590,2265,7325,0,0,0,1.0,1,1.0,1,1.0,1,0.15166033706062598,47
3093,4,9594,2266,7328,0,0,0,1.0,1,1.0,1,1.0,1,0.13340724805160964,47
3094,1,9595,2266,7329,0,0,0,1.0,1,1.0,1,1.0,1,0.15283844775973096,45
3095,1,9596,2266,7330,0,0,0,1.0,1,1.0,1,1.0,1,0.15100815658920777,46
3096,3,9599,2266,7333,0,0,0,1.0,1,1.0,1,1.0,1,0.13818760415804868,46
3097,2,9601,2268,7333,0,0,0,1.0,1,1.0,1,1.0,1,0.14408342593942336,47
3098,4,9605,2268,7337,0,0,0,1.0,1,1.0,1,1.0,1,0.14408342593942336,47
3099,3,9608,2268,7340,0,0,0,1.0,1,1.0,1,1.0,1,0.14049874660751463,47
3100,3,9611,2268,7343,0,0,0,1.0,1,1.0,1,1.0,1,0.1398645965936589,47
3101,2,9613,2268,7345,0,0,0,1.0,1,1.0,1,1.0,1,0.13129617504275692,48
3102,1,9614,2268,7346,0,0,0,1.0,1,1.0,1,1.0,1,0.12773297385774263,48
3103,4,9618,2269,7349,0,0,0,1.0,1,1.0,1,1.0,1,0.07904012818889766,49
3104,5,9623,2271,7352,0,0,0,1.0,1,1.0,1,1.0,1,0.08976363058115777,48
3105,3,9626,2272,7354,0,0,0,1.0,1,1.0,1,1.0,1,0.11198971877784182,45
3106,7,9633,2275,7358,0,0,0,1.0,1,1.0,1,1.0,1,0.14734198149014505,46
3107,2,9635,2275,7360,0,0,0,1.0,1,1.0,1,1.0,1,0.09782279842922596,44
3108,0,9635,2275,7360,0,0,0,1.0,1,1.0,1,1.0,1,0.09454098293351593,45
3109,0,9635,2275,7360,0,0,0,1.0,1,1.0,1,1.0,1,0.09952121889965311,44
3110,4,9639,2278,7361,0,0,0,1.0,1,1.0,1,1.0,1,0.1274943442140107,46
3111,4,9643,2279,7364,0,0,0,1.0,1,1.0,1,1.0,1,0.11950408079703019,46
3112,0,9643,2279,7364,0,0,0,1.0,1,1.0,1,1.0,1,0.1331115060363513,47
3113,1,9644,2280,7364,0,0,0,1.0,1,1.0,1,1.0,1,0.12333111790326938,48
3114,0,9644,2280,7364,0,0,0,1.0,1,1.0,1,1.0,1,0.13963613521402593,48
3115,5,9649,2280,7369,0,0,0,1.0,1,1.0,1,1.0,1,0.1266965355516932,49
3116,1,9650,2280,7370,0,0,0,1.0,1,1.0,1,1.0,1,0.16001507597332626,48
3117,3,9653,2280,7373,0,0,0,1.0,1,1.0,1,1.0,1,0.1649873660884926,49
3118,3,9656,2280,7376,0,0,0,1.0,1,1.0,1,1.0,1,0.19243532754203962,50
3119,3,9659,2280,7379,0,0,0,1.0,1,1.0,1,1.0,1,0.18092335565413487,50
3120,1,9660,2280,7380,0,0,0,1.0,1,1.0,1,1.0,1,0.19288580157359567,50
3121,8,9668,2281,7387,0,0,0,1.0,1,1.0,1,1.0,1,0.11050017759528664,50
3122,1,9669,2281,7388,0,0,0,1.0,1,1.0,1,1.0,1,0.1134136332489488,50
3123,1,9670,2282,7388,0,0,0,1.0,1,1.0,1,1.0,1,0.10999248602678806,51
3124,1,9671,2283,7388,0,0,0,1.0,1,1.0,1,1.0,1,0.13039914810312805,51
3125,1,9672,2283,7389,0,0,0,1.0,1,1.0,1,1.0,1,0.11873692715236676,51
3126,4,9676,2285,7391,0,0,0,1.0,1,1.0,1,1.0,1,0.13440314607613793,54
3127,2,9678,2286,7392,0,0,0,1.0,1,1.0,1,1.0,1,0.16159488303068856,53
3128,2,9680,2287,7393,0,0,0,1.0,1,1.0,1,1.0,1,0.14500220490234791,52
3129,2,9682,2288,7394,0,0,0,1.0,1,1.0,1,1.0,1,0.1559268970474989,51
3130,1,9683,2289,7394,0,0,0,1.0,1,1.0,1,1.0,1,0.1606288800520988,50
3131,1,9684,2290,7394,0,0,0,1.0,1,1.0,1,1.0,1,0.13844244269982028,50
3132,1,9685,2291,7394,0,0,0,1.0,1,1.0,1,1.0,1,0.1489694691032882,49
3133,3,9688,2292,7396,0,0,0,1.0,1,1.0,1,1.0,1,0.14603867471747198,49
3134,0,9688,2292,7396,0,0,0,1.0,1,1.0,1,1.0,1,0.16344618278855358,46
3135,2,9690,2294,7396,0,0,0,1.0,1,1.0,1,1.0,1,0.24001163034952122,47
3136,9,9699,2295,7404,0,0,0,1.0,1,1.0,1,1.0,1,0.10128358438637211,46
3137,5,9704,2296,7408,0,0,0,1.0,1,1.0,1,1.0,1,0.1179761608393441,49
3138,3,9707,2296,7411,0,0,0,1.0,1,1.0,1,1.0,1,0.13043883800250822,49
3139,7,9714,2298,7416,0,0,0,1.0,1,1.0,1,1.0,1,0.13616465232214187,50
3140,5,9719,2299,7420,0,0,0,1.0,1,1.0,1,1.0,1,0.18669681844032393,51
3141,3,9722,2299,7423,0,0,0,1.0,1,1.0,1,1.0,1,0.18781366432492885,50
3142,1,9723,2299,7424,0,0,0,1.0,1,1.0,1,1.0,1,0.19871787854515252,50
3143,5,9728,2300,7428,0,0,0,1.0,1,1.0,1,1.0,1,0.21338234971949424,49
3144,3,9731,2301,7430,0,0,0,1.0,1,1.0,1,1.0,1,0.236775710588153,49
3145,4,9735,2302,7433,0,0,0,1.0,1,1.0,1,1.0,1,0.27674346152793294,48
3146,5,9740,2303,7437,0,0,0,1.0,1,1.0,1,1.0,1,0.25539372661952636,49
3147,8,9748,2303,7445,0,0,0,1.0,1,1.0,1,1.0,1,0.2641201048752257,48
3148,9,9757,2303,7454,0,0,0,1.0,1,1.0,1,1.0,1,0.24869655983225147,48
3149,9,9766,2305,7461,0,0,0,1.0,1,1.0,1,1.0,1,0.22793902101307123,47
3150,2,9768,2305,7463,0,0,0,1.0,1,1.0,1,1.0,1,0.2269513540610343,47
3151,5,9773,2306,7467,0,0,0,1.0,1,1.0,1,1.0,1,0.17315793688932257,48
3152,2,9775,2306,7469,0,0,0,1.0,1,1.0,1,1.0,1,0.15754394229643792,47
3153,2,9777,2307,7470,0,0,0,1.0,1,1.0,1,1.0,1,0.1542520073985673,47
3154,4,9781,2308,7473,0,0,0,1.0,1,1.0,1,1.0,1,0.17973620762789658,48
3155,3,9784,2309,7475,0,0,0,1.0,1,1.0,1,1.0,1,0.19126362468748073,48
3156,3,9787,2309,7478,0,0,0,1.0,1,1.0,1,1.0,1,0.1561463759322819,48
3157,0,9787,2309,7478,0,0,0,1.0,1,1.0,1,1.0,1,0.18315844330290296,48
3158,3,9790,2310,7480,0,0,0,1.0,1,1.0,1,1.0,1,0.18769349620592146,48
3159,1,9791,2310,7481,0,0,0,1.0,1,1.0,1,1.0,1,0.1755205299308097,49
3160,7,9798,2310,7488,0,0,0,1.0,1,1.0,1,1.0,1,0.17472258994280113,51
3161,4,9802,2310,7492,0,0,0,1.0,1,1.0,1,1.0,1,0.16471837048452342,52
3162,4,9806,2310,7496,0,0,0,1.0,1,1.0,1,1.0,1,0.15943315091881202,51
3163,2,9808,2310,7498,0,0,0,1.0,1,1.0,1,1.0,1,0.14053616795531867,51
3164,3,9811,2310,7501,0,0,0,1.0,1,1.0,1,1.0,1,0.1528804385159718,52
3165,3,9814,2312,7502,0,0,0,1.0,1,1.0,1,1.0,1,0.15627565582663214,50
3166,8,9822,2313,7509,0,0,0,1.0,1,1.0,1,1.0,1,0.08472661990850515,50
3167,2,9824,2314,7510,0,0,0,1.0,1,1.0,1,1.0,1,0.08869269104137405,49
3168,0,9824,2314,7510,0,0,0,1.0,1,1.0,1,1.0,1,0.09553208101203682,47
3169,1,9825,2315,7510,0,0,0,1.0,1,1.0,1,1.0,1,0.10181387957396629,48
3170,0,9825,2315,7510,0,0,0,1.0,1,1.0,1,1.0,1,0.11026365145727023,47
3171,1,9826,2315,7511,0,0,0,1.0,1,1.0,1,1.0,1,0.1093219053969597,47
3172,3,9829,2316,7513,0,0,0,1.0,1,1.0,1,1.0,1,0.12920012097407724,46
3173,2,9831,2316,7515,0,0,0,1.0,1,1.0,1,1.0,1,0.10254213500806027,45
3174,3,9834,2317,7517,0,0,0,1.0,1,1.0,1,1.0,1,0.13305487429875962,43
3175,1,9835,2318,7517,0,0,0,1.0,1,1.0,1,1.0,1,0.132555458549606,43
3176,1,9836,2318,7518,0,0,0,1.0,1,1.0,1,1.0,1,0.12513523151209457,44
3177,1,9837,2319,7518,0,0,0,1.0,1,1.0,1,1.0,1,0.14492166658232689,44
3178,1,9838,2319,7519,0,0,0,1.0,1,1.0,1,1.0,1,0.14616729747820068,47
3179,7,9845,2322,7523,0,0,0,1.0,1,1.0,1,1.0,1,0.1538223754149887,48
3180,4,9849,2323,7526,0,0,0,1.0,1,1.0,1,1.0,1,0.137377011107486,48
3181,3,9852,2323,7529,0,0,0,1.0,1,1.0,1,1.0,1,0.09437271941489882,48
3182,4,9856,2325,7531,0,0,0,1.0,1,1.0,1,1.0,1,0.1541996253370329,51
3183,3,9859,2326,7533,0,0,0,1.0,1,1.0,1,1.0,1,0.12991975437708236,50
3184,2,9861,2328,7533,0,0,0,1.0,1,1.0,1,1.0,1,0.19487516985025177,50
3185,1,9862,2328,7534,0,0,0,1.0,1,1.0,1,1.0,1,0.17819918611187835,48
3186,3,9865,2329,7536,0,0,0,1.0,1,1.0,1,1.0,1,0.18590366293268307,48
3187,2,9867,2329,7538,0,0,0,1.0,1,1.0,1,1.0,1,0.18463856908338833,48
3188,5,9872,2330,7542,0,0,0,1.0,1,1.0,1,1.0,1,0.191807118071333,48
3189,4,9876,2330,7546,0,0,0,1.0,1,1.0,1,1.0,1,0.18876602403234022,49
3190,6,9882,2330,7552,0,0,0,1.0,1,1.0,1,1.0,1,0.17798075015132298,51
3191,3,9885,2331,7554,0,0,0,1.0,1,1.0,1,1.0,1,0.16954692098481602,52
3192,2,9887,2331,7556,0,0,0,1.0,1,1.0,1,1.0,1,0.15027581991194838,52
3193,2,9889,2331,7558,0,0,0,1.0,1,1.0,1,1.0,1,0.16772859803340515,52
3194,3,9892,2332,7560,0,0,0,1.0,1,1.0,1,1.0,1,0.1773503199289842,54
3195,2,9894,2332,7562,0,0,0,1.0,1,1.0,1,1.0,1,0.1773503199289842,54
3196,5,9899,2334,7565,0,0,0,1.0,1,1.0,1,1.0,1,0.12603614640190153,54
3197,0,9899,2334,7565,0,0,0,1.0,1,1.0,1,1.0,1,0.14915247866455889,54
3198,5,9904,2336,7568,0,0,0,1.0,1,1.0,1,1.0,1,0.13591022363081046,54
3199,3,9907,2336,7571,0,0,0,1.0,1,1.0,1,1.0,1,0.14166292218692528,56
3200,3,9910,2337,7573,0,0,0,1.0,1,1.0,1,1.0,1,0.18602745178714333,56
3201,5,9915,2337,7578,0,0,0,1.0,1,1.0,1,1.0,1,0.19674608808501964,56
3202,3,9918,2337,7581,0,0,0,1.0,1,1.0,1,1.0,1,0.16725722849216584,57
3203,5,9923,2337,7586,0,0,0,1.0,1,1.0,1,1.0,1,0.1919064785822011,56
3204,3,9926,2339,7587,0,0,0,1.0,1,1.0,1,1.0,1,0.2103651466991474,55
3205,4,9930,2339,7591,0,0,0,1.0,1,1.0,1,1.0,1,0.24095695041480433,54
3206,9,9939,2342,7597,0,0,0,1.0,1,1.0,1,1.0,1,0.2925680641547459,56
3207,9,9948,2343,7605,0,0,0,1.0,1,1.0,1,1.0,1,0.3155441295607787,54
3208,9,9957,2344,7613,0,0,0,1.0,1,1.0,1,1.0,1,0.28477010681569703,53
3209,4,9961,2344,7617,0,0,0,1.0,1,1.0,1,1.0,1,0.27745506570694034,54
3210,5,9966,2345,7621,0,0,0,1.0,1,1.0,1,1.0,1,0.2955306174360334,53
3211,12,9978,2346,7632,0,0,0,1.0,1,1.0,1,1.0,1,0.20282304822626707,53
3212,3,9981,2346,7635,0,0,0,1.0,1,1.0,1,1.0,1,0.19676251843102271,54
3213,3,9984,2346,7638,0,0,0,1.0,1,1.0,1,1.0,1,0.18909036818775696,54
3214,3,9987,2346,7641,0,0,0,1.0,1,1.0,1,1.0,1,0.20627089847880906,55
3215,3,9990,2346,7644,0,0,0,1.0,1,1.0,1,1.0,1,0.19520195238992666,55
3216,3,9993,2346,7647,0,0,0,1.0,1,1.0,1,1.0,1,0.18437636613970745,55
3217,5,9998,2349,7649,0,0,0,1.0,1,1.0,1,1.0,1,0.19244525575372007,54
3218,2,10000,2349,7651,0,0,0,1.0,1,1.0,1,1.0,1,0.18886542182001168,54
3219,6,10006,2349,7657,0,0,0,1.0,1,1.0,1,1.0,1,0.18523810299214957,55
3220,5,10011,2349,7662,0,0,0,1.0,1,1.0,1,1.0,1,0.16929554717128692,56
3221,6,10017,2349,7668,0,0,0,1.0,1,1.0,1,1.0,1,0.18083207916706864,57
3222,3,10020,2349,7671,0,0,0,1.0,1,1.0,1,1.0,1,0.17482012234380503,57
3223,7,10027,2350,7677,0,0,0,1.0,1,1.0,1,1.0,1,0.1914017468742178,56
3224,9,10036,2354,7682,0,0,0,1.0,1,1.0,1,1.0,1,0.21640487775935976,58
3225,8,10044,2355,7689,0,0,0,1.0,1,1.0,1,1.0,1,0.21970892302843778,55
3226,7,10051,2357,7694,0,0,0,1.0,1,1.0,1,1.0,1,0.14144647477396505,54
3227,0,10051,2357,7694,0,0,0,1.0,1,1.0,1,1.0,1,0.11789939505986066,53
3228,1,10052,2358,7694,0,0,0,1.0,1,1.0,1,1.0,1,0.14194723554308872,52
3229,6,10058,2362,7696,0,0,0,1.0,1,1.0,1,1.0,1,0.181411898743497,52
3230,4,10062,2363,7699,0,0,0,1.0,1,1.0,1,1.0,1,0.20433836458129426,50
3231,6,10068,2367,7701,0,0,0,1.0,1,1.0,1,1.0,1,0.2745105166966694,50
3232,4,10072,2367,7705,0,0,0,1.0,1,1.0,1,1.0,1,0.2764986889139022,50
3233,4,10076,2368,7708,0,0,0,1.0,1,1.0,1,1.0,1,0.2605792701762983,50
3234,5,10081,2370,7711,0,0,0,1.0,1,1.0,1,1.0,1,0.2950062925247172,49
3235,2,10083,2370,7713,0,0,0,1.0,1,1.0,1,1.0,1,0.29092454876196655,49
3236,5,10088,2370,7718,0,0,0,1.0,1,1.0,1,1.0,1,0.2971572996296945,51
3237,7,10095,2372,7723,0,0,0,1.0,1,1.0,1,1.0,1,0.2973299895203039,53
3238,8,10103,2372,7731,0,0,0,1.0,1,1.0,1,1.0,1,0.31497725785145786,53
3239,10,10113,2372,7741,0,0,0,1.0,1,1.0,1,1.0,1,0.3148025507423717,53
3240,6,10119,2372,7747,0,0,0,1.0,1,1.0,1,1.0,1,0.3320832589766798,53
3241,14,10133,2372,7761,0,0,0,1.0,1,1.0,1,1.0,1,0.21620897671977402,53
3242,1,10134,2372,7762,0,0,0,1.0,1,1.0,1,1.0,1,0.20127732516670513,53
3243,6,10140,2372,7768,0,0,0,1.0,1,1.0,1,1.0,1,0.17529520393444428,56
3244,4,10144,2372,7772,0,0,0,1.0,1,1.0,1,1.0,1,0.19850339127198377,57
3245,3,10147,2372,7775,0,0,0,1.0,1,1.0,1,1.0,1,0.17823604676743884,59
3246,3,10150,2372,7778,0,0,0,1.0,1,1.0,1,1.0,1,0.15663324301928186,59
3247,3,10153,2372,7781,0,0,0,1.0,1,1.0,1,1.0,1,0.16848139792977163,59
3248,15,10168,2373,7795,0,0,0,1.0,1,1.0,1,1.0,1,0.192530505614888,59
3249,5,10173,2373,7800,0,0,0,1.0,1,1.0,1,1.0,1,0.16585046494032482,58
3250,6,10179,2373,7806,0,0,0,1.0,1,1.0,1,1.0,1,0.17128722817300104,58
3251,5,10184,2374,7810,0,0,0,1.0,1,1.0,1,1.0,1,0.1864173881944888,57
3252,6,10190,2374,7816,0,0,0,1.0,1,1.0,1,1.0,1,0.20838992271878826,57
3253,5,10195,2374,7821,0,0,0,1.0,1,1.0,1,1.0,1,0.18474172798923122,56
3254,8,10203,2375,7828,0,0,0,1.0,1,1.0,1,1.0,1,0.20797457849923645,57
3255,8,10211,2376,7835,0,0,0,1.0,1,1.0,1,1.0,1,0.17171811632954084,57
3256,3,10214,2376,7838,0,0,0,1.0,1,1.0,1,1.0,1,0.14368649580323353,57
3257,2,10216,2376,7840,0,0,0,1.0,1,1.0,1,1.0,1,0.1188572768590107,57
3258,2,10218,2376,7842,0,0,0,1.0,1,1.0,1,1.0,1,0.11734049369857089,58
3259,1,10219,2377,7842,0,0,0,1.0,1,1.0,1,1.0,1,0.11384779307366096,59
3260,2,10221,2377,7844,0,0,0,1.0,1,1.0,1,1.0,1,0.09770651661429429,60
3261,5,10226,2380,7846,0,0,0,1.0,1,1.0,1,1.0,1,0.1312210851075238,60
3262,6,10232,2384,7848,0,0,0,1.0,1,1.0,1,1.0,1,0.16720447261835222,61
3263,2,10234,2385,7849,0,0,0,1.0,1,1.0,1,1.0,1,0.13283853449057517,62
3264,2,10236,2386,7850,0,0,0,1.0,1,1.0,1,1.0,1,0.13034152724760262,60
3265,3,10239,2387,7852,0,0,0,1.0,1,1.0,1,1.0,1,0.10825685940057052,58
3266,8,10247,2391,7856,0,0,0,1.0,1,1.0,1,1.0,1,0.14762536760015765,59
3267,4,10251,2394,7857,0,0,0,1.0,1,1.0,1,1.0,1,0.16692810603123817,60
3268,4,10255,2397,7858,0,0,0,1.0,1,1.0,1,1.0,1,0.15394327572197705,58
3269,2,10257,2398,7859,0,0,0,1.0,1,1.0,1,1.0,1,0.12413726911482803,57
3270,2,10259,2399,7860,0,0,0,1.0,1,1.0,1,1.0,1,0.0652900748507317,56
3271,0,10259,2399,7860,0,0,0,1.0,1,1.0,1,1.0,1,0.05385826357809807,55
3272,0,10259,2399,7860,0,0,0,1.0,1,1.0,1,1.0,1,0.053613958647874875,55
3273,1,10260,2400,7860,0,0,0,1.0,1,1.0,1,1.0,1,0.08063705832357922,55
3274,1,10261,2400,7861,0,0,0,1.0,1,1.0,1,1.0,1,0.07526431933492891,55
3275,1,10262,2401,7861,0,0,0,1.0,1,1.0,1,1.0,1,0.08102953431570255,55
3276,2,10264,2401,7863,0,0,0,1.0,1,1.0,1,1.0,1,0.08355540790956871,55
3277,3,10267,2402,7865,0,0,0,1.0,1,1.0,1,1.0,1,0.0583402720597192,57
3278,1,10268,2402,7866,0,0,0,1.0,1,1.0,1,1.0,1,0.08148586871749845,56
3279,1,10269,2403,7866,0,0,0,1.0,1,1.0,1,1.0,1,0.07442205850199836,54
3280,0,10269,2403,7866,0,0,0,1.0,1,1.0,1,1.0,1,0.07966041818780148,53
3281,4,10273,2405,7868,0,0,0,1.0,1,1.0,1,1.0,1,0.10335065325967749,52
3282,0,10273,2405,7868,0,0,0,1.0,1,1.0,1,1.0,1,0.1434350010352525,50
3283,2,10275,2407,7868,0,0,0,1.0,1,1.0,1,1.0,1,0.1300308951246505,50
3284,3,10278,2410,7868,0,0,0,1.0,1,1.0,1,1.0,1,0.23641966748332663,47
3285,0,10278,2410,7868,0,0,0,1.0,1,1.0,1,1.0,1,0.22345132967895645,48
3286,9,10287,2411,7876,0,0,0,1.0,1,1.0,1,1.0,1,0.14408575169796484,46
3287,5,10292,2414,7878,0,0,0,1.0,1,1.0,1,1.0,1,0.1718695086480149,46
3288,7,10299,2417,7882,0,0,0,1.0,1,1.0,1,1.0,1,0.229247245169765,46
3289,5,10304,2418,7886,0,0,0,1.0,1,1.0,1,1.0,1,0.18198403938046329,48
3290,2,10306,2419,7887,0,0,0,1.0,1,1.0,1,1.0,1,0.19297294595933112,48
3291,4,10310,2421,7889,0,0,0,1.0,1,1.0,1,1.0,1,0.18008334681844762,50
3292,5,10315,2423,7892,0,0,0,1.0,1,1.0,1,1.0,1,0.27131344347075653,50
3293,6,10321,2423,7898,0,0,0,1.0,1,1.0,1,1.0,1,0.23371960237152864,51
3294,4,10325,2423,7902,0,0,0,1.0,1,1.0,1,1.0,1,0.19552491201847128,50
3295,7,10332,2424,7908,0,0,0,1.0,1,1.0,1,1.0,1,0.23460350232825747,50
3296,5,10337,2424,7913,0,0,0,1.0,1,1.0,1,1.0,1,0.24630059006485822,50
3297,7,10344,2426,7918,0,0,0,1.0,1,1.0,1,1.0,1,0.1954049238487712,51
3298,5,10349,2428,7921,0,0,0,1.0,1,1.0,1,1.0,1,0.2438060089867172,52
3299,6,10355,2429,7926,0,0,0,1.0,1,1.0,1,1.0,1,0.19833723493238622,53
3300,7,10362,2429,7933,0,0,0,1.0,1,1.0,1,1.0,1,0.2525086608056712,53
3301,10,10372,2429,7943,0,0,0,1.0,1,1.0,1,1.0,1,0.09968431921178623,53
3302,8,10380,2433,7947,0,0,0,1.0,1,1.0,1,1.0,1,0.10517615300871876,53
3303,5,10385,2433,7952,0,0,0,1.0,1,1.0,1,1.0,1,0.09837431789829516,52
3304,8,10393,2434,7959,0,0,0,1.0,1,1.0,1,1.0,1,0.1437030529317634,52
3305,6,10399,2436,7963,0,0,0,1.0,1,1.0,1,1.0,1,0.1544994029611247,51
3306,7,10406,2436,7970,0,0,0,1.0,1,1.0,1,1.0,1,0.17904727173175866,51
3307,7,10413,2436,7977,0,0,0,1.0,1,1.0,1,1.0,1,0.168022617432968,48
3308,6,10419,2438,7981,0,0,0,1.0,1,1.0,1,1.0,1,0.203012434891147,48
3309,6,10425,2438,7987,0,0,0,1.0,1,1.0,1,1.0,1,0.18982734853615538,48
3310,7,10432,2438,7994,0,0,0,1.0,1,1.0,1,1.0,1,0.22542534998077332,47
3311,4,10436,2438,7998,0,0,0,1.0,1,1.0,1,1.0,1,0.2695176056412115,49
3312,5,10441,2438,8003,0,0,0,1.0,1,1.0,1,1.0,1,0.23658374553056152,48
3313,13,10454,2441,8013,0,0,0,1.0,1,1.0,1,1.0,1,0.26300200087656117,49
3314,10,10464,2441,8023,0,0,0,1.0,1,1.0,1,1.0,1,0.28016036844596975,47
3315,16,10480,2443,8037,0,0,0,1.0,1,1.0,1,1.0,1,0.31465631260028937,47
3316,8,10488,2443,8045,0,0,0,1.0,1,1.0,1,1.0,1,0.20116494950320582,47
3317,3,10491,2443,8048,0,0,0,1.0,1,1.0,1,1.0,1,0.16285145092021286,46
3318,4,10495,2444,8051,0,0,0,1.0,1,1.0,1,1.0,1,0.16462625556992705,45
3319,4,10499,2445,8054,0,0,0,1.0,1,1.0,1,1.0,1,0.16688677893697718,44
3320,4,10503,2446,8057,0,0,0,1.0,1,1.0,1,1.0,1,0.17232347347645446,43
3321,3,10506,2446,8060,0,0,0,1.0,1,1.0,1,1.0,1,0.14826644038806208,43
3322,2,10508,2447,8061,0,0,0,1.0,1,1.0,1,1.0,1,0.2290596322442494,40
3323,2,10510,2447,8063,0,0,0,1.0,1,1.0,1,1.0,1,0.2313267922565677,40
3324,4,10514,2448,8066,0,0,0,1.0,1,1.0,1,1.0,1,0.1874810687201875,40
3325,7,10521,2450,8071,0,0,0,1.0,1,1.0,1,1.0,1,0.22915159470189675,40
3326,3,10524,2451,8073,0,0,0,1.0,1,1.0,1,1.0,1,0.15419040549486063,41
3327,3,10527,2452,8075,0,0,0,1.0,1,1.0,1,1.0,1,0.16238307851263103,39
3328,6,10533,2454,8079,0,0,0,1.0,1,1.0,1,1.0,1,0.16954895398535677,41
3329,3,10536,2455,8081,0,0,0,1.0,1,1.0,1,1.0,1,0.1410526104820528,39
3330,2,10538,2456,8082,0,0,0,1.0,1,1.0,1,1.0,1,0.19221949497820187,40
3331,1,10539,2456,8083,0,0,0,1.0,1,1.0,1,1.0,1,0.1705424407608663,38
3332,1,10540,2456,8084,0,0,0,1.0,1,1.0,1,1.0,1,0.18969245881972527,38
3333,0,10540,2456,8084,0,0,0,1.0,1,1.0,1,1.0,1,0.18969245881972527,38
3334,0,10540,2456,8084,0,0,0,1.0,1,1.0,1,1.0,1,0.2033918055197685,40
3335,1,10541,2456,8085,0,0,0,1.0,1,1.0,1,1.0,1,0.15255753093454924,40
3336,0,10541,2456,8085,0,0,0,1.0,1,1.0,1,1.0,1,0.18687377842604913,39
3337,1,10542,2456,8086,0,0,0,1.0,1,1.0,1,1.0,1,0.1727168336394501,40
3338,2,10544,2458,8086,0,0,0,1.0,1,1.0,1,1.0,1,0.213156326722878,41
3339,3,10547,2459,8088,0,0,0,1.0,1,1.0,1,1.0,1,0.13227215902920106,42
3340,2,10549,2461,8088,0,0,0,1.0,1,1.0,1,1.0,1,0.16174736889864866,43
3341,3,10552,2461,8091,0,0,0,1.0,1,1.0,1,1.0,1,0.12745317017940289,43
3342,3,10555,2462,8093,0,0,0,1.0,1,1.0,1,1.0,1,0.16010023851298402,44
3343,2,10557,2464,8093,0,0,0,1.0,1,1.0,1,1.0,1,0.14249338312898185,44
3344,4,10561,2466,8095,0,0,0,1.0,1,1.0,1,1.0,1,0.1800469903370276,44
3345,4,10565,2466,8099,0,0,0,1.0,1,1.0,1,1.0,1,0.18246005194473036,43
3346,0,10565,2466,8099,0,0,0,1.0,1,1.0,1,1.0,1,0.2063874119020739,42
3347,1,10566,2466,8100,0,0,0,1.0,1,1.0,1,1.0,1,0.1807681082067888,44
3348,2,10568,2466,8102,0,0,0,1.0,1,1.0,1,1.0,1,0.17813834696997266,45
3349,1,10569,2467,8102,0,0,0,1.0,1,1.0,1,1.0,1,0.17537891003505723,45
3350,0,10569,2467,8102,0,0,0,1.0,1,1.0,1,1.0,1,0.15571930653475458,46
3351,3,10572,2468,8104,0,0,0,1.0,1,1.0,1,1.0,1,0.13625544819627827,47
3352,2,10574,2468,8106,0,0,0,1.0,1,1.0,1,1.0,1,0.1306453599975086,47
3353,4,10578,2469,8109,0,0,0,1.0,1,1.0,1,1.0,1,0.12865583595738908,48
3354,2,10580,2470,8110,0,0,0,1.0,1,1.0,1,1.0,1,0.1293535112571358,48
3355,4,10584,2471,8113,0,0,0,1.0,1,1.0,1,1.0,1,0.1133611172188836,48
3356,3,10587,2472,8115,0,0,0,1.0,1,1.0,1,1.0,1,0.09865291154434948,48
3357,2,10589,2472,8117,0,0,0,1.0,1,1.0,1,1.0,1,0.08264523375796064,47
3358,2,10591,2474,8117,0,0,0,1.0,1,1.0,1,1.0,1,0.13603857605923084,46
3359,4,10595,2476,8119,0,0,0,1.0,1,1.0,1,1.0,1,0.14504942075478153,45
3360,0,10595,2476,8119,0,0,0,1.0,1,1.0,1,1.0,1,0.13464799796953203,44
3361,1,10596,2476,8120,0,0,0,1.0,1,1.0,1,1.0,1,0.11022622729458825,43
3362,3,10599,2478,8121,0,0,0,1.0,1,1.0,1,1.0,1,0.1631037001654394,42
3363,1,10600,2479,8121,0,0,0,1.0,1,1.0,1,1.0,1,0.18452968786617047,41
3364,0,10600,2479,8121,0,0,0,1.0,1,1.0,1,1.0,1,0.22229348794158865,41
3365,1,10601,2480,8121,0,0,0,1.0,1,1.0,1,1.0,1,0.267914519807787,41
3366,4,10605,2480,8125,0,0,0,1.0,1,1.0,1,1.0,1,0.2123514150388149,40
3367,1,10606,2481,8125,0,0,0,1.0,1,1.0,1,1.0,1,0.18729932781053285,39
3368,0,10606,2481,8125,0,0,0,1.0,1,1.0,1,1.0,1,0.18729932781053285,39
3369,0,10606,2481,8125,0,0,0,1.0,1,1.0,1,1.0,1,0.18635759519125292,40
3370,2,10608,2483,8125,0,0,0,1.0,1,1.0,1,1.0,1,0.23621282095374885,41
3371,1,10609,2484,8125,0,0,0,1.0,1,1.0,1,1.0,1,0.22266748929784314,41
3372,3,10612,2486,8126,0,0,0,1.0,1,1.0,1,1.0,1,0.23426541157426747,40
3373,0,10612,2486,8126,0,0,0,1.0,1,1.0,1,1.0,1,0.2426118389406967,41
3374,2,10614,2486,8128,0,0,0,1.0,1,1.0,1,1.0,1,0.230979643589787,42
3375,1,10615,2486,8129,0,0,0,1.0,1,1.0,1,1.0,1,0.23128425157439517,44
3376,8,10623,2486,8137,0,0,0,1.0,1,1.0,1,1.0,1,0.10034151321612868,46
3377,2,10625,2486,8139,0,0,0,1.0,1,1.0,1,1.0,1,0.0993229821381938,47
3378,2,10627,2487,8140,0,0,0,1.0,1,1.0,1,1.0,1,0.11405045056207486,48
3379,1,10628,2487,8141,0,0,0,1.0,1,1.0,1,1.0,1,0.12235479020297614,48
3380,3,10631,2489,8142,0,0,0,1.0,1,1.0,1,1.0,1,0.15737691860923184,48
3381,2,10633,2489,8144,0,0,0,1.0,1,1.0,1,1.0,1,0.10628266168420833,48
3382,2,10635,2490,8145,0,0,0,1.0,1,1.0,1,1.0,1,0.16580622386986102,49
3383,1,10636,2490,8146,0,0,0,1.0,1,1.0,1,1.0,1,0.13012020447809236,47
3384,3,10639,2491,8148,0,0,0,1.0,1,1.0,1,1.0,1,0.16902313037282451,48
3385,3,10642,2491,8151,0,0,0,1.0,1,1.0,1,1.0,1,0.13592879756709556,47
3386,8,10650,2493,8157,0,0,0,1.0,1,1.0,1,1.0,1,0.1744834845822871,49
3387,4,10654,2493,8161,0,0,0,1.0,1,1.0,1,1.0,1,0.1370006319285991,48
3388,4,10658,2493,8165,0,0,0,1.0,1,1.0,1,1.0,1,0.13676673552516685,48
3389,2,10660,2493,8167,0,0,0,1.0,1,1.0,1,1.0,1,0.15952777718321845,50
3390,1,10661,2493,8168,0,0,0,1.0,1,1.0,1,1.0,1,0.14301167935437623,51
3391,1,10662,2493,8169,0,0,0,1.0,1,1.0,1,1.0,1,0.129610370831629,51
3392,1,10663,2493,8170,0,0,0,1.0,1,1.0,1,1.0,1,0.13713806790267483,52
3393,4,10667,2493,8174,0,0,0,1.0,1,1.0,1,1.0,1,0.10075814470845272,52
3394,1,10668,2493,8175,0,0,0,1.0,1,1.0,1,1.0,1,0.08101193898812084,52
3395,0,10668,2493,8175,0,0,0,1.0,1,1.0,1,1.0,1,0.11838693153579787,50
3396,0,10668,2493,8175,0,0,0,1.0,1,1.0,1,1.0,1,0.10936463683471283,49
3397,1,10669,2494,8175,0,0,0,1.0,1,1.0,1,1.0,1,0.10891478173648074,49
3398,2,10671,2495,8176,0,0,0,1.0,1,1.0,1,1.0,1,0.12456076363287989,48
3399,0,10671,2495,8176,0,0,0,1.0,1,1.0,1,1.0,1,0.11123213228657096,49
3400,1,10672,2496,8176,0,0,0,1.0,1,1.0,1,1.0,1,0.12590836950801215,50
3401,0,10672,2496,8176,0,0,0,1.0,1,1.0,1,1.0,1,0.12283749608485088,51
3402,1,10673,2497,8176,0,0,0,1.0,1,1.0,1,1.0,1,0.16223954506505386,51
3403,2,10675,2498,8177,0,0,0,1.0,1,1.0,1,1.0,1,0.13143875671662875,51
3404,1,10676,2498,8178,0,0,0,1.0,1,1.0,1,1.0,1,0.1248905613826881,51
3405,1,10677,2499,8178,0,0,0,1.0,1,1.0,1,1.0,1,0.12099228678831907,51
3406,1,10678,2499,8179,0,0,0,1.0,1,1.0,1,1.0,1,0.08451274297926926,51
3407,1,10679,2499,8180,0,0,0,1.0,1,1.0,1,1.0,1,0.08872347759189683,52
3408,0,10679,2499,8180,0,0,0,1.0,1,1.0,1,1.0,1,0.10293156447035574,53
3409,1,10680,2500,8180,0,0,0,1.0,1,1.0,1,1.0,1,0.10465738384354105,54
3410,5,10685,2503,8182,0,0,0,1.0,1,1.0,1,1.0,1,0.0978645566190372,54
3411,2,10687,2503,8184,0,0,0,1.0,1,1.0,1,1.0,1,0.11634524757893604,54
3412,3,10690,2504,8186,0,0,0,1.0,1,1.0,1,1.0,1,0.1348970761888392,55
3413,5,10695,2505,8190,0,0,0,1.0,1,1.0,1,1.0,1,0.15158773290980734,55
3414,3,10698,2505,8193,0,0,0,1.0,1,1.0,1,1.0,1,0.16070764150312605,55
3415,4,10702,2507,8195,0,0,0,1.0,1,1.0,1,1.0,1,0.1628342337141262,56
3416,2,10704,2507,8197,0,0,0,1.0,1,1.0,1,1.0,1,0.1564065192238497,55
3417,2,10706,2508,8198,0,0,0,1.0,1,1.0,1,1.0,1,0.16718167817174137,56
3418,4,10710,2511,8199,0,0,0,1.0,1,1.0,1,1.0,1,0.2305910803622464,55
3419,7,10717,2511,8206,0,0,0,1.0,1,1.0,1,1.0,1,0.21446230135234576,56
3420,6,10723,2512,8211,0,0,0,1.0,1,1.0,1,1.0,1,0.24231414282622438,55
3421,14,10737,2512,8225,0,0,0,1.0,1,1.0,1,1.0,1,0.1280132750627448,57
3422,2,10739,2512,8227,0,0,0,1.0,1,1.0,1,1.0,1,0.13949651996717874,56
3423,2,10741,2512,8229,0,0,0,1.0,1,1.0,1,1.0,1,0.13878950364029274,56
3424,3,10744,2512,8232,0,0,0,1.0,1,1.0,1,1.0,1,0.1498875538356205,56
3425,1,10745,2512,8233,0,0,0,1.0,1,1.0,1,1.0,1,0.14612542840706336,56
3426,2,10747,2513,8234,0,0,0,1.0,1,1.0,1,1.0,1,0.13548759576571162,55
3427,3,10750,2515,8235,0,0,0,1.0,1,1.0,1,1.0,1,0.173108881860462,55
3428,4,10754,2516,8238,0,0,0,1.0,1,1.0,1,1.0,1,0.16513206734699093,55
3429,2,10756,2516,8240,0,0,0,1.0,1,1.0,1,1.0,1,0.18575557544072488,54
3430,3,10759,2516,8243,0,0,0,1.0,1,1.0,1,1.0,1,0.15513656533411976,56
3431,2,10761,2516,8245,0,0,0,1.0,1,1.0,1,1.0,1,0.14512473234775555,54
3432,6,10767,2518,8249,0,0,0,1.0,1,1.0,1,1.0,1,0.14916841737993397,56
3433,3,10770,2519,8251,0,0,0,1.0,1,1.0,1,1.0,1,0.15535232180088066,53
3434,3,10773,2519,8254,0,0,0,1.0,1,1.0,1,1.0,1,0.17052956259288327,51
3435,5,10778,2520,8258,0,0,0,1.0,1,1.0,1,1.0,1,0.1588709914534383,51
3436,7,10785,2521,8264,0,0,0,1.0,1,1.0,1,1.0,1,0.06737766336092307,51
3437,1,10786,2521,8265,0,0,0,1.0,1,1.0,1,1.0,1,0.04997845168705751,53
3438,4,10790,2521,8269,0,0,0,1.0,1,1.0,1,1.0,1,0.04479754853704566,52
3439,5,10795,2522,8273,0,0,0,1.0,1,1.0,1,1.0,1,0.09783121813008933,54
3440,6,10801,2523,8278,0,0,0,1.0,1,1.0,1,1.0,1,0.11847150641745123,52
3441,6,10807,2523,8284,0,0,0,1.0,1,1.0,1,1.0,1,0.07299917147902961,53
3442,4,10811,2524,8287,0,0,0,1.0,1,1.0,1,1.0,1,0.09802716678212287,53
3443,2,10813,2524,8289,0,0,0,1.0,1,1.0,1,1.0,1,0.09576236352223284,53
3444,4,10817,2525,8292,0,0,0,1.0,1,1.0,1,1.0,1,0.12430669901923798,52
3445,7,10824,2526,8298,0,0,0,1.0,1,1.0,1,1.0,1,0.18868666795482653,53
3446,9,10833,2527,8306,0,0,0,1.0,1,1.0,1,1.0,1,0.22571495039344686,53
3447,10,10843,2528,8315,0,0,0,1.0,1,1.0,1,1.0,1,0.24019120904310973,53
3448,9,10852,2530,8322,0,0,0,1.0,1,1.0,1,1.0,1,0.2663403115615926,52
3449,6,10858,2530,8328,0,0,0,1.0,1,1.0,1,1.0,1,0.24144364300408686,52
3450,10,10868,2531,8337,0,0,0,1.0,1,1.0,1,1.0,1,0.22233896398600628,52
3451,11,10879,2534,8345,0,0,0,1.0,1,1.0,1,1.0,1,0.09095859775305555,54
3452,2,10881,2535,8346,0,0,0,1.0,1,1.0,1,1.0,1,0.09597824058751417,54
3453,1,10882,2535,8347,0,0,0,1.0,1,1.0,1,1.0,1,0.10400084402588056,54
3454,3,10885,2535,8350,0,0,0,1.0,1,1.0,1,1.0,1,0.10119346743025823,57
3455,3,10888,2536,8352,0,0,0,1.0,1,1.0,1,1.0,1,0.11829383611318599,57
3456,6,10894,2537,8357,0,0,0,1.0,1,1.0,1,1.0,1,0.11595491571328458,58
3457,1,10895,2537,8358,0,0,0,1.0,1,1.0,1,1.0,1,0.15005408459987607,57
3458,5,10900,2537,8363,0,0,0,1.0,1,1.0,1,1.0,1,0.14530158717182143,57
3459,2,10902,2537,8365,0,0,0,1.0,1,1.0,1,1.0,1,0.15123209870945942,57
3460,4,10906,2537,8369,0,0,0,1.0,1,1.0,1,1.0,1,0.1304125176110022,58
3461,5,10911,2537,8374,0,0,0,1.0,1,1.0,1,1.0,1,0.11384717854931167,59
3462,4,10915,2537,8378,0,0,0,1.0,1,1.0,1,1.0,1,0.11087205767503315,59
3463,4,10919,2539,8380,0,0,0,1.0,1,1.0,1,1.0,1,0.14441346914108819,59
3464,7,10926,2541,8385,0,0,0,1.0,1,1.0,1,1.0,1,0.15597376872927374,59
3465,6,10932,2543,8389,0,0,0,1.0,1,1.0,1,1.0,1,0.11148300418704524,57
3466,7,10939,2544,8395,0,0,0,1.0,1,1.0,1,1.0,1,0.08924409400342727,57
3467,6,10945,2545,8400,0,0,0,1.0,1,1.0,1,1.0,1,0.12535989560140673,57
3468,3,10948,2545,8403,0,0,0,1.0,1,1.0,1,1.0,1,0.08556114459075924,57
3469,3,10951,2546,8405,0,0,0,1.0,1,1.0,1,1.0,1,0.10108203200844741,53
3470,3,10954,2547,8407,0,0,0,1.0,1,1.0,1,1.0,1,0.17221228914897438,50
3471,0,10954,2547,8407,0,0,0,1.0,1,1.0,1,1.0,1,0.16431413306821552,49
3472,1,10955,2548,8407,0,0,0,1.0,1,1.0,1,1.0,1,0.1931461607373375,47
3473,6,10961,2552,8409,0,0,0,1.0,1,1.0,1,1.0,1,0.22320756964869162,45
3474,3,10964,2553,8411,0,0,0,1.0,1,1.0,1,1.0,1,0.26084200048824785,42
3475,8,10972,2556,8416,0,0,0,1.0,1,1.0,1,1.0,1,0.23572757384483153,43
3476,3,10975,2556,8419,0,0,0,1.0,1,1.0,1,1.0,1,0.26304174159194854,41
3477,5,10980,2559,8421,0,0,0,1.0,1,1.0,1,1.0,1,0.2360806601064497,42
3478,1,10981,2560,8421,0,0,0,1.0,1,1.0,1,1.0,1,0.28534209355484225,40
3479,4,10985,2562,8423,0,0,0,1.0,1,1.0,1,1.0,1,0.2889885946476048,40
3480,1,10986,2562,8424,0,0,0,1.0,1,1.0,1,1.0,1,0.29153471211570775,40
3481,8,10994,2562,8432,0,0,0,1.0,1,1.0,1,1.0,1,0.21045738780240272,40
3482,1,10995,2562,8433,0,0,0,1.0,1,1.0,1,1.0,1,0.1914371442286542,40
3483,5,11000,2563,8437,0,0,0,1.0,1,1.0,1,1.0,1,0.18610427260349,39
3484,2,11002,2563,8439,0,0,0,1.0,1,1.0,1,1.0,1,0.18610427260349,39
3485,4,11006,2564,8442,0,0,0,1.0,1,1.0,1,1.0,1,0.2251072100815759,40
3486,4,11010,2564,8446,0,0,0,1.0,1,1.0,1,1.0,1,0.21052685024839446,41
3487,3,11013,2565,8448,0,0,0,1.0,1,1.0,1,1.0,1,0.2471091021556738,41
3488,4,11017,2565,8452,0,0,0,1.0,1,1.0,1,1.0,1,0.2345846475117621,42
3489,5,11022,2565,8457,0,0,0,1.0,1,1.0,1,1.0,1,0.2171586099732372,44
3490,5,11027,2565,8462,0,0,0,1.0,1,1.0,1,1.0,1,0.23261159067202786,44
3491,7,11034,2566,8468,0,0,0,1.0,1,1.0,1,1.0,1,0.25254915292358127,45
3492,7,11041,2566,8475,0,0,0,1.0,1,1.0,1,1.0,1,0.23664101403736276,45
3493,7,11048,2566,8482,0,0,0,1.0,1,1.0,1,1.0,1,0.24938430678453885,45
3494,9,11057,2567,8490,0,0,0,1.0,1,1.0,1,1.0,1,0.2171822765201532,45
3495,7,11064,2568,8496,0,0,0,1.0,1,1.0,1,1.0,1,0.22927132929910587,45
3496,10,11074,2568,8506,0,0,0,1.0,1,1.0,1,1.0,1,0.16566513393044655,46
3497,4,11078,2569,8509,0,0,0,1.0,1,1.0,1,1.0,1,0.14052963622329345,47
3498,3,11081,2570,8511,0,0,0,1.0,1,1.0,1,1.0,1,0.18957676011185123,48
3499,2,11083,2570,8513,0,0,0,1.0,1,1.0,1,1.0,1,0.1848049693782161,47
3500,4,11087,2570,8517,0,0,0,1.0,1,1.0,1,1.0,1,0.21166061197885017,50
3501,6,11093,2570,8523,0,0,0,1.0,1,1.0,1,1.0,1,0.21166061197885017,50
3502,3,11096,2570,8526,0,0,0,1.0,1,1.0,1,1.0,1,0.20762413292625426,50
3503,10,11106,2572,8534,0,0,0,1.0,1,1.0,1,1.0,1,0.2241515421911222,50
3504,7,11113,2573,8540,0,0,0,1.0,1,1.0,1,1.0,1,0.2640804553017945,47
3505,5,11118,2574,8544,0,0,0,1.0,1,1.0,1,1.0,1,0.3046627613989469,48
3506,6,11124,2574,8550,0,0,0,1.0,1,1.0,1,1.0,1,0.26913265612298093,49
3507,3,11127,2574,8553,0,0,0,1.0,1,1.0,1,1.0,1,0.28138421753434845,46
3508,5,11132,2575,8557,0,0,0,1.0,1,1.0,1,1.0,1,0.2732503305276327,47
3509,3,11135,2576,8559,0,0,0,1.0,1,1.0,1,1.0,1,0.25629023921665756,44
3510,3,11138,2578,8560,0,0,0,1.0,1,1.0,1,1.0,1,0.27387007850972844,45
3511,4,11142,2578,8564,0,0,0,1.0,1,1.0,1,1.0,1,0.2342277259486764,44
3512,0,11142,2578,8564,0,0,0,1.0,1,1.0,1,1.0,1,0.23022589954125242,42
3513,1,11143,2578,8565,0,0,0,1.0,1,1.0,1,1.0,1,0.19775259513666413,42
3514,1,11144,2578,8566,0,0,0,1.0,1,1.0,1,1.0,1,0.18088602652763758,42
3515,4,11148,2580,8568,0,0,0,1.0,1,1.0,1,1.0,1,0.18339180855081239,42
3516,5,11153,2580,8573,0,0,0,1.0,1,1.0,1,1.0,1,0.14245763677024617,41
3517,1,11154,2580,8574,0,0,0,1.0,1,1.0,1,1.0,1,0.15855785563895847,44
3518,1,11155,2580,8575,0,0,0,1.0,1,1.0,1,1.0,1,0.17050986347881184,43
3519,0,11155,2580,8575,0,0,0,1.0,1,1.0,1,1.0,1,0.16092906386900727,44
3520,4,11159,2580,8579,0,0,0,1.0,1,1.0,1,1.0,1,0.18954757447250778,45
3521,1,11160,2580,8580,0,0,0,1.0,1,1.0,1,1.0,1,0.18613871050274788,45
3522,2,11162,2580,8582,0,0,0,1.0,1,1.0,1,1.0,1,0.19271568052951224,46
3523,1,11163,2580,8583,0,0,0,1.0,1,1.0,1,1.0,1,0.19572674714074564,46
3524,1,11164,2580,8584,0,0,0,1.0,1,1.0,1,1.0,1,0.17695363643742673,47
3525,2,11166,2580,8586,0,0,0,1.0,1,1.0,1,1.0,1,0.20532165276844985,48
3526,4,11170,2580,8590,0,0,0,1.0,1,1.0,1,1.0,1,0.1346866926633866,49
3527,2,11172,2582,8590,0,0,0,1.0,1,1.0,1,1.0,1,0.16480717331910552,49
3528,3,11175,2582,8593,0,0,0,1.0,1,1.0,1,1.0,1,0.16198376130361286,51
3529,3,11178,2582,8596,0,0,0,1.0,1,1.0,1,1.0,1,0.13059888453421867,51
3530,0,11178,2582,8596,0,0,0,1.0,1,1.0,1,1.0,1,0.1390836544195379,52
3531,1,11179,2582,8597,0,0,0,1.0,1,1.0,1,1.0,1,0.12695231804430596,52
3532,0,11179,2582,8597,0,0,0,1.0,1,1.0,1,1.0,1,0.12695231804430596,52
3533,0,11179,2582,8597,0,0,0,1.0,1,1.0,1,1.0,1,0.12695231804430596,52
3534,0,11179,2582,8597,0,0,0,1.0,1,1.0,1,1.0,1,0.12695231804430596,52
3535,3,11182,2583,8599,0,0,0,1.0,1,1.0,1,1.0,1,0.1431674642597539,52
3536,3,11185,2584,8601,0,0,0,1.0,1,1.0,1,1.0,1,0.17508297770341438,54
3537,2,11187,2584,8603,0,0,0,1.0,1,1.0,1,1.0,1,0.19598322160943227,55
3538,7,11194,2584,8610,0,0,0,1.0,1,1.0,1,1.0,1,0.13175551603673366,55
3539,3,11197,2584,8613,0,0,0,1.0,1,1.0,1,1.0,1,0.14191594431144514,58
3540,3,11200,2584,8616,0,0,0,1.0,1,1.0,1,1.0,1,0.10882493729416094,59
3541,3,11203,2584,8619,0,0,0,1.0,1,1.0,1,1.0,1,0.06341827498304844,59
3542,2,11205,2585,8620,0,0,0,1.0,1,1.0,1,1.0,1,0.06651585544772018,61
3543,4,11209,2587,8622,0,0,0,1.0,1,1.0,1,1.0,1,0.07131603982008249,62
3544,2,11211,2589,8622,0,0,0,1.0,1,1.0,1,1.0,1,0.09303600826233017,59
3545,4,11215,2590,8625,0,0,0,1.0,1,1.0,1,1.0,1,0.06781625246213045,59
3546,2,11217,2591,8626,0,0,0,1.0,1,1.0,1,1.0,1,0.10197824655072733,57
3547,2,11219,2592,8627,0,0,0,1.0,1,1.0,1,1.0,1,0.11579119797619424,53
3548,2,11221,2593,8628,0,0,0,1.0,1,1.0,1,1.0,1,0.11303587421158276,53
3549,0,11221,2593,8628,0,0,0,1.0,1,1.0,1,1.0,1,0.12617419745550076,52
3550,1,11222,2594,8628,0,0,0,1.0,1,1.0,1,1.0,1,0.12542697836563194,51
3551,2,11224,2595,8629,0,0,0,1.0,1,1.0,1,1.0,1,0.13010204205744688,51
3552,1,11225,2596,8629,0,0,0,1.0,1,1.0,1,1.0,1,0.1526843864023394,51
3553,0,11225,2596,8629,0,0,0,1.0,1,1.0,1,1.0,1,0.17649593494910615,49
3554,0,11225,2596,8629,0,0,0,1.0,1,1.0,1,1.0,1,0.17649593494910615,49
3555,2,11227,2596,8631,0,0,0,1.0,1,1.0,1,1.0,1,0.14692052155092894,51
3556,5,11232,2596,8636,0,0,0,1.0,1,1.0,1,1.0,1,0.07562500140489457,51
3557,3,11235,2597,8638,0,0,0,1.0,1,1.0,1,1.0,1,0.08536978543448238,52
3558,1,11236,2598,8638,0,0,0,1.0,1,1.0,1,1.0,1,0.09740124021226428,52
3559,3,11239,2600,8639,0,0,0,1.0,1,1.0,1,1.0,1,0.1123422621362004,52
3560,1,11240,2600,8640,0,0,0,1.0,1,1.0,1,1.0,1,0.11557340870111972,53
3561,1,11241,2601,8640,0,0,0,1.0,1,1.0,1,1.0,1,0.1484579389969624,54
3562,2,11243,2602,8641,0,0,0,1.0,1,1.0,1,1.0,1,0.16045768196011628,54
3563,2,11245,2602,8643,0,0,0,1.0,1,1.0,1,1.0,1,0.1699650182891993,55
3564,4,11249,2602,8647,0,0,0,1.0,1,1.0,1,1.0,1,0.14043955703500965,57
3565,3,11252,2602,8650,0,0,0,1.0,1,1.0,1,1.0,1,0.15935899197259087,56
3566,4,11256,2603,8653,0,0,0,1.0,1,1.0,1,1.0,1,0.19013752023542901,57
3567,2,11258,2603,8655,0,0,0,1.0,1,1.0,1,1.0,1,0.17198694501568107,57
3568,1,11259,2603,8656,0,0,0,1.0,1,1.0,1,1.0,1,0.1705282611046774,57
3569,5,11264,2603,8661,0,0,0,1.0,1,1.0,1,1.0,1,0.17811232059564225,57
3570,7,11271,2604,8667,0,0,0,1.0,1,1.0,1,1.0,1,0.19449708987758693,59
3571,5,11276,2604,8672,0,0,0,1.0,1,1.0,1,1.0,1,0.12892359373686443,60
3572,1,11277,2604,8673,0,0,0,1.0,1,1.0,1,1.0,1,0.11718146365798046,61
3573,2,11279,2604,8675,0,0,0,1.0,1,1.0,1,1.0,1,0.1246753043993705,62
3574,1,11280,2604,8676,0,0,0,1.0,1,1.0,1,1.0,1,0.12904741476111092,63
3575,5,11285,2606,8679,0,0,0,1.0,1,1.0,1,1.0,1,0.15848037586773334,63
3576,3,11288,2606,8682,0,0,0,1.0,1,1.0,1,1.0,1,0.1442246017324287,63
3577,2,11290,2606,8684,0,0,0,1.0,1,1.0,1,1.0,1,0.14587264509844042,64
3578,2,11292,2606,8686,0,0,0,1.0,1,1.0,1,1.0,1,0.1542433481632417,64
3579,1,11293,2606,8687,0,0,0,1.0,1,1.0,1,1.0,1,0.15477380874885896,64
3580,2,11295,2606,8689,0,0,0,1.0,1,1.0,1,1.0,1,0.14174558807400567,65
3581,6,11301,2606,8695,0,0,0,1.0,1,1.0,1,1.0,1,0.16085843098790997,68
3582,6,11307,2608,8699,0,0,0,1.0,1,1.0,1,1.0,1,0.15551988431974043,68
3583,7,11314,2610,8704,0,0,0,1.0,1,1.0,1,1.0,1,0.15795791505394613,65
3584,10,11324,2613,8711,0,0,0,1.0,1,1.0,1,1.0,1,0.14912587241821856,64
3585,9,11333,2614,8719,0,0,0,1.0,1,1.0,1,1.0,1,0.1839217828917082,64
3586,9,11342,2617,8725,0,0,0,1.0,1,1.0,1,1.0,1,0.13410138581965117,65
3587,4,11346,2618,8728,0,0,0,1.0,1,1.0,1,1.0,1,0.0651503981236702,64
3588,1,11347,2619,8728,0,0,0,1.0,1,1.0,1,1.0,1,0.055119772841010384,62
3589,4,11351,2622,8729,0,0,0,1.0,1,1.0,1,1.0,1,0.08872401174781011,63
3590,7,11358,2624,8734,0,0,0,1.0,1,1.0,1,1.0,1,0.10339378455000445,63
3591,1,11359,2624,8735,0,0,0,1.0,1,1.0,1,1.0,1,0.0737589240485826,62
3592,1,11360,2625,8735,0,0,0,1.0,1,1.0,1,1.0,1,0.08169148547067923,59
3593,2,11362,2627,8735,0,0,0,1.0,1,1.0,1,1.0,1,0.06799015741653792,58
3594,0,11362,2627,8735,0,0,0,1.0,1,1.0,1,1.0,1,0.09109802112150561,57
3595,0,11362,2627,8735,0,0,0,1.0,1,1.0,1,1.0,1,0.0819073610365,59
3596,1,11363,2628,8735,0,0,0,1.0,1,1.0,1,1.0,1,0.08613311551661366,57
3597,2,11365,2629,8736,0,0,0,1.0,1,1.0,1,1.0,1,0.10947717740178409,57
3598,3,11368,2630,8738,0,0,0,1.0,1,1.0,1,1.0,1,0.14390288883824556,57
3599,5,11373,2634,8739,0,0,0,1.0,1,1.0,1,1.0,1,0.17103752820759502,58
3600,3,11376,2635,8741,0,0,0,1.0,1,1.0,1,1.0,1,0.16660451570087767,58
3601,9,11385,2636,8749,0,0,0,1.0,1,1.0,1,1.0,1,0.08999839009390194,58
3602,2,11387,2636,8751,0,0,0,1.0,1,1.0,1,1.0,1,0.07917376976478624,60
3603,5,11392,2636,8756,0,0,0,1.0,1,1.0,1,1.0,1,0.09566136874271144,60
3604,4,11396,2636,8760,0,0,0,1.0,1,1.0,1,1.0,1,0.09566136874271144,60
3605,3,11399,2637,8762,0,0,0,1.0,1,1.0,1,1.0,1,0.1009824915461241,61
3606,6,11405,2638,8767,0,0,0,1.0,1,1.0,1,1.0,1,0.10055514223829345,63
3607,3,11408,2639,8769,0,0,0,1.0,1,1.0,1,1.0,1,0.10342307970820862,63
3608,4,11412,2639,8773,0,0,0,1.0,1,1.0,1,1.0,1,0.09258323307506285,64
3609,3,11415,2639,8776,0,0,0,1.0,1,1.0,1,1.0,1,0.062494420112210666,66
3610,4,11419,2640,8779,0,0,0,1.0,1,1.0,1,1.0,1,0.06286187264782998,67
3611,4,11423,2641,8782,0,0,0,1.0,1,1.0,1,1.0,1,0.08178848770501156,67
3612,4,11427,2642,8785,0,0,0,1.0,1,1.0,1,1.0,1,0.0949945993741345,66
3613,5,11432,2643,8789,0,0,0,1.0,1,1.0,1,1.0,1,0.10722182557685483,66
3614,6,11438,2645,8793,0,0,0,1.0,1,1.0,1,1.0,1,0.10279127283484722,65
3615,3,11441,2645,8796,0,0,0,1.0,1,1.0,1,1.0,1,0.12127729406839302,65
3616,3,11444,2645,8799,0,0,0,1.0,1,1.0,1,1.0,1,0.07686775603691327,65
3617,2,11446,2646,8800,0,0,0,1.0,1,1.0,1,1.0,1,0.09007485129721425,66
3618,1,11447,2647,8800,0,0,0,1.0,1,1.0,1,1.0,1,0.09337448807301356,66
3619,1,11448,2647,8801,0,0,0,1.0,1,1.0,1,1.0,1,0.09139144220246292,65
3620,4,11452,2649,8803,0,0,0,1.0,1,1.0,1,1.0,1,0.11324004719383912,66
3621,4,11456,2650,8806,0,0,0,1.0,1,1.0,1,1.0,1,0.12827640498119228,65
3622,2,11458,2650,8808,0,0,0,1.0,1,1.0,1,1.0,1,0.1299172637762891,65
3623,4,11462,2652,8810,0,0,0,1.0,1,1.0,1,1.0,1,0.17207647955421582,62
3624,4,11466,2655,8811,0,0,0,1.0,1,1.0,1,1.0,1,0.18863355736262563,62
3625,3,11469,2656,8813,0,0,0,1.0,1,1.0,1,1.0,1,0.20117334725913807,61
3626,3,11472,2657,8815,0,0,0,1.0,1,1.0,1,1.0,1,0.19683427031327513,58
3627,6,11478,2659,8819,0,0,0,1.0,1,1.0,1,1.0,1,0.18828434703729904,58
3628,6,11484,2662,8822,0,0,0,1.0,1,1.0,1,1.0,1,0.22342137250859068,57
3629,5,11489,2663,8826,0,0,0,1.0,1,1.0,1,1.0,1,0.219140851557503,57
3630,10,11499,2666,8833,0,0,0,1.0,1,1.0,1,1.0,1,0.2053521290654594,56
3631,12,11511,2668,8843,0,0,0,1.0,1,1.0,1,1.0,1,0.14845993265682966,54
3632,4,11515,2668,8847,0,0,0,1.0,1,1.0,1,1.0,1,0.11158211321684179,52
3633,11,11526,2671,8855,0,0,0,1.0,1,1.0,1,1.0,1,0.17535365628473137,52
3634,5,11531,2673,8858,0,0,0,1.0,1,1.0,1,1.0,1,0.1963363228832655,49
3635,4,11535,2673,8862,0,0,0,1.0,1,1.0,1,1.0,1,0.2263264067970302,47
3636,6,11541,2675,8866,0,0,0,1.0,1,1.0,1,1.0,1,0.17770329228783055,48
3637,5,11546,2675,8871,0,0,0,1.0,1,1.0,1,1.0,1,0.23838166593523913,49
3638,8,11554,2676,8878,0,0,0,1.0,1,1.0,1,1.0,1,0.22658314279772288,50
3639,13,11567,2677,8890,0,0,0,1.0,1,1.0,1,1.0,1,0.25363841725564706,52
3640,7,11574,2677,8897,0,0,0,1.0,1,1.0,1,1.0,1,0.2903442545959135,52
3641,8,11582,2677,8905,0,0,0,1.0,1,1.0,1,1.0,1,0.2533814502809701,52
3642,12,11594,2677,8917,0,0,0,1.0,1,1.0,1,1.0,1,0.2533814502809701,52
3643,8,11602,2677,8925,0,0,0,1.0,1,1.0,1,1.0,1,0.2523553244375986,52
3644,11,11613,2678,8935,0,0,0,1.0,1,1.0,1,1.0,1,0.2962285736309337,52
3645,12,11625,2678,8947,0,0,0,1.0,1,1.0,1,1.0,1,0.22846888153895364,53
3646,6,11631,2678,8953,0,0,0,1.0,1,1.0,1,1.0,1,0.1332902716354851,53
3647,1,11632,2678,8954,0,0,0,1.0,1,1.0,1,1.0,1,0.1334030729471205,55
3648,4,11636,2678,8958,0,0,0,1.0,1,1.0,1,1.0,1,0.12157136562625184,57
3649,3,11639,2678,8961,0,0,0,1.0,1,1.0,1,1.0,1,0.1261032260971866,57
3650,4,11643,2678,8965,0,0,0,1.0,1,1.0,1,1.0,1,0.11347393618304932,59
3651,2,11645,2678,8967,0,0,0,1.0,1,1.0,1,1.0,1,0.11347393618304932,59
3652,3,11648,2678,8970,0,0,0,1.0,1,1.0,1,1.0,1,0.12077915028835719,59
3653,1,11649,2678,8971,0,0,0,1.0,1,1.0,1,1.0,1,0.10166906311380372,59
3654,0,11649,2678,8971,0,0,0,1.0,1,1.0,1,1.0,1,0.10166906311380372,59
3655,4,11653,2678,8975,0,0,0,1.0,1,1.0,1,1.0,1,0.07976991931079119,62
3656,4,11657,2679,8978,0,0,0,1.0,1,1.0,1,1.0,1,0.11626436701635873,62
3657,4,11661,2679,8982,0,0,0,1.0,1,1.0,1,1.0,1,0.05597563128249889,63
3658,2,11663,2680,8983,0,0,0,1.0,1,1.0,1,1.0,1,0.10163754463293063,63
3659,4,11667,2680,8987,0,0,0,1.0,1,1.0,1,1.0,1,0.0852651262364081,62
3660,3,11670,2681,8989,0,0,0,1.0,1,1.0,1,1.0,1,0.09914618203034328,62
3661,1,11671,2681,8990,0,0,0,1.0,1,1.0,1,1.0,1,0.07611975468870122,61
3662,3,11674,2683,8991,0,0,0,1.0,1,1.0,1,1.0,1,0.09179109179907742,60
3663,2,11676,2685,8991,0,0,0,1.0,1,1.0,1,1.0,1,0.08377647611374911,61
3664,1,11677,2686,8991,0,0,0,1.0,1,1.0,1,1.0,1,0.09073091745495108,58
3665,3,11680,2689,8991,0,0,0,1.0,1,1.0,1,1.0,1,0.12187043283801091,58
3666,1,11681,2690,8991,0,0,0,1.0,1,1.0,1,1.0,1,0.10327381709518642,58
3667,3,11684,2692,8992,0,0,0,1.0,1,1.0,1,1.0,1,0.13567630313056425,58
3668,1,11685,2692,8993,0,0,0,1.0,1,1.0,1,1.0,1,0.13612521528137989,58
3669,3,11688,2694,8994,0,0,0,1.0,1,1.0,1,1.0,1,0.14914737779399292,57
3670,3,11691,2695,8996,0,0,0,1.0,1,1.0,1,1.0,1,0.15993657360888686,56
3671,6,11697,2696,9001,0,0,0,1.0,1,1.0,1,1.0,1,0.1885663383267957,57
3672,3,11700,2697,9003,0,0,0,1.0,1,1.0,1,1.0,1,0.2042054698847282,57
3673,2,11702,2698,9004,0,0,0,1.0,1,1.0,1,1.0,1,0.21003402292244627,58
3674,5,11707,2699,9008,0,0,0,1.0,1,1.0,1,1.0,1,0.23442514760175784,57
3675,4,11711,2699,9012,0,0,0,1.0,1,1.0,1,1.0,1,0.2303211889304891,58
3676,9,11720,2699,9021,0,0,0,1.0,1,1.0,1,1.0,1,0.15460571925255773,59
3677,4,11724,2700,9024,0,0,0,1.0,1,1.0,1,1.0,1,0.15413517931168086,60
3678,2,11726,2700,9026,0,0,0,1.0,1,1.0,1,1.0,1,0.1408869803437198,62
3679,2,11728,2700,9028,0,0,0,1.0,1,1.0,1,1.0,1,0.1408869803437198,62
3680,3,11731,2700,9031,0,0,0,1.0,1,1.0,1,1.0,1,0.1051963595395424,63
3681,4,11735,2700,9035,0,0,0,1.0,1,1.0,1,1.0,1,0.13197270937100233,64
3682,2,11737,2700,9037,0,0,0,1.0,1,1.0,1,1.0,1,0.13197270937100233,64
3683,3,11740,2700,9040,0,0,0,1.0,1,1.0,1,1.0,1,0.12227941116898228,64
3684,2,11742,2701,9041,0,0,0,1.0,1,1.0,1,1.0,1,0.13317978664145055,64
3685,2,11744,2701,9043,0,0,0,1.0,1,1.0,1,1.0,1,0.13317978664145055,64
3686,3,11747,2701,9046,0,0,0,1.0,1,1.0,1,1.0,1,0.14966751218800287,65
3687,4,11751,2701,9050,0,0,0,1.0,1,1.0,1,1.0,1,0.14966751218800287,65
3688,6,11757,2701,9056,0,0,0,1.0,1,1.0,1,1.0,1,0.15406857367360274,66
3689,4,11761,2701,9060,0,0,0,1.0,1,1.0,1,1.0,1,0.16084698354656687,66
3690,6,11767,2701,9066,0,0,0,1.0,1,1.0,1,1.0,1,0.15724459227369694,67
3691,9,11776,2702,9074,0,0,0,1.0,1,1.0,1,1.0,1,0.09881428528638399,68
3692,3,11779,2702,9077,0,0,0,1.0,1,1.0,1,1.0,1,0.08803631369853859,69
3693,1,11780,2702,9078,0,0,0,1.0,1,1.0,1,1.0,1,0.09718384611438104,69
3694,2,11782,2702,9080,0,0,0,1.0,1,1.0,1,1.0,1,0.10082670246939687,70
3695,3,11785,2702,9083,0,0,0,1.0,1,1.0,1,1.0,1,0.10908797210974086,70
3696,6,11791,2702,9089,0,0,0,1.0,1,1.0,1,1.0,1,0.10280800521076602,71
3697,7,11798,2703,9095,0,0,0,1.0,1,1.0,1,1.0,1,0.11091213085290261,70
3698,6,11804,2703,9101,0,0,0,1.0,1,1.0,1,1.0,1,0.11237342893066422,70
3699,8,11812,2705,9107,0,0,0,1.0,1,1.0,1,1.0,1,0.11962668028264156,70
3700,12,11824,2709,9115,0,0,0,1.0,1,1.0,1,1.0,1,0.17468908223837024,68
3701,7,11831,2712,9119,0,0,0,1.0,1,1.0,1,1.0,1,0.17621090477155474,69
3702,8,11839,2712,9127,0,0,0,1.0,1,1.0,1,1.0,1,0.1693565150004339,69
3703,5,11844,2712,9132,0,0,0,1.0,1,1.0,1,1.0,1,0.18620296446819704,70
3704,6,11850,2713,9137,0,0,0,1.0,1,1.0,1,1.0,1,0.18500859799128366,69
3705,7,11857,2715,9142,0,0,0,1.0,1,1.0,1,1.0,1,0.18292339260435478,69
3706,14,11871,2718,9153,0,0,0,1.0,1,1.0,1,1.0,1,0.12562711944649047,69
3707,1,11872,2718,9154,0,0,0,1.0,1,1.0,1,1.0,1,0.11339693749295932,67
3708,0,11872,2718,9154,0,0,0,1.0,1,1.0,1,1.0,1,0.11347282086987175,67
3709,1,11873,2718,9155,0,0,0,1.0,1,1.0,1,1.0,1,0.10686321828965942,67
3710,0,11873,2718,9155,0,0,0,1.0,1,1.0,1,1.0,1,0.10843877980779904,67
3711,1,11874,2718,9156,0,0,0,1.0,1,1.0,1,1.0,1,0.09883157996001575,68
3712,0,11874,2718,9156,0,0,0,1.0,1,1.0,1,1.0,1,0.09883157996001575,68
3713,2,11876,2720,9156,0,0,0,1.0,1,1.0,1,1.0,1,0.10576128721546967,68
3714,0,11876,2720,9156,0,0,0,1.0,1,1.0,1,1.0,1,0.12449069560794543,67
3715,3,11879,2721,9158,0,0,0,1.0,1,1.0,1,1.0,1,0.11739765041478564,68
3716,2,11881,2721,9160,0,0,0,1.0,1,1.0,1,1.0,1,0.13441616205912774,67
3717,2,11883,2722,9161,0,0,0,1.0,1,1.0,1,1.0,1,0.16328328215648397,68
3718,3,11886,2722,9164,0,0,0,1.0,1,1.0,1,1.0,1,0.15399792545709565,68
3719,3,11889,2723,9166,0,0,0,1.0,1,1.0,1,1.0,1,0.18892551099111582,68
3720,1,11890,2723,9167,0,0,0,1.0,1,1.0,1,1.0,1,0.19362918871823598,68
3721,10,11900,2726,9174,0,0,0,1.0,1,1.0,1,1.0,1,0.13348492713575225,70
3722,1,11901,2726,9175,0,0,0,1.0,1,1.0,1,1.0,1,0.15521086409276916,71
3723,3,11904,2728,9176,0,0,0,1.0,1,1.0,1,1.0,1,0.17218143578915387,71
3724,3,11907,2729,9178,0,0,0,1.0,1,1.0,1,1.0,1,0.16162844310045038,72
3725,4,11911,2732,9179,0,0,0,1.0,1,1.0,1,1.0,1,0.1909722731579874,72
3726,3,11914,2733,9181,0,0,0,1.0,1,1.0,1,1.0,1,0.17085407138385106,71
3727,2,11916,2733,9183,0,0,0,1.0,1,1.0,1,1.0,1,0.17085407138385106,71
3728,3,11919,2735,9184,0,0,0,1.0,1,1.0,1,1.0,1,0.1953339446592494,70
3729,6,11925,2736,9189,0,0,0,1.0,1,1.0,1,1.0,1,0.18699913572113108,70
3730,2,11927,2736,9191,0,0,0,1.0,1,1.0,1,1.0,1,0.19929454357959991,71
3731,4,11931,2736,9195,0,0,0,1.0,1,1.0,1,1.0,1,0.1906716323615399,71
3732,2,11933,2736,9197,0,0,0,1.0,1,1.0,1,1.0,1,0.18502726772763967,72
3733,3,11936,2737,9199,0,0,0,1.0,1,1.0,1,1.0,1,0.19270057893130277,73
3734,8,11944,2739,9205,0,0,0,1.0,1,1.0,1,1.0,1,0.20963705450565612,74
3735,4,11948,2740,9208,0,0,0,1.0,1,1.0,1,1.0,1,0.18804881432089007,72
3736,6,11954,2740,9214,0,0,0,1.0,1,1.0,1,1.0,1,0.10888968344880326,72
3737,3,11957,2740,9217,0,0,0,1.0,1,1.0,1,1.0,1,0.10173741585449843,73
3738,1,11958,2740,9218,0,0,0,1.0,1,1.0,1,1.0,1,0.10986800303597814,72
3739,1,11959,2740,9219,0,0,0,1.0,1,1.0,1,1.0,1,0.11304420819521246,73
3740,1,11960,2740,9220,0,0,0,1.0,1,1.0,1,1.0,1,0.13204680346044528,70
3741,0,11960,2740,9220,0,0,0,1.0,1,1.0,1,1.0,1,0.13204680346044528,70
3742,2,11962,2740,9222,0,0,0,1.0,1,1.0,1,1.0,1,0.12251828028826524,70
3743,1,11963,2741,9222,0,0,0,1.0,1,1.0,1,1.0,1,0.16460338072287936,69
3744,6,11969,2745,9224,0,0,0,1.0,1,1.0,1,1.0,1,0.19179566701409195,69
3745,2,11971,2746,9225,0,0,0,1.0,1,1.0,1,1.0,1,0.1754821798556317,68
3746,4,11975,2747,9228,0,0,0,1.0,1,1.0,1,1.0,1,0.18976525653978088,66
3747,3,11978,2748,9230,0,0,0,1.0,1,1.0,1,1.0,1,0.17325263671321925,66
3748,3,11981,2748,9233,0,0,0,1.0,1,1.0,1,1.0,1,0.15419980719751367,65
3749,2,11983,2749,9234,0,0,0,1.0,1,1.0,1,1.0,1,0.15603895109901852,64
3750,3,11986,2749,9237,0,0,0,1.0,1,1.0,1,1.0,1,0.16396437590250315,63
3751,7,11993,2750,9243,0,0,0,1.0,1,1.0,1,1.0,1,0.10683741405523202,64
3752,4,11997,2751,9246,0,0,0,1.0,1,1.0,1,1.0,1,0.1149564443863022,64
3753,4,12001,2753,9248,0,0,0,1.0,1,1.0,1,1.0,1,0.15835133364445536,65
3754,3,12004,2755,9249,0,0,0,1.0,1,1.0,1,1.0,1,0.1642020966835838,65
3755,6,12010,2756,9254,0,0,0,1.0,1,1.0,1,1.0,1,0.17776840798672167,65
3756,4,12014,2756,9258,0,0,0,1.0,1,1.0,1,1.0,1,0.18571778099000144,65
3757,6,12020,2756,9264,0,0,0,1.0,1,1.0,1,1.0,1,0.18652508433033962,65
3758,5,12025,2756,9269,0,0,0,1.0,1,1.0,1,1.0,1,0.14712477000772792,64
3759,7,12032,2758,9274,0,0,0,1.0,1,1.0,1,1.0,1,0.1624989059659387,64
3760,4,12036,2758,9278,0,0,0,1.0,1,1.0,1,1.0,1,0.17037111605632463,63
3761,3,12039,2758,9281,0,0,0,1.0,1,1.0,1,1.0,1,0.1643732780620869,63
3762,3,12042,2759,9283,0,0,0,1.0,1,1.0,1,1.0,1,0.15349195952092212,65
3763,4,12046,2760,9286,0,0,0,1.0,1,1.0,1,1.0,1,0.16806052310281588,65
3764,6,12052,2760,9292,0,0,0,1.0,1,1.0,1,1.0,1,0.15973605974526447,66
3765,4,12056,2760,9296,0,0,0,1.0,1,1.0,1,1.0,1,0.169012762526965,67
3766,6,12062,2761,9301,0,0,0,1.0,1,1.0,1,1.0,1,0.1351800030875181,67
3767,5,12067,2762,9305,0,0,0,1.0,1,1.0,1,1.0,1,0.13423298312103207,68
3768,3,12070,2764,9306,0,0,0,1.0,1,1.0,1,1.0,1,0.1521385447239196,67
3769,3,12073,2764,9309,0,0,0,1.0,1,1.0,1,1.0,1,0.11810037156451689,69
3770,0,12073,2764,9309,0,0,0,1.0,1,1.0,1,1.0,1,0.11810037156451689,69
3771,5,12078,2764,9314,0,0,0,1.0,1,1.0,1,1.0,1,0.11783693849772507,69
3772,3,12081,2764,9317,0,0,0,1.0,1,1.0,1,1.0,1,0.09378989308042605,70
3773,5,12086,2765,9321,0,0,0,1.0,1,1.0,1,1.0,1,0.13648605379488538,68
3774,4,12090,2766,9324,0,0,0,1.0,1,1.0,1,1.0,1,0.11796141351507494,68
3775,1,12091,2767,9324,0,0,0,1.0,1,1.0,1,1.0,1,0.14056372666607606,68
3776,0,12091,2767,9324,0,0,0,1.0,1,1.0,1,1.0,1,0.13302921870899884,66
3777,1,12092,2768,9324,0,0,0,1.0,1,1.0,1,1.0,1,0.12540231905708896,65
3778,2,12094,2769,9325,0,0,0,1.0,1,1.0,1,1.0,1,0.11406552971163732,65
3779,4,12098,2771,9327,0,0,0,1.0,1,1.0,1,1.0,1,0.12249982821340702,65
3780,1,12099,2772,9327,0,0,0,1.0,1,1.0,1,1.0,1,0.11521619123834802,64
3781,3,12102,2772,9330,0,0,0,1.0,1,1.0,1,1.0,1,0.09242527647264377,64
3782,1,12103,2773,9330,0,0,0,1.0,1,1.0,1,1.0,1,0.11056560298416147,67
3783,2,12105,2774,9331,0,0,0,1.0,1,1.0,1,1.0,1,0.10833005013406974,65
3784,7,12112,2776,9336,0,0,0,1.0,1,1.0,1,1.0,1,0.09651400387430559,65
3785,1,12113,2777,9336,0,0,0,1.0,1,1.0,1,1.0,1,0.13518336732235023,63
3786,4,12117,2778,9339,0,0,0,1.0,1,1.0,1,1.0,1,0.16028090426669322,66
3787,8,12125,2780,9345,0,0,0,1.0,1,1.0,1,1.0,1,0.16689596296802534,65
3788,4,12129,2780,9349,0,0,0,1.0,1,1.0,1,1.0,1,0.16351062710016798,65
3789,3,12132,2781,9351,0,0,0,1.0,1,1.0,1,1.0,1,0.1569042621835448,65
3790,3,12135,2782,9353,0,0,0,1.0,1,1.0,1,1.0,1,0.19970515049856405,64
3791,7,12142,2784,9358,0,0,0,1.0,1,1.0,1,1.0,1,0.22449439264409768,64
3792,7,12149,2786,9363,0,0,0,1.0,1,1.0,1,1.0,1,0.24807518410062218,65
3793,14,12163,2787,9376,0,0,0,1.0,1,1.0,1,1.0,1,0.2470273107403187,68
3794,10,12173,2788,9385,0,0,0,1.0,1,1.0,1,1.0,1,0.2532911991652228,68
3795,15,12188,2788,9400,0,0,0,1.0,1,1.0,1,1.0,1,0.24711509903080248,69
3796,15,12203,2788,9415,0,0,0,1.0,1,1.0,1,1.0,1,0.1417495829662514,69
3797,5,12208,2788,9420,0,0,0,1.0,1,1.0,1,1.0,1,0.1599290079164862,70
3798,5,12213,2788,9425,0,0,0,1.0,1,1.0,1,1.0,1,0.15775291582339215,70
3799,2,12215,2788,9427,0,0,0,1.0,1,1.0,1,1.0,1,0.14794438178172262,69
3800,5,12220,2788,9432,0,0,0,1.0,1,1.0,1,1.0,1,0.13993811710497178,69
3801,5,12225,2788,9437,0,0,0,1.0,1,1.0,1,1.0,1,0.14265769212911322,67
3802,4,12229,2788,9441,0,0,0,1.0,1,1.0,1,1.0,1,0.14265769212911322,67
3803,3,12232,2789,9443,0,0,0,1.0,1,1.0,1,1.0,1,0.15957840623255917,69
3804,6,12238,2790,9448,0,0,0,1.0,1,1.0,1,1.0,1,0.13480970034420406,70
3805,8,12246,2791,9455,0,0,0,1.0,1,1.0,1,1.0,1,0.14662972863194476,71
3806,3,12249,2792,9457,0,0,0,1.0,1,1.0,1,1.0,1,0.14518008368895438,71
3807,5,12254,2793,9461,0,0,0,1.0,1,1.0,1,1.0,1,0.15849694340941806,72
3808,5,12259,2793,9466,0,0,0,1.0,1,1.0,1,1.0,1,0.1612747213283621,72
3809,3,12262,2793,9469,0,0,0,1.0,1,1.0,1,1.0,1,0.1605649785219732,72
3810,8,12270,2795,9475,0,0,0,1.0,1,1.0,1,1.0,1,0.1856140451420719,72
3811,7,12277,2795,9482,0,0,0,1.0,1,1.0,1,1.0,1,0.1129372131543949,71
3812,6,12283,2795,9488,0,0,0,1.0,1,1.0,1,1.0,1,0.10065483369522664,72
3813,5,12288,2796,9492,0,0,0,1.0,1,1.0,1,1.0,1,0.14113682541693487,71
3814,4,12292,2798,9494,0,0,0,1.0,1,1.0,1,1.0,1,0.1544148669022198,72
3815,6,12298,2798,9500,0,0,0,1.0,1,1.0,1,1.0,1,0.13993995731530523,71
3816,4,12302,2800,9502,0,0,0,1.0,1,1.0,1,1.0,1,0.17684632273105313,69
3817,4,12306,2800,9506,0,0,0,1.0,1,1.0,1,1.0,1,0.15420854602543482,72
3818,3,12309,2800,9509,0,0,0,1.0,1,1.0,1,1.0,1,0.147795455165347,72
3819,3,12312,2800,9512,0,0,0,1.0,1,1.0,1,1.0,1,0.1536107341414468,72
3820,3,12315,2800,9515,0,0,0,1.0,1,1.0,1,1.0,1,0.1463184299298852,72
3821,3,12318,2801,9517,0,0,0,1.0,1,1.0,1,1.0,1,0.1691714533811128,72
3822,2,12320,2801,9519,0,0,0,1.0,1,1.0,1,1.0,1,0.16595692832700826,69
3823,4,12324,2802,9522,0,0,0,1.0,1,1.0,1,1.0,1,0.1519943962282939,69
3824,3,12327,2803,9524,0,0,0,1.0,1,1.0,1,1.0,1,0.1862705092425644,65
3825,3,12330,2804,9526,0,0,0,1.0,1,1.0,1,1.0,1,0.19189402737346048,64
3826,6,12336,2805,9531,0,0,0,1.0,1,1.0,1,1.0,1,0.16373278441266384,65
3827,3,12339,2806,9533,0,0,0,1.0,1,1.0,1,1.0,1,0.14434373117085625,64
3828,3,12342,2806,9536,0,0,0,1.0,1,1.0,1,1.0,1,0.12945861983422433,65
3829,4,12346,2807,9539,0,0,0,1.0,1,1.0,1,1.0,1,0.11937406765642757,65
3830,2,12348,2807,9541,0,0,0,1.0,1,1.0,1,1.0,1,0.1290334860466152,64
3831,5,12353,2810,9543,0,0,0,1.0,1,1.0,1,1.0,1,0.1346098849287754,63
3832,1,12354,2810,9544,0,0,0,1.0,1,1.0,1,1.0,1,0.1795285810948769,64
3833,1,12355,2810,9545,0,0,0,1.0,1,1.0,1,1.0,1,0.172236833111254,64
3834,4,12359,2811,9548,0,0,0,1.0,1,1.0,1,1.0,1,0.1684429186859442,63
3835,3,12362,2812,9550,0,0,0,1.0,1,1.0,1,1.0,1,0.18412658190654793,63
3836,6,12368,2815,9553,0,0,0,1.0,1,1.0,1,1.0,1,0.16647872516752554,63
3837,3,12371,2817,9554,0,0,0,1.0,1,1.0,1,1.0,1,0.21284093889737277,62
3838,2,12373,2818,9555,0,0,0,1.0,1,1.0,1,1.0,1,0.1945535619388853,62
3839,2,12375,2819,9556,0,0,0,1.0,1,1.0,1,1.0,1,0.24447012571324012,60
3840,1,12376,2819,9557,0,0,0,1.0,1,1.0,1,1.0,1,0.235517755605795,62
3841,7,12383,2819,9564,0,0,0,1.0,1,1.0,1,1.0,1,0.1337963878767797,62
3842,1,12384,2819,9565,0,0,0,1.0,1,1.0,1,1.0,1,0.10923691507779816,63
3843,2,12386,2819,9567,0,0,0,1.0,1,1.0,1,1.0,1,0.12050072829083604,64
3844,2,12388,2819,9569,0,0,0,1.0,1,1.0,1,1.0,1,0.10489899365172556,65
3845,6,12394,2819,9575,0,0,0,1.0,1,1.0,1,1.0,1,0.10981643287312476,66
3846,8,12402,2819,9583,0,0,0,1.0,1,1.0,1,1.0,1,0.1107117499401904,67
3847,6,12408,2819,9589,0,0,0,1.0,1,1.0,1,1.0,1,0.09669820456085423,67
3848,4,12412,2819,9593,0,0,0,1.0,1,1.0,1,1.0,1,0.12207825658380014,67
3849,1,12413,2819,9594,0,0,0,1.0,1,1.0,1,1.0,1,0.12152342305135273,67
3850,4,12417,2821,9596,0,0,0,1.0,1,1.0,1,1.0,1,0.12158938506314232,68
3851,2,12419,2821,9598,0,0,0,1.0,1,1.0,1,1.0,1,0.12158938506314232,68
3852,5,12424,2822,9602,0,0,0,1.0,1,1.0,1,1.0,1,0.1509852112444978,70
3853,3,12427,2822,9605,0,0,0,1.0,1,1.0,1,1.0,1,0.13513113134625512,70
3854,5,12432,2824,9608,0,0,0,1.0,1,1.0,1,1.0,1,0.15546430779699955,70
3855,4,12436,2824,9612,0,0,0,1.0,1,1.0,1,1.0,1,0.15195231107871873,69
3856,4,12440,2825,9615,0,0,0,1.0,1,1.0,1,1.0,1,0.13137044690334,70
3857,2,12442,2826,9616,0,0,0,1.0,1,1.0,1,1.0,1,0.12699863190655886,68
3858,3,12445,2827,9618,0,0,0,1.0,1,1.0,1,1.0,1,0.13419106425642402,67
3859,2,12447,2827,9620,0,0,0,1.0,1,1.0,1,1.0,1,0.11711459616165174,66
3860,1,12448,2827,9621,0,0,0,1.0,1,1.0,1,1.0,1,0.10899838983494067,66
3861,1,12449,2827,9622,0,0,0,1.0,1,1.0,1,1.0,1,0.08907594210555053,66
3862,3,12452,2829,9623,0,0,0,1.0,1,1.0,1,1.0,1,0.14160747971685334,66
3863,0,12452,2829,9623,0,0,0,1.0,1,1.0,1,1.0,1,0.12375910097748857,63
3864,3,12455,2831,9624,0,0,0,1.0,1,1.0,1,1.0,1,0.14671171732915445,63
3865,1,12456,2832,9624,0,0,0,1.0,1,1.0,1,1.0,1,0.15774550207663054,61
3866,2,12458,2833,9625,0,0,0,1.0,1,1.0,1,1.0,1,0.13249021696273763,61
3867,0,12458,2833,9625,0,0,0,1.0,1,1.0,1,1.0,1,0.13495585302946758,60
3868,4,12462,2836,9626,0,0,0,1.0,1,1.0,1,1.0,1,0.14428574058108118,59
3869,1,12463,2837,9626,0,0,0,1.0,1,1.0,1,1.0,1,0.15301066483070513,61
3870,0,12463,2837,9626,0,0,0,1.0,1,1.0,1,1.0,1,0.1669175440822962,61
3871,9,12472,2838,9634,0,0,0,1.0,1,1.0,1,1.0,1,0.0923187918968769,64
3872,0,12472,2838,9634,0,0,0,1.0,1,1.0,1,1.0,1,0.09737159151308794,63
3873,3,12475,2838,9637,0,0,0,1.0,1,1.0,1,1.0,1,0.12377286689688392,62
3874,1,12476,2839,9637,0,0,0,1.0,1,1.0,1,1.0,1,0.08816421743901612,63
3875,1,12477,2840,9637,0,0,0,1.0,1,1.0,1,1.0,1,0.11580392073557229,61
3876,0,12477,2840,9637,0,0,0,1.0,1,1.0,1,1.0,1,0.09930992692521096,62
3877,2,12479,2841,9638,0,0,0,1.0,1,1.0,1,1.0,1,0.14551289495730158,63
3878,5,12484,2842,9642,0,0,0,1.0,1,1.0,1,1.0,1,0.1489650934878266,63
3879,5,12489,2843,9646,0,0,0,1.0,1,1.0,1,1.0,1,0.14581741907551307,63
3880,7,12496,2844,9652,0,0,0,1.0,1,1.0,1,1.0,1,0.15229897580022445,65
3881,3,12499,2845,9654,0,0,0,1.0,1,1.0,1,1.0,1,0.17320973791755284,65
3882,6,12505,2846,9659,0,0,0,1.0,1,1.0,1,1.0,1,0.1565055692038631,66
3883,9,12514,2847,9667,0,0,0,1.0,1,1.0,1,1.0,1,0.1653526561242891,66
3884,10,12524,2847,9677,0,0,0,1.0,1,1.0,1,1.0,1,0.1653526561242891,66
3885,5,12529,2848,9681,0,0,0,1.0,1,1.0,1,1.0,1,0.17037518829571938,66
3886,6,12535,2850,9685,0,0,0,1.0,1,1.0,1,1.0,1,0.1477478705961667,65
3887,2,12537,2850,9687,0,0,0,1.0,1,1.0,1,1.0,1,0.10404416219954855,65
3888,2,12539,2851,9688,0,0,0,1.0,1,1.0,1,1.0,1,0.11421432967194249,66
3889,2,12541,2853,9688,0,0,0,1.0,1,1.0,1,1.0,1,0.15607354909587953,64
3890,3,12544,2854,9690,0,0,0,1.0,1,1.0,1,1.0,1,0.13880242332253243,63
3891,4,12548,2855,9693,0,0,0,1.0,1,1.0,1,1.0,1,0.15622304087118802,66
3892,3,12551,2855,9696,0,0,0,1.0,1,1.0,1,1.0,1,0.14910574413680897,67
3893,1,12552,2855,9697,0,0,0,1.0,1,1.0,1,1.0,1,0.14999743325560666,66
3894,2,12554,2855,9699,0,0,0,1.0,1,1.0,1,1.0,1,0.14309287515536417,67
3895,0,12554,2855,9699,0,0,0,1.0,1,1.0,1,1.0,1,0.14674820631183022,66
3896,2,12556,2856,9700,0,0,0,1.0,1,1.0,1,1.0,1,0.15388806621978088,66
3897,1,12557,2856,9701,0,0,0,1.0,1,1.0,1,1.0,1,0.16286791207940757,65
3898,8,12565,2860,9705,0,0,0,1.0,1,1.0,1,1.0,1,0.17787380458860738,65
3899,3,12568,2862,9706,0,0,0,1.0,1,1.0,1,1.0,1,0.19070620406908592,64
3900,4,12572,2863,9709,0,0,0,1.0,1,1.0,1,1.0,1,0.17422918863792256,63
3901,7,12579,2865,9714,0,0,0,1.0,1,1.0,1,1.0,1,0.12692267176937935,63
3902,0,12579,2865,9714,0,0,0,1.0,1,1.0,1,1.0,1,0.14070600860265356,64
3903,1,12580,2865,9715,0,0,0,1.0,1,1.0,1,1.0,1,0.12941526005318638,64
3904,1,12581,2865,9716,0,0,0,1.0,1,1.0,1,1.0,1,0.1305457118317772,63
3905,0,12581,2865,9716,0,0,0,1.0,1,1.0,1,1.0,1,0.1498268411670722,63
3906,2,12583,2867,9716,0,0,0,1.0,1,1.0,1,1.0,1,0.10844195090513954,64
3907,1,12584,2868,9716,0,0,0,1.0,1,1.0,1,1.0,1,0.14338254670098824,64
3908,1,12585,2869,9716,0,0,0,1.0,1,1.0,1,1.0,1,0.13186091172574704,63
3909,2,12587,2870,9717,0,0,0,1.0,1,1.0,1,1.0,1,0.15355056195978575,62
3910,2,12589,2871,9718,0,0,0,1.0,1,1.0,1,1.0,1,0.18548373311785185,62
3911,4,12593,2874,9719,0,0,0,1.0,1,1.0,1,1.0,1,0.24000764046151107,64
3912,5,12598,2876,9722,0,0,0,1.0,1,1.0,1,1.0,1,0.24758225973371312,64
3913,7,12605,2876,9729,0,0,0,1.0,1,1.0,1,1.0,1,0.2245206524213822,65
3914,1,12606,2876,9730,0,0,0,1.0,1,1.0,1,1.0,1,0.23692306603085733,65
3915,3,12609,2876,9733,0,0,0,1.0,1,1.0,1,1.0,1,0.24106516092327243,66
3916,10,12619,2876,9743,0,0,0,1.0,1,1.0,1,1.0,1,0.12828984856784162,66
3917,2,12621,2876,9745,0,0,0,1.0,1,1.0,1,1.0,1,0.11575260533999852,66
3918,4,12625,2876,9749,0,0,0,1.0,1,1.0,1,1.0,1,0.12680663708838324,67
3919,3,12628,2877,9751,0,0,0,1.0,1,1.0,1,1.0,1,0.12898010900387213,68
3920,0,12628,2877,9751,0,0,0,1.0,1,1.0,1,1.0,1,0.12019852777728501,69
3921,1,12629,2877,9752,0,0,0,1.0,1,1.0,1,1.0,1,0.12492686966181633,68
3922,2,12631,2879,9752,0,0,0,1.0,1,1.0,1,1.0,1,0.16682310891399765,68
3923,3,12634,2879,9755,0,0,0,1.0,1,1.0,1,1.0,1,0.1576428448716589,69
3924,7,12641,2879,9762,0,0,0,1.0,1,1.0,1,1.0,1,0.1914138163492402,69
3925,8,12649,2881,9768,0,0,0,1.0,1,1.0,1,1.0,1,0.16685211685703422,67
3926,3,12652,2881,9771,0,0,0,1.0,1,1.0,1,1.0,1,0.18165301575706885,67
3927,3,12655,2882,9773,0,0,0,1.0,1,1.0,1,1.0,1,0.17862433080303874,65
3928,4,12659,2882,9777,0,0,0,1.0,1,1.0,1,1.0,1,0.1644401930096858,65
3929,4,12663,2882,9781,0,0,0,1.0,1,1.0,1,1.0,1,0.1614889239020877,64
3930,3,12666,2882,9784,0,0,0,1.0,1,1.0,1,1.0,1,0.20476702487709467,64
3931,7,12673,2882,9791,0,0,0,1.0,1,1.0,1,1.0,1,0.11658862728025737,62
3932,1,12674,2882,9792,0,0,0,1.0,1,1.0,1,1.0,1,0.12497479417209054,62
3933,2,12676,2883,9793,0,0,0,1.0,1,1.0,1,1.0,1,0.11594601641201496,62
3934,0,12676,2883,9793,0,0,0,1.0,1,1.0,1,1.0,1,0.11777180696168894,61
3935,1,12677,2883,9794,0,0,0,1.0,1,1.0,1,1.0,1,0.12815565372795248,64
3936,1,12678,2884,9794,0,0,0,1.0,1,1.0,1,1.0,1,0.15290376802154496,65
3937,5,12683,2884,9799,0,0,0,1.0,1,1.0,1,1.0,1,0.15452693844094675,66
3938,4,12687,2885,9802,0,0,0,1.0,1,1.0,1,1.0,1,0.16885119120246173,66
3939,5,12692,2885,9807,0,0,0,1.0,1,1.0,1,1.0,1,0.16097252305116194,67
3940,5,12697,2886,9811,0,0,0,1.0,1,1.0,1,1.0,1,0.15646957234734712,69
3941,5,12702,2886,9816,0,0,0,1.0,1,1.0,1,1.0,1,0.15329709875264996,69
3942,7,12709,2887,9822,0,0,0,1.0,1,1.0,1,1.0,1,0.1632563410899361,69
3943,10,12719,2888,9831,0,0,0,1.0,1,1.0,1,1.0,1,0.18199851996625463,68
3944,12,12731,2889,9842,0,0,0,1.0,1,1.0,1,1.0,1,0.17259579300954275,68
3945,14,12745,2891,9854,0,0,0,1.0,1,1.0,1,1.0,1,0.18222093559766042,67
3946,8,12753,2893,9860,0,0,0,1.0,1,1.0,1,1.0,1,0.1235018407332949,67
3947,2,12755,2893,9862,0,0,0,1.0,1,1.0,1,1.0,1,0.1306072944533457,66
3948,1,12756,2893,9863,0,0,0,1.0,1,1.0,1,1.0,1,0.11991296307057628,67
3949,9,12765,2897,9868,0,0,0,1.0,1,1.0,1,1.0,1,0.1738807878072172,66
3950,2,12767,2897,9870,0,0,0,1.0,1,1.0,1,1.0,1,0.18913375587805528,65
3951,2,12769,2897,9872,0,0,0,1.0,1,1.0,1,1.0,1,0.17983915357024918,65
3952,3,12772,2900,9872,0,0,0,1.0,1,1.0,1,1.0,1,0.15643103302418998,65
3953,2,12774,2901,9873,0,0,0,1.0,1,1.0,1,1.0,1,0.1656167742792694,65
3954,1,12775,2902,9873,0,0,0,1.0,1,1.0,1,1.0,1,0.16762784775539785,64
3955,2,12777,2903,9874,0,0,0,1.0,1,1.0,1,1.0,1,0.18610515130075728,64
3956,2,12779,2905,9874,0,0,0,1.0,1,1.0,1,1.0,1,0.17133571642242262,63
3957,3,12782,2906,9876,0,0,0,1.0,1,1.0,1,1.0,1,0.16169838516621535,63
3958,0,12782,2906,9876,0,0,0,1.0,1,1.0,1,1.0,1,0.18129712964068526,63
3959,2,12784,2907,9877,0,0,0,1.0,1,1.0,1,1.0,1,0.18669605885463836,62
3960,0,12784,2907,9877,0,0,0,1.0,1,1.0,1,1.0,1,0.18669605885463836,62
3961,7,12791,2908,9883,0,0,0,1.0,1,1.0,1,1.0,1,0.11753544142843575,64
3962,3,12794,2910,9884,0,0,0,1.0,1,1.0,1,1.0,1,0.12768054969136378,64
3963,5,12799,2912,9887,0,0,0,1.0,1,1.0,1,1.0,1,0.14939469565054772,62
3964,3,12802,2913,9889,0,0,0,1.0,1,1.0,1,1.0,1,0.15438180570896162,63
3965,2,12804,2913,9891,0,0,0,1.0,1,1.0,1,1.0,1,0.12407101593224074,63
3966,1,12805,2913,9892,0,0,0,1.0,1,1.0,1,1.0,1,0.14573338357194923,62
3967,3,12808,2913,9895,0,0,0,1.0,1,1.0,1,1.0,1,0.1481401179350018,64
3968,2,12810,2913,9897,0,0,0,1.0,1,1.0,1,1.0,1,0.1695225946255186,63
3969,6,12816,2914,9902,0,0,0,1.0,1,1.0,1,1.0,1,0.1939750448642,63
3970,3,12819,2915,9904,0,0,0,1.0,1,1.0,1,1.0,1,0.15892624394676033,65
3971,5,12824,2916,9908,0,0,0,1.0,1,1.0,1,1.0,1,0.16221410538529749,65
3972,7,12831,2918,9913,0,0,0,1.0,1,1.0,1,1.0,1,0.15447071265974308,66
3973,6,12837,2919,9918,0,0,0,1.0,1,1.0,1,1.0,1,0.16681717094049398,66
3974,7,12844,2922,9922,0,0,0,1.0,1,1.0,1,1.0,1,0.17228077538046196,66
3975,8,12852,2923,9929,0,0,0,1.0,1,1.0,1,1.0,1,0.1567374057102975,66
3976,6,12858,2925,9933,0,0,0,1.0,1,1.0,1,1.0,1,0.1703507200029046,66
3977,3,12861,2926,9935,0,0,0,1.0,1,1.0,1,1.0,1,0.14577263320559308,64
3978,0,12861,2926,9935,0,0,0,1.0,1,1.0,1,1.0,1,0.16335593640138915,63
3979,1,12862,2926,9936,0,0,0,1.0,1,1.0,1,1.0,1,0.19006460712304737,63
3980,2,12864,2927,9937,0,0,0,1.0,1,1.0,1,1.0,1,0.18644811663094776,63
3981,2,12866,2927,9939,0,0,0,1.0,1,1.0,1,1.0,1,0.17956001839765312,64
3982,5,12871,2928,9943,0,0,0,1.0,1,1.0,1,1.0,1,0.17364647365589325,65
3983,2,12873,2929,9944,0,0,0,1.0,1,1.0,1,1.0,1,0.13675136754567468,64
3984,5,12878,2930,9948,0,0,0,1.0,1,1.0,1,1.0,1,0.13894230210938893,65
3985,5,12883,2934,9949,0,0,0,1.0,1,1.0,1,1.0,1,0.20892111005557604,64
3986,5,12888,2935,9953,0,0,0,1.0,1,1.0,1,1.0,1,0.18855627868963828,63
3987,3,12891,2936,9955,0,0,0,1.0,1,1.0,1,1.0,1,0.21542796383125049,63
3988,5,12896,2936,9960,0,0,0,1.0,1,1.0,1,1.0,1,0.1792574844704713,63
3989,4,12900,2937,9963,0,0,0,1.0,1,1.0,1,1.0,1,0.18508247889796883,63
3990,6,12906,2939,9967,0,0,0,1.0,1,1.0,1,1.0,1,0.25038016003433056,62
3991,13,12919,2939,9980,0,0,0,1.0,1,1.0,1,1.0,1,0.10005687920277495,62
3992,7,12926,2939,9987,0,0,0,1.0,1,1.0,1,1.0,1,0.09143687905025757,65
3993,3,12929,2939,9990,0,0,0,1.0,1,1.0,1,1.0,1,0.11911163045346794,65
3994,5,12934,2939,9995,0,0,0,1.0,1,1.0,1,1.0,1,0.11537518701228283,64
3995,5,12939,2939,10000,0,0,0,1.0,1,1.0,1,1.0,1,0.12880180912393766,64
3996,8,12947,2939,10008,0,0,0,1.0,1,1.0,1,1.0,1,0.10790885828979951,67
3997,7,12954,2939,10015,0,0,0,1.0,1,1.0,1,1.0,1,0.12615014760456442,69
3998,9,12963,2940,10023,0,0,0,1.0,1,1.0,1,1.0,1,0.11212985952762945,69
3999,5,12968,2940,10028,0,0,0,1.0,1,1.0,1,1.0,1,0.12095953399708287,69
4000,6,12974,2941,10033,0,0,0,1.0,1,1.0,1,1.0,1,0.10555068117803691,69
4001,4,12978,2941,10037,0,0,0,1.0,1,1.0,1,1.0,1,0.1339732721962627,68
4002,6,12984,2942,10042,0,0,0,1.0,1,1.0,1,1.0,1,0.12381166633133743,68
4003,7,12991,2943,10048,0,0,0,1.0,1,1.0,1,1.0,1,0.14415602828711394,68
4004,7,12998,2944,10054,0,0,0,1.0,1,1.0,1,1.0,1,0.13835159693474322,67
4005,5,13003,2944,10059,0,0,0,1.0,1,1.0,1,1.0,1,0.16010029155791783,67
4006,9,13012,2947,10065,0,0,0,1.0,1,1.0,1,1.0,1,0.14483639489464928,67
4007,4,13016,2948,10068,0,0,0,1.0,1,1.0,1,1.0,1,0.1156581183056286,67
4008,4,13020,2950,10070,0,0,0,1.0,1,1.0,1,1.0,1,0.14046482480863143,67
4009,0,13020,2950,10070,0,0,0,1.0,1,1.0,1,1.0,1,0.14046482480863143,67
4010,2,13022,2951,10071,0,0,0,1.0,1,1.0,1,1.0,1,0.15060451904391095,66
4011,0,13022,2951,10071,0,0,0,1.0,1,1.0,1,1.0,1,0.15060451904391095,66
4012,1,13023,2951,10072,0,0,0,1.0,1,1.0,1,1.0,1,0.1699974485223148,66
4013,1,13024,2951,10073,0,0,0,1.0,1,1.0,1,1.0,1,0.1617319577193661,66
4014,2,13026,2953,10073,0,0,0,1.0,1,1.0,1,1.0,1,0.18176683134709515,66
4015,0,13026,2953,10073,0,0,0,1.0,1,1.0,1,1.0,1,0.19036387737188828,64
4016,5,13031,2955,10076,0,0,0,1.0,1,1.0,1,1.0,1,0.2485804847170172,64
4017,5,13036,2955,10081,0,0,0,1.0,1,1.0,1,1.0,1,0.23655607664194797,66
4018,5,13041,2955,10086,0,0,0,1.0,1,1.0,1,1.0,1,0.23664083584522766,67
4019,10,13051,2957,10094,0,0,0,1.0,1,1.0,1,1.0,1,0.22920572928040717,67
4020,4,13055,2957,10098,0,0,0,1.0,1,1.0,1,1.0,1,0.23416287718900494,66
4021,6,13061,2957,10104,0,0,0,1.0,1,1.0,1,1.0,1,0.1802184722774425,66
4022,2,13063,2958,10105,0,0,0,1.0,1,1.0,1,1.0,1,0.18106855224855228,66
4023,3,13066,2960,10106,0,0,0,1.0,1,1.0,1,1.0,1,0.17389570172462102,66
4024,4,13070,2961,10109,0,0,0,1.0,1,1.0,1,1.0,1,0.18246993050084842,66
4025,1,13071,2961,10110,0,0,0,1.0,1,1.0,1,1.0,1,0.1592021869489873,66
4026,5,13076,2961,10115,0,0,0,1.0,1,1.0,1,1.0,1,0.1558049362375147,66
4027,8,13084,2962,10122,0,0,0,1.0,1,1.0,1,1.0,1,0.17007990341006785,64
4028,6,13090,2965,10125,0,0,0,1.0,1,1.0,1,1.0,1,0.19024341373382941,63
4029,6,13096,2966,10130,0,0,0,1.0,1,1.0,1,1.0,1,0.19858799323997606,62
4030,7,13103,2967,10136,0,0,0,1.0,1,1.0,1,1.0,1,0.22539524048264142,63
4031,3,13106,2968,10138,0,0,0,1.0,1,1.0,1,1.0,1,0.23692192236680798,62
4032,9,13115,2971,10144,0,0,0,1.0,1,1.0,1,1.0,1,0.2036447319212637,62
4033,8,13123,2971,10152,0,0,0,1.0,1,1.0,1,1.0,1,0.21452239677152904,61
4034,8,13131,2974,10157,0,0,0,1.0,1,1.0,1,1.0,1,0.22920585711498795,60
4035,2,13133,2974,10159,0,0,0,1.0,1,1.0,1,1.0,1,0.232127453914393,59
4036,7,13140,2975,10165,0,0,0,1.0,1,1.0,1,1.0,1,0.13501716958262253,58
4037,4,13144,2976,10168,0,0,0,1.0,1,1.0,1,1.0,1,0.09199752857651694,59
4038,3,13147,2977,10170,0,0,0,1.0,1,1.0,1,1.0,1,0.10575418058245224,58
4039,1,13148,2978,10170,0,0,0,1.0,1,1.0,1,1.0,1,0.12208707794290773,56
4040,0,13148,2978,10170,0,0,0,1.0,1,1.0,1,1.0,1,0.13405179603020084,55
4041,2,13150,2980,10170,0,0,0,1.0,1,1.0,1,1.0,1,0.1818604684440558,54
4042,8,13158,2983,10175,0,0,0,1.0,1,1.0,1,1.0,1,0.22914363733124143,56
4043,10,13168,2984,10184,0,0,0,1.0,1,1.0,1,1.0,1,0.24030871821370153,56
4044,8,13176,2986,10190,0,0,0,1.0,1,1.0,1,1.0,1,0.2873183112506777,56
4045,6,13182,2986,10196,0,0,0,1.0,1,1.0,1,1.0,1,0.26132868894587263,57
4046,10,13192,2986,10206,0,0,0,1.0,1,1.0,1,1.0,1,0.2732997925980245,59
4047,18,13210,2988,10222,0,0,0,1.0,1,1.0,1,1.0,1,0.3029714436723372,59
4048,12,13222,2988,10234,0,0,0,1.0,1,1.0,1,1.0,1,0.3030973842705892,59
4049,12,13234,2988,10246,0,0,0,1.0,1,1.0,1,1.0,1,0.2923094250529585,60
4050,12,13246,2988,10258,0,0,0,1.0,1,1.0,1,1.0,1,0.2984229503779369,60
4051,7,13253,2988,10265,0,0,0,1.0,1,1.0,1,1.0,1,0.24055420548444628,60
4052,1,13254,2988,10266,0,0,0,1.0,1,1.0,1,1.0,1,0.23419528390846053,60
4053,0,13254,2988,10266,0,0,0,1.0,1,1.0,1,1.0,1,0.23419528390846053,60
4054,1,13255,2989,10266,0,0,0,1.0,1,1.0,1,1.0,1,0.22817800803146385,61
4055,0,13255,2989,10266,0,0,0,1.0,1,1.0,1,1.0,1,0.22817800803146385,61
4056,1,13256,2989,10267,0,0,0,1.0,1,1.0,1,1.0,1,0.23249124114172823,62
4057,0,13256,2989,10267,0,0,0,1.0,1,1.0,1,1.0,1,0.2323669870999815,63
4058,5,13261,2990,10271,0,0,0,1.0,1,1.0,1,1.0,1,0.23685250247567322,64
4059,0,13261,2990,10271,0,0,0,1.0,1,1.0,1,1.0,1,0.2504592706408696,63
4060,0,13261,2990,10271,0,0,0,1.0,1,1.0,1,1.0,1,0.2504592706408696,63
4061,2,13263,2990,10273,0,0,0,1.0,1,1.0,1,1.0,1,0.2545165501777416,63
4062,3,13266,2991,10275,0,0,0,1.0,1,1.0,1,1.0,1,0.23891480618860106,65
4063,5,13271,2991,10280,0,0,0,1.0,1,1.0,1,1.0,1,0.20403128191796602,64
4064,6,13277,2992,10285,0,0,0,1.0,1,1.0,1,1.0,1,0.18858583758273456,65
4065,2,13279,2993,10286,0,0,0,1.0,1,1.0,1,1.0,1,0.17419599776876035,64
4066,3,13282,2994,10288,0,0,0,1.0,1,1.0,1,1.0,1,0.16510256075941712,64
4067,4,13286,2996,10290,0,0,0,1.0,1,1.0,1,1.0,1,0.19934930084489866,63
4068,1,13287,2996,10291,0,0,0,1.0,1,1.0,1,1.0,1,0.18365127688304186,64
4069,6,13293,2999,10294,0,0,0,1.0,1,1.0,1,1.0,1,0.17937436028808307,62
4070,1,13294,3000,10294,0,0,0,1.0,1,1.0,1,1.0,1,0.17446604281027078,61
4071,3,13297,3002,10295,0,0,0,1.0,1,1.0,1,1.0,1,0.1974498159503798,61
4072,7,13304,3006,10298,0,0,0,1.0,1,1.0,1,1.0,1,0.2225300549989952,60
4073,2,13306,3007,10299,0,0,0,1.0,1,1.0,1,1.0,1,0.20408448429147005,60
4074,3,13309,3010,10299,0,0,0,1.0,1,1.0,1,1.0,1,0.22171690602288416,60
4075,1,13310,3011,10299,0,0,0,1.0,1,1.0,1,1.0,1,0.20025286540626866,59
4076,1,13311,3011,10300,0,0,0,1.0,1,1.0,1,1.0,1,0.20061697067217008,60
4077,2,13313,3013,10300,0,0,0,1.0,1,1.0,1,1.0,1,0.20203377620879082,61
4078,0,13313,3013,10300,0,0,0,1.0,1,1.0,1,1.0,1,0.2125318550429685,60
4079,3,13316,3014,10302,0,0,0,1.0,1,1.0,1,1.0,1,0.21921054555701291,58
4080,2,13318,3015,10303,0,0,0,1.0,1,1.0,1,1.0,1,0.23923224319381503,56
4081,11,13329,3016,10313,0,0,0,1.0,1,1.0,1,1.0,1,0.16046328265439827,56
4082,2,13331,3016,10315,0,0,0,1.0,1,1.0,1,1.0,1,0.1711711085742596,55
4083,3,13334,3017,10317,0,0,0,1.0,1,1.0,1,1.0,1,0.17293426636499656,55
4084,3,13337,3018,10319,0,0,0,1.0,1,1.0,1,1.0,1,0.17923469977774034,55
4085,4,13341,3019,10322,0,0,0,1.0,1,1.0,1,1.0,1,0.16468292765178932,56
4086,4,13345,3020,10325,0,0,0,1.0,1,1.0,1,1.0,1,0.1449865371416751,57
4087,4,13349,3021,10328,0,0,0,1.0,1,1.0,1,1.0,1,0.19847696697515232,57
4088,3,13352,3021,10331,0,0,0,1.0,1,1.0,1,1.0,1,0.19523573102215058,57
4089,6,13358,3021,10337,0,0,0,1.0,1,1.0,1,1.0,1,0.2177294328813314,56
4090,5,13363,3022,10341,0,0,0,1.0,1,1.0,1,1.0,1,0.2319729143617778,56
4091,5,13368,3022,10346,0,0,0,1.0,1,1.0,1,1.0,1,0.21137014310137886,56
4092,4,13372,3022,10350,0,0,0,1.0,1,1.0,1,1.0,1,0.22899093484053298,57
4093,7,13379,3023,10356,0,0,0,1.0,1,1.0,1,1.0,1,0.21546691614739877,58
4094,8,13387,3024,10363,0,0,0,1.0,1,1.0,1,1.0,1,0.1905439623011337,57
4095,6,13393,3024,10369,0,0,0,1.0,1,1.0,1,1.0,1,0.15874778186292268,57
4096,3,13396,3024,10372,0,0,0,1.0,1,1.0,1,1.0,1,0.12242102550810882,59
4097,1,13397,3024,10373,0,0,0,1.0,1,1.0,1,1.0,1,0.10351030938154376,59
4098,2,13399,3024,10375,0,0,0,1.0,1,1.0,1,1.0,1,0.07393572932378703,59
4099,1,13400,3025,10375,0,0,0,1.0,1,1.0,1,1.0,1,0.10801791303074829,60
4100,3,13403,3027,10376,0,0,0,1.0,1,1.0,1,1.0,1,0.10395788402709358,60
4101,2,13405,3028,10377,0,0,0,1.0,1,1.0,1,1.0,1,0.08976819535293995,60
4102,7,13412,3034,10378,0,0,0,1.0,1,1.0,1,1.0,1,0.11842012078427536,60
4103,1,13413,3035,10378,0,0,0,1.0,1,1.0,1,1.0,1,0.15772229073599217,58
4104,1,13414,3036,10378,0,0,0,1.0,1,1.0,1,1.0,1,0.11771496075065153,60
4105,2,13416,3038,10378,0,0,0,1.0,1,1.0,1,1.0,1,0.10938726303730566,59
4106,2,13418,3039,10379,0,0,0,1.0,1,1.0,1,1.0,1,0.11212813809720834,61
4107,1,13419,3040,10379,0,0,0,1.0,1,1.0,1,1.0,1,0.12556287888379464,59
4108,0,13419,3040,10379,0,0,0,1.0,1,1.0,1,1.0,1,0.11053166804004524,60
4109,1,13420,3041,10379,0,0,0,1.0,1,1.0,1,1.0,1,0.11849360734277738,59
4110,3,13423,3042,10381,0,0,0,1.0,1,1.0,1,1.0,1,0.11199845616999447,60
4111,5,13428,3042,10386,0,0,0,1.0,1,1.0,1,1.0,1,0.062379366463681835,61
4112,2,13430,3043,10387,0,0,0,1.0,1,1.0,1,1.0,1,0.055769217125990395,60
4113,0,13430,3043,10387,0,0,0,1.0,1,1.0,1,1.0,1,0.04900202219226125,61
4114,0,13430,3043,10387,0,0,0,1.0,1,1.0,1,1.0,1,0.073802659591697,62
4115,2,13432,3044,10388,0,0,0,1.0,1,1.0,1,1.0,1,0.11533321511139932,60
4116,1,13433,3045,10388,0,0,0,1.0,1,1.0,1,1.0,1,0.12217948460276827,59
4117,5,13438,3049,10389,0,0,0,1.0,1,1.0,1,1.0,1,0.159288101048649,56
4118,0,13438,3049,10389,0,0,0,1.0,1,1.0,1,1.0,1,0.14200873491169724,55
4119,1,13439,3049,10390,0,0,0,1.0,1,1.0,1,1.0,1,0.14596571641272932,53
4120,3,13442,3051,10391,0,0,0,1.0,1,1.0,1,1.0,1,0.21129014264393053,52
4121,6,13448,3056,10392,0,0,0,1.0,1,1.0,1,1.0,1,0.22992100706923635,53
4122,4,13452,3057,10395,0,0,0,1.0,1,1.0,1,1.0,1,0.18909034434425814,52
4123,2,13454,3059,10395,0,0,0,1.0,1,1.0,1,1.0,1,0.20037852495690564,51
4124,1,13455,3060,10395,0,0,0,1.0,1,1.0,1,1.0,1,0.22060418792359293,51
4125,3,13458,3061,10397,0,0,0,1.0,1,1.0,1,1.0,1,0.2035923370711092,50
4126,9,13467,3064,10403,0,0,0,1.0,1,1.0,1,1.0,1,0.17551689124345143,50
4127,3,13470,3065,10405,0,0,0,1.0,1,1.0,1,1.0,1,0.20586077002193334,49
4128,4,13474,3065,10409,0,0,0,1.0,1,1.0,1,1.0,1,0.1736914677857814,49
4129,3,13477,3065,10412,0,0,0,1.0,1,1.0,1,1.0,1,0.20264914886871965,49
4130,4,13481,3065,10416,0,0,0,1.0,1,1.0,1,1.0,1,0.19436623581824564,50
4131,4,13485,3065,10420,0,0,0,1.0,1,1.0,1,1.0,1,0.20158839075228102,50
4132,2,13487,3065,10422,0,0,0,1.0,1,1.0,1,1.0,1,0.1834918164047495,50
4133,4,13491,3066,10425,0,0,0,1.0,1,1.0,1,1.0,1,0.1463498750281424,51
4134,0,13491,3066,10425,0,0,0,1.0,1,1.0,1,1.0,1,0.12379781959858092,53
4135,0,13491,3066,10425,0,0,0,1.0,1,1.0,1,1.0,1,0.13162227133422708,54
4136,2,13493,3066,10427,0,0,0,1.0,1,1.0,1,1.0,1,0.12181767379696168,54
4137,5,13498,3068,10430,0,0,0,1.0,1,1.0,1,1.0,1,0.15702161684528165,55
4138,0,13498,3068,10430,0,0,0,1.0,1,1.0,1,1.0,1,0.17539035996760993,54
4139,2,13500,3068,10432,0,0,0,1.0,1,1.0,1,1.0,1,0.19071968076109194,54
4140,8,13508,3070,10438,0,0,0,1.0,1,1.0,1,1.0,1,0.19037152158206247,55
4141,9,13517,3070,10447,0,0,0,1.0,1,1.0,1,1.0,1,0.21295172046595032,55
4142,4,13521,3070,10451,0,0,0,1.0,1,1.0,1,1.0,1,0.15746455548757338,55
4143,3,13524,3070,10454,0,0,0,1.0,1,1.0,1,1.0,1,0.1876786229224905,53
4144,5,13529,3071,10458,0,0,0,1.0,1,1.0,1,1.0,1,0.19814123314801318,52
4145,5,13534,3073,10461,0,0,0,1.0,1,1.0,1,1.0,1,0.21822352424045688,51
4146,5,13539,3073,10466,0,0,0,1.0,1,1.0,1,1.0,1,0.21032354206023549,51
4147,5,13544,3075,10469,0,0,0,1.0,1,1.0,1,1.0,1,0.2618108695582715,50
4148,11,13555,3076,10479,0,0,0,1.0,1,1.0,1,1.0,1,0.28706625612269554,52
4149,9,13564,3076,10488,0,0,0,1.0,1,1.0,1,1.0,1,0.22949814327959514,53
4150,9,13573,3078,10495,0,0,0,1.0,1,1.0,1,1.0,1,0.24114107133505439,53
4151,5,13578,3078,10500,0,0,0,1.0,1,1.0,1,1.0,1,0.27800631463441416,53
4152,8,13586,3079,10507,0,0,0,1.0,1,1.0,1,1.0,1,0.20102823668088804,54
4153,5,13591,3079,10512,0,0,0,1.0,1,1.0,1,1.0,1,0.1988552029275411,51
4154,4,13595,3079,10516,0,0,0,1.0,1,1.0,1,1.0,1,0.1988552029275411,51
4155,7,13602,3080,10522,0,0,0,1.0,1,1.0,1,1.0,1,0.20865877330770885,51
4156,9,13611,3081,10530,0,0,0,1.0,1,1.0,1,1.0,1,0.12528119919991604,52
4157,2,13613,3081,10532,0,0,0,1.0,1,1.0,1,1.0,1,0.13246599896151215,52
4158,4,13617,3082,10535,0,0,0,1.0,1,1.0,1,1.0,1,0.15991613294972956,52
4159,4,13621,3084,10537,0,0,0,1.0,1,1.0,1,1.0,1,0.15235698215191948,52
4160,3,13624,3085,10539,0,0,0,1.0,1,1.0,1,1.0,1,0.18985028642003687,50
4161,5,13629,3087,10542,0,0,0,1.0,1,1.0,1,1.0,1,0.23280115542371813,50
4162,5,13634,3087,10547,0,0,0,1.0,1,1.0,1,1.0,1,0.20426854089402788,51
4163,0,13634,3087,10547,0,0,0,1.0,1,1.0,1,1.0,1,0.22756358542127772,48
4164,1,13635,3087,10548,0,0,0,1.0,1,1.0,1,1.0,1,0.23318764029794195,50
4165,2,13637,3087,10550,0,0,0,1.0,1,1.0,1,1.0,1,0.23004261425275915,49
4166,3,13640,3088,10552,0,0,0,1.0,1,1.0,1,1.0,1,0.1915196601426935,50
4167,2,13642,3088,10554,0,0,0,1.0,1,1.0,1,1.0,1,0.1937380341350568,50
4168,3,13645,3089,10556,0,0,0,1.0,1,1.0,1,1.0,1,0.24338579901794935,50
4169,5,13650,3090,10560,0,0,0,1.0,1,1.0,1,1.0,1,0.2670221520735795,51
4170,3,13653,3090,10563,0,0,0,1.0,1,1.0,1,1.0,1,0.2626114063356383,50
4171,7,13660,3091,10569,0,0,0,1.0,1,1.0,1,1.0,1,0.20820767130094983,50
4172,1,13661,3091,10570,0,0,0,1.0,1,1.0,1,1.0,1,0.2138725163014016,49
4173,2,13663,3093,10570,0,0,0,1.0,1,1.0,1,1.0,1,0.24379152771214055,48
4174,2,13665,3094,10571,0,0,0,1.0,1,1.0,1,1.0,1,0.23859506119489612,48
4175,0,13665,3094,10571,0,0,0,1.0,1,1.0,1,1.0,1,0.23859506119489612,48
4176,2,13667,3095,10572,0,0,0,1.0,1,1.0,1,1.0,1,0.2803942764220604,50
4177,9,13676,3097,10579,0,0,0,1.0,1,1.0,1,1.0,1,0.2530172132332342,52
4178,4,13680,3099,10581,0,0,0,1.0,1,1.0,1,1.0,1,0.23062774810250394,53
4179,1,13681,3100,10581,0,0,0,1.0,1,1.0,1,1.0,1,0.22303200495641964,54
4180,1,13682,3100,10582,0,0,0,1.0,1,1.0,1,1.0,1,0.23096252839569054,55
4181,1,13683,3100,10583,0,0,0,1.0,1,1.0,1,1.0,1,0.20825749692532725,56
4182,1,13684,3101,10583,0,0,0,1.0,1,1.0,1,1.0,1,0.20063852672327565,56
4183,2,13686,3102,10584,0,0,0,1.0,1,1.0,1,1.0,1,0.16811305119873352,57
4184,8,13694,3105,10589,0,0,0,1.0,1,1.0,1,1.0,1,0.23238384291672998,57
4185,5,13699,3106,10593,0,0,0,1.0,1,1.0,1,1.0,1,0.20584072965480155,54
4186,12,13711,3108,10603,0,0,0,1.0,1,1.0,1,1.0,1,0.10547062929840594,55
4187,1,13712,3109,10603,0,0,0,1.0,1,1.0,1,1.0,1,0.09862775848266538,53
4188,5,13717,3111,10606,0,0,0,1.0,1,1.0,1,1.0,1,0.11648107005331128,53
4189,2,13719,3111,10608,0,0,0,1.0,1,1.0,1,1.0,1,0.11635787488972126,53
4190,4,13723,3112,10611,0,0,0,1.0,1,1.0,1,1.0,1,0.10756951605028627,53
4191,3,13726,3112,10614,0,0,0,1.0,1,1.0,1,1.0,1,0.12038319326006726,51
4192,3,13729,3113,10616,0,0,0,1.0,1,1.0,1,1.0,1,0.14567525837863649,51
4193,2,13731,3113,10618,0,0,0,1.0,1,1.0,1,1.0,1,0.14494106493940195,50
4194,3,13734,3113,10621,0,0,0,1.0,1,1.0,1,1.0,1,0.15264303137633842,50
4195,2,13736,3113,10623,0,0,0,1.0,1,1.0,1,1.0,1,0.18041717168142,50
4196,5,13741,3114,10627,0,0,0,1.0,1,1.0,1,1.0,1,0.21565588429700577,51
4197,5,13746,3115,10631,0,0,0,1.0,1,1.0,1,1.0,1,0.24402493622391266,50
4198,6,13752,3116,10636,0,0,0,1.0,1,1.0,1,1.0,1,0.27906038957244855,48
4199,2,13754,3116,10638,0,0,0,1.0,1,1.0,1,1.0,1,0.24715679470553253,48
4200,3,13757,3116,10641,0,0,0,1.0,1,1.0,1,1.0,1,0.24352608606329104,48
4201,6,13763,3116,10647,0,0,0,1.0,1,1.0,1,1.0,1,0.17963031947569347,47
4202,1,13764,3116,10648,0,0,0,1.0,1,1.0,1,1.0,1,0.17286446392227706,47
4203,1,13765,3117,10648,0,0,0,1.0,1,1.0,1,1.0,1,0.20166606955541777,47
4204,1,13766,3118,10648,0,0,0,1.0,1,1.0,1,1.0,1,0.23099935099796012,48
4205,0,13766,3118,10648,0,0,0,1.0,1,1.0,1,1.0,1,0.2113550617438409,49
4206,0,13766,3118,10648,0,0,0,1.0,1,1.0,1,1.0,1,0.2113550617438409,49
4207,0,13766,3118,10648,0,0,0,1.0,1,1.0,1,1.0,1,0.2088049530092477,48
4208,1,13767,3119,10648,0,0,0,1.0,1,1.0,1,1.0,1,0.21663096871093035,49
4209,9,13776,3121,10655,0,0,0,1.0,1,1.0,1,1.0,1,0.18511027919798037,51
4210,1,13777,3121,10656,0,0,0,1.0,1,1.0,1,1.0,1,0.1762509687580466,52
4211,1,13778,3121,10657,0,0,0,1.0,1,1.0,1,1.0,1,0.1791105911082205,53
4212,3,13781,3122,10659,0,0,0,1.0,1,1.0,1,1.0,1,0.20379931589706843,53
4213,3,13784,3122,10662,0,0,0,1.0,1,1.0,1,1.0,1,0.18504056735535618,54
4214,2,13786,3123,10663,0,0,0,1.0,1,1.0,1,1.0,1,0.18365055127110133,54
4215,6,13792,3124,10668,0,0,0,1.0,1,1.0,1,1.0,1,0.17445587812653418,54
4216,1,13793,3124,10669,0,0,0,1.0,1,1.0,1,1.0,1,0.18419800084176283,53
4217,4,13797,3126,10671,0,0,0,1.0,1,1.0,1,1.0,1,0.22286150042667394,54
4218,2,13799,3126,10673,0,0,0,1.0,1,1.0,1,1.0,1,0.24572290685541467,53
4219,3,13802,3126,10676,0,0,0,1.0,1,1.0,1,1.0,1,0.24051909210485173,53
4220,2,13804,3127,10677,0,0,0,1.0,1,1.0,1,1.0,1,0.2775693404660061,53
4221,5,13809,3128,10681,0,0,0,1.0,1,1.0,1,1.0,1,0.322446153912899,54
4222,4,13813,3130,10683,0,0,0,1.0,1,1.0,1,1.0,1,0.3174039917941726,55
4223,7,13820,3131,10689,0,0,0,1.0,1,1.0,1,1.0,1,0.2594890971872833,56
4224,1,13821,3132,10689,0,0,0,1.0,1,1.0,1,1.0,1,0.2579053126839723,55
4225,1,13822,3132,10690,0,0,0,1.0,1,1.0,1,1.0,1,0.2481043979055379,53
4226,5,13827,3134,10693,0,0,0,1.0,1,1.0,1,1.0,1,0.25584530375118547,54
4227,3,13830,3135,10695,0,0,0,1.0,1,1.0,1,1.0,1,0.23460090779028941,52
4228,3,13833,3137,10696,0,0,0,1.0,1,1.0,1,1.0,1,0.23651255062976023,51
4229,3,13836,3138,10698,0,0,0,1.0,1,1.0,1,1.0,1,0.23742570896418697,48
4230,2,13838,3140,10698,0,0,0,1.0,1,1.0,1,1.0,1,0.26022679072566474,48
4231,5,13843,3141,10702,0,0,0,1.0,1,1.0,1,1.0,1,0.18412661630944815,48
4232,3,13846,3142,10704,0,0,0,1.0,1,1.0,1,1.0,1,0.16398019568218816,48
4233,2,13848,3142,10706,0,0,0,1.0,1,1.0,1,1.0,1,0.1012347751670808,48
4234,8,13856,3144,10712,0,0,0,1.0,1,1.0,1,1.0,1,0.09615427208997332,49
4235,5,13861,3144,10717,0,0,0,1.0,1,1.0,1,1.0,1,0.0952914950779402,47
4236,6,13867,3145,10722,0,0,0,1.0,1,1.0,1,1.0,1,0.10241569689786886,47
4237,6,13873,3145,10728,0,0,0,1.0,1,1.0,1,1.0,1,0.12554604014124615,48
4238,5,13878,3145,10733,0,0,0,1.0,1,1.0,1,1.0,1,0.09389829769669088,47
4239,3,13881,3145,10736,0,0,0,1.0,1,1.0,1,1.0,1,0.1074307167657834,48
4240,4,13885,3145,10740,0,0,0,1.0,1,1.0,1,1.0,1,0.1302873071248182,47
4241,3,13888,3145,10743,0,0,0,1.0,1,1.0,1,1.0,1,0.13541235378752084,49
4242,5,13893,3145,10748,0,0,0,1.0,1,1.0,1,1.0,1,0.14502859786792605,49
4243,5,13898,3145,10753,0,0,0,1.0,1,1.0,1,1.0,1,0.16827106208182482,50
4244,5,13903,3145,10758,0,0,0,1.0,1,1.0,1,1.0,1,0.13688767364516952,51
4245,4,13907,3145,10762,0,0,0,1.0,1,1.0,1,1.0,1,0.1392875444970731,51
4246,6,13913,3145,10768,0,0,0,1.0,1,1.0,1,1.0,1,0.07484014580651449,51
4247,3,13916,3145,10771,0,0,0,1.0,1,1.0,1,1.0,1,0.07595196959752373,52
4248,1,13917,3145,10772,0,0,0,1.0,1,1.0,1,1.0,1,0.09315857569319012,52
4249,1,13918,3145,10773,0,0,0,1.0,1,1.0,1,1.0,1,0.0781067681794501,52
4250,3,13921,3147,10774,0,0,0,1.0,1,1.0,1,1.0,1,0.12249647959404271,52
4251,10,13931,3149,10782,0,0,0,1.0,1,1.0,1,1.0,1,0.10100286757179117,53
4252,4,13935,3150,10785,0,0,0,1.0,1,1.0,1,1.0,1,0.10771478382397613,53
4253,8,13943,3153,10790,0,0,0,1.0,1,1.0,1,1.0,1,0.14158431387984105,54
4254,5,13948,3154,10794,0,0,0,1.0,1,1.0,1,1.0,1,0.13312555851506686,54
4255,5,13953,3156,10797,0,0,0,1.0,1,1.0,1,1.0,1,0.15928482114509204,55
4256,6,13959,3157,10802,0,0,0,1.0,1,1.0,1,1.0,1,0.18693964820444328,57
4257,5,13964,3157,10807,0,0,0,1.0,1,1.0,1,1.0,1,0.1522095399315896,57
4258,10,13974,3157,10817,0,0,0,1.0,1,1.0,1,1.0,1,0.1485889029674624,57
4259,8,13982,3157,10825,0,0,0,1.0,1,1.0,1,1.0,1,0.11964194954199857,57
4260,7,13989,3157,10832,0,0,0,1.0,1,1.0,1,1.0,1,0.13242072538999083,58
4261,5,13994,3157,10837,0,0,0,1.0,1,1.0,1,1.0,1,0.07401852294623046,59
4262,2,13996,3158,10838,0,0,0,1.0,1,1.0,1,1.0,1,0.06573464356300891,60
4263,1,13997,3159,10838,0,0,0,1.0,1,1.0,1,1.0,1,0.055140512950266875,59
4264,0,13997,3159,10838,0,0,0,1.0,1,1.0,1,1.0,1,0.06661261666571555,58
4265,3,14000,3160,10840,0,0,0,1.0,1,1.0,1,1.0,1,0.10238060121371266,58
4266,3,14003,3162,10841,0,0,0,1.0,1,1.0,1,1.0,1,0.09281194116443699,58
4267,3,14006,3163,10843,0,0,0,1.0,1,1.0,1,1.0,1,0.11486906233209948,55
4268,1,14007,3164,10843,0,0,0,1.0,1,1.0,1,1.0,1,0.12376494295034467,55
4269,2,14009,3165,10844,0,0,0,1.0,1,1.0,1,1.0,1,0.12797133327269858,50
4270,2,14011,3167,10844,0,0,0,1.0,1,1.0,1,1.0,1,0.1422658446728094,47
4271,1,14012,3168,10844,0,0,0,1.0,1,1.0,1,1.0,1,0.17067609145490625,47
4272,2,14014,3169,10845,0,0,0,1.0,1,1.0,1,1.0,1,0.21829617900162981,46
4273,5,14019,3172,10847,0,0,0,1.0,1,1.0,1,1.0,1,0.26924399143753974,47
4274,2,14021,3173,10848,0,0,0,1.0,1,1.0,1,1.0,1,0.3157086491321008,45
4275,4,14025,3176,10849,0,0,0,1.0,1,1.0,1,1.0,1,0.32771177628663667,44
4276,11,14036,3178,10858,0,0,0,1.0,1,1.0,1,1.0,1,0.16646915984348737,43
4277,4,14040,3178,10862,0,0,0,1.0,1,1.0,1,1.0,1,0.20964918519687395,42
4278,4,14044,3179,10865,0,0,0,1.0,1,1.0,1,1.0,1,0.1956899014950496,43
4279,5,14049,3180,10869,0,0,0,1.0,1,1.0,1,1.0,1,0.24503190156228355,42
4280,6,14055,3182,10873,0,0,0,1.0,1,1.0,1,1.0,1,0.2544221590419161,44
4281,7,14062,3183,10879,0,0,0,1.0,1,1.0,1,1.0,1,0.23315832554536875,44
4282,6,14068,3183,10885,0,0,0,1.0,1,1.0,1,1.0,1,0.23969632816719708,44
4283,4,14072,3183,10889,0,0,0,1.0,1,1.0,1,1.0,1,0.201019000461435,45
4284,3,14075,3183,10892,0,0,0,1.0,1,1.0,1,1.0,1,0.19932135306273358,45
4285,4,14079,3183,10896,0,0,0,1.0,1,1.0,1,1.0,1,0.1583538161975902,47
4286,1,14080,3183,10897,0,0,0,1.0,1,1.0,1,1.0,1,0.14852673022782573,47
4287,5,14085,3183,10902,0,0,0,1.0,1,1.0,1,1.0,1,0.18477676556562295,49
4288,5,14090,3183,10907,0,0,0,1.0,1,1.0,1,1.0,1,0.18481934093533567,49
4289,6,14096,3183,10913,0,0,0,1.0,1,1.0,1,1.0,1,0.18070646560724687,50
4290,4,14100,3183,10917,0,0,0,1.0,1,1.0,1,1.0,1,0.1926850581213389,51
4291,10,14110,3183,10927,0,0,0,1.0,1,1.0,1,1.0,1,0.09148556833341233,50
4292,6,14116,3184,10932,0,0,0,1.0,1,1.0,1,1.0,1,0.12533410673549586,51
4293,3,14119,3184,10935,0,0,0,1.0,1,1.0,1,1.0,1,0.09832957535855735,51
4294,4,14123,3185,10938,0,0,0,1.0,1,1.0,1,1.0,1,0.1778598297886559,50
4295,6,14129,3186,10943,0,0,0,1.0,1,1.0,1,1.0,1,0.15091253061720472,50
4296,3,14132,3186,10946,0,0,0,1.0,1,1.0,1,1.0,1,0.1281149332212658,49
4297,3,14135,3186,10949,0,0,0,1.0,1,1.0,1,1.0,1,0.19160251644189102,49
4298,7,14142,3186,10956,0,0,0,1.0,1,1.0,1,1.0,1,0.1540112370849586,49
4299,6,14148,3186,10962,0,0,0,1.0,1,1.0,1,1.0,1,0.16605868865119436,48
4300,9,14157,3188,10969,0,0,0,1.0,1,1.0,1,1.0,1,0.13180689219238528,49
4301,10,14167,3189,10978,0,0,0,1.0,1,1.0,1,1.0,1,0.15027883516520643,50
4302,5,14172,3190,10982,0,0,0,1.0,1,1.0,1,1.0,1,0.1488176004852985,51
4303,4,14176,3191,10985,0,0,0,1.0,1,1.0,1,1.0,1,0.14698830312797664,51
4304,8,14184,3195,10989,0,0,0,1.0,1,1.0,1,1.0,1,0.22335629969033385,51
4305,8,14192,3196,10996,0,0,0,1.0,1,1.0,1,1.0,1,0.2032556130820097,49
4306,9,14201,3197,11004,0,0,0,1.0,1,1.0,1,1.0,1,0.0891824204307593,49
4307,0,14201,3197,11004,0,0,0,1.0,1,1.0,1,1.0,1,0.0812999063545989,46
4308,0,14201,3197,11004,0,0,0,1.0,1,1.0,1,1.0,1,0.07664184517436545,44
4309,1,14202,3197,11005,0,0,0,1.0,1,1.0,1,1.0,1,0.09907406196195476,44
4310,1,14203,3198,11005,0,0,0,1.0,1,1.0,1,1.0,1,0.12774940322398584,42
4311,5,14208,3201,11007,0,0,0,1.0,1,1.0,1,1.0,1,0.16159835134222925,42
4312,1,14209,3202,11007,0,0,0,1.0,1,1.0,1,1.0,1,0.19938644457247162,40
4313,4,14213,3204,11009,0,0,0,1.0,1,1.0,1,1.0,1,0.1759391482230589,40
4314,0,14213,3204,11009,0,0,0,1.0,1,1.0,1,1.0,1,0.2290335092223245,36
4315,1,14214,3205,11009,0,0,0,1.0,1,1.0,1,1.0,1,0.24406986736986686,37
4316,2,14216,3207,11009,0,0,0,1.0,1,1.0,1,1.0,1,0.24023572861960413,37
4317,2,14218,3209,11009,0,0,0,1.0,1,1.0,1,1.0,1,0.223734850882057,36
4318,2,14220,3210,11010,0,0,0,1.0,1,1.0,1,1.0,1,0.2515645090993447,34
4319,1,14221,3211,11010,0,0,0,1.0,1,1.0,1,1.0,1,0.2458921018279193,34
4320,0,14221,3211,11010,0,0,0,1.0,1,1.0,1,1.0,1,0.2458921018279193,34
4321,7,14228,3211,11017,0,0,0,1.0,1,1.0,1,1.0,1,0.1607119721904377,35
4322,0,14228,3211,11017,0,0,0,1.0,1,1.0,1,1.0,1,0.1607119721904377,35
4323,2,14230,3211,11019,0,0,0,1.0,1,1.0,1,1.0,1,0.15790174263464765,35
4324,1,14231,3211,11020,0,0,0,1.0,1,1.0,1,1.0,1,0.168435908114246,34
4325,4,14235,3211,11024,0,0,0,1.0,1,1.0,1,1.0,1,0.13999501385468102,34
4326,3,14238,3211,11027,0,0,0,1.0,1,1.0,1,1.0,1,0.1636914998535835,36
4327,3,14241,3211,11030,0,0,0,1.0,1,1.0,1,1.0,1,0.12434881517911985,35
4328,1,14242,3211,11031,0,0,0,1.0,1,1.0,1,1.0,1,0.10477711848865742,35
4329,8,14250,3212,11038,0,0,0,1.0,1,1.0,1,1.0,1,0.10881164448486919,38
4330,8,14258,3212,11046,0,0,0,1.0,1,1.0,1,1.0,1,0.1570153588589747,38
4331,4,14262,3212,11050,0,0,0,1.0,1,1.0,1,1.0,1,0.17390501208980905,39
4332,7,14269,3212,11057,0,0,0,1.0,1,1.0,1,1.0,1,0.1869780368255577,40
4333,7,14276,3212,11064,0,0,0,1.0,1,1.0,1,1.0,1,0.19002431287947763,41
4334,8,14284,3213,11071,0,0,0,1.0,1,1.0,1,1.0,1,0.18435738121037484,41
4335,4,14288,3213,11075,0,0,0,1.0,1,1.0,1,1.0,1,0.1654277114602556,42
4336,3,14291,3213,11078,0,0,0,1.0,1,1.0,1,1.0,1,0.08647384494916938,43
4337,2,14293,3213,11080,0,0,0,1.0,1,1.0,1,1.0,1,0.112712710341107,44
4338,0,14293,3213,11080,0,0,0,1.0,1,1.0,1,1.0,1,0.112712710341107,44
4339,1,14294,3213,11081,0,0,0,1.0,1,1.0,1,1.0,1,0.10714807342234119,46
4340,0,14294,3213,11081,0,0,0,1.0,1,1.0,1,1.0,1,0.11244259092620681,47
4341,2,14296,3214,11082,0,0,0,1.0,1,1.0,1,1.0,1,0.13491910480503944,47
4342,4,14300,3217,11083,0,0,0,1.0,1,1.0,1,1.0,1,0.1761293993086504,47
4343,0,14300,3217,11083,0,0,0,1.0,1,1.0,1,1.0,1,0.12180008480921178,42
4344,6,14306,3221,11085,0,0,0,1.0,1,1.0,1,1.0,1,0.20887194940946804,42
4345,4,14310,3223,11087,0,0,0,1.0,1,1.0,1,1.0,1,0.16649785965428182,39
4346,3,14313,3226,11087,0,0,0,1.0,1,1.0,1,1.0,1,0.23739768115751816,37
4347,2,14315,3228,11087,0,0,0,1.0,1,1.0,1,1.0,1,0.2881543953372891,37
4348,8,14323,3231,11092,0,0,0,1.0,1,1.0,1,1.0,1,0.2651190968411415,38
4349,1,14324,3231,11093,0,0,0,1.0,1,1.0,1,1.0,1,0.2548998216954412,36
4350,1,14325,3231,11094,0,0,0,1.0,1,1.0,1,1.0,1,0.20516762532231006,37
4351,2,14327,3232,11095,0,0,0,1.0,1,1.0,1,1.0,1,0.18327929735226678,35
4352,3,14330,3233,11097,0,0,0,1.0,1,1.0,1,1.0,1,0.19797339533568292,34
4353,1,14331,3233,11098,0,0,0,1.0,1,1.0,1,1.0,1,0.20781088021092176,34
4354,0,14331,3233,11098,0,0,0,1.0,1,1.0,1,1.0,1,0.23487831543810578,32
4355,2,14333,3233,11100,0,0,0,1.0,1,1.0,1,1.0,1,0.1856109522521312,32
4356,1,14334,3234,11100,0,0,0,1.0,1,1.0,1,1.0,1,0.23813953550289918,34
4357,0,14334,3234,11100,0,0,0,1.0,1,1.0,1,1.0,1,0.24271371106038417,35
4358,2,14336,3236,11100,0,0,0,1.0,1,1.0,1,1.0,1,0.3124964657146537,35
4359,3,14339,3236,11103,0,0,0,1.0,1,1.0,1,1.0,1,0.2735275646224898,37
4360,3,14342,3236,11106,0,0,0,1.0,1,1.0,1,1.0,1,0.2730199771287884,38
4361,6,14348,3236,11112,0,0,0,1.0,1,1.0,1,1.0,1,0.2545039437538843,39
4362,6,14354,3238,11116,0,0,0,1.0,1,1.0,1,1.0,1,0.29786273936145474,38
4363,2,14356,3238,11118,0,0,0,1.0,1,1.0,1,1.0,1,0.29786273936145474,38
4364,2,14358,3239,11119,0,0,0,1.0,1,1.0,1,1.0,1,0.2389534380903541,39
4365,2,14360,3239,11121,0,0,0,1.0,1,1.0,1,1.0,1,0.2389534380903541,39
4366,6,14366,3240,11126,0,0,0,1.0,1,1.0,1,1.0,1,0.12628698413580502,39
4367,0,14366,3240,11126,0,0,0,1.0,1,1.0,1,1.0,1,0.1081433353096843,41
4368,0,14366,3240,11126,0,0,0,1.0,1,1.0,1,1.0,1,0.1081433353096843,41
4369,3,14369,3241,11128,0,0,0,1.0,1,1.0,1,1.0,1,0.11399942675518475,42
4370,1,14370,3241,11129,0,0,0,1.0,1,1.0,1,1.0,1,0.11723395113539488,42
4371,1,14371,3241,11130,0,0,0,1.0,1,1.0,1,1.0,1,0.11699711200254034,43
4372,2,14373,3242,11131,0,0,0,1.0,1,1.0,1,1.0,1,0.12284975951007568,43
4373,4,14377,3244,11133,0,0,0,1.0,1,1.0,1,1.0,1,0.17833974030762811,43
4374,5,14382,3244,11138,0,0,0,1.0,1,1.0,1,1.0,1,0.18128833513672127,44
4375,7,14389,3247,11142,0,0,0,1.0,1,1.0,1,1.0,1,0.22410353169587827,45
4376,5,14394,3247,11147,0,0,0,1.0,1,1.0,1,1.0,1,0.21428594835634074,46
4377,8,14402,3250,11152,0,0,0,1.0,1,1.0,1,1.0,1,0.26683947681716313,47
4378,9,14411,3252,11159,0,0,0,1.0,1,1.0,1,1.0,1,0.2306450534468684,49
4379,12,14423,3255,11168,0,0,0,1.0,1,1.0,1,1.0,1,0.2473905737072251,51
4380,11,14434,3255,11179,0,0,0,1.0,1,1.0,1,1.0,1,0.2365783750497325,50
4381,4,14438,3255,11183,0,0,0,1.0,1,1.0,1,1.0,1,0.18040395226795897,49
4382,3,14441,3257,11184,0,0,0,1.0,1,1.0,1,1.0,1,0.22015591704437115,47
4383,3,14444,3259,11185,0,0,0,1.0,1,1.0,1,1.0,1,0.22744561441442798,47
4384,2,14446,3260,11186,0,0,0,1.0,1,1.0,1,1.0,1,0.23972541709730097,44
4385,1,14447,3260,11187,0,0,0,1.0,1,1.0,1,1.0,1,0.20640258335294603,42
4386,1,14448,3261,11187,0,0,0,1.0,1,1.0,1,1.0,1,0.2596400591488341,41
4387,0,14448,3261,11187,0,0,0,1.0,1,1.0,1,1.0,1,0.2517317070629,39
4388,2,14450,3262,11188,0,0,0,1.0,1,1.0,1,1.0,1,0.22225022935261876,39
4389,2,14452,3263,11189,0,0,0,1.0,1,1.0,1,1.0,1,0.1837616850461375,38
4390,0,14452,3263,11189,0,0,0,1.0,1,1.0,1,1.0,1,0.14378842126019206,38
4391,0,14452,3263,11189,0,0,0,1.0,1,1.0,1,1.0,1,0.1295491680151604,39
4392,2,14454,3263,11191,0,0,0,1.0,1,1.0,1,1.0,1,0.13420127268211376,39
4393,2,14456,3263,11193,0,0,0,1.0,1,1.0,1,1.0,1,0.13045368254781467,40
4394,3,14459,3264,11195,0,0,0,1.0,1,1.0,1,1.0,1,0.17718008673988878,39
4395,3,14462,3265,11197,0,0,0,1.0,1,1.0,1,1.0,1,0.15783777177571998,39
4396,3,14465,3265,11200,0,0,0,1.0,1,1.0,1,1.0,1,0.11853369744945032,39
4397,2,14467,3266,11201,0,0,0,1.0,1,1.0,1,1.0,1,0.12424449519476442,38
4398,0,14467,3266,11201,0,0,0,1.0,1,1.0,1,1.0,1,0.1278967649765578,39
4399,2,14469,3266,11203,0,0,0,1.0,1,1.0,1,1.0,1,0.14002081835447222,42
4400,1,14470,3266,11204,0,0,0,1.0,1,1.0,1,1.0,1,0.1321798993388365,43
4401,0,14470,3266,11204,0,0,0,1.0,1,1.0,1,1.0,1,0.11882622305201697,44
4402,0,14470,3266,11204,0,0,0,1.0,1,1.0,1,1.0,1,0.11882622305201697,44
4403,0,14470,3266,11204,0,0,0,1.0,1,1.0,1,1.0,1,0.11143586158367651,45
4404,1,14471,3266,11205,0,0,0,1.0,1,1.0,1,1.0,1,0.12320275312735131,45
4405,4,14475,3266,11209,0,0,0,1.0,1,1.0,1,1.0,1,0.12802593090917888,46
4406,6,14481,3267,11214,0,0,0,1.0,1,1.0,1,1.0,1,0.18429420690613527,46
4407,6,14487,3267,11220,0,0,0,1.0,1,1.0,1,1.0,1,0.180375192206123,46
4408,8,14495,3267,11228,0,0,0,1.0,1,1.0,1,1.0,1,0.2048016507180573,47
4409,9,14504,3267,11237,0,0,0,1.0,1,1.0,1,1.0,1,0.2034713960107038,48
4410,8,14512,3267,11245,0,0,0,1.0,1,1.0,1,1.0,1,0.17239597065675213,48
4411,5,14517,3267,11250,0,0,0,1.0,1,1.0,1,1.0,1,0.11195447120626974,50
4412,2,14519,3268,11251,0,0,0,1.0,1,1.0,1,1.0,1,0.10750064205296221,50
4413,1,14520,3268,11252,0,0,0,1.0,1,1.0,1,1.0,1,0.0958078816974504,50
4414,3,14523,3268,11255,0,0,0,1.0,1,1.0,1,1.0,1,0.10954638379888289,51
4415,4,14527,3268,11259,0,0,0,1.0,1,1.0,1,1.0,1,0.1013945335562775,51
4416,3,14530,3268,11262,0,0,0,1.0,1,1.0,1,1.0,1,0.09507337813394107,51
4417,2,14532,3268,11264,0,0,0,1.0,1,1.0,1,1.0,1,0.1031971528226918,51
4418,2,14534,3268,11266,0,0,0,1.0,1,1.0,1,1.0,1,0.10822943044718589,51
4419,2,14536,3268,11268,0,0,0,1.0,1,1.0,1,1.0,1,0.11884154004860292,50
4420,2,14538,3268,11270,0,0,0,1.0,1,1.0,1,1.0,1,0.1325856997927392,50
4421,0,14538,3268,11270,0,0,0,1.0,1,1.0,1,1.0,1,0.15034983988081893,52
4422,0,14538,3268,11270,0,0,0,1.0,1,1.0,1,1.0,1,0.15080396438652874,51
4423,4,14542,3269,11273,0,0,0,1.0,1,1.0,1,1.0,1,0.17993013635702512,51
4424,3,14545,3269,11276,0,0,0,1.0,1,1.0,1,1.0,1,0.16041437294648514,53
4425,4,14549,3269,11280,0,0,0,1.0,1,1.0,1,1.0,1,0.1509598172246135,54
4426,6,14555,3269,11286,0,0,0,1.0,1,1.0,1,1.0,1,0.07393843485698134,55
4427,1,14556,3269,11287,0,0,0,1.0,1,1.0,1,1.0,1,0.05583088650141265,55
4428,0,14556,3269,11287,0,0,0,1.0,1,1.0,1,1.0,1,0.05583088650141265,55
4429,0,14556,3269,11287,0,0,0,1.0,1,1.0,1,1.0,1,0.051945943361759235,56
4430,1,14557,3269,11288,0,0,0,1.0,1,1.0,1,1.0,1,0.06566185890457599,55
4431,0,14557,3269,11288,0,0,0,1.0,1,1.0,1,1.0,1,0.05896729278447189,56
4432,2,14559,3270,11289,0,0,0,1.0,1,1.0,1,1.0,1,0.05654803845573127,56
4433,1,14560,3271,11289,0,0,0,1.0,1,1.0,1,1.0,1,0.08714993895341526,57
4434,1,14561,3272,11289,0,0,0,1.0,1,1.0,1,1.0,1,0.07432647959978998,56
4435,1,14562,3273,11289,0,0,0,1.0,1,1.0,1,1.0,1,0.07842531558517746,56
4436,4,14566,3276,11290,0,0,0,1.0,1,1.0,1,1.0,1,0.05181155680274154,55
4437,0,14566,3276,11290,0,0,0,1.0,1,1.0,1,1.0,1,0.07052445892845559,54
4438,1,14567,3277,11290,0,0,0,1.0,1,1.0,1,1.0,1,0.08622492443322528,54
4439,1,14568,3277,11291,0,0,0,1.0,1,1.0,1,1.0,1,0.11774737547012046,55
4440,1,14569,3278,11291,0,0,0,1.0,1,1.0,1,1.0,1,0.13649207747490683,55
4441,4,14573,3280,11293,0,0,0,1.0,1,1.0,1,1.0,1,0.0939800565278257,59
4442,2,14575,3281,11294,0,0,0,1.0,1,1.0,1,1.0,1,0.08200819865434898,61
4443,1,14576,3282,11294,0,0,0,1.0,1,1.0,1,1.0,1,0.09804247353306975,60
4444,2,14578,3282,11296,0,0,0,1.0,1,1.0,1,1.0,1,0.0720672236162508,61
4445,2,14580,3282,11298,0,0,0,1.0,1,1.0,1,1.0,1,0.07749115809464037,61
4446,1,14581,3282,11299,0,0,0,1.0,1,1.0,1,1.0,1,0.08154090771540523,62
4447,0,14581,3282,11299,0,0,0,1.0,1,1.0,1,1.0,1,0.07270648614621819,63
4448,0,14581,3282,11299,0,0,0,1.0,1,1.0,1,1.0,1,0.07270648614621819,63
4449,0,14581,3282,11299,0,0,0,1.0,1,1.0,1,1.0,1,0.07270648614621819,63
4450,0,14581,3282,11299,0,0,0,1.0,1,1.0,1,1.0,1,0.08942165615411808,62
4451,1,14582,3283,11299,0,0,0,1.0,1,1.0,1,1.0,1,0.11368599356522749,63
4452,3,14585,3283,11302,0,0,0,1.0,1,1.0,1,1.0,1,0.09914610141900902,64
4453,3,14588,3283,11305,0,0,0,1.0,1,1.0,1,1.0,1,0.10821103218975305,65
4454,2,14590,3283,11307,0,0,0,1.0,1,1.0,1,1.0,1,0.11754508515644568,66
4455,5,14595,3283,11312,0,0,0,1.0,1,1.0,1,1.0,1,0.1040615873963193,67
4456,9,14604,3285,11319,0,0,0,1.0,1,1.0,1,1.0,1,0.10512149773065883,67
4457,7,14611,3286,11325,0,0,0,1.0,1,1.0,1,1.0,1,0.12033178256344186,65
4458,4,14615,3286,11329,0,0,0,1.0,1,1.0,1,1.0,1,0.15734169375760948,65
4459,8,14623,3289,11334,0,0,0,1.0,1,1.0,1,1.0,1,0.1890570615849727,64
4460,4,14627,3289,11338,0,0,0,1.0,1,1.0,1,1.0,1,0.21240073461235126,63
4461,9,14636,3291,11345,0,0,0,1.0,1,1.0,1,1.0,1,0.24059398802234513,62
4462,12,14648,3294,11354,0,0,0,1.0,1,1.0,1,1.0,1,0.25995826381593623,61
4463,10,14658,3295,11363,0,0,0,1.0,1,1.0,1,1.0,1,0.3190067399333003,61
4464,12,14670,3296,11374,0,0,0,1.0,1,1.0,1,1.0,1,0.31803713435535014,58
4465,8,14678,3298,11380,0,0,0,1.0,1,1.0,1,1.0,1,0.3039590145636955,57
4466,8,14686,3300,11386,0,0,0,1.0,1,1.0,1,1.0,1,0.34332476355267866,54
4467,4,14690,3302,11388,0,0,0,1.0,1,1.0,1,1.0,1,0.33707903715400184,52
4468,7,14697,3305,11392,0,0,0,1.0,1,1.0,1,1.0,1,0.2988880564191395,52
4469,5,14702,3305,11397,0,0,0,1.0,1,1.0,1,1.0,1,0.286793867583341,51
4470,6,14708,3307,11401,0,0,0,1.0,1,1.0,1,1.0,1,0.2578955924097235,51
4471,10,14718,3310,11408,0,0,0,1.0,1,1.0,1,1.0,1,0.1171223447630648,50
4472,4,14722,3311,11411,0,0,0,1.0,1,1.0,1,1.0,1,0.0927691732346799,48
4473,5,14727,3312,11415,0,0,0,1.0,1,1.0,1,1.0,1,0.11115741685949707,47
4474,4,14731,3314,11417,0,0,0,1.0,1,1.0,1,1.0,1,0.12452276460103617,49
4475,0,14731,3314,11417,0,0,0,1.0,1,1.0,1,1.0,1,0.12207507925040763,47
4476,3,14734,3315,11419,0,0,0,1.0,1,1.0,1,1.0,1,0.166634106310905,49
4477,6,14740,3316,11424,0,0,0,1.0,1,1.0,1,1.0,1,0.1676727812603719,48
4478,0,14740,3316,11424,0,0,0,1.0,1,1.0,1,1.0,1,0.1676727812603719,48
4479,0,14740,3316,11424,0,0,0,1.0,1,1.0,1,1.0,1,0.1676727812603719,48
4480,1,14741,3316,11425,0,0,0,1.0,1,1.0,1,1.0,1,0.182733132836536,49
4481,1,14742,3316,11426,0,0,0,1.0,1,1.0,1,1.0,1,0.1838926040119781,49
4482,2,14744,3316,11428,0,0,0,1.0,1,1.0,1,1.0,1,0.1838926040119781,49
4483,5,14749,3317,11432,0,0,0,1.0,1,1.0,1,1.0,1,0.15718180263809164,50
4484,2,14751,3319,11432,0,0,0,1.0,1,1.0,1,1.0,1,0.18009305199595158,52
4485,1,14752,3319,11433,0,0,0,1.0,1,1.0,1,1.0,1,0.16576110074170947,53
4486,8,14760,3321,11439,0,0,0,1.0,1,1.0,1,1.0,1,0.1481216429713881,55
4487,4,14764,3323,11441,0,0,0,1.0,1,1.0,1,1.0,1,0.11895442583769415,55
4488,6,14770,3323,11447,0,0,0,1.0,1,1.0,1,1.0,1,0.1102282110528796,54
4489,2,14772,3323,11449,0,0,0,1.0,1,1.0,1,1.0,1,0.16553992841892426,53
4490,2,14774,3324,11450,0,0,0,1.0,1,1.0,1,1.0,1,0.1691681374768952,53
4491,2,14776,3324,11452,0,0,0,1.0,1,1.0,1,1.0,1,0.18579436609559766,52
4492,3,14779,3324,11455,0,0,0,1.0,1,1.0,1,1.0,1,0.16992061206381506,52
4493,7,14786,3325,11461,0,0,0,1.0,1,1.0,1,1.0,1,0.20097507923448346,52
4494,4,14790,3325,11465,0,0,0,1.0,1,1.0,1,1.0,1,0.18280723419581818,53
4495,4,14794,3326,11468,0,0,0,1.0,1,1.0,1,1.0,1,0.17122236739918165,50
4496,0,14794,3326,11468,0,0,0,1.0,1,1.0,1,1.0,1,0.17913685459374404,51
4497,4,14798,3326,11472,0,0,0,1.0,1,1.0,1,1.0,1,0.178696451130178,50
4498,0,14798,3326,11472,0,0,0,1.0,1,1.0,1,1.0,1,0.19394246575010085,49
4499,1,14799,3327,11472,0,0,0,1.0,1,1.0,1,1.0,1,0.26043423863514986,48
4500,8,14807,3329,11478,0,0,0,1.0,1,1.0,1,1.0,1,0.23339151449462633,48
4501,4,14811,3330,11481,0,0,0,1.0,1,1.0,1,1.0,1,0.11479099811676334,48
4502,0,14811,3330,11481,0,0,0,1.0,1,1.0,1,1.0,1,0.13213138839988267,49
4503,5,14816,3332,11484,0,0,0,1.0,1,1.0,1,1.0,1,0.10902522583623221,49
4504,1,14817,3333,11484,0,0,0,1.0,1,1.0,1,1.0,1,0.13013016246294318,45
4505,1,14818,3334,11484,0,0,0,1.0,1,1.0,1,1.0,1,0.14089603230660389,46
4506,3,14821,3336,11485,0,0,0,1.0,1,1.0,1,1.0,1,0.1528428827402185,45
4507,6,14827,3337,11490,0,0,0,1.0,1,1.0,1,1.0,1,0.20639329635857412,45
4508,6,14833,3339,11494,0,0,0,1.0,1,1.0,1,1.0,1,0.20466944177442098,43
4509,3,14836,3340,11496,0,0,0,1.0,1,1.0,1,1.0,1,0.2568625416324329,41
4510,3,14839,3341,11498,0,0,0,1.0,1,1.0,1,1.0,1,0.2574647977167738,42
4511,3,14842,3342,11500,0,0,0,1.0,1,1.0,1,1.0,1,0.3084363559228904,41
4512,3,14845,3342,11503,0,0,0,1.0,1,1.0,1,1.0,1,0.28075655916278147,41
4513,2,14847,3342,11505,0,0,0,1.0,1,1.0,1,1.0,1,0.28075655916278147,41
4514,5,14852,3344,11508,0,0,0,1.0,1,1.0,1,1.0,1,0.24370347515996654,42
4515,3,14855,3344,11511,0,0,0,1.0,1,1.0,1,1.0,1,0.2870359440821297,41
4516,8,14863,3345,11518,0,0,0,1.0,1,1.0,1,1.0,1,0.11417466574511728,42
4517,7,14870,3346,11524,0,0,0,1.0,1,1.0,1,1.0,1,0.12758499316590385,43
4518,6,14876,3346,11530,0,0,0,1.0,1,1.0,1,1.0,1,0.11064635017300015,42
4519,3,14879,3347,11532,0,0,0,1.0,1,1.0,1,1.0,1,0.1852818320279897,42
4520,4,14883,3347,11536,0,0,0,1.0,1,1.0,1,1.0,1,0.22091288140422802,42
4521,3,14886,3348,11538,0,0,0,1.0,1,1.0,1,1.0,1,0.2239928390951199,42
4522,3,14889,3348,11541,0,0,0,1.0,1,1.0,1,1.0,1,0.257604166887486,42
4523,3,14892,3348,11544,0,0,0,1.0,1,1.0,1,1.0,1,0.228340616142639,42
4524,6,14898,3349,11549,0,0,0,1.0,1,1.0,1,1.0,1,0.2189924133488774,43
4525,6,14904,3349,11555,0,0,0,1.0,1,1.0,1,1.0,1,0.14362156289615258,46
4526,5,14909,3351,11558,0,0,0,1.0,1,1.0,1,1.0,1,0.186359097053754,46
4527,9,14918,3351,11567,0,0,0,1.0,1,1.0,1,1.0,1,0.16492103028026908,47
4528,11,14929,3351,11578,0,0,0,1.0,1,1.0,1,1.0,1,0.23357430976338514,49
4529,14,14943,3351,11592,0,0,0,1.0,1,1.0,1,1.0,1,0.18894404355987415,50
4530,6,14949,3351,11598,0,0,0,1.0,1,1.0,1,1.0,1,0.19717210766028323,51
4531,5,14954,3351,11603,0,0,0,1.0,1,1.0,1,1.0,1,0.13940273321141988,51
4532,5,14959,3353,11606,0,0,0,1.0,1,1.0,1,1.0,1,0.1847494895710685,51
4533,3,14962,3354,11608,0,0,0,1.0,1,1.0,1,1.0,1,0.18610689701933955,50
4534,2,14964,3354,11610,0,0,0,1.0,1,1.0,1,1.0,1,0.16187390792626694,51
4535,1,14965,3354,11611,0,0,0,1.0,1,1.0,1,1.0,1,0.16361481367211478,50
4536,2,14967,3354,11613,0,0,0,1.0,1,1.0,1,1.0,1,0.18300307643439884,48
4537,3,14970,3354,11616,0,0,0,1.0,1,1.0,1,1.0,1,0.18352924666280404,49
4538,2,14972,3354,11618,0,0,0,1.0,1,1.0,1,1.0,1,0.19848137088676404,48
4539,9,14981,3354,11627,0,0,0,1.0,1,1.0,1,1.0,1,0.20319892644124748,50
4540,2,14983,3354,11629,0,0,0,1.0,1,1.0,1,1.0,1,0.22862019552316987,49
4541,5,14988,3356,11632,0,0,0,1.0,1,1.0,1,1.0,1,0.23202842492619644,49
4542,2,14990,3358,11632,0,0,0,1.0,1,1.0,1,1.0,1,0.2523820252817817,47
4543,1,14991,3358,11633,0,0,0,1.0,1,1.0,1,1.0,1,0.23259022355355663,45
4544,1,14992,3359,11633,0,0,0,1.0,1,1.0,1,1.0,1,0.23339343269519325,45
4545,5,14997,3362,11635,0,0,0,1.0,1,1.0,1,1.0,1,0.258216213089016,43
4546,8,15005,3364,11641,0,0,0,1.0,1,1.0,1,1.0,1,0.24208626008003348,43
4547,2,15007,3364,11643,0,0,0,1.0,1,1.0,1,1.0,1,0.2002651414856316,41
4548,2,15009,3365,11644,0,0,0,1.0,1,1.0,1,1.0,1,0.17376302050176795,42
4549,0,15009,3365,11644,0,0,0,1.0,1,1.0,1,1.0,1,0.16020935684466847,41
4550,1,15010,3366,11644,0,0,0,1.0,1,1.0,1,1.0,1,0.15584793808335284,41
4551,1,15011,3367,11644,0,0,0,1.0,1,1.0,1,1.0,1,0.15792664324229647,39
4552,0,15011,3367,11644,0,0,0,1.0,1,1.0,1,1.0,1,0.17687266210565994,38
4553,1,15012,3368,11644,0,0,0,1.0,1,1.0,1,1.0,1,0.16525465601607275,39
4554,1,15013,3369,11644,0,0,0,1.0,1,1.0,1,1.0,1,0.18330212241623323,38
4555,0,15013,3369,11644,0,0,0,1.0,1,1.0,1,1.0,1,0.1991138098326889,37
4556,0,15013,3369,11644,0,0,0,1.0,1,1.0,1,1.0,1,0.2379938522306516,36
4557,1,15014,3370,11644,0,0,0,1.0,1,1.0,1,1.0,1,0.18007513506802075,38
4558,2,15016,3371,11645,0,0,0,1.0,1,1.0,1,1.0,1,0.15405813125405166,39
4559,6,15022,3374,11648,0,0,0,1.0,1,1.0,1,1.0,1,0.20133720922604198,38
4560,2,15024,3374,11650,0,0,0,1.0,1,1.0,1,1.0,1,0.18960255618496966,41
4561,2,15026,3374,11652,0,0,0,1.0,1,1.0,1,1.0,1,0.1606148874252451,41
4562,1,15027,3375,11652,0,0,0,1.0,1,1.0,1,1.0,1,0.1593307192807699,43
4563,0,15027,3375,11652,0,0,0,1.0,1,1.0,1,1.0,1,0.1841613952124648,42
4564,1,15028,3375,11653,0,0,0,1.0,1,1.0,1,1.0,1,0.16648297865038672,43
4565,2,15030,3375,11655,0,0,0,1.0,1,1.0,1,1.0,1,0.16538572170747198,44
4566,5,15035,3376,11659,0,0,0,1.0,1,1.0,1,1.0,1,0.10072832339982621,45
4567,3,15038,3377,11661,0,0,0,1.0,1,1.0,1,1.0,1,0.096318046707219,47
4568,1,15039,3377,11662,0,0,0,1.0,1,1.0,1,1.0,1,0.09771461525649275,47
4569,1,15040,3378,11662,0,0,0,1.0,1,1.0,1,1.0,1,0.10859165746629657,49
4570,4,15044,3380,11664,0,0,0,1.0,1,1.0,1,1.0,1,0.10662362791869029,49
4571,1,15045,3380,11665,0,0,0,1.0,1,1.0,1,1.0,1,0.1024267105494365,48
4572,0,15045,3380,11665,0,0,0,1.0,1,1.0,1,1.0,1,0.1024267105494365,48
4573,4,15049,3381,11668,0,0,0,1.0,1,1.0,1,1.0,1,0.10186477549237848,48
4574,3,15052,3382,11670,0,0,0,1.0,1,1.0,1,1.0,1,0.16494574161592487,50
4575,5,15057,3384,11673,0,0,0,1.0,1,1.0,1,1.0,1,0.15655058862207563,51
4576,1,15058,3384,11674,0,0,0,1.0,1,1.0,1,1.0,1,0.16218691336670302,48
4577,0,15058,3384,11674,0,0,0,1.0,1,1.0,1,1.0,1,0.16853074517671346,47
4578,2,15060,3385,11675,0,0,0,1.0,1,1.0,1,1.0,1,0.18369841939008405,46
4579,2,15062,3386,11676,0,0,0,1.0,1,1.0,1,1.0,1,0.20824863309751335,46
4580,1,15063,3386,11677,0,0,0,1.0,1,1.0,1,1.0,1,0.18442065453055886,47
4581,1,15064,3387,11677,0,0,0,1.0,1,1.0,1,1.0,1,0.20899386819811946,47
4582,0,15064,3387,11677,0,0,0,1.0,1,1.0,1,1.0,1,0.22297227521883636,48
4583,0,15064,3387,11677,0,0,0,1.0,1,1.0,1,1.0,1,0.22297227521883636,48
4584,2,15066,3387,11679,0,0,0,1.0,1,1.0,1,1.0,1,0.21098761160151291,50
4585,4,15070,3388,11682,0,0,0,1.0,1,1.0,1,1.0,1,0.19550307748473744,50
4586,2,15072,3388,11684,0,0,0,1.0,1,1.0,1,1.0,1,0.1931924007319869,50
4587,2,15074,3388,11686,0,0,0,1.0,1,1.0,1,1.0,1,0.1931924007319869,50
4588,1,15075,3388,11687,0,0,0,1.0,1,1.0,1,1.0,1,0.19604735208457214,50
4589,4,15079,3389,11690,0,0,0,1.0,1,1.0,1,1.0,1,0.19237019623698723,52
4590,1,15080,3389,11691,0,0,0,1.0,1,1.0,1,1.0,1,0.18961160854667558,52
4591,2,15082,3389,11693,0,0,0,1.0,1,1.0,1,1.0,1,0.16738236259430175,53
4592,1,15083,3389,11694,0,0,0,1.0,1,1.0,1,1.0,1,0.17516653269151974,54
4593,2,15085,3390,11695,0,0,0,1.0,1,1.0,1,1.0,1,0.1482474530596866,56
4594,1,15086,3390,11696,0,0,0,1.0,1,1.0,1,1.0,1,0.1482088026282395,57
4595,0,15086,3390,11696,0,0,0,1.0,1,1.0,1,1.0,1,0.14125244504725834,56
4596,1,15087,3390,11697,0,0,0,1.0,1,1.0,1,1.0,1,0.13040272799107744,56
4597,3,15090,3391,11699,0,0,0,1.0,1,1.0,1,1.0,1,0.14192530668998113,56
4598,3,15093,3393,11700,0,0,0,1.0,1,1.0,1,1.0,1,0.1691879257618197,57
4599,4,15097,3394,11703,0,0,0,1.0,1,1.0,1,1.0,1,0.1490869544046859,59
4600,2,15099,3394,11705,0,0,0,1.0,1,1.0,1,1.0,1,0.1686288912714128,60
4601,1,15100,3395,11705,0,0,0,1.0,1,1.0,1,1.0,1,0.18667321562298286,60
4602,1,15101,3395,11706,0,0,0,1.0,1,1.0,1,1.0,1,0.15807257492515064,62
4603,2,15103,3395,11708,0,0,0,1.0,1,1.0,1,1.0,1,0.15604702277783505,62
4604,0,15103,3395,11708,0,0,0,1.0,1,1.0,1,1.0,1,0.14274452651206082,63
4605,0,15103,3395,11708,0,0,0,1.0,1,1.0,1,1.0,1,0.14274452651206082,63
4606,4,15107,3395,11712,0,0,0,1.0,1,1.0,1,1.0,1,0.11469877136904112,64
4607,0,15107,3395,11712,0,0,0,1.0,1,1.0,1,1.0,1,0.10802326743756903,65
4608,2,15109,3396,11713,0,0,0,1.0,1,1.0,1,1.0,1,0.11669105415547107,66
4609,1,15110,3396,11714,0,0,0,1.0,1,1.0,1,1.0,1,0.09400487781891227,65
4610,0,15110,3396,11714,0,0,0,1.0,1,1.0,1,1.0,1,0.10006709520439158,63
4611,4,15114,3398,11716,0,0,0,1.0,1,1.0,1,1.0,1,0.13638659792664456,64
4612,1,15115,3398,11717,0,0,0,1.0,1,1.0,1,1.0,1,0.1665820183709868,62
4613,2,15117,3399,11718,0,0,0,1.0,1,1.0,1,1.0,1,0.19345637669587867,63
4614,5,15122,3401,11721,0,0,0,1.0,1,1.0,1,1.0,1,0.20410514575207872,61
4615,5,15127,3401,11726,0,0,0,1.0,1,1.0,1,1.0,1,0.20003098669713526,59
4616,5,15132,3402,11730,0,0,0,1.0,1,1.0,1,1.0,1,0.1998622434867226,58
4617,4,15136,3403,11733,0,0,0,1.0,1,1.0,1,1.0,1,0.2175379268043453,58
4618,4,15140,3404,11736,0,0,0,1.0,1,1.0,1,1.0,1,0.22523077140948533,57
4619,2,15142,3405,11737,0,0,0,1.0,1,1.0,1,1.0,1,0.24555172250106475,57
4620,2,15144,3406,11738,0,0,0,1.0,1,1.0,1,1.0,1,0.2303771390218181,57
4621,5,15149,3407,11742,0,0,0,1.0,1,1.0,1,1.0,1,0.17339112617065935,59
4622,2,15151,3408,11743,0,0,0,1.0,1,1.0,1,1.0,1,0.18165772677125488,60
4623,3,15154,3409,11745,0,0,0,1.0,1,1.0,1,1.0,1,0.158071805487846,59
4624,1,15155,3410,11745,0,0,0,1.0,1,1.0,1,1.0,1,0.1709330416190366,59
4625,3,15158,3412,11746,0,0,0,1.0,1,1.0,1,1.0,1,0.19490746335081638,57
4626,4,15162,3413,11749,0,0,0,1.0,1,1.0,1,1.0,1,0.22470167612824926,56
4627,3,15165,3414,11751,0,0,0,1.0,1,1.0,1,1.0,1,0.2190792442921961,56
4628,3,15168,3415,11753,0,0,0,1.0,1,1.0,1,1.0,1,0.22703119117344223,56
4629,3,15171,3416,11755,0,0,0,1.0,1,1.0,1,1.0,1,0.26287071359005026,56
4630,4,15175,3417,11758,0,0,0,1.0,1,1.0,1,1.0,1,0.24552298165157263,57
4631,2,15177,3417,11760,0,0,0,1.0,1,1.0,1,1.0,1,0.29974441429057125,56
4632,7,15184,3418,11766,0,0,0,1.0,1,1.0,1,1.0,1,0.31848764890323933,57
4633,7,15191,3418,11773,0,0,0,1.0,1,1.0,1,1.0,1,0.30234619509525307,58
4634,5,15196,3418,11778,0,0,0,1.0,1,1.0,1,1.0,1,0.3061873665338373,58
4635,5,15201,3418,11783,0,0,0,1.0,1,1.0,1,1.0,1,0.26006798668934883,59
4636,10,15211,3418,11793,0,0,0,1.0,1,1.0,1,1.0,1,0.1767955076362306,60
4637,6,15217,3418,11799,0,0,0,1.0,1,1.0,1,1.0,1,0.17812992246355883,60
4638,3,15220,3418,11802,0,0,0,1.0,1,1.0,1,1.0,1,0.1582081969713406,61
4639,4,15224,3418,11806,0,0,0,1.0,1,1.0,1,1.0,1,0.18405241223212934,62
4640,9,15233,3418,11815,0,0,0,1.0,1,1.0,1,1.0,1,0.16751867589491543,63
4641,5,15238,3419,11819,0,0,0,1.0,1,1.0,1,1.0,1,0.15898406887919084,63
4642,7,15245,3419,11826,0,0,0,1.0,1,1.0,1,1.0,1,0.1396250833271479,62
4643,12,15257,3421,11836,0,0,0,1.0,1,1.0,1,1.0,1,0.14777602966510112,63
4644,8,15265,3421,11844,0,0,0,1.0,1,1.0,1,1.0,1,0.183658081610228,62
4645,8,15273,3421,11852,0,0,0,1.0,1,1.0,1,1.0,1,0.21807547654843568,63
4646,9,15282,3423,11859,0,0,0,1.0,1,1.0,1,1.0,1,0.2103229307236625,63
4647,5,15287,3424,11863,0,0,0,1.0,1,1.0,1,1.0,1,0.204534597541968,62
4648,12,15299,3425,11874,0,0,0,1.0,1,1.0,1,1.0,1,0.2033999664882787,63
4649,10,15309,3425,11884,0,0,0,1.0,1,1.0,1,1.0,1,0.19447095767416506,61
4650,12,15321,3427,11894,0,0,0,1.0,1,1.0,1,1.0,1,0.17178042515946487,63
4651,4,15325,3429,11896,0,0,0,1.0,1,1.0,1,1.0,1,0.1435889572288473,62
4652,0,15325,3429,11896,0,0,0,1.0,1,1.0,1,1.0,1,0.15495991917056362,59
4653,2,15327,3429,11898,0,0,0,1.0,1,1.0,1,1.0,1,0.15146581073168597,60
4654,1,15328,3430,11898,0,0,0,1.0,1,1.0,1,1.0,1,0.17186871007241597,60
4655,1,15329,3431,11898,0,0,0,1.0,1,1.0,1,1.0,1,0.18853276789349788,60
4656,4,15333,3434,11899,0,0,0,1.0,1,1.0,1,1.0,1,0.2471535996577011,61
4657,4,15337,3435,11902,0,0,0,1.0,1,1.0,1,1.0,1,0.23260443461209135,62
4658,1,15338,3435,11903,0,0,0,1.0,1,1.0,1,1.0,1,0.23317117301007978,62
4659,2,15340,3435,11905,0,0,0,1.0,1,1.0,1,1.0,1,0.23088479716905294,61
4660,3,15343,3436,11907,0,0,0,1.0,1,1.0,1,1.0,1,0.25440459625429196,61
4661,1,15344,3436,11908,0,0,0,1.0,1,1.0,1,1.0,1,0.269060401498876,61
4662,3,15347,3437,11910,0,0,0,1.0,1,1.0,1,1.0,1,0.25328695452490785,62
4663,4,15351,3437,11914,0,0,0,1.0,1,1.0,1,1.0,1,0.20417674916229492,61
4664,3,15354,3439,11915,0,0,0,1.0,1,1.0,1,1.0,1,0.21197937665155953,62
4665,4,15358,3442,11916,0,0,0,1.0,1,1.0,1,1.0,1,0.25498538832339207,61
4666,15,15373,3443,11930,0,0,0,1.0,1,1.0,1,1.0,1,0.13306162601433552,61
4667,2,15375,3444,11931,0,0,0,1.0,1,1.0,1,1.0,1,0.17379757198290754,59
4668,4,15379,3446,11933,0,0,0,1.0,1,1.0,1,1.0,1,0.17143263905120473,59
4669,2,15381,3446,11935,0,0,0,1.0,1,1.0,1,1.0,1,0.17473042103957545,58
4670,3,15384,3449,11935,0,0,0,1.0,1,1.0,1,1.0,1,0.13109982752497318,57
4671,0,15384,3449,11935,0,0,0,1.0,1,1.0,1,1.0,1,0.1564327479677836,55
4672,4,15388,3450,11938,0,0,0,1.0,1,1.0,1,1.0,1,0.16804755246679537,56
4673,1,15389,3450,11939,0,0,0,1.0,1,1.0,1,1.0,1,0.13355356404333046,58
4674,3,15392,3452,11940,0,0,0,1.0,1,1.0,1,1.0,1,0.15642055144128952,58
4675,2,15394,3452,11942,0,0,0,1.0,1,1.0,1,1.0,1,0.18474085332759338,57
4676,2,15396,3454,11942,0,0,0,1.0,1,1.0,1,1.0,1,0.19262673334072505,58
4677,0,15396,3454,11942,0,0,0,1.0,1,1.0,1,1.0,1,0.21350431670521397,57
4678,1,15397,3455,11942,0,0,0,1.0,1,1.0,1,1.0,1,0.2123384061446378,57
4679,0,15397,3455,11942,0,0,0,1.0,1,1.0,1,1.0,1,0.2123384061446378,57
4680,4,15401,3457,11944,0,0,0,1.0,1,1.0,1,1.0,1,0.17331176467337917,59
4681,8,15409,3459,11950,0,0,0,1.0,1,1.0,1,1.0,1,0.11635377904848297,60
4682,1,15410,3459,11951,0,0,0,1.0,1,1.0,1,1.0,1,0.11142961038370569,60
4683,4,15414,3460,11954,0,0,0,1.0,1,1.0,1,1.0,1,0.1331075155705916,60
4684,6,15420,3464,11956,0,0,0,1.0,1,1.0,1,1.0,1,0.20509252390307248,60
4685,4,15424,3465,11959,0,0,0,1.0,1,1.0,1,1.0,1,0.2028260394207568,59
4686,7,15431,3466,11965,0,0,0,1.0,1,1.0,1,1.0,1,0.18739956649076767,60
4687,2,15433,3466,11967,0,0,0,1.0,1,1.0,1,1.0,1,0.18345005233649636,59
4688,5,15438,3467,11971,0,0,0,1.0,1,1.0,1,1.0,1,0.2045773784367875,59
4689,3,15441,3467,11974,0,0,0,1.0,1,1.0,1,1.0,1,0.1763399883730443,59
4690,5,15446,3468,11978,0,0,0,1.0,1,1.0,1,1.0,1,0.21045355089279705,58
4691,6,15452,3469,11983,0,0,0,1.0,1,1.0,1,1.0,1,0.21528022960562082,57
4692,4,15456,3469,11987,0,0,0,1.0,1,1.0,1,1.0,1,0.20054458565626376,58
4693,5,15461,3469,11992,0,0,0,1.0,1,1.0,1,1.0,1,0.2032284391620136,57
4694,3,15464,3469,11995,0,0,0,1.0,1,1.0,1,1.0,1,0.19583775759843167,57
4695,4,15468,3469,11999,0,0,0,1.0,1,1.0,1,1.0,1,0.22303962956947102,56
4696,7,15475,3471,12004,0,0,0,1.0,1,1.0,1,1.0,1,0.17685779915535502,57
4697,2,15477,3471,12006,0,0,0,1.0,1,1.0,1,1.0,1,0.14240929938152497,58
4698,0,15477,3471,12006,0,0,0,1.0,1,1.0,1,1.0,1,0.14276985656957683,59
4699,2,15479,3472,12007,0,0,0,1.0,1,1.0,1,1.0,1,0.14092092136553447,58
4700,3,15482,3472,12010,0,0,0,1.0,1,1.0,1,1.0,1,0.1419760971353776,59
4701,1,15483,3472,12011,0,0,0,1.0,1,1.0,1,1.0,1,0.14024250255746398,60
4702,0,15483,3472,12011,0,0,0,1.0,1,1.0,1,1.0,1,0.14246666029080104,61
4703,3,15486,3474,12012,0,0,0,1.0,1,1.0,1,1.0,1,0.14534793343387378,59
4704,2,15488,3476,12012,0,0,0,1.0,1,1.0,1,1.0,1,0.18118529783143542,58
4705,5,15493,3479,12014,0,0,0,1.0,1,1.0,1,1.0,1,0.16940240624321784,58
4706,8,15501,3482,12019,0,0,0,1.0,1,1.0,1,1.0,1,0.21299577138209605,60
4707,10,15511,3483,12028,0,0,0,1.0,1,1.0,1,1.0,1,0.21339158167938224,57
4708,7,15518,3484,12034,0,0,0,1.0,1,1.0,1,1.0,1,0.27198885308766607,57
4709,11,15529,3486,12043,0,0,0,1.0,1,1.0,1,1.0,1,0.25763336582864504,55
4710,11,15540,3487,12053,0,0,0,1.0,1,1.0,1,1.0,1,0.3070829359451127,53
4711,10,15550,3490,12060,0,0,0,1.0,1,1.0,1,1.0,1,0.1883318321627875,52
4712,2,15552,3492,12060,0,0,0,1.0,1,1.0,1,1.0,1,0.2094511841120259,52
4713,2,15554,3493,12061,0,0,0,1.0,1,1.0,1,1.0,1,0.19906558375620836,51
4714,2,15556,3493,12063,0,0,0,1.0,1,1.0,1,1.0,1,0.17757337807744258,50
4715,0,15556,3493,12063,0,0,0,1.0,1,1.0,1,1.0,1,0.17757337807744258,50
4716,2,15558,3494,12064,0,0,0,1.0,1,1.0,1,1.0,1,0.1847928741010152,49
4717,2,15560,3496,12064,0,0,0,1.0,1,1.0,1,1.0,1,0.21011600314060863,49
4718,2,15562,3496,12066,0,0,0,1.0,1,1.0,1,1.0,1,0.21779074425843722,50
4719,5,15567,3496,12071,0,0,0,1.0,1,1.0,1,1.0,1,0.1894704099948522,49
4720,2,15569,3496,12073,0,0,0,1.0,1,1.0,1,1.0,1,0.18672147107755727,49
4721,2,15571,3496,12075,0,0,0,1.0,1,1.0,1,1.0,1,0.12662264058573716,50
4722,2,15573,3496,12077,0,0,0,1.0,1,1.0,1,1.0,1,0.13895747189587696,51
4723,2,15575,3497,12078,0,0,0,1.0,1,1.0,1,1.0,1,0.14650031532592642,50
4724,2,15577,3497,12080,0,0,0,1.0,1,1.0,1,1.0,1,0.14270691085267503,50
4725,6,15583,3498,12085,0,0,0,1.0,1,1.0,1,1.0,1,0.17871622924223418,52
4726,3,15586,3499,12087,0,0,0,1.0,1,1.0,1,1.0,1,0.1581761633581916,51
4727,2,15588,3499,12089,0,0,0,1.0,1,1.0,1,1.0,1,0.13329668498843472,52
4728,0,15588,3499,12089,0,0,0,1.0,1,1.0,1,1.0,1,0.13329668498843472,52
4729,3,15591,3501,12090,0,0,0,1.0,1,1.0,1,1.0,1,0.14338085572463766,52
4730,1,15592,3502,12090,0,0,0,1.0,1,1.0,1,1.0,1,0.18554213434541095,50
4731,6,15598,3504,12094,0,0,0,1.0,1,1.0,1,1.0,1,0.15459004925050696,51
4732,2,15600,3505,12095,0,0,0,1.0,1,1.0,1,1.0,1,0.18723382463285937,52
4733,5,15605,3507,12098,0,0,0,1.0,1,1.0,1,1.0,1,0.2163484133209903,53
4734,6,15611,3508,12103,0,0,0,1.0,1,1.0,1,1.0,1,0.24186084807374406,53
4735,8,15619,3509,12110,0,0,0,1.0,1,1.0,1,1.0,1,0.25496435716202154,53
4736,11,15630,3509,12121,0,0,0,1.0,1,1.0,1,1.0,1,0.2643023762919614,55
4737,8,15638,3509,12129,0,0,0,1.0,1,1.0,1,1.0,1,0.24585333611043234,57
4738,10,15648,3509,12139,0,0,0,1.0,1,1.0,1,1.0,1,0.2611567116673281,57
4739,9,15657,3509,12148,0,0,0,1.0,1,1.0,1,1.0,1,0.2513925673604677,57
4740,5,15662,3509,12153,0,0,0,1.0,1,1.0,1,1.0,1,0.22922894265017388,57
4741,4,15666,3509,12157,0,0,0,1.0,1,1.0,1,1.0,1,0.17759509131567125,58
4742,3,15669,3511,12158,0,0,0,1.0,1,1.0,1,1.0,1,0.1953755105713625,58
4743,5,15674,3511,12163,0,0,0,1.0,1,1.0,1,1.0,1,0.1481081282415067,56
4744,3,15677,3512,12165,0,0,0,1.0,1,1.0,1,1.0,1,0.11413394532403748,57
4745,2,15679,3512,12167,0,0,0,1.0,1,1.0,1,1.0,1,0.10773953886018589,56
4746,4,15683,3513,12170,0,0,0,1.0,1,1.0,1,1.0,1,0.10752177577865979,56
4747,1,15684,3514,12170,0,0,0,1.0,1,1.0,1,1.0,1,0.1182672162861131,55
4748,6,15690,3516,12174,0,0,0,1.0,1,1.0,1,1.0,1,0.10863494768377138,55
4749,5,15695,3518,12177,0,0,0,1.0,1,1.0,1,1.0,1,0.07941654788262816,54
4750,4,15699,3519,12180,0,0,0,1.0,1,1.0,1,1.0,1,0.09098302172385209,53
4751,3,15702,3520,12182,0,0,0,1.0,1,1.0,1,1.0,1,0.12531006472591422,53
4752,3,15705,3520,12185,0,0,0,1.0,1,1.0,1,1.0,1,0.09392381721500416,53
4753,1,15706,3520,12186,0,0,0,1.0,1,1.0,1,1.0,1,0.10286514972417578,52
4754,0,15706,3520,12186,0,0,0,1.0,1,1.0,1,1.0,1,0.1201830821029632,52
4755,1,15707,3520,12187,0,0,0,1.0,1,1.0,1,1.0,1,0.1421902827314543,51
4756,3,15710,3521,12189,0,0,0,1.0,1,1.0,1,1.0,1,0.11761702915689476,52
4757,1,15711,3521,12190,0,0,0,1.0,1,1.0,1,1.0,1,0.11559477759928934,51
4758,1,15712,3521,12191,0,0,0,1.0,1,1.0,1,1.0,1,0.110045423104674,51
4759,0,15712,3521,12191,0,0,0,1.0,1,1.0,1,1.0,1,0.110045423104674,51
4760,1,15713,3522,12191,0,0,0,1.0,1,1.0,1,1.0,1,0.1053453630129692,52
4761,3,15716,3524,12192,0,0,0,1.0,1,1.0,1,1.0,1,0.17249141042889174,50
4762,3,15719,3526,12193,0,0,0,1.0,1,1.0,1,1.0,1,0.19757650295359525,51
4763,4,15723,3527,12196,0,0,0,1.0,1,1.0,1,1.0,1,0.20471714952530606,51
4764,6,15729,3527,12202,0,0,0,1.0,1,1.0,1,1.0,1,0.1471834664073681,53
4765,4,15733,3528,12205,0,0,0,1.0,1,1.0,1,1.0,1,0.1738454288416041,53
4766,8,15741,3530,12211,0,0,0,1.0,1,1.0,1,1.0,1,0.20125271100880265,55
4767,11,15752,3531,12221,0,0,0,1.0,1,1.0,1,1.0,1,0.18167656174171784,56
4768,6,15758,3531,12227,0,0,0,1.0,1,1.0,1,1.0,1,0.14399084886995955,56
4769,7,15765,3531,12234,0,0,0,1.0,1,1.0,1,1.0,1,0.15489642125229824,56
4770,6,15771,3531,12240,0,0,0,1.0,1,1.0,1,1.0,1,0.1577730362609445,56
4771,6,15777,3531,12246,0,0,0,1.0,1,1.0,1,1.0,1,0.1216062978918595,55
4772,1,15778,3531,12247,0,0,0,1.0,1,1.0,1,1.0,1,0.10495379201074373,56
4773,1,15779,3532,12247,0,0,0,1.0,1,1.0,1,1.0,1,0.08173123947101037,56
4774,1,15780,3532,12248,0,0,0,1.0,1,1.0,1,1.0,1,0.07002631332420774,58
4775,7,15787,3534,12253,0,0,0,1.0,1,1.0,1,1.0,1,0.09601896281918153,59
4776,3,15790,3534,12256,0,0,0,1.0,1,1.0,1,1.0,1,0.05731401207820729,59
4777,3,15793,3534,12259,0,0,0,1.0,1,1.0,1,1.0,1,0.08387306203354644,60
4778,3,15796,3534,12262,0,0,0,1.0,1,1.0,1,1.0,1,0.09024445185263368,60
4779,3,15799,3534,12265,0,0,0,1.0,1,1.0,1,1.0,1,0.07613201501657181,61
4780,1,15800,3534,12266,0,0,0,1.0,1,1.0,1,1.0,1,0.09632910227331022,63
4781,1,15801,3534,12267,0,0,0,1.0,1,1.0,1,1.0,1,0.11317329969819268,62
4782,3,15804,3535,12269,0,0,0,1.0,1,1.0,1,1.0,1,0.12648041901975532,63
4783,3,15807,3536,12271,0,0,0,1.0,1,1.0,1,1.0,1,0.13010851605763685,62
4784,7,15814,3539,12275,0,0,0,1.0,1,1.0,1,1.0,1,0.16307257176067105,62
4785,8,15822,3542,12280,0,0,0,1.0,1,1.0,1,1.0,1,0.1790945829893815,62
4786,11,15833,3544,12289,0,0,0,1.0,1,1.0,1,1.0,1,0.10822109079198744,63
4787,7,15840,3547,12293,0,0,0,1.0,1,1.0,1,1.0,1,0.11645192637695724,62
4788,9,15849,3549,12300,0,0,0,1.0,1,1.0,1,1.0,1,0.1279418719265514,62
4789,4,15853,3549,12304,0,0,0,1.0,1,1.0,1,1.0,1,0.12111924652134567,60
4790,7,15860,3550,12310,0,0,0,1.0,1,1.0,1,1.0,1,0.1367732176572359,61
4791,5,15865,3552,12313,0,0,0,1.0,1,1.0,1,1.0,1,0.1233021249541165,60
4792,6,15871,3554,12317,0,0,0,1.0,1,1.0,1,1.0,1,0.2016438377597,60
4793,13,15884,3557,12327,0,0,0,1.0,1,1.0,1,1.0,1,0.17884525892256947,61
4794,4,15888,3558,12330,0,0,0,1.0,1,1.0,1,1.0,1,0.16061200741260012,59
4795,7,15895,3559,12336,0,0,0,1.0,1,1.0,1,1.0,1,0.0955961212300116,61
4796,6,15901,3561,12340,0,0,0,1.0,1,1.0,1,1.0,1,0.1133435688479113,59
4797,5,15906,3561,12345,0,0,0,1.0,1,1.0,1,1.0,1,0.15624945756279227,58
4798,6,15912,3562,12350,0,0,0,1.0,1,1.0,1,1.0,1,0.16918375499292093,59
4799,4,15916,3563,12353,0,0,0,1.0,1,1.0,1,1.0,1,0.15478261662766116,57
4800,4,15920,3563,12357,0,0,0,1.0,1,1.0,1,1.0,1,0.1568142067227341,58
4801,9,15929,3565,12364,0,0,0,1.0,1,1.0,1,1.0,1,0.09445241066952377,57
4802,2,15931,3566,12365,0,0,0,1.0,1,1.0,1,1.0,1,0.07911491996859285,57
4803,2,15933,3566,12367,0,0,0,1.0,1,1.0,1,1.0,1,0.07032376890310373,56
4804,0,15933,3566,12367,0,0,0,1.0,1,1.0,1,1.0,1,0.07599727267546648,54
4805,1,15934,3567,12367,0,0,0,1.0,1,1.0,1,1.0,1,0.07469216090766698,56
4806,1,15935,3567,12368,0,0,0,1.0,1,1.0,1,1.0,1,0.07828928372706052,55
4807,3,15938,3568,12370,0,0,0,1.0,1,1.0,1,1.0,1,0.09764772037226954,54
4808,5,15943,3568,12375,0,0,0,1.0,1,1.0,1,1.0,1,0.1581718935626362,53
4809,3,15946,3569,12377,0,0,0,1.0,1,1.0,1,1.0,1,0.12643579751242928,53
4810,3,15949,3570,12379,0,0,0,1.0,1,1.0,1,1.0,1,0.13880775058748104,51
4811,1,15950,3570,12380,0,0,0,1.0,1,1.0,1,1.0,1,0.14339607179094968,52
4812,3,15953,3571,12382,0,0,0,1.0,1,1.0,1,1.0,1,0.15190876284913388,52
4813,7,15960,3572,12388,0,0,0,1.0,1,1.0,1,1.0,1,0.16419915389643272,52
4814,13,15973,3577,12396,0,0,0,1.0,1,1.0,1,1.0,1,0.17832612928353675,53
4815,5,15978,3579,12399,0,0,0,1.0,1,1.0,1,1.0,1,0.17963933860174658,54
4816,6,15984,3579,12405,0,0,0,1.0,1,1.0,1,1.0,1,0.07050610641138538,54
4817,6,15990,3583,12407,0,0,0,1.0,1,1.0,1,1.0,1,0.1439407644470081,55
4818,8,15998,3584,12414,0,0,0,1.0,1,1.0,1,1.0,1,0.10844324773059667,55
4819,5,16003,3585,12418,0,0,0,1.0,1,1.0,1,1.0,1,0.1525618812141652,55
4820,3,16006,3586,12420,0,0,0,1.0,1,1.0,1,1.0,1,0.15685163085162235,55
4821,7,16013,3588,12425,0,0,0,1.0,1,1.0,1,1.0,1,0.18890262595005652,55
4822,7,16020,3589,12431,0,0,0,1.0,1,1.0,1,1.0,1,0.1736218817221466,54
4823,5,16025,3589,12436,0,0,0,1.0,1,1.0,1,1.0,1,0.1534659381961385,54
4824,4,16029,3591,12438,0,0,0,1.0,1,1.0,1,1.0,1,0.1349344942393676,55
4825,3,16032,3592,12440,0,0,0,1.0,1,1.0,1,1.0,1,0.12556224270798672,53
4826,5,16037,3595,12442,0,0,0,1.0,1,1.0,1,1.0,1,0.13646305685404303,54
4827,4,16041,3596,12445,0,0,0,1.0,1,1.0,1,1.0,1,0.16109647843284597,53
4828,4,16045,3596,12449,0,0,0,1.0,1,1.0,1,1.0,1,0.14818850841653958,54
4829,2,16047,3596,12451,0,0,0,1.0,1,1.0,1,1.0,1,0.11788685275141352,54
4830,6,16053,3598,12455,0,0,0,1.0,1,1.0,1,1.0,1,0.1458936347877869,53
4831,6,16059,3600,12459,0,0,0,1.0,1,1.0,1,1.0,1,0.07637320963589121,52
4832,1,16060,3600,12460,0,0,0,1.0,1,1.0,1,1.0,1,0.07719171583867827,50
4833,0,16060,3600,12460,0,0,0,1.0,1,1.0,1,1.0,1,0.09159260674139713,51
4834,2,16062,3602,12460,0,0,0,1.0,1,1.0,1,1.0,1,0.15561851484811448,51
4835,1,16063,3602,12461,0,0,0,1.0,1,1.0,1,1.0,1,0.1376797549980022,50
4836,1,16064,3603,12461,0,0,0,1.0,1,1.0,1,1.0,1,0.16631768440984535,50
4837,0,16064,3603,12461,0,0,0,1.0,1,1.0,1,1.0,1,0.15660737779525577,46
4838,5,16069,3607,12462,0,0,0,1.0,1,1.0,1,1.0,1,0.1860230581275995,47
4839,1,16070,3607,12463,0,0,0,1.0,1,1.0,1,1.0,1,0.1675095520368649,45
4840,3,16073,3609,12464,0,0,0,1.0,1,1.0,1,1.0,1,0.18083781652389602,45
4841,2,16075,3610,12465,0,0,0,1.0,1,1.0,1,1.0,1,0.1668807836471797,43
4842,0,16075,3610,12465,0,0,0,1.0,1,1.0,1,1.0,1,0.1446205365902772,43
4843,1,16076,3610,12466,0,0,0,1.0,1,1.0,1,1.0,1,0.14322138555906808,44
4844,0,16076,3610,12466,0,0,0,1.0,1,1.0,1,1.0,1,0.17382895323767117,43
4845,4,16080,3612,12468,0,0,0,1.0,1,1.0,1,1.0,1,0.17904754827182198,44
4846,5,16085,3612,12473,0,0,0,1.0,1,1.0,1,1.0,1,0.13988715373461408,43
4847,5,16090,3614,12476,0,0,0,1.0,1,1.0,1,1.0,1,0.1533398101713618,42
4848,3,16093,3616,12477,0,0,0,1.0,1,1.0,1,1.0,1,0.18802301364087043,41
4849,1,16094,3617,12477,0,0,0,1.0,1,1.0,1,1.0,1,0.18782169742262145,41
4850,1,16095,3617,12478,0,0,0,1.0,1,1.0,1,1.0,1,0.2092026497417143,41
4851,1,16096,3617,12479,0,0,0,1.0,1,1.0,1,1.0,1,0.20075485130189022,41
4852,2,16098,3617,12481,0,0,0,1.0,1,1.0,1,1.0,1,0.20284637813643863,43
4853,2,16100,3618,12482,0,0,0,1.0,1,1.0,1,1.0,1,0.23291862280547868,44
4854,2,16102,3619,12483,0,0,0,1.0,1,1.0,1,1.0,1,0.24559146931155432,45
4855,1,16103,3619,12484,0,0,0,1.0,1,1.0,1,1.0,1,0.21735511810528957,44
4856,2,16105,3619,12486,0,0,0,1.0,1,1.0,1,1.0,1,0.21735511810528957,44
4857,2,16107,3619,12488,0,0,0,1.0,1,1.0,1,1.0,1,0.1951216008600873,44
4858,0,16107,3619,12488,0,0,0,1.0,1,1.0,1,1.0,1,0.20726824856325896,45
4859,1,16108,3619,12489,0,0,0,1.0,1,1.0,1,1.0,1,0.18476342729724995,46
4860,0,16108,3619,12489,0,0,0,1.0,1,1.0,1,1.0,1,0.18476342729724995,46
4861,3,16111,3619,12492,0,0,0,1.0,1,1.0,1,1.0,1,0.10763728935171855,46
4862,0,16111,3619,12492,0,0,0,1.0,1,1.0,1,1.0,1,0.10416439541501422,47
4863,2,16113,3621,12492,0,0,0,1.0,1,1.0,1,1.0,1,0.1145776697995391,47
4864,1,16114,3621,12493,0,0,0,1.0,1,1.0,1,1.0,1,0.10510777586113902,47
4865,2,16116,3621,12495,0,0,0,1.0,1,1.0,1,1.0,1,0.08978186015424668,48
4866,1,16117,3622,12495,0,0,0,1.0,1,1.0,1,1.0,1,0.107758102139042,49
4867,0,16117,3622,12495,0,0,0,1.0,1,1.0,1,1.0,1,0.12050674793700748,50
4868,1,16118,3623,12495,0,0,0,1.0,1,1.0,1,1.0,1,0.1507592616310947,50
4869,1,16119,3623,12496,0,0,0,1.0,1,1.0,1,1.0,1,0.14275527223151707,50
4870,3,16122,3624,12498,0,0,0,1.0,1,1.0,1,1.0,1,0.17410984371417726,52
4871,2,16124,3624,12500,0,0,0,1.0,1,1.0,1,1.0,1,0.13780177788444717,52
4872,5,16129,3626,12503,0,0,0,1.0,1,1.0,1,1.0,1,0.1370128154208038,53
4873,5,16134,3627,12507,0,0,0,1.0,1,1.0,1,1.0,1,0.16958058499000575,55
4874,3,16137,3628,12509,0,0,0,1.0,1,1.0,1,1.0,1,0.20171057758201383,56
4875,3,16140,3629,12511,0,0,0,1.0,1,1.0,1,1.0,1,0.18339009953183694,55
4876,7,16147,3631,12516,0,0,0,1.0,1,1.0,1,1.0,1,0.1396346304323674,55
4877,0,16147,3631,12516,0,0,0,1.0,1,1.0,1,1.0,1,0.14168786794267427,54
4878,4,16151,3633,12518,0,0,0,1.0,1,1.0,1,1.0,1,0.194876477560133,53
4879,4,16155,3636,12519,0,0,0,1.0,1,1.0,1,1.0,1,0.2591051669568656,54
4880,5,16160,3636,12524,0,0,0,1.0,1,1.0,1,1.0,1,0.22534614779467227,54
4881,1,16161,3636,12525,0,0,0,1.0,1,1.0,1,1.0,1,0.21098690268027875,53
4882,5,16166,3637,12529,0,0,0,1.0,1,1.0,1,1.0,1,0.22436599296320303,53
4883,1,16167,3637,12530,0,0,0,1.0,1,1.0,1,1.0,1,0.2348628315840734,53
4884,4,16171,3638,12533,0,0,0,1.0,1,1.0,1,1.0,1,0.2414871349657809,51
4885,6,16177,3639,12538,0,0,0,1.0,1,1.0,1,1.0,1,0.2508943490866771,50
4886,3,16180,3639,12541,0,0,0,1.0,1,1.0,1,1.0,1,0.23313971751342819,48
4887,2,16182,3639,12543,0,0,0,1.0,1,1.0,1,1.0,1,0.23313971751342819,48
4888,5,16187,3640,12547,0,0,0,1.0,1,1.0,1,1.0,1,0.25909386715546623,48
4889,2,16189,3640,12549,0,0,0,1.0,1,1.0,1,1.0,1,0.23337459102157226,48
4890,3,16192,3641,12551,0,0,0,1.0,1,1.0,1,1.0,1,0.25272959248241755,49
4891,7,16199,3642,12557,0,0,0,1.0,1,1.0,1,1.0,1,0.1923489622810677,50
4892,3,16202,3642,12560,0,0,0,1.0,1,1.0,1,1.0,1,0.16651092986651225,49
4893,3,16205,3643,12562,0,0,0,1.0,1,1.0,1,1.0,1,0.1612418148823056,50
4894,1,16206,3643,12563,0,0,0,1.0,1,1.0,1,1.0,1,0.14671678358244453,51
4895,0,16206,3643,12563,0,0,0,1.0,1,1.0,1,1.0,1,0.1438062667876996,52
4896,4,16210,3643,12567,0,0,0,1.0,1,1.0,1,1.0,1,0.1128553732498147,53
4897,3,16213,3643,12570,0,0,0,1.0,1,1.0,1,1.0,1,0.12072426457629197,53
4898,4,16217,3643,12574,0,0,0,1.0,1,1.0,1,1.0,1,0.12157005909263538,53
4899,4,16221,3644,12577,0,0,0,1.0,1,1.0,1,1.0,1,0.1342066429355401,55
4900,3,16224,3645,12579,0,0,0,1.0,1,1.0,1,1.0,1,0.14969345379788307,55
4901,3,16227,3645,12582,0,0,0,1.0,1,1.0,1,1.0,1,0.11572218731532641,56
4902,6,16233,3645,12588,0,0,0,1.0,1,1.0,1,1.0,1,0.13711838606362017,58
4903,7,16240,3647,12593,0,0,0,1.0,1,1.0,1,1.0,1,0.1589043196515817,58
4904,8,16248,3649,12599,0,0,0,1.0,1,1.0,1,1.0,1,0.17542391236484497,57
4905,6,16254,3649,12605,0,0,0,1.0,1,1.0,1,1.0,1,0.19171334675032622,54
4906,9,16263,3650,12613,0,0,0,1.0,1,1.0,1,1.0,1,0.21607019091578905,55
4907,4,16267,3650,12617,0,0,0,1.0,1,1.0,1,1.0,1,0.17050446977045797,52
4908,9,16276,3652,12624,0,0,0,1.0,1,1.0,1,1.0,1,0.18289725719425268,53
4909,2,16278,3652,12626,0,0,0,1.0,1,1.0,1,1.0,1,0.17890463325550757,52
4910,6,16284,3653,12631,0,0,0,1.0,1,1.0,1,1.0,1,0.19298697014369381,53
4911,2,16286,3653,12633,0,0,0,1.0,1,1.0,1,1.0,1,0.19331191153587432,55
4912,3,16289,3653,12636,0,0,0,1.0,1,1.0,1,1.0,1,0.1773730679920622,54
4913,5,16294,3653,12641,0,0,0,1.0,1,1.0,1,1.0,1,0.13656306915767127,53
4914,1,16295,3654,12641,0,0,0,1.0,1,1.0,1,1.0,1,0.11463929050584645,53
4915,2,16297,3655,12642,0,0,0,1.0,1,1.0,1,1.0,1,0.1501440467548276,54
4916,5,16302,3656,12646,0,0,0,1.0,1,1.0,1,1.0,1,0.20086374395325815,52
4917,4,16306,3657,12649,0,0,0,1.0,1,1.0,1,1.0,1,0.23120776456894454,52
4918,11,16317,3658,12659,0,0,0,1.0,1,1.0,1,1.0,1,0.2800556368611525,51
4919,6,16323,3658,12665,0,0,0,1.0,1,1.0,1,1.0,1,0.2828409757820825,50
4920,11,16334,3658,12676,0,0,0,1.0,1,1.0,1,1.0,1,0.2709462613292438,51
4921,11,16345,3658,12687,0,0,0,1.0,1,1.0,1,1.0,1,0.16906639687916736,51
4922,5,16350,3659,12691,0,0,0,1.0,1,1.0,1,1.0,1,0.1716529120364067,53
4923,1,16351,3659,12692,0,0,0,1.0,1,1.0,1,1.0,1,0.1701762994675308,53
4924,3,16354,3659,12695,0,0,0,1.0,1,1.0,1,1.0,1,0.16723236168955558,55
4925,5,16359,3660,12699,0,0,0,1.0,1,1.0,1,1.0,1,0.12277564039177868,56
4926,5,16364,3660,12704,0,0,0,1.0,1,1.0,1,1.0,1,0.1266300899713791,55
4927,4,16368,3660,12708,0,0,0,1.0,1,1.0,1,1.0,1,0.12173504218542362,55
4928,2,16370,3660,12710,0,0,0,1.0,1,1.0,1,1.0,1,0.11898094749611703,55
4929,4,16374,3660,12714,0,0,0,1.0,1,1.0,1,1.0,1,0.12593096737939283,56
4930,6,16380,3661,12719,0,0,0,1.0,1,1.0,1,1.0,1,0.14247929017978525,58
4931,5,16385,3661,12724,0,0,0,1.0,1,1.0,1,1.0,1,0.15963163375143977,59
4932,7,16392,3661,12731,0,0,0,1.0,1,1.0,1,1.0,1,0.18499693130484762,60
4933,4,16396,3661,12735,0,0,0,1.0,1,1.0,1,1.0,1,0.16488003796658665,60
4934,5,16401,3662,12739,0,0,0,1.0,1,1.0,1,1.0,1,0.19341819978012093,60
4935,6,16407,3662,12745,0,0,0,1.0,1,1.0,1,1.0,1,0.14062438190736262,60
4936,9,16416,3664,12752,0,0,0,1.0,1,1.0,1,1.0,1,0.14554127938601522,61
4937,6,16422,3665,12757,0,0,0,1.0,1,1.0,1,1.0,1,0.15608751795667652,62
4938,4,16426,3665,12761,0,0,0,1.0,1,1.0,1,1.0,1,0.1393796173447687,62
4939,9,16435,3667,12768,0,0,0,1.0,1,1.0,1,1.0,1,0.14787822306178638,64
4940,8,16443,3667,12776,0,0,0,1.0,1,1.0,1,1.0,1,0.12066502154731108,67
4941,11,16454,3668,12786,0,0,0,1.0,1,1.0,1,1.0,1,0.1628064426060096,66
4942,13,16467,3668,12799,0,0,0,1.0,1,1.0,1,1.0,1,0.15145302632865107,67
4943,11,16478,3668,12810,0,0,0,1.0,1,1.0,1,1.0,1,0.18162125952420086,65
4944,15,16493,3670,12823,0,0,0,1.0,1,1.0,1,1.0,1,0.18407582914371565,65
4945,8,16501,3670,12831,0,0,0,1.0,1,1.0,1,1.0,1,0.19919171772729521,62
4946,9,16510,3672,12838,0,0,0,1.0,1,1.0,1,1.0,1,0.17075494281632578,61
4947,9,16519,3673,12846,0,0,0,1.0,1,1.0,1,1.0,1,0.18462211673264614,59
4948,5,16524,3674,12850,0,0,0,1.0,1,1.0,1,1.0,1,0.17692315026888505,59
4949,5,16529,3675,12854,0,0,0,1.0,1,1.0,1,1.0,1,0.18734007485330448,57
4950,8,16537,3678,12859,0,0,0,1.0,1,1.0,1,1.0,1,0.20351600299490552,58
4951,11,16548,3683,12865,0,0,0,1.0,1,1.0,1,1.0,1,0.13652131892830846,55
4952,3,16551,3684,12867,0,0,0,1.0,1,1.0,1,1.0,1,0.10691619522140992,53
4953,6,16557,3688,12869,0,0,0,1.0,1,1.0,1,1.0,1,0.12935766649108077,54
4954,1,16558,3688,12870,0,0,0,1.0,1,1.0,1,1.0,1,0.10209294015967943,52
4955,3,16561,3690,12871,0,0,0,1.0,1,1.0,1,1.0,1,0.12705320592628724,51
4956,0,16561,3690,12871,0,0,0,1.0,1,1.0,1,1.0,1,0.154108424160918,47
4957,2,16563,3691,12872,0,0,0,1.0,1,1.0,1,1.0,1,0.15887242059265763,48
4958,0,16563,3691,12872,0,0,0,1.0,1,1.0,1,1.0,1,0.16080225788768415,47
4959,0,16563,3691,12872,0,0,0,1.0,1,1.0,1,1.0,1,0.16080225788768415,47
4960,0,16563,3691,12872,0,0,0,1.0,1,1.0,1,1.0,1,0.15587994736613003,48
4961,2,16565,3692,12873,0,0,0,1.0,1,1.0,1,1.0,1,0.11772379718606518,49
4962,1,16566,3692,12874,0,0,0,1.0,1,1.0,1,1.0,1,0.12893057693620616,49
4963,1,16567,3693,12874,0,0,0,1.0,1,1.0,1,1.0,1,0.1532812124443266,51
4964,3,16570,3695,12875,0,0,0,1.0,1,1.0,1,1.0,1,0.18187949390996042,51
4965,3,16573,3696,12877,0,0,0,1.0,1,1.0,1,1.0,1,0.17170867788483957,51
4966,2,16575,3696,12879,0,0,0,1.0,1,1.0,1,1.0,1,0.15826867513071402,51
4967,3,16578,3698,12880,0,0,0,1.0,1,1.0,1,1.0,1,0.14229215888296262,51
4968,2,16580,3699,12881,0,0,0,1.0,1,1.0,1,1.0,1,0.12135967360240071,52
4969,4,16584,3702,12882,0,0,0,1.0,1,1.0,1,1.0,1,0.16987376006145655,53
4970,9,16593,3705,12888,0,0,0,1.0,1,1.0,1,1.0,1,0.15477754651389725,54
4971,9,16602,3705,12897,0,0,0,1.0,1,1.0,1,1.0,1,0.17296753939448686,55
4972,12,16614,3707,12907,0,0,0,1.0,1,1.0,1,1.0,1,0.23885870587783956,56
4973,9,16623,3708,12915,0,0,0,1.0,1,1.0,1,1.0,1,0.21651986533300996,57
4974,8,16631,3709,12922,0,0,0,1.0,1,1.0,1,1.0,1,0.2523300331194294,56
4975,8,16639,3710,12929,0,0,0,1.0,1,1.0,1,1.0,1,0.21519276108065655,57
4976,11,16650,3711,12939,0,0,0,1.0,1,1.0,1,1.0,1,0.17211931614649004,57
4977,8,16658,3711,12947,0,0,0,1.0,1,1.0,1,1.0,1,0.2248491884109398,57
4978,12,16670,3711,12959,0,0,0,1.0,1,1.0,1,1.0,1,0.22253111194691272,58
4979,10,16680,3711,12969,0,0,0,1.0,1,1.0,1,1.0,1,0.2165058349982643,58
4980,8,16688,3711,12977,0,0,0,1.0,1,1.0,1,1.0,1,0.21043215063259352,59
4981,7,16695,3711,12984,0,0,0,1.0,1,1.0,1,1.0,1,0.10751468649876347,60
4982,1,16696,3711,12985,0,0,0,1.0,1,1.0,1,1.0,1,0.1003263115439799,61
4983,1,16697,3711,12986,0,0,0,1.0,1,1.0,1,1.0,1,0.11237463941609264,61
4984,1,16698,3711,12987,0,0,0,1.0,1,1.0,1,1.0,1,0.10792360503795383,59
4985,0,16698,3711,12987,0,0,0,1.0,1,1.0,1,1.0,1,0.14604709731067259,58
4986,2,16700,3712,12988,0,0,0,1.0,1,1.0,1,1.0,1,0.11356879626468072,59
4987,1,16701,3713,12988,0,0,0,1.0,1,1.0,1,1.0,1,0.14935261194857175,58
4988,4,16705,3717,12988,0,0,0,1.0,1,1.0,1,1.0,1,0.12461322485978764,57
4989,3,16708,3718,12990,0,0,0,1.0,1,1.0,1,1.0,1,0.13194522250166735,54
4990,1,16709,3719,12990,0,0,0,1.0,1,1.0,1,1.0,1,0.1302993699042104,53
4991,3,16712,3722,12990,0,0,0,1.0,1,1.0,1,1.0,1,0.1727892446599465,52
4992,3,16715,3724,12991,0,0,0,1.0,1,1.0,1,1.0,1,0.21583287553164415,48
4993,5,16720,3725,12995,0,0,0,1.0,1,1.0,1,1.0,1,0.2056661077985976,48
4994,2,16722,3725,12997,0,0,0,1.0,1,1.0,1,1.0,1,0.2662143774879362,45
4995,4,16726,3728,12998,0,0,0,1.0,1,1.0,1,1.0,1,0.3060099623568733,45
4996,11,16737,3730,13007,0,0,0,1.0,1,1.0,1,1.0,1,0.13211359234572093,45
4997,1,16738,3731,13007,0,0,0,1.0,1,1.0,1,1.0,1,0.1601032677830559,42
4998,6,16744,3732,13012,0,0,0,1.0,1,1.0,1,1.0,1,0.18767571932313093,44
4999,7,16751,3733,13018,0,0,0,1.0,1,1.0,1,1.0,1,0.22402368399961275,44
5000,3,16754,3734,13020,0,0,0,1.0,1,1.0,1,1.0,1,0.20871805573069885,42
5001,1,16755,3734,13021,0,0,0,1.0,1,1.0,1,1.0,1,0.2055273079918853,42
5002,1,16756,3735,13021,0,0,0,1.0,1,1.0,1,1.0,1,0.2227273075034692,41
5003,1,16757,3735,13022,0,0,0,1.0,1,1.0,1,1.0,1,0.22811127444483273,41
5004,2,16759,3735,13024,0,0,0,1.0,1,1.0,1,1.0,1,0.24520472440060778,41
5005,2,16761,3735,13026,0,0,0,1.0,1,1.0,1,1.0,1,0.24520472440060778,41
5006,4,16765,3735,13030,0,0,0,1.0,1,1.0,1,1.0,1,0.2603172700784361,42
5007,6,16771,3735,13036,0,0,0,1.0,1,1.0,1,1.0,1,0.26723349626953563,43
5008,4,16775,3735,13040,0,0,0,1.0,1,1.0,1,1.0,1,0.2347983795836254,46
5009,8,16783,3735,13048,0,0,0,1.0,1,1.0,1,1.0,1,0.2347983795836254,46
5010,9,16792,3735,13057,0,0,0,1.0,1,1.0,1,1.0,1,0.24774017270051202,46
5011,11,16803,3735,13068,0,0,0,1.0,1,1.0,1,1.0,1,0.12455372910830109,47
5012,1,16804,3735,13069,0,0,0,1.0,1,1.0,1,1.0,1,0.13594334271145572,48
5013,2,16806,3735,13071,0,0,0,1.0,1,1.0,1,1.0,1,0.10759868873275168,48
5014,3,16809,3735,13074,0,0,0,1.0,1,1.0,1,1.0,1,0.09857851203092714,49
5015,3,16812,3736,13076,0,0,0,1.0,1,1.0,1,1.0,1,0.13879633538141417,50
5016,4,16816,3737,13079,0,0,0,1.0,1,1.0,1,1.0,1,0.17282925551601075,51
5017,0,16816,3737,13079,0,0,0,1.0,1,1.0,1,1.0,1,0.17282925551601075,51
5018,3,16819,3737,13082,0,0,0,1.0,1,1.0,1,1.0,1,0.1411950338486478,51
5019,4,16823,3738,13085,0,0,0,1.0,1,1.0,1,1.0,1,0.1659172491605888,51
5020,7,16830,3738,13092,0,0,0,1.0,1,1.0,1,1.0,1,0.14567489659485974,51
5021,3,16833,3738,13095,0,0,0,1.0,1,1.0,1,1.0,1,0.1426341183071728,52
5022,0,16833,3738,13095,0,0,0,1.0,1,1.0,1,1.0,1,0.1426341183071728,52
5023,4,16837,3741,13096,0,0,0,1.0,1,1.0,1,1.0,1,0.14675182102793247,52
5024,2,16839,3743,13096,0,0,0,1.0,1,1.0,1,1.0,1,0.15111950870446766,51
5025,1,16840,3743,13097,0,0,0,1.0,1,1.0,1,1.0,1,0.14456242210873937,50
5026,6,16846,3745,13101,0,0,0,1.0,1,1.0,1,1.0,1,0.13222553782107235,49
5027,2,16848,3746,13102,0,0,0,1.0,1,1.0,1,1.0,1,0.15724703611387023,47
5028,3,16851,3748,13103,0,0,0,1.0,1,1.0,1,1.0,1,0.20334456163208178,47
5029,4,16855,3750,13105,0,0,0,1.0,1,1.0,1,1.0,1,0.18306479263110867,46
5030,2,16857,3750,13107,0,0,0,1.0,1,1.0,1,1.0,1,0.1356121387748131,48
5031,1,16858,3751,13107,0,0,0,1.0,1,1.0,1,1.0,1,0.18271733320073233,46
5032,4,16862,3752,13110,0,0,0,1.0,1,1.0,1,1.0,1,0.1455738119205633,46
5033,3,16865,3753,13112,0,0,0,1.0,1,1.0,1,1.0,1,0.13128248538028692,47
5034,5,16870,3754,13116,0,0,0,1.0,1,1.0,1,1.0,1,0.17691861312998358,48
5035,2,16872,3754,13118,0,0,0,1.0,1,1.0,1,1.0,1,0.16248378972702068,47
5036,4,16876,3754,13122,0,0,0,1.0,1,1.0,1,1.0,1,0.16248378972702068,47
5037,4,16880,3754,13126,0,0,0,1.0,1,1.0,1,1.0,1,0.16465078102343367,47
5038,3,16883,3755,13128,0,0,0,1.0,1,1.0,1,1.0,1,0.20523691610178887,48
5039,5,16888,3755,13133,0,0,0,1.0,1,1.0,1,1.0,1,0.19224567411360075,47
5040,3,16891,3755,13136,0,0,0,1.0,1,1.0,1,1.0,1,0.15837365018990446,48
5041,3,16894,3755,13139,0,0,0,1.0,1,1.0,1,1.0,1,0.11768182770928896,49
5042,3,16897,3756,13141,0,0,0,1.0,1,1.0,1,1.0,1,0.09334156082731423,50
5043,0,16897,3756,13141,0,0,0,1.0,1,1.0,1,1.0,1,0.08421366907140652,51
5044,2,16899,3756,13143,0,0,0,1.0,1,1.0,1,1.0,1,0.07622170779852415,51
5045,2,16901,3756,13145,0,0,0,1.0,1,1.0,1,1.0,1,0.07543126156640913,51
5046,1,16902,3757,13145,0,0,0,1.0,1,1.0,1,1.0,1,0.09195776681577719,52
5047,1,16903,3757,13146,0,0,0,1.0,1,1.0,1,1.0,1,0.09023289308538376,52
5048,0,16903,3757,13146,0,0,0,1.0,1,1.0,1,1.0,1,0.09023289308538376,52
5049,1,16904,3757,13147,0,0,0,1.0,1,1.0,1,1.0,1,0.0963847319484713,52
5050,1,16905,3757,13148,0,0,0,1.0,1,1.0,1,1.0,1,0.09507955512283078,55
5051,0,16905,3757,13148,0,0,0,1.0,1,1.0,1,1.0,1,0.11255980270826624,55
5052,0,16905,3757,13148,0,0,0,1.0,1,1.0,1,1.0,1,0.11255980270826624,55
5053,0,16905,3757,13148,0,0,0,1.0,1,1.0,1,1.0,1,0.12355816541425184,54
5054,2,16907,3758,13149,0,0,0,1.0,1,1.0,1,1.0,1,0.12844778259282194,54
5055,2,16909,3758,13151,0,0,0,1.0,1,1.0,1,1.0,1,0.12932391667127766,54
5056,3,16912,3758,13154,0,0,0,1.0,1,1.0,1,1.0,1,0.08445144268410114,55
5057,2,16914,3758,13156,0,0,0,1.0,1,1.0,1,1.0,1,0.0756577828156464,56
5058,2,16916,3758,13158,0,0,0,1.0,1,1.0,1,1.0,1,0.060856018101507516,58
5059,2,16918,3758,13160,0,0,0,1.0,1,1.0,1,1.0,1,0.06495808928120327,58
5060,3,16921,3758,13163,0,0,0,1.0,1,1.0,1,1.0,1,0.06043856081199053,59
5061,2,16923,3759,13164,0,0,0,1.0,1,1.0,1,1.0,1,0.06504224635547667,58
5062,2,16925,3760,13165,0,0,0,1.0,1,1.0,1,1.0,1,0.06139531667518057,58
5063,4,16929,3764,13165,0,0,0,1.0,1,1.0,1,1.0,1,0.10525472039468764,57
5064,4,16933,3766,13167,0,0,0,1.0,1,1.0,1,1.0,1,0.14292285912334432,57
5065,1,16934,3767,13167,0,0,0,1.0,1,1.0,1,1.0,1,0.1580864854638599,56
5066,6,16940,3770,13170,0,0,0,1.0,1,1.0,1,1.0,1,0.2219594831835567,55
5067,1,16941,3770,13171,0,0,0,1.0,1,1.0,1,1.0,1,0.20456015994105695,54
5068,4,16945,3771,13174,0,0,0,1.0,1,1.0,1,1.0,1,0.20250906346591302,54
5069,4,16949,3772,13177,0,0,0,1.0,1,1.0,1,1.0,1,0.17213588732001667,53
5070,0,16949,3772,13177,0,0,0,1.0,1,1.0,1,1.0,1,0.17565602854460743,53
5071,5,16954,3772,13182,0,0,0,1.0,1,1.0,1,1.0,1,0.12813787061406742,53
5072,3,16957,3773,13184,0,0,0,1.0,1,1.0,1,1.0,1,0.08896190347179793,53
5073,2,16959,3773,13186,0,0,0,1.0,1,1.0,1,1.0,1,0.08896190347179793,53
5074,2,16961,3773,13188,0,0,0,1.0,1,1.0,1,1.0,1,0.0896088403945701,52
5075,2,16963,3773,13190,0,0,0,1.0,1,1.0,1,1.0,1,0.10249583745700286,52
5076,1,16964,3773,13191,0,0,0,1.0,1,1.0,1,1.0,1,0.09768647874015449,55
5077,4,16968,3774,13194,0,0,0,1.0,1,1.0,1,1.0,1,0.13539286182643487,55
5078,0,16968,3774,13194,0,0,0,1.0,1,1.0,1,1.0,1,0.13539286182643487,55
5079,0,16968,3774,13194,0,0,0,1.0,1,1.0,1,1.0,1,0.15187283311606134,54
5080,1,16969,3775,13194,0,0,0,1.0,1,1.0,1,1.0,1,0.16897839949315327,55
5081,2,16971,3775,13196,0,0,0,1.0,1,1.0,1,1.0,1,0.188500237393839,57
5082,6,16977,3775,13202,0,0,0,1.0,1,1.0,1,1.0,1,0.15815688473403935,57
5083,6,16983,3775,13208,0,0,0,1.0,1,1.0,1,1.0,1,0.12898325302509206,58
5084,1,16984,3776,13208,0,0,0,1.0,1,1.0,1,1.0,1,0.12323360389269256,58
5085,4,16988,3777,13211,0,0,0,1.0,1,1.0,1,1.0,1,0.1316954414835788,59
5086,5,16993,3779,13214,0,0,0,1.0,1,1.0,1,1.0,1,0.08618955643376021,60
5087,6,16999,3781,13218,0,0,0,1.0,1,1.0,1,1.0,1,0.11117893566864,61
5088,5,17004,3782,13222,0,0,0,1.0,1,1.0,1,1.0,1,0.12596105402758012,62
5089,9,17013,3787,13226,0,0,0,1.0,1,1.0,1,1.0,1,0.13944697368862133,63
5090,6,17019,3788,13231,0,0,0,1.0,1,1.0,1,1.0,1,0.14531929858381973,63
5091,8,17027,3789,13238,0,0,0,1.0,1,1.0,1,1.0,1,0.1635184452112653,63
5092,4,17031,3789,13242,0,0,0,1.0,1,1.0,1,1.0,1,0.1520455863751836,63
5093,5,17036,3791,13245,0,0,0,1.0,1,1.0,1,1.0,1,0.1692900429582228,63
5094,4,17040,3792,13248,0,0,0,1.0,1,1.0,1,1.0,1,0.17577017972346956,64
5095,3,17043,3792,13251,0,0,0,1.0,1,1.0,1,1.0,1,0.16732870987499837,64
5096,6,17049,3793,13256,0,0,0,1.0,1,1.0,1,1.0,1,0.19104619640835857,67
5097,8,17057,3793,13264,0,0,0,1.0,1,1.0,1,1.0,1,0.19968134400656123,67
5098,13,17070,3796,13274,0,0,0,1.0,1,1.0,1,1.0,1,0.21283582183012265,68
5099,8,17078,3796,13282,0,0,0,1.0,1,1.0,1,1.0,1,0.19264749106379297,70
5100,6,17084,3796,13288,0,0,0,1.0,1,1.0,1,1.0,1,0.18951902004379695,71
5101,13,17097,3798,13299,0,0,0,1.0,1,1.0,1,1.0,1,0.12130237304767622,71
5102,4,17101,3800,13301,0,0,0,1.0,1,1.0,1,1.0,1,0.11650290493399006,70
5103,1,17102,3800,13302,0,0,0,1.0,1,1.0,1,1.0,1,0.11255434373039913,67
5104,3,17105,3802,13303,0,0,0,1.0,1,1.0,1,1.0,1,0.0863811951827747,67
5105,5,17110,3806,13304,0,0,0,1.0,1,1.0,1,1.0,1,0.10805721812851138,63
5106,6,17116,3810,13306,0,0,0,1.0,1,1.0,1,1.0,1,0.15944664066722397,63
5107,3,17119,3812,13307,0,0,0,1.0,1,1.0,1,1.0,1,0.14574702993728578,60
5108,2,17121,3813,13308,0,0,0,1.0,1,1.0,1,1.0,1,0.19369353422643948,56
5109,6,17127,3817,13310,0,0,0,1.0,1,1.0,1,1.0,1,0.19328952289495677,56
5110,1,17128,3817,13311,0,0,0,1.0,1,1.0,1,1.0,1,0.20786394111950898,52
5111,6,17134,3823,13311,0,0,0,1.0,1,1.0,1,1.0,1,0.23179465018724843,51
5112,1,17135,3824,13311,0,0,0,1.0,1,1.0,1,1.0,1,0.2663923200562479,50
5113,2,17137,3825,13312,0,0,0,1.0,1,1.0,1,1.0,1,0.31349596784506745,48
5114,3,17140,3826,13314,0,0,0,1.0,1,1.0,1,1.0,1,0.29440790973886866,46
5115,2,17142,3826,13316,0,0,0,1.0,1,1.0,1,1.0,1,0.29280977359089483,44
5116,10,17152,3826,13326,0,0,0,1.0,1,1.0,1,1.0,1,0.09017038913690785,44
5117,4,17156,3826,13330,0,0,0,1.0,1,1.0,1,1.0,1,0.07454992611999225,46
5118,3,17159,3826,13333,0,0,0,1.0,1,1.0,1,1.0,1,0.09498706713933878,46
5119,5,17164,3828,13336,0,0,0,1.0,1,1.0,1,1.0,1,0.13666200210321003,46
5120,8,17172,3829,13343,0,0,0,1.0,1,1.0,1,1.0,1,0.13528983404086567,46
5121,5,17177,3831,13346,0,0,0,1.0,1,1.0,1,1.0,1,0.18919197796339707,46
5122,10,17187,3834,13353,0,0,0,1.0,1,1.0,1,1.0,1,0.21949903223488954,46
5123,6,17193,3834,13359,0,0,0,1.0,1,1.0,1,1.0,1,0.23798432443443646,45
5124,6,17199,3834,13365,0,0,0,1.0,1,1.0,1,1.0,1,0.18356552566979367,47
5125,11,17210,3835,13375,0,0,0,1.0,1,1.0,1,1.0,1,0.14381663486960183,50
5126,11,17221,3836,13385,0,0,0,1.0,1,1.0,1,1.0,1,0.20903884387658547,50
5127,11,17232,3837,13395,0,0,0,1.0,1,1.0,1,1.0,1,0.24785880054689644,52
5128,18,17250,3837,13413,0,0,0,1.0,1,1.0,1,1.0,1,0.2223587372963201,53
5129,15,17265,3838,13427,0,0,0,1.0,1,1.0,1,1.0,1,0.19956084995092596,55
5130,13,17278,3839,13439,0,0,0,1.0,1,1.0,1,1.0,1,0.20423909548440355,55
5131,3,17281,3839,13442,0,0,0,1.0,1,1.0,1,1.0,1,0.15041484062250635,54
5132,0,17281,3839,13442,0,0,0,1.0,1,1.0,1,1.0,1,0.16938223628495488,54
5133,3,17284,3840,13444,0,0,0,1.0,1,1.0,1,1.0,1,0.14840715291616646,54
5134,1,17285,3840,13445,0,0,0,1.0,1,1.0,1,1.0,1,0.14219970761701578,53
5135,1,17286,3840,13446,0,0,0,1.0,1,1.0,1,1.0,1,0.13375225809424887,54
5136,3,17289,3840,13449,0,0,0,1.0,1,1.0,1,1.0,1,0.11585872506543902,54
5137,0,17289,3840,13449,0,0,0,1.0,1,1.0,1,1.0,1,0.11585872506543902,54
5138,1,17290,3841,13449,0,0,0,1.0,1,1.0,1,1.0,1,0.15407403841979742,54
5139,0,17290,3841,13449,0,0,0,1.0,1,1.0,1,1.0,1,0.16853735298312525,55
5140,0,17290,3841,13449,0,0,0,1.0,1,1.0,1,1.0,1,0.16853735298312525,55
5141,1,17291,3841,13450,0,0,0,1.0,1,1.0,1,1.0,1,0.13932386809648467,53
5142,7,17298,3845,13453,0,0,0,1.0,1,1.0,1,1.0,1,0.10974088843892801,54
5143,4,17302,3846,13456,0,0,0,1.0,1,1.0,1,1.0,1,0.09043390065657686,52
5144,2,17304,3847,13457,0,0,0,1.0,1,1.0,1,1.0,1,0.13831942934548358,50
5145,0,17304,3847,13457,0,0,0,1.0,1,1.0,1,1.0,1,0.11601365219412765,49
5146,4,17308,3848,13460,0,0,0,1.0,1,1.0,1,1.0,1,0.10981932023121964,49
5147,2,17310,3849,13461,0,0,0,1.0,1,1.0,1,1.0,1,0.07847689717201535,46
5148,1,17311,3850,13461,0,0,0,1.0,1,1.0,1,1.0,1,0.09410156060702048,46
5149,1,17312,3851,13461,0,0,0,1.0,1,1.0,1,1.0,1,0.11862318720892724,45
5150,3,17315,3852,13463,0,0,0,1.0,1,1.0,1,1.0,1,0.10418192537394765,47
5151,0,17315,3852,13463,0,0,0,1.0,1,1.0,1,1.0,1,0.1045610033847515,46
5152,1,17316,3853,13463,0,0,0,1.0,1,1.0,1,1.0,1,0.11016668249387356,46
5153,1,17317,3854,13463,0,0,0,1.0,1,1.0,1,1.0,1,0.11136811252708102,45
5154,3,17320,3857,13463,0,0,0,1.0,1,1.0,1,1.0,1,0.18505532795221985,47
5155,4,17324,3858,13466,0,0,0,1.0,1,1.0,1,1.0,1,0.19541742364298406,47
5156,6,17330,3859,13471,0,0,0,1.0,1,1.0,1,1.0,1,0.20971547792815617,47
5157,2,17332,3860,13472,0,0,0,1.0,1,1.0,1,1.0,1,0.21857134737761047,46
5158,3,17335,3860,13475,0,0,0,1.0,1,1.0,1,1.0,1,0.19346709676348917,47
5159,2,17337,3860,13477,0,0,0,1.0,1,1.0,1,1.0,1,0.184578919967292,49
5160,3,17340,3860,13480,0,0,0,1.0,1,1.0,1,1.0,1,0.18667436932744433,48
5161,4,17344,3860,13484,0,0,0,1.0,1,1.0,1,1.0,1,0.10526534634609229,48
5162,0,17344,3860,13484,0,0,0,1.0,1,1.0,1,1.0,1,0.10290555358402197,49
5163,4,17348,3860,13488,0,0,0,1.0,1,1.0,1,1.0,1,0.11588131209726421,51
5164,1,17349,3860,13489,0,0,0,1.0,1,1.0,1,1.0,1,0.09152751379649347,51
5165,3,17352,3862,13490,0,0,0,1.0,1,1.0,1,1.0,1,0.12872793831455628,52
5166,3,17355,3864,13491,0,0,0,1.0,1,1.0,1,1.0,1,0.15122727880462497,52
5167,4,17359,3865,13494,0,0,0,1.0,1,1.0,1,1.0,1,0.13135767304282375,52
5168,1,17360,3865,13495,0,0,0,1.0,1,1.0,1,1.0,1,0.10486299807949681,52
5169,2,17362,3866,13496,0,0,0,1.0,1,1.0,1,1.0,1,0.1275669133502944,53
5170,2,17364,3866,13498,0,0,0,1.0,1,1.0,1,1.0,1,0.10659913127928358,53
5171,1,17365,3866,13499,0,0,0,1.0,1,1.0,1,1.0,1,0.10554210140967962,52
5172,5,17370,3867,13503,0,0,0,1.0,1,1.0,1,1.0,1,0.1024165104388589,53
5173,5,17375,3867,13508,0,0,0,1.0,1,1.0,1,1.0,1,0.10641770328352432,54
5174,4,17379,3867,13512,0,0,0,1.0,1,1.0,1,1.0,1,0.11903324380942018,56
5175,6,17385,3868,13517,0,0,0,1.0,1,1.0,1,1.0,1,0.122259814633275,58
5176,5,17390,3870,13520,0,0,0,1.0,1,1.0,1,1.0,1,0.10650253861816933,58
5177,1,17391,3870,13521,0,0,0,1.0,1,1.0,1,1.0,1,0.10625677041561914,59
5178,3,17394,3872,13522,0,0,0,1.0,1,1.0,1,1.0,1,0.0901027742475735,57
5179,1,17395,3872,13523,0,0,0,1.0,1,1.0,1,1.0,1,0.0929325179533355,58
5180,0,17395,3872,13523,0,0,0,1.0,1,1.0,1,1.0,1,0.09499000209501708,56
5181,0,17395,3872,13523,0,0,0,1.0,1,1.0,1,1.0,1,0.07577689905372884,57
5182,1,17396,3873,13523,0,0,0,1.0,1,1.0,1,1.0,1,0.08629915693487798,56
5183,1,17397,3874,13523,0,0,0,1.0,1,1.0,1,1.0,1,0.09794006261566476,57
5184,3,17400,3876,13524,0,0,0,1.0,1,1.0,1,1.0,1,0.13242963845430805,56
5185,3,17403,3878,13525,0,0,0,1.0,1,1.0,1,1.0,1,0.13491175205902697,56
5186,4,17407,3881,13526,0,0,0,1.0,1,1.0,1,1.0,1,0.19217398072143532,54
5187,4,17411,3881,13530,0,0,0,1.0,1,1.0,1,1.0,1,0.1663215707571107,51
5188,2,17413,3883,13530,0,0,0,1.0,1,1.0,1,1.0,1,0.23520529131522494,50
5189,5,17418,3883,13535,0,0,0,1.0,1,1.0,1,1.0,1,0.1752735121982811,49
5190,1,17419,3884,13535,0,0,0,1.0,1,1.0,1,1.0,1,0.1872074600330429,50
5191,7,17426,3884,13542,0,0,0,1.0,1,1.0,1,1.0,1,0.07702365046113537,50
5192,1,17427,3885,13542,0,0,0,1.0,1,1.0,1,1.0,1,0.09381422237581018,49
5193,3,17430,3885,13545,0,0,0,1.0,1,1.0,1,1.0,1,0.08179403593117644,50
5194,3,17433,3887,13546,0,0,0,1.0,1,1.0,1,1.0,1,0.1556469607783124,51
5195,2,17435,3887,13548,0,0,0,1.0,1,1.0,1,1.0,1,0.1556469607783124,51
5196,2,17437,3887,13550,0,0,0,1.0,1,1.0,1,1.0,1,0.1556469607783124,51
5197,1,17438,3887,13551,0,0,0,1.0,1,1.0,1,1.0,1,0.15346382595836505,51
5198,1,17439,3887,13552,0,0,0,1.0,1,1.0,1,1.0,1,0.1556469607783124,51
5199,3,17442,3887,13555,0,0,0,1.0,1,1.0,1,1.0,1,0.14626595535204762,54
5200,2,17444,3888,13556,0,0,0,1.0,1,1.0,1,1.0,1,0.13787478879518558,54
5201,5,17449,3890,13559,0,0,0,1.0,1,1.0,1,1.0,1,0.1266729175645569,55
5202,6,17455,3890,13565,0,0,0,1.0,1,1.0,1,1.0,1,0.10968093413001576,56
5203,2,17457,3890,13567,0,0,0,1.0,1,1.0,1,1.0,1,0.10209011329879546,56
5204,4,17461,3890,13571,0,0,0,1.0,1,1.0,1,1.0,1,0.11048885775444171,58
5205,6,17467,3890,13577,0,0,0,1.0,1,1.0,1,1.0,1,0.12721024600803132,58
5206,4,17471,3890,13581,0,0,0,1.0,1,1.0,1,1.0,1,0.0829448839287932,58
5207,1,17472,3890,13582,0,0,0,1.0,1,1.0,1,1.0,1,0.08060825555225583,59
5208,0,17472,3890,13582,0,0,0,1.0,1,1.0,1,1.0,1,0.08254659684122946,58
5209,0,17472,3890,13582,0,0,0,1.0,1,1.0,1,1.0,1,0.08254659684122946,58
5210,0,17472,3890,13582,0,0,0,1.0,1,1.0,1,1.0,1,0.09887484569232716,57
5211,1,17473,3891,13582,0,0,0,1.0,1,1.0,1,1.0,1,0.12051465963099005,57
5212,1,17474,3891,13583,0,0,0,1.0,1,1.0,1,1.0,1,0.11187200142816556,59
5213,3,17477,3893,13584,0,0,0,1.0,1,1.0,1,1.0,1,0.14948895182883007,59
5214,8,17485,3895,13590,0,0,0,1.0,1,1.0,1,1.0,1,0.1806603588607923,59
5215,3,17488,3896,13592,0,0,0,1.0,1,1.0,1,1.0,1,0.19269800384724234,58
5216,2,17490,3896,13594,0,0,0,1.0,1,1.0,1,1.0,1,0.17603686910488445,59
5217,5,17495,3900,13595,0,0,0,1.0,1,1.0,1,1.0,1,0.18693863886409992,58
5218,5,17500,3904,13596,0,0,0,1.0,1,1.0,1,1.0,1,0.2120915180586799,58
5219,3,17503,3904,13599,0,0,0,1.0,1,1.0,1,1.0,1,0.1822287233884686,57
5220,3,17506,3904,13602,0,0,0,1.0,1,1.0,1,1.0,1,0.17227144015055687,56
5221,7,17513,3906,13607,0,0,0,1.0,1,1.0,1,1.0,1,0.15449872660361705,58
5222,4,17517,3908,13609,0,0,0,1.0,1,1.0,1,1.0,1,0.1530249853748522,56
5223,3,17520,3910,13610,0,0,0,1.0,1,1.0,1,1.0,1,0.18891604015317168,55
5224,0,17520,3910,13610,0,0,0,1.0,1,1.0,1,1.0,1,0.19832131086787766,56
5225,3,17523,3911,13612,0,0,0,1.0,1,1.0,1,1.0,1,0.2142617408350766,55
5226,1,17524,3912,13612,0,0,0,1.0,1,1.0,1,1.0,1,0.21049537333898058,55
5227,1,17525,3912,13613,0,0,0,1.0,1,1.0,1,1.0,1,0.18618558947239644,53
5228,0,17525,3912,13613,0,0,0,1.0,1,1.0,1,1.0,1,0.17656742519592936,51
5229,3,17528,3913,13615,0,0,0,1.0,1,1.0,1,1.0,1,0.143747698940017,51
5230,0,17528,3913,13615,0,0,0,1.0,1,1.0,1,1.0,1,0.14358054506944218,51
5231,3,17531,3915,13616,0,0,0,1.0,1,1.0,1,1.0,1,0.21284813831269667,52
5232,3,17534,3916,13618,0,0,0,1.0,1,1.0,1,1.0,1,0.25108893180602443,52
5233,2,17536,3916,13620,0,0,0,1.0,1,1.0,1,1.0,1,0.23005429941594774,53
5234,1,17537,3917,13620,0,0,0,1.0,1,1.0,1,1.0,1,0.22444918213143789,53
5235,2,17539,3918,13621,0,0,0,1.0,1,1.0,1,1.0,1,0.22075389896549305,53
5236,10,17549,3920,13629,0,0,0,1.0,1,1.0,1,1.0,1,0.11876398364304934,52
5237,1,17550,3920,13630,0,0,0,1.0,1,1.0,1,1.0,1,0.16322677862846838,52
5238,4,17554,3921,13633,0,0,0,1.0,1,1.0,1,1.0,1,0.1565960377814296,52
5239,1,17555,3921,13634,0,0,0,1.0,1,1.0,1,1.0,1,0.16762928539245908,51
5240,5,17560,3922,13638,0,0,0,1.0,1,1.0,1,1.0,1,0.17848248848153048,53
5241,3,17563,3922,13641,0,0,0,1.0,1,1.0,1,1.0,1,0.17458634842374227,53
5242,2,17565,3922,13643,0,0,0,1.0,1,1.0,1,1.0,1,0.16550225294670778,51
5243,3,17568,3923,13645,0,0,0,1.0,1,1.0,1,1.0,1,0.1770581312693165,51
5244,2,17570,3923,13647,0,0,0,1.0,1,1.0,1,1.0,1,0.17178460900337064,52
5245,5,17575,3924,13651,0,0,0,1.0,1,1.0,1,1.0,1,0.16073486038410026,53
5246,4,17579,3926,13653,0,0,0,1.0,1,1.0,1,1.0,1,0.1599035418268396,53
5247,5,17584,3928,13656,0,0,0,1.0,1,1.0,1,1.0,1,0.24149204619756587,54
5248,8,17592,3930,13662,0,0,0,1.0,1,1.0,1,1.0,1,0.19493023755863184,54
5249,5,17597,3931,13666,0,0,0,1.0,1,1.0,1,1.0,1,0.23644540870139455,55
5250,13,17610,3931,13679,0,0,0,1.0,1,1.0,1,1.0,1,0.2308988950326146,57
5251,8,17618,3931,13687,0,0,0,1.0,1,1.0,1,1.0,1,0.10173392953468491,58
5252,1,17619,3931,13688,0,0,0,1.0,1,1.0,1,1.0,1,0.10799116905392948,58
5253,3,17622,3933,13689,0,0,0,1.0,1,1.0,1,1.0,1,0.14897286555541478,58
5254,3,17625,3934,13691,0,0,0,1.0,1,1.0,1,1.0,1,0.16749489941311846,59
5255,2,17627,3935,13692,0,0,0,1.0,1,1.0,1,1.0,1,0.16422784669534476,58
5256,2,17629,3935,13694,0,0,0,1.0,1,1.0,1,1.0,1,0.1929229523608029,58
5257,4,17633,3936,13697,0,0,0,1.0,1,1.0,1,1.0,1,0.21468006429207584,57
5258,3,17636,3938,13698,0,0,0,1.0,1,1.0,1,1.0,1,0.2027221554379501,55
5259,4,17640,3939,13701,0,0,0,1.0,1,1.0,1,1.0,1,0.21447223688151812,56
5260,5,17645,3939,13706,0,0,0,1.0,1,1.0,1,1.0,1,0.1996693320329299,55
5261,1,17646,3939,13707,0,0,0,1.0,1,1.0,1,1.0,1,0.20387950395331672,54
5262,1,17647,3939,13708,0,0,0,1.0,1,1.0,1,1.0,1,0.19372824974236968,54
5263,7,17654,3943,13711,0,0,0,1.0,1,1.0,1,1.0,1,0.20319687873758296,55
5264,5,17659,3944,13715,0,0,0,1.0,1,1.0,1,1.0,1,0.24691659555965645,53
5265,7,17666,3948,13718,0,0,0,1.0,1,1.0,1,1.0,1,0.26071231527871885,52
5266,8,17674,3948,13726,0,0,0,1.0,1,1.0,1,1.0,1,0.21673201034710354,49
5267,4,17678,3949,13729,0,0,0,1.0,1,1.0,1,1.0,1,0.20020283533902963,49
5268,2,17680,3950,13730,0,0,0,1.0,1,1.0,1,1.0,1,0.1962502867088423,46
5269,1,17681,3950,13731,0,0,0,1.0,1,1.0,1,1.0,1,0.1984395630339299,45
5270,2,17683,3950,13733,0,0,0,1.0,1,1.0,1,1.0,1,0.1877074853351013,46
5271,7,17690,3954,13736,0,0,0,1.0,1,1.0,1,1.0,1,0.2369516015639371,46
5272,6,17696,3955,13741,0,0,0,1.0,1,1.0,1,1.0,1,0.2481163739103785,45
5273,6,17702,3957,13745,0,0,0,1.0,1,1.0,1,1.0,1,0.24995906820179084,45
5274,5,17707,3958,13749,0,0,0,1.0,1,1.0,1,1.0,1,0.2262297482125629,45
5275,5,17712,3961,13751,0,0,0,1.0,1,1.0,1,1.0,1,0.2193886995002399,46
5276,3,17715,3962,13753,0,0,0,1.0,1,1.0,1,1.0,1,0.2566343865346392,45
5277,2,17717,3963,13754,0,0,0,1.0,1,1.0,1,1.0,1,0.2408970055794202,45
5278,2,17719,3964,13755,0,0,0,1.0,1,1.0,1,1.0,1,0.2770017416080076,44
5279,4,17723,3965,13758,0,0,0,1.0,1,1.0,1,1.0,1,0.3106525259155761,45
5280,2,17725,3966,13759,0,0,0,1.0,1,1.0,1,1.0,1,0.2950079010167001,46
5281,10,17735,3966,13769,0,0,0,1.0,1,1.0,1,1.0,1,0.1777134245159388,46
5282,2,17737,3967,13770,0,0,0,1.0,1,1.0,1,1.0,1,0.1914484108164862,47
5283,3,17740,3967,13773,0,0,0,1.0,1,1.0,1,1.0,1,0.18856087830537097,48
5284,3,17743,3967,13776,0,0,0,1.0,1,1.0,1,1.0,1,0.17479044420297576,48
5285,3,17746,3967,13779,0,0,0,1.0,1,1.0,1,1.0,1,0.15255016755527512,48
5286,3,17749,3967,13782,0,0,0,1.0,1,1.0,1,1.0,1,0.15499601143215136,50
5287,2,17751,3967,13784,0,0,0,1.0,1,1.0,1,1.0,1,0.1392990928156696,50
5288,2,17753,3967,13786,0,0,0,1.0,1,1.0,1,1.0,1,0.13283830944146774,51
5289,4,17757,3967,13790,0,0,0,1.0,1,1.0,1,1.0,1,0.10959870539801568,51
5290,3,17760,3967,13793,0,0,0,1.0,1,1.0,1,1.0,1,0.11855805467593726,52
5291,1,17761,3968,13793,0,0,0,1.0,1,1.0,1,1.0,1,0.10925091686971537,52
5292,2,17763,3968,13795,0,0,0,1.0,1,1.0,1,1.0,1,0.1235016513064545,53
5293,2,17765,3969,13796,0,0,0,1.0,1,1.0,1,1.0,1,0.14461882064733297,51
5294,3,17768,3970,13798,0,0,0,1.0,1,1.0,1,1.0,1,0.14421399217933714,50
5295,2,17770,3971,13799,0,0,0,1.0,1,1.0,1,1.0,1,0.20552647455231587,49
5296,7,17777,3973,13804,0,0,0,1.0,1,1.0,1,1.0,1,0.176611670008823,48
5297,2,17779,3973,13806,0,0,0,1.0,1,1.0,1,1.0,1,0.19807930337265522,46
5298,0,17779,3973,13806,0,0,0,1.0,1,1.0,1,1.0,1,0.1991435726754954,46
5299,0,17779,3973,13806,0,0,0,1.0,1,1.0,1,1.0,1,0.2066227180655746,47
5300,0,17779,3973,13806,0,0,0,1.0,1,1.0,1,1.0,1,0.18126810952688835,48
5301,0,17779,3973,13806,0,0,0,1.0,1,1.0,1,1.0,1,0.18126810952688835,48
5302,1,17780,3974,13806,0,0,0,1.0,1,1.0,1,1.0,1,0.19283857785809577,49
5303,1,17781,3975,13806,0,0,0,1.0,1,1.0,1,1.0,1,0.19449911327739927,48
5304,1,17782,3975,13807,0,0,0,1.0,1,1.0,1,1.0,1,0.16120915380652576,48
5305,0,17782,3975,13807,0,0,0,1.0,1,1.0,1,1.0,1,0.1665145099323283,47
5306,2,17784,3977,13807,0,0,0,1.0,1,1.0,1,1.0,1,0.17617934942409919,48
5307,2,17786,3978,13808,0,0,0,1.0,1,1.0,1,1.0,1,0.18206084307832152,48
5308,1,17787,3978,13809,0,0,0,1.0,1,1.0,1,1.0,1,0.18106264448440954,47
5309,2,17789,3979,13810,0,0,0,1.0,1,1.0,1,1.0,1,0.1934209910918646,46
5310,3,17792,3980,13812,0,0,0,1.0,1,1.0,1,1.0,1,0.18917850925583143,46
5311,3,17795,3981,13814,0,0,0,1.0,1,1.0,1,1.0,1,0.17593537211779875,46
5312,2,17797,3982,13815,0,0,0,1.0,1,1.0,1,1.0,1,0.19733244504926928,46
5313,3,17800,3982,13818,0,0,0,1.0,1,1.0,1,1.0,1,0.154585879608035,46
5314,1,17801,3982,13819,0,0,0,1.0,1,1.0,1,1.0,1,0.15484497818513637,46
5315,3,17804,3984,13820,0,0,0,1.0,1,1.0,1,1.0,1,0.22546528135230728,47
5316,8,17812,3984,13828,0,0,0,1.0,1,1.0,1,1.0,1,0.14401424869797774,48
5317,4,17816,3986,13830,0,0,0,1.0,1,1.0,1,1.0,1,0.19064970785579477,49
5318,3,17819,3986,13833,0,0,0,1.0,1,1.0,1,1.0,1,0.15740009754378276,49
5319,2,17821,3987,13834,0,0,0,1.0,1,1.0,1,1.0,1,0.17802088043090925,50
5320,8,17829,3988,13841,0,0,0,1.0,1,1.0,1,1.0,1,0.2376079414001011,51
5321,8,17837,3988,13849,0,0,0,1.0,1,1.0,1,1.0,1,0.21694007774313903,52
5322,6,17843,3988,13855,0,0,0,1.0,1,1.0,1,1.0,1,0.21815828312336707,53
5323,9,17852,3988,13864,0,0,0,1.0,1,1.0,1,1.0,1,0.21423894841983884,53
5324,11,17863,3988,13875,0,0,0,1.0,1,1.0,1,1.0,1,0.2208661626533928,55
5325,7,17870,3989,13881,0,0,0,1.0,1,1.0,1,1.0,1,0.23203175411795923,55
5326,13,17883,3989,13894,0,0,0,1.0,1,1.0,1,1.0,1,0.14347186710905097,55
5327,6,17889,3990,13899,0,0,0,1.0,1,1.0,1,1.0,1,0.12742127014750762,56
5328,5,17894,3991,13903,0,0,0,1.0,1,1.0,1,1.0,1,0.10841499445868459,57
5329,7,17901,3991,13910,0,0,0,1.0,1,1.0,1,1.0,1,0.08267350527947674,57
5330,5,17906,3992,13914,0,0,0,1.0,1,1.0,1,1.0,1,0.14268049702310842,56
5331,7,17913,3993,13920,0,0,0,1.0,1,1.0,1,1.0,1,0.16385660987014541,57
5332,6,17919,3993,13926,0,0,0,1.0,1,1.0,1,1.0,1,0.11928608541726336,58
5333,7,17926,3993,13933,0,0,0,1.0,1,1.0,1,1.0,1,0.13464666551624138,59
5334,6,17932,3994,13938,0,0,0,1.0,1,1.0,1,1.0,1,0.10101463054571719,59
5335,7,17939,3994,13945,0,0,0,1.0,1,1.0,1,1.0,1,0.1745362118098727,58
5336,5,17944,3994,13950,0,0,0,1.0,1,1.0,1,1.0,1,0.15885768672787415,59
5337,6,17950,3994,13956,0,0,0,1.0,1,1.0,1,1.0,1,0.14915713016299967,60
5338,5,17955,3994,13961,0,0,0,1.0,1,1.0,1,1.0,1,0.17030765320529986,60
5339,5,17960,3994,13966,0,0,0,1.0,1,1.0,1,1.0,1,0.1356852646253369,60
5340,10,17970,3996,13974,0,0,0,1.0,1,1.0,1,1.0,1,0.13953964658605067,60
5341,8,17978,3997,13981,0,0,0,1.0,1,1.0,1,1.0,1,0.08367911349378963,61
5342,3,17981,3999,13982,0,0,0,1.0,1,1.0,1,1.0,1,0.07783671670879565,59
5343,1,17982,4000,13982,0,0,0,1.0,1,1.0,1,1.0,1,0.08400039208925568,58
5344,3,17985,4002,13983,0,0,0,1.0,1,1.0,1,1.0,1,0.15051397911997014,58
5345,2,17987,4002,13985,0,0,0,1.0,1,1.0,1,1.0,1,0.09099493167767808,54
5346,1,17988,4003,13985,0,0,0,1.0,1,1.0,1,1.0,1,0.11751638247717129,54
5347,4,17992,4006,13986,0,0,0,1.0,1,1.0,1,1.0,1,0.11707752693733361,54
5348,1,17993,4007,13986,0,0,0,1.0,1,1.0,1,1.0,1,0.1539230077908919,55
5349,4,17997,4008,13989,0,0,0,1.0,1,1.0,1,1.0,1,0.12270702142908084,56
5350,1,17998,4009,13989,0,0,0,1.0,1,1.0,1,1.0,1,0.1271868838476252,56
5351,0,17998,4009,13989,0,0,0,1.0,1,1.0,1,1.0,1,0.12154969247261323,57
5352,4,18002,4011,13991,0,0,0,1.0,1,1.0,1,1.0,1,0.14288339938062697,57
5353,1,18003,4011,13992,0,0,0,1.0,1,1.0,1,1.0,1,0.143105136615851,57
5354,2,18005,4011,13994,0,0,0,1.0,1,1.0,1,1.0,1,0.1493370862895388,56
5355,4,18009,4012,13997,0,0,0,1.0,1,1.0,1,1.0,1,0.13002724113274214,57
5356,2,18011,4012,13999,0,0,0,1.0,1,1.0,1,1.0,1,0.09701818022213844,56
5357,1,18012,4012,14000,0,0,0,1.0,1,1.0,1,1.0,1,0.11067662203435233,56
5358,0,18012,4012,14000,0,0,0,1.0,1,1.0,1,1.0,1,0.10193336451026387,57
5359,1,18013,4012,14001,0,0,0,1.0,1,1.0,1,1.0,1,0.09604458354778021,57
5360,0,18013,4012,14001,0,0,0,1.0,1,1.0,1,1.0,1,0.11508287135000937,55
5361,4,18017,4014,14003,0,0,0,1.0,1,1.0,1,1.0,1,0.14014461348678137,56
5362,0,18017,4014,14003,0,0,0,1.0,1,1.0,1,1.0,1,0.12500389999060524,57
5363,1,18018,4015,14003,0,0,0,1.0,1,1.0,1,1.0,1,0.14314957458031086,57
5364,1,18019,4015,14004,0,0,0,1.0,1,1.0,1,1.0,1,0.14174189792532926,58
5365,3,18022,4016,14006,0,0,0,1.0,1,1.0,1,1.0,1,0.12173687089300758,59
5366,5,18027,4018,14009,0,0,0,1.0,1,1.0,1,1.0,1,0.1563646199921962,60
5367,0,18027,4018,14009,0,0,0,1.0,1,1.0,1,1.0,1,0.15618434011877946,60
5368,1,18028,4019,14009,0,0,0,1.0,1,1.0,1,1.0,1,0.12303296917063898,58
5369,9,18037,4020,14017,0,0,0,1.0,1,1.0,1,1.0,1,0.13195809535370437,58
5370,6,18043,4023,14020,0,0,0,1.0,1,1.0,1,1.0,1,0.15810545324707748,57
5371,9,18052,4027,14025,0,0,0,1.0,1,1.0,1,1.0,1,0.17760574155255637,56
5372,6,18058,4030,14028,0,0,0,1.0,1,1.0,1,1.0,1,0.14648803422764733,55
5373,2,18060,4031,14029,0,0,0,1.0,1,1.0,1,1.0,1,0.13504249773281368,54
5374,3,18063,4034,14029,0,0,0,1.0,1,1.0,1,1.0,1,0.13212291338860732,53
5375,4,18067,4037,14030,0,0,0,1.0,1,1.0,1,1.0,1,0.1648989589384815,52
5376,1,18068,4038,14030,0,0,0,1.0,1,1.0,1,1.0,1,0.14897373682685666,52
5377,2,18070,4040,14030,0,0,0,1.0,1,1.0,1,1.0,1,0.18639833614492404,51
5378,3,18073,4041,14032,0,0,0,1.0,1,1.0,1,1.0,1,0.2111415219256176,52
5379,1,18074,4042,14032,0,0,0,1.0,1,1.0,1,1.0,1,0.21691741496067782,50
5380,3,18077,4043,14034,0,0,0,1.0,1,1.0,1,1.0,1,0.21530689914177234,51
5381,1,18078,4044,14034,0,0,0,1.0,1,1.0,1,1.0,1,0.2045889943060348,50
5382,1,18079,4044,14035,0,0,0,1.0,1,1.0,1,1.0,1,0.20369914392220892,48
5383,1,18080,4044,14036,0,0,0,1.0,1,1.0,1,1.0,1,0.17528471556355588,48
5384,1,18081,4044,14037,0,0,0,1.0,1,1.0,1,1.0,1,0.1556406483463411,48
5385,0,18081,4044,14037,0,0,0,1.0,1,1.0,1,1.0,1,0.15893240359645502,47
5386,4,18085,4045,14040,0,0,0,1.0,1,1.0,1,1.0,1,0.13335835716183062,48
5387,0,18085,4045,14040,0,0,0,1.0,1,1.0,1,1.0,1,0.1354895554102191,48
5388,0,18085,4045,14040,0,0,0,1.0,1,1.0,1,1.0,1,0.1354895554102191,48
5389,3,18088,4045,14043,0,0,0,1.0,1,1.0,1,1.0,1,0.14399555602475883,50
5390,4,18092,4047,14045,0,0,0,1.0,1,1.0,1,1.0,1,0.11593522096275946,52
5391,5,18097,4049,14048,0,0,0,1.0,1,1.0,1,1.0,1,0.1454567857816128,52
5392,2,18099,4050,14049,0,0,0,1.0,1,1.0,1,1.0,1,0.16016115341316642,51
5393,5,18104,4052,14052,0,0,0,1.0,1,1.0,1,1.0,1,0.21278080197862997,50
5394,2,18106,4053,14053,0,0,0,1.0,1,1.0,1,1.0,1,0.20570814476070043,50
5395,1,18107,4053,14054,0,0,0,1.0,1,1.0,1,1.0,1,0.18807399158519533,49
5396,2,18109,4054,14055,0,0,0,1.0,1,1.0,1,1.0,1,0.2041107082154751,48
5397,3,18112,4056,14056,0,0,0,1.0,1,1.0,1,1.0,1,0.24257603110921336,48
5398,3,18115,4056,14059,0,0,0,1.0,1,1.0,1,1.0,1,0.21753566991530235,46
5399,7,18122,4058,14064,0,0,0,1.0,1,1.0,1,1.0,1,0.22912943806481365,46
5400,6,18128,4060,14068,0,0,0,1.0,1,1.0,1,1.0,1,0.2499138611563262,48
5401,9,18137,4060,14077,0,0,0,1.0,1,1.0,1,1.0,1,0.12926407625728925,49
5402,0,18137,4060,14077,0,0,0,1.0,1,1.0,1,1.0,1,0.0,0
