,SuccessfulHandoverCount,TotalSuccessfulHandoverCount,TotalSuccessfulHandoverCountRange,TotalSuccessfulHandoverCountLoadBalancing,TotalSuccessfulHandoverCountOverload,FailedHandoverCount,TotalFailedHandoverCount,AvgQoS,MinQoS,AvgQoS_LoadBased,MinQoS_LoadBased,AvgQoS_RangeBased,MinQoS_RangeBased,GiniLoad,VehicleCount
0,0,0,0,0,0,0,0,1.0,1,1.0,1,1.0,1,0.0,0
1,16,16,0,16,0,0,0,1.0,1,1.0,1,1.0,1,0.2981687554246577,30
2,17,33,0,33,0,0,0,1.0,1,1.0,1,1.0,1,0.2838240682696022,32
3,2,35,0,35,0,0,0,1.0,1,1.0,1,1.0,1,0.20622106096556908,33
4,0,35,0,35,0,0,0,1.0,1,1.0,1,1.0,1,0.21632272748939135,34
5,0,35,0,35,0,0,0,1.0,1,1.0,1,1.0,1,0.1910460324243437,36
6,2,37,0,37,0,0,0,1.0,1,1.0,1,1.0,1,0.15780148835167407,38
7,0,37,0,37,0,0,0,1.0,1,1.0,1,1.0,1,0.17863413579626614,40
8,0,37,0,37,0,0,0,1.0,1,1.0,1,1.0,1,0.17863413579626614,40
9,0,37,0,37,0,0,0,1.0,1,1.0,1,1.0,1,0.17863413579626614,40
10,1,38,1,37,0,0,0,1.0,1,1.0,1,1.0,1,0.22122670680948467,41
11,1,39,2,37,0,0,0,1.0,1,1.0,1,1.0,1,0.19734874710190717,40
12,1,40,3,37,0,0,0,1.0,1,1.0,1,1.0,1,0.20688179498076847,39
13,3,43,5,38,0,0,0,1.0,1,1.0,1,1.0,1,0.25166055535478393,37
14,0,43,5,38,0,0,0,1.0,1,1.0,1,1.0,1,0.28382292660319924,35
15,2,45,7,38,0,0,0,1.0,1,1.0,1,1.0,1,0.29741159105084464,36
16,1,46,8,38,0,0,0,1.0,1,1.0,1,1.0,1,0.304165692180348,34
17,0,46,8,38,0,0,0,1.0,1,1.0,1,1.0,1,0.32505903124358076,33
18,3,49,8,41,0,0,0,1.0,1,1.0,1,1.0,1,0.2731820038338991,34
19,3,52,9,43,0,0,0,1.0,1,1.0,1,1.0,1,0.26315348421836227,34
20,0,52,9,43,0,0,0,1.0,1,1.0,1,1.0,1,0.24140063628104172,34
21,3,55,10,45,0,0,0,1.0,1,1.0,1,1.0,1,0.22830553824250752,36
22,0,55,10,45,0,0,0,1.0,1,1.0,1,1.0,1,0.24244377315702054,35
23,3,58,11,47,0,0,0,1.0,1,1.0,1,1.0,1,0.23821072230199283,35
24,2,60,13,47,0,0,0,1.0,1,1.0,1,1.0,1,0.2318647083219328,35
25,6,66,17,49,0,0,0,1.0,1,1.0,1,1.0,1,0.29309476530543416,35
26,5,71,20,51,0,0,0,1.0,1,1.0,1,1.0,1,0.2842806247984965,36
27,2,73,22,51,0,0,0,1.0,1,1.0,1,1.0,1,0.2423625629897557,34
28,0,73,22,51,0,0,0,1.0,1,1.0,1,1.0,1,0.24127421754433154,35
29,1,74,22,52,0,0,0,1.0,1,1.0,1,1.0,1,0.18666994674659937,33
30,1,75,23,52,0,0,0,1.0,1,1.0,1,1.0,1,0.21908153272843364,33
31,1,76,24,52,0,0,0,1.0,1,1.0,1,1.0,1,0.2902830963389197,33
32,1,77,25,52,0,0,0,1.0,1,1.0,1,1.0,1,0.3509673372123489,32
33,2,79,25,54,0,0,0,1.0,1,1.0,1,1.0,1,0.3159865629747083,33
34,3,82,26,56,0,0,0,1.0,1,1.0,1,1.0,1,0.2981116557131303,33
35,1,83,26,57,0,0,0,1.0,1,1.0,1,1.0,1,0.2665677505960939,35
36,0,83,26,57,0,0,0,1.0,1,1.0,1,1.0,1,0.285800596284574,36
37,2,85,27,58,0,0,0,1.0,1,1.0,1,1.0,1,0.24988998044448898,37
38,0,85,27,58,0,0,0,1.0,1,1.0,1,1.0,1,0.2525810783317863,36
39,4,89,27,62,0,0,0,1.0,1,1.0,1,1.0,1,0.20077871751024176,38
40,1,90,27,63,0,0,0,1.0,1,1.0,1,1.0,1,0.21012398856916523,40
41,0,90,27,63,0,0,0,1.0,1,1.0,1,1.0,1,0.21012398856916523,40
42,3,93,30,63,0,0,0,1.0,1,1.0,1,1.0,1,0.2409156501379386,40
43,3,96,31,65,0,0,0,1.0,1,1.0,1,1.0,1,0.24374467368972594,43
44,1,97,31,66,0,0,0,1.0,1,1.0,1,1.0,1,0.22458179054133276,43
45,2,99,32,67,0,0,0,1.0,1,1.0,1,1.0,1,0.21507245114559892,44
46,0,99,32,67,0,0,0,1.0,1,1.0,1,1.0,1,0.21507245114559892,44
47,0,99,32,67,0,0,0,1.0,1,1.0,1,1.0,1,0.21507245114559892,44
48,3,102,35,67,0,0,0,1.0,1,1.0,1,1.0,1,0.2818737812420732,44
49,0,102,35,67,0,0,0,1.0,1,1.0,1,1.0,1,0.23592394750647555,41
50,1,103,36,67,0,0,0,1.0,1,1.0,1,1.0,1,0.2928947205232444,40
51,1,104,36,68,0,0,0,1.0,1,1.0,1,1.0,1,0.23803199046783227,38
52,1,105,37,68,0,0,0,1.0,1,1.0,1,1.0,1,0.2942320492258276,37
53,1,106,37,69,0,0,0,1.0,1,1.0,1,1.0,1,0.279730998378698,38
54,2,108,38,70,0,0,0,1.0,1,1.0,1,1.0,1,0.2811489925549112,38
55,1,109,38,71,0,0,0,1.0,1,1.0,1,1.0,1,0.24937337553746974,38
56,3,112,39,73,0,0,0,1.0,1,1.0,1,1.0,1,0.26141542253377004,38
57,2,114,40,74,0,0,0,1.0,1,1.0,1,1.0,1,0.2532468567203747,38
58,3,117,43,74,0,0,0,1.0,1,1.0,1,1.0,1,0.2722142567484786,38
59,1,118,43,75,0,0,0,1.0,1,1.0,1,1.0,1,0.2654571031521578,40
60,2,120,45,75,0,0,0,1.0,1,1.0,1,1.0,1,0.26544388937076985,40
61,0,120,45,75,0,0,0,1.0,1,1.0,1,1.0,1,0.2629934340467473,40
62,4,124,47,77,0,0,0,1.0,1,1.0,1,1.0,1,0.26392561398857267,42
63,2,126,48,78,0,0,0,1.0,1,1.0,1,1.0,1,0.26016545347247455,40
64,0,126,48,78,0,0,0,1.0,1,1.0,1,1.0,1,0.25562007947199333,41
65,1,127,49,78,0,0,0,1.0,1,1.0,1,1.0,1,0.27984946983937997,41
66,0,127,49,78,0,0,0,1.0,1,1.0,1,1.0,1,0.280086836188743,41
67,1,128,49,79,0,0,0,1.0,1,1.0,1,1.0,1,0.24798042824051592,41
68,1,129,50,79,0,0,0,1.0,1,1.0,1,1.0,1,0.2493537781666782,41
69,2,131,51,80,0,0,0,1.0,1,1.0,1,1.0,1,0.26349975962144284,41
70,0,131,51,80,0,0,0,1.0,1,1.0,1,1.0,1,0.27591983920552393,42
71,2,133,53,80,0,0,0,1.0,1,1.0,1,1.0,1,0.2613142372562698,44
72,0,133,53,80,0,0,0,1.0,1,1.0,1,1.0,1,0.2613142372562698,44
73,3,136,53,83,0,0,0,1.0,1,1.0,1,1.0,1,0.2179104107477938,46
74,1,137,53,84,0,0,0,1.0,1,1.0,1,1.0,1,0.23260541629177328,44
75,3,140,54,86,0,0,0,1.0,1,1.0,1,1.0,1,0.17084696269498287,44
76,3,143,56,87,0,0,0,1.0,1,1.0,1,1.0,1,0.24790763765694734,45
77,1,144,56,88,0,0,0,1.0,1,1.0,1,1.0,1,0.19789972772193332,44
78,2,146,57,89,0,0,0,1.0,1,1.0,1,1.0,1,0.24496763350405446,44
79,0,146,57,89,0,0,0,1.0,1,1.0,1,1.0,1,0.27155789143797865,43
80,2,148,59,89,0,0,0,1.0,1,1.0,1,1.0,1,0.2736221481481361,43
81,3,151,62,89,0,0,0,1.0,1,1.0,1,1.0,1,0.32755286371127296,44
82,2,153,63,90,0,0,0,1.0,1,1.0,1,1.0,1,0.3044482580728238,45
83,3,156,65,91,0,0,0,1.0,1,1.0,1,1.0,1,0.319349556790638,45
84,0,156,65,91,0,0,0,1.0,1,1.0,1,1.0,1,0.319349556790638,45
85,0,156,65,91,0,0,0,1.0,1,1.0,1,1.0,1,0.319349556790638,45
86,1,157,65,92,0,0,0,1.0,1,1.0,1,1.0,1,0.27962370163182376,45
87,0,157,65,92,0,0,0,1.0,1,1.0,1,1.0,1,0.2908475055311404,44
88,0,157,65,92,0,0,0,1.0,1,1.0,1,1.0,1,0.279305748551361,45
89,2,159,66,93,0,0,0,1.0,1,1.0,1,1.0,1,0.2905636886590377,46
90,0,159,66,93,0,0,0,1.0,1,1.0,1,1.0,1,0.32402969653705804,44
91,2,161,67,94,0,0,0,1.0,1,1.0,1,1.0,1,0.28538880916977216,45
92,1,162,67,95,0,0,0,1.0,1,1.0,1,1.0,1,0.28688993298134513,46
93,0,162,67,95,0,0,0,1.0,1,1.0,1,1.0,1,0.28688993298134513,46
94,0,162,67,95,0,0,0,1.0,1,1.0,1,1.0,1,0.28688993298134513,46
95,1,163,67,96,0,0,0,1.0,1,1.0,1,1.0,1,0.29164975961263767,46
96,1,164,68,96,0,0,0,1.0,1,1.0,1,1.0,1,0.30259991737011116,46
97,0,164,68,96,0,0,0,1.0,1,1.0,1,1.0,1,0.29721045191254525,47
98,1,165,68,97,0,0,0,1.0,1,1.0,1,1.0,1,0.2902782811221693,47
99,0,165,68,97,0,0,0,1.0,1,1.0,1,1.0,1,0.3073721422474099,46
100,2,167,69,98,0,0,0,1.0,1,1.0,1,1.0,1,0.3328577907459979,48
101,2,169,70,99,0,0,0,1.0,1,1.0,1,1.0,1,0.34067769382493013,49
102,2,171,72,99,0,0,0,1.0,1,1.0,1,1.0,1,0.3588185218833326,49
103,4,175,72,103,0,0,0,1.0,1,1.0,1,1.0,1,0.27803483248760424,48
104,4,179,74,105,0,0,0,1.0,1,1.0,1,1.0,1,0.2802058572568711,49
105,5,184,77,107,0,0,0,1.0,1,1.0,1,1.0,1,0.24827323297920673,48
106,1,185,78,107,0,0,0,1.0,1,1.0,1,1.0,1,0.2445510315239307,48
107,1,186,79,107,0,0,0,1.0,1,1.0,1,1.0,1,0.2543480043160841,47
108,3,189,79,110,0,0,0,1.0,1,1.0,1,1.0,1,0.22004749468075951,47
109,6,195,82,113,0,0,0,1.0,1,1.0,1,1.0,1,0.2349438997317075,47
110,3,198,83,115,0,0,0,1.0,1,1.0,1,1.0,1,0.23251078536120567,47
111,3,201,84,117,0,0,0,1.0,1,1.0,1,1.0,1,0.1466978841789992,46
112,1,202,85,117,0,0,0,1.0,1,1.0,1,1.0,1,0.16658035119770812,46
113,2,204,87,117,0,0,0,1.0,1,1.0,1,1.0,1,0.15705840011790076,45
114,2,206,88,118,0,0,0,1.0,1,1.0,1,1.0,1,0.1491481144728045,46
115,1,207,89,118,0,0,0,1.0,1,1.0,1,1.0,1,0.17100070960852964,47
116,0,207,89,118,0,0,0,1.0,1,1.0,1,1.0,1,0.15377527883886977,48
117,4,211,93,118,0,0,0,1.0,1,1.0,1,1.0,1,0.2021526893262527,48
118,1,212,93,119,0,0,0,1.0,1,1.0,1,1.0,1,0.2044882163220608,49
119,3,215,94,121,0,0,0,1.0,1,1.0,1,1.0,1,0.20385819647629122,50
120,0,215,94,121,0,0,0,1.0,1,1.0,1,1.0,1,0.1959159555120685,51
121,0,215,94,121,0,0,0,1.0,1,1.0,1,1.0,1,0.1959159555120685,51
122,1,216,95,121,0,0,0,1.0,1,1.0,1,1.0,1,0.18186524669333703,51
123,1,217,95,122,0,0,0,1.0,1,1.0,1,1.0,1,0.1704666069596944,51
124,0,217,95,122,0,0,0,1.0,1,1.0,1,1.0,1,0.1704666069596944,51
125,1,218,95,123,0,0,0,1.0,1,1.0,1,1.0,1,0.20449048818728124,50
126,3,221,97,124,0,0,0,1.0,1,1.0,1,1.0,1,0.16592252329107116,52
127,3,224,97,127,0,0,0,1.0,1,1.0,1,1.0,1,0.1512196992327473,50
128,0,224,97,127,0,0,0,1.0,1,1.0,1,1.0,1,0.1512196992327473,50
129,1,225,97,128,0,0,0,1.0,1,1.0,1,1.0,1,0.16202816746505755,52
130,1,226,98,128,0,0,0,1.0,1,1.0,1,1.0,1,0.18818589979069342,52
131,3,229,98,131,0,0,0,1.0,1,1.0,1,1.0,1,0.15294097481109742,54
132,1,230,99,131,0,0,0,1.0,1,1.0,1,1.0,1,0.15018752607971395,54
133,2,232,100,132,0,0,0,1.0,1,1.0,1,1.0,1,0.1515849596576259,52
134,0,232,100,132,0,0,0,1.0,1,1.0,1,1.0,1,0.15158504929456398,52
135,5,237,104,133,0,0,0,1.0,1,1.0,1,1.0,1,0.20580554693433567,51
136,4,241,106,135,0,0,0,1.0,1,1.0,1,1.0,1,0.18202410271881037,51
137,2,243,107,136,0,0,0,1.0,1,1.0,1,1.0,1,0.15437866454731602,50
138,1,244,108,136,0,0,0,1.0,1,1.0,1,1.0,1,0.18351140780650313,52
139,4,248,110,138,0,0,0,1.0,1,1.0,1,1.0,1,0.20531274453371356,51
140,3,251,111,140,0,0,0,1.0,1,1.0,1,1.0,1,0.14331955074753594,51
141,1,252,112,140,0,0,0,1.0,1,1.0,1,1.0,1,0.1968448326301554,50
142,2,254,114,140,0,0,0,1.0,1,1.0,1,1.0,1,0.18283593662830347,51
143,0,254,114,140,0,0,0,1.0,1,1.0,1,1.0,1,0.19676882889889197,48
144,2,256,116,140,0,0,0,1.0,1,1.0,1,1.0,1,0.20683922049191125,49
145,5,261,120,141,0,0,0,1.0,1,1.0,1,1.0,1,0.12896426557693047,47
146,2,263,122,141,0,0,0,1.0,1,1.0,1,1.0,1,0.16378865045745686,49
147,2,265,122,143,0,0,0,1.0,1,1.0,1,1.0,1,0.08089560968306934,46
148,0,265,122,143,0,0,0,1.0,1,1.0,1,1.0,1,0.09220519771096287,47
149,1,266,123,143,0,0,0,1.0,1,1.0,1,1.0,1,0.0945745569347657,46
150,0,266,123,143,0,0,0,1.0,1,1.0,1,1.0,1,0.09008366334497915,47
151,1,267,124,143,0,0,0,1.0,1,1.0,1,1.0,1,0.12459282584743829,46
152,0,267,124,143,0,0,0,1.0,1,1.0,1,1.0,1,0.14324913369824002,45
153,0,267,124,143,0,0,0,1.0,1,1.0,1,1.0,1,0.1574901816547461,46
154,0,267,124,143,0,0,0,1.0,1,1.0,1,1.0,1,0.1701037138679737,44
155,3,270,127,143,0,0,0,1.0,1,1.0,1,1.0,1,0.20677044842251127,45
156,3,273,129,144,0,0,0,1.0,1,1.0,1,1.0,1,0.26678313480670385,43
157,2,275,129,146,0,0,0,1.0,1,1.0,1,1.0,1,0.19902851935934748,42
158,2,277,129,148,0,0,0,1.0,1,1.0,1,1.0,1,0.19529092706350007,43
159,3,280,130,150,0,0,0,1.0,1,1.0,1,1.0,1,0.20022081337950745,44
160,4,284,131,153,0,0,0,1.0,1,1.0,1,1.0,1,0.15884059601921993,44
161,2,286,133,153,0,0,0,1.0,1,1.0,1,1.0,1,0.21907392927763142,44
162,0,286,133,153,0,0,0,1.0,1,1.0,1,1.0,1,0.21907392927763142,44
163,9,295,139,156,0,0,0,1.0,1,1.0,1,1.0,1,0.2522614807214045,44
164,5,300,142,158,0,0,0,1.0,1,1.0,1,1.0,1,0.3034441310818411,44
165,4,304,144,160,0,0,0,1.0,1,1.0,1,1.0,1,0.21792489767064893,43
166,3,307,145,162,0,0,0,1.0,1,1.0,1,1.0,1,0.20863662610153708,43
167,0,307,145,162,0,0,0,1.0,1,1.0,1,1.0,1,0.19511985759323447,42
168,0,307,145,162,0,0,0,1.0,1,1.0,1,1.0,1,0.1793412556113573,40
169,0,307,145,162,0,0,0,1.0,1,1.0,1,1.0,1,0.15768589774366049,41
170,0,307,145,162,0,0,0,1.0,1,1.0,1,1.0,1,0.17460316705183274,39
171,2,309,146,163,0,0,0,1.0,1,1.0,1,1.0,1,0.1892573015954367,39
172,0,309,146,163,0,0,0,1.0,1,1.0,1,1.0,1,0.2001640627736683,38
173,2,311,148,163,0,0,0,1.0,1,1.0,1,1.0,1,0.24102205394055776,38
174,1,312,148,164,0,0,0,1.0,1,1.0,1,1.0,1,0.24192923396878452,37
175,2,314,150,164,0,0,0,1.0,1,1.0,1,1.0,1,0.28273528683866395,36
176,2,316,152,164,0,0,0,1.0,1,1.0,1,1.0,1,0.3227623792366803,36
177,6,322,153,169,0,0,0,1.0,1,1.0,1,1.0,1,0.23119562776190236,38
178,2,324,154,170,0,0,0,1.0,1,1.0,1,1.0,1,0.2528903835987109,39
179,1,325,154,171,0,0,0,1.0,1,1.0,1,1.0,1,0.25941826719719985,40
180,0,325,154,171,0,0,0,1.0,1,1.0,1,1.0,1,0.25941826719719985,40
181,0,325,154,171,0,0,0,1.0,1,1.0,1,1.0,1,0.2819661406494621,39
182,1,326,155,171,0,0,0,1.0,1,1.0,1,1.0,1,0.27306757975335555,40
183,2,328,157,171,0,0,0,1.0,1,1.0,1,1.0,1,0.3350143744858221,40
184,0,328,157,171,0,0,0,1.0,1,1.0,1,1.0,1,0.3628261178849667,38
185,3,331,158,173,0,0,0,1.0,1,1.0,1,1.0,1,0.33885607224835607,38
186,4,335,160,175,0,0,0,1.0,1,1.0,1,1.0,1,0.32629228986834663,37
187,4,339,161,178,0,0,0,1.0,1,1.0,1,1.0,1,0.2595630210159102,36
188,2,341,162,179,0,0,0,1.0,1,1.0,1,1.0,1,0.2050139779641588,36
189,2,343,162,181,0,0,0,1.0,1,1.0,1,1.0,1,0.1629534702046673,36
190,0,343,162,181,0,0,0,1.0,1,1.0,1,1.0,1,0.1999855880636213,36
191,1,344,163,181,0,0,0,1.0,1,1.0,1,1.0,1,0.21323736246802089,37
192,0,344,163,181,0,0,0,1.0,1,1.0,1,1.0,1,0.21323736246802089,37
193,1,345,164,181,0,0,0,1.0,1,1.0,1,1.0,1,0.2275331842645786,38
194,2,347,164,183,0,0,0,1.0,1,1.0,1,1.0,1,0.2065856264298288,39
195,4,351,166,185,0,0,0,1.0,1,1.0,1,1.0,1,0.1786457535837772,40
196,1,352,167,185,0,0,0,1.0,1,1.0,1,1.0,1,0.17510947984807593,40
197,0,352,167,185,0,0,0,1.0,1,1.0,1,1.0,1,0.21940305598021903,40
198,1,353,168,185,0,0,0,1.0,1,1.0,1,1.0,1,0.21433051798986671,40
199,1,354,169,185,0,0,0,1.0,1,1.0,1,1.0,1,0.21441758131336275,40
200,1,355,169,186,0,0,0,1.0,1,1.0,1,1.0,1,0.19261987299432742,40
201,2,357,171,186,0,0,0,1.0,1,1.0,1,1.0,1,0.17110262761788464,39
202,0,357,171,186,0,0,0,1.0,1,1.0,1,1.0,1,0.17319176338559772,40
203,4,361,174,187,0,0,0,1.0,1,1.0,1,1.0,1,0.1693136382866376,39
204,1,362,175,187,0,0,0,1.0,1,1.0,1,1.0,1,0.1431682930059998,38
205,2,364,176,188,0,0,0,1.0,1,1.0,1,1.0,1,0.10058860916988206,37
206,1,365,177,188,0,0,0,1.0,1,1.0,1,1.0,1,0.15292901179667354,36
207,1,366,177,189,0,0,0,1.0,1,1.0,1,1.0,1,0.1501512145753947,37
208,0,366,177,189,0,0,0,1.0,1,1.0,1,1.0,1,0.13611591402845302,36
209,1,367,178,189,0,0,0,1.0,1,1.0,1,1.0,1,0.1620061841368949,36
210,0,367,178,189,0,0,0,1.0,1,1.0,1,1.0,1,0.1964760019294606,36
211,0,367,178,189,0,0,0,1.0,1,1.0,1,1.0,1,0.22070499805026098,34
212,1,368,179,189,0,0,0,1.0,1,1.0,1,1.0,1,0.2486193112493952,34
213,1,369,179,190,0,0,0,1.0,1,1.0,1,1.0,1,0.2390965068142106,36
214,1,370,179,191,0,0,0,1.0,1,1.0,1,1.0,1,0.2569884743961964,35
215,2,372,180,192,0,0,0,1.0,1,1.0,1,1.0,1,0.22821787190757944,35
216,3,375,180,195,0,0,0,1.0,1,1.0,1,1.0,1,0.1803910439707642,37
217,1,376,181,195,0,0,0,1.0,1,1.0,1,1.0,1,0.19538254481626205,37
218,4,380,184,196,0,0,0,1.0,1,1.0,1,1.0,1,0.27805184907478736,37
219,6,386,185,201,0,0,0,1.0,1,1.0,1,1.0,1,0.1911928598265516,37
220,0,386,185,201,0,0,0,1.0,1,1.0,1,1.0,1,0.20462362721917954,38
221,2,388,186,202,0,0,0,1.0,1,1.0,1,1.0,1,0.14323556807309035,39
222,2,390,188,202,0,0,0,1.0,1,1.0,1,1.0,1,0.1467452131933353,39
223,3,393,190,203,0,0,0,1.0,1,1.0,1,1.0,1,0.1680092075605235,40
224,1,394,191,203,0,0,0,1.0,1,1.0,1,1.0,1,0.18837465135204728,40
225,2,396,191,205,0,0,0,1.0,1,1.0,1,1.0,1,0.13052456387567693,39
226,3,399,194,205,0,0,0,1.0,1,1.0,1,1.0,1,0.16773056149784624,39
227,1,400,194,206,0,0,0,1.0,1,1.0,1,1.0,1,0.14315490145016616,39
228,3,403,197,206,0,0,0,1.0,1,1.0,1,1.0,1,0.1863019342099602,38
229,3,406,198,208,0,0,0,1.0,1,1.0,1,1.0,1,0.1728527458535652,39
230,2,408,200,208,0,0,0,1.0,1,1.0,1,1.0,1,0.16268651287696478,38
231,2,410,202,208,0,0,0,1.0,1,1.0,1,1.0,1,0.18189952957023733,38
232,1,411,203,208,0,0,0,1.0,1,1.0,1,1.0,1,0.20140526367414605,37
233,2,413,205,208,0,0,0,1.0,1,1.0,1,1.0,1,0.208433063276915,36
234,1,414,206,208,0,0,0,1.0,1,1.0,1,1.0,1,0.23701841320454684,34
235,3,417,207,210,0,0,0,1.0,1,1.0,1,1.0,1,0.23407401048800508,34
236,1,418,207,211,0,0,0,1.0,1,1.0,1,1.0,1,0.23875017013839606,33
237,1,419,208,211,0,0,0,1.0,1,1.0,1,1.0,1,0.23207736978860885,32
238,1,420,209,211,0,0,0,1.0,1,1.0,1,1.0,1,0.2737389286027365,32
239,2,422,210,212,0,0,0,1.0,1,1.0,1,1.0,1,0.24550703497540072,31
240,0,422,210,212,0,0,0,1.0,1,1.0,1,1.0,1,0.2829520638325528,28
241,2,424,211,213,0,0,0,1.0,1,1.0,1,1.0,1,0.2642522509849321,27
242,1,425,212,213,0,0,0,1.0,1,1.0,1,1.0,1,0.26363205945473717,29
243,1,426,213,213,0,0,0,1.0,1,1.0,1,1.0,1,0.2940293234661913,28
244,0,426,213,213,0,0,0,1.0,1,1.0,1,1.0,1,0.3053405115287448,28
245,2,428,214,214,0,0,0,1.0,1,1.0,1,1.0,1,0.25514088871814733,27
246,3,431,216,215,0,0,0,1.0,1,1.0,1,1.0,1,0.24731113208478459,25
247,0,431,216,215,0,0,0,1.0,1,1.0,1,1.0,1,0.26134326141852426,26
248,0,431,216,215,0,0,0,1.0,1,1.0,1,1.0,1,0.28869138979524733,27
249,1,432,217,215,0,0,0,1.0,1,1.0,1,1.0,1,0.2734135410339038,26
250,0,432,217,215,0,0,0,1.0,1,1.0,1,1.0,1,0.30010503809480005,27
251,2,434,217,217,0,0,0,1.0,1,1.0,1,1.0,1,0.274259266836335,28
252,1,435,218,217,0,0,0,1.0,1,1.0,1,1.0,1,0.28594378760629546,28
253,0,435,218,217,0,0,0,1.0,1,1.0,1,1.0,1,0.27412120352991814,28
254,0,435,218,217,0,0,0,1.0,1,1.0,1,1.0,1,0.30183125173389014,29
255,3,438,219,219,0,0,0,1.0,1,1.0,1,1.0,1,0.310344383531509,30
256,2,440,221,219,0,0,0,1.0,1,1.0,1,1.0,1,0.3165343695948352,30
257,2,442,222,220,0,0,0,1.0,1,1.0,1,1.0,1,0.3530126421537236,32
258,4,446,224,222,0,0,0,1.0,1,1.0,1,1.0,1,0.32865796875553077,32
259,2,448,224,224,0,0,0,1.0,1,1.0,1,1.0,1,0.2993178845092813,32
260,1,449,225,224,0,0,0,1.0,1,1.0,1,1.0,1,0.2616319215196612,34
261,0,449,225,224,0,0,0,1.0,1,1.0,1,1.0,1,0.2768080877817881,35
262,2,451,227,224,0,0,0,1.0,1,1.0,1,1.0,1,0.36306786793697077,36
263,0,451,227,224,0,0,0,1.0,1,1.0,1,1.0,1,0.3361248551994806,34
264,2,453,228,225,0,0,0,1.0,1,1.0,1,1.0,1,0.333182441240602,34
265,1,454,228,226,0,0,0,1.0,1,1.0,1,1.0,1,0.3213298604583842,33
266,1,455,229,226,0,0,0,1.0,1,1.0,1,1.0,1,0.3633243268457902,34
267,0,455,229,226,0,0,0,1.0,1,1.0,1,1.0,1,0.3556857471582167,33
268,1,456,229,227,0,0,0,1.0,1,1.0,1,1.0,1,0.35842275877304175,34
269,3,459,231,228,0,0,0,1.0,1,1.0,1,1.0,1,0.32399482755500614,34
270,0,459,231,228,0,0,0,1.0,1,1.0,1,1.0,1,0.3427383939582807,36
271,0,459,231,228,0,0,0,1.0,1,1.0,1,1.0,1,0.3427383939582807,36
272,1,460,231,229,0,0,0,1.0,1,1.0,1,1.0,1,0.3452746017463976,38
273,0,460,231,229,0,0,0,1.0,1,1.0,1,1.0,1,0.3452746017463976,38
274,1,461,232,229,0,0,0,1.0,1,1.0,1,1.0,1,0.34909453534376017,38
275,3,464,232,232,0,0,0,1.0,1,1.0,1,1.0,1,0.27644585386184145,38
276,0,464,232,232,0,0,0,1.0,1,1.0,1,1.0,1,0.31014813857432805,39
277,4,468,233,235,0,0,0,1.0,1,1.0,1,1.0,1,0.30084286159833756,38
278,0,468,233,235,0,0,0,1.0,1,1.0,1,1.0,1,0.28088451145462756,38
279,2,470,234,236,0,0,0,1.0,1,1.0,1,1.0,1,0.262015289787239,38
280,0,470,234,236,0,0,0,1.0,1,1.0,1,1.0,1,0.2663881614944266,38
281,0,470,234,236,0,0,0,1.0,1,1.0,1,1.0,1,0.26709603769137846,38
282,0,470,234,236,0,0,0,1.0,1,1.0,1,1.0,1,0.27644698538165385,38
283,1,471,235,236,0,0,0,1.0,1,1.0,1,1.0,1,0.29277762413960123,38
284,0,471,235,236,0,0,0,1.0,1,1.0,1,1.0,1,0.2949568025274644,39
285,1,472,236,236,0,0,0,1.0,1,1.0,1,1.0,1,0.3212708489433016,39
286,0,472,236,236,0,0,0,1.0,1,1.0,1,1.0,1,0.3212708489433016,39
287,3,475,236,239,0,0,0,1.0,1,1.0,1,1.0,1,0.3254282090606524,39
288,1,476,236,240,0,0,0,1.0,1,1.0,1,1.0,1,0.2768300512431646,39
289,0,476,236,240,0,0,0,1.0,1,1.0,1,1.0,1,0.2768300512431646,39
290,0,476,236,240,0,0,0,1.0,1,1.0,1,1.0,1,0.277102133948808,39
291,1,477,236,241,0,0,0,1.0,1,1.0,1,1.0,1,0.2571306541037112,39
292,1,478,236,242,0,0,0,1.0,1,1.0,1,1.0,1,0.24439407717836362,40
293,2,480,236,244,0,0,0,1.0,1,1.0,1,1.0,1,0.20180210632080053,41
294,1,481,237,244,0,0,0,1.0,1,1.0,1,1.0,1,0.1952102826402788,40
295,3,484,238,246,0,0,0,1.0,1,1.0,1,1.0,1,0.17443462181587907,42
296,3,487,241,246,0,0,0,1.0,1,1.0,1,1.0,1,0.20733486395166173,42
297,6,493,243,250,0,0,0,1.0,1,1.0,1,1.0,1,0.14395170323769393,43
298,1,494,244,250,0,0,0,1.0,1,1.0,1,1.0,1,0.2085732227044527,44
299,4,498,245,253,0,0,0,1.0,1,1.0,1,1.0,1,0.1345597515801859,44
300,2,500,245,255,0,0,0,1.0,1,1.0,1,1.0,1,0.1123917250730777,45
301,2,502,247,255,0,0,0,1.0,1,1.0,1,1.0,1,0.17131903655784683,47
302,3,505,248,257,0,0,0,1.0,1,1.0,1,1.0,1,0.16522549404818487,46
303,2,507,249,258,0,0,0,1.0,1,1.0,1,1.0,1,0.15700488591244582,45
304,1,508,250,258,0,0,0,1.0,1,1.0,1,1.0,1,0.1590975019070974,45
305,0,508,250,258,0,0,0,1.0,1,1.0,1,1.0,1,0.1502596834461488,43
306,2,510,251,259,0,0,0,1.0,1,1.0,1,1.0,1,0.16977805978650806,44
307,2,512,253,259,0,0,0,1.0,1,1.0,1,1.0,1,0.21050611515325982,42
308,2,514,255,259,0,0,0,1.0,1,1.0,1,1.0,1,0.22850007775837508,41
309,4,518,255,263,0,0,0,1.0,1,1.0,1,1.0,1,0.1584002867776532,42
310,0,518,255,263,0,0,0,1.0,1,1.0,1,1.0,1,0.14188231568788448,41
311,0,518,255,263,0,0,0,1.0,1,1.0,1,1.0,1,0.14188231568788448,41
312,0,518,255,263,0,0,0,1.0,1,1.0,1,1.0,1,0.1334871753537775,44
313,0,518,255,263,0,0,0,1.0,1,1.0,1,1.0,1,0.1183814395276571,43
314,2,520,256,264,0,0,0,1.0,1,1.0,1,1.0,1,0.11674189709255917,43
315,0,520,256,264,0,0,0,1.0,1,1.0,1,1.0,1,0.13558266865643756,43
316,1,521,257,264,0,0,0,1.0,1,1.0,1,1.0,1,0.17420331597286087,43
317,0,521,257,264,0,0,0,1.0,1,1.0,1,1.0,1,0.18065389725653375,44
318,3,524,259,265,0,0,0,1.0,1,1.0,1,1.0,1,0.2530730794538504,45
319,1,525,259,266,0,0,0,1.0,1,1.0,1,1.0,1,0.2552320194047735,46
320,1,526,259,267,0,0,0,1.0,1,1.0,1,1.0,1,0.25446419847839724,45
321,1,527,260,267,0,0,0,1.0,1,1.0,1,1.0,1,0.2256494481452064,44
322,1,528,260,268,0,0,0,1.0,1,1.0,1,1.0,1,0.2045219722277679,42
323,2,530,262,268,0,0,0,1.0,1,1.0,1,1.0,1,0.22107148701769744,42
324,1,531,262,269,0,0,0,1.0,1,1.0,1,1.0,1,0.20778349584758052,43
325,3,534,264,270,0,0,0,1.0,1,1.0,1,1.0,1,0.24083159381591823,43
326,0,534,264,270,0,0,0,1.0,1,1.0,1,1.0,1,0.24083159381591823,43
327,2,536,265,271,0,0,0,1.0,1,1.0,1,1.0,1,0.25237538290950073,44
328,1,537,266,271,0,0,0,1.0,1,1.0,1,1.0,1,0.26625211112218417,44
329,1,538,266,272,0,0,0,1.0,1,1.0,1,1.0,1,0.22613665662192703,45
330,1,539,266,273,0,0,0,1.0,1,1.0,1,1.0,1,0.2055492711244278,46
331,0,539,266,273,0,0,0,1.0,1,1.0,1,1.0,1,0.2055492711244278,46
332,0,539,266,273,0,0,0,1.0,1,1.0,1,1.0,1,0.18033030321253204,47
333,1,540,266,274,0,0,0,1.0,1,1.0,1,1.0,1,0.18773847620935502,48
334,2,542,266,276,0,0,0,1.0,1,1.0,1,1.0,1,0.14774201590937885,48
335,2,544,267,277,0,0,0,1.0,1,1.0,1,1.0,1,0.14615737842499088,49
336,0,544,267,277,0,0,0,1.0,1,1.0,1,1.0,1,0.1540933574031908,50
337,0,544,267,277,0,0,0,1.0,1,1.0,1,1.0,1,0.17249238851487458,51
338,0,544,267,277,0,0,0,1.0,1,1.0,1,1.0,1,0.17249238851487458,51
339,1,545,268,277,0,0,0,1.0,1,1.0,1,1.0,1,0.16818715328020498,51
340,1,546,269,277,0,0,0,1.0,1,1.0,1,1.0,1,0.18744449877541883,51
341,0,546,269,277,0,0,0,1.0,1,1.0,1,1.0,1,0.18706207498284186,51
342,1,547,270,277,0,0,0,1.0,1,1.0,1,1.0,1,0.21043638410456927,51
343,2,549,270,279,0,0,0,1.0,1,1.0,1,1.0,1,0.20154937936387918,51
344,1,550,271,279,0,0,0,1.0,1,1.0,1,1.0,1,0.20294164425780176,50
345,2,552,271,281,0,0,0,1.0,1,1.0,1,1.0,1,0.18457598456529994,50
346,2,554,273,281,0,0,0,1.0,1,1.0,1,1.0,1,0.2239675328857428,50
347,2,556,273,283,0,0,0,1.0,1,1.0,1,1.0,1,0.1880536198585195,51
348,1,557,274,283,0,0,0,1.0,1,1.0,1,1.0,1,0.20491534820910398,52
349,2,559,276,283,0,0,0,1.0,1,1.0,1,1.0,1,0.2277569311717575,54
350,3,562,276,286,0,0,0,1.0,1,1.0,1,1.0,1,0.23629858974499485,54
351,5,567,279,288,0,0,0,1.0,1,1.0,1,1.0,1,0.22716251600577944,54
352,0,567,279,288,0,0,0,1.0,1,1.0,1,1.0,1,0.22714925396028715,56
353,2,569,280,289,0,0,0,1.0,1,1.0,1,1.0,1,0.19263819407647917,54
354,0,569,280,289,0,0,0,1.0,1,1.0,1,1.0,1,0.2006462391216828,53
355,3,572,282,290,0,0,0,1.0,1,1.0,1,1.0,1,0.16891271008601824,54
356,2,574,283,291,0,0,0,1.0,1,1.0,1,1.0,1,0.18412169502762293,54
357,4,578,286,292,0,0,0,1.0,1,1.0,1,1.0,1,0.2164841596529108,53
358,0,578,286,292,0,0,0,1.0,1,1.0,1,1.0,1,0.2595494351528092,49
359,0,578,286,292,0,0,0,1.0,1,1.0,1,1.0,1,0.27669606194183993,48
360,0,578,286,292,0,0,0,1.0,1,1.0,1,1.0,1,0.2953511598298521,47
361,2,580,286,294,0,0,0,1.0,1,1.0,1,1.0,1,0.2508441985975988,46
362,1,581,286,295,0,0,0,1.0,1,1.0,1,1.0,1,0.2449773472690637,46
363,0,581,286,295,0,0,0,1.0,1,1.0,1,1.0,1,0.25087718586875335,47
364,0,581,286,295,0,0,0,1.0,1,1.0,1,1.0,1,0.25087718586875335,47
365,0,581,286,295,0,0,0,1.0,1,1.0,1,1.0,1,0.25087718586875335,47
366,4,585,288,297,0,0,0,1.0,1,1.0,1,1.0,1,0.28169477880912325,50
367,0,585,288,297,0,0,0,1.0,1,1.0,1,1.0,1,0.28169477880912325,50
368,0,585,288,297,0,0,0,1.0,1,1.0,1,1.0,1,0.2635777350899117,51
369,1,586,288,298,0,0,0,1.0,1,1.0,1,1.0,1,0.2544661697039954,51
370,1,587,288,299,0,0,0,1.0,1,1.0,1,1.0,1,0.22963200292522398,51
371,2,589,288,301,0,0,0,1.0,1,1.0,1,1.0,1,0.23182589687043068,52
372,0,589,288,301,0,0,0,1.0,1,1.0,1,1.0,1,0.23159281153639077,53
373,1,590,289,301,0,0,0,1.0,1,1.0,1,1.0,1,0.22832303390239886,53
374,3,593,290,303,0,0,0,1.0,1,1.0,1,1.0,1,0.2493219643837054,53
375,4,597,293,304,0,0,0,1.0,1,1.0,1,1.0,1,0.23716985609381172,53
376,1,598,294,304,0,0,0,1.0,1,1.0,1,1.0,1,0.22862502045574942,53
377,3,601,296,305,0,0,0,1.0,1,1.0,1,1.0,1,0.203993006201957,53
378,1,602,297,305,0,0,0,1.0,1,1.0,1,1.0,1,0.1851642160998937,53
379,1,603,298,305,0,0,0,1.0,1,1.0,1,1.0,1,0.19797978151255333,54
380,1,604,299,305,0,0,0,1.0,1,1.0,1,1.0,1,0.20028873883864654,54
381,2,606,301,305,0,0,0,1.0,1,1.0,1,1.0,1,0.19915473161609493,54
382,5,611,303,308,0,0,0,1.0,1,1.0,1,1.0,1,0.1621843174189659,55
383,4,615,304,311,0,0,0,1.0,1,1.0,1,1.0,1,0.13666143466738884,55
384,1,616,305,311,0,0,0,1.0,1,1.0,1,1.0,1,0.15252896830352516,54
385,1,617,305,312,0,0,0,1.0,1,1.0,1,1.0,1,0.1485980751232552,52
386,0,617,305,312,0,0,0,1.0,1,1.0,1,1.0,1,0.14700828676801947,52
387,2,619,306,313,0,0,0,1.0,1,1.0,1,1.0,1,0.16014375189927813,50
388,3,622,307,315,0,0,0,1.0,1,1.0,1,1.0,1,0.15751830448561818,52
389,2,624,309,315,0,0,0,1.0,1,1.0,1,1.0,1,0.18784133338523998,51
390,4,628,312,316,0,0,0,1.0,1,1.0,1,1.0,1,0.1767004021628537,50
391,5,633,314,319,0,0,0,1.0,1,1.0,1,1.0,1,0.15727457952785565,49
392,3,636,316,320,0,0,0,1.0,1,1.0,1,1.0,1,0.16783403316968154,47
393,3,639,318,321,0,0,0,1.0,1,1.0,1,1.0,1,0.223970391696537,47
394,2,641,320,321,0,0,0,1.0,1,1.0,1,1.0,1,0.24360892838308176,48
395,2,643,320,323,0,0,0,1.0,1,1.0,1,1.0,1,0.24730282188807556,46
396,1,644,321,323,0,0,0,1.0,1,1.0,1,1.0,1,0.27576365912263545,43
397,0,644,321,323,0,0,0,1.0,1,1.0,1,1.0,1,0.28740229407314427,42
398,1,645,322,323,0,0,0,1.0,1,1.0,1,1.0,1,0.32395754503541724,40
399,2,647,323,324,0,0,0,1.0,1,1.0,1,1.0,1,0.3332816088216308,39
400,0,647,323,324,0,0,0,1.0,1,1.0,1,1.0,1,0.3115765557058234,38
401,1,648,323,325,0,0,0,1.0,1,1.0,1,1.0,1,0.33201817929739025,37
402,2,650,325,325,0,0,0,1.0,1,1.0,1,1.0,1,0.29982501555778623,36
403,3,653,326,327,0,0,0,1.0,1,1.0,1,1.0,1,0.24938623386843445,38
404,3,656,327,329,0,0,0,1.0,1,1.0,1,1.0,1,0.284730319109509,39
405,2,658,327,331,0,0,0,1.0,1,1.0,1,1.0,1,0.22889378896695606,40
406,1,659,327,332,0,0,0,1.0,1,1.0,1,1.0,1,0.23897308082554605,41
407,0,659,327,332,0,0,0,1.0,1,1.0,1,1.0,1,0.23225716624330245,42
408,0,659,327,332,0,0,0,1.0,1,1.0,1,1.0,1,0.2188155000979895,43
409,2,661,328,333,0,0,0,1.0,1,1.0,1,1.0,1,0.24400326771207634,44
410,1,662,328,334,0,0,0,1.0,1,1.0,1,1.0,1,0.2444887557688108,46
411,0,662,328,334,0,0,0,1.0,1,1.0,1,1.0,1,0.2444887557688108,46
412,1,663,328,335,0,0,0,1.0,1,1.0,1,1.0,1,0.23098369160810486,47
413,1,664,329,335,0,0,0,1.0,1,1.0,1,1.0,1,0.25785117562136894,47
414,1,665,329,336,0,0,0,1.0,1,1.0,1,1.0,1,0.25317956518167883,47
415,2,667,329,338,0,0,0,1.0,1,1.0,1,1.0,1,0.2461729190341253,48
416,1,668,329,339,0,0,0,1.0,1,1.0,1,1.0,1,0.23665016577351838,49
417,1,669,329,340,0,0,0,1.0,1,1.0,1,1.0,1,0.22768748012308238,49
418,0,669,329,340,0,0,0,1.0,1,1.0,1,1.0,1,0.2419936674500171,50
419,1,670,329,341,0,0,0,1.0,1,1.0,1,1.0,1,0.22570993660537303,50
420,0,670,329,341,0,0,0,1.0,1,1.0,1,1.0,1,0.22570993660537303,50
421,0,670,329,341,0,0,0,1.0,1,1.0,1,1.0,1,0.22570993660537303,50
422,1,671,329,342,0,0,0,1.0,1,1.0,1,1.0,1,0.2350552048539486,50
423,2,673,331,342,0,0,0,1.0,1,1.0,1,1.0,1,0.24504413903079514,51
424,2,675,332,343,0,0,0,1.0,1,1.0,1,1.0,1,0.24169013620868607,49
425,2,677,333,344,0,0,0,1.0,1,1.0,1,1.0,1,0.24731207213800133,48
426,2,679,335,344,0,0,0,1.0,1,1.0,1,1.0,1,0.2612003257511748,50
427,2,681,336,345,0,0,0,1.0,1,1.0,1,1.0,1,0.28125961273036987,48
428,7,688,339,349,0,0,0,1.0,1,1.0,1,1.0,1,0.3050367344687446,49
429,5,693,341,352,0,0,0,1.0,1,1.0,1,1.0,1,0.23061393911004996,45
430,4,697,343,354,0,0,0,1.0,1,1.0,1,1.0,1,0.2577304465395615,44
431,6,703,345,358,0,0,0,1.0,1,1.0,1,1.0,1,0.18202791886618552,42
432,0,703,345,358,0,0,0,1.0,1,1.0,1,1.0,1,0.18307145256039248,40
433,2,705,346,359,0,0,0,1.0,1,1.0,1,1.0,1,0.18647086984793332,39
434,1,706,347,359,0,0,0,1.0,1,1.0,1,1.0,1,0.17229296078912132,39
435,2,708,349,359,0,0,0,1.0,1,1.0,1,1.0,1,0.2687917644923741,38
436,2,710,350,360,0,0,0,1.0,1,1.0,1,1.0,1,0.23927166098937208,38
437,0,710,350,360,0,0,0,1.0,1,1.0,1,1.0,1,0.25587320081795895,39
438,0,710,350,360,0,0,0,1.0,1,1.0,1,1.0,1,0.25346145884361587,38
439,2,712,350,362,0,0,0,1.0,1,1.0,1,1.0,1,0.22227069628839716,39
440,1,713,350,363,0,0,0,1.0,1,1.0,1,1.0,1,0.18575142199140235,39
441,1,714,351,363,0,0,0,1.0,1,1.0,1,1.0,1,0.17838401067034734,41
442,0,714,351,363,0,0,0,1.0,1,1.0,1,1.0,1,0.2066241776778129,42
443,1,715,351,364,0,0,0,1.0,1,1.0,1,1.0,1,0.1833003633920792,42
444,1,716,352,364,0,0,0,1.0,1,1.0,1,1.0,1,0.18426995651846645,43
445,2,718,354,364,0,0,0,1.0,1,1.0,1,1.0,1,0.19764786823071148,44
446,1,719,355,364,0,0,0,1.0,1,1.0,1,1.0,1,0.15777881077220363,44
447,1,720,356,364,0,0,0,1.0,1,1.0,1,1.0,1,0.19299098401209577,47
448,0,720,356,364,0,0,0,1.0,1,1.0,1,1.0,1,0.20747787075729637,46
449,0,720,356,364,0,0,0,1.0,1,1.0,1,1.0,1,0.20747787075729637,46
450,1,721,356,365,0,0,0,1.0,1,1.0,1,1.0,1,0.21926357074710262,46
451,1,722,356,366,0,0,0,1.0,1,1.0,1,1.0,1,0.21747898855513165,47
452,0,722,356,366,0,0,0,1.0,1,1.0,1,1.0,1,0.2399940752361912,47
453,0,722,356,366,0,0,0,1.0,1,1.0,1,1.0,1,0.2399940752361912,47
454,2,724,356,368,0,0,0,1.0,1,1.0,1,1.0,1,0.1877605255566745,46
455,3,727,357,370,0,0,0,1.0,1,1.0,1,1.0,1,0.1890104602914742,47
456,0,727,357,370,0,0,0,1.0,1,1.0,1,1.0,1,0.18914288900902848,49
457,2,729,358,371,0,0,0,1.0,1,1.0,1,1.0,1,0.18384067336217644,50
458,0,729,358,371,0,0,0,1.0,1,1.0,1,1.0,1,0.18384067336217644,50
459,1,730,358,372,0,0,0,1.0,1,1.0,1,1.0,1,0.1477703430312869,52
460,2,732,358,374,0,0,0,1.0,1,1.0,1,1.0,1,0.14663581490133493,53
461,1,733,358,375,0,0,0,1.0,1,1.0,1,1.0,1,0.1558752729689579,54
462,0,733,358,375,0,0,0,1.0,1,1.0,1,1.0,1,0.1558752729689579,54
463,2,735,359,376,0,0,0,1.0,1,1.0,1,1.0,1,0.15724229012943375,55
464,3,738,361,377,0,0,0,1.0,1,1.0,1,1.0,1,0.17149569924305016,56
465,2,740,361,379,0,0,0,1.0,1,1.0,1,1.0,1,0.13062136985464012,54
466,1,741,362,379,0,0,0,1.0,1,1.0,1,1.0,1,0.13371210856190577,54
467,3,744,364,380,0,0,0,1.0,1,1.0,1,1.0,1,0.14581716095006786,51
468,5,749,367,382,0,0,0,1.0,1,1.0,1,1.0,1,0.1488918627876606,51
469,4,753,369,384,0,0,0,1.0,1,1.0,1,1.0,1,0.1810246985797313,48
470,4,757,373,384,0,0,0,1.0,1,1.0,1,1.0,1,0.22118580114827444,47
471,4,761,375,386,0,0,0,1.0,1,1.0,1,1.0,1,0.21405016823325448,44
472,4,765,378,387,0,0,0,1.0,1,1.0,1,1.0,1,0.25493812884772404,43
473,2,767,379,388,0,0,0,1.0,1,1.0,1,1.0,1,0.19054566187551575,41
474,0,767,379,388,0,0,0,1.0,1,1.0,1,1.0,1,0.19884672263787825,39
475,3,770,379,391,0,0,0,1.0,1,1.0,1,1.0,1,0.13088262474972337,40
476,3,773,382,391,0,0,0,1.0,1,1.0,1,1.0,1,0.1427805701556077,38
477,2,775,384,391,0,0,0,1.0,1,1.0,1,1.0,1,0.22081644922432156,35
478,1,776,384,392,0,0,0,1.0,1,1.0,1,1.0,1,0.19957714444402896,35
479,1,777,385,392,0,0,0,1.0,1,1.0,1,1.0,1,0.2722508904946452,32
480,0,777,385,392,0,0,0,1.0,1,1.0,1,1.0,1,0.2843739010537721,32
481,0,777,385,392,0,0,0,1.0,1,1.0,1,1.0,1,0.28718569716308356,33
482,4,781,387,394,0,0,0,1.0,1,1.0,1,1.0,1,0.32843895805063245,34
483,0,781,387,394,0,0,0,1.0,1,1.0,1,1.0,1,0.30976111042025073,32
484,2,783,387,396,0,0,0,1.0,1,1.0,1,1.0,1,0.24850396218475293,33
485,2,785,388,397,0,0,0,1.0,1,1.0,1,1.0,1,0.2631830602657314,34
486,1,786,388,398,0,0,0,1.0,1,1.0,1,1.0,1,0.29207728359733093,36
487,3,789,388,401,0,0,0,1.0,1,1.0,1,1.0,1,0.23807252050172925,36
488,1,790,388,402,0,0,0,1.0,1,1.0,1,1.0,1,0.2373912674009035,37
489,3,793,390,403,0,0,0,1.0,1,1.0,1,1.0,1,0.28720480718560665,38
490,1,794,391,403,0,0,0,1.0,1,1.0,1,1.0,1,0.29898778276975263,38
491,5,799,391,408,0,0,0,1.0,1,1.0,1,1.0,1,0.1920769944495676,37
492,1,800,392,408,0,0,0,1.0,1,1.0,1,1.0,1,0.21533768701139583,37
493,1,801,392,409,0,0,0,1.0,1,1.0,1,1.0,1,0.20834401989549073,37
494,3,804,394,410,0,0,0,1.0,1,1.0,1,1.0,1,0.24898727512007904,39
495,0,804,394,410,0,0,0,1.0,1,1.0,1,1.0,1,0.24851168053058684,40
496,0,804,394,410,0,0,0,1.0,1,1.0,1,1.0,1,0.24851168053058684,40
497,2,806,394,412,0,0,0,1.0,1,1.0,1,1.0,1,0.20363660579514042,43
498,2,808,395,413,0,0,0,1.0,1,1.0,1,1.0,1,0.17941231875399266,43
499,3,811,396,415,0,0,0,1.0,1,1.0,1,1.0,1,0.19361848342518825,44
500,3,814,397,417,0,0,0,1.0,1,1.0,1,1.0,1,0.14633549660577477,45
501,1,815,398,417,0,0,0,1.0,1,1.0,1,1.0,1,0.1588617753788172,45
502,1,816,399,417,0,0,0,1.0,1,1.0,1,1.0,1,0.17390228845879557,45
503,1,817,400,417,0,0,0,1.0,1,1.0,1,1.0,1,0.1935621714437346,46
504,3,820,402,418,0,0,0,1.0,1,1.0,1,1.0,1,0.23210512513814108,47
505,1,821,402,419,0,0,0,1.0,1,1.0,1,1.0,1,0.21919701003399555,42
506,1,822,403,419,0,0,0,1.0,1,1.0,1,1.0,1,0.24686541790968994,41
507,0,822,403,419,0,0,0,1.0,1,1.0,1,1.0,1,0.24211237699923163,38
508,2,824,405,419,0,0,0,1.0,1,1.0,1,1.0,1,0.3161933325676993,38
509,0,824,405,419,0,0,0,1.0,1,1.0,1,1.0,1,0.3445065809728754,37
510,0,824,405,419,0,0,0,1.0,1,1.0,1,1.0,1,0.3647273887736581,36
511,3,827,406,421,0,0,0,1.0,1,1.0,1,1.0,1,0.36138089520338545,34
512,0,827,406,421,0,0,0,1.0,1,1.0,1,1.0,1,0.35623188436064285,32
513,0,827,406,421,0,0,0,1.0,1,1.0,1,1.0,1,0.35623188436064285,32
514,1,828,406,422,0,0,0,1.0,1,1.0,1,1.0,1,0.3264887901332185,35
515,1,829,406,423,0,0,0,1.0,1,1.0,1,1.0,1,0.3066744001504999,35
516,2,831,406,425,0,0,0,1.0,1,1.0,1,1.0,1,0.29016617984352655,36
517,1,832,406,426,0,0,0,1.0,1,1.0,1,1.0,1,0.27707307330431324,36
518,2,834,406,428,0,0,0,1.0,1,1.0,1,1.0,1,0.2751802121049958,39
519,1,835,407,428,0,0,0,1.0,1,1.0,1,1.0,1,0.2773245635384422,39
520,1,836,408,428,0,0,0,1.0,1,1.0,1,1.0,1,0.30103249170538504,39
521,2,838,408,430,0,0,0,1.0,1,1.0,1,1.0,1,0.25825525371000346,40
522,1,839,408,431,0,0,0,1.0,1,1.0,1,1.0,1,0.2410670404764285,40
523,0,839,408,431,0,0,0,1.0,1,1.0,1,1.0,1,0.25855066614826455,41
524,1,840,408,432,0,0,0,1.0,1,1.0,1,1.0,1,0.23983729281855484,41
525,2,842,410,432,0,0,0,1.0,1,1.0,1,1.0,1,0.25890411548607384,40
526,0,842,410,432,0,0,0,1.0,1,1.0,1,1.0,1,0.2705181289842755,40
527,2,844,411,433,0,0,0,1.0,1,1.0,1,1.0,1,0.2642162115324233,40
528,1,845,412,433,0,0,0,1.0,1,1.0,1,1.0,1,0.25967617286798517,40
529,1,846,412,434,0,0,0,1.0,1,1.0,1,1.0,1,0.26692266383147895,39
530,1,847,412,435,0,0,0,1.0,1,1.0,1,1.0,1,0.23631774989863383,39
531,2,849,413,436,0,0,0,1.0,1,1.0,1,1.0,1,0.23084158997611498,39
532,0,849,413,436,0,0,0,1.0,1,1.0,1,1.0,1,0.23732437916504803,40
533,1,850,414,436,0,0,0,1.0,1,1.0,1,1.0,1,0.3083247340089133,40
534,0,850,414,436,0,0,0,1.0,1,1.0,1,1.0,1,0.3246397078355635,42
535,3,853,415,438,0,0,0,1.0,1,1.0,1,1.0,1,0.3010661480583504,42
536,0,853,415,438,0,0,0,1.0,1,1.0,1,1.0,1,0.3066302459343341,43
537,0,853,415,438,0,0,0,1.0,1,1.0,1,1.0,1,0.3066302459343341,43
538,1,854,415,439,0,0,0,1.0,1,1.0,1,1.0,1,0.30494834067227095,44
539,0,854,415,439,0,0,0,1.0,1,1.0,1,1.0,1,0.30494834067227095,44
540,1,855,416,439,0,0,0,1.0,1,1.0,1,1.0,1,0.31394997077263254,44
541,1,856,417,439,0,0,0,1.0,1,1.0,1,1.0,1,0.2940629336870357,45
542,3,859,418,441,0,0,0,1.0,1,1.0,1,1.0,1,0.27073324066521814,46
543,2,861,420,441,0,0,0,1.0,1,1.0,1,1.0,1,0.3145270679529792,43
544,3,864,421,443,0,0,0,1.0,1,1.0,1,1.0,1,0.3115883138518978,42
545,4,868,423,445,0,0,0,1.0,1,1.0,1,1.0,1,0.2914356125360446,43
546,3,871,426,445,0,0,0,1.0,1,1.0,1,1.0,1,0.3704333044135526,41
547,3,874,426,448,0,0,0,1.0,1,1.0,1,1.0,1,0.2883569748555576,40
548,3,877,429,448,0,0,0,1.0,1,1.0,1,1.0,1,0.3346366602116694,40
549,3,880,431,449,0,0,0,1.0,1,1.0,1,1.0,1,0.368095190440564,39
550,1,881,431,450,0,0,0,1.0,1,1.0,1,1.0,1,0.3301639304652622,38
551,4,885,432,453,0,0,0,1.0,1,1.0,1,1.0,1,0.31467332312845925,38
552,1,886,433,453,0,0,0,1.0,1,1.0,1,1.0,1,0.351550543415117,39
553,0,886,433,453,0,0,0,1.0,1,1.0,1,1.0,1,0.34405094446730217,38
554,2,888,434,454,0,0,0,1.0,1,1.0,1,1.0,1,0.35340510482052234,39
555,2,890,434,456,0,0,0,1.0,1,1.0,1,1.0,1,0.31798301322471323,39
556,4,894,435,459,0,0,0,1.0,1,1.0,1,1.0,1,0.26978832875720876,40
557,2,896,435,461,0,0,0,1.0,1,1.0,1,1.0,1,0.2715648368624697,40
558,1,897,435,462,0,0,0,1.0,1,1.0,1,1.0,1,0.2642294578404605,40
559,2,899,436,463,0,0,0,1.0,1,1.0,1,1.0,1,0.25387003323544266,40
560,1,900,436,464,0,0,0,1.0,1,1.0,1,1.0,1,0.24073472379371946,41
561,2,902,437,465,0,0,0,1.0,1,1.0,1,1.0,1,0.23554601391592458,42
562,1,903,438,465,0,0,0,1.0,1,1.0,1,1.0,1,0.2553082686114354,42
563,2,905,439,466,0,0,0,1.0,1,1.0,1,1.0,1,0.2757066411983745,42
564,0,905,439,466,0,0,0,1.0,1,1.0,1,1.0,1,0.29300660639410486,43
565,1,906,440,466,0,0,0,1.0,1,1.0,1,1.0,1,0.3363955198463924,44
566,1,907,440,467,0,0,0,1.0,1,1.0,1,1.0,1,0.3096294334490736,45
567,0,907,440,467,0,0,0,1.0,1,1.0,1,1.0,1,0.3096294334490736,45
568,2,909,440,469,0,0,0,1.0,1,1.0,1,1.0,1,0.2609703123245816,46
569,2,911,441,470,0,0,0,1.0,1,1.0,1,1.0,1,0.2372762538344915,47
570,1,912,442,470,0,0,0,1.0,1,1.0,1,1.0,1,0.2633197771367552,48
571,0,912,442,470,0,0,0,1.0,1,1.0,1,1.0,1,0.2633197771367552,48
572,0,912,442,470,0,0,0,1.0,1,1.0,1,1.0,1,0.25504414770570594,47
573,2,914,442,472,0,0,0,1.0,1,1.0,1,1.0,1,0.2189278625524585,49
574,1,915,442,473,0,0,0,1.0,1,1.0,1,1.0,1,0.20932239887409448,49
575,2,917,442,475,0,0,0,1.0,1,1.0,1,1.0,1,0.156107886166321,50
576,0,917,442,475,0,0,0,1.0,1,1.0,1,1.0,1,0.1716947623470765,51
577,0,917,442,475,0,0,0,1.0,1,1.0,1,1.0,1,0.1716947623470765,51
578,0,917,442,475,0,0,0,1.0,1,1.0,1,1.0,1,0.1716947623470765,51
579,3,920,444,476,0,0,0,1.0,1,1.0,1,1.0,1,0.1659395707904852,52
580,2,922,444,478,0,0,0,1.0,1,1.0,1,1.0,1,0.17766761974222445,52
581,2,924,445,479,0,0,0,1.0,1,1.0,1,1.0,1,0.18393945324179306,52
582,1,925,446,479,0,0,0,1.0,1,1.0,1,1.0,1,0.20154536649486945,53
583,6,931,448,483,0,0,0,1.0,1,1.0,1,1.0,1,0.23062446335042314,51
584,4,935,451,484,0,0,0,1.0,1,1.0,1,1.0,1,0.21104878222849516,51
585,3,938,454,484,0,0,0,1.0,1,1.0,1,1.0,1,0.23219897014066346,49
586,5,943,458,485,0,0,0,1.0,1,1.0,1,1.0,1,0.22775459451440003,49
587,2,945,459,486,0,0,0,1.0,1,1.0,1,1.0,1,0.2115548108118329,48
588,3,948,462,486,0,0,0,1.0,1,1.0,1,1.0,1,0.1854233135665444,46
589,2,950,463,487,0,0,0,1.0,1,1.0,1,1.0,1,0.1801269853942507,48
590,0,950,463,487,0,0,0,1.0,1,1.0,1,1.0,1,0.18417122926085266,47
591,1,951,464,487,0,0,0,1.0,1,1.0,1,1.0,1,0.2078031226541391,48
592,1,952,464,488,0,0,0,1.0,1,1.0,1,1.0,1,0.1975448513507556,47
593,2,954,465,489,0,0,0,1.0,1,1.0,1,1.0,1,0.19929458028952188,45
594,0,954,465,489,0,0,0,1.0,1,1.0,1,1.0,1,0.2007559077402303,44
595,2,956,467,489,0,0,0,1.0,1,1.0,1,1.0,1,0.26268888149018743,43
596,3,959,470,489,0,0,0,1.0,1,1.0,1,1.0,1,0.3364728850079697,44
597,4,963,471,492,0,0,0,1.0,1,1.0,1,1.0,1,0.28092003069850546,43
598,1,964,472,492,0,0,0,1.0,1,1.0,1,1.0,1,0.2701920749500641,45
599,4,968,475,493,0,0,0,1.0,1,1.0,1,1.0,1,0.21499135217978882,44
600,1,969,475,494,0,0,0,1.0,1,1.0,1,1.0,1,0.2064846042761956,44
601,1,970,476,494,0,0,0,1.0,1,1.0,1,1.0,1,0.19898701375516198,45
602,0,970,476,494,0,0,0,1.0,1,1.0,1,1.0,1,0.21846778379849344,46
603,0,970,476,494,0,0,0,1.0,1,1.0,1,1.0,1,0.21882762811887901,46
604,0,970,476,494,0,0,0,1.0,1,1.0,1,1.0,1,0.22652506011671578,47
605,2,972,477,495,0,0,0,1.0,1,1.0,1,1.0,1,0.20932273808865878,47
606,0,972,477,495,0,0,0,1.0,1,1.0,1,1.0,1,0.21517864287846905,47
607,1,973,477,496,0,0,0,1.0,1,1.0,1,1.0,1,0.2100674649376437,48
608,1,974,477,497,0,0,0,1.0,1,1.0,1,1.0,1,0.2265251480814551,47
609,1,975,477,498,0,0,0,1.0,1,1.0,1,1.0,1,0.214816963279495,48
610,1,976,477,499,0,0,0,1.0,1,1.0,1,1.0,1,0.1981081381746588,48
611,3,979,478,501,0,0,0,1.0,1,1.0,1,1.0,1,0.14088939375101783,49
612,0,979,478,501,0,0,0,1.0,1,1.0,1,1.0,1,0.178590960594356,50
613,3,982,480,502,0,0,0,1.0,1,1.0,1,1.0,1,0.1393604210773915,50
614,0,982,480,502,0,0,0,1.0,1,1.0,1,1.0,1,0.1393604210773915,50
615,1,983,481,502,0,0,0,1.0,1,1.0,1,1.0,1,0.1507108433084555,50
616,0,983,481,502,0,0,0,1.0,1,1.0,1,1.0,1,0.1507108433084555,50
617,4,987,482,505,0,0,0,1.0,1,1.0,1,1.0,1,0.13980135483420797,52
618,0,987,482,505,0,0,0,1.0,1,1.0,1,1.0,1,0.13980135483420797,52
619,0,987,482,505,0,0,0,1.0,1,1.0,1,1.0,1,0.14203673238554637,50
620,1,988,482,506,0,0,0,1.0,1,1.0,1,1.0,1,0.1330947078266371,50
621,1,989,483,506,0,0,0,1.0,1,1.0,1,1.0,1,0.1357672663213663,49
622,1,990,483,507,0,0,0,1.0,1,1.0,1,1.0,1,0.14574621063834145,49
623,4,994,487,507,0,0,0,1.0,1,1.0,1,1.0,1,0.19210565209455413,48
624,1,995,488,507,0,0,0,1.0,1,1.0,1,1.0,1,0.2653939721910003,46
625,3,998,490,508,0,0,0,1.0,1,1.0,1,1.0,1,0.255405175603299,45
626,2,1000,492,508,0,0,0,1.0,1,1.0,1,1.0,1,0.2719718494143858,44
627,5,1005,494,511,0,0,0,1.0,1,1.0,1,1.0,1,0.19325897423949834,44
628,2,1007,496,511,0,0,0,1.0,1,1.0,1,1.0,1,0.22879779429471825,44
629,1,1008,497,511,0,0,0,1.0,1,1.0,1,1.0,1,0.19187059070506868,41
630,1,1009,498,511,0,0,0,1.0,1,1.0,1,1.0,1,0.23803316330948796,40
631,3,1012,500,512,0,0,0,1.0,1,1.0,1,1.0,1,0.2734885920989039,38
632,2,1014,502,512,0,0,0,1.0,1,1.0,1,1.0,1,0.31879256493150043,38
633,4,1018,503,515,0,0,0,1.0,1,1.0,1,1.0,1,0.28332193055882143,36
634,1,1019,503,516,0,0,0,1.0,1,1.0,1,1.0,1,0.275989799349487,35
635,1,1020,503,517,0,0,0,1.0,1,1.0,1,1.0,1,0.2488239820623825,35
636,2,1022,504,518,0,0,0,1.0,1,1.0,1,1.0,1,0.27900590075787235,36
637,2,1024,504,520,0,0,0,1.0,1,1.0,1,1.0,1,0.24201129472574115,35
638,0,1024,504,520,0,0,0,1.0,1,1.0,1,1.0,1,0.2687142746942622,34
639,1,1025,505,520,0,0,0,1.0,1,1.0,1,1.0,1,0.2503604877882305,36
640,3,1028,506,522,0,0,0,1.0,1,1.0,1,1.0,1,0.2500008131958048,37
641,2,1030,506,524,0,0,0,1.0,1,1.0,1,1.0,1,0.2010669845703391,37
642,0,1030,506,524,0,0,0,1.0,1,1.0,1,1.0,1,0.17652359846347565,38
643,1,1031,506,525,0,0,0,1.0,1,1.0,1,1.0,1,0.14970342066304457,39
644,1,1032,507,525,0,0,0,1.0,1,1.0,1,1.0,1,0.17737970864860156,39
645,1,1033,507,526,0,0,0,1.0,1,1.0,1,1.0,1,0.16719190510536314,39
646,2,1035,509,526,0,0,0,1.0,1,1.0,1,1.0,1,0.23334808653283554,40
647,1,1036,509,527,0,0,0,1.0,1,1.0,1,1.0,1,0.22732413298847223,40
648,0,1036,509,527,0,0,0,1.0,1,1.0,1,1.0,1,0.22732413298847223,40
649,0,1036,509,527,0,0,0,1.0,1,1.0,1,1.0,1,0.22732413298847223,40
650,1,1037,510,527,0,0,0,1.0,1,1.0,1,1.0,1,0.2575138201892775,41
651,3,1040,511,529,0,0,0,1.0,1,1.0,1,1.0,1,0.22598642955521667,42
652,1,1041,512,529,0,0,0,1.0,1,1.0,1,1.0,1,0.26454884695458103,41
653,2,1043,513,530,0,0,0,1.0,1,1.0,1,1.0,1,0.2385269749915327,41
654,1,1044,513,531,0,0,0,1.0,1,1.0,1,1.0,1,0.23728484337314187,42
655,0,1044,513,531,0,0,0,1.0,1,1.0,1,1.0,1,0.2387081890047311,45
656,2,1046,515,531,0,0,0,1.0,1,1.0,1,1.0,1,0.307610860793619,45
657,3,1049,515,534,0,0,0,1.0,1,1.0,1,1.0,1,0.23579695388312785,43
658,5,1054,519,535,0,0,0,1.0,1,1.0,1,1.0,1,0.3432353404978203,43
659,0,1054,519,535,0,0,0,1.0,1,1.0,1,1.0,1,0.31854403738620396,43
660,2,1056,521,535,0,0,0,1.0,1,1.0,1,1.0,1,0.3694638865577586,43
661,2,1058,522,536,0,0,0,1.0,1,1.0,1,1.0,1,0.37428939097826264,41
662,3,1061,523,538,0,0,0,1.0,1,1.0,1,1.0,1,0.3823187100663441,40
663,4,1065,525,540,0,0,0,1.0,1,1.0,1,1.0,1,0.333314932275673,39
664,3,1068,526,542,0,0,0,1.0,1,1.0,1,1.0,1,0.3213007020862027,36
665,4,1072,527,545,0,0,0,1.0,1,1.0,1,1.0,1,0.2653235762288665,36
666,2,1074,528,546,0,0,0,1.0,1,1.0,1,1.0,1,0.240292314598718,36
667,2,1076,529,547,0,0,0,1.0,1,1.0,1,1.0,1,0.2236481006676954,35
668,3,1079,532,547,0,0,0,1.0,1,1.0,1,1.0,1,0.21622127929159074,34
669,2,1081,534,547,0,0,0,1.0,1,1.0,1,1.0,1,0.24730414019091304,34
670,2,1083,535,548,0,0,0,1.0,1,1.0,1,1.0,1,0.2539540647462206,32
671,2,1085,536,549,0,0,0,1.0,1,1.0,1,1.0,1,0.24971062282281675,33
672,1,1086,536,550,0,0,0,1.0,1,1.0,1,1.0,1,0.234451329202816,32
673,1,1087,536,551,0,0,0,1.0,1,1.0,1,1.0,1,0.18943781419358088,32
674,1,1088,537,551,0,0,0,1.0,1,1.0,1,1.0,1,0.2495938511719115,32
675,2,1090,538,552,0,0,0,1.0,1,1.0,1,1.0,1,0.22902511026541128,34
676,0,1090,538,552,0,0,0,1.0,1,1.0,1,1.0,1,0.2176939218118294,35
677,1,1091,539,552,0,0,0,1.0,1,1.0,1,1.0,1,0.21638399768611877,35
678,0,1091,539,552,0,0,0,1.0,1,1.0,1,1.0,1,0.21638399768611877,35
679,3,1094,540,554,0,0,0,1.0,1,1.0,1,1.0,1,0.18510948396881857,36
680,1,1095,541,554,0,0,0,1.0,1,1.0,1,1.0,1,0.1621033999546177,37
681,0,1095,541,554,0,0,0,1.0,1,1.0,1,1.0,1,0.1621033999546177,37
682,1,1096,542,554,0,0,0,1.0,1,1.0,1,1.0,1,0.18638822977631989,37
683,1,1097,542,555,0,0,0,1.0,1,1.0,1,1.0,1,0.15334499694071702,38
684,1,1098,543,555,0,0,0,1.0,1,1.0,1,1.0,1,0.18236953921667506,39
685,0,1098,543,555,0,0,0,1.0,1,1.0,1,1.0,1,0.17253340959291313,38
686,0,1098,543,555,0,0,0,1.0,1,1.0,1,1.0,1,0.1958248392457126,37
687,3,1101,544,557,0,0,0,1.0,1,1.0,1,1.0,1,0.21908762609054822,38
688,0,1101,544,557,0,0,0,1.0,1,1.0,1,1.0,1,0.256399856129046,37
689,2,1103,546,557,0,0,0,1.0,1,1.0,1,1.0,1,0.3089130892121158,39
690,1,1104,546,558,0,0,0,1.0,1,1.0,1,1.0,1,0.27669417045002703,38
691,1,1105,547,558,0,0,0,1.0,1,1.0,1,1.0,1,0.2761986832360306,38
692,2,1107,549,558,0,0,0,1.0,1,1.0,1,1.0,1,0.3018050071171513,38
693,2,1109,551,558,0,0,0,1.0,1,1.0,1,1.0,1,0.33039923785355485,40
694,5,1114,553,561,0,0,0,1.0,1,1.0,1,1.0,1,0.3422202472008489,42
695,2,1116,553,563,0,0,0,1.0,1,1.0,1,1.0,1,0.2694094899314702,40
696,1,1117,554,563,0,0,0,1.0,1,1.0,1,1.0,1,0.2913802156712795,39
697,2,1119,554,565,0,0,0,1.0,1,1.0,1,1.0,1,0.25419087802966295,39
698,2,1121,555,566,0,0,0,1.0,1,1.0,1,1.0,1,0.21532624409885054,37
699,0,1121,555,566,0,0,0,1.0,1,1.0,1,1.0,1,0.20124623132683284,37
700,2,1123,556,567,0,0,0,1.0,1,1.0,1,1.0,1,0.21884011061893394,37
701,2,1125,558,567,0,0,0,1.0,1,1.0,1,1.0,1,0.240939199443717,37
702,1,1126,558,568,0,0,0,1.0,1,1.0,1,1.0,1,0.2292428348979415,38
703,4,1130,561,569,0,0,0,1.0,1,1.0,1,1.0,1,0.24990723939371498,36
704,3,1133,562,571,0,0,0,1.0,1,1.0,1,1.0,1,0.2145518715533639,36
705,3,1136,565,571,0,0,0,1.0,1,1.0,1,1.0,1,0.2129533351002454,36
706,4,1140,568,572,0,0,0,1.0,1,1.0,1,1.0,1,0.23576943427824923,35
707,1,1141,569,572,0,0,0,1.0,1,1.0,1,1.0,1,0.2982519541114036,36
708,2,1143,571,572,0,0,0,1.0,1,1.0,1,1.0,1,0.32118668526740923,36
709,1,1144,572,572,0,0,0,1.0,1,1.0,1,1.0,1,0.2768282425453274,34
710,0,1144,572,572,0,0,0,1.0,1,1.0,1,1.0,1,0.2768282425453274,34
711,0,1144,572,572,0,0,0,1.0,1,1.0,1,1.0,1,0.2733457965066924,34
712,4,1148,574,574,0,0,0,1.0,1,1.0,1,1.0,1,0.2789013251847693,35
713,4,1152,576,576,0,0,0,1.0,1,1.0,1,1.0,1,0.2768803661731897,34
714,0,1152,576,576,0,0,0,1.0,1,1.0,1,1.0,1,0.25663565992178344,34
715,1,1153,577,576,0,0,0,1.0,1,1.0,1,1.0,1,0.30857536604579333,35
716,1,1154,578,576,0,0,0,1.0,1,1.0,1,1.0,1,0.34266408177724716,33
717,4,1158,579,579,0,0,0,1.0,1,1.0,1,1.0,1,0.3085300267682991,33
718,1,1159,580,579,0,0,0,1.0,1,1.0,1,1.0,1,0.3087152926339711,32
719,0,1159,580,579,0,0,0,1.0,1,1.0,1,1.0,1,0.3087152926339711,32
720,2,1161,581,580,0,0,0,1.0,1,1.0,1,1.0,1,0.29589492270201173,33
721,0,1161,581,580,0,0,0,1.0,1,1.0,1,1.0,1,0.29589492270201173,33
722,2,1163,582,581,0,0,0,1.0,1,1.0,1,1.0,1,0.31499133128463525,34
723,3,1166,582,584,0,0,0,1.0,1,1.0,1,1.0,1,0.2544395184380212,34
724,1,1167,582,585,0,0,0,1.0,1,1.0,1,1.0,1,0.24901510904277863,36
725,1,1168,582,586,0,0,0,1.0,1,1.0,1,1.0,1,0.24064983643774387,36
726,0,1168,582,586,0,0,0,1.0,1,1.0,1,1.0,1,0.24064983643774387,36
727,1,1169,582,587,0,0,0,1.0,1,1.0,1,1.0,1,0.21691506212936867,36
728,0,1169,582,587,0,0,0,1.0,1,1.0,1,1.0,1,0.23218358386503773,37
729,1,1170,583,587,0,0,0,1.0,1,1.0,1,1.0,1,0.2427934395859292,37
730,1,1171,583,588,0,0,0,1.0,1,1.0,1,1.0,1,0.21370966562870022,38
731,1,1172,583,589,0,0,0,1.0,1,1.0,1,1.0,1,0.22821827498369554,39
732,1,1173,584,589,0,0,0,1.0,1,1.0,1,1.0,1,0.25476014235738,41
733,1,1174,585,589,0,0,0,1.0,1,1.0,1,1.0,1,0.22149778929513989,39
734,3,1177,587,590,0,0,0,1.0,1,1.0,1,1.0,1,0.28148577473608133,39
735,2,1179,588,591,0,0,0,1.0,1,1.0,1,1.0,1,0.29644726652631864,39
736,0,1179,588,591,0,0,0,1.0,1,1.0,1,1.0,1,0.2911423467579459,38
737,1,1180,589,591,0,0,0,1.0,1,1.0,1,1.0,1,0.3275640784688679,39
738,0,1180,589,591,0,0,0,1.0,1,1.0,1,1.0,1,0.33154336381195587,37
739,1,1181,590,591,0,0,0,1.0,1,1.0,1,1.0,1,0.36442386630614726,37
740,0,1181,590,591,0,0,0,1.0,1,1.0,1,1.0,1,0.34658762576274244,35
741,0,1181,590,591,0,0,0,1.0,1,1.0,1,1.0,1,0.3224287694338647,33
742,1,1182,591,591,0,0,0,1.0,1,1.0,1,1.0,1,0.35787243570428745,35
743,5,1187,593,594,0,0,0,1.0,1,1.0,1,1.0,1,0.3124924207955024,35
744,2,1189,595,594,0,0,0,1.0,1,1.0,1,1.0,1,0.2855407900518347,34
745,1,1190,596,594,0,0,0,1.0,1,1.0,1,1.0,1,0.3159297509201592,34
746,3,1193,598,595,0,0,0,1.0,1,1.0,1,1.0,1,0.26658092776834097,33
747,1,1194,599,595,0,0,0,1.0,1,1.0,1,1.0,1,0.24022517930354495,32
748,0,1194,599,595,0,0,0,1.0,1,1.0,1,1.0,1,0.2397226682469963,33
749,0,1194,599,595,0,0,0,1.0,1,1.0,1,1.0,1,0.2397226682469963,33
750,1,1195,600,595,0,0,0,1.0,1,1.0,1,1.0,1,0.27030147992062975,34
751,3,1198,601,597,0,0,0,1.0,1,1.0,1,1.0,1,0.26322428353373784,36
752,1,1199,602,597,0,0,0,1.0,1,1.0,1,1.0,1,0.2409907165025318,35
753,3,1202,604,598,0,0,0,1.0,1,1.0,1,1.0,1,0.2921082974608265,37
754,2,1204,606,598,0,0,0,1.0,1,1.0,1,1.0,1,0.3413667566535904,37
755,3,1207,606,601,0,0,0,1.0,1,1.0,1,1.0,1,0.2677483063135229,35
756,1,1208,607,601,0,0,0,1.0,1,1.0,1,1.0,1,0.3290758527891781,36
757,1,1209,607,602,0,0,0,1.0,1,1.0,1,1.0,1,0.30203386094799806,35
758,1,1210,607,603,0,0,0,1.0,1,1.0,1,1.0,1,0.30421235821343245,36
759,0,1210,607,603,0,0,0,1.0,1,1.0,1,1.0,1,0.3074677697340742,37
760,1,1211,607,604,0,0,0,1.0,1,1.0,1,1.0,1,0.3066722221538678,36
761,0,1211,607,604,0,0,0,1.0,1,1.0,1,1.0,1,0.3066722221538678,36
762,0,1211,607,604,0,0,0,1.0,1,1.0,1,1.0,1,0.3158940597609189,37
763,0,1211,607,604,0,0,0,1.0,1,1.0,1,1.0,1,0.3259368754335485,38
764,0,1211,607,604,0,0,0,1.0,1,1.0,1,1.0,1,0.3259368754335485,38
765,0,1211,607,604,0,0,0,1.0,1,1.0,1,1.0,1,0.3259368754335485,38
766,0,1211,607,604,0,0,0,1.0,1,1.0,1,1.0,1,0.3162380213919534,40
767,0,1211,607,604,0,0,0,1.0,1,1.0,1,1.0,1,0.3254619334911601,41
768,2,1213,608,605,0,0,0,1.0,1,1.0,1,1.0,1,0.3458028968255124,41
769,2,1215,608,607,0,0,0,1.0,1,1.0,1,1.0,1,0.3225830167748828,42
770,2,1217,609,608,0,0,0,1.0,1,1.0,1,1.0,1,0.3008206382988522,41
771,1,1218,609,609,0,0,0,1.0,1,1.0,1,1.0,1,0.3171737242696686,41
772,4,1222,611,611,0,0,0,1.0,1,1.0,1,1.0,1,0.2701965606458871,41
773,1,1223,611,612,0,0,0,1.0,1,1.0,1,1.0,1,0.24430864876101505,41
774,3,1226,613,613,0,0,0,1.0,1,1.0,1,1.0,1,0.2504806616672465,42
775,1,1227,613,614,0,0,0,1.0,1,1.0,1,1.0,1,0.23645658134148412,42
776,0,1227,613,614,0,0,0,1.0,1,1.0,1,1.0,1,0.23645658134148412,42
777,1,1228,613,615,0,0,0,1.0,1,1.0,1,1.0,1,0.23051207840109442,42
778,0,1228,613,615,0,0,0,1.0,1,1.0,1,1.0,1,0.25504558306915837,44
779,0,1228,613,615,0,0,0,1.0,1,1.0,1,1.0,1,0.25504558306915837,44
780,1,1229,614,615,0,0,0,1.0,1,1.0,1,1.0,1,0.2690557716048905,44
781,1,1230,614,616,0,0,0,1.0,1,1.0,1,1.0,1,0.25672901923361974,46
782,4,1234,616,618,0,0,0,1.0,1,1.0,1,1.0,1,0.2743930792094032,45
783,2,1236,616,620,0,0,0,1.0,1,1.0,1,1.0,1,0.272257656780789,44
784,1,1237,617,620,0,0,0,1.0,1,1.0,1,1.0,1,0.3000450385552584,44
785,2,1239,618,621,0,0,0,1.0,1,1.0,1,1.0,1,0.2537694784067149,43
786,1,1240,619,621,0,0,0,1.0,1,1.0,1,1.0,1,0.24580382948381968,43
787,0,1240,619,621,0,0,0,1.0,1,1.0,1,1.0,1,0.24580382948381968,43
788,4,1244,620,624,0,0,0,1.0,1,1.0,1,1.0,1,0.2473894159372722,45
789,3,1247,621,626,0,0,0,1.0,1,1.0,1,1.0,1,0.19738504183488104,46
790,0,1247,621,626,0,0,0,1.0,1,1.0,1,1.0,1,0.22780555981459685,45
791,1,1248,621,627,0,0,0,1.0,1,1.0,1,1.0,1,0.22764362058114038,46
792,2,1250,622,628,0,0,0,1.0,1,1.0,1,1.0,1,0.24960801224264556,46
793,4,1254,622,632,0,0,0,1.0,1,1.0,1,1.0,1,0.16473498102526868,46
794,1,1255,623,632,0,0,0,1.0,1,1.0,1,1.0,1,0.21397691690169843,47
795,1,1256,623,633,0,0,0,1.0,1,1.0,1,1.0,1,0.19914456139613243,47
796,3,1259,624,635,0,0,0,1.0,1,1.0,1,1.0,1,0.21584401691545538,46
797,4,1263,627,636,0,0,0,1.0,1,1.0,1,1.0,1,0.22785632973537845,47
798,3,1266,629,637,0,0,0,1.0,1,1.0,1,1.0,1,0.24243373886920377,48
799,4,1270,629,641,0,0,0,1.0,1,1.0,1,1.0,1,0.16369068331960654,48
800,1,1271,630,641,0,0,0,1.0,1,1.0,1,1.0,1,0.1888394634398222,48
801,2,1273,630,643,0,0,0,1.0,1,1.0,1,1.0,1,0.1849414704441995,49
802,2,1275,631,644,0,0,0,1.0,1,1.0,1,1.0,1,0.17166990695875092,50
803,0,1275,631,644,0,0,0,1.0,1,1.0,1,1.0,1,0.166268167890237,49
804,2,1277,633,644,0,0,0,1.0,1,1.0,1,1.0,1,0.1480407007998816,50
805,0,1277,633,644,0,0,0,1.0,1,1.0,1,1.0,1,0.1480407007998816,50
806,0,1277,633,644,0,0,0,1.0,1,1.0,1,1.0,1,0.1480407007998816,50
807,0,1277,633,644,0,0,0,1.0,1,1.0,1,1.0,1,0.1641788258534564,51
808,0,1277,633,644,0,0,0,1.0,1,1.0,1,1.0,1,0.1641788258534564,51
809,4,1281,634,647,0,0,0,1.0,1,1.0,1,1.0,1,0.14083450494201122,51
810,1,1282,634,648,0,0,0,1.0,1,1.0,1,1.0,1,0.1284779046377875,52
811,1,1283,635,648,0,0,0,1.0,1,1.0,1,1.0,1,0.14790593986536338,50
812,2,1285,636,649,0,0,0,1.0,1,1.0,1,1.0,1,0.15563393404168546,48
813,2,1287,638,649,0,0,0,1.0,1,1.0,1,1.0,1,0.20854804733324736,49
814,1,1288,638,650,0,0,0,1.0,1,1.0,1,1.0,1,0.20105396026350073,48
815,6,1294,641,653,0,0,0,1.0,1,1.0,1,1.0,1,0.18000468981824566,48
816,1,1295,642,653,0,0,0,1.0,1,1.0,1,1.0,1,0.2095806046841392,46
817,3,1298,642,656,0,0,0,1.0,1,1.0,1,1.0,1,0.21410958384139206,44
818,0,1298,642,656,0,0,0,1.0,1,1.0,1,1.0,1,0.20273232967062355,46
819,1,1299,642,657,0,0,0,1.0,1,1.0,1,1.0,1,0.1956230578756983,44
820,0,1299,642,657,0,0,0,1.0,1,1.0,1,1.0,1,0.22423009447051986,44
821,1,1300,642,658,0,0,0,1.0,1,1.0,1,1.0,1,0.18932546241644824,44
822,1,1301,643,658,0,0,0,1.0,1,1.0,1,1.0,1,0.22366817861440078,44
823,4,1305,644,661,0,0,0,1.0,1,1.0,1,1.0,1,0.1541559504056294,42
824,2,1307,646,661,0,0,0,1.0,1,1.0,1,1.0,1,0.1709117977528742,42
825,3,1310,648,662,0,0,0,1.0,1,1.0,1,1.0,1,0.13044380092704072,40
826,3,1313,651,662,0,0,0,1.0,1,1.0,1,1.0,1,0.14466154091313227,41
827,3,1316,654,662,0,0,0,1.0,1,1.0,1,1.0,1,0.16022736572494653,40
828,3,1319,657,662,0,0,0,1.0,1,1.0,1,1.0,1,0.13417550785913848,40
829,1,1320,658,662,0,0,0,1.0,1,1.0,1,1.0,1,0.18642136722053962,42
830,5,1325,660,665,0,0,0,1.0,1,1.0,1,1.0,1,0.1821973440001429,42
831,3,1328,662,666,0,0,0,1.0,1,1.0,1,1.0,1,0.1945420226833989,43
832,0,1328,662,666,0,0,0,1.0,1,1.0,1,1.0,1,0.18799962200312995,42
833,2,1330,662,668,0,0,0,1.0,1,1.0,1,1.0,1,0.16549818088501922,41
834,2,1332,663,669,0,0,0,1.0,1,1.0,1,1.0,1,0.1734517419973084,41
835,0,1332,663,669,0,0,0,1.0,1,1.0,1,1.0,1,0.1771356032106709,41
836,0,1332,663,669,0,0,0,1.0,1,1.0,1,1.0,1,0.18709720279421876,40
837,0,1332,663,669,0,0,0,1.0,1,1.0,1,1.0,1,0.178984939616036,41
838,2,1334,664,670,0,0,0,1.0,1,1.0,1,1.0,1,0.1979961106744954,41
839,2,1336,665,671,0,0,0,1.0,1,1.0,1,1.0,1,0.16562375371338942,41
840,3,1339,668,671,0,0,0,1.0,1,1.0,1,1.0,1,0.23052993830279092,42
841,2,1341,669,672,0,0,0,1.0,1,1.0,1,1.0,1,0.24177999143329207,42
842,2,1343,670,673,0,0,0,1.0,1,1.0,1,1.0,1,0.24849153157519696,42
843,3,1346,672,674,0,0,0,1.0,1,1.0,1,1.0,1,0.2950865020169336,42
844,1,1347,672,675,0,0,0,1.0,1,1.0,1,1.0,1,0.2997376412560631,42
845,4,1351,672,679,0,0,0,1.0,1,1.0,1,1.0,1,0.2752144503805038,44
846,1,1352,672,680,0,0,0,1.0,1,1.0,1,1.0,1,0.26059922611619685,44
847,1,1353,673,680,0,0,0,1.0,1,1.0,1,1.0,1,0.24860855540430624,42
848,1,1354,673,681,0,0,0,1.0,1,1.0,1,1.0,1,0.2426084173776516,43
849,1,1355,673,682,0,0,0,1.0,1,1.0,1,1.0,1,0.2268586054506163,43
850,3,1358,674,684,0,0,0,1.0,1,1.0,1,1.0,1,0.2486087056022072,41
851,1,1359,674,685,0,0,0,1.0,1,1.0,1,1.0,1,0.22820346750188247,40
852,1,1360,674,686,0,0,0,1.0,1,1.0,1,1.0,1,0.21357552330106183,40
853,2,1362,675,687,0,0,0,1.0,1,1.0,1,1.0,1,0.18990175220157962,40
854,1,1363,676,687,0,0,0,1.0,1,1.0,1,1.0,1,0.21044315736022867,40
855,2,1365,677,688,0,0,0,1.0,1,1.0,1,1.0,1,0.18946280780991817,41
856,1,1366,678,688,0,0,0,1.0,1,1.0,1,1.0,1,0.21190032664648073,41
857,1,1367,679,688,0,0,0,1.0,1,1.0,1,1.0,1,0.20649213499330482,42
858,2,1369,679,690,0,0,0,1.0,1,1.0,1,1.0,1,0.18159832229301778,43
859,0,1369,679,690,0,0,0,1.0,1,1.0,1,1.0,1,0.18159832229301778,43
860,0,1369,679,690,0,0,0,1.0,1,1.0,1,1.0,1,0.1887828747757718,44
861,2,1371,680,691,0,0,0,1.0,1,1.0,1,1.0,1,0.1865358369775064,44
862,1,1372,681,691,0,0,0,1.0,1,1.0,1,1.0,1,0.1919990747933563,44
863,2,1374,682,692,0,0,0,1.0,1,1.0,1,1.0,1,0.1993391332644909,44
864,2,1376,683,693,0,0,0,1.0,1,1.0,1,1.0,1,0.2074561581051146,44
865,2,1378,685,693,0,0,0,1.0,1,1.0,1,1.0,1,0.19341605916511537,43
866,5,1383,689,694,0,0,0,1.0,1,1.0,1,1.0,1,0.2945698624398004,45
867,2,1385,689,696,0,0,0,1.0,1,1.0,1,1.0,1,0.22144096489760096,44
868,2,1387,690,697,0,0,0,1.0,1,1.0,1,1.0,1,0.1836971212778674,45
869,3,1390,692,698,0,0,0,1.0,1,1.0,1,1.0,1,0.21717757912135813,44
870,2,1392,692,700,0,0,0,1.0,1,1.0,1,1.0,1,0.14919333645936284,44
871,1,1393,692,701,0,0,0,1.0,1,1.0,1,1.0,1,0.16353488101302585,43
872,0,1393,692,701,0,0,0,1.0,1,1.0,1,1.0,1,0.16353488101302585,43
873,2,1395,693,702,0,0,0,1.0,1,1.0,1,1.0,1,0.18786386486745768,43
874,4,1399,696,703,0,0,0,1.0,1,1.0,1,1.0,1,0.20994483899620756,46
875,2,1401,697,704,0,0,0,1.0,1,1.0,1,1.0,1,0.20732189474876944,43
876,4,1405,699,706,0,0,0,1.0,1,1.0,1,1.0,1,0.17970610401182358,44
877,2,1407,699,708,0,0,0,1.0,1,1.0,1,1.0,1,0.1423135636003392,44
878,1,1408,700,708,0,0,0,1.0,1,1.0,1,1.0,1,0.16699426763159295,44
879,0,1408,700,708,0,0,0,1.0,1,1.0,1,1.0,1,0.16699426763159295,44
880,4,1412,703,709,0,0,0,1.0,1,1.0,1,1.0,1,0.24140668237961468,44
881,1,1413,703,710,0,0,0,1.0,1,1.0,1,1.0,1,0.2039312445638256,43
882,1,1414,704,710,0,0,0,1.0,1,1.0,1,1.0,1,0.20380903899040476,45
883,3,1417,705,712,0,0,0,1.0,1,1.0,1,1.0,1,0.19519205560859698,45
884,1,1418,706,712,0,0,0,1.0,1,1.0,1,1.0,1,0.24028968666740685,45
885,2,1420,707,713,0,0,0,1.0,1,1.0,1,1.0,1,0.19807100486618273,43
886,2,1422,708,714,0,0,0,1.0,1,1.0,1,1.0,1,0.25691004982480176,43
887,2,1424,709,715,0,0,0,1.0,1,1.0,1,1.0,1,0.2101685035211608,41
888,0,1424,709,715,0,0,0,1.0,1,1.0,1,1.0,1,0.23834105461926805,40
889,4,1428,711,717,0,0,0,1.0,1,1.0,1,1.0,1,0.2322461748225046,40
890,1,1429,712,717,0,0,0,1.0,1,1.0,1,1.0,1,0.19834706150316833,38
891,1,1430,713,717,0,0,0,1.0,1,1.0,1,1.0,1,0.19022838277839596,39
892,2,1432,715,717,0,0,0,1.0,1,1.0,1,1.0,1,0.250289340616231,39
893,2,1434,716,718,0,0,0,1.0,1,1.0,1,1.0,1,0.18880250101537688,37
894,1,1435,717,718,0,0,0,1.0,1,1.0,1,1.0,1,0.19546341031748507,36
895,1,1436,717,719,0,0,0,1.0,1,1.0,1,1.0,1,0.20099033038170458,37
896,2,1438,719,719,0,0,0,1.0,1,1.0,1,1.0,1,0.21543022674720194,36
897,2,1440,721,719,0,0,0,1.0,1,1.0,1,1.0,1,0.21730775274290573,36
898,0,1440,721,719,0,0,0,1.0,1,1.0,1,1.0,1,0.22785999954276367,35
899,1,1441,722,719,0,0,0,1.0,1,1.0,1,1.0,1,0.2465017133812091,35
900,1,1442,723,719,0,0,0,1.0,1,1.0,1,1.0,1,0.2872740457844923,36
901,2,1444,724,720,0,0,0,1.0,1,1.0,1,1.0,1,0.28070004052098974,36
902,2,1446,726,720,0,0,0,1.0,1,1.0,1,1.0,1,0.34225133510498207,36
903,2,1448,727,721,0,0,0,1.0,1,1.0,1,1.0,1,0.31855861526828205,35
904,4,1452,730,722,0,0,0,1.0,1,1.0,1,1.0,1,0.3132529437495048,37
905,2,1454,732,722,0,0,0,1.0,1,1.0,1,1.0,1,0.3462871625557157,36
906,3,1457,732,725,0,0,0,1.0,1,1.0,1,1.0,1,0.25886560355875937,37
907,2,1459,734,725,0,0,0,1.0,1,1.0,1,1.0,1,0.26558690011346664,37
908,0,1459,734,725,0,0,0,1.0,1,1.0,1,1.0,1,0.26397070900849007,36
909,3,1462,734,728,0,0,0,1.0,1,1.0,1,1.0,1,0.19989001706672987,36
910,1,1463,735,728,0,0,0,1.0,1,1.0,1,1.0,1,0.20884664818120274,37
911,2,1465,736,729,0,0,0,1.0,1,1.0,1,1.0,1,0.2780760592269323,36
912,1,1466,737,729,0,0,0,1.0,1,1.0,1,1.0,1,0.26806687363735765,34
913,3,1469,738,731,0,0,0,1.0,1,1.0,1,1.0,1,0.2188854800175995,34
914,0,1469,738,731,0,0,0,1.0,1,1.0,1,1.0,1,0.24912709317009035,33
915,2,1471,738,733,0,0,0,1.0,1,1.0,1,1.0,1,0.20252221800302822,33
916,2,1473,739,734,0,0,0,1.0,1,1.0,1,1.0,1,0.1905738773240122,34
917,0,1473,739,734,0,0,0,1.0,1,1.0,1,1.0,1,0.1905738773240122,34
918,1,1474,740,734,0,0,0,1.0,1,1.0,1,1.0,1,0.19567238041176468,36
919,0,1474,740,734,0,0,0,1.0,1,1.0,1,1.0,1,0.19567238041176468,36
920,1,1475,741,734,0,0,0,1.0,1,1.0,1,1.0,1,0.20805848396264093,37
921,0,1475,741,734,0,0,0,1.0,1,1.0,1,1.0,1,0.20805848396264093,37
922,2,1477,742,735,0,0,0,1.0,1,1.0,1,1.0,1,0.18646579748470893,38
923,1,1478,743,735,0,0,0,1.0,1,1.0,1,1.0,1,0.18808152969252312,36
924,1,1479,744,735,0,0,0,1.0,1,1.0,1,1.0,1,0.1795795524835246,35
925,5,1484,746,738,0,0,0,1.0,1,1.0,1,1.0,1,0.26598942146585314,35
926,2,1486,747,739,0,0,0,1.0,1,1.0,1,1.0,1,0.24872178979805637,34
927,3,1489,748,741,0,0,0,1.0,1,1.0,1,1.0,1,0.20427960422306957,32
928,1,1490,748,742,0,0,0,1.0,1,1.0,1,1.0,1,0.21771427328020063,32
929,0,1490,748,742,0,0,0,1.0,1,1.0,1,1.0,1,0.24077878435482467,31
930,0,1490,748,742,0,0,0,1.0,1,1.0,1,1.0,1,0.2572296676905132,30
931,3,1493,749,744,0,0,0,1.0,1,1.0,1,1.0,1,0.2195399990157243,29
932,1,1494,750,744,0,0,0,1.0,1,1.0,1,1.0,1,0.1919031484440977,29
933,0,1494,750,744,0,0,0,1.0,1,1.0,1,1.0,1,0.1919031484440977,29
934,1,1495,751,744,0,0,0,1.0,1,1.0,1,1.0,1,0.19010928274795633,29
935,0,1495,751,744,0,0,0,1.0,1,1.0,1,1.0,1,0.16454389260281316,31
936,2,1497,752,745,0,0,0,1.0,1,1.0,1,1.0,1,0.17381974446839216,31
937,1,1498,753,745,0,0,0,1.0,1,1.0,1,1.0,1,0.18038548055887998,34
938,0,1498,753,745,0,0,0,1.0,1,1.0,1,1.0,1,0.18643418106038454,33
939,1,1499,753,746,0,0,0,1.0,1,1.0,1,1.0,1,0.22922773109705408,36
940,0,1499,753,746,0,0,0,1.0,1,1.0,1,1.0,1,0.22741041040802432,36
941,2,1501,755,746,0,0,0,1.0,1,1.0,1,1.0,1,0.2821479503692064,36
942,3,1504,757,747,0,0,0,1.0,1,1.0,1,1.0,1,0.2888232464118653,36
943,4,1508,759,749,0,0,0,1.0,1,1.0,1,1.0,1,0.2183275027302733,35
944,1,1509,760,749,0,0,0,1.0,1,1.0,1,1.0,1,0.21158416988984063,35
945,1,1510,761,749,0,0,0,1.0,1,1.0,1,1.0,1,0.18165310456784,33
946,1,1511,762,749,0,0,0,1.0,1,1.0,1,1.0,1,0.23218288536112097,36
947,0,1511,762,749,0,0,0,1.0,1,1.0,1,1.0,1,0.22943893813545574,34
948,2,1513,764,749,0,0,0,1.0,1,1.0,1,1.0,1,0.29066943807883283,33
949,3,1516,765,751,0,0,0,1.0,1,1.0,1,1.0,1,0.3344784259996038,34
950,0,1516,765,751,0,0,0,1.0,1,1.0,1,1.0,1,0.34894447717814714,33
951,0,1516,765,751,0,0,0,1.0,1,1.0,1,1.0,1,0.34894447717814714,33
952,0,1516,765,751,0,0,0,1.0,1,1.0,1,1.0,1,0.3612347694763642,32
953,0,1516,765,751,0,0,0,1.0,1,1.0,1,1.0,1,0.3612347694763642,32
954,1,1517,766,751,0,0,0,1.0,1,1.0,1,1.0,1,0.35312121818913744,31
955,0,1517,766,751,0,0,0,1.0,1,1.0,1,1.0,1,0.3724680372953746,32
956,1,1518,767,751,0,0,0,1.0,1,1.0,1,1.0,1,0.33584546468752785,32
957,2,1520,767,753,0,0,0,1.0,1,1.0,1,1.0,1,0.290620219422544,33
958,0,1520,767,753,0,0,0,1.0,1,1.0,1,1.0,1,0.28332667589416993,35
959,2,1522,768,754,0,0,0,1.0,1,1.0,1,1.0,1,0.2657036467987907,36
960,1,1523,768,755,0,0,0,1.0,1,1.0,1,1.0,1,0.27765911169699103,38
961,4,1527,770,757,0,0,0,1.0,1,1.0,1,1.0,1,0.3365929053358833,37
962,4,1531,773,758,0,0,0,1.0,1,1.0,1,1.0,1,0.3177917686960629,35
963,0,1531,773,758,0,0,0,1.0,1,1.0,1,1.0,1,0.31214791428098587,35
964,0,1531,773,758,0,0,0,1.0,1,1.0,1,1.0,1,0.3315428438708782,34
965,1,1532,773,759,0,0,0,1.0,1,1.0,1,1.0,1,0.31091207265470894,35
966,2,1534,774,760,0,0,0,1.0,1,1.0,1,1.0,1,0.28922155127293786,34
967,2,1536,775,761,0,0,0,1.0,1,1.0,1,1.0,1,0.3044109036057085,35
968,2,1538,776,762,0,0,0,1.0,1,1.0,1,1.0,1,0.26425403617900795,36
969,0,1538,776,762,0,0,0,1.0,1,1.0,1,1.0,1,0.2459895477405132,35
970,0,1538,776,762,0,0,0,1.0,1,1.0,1,1.0,1,0.28126292232759587,34
971,0,1538,776,762,0,0,0,1.0,1,1.0,1,1.0,1,0.27962040598191606,35
972,3,1541,778,763,0,0,0,1.0,1,1.0,1,1.0,1,0.2830931996167101,35
973,2,1543,778,765,0,0,0,1.0,1,1.0,1,1.0,1,0.2699797511657981,36
974,1,1544,779,765,0,0,0,1.0,1,1.0,1,1.0,1,0.29606519207949483,35
975,0,1544,779,765,0,0,0,1.0,1,1.0,1,1.0,1,0.2833855385441731,36
976,1,1545,779,766,0,0,0,1.0,1,1.0,1,1.0,1,0.26727572833617774,38
977,0,1545,779,766,0,0,0,1.0,1,1.0,1,1.0,1,0.26727572833617774,38
978,0,1545,779,766,0,0,0,1.0,1,1.0,1,1.0,1,0.26727572833617774,38
979,0,1545,779,766,0,0,0,1.0,1,1.0,1,1.0,1,0.2769898909423303,39
980,3,1548,781,767,0,0,0,1.0,1,1.0,1,1.0,1,0.2980058704777279,39
981,2,1550,782,768,0,0,0,1.0,1,1.0,1,1.0,1,0.2829904371580249,40
982,4,1554,785,769,0,0,0,1.0,1,1.0,1,1.0,1,0.34805832670858367,40
983,2,1556,785,771,0,0,0,1.0,1,1.0,1,1.0,1,0.2966987461169271,38
984,4,1560,787,773,0,0,0,1.0,1,1.0,1,1.0,1,0.30587247574932963,39
985,4,1564,790,774,0,0,0,1.0,1,1.0,1,1.0,1,0.32841923342651735,38
986,3,1567,792,775,0,0,0,1.0,1,1.0,1,1.0,1,0.3777454348146269,38
987,3,1570,794,776,0,0,0,1.0,1,1.0,1,1.0,1,0.3563346673776505,38
988,0,1570,794,776,0,0,0,1.0,1,1.0,1,1.0,1,0.3563346673776505,38
989,2,1572,794,778,0,0,0,1.0,1,1.0,1,1.0,1,0.31694753194639036,38
990,0,1572,794,778,0,0,0,1.0,1,1.0,1,1.0,1,0.31694753194639036,38
991,3,1575,794,781,0,0,0,1.0,1,1.0,1,1.0,1,0.26298035834964395,40
992,1,1576,795,781,0,0,0,1.0,1,1.0,1,1.0,1,0.2905073181074004,39
993,1,1577,796,781,0,0,0,1.0,1,1.0,1,1.0,1,0.29440524852451766,38
994,1,1578,796,782,0,0,0,1.0,1,1.0,1,1.0,1,0.29303667867410543,39
995,0,1578,796,782,0,0,0,1.0,1,1.0,1,1.0,1,0.29245992868654397,41
996,0,1578,796,782,0,0,0,1.0,1,1.0,1,1.0,1,0.2985177969559846,40
997,1,1579,796,783,0,0,0,1.0,1,1.0,1,1.0,1,0.3061227139127372,41
998,0,1579,796,783,0,0,0,1.0,1,1.0,1,1.0,1,0.3307217895045165,40
999,0,1579,796,783,0,0,0,1.0,1,1.0,1,1.0,1,0.36947892262449256,40
1000,0,1579,796,783,0,0,0,1.0,1,1.0,1,1.0,1,0.36947892262449256,40
1001,1,1580,796,784,0,0,0,1.0,1,1.0,1,1.0,1,0.3524508505133269,39
1002,0,1580,796,784,0,0,0,1.0,1,1.0,1,1.0,1,0.3524508505133269,39
1003,0,1580,796,784,0,0,0,1.0,1,1.0,1,1.0,1,0.3524508505133269,39
1004,0,1580,796,784,0,0,0,1.0,1,1.0,1,1.0,1,0.3524508505133269,39
1005,0,1580,796,784,0,0,0,1.0,1,1.0,1,1.0,1,0.35919508125153476,40
1006,0,1580,796,784,0,0,0,1.0,1,1.0,1,1.0,1,0.34824695868911343,41
1007,1,1581,796,785,0,0,0,1.0,1,1.0,1,1.0,1,0.34428081539179006,42
1008,3,1584,796,788,0,0,0,1.0,1,1.0,1,1.0,1,0.29450092252674664,43
1009,2,1586,796,790,0,0,0,1.0,1,1.0,1,1.0,1,0.27425741667284864,44
1010,1,1587,797,790,0,0,0,1.0,1,1.0,1,1.0,1,0.2631959212145953,44
1011,0,1587,797,790,0,0,0,1.0,1,1.0,1,1.0,1,0.2631959212145953,44
1012,3,1590,800,790,0,0,0,1.0,1,1.0,1,1.0,1,0.2838714364057882,46
1013,2,1592,800,792,0,0,0,1.0,1,1.0,1,1.0,1,0.2529122575821413,46
1014,1,1593,801,792,0,0,0,1.0,1,1.0,1,1.0,1,0.27434142058884137,46
1015,0,1593,801,792,0,0,0,1.0,1,1.0,1,1.0,1,0.27434142058884137,46
1016,1,1594,802,792,0,0,0,1.0,1,1.0,1,1.0,1,0.29087553786309756,47
1017,2,1596,802,794,0,0,0,1.0,1,1.0,1,1.0,1,0.26449114908211285,47
1018,4,1600,803,797,0,0,0,1.0,1,1.0,1,1.0,1,0.23179029830001105,48
1019,4,1604,804,800,0,0,0,1.0,1,1.0,1,1.0,1,0.1971350748704661,49
1020,1,1605,804,801,0,0,0,1.0,1,1.0,1,1.0,1,0.1818108253357895,51
1021,0,1605,804,801,0,0,0,1.0,1,1.0,1,1.0,1,0.1818108253357895,51
1022,1,1606,805,801,0,0,0,1.0,1,1.0,1,1.0,1,0.18631764975481252,52
1023,2,1608,805,803,0,0,0,1.0,1,1.0,1,1.0,1,0.1485531550195768,52
1024,1,1609,806,803,0,0,0,1.0,1,1.0,1,1.0,1,0.16193685357632012,52
1025,1,1610,806,804,0,0,0,1.0,1,1.0,1,1.0,1,0.17059464648426167,54
1026,1,1611,806,805,0,0,0,1.0,1,1.0,1,1.0,1,0.14601378723266725,54
1027,0,1611,806,805,0,0,0,1.0,1,1.0,1,1.0,1,0.14421455046574438,55
1028,2,1613,807,806,0,0,0,1.0,1,1.0,1,1.0,1,0.16783606632536144,56
1029,2,1615,807,808,0,0,0,1.0,1,1.0,1,1.0,1,0.12865216153092374,56
1030,0,1615,807,808,0,0,0,1.0,1,1.0,1,1.0,1,0.14366259651993724,57
1031,0,1615,807,808,0,0,0,1.0,1,1.0,1,1.0,1,0.1539308555059402,58
1032,2,1617,809,808,0,0,0,1.0,1,1.0,1,1.0,1,0.17470209645904375,58
1033,0,1617,809,808,0,0,0,1.0,1,1.0,1,1.0,1,0.16664868993526835,57
1034,3,1620,812,808,0,0,0,1.0,1,1.0,1,1.0,1,0.18458155490822625,57
1035,5,1625,814,811,0,0,0,1.0,1,1.0,1,1.0,1,0.19131590203679213,57
1036,1,1626,815,811,0,0,0,1.0,1,1.0,1,1.0,1,0.20277426126090253,59
1037,2,1628,817,811,0,0,0,1.0,1,1.0,1,1.0,1,0.2360712997580811,57
1038,7,1635,820,815,0,0,0,1.0,1,1.0,1,1.0,1,0.2558628681121127,59
1039,6,1641,824,817,0,0,0,1.0,1,1.0,1,1.0,1,0.2335142028263707,57
1040,1,1642,824,818,0,0,0,1.0,1,1.0,1,1.0,1,0.2717958165641458,56
1041,3,1645,825,820,0,0,0,1.0,1,1.0,1,1.0,1,0.2613414222979611,54
1042,1,1646,826,820,0,0,0,1.0,1,1.0,1,1.0,1,0.21900430229016768,52
1043,4,1650,827,823,0,0,0,1.0,1,1.0,1,1.0,1,0.1726921030072676,52
1044,0,1650,827,823,0,0,0,1.0,1,1.0,1,1.0,1,0.17543738469861753,50
1045,3,1653,828,825,0,0,0,1.0,1,1.0,1,1.0,1,0.1702506661049069,51
1046,2,1655,829,826,0,0,0,1.0,1,1.0,1,1.0,1,0.16434514687778193,50
1047,0,1655,829,826,0,0,0,1.0,1,1.0,1,1.0,1,0.13451213542074608,50
1048,1,1656,830,826,0,0,0,1.0,1,1.0,1,1.0,1,0.16714567198062813,50
1049,1,1657,831,826,0,0,0,1.0,1,1.0,1,1.0,1,0.19751165621537664,50
1050,0,1657,831,826,0,0,0,1.0,1,1.0,1,1.0,1,0.19751165621537664,50
1051,0,1657,831,826,0,0,0,1.0,1,1.0,1,1.0,1,0.19280218987990616,50
1052,1,1658,832,826,0,0,0,1.0,1,1.0,1,1.0,1,0.1974124111943544,51
1053,0,1658,832,826,0,0,0,1.0,1,1.0,1,1.0,1,0.1974124111943544,51
1054,1,1659,832,827,0,0,0,1.0,1,1.0,1,1.0,1,0.18050063528778598,53
1055,2,1661,832,829,0,0,0,1.0,1,1.0,1,1.0,1,0.1703060365600032,54
1056,1,1662,832,830,0,0,0,1.0,1,1.0,1,1.0,1,0.1834906359472425,54
1057,3,1665,833,832,0,0,0,1.0,1,1.0,1,1.0,1,0.1786051370237044,55
1058,0,1665,833,832,0,0,0,1.0,1,1.0,1,1.0,1,0.18927868090073918,54
1059,3,1668,835,833,0,0,0,1.0,1,1.0,1,1.0,1,0.24169923887913075,53
1060,1,1669,835,834,0,0,0,1.0,1,1.0,1,1.0,1,0.22577284131936173,53
1061,3,1672,837,835,0,0,0,1.0,1,1.0,1,1.0,1,0.21360859817596425,53
1062,6,1678,842,836,0,0,0,1.0,1,1.0,1,1.0,1,0.21962857493381838,54
1063,2,1680,842,838,0,0,0,1.0,1,1.0,1,1.0,1,0.20419880912642444,53
1064,4,1684,845,839,0,0,0,1.0,1,1.0,1,1.0,1,0.20766934437802298,55
1065,4,1688,845,843,0,0,0,1.0,1,1.0,1,1.0,1,0.19504648465297802,54
1066,2,1690,845,845,0,0,0,1.0,1,1.0,1,1.0,1,0.1906647804170509,55
1067,3,1693,846,847,0,0,0,1.0,1,1.0,1,1.0,1,0.18395057351268143,55
1068,1,1694,846,848,0,0,0,1.0,1,1.0,1,1.0,1,0.19238763360381753,55
1069,1,1695,847,848,0,0,0,1.0,1,1.0,1,1.0,1,0.2142883670154251,55
1070,0,1695,847,848,0,0,0,1.0,1,1.0,1,1.0,1,0.23024583730902035,54
1071,0,1695,847,848,0,0,0,1.0,1,1.0,1,1.0,1,0.2152215938757362,55
1072,1,1696,848,848,0,0,0,1.0,1,1.0,1,1.0,1,0.1993873369420235,54
1073,1,1697,848,849,0,0,0,1.0,1,1.0,1,1.0,1,0.17371144733863148,54
1074,2,1699,849,850,0,0,0,1.0,1,1.0,1,1.0,1,0.16937524994021672,52
1075,1,1700,849,851,0,0,0,1.0,1,1.0,1,1.0,1,0.16375054731446045,51
1076,1,1701,849,852,0,0,0,1.0,1,1.0,1,1.0,1,0.1733877606605368,52
1077,3,1704,851,853,0,0,0,1.0,1,1.0,1,1.0,1,0.17880604392675625,49
1078,5,1709,855,854,0,0,0,1.0,1,1.0,1,1.0,1,0.23516212135545256,48
1079,5,1714,857,857,0,0,0,1.0,1,1.0,1,1.0,1,0.2210595077435112,47
1080,2,1716,859,857,0,0,0,1.0,1,1.0,1,1.0,1,0.29661318768542627,47
1081,1,1717,860,857,0,0,0,1.0,1,1.0,1,1.0,1,0.33415001375328635,45
1082,0,1717,860,857,0,0,0,1.0,1,1.0,1,1.0,1,0.32792915264512107,42
1083,1,1718,861,857,0,0,0,1.0,1,1.0,1,1.0,1,0.36695865149265006,42
1084,0,1718,861,857,0,0,0,1.0,1,1.0,1,1.0,1,0.36432030686368133,40
1085,1,1719,861,858,0,0,0,1.0,1,1.0,1,1.0,1,0.32915196905466904,43
1086,1,1720,862,858,0,0,0,1.0,1,1.0,1,1.0,1,0.3381729139109752,41
1087,3,1723,863,860,0,0,0,1.0,1,1.0,1,1.0,1,0.31236468266044176,41
1088,0,1723,863,860,0,0,0,1.0,1,1.0,1,1.0,1,0.31236468266044176,41
1089,3,1726,865,861,0,0,0,1.0,1,1.0,1,1.0,1,0.29051018915589616,42
1090,3,1729,865,864,0,0,0,1.0,1,1.0,1,1.0,1,0.23973443125982083,43
1091,3,1732,866,866,0,0,0,1.0,1,1.0,1,1.0,1,0.24000610223319432,43
1092,1,1733,866,867,0,0,0,1.0,1,1.0,1,1.0,1,0.21704693460376037,43
1093,1,1734,867,867,0,0,0,1.0,1,1.0,1,1.0,1,0.20363673054671452,43
1094,0,1734,867,867,0,0,0,1.0,1,1.0,1,1.0,1,0.20363673054671452,43
1095,0,1734,867,867,0,0,0,1.0,1,1.0,1,1.0,1,0.21889842011124808,44
1096,0,1734,867,867,0,0,0,1.0,1,1.0,1,1.0,1,0.21889842011124808,44
1097,2,1736,868,868,0,0,0,1.0,1,1.0,1,1.0,1,0.2639114331875492,45
1098,1,1737,868,869,0,0,0,1.0,1,1.0,1,1.0,1,0.23795886845924916,46
1099,1,1738,868,870,0,0,0,1.0,1,1.0,1,1.0,1,0.23576510428971237,48
1100,0,1738,868,870,0,0,0,1.0,1,1.0,1,1.0,1,0.23551923266244454,49
1101,2,1740,868,872,0,0,0,1.0,1,1.0,1,1.0,1,0.17516348853198654,49
1102,3,1743,870,873,0,0,0,1.0,1,1.0,1,1.0,1,0.17228098502999584,50
1103,2,1745,871,874,0,0,0,1.0,1,1.0,1,1.0,1,0.14469977089276853,48
1104,3,1748,874,874,0,0,0,1.0,1,1.0,1,1.0,1,0.15410383057605678,50
1105,5,1753,878,875,0,0,0,1.0,1,1.0,1,1.0,1,0.171981509588214,48
1106,1,1754,878,876,0,0,0,1.0,1,1.0,1,1.0,1,0.16738941037362268,48
1107,3,1757,879,878,0,0,0,1.0,1,1.0,1,1.0,1,0.15295373863096434,47
1108,1,1758,880,878,0,0,0,1.0,1,1.0,1,1.0,1,0.17815179136509282,47
1109,1,1759,881,878,0,0,0,1.0,1,1.0,1,1.0,1,0.17163618123144123,46
1110,1,1760,882,878,0,0,0,1.0,1,1.0,1,1.0,1,0.20610743796742673,43
1111,3,1763,884,879,0,0,0,1.0,1,1.0,1,1.0,1,0.2365792139003146,44
1112,5,1768,887,881,0,0,0,1.0,1,1.0,1,1.0,1,0.2803365310324728,43
1113,4,1772,888,884,0,0,0,1.0,1,1.0,1,1.0,1,0.2596751771151691,39
1114,2,1774,889,885,0,0,0,1.0,1,1.0,1,1.0,1,0.28862038937598145,39
1115,1,1775,890,885,0,0,0,1.0,1,1.0,1,1.0,1,0.2957624169257858,37
1116,2,1777,891,886,0,0,0,1.0,1,1.0,1,1.0,1,0.249226312901307,37
1117,4,1781,894,887,0,0,0,1.0,1,1.0,1,1.0,1,0.2604131813923863,36
1118,0,1781,894,887,0,0,0,1.0,1,1.0,1,1.0,1,0.26120322817424074,36
1119,0,1781,894,887,0,0,0,1.0,1,1.0,1,1.0,1,0.26120322817424074,36
1120,0,1781,894,887,0,0,0,1.0,1,1.0,1,1.0,1,0.26120322817424074,36
1121,0,1781,894,887,0,0,0,1.0,1,1.0,1,1.0,1,0.26120322817424074,36
1122,0,1781,894,887,0,0,0,1.0,1,1.0,1,1.0,1,0.254067652921252,37
1123,0,1781,894,887,0,0,0,1.0,1,1.0,1,1.0,1,0.254067652921252,37
1124,0,1781,894,887,0,0,0,1.0,1,1.0,1,1.0,1,0.254067652921252,37
1125,3,1784,896,888,0,0,0,1.0,1,1.0,1,1.0,1,0.2933553841932678,38
1126,2,1786,897,889,0,0,0,1.0,1,1.0,1,1.0,1,0.2929470663978456,38
1127,3,1789,898,891,0,0,0,1.0,1,1.0,1,1.0,1,0.3179398962787459,39
1128,0,1789,898,891,0,0,0,1.0,1,1.0,1,1.0,1,0.3179398962787459,39
1129,1,1790,898,892,0,0,0,1.0,1,1.0,1,1.0,1,0.3042498025133245,39
1130,2,1792,899,893,0,0,0,1.0,1,1.0,1,1.0,1,0.3018717395343346,39
1131,2,1794,900,894,0,0,0,1.0,1,1.0,1,1.0,1,0.25461554862210567,39
1132,1,1795,901,894,0,0,0,1.0,1,1.0,1,1.0,1,0.27453221357715535,39
1133,1,1796,901,895,0,0,0,1.0,1,1.0,1,1.0,1,0.2512571791918883,42
1134,0,1796,901,895,0,0,0,1.0,1,1.0,1,1.0,1,0.2512571791918883,42
1135,2,1798,902,896,0,0,0,1.0,1,1.0,1,1.0,1,0.3259669982246806,44
1136,6,1804,903,901,0,0,0,1.0,1,1.0,1,1.0,1,0.27915833879923835,46
1137,1,1805,903,902,0,0,0,1.0,1,1.0,1,1.0,1,0.25697727365826245,45
1138,2,1807,905,902,0,0,0,1.0,1,1.0,1,1.0,1,0.30249996238279725,46
1139,3,1810,905,905,0,0,0,1.0,1,1.0,1,1.0,1,0.26968770810914316,47
1140,1,1811,905,906,0,0,0,1.0,1,1.0,1,1.0,1,0.25505880811855325,46
1141,2,1813,905,908,0,0,0,1.0,1,1.0,1,1.0,1,0.23315677543765662,45
1142,0,1813,905,908,0,0,0,1.0,1,1.0,1,1.0,1,0.23315677543765662,45
1143,2,1815,907,908,0,0,0,1.0,1,1.0,1,1.0,1,0.2584485334387602,43
1144,4,1819,910,909,0,0,0,1.0,1,1.0,1,1.0,1,0.20912373190676237,45
1145,3,1822,912,910,0,0,0,1.0,1,1.0,1,1.0,1,0.21197511158986224,44
1146,3,1825,913,912,0,0,0,1.0,1,1.0,1,1.0,1,0.1861422736590276,45
1147,3,1828,915,913,0,0,0,1.0,1,1.0,1,1.0,1,0.20993483763082696,44
1148,3,1831,918,913,0,0,0,1.0,1,1.0,1,1.0,1,0.23989620989792457,43
1149,5,1836,919,917,0,0,0,1.0,1,1.0,1,1.0,1,0.19688798967016302,42
1150,3,1839,920,919,0,0,0,1.0,1,1.0,1,1.0,1,0.20193278237808773,45
1151,0,1839,920,919,0,0,0,1.0,1,1.0,1,1.0,1,0.21908544715649136,40
1152,1,1840,921,919,0,0,0,1.0,1,1.0,1,1.0,1,0.20192028822030889,41
1153,4,1844,923,921,0,0,0,1.0,1,1.0,1,1.0,1,0.1830590406269899,38
1154,1,1845,924,921,0,0,0,1.0,1,1.0,1,1.0,1,0.15726652621126155,37
1155,2,1847,926,921,0,0,0,1.0,1,1.0,1,1.0,1,0.21870599898152743,38
1156,1,1848,926,922,0,0,0,1.0,1,1.0,1,1.0,1,0.2494184265938333,38
1157,0,1848,926,922,0,0,0,1.0,1,1.0,1,1.0,1,0.2372938013637275,37
1158,0,1848,926,922,0,0,0,1.0,1,1.0,1,1.0,1,0.2694064826628351,36
1159,0,1848,926,922,0,0,0,1.0,1,1.0,1,1.0,1,0.26961331157322804,35
1160,0,1848,926,922,0,0,0,1.0,1,1.0,1,1.0,1,0.26961331157322804,35
1161,0,1848,926,922,0,0,0,1.0,1,1.0,1,1.0,1,0.26951027075540235,36
1162,0,1848,926,922,0,0,0,1.0,1,1.0,1,1.0,1,0.270992238102822,37
1163,0,1848,926,922,0,0,0,1.0,1,1.0,1,1.0,1,0.270992238102822,37
1164,0,1848,926,922,0,0,0,1.0,1,1.0,1,1.0,1,0.25977286857685705,38
1165,1,1849,926,923,0,0,0,1.0,1,1.0,1,1.0,1,0.246900710153915,38
1166,0,1849,926,923,0,0,0,1.0,1,1.0,1,1.0,1,0.2764644888340107,40
1167,2,1851,928,923,0,0,0,1.0,1,1.0,1,1.0,1,0.28413237632680827,40
1168,2,1853,930,923,0,0,0,1.0,1,1.0,1,1.0,1,0.2841011665602284,40
1169,3,1856,930,926,0,0,0,1.0,1,1.0,1,1.0,1,0.25242990648239455,41
1170,3,1859,932,927,0,0,0,1.0,1,1.0,1,1.0,1,0.2636521273507965,41
1171,3,1862,933,929,0,0,0,1.0,1,1.0,1,1.0,1,0.24106201065795677,43
1172,1,1863,934,929,0,0,0,1.0,1,1.0,1,1.0,1,0.2545372435788124,43
1173,1,1864,934,930,0,0,0,1.0,1,1.0,1,1.0,1,0.2451016474988891,43
1174,0,1864,934,930,0,0,0,1.0,1,1.0,1,1.0,1,0.2451016474988891,43
1175,0,1864,934,930,0,0,0,1.0,1,1.0,1,1.0,1,0.25842725458730126,44
1176,3,1867,935,932,0,0,0,1.0,1,1.0,1,1.0,1,0.2380783315524957,45
1177,2,1869,936,933,0,0,0,1.0,1,1.0,1,1.0,1,0.20955353666673943,45
1178,0,1869,936,933,0,0,0,1.0,1,1.0,1,1.0,1,0.20955353666673943,45
1179,1,1870,936,934,0,0,0,1.0,1,1.0,1,1.0,1,0.22465298658562133,46
1180,0,1870,936,934,0,0,0,1.0,1,1.0,1,1.0,1,0.20589919540943477,47
1181,0,1870,936,934,0,0,0,1.0,1,1.0,1,1.0,1,0.2209616937235522,48
1182,1,1871,937,934,0,0,0,1.0,1,1.0,1,1.0,1,0.2263155084165808,48
1183,0,1871,937,934,0,0,0,1.0,1,1.0,1,1.0,1,0.23427342560623887,46
1184,2,1873,939,934,0,0,0,1.0,1,1.0,1,1.0,1,0.24956668300981508,47
1185,3,1876,940,936,0,0,0,1.0,1,1.0,1,1.0,1,0.24254908156968205,44
1186,1,1877,940,937,0,0,0,1.0,1,1.0,1,1.0,1,0.24808660401272117,47
1187,5,1882,941,941,0,0,0,1.0,1,1.0,1,1.0,1,0.24953839570618783,49
1188,0,1882,941,941,0,0,0,1.0,1,1.0,1,1.0,1,0.24817520536749835,50
1189,1,1883,941,942,0,0,0,1.0,1,1.0,1,1.0,1,0.23272947408071634,48
1190,3,1886,942,944,0,0,0,1.0,1,1.0,1,1.0,1,0.2538892037142797,48
1191,2,1888,942,946,0,0,0,1.0,1,1.0,1,1.0,1,0.23754913169253739,46
1192,0,1888,942,946,0,0,0,1.0,1,1.0,1,1.0,1,0.23754913169253739,46
1193,0,1888,942,946,0,0,0,1.0,1,1.0,1,1.0,1,0.24897753720752838,45
1194,0,1888,942,946,0,0,0,1.0,1,1.0,1,1.0,1,0.24897753720752838,45
1195,1,1889,943,946,0,0,0,1.0,1,1.0,1,1.0,1,0.21275335670916318,47
1196,3,1892,944,948,0,0,0,1.0,1,1.0,1,1.0,1,0.18906570831442257,48
1197,1,1893,944,949,0,0,0,1.0,1,1.0,1,1.0,1,0.1640478323007435,49
1198,2,1895,945,950,0,0,0,1.0,1,1.0,1,1.0,1,0.16492583095710547,49
1199,2,1897,945,952,0,0,0,1.0,1,1.0,1,1.0,1,0.14350544052779937,50
1200,1,1898,946,952,0,0,0,1.0,1,1.0,1,1.0,1,0.15386894767105636,50
1201,0,1898,946,952,0,0,0,1.0,1,1.0,1,1.0,1,0.15386894767105636,50
1202,1,1899,947,952,0,0,0,1.0,1,1.0,1,1.0,1,0.15488066207120443,51
1203,0,1899,947,952,0,0,0,1.0,1,1.0,1,1.0,1,0.14446896873307194,52
1204,0,1899,947,952,0,0,0,1.0,1,1.0,1,1.0,1,0.14446896873307194,52
1205,1,1900,948,952,0,0,0,1.0,1,1.0,1,1.0,1,0.17269732354317976,53
1206,0,1900,948,952,0,0,0,1.0,1,1.0,1,1.0,1,0.17269732354317976,53
1207,0,1900,948,952,0,0,0,1.0,1,1.0,1,1.0,1,0.18101032406692122,55
1208,1,1901,948,953,0,0,0,1.0,1,1.0,1,1.0,1,0.1879081723939888,56
1209,1,1902,948,954,0,0,0,1.0,1,1.0,1,1.0,1,0.1798383591432215,55
1210,2,1904,949,955,0,0,0,1.0,1,1.0,1,1.0,1,0.16003436230310164,55
1211,0,1904,949,955,0,0,0,1.0,1,1.0,1,1.0,1,0.14979893169532724,57
1212,0,1904,949,955,0,0,0,1.0,1,1.0,1,1.0,1,0.14979893169532724,57
1213,0,1904,949,955,0,0,0,1.0,1,1.0,1,1.0,1,0.14979893169532724,57
1214,3,1907,952,955,0,0,0,1.0,1,1.0,1,1.0,1,0.2108730695148847,57
1215,4,1911,952,959,0,0,0,1.0,1,1.0,1,1.0,1,0.16949323286138038,59
1216,1,1912,952,960,0,0,0,1.0,1,1.0,1,1.0,1,0.16762722226179438,61
1217,1,1913,952,961,0,0,0,1.0,1,1.0,1,1.0,1,0.16436214039891314,61
1218,2,1915,954,961,0,0,0,1.0,1,1.0,1,1.0,1,0.18989689865546816,61
1219,2,1917,955,962,0,0,0,1.0,1,1.0,1,1.0,1,0.17743955130223493,61
1220,2,1919,956,963,0,0,0,1.0,1,1.0,1,1.0,1,0.1794444114788612,60
1221,1,1920,956,964,0,0,0,1.0,1,1.0,1,1.0,1,0.18647086304571553,61
1222,3,1923,957,966,0,0,0,1.0,1,1.0,1,1.0,1,0.16656498251514393,61
1223,2,1925,959,966,0,0,0,1.0,1,1.0,1,1.0,1,0.19425284556715758,59
1224,5,1930,963,967,0,0,0,1.0,1,1.0,1,1.0,1,0.19974769325185937,60
1225,8,1938,966,972,0,0,0,1.0,1,1.0,1,1.0,1,0.17888811152172465,60
1226,4,1942,967,975,0,0,0,1.0,1,1.0,1,1.0,1,0.17198446612592022,61
1227,3,1945,968,977,0,0,0,1.0,1,1.0,1,1.0,1,0.11779184837587318,59
1228,1,1946,969,977,0,0,0,1.0,1,1.0,1,1.0,1,0.13532908423404516,58
1229,1,1947,970,977,0,0,0,1.0,1,1.0,1,1.0,1,0.1487324410757077,57
1230,2,1949,972,977,0,0,0,1.0,1,1.0,1,1.0,1,0.15920137711355103,55
1231,2,1951,974,977,0,0,0,1.0,1,1.0,1,1.0,1,0.16575836163296417,54
1232,4,1955,977,978,0,0,0,1.0,1,1.0,1,1.0,1,0.21078808322650222,51
1233,4,1959,979,980,0,0,0,1.0,1,1.0,1,1.0,1,0.1988484532964992,49
1234,2,1961,981,980,0,0,0,1.0,1,1.0,1,1.0,1,0.2552936896811652,49
1235,4,1965,981,984,0,0,0,1.0,1,1.0,1,1.0,1,0.19761570582417878,48
1236,0,1965,981,984,0,0,0,1.0,1,1.0,1,1.0,1,0.21557151950995712,49
1237,2,1967,982,985,0,0,0,1.0,1,1.0,1,1.0,1,0.24317136045034385,48
1238,1,1968,982,986,0,0,0,1.0,1,1.0,1,1.0,1,0.22956848255172274,47
1239,1,1969,982,987,0,0,0,1.0,1,1.0,1,1.0,1,0.20253356421625895,48
1240,0,1969,982,987,0,0,0,1.0,1,1.0,1,1.0,1,0.21338504054351295,49
1241,2,1971,984,987,0,0,0,1.0,1,1.0,1,1.0,1,0.19757379560073388,49
1242,0,1971,984,987,0,0,0,1.0,1,1.0,1,1.0,1,0.20036020434575838,49
1243,0,1971,984,987,0,0,0,1.0,1,1.0,1,1.0,1,0.20760729647152193,50
1244,1,1972,985,987,0,0,0,1.0,1,1.0,1,1.0,1,0.2589224385362713,50
1245,3,1975,985,990,0,0,0,1.0,1,1.0,1,1.0,1,0.21330339250911873,51
1246,1,1976,985,991,0,0,0,1.0,1,1.0,1,1.0,1,0.2433238213159751,52
1247,0,1976,985,991,0,0,0,1.0,1,1.0,1,1.0,1,0.2433238213159751,52
1248,0,1976,985,991,0,0,0,1.0,1,1.0,1,1.0,1,0.25641587911577984,51
1249,2,1978,987,991,0,0,0,1.0,1,1.0,1,1.0,1,0.24415902491795075,51
1250,3,1981,990,991,0,0,0,1.0,1,1.0,1,1.0,1,0.2639908108717365,51
1251,1,1982,990,992,0,0,0,1.0,1,1.0,1,1.0,1,0.24635185031907902,53
1252,3,1985,992,993,0,0,0,1.0,1,1.0,1,1.0,1,0.2703666373371313,52
1253,6,1991,992,999,0,0,0,1.0,1,1.0,1,1.0,1,0.1851256554792311,52
1254,0,1991,992,999,0,0,0,1.0,1,1.0,1,1.0,1,0.189151807524664,53
1255,3,1994,993,1001,0,0,0,1.0,1,1.0,1,1.0,1,0.1855555797894567,55
1256,1,1995,993,1002,0,0,0,1.0,1,1.0,1,1.0,1,0.16990503745940644,55
1257,0,1995,993,1002,0,0,0,1.0,1,1.0,1,1.0,1,0.1917585300591823,57
1258,0,1995,993,1002,0,0,0,1.0,1,1.0,1,1.0,1,0.19172520771784257,57
1259,0,1995,993,1002,0,0,0,1.0,1,1.0,1,1.0,1,0.19172520771784257,57
1260,0,1995,993,1002,0,0,0,1.0,1,1.0,1,1.0,1,0.19549794561406697,56
1261,1,1996,993,1003,0,0,0,1.0,1,1.0,1,1.0,1,0.195856037655994,57
1262,3,1999,994,1005,0,0,0,1.0,1,1.0,1,1.0,1,0.18837636635860291,58
1263,6,2005,997,1008,0,0,0,1.0,1,1.0,1,1.0,1,0.20037758951181767,58
1264,1,2006,997,1009,0,0,0,1.0,1,1.0,1,1.0,1,0.17493082153116288,57
1265,3,2009,1000,1009,0,0,0,1.0,1,1.0,1,1.0,1,0.23840802302423478,56
1266,6,2015,1003,1012,0,0,0,1.0,1,1.0,1,1.0,1,0.24849414169410816,55
1267,6,2021,1005,1016,0,0,0,1.0,1,1.0,1,1.0,1,0.17057699586775002,53
1268,3,2024,1007,1017,0,0,0,1.0,1,1.0,1,1.0,1,0.1897992184482031,52
1269,2,2026,1009,1017,0,0,0,1.0,1,1.0,1,1.0,1,0.16356606477269214,51
1270,0,2026,1009,1017,0,0,0,1.0,1,1.0,1,1.0,1,0.17379091381764789,47
1271,2,2028,1009,1019,0,0,0,1.0,1,1.0,1,1.0,1,0.13972820815665452,46
1272,0,2028,1009,1019,0,0,0,1.0,1,1.0,1,1.0,1,0.12142750351612319,43
1273,3,2031,1011,1020,0,0,0,1.0,1,1.0,1,1.0,1,0.14303203469662507,44
1274,2,2033,1013,1020,0,0,0,1.0,1,1.0,1,1.0,1,0.19474638255072638,44
1275,3,2036,1014,1022,0,0,0,1.0,1,1.0,1,1.0,1,0.162573635949214,45
1276,1,2037,1015,1022,0,0,0,1.0,1,1.0,1,1.0,1,0.2128433616805854,43
1277,3,2040,1017,1023,0,0,0,1.0,1,1.0,1,1.0,1,0.1997605635397879,44
1278,3,2043,1020,1023,0,0,0,1.0,1,1.0,1,1.0,1,0.2318217534362334,45
1279,3,2046,1021,1025,0,0,0,1.0,1,1.0,1,1.0,1,0.197527472095869,47
1280,0,2046,1021,1025,0,0,0,1.0,1,1.0,1,1.0,1,0.197527472095869,47
1281,0,2046,1021,1025,0,0,0,1.0,1,1.0,1,1.0,1,0.197527472095869,47
1282,1,2047,1022,1025,0,0,0,1.0,1,1.0,1,1.0,1,0.2172800586498554,46
1283,3,2050,1023,1027,0,0,0,1.0,1,1.0,1,1.0,1,0.19197682905898103,46
1284,0,2050,1023,1027,0,0,0,1.0,1,1.0,1,1.0,1,0.19197682905898103,46
1285,2,2052,1023,1029,0,0,0,1.0,1,1.0,1,1.0,1,0.19234748799486734,46
1286,0,2052,1023,1029,0,0,0,1.0,1,1.0,1,1.0,1,0.19244171555512918,45
1287,4,2056,1024,1032,0,0,0,1.0,1,1.0,1,1.0,1,0.17816569103199967,49
1288,2,2058,1024,1034,0,0,0,1.0,1,1.0,1,1.0,1,0.1383526936752545,49
1289,0,2058,1024,1034,0,0,0,1.0,1,1.0,1,1.0,1,0.1276467807782613,52
1290,0,2058,1024,1034,0,0,0,1.0,1,1.0,1,1.0,1,0.1276467807782613,52
1291,0,2058,1024,1034,0,0,0,1.0,1,1.0,1,1.0,1,0.1276467807782613,52
1292,0,2058,1024,1034,0,0,0,1.0,1,1.0,1,1.0,1,0.12584749486663857,53
1293,0,2058,1024,1034,0,0,0,1.0,1,1.0,1,1.0,1,0.12584749486663857,53
1294,1,2059,1025,1034,0,0,0,1.0,1,1.0,1,1.0,1,0.1247209580072683,53
1295,1,2060,1026,1034,0,0,0,1.0,1,1.0,1,1.0,1,0.144979673122881,54
1296,0,2060,1026,1034,0,0,0,1.0,1,1.0,1,1.0,1,0.1371915604385123,55
1297,0,2060,1026,1034,0,0,0,1.0,1,1.0,1,1.0,1,0.15785538669436797,54
1298,0,2060,1026,1034,0,0,0,1.0,1,1.0,1,1.0,1,0.17115700488372332,55
1299,2,2062,1026,1036,0,0,0,1.0,1,1.0,1,1.0,1,0.1685784429209716,54
1300,2,2064,1027,1037,0,0,0,1.0,1,1.0,1,1.0,1,0.1830923950525681,55
1301,2,2066,1029,1037,0,0,0,1.0,1,1.0,1,1.0,1,0.21820265352250418,54
1302,3,2069,1031,1038,0,0,0,1.0,1,1.0,1,1.0,1,0.24790653304663876,54
1303,8,2077,1035,1042,0,0,0,1.0,1,1.0,1,1.0,1,0.2472941807596597,50
1304,4,2081,1039,1042,0,0,0,1.0,1,1.0,1,1.0,1,0.19980901593220163,51
1305,2,2083,1040,1043,0,0,0,1.0,1,1.0,1,1.0,1,0.23323289080859114,48
1306,2,2085,1042,1043,0,0,0,1.0,1,1.0,1,1.0,1,0.2937659090245074,48
1307,4,2089,1043,1046,0,0,0,1.0,1,1.0,1,1.0,1,0.19855546036381685,48
1308,0,2089,1043,1046,0,0,0,1.0,1,1.0,1,1.0,1,0.18768476980292134,46
1309,3,2092,1045,1047,0,0,0,1.0,1,1.0,1,1.0,1,0.20419652640038718,47
1310,0,2092,1045,1047,0,0,0,1.0,1,1.0,1,1.0,1,0.21046233695972982,46
1311,5,2097,1048,1049,0,0,0,1.0,1,1.0,1,1.0,1,0.22659433698254464,46
1312,2,2099,1049,1050,0,0,0,1.0,1,1.0,1,1.0,1,0.23184421415669343,45
1313,0,2099,1049,1050,0,0,0,1.0,1,1.0,1,1.0,1,0.24802733406297825,44
1314,0,2099,1049,1050,0,0,0,1.0,1,1.0,1,1.0,1,0.24551142433222073,42
1315,2,2101,1050,1051,0,0,0,1.0,1,1.0,1,1.0,1,0.2761770409508032,40
1316,1,2102,1050,1052,0,0,0,1.0,1,1.0,1,1.0,1,0.2463097646323094,42
1317,1,2103,1051,1052,0,0,0,1.0,1,1.0,1,1.0,1,0.27369847402455316,42
1318,0,2103,1051,1052,0,0,0,1.0,1,1.0,1,1.0,1,0.27369847402455316,42
1319,0,2103,1051,1052,0,0,0,1.0,1,1.0,1,1.0,1,0.27369847402455316,42
1320,1,2104,1051,1053,0,0,0,1.0,1,1.0,1,1.0,1,0.23886389506795672,42
1321,0,2104,1051,1053,0,0,0,1.0,1,1.0,1,1.0,1,0.22298344714887686,45
1322,1,2105,1051,1054,0,0,0,1.0,1,1.0,1,1.0,1,0.21703543149702123,45
1323,1,2106,1052,1054,0,0,0,1.0,1,1.0,1,1.0,1,0.22163045649738128,46
1324,0,2106,1052,1054,0,0,0,1.0,1,1.0,1,1.0,1,0.23728131275153075,45
1325,2,2108,1053,1055,0,0,0,1.0,1,1.0,1,1.0,1,0.2510968152897582,46
1326,3,2111,1054,1057,0,0,0,1.0,1,1.0,1,1.0,1,0.26056320403426797,45
1327,2,2113,1054,1059,0,0,0,1.0,1,1.0,1,1.0,1,0.25267657373485297,46
1328,0,2113,1054,1059,0,0,0,1.0,1,1.0,1,1.0,1,0.2519239173043481,47
1329,1,2114,1055,1059,0,0,0,1.0,1,1.0,1,1.0,1,0.26166277220749257,47
1330,2,2116,1055,1061,0,0,0,1.0,1,1.0,1,1.0,1,0.2574636874293887,46
1331,0,2116,1055,1061,0,0,0,1.0,1,1.0,1,1.0,1,0.2574636874293887,46
1332,2,2118,1056,1062,0,0,0,1.0,1,1.0,1,1.0,1,0.24743832906327926,49
1333,0,2118,1056,1062,0,0,0,1.0,1,1.0,1,1.0,1,0.26031366900638697,50
1334,0,2118,1056,1062,0,0,0,1.0,1,1.0,1,1.0,1,0.26031366900638697,50
1335,0,2118,1056,1062,0,0,0,1.0,1,1.0,1,1.0,1,0.2861308618806802,52
1336,0,2118,1056,1062,0,0,0,1.0,1,1.0,1,1.0,1,0.27270637431408173,53
1337,5,2123,1058,1065,0,0,0,1.0,1,1.0,1,1.0,1,0.2829008886235599,54
1338,3,2126,1059,1067,0,0,0,1.0,1,1.0,1,1.0,1,0.27886245482209454,54
1339,2,2128,1061,1067,0,0,0,1.0,1,1.0,1,1.0,1,0.29180158366525444,54
1340,1,2129,1061,1068,0,0,0,1.0,1,1.0,1,1.0,1,0.30912353826088146,53
1341,3,2132,1061,1071,0,0,0,1.0,1,1.0,1,1.0,1,0.2385685661133046,53
1342,0,2132,1061,1071,0,0,0,1.0,1,1.0,1,1.0,1,0.23031113018297453,52
1343,1,2133,1062,1071,0,0,0,1.0,1,1.0,1,1.0,1,0.23115617348564665,50
1344,3,2136,1065,1071,0,0,0,1.0,1,1.0,1,1.0,1,0.261567687593576,51
1345,1,2137,1065,1072,0,0,0,1.0,1,1.0,1,1.0,1,0.23679901781432777,50
1346,5,2142,1068,1074,0,0,0,1.0,1,1.0,1,1.0,1,0.23818711531180708,50
1347,2,2144,1068,1076,0,0,0,1.0,1,1.0,1,1.0,1,0.21794489293339378,48
1348,1,2145,1068,1077,0,0,0,1.0,1,1.0,1,1.0,1,0.20051746385836644,49
1349,0,2145,1068,1077,0,0,0,1.0,1,1.0,1,1.0,1,0.19239324543912928,48
1350,1,2146,1069,1077,0,0,0,1.0,1,1.0,1,1.0,1,0.2167595875368727,49
1351,0,2146,1069,1077,0,0,0,1.0,1,1.0,1,1.0,1,0.2041309227763668,48
1352,1,2147,1070,1077,0,0,0,1.0,1,1.0,1,1.0,1,0.20816863925463047,49
1353,0,2147,1070,1077,0,0,0,1.0,1,1.0,1,1.0,1,0.20418063169718428,49
1354,2,2149,1071,1078,0,0,0,1.0,1,1.0,1,1.0,1,0.23417522107133676,49
1355,6,2155,1073,1082,0,0,0,1.0,1,1.0,1,1.0,1,0.1635632677766622,50
1356,1,2156,1074,1082,0,0,0,1.0,1,1.0,1,1.0,1,0.1849002322024383,50
1357,4,2160,1077,1083,0,0,0,1.0,1,1.0,1,1.0,1,0.22801371286635674,50
1358,4,2164,1078,1086,0,0,0,1.0,1,1.0,1,1.0,1,0.21866423938389382,51
1359,2,2166,1079,1087,0,0,0,1.0,1,1.0,1,1.0,1,0.24144732951775852,53
1360,0,2166,1079,1087,0,0,0,1.0,1,1.0,1,1.0,1,0.23849120041804406,54
1361,2,2168,1079,1089,0,0,0,1.0,1,1.0,1,1.0,1,0.21610362227335414,54
1362,1,2169,1080,1089,0,0,0,1.0,1,1.0,1,1.0,1,0.2105633426995468,55
1363,1,2170,1080,1090,0,0,0,1.0,1,1.0,1,1.0,1,0.18721904412997797,55
1364,1,2171,1080,1091,0,0,0,1.0,1,1.0,1,1.0,1,0.1903706065701629,55
1365,2,2173,1081,1092,0,0,0,1.0,1,1.0,1,1.0,1,0.17967449168627148,56
1366,0,2173,1081,1092,0,0,0,1.0,1,1.0,1,1.0,1,0.17967449168627148,56
1367,2,2175,1082,1093,0,0,0,1.0,1,1.0,1,1.0,1,0.1878325503012351,56
1368,2,2177,1082,1095,0,0,0,1.0,1,1.0,1,1.0,1,0.17350555012035504,58
1369,1,2178,1082,1096,0,0,0,1.0,1,1.0,1,1.0,1,0.1731908335202757,59
1370,1,2179,1083,1096,0,0,0,1.0,1,1.0,1,1.0,1,0.17251775668876176,59
1371,0,2179,1083,1096,0,0,0,1.0,1,1.0,1,1.0,1,0.17251775668876176,59
1372,2,2181,1084,1097,0,0,0,1.0,1,1.0,1,1.0,1,0.16417290937628176,59
1373,1,2182,1084,1098,0,0,0,1.0,1,1.0,1,1.0,1,0.16133046229871367,59
1374,7,2189,1087,1102,0,0,0,1.0,1,1.0,1,1.0,1,0.13493705297016934,60
1375,4,2193,1087,1106,0,0,0,1.0,1,1.0,1,1.0,1,0.08481772693599214,61
1376,0,2193,1087,1106,0,0,0,1.0,1,1.0,1,1.0,1,0.1126866025595343,61
1377,0,2193,1087,1106,0,0,0,1.0,1,1.0,1,1.0,1,0.1126866025595343,61
1378,2,2195,1089,1106,0,0,0,1.0,1,1.0,1,1.0,1,0.1679099503933077,61
1379,0,2195,1089,1106,0,0,0,1.0,1,1.0,1,1.0,1,0.17721504714268838,60
1380,2,2197,1090,1107,0,0,0,1.0,1,1.0,1,1.0,1,0.20087301022063028,60
1381,0,2197,1090,1107,0,0,0,1.0,1,1.0,1,1.0,1,0.20541878600250685,58
1382,4,2201,1094,1107,0,0,0,1.0,1,1.0,1,1.0,1,0.2361206989128334,58
1383,4,2205,1097,1108,0,0,0,1.0,1,1.0,1,1.0,1,0.198514163135529,57
1384,7,2212,1101,1111,0,0,0,1.0,1,1.0,1,1.0,1,0.1994839697342924,54
1385,2,2214,1102,1112,0,0,0,1.0,1,1.0,1,1.0,1,0.19498513595983807,52
1386,5,2219,1103,1116,0,0,0,1.0,1,1.0,1,1.0,1,0.12968877317703728,51
1387,1,2220,1104,1116,0,0,0,1.0,1,1.0,1,1.0,1,0.18775290273549797,51
1388,2,2222,1105,1117,0,0,0,1.0,1,1.0,1,1.0,1,0.15898245523923082,52
1389,3,2225,1105,1120,0,0,0,1.0,1,1.0,1,1.0,1,0.16686329539197672,50
1390,1,2226,1106,1120,0,0,0,1.0,1,1.0,1,1.0,1,0.15218781710493787,51
1391,0,2226,1106,1120,0,0,0,1.0,1,1.0,1,1.0,1,0.1638101094740235,50
1392,2,2228,1108,1120,0,0,0,1.0,1,1.0,1,1.0,1,0.1852782601855729,50
1393,1,2229,1108,1121,0,0,0,1.0,1,1.0,1,1.0,1,0.16175682456523158,49
1394,2,2231,1109,1122,0,0,0,1.0,1,1.0,1,1.0,1,0.17350860275514243,50
1395,2,2233,1109,1124,0,0,0,1.0,1,1.0,1,1.0,1,0.14952660577361304,51
1396,0,2233,1109,1124,0,0,0,1.0,1,1.0,1,1.0,1,0.16531043126957476,52
1397,0,2233,1109,1124,0,0,0,1.0,1,1.0,1,1.0,1,0.16531043126957476,52
1398,1,2234,1110,1124,0,0,0,1.0,1,1.0,1,1.0,1,0.15893706106489894,53
1399,4,2238,1113,1125,0,0,0,1.0,1,1.0,1,1.0,1,0.18133192311615856,54
1400,0,2238,1113,1125,0,0,0,1.0,1,1.0,1,1.0,1,0.18133192311615856,54
1401,2,2240,1115,1125,0,0,0,1.0,1,1.0,1,1.0,1,0.18714429515769423,54
1402,2,2242,1117,1125,0,0,0,1.0,1,1.0,1,1.0,1,0.18901729554557192,53
1403,0,2242,1117,1125,0,0,0,1.0,1,1.0,1,1.0,1,0.20705435405338185,52
1404,1,2243,1117,1126,0,0,0,1.0,1,1.0,1,1.0,1,0.209208867875668,53
1405,1,2244,1118,1126,0,0,0,1.0,1,1.0,1,1.0,1,0.2634722875788864,52
1406,1,2245,1118,1127,0,0,0,1.0,1,1.0,1,1.0,1,0.25308332257429283,53
1407,1,2246,1119,1127,0,0,0,1.0,1,1.0,1,1.0,1,0.2683733272928506,54
1408,0,2246,1119,1127,0,0,0,1.0,1,1.0,1,1.0,1,0.29042859939718746,53
1409,2,2248,1119,1129,0,0,0,1.0,1,1.0,1,1.0,1,0.2733455551642363,55
1410,0,2248,1119,1129,0,0,0,1.0,1,1.0,1,1.0,1,0.2832667057532929,54
1411,3,2251,1119,1132,0,0,0,1.0,1,1.0,1,1.0,1,0.2457612513791324,54
1412,0,2251,1119,1132,0,0,0,1.0,1,1.0,1,1.0,1,0.25189526220273567,53
1413,1,2252,1119,1133,0,0,0,1.0,1,1.0,1,1.0,1,0.2412637970908771,54
1414,3,2255,1119,1136,0,0,0,1.0,1,1.0,1,1.0,1,0.22843810159530248,55
1415,1,2256,1119,1137,0,0,0,1.0,1,1.0,1,1.0,1,0.19507456730026562,57
1416,4,2260,1120,1140,0,0,0,1.0,1,1.0,1,1.0,1,0.21927169191495055,59
1417,2,2262,1120,1142,0,0,0,1.0,1,1.0,1,1.0,1,0.18376860598640057,58
1418,1,2263,1121,1142,0,0,0,1.0,1,1.0,1,1.0,1,0.18665224480588632,57
1419,1,2264,1122,1142,0,0,0,1.0,1,1.0,1,1.0,1,0.20569665968356723,56
1420,2,2266,1123,1143,0,0,0,1.0,1,1.0,1,1.0,1,0.20683104436858957,54
1421,3,2269,1124,1145,0,0,0,1.0,1,1.0,1,1.0,1,0.1694964546906651,55
1422,0,2269,1124,1145,0,0,0,1.0,1,1.0,1,1.0,1,0.17707378041654429,52
1423,4,2273,1126,1147,0,0,0,1.0,1,1.0,1,1.0,1,0.18932950645210078,52
1424,3,2276,1129,1147,0,0,0,1.0,1,1.0,1,1.0,1,0.21931706831390735,51
1425,2,2278,1129,1149,0,0,0,1.0,1,1.0,1,1.0,1,0.1734159236832162,50
1426,4,2282,1131,1151,0,0,0,1.0,1,1.0,1,1.0,1,0.19648997887234498,50
1427,0,2282,1131,1151,0,0,0,1.0,1,1.0,1,1.0,1,0.194022178413171,48
1428,3,2285,1134,1151,0,0,0,1.0,1,1.0,1,1.0,1,0.23279167567530207,48
1429,2,2287,1135,1152,0,0,0,1.0,1,1.0,1,1.0,1,0.21854768566572,48
1430,2,2289,1137,1152,0,0,0,1.0,1,1.0,1,1.0,1,0.2174290773718113,48
1431,0,2289,1137,1152,0,0,0,1.0,1,1.0,1,1.0,1,0.2174290773718113,48
1432,3,2292,1137,1155,0,0,0,1.0,1,1.0,1,1.0,1,0.15483897940390115,50
1433,2,2294,1138,1156,0,0,0,1.0,1,1.0,1,1.0,1,0.16989660081606398,51
1434,2,2296,1140,1156,0,0,0,1.0,1,1.0,1,1.0,1,0.18064952483564894,51
1435,3,2299,1141,1158,0,0,0,1.0,1,1.0,1,1.0,1,0.16766132821745758,50
1436,2,2301,1142,1159,0,0,0,1.0,1,1.0,1,1.0,1,0.14941784710043246,51
1437,1,2302,1142,1160,0,0,0,1.0,1,1.0,1,1.0,1,0.13988486635141922,51
1438,1,2303,1143,1160,0,0,0,1.0,1,1.0,1,1.0,1,0.1605588112250158,51
1439,3,2306,1146,1160,0,0,0,1.0,1,1.0,1,1.0,1,0.1924653364918932,50
1440,5,2311,1147,1164,0,0,0,1.0,1,1.0,1,1.0,1,0.2177114023232923,51
1441,0,2311,1147,1164,0,0,0,1.0,1,1.0,1,1.0,1,0.2177114023232923,51
1442,2,2313,1149,1164,0,0,0,1.0,1,1.0,1,1.0,1,0.231886561092987,52
1443,3,2316,1149,1167,0,0,0,1.0,1,1.0,1,1.0,1,0.21892384069260237,53
1444,4,2320,1150,1170,0,0,0,1.0,1,1.0,1,1.0,1,0.19346954192037485,54
1445,0,2320,1150,1170,0,0,0,1.0,1,1.0,1,1.0,1,0.19346954192037485,54
1446,2,2322,1150,1172,0,0,0,1.0,1,1.0,1,1.0,1,0.18929040508230513,54
1447,0,2322,1150,1172,0,0,0,1.0,1,1.0,1,1.0,1,0.18318733456407627,55
1448,1,2323,1150,1173,0,0,0,1.0,1,1.0,1,1.0,1,0.17081143257273035,55
1449,2,2325,1151,1174,0,0,0,1.0,1,1.0,1,1.0,1,0.16665818028501045,55
1450,2,2327,1151,1176,0,0,0,1.0,1,1.0,1,1.0,1,0.13870104115273302,57
1451,0,2327,1151,1176,0,0,0,1.0,1,1.0,1,1.0,1,0.13870104115273302,57
1452,0,2327,1151,1176,0,0,0,1.0,1,1.0,1,1.0,1,0.13870104115273302,57
1453,2,2329,1152,1177,0,0,0,1.0,1,1.0,1,1.0,1,0.1503735513918477,57
1454,1,2330,1153,1177,0,0,0,1.0,1,1.0,1,1.0,1,0.17431988827791023,58
1455,3,2333,1154,1179,0,0,0,1.0,1,1.0,1,1.0,1,0.15072815297175823,56
1456,3,2336,1156,1180,0,0,0,1.0,1,1.0,1,1.0,1,0.14190598413429437,55
1457,0,2336,1156,1180,0,0,0,1.0,1,1.0,1,1.0,1,0.1676417926647195,54
1458,3,2339,1158,1181,0,0,0,1.0,1,1.0,1,1.0,1,0.1846456146695812,53
1459,3,2342,1158,1184,0,0,0,1.0,1,1.0,1,1.0,1,0.10898471532321677,52
1460,0,2342,1158,1184,0,0,0,1.0,1,1.0,1,1.0,1,0.09834801199241071,51
1461,3,2345,1161,1184,0,0,0,1.0,1,1.0,1,1.0,1,0.11846206950766636,51
1462,4,2349,1164,1185,0,0,0,1.0,1,1.0,1,1.0,1,0.10767671841112729,51
1463,4,2353,1167,1186,0,0,0,1.0,1,1.0,1,1.0,1,0.1678331938969533,52
1464,3,2356,1170,1186,0,0,0,1.0,1,1.0,1,1.0,1,0.1910141029611371,52
1465,4,2360,1172,1188,0,0,0,1.0,1,1.0,1,1.0,1,0.19406878489023388,51
1466,4,2364,1176,1188,0,0,0,1.0,1,1.0,1,1.0,1,0.2103289278157546,50
1467,4,2368,1178,1190,0,0,0,1.0,1,1.0,1,1.0,1,0.185300815364193,48
1468,3,2371,1180,1191,0,0,0,1.0,1,1.0,1,1.0,1,0.17747179705157246,48
1469,3,2374,1181,1193,0,0,0,1.0,1,1.0,1,1.0,1,0.17716073644462751,48
1470,3,2377,1182,1195,0,0,0,1.0,1,1.0,1,1.0,1,0.1591284635553656,48
1471,3,2380,1183,1197,0,0,0,1.0,1,1.0,1,1.0,1,0.13689781203314658,45
1472,0,2380,1183,1197,0,0,0,1.0,1,1.0,1,1.0,1,0.14046126650316784,45
1473,2,2382,1184,1198,0,0,0,1.0,1,1.0,1,1.0,1,0.1336262661897892,46
1474,0,2382,1184,1198,0,0,0,1.0,1,1.0,1,1.0,1,0.15843573110483286,46
1475,2,2384,1185,1199,0,0,0,1.0,1,1.0,1,1.0,1,0.15276514543294534,46
1476,1,2385,1185,1200,0,0,0,1.0,1,1.0,1,1.0,1,0.13357925162559386,47
1477,1,2386,1186,1200,0,0,0,1.0,1,1.0,1,1.0,1,0.15141669241551492,47
1478,2,2388,1187,1201,0,0,0,1.0,1,1.0,1,1.0,1,0.18796712949891844,47
1479,1,2389,1187,1202,0,0,0,1.0,1,1.0,1,1.0,1,0.17022438789775415,48
1480,1,2390,1188,1202,0,0,0,1.0,1,1.0,1,1.0,1,0.18522698832200746,47
1481,2,2392,1189,1203,0,0,0,1.0,1,1.0,1,1.0,1,0.1960270469751633,47
1482,2,2394,1191,1203,0,0,0,1.0,1,1.0,1,1.0,1,0.21192365573523772,46
1483,4,2398,1192,1206,0,0,0,1.0,1,1.0,1,1.0,1,0.18423947957666587,47
1484,1,2399,1192,1207,0,0,0,1.0,1,1.0,1,1.0,1,0.1824883043499875,47
1485,2,2401,1192,1209,0,0,0,1.0,1,1.0,1,1.0,1,0.18058378298130792,47
1486,0,2401,1192,1209,0,0,0,1.0,1,1.0,1,1.0,1,0.17587325300875192,49
1487,4,2405,1195,1210,0,0,0,1.0,1,1.0,1,1.0,1,0.16826957957103553,49
1488,1,2406,1196,1210,0,0,0,1.0,1,1.0,1,1.0,1,0.1766600098858565,51
1489,1,2407,1197,1210,0,0,0,1.0,1,1.0,1,1.0,1,0.21767477089193285,52
1490,2,2409,1198,1211,0,0,0,1.0,1,1.0,1,1.0,1,0.19078739882627266,52
1491,6,2415,1201,1214,0,0,0,1.0,1,1.0,1,1.0,1,0.1574416521991041,53
1492,3,2418,1204,1214,0,0,0,1.0,1,1.0,1,1.0,1,0.2015893665135331,53
1493,1,2419,1204,1215,0,0,0,1.0,1,1.0,1,1.0,1,0.14595341647720872,52
1494,2,2421,1206,1215,0,0,0,1.0,1,1.0,1,1.0,1,0.1461511814180851,50
1495,2,2423,1208,1215,0,0,0,1.0,1,1.0,1,1.0,1,0.1322372479255757,50
1496,2,2425,1209,1216,0,0,0,1.0,1,1.0,1,1.0,1,0.16062658139827105,52
1497,1,2426,1210,1216,0,0,0,1.0,1,1.0,1,1.0,1,0.17886161031626197,51
1498,2,2428,1211,1217,0,0,0,1.0,1,1.0,1,1.0,1,0.1658372193229657,50
1499,0,2428,1211,1217,0,0,0,1.0,1,1.0,1,1.0,1,0.16378153382033958,50
1500,3,2431,1214,1217,0,0,0,1.0,1,1.0,1,1.0,1,0.2181770683181107,49
1501,1,2432,1214,1218,0,0,0,1.0,1,1.0,1,1.0,1,0.19586008484583306,47
1502,3,2435,1217,1218,0,0,0,1.0,1,1.0,1,1.0,1,0.248411540284597,47
1503,2,2437,1217,1220,0,0,0,1.0,1,1.0,1,1.0,1,0.17481371589196984,47
1504,1,2438,1218,1220,0,0,0,1.0,1,1.0,1,1.0,1,0.16281332307278065,48
1505,1,2439,1219,1220,0,0,0,1.0,1,1.0,1,1.0,1,0.15539997344667902,47
1506,1,2440,1220,1220,0,0,0,1.0,1,1.0,1,1.0,1,0.1400087139892968,47
1507,3,2443,1222,1221,0,0,0,1.0,1,1.0,1,1.0,1,0.16239369982151516,45
1508,1,2444,1223,1221,0,0,0,1.0,1,1.0,1,1.0,1,0.16423436231517533,45
1509,2,2446,1225,1221,0,0,0,1.0,1,1.0,1,1.0,1,0.1996320682537714,44
1510,3,2449,1228,1221,0,0,0,1.0,1,1.0,1,1.0,1,0.30845860712620904,42
1511,3,2452,1229,1223,0,0,0,1.0,1,1.0,1,1.0,1,0.3214337688508235,40
1512,5,2457,1232,1225,0,0,0,1.0,1,1.0,1,1.0,1,0.33109314607091,39
1513,2,2459,1232,1227,0,0,0,1.0,1,1.0,1,1.0,1,0.2676693990665669,39
1514,2,2461,1232,1229,0,0,0,1.0,1,1.0,1,1.0,1,0.22886995325565743,38
1515,2,2463,1233,1230,0,0,0,1.0,1,1.0,1,1.0,1,0.23205970489866373,39
1516,0,2463,1233,1230,0,0,0,1.0,1,1.0,1,1.0,1,0.23205970489866373,39
1517,1,2464,1234,1230,0,0,0,1.0,1,1.0,1,1.0,1,0.23195558419670959,39
1518,1,2465,1235,1230,0,0,0,1.0,1,1.0,1,1.0,1,0.24661426851386162,39
1519,0,2465,1235,1230,0,0,0,1.0,1,1.0,1,1.0,1,0.24661426851386162,39
1520,5,2470,1238,1232,0,0,0,1.0,1,1.0,1,1.0,1,0.25815434920580543,39
1521,2,2472,1239,1233,0,0,0,1.0,1,1.0,1,1.0,1,0.26607452837422324,40
1522,1,2473,1240,1233,0,0,0,1.0,1,1.0,1,1.0,1,0.284449824701789,40
1523,4,2477,1240,1237,0,0,0,1.0,1,1.0,1,1.0,1,0.2265707536601525,41
1524,0,2477,1240,1237,0,0,0,1.0,1,1.0,1,1.0,1,0.24233193167286496,42
1525,1,2478,1241,1237,0,0,0,1.0,1,1.0,1,1.0,1,0.24014493700728362,45
1526,1,2479,1241,1238,0,0,0,1.0,1,1.0,1,1.0,1,0.2396520542850058,46
1527,0,2479,1241,1238,0,0,0,1.0,1,1.0,1,1.0,1,0.2396520542850058,46
1528,0,2479,1241,1238,0,0,0,1.0,1,1.0,1,1.0,1,0.23942802390314205,47
1529,0,2479,1241,1238,0,0,0,1.0,1,1.0,1,1.0,1,0.23942802390314205,47
1530,1,2480,1241,1239,0,0,0,1.0,1,1.0,1,1.0,1,0.22690184625556406,48
1531,0,2480,1241,1239,0,0,0,1.0,1,1.0,1,1.0,1,0.21846695275867364,46
1532,2,2482,1242,1240,0,0,0,1.0,1,1.0,1,1.0,1,0.2130393915937928,47
1533,0,2482,1242,1240,0,0,0,1.0,1,1.0,1,1.0,1,0.20641913893848707,46
1534,2,2484,1243,1241,0,0,0,1.0,1,1.0,1,1.0,1,0.19148888675894718,47
1535,1,2485,1244,1241,0,0,0,1.0,1,1.0,1,1.0,1,0.1982267289832429,47
1536,1,2486,1244,1242,0,0,0,1.0,1,1.0,1,1.0,1,0.200885375092579,48
1537,1,2487,1244,1243,0,0,0,1.0,1,1.0,1,1.0,1,0.1741582627751818,46
1538,0,2487,1244,1243,0,0,0,1.0,1,1.0,1,1.0,1,0.18996554624680023,47
1539,0,2487,1244,1243,0,0,0,1.0,1,1.0,1,1.0,1,0.2189339306971134,47
1540,2,2489,1246,1243,0,0,0,1.0,1,1.0,1,1.0,1,0.24798830826525337,47
1541,0,2489,1246,1243,0,0,0,1.0,1,1.0,1,1.0,1,0.24791623129398496,47
1542,3,2492,1248,1244,0,0,0,1.0,1,1.0,1,1.0,1,0.28742067819075506,50
1543,6,2498,1251,1247,0,0,0,1.0,1,1.0,1,1.0,1,0.2485360123145599,47
1544,5,2503,1254,1249,0,0,0,1.0,1,1.0,1,1.0,1,0.2502453245808231,48
1545,2,2505,1255,1250,0,0,0,1.0,1,1.0,1,1.0,1,0.23337869169877248,47
1546,4,2509,1256,1253,0,0,0,1.0,1,1.0,1,1.0,1,0.22225876192992372,47
1547,4,2513,1259,1254,0,0,0,1.0,1,1.0,1,1.0,1,0.22696297706899096,47
1548,3,2516,1261,1255,0,0,0,1.0,1,1.0,1,1.0,1,0.22673307742048668,47
1549,6,2522,1265,1257,0,0,0,1.0,1,1.0,1,1.0,1,0.2082386781750075,46
1550,2,2524,1266,1258,0,0,0,1.0,1,1.0,1,1.0,1,0.23103563783721795,44
1551,3,2527,1268,1259,0,0,0,1.0,1,1.0,1,1.0,1,0.26693050448216293,45
1552,5,2532,1270,1262,0,0,0,1.0,1,1.0,1,1.0,1,0.2687837282531103,43
1553,4,2536,1271,1265,0,0,0,1.0,1,1.0,1,1.0,1,0.20015549002717248,43
1554,0,2536,1271,1265,0,0,0,1.0,1,1.0,1,1.0,1,0.24314813579284322,41
1555,1,2537,1271,1266,0,0,0,1.0,1,1.0,1,1.0,1,0.2463418064034671,44
1556,2,2539,1272,1267,0,0,0,1.0,1,1.0,1,1.0,1,0.22303526952479266,45
1557,2,2541,1272,1269,0,0,0,1.0,1,1.0,1,1.0,1,0.18242002694070417,45
1558,1,2542,1272,1270,0,0,0,1.0,1,1.0,1,1.0,1,0.17390786924877386,46
1559,3,2545,1273,1272,0,0,0,1.0,1,1.0,1,1.0,1,0.13023805893419674,47
1560,1,2546,1274,1272,0,0,0,1.0,1,1.0,1,1.0,1,0.11508265239304367,46
1561,0,2546,1274,1272,0,0,0,1.0,1,1.0,1,1.0,1,0.10378032637902541,47
1562,1,2547,1275,1272,0,0,0,1.0,1,1.0,1,1.0,1,0.09264702801146754,47
1563,0,2547,1275,1272,0,0,0,1.0,1,1.0,1,1.0,1,0.09264702801146754,47
1564,0,2547,1275,1272,0,0,0,1.0,1,1.0,1,1.0,1,0.09264702801146754,47
1565,0,2547,1275,1272,0,0,0,1.0,1,1.0,1,1.0,1,0.13711993144689388,48
1566,1,2548,1276,1272,0,0,0,1.0,1,1.0,1,1.0,1,0.14718876510125145,48
1567,0,2548,1276,1272,0,0,0,1.0,1,1.0,1,1.0,1,0.1838030140686917,48
1568,2,2550,1278,1272,0,0,0,1.0,1,1.0,1,1.0,1,0.24551506077222318,48
1569,1,2551,1278,1273,0,0,0,1.0,1,1.0,1,1.0,1,0.19823138079872835,45
1570,0,2551,1278,1273,0,0,0,1.0,1,1.0,1,1.0,1,0.18693467226644228,44
1571,3,2554,1280,1274,0,0,0,1.0,1,1.0,1,1.0,1,0.1876372892876285,42
1572,4,2558,1282,1276,0,0,0,1.0,1,1.0,1,1.0,1,0.2287924764370143,43
1573,1,2559,1282,1277,0,0,0,1.0,1,1.0,1,1.0,1,0.21095996119995897,43
1574,5,2564,1285,1279,0,0,0,1.0,1,1.0,1,1.0,1,0.2246507245881054,42
1575,4,2568,1287,1281,0,0,0,1.0,1,1.0,1,1.0,1,0.2125295975800721,43
1576,3,2571,1290,1281,0,0,0,1.0,1,1.0,1,1.0,1,0.25284445855551385,41
1577,3,2574,1291,1283,0,0,0,1.0,1,1.0,1,1.0,1,0.21902961560792475,40
1578,0,2574,1291,1283,0,0,0,1.0,1,1.0,1,1.0,1,0.2205567270084561,40
1579,0,2574,1291,1283,0,0,0,1.0,1,1.0,1,1.0,1,0.21990225114511405,40
1580,2,2576,1292,1284,0,0,0,1.0,1,1.0,1,1.0,1,0.23313032930847224,40
1581,1,2577,1293,1284,0,0,0,1.0,1,1.0,1,1.0,1,0.2550344410855742,40
1582,6,2583,1296,1287,0,0,0,1.0,1,1.0,1,1.0,1,0.23392043535848003,40
1583,1,2584,1297,1287,0,0,0,1.0,1,1.0,1,1.0,1,0.25993738828431706,38
1584,3,2587,1298,1289,0,0,0,1.0,1,1.0,1,1.0,1,0.21658440649650323,39
1585,2,2589,1300,1289,0,0,0,1.0,1,1.0,1,1.0,1,0.20918042463943853,38
1586,5,2594,1303,1291,0,0,0,1.0,1,1.0,1,1.0,1,0.19751902623950657,38
1587,1,2595,1304,1291,0,0,0,1.0,1,1.0,1,1.0,1,0.18202961487267336,37
1588,3,2598,1306,1292,0,0,0,1.0,1,1.0,1,1.0,1,0.18220782708466607,39
1589,1,2599,1307,1292,0,0,0,1.0,1,1.0,1,1.0,1,0.18671967852948027,37
1590,2,2601,1308,1293,0,0,0,1.0,1,1.0,1,1.0,1,0.18420770401552877,37
1591,1,2602,1309,1293,0,0,0,1.0,1,1.0,1,1.0,1,0.22924328036728656,36
1592,0,2602,1309,1293,0,0,0,1.0,1,1.0,1,1.0,1,0.28613207808697294,34
1593,2,2604,1310,1294,0,0,0,1.0,1,1.0,1,1.0,1,0.30792154729428045,33
1594,0,2604,1310,1294,0,0,0,1.0,1,1.0,1,1.0,1,0.3351778042387279,31
1595,3,2607,1310,1297,0,0,0,1.0,1,1.0,1,1.0,1,0.2561576105103786,34
1596,0,2607,1310,1297,0,0,0,1.0,1,1.0,1,1.0,1,0.26630143365137915,33
1597,0,2607,1310,1297,0,0,0,1.0,1,1.0,1,1.0,1,0.26630143365137915,33
1598,0,2607,1310,1297,0,0,0,1.0,1,1.0,1,1.0,1,0.2732756148677932,33
1599,0,2607,1310,1297,0,0,0,1.0,1,1.0,1,1.0,1,0.2732756148677932,33
1600,1,2608,1310,1298,0,0,0,1.0,1,1.0,1,1.0,1,0.2562315718900593,34
1601,2,2610,1312,1298,0,0,0,1.0,1,1.0,1,1.0,1,0.29398348978797245,35
1602,1,2611,1312,1299,0,0,0,1.0,1,1.0,1,1.0,1,0.23614984740013611,36
1603,2,2613,1313,1300,0,0,0,1.0,1,1.0,1,1.0,1,0.2824774532756662,38
1604,2,2615,1314,1301,0,0,0,1.0,1,1.0,1,1.0,1,0.2736161469597254,38
1605,0,2615,1314,1301,0,0,0,1.0,1,1.0,1,1.0,1,0.2736161469597254,38
1606,4,2619,1316,1303,0,0,0,1.0,1,1.0,1,1.0,1,0.2921379735858211,39
1607,6,2625,1317,1308,0,0,0,1.0,1,1.0,1,1.0,1,0.2261904846835312,37
1608,1,2626,1318,1308,0,0,0,1.0,1,1.0,1,1.0,1,0.25833862687595,36
1609,1,2627,1318,1309,0,0,0,1.0,1,1.0,1,1.0,1,0.2279188386824288,34
1610,1,2628,1319,1309,0,0,0,1.0,1,1.0,1,1.0,1,0.25247956199337823,34
1611,3,2631,1320,1311,0,0,0,1.0,1,1.0,1,1.0,1,0.24083264429565485,35
1612,1,2632,1321,1311,0,0,0,1.0,1,1.0,1,1.0,1,0.20280806262968457,33
1613,1,2633,1321,1312,0,0,0,1.0,1,1.0,1,1.0,1,0.18339114547989327,34
1614,0,2633,1321,1312,0,0,0,1.0,1,1.0,1,1.0,1,0.18771793646048254,35
1615,0,2633,1321,1312,0,0,0,1.0,1,1.0,1,1.0,1,0.18771793646048254,35
1616,2,2635,1322,1313,0,0,0,1.0,1,1.0,1,1.0,1,0.16559426641993755,37
1617,1,2636,1323,1313,0,0,0,1.0,1,1.0,1,1.0,1,0.19688301345196416,38
1618,1,2637,1324,1313,0,0,0,1.0,1,1.0,1,1.0,1,0.22700304971113472,38
1619,3,2640,1325,1315,0,0,0,1.0,1,1.0,1,1.0,1,0.21178060203915325,38
1620,4,2644,1326,1318,0,0,0,1.0,1,1.0,1,1.0,1,0.2078827557717215,39
1621,0,2644,1326,1318,0,0,0,1.0,1,1.0,1,1.0,1,0.23585451206517263,37
1622,1,2645,1326,1319,0,0,0,1.0,1,1.0,1,1.0,1,0.2523957397802243,37
1623,3,2648,1329,1319,0,0,0,1.0,1,1.0,1,1.0,1,0.2815504079247395,37
1624,2,2650,1331,1319,0,0,0,1.0,1,1.0,1,1.0,1,0.30884546140198554,37
1625,1,2651,1332,1319,0,0,0,1.0,1,1.0,1,1.0,1,0.3077522863792694,35
1626,2,2653,1333,1320,0,0,0,1.0,1,1.0,1,1.0,1,0.35814210809890323,35
1627,1,2654,1333,1321,0,0,0,1.0,1,1.0,1,1.0,1,0.31282491995448575,34
1628,2,2656,1334,1322,0,0,0,1.0,1,1.0,1,1.0,1,0.3149976151710111,35
1629,2,2658,1335,1323,0,0,0,1.0,1,1.0,1,1.0,1,0.3260374843275925,34
1630,1,2659,1335,1324,0,0,0,1.0,1,1.0,1,1.0,1,0.29513813761165586,32
1631,1,2660,1335,1325,0,0,0,1.0,1,1.0,1,1.0,1,0.2841315781337809,33
1632,0,2660,1335,1325,0,0,0,1.0,1,1.0,1,1.0,1,0.2863693185474126,32
1633,0,2660,1335,1325,0,0,0,1.0,1,1.0,1,1.0,1,0.28255924972443974,31
1634,1,2661,1336,1325,0,0,0,1.0,1,1.0,1,1.0,1,0.32120384922740963,31
1635,0,2661,1336,1325,0,0,0,1.0,1,1.0,1,1.0,1,0.33533596781829983,31
1636,2,2663,1337,1326,0,0,0,1.0,1,1.0,1,1.0,1,0.30602964210277367,33
1637,2,2665,1337,1328,0,0,0,1.0,1,1.0,1,1.0,1,0.2670772751115123,33
1638,0,2665,1337,1328,0,0,0,1.0,1,1.0,1,1.0,1,0.2837128375991495,36
1639,0,2665,1337,1328,0,0,0,1.0,1,1.0,1,1.0,1,0.2837128375991495,36
1640,2,2667,1338,1329,0,0,0,1.0,1,1.0,1,1.0,1,0.2988553818230766,36
1641,1,2668,1339,1329,0,0,0,1.0,1,1.0,1,1.0,1,0.28418664548623085,38
1642,3,2671,1341,1330,0,0,0,1.0,1,1.0,1,1.0,1,0.2882232981223414,37
1643,1,2672,1342,1330,0,0,0,1.0,1,1.0,1,1.0,1,0.2996151500499356,37
1644,4,2676,1344,1332,0,0,0,1.0,1,1.0,1,1.0,1,0.3374344114734158,38
1645,1,2677,1344,1333,0,0,0,1.0,1,1.0,1,1.0,1,0.34322968917051555,36
1646,2,2679,1345,1334,0,0,0,1.0,1,1.0,1,1.0,1,0.3367436657838076,37
1647,1,2680,1346,1334,0,0,0,1.0,1,1.0,1,1.0,1,0.3595289142645056,35
1648,2,2682,1346,1336,0,0,0,1.0,1,1.0,1,1.0,1,0.3496189016645819,38
1649,1,2683,1347,1336,0,0,0,1.0,1,1.0,1,1.0,1,0.35557513748182906,35
1650,0,2683,1347,1336,0,0,0,1.0,1,1.0,1,1.0,1,0.37017235154475836,34
1651,0,2683,1347,1336,0,0,0,1.0,1,1.0,1,1.0,1,0.3986265956789441,32
1652,1,2684,1347,1337,0,0,0,1.0,1,1.0,1,1.0,1,0.3718741891985478,33
1653,0,2684,1347,1337,0,0,0,1.0,1,1.0,1,1.0,1,0.3718741891985478,33
1654,1,2685,1347,1338,0,0,0,1.0,1,1.0,1,1.0,1,0.37802349796227774,34
1655,3,2688,1347,1341,0,0,0,1.0,1,1.0,1,1.0,1,0.3043404338584221,35
1656,0,2688,1347,1341,0,0,0,1.0,1,1.0,1,1.0,1,0.3043404338584221,35
1657,4,2692,1347,1345,0,0,0,1.0,1,1.0,1,1.0,1,0.23194271158269802,36
1658,1,2693,1348,1345,0,0,0,1.0,1,1.0,1,1.0,1,0.21110626058024318,36
1659,0,2693,1348,1345,0,0,0,1.0,1,1.0,1,1.0,1,0.21110626058024318,36
1660,4,2697,1352,1345,0,0,0,1.0,1,1.0,1,1.0,1,0.25758118956524684,38
1661,1,2698,1352,1346,0,0,0,1.0,1,1.0,1,1.0,1,0.22172533205384246,38
1662,4,2702,1355,1347,0,0,0,1.0,1,1.0,1,1.0,1,0.23483250362125457,39
1663,4,2706,1356,1350,0,0,0,1.0,1,1.0,1,1.0,1,0.19825492932680572,40
1664,3,2709,1357,1352,0,0,0,1.0,1,1.0,1,1.0,1,0.17732274499735365,39
1665,2,2711,1358,1353,0,0,0,1.0,1,1.0,1,1.0,1,0.19515335650862514,40
1666,1,2712,1359,1353,0,0,0,1.0,1,1.0,1,1.0,1,0.23157150649288544,40
1667,1,2713,1360,1353,0,0,0,1.0,1,1.0,1,1.0,1,0.2333756144706811,40
1668,1,2714,1361,1353,0,0,0,1.0,1,1.0,1,1.0,1,0.22378688449275438,41
1669,0,2714,1361,1353,0,0,0,1.0,1,1.0,1,1.0,1,0.21231090470959216,40
1670,1,2715,1362,1353,0,0,0,1.0,1,1.0,1,1.0,1,0.2121242196323956,40
1671,2,2717,1363,1354,0,0,0,1.0,1,1.0,1,1.0,1,0.25645223688763785,41
1672,2,2719,1364,1355,0,0,0,1.0,1,1.0,1,1.0,1,0.2533262295865578,40
1673,3,2722,1365,1357,0,0,0,1.0,1,1.0,1,1.0,1,0.24074315316143707,39
1674,0,2722,1365,1357,0,0,0,1.0,1,1.0,1,1.0,1,0.2549362663613148,40
1675,1,2723,1365,1358,0,0,0,1.0,1,1.0,1,1.0,1,0.2190905753276977,38
1676,0,2723,1365,1358,0,0,0,1.0,1,1.0,1,1.0,1,0.2313676334493706,39
1677,1,2724,1365,1359,0,0,0,1.0,1,1.0,1,1.0,1,0.22218867204835338,39
1678,0,2724,1365,1359,0,0,0,1.0,1,1.0,1,1.0,1,0.22218867204835338,39
1679,1,2725,1366,1359,0,0,0,1.0,1,1.0,1,1.0,1,0.22997832079137553,39
1680,2,2727,1367,1360,0,0,0,1.0,1,1.0,1,1.0,1,0.24702928842650704,41
1681,4,2731,1368,1363,0,0,0,1.0,1,1.0,1,1.0,1,0.17239102734065267,41
1682,2,2733,1369,1364,0,0,0,1.0,1,1.0,1,1.0,1,0.21381645867580074,43
1683,2,2735,1371,1364,0,0,0,1.0,1,1.0,1,1.0,1,0.22387132818656574,43
1684,2,2737,1372,1365,0,0,0,1.0,1,1.0,1,1.0,1,0.22283971542657321,42
1685,1,2738,1373,1365,0,0,0,1.0,1,1.0,1,1.0,1,0.24016133949220217,41
1686,3,2741,1375,1366,0,0,0,1.0,1,1.0,1,1.0,1,0.28363517689328854,41
1687,2,2743,1377,1366,0,0,0,1.0,1,1.0,1,1.0,1,0.2893483223235198,40
1688,6,2749,1379,1370,0,0,0,1.0,1,1.0,1,1.0,1,0.2810087941457611,39
1689,3,2752,1380,1372,0,0,0,1.0,1,1.0,1,1.0,1,0.2777315457894129,38
1690,3,2755,1382,1373,0,0,0,1.0,1,1.0,1,1.0,1,0.27372933596890403,38
1691,1,2756,1382,1374,0,0,0,1.0,1,1.0,1,1.0,1,0.27479578871152816,36
1692,0,2756,1382,1374,0,0,0,1.0,1,1.0,1,1.0,1,0.24992438022530283,36
1693,1,2757,1383,1374,0,0,0,1.0,1,1.0,1,1.0,1,0.26185021502319145,35
1694,0,2757,1383,1374,0,0,0,1.0,1,1.0,1,1.0,1,0.23674472992403936,33
1695,1,2758,1383,1375,0,0,0,1.0,1,1.0,1,1.0,1,0.21919951120541592,34
1696,0,2758,1383,1375,0,0,0,1.0,1,1.0,1,1.0,1,0.23855822565552842,35
1697,0,2758,1383,1375,0,0,0,1.0,1,1.0,1,1.0,1,0.23151705168497902,36
1698,1,2759,1384,1375,0,0,0,1.0,1,1.0,1,1.0,1,0.27099432248259114,38
1699,1,2760,1385,1375,0,0,0,1.0,1,1.0,1,1.0,1,0.29500325284903095,38
1700,2,2762,1385,1377,0,0,0,1.0,1,1.0,1,1.0,1,0.2553609306145684,39
1701,0,2762,1385,1377,0,0,0,1.0,1,1.0,1,1.0,1,0.2647386646607309,40
1702,4,2766,1389,1377,0,0,0,1.0,1,1.0,1,1.0,1,0.3425188817416514,41
1703,4,2770,1390,1380,0,0,0,1.0,1,1.0,1,1.0,1,0.3257334828016225,41
1704,3,2773,1392,1381,0,0,0,1.0,1,1.0,1,1.0,1,0.2830909594964078,41
1705,1,2774,1393,1381,0,0,0,1.0,1,1.0,1,1.0,1,0.27960992947418634,40
1706,1,2775,1393,1382,0,0,0,1.0,1,1.0,1,1.0,1,0.26200352624725326,40
1707,1,2776,1393,1383,0,0,0,1.0,1,1.0,1,1.0,1,0.26798906042876086,39
1708,2,2778,1393,1385,0,0,0,1.0,1,1.0,1,1.0,1,0.22803935955525445,39
1709,1,2779,1394,1385,0,0,0,1.0,1,1.0,1,1.0,1,0.24317677026550566,38
1710,4,2783,1395,1388,0,0,0,1.0,1,1.0,1,1.0,1,0.25165351889921855,39
1711,2,2785,1395,1390,0,0,0,1.0,1,1.0,1,1.0,1,0.2441264888335629,38
1712,2,2787,1397,1390,0,0,0,1.0,1,1.0,1,1.0,1,0.25603757808624267,38
1713,1,2788,1397,1391,0,0,0,1.0,1,1.0,1,1.0,1,0.27537439423223925,37
1714,0,2788,1397,1391,0,0,0,1.0,1,1.0,1,1.0,1,0.26863345510126674,38
1715,3,2791,1398,1393,0,0,0,1.0,1,1.0,1,1.0,1,0.2322174975500159,40
1716,1,2792,1399,1393,0,0,0,1.0,1,1.0,1,1.0,1,0.2531668240847819,39
1717,0,2792,1399,1393,0,0,0,1.0,1,1.0,1,1.0,1,0.2537687327686344,38
1718,0,2792,1399,1393,0,0,0,1.0,1,1.0,1,1.0,1,0.2873328514098742,38
1719,0,2792,1399,1393,0,0,0,1.0,1,1.0,1,1.0,1,0.2873328514098742,38
1720,0,2792,1399,1393,0,0,0,1.0,1,1.0,1,1.0,1,0.2838956241142943,41
1721,1,2793,1399,1394,0,0,0,1.0,1,1.0,1,1.0,1,0.2263332489127444,39
1722,2,2795,1401,1394,0,0,0,1.0,1,1.0,1,1.0,1,0.2748135102270486,40
1723,3,2798,1403,1395,0,0,0,1.0,1,1.0,1,1.0,1,0.26782729448898496,38
1724,0,2798,1403,1395,0,0,0,1.0,1,1.0,1,1.0,1,0.2875748910897609,37
1725,0,2798,1403,1395,0,0,0,1.0,1,1.0,1,1.0,1,0.30639672703055115,38
1726,2,2800,1404,1396,0,0,0,1.0,1,1.0,1,1.0,1,0.2996826231316219,37
1727,2,2802,1404,1398,0,0,0,1.0,1,1.0,1,1.0,1,0.2602342272559503,37
1728,0,2802,1404,1398,0,0,0,1.0,1,1.0,1,1.0,1,0.2566101198746855,35
1729,1,2803,1404,1399,0,0,0,1.0,1,1.0,1,1.0,1,0.2314451447502954,37
1730,1,2804,1405,1399,0,0,0,1.0,1,1.0,1,1.0,1,0.30009870739390293,37
1731,0,2804,1405,1399,0,0,0,1.0,1,1.0,1,1.0,1,0.30009870739390293,37
1732,1,2805,1405,1400,0,0,0,1.0,1,1.0,1,1.0,1,0.33656044757275144,37
1733,3,2808,1407,1401,0,0,0,1.0,1,1.0,1,1.0,1,0.34545134976086045,36
1734,2,2810,1407,1403,0,0,0,1.0,1,1.0,1,1.0,1,0.30410409348120443,35
1735,1,2811,1408,1403,0,0,0,1.0,1,1.0,1,1.0,1,0.29483231168618057,34
1736,1,2812,1408,1404,0,0,0,1.0,1,1.0,1,1.0,1,0.282862158174893,35
1737,3,2815,1410,1405,0,0,0,1.0,1,1.0,1,1.0,1,0.26517100381497044,36
1738,2,2817,1411,1406,0,0,0,1.0,1,1.0,1,1.0,1,0.2834609707157415,37
1739,3,2820,1414,1406,0,0,0,1.0,1,1.0,1,1.0,1,0.24316378703832114,38
1740,0,2820,1414,1406,0,0,0,1.0,1,1.0,1,1.0,1,0.25956029317793083,37
1741,3,2823,1415,1408,0,0,0,1.0,1,1.0,1,1.0,1,0.22533758846330396,38
1742,2,2825,1417,1408,0,0,0,1.0,1,1.0,1,1.0,1,0.2847161159377394,39
1743,2,2827,1417,1410,0,0,0,1.0,1,1.0,1,1.0,1,0.24133930748430715,37
1744,2,2829,1419,1410,0,0,0,1.0,1,1.0,1,1.0,1,0.25081100531186495,38
1745,3,2832,1420,1412,0,0,0,1.0,1,1.0,1,1.0,1,0.2507948164062734,37
1746,1,2833,1420,1413,0,0,0,1.0,1,1.0,1,1.0,1,0.22926293456456137,38
1747,3,2836,1421,1415,0,0,0,1.0,1,1.0,1,1.0,1,0.1850324432973007,38
1748,2,2838,1422,1416,0,0,0,1.0,1,1.0,1,1.0,1,0.19828977527192052,38
1749,0,2838,1422,1416,0,0,0,1.0,1,1.0,1,1.0,1,0.21270159231529023,37
1750,1,2839,1422,1417,0,0,0,1.0,1,1.0,1,1.0,1,0.2160458268955813,39
1751,0,2839,1422,1417,0,0,0,1.0,1,1.0,1,1.0,1,0.2215124573786467,38
1752,0,2839,1422,1417,0,0,0,1.0,1,1.0,1,1.0,1,0.22670942281602066,39
1753,0,2839,1422,1417,0,0,0,1.0,1,1.0,1,1.0,1,0.22223032525484696,40
1754,1,2840,1423,1417,0,0,0,1.0,1,1.0,1,1.0,1,0.26278206058820686,41
1755,1,2841,1423,1418,0,0,0,1.0,1,1.0,1,1.0,1,0.259202884616142,41
1756,3,2844,1424,1420,0,0,0,1.0,1,1.0,1,1.0,1,0.23557797911458433,42
1757,1,2845,1424,1421,0,0,0,1.0,1,1.0,1,1.0,1,0.23815895738854956,42
1758,2,2847,1426,1421,0,0,0,1.0,1,1.0,1,1.0,1,0.2820312268872887,42
1759,2,2849,1427,1422,0,0,0,1.0,1,1.0,1,1.0,1,0.353392422905849,39
1760,5,2854,1428,1426,0,0,0,1.0,1,1.0,1,1.0,1,0.35503928973669435,39
1761,6,2860,1429,1431,0,0,0,1.0,1,1.0,1,1.0,1,0.21595087089180423,38
1762,2,2862,1430,1432,0,0,0,1.0,1,1.0,1,1.0,1,0.17915773232267168,37
1763,0,2862,1430,1432,0,0,0,1.0,1,1.0,1,1.0,1,0.17915773232267168,37
1764,1,2863,1431,1432,0,0,0,1.0,1,1.0,1,1.0,1,0.19759026613768732,36
1765,5,2868,1433,1435,0,0,0,1.0,1,1.0,1,1.0,1,0.1356665312091876,37
1766,0,2868,1433,1435,0,0,0,1.0,1,1.0,1,1.0,1,0.13716712688878788,36
1767,0,2868,1433,1435,0,0,0,1.0,1,1.0,1,1.0,1,0.13716712688878788,36
1768,0,2868,1433,1435,0,0,0,1.0,1,1.0,1,1.0,1,0.13716712688878788,36
1769,1,2869,1434,1435,0,0,0,1.0,1,1.0,1,1.0,1,0.13037804913458748,38
1770,0,2869,1434,1435,0,0,0,1.0,1,1.0,1,1.0,1,0.13037804913458748,38
1771,0,2869,1434,1435,0,0,0,1.0,1,1.0,1,1.0,1,0.13037804913458748,38
1772,0,2869,1434,1435,0,0,0,1.0,1,1.0,1,1.0,1,0.14334434774410615,40
1773,1,2870,1435,1435,0,0,0,1.0,1,1.0,1,1.0,1,0.1548606778916589,40
1774,0,2870,1435,1435,0,0,0,1.0,1,1.0,1,1.0,1,0.1548606778916589,40
1775,0,2870,1435,1435,0,0,0,1.0,1,1.0,1,1.0,1,0.1666292460011275,41
1776,0,2870,1435,1435,0,0,0,1.0,1,1.0,1,1.0,1,0.15143818578438012,43
1777,0,2870,1435,1435,0,0,0,1.0,1,1.0,1,1.0,1,0.16236908829628197,44
1778,3,2873,1438,1435,0,0,0,1.0,1,1.0,1,1.0,1,0.18732510324154703,44
1779,1,2874,1438,1436,0,0,0,1.0,1,1.0,1,1.0,1,0.15930766830550297,44
1780,1,2875,1438,1437,0,0,0,1.0,1,1.0,1,1.0,1,0.17887355110275868,46
1781,1,2876,1439,1437,0,0,0,1.0,1,1.0,1,1.0,1,0.20612868898113926,46
1782,5,2881,1443,1438,0,0,0,1.0,1,1.0,1,1.0,1,0.22895076762449781,45
1783,4,2885,1444,1441,0,0,0,1.0,1,1.0,1,1.0,1,0.19202841797979192,44
1784,2,2887,1445,1442,0,0,0,1.0,1,1.0,1,1.0,1,0.21887553961441528,44
1785,4,2891,1448,1443,0,0,0,1.0,1,1.0,1,1.0,1,0.22988055436799187,42
1786,5,2896,1450,1446,0,0,0,1.0,1,1.0,1,1.0,1,0.22449758570831058,42
1787,1,2897,1450,1447,0,0,0,1.0,1,1.0,1,1.0,1,0.23960792212118567,41
1788,4,2901,1453,1448,0,0,0,1.0,1,1.0,1,1.0,1,0.2606201948994783,41
1789,2,2903,1454,1449,0,0,0,1.0,1,1.0,1,1.0,1,0.2383208012738288,41
1790,2,2905,1454,1451,0,0,0,1.0,1,1.0,1,1.0,1,0.2040377197530567,41
1791,2,2907,1456,1451,0,0,0,1.0,1,1.0,1,1.0,1,0.20079025063290834,41
1792,1,2908,1457,1451,0,0,0,1.0,1,1.0,1,1.0,1,0.20911696986504172,43
1793,4,2912,1460,1452,0,0,0,1.0,1,1.0,1,1.0,1,0.18721204476746423,43
1794,2,2914,1462,1452,0,0,0,1.0,1,1.0,1,1.0,1,0.1757750893211202,41
1795,2,2916,1463,1453,0,0,0,1.0,1,1.0,1,1.0,1,0.16603030937578817,41
1796,5,2921,1464,1457,0,0,0,1.0,1,1.0,1,1.0,1,0.16515988716034236,40
1797,2,2923,1465,1458,0,0,0,1.0,1,1.0,1,1.0,1,0.20617996340035777,38
1798,0,2923,1465,1458,0,0,0,1.0,1,1.0,1,1.0,1,0.20617996340035777,38
1799,0,2923,1465,1458,0,0,0,1.0,1,1.0,1,1.0,1,0.18539443102374975,37
1800,3,2926,1466,1460,0,0,0,1.0,1,1.0,1,1.0,1,0.21335787263213182,35
1801,1,2927,1466,1461,0,0,0,1.0,1,1.0,1,1.0,1,0.17122413433216704,34
1802,0,2927,1466,1461,0,0,0,1.0,1,1.0,1,1.0,1,0.1653812906377975,33
1803,1,2928,1467,1461,0,0,0,1.0,1,1.0,1,1.0,1,0.20130169062932746,33
1804,3,2931,1469,1462,0,0,0,1.0,1,1.0,1,1.0,1,0.2550137691719708,33
1805,1,2932,1469,1463,0,0,0,1.0,1,1.0,1,1.0,1,0.21534927159746234,35
1806,2,2934,1469,1465,0,0,0,1.0,1,1.0,1,1.0,1,0.1815609830236241,36
1807,0,2934,1469,1465,0,0,0,1.0,1,1.0,1,1.0,1,0.24705583767472075,35
1808,1,2935,1469,1466,0,0,0,1.0,1,1.0,1,1.0,1,0.22628230484240153,37
1809,0,2935,1469,1466,0,0,0,1.0,1,1.0,1,1.0,1,0.2340537350170954,35
1810,1,2936,1469,1467,0,0,0,1.0,1,1.0,1,1.0,1,0.22304427495199672,36
1811,1,2937,1469,1468,0,0,0,1.0,1,1.0,1,1.0,1,0.23671575900649522,34
1812,0,2937,1469,1468,0,0,0,1.0,1,1.0,1,1.0,1,0.2571830591979435,36
1813,0,2937,1469,1468,0,0,0,1.0,1,1.0,1,1.0,1,0.2739734148970691,35
1814,2,2939,1471,1468,0,0,0,1.0,1,1.0,1,1.0,1,0.27187239063776697,36
1815,1,2940,1471,1469,0,0,0,1.0,1,1.0,1,1.0,1,0.26995087526964306,35
1816,1,2941,1472,1469,0,0,0,1.0,1,1.0,1,1.0,1,0.26848109181857915,35
1817,1,2942,1473,1469,0,0,0,1.0,1,1.0,1,1.0,1,0.26755114293436777,35
1818,4,2946,1476,1470,0,0,0,1.0,1,1.0,1,1.0,1,0.2626064303274552,36
1819,4,2950,1477,1473,0,0,0,1.0,1,1.0,1,1.0,1,0.19452578679969895,37
1820,1,2951,1477,1474,0,0,0,1.0,1,1.0,1,1.0,1,0.16859714514050678,37
1821,1,2952,1478,1474,0,0,0,1.0,1,1.0,1,1.0,1,0.15638453463684784,38
1822,4,2956,1481,1475,0,0,0,1.0,1,1.0,1,1.0,1,0.2468395717038075,37
1823,4,2960,1484,1476,0,0,0,1.0,1,1.0,1,1.0,1,0.25095536783278494,36
1824,2,2962,1486,1476,0,0,0,1.0,1,1.0,1,1.0,1,0.2625135352146552,36
1825,2,2964,1487,1477,0,0,0,1.0,1,1.0,1,1.0,1,0.22206985424673437,34
1826,2,2966,1488,1478,0,0,0,1.0,1,1.0,1,1.0,1,0.20208801920333916,35
1827,2,2968,1490,1478,0,0,0,1.0,1,1.0,1,1.0,1,0.20758779434290958,34
1828,2,2970,1492,1478,0,0,0,1.0,1,1.0,1,1.0,1,0.2313381998987984,33
1829,1,2971,1493,1478,0,0,0,1.0,1,1.0,1,1.0,1,0.24747219187680225,31
1830,0,2971,1493,1478,0,0,0,1.0,1,1.0,1,1.0,1,0.24644145230625106,31
1831,1,2972,1494,1478,0,0,0,1.0,1,1.0,1,1.0,1,0.2646263236393578,30
1832,0,2972,1494,1478,0,0,0,1.0,1,1.0,1,1.0,1,0.2560350433507267,29
1833,4,2976,1496,1480,0,0,0,1.0,1,1.0,1,1.0,1,0.3148750018216696,28
1834,2,2978,1497,1481,0,0,0,1.0,1,1.0,1,1.0,1,0.25251862381749657,27
1835,3,2981,1500,1481,0,0,0,1.0,1,1.0,1,1.0,1,0.332453021298425,26
1836,2,2983,1501,1482,0,0,0,1.0,1,1.0,1,1.0,1,0.30676485580202195,26
1837,3,2986,1501,1485,0,0,0,1.0,1,1.0,1,1.0,1,0.2564862411679495,25
1838,0,2986,1501,1485,0,0,0,1.0,1,1.0,1,1.0,1,0.23606094228920232,25
1839,0,2986,1501,1485,0,0,0,1.0,1,1.0,1,1.0,1,0.2894242129548516,24
1840,2,2988,1502,1486,0,0,0,1.0,1,1.0,1,1.0,1,0.33980020942911904,23
1841,0,2988,1502,1486,0,0,0,1.0,1,1.0,1,1.0,1,0.31255462007610507,22
1842,2,2990,1503,1487,0,0,0,1.0,1,1.0,1,1.0,1,0.324230311942122,23
1843,1,2991,1504,1487,0,0,0,1.0,1,1.0,1,1.0,1,0.31161631964569214,23
1844,1,2992,1505,1487,0,0,0,1.0,1,1.0,1,1.0,1,0.34838457262641326,23
1845,2,2994,1507,1487,0,0,0,1.0,1,1.0,1,1.0,1,0.3564304217381322,23
1846,1,2995,1507,1488,0,0,0,1.0,1,1.0,1,1.0,1,0.32054072508438053,23
1847,0,2995,1507,1488,0,0,0,1.0,1,1.0,1,1.0,1,0.34013297158099376,24
1848,0,2995,1507,1488,0,0,0,1.0,1,1.0,1,1.0,1,0.34013297158099376,24
1849,0,2995,1507,1488,0,0,0,1.0,1,1.0,1,1.0,1,0.36353560426016607,25
1850,0,2995,1507,1488,0,0,0,1.0,1,1.0,1,1.0,1,0.36353560426016607,25
1851,0,2995,1507,1488,0,0,0,1.0,1,1.0,1,1.0,1,0.36353560426016607,25
1852,0,2995,1507,1488,0,0,0,1.0,1,1.0,1,1.0,1,0.36353560426016607,25
1853,0,2995,1507,1488,0,0,0,1.0,1,1.0,1,1.0,1,0.37560558443440684,25
1854,0,2995,1507,1488,0,0,0,1.0,1,1.0,1,1.0,1,0.37560558443440684,25
1855,1,2996,1507,1489,0,0,0,1.0,1,1.0,1,1.0,1,0.36696534209153586,26
1856,0,2996,1507,1489,0,0,0,1.0,1,1.0,1,1.0,1,0.350901811278368,27
1857,0,2996,1507,1489,0,0,0,1.0,1,1.0,1,1.0,1,0.3449653659426327,28
1858,2,2998,1509,1489,0,0,0,1.0,1,1.0,1,1.0,1,0.3515005231654228,28
1859,4,3002,1511,1491,0,0,0,1.0,1,1.0,1,1.0,1,0.35440056647733276,28
1860,0,3002,1511,1491,0,0,0,1.0,1,1.0,1,1.0,1,0.35440056647733276,28
1861,0,3002,1511,1491,0,0,0,1.0,1,1.0,1,1.0,1,0.35440056647733276,28
1862,0,3002,1511,1491,0,0,0,1.0,1,1.0,1,1.0,1,0.35440056647733276,28
1863,1,3003,1512,1491,0,0,0,1.0,1,1.0,1,1.0,1,0.36803473253223995,29
1864,1,3004,1513,1491,0,0,0,1.0,1,1.0,1,1.0,1,0.3531512507381367,27
1865,2,3006,1514,1492,0,0,0,1.0,1,1.0,1,1.0,1,0.37502517459654533,26
1866,1,3007,1515,1492,0,0,0,1.0,1,1.0,1,1.0,1,0.41313886091495,26
1867,0,3007,1515,1492,0,0,0,1.0,1,1.0,1,1.0,1,0.41313886091495,26
1868,1,3008,1515,1493,0,0,0,1.0,1,1.0,1,1.0,1,0.36815733451802707,26
1869,1,3009,1515,1494,0,0,0,1.0,1,1.0,1,1.0,1,0.35033592699571253,26
1870,0,3009,1515,1494,0,0,0,1.0,1,1.0,1,1.0,1,0.3687377437403143,27
1871,1,3010,1516,1494,0,0,0,1.0,1,1.0,1,1.0,1,0.37556504226147125,27
1872,0,3010,1516,1494,0,0,0,1.0,1,1.0,1,1.0,1,0.3672861916843798,25
1873,1,3011,1516,1495,0,0,0,1.0,1,1.0,1,1.0,1,0.30800384151605875,25
1874,2,3013,1516,1497,0,0,0,1.0,1,1.0,1,1.0,1,0.3198452043961156,25
1875,1,3014,1516,1498,0,0,0,1.0,1,1.0,1,1.0,1,0.2844099679248166,25
1876,0,3014,1516,1498,0,0,0,1.0,1,1.0,1,1.0,1,0.28156933204439505,26
1877,0,3014,1516,1498,0,0,0,1.0,1,1.0,1,1.0,1,0.265106105355805,27
1878,2,3016,1518,1498,0,0,0,1.0,1,1.0,1,1.0,1,0.2946971035979542,28
1879,1,3017,1518,1499,0,0,0,1.0,1,1.0,1,1.0,1,0.249636208312679,29
1880,0,3017,1518,1499,0,0,0,1.0,1,1.0,1,1.0,1,0.249636208312679,29
1881,0,3017,1518,1499,0,0,0,1.0,1,1.0,1,1.0,1,0.249636208312679,29
1882,0,3017,1518,1499,0,0,0,1.0,1,1.0,1,1.0,1,0.23278178627007662,28
1883,0,3017,1518,1499,0,0,0,1.0,1,1.0,1,1.0,1,0.23278178627007662,28
1884,1,3018,1519,1499,0,0,0,1.0,1,1.0,1,1.0,1,0.2495932484754333,28
1885,0,3018,1519,1499,0,0,0,1.0,1,1.0,1,1.0,1,0.2495932484754333,28
1886,0,3018,1519,1499,0,0,0,1.0,1,1.0,1,1.0,1,0.24419244877504168,29
1887,0,3018,1519,1499,0,0,0,1.0,1,1.0,1,1.0,1,0.24419244877504168,29
1888,1,3019,1519,1500,0,0,0,1.0,1,1.0,1,1.0,1,0.26499075198020194,31
1889,0,3019,1519,1500,0,0,0,1.0,1,1.0,1,1.0,1,0.26499075198020194,31
1890,1,3020,1520,1500,0,0,0,1.0,1,1.0,1,1.0,1,0.2858181117321814,31
1891,0,3020,1520,1500,0,0,0,1.0,1,1.0,1,1.0,1,0.30279643964671016,32
1892,0,3020,1520,1500,0,0,0,1.0,1,1.0,1,1.0,1,0.30279643964671016,32
1893,0,3020,1520,1500,0,0,0,1.0,1,1.0,1,1.0,1,0.30279643964671016,32
1894,0,3020,1520,1500,0,0,0,1.0,1,1.0,1,1.0,1,0.2877101214262135,33
1895,3,3023,1521,1502,0,0,0,1.0,1,1.0,1,1.0,1,0.2571878129325313,35
1896,0,3023,1521,1502,0,0,0,1.0,1,1.0,1,1.0,1,0.2840295974889091,34
1897,0,3023,1521,1502,0,0,0,1.0,1,1.0,1,1.0,1,0.2840295974889091,34
1898,0,3023,1521,1502,0,0,0,1.0,1,1.0,1,1.0,1,0.2840295974889091,34
1899,0,3023,1521,1502,0,0,0,1.0,1,1.0,1,1.0,1,0.2840295974889091,34
1900,3,3026,1521,1505,0,0,0,1.0,1,1.0,1,1.0,1,0.2012980956229387,35
1901,0,3026,1521,1505,0,0,0,1.0,1,1.0,1,1.0,1,0.2012980956229387,35
1902,0,3026,1521,1505,0,0,0,1.0,1,1.0,1,1.0,1,0.2012980956229387,35
1903,0,3026,1521,1505,0,0,0,1.0,1,1.0,1,1.0,1,0.2012980956229387,35
1904,0,3026,1521,1505,0,0,0,1.0,1,1.0,1,1.0,1,0.2012980956229387,35
1905,0,3026,1521,1505,0,0,0,1.0,1,1.0,1,1.0,1,0.19050384277875032,37
1906,0,3026,1521,1505,0,0,0,1.0,1,1.0,1,1.0,1,0.19050384277875032,37
1907,1,3027,1521,1506,0,0,0,1.0,1,1.0,1,1.0,1,0.1729542703858144,39
1908,0,3027,1521,1506,0,0,0,1.0,1,1.0,1,1.0,1,0.1729542703858144,39
1909,0,3027,1521,1506,0,0,0,1.0,1,1.0,1,1.0,1,0.18988328493080348,41
1910,0,3027,1521,1506,0,0,0,1.0,1,1.0,1,1.0,1,0.18988328493080348,41
1911,0,3027,1521,1506,0,0,0,1.0,1,1.0,1,1.0,1,0.22491270180122244,40
1912,3,3030,1524,1506,0,0,0,1.0,1,1.0,1,1.0,1,0.25969065801239355,39
1913,4,3034,1526,1508,0,0,0,1.0,1,1.0,1,1.0,1,0.25271041639205916,40
1914,1,3035,1527,1508,0,0,0,1.0,1,1.0,1,1.0,1,0.26042552633258303,41
1915,5,3040,1529,1511,0,0,0,1.0,1,1.0,1,1.0,1,0.24238531664175417,42
1916,2,3042,1530,1512,0,0,0,1.0,1,1.0,1,1.0,1,0.21367670004060593,42
1917,1,3043,1531,1512,0,0,0,1.0,1,1.0,1,1.0,1,0.2288695754442143,41
1918,2,3045,1533,1512,0,0,0,1.0,1,1.0,1,1.0,1,0.2314332706907394,38
1919,2,3047,1534,1513,0,0,0,1.0,1,1.0,1,1.0,1,0.27142932288442234,38
1920,0,3047,1534,1513,0,0,0,1.0,1,1.0,1,1.0,1,0.2947066668543989,38
1921,1,3048,1534,1514,0,0,0,1.0,1,1.0,1,1.0,1,0.24323673778246288,39
1922,0,3048,1534,1514,0,0,0,1.0,1,1.0,1,1.0,1,0.2343611698767209,40
1923,1,3049,1535,1514,0,0,0,1.0,1,1.0,1,1.0,1,0.22254124213989218,41
1924,3,3052,1538,1514,0,0,0,1.0,1,1.0,1,1.0,1,0.3022478408055552,41
1925,3,3055,1538,1517,0,0,0,1.0,1,1.0,1,1.0,1,0.20568371606877556,41
1926,0,3055,1538,1517,0,0,0,1.0,1,1.0,1,1.0,1,0.20568371606877556,41
1927,1,3056,1538,1518,0,0,0,1.0,1,1.0,1,1.0,1,0.19970512463469164,41
1928,2,3058,1540,1518,0,0,0,1.0,1,1.0,1,1.0,1,0.20103068866051538,42
1929,0,3058,1540,1518,0,0,0,1.0,1,1.0,1,1.0,1,0.2058288393965291,41
1930,0,3058,1540,1518,0,0,0,1.0,1,1.0,1,1.0,1,0.2058288393965291,41
1931,0,3058,1540,1518,0,0,0,1.0,1,1.0,1,1.0,1,0.2058288393965291,41
1932,0,3058,1540,1518,0,0,0,1.0,1,1.0,1,1.0,1,0.2058288393965291,41
1933,1,3059,1541,1518,0,0,0,1.0,1,1.0,1,1.0,1,0.2523198415070414,43
1934,0,3059,1541,1518,0,0,0,1.0,1,1.0,1,1.0,1,0.2617190022167601,44
1935,0,3059,1541,1518,0,0,0,1.0,1,1.0,1,1.0,1,0.24637046952226851,45
1936,2,3061,1541,1520,0,0,0,1.0,1,1.0,1,1.0,1,0.20288817128460424,48
1937,3,3064,1543,1521,0,0,0,1.0,1,1.0,1,1.0,1,0.21017075599660565,48
1938,1,3065,1544,1521,0,0,0,1.0,1,1.0,1,1.0,1,0.2140163373350501,48
1939,0,3065,1544,1521,0,0,0,1.0,1,1.0,1,1.0,1,0.2140163373350501,48
1940,0,3065,1544,1521,0,0,0,1.0,1,1.0,1,1.0,1,0.2140163373350501,48
1941,0,3065,1544,1521,0,0,0,1.0,1,1.0,1,1.0,1,0.2140163373350501,48
1942,3,3068,1545,1523,0,0,0,1.0,1,1.0,1,1.0,1,0.2405756832577917,49
1943,0,3068,1545,1523,0,0,0,1.0,1,1.0,1,1.0,1,0.23653122676092894,48
1944,4,3072,1548,1524,0,0,0,1.0,1,1.0,1,1.0,1,0.2811724728701725,47
1945,6,3078,1549,1529,0,0,0,1.0,1,1.0,1,1.0,1,0.23075719276176382,46
1946,2,3080,1550,1530,0,0,0,1.0,1,1.0,1,1.0,1,0.26524091418563495,46
1947,4,3084,1552,1532,0,0,0,1.0,1,1.0,1,1.0,1,0.30381253749431253,45
1948,3,3087,1552,1535,0,0,0,1.0,1,1.0,1,1.0,1,0.26826496372617853,46
1949,1,3088,1553,1535,0,0,0,1.0,1,1.0,1,1.0,1,0.30676409505063607,42
1950,0,3088,1553,1535,0,0,0,1.0,1,1.0,1,1.0,1,0.3034490965667966,40
1951,3,3091,1556,1535,0,0,0,1.0,1,1.0,1,1.0,1,0.3529827636232239,39
1952,1,3092,1557,1535,0,0,0,1.0,1,1.0,1,1.0,1,0.3854519176015671,35
1953,6,3098,1560,1538,0,0,0,1.0,1,1.0,1,1.0,1,0.3413221326004392,36
1954,1,3099,1561,1538,0,0,0,1.0,1,1.0,1,1.0,1,0.35822895981453423,34
1955,1,3100,1561,1539,0,0,0,1.0,1,1.0,1,1.0,1,0.35651579012034185,35
1956,5,3105,1563,1542,0,0,0,1.0,1,1.0,1,1.0,1,0.33241201453583225,37
1957,3,3108,1563,1545,0,0,0,1.0,1,1.0,1,1.0,1,0.25963121069587763,37
1958,1,3109,1563,1546,0,0,0,1.0,1,1.0,1,1.0,1,0.24017025923280788,39
1959,0,3109,1563,1546,0,0,0,1.0,1,1.0,1,1.0,1,0.24731294084571454,41
1960,0,3109,1563,1546,0,0,0,1.0,1,1.0,1,1.0,1,0.23447464197752046,40
1961,1,3110,1563,1547,0,0,0,1.0,1,1.0,1,1.0,1,0.2114093906097048,41
1962,1,3111,1564,1547,0,0,0,1.0,1,1.0,1,1.0,1,0.26928324000416004,40
1963,2,3113,1564,1549,0,0,0,1.0,1,1.0,1,1.0,1,0.2634994798275489,41
1964,1,3114,1565,1549,0,0,0,1.0,1,1.0,1,1.0,1,0.2749660570769004,40
1965,1,3115,1565,1550,0,0,0,1.0,1,1.0,1,1.0,1,0.24419315844210723,41
1966,0,3115,1565,1550,0,0,0,1.0,1,1.0,1,1.0,1,0.24419315844210723,41
1967,2,3117,1566,1551,0,0,0,1.0,1,1.0,1,1.0,1,0.2660388872508058,42
1968,0,3117,1566,1551,0,0,0,1.0,1,1.0,1,1.0,1,0.2757664204901316,42
1969,2,3119,1567,1552,0,0,0,1.0,1,1.0,1,1.0,1,0.253621630587199,43
1970,0,3119,1567,1552,0,0,0,1.0,1,1.0,1,1.0,1,0.2729314838207448,42
1971,0,3119,1567,1552,0,0,0,1.0,1,1.0,1,1.0,1,0.2729314838207448,42
1972,0,3119,1567,1552,0,0,0,1.0,1,1.0,1,1.0,1,0.2729314838207448,42
1973,1,3120,1567,1553,0,0,0,1.0,1,1.0,1,1.0,1,0.26616916282862846,43
1974,0,3120,1567,1553,0,0,0,1.0,1,1.0,1,1.0,1,0.2752740240217797,43
1975,1,3121,1567,1554,0,0,0,1.0,1,1.0,1,1.0,1,0.26975900894445043,43
1976,2,3123,1568,1555,0,0,0,1.0,1,1.0,1,1.0,1,0.2560213977964465,43
1977,4,3127,1568,1559,0,0,0,1.0,1,1.0,1,1.0,1,0.25390035460445953,48
1978,2,3129,1570,1559,0,0,0,1.0,1,1.0,1,1.0,1,0.2741119598861017,48
1979,1,3130,1570,1560,0,0,0,1.0,1,1.0,1,1.0,1,0.2781693419868726,49
1980,4,3134,1570,1564,0,0,0,1.0,1,1.0,1,1.0,1,0.22830360932098812,50
1981,1,3135,1571,1564,0,0,0,1.0,1,1.0,1,1.0,1,0.2222153060499206,50
1982,4,3139,1574,1565,0,0,0,1.0,1,1.0,1,1.0,1,0.19282761969332451,50
1983,2,3141,1575,1566,0,0,0,1.0,1,1.0,1,1.0,1,0.19680396610992276,49
1984,2,3143,1577,1566,0,0,0,1.0,1,1.0,1,1.0,1,0.20643701970090386,48
1985,0,3143,1577,1566,0,0,0,1.0,1,1.0,1,1.0,1,0.1985587901664736,46
1986,0,3143,1577,1566,0,0,0,1.0,1,1.0,1,1.0,1,0.1985587901664736,46
1987,3,3146,1579,1567,0,0,0,1.0,1,1.0,1,1.0,1,0.24144130698871535,42
1988,1,3147,1579,1568,0,0,0,1.0,1,1.0,1,1.0,1,0.22440405566180757,40
1989,4,3151,1583,1568,0,0,0,1.0,1,1.0,1,1.0,1,0.2387627281576931,38
1990,2,3153,1583,1570,0,0,0,1.0,1,1.0,1,1.0,1,0.18898107316815718,38
1991,1,3154,1584,1570,0,0,0,1.0,1,1.0,1,1.0,1,0.2326435916387494,38
1992,1,3155,1584,1571,0,0,0,1.0,1,1.0,1,1.0,1,0.24058201515097735,39
1993,2,3157,1585,1572,0,0,0,1.0,1,1.0,1,1.0,1,0.26435741398505724,38
1994,1,3158,1586,1572,0,0,0,1.0,1,1.0,1,1.0,1,0.25007241107071393,37
1995,3,3161,1587,1574,0,0,0,1.0,1,1.0,1,1.0,1,0.2417316330661286,37
1996,0,3161,1587,1574,0,0,0,1.0,1,1.0,1,1.0,1,0.24068313563426483,37
1997,0,3161,1587,1574,0,0,0,1.0,1,1.0,1,1.0,1,0.2750257588769663,35
1998,1,3162,1588,1574,0,0,0,1.0,1,1.0,1,1.0,1,0.3111599480663604,34
1999,5,3167,1591,1576,0,0,0,1.0,1,1.0,1,1.0,1,0.2612754757896269,35
2000,0,3167,1591,1576,0,0,0,1.0,1,1.0,1,1.0,1,0.2773402781362716,34
2001,0,3167,1591,1576,0,0,0,1.0,1,1.0,1,1.0,1,0.2997833467871413,35
2002,2,3169,1591,1578,0,0,0,1.0,1,1.0,1,1.0,1,0.25882246252029995,36
2003,2,3171,1592,1579,0,0,0,1.0,1,1.0,1,1.0,1,0.24860504405423192,37
2004,5,3176,1594,1582,0,0,0,1.0,1,1.0,1,1.0,1,0.22104847300473823,38
2005,1,3177,1595,1582,0,0,0,1.0,1,1.0,1,1.0,1,0.23312703613192867,38
2006,0,3177,1595,1582,0,0,0,1.0,1,1.0,1,1.0,1,0.23312703613192867,38
2007,1,3178,1596,1582,0,0,0,1.0,1,1.0,1,1.0,1,0.23914674330669658,40
2008,1,3179,1597,1582,0,0,0,1.0,1,1.0,1,1.0,1,0.24062524528305132,40
2009,2,3181,1599,1582,0,0,0,1.0,1,1.0,1,1.0,1,0.2509443397572348,41
2010,0,3181,1599,1582,0,0,0,1.0,1,1.0,1,1.0,1,0.2509443397572348,41
2011,0,3181,1599,1582,0,0,0,1.0,1,1.0,1,1.0,1,0.2509443397572348,41
2012,0,3181,1599,1582,0,0,0,1.0,1,1.0,1,1.0,1,0.2509443397572348,41
2013,2,3183,1599,1584,0,0,0,1.0,1,1.0,1,1.0,1,0.24502789449359652,43
2014,0,3183,1599,1584,0,0,0,1.0,1,1.0,1,1.0,1,0.25772275700524905,43
2015,1,3184,1599,1585,0,0,0,1.0,1,1.0,1,1.0,1,0.24085681588076063,43
2016,0,3184,1599,1585,0,0,0,1.0,1,1.0,1,1.0,1,0.2569604263473609,44
2017,1,3185,1599,1586,0,0,0,1.0,1,1.0,1,1.0,1,0.24140086377639272,45
2018,3,3188,1600,1588,0,0,0,1.0,1,1.0,1,1.0,1,0.21342100090267616,46
2019,1,3189,1601,1588,0,0,0,1.0,1,1.0,1,1.0,1,0.21377505452758533,47
2020,3,3192,1603,1589,0,0,0,1.0,1,1.0,1,1.0,1,0.22857833596554103,47
2021,3,3195,1604,1591,0,0,0,1.0,1,1.0,1,1.0,1,0.2035318820124391,47
2022,2,3197,1604,1593,0,0,0,1.0,1,1.0,1,1.0,1,0.19017358368282877,48
2023,3,3200,1607,1593,0,0,0,1.0,1,1.0,1,1.0,1,0.22422084013306187,48
2024,1,3201,1608,1593,0,0,0,1.0,1,1.0,1,1.0,1,0.23504917377368512,45
2025,4,3205,1611,1594,0,0,0,1.0,1,1.0,1,1.0,1,0.31583141143130034,42
2026,4,3209,1612,1597,0,0,0,1.0,1,1.0,1,1.0,1,0.2541193947089151,44
2027,2,3211,1614,1597,0,0,0,1.0,1,1.0,1,1.0,1,0.2986636689616494,40
2028,3,3214,1616,1598,0,0,0,1.0,1,1.0,1,1.0,1,0.34919667946205696,39
2029,2,3216,1616,1600,0,0,0,1.0,1,1.0,1,1.0,1,0.3021655472165299,37
2030,2,3218,1617,1601,0,0,0,1.0,1,1.0,1,1.0,1,0.27634921439499616,34
2031,2,3220,1617,1603,0,0,0,1.0,1,1.0,1,1.0,1,0.2553975352944779,35
2032,2,3222,1618,1604,0,0,0,1.0,1,1.0,1,1.0,1,0.2615191713373106,34
2033,5,3227,1621,1606,0,0,0,1.0,1,1.0,1,1.0,1,0.24161160339433374,36
2034,0,3227,1621,1606,0,0,0,1.0,1,1.0,1,1.0,1,0.23767374699651617,34
2035,1,3228,1622,1606,0,0,0,1.0,1,1.0,1,1.0,1,0.25419192538872226,35
2036,2,3230,1623,1607,0,0,0,1.0,1,1.0,1,1.0,1,0.2130031159199408,34
2037,0,3230,1623,1607,0,0,0,1.0,1,1.0,1,1.0,1,0.21483765222096032,35
2038,0,3230,1623,1607,0,0,0,1.0,1,1.0,1,1.0,1,0.21516947262535824,36
2039,0,3230,1623,1607,0,0,0,1.0,1,1.0,1,1.0,1,0.21841716964325186,38
2040,0,3230,1623,1607,0,0,0,1.0,1,1.0,1,1.0,1,0.21841716964325186,38
2041,0,3230,1623,1607,0,0,0,1.0,1,1.0,1,1.0,1,0.22046132268351884,39
2042,0,3230,1623,1607,0,0,0,1.0,1,1.0,1,1.0,1,0.22046132268351884,39
2043,1,3231,1623,1608,0,0,0,1.0,1,1.0,1,1.0,1,0.17523043137902236,39
2044,0,3231,1623,1608,0,0,0,1.0,1,1.0,1,1.0,1,0.17523043137902236,39
2045,2,3233,1624,1609,0,0,0,1.0,1,1.0,1,1.0,1,0.17986737775696054,41
2046,0,3233,1624,1609,0,0,0,1.0,1,1.0,1,1.0,1,0.20122916746536051,42
2047,0,3233,1624,1609,0,0,0,1.0,1,1.0,1,1.0,1,0.20122916746536051,42
2048,2,3235,1625,1610,0,0,0,1.0,1,1.0,1,1.0,1,0.20822386314025523,43
2049,3,3238,1626,1612,0,0,0,1.0,1,1.0,1,1.0,1,0.2053673495814462,44
2050,1,3239,1626,1613,0,0,0,1.0,1,1.0,1,1.0,1,0.18622206274944383,44
2051,4,3243,1627,1616,0,0,0,1.0,1,1.0,1,1.0,1,0.2425079507323676,45
2052,0,3243,1627,1616,0,0,0,1.0,1,1.0,1,1.0,1,0.2425079507323676,45
2053,1,3244,1627,1617,0,0,0,1.0,1,1.0,1,1.0,1,0.22097412526381788,45
2054,0,3244,1627,1617,0,0,0,1.0,1,1.0,1,1.0,1,0.22552846399503282,46
2055,1,3245,1627,1618,0,0,0,1.0,1,1.0,1,1.0,1,0.2110092102069487,46
2056,2,3247,1628,1619,0,0,0,1.0,1,1.0,1,1.0,1,0.22071727706107785,46
2057,4,3251,1631,1620,0,0,0,1.0,1,1.0,1,1.0,1,0.1794651982632456,47
2058,3,3254,1633,1621,0,0,0,1.0,1,1.0,1,1.0,1,0.17533238239679372,47
2059,3,3257,1635,1622,0,0,0,1.0,1,1.0,1,1.0,1,0.16345420618006581,48
2060,4,3261,1637,1624,0,0,0,1.0,1,1.0,1,1.0,1,0.1499471764404156,50
2061,1,3262,1638,1624,0,0,0,1.0,1,1.0,1,1.0,1,0.16106908596039649,51
2062,3,3265,1641,1624,0,0,0,1.0,1,1.0,1,1.0,1,0.19200153666337663,49
2063,2,3267,1642,1625,0,0,0,1.0,1,1.0,1,1.0,1,0.18897000867958305,48
2064,2,3269,1643,1626,0,0,0,1.0,1,1.0,1,1.0,1,0.22341179684508666,45
2065,1,3270,1643,1627,0,0,0,1.0,1,1.0,1,1.0,1,0.20639726572640466,44
2066,1,3271,1644,1627,0,0,0,1.0,1,1.0,1,1.0,1,0.21366091080405689,42
2067,3,3274,1645,1629,0,0,0,1.0,1,1.0,1,1.0,1,0.21319923261407922,41
2068,2,3276,1647,1629,0,0,0,1.0,1,1.0,1,1.0,1,0.2252329148274693,40
2069,1,3277,1647,1630,0,0,0,1.0,1,1.0,1,1.0,1,0.21106481543757333,40
2070,2,3279,1647,1632,0,0,0,1.0,1,1.0,1,1.0,1,0.17992431549622737,40
2071,1,3280,1648,1632,0,0,0,1.0,1,1.0,1,1.0,1,0.2052280306811674,40
2072,2,3282,1648,1634,0,0,0,1.0,1,1.0,1,1.0,1,0.1908694720462587,41
2073,1,3283,1649,1634,0,0,0,1.0,1,1.0,1,1.0,1,0.22307077959208316,41
2074,1,3284,1649,1635,0,0,0,1.0,1,1.0,1,1.0,1,0.1907506712483595,41
2075,1,3285,1650,1635,0,0,0,1.0,1,1.0,1,1.0,1,0.20402054058414948,41
2076,2,3287,1652,1635,0,0,0,1.0,1,1.0,1,1.0,1,0.21972096802922492,41
2077,1,3288,1652,1636,0,0,0,1.0,1,1.0,1,1.0,1,0.18463698102403864,40
2078,1,3289,1653,1636,0,0,0,1.0,1,1.0,1,1.0,1,0.205387547551188,40
2079,2,3291,1653,1638,0,0,0,1.0,1,1.0,1,1.0,1,0.14816188291195959,39
2080,0,3291,1653,1638,0,0,0,1.0,1,1.0,1,1.0,1,0.1736366734468404,38
2081,0,3291,1653,1638,0,0,0,1.0,1,1.0,1,1.0,1,0.18759363562118503,40
2082,2,3293,1654,1639,0,0,0,1.0,1,1.0,1,1.0,1,0.22251929602458417,41
2083,3,3296,1655,1641,0,0,0,1.0,1,1.0,1,1.0,1,0.17065011007610784,40
2084,4,3300,1658,1642,0,0,0,1.0,1,1.0,1,1.0,1,0.19394925110904848,42
2085,1,3301,1658,1643,0,0,0,1.0,1,1.0,1,1.0,1,0.1714313190575533,42
2086,1,3302,1659,1643,0,0,0,1.0,1,1.0,1,1.0,1,0.15232804474640876,43
2087,1,3303,1660,1643,0,0,0,1.0,1,1.0,1,1.0,1,0.17715798635289273,45
2088,3,3306,1662,1644,0,0,0,1.0,1,1.0,1,1.0,1,0.2140841452822435,46
2089,0,3306,1662,1644,0,0,0,1.0,1,1.0,1,1.0,1,0.20953323403109034,47
2090,2,3308,1662,1646,0,0,0,1.0,1,1.0,1,1.0,1,0.2059682202338516,49
2091,1,3309,1662,1647,0,0,0,1.0,1,1.0,1,1.0,1,0.19682445375160343,49
2092,0,3309,1662,1647,0,0,0,1.0,1,1.0,1,1.0,1,0.19682445375160343,49
2093,2,3311,1663,1648,0,0,0,1.0,1,1.0,1,1.0,1,0.18474174623829923,49
2094,0,3311,1663,1648,0,0,0,1.0,1,1.0,1,1.0,1,0.18474174623829923,49
2095,1,3312,1663,1649,0,0,0,1.0,1,1.0,1,1.0,1,0.14867119583328225,49
2096,1,3313,1663,1650,0,0,0,1.0,1,1.0,1,1.0,1,0.1404037521242788,51
2097,0,3313,1663,1650,0,0,0,1.0,1,1.0,1,1.0,1,0.1404037521242788,51
2098,1,3314,1664,1650,0,0,0,1.0,1,1.0,1,1.0,1,0.161142320478466,52
2099,3,3317,1666,1651,0,0,0,1.0,1,1.0,1,1.0,1,0.15934900509586086,51
2100,1,3318,1667,1651,0,0,0,1.0,1,1.0,1,1.0,1,0.18137045513743186,51
2101,3,3321,1667,1654,0,0,0,1.0,1,1.0,1,1.0,1,0.18186641702133824,48
2102,2,3323,1669,1654,0,0,0,1.0,1,1.0,1,1.0,1,0.2439111596740162,49
2103,6,3329,1672,1657,0,0,0,1.0,1,1.0,1,1.0,1,0.2694724078317929,48
2104,0,3329,1672,1657,0,0,0,1.0,1,1.0,1,1.0,1,0.25437064444479496,43
2105,2,3331,1674,1657,0,0,0,1.0,1,1.0,1,1.0,1,0.3048792996998215,42
2106,2,3333,1675,1658,0,0,0,1.0,1,1.0,1,1.0,1,0.3088690893887263,40
2107,3,3336,1675,1661,0,0,0,1.0,1,1.0,1,1.0,1,0.25623009542166064,39
2108,2,3338,1677,1661,0,0,0,1.0,1,1.0,1,1.0,1,0.27589582458694784,38
2109,1,3339,1678,1661,0,0,0,1.0,1,1.0,1,1.0,1,0.2882054583148894,37
2110,0,3339,1678,1661,0,0,0,1.0,1,1.0,1,1.0,1,0.2895349197318154,38
2111,2,3341,1679,1662,0,0,0,1.0,1,1.0,1,1.0,1,0.28286021716618504,37
2112,1,3342,1680,1662,0,0,0,1.0,1,1.0,1,1.0,1,0.2759728581852253,36
2113,4,3346,1681,1665,0,0,0,1.0,1,1.0,1,1.0,1,0.2781452194787272,36
2114,2,3348,1682,1666,0,0,0,1.0,1,1.0,1,1.0,1,0.28391889473681076,36
2115,0,3348,1682,1666,0,0,0,1.0,1,1.0,1,1.0,1,0.2680470630647372,35
2116,1,3349,1682,1667,0,0,0,1.0,1,1.0,1,1.0,1,0.26813182159137294,37
2117,0,3349,1682,1667,0,0,0,1.0,1,1.0,1,1.0,1,0.2446466165400419,38
2118,1,3350,1682,1668,0,0,0,1.0,1,1.0,1,1.0,1,0.24089292432672985,40
2119,0,3350,1682,1668,0,0,0,1.0,1,1.0,1,1.0,1,0.24089292432672985,40
2120,1,3351,1683,1668,0,0,0,1.0,1,1.0,1,1.0,1,0.28239111564562985,41
2121,0,3351,1683,1668,0,0,0,1.0,1,1.0,1,1.0,1,0.28239111564562985,41
2122,0,3351,1683,1668,0,0,0,1.0,1,1.0,1,1.0,1,0.2910157196056974,42
2123,0,3351,1683,1668,0,0,0,1.0,1,1.0,1,1.0,1,0.2881462969094777,43
2124,0,3351,1683,1668,0,0,0,1.0,1,1.0,1,1.0,1,0.3223357284953321,41
2125,1,3352,1683,1669,0,0,0,1.0,1,1.0,1,1.0,1,0.2995558642579222,41
2126,0,3352,1683,1669,0,0,0,1.0,1,1.0,1,1.0,1,0.3227543900243158,40
2127,2,3354,1683,1671,0,0,0,1.0,1,1.0,1,1.0,1,0.2985173715643093,40
2128,0,3354,1683,1671,0,0,0,1.0,1,1.0,1,1.0,1,0.31585179783955697,41
2129,1,3355,1683,1672,0,0,0,1.0,1,1.0,1,1.0,1,0.2993807526539944,42
2130,1,3356,1683,1673,0,0,0,1.0,1,1.0,1,1.0,1,0.3081648251911147,45
2131,0,3356,1683,1673,0,0,0,1.0,1,1.0,1,1.0,1,0.3081648251911147,45
2132,0,3356,1683,1673,0,0,0,1.0,1,1.0,1,1.0,1,0.31940482351484045,46
2133,3,3359,1684,1675,0,0,0,1.0,1,1.0,1,1.0,1,0.30565188501508056,46
2134,1,3360,1684,1676,0,0,0,1.0,1,1.0,1,1.0,1,0.2912801675560339,47
2135,2,3362,1684,1678,0,0,0,1.0,1,1.0,1,1.0,1,0.2643693163541955,47
2136,3,3365,1684,1681,0,0,0,1.0,1,1.0,1,1.0,1,0.2184071575386816,47
2137,4,3369,1686,1683,0,0,0,1.0,1,1.0,1,1.0,1,0.18054663355400205,49
2138,2,3371,1686,1685,0,0,0,1.0,1,1.0,1,1.0,1,0.15607462736293282,49
2139,1,3372,1687,1685,0,0,0,1.0,1,1.0,1,1.0,1,0.18167228095099103,47
2140,6,3378,1689,1689,0,0,0,1.0,1,1.0,1,1.0,1,0.15081871065242913,48
2141,2,3380,1690,1690,0,0,0,1.0,1,1.0,1,1.0,1,0.13197881500637457,47
2142,1,3381,1691,1690,0,0,0,1.0,1,1.0,1,1.0,1,0.12435540754611168,47
2143,0,3381,1691,1690,0,0,0,1.0,1,1.0,1,1.0,1,0.1410208924297514,48
2144,1,3382,1692,1690,0,0,0,1.0,1,1.0,1,1.0,1,0.16512789061484573,48
2145,2,3384,1694,1690,0,0,0,1.0,1,1.0,1,1.0,1,0.14669163841379365,46
2146,1,3385,1695,1690,0,0,0,1.0,1,1.0,1,1.0,1,0.1569529568554156,47
2147,3,3388,1698,1690,0,0,0,1.0,1,1.0,1,1.0,1,0.16114598625293175,48
2148,1,3389,1699,1690,0,0,0,1.0,1,1.0,1,1.0,1,0.19031190479177773,46
2149,4,3393,1702,1691,0,0,0,1.0,1,1.0,1,1.0,1,0.2100630424778115,46
2150,4,3397,1705,1692,0,0,0,1.0,1,1.0,1,1.0,1,0.22439937382919137,46
2151,5,3402,1707,1695,0,0,0,1.0,1,1.0,1,1.0,1,0.2386360220143628,44
2152,2,3404,1708,1696,0,0,0,1.0,1,1.0,1,1.0,1,0.2566326088668322,45
2153,3,3407,1709,1698,0,0,0,1.0,1,1.0,1,1.0,1,0.2577780849762556,48
2154,1,3408,1709,1699,0,0,0,1.0,1,1.0,1,1.0,1,0.2693166241068041,47
2155,2,3410,1711,1699,0,0,0,1.0,1,1.0,1,1.0,1,0.30572056076168147,48
2156,1,3411,1712,1699,0,0,0,1.0,1,1.0,1,1.0,1,0.330988970315009,45
2157,3,3414,1712,1702,0,0,0,1.0,1,1.0,1,1.0,1,0.29999661875688177,43
2158,2,3416,1712,1704,0,0,0,1.0,1,1.0,1,1.0,1,0.27923266927316504,43
2159,6,3422,1714,1708,0,0,0,1.0,1,1.0,1,1.0,1,0.2961232506042297,43
2160,0,3422,1714,1708,0,0,0,1.0,1,1.0,1,1.0,1,0.28274228205670066,41
2161,3,3425,1714,1711,0,0,0,1.0,1,1.0,1,1.0,1,0.2357181847375028,41
2162,4,3429,1716,1713,0,0,0,1.0,1,1.0,1,1.0,1,0.193811332023937,42
2163,1,3430,1716,1714,0,0,0,1.0,1,1.0,1,1.0,1,0.20374567885167968,43
2164,4,3434,1718,1716,0,0,0,1.0,1,1.0,1,1.0,1,0.22708509710578942,44
2165,2,3436,1718,1718,0,0,0,1.0,1,1.0,1,1.0,1,0.1878886491879888,44
2166,0,3436,1718,1718,0,0,0,1.0,1,1.0,1,1.0,1,0.19152793113824787,46
2167,3,3439,1719,1720,0,0,0,1.0,1,1.0,1,1.0,1,0.19793286890558837,46
2168,0,3439,1719,1720,0,0,0,1.0,1,1.0,1,1.0,1,0.18807195540878374,45
2169,2,3441,1720,1721,0,0,0,1.0,1,1.0,1,1.0,1,0.16794151401351154,49
2170,0,3441,1720,1721,0,0,0,1.0,1,1.0,1,1.0,1,0.16794151401351154,49
2171,1,3442,1720,1722,0,0,0,1.0,1,1.0,1,1.0,1,0.14353206852728864,51
2172,1,3443,1721,1722,0,0,0,1.0,1,1.0,1,1.0,1,0.11796476825729181,52
2173,0,3443,1721,1722,0,0,0,1.0,1,1.0,1,1.0,1,0.11796476825729181,52
2174,1,3444,1722,1722,0,0,0,1.0,1,1.0,1,1.0,1,0.1269069407156565,52
2175,3,3447,1723,1724,0,0,0,1.0,1,1.0,1,1.0,1,0.13928664183428838,53
2176,0,3447,1723,1724,0,0,0,1.0,1,1.0,1,1.0,1,0.13083977438703223,54
2177,1,3448,1724,1724,0,0,0,1.0,1,1.0,1,1.0,1,0.146902594706945,55
2178,2,3450,1724,1726,0,0,0,1.0,1,1.0,1,1.0,1,0.09594200786759739,54
2179,1,3451,1725,1726,0,0,0,1.0,1,1.0,1,1.0,1,0.13196742106864384,52
2180,3,3454,1728,1726,0,0,0,1.0,1,1.0,1,1.0,1,0.1927347199251279,51
2181,1,3455,1728,1727,0,0,0,1.0,1,1.0,1,1.0,1,0.1614560308841792,49
2182,5,3460,1733,1727,0,0,0,1.0,1,1.0,1,1.0,1,0.2650070143085963,49
2183,5,3465,1735,1730,0,0,0,1.0,1,1.0,1,1.0,1,0.25682024944221044,46
2184,4,3469,1736,1733,0,0,0,1.0,1,1.0,1,1.0,1,0.21956182755653422,45
2185,5,3474,1738,1736,0,0,0,1.0,1,1.0,1,1.0,1,0.18704358154579906,44
2186,1,3475,1739,1736,0,0,0,1.0,1,1.0,1,1.0,1,0.22557371881117663,42
2187,7,3482,1743,1739,0,0,0,1.0,1,1.0,1,1.0,1,0.2495096969971531,40
2188,4,3486,1747,1739,0,0,0,1.0,1,1.0,1,1.0,1,0.22701104968853122,38
2189,3,3489,1747,1742,0,0,0,1.0,1,1.0,1,1.0,1,0.12945993235692485,36
2190,2,3491,1748,1743,0,0,0,1.0,1,1.0,1,1.0,1,0.17598491632978416,34
2191,2,3493,1750,1743,0,0,0,1.0,1,1.0,1,1.0,1,0.2097779643279797,34
2192,1,3494,1751,1743,0,0,0,1.0,1,1.0,1,1.0,1,0.21198050146824007,33
2193,1,3495,1751,1744,0,0,0,1.0,1,1.0,1,1.0,1,0.20826077974740384,32
2194,1,3496,1752,1744,0,0,0,1.0,1,1.0,1,1.0,1,0.2226566095116735,32
2195,1,3497,1752,1745,0,0,0,1.0,1,1.0,1,1.0,1,0.18511345662838113,31
2196,0,3497,1752,1745,0,0,0,1.0,1,1.0,1,1.0,1,0.18850604168561624,32
2197,2,3499,1754,1745,0,0,0,1.0,1,1.0,1,1.0,1,0.17863394284870135,31
2198,1,3500,1754,1746,0,0,0,1.0,1,1.0,1,1.0,1,0.1346856902479241,31
2199,1,3501,1755,1746,0,0,0,1.0,1,1.0,1,1.0,1,0.14830243895990183,32
2200,0,3501,1755,1746,0,0,0,1.0,1,1.0,1,1.0,1,0.1987681189160052,35
2201,1,3502,1756,1746,0,0,0,1.0,1,1.0,1,1.0,1,0.15918734827996123,36
2202,1,3503,1757,1746,0,0,0,1.0,1,1.0,1,1.0,1,0.1331390580459111,36
2203,0,3503,1757,1746,0,0,0,1.0,1,1.0,1,1.0,1,0.15034069481702908,37
2204,1,3504,1758,1746,0,0,0,1.0,1,1.0,1,1.0,1,0.20001233586060102,36
2205,2,3506,1759,1747,0,0,0,1.0,1,1.0,1,1.0,1,0.14325616801052624,37
2206,1,3507,1760,1747,0,0,0,1.0,1,1.0,1,1.0,1,0.21856843315470148,35
2207,1,3508,1761,1747,0,0,0,1.0,1,1.0,1,1.0,1,0.23620059020259354,37
2208,0,3508,1761,1747,0,0,0,1.0,1,1.0,1,1.0,1,0.23621256113585726,36
2209,0,3508,1761,1747,0,0,0,1.0,1,1.0,1,1.0,1,0.24924032690626122,35
2210,1,3509,1761,1748,0,0,0,1.0,1,1.0,1,1.0,1,0.2445208528354372,38
2211,1,3510,1761,1749,0,0,0,1.0,1,1.0,1,1.0,1,0.2472997637808307,37
2212,3,3513,1762,1751,0,0,0,1.0,1,1.0,1,1.0,1,0.21491912273157493,38
2213,1,3514,1762,1752,0,0,0,1.0,1,1.0,1,1.0,1,0.18804245456675964,38
2214,1,3515,1763,1752,0,0,0,1.0,1,1.0,1,1.0,1,0.21251849781394708,39
2215,2,3517,1765,1752,0,0,0,1.0,1,1.0,1,1.0,1,0.2316593161899757,39
2216,2,3519,1766,1753,0,0,0,1.0,1,1.0,1,1.0,1,0.24259354821680204,39
2217,2,3521,1768,1753,0,0,0,1.0,1,1.0,1,1.0,1,0.2305273663681554,38
2218,3,3524,1770,1754,0,0,0,1.0,1,1.0,1,1.0,1,0.21158062387776094,37
2219,1,3525,1771,1754,0,0,0,1.0,1,1.0,1,1.0,1,0.23166538814992035,36
2220,0,3525,1771,1754,0,0,0,1.0,1,1.0,1,1.0,1,0.25633537111760046,34
2221,1,3526,1772,1754,0,0,0,1.0,1,1.0,1,1.0,1,0.26402041057915737,35
2222,1,3527,1772,1755,0,0,0,1.0,1,1.0,1,1.0,1,0.25865738454347614,33
2223,1,3528,1772,1756,0,0,0,1.0,1,1.0,1,1.0,1,0.23837884030102804,34
2224,3,3531,1774,1757,0,0,0,1.0,1,1.0,1,1.0,1,0.14984673839948545,32
2225,3,3534,1777,1757,0,0,0,1.0,1,1.0,1,1.0,1,0.21857851325722472,33
2226,3,3537,1779,1758,0,0,0,1.0,1,1.0,1,1.0,1,0.26060290279942083,32
2227,1,3538,1780,1758,0,0,0,1.0,1,1.0,1,1.0,1,0.24916655078941233,31
2228,2,3540,1781,1759,0,0,0,1.0,1,1.0,1,1.0,1,0.18999810176943044,32
2229,0,3540,1781,1759,0,0,0,1.0,1,1.0,1,1.0,1,0.18999810176943044,32
2230,1,3541,1782,1759,0,0,0,1.0,1,1.0,1,1.0,1,0.17555655058412487,31
2231,0,3541,1782,1759,0,0,0,1.0,1,1.0,1,1.0,1,0.17159674327814728,32
2232,1,3542,1783,1759,0,0,0,1.0,1,1.0,1,1.0,1,0.21014065580400354,32
2233,2,3544,1784,1760,0,0,0,1.0,1,1.0,1,1.0,1,0.24101867172794672,31
2234,1,3545,1785,1760,0,0,0,1.0,1,1.0,1,1.0,1,0.30792029624848033,32
2235,1,3546,1785,1761,0,0,0,1.0,1,1.0,1,1.0,1,0.329446180920948,31
2236,1,3547,1786,1761,0,0,0,1.0,1,1.0,1,1.0,1,0.3569453629326571,31
2237,1,3548,1787,1761,0,0,0,1.0,1,1.0,1,1.0,1,0.39309244877893207,31
2238,6,3554,1788,1766,0,0,0,1.0,1,1.0,1,1.0,1,0.30765842606446614,31
2239,1,3555,1788,1767,0,0,0,1.0,1,1.0,1,1.0,1,0.2830831345435113,31
2240,5,3560,1791,1769,0,0,0,1.0,1,1.0,1,1.0,1,0.22889517732220993,32
2241,2,3562,1792,1770,0,0,0,1.0,1,1.0,1,1.0,1,0.1889672005949822,32
2242,3,3565,1794,1771,0,0,0,1.0,1,1.0,1,1.0,1,0.1812162144955702,34
2243,1,3566,1794,1772,0,0,0,1.0,1,1.0,1,1.0,1,0.15727298280461322,34
2244,0,3566,1794,1772,0,0,0,1.0,1,1.0,1,1.0,1,0.16533545693935683,36
2245,0,3566,1794,1772,0,0,0,1.0,1,1.0,1,1.0,1,0.16533545693935683,36
2246,2,3568,1794,1774,0,0,0,1.0,1,1.0,1,1.0,1,0.14457401851611612,39
2247,0,3568,1794,1774,0,0,0,1.0,1,1.0,1,1.0,1,0.1528093911101916,40
2248,0,3568,1794,1774,0,0,0,1.0,1,1.0,1,1.0,1,0.1528093911101916,40
2249,0,3568,1794,1774,0,0,0,1.0,1,1.0,1,1.0,1,0.15011418237127638,41
2250,0,3568,1794,1774,0,0,0,1.0,1,1.0,1,1.0,1,0.15011418237127638,41
2251,0,3568,1794,1774,0,0,0,1.0,1,1.0,1,1.0,1,0.16701476167405102,42
2252,1,3569,1795,1774,0,0,0,1.0,1,1.0,1,1.0,1,0.17154019579734053,41
2253,1,3570,1796,1774,0,0,0,1.0,1,1.0,1,1.0,1,0.18184721824670266,40
2254,1,3571,1797,1774,0,0,0,1.0,1,1.0,1,1.0,1,0.23090015917013895,39
2255,0,3571,1797,1774,0,0,0,1.0,1,1.0,1,1.0,1,0.23021502824228599,39
2256,2,3573,1799,1774,0,0,0,1.0,1,1.0,1,1.0,1,0.24667831929470715,40
2257,3,3576,1801,1775,0,0,0,1.0,1,1.0,1,1.0,1,0.23571146030638224,40
2258,2,3578,1802,1776,0,0,0,1.0,1,1.0,1,1.0,1,0.19676810605182732,39
2259,2,3580,1804,1776,0,0,0,1.0,1,1.0,1,1.0,1,0.2141213928078602,41
2260,1,3581,1805,1776,0,0,0,1.0,1,1.0,1,1.0,1,0.23152387938818056,38
2261,1,3582,1806,1776,0,0,0,1.0,1,1.0,1,1.0,1,0.24459266616688077,38
2262,2,3584,1808,1776,0,0,0,1.0,1,1.0,1,1.0,1,0.31317539477538325,36
2263,4,3588,1810,1778,0,0,0,1.0,1,1.0,1,1.0,1,0.30297116635463317,35
2264,3,3591,1812,1779,0,0,0,1.0,1,1.0,1,1.0,1,0.34723814322752733,33
2265,6,3597,1814,1783,0,0,0,1.0,1,1.0,1,1.0,1,0.3137378314325397,33
2266,2,3599,1815,1784,0,0,0,1.0,1,1.0,1,1.0,1,0.2814132708955956,33
2267,2,3601,1817,1784,0,0,0,1.0,1,1.0,1,1.0,1,0.2781120509510165,33
2268,2,3603,1818,1785,0,0,0,1.0,1,1.0,1,1.0,1,0.28680391779613434,35
2269,2,3605,1819,1786,0,0,0,1.0,1,1.0,1,1.0,1,0.2620325168918731,36
2270,0,3605,1819,1786,0,0,0,1.0,1,1.0,1,1.0,1,0.25735025981659443,34
2271,6,3611,1822,1789,0,0,0,1.0,1,1.0,1,1.0,1,0.25435809453739033,34
2272,3,3614,1824,1790,0,0,0,1.0,1,1.0,1,1.0,1,0.18477303354614605,33
2273,2,3616,1826,1790,0,0,0,1.0,1,1.0,1,1.0,1,0.21256373551164348,32
2274,1,3617,1827,1790,0,0,0,1.0,1,1.0,1,1.0,1,0.2507182835126963,32
2275,1,3618,1827,1791,0,0,0,1.0,1,1.0,1,1.0,1,0.2100022763432935,32
2276,2,3620,1828,1792,0,0,0,1.0,1,1.0,1,1.0,1,0.1818338386195831,31
2277,0,3620,1828,1792,0,0,0,1.0,1,1.0,1,1.0,1,0.1710863040148781,30
2278,0,3620,1828,1792,0,0,0,1.0,1,1.0,1,1.0,1,0.19423604479724152,33
2279,0,3620,1828,1792,0,0,0,1.0,1,1.0,1,1.0,1,0.19423604479724152,33
2280,2,3622,1828,1794,0,0,0,1.0,1,1.0,1,1.0,1,0.17986200405359598,35
2281,1,3623,1829,1794,0,0,0,1.0,1,1.0,1,1.0,1,0.20626952074562957,36
2282,0,3623,1829,1794,0,0,0,1.0,1,1.0,1,1.0,1,0.20626952074562957,36
2283,0,3623,1829,1794,0,0,0,1.0,1,1.0,1,1.0,1,0.20626952074562957,36
2284,1,3624,1830,1794,0,0,0,1.0,1,1.0,1,1.0,1,0.210343932923003,36
2285,1,3625,1830,1795,0,0,0,1.0,1,1.0,1,1.0,1,0.1875497327394529,37
2286,1,3626,1831,1795,0,0,0,1.0,1,1.0,1,1.0,1,0.2281829918527009,38
2287,2,3628,1831,1797,0,0,0,1.0,1,1.0,1,1.0,1,0.1740274506628299,38
2288,3,3631,1832,1799,0,0,0,1.0,1,1.0,1,1.0,1,0.1738142538005798,40
2289,1,3632,1832,1800,0,0,0,1.0,1,1.0,1,1.0,1,0.17999412588757188,40
2290,3,3635,1835,1800,0,0,0,1.0,1,1.0,1,1.0,1,0.267809956475977,39
2291,2,3637,1836,1801,0,0,0,1.0,1,1.0,1,1.0,1,0.2453445733416024,37
2292,0,3637,1836,1801,0,0,0,1.0,1,1.0,1,1.0,1,0.266048322798066,35
2293,2,3639,1838,1801,0,0,0,1.0,1,1.0,1,1.0,1,0.3458024795108037,35
2294,1,3640,1838,1802,0,0,0,1.0,1,1.0,1,1.0,1,0.36362395625276794,35
2295,2,3642,1838,1804,0,0,0,1.0,1,1.0,1,1.0,1,0.32637231108139714,36
2296,0,3642,1838,1804,0,0,0,1.0,1,1.0,1,1.0,1,0.34029115847046754,34
2297,2,3644,1838,1806,0,0,0,1.0,1,1.0,1,1.0,1,0.31870824859575764,35
2298,0,3644,1838,1806,0,0,0,1.0,1,1.0,1,1.0,1,0.31052349347688557,34
2299,1,3645,1839,1806,0,0,0,1.0,1,1.0,1,1.0,1,0.29045759452360326,35
2300,0,3645,1839,1806,0,0,0,1.0,1,1.0,1,1.0,1,0.29045759452360326,35
2301,0,3645,1839,1806,0,0,0,1.0,1,1.0,1,1.0,1,0.29045759452360326,35
2302,4,3649,1842,1807,0,0,0,1.0,1,1.0,1,1.0,1,0.3534333692805241,37
2303,1,3650,1843,1807,0,0,0,1.0,1,1.0,1,1.0,1,0.30467872622569747,35
2304,2,3652,1845,1807,0,0,0,1.0,1,1.0,1,1.0,1,0.3736514705361998,36
2305,1,3653,1845,1808,0,0,0,1.0,1,1.0,1,1.0,1,0.37814707995559554,34
2306,2,3655,1845,1810,0,0,0,1.0,1,1.0,1,1.0,1,0.35694817373819654,35
2307,2,3657,1845,1812,0,0,0,1.0,1,1.0,1,1.0,1,0.3100961488876541,35
2308,0,3657,1845,1812,0,0,0,1.0,1,1.0,1,1.0,1,0.3100961488876541,35
2309,0,3657,1845,1812,0,0,0,1.0,1,1.0,1,1.0,1,0.3267084118802835,34
2310,1,3658,1845,1813,0,0,0,1.0,1,1.0,1,1.0,1,0.3146949748021208,36
2311,2,3660,1845,1815,0,0,0,1.0,1,1.0,1,1.0,1,0.3006775900991447,38
2312,4,3664,1847,1817,0,0,0,1.0,1,1.0,1,1.0,1,0.30545468927957964,39
2313,5,3669,1849,1820,0,0,0,1.0,1,1.0,1,1.0,1,0.22015381246482751,39
2314,2,3671,1849,1822,0,0,0,1.0,1,1.0,1,1.0,1,0.1909756308100846,39
2315,3,3674,1851,1823,0,0,0,1.0,1,1.0,1,1.0,1,0.2217940467504131,40
2316,1,3675,1851,1824,0,0,0,1.0,1,1.0,1,1.0,1,0.16957853577973206,40
2317,1,3676,1852,1824,0,0,0,1.0,1,1.0,1,1.0,1,0.22829260317031766,41
2318,2,3678,1853,1825,0,0,0,1.0,1,1.0,1,1.0,1,0.21355124542930864,41
2319,0,3678,1853,1825,0,0,0,1.0,1,1.0,1,1.0,1,0.21355124542930864,41
2320,0,3678,1853,1825,0,0,0,1.0,1,1.0,1,1.0,1,0.23399872665142823,42
2321,0,3678,1853,1825,0,0,0,1.0,1,1.0,1,1.0,1,0.21290068302751058,43
2322,0,3678,1853,1825,0,0,0,1.0,1,1.0,1,1.0,1,0.20490584108842044,42
2323,1,3679,1854,1825,0,0,0,1.0,1,1.0,1,1.0,1,0.2526856149709562,43
2324,2,3681,1854,1827,0,0,0,1.0,1,1.0,1,1.0,1,0.2490735004651893,44
2325,2,3683,1854,1829,0,0,0,1.0,1,1.0,1,1.0,1,0.20702465540568712,44
2326,2,3685,1854,1831,0,0,0,1.0,1,1.0,1,1.0,1,0.16789731267177635,45
2327,0,3685,1854,1831,0,0,0,1.0,1,1.0,1,1.0,1,0.16789731267177635,45
2328,0,3685,1854,1831,0,0,0,1.0,1,1.0,1,1.0,1,0.17997027117365622,46
2329,1,3686,1855,1831,0,0,0,1.0,1,1.0,1,1.0,1,0.20060565397827693,45
2330,0,3686,1855,1831,0,0,0,1.0,1,1.0,1,1.0,1,0.18590005610071964,47
2331,1,3687,1856,1831,0,0,0,1.0,1,1.0,1,1.0,1,0.2128162203094291,48
2332,0,3687,1856,1831,0,0,0,1.0,1,1.0,1,1.0,1,0.2128162203094291,48
2333,2,3689,1857,1832,0,0,0,1.0,1,1.0,1,1.0,1,0.24267087409941923,49
2334,1,3690,1858,1832,0,0,0,1.0,1,1.0,1,1.0,1,0.28148318590412674,47
2335,2,3692,1859,1833,0,0,0,1.0,1,1.0,1,1.0,1,0.2848212256846307,46
2336,2,3694,1859,1835,0,0,0,1.0,1,1.0,1,1.0,1,0.27655767681565335,46
2337,0,3694,1859,1835,0,0,0,1.0,1,1.0,1,1.0,1,0.26469298266820857,45
2338,3,3697,1862,1835,0,0,0,1.0,1,1.0,1,1.0,1,0.21299353941364116,44
2339,3,3700,1863,1837,0,0,0,1.0,1,1.0,1,1.0,1,0.1610596351533088,45
2340,0,3700,1863,1837,0,0,0,1.0,1,1.0,1,1.0,1,0.17430725420500925,44
2341,0,3700,1863,1837,0,0,0,1.0,1,1.0,1,1.0,1,0.18815147067298246,45
2342,2,3702,1864,1838,0,0,0,1.0,1,1.0,1,1.0,1,0.1686908856520945,47
2343,0,3702,1864,1838,0,0,0,1.0,1,1.0,1,1.0,1,0.1776040245692494,46
2344,2,3704,1865,1839,0,0,0,1.0,1,1.0,1,1.0,1,0.17529437679369328,46
2345,0,3704,1865,1839,0,0,0,1.0,1,1.0,1,1.0,1,0.19616329078990638,45
2346,0,3704,1865,1839,0,0,0,1.0,1,1.0,1,1.0,1,0.17751782493876922,46
2347,1,3705,1865,1840,0,0,0,1.0,1,1.0,1,1.0,1,0.18340924791052385,47
2348,3,3708,1866,1842,0,0,0,1.0,1,1.0,1,1.0,1,0.19379969486621565,49
2349,1,3709,1867,1842,0,0,0,1.0,1,1.0,1,1.0,1,0.2236871981540094,49
2350,2,3711,1868,1843,0,0,0,1.0,1,1.0,1,1.0,1,0.22988953834858583,50
2351,2,3713,1869,1844,0,0,0,1.0,1,1.0,1,1.0,1,0.2180208846516316,50
2352,0,3713,1869,1844,0,0,0,1.0,1,1.0,1,1.0,1,0.22863746755420084,51
2353,1,3714,1869,1845,0,0,0,1.0,1,1.0,1,1.0,1,0.2056570618379157,51
2354,0,3714,1869,1845,0,0,0,1.0,1,1.0,1,1.0,1,0.2186859512960142,51
2355,2,3716,1870,1846,0,0,0,1.0,1,1.0,1,1.0,1,0.2175768651301353,50
2356,0,3716,1870,1846,0,0,0,1.0,1,1.0,1,1.0,1,0.2175768651301353,50
2357,0,3716,1870,1846,0,0,0,1.0,1,1.0,1,1.0,1,0.21252323729563247,49
2358,3,3719,1870,1849,0,0,0,1.0,1,1.0,1,1.0,1,0.1946721046935877,51
2359,1,3720,1870,1850,0,0,0,1.0,1,1.0,1,1.0,1,0.16612040408408119,51
2360,3,3723,1872,1851,0,0,0,1.0,1,1.0,1,1.0,1,0.19752846511072955,51
2361,2,3725,1874,1851,0,0,0,1.0,1,1.0,1,1.0,1,0.23300084429919576,52
2362,1,3726,1874,1852,0,0,0,1.0,1,1.0,1,1.0,1,0.2150568147120374,53
2363,2,3728,1875,1853,0,0,0,1.0,1,1.0,1,1.0,1,0.21168119754560966,54
2364,3,3731,1876,1855,0,0,0,1.0,1,1.0,1,1.0,1,0.17123048282367664,55
2365,2,3733,1877,1856,0,0,0,1.0,1,1.0,1,1.0,1,0.18112022519438734,53
2366,2,3735,1879,1856,0,0,0,1.0,1,1.0,1,1.0,1,0.15787021075185495,53
2367,2,3737,1880,1857,0,0,0,1.0,1,1.0,1,1.0,1,0.15969720219648761,51
2368,4,3741,1883,1858,0,0,0,1.0,1,1.0,1,1.0,1,0.17929159664268826,50
2369,2,3743,1885,1858,0,0,0,1.0,1,1.0,1,1.0,1,0.2222576216262495,47
2370,1,3744,1885,1859,0,0,0,1.0,1,1.0,1,1.0,1,0.2379761051262417,48
2371,4,3748,1887,1861,0,0,0,1.0,1,1.0,1,1.0,1,0.2345056171120608,49
2372,0,3748,1887,1861,0,0,0,1.0,1,1.0,1,1.0,1,0.2505283836072652,48
2373,0,3748,1887,1861,0,0,0,1.0,1,1.0,1,1.0,1,0.2522226235394727,49
2374,0,3748,1887,1861,0,0,0,1.0,1,1.0,1,1.0,1,0.261417796783089,50
2375,1,3749,1888,1861,0,0,0,1.0,1,1.0,1,1.0,1,0.24981621487893257,50
2376,0,3749,1888,1861,0,0,0,1.0,1,1.0,1,1.0,1,0.24829338629886072,50
2377,1,3750,1888,1862,0,0,0,1.0,1,1.0,1,1.0,1,0.2353682677708302,49
2378,0,3750,1888,1862,0,0,0,1.0,1,1.0,1,1.0,1,0.2353682677708302,49
2379,1,3751,1889,1862,0,0,0,1.0,1,1.0,1,1.0,1,0.27139375316242653,50
2380,1,3752,1890,1862,0,0,0,1.0,1,1.0,1,1.0,1,0.292584772567364,50
2381,1,3753,1891,1862,0,0,0,1.0,1,1.0,1,1.0,1,0.32000697699032404,51
2382,1,3754,1892,1862,0,0,0,1.0,1,1.0,1,1.0,1,0.3314045684043424,51
2383,6,3760,1893,1867,0,0,0,1.0,1,1.0,1,1.0,1,0.2830077218583111,52
2384,3,3763,1894,1869,0,0,0,1.0,1,1.0,1,1.0,1,0.23245830101301473,52
2385,1,3764,1895,1869,0,0,0,1.0,1,1.0,1,1.0,1,0.25196565660911013,51
2386,2,3766,1896,1870,0,0,0,1.0,1,1.0,1,1.0,1,0.26210851961881476,52
2387,2,3768,1896,1872,0,0,0,1.0,1,1.0,1,1.0,1,0.267555611885003,49
2388,1,3769,1897,1872,0,0,0,1.0,1,1.0,1,1.0,1,0.2708947140399947,48
2389,5,3774,1899,1875,0,0,0,1.0,1,1.0,1,1.0,1,0.24987278893105427,48
2390,3,3777,1900,1877,0,0,0,1.0,1,1.0,1,1.0,1,0.2263972497309954,49
2391,1,3778,1900,1878,0,0,0,1.0,1,1.0,1,1.0,1,0.22130987086445625,48
2392,4,3782,1903,1879,0,0,0,1.0,1,1.0,1,1.0,1,0.20249527601830727,49
2393,2,3784,1904,1880,0,0,0,1.0,1,1.0,1,1.0,1,0.1783251809996903,50
2394,4,3788,1907,1881,0,0,0,1.0,1,1.0,1,1.0,1,0.19434916415474868,50
2395,1,3789,1908,1881,0,0,0,1.0,1,1.0,1,1.0,1,0.20153049853066066,49
2396,1,3790,1908,1882,0,0,0,1.0,1,1.0,1,1.0,1,0.18676931913049954,50
2397,2,3792,1909,1883,0,0,0,1.0,1,1.0,1,1.0,1,0.19203216419519634,51
2398,2,3794,1911,1883,0,0,0,1.0,1,1.0,1,1.0,1,0.21215722020432948,49
2399,2,3796,1911,1885,0,0,0,1.0,1,1.0,1,1.0,1,0.17776057224913355,50
2400,0,3796,1911,1885,0,0,0,1.0,1,1.0,1,1.0,1,0.19042145119535375,51
2401,0,3796,1911,1885,0,0,0,1.0,1,1.0,1,1.0,1,0.19555212109127976,50
2402,1,3797,1911,1886,0,0,0,1.0,1,1.0,1,1.0,1,0.17556559593075807,51
2403,0,3797,1911,1886,0,0,0,1.0,1,1.0,1,1.0,1,0.1762286510194096,52
2404,1,3798,1911,1887,0,0,0,1.0,1,1.0,1,1.0,1,0.17146824843804262,53
2405,2,3800,1912,1888,0,0,0,1.0,1,1.0,1,1.0,1,0.1837389553313901,52
2406,1,3801,1913,1888,0,0,0,1.0,1,1.0,1,1.0,1,0.19902440252372755,52
2407,1,3802,1914,1888,0,0,0,1.0,1,1.0,1,1.0,1,0.24568774308479702,51
2408,0,3802,1914,1888,0,0,0,1.0,1,1.0,1,1.0,1,0.24710573277839704,50
2409,1,3803,1914,1889,0,0,0,1.0,1,1.0,1,1.0,1,0.25021310833298194,50
2410,1,3804,1915,1889,0,0,0,1.0,1,1.0,1,1.0,1,0.29038036531554123,49
2411,3,3807,1915,1892,0,0,0,1.0,1,1.0,1,1.0,1,0.272032988757896,48
2412,0,3807,1915,1892,0,0,0,1.0,1,1.0,1,1.0,1,0.2784458507811963,47
2413,2,3809,1915,1894,0,0,0,1.0,1,1.0,1,1.0,1,0.24374372279634288,47
2414,1,3810,1916,1894,0,0,0,1.0,1,1.0,1,1.0,1,0.2847553951539529,47
2415,3,3813,1917,1896,0,0,0,1.0,1,1.0,1,1.0,1,0.29474642344452856,46
2416,1,3814,1917,1897,0,0,0,1.0,1,1.0,1,1.0,1,0.26911312938805004,47
2417,1,3815,1917,1898,0,0,0,1.0,1,1.0,1,1.0,1,0.27012483313217744,46
2418,3,3818,1917,1901,0,0,0,1.0,1,1.0,1,1.0,1,0.23686407178087426,48
2419,1,3819,1917,1902,0,0,0,1.0,1,1.0,1,1.0,1,0.23679984360524975,47
2420,0,3819,1917,1902,0,0,0,1.0,1,1.0,1,1.0,1,0.22680904971769442,49
2421,2,3821,1918,1903,0,0,0,1.0,1,1.0,1,1.0,1,0.2140016214758494,50
2422,3,3824,1921,1903,0,0,0,1.0,1,1.0,1,1.0,1,0.21915150160983127,50
2423,3,3827,1922,1905,0,0,0,1.0,1,1.0,1,1.0,1,0.18257810267839042,51
2424,2,3829,1924,1905,0,0,0,1.0,1,1.0,1,1.0,1,0.1803143736813752,50
2425,0,3829,1924,1905,0,0,0,1.0,1,1.0,1,1.0,1,0.18169197425028183,48
2426,5,3834,1928,1906,0,0,0,1.0,1,1.0,1,1.0,1,0.1782103962288165,51
2427,2,3836,1930,1906,0,0,0,1.0,1,1.0,1,1.0,1,0.20731929415616604,50
2428,2,3838,1931,1907,0,0,0,1.0,1,1.0,1,1.0,1,0.17042091829967698,49
2429,3,3841,1933,1908,0,0,0,1.0,1,1.0,1,1.0,1,0.20716909098669328,49
2430,0,3841,1933,1908,0,0,0,1.0,1,1.0,1,1.0,1,0.2204892394758652,46
2431,1,3842,1934,1908,0,0,0,1.0,1,1.0,1,1.0,1,0.2435783769461048,45
2432,1,3843,1935,1908,0,0,0,1.0,1,1.0,1,1.0,1,0.31402145239404355,44
2433,2,3845,1935,1910,0,0,0,1.0,1,1.0,1,1.0,1,0.25132172685316295,45
2434,1,3846,1936,1910,0,0,0,1.0,1,1.0,1,1.0,1,0.26938993889304075,44
2435,2,3848,1936,1912,0,0,0,1.0,1,1.0,1,1.0,1,0.21746270518866787,44
2436,1,3849,1936,1913,0,0,0,1.0,1,1.0,1,1.0,1,0.1788625796925023,44
2437,1,3850,1937,1913,0,0,0,1.0,1,1.0,1,1.0,1,0.2062325588436245,45
2438,1,3851,1938,1913,0,0,0,1.0,1,1.0,1,1.0,1,0.24240466276983333,45
2439,1,3852,1938,1914,0,0,0,1.0,1,1.0,1,1.0,1,0.216156240163484,46
2440,0,3852,1938,1914,0,0,0,1.0,1,1.0,1,1.0,1,0.23198562658704644,45
2441,1,3853,1938,1915,0,0,0,1.0,1,1.0,1,1.0,1,0.19931291410356342,45
2442,0,3853,1938,1915,0,0,0,1.0,1,1.0,1,1.0,1,0.19423472605675818,46
2443,1,3854,1938,1916,0,0,0,1.0,1,1.0,1,1.0,1,0.22065737502583832,45
2444,4,3858,1941,1917,0,0,0,1.0,1,1.0,1,1.0,1,0.2964545222081295,46
2445,4,3862,1942,1920,0,0,0,1.0,1,1.0,1,1.0,1,0.2958913295283045,44
2446,5,3867,1945,1922,0,0,0,1.0,1,1.0,1,1.0,1,0.3186068248795784,44
2447,4,3871,1947,1924,0,0,0,1.0,1,1.0,1,1.0,1,0.2673528805165602,42
2448,3,3874,1950,1924,0,0,0,1.0,1,1.0,1,1.0,1,0.26780260851543625,41
2449,3,3877,1951,1926,0,0,0,1.0,1,1.0,1,1.0,1,0.25177254436171387,40
2450,2,3879,1953,1926,0,0,0,1.0,1,1.0,1,1.0,1,0.2570236372815709,42
2451,0,3879,1953,1926,0,0,0,1.0,1,1.0,1,1.0,1,0.25197789805029636,43
2452,0,3879,1953,1926,0,0,0,1.0,1,1.0,1,1.0,1,0.25197789805029636,43
2453,2,3881,1953,1928,0,0,0,1.0,1,1.0,1,1.0,1,0.23242829660934608,45
2454,3,3884,1955,1929,0,0,0,1.0,1,1.0,1,1.0,1,0.26221033223454504,47
2455,1,3885,1955,1930,0,0,0,1.0,1,1.0,1,1.0,1,0.2504126845829509,48
2456,1,3886,1955,1931,0,0,0,1.0,1,1.0,1,1.0,1,0.25592799570900104,49
2457,2,3888,1957,1931,0,0,0,1.0,1,1.0,1,1.0,1,0.32639960135704893,48
2458,2,3890,1958,1932,0,0,0,1.0,1,1.0,1,1.0,1,0.29859385433454383,49
2459,1,3891,1958,1933,0,0,0,1.0,1,1.0,1,1.0,1,0.28571556680595245,49
2460,4,3895,1960,1935,0,0,0,1.0,1,1.0,1,1.0,1,0.29764147044956935,50
2461,0,3895,1960,1935,0,0,0,1.0,1,1.0,1,1.0,1,0.29764147044956935,50
2462,5,3900,1962,1938,0,0,0,1.0,1,1.0,1,1.0,1,0.27251530611059477,51
2463,2,3902,1963,1939,0,0,0,1.0,1,1.0,1,1.0,1,0.27499606200674737,51
2464,3,3905,1965,1940,0,0,0,1.0,1,1.0,1,1.0,1,0.24202629033377643,50
2465,0,3905,1965,1940,0,0,0,1.0,1,1.0,1,1.0,1,0.23523873585813848,49
2466,0,3905,1965,1940,0,0,0,1.0,1,1.0,1,1.0,1,0.23523873585813848,49
2467,0,3905,1965,1940,0,0,0,1.0,1,1.0,1,1.0,1,0.2309624475988001,48
2468,2,3907,1967,1940,0,0,0,1.0,1,1.0,1,1.0,1,0.2536386317970827,47
2469,3,3910,1968,1942,0,0,0,1.0,1,1.0,1,1.0,1,0.20295252306971132,46
2470,1,3911,1969,1942,0,0,0,1.0,1,1.0,1,1.0,1,0.21911137912036252,44
2471,4,3915,1970,1945,0,0,0,1.0,1,1.0,1,1.0,1,0.1928515486226451,44
2472,1,3916,1970,1946,0,0,0,1.0,1,1.0,1,1.0,1,0.21333375599678536,44
2473,3,3919,1972,1947,0,0,0,1.0,1,1.0,1,1.0,1,0.213999829708691,43
2474,4,3923,1974,1949,0,0,0,1.0,1,1.0,1,1.0,1,0.2311387581850202,44
2475,2,3925,1975,1950,0,0,0,1.0,1,1.0,1,1.0,1,0.17867364370434227,46
2476,2,3927,1976,1951,0,0,0,1.0,1,1.0,1,1.0,1,0.1726824620859337,46
2477,0,3927,1976,1951,0,0,0,1.0,1,1.0,1,1.0,1,0.1726824620859337,46
2478,0,3927,1976,1951,0,0,0,1.0,1,1.0,1,1.0,1,0.1726824620859337,46
2479,0,3927,1976,1951,0,0,0,1.0,1,1.0,1,1.0,1,0.1726824620859337,46
2480,2,3929,1977,1952,0,0,0,1.0,1,1.0,1,1.0,1,0.17254564831102848,47
2481,1,3930,1978,1952,0,0,0,1.0,1,1.0,1,1.0,1,0.15242303196832246,47
2482,0,3930,1978,1952,0,0,0,1.0,1,1.0,1,1.0,1,0.18914130379260424,45
2483,0,3930,1978,1952,0,0,0,1.0,1,1.0,1,1.0,1,0.19935276250587275,45
2484,1,3931,1979,1952,0,0,0,1.0,1,1.0,1,1.0,1,0.2367369005132855,46
2485,1,3932,1980,1952,0,0,0,1.0,1,1.0,1,1.0,1,0.2309196512053247,44
2486,1,3933,1980,1953,0,0,0,1.0,1,1.0,1,1.0,1,0.18445258990736096,43
2487,2,3935,1981,1954,0,0,0,1.0,1,1.0,1,1.0,1,0.1870095726045331,44
2488,3,3938,1983,1955,0,0,0,1.0,1,1.0,1,1.0,1,0.21529437752873518,45
2489,1,3939,1983,1956,0,0,0,1.0,1,1.0,1,1.0,1,0.20888718126272918,44
2490,4,3943,1985,1958,0,0,0,1.0,1,1.0,1,1.0,1,0.22438288782922353,44
2491,1,3944,1985,1959,0,0,0,1.0,1,1.0,1,1.0,1,0.23313142606024626,44
2492,0,3944,1985,1959,0,0,0,1.0,1,1.0,1,1.0,1,0.23313142606024626,44
2493,1,3945,1985,1960,0,0,0,1.0,1,1.0,1,1.0,1,0.25391740533768076,42
2494,0,3945,1985,1960,0,0,0,1.0,1,1.0,1,1.0,1,0.25391740533768076,42
2495,0,3945,1985,1960,0,0,0,1.0,1,1.0,1,1.0,1,0.2538911191440555,42
2496,1,3946,1986,1960,0,0,0,1.0,1,1.0,1,1.0,1,0.28480484296486647,42
2497,2,3948,1987,1961,0,0,0,1.0,1,1.0,1,1.0,1,0.2789214756239376,44
2498,4,3952,1988,1964,0,0,0,1.0,1,1.0,1,1.0,1,0.25561220076153174,43
2499,1,3953,1989,1964,0,0,0,1.0,1,1.0,1,1.0,1,0.24270079716345,43
2500,1,3954,1990,1964,0,0,0,1.0,1,1.0,1,1.0,1,0.2627147065882193,44
2501,3,3957,1990,1967,0,0,0,1.0,1,1.0,1,1.0,1,0.20321747047933716,46
2502,4,3961,1993,1968,0,0,0,1.0,1,1.0,1,1.0,1,0.18887900271577962,47
2503,1,3962,1994,1968,0,0,0,1.0,1,1.0,1,1.0,1,0.21454799231869673,47
2504,1,3963,1995,1968,0,0,0,1.0,1,1.0,1,1.0,1,0.23890264876373507,46
2505,4,3967,1999,1968,0,0,0,1.0,1,1.0,1,1.0,1,0.2678706537996163,46
2506,3,3970,2000,1970,0,0,0,1.0,1,1.0,1,1.0,1,0.2788961588792997,45
2507,6,3976,2002,1974,0,0,0,1.0,1,1.0,1,1.0,1,0.2345769960131081,45
2508,4,3980,2004,1976,0,0,0,1.0,1,1.0,1,1.0,1,0.24435889124332713,46
2509,1,3981,2005,1976,0,0,0,1.0,1,1.0,1,1.0,1,0.26897702073801744,45
2510,3,3984,2006,1978,0,0,0,1.0,1,1.0,1,1.0,1,0.2359951551896042,46
2511,0,3984,2006,1978,0,0,0,1.0,1,1.0,1,1.0,1,0.21869285360580362,47
2512,1,3985,2007,1978,0,0,0,1.0,1,1.0,1,1.0,1,0.26602251714836955,47
2513,1,3986,2007,1979,0,0,0,1.0,1,1.0,1,1.0,1,0.23943196496326621,48
2514,3,3989,2008,1981,0,0,0,1.0,1,1.0,1,1.0,1,0.16419919313186712,48
2515,2,3991,2008,1983,0,0,0,1.0,1,1.0,1,1.0,1,0.1298578025414116,49
2516,1,3992,2009,1983,0,0,0,1.0,1,1.0,1,1.0,1,0.14174339645929002,49
2517,1,3993,2010,1983,0,0,0,1.0,1,1.0,1,1.0,1,0.14827988585882113,49
2518,1,3994,2011,1983,0,0,0,1.0,1,1.0,1,1.0,1,0.16986393544247616,48
2519,3,3997,2012,1985,0,0,0,1.0,1,1.0,1,1.0,1,0.1643616351940284,48
2520,1,3998,2013,1985,0,0,0,1.0,1,1.0,1,1.0,1,0.19757928220094695,46
2521,3,4001,2015,1986,0,0,0,1.0,1,1.0,1,1.0,1,0.21293072384619394,47
2522,2,4003,2017,1986,0,0,0,1.0,1,1.0,1,1.0,1,0.2669418572886362,45
2523,1,4004,2017,1987,0,0,0,1.0,1,1.0,1,1.0,1,0.2452244635916275,44
2524,0,4004,2017,1987,0,0,0,1.0,1,1.0,1,1.0,1,0.27252375802036466,42
2525,1,4005,2017,1988,0,0,0,1.0,1,1.0,1,1.0,1,0.27705469561948537,42
2526,0,4005,2017,1988,0,0,0,1.0,1,1.0,1,1.0,1,0.29722443400927767,41
2527,1,4006,2017,1989,0,0,0,1.0,1,1.0,1,1.0,1,0.2894360794128824,41
2528,0,4006,2017,1989,0,0,0,1.0,1,1.0,1,1.0,1,0.2995658682313884,41
2529,1,4007,2017,1990,0,0,0,1.0,1,1.0,1,1.0,1,0.28767971518548596,42
2530,1,4008,2017,1991,0,0,0,1.0,1,1.0,1,1.0,1,0.2590103675241084,41
2531,0,4008,2017,1991,0,0,0,1.0,1,1.0,1,1.0,1,0.2590103675241084,41
2532,0,4008,2017,1991,0,0,0,1.0,1,1.0,1,1.0,1,0.2766439536626377,43
2533,0,4008,2017,1991,0,0,0,1.0,1,1.0,1,1.0,1,0.2766439536626377,43
2534,0,4008,2017,1991,0,0,0,1.0,1,1.0,1,1.0,1,0.2766439536626377,43
2535,1,4009,2018,1991,0,0,0,1.0,1,1.0,1,1.0,1,0.3139512354433609,44
2536,0,4009,2018,1991,0,0,0,1.0,1,1.0,1,1.0,1,0.3139512354433609,44
2537,0,4009,2018,1991,0,0,0,1.0,1,1.0,1,1.0,1,0.32169855176098655,45
2538,3,4012,2018,1994,0,0,0,1.0,1,1.0,1,1.0,1,0.2877750937353522,48
2539,1,4013,2019,1994,0,0,0,1.0,1,1.0,1,1.0,1,0.2848776992601202,48
2540,2,4015,2019,1996,0,0,0,1.0,1,1.0,1,1.0,1,0.2733963299317526,50
2541,2,4017,2020,1997,0,0,0,1.0,1,1.0,1,1.0,1,0.25678018737400865,52
2542,8,4025,2023,2002,0,0,0,1.0,1,1.0,1,1.0,1,0.273649085074012,52
2543,5,4030,2026,2004,0,0,0,1.0,1,1.0,1,1.0,1,0.2847245521944545,51
2544,4,4034,2029,2005,0,0,0,1.0,1,1.0,1,1.0,1,0.2865061917833831,51
2545,3,4037,2030,2007,0,0,0,1.0,1,1.0,1,1.0,1,0.2714102136031212,50
2546,2,4039,2032,2007,0,0,0,1.0,1,1.0,1,1.0,1,0.2951032289802831,50
2547,5,4044,2034,2010,0,0,0,1.0,1,1.0,1,1.0,1,0.24742343268153472,47
2548,1,4045,2034,2011,0,0,0,1.0,1,1.0,1,1.0,1,0.21313216576171548,46
2549,3,4048,2037,2011,0,0,0,1.0,1,1.0,1,1.0,1,0.2760699221638739,46
2550,3,4051,2039,2012,0,0,0,1.0,1,1.0,1,1.0,1,0.27392907001778305,44
2551,1,4052,2039,2013,0,0,0,1.0,1,1.0,1,1.0,1,0.2524529914572537,43
2552,0,4052,2039,2013,0,0,0,1.0,1,1.0,1,1.0,1,0.282085527923719,43
2553,3,4055,2039,2016,0,0,0,1.0,1,1.0,1,1.0,1,0.2606628428941836,44
2554,2,4057,2041,2016,0,0,0,1.0,1,1.0,1,1.0,1,0.27924501410649616,45
2555,4,4061,2042,2019,0,0,0,1.0,1,1.0,1,1.0,1,0.2821371260265869,44
2556,0,4061,2042,2019,0,0,0,1.0,1,1.0,1,1.0,1,0.2817400830910263,44
2557,2,4063,2043,2020,0,0,0,1.0,1,1.0,1,1.0,1,0.30628122308987943,41
2558,1,4064,2043,2021,0,0,0,1.0,1,1.0,1,1.0,1,0.28945511786279754,40
2559,2,4066,2043,2023,0,0,0,1.0,1,1.0,1,1.0,1,0.2709560920841622,41
2560,0,4066,2043,2023,0,0,0,1.0,1,1.0,1,1.0,1,0.2709560920841622,41
2561,2,4068,2043,2025,0,0,0,1.0,1,1.0,1,1.0,1,0.27025822396608307,43
2562,2,4070,2043,2027,0,0,0,1.0,1,1.0,1,1.0,1,0.25850362360615686,44
2563,1,4071,2043,2028,0,0,0,1.0,1,1.0,1,1.0,1,0.2403021045579226,44
2564,1,4072,2044,2028,0,0,0,1.0,1,1.0,1,1.0,1,0.2548575853015232,44
2565,3,4075,2046,2029,0,0,0,1.0,1,1.0,1,1.0,1,0.24335975631372703,45
2566,1,4076,2047,2029,0,0,0,1.0,1,1.0,1,1.0,1,0.25860463809763873,46
2567,1,4077,2048,2029,0,0,0,1.0,1,1.0,1,1.0,1,0.2702215541892576,48
2568,1,4078,2049,2029,0,0,0,1.0,1,1.0,1,1.0,1,0.28153744533303904,48
2569,2,4080,2049,2031,0,0,0,1.0,1,1.0,1,1.0,1,0.2875998612150177,49
2570,0,4080,2049,2031,0,0,0,1.0,1,1.0,1,1.0,1,0.2884817181685218,48
2571,1,4081,2049,2032,0,0,0,1.0,1,1.0,1,1.0,1,0.2730459395858443,48
2572,0,4081,2049,2032,0,0,0,1.0,1,1.0,1,1.0,1,0.2562403064166522,49
2573,1,4082,2049,2033,0,0,0,1.0,1,1.0,1,1.0,1,0.24159626222225386,50
2574,1,4083,2050,2033,0,0,0,1.0,1,1.0,1,1.0,1,0.25292415372807486,49
2575,1,4084,2050,2034,0,0,0,1.0,1,1.0,1,1.0,1,0.25425150768656724,48
2576,0,4084,2050,2034,0,0,0,1.0,1,1.0,1,1.0,1,0.25425150768656724,48
2577,2,4086,2050,2036,0,0,0,1.0,1,1.0,1,1.0,1,0.24634847126711162,50
2578,1,4087,2050,2037,0,0,0,1.0,1,1.0,1,1.0,1,0.22642008609703165,50
2579,1,4088,2051,2037,0,0,0,1.0,1,1.0,1,1.0,1,0.2126235740021851,51
2580,0,4088,2051,2037,0,0,0,1.0,1,1.0,1,1.0,1,0.22724524490988932,52
2581,0,4088,2051,2037,0,0,0,1.0,1,1.0,1,1.0,1,0.2391384787911618,51
2582,1,4089,2052,2037,0,0,0,1.0,1,1.0,1,1.0,1,0.2569446927757056,51
2583,4,4093,2053,2040,0,0,0,1.0,1,1.0,1,1.0,1,0.2338317428862098,51
2584,5,4098,2056,2042,0,0,0,1.0,1,1.0,1,1.0,1,0.2646591742236167,51
2585,2,4100,2056,2044,0,0,0,1.0,1,1.0,1,1.0,1,0.22143501025036516,50
2586,5,4105,2059,2046,0,0,0,1.0,1,1.0,1,1.0,1,0.22425422839300627,50
2587,0,4105,2059,2046,0,0,0,1.0,1,1.0,1,1.0,1,0.1953691523691274,48
2588,3,4108,2060,2048,0,0,0,1.0,1,1.0,1,1.0,1,0.21102534806168385,50
2589,0,4108,2060,2048,0,0,0,1.0,1,1.0,1,1.0,1,0.18713137448957057,48
2590,0,4108,2060,2048,0,0,0,1.0,1,1.0,1,1.0,1,0.19091554014825501,47
2591,2,4110,2061,2049,0,0,0,1.0,1,1.0,1,1.0,1,0.19817038101053316,47
2592,1,4111,2062,2049,0,0,0,1.0,1,1.0,1,1.0,1,0.22063867721444103,47
2593,2,4113,2063,2050,0,0,0,1.0,1,1.0,1,1.0,1,0.25165565405326795,47
2594,5,4118,2066,2052,0,0,0,1.0,1,1.0,1,1.0,1,0.22512594441226425,49
2595,1,4119,2066,2053,0,0,0,1.0,1,1.0,1,1.0,1,0.21071854775075285,48
2596,3,4122,2069,2053,0,0,0,1.0,1,1.0,1,1.0,1,0.1713837455560234,47
2597,4,4126,2072,2054,0,0,0,1.0,1,1.0,1,1.0,1,0.16879167696493996,48
2598,2,4128,2073,2055,0,0,0,1.0,1,1.0,1,1.0,1,0.1290594610719501,48
2599,3,4131,2075,2056,0,0,0,1.0,1,1.0,1,1.0,1,0.11588060176229852,49
2600,1,4132,2076,2056,0,0,0,1.0,1,1.0,1,1.0,1,0.15270233055957091,52
2601,3,4135,2078,2057,0,0,0,1.0,1,1.0,1,1.0,1,0.16539246807321634,51
2602,1,4136,2079,2057,0,0,0,1.0,1,1.0,1,1.0,1,0.17725684076730244,52
2603,1,4137,2079,2058,0,0,0,1.0,1,1.0,1,1.0,1,0.18032361347422723,53
2604,0,4137,2079,2058,0,0,0,1.0,1,1.0,1,1.0,1,0.18032361347422723,53
2605,1,4138,2080,2058,0,0,0,1.0,1,1.0,1,1.0,1,0.21160489080128153,52
2606,1,4139,2080,2059,0,0,0,1.0,1,1.0,1,1.0,1,0.19975855402286202,52
2607,1,4140,2081,2059,0,0,0,1.0,1,1.0,1,1.0,1,0.22766168152573493,52
2608,1,4141,2081,2060,0,0,0,1.0,1,1.0,1,1.0,1,0.21440509062818786,52
2609,1,4142,2081,2061,0,0,0,1.0,1,1.0,1,1.0,1,0.1871131844990767,53
2610,3,4145,2082,2063,0,0,0,1.0,1,1.0,1,1.0,1,0.18603930057283138,54
2611,2,4147,2082,2065,0,0,0,1.0,1,1.0,1,1.0,1,0.14628410606982784,54
2612,1,4148,2083,2065,0,0,0,1.0,1,1.0,1,1.0,1,0.15259280231079855,56
2613,1,4149,2084,2065,0,0,0,1.0,1,1.0,1,1.0,1,0.14252575262736628,56
2614,2,4151,2085,2066,0,0,0,1.0,1,1.0,1,1.0,1,0.11968254029670666,56
2615,1,4152,2086,2066,0,0,0,1.0,1,1.0,1,1.0,1,0.12717807736501946,57
2616,0,4152,2086,2066,0,0,0,1.0,1,1.0,1,1.0,1,0.12717807736501946,57
2617,1,4153,2087,2066,0,0,0,1.0,1,1.0,1,1.0,1,0.1389422298833857,58
2618,0,4153,2087,2066,0,0,0,1.0,1,1.0,1,1.0,1,0.1389422298833857,58
2619,1,4154,2087,2067,0,0,0,1.0,1,1.0,1,1.0,1,0.14215971814216363,58
2620,1,4155,2088,2067,0,0,0,1.0,1,1.0,1,1.0,1,0.16069341036881338,60
2621,2,4157,2088,2069,0,0,0,1.0,1,1.0,1,1.0,1,0.1513130382486575,59
2622,1,4158,2089,2069,0,0,0,1.0,1,1.0,1,1.0,1,0.1688132366403212,60
2623,3,4161,2090,2071,0,0,0,1.0,1,1.0,1,1.0,1,0.15474782168994627,59
2624,10,4171,2096,2075,0,0,0,1.0,1,1.0,1,1.0,1,0.2080526633629632,58
2625,2,4173,2097,2076,0,0,0,1.0,1,1.0,1,1.0,1,0.18219706543013436,58
2626,3,4176,2099,2077,0,0,0,1.0,1,1.0,1,1.0,1,0.20508283199317132,57
2627,0,4176,2099,2077,0,0,0,1.0,1,1.0,1,1.0,1,0.18488980087808357,55
2628,1,4177,2100,2077,0,0,0,1.0,1,1.0,1,1.0,1,0.18183438928140466,55
2629,0,4177,2100,2077,0,0,0,1.0,1,1.0,1,1.0,1,0.16962199591546043,54
2630,5,4182,2102,2080,0,0,0,1.0,1,1.0,1,1.0,1,0.21982681788253622,55
2631,0,4182,2102,2080,0,0,0,1.0,1,1.0,1,1.0,1,0.21509933593722494,55
2632,3,4185,2104,2081,0,0,0,1.0,1,1.0,1,1.0,1,0.24264619639334817,55
2633,2,4187,2106,2081,0,0,0,1.0,1,1.0,1,1.0,1,0.2672770592043231,53
2634,4,4191,2108,2083,0,0,0,1.0,1,1.0,1,1.0,1,0.27328205794362087,52
2635,4,4195,2109,2086,0,0,0,1.0,1,1.0,1,1.0,1,0.26086854060454856,52
2636,8,4203,2111,2092,0,0,0,1.0,1,1.0,1,1.0,1,0.2397749522906194,51
2637,5,4208,2112,2096,0,0,0,1.0,1,1.0,1,1.0,1,0.1745950281080037,50
2638,3,4211,2114,2097,0,0,0,1.0,1,1.0,1,1.0,1,0.17441164343820334,48
2639,4,4215,2115,2100,0,0,0,1.0,1,1.0,1,1.0,1,0.15439115166321563,48
2640,4,4219,2118,2101,0,0,0,1.0,1,1.0,1,1.0,1,0.1253957532078484,46
2641,2,4221,2119,2102,0,0,0,1.0,1,1.0,1,1.0,1,0.1273228274721325,46
2642,3,4224,2122,2102,0,0,0,1.0,1,1.0,1,1.0,1,0.1521780503327183,47
2643,1,4225,2122,2103,0,0,0,1.0,1,1.0,1,1.0,1,0.14836563165085254,45
2644,2,4227,2124,2103,0,0,0,1.0,1,1.0,1,1.0,1,0.23672729622609281,44
2645,3,4230,2125,2105,0,0,0,1.0,1,1.0,1,1.0,1,0.219428448223424,42
2646,1,4231,2126,2105,0,0,0,1.0,1,1.0,1,1.0,1,0.254960562803053,43
2647,2,4233,2126,2107,0,0,0,1.0,1,1.0,1,1.0,1,0.19649483797298756,40
2648,0,4233,2126,2107,0,0,0,1.0,1,1.0,1,1.0,1,0.16654653523421858,41
2649,2,4235,2126,2109,0,0,0,1.0,1,1.0,1,1.0,1,0.13997913400869194,43
2650,0,4235,2126,2109,0,0,0,1.0,1,1.0,1,1.0,1,0.12253182453800715,43
2651,0,4235,2126,2109,0,0,0,1.0,1,1.0,1,1.0,1,0.1113099151509367,44
2652,1,4236,2127,2109,0,0,0,1.0,1,1.0,1,1.0,1,0.10187188736114079,44
2653,0,4236,2127,2109,0,0,0,1.0,1,1.0,1,1.0,1,0.10187188736114079,44
2654,1,4237,2128,2109,0,0,0,1.0,1,1.0,1,1.0,1,0.14662025695111378,45
2655,2,4239,2129,2110,0,0,0,1.0,1,1.0,1,1.0,1,0.1389296135849408,45
2656,1,4240,2129,2111,0,0,0,1.0,1,1.0,1,1.0,1,0.1202256322339426,45
2657,0,4240,2129,2111,0,0,0,1.0,1,1.0,1,1.0,1,0.149215902092517,45
2658,1,4241,2130,2111,0,0,0,1.0,1,1.0,1,1.0,1,0.15965779762530904,47
2659,3,4244,2130,2114,0,0,0,1.0,1,1.0,1,1.0,1,0.09830957170380997,46
2660,1,4245,2131,2114,0,0,0,1.0,1,1.0,1,1.0,1,0.1011404891396694,46
2661,3,4248,2134,2114,0,0,0,1.0,1,1.0,1,1.0,1,0.16278752597571605,46
2662,2,4250,2135,2115,0,0,0,1.0,1,1.0,1,1.0,1,0.15350123100300672,47
2663,4,4254,2138,2116,0,0,0,1.0,1,1.0,1,1.0,1,0.1667536989122783,46
2664,3,4257,2141,2116,0,0,0,1.0,1,1.0,1,1.0,1,0.16713753771812057,45
2665,3,4260,2142,2118,0,0,0,1.0,1,1.0,1,1.0,1,0.13941193307231875,47
2666,5,4265,2146,2119,0,0,0,1.0,1,1.0,1,1.0,1,0.19427510601582523,47
2667,3,4268,2148,2120,0,0,0,1.0,1,1.0,1,1.0,1,0.18774776099661836,45
2668,1,4269,2148,2121,0,0,0,1.0,1,1.0,1,1.0,1,0.1629092088512921,45
2669,1,4270,2149,2121,0,0,0,1.0,1,1.0,1,1.0,1,0.15356596680067425,45
2670,3,4273,2151,2122,0,0,0,1.0,1,1.0,1,1.0,1,0.1470352233201693,45
2671,0,4273,2151,2122,0,0,0,1.0,1,1.0,1,1.0,1,0.16750454720412755,41
2672,3,4276,2154,2122,0,0,0,1.0,1,1.0,1,1.0,1,0.12847371983208314,40
2673,2,4278,2156,2122,0,0,0,1.0,1,1.0,1,1.0,1,0.1601708402473211,39
2674,3,4281,2159,2122,0,0,0,1.0,1,1.0,1,1.0,1,0.26674385672291967,37
2675,1,4282,2160,2122,0,0,0,1.0,1,1.0,1,1.0,1,0.2503243703907301,35
2676,2,4284,2161,2123,0,0,0,1.0,1,1.0,1,1.0,1,0.28792060917669127,34
2677,3,4287,2163,2124,0,0,0,1.0,1,1.0,1,1.0,1,0.26204315334342027,32
2678,3,4290,2165,2125,0,0,0,1.0,1,1.0,1,1.0,1,0.28871024023542885,33
2679,4,4294,2167,2127,0,0,0,1.0,1,1.0,1,1.0,1,0.33230835048129487,33
2680,4,4298,2169,2129,0,0,0,1.0,1,1.0,1,1.0,1,0.2880497600915752,33
2681,1,4299,2169,2130,0,0,0,1.0,1,1.0,1,1.0,1,0.19659083337250496,32
2682,1,4300,2170,2130,0,0,0,1.0,1,1.0,1,1.0,1,0.21180968718837978,32
2683,1,4301,2171,2130,0,0,0,1.0,1,1.0,1,1.0,1,0.2549490542325566,32
2684,1,4302,2172,2130,0,0,0,1.0,1,1.0,1,1.0,1,0.26828739941965396,31
2685,2,4304,2173,2131,0,0,0,1.0,1,1.0,1,1.0,1,0.29858223768462044,30
2686,0,4304,2173,2131,0,0,0,1.0,1,1.0,1,1.0,1,0.28359423137920076,29
2687,0,4304,2173,2131,0,0,0,1.0,1,1.0,1,1.0,1,0.2735976471537611,28
2688,0,4304,2173,2131,0,0,0,1.0,1,1.0,1,1.0,1,0.2735976471537611,28
2689,0,4304,2173,2131,0,0,0,1.0,1,1.0,1,1.0,1,0.2982070021836662,29
2690,1,4305,2174,2131,0,0,0,1.0,1,1.0,1,1.0,1,0.31484106642938436,29
2691,3,4308,2177,2131,0,0,0,1.0,1,1.0,1,1.0,1,0.31313227955160433,29
2692,3,4311,2177,2134,0,0,0,1.0,1,1.0,1,1.0,1,0.25748309691477156,31
2693,3,4314,2179,2135,0,0,0,1.0,1,1.0,1,1.0,1,0.2913868066209186,32
2694,1,4315,2180,2135,0,0,0,1.0,1,1.0,1,1.0,1,0.2958713891082771,32
2695,0,4315,2180,2135,0,0,0,1.0,1,1.0,1,1.0,1,0.2714831683700554,33
2696,0,4315,2180,2135,0,0,0,1.0,1,1.0,1,1.0,1,0.2714831683700554,33
2697,1,4316,2181,2135,0,0,0,1.0,1,1.0,1,1.0,1,0.24910521539966907,34
2698,2,4318,2182,2136,0,0,0,1.0,1,1.0,1,1.0,1,0.24510021394860484,34
2699,1,4319,2182,2137,0,0,0,1.0,1,1.0,1,1.0,1,0.20564920048187635,36
2700,0,4319,2182,2137,0,0,0,1.0,1,1.0,1,1.0,1,0.22214967438716343,36
2701,0,4319,2182,2137,0,0,0,1.0,1,1.0,1,1.0,1,0.22214967438716343,36
2702,1,4320,2183,2137,0,0,0,1.0,1,1.0,1,1.0,1,0.1967564257741813,36
2703,3,4323,2186,2137,0,0,0,1.0,1,1.0,1,1.0,1,0.2693914841577751,38
2704,2,4325,2187,2138,0,0,0,1.0,1,1.0,1,1.0,1,0.2811201886397097,37
2705,5,4330,2190,2140,0,0,0,1.0,1,1.0,1,1.0,1,0.2932698173541349,36
2706,2,4332,2191,2141,0,0,0,1.0,1,1.0,1,1.0,1,0.2581534859219758,34
2707,2,4334,2192,2142,0,0,0,1.0,1,1.0,1,1.0,1,0.26810545598340135,36
2708,3,4337,2195,2142,0,0,0,1.0,1,1.0,1,1.0,1,0.28288251461609465,36
2709,1,4338,2196,2142,0,0,0,1.0,1,1.0,1,1.0,1,0.2932299683574643,33
2710,6,4344,2199,2145,0,0,0,1.0,1,1.0,1,1.0,1,0.292810156821914,32
2711,2,4346,2200,2146,0,0,0,1.0,1,1.0,1,1.0,1,0.24167067559642877,29
2712,0,4346,2200,2146,0,0,0,1.0,1,1.0,1,1.0,1,0.2544560707386895,28
2713,1,4347,2200,2147,0,0,0,1.0,1,1.0,1,1.0,1,0.22802093004499033,28
2714,0,4347,2200,2147,0,0,0,1.0,1,1.0,1,1.0,1,0.19843589659785024,25
2715,1,4348,2201,2147,0,0,0,1.0,1,1.0,1,1.0,1,0.2812497904420264,24
2716,3,4351,2203,2148,0,0,0,1.0,1,1.0,1,1.0,1,0.3899911750603491,23
2717,2,4353,2204,2149,0,0,0,1.0,1,1.0,1,1.0,1,0.31129753223687223,24
2718,0,4353,2204,2149,0,0,0,1.0,1,1.0,1,1.0,1,0.31129753223687223,24
2719,1,4354,2204,2150,0,0,0,1.0,1,1.0,1,1.0,1,0.2698664821798872,25
2720,2,4356,2206,2150,0,0,0,1.0,1,1.0,1,1.0,1,0.27008621836121305,25
2721,2,4358,2208,2150,0,0,0,1.0,1,1.0,1,1.0,1,0.24662983858893148,26
2722,1,4359,2209,2150,0,0,0,1.0,1,1.0,1,1.0,1,0.28616661344724786,26
2723,1,4360,2210,2150,0,0,0,1.0,1,1.0,1,1.0,1,0.25482892348865344,26
2724,1,4361,2211,2150,0,0,0,1.0,1,1.0,1,1.0,1,0.2906036185970885,27
2725,1,4362,2212,2150,0,0,0,1.0,1,1.0,1,1.0,1,0.29930733071392623,27
2726,1,4363,2212,2151,0,0,0,1.0,1,1.0,1,1.0,1,0.3077137437091211,28
2727,1,4364,2212,2152,0,0,0,1.0,1,1.0,1,1.0,1,0.25242639301772296,29
2728,0,4364,2212,2152,0,0,0,1.0,1,1.0,1,1.0,1,0.24132863946104263,28
2729,1,4365,2212,2153,0,0,0,1.0,1,1.0,1,1.0,1,0.20203012813697213,28
2730,1,4366,2213,2153,0,0,0,1.0,1,1.0,1,1.0,1,0.26032468289854366,29
2731,3,4369,2213,2156,0,0,0,1.0,1,1.0,1,1.0,1,0.22418374647077133,30
2732,0,4369,2213,2156,0,0,0,1.0,1,1.0,1,1.0,1,0.2144555909356897,29
2733,0,4369,2213,2156,0,0,0,1.0,1,1.0,1,1.0,1,0.2144555909356897,29
2734,0,4369,2213,2156,0,0,0,1.0,1,1.0,1,1.0,1,0.2144555909356897,29
2735,2,4371,2215,2156,0,0,0,1.0,1,1.0,1,1.0,1,0.2675020495529848,29
2736,1,4372,2215,2157,0,0,0,1.0,1,1.0,1,1.0,1,0.27500981050897855,30
2737,0,4372,2215,2157,0,0,0,1.0,1,1.0,1,1.0,1,0.27500981050897855,30
2738,3,4375,2218,2157,0,0,0,1.0,1,1.0,1,1.0,1,0.3077085866290147,29
2739,2,4377,2218,2159,0,0,0,1.0,1,1.0,1,1.0,1,0.2657713360749361,30
2740,0,4377,2218,2159,0,0,0,1.0,1,1.0,1,1.0,1,0.2867997937777647,29
2741,1,4378,2219,2159,0,0,0,1.0,1,1.0,1,1.0,1,0.2687393079108889,29
2742,1,4379,2220,2159,0,0,0,1.0,1,1.0,1,1.0,1,0.28959647775029934,29
2743,0,4379,2220,2159,0,0,0,1.0,1,1.0,1,1.0,1,0.3106164558642981,30
2744,3,4382,2223,2159,0,0,0,1.0,1,1.0,1,1.0,1,0.40256655542050357,28
2745,1,4383,2223,2160,0,0,0,1.0,1,1.0,1,1.0,1,0.3478287761942839,27
2746,1,4384,2224,2160,0,0,0,1.0,1,1.0,1,1.0,1,0.4419931229329584,26
2747,3,4387,2226,2161,0,0,0,1.0,1,1.0,1,1.0,1,0.47375073316389504,22
2748,1,4388,2226,2162,0,0,0,1.0,1,1.0,1,1.0,1,0.4175847294310683,22
2749,1,4389,2226,2163,0,0,0,1.0,1,1.0,1,1.0,1,0.43898545739871436,20
2750,0,4389,2226,2163,0,0,0,1.0,1,1.0,1,1.0,1,0.4654857317452497,17
2751,1,4390,2227,2163,0,0,0,1.0,1,1.0,1,1.0,1,0.5060274689749473,17
2752,1,4391,2227,2164,0,0,0,1.0,1,1.0,1,1.0,1,0.4564201145180356,16
2753,0,4391,2227,2164,0,0,0,1.0,1,1.0,1,1.0,1,0.4564201145180356,16
2754,2,4393,2228,2165,0,0,0,1.0,1,1.0,1,1.0,1,0.4647641011142189,16
2755,1,4394,2229,2165,0,0,0,1.0,1,1.0,1,1.0,1,0.5156561094931786,16
2756,1,4395,2229,2166,0,0,0,1.0,1,1.0,1,1.0,1,0.5264575041329556,17
2757,1,4396,2230,2166,0,0,0,1.0,1,1.0,1,1.0,1,0.49985881103937163,18
2758,0,4396,2230,2166,0,0,0,1.0,1,1.0,1,1.0,1,0.49985881103937163,18
2759,1,4397,2230,2167,0,0,0,1.0,1,1.0,1,1.0,1,0.4789371710735084,19
2760,0,4397,2230,2167,0,0,0,1.0,1,1.0,1,1.0,1,0.44863520157779985,18
2761,0,4397,2230,2167,0,0,0,1.0,1,1.0,1,1.0,1,0.44863520157779985,18
2762,0,4397,2230,2167,0,0,0,1.0,1,1.0,1,1.0,1,0.44863520157779985,18
2763,0,4397,2230,2167,0,0,0,1.0,1,1.0,1,1.0,1,0.44863520157779985,18
2764,1,4398,2231,2167,0,0,0,1.0,1,1.0,1,1.0,1,0.41625088045905045,18
2765,1,4399,2232,2167,0,0,0,1.0,1,1.0,1,1.0,1,0.40441107201372833,18
2766,0,4399,2232,2167,0,0,0,1.0,1,1.0,1,1.0,1,0.40441107201372833,18
2767,0,4399,2232,2167,0,0,0,1.0,1,1.0,1,1.0,1,0.437240451768015,17
2768,0,4399,2232,2167,0,0,0,1.0,1,1.0,1,1.0,1,0.437240451768015,17
2769,0,4399,2232,2167,0,0,0,1.0,1,1.0,1,1.0,1,0.437240451768015,17
2770,0,4399,2232,2167,0,0,0,1.0,1,1.0,1,1.0,1,0.437240451768015,17
2771,0,4399,2232,2167,0,0,0,1.0,1,1.0,1,1.0,1,0.437240451768015,17
2772,0,4399,2232,2167,0,0,0,1.0,1,1.0,1,1.0,1,0.437240451768015,17
2773,1,4400,2233,2167,0,0,0,1.0,1,1.0,1,1.0,1,0.5130120802447192,17
2774,0,4400,2233,2167,0,0,0,1.0,1,1.0,1,1.0,1,0.45010429886830305,18
2775,3,4403,2235,2168,0,0,0,1.0,1,1.0,1,1.0,1,0.4369142208361562,20
2776,0,4403,2235,2168,0,0,0,1.0,1,1.0,1,1.0,1,0.4066168043875881,21
2777,0,4403,2235,2168,0,0,0,1.0,1,1.0,1,1.0,1,0.4066168043875881,21
2778,4,4407,2237,2170,0,0,0,1.0,1,1.0,1,1.0,1,0.44660265031946633,21
2779,0,4407,2237,2170,0,0,0,1.0,1,1.0,1,1.0,1,0.4334393976350507,22
2780,1,4408,2238,2170,0,0,0,1.0,1,1.0,1,1.0,1,0.5123222198692592,22
2781,4,4412,2239,2173,0,0,0,1.0,1,1.0,1,1.0,1,0.4158830281677372,22
2782,2,4414,2240,2174,0,0,0,1.0,1,1.0,1,1.0,1,0.3656296285224606,23
2783,0,4414,2240,2174,0,0,0,1.0,1,1.0,1,1.0,1,0.34204969256588774,22
2784,1,4415,2241,2174,0,0,0,1.0,1,1.0,1,1.0,1,0.3916216078137407,21
2785,0,4415,2241,2174,0,0,0,1.0,1,1.0,1,1.0,1,0.3262261775669008,19
2786,0,4415,2241,2174,0,0,0,1.0,1,1.0,1,1.0,1,0.3262261775669008,19
2787,0,4415,2241,2174,0,0,0,1.0,1,1.0,1,1.0,1,0.28951886429534984,20
2788,1,4416,2242,2174,0,0,0,1.0,1,1.0,1,1.0,1,0.3330366053247319,20
2789,0,4416,2242,2174,0,0,0,1.0,1,1.0,1,1.0,1,0.3236285679058808,19
2790,0,4416,2242,2174,0,0,0,1.0,1,1.0,1,1.0,1,0.31496104659696583,20
2791,0,4416,2242,2174,0,0,0,1.0,1,1.0,1,1.0,1,0.31496104659696583,20
2792,0,4416,2242,2174,0,0,0,1.0,1,1.0,1,1.0,1,0.31496104659696583,20
2793,0,4416,2242,2174,0,0,0,1.0,1,1.0,1,1.0,1,0.3537971285596006,19
2794,0,4416,2242,2174,0,0,0,1.0,1,1.0,1,1.0,1,0.37395365178027223,20
2795,0,4416,2242,2174,0,0,0,1.0,1,1.0,1,1.0,1,0.36191314992652324,21
2796,0,4416,2242,2174,0,0,0,1.0,1,1.0,1,1.0,1,0.36695601279031764,22
2797,0,4416,2242,2174,0,0,0,1.0,1,1.0,1,1.0,1,0.4097774102707242,21
2798,1,4417,2243,2174,0,0,0,1.0,1,1.0,1,1.0,1,0.4520729097684035,21
2799,0,4417,2243,2174,0,0,0,1.0,1,1.0,1,1.0,1,0.4484931791256177,20
2800,0,4417,2243,2174,0,0,0,1.0,1,1.0,1,1.0,1,0.4484931791256177,20
2801,0,4417,2243,2174,0,0,0,1.0,1,1.0,1,1.0,1,0.4484931791256177,20
2802,1,4418,2243,2175,0,0,0,1.0,1,1.0,1,1.0,1,0.39727802826824676,20
2803,0,4418,2243,2175,0,0,0,1.0,1,1.0,1,1.0,1,0.3861136804324541,21
2804,2,4420,2243,2177,0,0,0,1.0,1,1.0,1,1.0,1,0.3273584032419917,22
2805,1,4421,2244,2177,0,0,0,1.0,1,1.0,1,1.0,1,0.3017654667955358,22
2806,1,4422,2245,2177,0,0,0,1.0,1,1.0,1,1.0,1,0.33367797358064066,23
2807,4,4426,2248,2178,0,0,0,1.0,1,1.0,1,1.0,1,0.42743951967207144,24
2808,2,4428,2250,2178,0,0,0,1.0,1,1.0,1,1.0,1,0.48921677676654635,24
2809,5,4433,2250,2183,0,0,0,1.0,1,1.0,1,1.0,1,0.2459329865366805,26
2810,2,4435,2250,2185,0,0,0,1.0,1,1.0,1,1.0,1,0.1498665841163179,26
2811,0,4435,2250,2185,0,0,0,1.0,1,1.0,1,1.0,1,0.16718135510048918,27
2812,0,4435,2250,2185,0,0,0,1.0,1,1.0,1,1.0,1,0.16718135510048918,27
2813,0,4435,2250,2185,0,0,0,1.0,1,1.0,1,1.0,1,0.15542737602695553,28
2814,2,4437,2251,2186,0,0,0,1.0,1,1.0,1,1.0,1,0.1993952500476549,29
2815,0,4437,2251,2186,0,0,0,1.0,1,1.0,1,1.0,1,0.20503151517938334,30
2816,1,4438,2252,2186,0,0,0,1.0,1,1.0,1,1.0,1,0.2028738648630647,31
2817,0,4438,2252,2186,0,0,0,1.0,1,1.0,1,1.0,1,0.2028738648630647,31
2818,1,4439,2253,2186,0,0,0,1.0,1,1.0,1,1.0,1,0.21130092757362107,32
2819,0,4439,2253,2186,0,0,0,1.0,1,1.0,1,1.0,1,0.21130092757362107,32
2820,0,4439,2253,2186,0,0,0,1.0,1,1.0,1,1.0,1,0.22575048952000895,33
2821,2,4441,2253,2188,0,0,0,1.0,1,1.0,1,1.0,1,0.18426113058951898,34
2822,1,4442,2254,2188,0,0,0,1.0,1,1.0,1,1.0,1,0.1982020196622206,35
2823,1,4443,2255,2188,0,0,0,1.0,1,1.0,1,1.0,1,0.20032152349197663,31
2824,3,4446,2258,2188,0,0,0,1.0,1,1.0,1,1.0,1,0.34762043485119243,33
2825,1,4447,2258,2189,0,0,0,1.0,1,1.0,1,1.0,1,0.2886191242781721,31
2826,0,4447,2258,2189,0,0,0,1.0,1,1.0,1,1.0,1,0.2886191242781721,31
2827,1,4448,2259,2189,0,0,0,1.0,1,1.0,1,1.0,1,0.2724118203482432,32
2828,4,4452,2260,2192,0,0,0,1.0,1,1.0,1,1.0,1,0.2724348801439162,33
2829,2,4454,2261,2193,0,0,0,1.0,1,1.0,1,1.0,1,0.24036211644549613,33
2830,0,4454,2261,2193,0,0,0,1.0,1,1.0,1,1.0,1,0.25821559099405594,32
2831,3,4457,2263,2194,0,0,0,1.0,1,1.0,1,1.0,1,0.32505039311432266,31
2832,2,4459,2265,2194,0,0,0,1.0,1,1.0,1,1.0,1,0.3086738880428011,30
2833,4,4463,2266,2197,0,0,0,1.0,1,1.0,1,1.0,1,0.19358048589422994,29
2834,5,4468,2269,2199,0,0,0,1.0,1,1.0,1,1.0,1,0.1367032434364366,29
2835,2,4470,2271,2199,0,0,0,1.0,1,1.0,1,1.0,1,0.2639057046218846,27
2836,0,4470,2271,2199,0,0,0,1.0,1,1.0,1,1.0,1,0.2572908378111879,27
2837,1,4471,2271,2200,0,0,0,1.0,1,1.0,1,1.0,1,0.2246997365597194,28
2838,0,4471,2271,2200,0,0,0,1.0,1,1.0,1,1.0,1,0.24322976369380211,29
2839,0,4471,2271,2200,0,0,0,1.0,1,1.0,1,1.0,1,0.2551778153192271,29
2840,0,4471,2271,2200,0,0,0,1.0,1,1.0,1,1.0,1,0.2551778153192271,29
2841,1,4472,2272,2200,0,0,0,1.0,1,1.0,1,1.0,1,0.2642447067531001,31
2842,2,4474,2273,2201,0,0,0,1.0,1,1.0,1,1.0,1,0.26898429610001257,32
2843,0,4474,2273,2201,0,0,0,1.0,1,1.0,1,1.0,1,0.26898429610001257,32
2844,1,4475,2273,2202,0,0,0,1.0,1,1.0,1,1.0,1,0.2729039818766577,33
2845,2,4477,2275,2202,0,0,0,1.0,1,1.0,1,1.0,1,0.2702011677836909,34
2846,1,4478,2276,2202,0,0,0,1.0,1,1.0,1,1.0,1,0.28996817395972385,34
2847,1,4479,2277,2202,0,0,0,1.0,1,1.0,1,1.0,1,0.2807478456741849,35
2848,4,4483,2278,2205,0,0,0,1.0,1,1.0,1,1.0,1,0.23366026049895047,37
2849,2,4485,2280,2205,0,0,0,1.0,1,1.0,1,1.0,1,0.2601192533164659,37
2850,0,4485,2280,2205,0,0,0,1.0,1,1.0,1,1.0,1,0.2601192533164659,37
2851,2,4487,2280,2207,0,0,0,1.0,1,1.0,1,1.0,1,0.21962039856532323,38
2852,0,4487,2280,2207,0,0,0,1.0,1,1.0,1,1.0,1,0.23279302586152334,36
2853,0,4487,2280,2207,0,0,0,1.0,1,1.0,1,1.0,1,0.26620464201627403,36
2854,1,4488,2280,2208,0,0,0,1.0,1,1.0,1,1.0,1,0.2625241211459251,37
2855,0,4488,2280,2208,0,0,0,1.0,1,1.0,1,1.0,1,0.30502408269073006,37
2856,2,4490,2280,2210,0,0,0,1.0,1,1.0,1,1.0,1,0.24170858575410537,38
2857,1,4491,2281,2210,0,0,0,1.0,1,1.0,1,1.0,1,0.2862668941756961,39
2858,5,4496,2282,2214,0,0,0,1.0,1,1.0,1,1.0,1,0.23575493098001227,39
2859,1,4497,2283,2214,0,0,0,1.0,1,1.0,1,1.0,1,0.21587268273160692,39
2860,1,4498,2284,2214,0,0,0,1.0,1,1.0,1,1.0,1,0.22159060465652783,40
2861,2,4500,2285,2215,0,0,0,1.0,1,1.0,1,1.0,1,0.1542425368262172,38
2862,5,4505,2289,2216,0,0,0,1.0,1,1.0,1,1.0,1,0.15790155692469865,38
2863,1,4506,2290,2216,0,0,0,1.0,1,1.0,1,1.0,1,0.17019690126546805,37
2864,4,4510,2294,2216,0,0,0,1.0,1,1.0,1,1.0,1,0.2120496129048814,35
2865,3,4513,2295,2218,0,0,0,1.0,1,1.0,1,1.0,1,0.20588225854531006,33
2866,3,4516,2298,2218,0,0,0,1.0,1,1.0,1,1.0,1,0.25856818959927563,31
2867,1,4517,2299,2218,0,0,0,1.0,1,1.0,1,1.0,1,0.2714669235428462,30
2868,2,4519,2300,2219,0,0,0,1.0,1,1.0,1,1.0,1,0.2759882530426848,31
2869,4,4523,2303,2220,0,0,0,1.0,1,1.0,1,1.0,1,0.35768504502292375,30
2870,0,4523,2303,2220,0,0,0,1.0,1,1.0,1,1.0,1,0.3485361571949304,26
2871,2,4525,2304,2221,0,0,0,1.0,1,1.0,1,1.0,1,0.36973888021684087,27
2872,1,4526,2305,2221,0,0,0,1.0,1,1.0,1,1.0,1,0.339922019486293,25
2873,0,4526,2305,2221,0,0,0,1.0,1,1.0,1,1.0,1,0.35882206059236227,24
2874,1,4527,2305,2222,0,0,0,1.0,1,1.0,1,1.0,1,0.30588856053256036,25
2875,0,4527,2305,2222,0,0,0,1.0,1,1.0,1,1.0,1,0.32829477850103195,26
2876,2,4529,2306,2223,0,0,0,1.0,1,1.0,1,1.0,1,0.3347038778738978,28
2877,0,4529,2306,2223,0,0,0,1.0,1,1.0,1,1.0,1,0.3364173515212475,29
2878,0,4529,2306,2223,0,0,0,1.0,1,1.0,1,1.0,1,0.3359159331384166,31
2879,2,4531,2306,2225,0,0,0,1.0,1,1.0,1,1.0,1,0.2695536123945327,31
2880,2,4533,2306,2227,0,0,0,1.0,1,1.0,1,1.0,1,0.20342309753082555,32
2881,0,4533,2306,2227,0,0,0,1.0,1,1.0,1,1.0,1,0.2221993225707588,31
2882,0,4533,2306,2227,0,0,0,1.0,1,1.0,1,1.0,1,0.2221993225707588,31
2883,2,4535,2306,2229,0,0,0,1.0,1,1.0,1,1.0,1,0.25320061610318834,32
2884,1,4536,2307,2229,0,0,0,1.0,1,1.0,1,1.0,1,0.26242068259449447,32
2885,2,4538,2307,2231,0,0,0,1.0,1,1.0,1,1.0,1,0.20107702535721225,33
2886,2,4540,2309,2231,0,0,0,1.0,1,1.0,1,1.0,1,0.21901551655779578,34
2887,0,4540,2309,2231,0,0,0,1.0,1,1.0,1,1.0,1,0.23308279560011388,34
2888,3,4543,2311,2232,0,0,0,1.0,1,1.0,1,1.0,1,0.22057269785001002,34
2889,3,4546,2312,2234,0,0,0,1.0,1,1.0,1,1.0,1,0.21556259563246138,37
2890,1,4547,2312,2235,0,0,0,1.0,1,1.0,1,1.0,1,0.1861086434481751,37
2891,1,4548,2313,2235,0,0,0,1.0,1,1.0,1,1.0,1,0.23400966398633785,37
2892,0,4548,2313,2235,0,0,0,1.0,1,1.0,1,1.0,1,0.23400966398633785,37
2893,1,4549,2314,2235,0,0,0,1.0,1,1.0,1,1.0,1,0.26231109953789916,38
2894,2,4551,2314,2237,0,0,0,1.0,1,1.0,1,1.0,1,0.22922237261361306,39
2895,1,4552,2315,2237,0,0,0,1.0,1,1.0,1,1.0,1,0.2244125828340005,40
2896,0,4552,2315,2237,0,0,0,1.0,1,1.0,1,1.0,1,0.24249840210406348,41
2897,1,4553,2315,2238,0,0,0,1.0,1,1.0,1,1.0,1,0.21283759896534973,41
2898,1,4554,2316,2238,0,0,0,1.0,1,1.0,1,1.0,1,0.2576864997554824,41
2899,2,4556,2317,2239,0,0,0,1.0,1,1.0,1,1.0,1,0.24111186545748048,39
2900,4,4560,2320,2240,0,0,0,1.0,1,1.0,1,1.0,1,0.3453692768407718,40
2901,0,4560,2320,2240,0,0,0,1.0,1,1.0,1,1.0,1,0.3038214351295566,40
2902,2,4562,2321,2241,0,0,0,1.0,1,1.0,1,1.0,1,0.30662103846078836,38
2903,0,4562,2321,2241,0,0,0,1.0,1,1.0,1,1.0,1,0.29702620800620827,36
2904,3,4565,2323,2242,0,0,0,1.0,1,1.0,1,1.0,1,0.27898087385923553,36
2905,1,4566,2324,2242,0,0,0,1.0,1,1.0,1,1.0,1,0.27149477954951584,35
2906,0,4566,2324,2242,0,0,0,1.0,1,1.0,1,1.0,1,0.28732635616687435,36
2907,2,4568,2325,2243,0,0,0,1.0,1,1.0,1,1.0,1,0.31185983251594107,37
2908,3,4571,2326,2245,0,0,0,1.0,1,1.0,1,1.0,1,0.3104878739550281,38
2909,0,4571,2326,2245,0,0,0,1.0,1,1.0,1,1.0,1,0.3001968144630193,37
2910,2,4573,2327,2246,0,0,0,1.0,1,1.0,1,1.0,1,0.29118342936455943,37
2911,0,4573,2327,2246,0,0,0,1.0,1,1.0,1,1.0,1,0.2834011369752053,36
2912,4,4577,2329,2248,0,0,0,1.0,1,1.0,1,1.0,1,0.29130928132528805,36
2913,2,4579,2329,2250,0,0,0,1.0,1,1.0,1,1.0,1,0.25212885579765515,36
2914,0,4579,2329,2250,0,0,0,1.0,1,1.0,1,1.0,1,0.27482877991475335,38
2915,0,4579,2329,2250,0,0,0,1.0,1,1.0,1,1.0,1,0.26461616790182957,37
2916,1,4580,2329,2251,0,0,0,1.0,1,1.0,1,1.0,1,0.2610166399531785,39
2917,1,4581,2329,2252,0,0,0,1.0,1,1.0,1,1.0,1,0.2578926583306494,40
2918,3,4584,2332,2252,0,0,0,1.0,1,1.0,1,1.0,1,0.26888075030997644,40
2919,3,4587,2333,2254,0,0,0,1.0,1,1.0,1,1.0,1,0.2393910439476988,42
2920,0,4587,2333,2254,0,0,0,1.0,1,1.0,1,1.0,1,0.2393910439476988,42
2921,0,4587,2333,2254,0,0,0,1.0,1,1.0,1,1.0,1,0.2393910439476988,42
2922,0,4587,2333,2254,0,0,0,1.0,1,1.0,1,1.0,1,0.22211210290156225,43
2923,0,4587,2333,2254,0,0,0,1.0,1,1.0,1,1.0,1,0.22896777020989273,45
2924,2,4589,2335,2254,0,0,0,1.0,1,1.0,1,1.0,1,0.22550295440487358,46
2925,0,4589,2335,2254,0,0,0,1.0,1,1.0,1,1.0,1,0.22550295440487358,46
2926,1,4590,2335,2255,0,0,0,1.0,1,1.0,1,1.0,1,0.19933981416450772,46
2927,2,4592,2336,2256,0,0,0,1.0,1,1.0,1,1.0,1,0.20647200683123856,48
2928,2,4594,2338,2256,0,0,0,1.0,1,1.0,1,1.0,1,0.23301083599422093,48
2929,0,4594,2338,2256,0,0,0,1.0,1,1.0,1,1.0,1,0.23301083599422093,48
2930,1,4595,2338,2257,0,0,0,1.0,1,1.0,1,1.0,1,0.2375989580877156,50
2931,1,4596,2339,2257,0,0,0,1.0,1,1.0,1,1.0,1,0.2582971759907562,51
2932,0,4596,2339,2257,0,0,0,1.0,1,1.0,1,1.0,1,0.2638013521051675,52
2933,1,4597,2339,2258,0,0,0,1.0,1,1.0,1,1.0,1,0.2524932143391465,53
2934,2,4599,2340,2259,0,0,0,1.0,1,1.0,1,1.0,1,0.26492746134042394,54
2935,2,4601,2341,2260,0,0,0,1.0,1,1.0,1,1.0,1,0.2664708634156178,53
2936,0,4601,2341,2260,0,0,0,1.0,1,1.0,1,1.0,1,0.2664708634156178,53
2937,1,4602,2342,2260,0,0,0,1.0,1,1.0,1,1.0,1,0.29976795572906023,51
2938,6,4608,2345,2263,0,0,0,1.0,1,1.0,1,1.0,1,0.32368155889728273,53
2939,6,4614,2347,2267,0,0,0,1.0,1,1.0,1,1.0,1,0.2986331463991049,52
2940,1,4615,2348,2267,0,0,0,1.0,1,1.0,1,1.0,1,0.30643911853897365,52
2941,0,4615,2348,2267,0,0,0,1.0,1,1.0,1,1.0,1,0.31291749645796546,50
2942,1,4616,2348,2268,0,0,0,1.0,1,1.0,1,1.0,1,0.3106981270627596,50
2943,0,4616,2348,2268,0,0,0,1.0,1,1.0,1,1.0,1,0.2944534875211427,49
2944,3,4619,2348,2271,0,0,0,1.0,1,1.0,1,1.0,1,0.24520073020760957,48
2945,1,4620,2348,2272,0,0,0,1.0,1,1.0,1,1.0,1,0.22595931405996483,48
2946,3,4623,2351,2272,0,0,0,1.0,1,1.0,1,1.0,1,0.19678198489678483,47
2947,1,4624,2352,2272,0,0,0,1.0,1,1.0,1,1.0,1,0.18487583901154528,47
2948,1,4625,2353,2272,0,0,0,1.0,1,1.0,1,1.0,1,0.21756582616404807,48
2949,2,4627,2353,2274,0,0,0,1.0,1,1.0,1,1.0,1,0.1733502040942567,48
2950,0,4627,2353,2274,0,0,0,1.0,1,1.0,1,1.0,1,0.1733502040942567,48
2951,1,4628,2353,2275,0,0,0,1.0,1,1.0,1,1.0,1,0.1807751070699103,50
2952,0,4628,2353,2275,0,0,0,1.0,1,1.0,1,1.0,1,0.1807751070699103,50
2953,1,4629,2354,2275,0,0,0,1.0,1,1.0,1,1.0,1,0.212746395234244,51
2954,1,4630,2354,2276,0,0,0,1.0,1,1.0,1,1.0,1,0.19181049524351787,51
2955,0,4630,2354,2276,0,0,0,1.0,1,1.0,1,1.0,1,0.19181049524351787,51
2956,0,4630,2354,2276,0,0,0,1.0,1,1.0,1,1.0,1,0.19181049524351787,51
2957,1,4631,2355,2276,0,0,0,1.0,1,1.0,1,1.0,1,0.19938699071477856,52
2958,0,4631,2355,2276,0,0,0,1.0,1,1.0,1,1.0,1,0.19938699071477856,52
2959,0,4631,2355,2276,0,0,0,1.0,1,1.0,1,1.0,1,0.19464554608435797,53
2960,2,4633,2357,2276,0,0,0,1.0,1,1.0,1,1.0,1,0.19236772232200333,52
2961,0,4633,2357,2276,0,0,0,1.0,1,1.0,1,1.0,1,0.20350955492517372,53
2962,0,4633,2357,2276,0,0,0,1.0,1,1.0,1,1.0,1,0.22055833376179895,54
2963,3,4636,2358,2278,0,0,0,1.0,1,1.0,1,1.0,1,0.19648010062203863,55
2964,0,4636,2358,2278,0,0,0,1.0,1,1.0,1,1.0,1,0.21810079521531384,55
2965,0,4636,2358,2278,0,0,0,1.0,1,1.0,1,1.0,1,0.22411110613604948,55
2966,3,4639,2358,2281,0,0,0,1.0,1,1.0,1,1.0,1,0.18982188844329603,55
2967,2,4641,2358,2283,0,0,0,1.0,1,1.0,1,1.0,1,0.214650870780925,56
2968,0,4641,2358,2283,0,0,0,1.0,1,1.0,1,1.0,1,0.214650870780925,56
2969,1,4642,2358,2284,0,0,0,1.0,1,1.0,1,1.0,1,0.21170445415563469,55
2970,1,4643,2358,2285,0,0,0,1.0,1,1.0,1,1.0,1,0.21449307829037625,57
2971,2,4645,2360,2285,0,0,0,1.0,1,1.0,1,1.0,1,0.2095044611888832,56
2972,2,4647,2361,2286,0,0,0,1.0,1,1.0,1,1.0,1,0.22041785472271502,57
2973,5,4652,2363,2289,0,0,0,1.0,1,1.0,1,1.0,1,0.21433848417085619,59
2974,2,4654,2364,2290,0,0,0,1.0,1,1.0,1,1.0,1,0.21325185390349083,60
2975,5,4659,2366,2293,0,0,0,1.0,1,1.0,1,1.0,1,0.2498910642173012,58
2976,1,4660,2366,2294,0,0,0,1.0,1,1.0,1,1.0,1,0.23312111512726694,59
2977,5,4665,2367,2298,0,0,0,1.0,1,1.0,1,1.0,1,0.19719272731284462,59
2978,2,4667,2369,2298,0,0,0,1.0,1,1.0,1,1.0,1,0.20870126332039057,58
2979,0,4667,2369,2298,0,0,0,1.0,1,1.0,1,1.0,1,0.19954023984310007,57
2980,1,4668,2370,2298,0,0,0,1.0,1,1.0,1,1.0,1,0.1840307003212758,56
2981,1,4669,2371,2298,0,0,0,1.0,1,1.0,1,1.0,1,0.2037576499896568,56
2982,0,4669,2371,2298,0,0,0,1.0,1,1.0,1,1.0,1,0.20119901514650973,57
2983,6,4675,2374,2301,0,0,0,1.0,1,1.0,1,1.0,1,0.19589268177798214,57
2984,1,4676,2374,2302,0,0,0,1.0,1,1.0,1,1.0,1,0.17424623969532832,56
2985,1,4677,2374,2303,0,0,0,1.0,1,1.0,1,1.0,1,0.2037765500589,55
2986,5,4682,2378,2304,0,0,0,1.0,1,1.0,1,1.0,1,0.22962812600551852,55
2987,3,4685,2378,2307,0,0,0,1.0,1,1.0,1,1.0,1,0.23987670978754325,51
2988,3,4688,2379,2309,0,0,0,1.0,1,1.0,1,1.0,1,0.20244321144440952,52
2989,1,4689,2379,2310,0,0,0,1.0,1,1.0,1,1.0,1,0.21480547797317148,50
2990,3,4692,2380,2312,0,0,0,1.0,1,1.0,1,1.0,1,0.18783886815410336,50
2991,0,4692,2380,2312,0,0,0,1.0,1,1.0,1,1.0,1,0.1819554699053738,50
2992,1,4693,2380,2313,0,0,0,1.0,1,1.0,1,1.0,1,0.17305971601032444,50
2993,2,4695,2380,2315,0,0,0,1.0,1,1.0,1,1.0,1,0.1908734408386008,51
2994,5,4700,2383,2317,0,0,0,1.0,1,1.0,1,1.0,1,0.19600065840421907,51
2995,0,4700,2383,2317,0,0,0,1.0,1,1.0,1,1.0,1,0.21102013494990174,51
2996,1,4701,2384,2317,0,0,0,1.0,1,1.0,1,1.0,1,0.22828177469290412,52
2997,1,4702,2384,2318,0,0,0,1.0,1,1.0,1,1.0,1,0.2347138206701158,52
2998,4,4706,2387,2319,0,0,0,1.0,1,1.0,1,1.0,1,0.2452520389560805,51
2999,2,4708,2387,2321,0,0,0,1.0,1,1.0,1,1.0,1,0.2294969257118782,51
3000,3,4711,2389,2322,0,0,0,1.0,1,1.0,1,1.0,1,0.2084829679747223,52
3001,0,4711,2389,2322,0,0,0,1.0,1,1.0,1,1.0,1,0.2084829679747223,52
3002,2,4713,2390,2323,0,0,0,1.0,1,1.0,1,1.0,1,0.23175024021561935,53
3003,0,4713,2390,2323,0,0,0,1.0,1,1.0,1,1.0,1,0.22909470608850718,54
3004,0,4713,2390,2323,0,0,0,1.0,1,1.0,1,1.0,1,0.23653000787218723,55
3005,0,4713,2390,2323,0,0,0,1.0,1,1.0,1,1.0,1,0.24711372073423712,56
3006,0,4713,2390,2323,0,0,0,1.0,1,1.0,1,1.0,1,0.2466608190071593,57
3007,1,4714,2390,2324,0,0,0,1.0,1,1.0,1,1.0,1,0.238476437177522,58
3008,0,4714,2390,2324,0,0,0,1.0,1,1.0,1,1.0,1,0.23177434591474128,59
3009,0,4714,2390,2324,0,0,0,1.0,1,1.0,1,1.0,1,0.23177434591474128,59
3010,1,4715,2390,2325,0,0,0,1.0,1,1.0,1,1.0,1,0.21370915564249382,59
3011,3,4718,2391,2327,0,0,0,1.0,1,1.0,1,1.0,1,0.20488354007167286,59
3012,1,4719,2392,2327,0,0,0,1.0,1,1.0,1,1.0,1,0.24767537483045976,61
3013,3,4722,2393,2329,0,0,0,1.0,1,1.0,1,1.0,1,0.24760984861430455,59
3014,0,4722,2393,2329,0,0,0,1.0,1,1.0,1,1.0,1,0.2541235142253618,60
3015,1,4723,2393,2330,0,0,0,1.0,1,1.0,1,1.0,1,0.24853990354490468,58
3016,0,4723,2393,2330,0,0,0,1.0,1,1.0,1,1.0,1,0.24190488775008315,57
3017,3,4726,2396,2330,0,0,0,1.0,1,1.0,1,1.0,1,0.25718293141906795,58
3018,0,4726,2396,2330,0,0,0,1.0,1,1.0,1,1.0,1,0.28684920659423063,55
3019,2,4728,2396,2332,0,0,0,1.0,1,1.0,1,1.0,1,0.25954933068853836,56
3020,0,4728,2396,2332,0,0,0,1.0,1,1.0,1,1.0,1,0.31396073159270976,55
3021,1,4729,2396,2333,0,0,0,1.0,1,1.0,1,1.0,1,0.278184024235462,55
3022,3,4732,2398,2334,0,0,0,1.0,1,1.0,1,1.0,1,0.2984211666589118,55
3023,3,4735,2399,2336,0,0,0,1.0,1,1.0,1,1.0,1,0.2514138488081552,54
3024,1,4736,2400,2336,0,0,0,1.0,1,1.0,1,1.0,1,0.27021303307268607,54
3025,5,4741,2402,2339,0,0,0,1.0,1,1.0,1,1.0,1,0.23069232572538748,54
3026,0,4741,2402,2339,0,0,0,1.0,1,1.0,1,1.0,1,0.245826251931562,53
3027,5,4746,2405,2341,0,0,0,1.0,1,1.0,1,1.0,1,0.21037165017581566,53
3028,3,4749,2407,2342,0,0,0,1.0,1,1.0,1,1.0,1,0.2231506583676011,51
3029,3,4752,2408,2344,0,0,0,1.0,1,1.0,1,1.0,1,0.24024556377458814,51
3030,4,4756,2410,2346,0,0,0,1.0,1,1.0,1,1.0,1,0.2302844449018446,52
3031,4,4760,2412,2348,0,0,0,1.0,1,1.0,1,1.0,1,0.2396129735534441,51
3032,2,4762,2412,2350,0,0,0,1.0,1,1.0,1,1.0,1,0.20883324890845684,50
3033,1,4763,2413,2350,0,0,0,1.0,1,1.0,1,1.0,1,0.2000471135794644,52
3034,0,4763,2413,2350,0,0,0,1.0,1,1.0,1,1.0,1,0.21166095194222856,51
3035,2,4765,2413,2352,0,0,0,1.0,1,1.0,1,1.0,1,0.17825015786050719,51
3036,1,4766,2413,2353,0,0,0,1.0,1,1.0,1,1.0,1,0.15771675596143264,53
3037,0,4766,2413,2353,0,0,0,1.0,1,1.0,1,1.0,1,0.17201373612151283,52
3038,0,4766,2413,2353,0,0,0,1.0,1,1.0,1,1.0,1,0.17201373612151283,52
3039,2,4768,2413,2355,0,0,0,1.0,1,1.0,1,1.0,1,0.13673208565916134,54
3040,1,4769,2414,2355,0,0,0,1.0,1,1.0,1,1.0,1,0.11298187977299122,55
3041,1,4770,2414,2356,0,0,0,1.0,1,1.0,1,1.0,1,0.1143443281448953,56
3042,2,4772,2416,2356,0,0,0,1.0,1,1.0,1,1.0,1,0.173756946684676,56
3043,2,4774,2416,2358,0,0,0,1.0,1,1.0,1,1.0,1,0.12083692429120348,57
3044,1,4775,2417,2358,0,0,0,1.0,1,1.0,1,1.0,1,0.14622959981429565,57
3045,2,4777,2417,2360,0,0,0,1.0,1,1.0,1,1.0,1,0.11546594383436584,56
3046,2,4779,2419,2360,0,0,0,1.0,1,1.0,1,1.0,1,0.13586878333596417,57
3047,1,4780,2420,2360,0,0,0,1.0,1,1.0,1,1.0,1,0.15913461939162646,56
3048,2,4782,2420,2362,0,0,0,1.0,1,1.0,1,1.0,1,0.15646328564477333,58
3049,1,4783,2420,2363,0,0,0,1.0,1,1.0,1,1.0,1,0.18508132282265852,59
3050,3,4786,2420,2366,0,0,0,1.0,1,1.0,1,1.0,1,0.16835185654000703,60
3051,2,4788,2421,2367,0,0,0,1.0,1,1.0,1,1.0,1,0.19681866887918903,59
3052,0,4788,2421,2367,0,0,0,1.0,1,1.0,1,1.0,1,0.2106456903327208,58
3053,4,4792,2423,2369,0,0,0,1.0,1,1.0,1,1.0,1,0.2655768116993011,57
3054,4,4796,2425,2371,0,0,0,1.0,1,1.0,1,1.0,1,0.2741487367558402,55
3055,1,4797,2426,2371,0,0,0,1.0,1,1.0,1,1.0,1,0.279992322103465,54
3056,3,4800,2428,2372,0,0,0,1.0,1,1.0,1,1.0,1,0.3016647905107073,55
3057,1,4801,2428,2373,0,0,0,1.0,1,1.0,1,1.0,1,0.29308424207947736,54
3058,3,4804,2429,2375,0,0,0,1.0,1,1.0,1,1.0,1,0.3019032023806983,55
3059,2,4806,2429,2377,0,0,0,1.0,1,1.0,1,1.0,1,0.28474998746579555,56
3060,0,4806,2429,2377,0,0,0,1.0,1,1.0,1,1.0,1,0.28474998746579555,56
3061,1,4807,2430,2377,0,0,0,1.0,1,1.0,1,1.0,1,0.2671588912289384,56
3062,2,4809,2431,2378,0,0,0,1.0,1,1.0,1,1.0,1,0.2616886918918783,57
3063,2,4811,2432,2379,0,0,0,1.0,1,1.0,1,1.0,1,0.23998563709568102,55
3064,4,4815,2435,2380,0,0,0,1.0,1,1.0,1,1.0,1,0.2780226875839541,56
3065,5,4820,2437,2383,0,0,0,1.0,1,1.0,1,1.0,1,0.22712697412608013,55
3066,2,4822,2439,2383,0,0,0,1.0,1,1.0,1,1.0,1,0.2529498369277329,55
3067,3,4825,2441,2384,0,0,0,1.0,1,1.0,1,1.0,1,0.27161378230256356,54
3068,2,4827,2442,2385,0,0,0,1.0,1,1.0,1,1.0,1,0.28759924464646314,53
3069,4,4831,2444,2387,0,0,0,1.0,1,1.0,1,1.0,1,0.23895505827868882,51
3070,1,4832,2444,2388,0,0,0,1.0,1,1.0,1,1.0,1,0.23380087172272046,50
3071,2,4834,2444,2390,0,0,0,1.0,1,1.0,1,1.0,1,0.20172952287322185,51
3072,3,4837,2446,2391,0,0,0,1.0,1,1.0,1,1.0,1,0.21848599002192787,53
3073,1,4838,2446,2392,0,0,0,1.0,1,1.0,1,1.0,1,0.21553591025423863,51
3074,1,4839,2446,2393,0,0,0,1.0,1,1.0,1,1.0,1,0.1811376579421148,50
3075,2,4841,2447,2394,0,0,0,1.0,1,1.0,1,1.0,1,0.20396318953138332,52
3076,2,4843,2447,2396,0,0,0,1.0,1,1.0,1,1.0,1,0.2057069721041314,53
3077,0,4843,2447,2396,0,0,0,1.0,1,1.0,1,1.0,1,0.1869976422915634,52
3078,0,4843,2447,2396,0,0,0,1.0,1,1.0,1,1.0,1,0.22327255235643229,53
3079,0,4843,2447,2396,0,0,0,1.0,1,1.0,1,1.0,1,0.22327255235643229,53
3080,0,4843,2447,2396,0,0,0,1.0,1,1.0,1,1.0,1,0.24374779488369183,52
3081,2,4845,2449,2396,0,0,0,1.0,1,1.0,1,1.0,1,0.26620650249540506,54
3082,3,4848,2451,2397,0,0,0,1.0,1,1.0,1,1.0,1,0.27121718169435344,54
3083,1,4849,2451,2398,0,0,0,1.0,1,1.0,1,1.0,1,0.2649424289391338,54
3084,1,4850,2452,2398,0,0,0,1.0,1,1.0,1,1.0,1,0.27610664465504725,55
3085,1,4851,2453,2398,0,0,0,1.0,1,1.0,1,1.0,1,0.26690147868163877,55
3086,0,4851,2453,2398,0,0,0,1.0,1,1.0,1,1.0,1,0.2765304370839757,56
3087,0,4851,2453,2398,0,0,0,1.0,1,1.0,1,1.0,1,0.2888247615267368,57
3088,0,4851,2453,2398,0,0,0,1.0,1,1.0,1,1.0,1,0.30236278032530894,56
3089,1,4852,2454,2398,0,0,0,1.0,1,1.0,1,1.0,1,0.3310403585157553,55
3090,0,4852,2454,2398,0,0,0,1.0,1,1.0,1,1.0,1,0.3227450782001383,54
3091,1,4853,2454,2399,0,0,0,1.0,1,1.0,1,1.0,1,0.33079829790056753,53
3092,2,4855,2454,2401,0,0,0,1.0,1,1.0,1,1.0,1,0.31191020121045426,56
3093,2,4857,2455,2402,0,0,0,1.0,1,1.0,1,1.0,1,0.319449745684885,56
3094,0,4857,2455,2402,0,0,0,1.0,1,1.0,1,1.0,1,0.3272391967899327,58
3095,3,4860,2455,2405,0,0,0,1.0,1,1.0,1,1.0,1,0.2775989051552458,59
3096,0,4860,2455,2405,0,0,0,1.0,1,1.0,1,1.0,1,0.28478153556833574,60
3097,2,4862,2456,2406,0,0,0,1.0,1,1.0,1,1.0,1,0.266364251692551,60
3098,0,4862,2456,2406,0,0,0,1.0,1,1.0,1,1.0,1,0.2884101871951788,58
3099,0,4862,2456,2406,0,0,0,1.0,1,1.0,1,1.0,1,0.30020142199006705,57
3100,0,4862,2456,2406,0,0,0,1.0,1,1.0,1,1.0,1,0.30020142199006705,57
3101,3,4865,2458,2407,0,0,0,1.0,1,1.0,1,1.0,1,0.29976067875646656,58
3102,3,4868,2460,2408,0,0,0,1.0,1,1.0,1,1.0,1,0.34260318751326213,59
3103,5,4873,2462,2411,0,0,0,1.0,1,1.0,1,1.0,1,0.2520821552817435,58
3104,5,4878,2465,2413,0,0,0,1.0,1,1.0,1,1.0,1,0.2640902713269767,58
3105,1,4879,2466,2413,0,0,0,1.0,1,1.0,1,1.0,1,0.2580689191922098,56
3106,5,4884,2469,2415,0,0,0,1.0,1,1.0,1,1.0,1,0.27144448909747687,57
3107,6,4890,2471,2419,0,0,0,1.0,1,1.0,1,1.0,1,0.19799205216073298,55
3108,4,4894,2473,2421,0,0,0,1.0,1,1.0,1,1.0,1,0.2121018939878184,55
3109,2,4896,2474,2422,0,0,0,1.0,1,1.0,1,1.0,1,0.21216089702998003,54
3110,4,4900,2477,2423,0,0,0,1.0,1,1.0,1,1.0,1,0.1831403140612677,54
3111,0,4900,2477,2423,0,0,0,1.0,1,1.0,1,1.0,1,0.1831403140612677,54
3112,4,4904,2480,2424,0,0,0,1.0,1,1.0,1,1.0,1,0.2033864098551204,56
3113,3,4907,2483,2424,0,0,0,1.0,1,1.0,1,1.0,1,0.21091184935995985,55
3114,1,4908,2483,2425,0,0,0,1.0,1,1.0,1,1.0,1,0.18391024029562839,54
3115,0,4908,2483,2425,0,0,0,1.0,1,1.0,1,1.0,1,0.17199298829359036,56
3116,2,4910,2484,2426,0,0,0,1.0,1,1.0,1,1.0,1,0.17932336689536507,56
3117,1,4911,2484,2427,0,0,0,1.0,1,1.0,1,1.0,1,0.2187342561925196,58
3118,7,4918,2486,2432,0,0,0,1.0,1,1.0,1,1.0,1,0.17477609643726486,57
3119,2,4920,2487,2433,0,0,0,1.0,1,1.0,1,1.0,1,0.1772437758600776,57
3120,0,4920,2487,2433,0,0,0,1.0,1,1.0,1,1.0,1,0.17328035935240288,56
3121,3,4923,2488,2435,0,0,0,1.0,1,1.0,1,1.0,1,0.1380098513482033,57
3122,0,4923,2488,2435,0,0,0,1.0,1,1.0,1,1.0,1,0.1380098513482033,57
3123,0,4923,2488,2435,0,0,0,1.0,1,1.0,1,1.0,1,0.1380098513482033,57
3124,0,4923,2488,2435,0,0,0,1.0,1,1.0,1,1.0,1,0.1340675626246478,59
3125,2,4925,2490,2435,0,0,0,1.0,1,1.0,1,1.0,1,0.17066005262302766,61
3126,1,4926,2491,2435,0,0,0,1.0,1,1.0,1,1.0,1,0.20148762574624135,60
3127,1,4927,2492,2435,0,0,0,1.0,1,1.0,1,1.0,1,0.23054620981358695,58
3128,6,4933,2493,2440,0,0,0,1.0,1,1.0,1,1.0,1,0.23149220518102367,58
3129,3,4936,2493,2443,0,0,0,1.0,1,1.0,1,1.0,1,0.19242345179603737,56
3130,0,4936,2493,2443,0,0,0,1.0,1,1.0,1,1.0,1,0.2080050271963887,56
3131,4,4940,2494,2446,0,0,0,1.0,1,1.0,1,1.0,1,0.18616942485764354,55
3132,1,4941,2494,2447,0,0,0,1.0,1,1.0,1,1.0,1,0.19143854809395416,53
3133,1,4942,2494,2448,0,0,0,1.0,1,1.0,1,1.0,1,0.20164673313764914,52
3134,3,4945,2495,2450,0,0,0,1.0,1,1.0,1,1.0,1,0.1887325517288037,52
3135,4,4949,2497,2452,0,0,0,1.0,1,1.0,1,1.0,1,0.14983506168836166,53
3136,5,4954,2500,2454,0,0,0,1.0,1,1.0,1,1.0,1,0.15866236261505814,54
3137,3,4957,2502,2455,0,0,0,1.0,1,1.0,1,1.0,1,0.15776174194550915,55
3138,4,4961,2505,2456,0,0,0,1.0,1,1.0,1,1.0,1,0.23170535523021776,57
3139,6,4967,2505,2462,0,0,0,1.0,1,1.0,1,1.0,1,0.15110063776638913,56
3140,0,4967,2505,2462,0,0,0,1.0,1,1.0,1,1.0,1,0.14051520783092192,56
3141,0,4967,2505,2462,0,0,0,1.0,1,1.0,1,1.0,1,0.14051520783092192,56
3142,1,4968,2506,2462,0,0,0,1.0,1,1.0,1,1.0,1,0.17190605369496453,56
3143,2,4970,2507,2463,0,0,0,1.0,1,1.0,1,1.0,1,0.1716324087153042,56
3144,0,4970,2507,2463,0,0,0,1.0,1,1.0,1,1.0,1,0.14622603856974964,54
3145,1,4971,2507,2464,0,0,0,1.0,1,1.0,1,1.0,1,0.15030489723636445,55
3146,0,4971,2507,2464,0,0,0,1.0,1,1.0,1,1.0,1,0.14786464987131231,53
3147,1,4972,2507,2465,0,0,0,1.0,1,1.0,1,1.0,1,0.14780385999320333,54
3148,4,4976,2509,2467,0,0,0,1.0,1,1.0,1,1.0,1,0.11633942031006837,54
3149,1,4977,2510,2467,0,0,0,1.0,1,1.0,1,1.0,1,0.1308885273016278,53
3150,1,4978,2510,2468,0,0,0,1.0,1,1.0,1,1.0,1,0.10849113328073212,53
3151,1,4979,2510,2469,0,0,0,1.0,1,1.0,1,1.0,1,0.08613218847670198,53
3152,0,4979,2510,2469,0,0,0,1.0,1,1.0,1,1.0,1,0.08277673903478505,54
3153,0,4979,2510,2469,0,0,0,1.0,1,1.0,1,1.0,1,0.10307382519794109,53
3154,2,4981,2511,2470,0,0,0,1.0,1,1.0,1,1.0,1,0.12944371489540352,55
3155,1,4982,2511,2471,0,0,0,1.0,1,1.0,1,1.0,1,0.11493033387510117,56
3156,1,4983,2512,2471,0,0,0,1.0,1,1.0,1,1.0,1,0.16393328018674885,56
3157,0,4983,2512,2471,0,0,0,1.0,1,1.0,1,1.0,1,0.16393328018674885,56
3158,0,4983,2512,2471,0,0,0,1.0,1,1.0,1,1.0,1,0.16457465973599913,57
3159,1,4984,2513,2471,0,0,0,1.0,1,1.0,1,1.0,1,0.18980880635748287,56
3160,3,4987,2514,2473,0,0,0,1.0,1,1.0,1,1.0,1,0.1944253649340648,58
3161,1,4988,2514,2474,0,0,0,1.0,1,1.0,1,1.0,1,0.17217281540035967,59
3162,1,4989,2515,2474,0,0,0,1.0,1,1.0,1,1.0,1,0.19177449593011206,59
3163,3,4992,2517,2475,0,0,0,1.0,1,1.0,1,1.0,1,0.23664480394711337,59
3164,6,4998,2519,2479,0,0,0,1.0,1,1.0,1,1.0,1,0.20878830995690648,60
3165,4,5002,2519,2483,0,0,0,1.0,1,1.0,1,1.0,1,0.15667247852745478,58
3166,1,5003,2520,2483,0,0,0,1.0,1,1.0,1,1.0,1,0.14815111848358462,59
3167,6,5009,2523,2486,0,0,0,1.0,1,1.0,1,1.0,1,0.1304173413909044,57
3168,1,5010,2524,2486,0,0,0,1.0,1,1.0,1,1.0,1,0.13743650200586902,58
3169,5,5015,2527,2488,0,0,0,1.0,1,1.0,1,1.0,1,0.14286161040503517,57
3170,1,5016,2527,2489,0,0,0,1.0,1,1.0,1,1.0,1,0.13140245786742835,55
3171,2,5018,2528,2490,0,0,0,1.0,1,1.0,1,1.0,1,0.13120728340642596,56
3172,0,5018,2528,2490,0,0,0,1.0,1,1.0,1,1.0,1,0.14244082812434486,54
3173,3,5021,2531,2490,0,0,0,1.0,1,1.0,1,1.0,1,0.1949152113918911,53
3174,0,5021,2531,2490,0,0,0,1.0,1,1.0,1,1.0,1,0.1895176128602003,53
3175,2,5023,2531,2492,0,0,0,1.0,1,1.0,1,1.0,1,0.19987539512427052,52
3176,6,5029,2534,2495,0,0,0,1.0,1,1.0,1,1.0,1,0.22501334627201314,53
3177,3,5032,2536,2496,0,0,0,1.0,1,1.0,1,1.0,1,0.22203008228742038,52
3178,2,5034,2538,2496,0,0,0,1.0,1,1.0,1,1.0,1,0.24460966805740048,53
3179,3,5037,2538,2499,0,0,0,1.0,1,1.0,1,1.0,1,0.16780691179377277,54
3180,0,5037,2538,2499,0,0,0,1.0,1,1.0,1,1.0,1,0.19700209046425513,54
3181,2,5039,2538,2501,0,0,0,1.0,1,1.0,1,1.0,1,0.17131792079104688,55
3182,0,5039,2538,2501,0,0,0,1.0,1,1.0,1,1.0,1,0.1812778871578625,54
3183,3,5042,2540,2502,0,0,0,1.0,1,1.0,1,1.0,1,0.2200669501687036,56
3184,2,5044,2542,2502,0,0,0,1.0,1,1.0,1,1.0,1,0.24180153779544908,54
3185,4,5048,2543,2505,0,0,0,1.0,1,1.0,1,1.0,1,0.2125467571769772,53
3186,3,5051,2544,2507,0,0,0,1.0,1,1.0,1,1.0,1,0.20255008698411528,52
3187,1,5052,2544,2508,0,0,0,1.0,1,1.0,1,1.0,1,0.19583900282833203,50
3188,2,5054,2546,2508,0,0,0,1.0,1,1.0,1,1.0,1,0.2209261649625087,50
3189,2,5056,2547,2509,0,0,0,1.0,1,1.0,1,1.0,1,0.23815576446723538,49
3190,2,5058,2548,2510,0,0,0,1.0,1,1.0,1,1.0,1,0.24927526589297236,50
3191,3,5061,2549,2512,0,0,0,1.0,1,1.0,1,1.0,1,0.23923065589053163,49
3192,0,5061,2549,2512,0,0,0,1.0,1,1.0,1,1.0,1,0.23923065589053163,49
3193,0,5061,2549,2512,0,0,0,1.0,1,1.0,1,1.0,1,0.23632117088539517,49
3194,3,5064,2552,2512,0,0,0,1.0,1,1.0,1,1.0,1,0.28556493026151053,50
3195,2,5066,2552,2514,0,0,0,1.0,1,1.0,1,1.0,1,0.24746330782714562,49
3196,1,5067,2553,2514,0,0,0,1.0,1,1.0,1,1.0,1,0.2487012329178662,49
3197,1,5068,2553,2515,0,0,0,1.0,1,1.0,1,1.0,1,0.21355943188855495,50
3198,3,5071,2553,2518,0,0,0,1.0,1,1.0,1,1.0,1,0.1492759184948885,50
3199,1,5072,2553,2519,0,0,0,1.0,1,1.0,1,1.0,1,0.15839103379018007,52
3200,1,5073,2554,2519,0,0,0,1.0,1,1.0,1,1.0,1,0.16845271490519034,53
3201,4,5077,2556,2521,0,0,0,1.0,1,1.0,1,1.0,1,0.17652138454484315,55
3202,1,5078,2556,2522,0,0,0,1.0,1,1.0,1,1.0,1,0.16065329124639507,55
3203,0,5078,2556,2522,0,0,0,1.0,1,1.0,1,1.0,1,0.15970003300213734,53
3204,0,5078,2556,2522,0,0,0,1.0,1,1.0,1,1.0,1,0.15821022595580553,53
3205,0,5078,2556,2522,0,0,0,1.0,1,1.0,1,1.0,1,0.15821022595580553,53
3206,1,5079,2556,2523,0,0,0,1.0,1,1.0,1,1.0,1,0.17378252395814042,52
3207,3,5082,2559,2523,0,0,0,1.0,1,1.0,1,1.0,1,0.23913212992277957,53
3208,0,5082,2559,2523,0,0,0,1.0,1,1.0,1,1.0,1,0.25094428690537435,51
3209,3,5085,2560,2525,0,0,0,1.0,1,1.0,1,1.0,1,0.2855877415724723,52
3210,0,5085,2560,2525,0,0,0,1.0,1,1.0,1,1.0,1,0.2973506254187296,49
3211,4,5089,2562,2527,0,0,0,1.0,1,1.0,1,1.0,1,0.2720325564978917,48
3212,0,5089,2562,2527,0,0,0,1.0,1,1.0,1,1.0,1,0.2698752279344254,48
3213,2,5091,2563,2528,0,0,0,1.0,1,1.0,1,1.0,1,0.2389344219410701,49
3214,2,5093,2565,2528,0,0,0,1.0,1,1.0,1,1.0,1,0.21749033358521935,51
3215,1,5094,2565,2529,0,0,0,1.0,1,1.0,1,1.0,1,0.20039564108887412,51
3216,2,5096,2567,2529,0,0,0,1.0,1,1.0,1,1.0,1,0.19990637043745133,51
3217,2,5098,2568,2530,0,0,0,1.0,1,1.0,1,1.0,1,0.20992064244059996,51
3218,0,5098,2568,2530,0,0,0,1.0,1,1.0,1,1.0,1,0.20992064244059996,51
3219,1,5099,2568,2531,0,0,0,1.0,1,1.0,1,1.0,1,0.21941565619632022,52
3220,0,5099,2568,2531,0,0,0,1.0,1,1.0,1,1.0,1,0.21941565619632022,52
3221,1,5100,2568,2532,0,0,0,1.0,1,1.0,1,1.0,1,0.20943690608301138,54
3222,0,5100,2568,2532,0,0,0,1.0,1,1.0,1,1.0,1,0.20660927177509725,54
3223,3,5103,2568,2535,0,0,0,1.0,1,1.0,1,1.0,1,0.1831673438628207,56
3224,1,5104,2569,2535,0,0,0,1.0,1,1.0,1,1.0,1,0.19255085426727073,57
3225,1,5105,2569,2536,0,0,0,1.0,1,1.0,1,1.0,1,0.2001091675268482,58
3226,0,5105,2569,2536,0,0,0,1.0,1,1.0,1,1.0,1,0.2001091675268482,58
3227,0,5105,2569,2536,0,0,0,1.0,1,1.0,1,1.0,1,0.2001091675268482,58
3228,0,5105,2569,2536,0,0,0,1.0,1,1.0,1,1.0,1,0.2001091675268482,58
3229,1,5106,2570,2536,0,0,0,1.0,1,1.0,1,1.0,1,0.23281964705834715,60
3230,1,5107,2570,2537,0,0,0,1.0,1,1.0,1,1.0,1,0.22338215487101626,61
3231,1,5108,2570,2538,0,0,0,1.0,1,1.0,1,1.0,1,0.21538257445080694,61
3232,0,5108,2570,2538,0,0,0,1.0,1,1.0,1,1.0,1,0.21538257445080694,61
3233,1,5109,2570,2539,0,0,0,1.0,1,1.0,1,1.0,1,0.2208147293190588,63
3234,4,5113,2571,2542,0,0,0,1.0,1,1.0,1,1.0,1,0.21107745211076412,64
3235,1,5114,2571,2543,0,0,0,1.0,1,1.0,1,1.0,1,0.1921078711648066,65
3236,0,5114,2571,2543,0,0,0,1.0,1,1.0,1,1.0,1,0.19965911592099056,66
3237,1,5115,2571,2544,0,0,0,1.0,1,1.0,1,1.0,1,0.18530978320389074,67
3238,0,5115,2571,2544,0,0,0,1.0,1,1.0,1,1.0,1,0.18530978320389074,67
3239,1,5116,2572,2544,0,0,0,1.0,1,1.0,1,1.0,1,0.19633630941344712,69
3240,0,5116,2572,2544,0,0,0,1.0,1,1.0,1,1.0,1,0.19633630941344712,69
3241,4,5120,2575,2545,0,0,0,1.0,1,1.0,1,1.0,1,0.1893403412876929,68
3242,1,5121,2576,2545,0,0,0,1.0,1,1.0,1,1.0,1,0.2124669160275341,67
3243,6,5127,2578,2549,0,0,0,1.0,1,1.0,1,1.0,1,0.18599595976816774,68
3244,1,5128,2578,2550,0,0,0,1.0,1,1.0,1,1.0,1,0.16626730552202962,68
3245,1,5129,2578,2551,0,0,0,1.0,1,1.0,1,1.0,1,0.1671087224815377,69
3246,1,5130,2579,2551,0,0,0,1.0,1,1.0,1,1.0,1,0.16908848494544512,68
3247,1,5131,2579,2552,0,0,0,1.0,1,1.0,1,1.0,1,0.15844172378769983,68
3248,3,5134,2581,2553,0,0,0,1.0,1,1.0,1,1.0,1,0.16829199307421427,68
3249,0,5134,2581,2553,0,0,0,1.0,1,1.0,1,1.0,1,0.1756896473045202,69
3250,1,5135,2582,2553,0,0,0,1.0,1,1.0,1,1.0,1,0.18325733315155976,69
3251,4,5139,2583,2556,0,0,0,1.0,1,1.0,1,1.0,1,0.17298994870520648,68
3252,0,5139,2583,2556,0,0,0,1.0,1,1.0,1,1.0,1,0.15760700197323146,68
3253,1,5140,2584,2556,0,0,0,1.0,1,1.0,1,1.0,1,0.16301825373840853,69
3254,0,5140,2584,2556,0,0,0,1.0,1,1.0,1,1.0,1,0.16301825373840853,69
3255,2,5142,2584,2558,0,0,0,1.0,1,1.0,1,1.0,1,0.15191172446478143,70
3256,0,5142,2584,2558,0,0,0,1.0,1,1.0,1,1.0,1,0.15191172446478143,70
3257,1,5143,2584,2559,0,0,0,1.0,1,1.0,1,1.0,1,0.1485563304311761,71
3258,3,5146,2587,2559,0,0,0,1.0,1,1.0,1,1.0,1,0.15972252470451884,72
3259,3,5149,2589,2560,0,0,0,1.0,1,1.0,1,1.0,1,0.15757896464774715,71
3260,1,5150,2590,2560,0,0,0,1.0,1,1.0,1,1.0,1,0.18334081023101761,72
3261,1,5151,2590,2561,0,0,0,1.0,1,1.0,1,1.0,1,0.1870073396746531,74
3262,0,5151,2590,2561,0,0,0,1.0,1,1.0,1,1.0,1,0.19474453587353333,73
3263,4,5155,2591,2564,0,0,0,1.0,1,1.0,1,1.0,1,0.19689923555683622,73
3264,2,5157,2593,2564,0,0,0,1.0,1,1.0,1,1.0,1,0.234288451800935,71
3265,4,5161,2595,2566,0,0,0,1.0,1,1.0,1,1.0,1,0.21295020780234128,70
3266,2,5163,2597,2566,0,0,0,1.0,1,1.0,1,1.0,1,0.2166973417369995,69
3267,5,5168,2598,2570,0,0,0,1.0,1,1.0,1,1.0,1,0.18329455990390067,69
3268,3,5171,2601,2570,0,0,0,1.0,1,1.0,1,1.0,1,0.1982490244003327,68
3269,5,5176,2603,2573,0,0,0,1.0,1,1.0,1,1.0,1,0.2113685657307391,68
3270,0,5176,2603,2573,0,0,0,1.0,1,1.0,1,1.0,1,0.22316023489718062,67
3271,0,5176,2603,2573,0,0,0,1.0,1,1.0,1,1.0,1,0.2300245000192851,66
3272,0,5176,2603,2573,0,0,0,1.0,1,1.0,1,1.0,1,0.215002182483921,67
3273,4,5180,2603,2577,0,0,0,1.0,1,1.0,1,1.0,1,0.18877141197820202,66
3274,2,5182,2604,2578,0,0,0,1.0,1,1.0,1,1.0,1,0.20369758407048916,68
3275,0,5182,2604,2578,0,0,0,1.0,1,1.0,1,1.0,1,0.20369758407048916,68
3276,3,5185,2605,2580,0,0,0,1.0,1,1.0,1,1.0,1,0.19209170108763063,69
3277,3,5188,2605,2583,0,0,0,1.0,1,1.0,1,1.0,1,0.16317248170016802,68
3278,0,5188,2605,2583,0,0,0,1.0,1,1.0,1,1.0,1,0.17034047004247008,69
3279,1,5189,2606,2583,0,0,0,1.0,1,1.0,1,1.0,1,0.15743986573670365,67
3280,1,5190,2607,2583,0,0,0,1.0,1,1.0,1,1.0,1,0.1837403229866969,66
3281,3,5193,2609,2584,0,0,0,1.0,1,1.0,1,1.0,1,0.2046656184011174,67
3282,5,5198,2610,2588,0,0,0,1.0,1,1.0,1,1.0,1,0.21766168950723153,66
3283,3,5201,2611,2590,0,0,0,1.0,1,1.0,1,1.0,1,0.2123395450993205,67
3284,2,5203,2611,2592,0,0,0,1.0,1,1.0,1,1.0,1,0.1716105262366759,66
3285,0,5203,2611,2592,0,0,0,1.0,1,1.0,1,1.0,1,0.1716105262366759,66
3286,0,5203,2611,2592,0,0,0,1.0,1,1.0,1,1.0,1,0.16074387140690946,63
3287,1,5204,2612,2592,0,0,0,1.0,1,1.0,1,1.0,1,0.20045945717294228,61
3288,1,5205,2612,2593,0,0,0,1.0,1,1.0,1,1.0,1,0.22441939552109624,63
3289,1,5206,2613,2593,0,0,0,1.0,1,1.0,1,1.0,1,0.2419571681941607,62
3290,1,5207,2614,2593,0,0,0,1.0,1,1.0,1,1.0,1,0.2572331157175601,63
3291,2,5209,2615,2594,0,0,0,1.0,1,1.0,1,1.0,1,0.29042719751344215,62
3292,1,5210,2615,2595,0,0,0,1.0,1,1.0,1,1.0,1,0.2928624602126686,63
3293,6,5216,2616,2600,0,0,0,1.0,1,1.0,1,1.0,1,0.23747915333731126,65
3294,1,5217,2616,2601,0,0,0,1.0,1,1.0,1,1.0,1,0.21778876050928883,65
3295,3,5220,2618,2602,0,0,0,1.0,1,1.0,1,1.0,1,0.19329933095287627,65
3296,0,5220,2618,2602,0,0,0,1.0,1,1.0,1,1.0,1,0.19329933095287627,65
3297,3,5223,2619,2604,0,0,0,1.0,1,1.0,1,1.0,1,0.18019292061935197,66
3298,0,5223,2619,2604,0,0,0,1.0,1,1.0,1,1.0,1,0.18019292061935197,66
3299,0,5223,2619,2604,0,0,0,1.0,1,1.0,1,1.0,1,0.18342256828081918,67
3300,2,5225,2621,2604,0,0,0,1.0,1,1.0,1,1.0,1,0.20498288377119847,67
3301,0,5225,2621,2604,0,0,0,1.0,1,1.0,1,1.0,1,0.210758796996871,68
3302,0,5225,2621,2604,0,0,0,1.0,1,1.0,1,1.0,1,0.2205165020692148,67
3303,2,5227,2623,2604,0,0,0,1.0,1,1.0,1,1.0,1,0.22693834029567453,67
3304,0,5227,2623,2604,0,0,0,1.0,1,1.0,1,1.0,1,0.2276096799768943,67
3305,3,5230,2623,2607,0,0,0,1.0,1,1.0,1,1.0,1,0.22432822247559858,69
3306,1,5231,2623,2608,0,0,0,1.0,1,1.0,1,1.0,1,0.20034103698032127,70
3307,3,5234,2623,2611,0,0,0,1.0,1,1.0,1,1.0,1,0.18314349588196774,70
3308,0,5234,2623,2611,0,0,0,1.0,1,1.0,1,1.0,1,0.18314349588196774,70
3309,0,5234,2623,2611,0,0,0,1.0,1,1.0,1,1.0,1,0.1995261992170885,72
3310,2,5236,2623,2613,0,0,0,1.0,1,1.0,1,1.0,1,0.19843911377810827,74
3311,1,5237,2623,2614,0,0,0,1.0,1,1.0,1,1.0,1,0.19220420844764302,74
3312,0,5237,2623,2614,0,0,0,1.0,1,1.0,1,1.0,1,0.19220420844764302,74
3313,5,5242,2623,2619,0,0,0,1.0,1,1.0,1,1.0,1,0.1628543899004304,75
3314,2,5244,2623,2621,0,0,0,1.0,1,1.0,1,1.0,1,0.16419725544655156,76
3315,1,5245,2624,2621,0,0,0,1.0,1,1.0,1,1.0,1,0.19520758219738124,75
3316,2,5247,2626,2621,0,0,0,1.0,1,1.0,1,1.0,1,0.21344796898562937,76
3317,4,5251,2628,2623,0,0,0,1.0,1,1.0,1,1.0,1,0.22008246833289935,73
3318,5,5256,2631,2625,0,0,0,1.0,1,1.0,1,1.0,1,0.24448242518459898,72
3319,6,5262,2632,2630,0,0,0,1.0,1,1.0,1,1.0,1,0.21821041776059916,71
3320,1,5263,2632,2631,0,0,0,1.0,1,1.0,1,1.0,1,0.2074673411389819,70
3321,1,5264,2633,2631,0,0,0,1.0,1,1.0,1,1.0,1,0.22301741808309156,69
3322,1,5265,2634,2631,0,0,0,1.0,1,1.0,1,1.0,1,0.21753007336054436,68
3323,3,5268,2635,2633,0,0,0,1.0,1,1.0,1,1.0,1,0.22215206632412424,69
3324,1,5269,2636,2633,0,0,0,1.0,1,1.0,1,1.0,1,0.2078937725719874,69
3325,0,5269,2636,2633,0,0,0,1.0,1,1.0,1,1.0,1,0.20843192623514206,70
3326,3,5272,2638,2634,0,0,0,1.0,1,1.0,1,1.0,1,0.2148438248158218,69
3327,0,5272,2638,2634,0,0,0,1.0,1,1.0,1,1.0,1,0.20931935885435415,70
3328,1,5273,2639,2634,0,0,0,1.0,1,1.0,1,1.0,1,0.22122814839667745,73
3329,1,5274,2640,2634,0,0,0,1.0,1,1.0,1,1.0,1,0.2539470219979151,72
3330,1,5275,2641,2634,0,0,0,1.0,1,1.0,1,1.0,1,0.26304306799690597,72
3331,4,5279,2643,2636,0,0,0,1.0,1,1.0,1,1.0,1,0.2760377874880366,72
3332,4,5283,2643,2640,0,0,0,1.0,1,1.0,1,1.0,1,0.24901254379413237,73
3333,0,5283,2643,2640,0,0,0,1.0,1,1.0,1,1.0,1,0.24967578484211989,72
3334,2,5285,2643,2642,0,0,0,1.0,1,1.0,1,1.0,1,0.23227556275908803,73
3335,0,5285,2643,2642,0,0,0,1.0,1,1.0,1,1.0,1,0.23881628891433349,74
3336,0,5285,2643,2642,0,0,0,1.0,1,1.0,1,1.0,1,0.23881628891433349,74
3337,0,5285,2643,2642,0,0,0,1.0,1,1.0,1,1.0,1,0.23881628891433349,74
3338,0,5285,2643,2642,0,0,0,1.0,1,1.0,1,1.0,1,0.23881628891433349,74
3339,2,5287,2644,2643,0,0,0,1.0,1,1.0,1,1.0,1,0.24574917230206347,75
3340,3,5290,2644,2646,0,0,0,1.0,1,1.0,1,1.0,1,0.2328379658322739,75
3341,1,5291,2644,2647,0,0,0,1.0,1,1.0,1,1.0,1,0.2384757673807197,76
3342,2,5293,2644,2649,0,0,0,1.0,1,1.0,1,1.0,1,0.24214055998382025,76
3343,5,5298,2646,2652,0,0,0,1.0,1,1.0,1,1.0,1,0.21241375351466524,75
3344,1,5299,2647,2652,0,0,0,1.0,1,1.0,1,1.0,1,0.2194765769346244,75
3345,3,5302,2649,2653,0,0,0,1.0,1,1.0,1,1.0,1,0.24288503687271767,72
3346,3,5305,2651,2654,0,0,0,1.0,1,1.0,1,1.0,1,0.2528716464414319,73
3347,9,5314,2653,2661,0,0,0,1.0,1,1.0,1,1.0,1,0.1959940372158639,73
3348,1,5315,2653,2662,0,0,0,1.0,1,1.0,1,1.0,1,0.19405329754970277,73
3349,2,5317,2654,2663,0,0,0,1.0,1,1.0,1,1.0,1,0.19780998697925462,74
3350,2,5319,2655,2664,0,0,0,1.0,1,1.0,1,1.0,1,0.1902721127965963,73
3351,0,5319,2655,2664,0,0,0,1.0,1,1.0,1,1.0,1,0.19446181284693112,72
3352,1,5320,2656,2664,0,0,0,1.0,1,1.0,1,1.0,1,0.20190974448317325,72
3353,4,5324,2658,2666,0,0,0,1.0,1,1.0,1,1.0,1,0.22076524380258655,72
3354,3,5327,2660,2667,0,0,0,1.0,1,1.0,1,1.0,1,0.2211108599560648,70
3355,3,5330,2662,2668,0,0,0,1.0,1,1.0,1,1.0,1,0.2422347871239524,69
3356,3,5333,2664,2669,0,0,0,1.0,1,1.0,1,1.0,1,0.24374178934159949,69
3357,3,5336,2665,2671,0,0,0,1.0,1,1.0,1,1.0,1,0.22609149538219644,68
3358,0,5336,2665,2671,0,0,0,1.0,1,1.0,1,1.0,1,0.22609149538219644,68
3359,0,5336,2665,2671,0,0,0,1.0,1,1.0,1,1.0,1,0.23644104258268137,66
3360,1,5337,2666,2671,0,0,0,1.0,1,1.0,1,1.0,1,0.2569819907869726,65
3361,0,5337,2666,2671,0,0,0,1.0,1,1.0,1,1.0,1,0.2642104026730389,64
3362,0,5337,2666,2671,0,0,0,1.0,1,1.0,1,1.0,1,0.2642104026730389,64
3363,0,5337,2666,2671,0,0,0,1.0,1,1.0,1,1.0,1,0.25736449118475113,65
3364,1,5338,2666,2672,0,0,0,1.0,1,1.0,1,1.0,1,0.24930598172120805,66
3365,0,5338,2666,2672,0,0,0,1.0,1,1.0,1,1.0,1,0.25232909266322295,68
3366,1,5339,2667,2672,0,0,0,1.0,1,1.0,1,1.0,1,0.27360287284653007,66
3367,1,5340,2667,2673,0,0,0,1.0,1,1.0,1,1.0,1,0.2750323617833915,68
3368,4,5344,2668,2676,0,0,0,1.0,1,1.0,1,1.0,1,0.24372041514345058,68
3369,3,5347,2668,2679,0,0,0,1.0,1,1.0,1,1.0,1,0.22551578335042574,69
3370,1,5348,2668,2680,0,0,0,1.0,1,1.0,1,1.0,1,0.19718275916246786,71
3371,0,5348,2668,2680,0,0,0,1.0,1,1.0,1,1.0,1,0.19718275916246786,71
3372,2,5350,2669,2681,0,0,0,1.0,1,1.0,1,1.0,1,0.19507012259620418,71
3373,0,5350,2669,2681,0,0,0,1.0,1,1.0,1,1.0,1,0.1954705845923228,72
3374,0,5350,2669,2681,0,0,0,1.0,1,1.0,1,1.0,1,0.18903002693542145,72
3375,1,5351,2670,2681,0,0,0,1.0,1,1.0,1,1.0,1,0.1926196548923683,73
3376,0,5351,2670,2681,0,0,0,1.0,1,1.0,1,1.0,1,0.1898048170973684,75
3377,2,5353,2671,2682,0,0,0,1.0,1,1.0,1,1.0,1,0.18390691039159004,77
3378,0,5353,2671,2682,0,0,0,1.0,1,1.0,1,1.0,1,0.18390691039159004,77
3379,4,5357,2674,2683,0,0,0,1.0,1,1.0,1,1.0,1,0.2218905132446263,77
3380,3,5360,2675,2685,0,0,0,1.0,1,1.0,1,1.0,1,0.2096626379014966,76
3381,2,5362,2677,2685,0,0,0,1.0,1,1.0,1,1.0,1,0.22574831721620806,76
3382,2,5364,2678,2686,0,0,0,1.0,1,1.0,1,1.0,1,0.22709885678574707,78
3383,2,5366,2678,2688,0,0,0,1.0,1,1.0,1,1.0,1,0.2181495398943429,77
3384,4,5370,2682,2688,0,0,0,1.0,1,1.0,1,1.0,1,0.24989843064874714,77
3385,2,5372,2683,2689,0,0,0,1.0,1,1.0,1,1.0,1,0.23593600382759802,75
3386,2,5374,2684,2690,0,0,0,1.0,1,1.0,1,1.0,1,0.2556777822802834,76
3387,1,5375,2684,2691,0,0,0,1.0,1,1.0,1,1.0,1,0.2535526540560347,75
3388,2,5377,2685,2692,0,0,0,1.0,1,1.0,1,1.0,1,0.2570380097150569,76
3389,3,5380,2685,2695,0,0,0,1.0,1,1.0,1,1.0,1,0.22993496741460553,77
3390,0,5380,2685,2695,0,0,0,1.0,1,1.0,1,1.0,1,0.23161967203837933,76
3391,1,5381,2686,2695,0,0,0,1.0,1,1.0,1,1.0,1,0.21358765501563373,77
3392,2,5383,2686,2697,0,0,0,1.0,1,1.0,1,1.0,1,0.19666518928035662,78
3393,2,5385,2687,2698,0,0,0,1.0,1,1.0,1,1.0,1,0.19002807692272308,76
3394,2,5387,2688,2699,0,0,0,1.0,1,1.0,1,1.0,1,0.21660180812824714,75
3395,2,5389,2688,2701,0,0,0,1.0,1,1.0,1,1.0,1,0.20428086997955186,73
3396,1,5390,2688,2702,0,0,0,1.0,1,1.0,1,1.0,1,0.19106326220655606,73
3397,1,5391,2689,2702,0,0,0,1.0,1,1.0,1,1.0,1,0.17996300365197507,74
3398,1,5392,2690,2702,0,0,0,1.0,1,1.0,1,1.0,1,0.18883507073877764,74
3399,5,5397,2692,2705,0,0,0,1.0,1,1.0,1,1.0,1,0.16859164907750146,75
3400,3,5400,2693,2707,0,0,0,1.0,1,1.0,1,1.0,1,0.15823582231589728,75
3401,3,5403,2694,2709,0,0,0,1.0,1,1.0,1,1.0,1,0.1433998241739021,77
3402,1,5404,2695,2709,0,0,0,1.0,1,1.0,1,1.0,1,0.1567592788132599,77
3403,2,5406,2696,2710,0,0,0,1.0,1,1.0,1,1.0,1,0.1533477119367415,78
3404,2,5408,2697,2711,0,0,0,1.0,1,1.0,1,1.0,1,0.15718334223230335,78
3405,1,5409,2697,2712,0,0,0,1.0,1,1.0,1,1.0,1,0.14758336288322196,78
3406,1,5410,2698,2712,0,0,0,1.0,1,1.0,1,1.0,1,0.15671002164414582,78
3407,0,5410,2698,2712,0,0,0,1.0,1,1.0,1,1.0,1,0.1534917910857698,78
3408,1,5411,2698,2713,0,0,0,1.0,1,1.0,1,1.0,1,0.13919922889191802,79
3409,2,5413,2698,2715,0,0,0,1.0,1,1.0,1,1.0,1,0.12814295603151957,81
3410,0,5413,2698,2715,0,0,0,1.0,1,1.0,1,1.0,1,0.1367667419875005,82
3411,0,5413,2698,2715,0,0,0,1.0,1,1.0,1,1.0,1,0.13697105870893891,84
3412,0,5413,2698,2715,0,0,0,1.0,1,1.0,1,1.0,1,0.13697105870893891,84
3413,1,5414,2699,2715,0,0,0,1.0,1,1.0,1,1.0,1,0.13878008364251956,84
3414,0,5414,2699,2715,0,0,0,1.0,1,1.0,1,1.0,1,0.13878008364251956,84
3415,3,5417,2701,2716,0,0,0,1.0,1,1.0,1,1.0,1,0.15146139291687072,85
3416,1,5418,2701,2717,0,0,0,1.0,1,1.0,1,1.0,1,0.14733262352445303,85
3417,4,5422,2703,2719,0,0,0,1.0,1,1.0,1,1.0,1,0.13997893317681584,86
3418,1,5423,2704,2719,0,0,0,1.0,1,1.0,1,1.0,1,0.14646793175234005,86
3419,4,5427,2705,2722,0,0,0,1.0,1,1.0,1,1.0,1,0.14697356191024796,87
3420,0,5427,2705,2722,0,0,0,1.0,1,1.0,1,1.0,1,0.1530154228306787,88
3421,1,5428,2706,2722,0,0,0,1.0,1,1.0,1,1.0,1,0.16813376197695276,89
3422,2,5430,2706,2724,0,0,0,1.0,1,1.0,1,1.0,1,0.16478708812696766,90
3423,2,5432,2707,2725,0,0,0,1.0,1,1.0,1,1.0,1,0.15648147285125028,90
3424,0,5432,2707,2725,0,0,0,1.0,1,1.0,1,1.0,1,0.14722404045939447,91
3425,2,5434,2708,2726,0,0,0,1.0,1,1.0,1,1.0,1,0.14617708835290394,90
3426,2,5436,2710,2726,0,0,0,1.0,1,1.0,1,1.0,1,0.15667488964957307,92
3427,3,5439,2710,2729,0,0,0,1.0,1,1.0,1,1.0,1,0.140963286440977,92
3428,0,5439,2710,2729,0,0,0,1.0,1,1.0,1,1.0,1,0.14834088330939307,91
3429,1,5440,2710,2730,0,0,0,1.0,1,1.0,1,1.0,1,0.14667478156798694,91
3430,1,5441,2711,2730,0,0,0,1.0,1,1.0,1,1.0,1,0.15418468664759347,91
3431,1,5442,2711,2731,0,0,0,1.0,1,1.0,1,1.0,1,0.14381482516832728,90
3432,2,5444,2713,2731,0,0,0,1.0,1,1.0,1,1.0,1,0.1604126468673615,91
3433,3,5447,2713,2734,0,0,0,1.0,1,1.0,1,1.0,1,0.14878217608844396,90
3434,0,5447,2713,2734,0,0,0,1.0,1,1.0,1,1.0,1,0.15850476554228488,89
3435,3,5450,2714,2736,0,0,0,1.0,1,1.0,1,1.0,1,0.15674008428588984,88
3436,0,5450,2714,2736,0,0,0,1.0,1,1.0,1,1.0,1,0.1625361366437904,86
3437,1,5451,2715,2736,0,0,0,1.0,1,1.0,1,1.0,1,0.16470927231516314,86
3438,1,5452,2715,2737,0,0,0,1.0,1,1.0,1,1.0,1,0.1693693678805269,87
3439,2,5454,2716,2738,0,0,0,1.0,1,1.0,1,1.0,1,0.17320588915514584,86
3440,3,5457,2716,2741,0,0,0,1.0,1,1.0,1,1.0,1,0.15318766770630496,86
3441,1,5458,2717,2741,0,0,0,1.0,1,1.0,1,1.0,1,0.14972075751010444,85
3442,0,5458,2717,2741,0,0,0,1.0,1,1.0,1,1.0,1,0.15041235396413985,85
3443,1,5459,2717,2742,0,0,0,1.0,1,1.0,1,1.0,1,0.1534565261508856,85
3444,1,5460,2718,2742,0,0,0,1.0,1,1.0,1,1.0,1,0.1556460506335645,85
3445,2,5462,2720,2742,0,0,0,1.0,1,1.0,1,1.0,1,0.1866053026950993,84
3446,4,5466,2723,2743,0,0,0,1.0,1,1.0,1,1.0,1,0.23112416330393767,85
3447,3,5469,2723,2746,0,0,0,1.0,1,1.0,1,1.0,1,0.21286035542004653,85
3448,2,5471,2725,2746,0,0,0,1.0,1,1.0,1,1.0,1,0.23111813310402085,85
3449,1,5472,2725,2747,0,0,0,1.0,1,1.0,1,1.0,1,0.23453239261611938,84
3450,1,5473,2725,2748,0,0,0,1.0,1,1.0,1,1.0,1,0.228909543322553,84
3451,2,5475,2725,2750,0,0,0,1.0,1,1.0,1,1.0,1,0.2237161664956778,85
3452,2,5477,2727,2750,0,0,0,1.0,1,1.0,1,1.0,1,0.210345759259918,86
3453,4,5481,2727,2754,0,0,0,1.0,1,1.0,1,1.0,1,0.18022500873060873,85
3454,2,5483,2727,2756,0,0,0,1.0,1,1.0,1,1.0,1,0.15849832820661364,88
3455,0,5483,2727,2756,0,0,0,1.0,1,1.0,1,1.0,1,0.15849832820661364,88
3456,1,5484,2728,2756,0,0,0,1.0,1,1.0,1,1.0,1,0.16700318917537046,88
3457,1,5485,2729,2756,0,0,0,1.0,1,1.0,1,1.0,1,0.17761558433412586,89
3458,0,5485,2729,2756,0,0,0,1.0,1,1.0,1,1.0,1,0.1832800568158277,88
3459,0,5485,2729,2756,0,0,0,1.0,1,1.0,1,1.0,1,0.1832800568158277,88
3460,0,5485,2729,2756,0,0,0,1.0,1,1.0,1,1.0,1,0.17852509718015247,89
3461,0,5485,2729,2756,0,0,0,1.0,1,1.0,1,1.0,1,0.17852509718015247,89
3462,1,5486,2729,2757,0,0,0,1.0,1,1.0,1,1.0,1,0.18302054153484798,90
3463,2,5488,2729,2759,0,0,0,1.0,1,1.0,1,1.0,1,0.16430204409772148,89
3464,0,5488,2729,2759,0,0,0,1.0,1,1.0,1,1.0,1,0.16792915741987127,88
3465,2,5490,2729,2761,0,0,0,1.0,1,1.0,1,1.0,1,0.18070429138418084,87
3466,1,5491,2729,2762,0,0,0,1.0,1,1.0,1,1.0,1,0.1701306425386193,87
3467,2,5493,2730,2763,0,0,0,1.0,1,1.0,1,1.0,1,0.1760670936546298,87
3468,6,5499,2731,2768,0,0,0,1.0,1,1.0,1,1.0,1,0.1597290877015682,88
3469,3,5502,2732,2770,0,0,0,1.0,1,1.0,1,1.0,1,0.1671015644808028,85
3470,3,5505,2734,2771,0,0,0,1.0,1,1.0,1,1.0,1,0.17614693574120044,86
3471,5,5510,2737,2773,0,0,0,1.0,1,1.0,1,1.0,1,0.18860230625076532,84
3472,1,5511,2738,2773,0,0,0,1.0,1,1.0,1,1.0,1,0.19375508204484004,83
3473,0,5511,2738,2773,0,0,0,1.0,1,1.0,1,1.0,1,0.1993740527153201,81
3474,1,5512,2738,2774,0,0,0,1.0,1,1.0,1,1.0,1,0.17105247151850833,80
3475,1,5513,2739,2774,0,0,0,1.0,1,1.0,1,1.0,1,0.20120645256448513,82
3476,2,5515,2740,2775,0,0,0,1.0,1,1.0,1,1.0,1,0.1891399785803194,81
3477,4,5519,2743,2776,0,0,0,1.0,1,1.0,1,1.0,1,0.19650080849573615,83
3478,3,5522,2744,2778,0,0,0,1.0,1,1.0,1,1.0,1,0.19540031550964615,83
3479,2,5524,2745,2779,0,0,0,1.0,1,1.0,1,1.0,1,0.1899312135266763,83
3480,0,5524,2745,2779,0,0,0,1.0,1,1.0,1,1.0,1,0.1899312135266763,83
3481,6,5530,2747,2783,0,0,0,1.0,1,1.0,1,1.0,1,0.16065031094556112,83
3482,1,5531,2748,2783,0,0,0,1.0,1,1.0,1,1.0,1,0.17543966132516942,83
3483,2,5533,2750,2783,0,0,0,1.0,1,1.0,1,1.0,1,0.18344241666581232,82
3484,1,5534,2751,2783,0,0,0,1.0,1,1.0,1,1.0,1,0.19814463156404086,82
3485,3,5537,2752,2785,0,0,0,1.0,1,1.0,1,1.0,1,0.19653995418503223,83
3486,0,5537,2752,2785,0,0,0,1.0,1,1.0,1,1.0,1,0.19653995418503223,83
3487,1,5538,2752,2786,0,0,0,1.0,1,1.0,1,1.0,1,0.19126370795228945,84
3488,0,5538,2752,2786,0,0,0,1.0,1,1.0,1,1.0,1,0.1916392616609004,84
3489,1,5539,2752,2787,0,0,0,1.0,1,1.0,1,1.0,1,0.1737529200632624,84
3490,0,5539,2752,2787,0,0,0,1.0,1,1.0,1,1.0,1,0.1737529200632624,84
3491,1,5540,2752,2788,0,0,0,1.0,1,1.0,1,1.0,1,0.16955161152756423,86
3492,2,5542,2753,2789,0,0,0,1.0,1,1.0,1,1.0,1,0.1693887867097633,86
3493,2,5544,2753,2791,0,0,0,1.0,1,1.0,1,1.0,1,0.1539032145591921,86
3494,1,5545,2753,2792,0,0,0,1.0,1,1.0,1,1.0,1,0.14575198552923266,86
3495,2,5547,2753,2794,0,0,0,1.0,1,1.0,1,1.0,1,0.13070029309886666,87
3496,0,5547,2753,2794,0,0,0,1.0,1,1.0,1,1.0,1,0.14157954325080688,88
3497,2,5549,2754,2795,0,0,0,1.0,1,1.0,1,1.0,1,0.15259143930052912,89
3498,1,5550,2754,2796,0,0,0,1.0,1,1.0,1,1.0,1,0.16723921780978038,89
3499,4,5554,2755,2799,0,0,0,1.0,1,1.0,1,1.0,1,0.16048006745217616,91
3500,2,5556,2756,2800,0,0,0,1.0,1,1.0,1,1.0,1,0.1596814849993817,90
3501,0,5556,2756,2800,0,0,0,1.0,1,1.0,1,1.0,1,0.1596814849993817,90
3502,3,5559,2756,2803,0,0,0,1.0,1,1.0,1,1.0,1,0.13599793313127562,91
3503,3,5562,2759,2803,0,0,0,1.0,1,1.0,1,1.0,1,0.15384385630654274,91
3504,2,5564,2761,2803,0,0,0,1.0,1,1.0,1,1.0,1,0.17485019544833308,89
3505,6,5570,2763,2807,0,0,0,1.0,1,1.0,1,1.0,1,0.15387419873104094,87
3506,3,5573,2765,2808,0,0,0,1.0,1,1.0,1,1.0,1,0.16496810694014713,87
3507,2,5575,2766,2809,0,0,0,1.0,1,1.0,1,1.0,1,0.14638294939796045,84
3508,2,5577,2767,2810,0,0,0,1.0,1,1.0,1,1.0,1,0.1680988392373509,83
3509,2,5579,2769,2810,0,0,0,1.0,1,1.0,1,1.0,1,0.1795949288714826,80
3510,0,5579,2769,2810,0,0,0,1.0,1,1.0,1,1.0,1,0.172655322021132,78
3511,2,5581,2771,2810,0,0,0,1.0,1,1.0,1,1.0,1,0.16690749628054982,77
3512,1,5582,2772,2810,0,0,0,1.0,1,1.0,1,1.0,1,0.1751615527072413,74
3513,0,5582,2772,2810,0,0,0,1.0,1,1.0,1,1.0,1,0.17537752485289188,76
3514,0,5582,2772,2810,0,0,0,1.0,1,1.0,1,1.0,1,0.17417456059239547,76
3515,1,5583,2773,2810,0,0,0,1.0,1,1.0,1,1.0,1,0.17844988878973403,75
3516,1,5584,2774,2810,0,0,0,1.0,1,1.0,1,1.0,1,0.18318142732791082,73
3517,3,5587,2776,2811,0,0,0,1.0,1,1.0,1,1.0,1,0.2082909982101969,74
3518,1,5588,2776,2812,0,0,0,1.0,1,1.0,1,1.0,1,0.2083779409001933,74
3519,1,5589,2776,2813,0,0,0,1.0,1,1.0,1,1.0,1,0.21299621465245092,73
3520,1,5590,2776,2814,0,0,0,1.0,1,1.0,1,1.0,1,0.18888270959925357,74
3521,2,5592,2776,2816,0,0,0,1.0,1,1.0,1,1.0,1,0.17208559115224256,75
3522,0,5592,2776,2816,0,0,0,1.0,1,1.0,1,1.0,1,0.17208559115224256,75
3523,3,5595,2776,2819,0,0,0,1.0,1,1.0,1,1.0,1,0.1413864007361162,75
3524,1,5596,2777,2819,0,0,0,1.0,1,1.0,1,1.0,1,0.13543057844136966,75
3525,0,5596,2777,2819,0,0,0,1.0,1,1.0,1,1.0,1,0.14436840675953805,75
3526,2,5598,2779,2819,0,0,0,1.0,1,1.0,1,1.0,1,0.165815348015133,76
3527,5,5603,2781,2822,0,0,0,1.0,1,1.0,1,1.0,1,0.1846336837513983,77
3528,4,5607,2782,2825,0,0,0,1.0,1,1.0,1,1.0,1,0.19274108457461547,77
3529,3,5610,2783,2827,0,0,0,1.0,1,1.0,1,1.0,1,0.18681835046846454,78
3530,0,5610,2783,2827,0,0,0,1.0,1,1.0,1,1.0,1,0.20519945353629415,78
3531,1,5611,2784,2827,0,0,0,1.0,1,1.0,1,1.0,1,0.2254885022272413,79
3532,1,5612,2785,2827,0,0,0,1.0,1,1.0,1,1.0,1,0.25250564966354294,79
3533,2,5614,2786,2828,0,0,0,1.0,1,1.0,1,1.0,1,0.2616350903333474,79
3534,4,5618,2789,2829,0,0,0,1.0,1,1.0,1,1.0,1,0.28526688613498674,80
3535,4,5622,2789,2833,0,0,0,1.0,1,1.0,1,1.0,1,0.24201543757799038,81
3536,0,5622,2789,2833,0,0,0,1.0,1,1.0,1,1.0,1,0.23827242195251022,82
3537,1,5623,2789,2834,0,0,0,1.0,1,1.0,1,1.0,1,0.22929018761681566,82
3538,1,5624,2790,2834,0,0,0,1.0,1,1.0,1,1.0,1,0.23893329931014567,83
3539,0,5624,2790,2834,0,0,0,1.0,1,1.0,1,1.0,1,0.23893329931014567,83
3540,3,5627,2792,2835,0,0,0,1.0,1,1.0,1,1.0,1,0.23766753044938513,85
3541,1,5628,2793,2835,0,0,0,1.0,1,1.0,1,1.0,1,0.24282133157044178,85
3542,4,5632,2793,2839,0,0,0,1.0,1,1.0,1,1.0,1,0.21270242656161278,88
3543,2,5634,2794,2840,0,0,0,1.0,1,1.0,1,1.0,1,0.19696698989540387,87
3544,0,5634,2794,2840,0,0,0,1.0,1,1.0,1,1.0,1,0.19639366702968872,87
3545,0,5634,2794,2840,0,0,0,1.0,1,1.0,1,1.0,1,0.19323147597577783,85
3546,0,5634,2794,2840,0,0,0,1.0,1,1.0,1,1.0,1,0.1911218219343111,83
3547,1,5635,2794,2841,0,0,0,1.0,1,1.0,1,1.0,1,0.18436323716870076,82
3548,2,5637,2796,2841,0,0,0,1.0,1,1.0,1,1.0,1,0.17712618270876956,82
3549,1,5638,2797,2841,0,0,0,1.0,1,1.0,1,1.0,1,0.17392636253274196,81
3550,2,5640,2798,2842,0,0,0,1.0,1,1.0,1,1.0,1,0.18448625013560305,79
3551,2,5642,2800,2842,0,0,0,1.0,1,1.0,1,1.0,1,0.1890929872450802,80
3552,2,5644,2801,2843,0,0,0,1.0,1,1.0,1,1.0,1,0.19444786305502196,78
3553,1,5645,2801,2844,0,0,0,1.0,1,1.0,1,1.0,1,0.18616456060238887,79
3554,1,5646,2801,2845,0,0,0,1.0,1,1.0,1,1.0,1,0.18080678651154575,77
3555,1,5647,2802,2845,0,0,0,1.0,1,1.0,1,1.0,1,0.19258446400477292,77
3556,1,5648,2802,2846,0,0,0,1.0,1,1.0,1,1.0,1,0.19472552072871338,76
3557,1,5649,2802,2847,0,0,0,1.0,1,1.0,1,1.0,1,0.18904910040589817,76
3558,2,5651,2803,2848,0,0,0,1.0,1,1.0,1,1.0,1,0.19886869495702028,76
3559,1,5652,2803,2849,0,0,0,1.0,1,1.0,1,1.0,1,0.189987561768786,76
3560,2,5654,2804,2850,0,0,0,1.0,1,1.0,1,1.0,1,0.2112994313001696,78
3561,5,5659,2805,2854,0,0,0,1.0,1,1.0,1,1.0,1,0.18835058937251312,79
3562,4,5663,2807,2856,0,0,0,1.0,1,1.0,1,1.0,1,0.1993637079144935,79
3563,8,5671,2809,2862,0,0,0,1.0,1,1.0,1,1.0,1,0.14146729048998458,79
3564,0,5671,2809,2862,0,0,0,1.0,1,1.0,1,1.0,1,0.14353519727166372,80
3565,2,5673,2810,2863,0,0,0,1.0,1,1.0,1,1.0,1,0.15458603421222775,83
3566,2,5675,2811,2864,0,0,0,1.0,1,1.0,1,1.0,1,0.16721211713817524,84
3567,1,5676,2811,2865,0,0,0,1.0,1,1.0,1,1.0,1,0.16009144944664236,84
3568,1,5677,2812,2865,0,0,0,1.0,1,1.0,1,1.0,1,0.16711334310667006,84
3569,1,5678,2813,2865,0,0,0,1.0,1,1.0,1,1.0,1,0.17204230519914201,84
3570,4,5682,2814,2868,0,0,0,1.0,1,1.0,1,1.0,1,0.1642587958202008,87
3571,5,5687,2816,2871,0,0,0,1.0,1,1.0,1,1.0,1,0.1711793333382202,86
3572,2,5689,2817,2872,0,0,0,1.0,1,1.0,1,1.0,1,0.16416261870539986,87
3573,1,5690,2818,2872,0,0,0,1.0,1,1.0,1,1.0,1,0.1716068849663408,87
3574,2,5692,2820,2872,0,0,0,1.0,1,1.0,1,1.0,1,0.1869064657912689,88
3575,1,5693,2820,2873,0,0,0,1.0,1,1.0,1,1.0,1,0.18272593398943945,88
3576,1,5694,2821,2873,0,0,0,1.0,1,1.0,1,1.0,1,0.17149503538796124,90
3577,1,5695,2821,2874,0,0,0,1.0,1,1.0,1,1.0,1,0.15526541514648945,90
3578,0,5695,2821,2874,0,0,0,1.0,1,1.0,1,1.0,1,0.16435086447315123,91
3579,3,5698,2823,2875,0,0,0,1.0,1,1.0,1,1.0,1,0.15887013156759178,91
3580,1,5699,2823,2876,0,0,0,1.0,1,1.0,1,1.0,1,0.17136319312536016,91
3581,2,5701,2824,2877,0,0,0,1.0,1,1.0,1,1.0,1,0.16578695004119226,91
3582,2,5703,2825,2878,0,0,0,1.0,1,1.0,1,1.0,1,0.1694049800432801,92
3583,4,5707,2826,2881,0,0,0,1.0,1,1.0,1,1.0,1,0.14099620421774883,88
3584,4,5711,2828,2883,0,0,0,1.0,1,1.0,1,1.0,1,0.13272448949009588,87
3585,5,5716,2831,2885,0,0,0,1.0,1,1.0,1,1.0,1,0.16283184368566256,84
3586,4,5720,2835,2885,0,0,0,1.0,1,1.0,1,1.0,1,0.15644037144521694,83
3587,1,5721,2836,2885,0,0,0,1.0,1,1.0,1,1.0,1,0.15548101029421074,82
3588,3,5724,2838,2886,0,0,0,1.0,1,1.0,1,1.0,1,0.1557890874871507,81
3589,5,5729,2842,2887,0,0,0,1.0,1,1.0,1,1.0,1,0.1599552967201038,80
3590,2,5731,2843,2888,0,0,0,1.0,1,1.0,1,1.0,1,0.17436116673379373,78
3591,4,5735,2844,2891,0,0,0,1.0,1,1.0,1,1.0,1,0.16051191165779818,77
3592,1,5736,2845,2891,0,0,0,1.0,1,1.0,1,1.0,1,0.18373124452222442,75
3593,6,5742,2846,2896,0,0,0,1.0,1,1.0,1,1.0,1,0.1637879428246406,76
3594,1,5743,2846,2897,0,0,0,1.0,1,1.0,1,1.0,1,0.16563392015260636,74
3595,2,5745,2848,2897,0,0,0,1.0,1,1.0,1,1.0,1,0.18595230949724298,74
3596,0,5745,2848,2897,0,0,0,1.0,1,1.0,1,1.0,1,0.18841650031409918,73
3597,4,5749,2851,2898,0,0,0,1.0,1,1.0,1,1.0,1,0.17410561228995505,73
3598,1,5750,2852,2898,0,0,0,1.0,1,1.0,1,1.0,1,0.17946767992668772,73
3599,4,5754,2853,2901,0,0,0,1.0,1,1.0,1,1.0,1,0.14569296220249056,73
3600,0,5754,2853,2901,0,0,0,1.0,1,1.0,1,1.0,1,0.14717926186206962,74
3601,0,5754,2853,2901,0,0,0,1.0,1,1.0,1,1.0,1,0.14517470224709844,75
3602,1,5755,2853,2902,0,0,0,1.0,1,1.0,1,1.0,1,0.12397780113629098,76
3603,2,5757,2855,2902,0,0,0,1.0,1,1.0,1,1.0,1,0.15019797488824554,77
3604,2,5759,2856,2903,0,0,0,1.0,1,1.0,1,1.0,1,0.15708060187163594,78
3605,3,5762,2857,2905,0,0,0,1.0,1,1.0,1,1.0,1,0.14210964941340992,77
3606,2,5764,2858,2906,0,0,0,1.0,1,1.0,1,1.0,1,0.14315145019020703,79
3607,3,5767,2858,2909,0,0,0,1.0,1,1.0,1,1.0,1,0.12112255024174663,79
3608,1,5768,2858,2910,0,0,0,1.0,1,1.0,1,1.0,1,0.10980676703058302,79
3609,1,5769,2858,2911,0,0,0,1.0,1,1.0,1,1.0,1,0.10304380735623701,79
3610,2,5771,2860,2911,0,0,0,1.0,1,1.0,1,1.0,1,0.1258247423035539,80
3611,2,5773,2861,2912,0,0,0,1.0,1,1.0,1,1.0,1,0.11528117095926403,80
3612,1,5774,2861,2913,0,0,0,1.0,1,1.0,1,1.0,1,0.12014281919122834,79
3613,1,5775,2862,2913,0,0,0,1.0,1,1.0,1,1.0,1,0.12245465612610175,79
3614,3,5778,2865,2913,0,0,0,1.0,1,1.0,1,1.0,1,0.13494574004685433,78
3615,3,5781,2865,2916,0,0,0,1.0,1,1.0,1,1.0,1,0.09759120420243328,79
3616,2,5783,2866,2917,0,0,0,1.0,1,1.0,1,1.0,1,0.12867605405205337,79
3617,1,5784,2866,2918,0,0,0,1.0,1,1.0,1,1.0,1,0.119543179867695,80
3618,2,5786,2866,2920,0,0,0,1.0,1,1.0,1,1.0,1,0.12462813884002423,82
3619,1,5787,2866,2921,0,0,0,1.0,1,1.0,1,1.0,1,0.1275037327525855,82
3620,3,5790,2868,2922,0,0,0,1.0,1,1.0,1,1.0,1,0.15545816498486442,81
3621,1,5791,2869,2922,0,0,0,1.0,1,1.0,1,1.0,1,0.16158197020481924,83
3622,2,5793,2870,2923,0,0,0,1.0,1,1.0,1,1.0,1,0.1688074980045795,81
3623,5,5798,2872,2926,0,0,0,1.0,1,1.0,1,1.0,1,0.1625244096492208,81
3624,2,5800,2873,2927,0,0,0,1.0,1,1.0,1,1.0,1,0.1769719121379229,79
3625,5,5805,2875,2930,0,0,0,1.0,1,1.0,1,1.0,1,0.1498673791671919,80
3626,2,5807,2875,2932,0,0,0,1.0,1,1.0,1,1.0,1,0.14172370129532288,78
3627,2,5809,2875,2934,0,0,0,1.0,1,1.0,1,1.0,1,0.1544419165426168,78
3628,1,5810,2876,2934,0,0,0,1.0,1,1.0,1,1.0,1,0.15079697679848827,77
3629,1,5811,2876,2935,0,0,0,1.0,1,1.0,1,1.0,1,0.14116910232186666,76
3630,2,5813,2876,2937,0,0,0,1.0,1,1.0,1,1.0,1,0.11473795717058032,77
3631,3,5816,2878,2938,0,0,0,1.0,1,1.0,1,1.0,1,0.12647495194218253,75
3632,2,5818,2880,2938,0,0,0,1.0,1,1.0,1,1.0,1,0.1372290166622863,74
3633,2,5820,2881,2939,0,0,0,1.0,1,1.0,1,1.0,1,0.1324916515795831,75
3634,4,5824,2883,2941,0,0,0,1.0,1,1.0,1,1.0,1,0.1463913822133675,74
3635,2,5826,2884,2942,0,0,0,1.0,1,1.0,1,1.0,1,0.1336667662749861,74
3636,1,5827,2884,2943,0,0,0,1.0,1,1.0,1,1.0,1,0.13312600160543536,74
3637,2,5829,2884,2945,0,0,0,1.0,1,1.0,1,1.0,1,0.1306309445999779,74
3638,0,5829,2884,2945,0,0,0,1.0,1,1.0,1,1.0,1,0.13950927260397672,75
3639,4,5833,2886,2947,0,0,0,1.0,1,1.0,1,1.0,1,0.14287021548832043,76
3640,2,5835,2886,2949,0,0,0,1.0,1,1.0,1,1.0,1,0.11874450113756979,76
3641,3,5838,2888,2950,0,0,0,1.0,1,1.0,1,1.0,1,0.15662859263766157,75
3642,3,5841,2890,2951,0,0,0,1.0,1,1.0,1,1.0,1,0.1842743781989281,75
3643,1,5842,2890,2952,0,0,0,1.0,1,1.0,1,1.0,1,0.17245455170871182,74
3644,1,5843,2891,2952,0,0,0,1.0,1,1.0,1,1.0,1,0.1688786344048354,74
3645,0,5843,2891,2952,0,0,0,1.0,1,1.0,1,1.0,1,0.1688786344048354,74
3646,1,5844,2891,2953,0,0,0,1.0,1,1.0,1,1.0,1,0.15809818447777668,75
3647,2,5846,2891,2955,0,0,0,1.0,1,1.0,1,1.0,1,0.13771055287882214,77
3648,2,5848,2891,2957,0,0,0,1.0,1,1.0,1,1.0,1,0.14033377025366017,78
3649,1,5849,2891,2958,0,0,0,1.0,1,1.0,1,1.0,1,0.1331563233873074,80
3650,0,5849,2891,2958,0,0,0,1.0,1,1.0,1,1.0,1,0.1443453957763307,81
3651,0,5849,2891,2958,0,0,0,1.0,1,1.0,1,1.0,1,0.1443453957763307,81
3652,1,5850,2892,2958,0,0,0,1.0,1,1.0,1,1.0,1,0.16464440228171118,83
3653,1,5851,2892,2959,0,0,0,1.0,1,1.0,1,1.0,1,0.14937032141533357,83
3654,1,5852,2893,2959,0,0,0,1.0,1,1.0,1,1.0,1,0.1462574719234824,83
3655,1,5853,2893,2960,0,0,0,1.0,1,1.0,1,1.0,1,0.13054824338134322,84
3656,1,5854,2893,2961,0,0,0,1.0,1,1.0,1,1.0,1,0.12961367061964146,85
3657,1,5855,2894,2961,0,0,0,1.0,1,1.0,1,1.0,1,0.14230935823891777,86
3658,0,5855,2894,2961,0,0,0,1.0,1,1.0,1,1.0,1,0.15692360122311375,87
3659,5,5860,2894,2966,0,0,0,1.0,1,1.0,1,1.0,1,0.13989800753603351,87
3660,0,5860,2894,2966,0,0,0,1.0,1,1.0,1,1.0,1,0.13424888442209018,86
3661,3,5863,2895,2968,0,0,0,1.0,1,1.0,1,1.0,1,0.1291505870879189,86
3662,0,5863,2895,2968,0,0,0,1.0,1,1.0,1,1.0,1,0.1436650412216017,83
3663,6,5869,2900,2969,0,0,0,1.0,1,1.0,1,1.0,1,0.19218841405474693,85
3664,2,5871,2902,2969,0,0,0,1.0,1,1.0,1,1.0,1,0.19130744577102382,82
3665,6,5877,2903,2974,0,0,0,1.0,1,1.0,1,1.0,1,0.1475307067507236,81
3666,3,5880,2906,2974,0,0,0,1.0,1,1.0,1,1.0,1,0.1775770478431496,79
3667,2,5882,2906,2976,0,0,0,1.0,1,1.0,1,1.0,1,0.16414201506222464,79
3668,1,5883,2907,2976,0,0,0,1.0,1,1.0,1,1.0,1,0.15614494737365997,77
3669,1,5884,2908,2976,0,0,0,1.0,1,1.0,1,1.0,1,0.1435023356154307,75
3670,1,5885,2909,2976,0,0,0,1.0,1,1.0,1,1.0,1,0.14200039191354932,76
3671,3,5888,2910,2978,0,0,0,1.0,1,1.0,1,1.0,1,0.1286754718648653,74
3672,1,5889,2911,2978,0,0,0,1.0,1,1.0,1,1.0,1,0.1343733544090549,75
3673,0,5889,2911,2978,0,0,0,1.0,1,1.0,1,1.0,1,0.1343733544090549,75
3674,3,5892,2914,2978,0,0,0,1.0,1,1.0,1,1.0,1,0.1277264400775779,75
3675,0,5892,2914,2978,0,0,0,1.0,1,1.0,1,1.0,1,0.12909150836169775,75
3676,1,5893,2915,2978,0,0,0,1.0,1,1.0,1,1.0,1,0.1412131833227652,75
3677,0,5893,2915,2978,0,0,0,1.0,1,1.0,1,1.0,1,0.14490421385952296,75
3678,1,5894,2915,2979,0,0,0,1.0,1,1.0,1,1.0,1,0.15515650946770976,77
3679,1,5895,2916,2979,0,0,0,1.0,1,1.0,1,1.0,1,0.18024853858017212,78
3680,1,5896,2916,2980,0,0,0,1.0,1,1.0,1,1.0,1,0.1812624803111016,80
3681,3,5899,2916,2983,0,0,0,1.0,1,1.0,1,1.0,1,0.1646050538488634,81
3682,0,5899,2916,2983,0,0,0,1.0,1,1.0,1,1.0,1,0.1646050538488634,81
3683,1,5900,2917,2983,0,0,0,1.0,1,1.0,1,1.0,1,0.17810322690981448,81
3684,0,5900,2917,2983,0,0,0,1.0,1,1.0,1,1.0,1,0.17810322690981448,81
3685,0,5900,2917,2983,0,0,0,1.0,1,1.0,1,1.0,1,0.17810322690981448,81
3686,0,5900,2917,2983,0,0,0,1.0,1,1.0,1,1.0,1,0.17810322690981448,81
3687,0,5900,2917,2983,0,0,0,1.0,1,1.0,1,1.0,1,0.17171055105178157,82
3688,0,5900,2917,2983,0,0,0,1.0,1,1.0,1,1.0,1,0.18528748271113152,84
3689,0,5900,2917,2983,0,0,0,1.0,1,1.0,1,1.0,1,0.18528748271113152,84
3690,2,5902,2918,2984,0,0,0,1.0,1,1.0,1,1.0,1,0.18654455370354275,85
3691,1,5903,2918,2985,0,0,0,1.0,1,1.0,1,1.0,1,0.17836497157028663,86
3692,0,5903,2918,2985,0,0,0,1.0,1,1.0,1,1.0,1,0.1749654667444708,86
3693,0,5903,2918,2985,0,0,0,1.0,1,1.0,1,1.0,1,0.1749654667444708,86
3694,0,5903,2918,2985,0,0,0,1.0,1,1.0,1,1.0,1,0.1749654667444708,86
3695,3,5906,2921,2985,0,0,0,1.0,1,1.0,1,1.0,1,0.20898881070678763,86
3696,2,5908,2921,2987,0,0,0,1.0,1,1.0,1,1.0,1,0.183958777041791,87
3697,1,5909,2922,2987,0,0,0,1.0,1,1.0,1,1.0,1,0.18691386738110996,85
3698,1,5910,2923,2987,0,0,0,1.0,1,1.0,1,1.0,1,0.18861248070227046,85
3699,2,5912,2924,2988,0,0,0,1.0,1,1.0,1,1.0,1,0.16932001762593482,85
3700,3,5915,2927,2988,0,0,0,1.0,1,1.0,1,1.0,1,0.18165883299960117,84
3701,1,5916,2927,2989,0,0,0,1.0,1,1.0,1,1.0,1,0.1806059300016116,85
3702,2,5918,2929,2989,0,0,0,1.0,1,1.0,1,1.0,1,0.18857679116668424,85
3703,0,5918,2929,2989,0,0,0,1.0,1,1.0,1,1.0,1,0.18857679116668424,85
3704,1,5919,2930,2989,0,0,0,1.0,1,1.0,1,1.0,1,0.20649807290958339,85
3705,3,5922,2930,2992,0,0,0,1.0,1,1.0,1,1.0,1,0.181647437072265,86
3706,2,5924,2931,2993,0,0,0,1.0,1,1.0,1,1.0,1,0.18111060589850486,86
3707,2,5926,2932,2994,0,0,0,1.0,1,1.0,1,1.0,1,0.18216788327777148,85
3708,2,5928,2932,2996,0,0,0,1.0,1,1.0,1,1.0,1,0.1710529311674211,84
3709,0,5928,2932,2996,0,0,0,1.0,1,1.0,1,1.0,1,0.1753711752507379,85
3710,0,5928,2932,2996,0,0,0,1.0,1,1.0,1,1.0,1,0.16770735205448395,84
3711,1,5929,2932,2997,0,0,0,1.0,1,1.0,1,1.0,1,0.16712767796312178,85
3712,0,5929,2932,2997,0,0,0,1.0,1,1.0,1,1.0,1,0.16712767796312178,85
3713,1,5930,2932,2998,0,0,0,1.0,1,1.0,1,1.0,1,0.16002316938083944,85
3714,3,5933,2933,3000,0,0,0,1.0,1,1.0,1,1.0,1,0.17244481788926144,85
3715,2,5935,2934,3001,0,0,0,1.0,1,1.0,1,1.0,1,0.15829329794413063,85
3716,1,5936,2935,3001,0,0,0,1.0,1,1.0,1,1.0,1,0.16160569655850615,84
3717,1,5937,2935,3002,0,0,0,1.0,1,1.0,1,1.0,1,0.15939230881621225,86
3718,1,5938,2935,3003,0,0,0,1.0,1,1.0,1,1.0,1,0.16719750673582667,85
3719,2,5940,2937,3003,0,0,0,1.0,1,1.0,1,1.0,1,0.18158227280819744,84
3720,1,5941,2937,3004,0,0,0,1.0,1,1.0,1,1.0,1,0.19471754412091502,84
3721,7,5948,2941,3007,0,0,0,1.0,1,1.0,1,1.0,1,0.18095151794749648,85
3722,3,5951,2941,3010,0,0,0,1.0,1,1.0,1,1.0,1,0.16456332646153962,85
3723,2,5953,2941,3012,0,0,0,1.0,1,1.0,1,1.0,1,0.164708999514182,85
3724,1,5954,2941,3013,0,0,0,1.0,1,1.0,1,1.0,1,0.15575575353876764,86
3725,0,5954,2941,3013,0,0,0,1.0,1,1.0,1,1.0,1,0.15575575353876764,86
3726,0,5954,2941,3013,0,0,0,1.0,1,1.0,1,1.0,1,0.15575575353876764,86
3727,0,5954,2941,3013,0,0,0,1.0,1,1.0,1,1.0,1,0.15575575353876764,86
3728,1,5955,2942,3013,0,0,0,1.0,1,1.0,1,1.0,1,0.18144921948152234,86
3729,2,5957,2942,3015,0,0,0,1.0,1,1.0,1,1.0,1,0.16571416216168286,86
3730,0,5957,2942,3015,0,0,0,1.0,1,1.0,1,1.0,1,0.17804754435104245,85
3731,1,5958,2942,3016,0,0,0,1.0,1,1.0,1,1.0,1,0.1801374426978326,86
3732,1,5959,2943,3016,0,0,0,1.0,1,1.0,1,1.0,1,0.19119632309009157,87
3733,2,5961,2944,3017,0,0,0,1.0,1,1.0,1,1.0,1,0.19119348933970076,87
3734,0,5961,2944,3017,0,0,0,1.0,1,1.0,1,1.0,1,0.19119348933970076,87
3735,7,5968,2946,3022,0,0,0,1.0,1,1.0,1,1.0,1,0.19364136937363804,86
3736,1,5969,2946,3023,0,0,0,1.0,1,1.0,1,1.0,1,0.18599052249635897,87
3737,1,5970,2946,3024,0,0,0,1.0,1,1.0,1,1.0,1,0.17815626087541786,87
3738,1,5971,2947,3024,0,0,0,1.0,1,1.0,1,1.0,1,0.18608686116117834,87
3739,3,5974,2947,3027,0,0,0,1.0,1,1.0,1,1.0,1,0.15601635632648125,88
3740,3,5977,2950,3027,0,0,0,1.0,1,1.0,1,1.0,1,0.19887603362198672,87
3741,3,5980,2950,3030,0,0,0,1.0,1,1.0,1,1.0,1,0.17911209893516516,87
3742,2,5982,2951,3031,0,0,0,1.0,1,1.0,1,1.0,1,0.1817599415082462,86
3743,4,5986,2952,3034,0,0,0,1.0,1,1.0,1,1.0,1,0.1811162565943275,84
3744,2,5988,2954,3034,0,0,0,1.0,1,1.0,1,1.0,1,0.2054791698770373,83
3745,3,5991,2954,3037,0,0,0,1.0,1,1.0,1,1.0,1,0.17458829011755314,83
3746,5,5996,2955,3041,0,0,0,1.0,1,1.0,1,1.0,1,0.2034519413562447,83
3747,1,5997,2955,3042,0,0,0,1.0,1,1.0,1,1.0,1,0.19348576848746632,81
3748,1,5998,2955,3043,0,0,0,1.0,1,1.0,1,1.0,1,0.19404204172382908,81
3749,2,6000,2955,3045,0,0,0,1.0,1,1.0,1,1.0,1,0.18305491083367523,80
3750,0,6000,2955,3045,0,0,0,1.0,1,1.0,1,1.0,1,0.1856421672959546,79
3751,4,6004,2959,3045,0,0,0,1.0,1,1.0,1,1.0,1,0.19897919239587766,80
3752,3,6007,2961,3046,0,0,0,1.0,1,1.0,1,1.0,1,0.21147768092750407,80
3753,5,6012,2965,3047,0,0,0,1.0,1,1.0,1,1.0,1,0.22191895403494552,81
3754,1,6013,2965,3048,0,0,0,1.0,1,1.0,1,1.0,1,0.22794771752091023,81
3755,3,6016,2965,3051,0,0,0,1.0,1,1.0,1,1.0,1,0.21334021207778986,80
3756,1,6017,2966,3051,0,0,0,1.0,1,1.0,1,1.0,1,0.22003154046716328,79
3757,2,6019,2966,3053,0,0,0,1.0,1,1.0,1,1.0,1,0.2098400045488373,80
3758,1,6020,2967,3053,0,0,0,1.0,1,1.0,1,1.0,1,0.22819064450421053,79
3759,1,6021,2967,3054,0,0,0,1.0,1,1.0,1,1.0,1,0.22043589431289187,79
3760,0,6021,2967,3054,0,0,0,1.0,1,1.0,1,1.0,1,0.22043589431289187,79
3761,0,6021,2967,3054,0,0,0,1.0,1,1.0,1,1.0,1,0.2348221915553858,78
3762,3,6024,2967,3057,0,0,0,1.0,1,1.0,1,1.0,1,0.21566738861968232,80
3763,0,6024,2967,3057,0,0,0,1.0,1,1.0,1,1.0,1,0.21566738861968232,80
3764,2,6026,2969,3057,0,0,0,1.0,1,1.0,1,1.0,1,0.24208353128170848,80
3765,3,6029,2969,3060,0,0,0,1.0,1,1.0,1,1.0,1,0.22464991170852075,81
3766,4,6033,2970,3063,0,0,0,1.0,1,1.0,1,1.0,1,0.21554120123852477,83
3767,1,6034,2971,3063,0,0,0,1.0,1,1.0,1,1.0,1,0.2055592683301138,83
3768,3,6037,2972,3065,0,0,0,1.0,1,1.0,1,1.0,1,0.19617069936512124,84
3769,1,6038,2972,3066,0,0,0,1.0,1,1.0,1,1.0,1,0.1730625237421029,86
3770,0,6038,2972,3066,0,0,0,1.0,1,1.0,1,1.0,1,0.17940491541275552,87
3771,1,6039,2973,3066,0,0,0,1.0,1,1.0,1,1.0,1,0.1811030611138551,87
3772,0,6039,2973,3066,0,0,0,1.0,1,1.0,1,1.0,1,0.19661200821791938,88
3773,1,6040,2973,3067,0,0,0,1.0,1,1.0,1,1.0,1,0.20532733319364974,85
3774,1,6041,2973,3068,0,0,0,1.0,1,1.0,1,1.0,1,0.20132349763212684,85
3775,2,6043,2974,3069,0,0,0,1.0,1,1.0,1,1.0,1,0.2345326003092302,83
3776,2,6045,2975,3070,0,0,0,1.0,1,1.0,1,1.0,1,0.25413095248708556,82
3777,6,6051,2977,3074,0,0,0,1.0,1,1.0,1,1.0,1,0.2200366565181589,81
3778,1,6052,2977,3075,0,0,0,1.0,1,1.0,1,1.0,1,0.22125699104725047,81
3779,4,6056,2979,3077,0,0,0,1.0,1,1.0,1,1.0,1,0.22216302379998024,80
3780,0,6056,2979,3077,0,0,0,1.0,1,1.0,1,1.0,1,0.22216302379998024,80
3781,1,6057,2979,3078,0,0,0,1.0,1,1.0,1,1.0,1,0.20849645439082334,80
3782,1,6058,2979,3079,0,0,0,1.0,1,1.0,1,1.0,1,0.20273348213927048,80
3783,3,6061,2980,3081,0,0,0,1.0,1,1.0,1,1.0,1,0.19340753530983315,80
3784,0,6061,2980,3081,0,0,0,1.0,1,1.0,1,1.0,1,0.1976236396879048,79
3785,3,6064,2981,3083,0,0,0,1.0,1,1.0,1,1.0,1,0.20464726675399983,77
3786,2,6066,2983,3083,0,0,0,1.0,1,1.0,1,1.0,1,0.19308919473950675,78
3787,1,6067,2983,3084,0,0,0,1.0,1,1.0,1,1.0,1,0.18451578880437935,77
3788,1,6068,2983,3085,0,0,0,1.0,1,1.0,1,1.0,1,0.1798211280338387,78
3789,5,6073,2984,3089,0,0,0,1.0,1,1.0,1,1.0,1,0.16746218506485624,77
3790,1,6074,2985,3089,0,0,0,1.0,1,1.0,1,1.0,1,0.18476712724339908,77
3791,1,6075,2986,3089,0,0,0,1.0,1,1.0,1,1.0,1,0.19108828958016938,77
3792,1,6076,2986,3090,0,0,0,1.0,1,1.0,1,1.0,1,0.1690703374556478,78
3793,2,6078,2987,3091,0,0,0,1.0,1,1.0,1,1.0,1,0.18173572984105546,80
3794,2,6080,2987,3093,0,0,0,1.0,1,1.0,1,1.0,1,0.17010002490404064,82
3795,0,6080,2987,3093,0,0,0,1.0,1,1.0,1,1.0,1,0.17776504574644292,83
3796,3,6083,2989,3094,0,0,0,1.0,1,1.0,1,1.0,1,0.1712979086340269,83
3797,1,6084,2989,3095,0,0,0,1.0,1,1.0,1,1.0,1,0.16456944410593227,82
3798,2,6086,2990,3096,0,0,0,1.0,1,1.0,1,1.0,1,0.16541015453752056,82
3799,1,6087,2990,3097,0,0,0,1.0,1,1.0,1,1.0,1,0.15806714045626005,83
3800,1,6088,2990,3098,0,0,0,1.0,1,1.0,1,1.0,1,0.17707630471217398,83
3801,2,6090,2991,3099,0,0,0,1.0,1,1.0,1,1.0,1,0.17500265937479792,83
3802,0,6090,2991,3099,0,0,0,1.0,1,1.0,1,1.0,1,0.1900197730620821,82
3803,1,6091,2991,3100,0,0,0,1.0,1,1.0,1,1.0,1,0.18306916638511925,84
3804,1,6092,2991,3101,0,0,0,1.0,1,1.0,1,1.0,1,0.17437620286533118,84
3805,6,6098,2992,3106,0,0,0,1.0,1,1.0,1,1.0,1,0.17693402199305835,86
3806,0,6098,2992,3106,0,0,0,1.0,1,1.0,1,1.0,1,0.17693402199305835,86
3807,3,6101,2993,3108,0,0,0,1.0,1,1.0,1,1.0,1,0.18457669665758905,86
3808,0,6101,2993,3108,0,0,0,1.0,1,1.0,1,1.0,1,0.1861825002914645,85
3809,3,6104,2994,3110,0,0,0,1.0,1,1.0,1,1.0,1,0.18534224835967542,85
3810,1,6105,2994,3111,0,0,0,1.0,1,1.0,1,1.0,1,0.1751395186074356,85
3811,1,6106,2995,3111,0,0,0,1.0,1,1.0,1,1.0,1,0.1876473914412036,84
3812,0,6106,2995,3111,0,0,0,1.0,1,1.0,1,1.0,1,0.18223703881931855,83
3813,0,6106,2995,3111,0,0,0,1.0,1,1.0,1,1.0,1,0.16417430573072606,82
3814,2,6108,2997,3111,0,0,0,1.0,1,1.0,1,1.0,1,0.17293301330146613,81
3815,0,6108,2997,3111,0,0,0,1.0,1,1.0,1,1.0,1,0.1726354995999605,82
3816,2,6110,2998,3112,0,0,0,1.0,1,1.0,1,1.0,1,0.1668724957280913,81
3817,1,6111,2998,3113,0,0,0,1.0,1,1.0,1,1.0,1,0.16054456909711962,81
3818,3,6114,3000,3114,0,0,0,1.0,1,1.0,1,1.0,1,0.19919952754378717,81
3819,3,6117,3001,3116,0,0,0,1.0,1,1.0,1,1.0,1,0.2058274601023956,82
3820,1,6118,3001,3117,0,0,0,1.0,1,1.0,1,1.0,1,0.20074411642607426,84
3821,3,6121,3002,3119,0,0,0,1.0,1,1.0,1,1.0,1,0.22086272212145575,84
3822,0,6121,3002,3119,0,0,0,1.0,1,1.0,1,1.0,1,0.22014018090914714,82
3823,5,6126,3005,3121,0,0,0,1.0,1,1.0,1,1.0,1,0.202012825352571,81
3824,1,6127,3006,3121,0,0,0,1.0,1,1.0,1,1.0,1,0.22230530365597762,78
3825,4,6131,3006,3125,0,0,0,1.0,1,1.0,1,1.0,1,0.20114970395759238,76
3826,1,6132,3006,3126,0,0,0,1.0,1,1.0,1,1.0,1,0.2082985660872549,76
3827,1,6133,3006,3127,0,0,0,1.0,1,1.0,1,1.0,1,0.21113198917398332,75
3828,0,6133,3006,3127,0,0,0,1.0,1,1.0,1,1.0,1,0.22209987120081656,74
3829,5,6138,3007,3131,0,0,0,1.0,1,1.0,1,1.0,1,0.1937840230690166,74
3830,1,6139,3007,3132,0,0,0,1.0,1,1.0,1,1.0,1,0.18869201377162803,74
3831,3,6142,3009,3133,0,0,0,1.0,1,1.0,1,1.0,1,0.2147107190202195,74
3832,0,6142,3009,3133,0,0,0,1.0,1,1.0,1,1.0,1,0.22145595911635596,73
3833,3,6145,3011,3134,0,0,0,1.0,1,1.0,1,1.0,1,0.22489096886968907,73
3834,0,6145,3011,3134,0,0,0,1.0,1,1.0,1,1.0,1,0.22101814320497068,74
3835,2,6147,3013,3134,0,0,0,1.0,1,1.0,1,1.0,1,0.22750364127826483,75
3836,2,6149,3014,3135,0,0,0,1.0,1,1.0,1,1.0,1,0.22058656601795085,75
3837,4,6153,3015,3138,0,0,0,1.0,1,1.0,1,1.0,1,0.24587176238426706,78
3838,2,6155,3017,3138,0,0,0,1.0,1,1.0,1,1.0,1,0.23735159877494905,78
3839,5,6160,3017,3143,0,0,0,1.0,1,1.0,1,1.0,1,0.19417429823563437,79
3840,2,6162,3018,3144,0,0,0,1.0,1,1.0,1,1.0,1,0.20970894380860167,82
3841,1,6163,3018,3145,0,0,0,1.0,1,1.0,1,1.0,1,0.20193236659443387,82
3842,0,6163,3018,3145,0,0,0,1.0,1,1.0,1,1.0,1,0.19950103647289863,82
3843,1,6164,3018,3146,0,0,0,1.0,1,1.0,1,1.0,1,0.1904961920367124,82
3844,0,6164,3018,3146,0,0,0,1.0,1,1.0,1,1.0,1,0.18784531083303996,83
3845,0,6164,3018,3146,0,0,0,1.0,1,1.0,1,1.0,1,0.18561756501416782,84
3846,1,6165,3018,3147,0,0,0,1.0,1,1.0,1,1.0,1,0.1878391312547878,85
3847,2,6167,3018,3149,0,0,0,1.0,1,1.0,1,1.0,1,0.18097172235517164,84
3848,3,6170,3021,3149,0,0,0,1.0,1,1.0,1,1.0,1,0.21050891353251763,84
3849,2,6172,3021,3151,0,0,0,1.0,1,1.0,1,1.0,1,0.17854620369461977,83
3850,0,6172,3021,3151,0,0,0,1.0,1,1.0,1,1.0,1,0.1995900966447615,80
3851,2,6174,3021,3153,0,0,0,1.0,1,1.0,1,1.0,1,0.1823728709835483,80
3852,0,6174,3021,3153,0,0,0,1.0,1,1.0,1,1.0,1,0.200190441872546,79
3853,1,6175,3022,3153,0,0,0,1.0,1,1.0,1,1.0,1,0.20918453827903505,79
3854,5,6180,3025,3155,0,0,0,1.0,1,1.0,1,1.0,1,0.23581500172168668,78
3855,1,6181,3026,3155,0,0,0,1.0,1,1.0,1,1.0,1,0.256819328304005,78
3856,2,6183,3027,3156,0,0,0,1.0,1,1.0,1,1.0,1,0.27144425551301726,80
3857,4,6187,3028,3159,0,0,0,1.0,1,1.0,1,1.0,1,0.24501351175673788,81
3858,2,6189,3030,3159,0,0,0,1.0,1,1.0,1,1.0,1,0.25980509332050233,81
3859,4,6193,3030,3163,0,0,0,1.0,1,1.0,1,1.0,1,0.2541464621218912,83
3860,2,6195,3031,3164,0,0,0,1.0,1,1.0,1,1.0,1,0.27309328664922333,82
3861,2,6197,3032,3165,0,0,0,1.0,1,1.0,1,1.0,1,0.27689228736502575,84
3862,7,6204,3034,3170,0,0,0,1.0,1,1.0,1,1.0,1,0.23934727317839863,85
3863,2,6206,3034,3172,0,0,0,1.0,1,1.0,1,1.0,1,0.2319406743720381,84
3864,1,6207,3035,3172,0,0,0,1.0,1,1.0,1,1.0,1,0.22926422431100227,83
3865,1,6208,3035,3173,0,0,0,1.0,1,1.0,1,1.0,1,0.22279220344394174,82
3866,1,6209,3036,3173,0,0,0,1.0,1,1.0,1,1.0,1,0.22109638900122291,81
3867,4,6213,3039,3174,0,0,0,1.0,1,1.0,1,1.0,1,0.23259283637787803,81
3868,4,6217,3040,3177,0,0,0,1.0,1,1.0,1,1.0,1,0.21152890975581196,81
3869,2,6219,3041,3178,0,0,0,1.0,1,1.0,1,1.0,1,0.21397364688777873,81
3870,0,6219,3041,3178,0,0,0,1.0,1,1.0,1,1.0,1,0.19342882403786815,80
3871,4,6223,3042,3181,0,0,0,1.0,1,1.0,1,1.0,1,0.1790664798447596,82
3872,0,6223,3042,3181,0,0,0,1.0,1,1.0,1,1.0,1,0.16933220373858332,81
3873,0,6223,3042,3181,0,0,0,1.0,1,1.0,1,1.0,1,0.16933220373858332,81
3874,2,6225,3043,3182,0,0,0,1.0,1,1.0,1,1.0,1,0.15523516879853427,78
3875,0,6225,3043,3182,0,0,0,1.0,1,1.0,1,1.0,1,0.15606939894314523,77
3876,4,6229,3045,3184,0,0,0,1.0,1,1.0,1,1.0,1,0.15380114519672392,78
3877,2,6231,3045,3186,0,0,0,1.0,1,1.0,1,1.0,1,0.14570006110838202,75
3878,1,6232,3046,3186,0,0,0,1.0,1,1.0,1,1.0,1,0.14467462872541378,75
3879,0,6232,3046,3186,0,0,0,1.0,1,1.0,1,1.0,1,0.1574489661751551,73
3880,0,6232,3046,3186,0,0,0,1.0,1,1.0,1,1.0,1,0.158610831855492,74
3881,0,6232,3046,3186,0,0,0,1.0,1,1.0,1,1.0,1,0.164088016994634,75
3882,0,6232,3046,3186,0,0,0,1.0,1,1.0,1,1.0,1,0.16660245432738005,76
3883,0,6232,3046,3186,0,0,0,1.0,1,1.0,1,1.0,1,0.1726804740865909,77
3884,6,6238,3048,3190,0,0,0,1.0,1,1.0,1,1.0,1,0.15308680893380505,78
3885,2,6240,3048,3192,0,0,0,1.0,1,1.0,1,1.0,1,0.1406902702633473,78
3886,1,6241,3048,3193,0,0,0,1.0,1,1.0,1,1.0,1,0.1370043900941125,79
3887,1,6242,3049,3193,0,0,0,1.0,1,1.0,1,1.0,1,0.1424746302175366,78
3888,3,6245,3051,3194,0,0,0,1.0,1,1.0,1,1.0,1,0.1494905792645769,80
3889,2,6247,3051,3196,0,0,0,1.0,1,1.0,1,1.0,1,0.13920907253013276,82
3890,3,6250,3053,3197,0,0,0,1.0,1,1.0,1,1.0,1,0.13553698723608917,82
3891,7,6257,3055,3202,0,0,0,1.0,1,1.0,1,1.0,1,0.12283549412096346,85
3892,3,6260,3057,3203,0,0,0,1.0,1,1.0,1,1.0,1,0.15584451702093843,87
3893,2,6262,3058,3204,0,0,0,1.0,1,1.0,1,1.0,1,0.14227583114676984,86
3894,0,6262,3058,3204,0,0,0,1.0,1,1.0,1,1.0,1,0.14632338928961303,87
3895,3,6265,3059,3206,0,0,0,1.0,1,1.0,1,1.0,1,0.14673323207883662,87
3896,0,6265,3059,3206,0,0,0,1.0,1,1.0,1,1.0,1,0.15697368558972566,85
3897,2,6267,3061,3206,0,0,0,1.0,1,1.0,1,1.0,1,0.1689832021847639,85
3898,4,6271,3064,3207,0,0,0,1.0,1,1.0,1,1.0,1,0.17821160751992474,86
3899,2,6273,3066,3207,0,0,0,1.0,1,1.0,1,1.0,1,0.18496688265459016,86
3900,0,6273,3066,3207,0,0,0,1.0,1,1.0,1,1.0,1,0.18496688265459016,86
3901,3,6276,3067,3209,0,0,0,1.0,1,1.0,1,1.0,1,0.18186423091425347,86
3902,0,6276,3067,3209,0,0,0,1.0,1,1.0,1,1.0,1,0.17764859159592786,87
3903,1,6277,3067,3210,0,0,0,1.0,1,1.0,1,1.0,1,0.16595381191629846,87
3904,3,6280,3069,3211,0,0,0,1.0,1,1.0,1,1.0,1,0.17151819056162707,85
3905,2,6282,3070,3212,0,0,0,1.0,1,1.0,1,1.0,1,0.16162524670042125,84
3906,4,6286,3072,3214,0,0,0,1.0,1,1.0,1,1.0,1,0.15985042509658787,86
3907,1,6287,3072,3215,0,0,0,1.0,1,1.0,1,1.0,1,0.14744526382787543,84
3908,1,6288,3073,3215,0,0,0,1.0,1,1.0,1,1.0,1,0.1525372876572536,83
3909,0,6288,3073,3215,0,0,0,1.0,1,1.0,1,1.0,1,0.14913007055666433,81
3910,6,6294,3075,3219,0,0,0,1.0,1,1.0,1,1.0,1,0.12024296516346372,82
3911,3,6297,3077,3220,0,0,0,1.0,1,1.0,1,1.0,1,0.12098617790608832,81
3912,0,6297,3077,3220,0,0,0,1.0,1,1.0,1,1.0,1,0.11990045743392286,80
3913,4,6301,3080,3221,0,0,0,1.0,1,1.0,1,1.0,1,0.12478622589061913,80
3914,4,6305,3081,3224,0,0,0,1.0,1,1.0,1,1.0,1,0.11739484402477462,81
3915,3,6308,3083,3225,0,0,0,1.0,1,1.0,1,1.0,1,0.12861556970345067,81
3916,2,6310,3085,3225,0,0,0,1.0,1,1.0,1,1.0,1,0.17489136980462064,81
3917,6,6316,3087,3229,0,0,0,1.0,1,1.0,1,1.0,1,0.16083577049953413,82
3918,5,6321,3090,3231,0,0,0,1.0,1,1.0,1,1.0,1,0.18363294690549786,85
3919,5,6326,3091,3235,0,0,0,1.0,1,1.0,1,1.0,1,0.17444264855360328,85
3920,1,6327,3092,3235,0,0,0,1.0,1,1.0,1,1.0,1,0.17396643961826336,85
3921,5,6332,3093,3239,0,0,0,1.0,1,1.0,1,1.0,1,0.15387776846914836,88
3922,0,6332,3093,3239,0,0,0,1.0,1,1.0,1,1.0,1,0.15387776846914836,88
3923,0,6332,3093,3239,0,0,0,1.0,1,1.0,1,1.0,1,0.14511903957233638,89
3924,0,6332,3093,3239,0,0,0,1.0,1,1.0,1,1.0,1,0.1490224442294735,90
3925,0,6332,3093,3239,0,0,0,1.0,1,1.0,1,1.0,1,0.14469161702908967,88
3926,0,6332,3093,3239,0,0,0,1.0,1,1.0,1,1.0,1,0.1455631056430723,89
3927,3,6335,3093,3242,0,0,0,1.0,1,1.0,1,1.0,1,0.14011056780003667,89
3928,0,6335,3093,3242,0,0,0,1.0,1,1.0,1,1.0,1,0.1475425533752779,88
3929,1,6336,3093,3243,0,0,0,1.0,1,1.0,1,1.0,1,0.13491674589404234,88
3930,0,6336,3093,3243,0,0,0,1.0,1,1.0,1,1.0,1,0.15562312659212832,87
3931,4,6340,3094,3246,0,0,0,1.0,1,1.0,1,1.0,1,0.14336046758955245,86
3932,1,6341,3095,3246,0,0,0,1.0,1,1.0,1,1.0,1,0.16366436999694686,85
3933,1,6342,3096,3246,0,0,0,1.0,1,1.0,1,1.0,1,0.1808778185151872,84
3934,0,6342,3096,3246,0,0,0,1.0,1,1.0,1,1.0,1,0.19113620791124697,85
3935,1,6343,3097,3246,0,0,0,1.0,1,1.0,1,1.0,1,0.20652554956071523,84
3936,2,6345,3097,3248,0,0,0,1.0,1,1.0,1,1.0,1,0.18415161637828678,84
3937,3,6348,3097,3251,0,0,0,1.0,1,1.0,1,1.0,1,0.1412803218623188,82
3938,0,6348,3097,3251,0,0,0,1.0,1,1.0,1,1.0,1,0.1412803218623188,82
3939,0,6348,3097,3251,0,0,0,1.0,1,1.0,1,1.0,1,0.13897512338975282,84
3940,2,6350,3098,3252,0,0,0,1.0,1,1.0,1,1.0,1,0.126377727672858,84
3941,1,6351,3098,3253,0,0,0,1.0,1,1.0,1,1.0,1,0.1045994683328611,85
3942,2,6353,3100,3253,0,0,0,1.0,1,1.0,1,1.0,1,0.12428372845065803,85
3943,2,6355,3101,3254,0,0,0,1.0,1,1.0,1,1.0,1,0.10749648131833554,84
3944,2,6357,3102,3255,0,0,0,1.0,1,1.0,1,1.0,1,0.1343420184784234,83
3945,1,6358,3103,3255,0,0,0,1.0,1,1.0,1,1.0,1,0.13840010173224346,83
3946,1,6359,3104,3255,0,0,0,1.0,1,1.0,1,1.0,1,0.16202279993821428,83
3947,4,6363,3104,3259,0,0,0,1.0,1,1.0,1,1.0,1,0.12626735840634573,83
3948,1,6364,3105,3259,0,0,0,1.0,1,1.0,1,1.0,1,0.14367906207059714,84
3949,2,6366,3105,3261,0,0,0,1.0,1,1.0,1,1.0,1,0.15238428671347182,84
3950,2,6368,3106,3262,0,0,0,1.0,1,1.0,1,1.0,1,0.15733962732710471,86
3951,3,6371,3106,3265,0,0,0,1.0,1,1.0,1,1.0,1,0.13461989830071347,87
3952,3,6374,3108,3266,0,0,0,1.0,1,1.0,1,1.0,1,0.14207695621581182,86
3953,1,6375,3108,3267,0,0,0,1.0,1,1.0,1,1.0,1,0.1457309204105452,86
3954,0,6375,3108,3267,0,0,0,1.0,1,1.0,1,1.0,1,0.13846820090834702,85
3955,0,6375,3108,3267,0,0,0,1.0,1,1.0,1,1.0,1,0.15517939957180904,85
3956,0,6375,3108,3267,0,0,0,1.0,1,1.0,1,1.0,1,0.15419734274331373,84
3957,4,6379,3109,3270,0,0,0,1.0,1,1.0,1,1.0,1,0.14344721238258146,85
3958,2,6381,3110,3271,0,0,0,1.0,1,1.0,1,1.0,1,0.14369119428685825,84
3959,1,6382,3110,3272,0,0,0,1.0,1,1.0,1,1.0,1,0.14686632865873817,83
3960,2,6384,3110,3274,0,0,0,1.0,1,1.0,1,1.0,1,0.13131842943388164,84
3961,1,6385,3110,3275,0,0,0,1.0,1,1.0,1,1.0,1,0.1319840833685134,83
3962,1,6386,3111,3275,0,0,0,1.0,1,1.0,1,1.0,1,0.13606506499454019,84
3963,1,6387,3112,3275,0,0,0,1.0,1,1.0,1,1.0,1,0.1692710561198932,81
3964,2,6389,3114,3275,0,0,0,1.0,1,1.0,1,1.0,1,0.18490300475513696,81
3965,1,6390,3114,3276,0,0,0,1.0,1,1.0,1,1.0,1,0.17518921640772792,81
3966,3,6393,3117,3276,0,0,0,1.0,1,1.0,1,1.0,1,0.21720319181057046,79
3967,4,6397,3118,3279,0,0,0,1.0,1,1.0,1,1.0,1,0.20270916306309894,81
3968,3,6400,3120,3280,0,0,0,1.0,1,1.0,1,1.0,1,0.17376102042219113,79
3969,4,6404,3123,3281,0,0,0,1.0,1,1.0,1,1.0,1,0.1843536178605056,79
3970,3,6407,3125,3282,0,0,0,1.0,1,1.0,1,1.0,1,0.18781782999870542,78
3971,1,6408,3125,3283,0,0,0,1.0,1,1.0,1,1.0,1,0.17587946454182812,77
3972,1,6409,3126,3283,0,0,0,1.0,1,1.0,1,1.0,1,0.17652708808492862,78
3973,0,6409,3126,3283,0,0,0,1.0,1,1.0,1,1.0,1,0.17215285684594514,77
3974,1,6410,3127,3283,0,0,0,1.0,1,1.0,1,1.0,1,0.17392623001026397,77
3975,1,6411,3128,3283,0,0,0,1.0,1,1.0,1,1.0,1,0.1991509839122887,76
3976,1,6412,3128,3284,0,0,0,1.0,1,1.0,1,1.0,1,0.20724798530657854,77
3977,0,6412,3128,3284,0,0,0,1.0,1,1.0,1,1.0,1,0.21208414350268595,78
3978,4,6416,3129,3287,0,0,0,1.0,1,1.0,1,1.0,1,0.21938304276828519,79
3979,1,6417,3129,3288,0,0,0,1.0,1,1.0,1,1.0,1,0.2088637180929891,79
3980,0,6417,3129,3288,0,0,0,1.0,1,1.0,1,1.0,1,0.2088637180929891,79
3981,4,6421,3131,3290,0,0,0,1.0,1,1.0,1,1.0,1,0.22665002176488416,83
3982,2,6423,3132,3291,0,0,0,1.0,1,1.0,1,1.0,1,0.2241749356634688,83
3983,3,6426,3133,3293,0,0,0,1.0,1,1.0,1,1.0,1,0.209740426027054,82
3984,2,6428,3134,3294,0,0,0,1.0,1,1.0,1,1.0,1,0.21213163215221714,83
3985,4,6432,3136,3296,0,0,0,1.0,1,1.0,1,1.0,1,0.21333846106881624,84
3986,6,6438,3139,3299,0,0,0,1.0,1,1.0,1,1.0,1,0.2216487065476069,83
3987,4,6442,3141,3301,0,0,0,1.0,1,1.0,1,1.0,1,0.20345662479526921,82
3988,1,6443,3141,3302,0,0,0,1.0,1,1.0,1,1.0,1,0.20283170565842312,83
3989,0,6443,3141,3302,0,0,0,1.0,1,1.0,1,1.0,1,0.21123811014606006,81
3990,1,6444,3141,3303,0,0,0,1.0,1,1.0,1,1.0,1,0.20633129708577877,81
3991,2,6446,3142,3304,0,0,0,1.0,1,1.0,1,1.0,1,0.2336251215795032,79
3992,5,6451,3143,3308,0,0,0,1.0,1,1.0,1,1.0,1,0.20156549025202397,81
3993,2,6453,3144,3309,0,0,0,1.0,1,1.0,1,1.0,1,0.1930456587505947,80
3994,0,6453,3144,3309,0,0,0,1.0,1,1.0,1,1.0,1,0.1930456587505947,80
3995,3,6456,3147,3309,0,0,0,1.0,1,1.0,1,1.0,1,0.19162132803958637,81
3996,1,6457,3147,3310,0,0,0,1.0,1,1.0,1,1.0,1,0.2093285409687897,80
3997,5,6462,3148,3314,0,0,0,1.0,1,1.0,1,1.0,1,0.17586088717700826,81
3998,2,6464,3149,3315,0,0,0,1.0,1,1.0,1,1.0,1,0.16266950776801886,82
3999,4,6468,3150,3318,0,0,0,1.0,1,1.0,1,1.0,1,0.15177736430032132,82
4000,4,6472,3153,3319,0,0,0,1.0,1,1.0,1,1.0,1,0.17548084916736384,82
4001,2,6474,3154,3320,0,0,0,1.0,1,1.0,1,1.0,1,0.1786234692974705,81
4002,2,6476,3156,3320,0,0,0,1.0,1,1.0,1,1.0,1,0.2068842743720252,81
4003,2,6478,3157,3321,0,0,0,1.0,1,1.0,1,1.0,1,0.20458784096882388,81
4004,1,6479,3157,3322,0,0,0,1.0,1,1.0,1,1.0,1,0.18640372662368915,80
4005,5,6484,3158,3326,0,0,0,1.0,1,1.0,1,1.0,1,0.15645911272526877,78
4006,2,6486,3159,3327,0,0,0,1.0,1,1.0,1,1.0,1,0.14857256549437767,76
4007,1,6487,3160,3327,0,0,0,1.0,1,1.0,1,1.0,1,0.16194273922191355,75
4008,2,6489,3162,3327,0,0,0,1.0,1,1.0,1,1.0,1,0.16851307596656634,74
4009,4,6493,3163,3330,0,0,0,1.0,1,1.0,1,1.0,1,0.1721906863359806,75
4010,3,6496,3164,3332,0,0,0,1.0,1,1.0,1,1.0,1,0.17765381772177158,75
4011,2,6498,3165,3333,0,0,0,1.0,1,1.0,1,1.0,1,0.19022148545822032,74
4012,2,6500,3166,3334,0,0,0,1.0,1,1.0,1,1.0,1,0.19173265682905144,74
4013,1,6501,3167,3334,0,0,0,1.0,1,1.0,1,1.0,1,0.21777068011678813,74
4014,2,6503,3167,3336,0,0,0,1.0,1,1.0,1,1.0,1,0.21628129217159237,73
4015,0,6503,3167,3336,0,0,0,1.0,1,1.0,1,1.0,1,0.2246833685864948,74
4016,1,6504,3168,3336,0,0,0,1.0,1,1.0,1,1.0,1,0.24270512892977464,74
4017,3,6507,3168,3339,0,0,0,1.0,1,1.0,1,1.0,1,0.2164861094570135,78
4018,1,6508,3169,3339,0,0,0,1.0,1,1.0,1,1.0,1,0.2322944390342704,78
4019,1,6509,3169,3340,0,0,0,1.0,1,1.0,1,1.0,1,0.2229898772097926,78
4020,1,6510,3170,3340,0,0,0,1.0,1,1.0,1,1.0,1,0.22271716490108148,78
4021,0,6510,3170,3340,0,0,0,1.0,1,1.0,1,1.0,1,0.22271716490108148,78
4022,2,6512,3171,3341,0,0,0,1.0,1,1.0,1,1.0,1,0.20857656099018024,79
4023,1,6513,3171,3342,0,0,0,1.0,1,1.0,1,1.0,1,0.1980244141834466,78
4024,0,6513,3171,3342,0,0,0,1.0,1,1.0,1,1.0,1,0.19540675772406937,77
4025,0,6513,3171,3342,0,0,0,1.0,1,1.0,1,1.0,1,0.19597822036231904,76
4026,1,6514,3172,3342,0,0,0,1.0,1,1.0,1,1.0,1,0.1872965163160604,76
4027,3,6517,3174,3343,0,0,0,1.0,1,1.0,1,1.0,1,0.18623480522291763,75
4028,3,6520,3176,3344,0,0,0,1.0,1,1.0,1,1.0,1,0.18856983983668135,76
4029,3,6523,3177,3346,0,0,0,1.0,1,1.0,1,1.0,1,0.16167279049692754,75
4030,2,6525,3178,3347,0,0,0,1.0,1,1.0,1,1.0,1,0.16210978540705293,74
4031,4,6529,3180,3349,0,0,0,1.0,1,1.0,1,1.0,1,0.19315122537494298,73
4032,1,6530,3180,3350,0,0,0,1.0,1,1.0,1,1.0,1,0.1824481267963198,71
4033,4,6534,3180,3354,0,0,0,1.0,1,1.0,1,1.0,1,0.1268617244895803,73
4034,2,6536,3182,3354,0,0,0,1.0,1,1.0,1,1.0,1,0.12442545591222973,72
4035,1,6537,3183,3354,0,0,0,1.0,1,1.0,1,1.0,1,0.14463969291674436,71
4036,2,6539,3184,3355,0,0,0,1.0,1,1.0,1,1.0,1,0.1333476277543935,71
4037,1,6540,3185,3355,0,0,0,1.0,1,1.0,1,1.0,1,0.1563992629374912,70
4038,0,6540,3185,3355,0,0,0,1.0,1,1.0,1,1.0,1,0.17220394789843443,69
4039,2,6542,3186,3356,0,0,0,1.0,1,1.0,1,1.0,1,0.1976573535606929,68
4040,3,6545,3187,3358,0,0,0,1.0,1,1.0,1,1.0,1,0.2247030533163759,69
4041,1,6546,3188,3358,0,0,0,1.0,1,1.0,1,1.0,1,0.2766788636233086,67
4042,2,6548,3189,3359,0,0,0,1.0,1,1.0,1,1.0,1,0.31126151515369865,67
4043,3,6551,3190,3361,0,0,0,1.0,1,1.0,1,1.0,1,0.3242050338457122,66
4044,3,6554,3192,3362,0,0,0,1.0,1,1.0,1,1.0,1,0.34238393733866807,65
4045,0,6554,3192,3362,0,0,0,1.0,1,1.0,1,1.0,1,0.34824760106405594,66
4046,4,6558,3193,3365,0,0,0,1.0,1,1.0,1,1.0,1,0.32868117632069477,68
4047,0,6558,3193,3365,0,0,0,1.0,1,1.0,1,1.0,1,0.32868117632069477,68
4048,2,6560,3193,3367,0,0,0,1.0,1,1.0,1,1.0,1,0.3157830865513933,69
4049,0,6560,3193,3367,0,0,0,1.0,1,1.0,1,1.0,1,0.3157830865513933,69
4050,1,6561,3193,3368,0,0,0,1.0,1,1.0,1,1.0,1,0.3147614264834252,69
4051,0,6561,3193,3368,0,0,0,1.0,1,1.0,1,1.0,1,0.3147614264834252,69
4052,2,6563,3193,3370,0,0,0,1.0,1,1.0,1,1.0,1,0.28320853821408615,69
4053,0,6563,3193,3370,0,0,0,1.0,1,1.0,1,1.0,1,0.28320853821408615,69
4054,1,6564,3194,3370,0,0,0,1.0,1,1.0,1,1.0,1,0.2870396887773928,70
4055,2,6566,3194,3372,0,0,0,1.0,1,1.0,1,1.0,1,0.25202686814685743,70
4056,0,6566,3194,3372,0,0,0,1.0,1,1.0,1,1.0,1,0.25202686814685743,70
4057,1,6567,3194,3373,0,0,0,1.0,1,1.0,1,1.0,1,0.24364649388283854,71
4058,1,6568,3195,3373,0,0,0,1.0,1,1.0,1,1.0,1,0.2504999477390575,71
4059,2,6570,3196,3374,0,0,0,1.0,1,1.0,1,1.0,1,0.24816492499492662,72
4060,2,6572,3197,3375,0,0,0,1.0,1,1.0,1,1.0,1,0.2547628159367895,71
4061,2,6574,3198,3376,0,0,0,1.0,1,1.0,1,1.0,1,0.266870576114076,72
4062,2,6576,3200,3376,0,0,0,1.0,1,1.0,1,1.0,1,0.2742179811418647,72
4063,5,6581,3201,3380,0,0,0,1.0,1,1.0,1,1.0,1,0.23339393357390104,72
4064,3,6584,3203,3381,0,0,0,1.0,1,1.0,1,1.0,1,0.2194321164023684,71
4065,3,6587,3204,3383,0,0,0,1.0,1,1.0,1,1.0,1,0.2000528510891502,70
4066,4,6591,3206,3385,0,0,0,1.0,1,1.0,1,1.0,1,0.20095367781019155,70
4067,1,6592,3207,3385,0,0,0,1.0,1,1.0,1,1.0,1,0.1923867804580312,68
4068,5,6597,3210,3387,0,0,0,1.0,1,1.0,1,1.0,1,0.22668410001861747,70
4069,2,6599,3211,3388,0,0,0,1.0,1,1.0,1,1.0,1,0.20775287975558598,68
4070,1,6600,3211,3389,0,0,0,1.0,1,1.0,1,1.0,1,0.1901406052666078,67
4071,2,6602,3211,3391,0,0,0,1.0,1,1.0,1,1.0,1,0.1870572938407383,68
4072,4,6606,3214,3392,0,0,0,1.0,1,1.0,1,1.0,1,0.1839712538514035,70
4073,1,6607,3214,3393,0,0,0,1.0,1,1.0,1,1.0,1,0.17217956924079203,70
4074,5,6612,3219,3393,0,0,0,1.0,1,1.0,1,1.0,1,0.22549412375629593,71
4075,5,6617,3223,3394,0,0,0,1.0,1,1.0,1,1.0,1,0.21046765049982416,72
4076,3,6620,3225,3395,0,0,0,1.0,1,1.0,1,1.0,1,0.22197057008739166,73
4077,6,6626,3227,3399,0,0,0,1.0,1,1.0,1,1.0,1,0.22804673987920357,72
4078,2,6628,3229,3399,0,0,0,1.0,1,1.0,1,1.0,1,0.2644367494122856,71
4079,5,6633,3231,3402,0,0,0,1.0,1,1.0,1,1.0,1,0.24462602783226142,69
4080,2,6635,3232,3403,0,0,0,1.0,1,1.0,1,1.0,1,0.2437093886088119,67
4081,2,6637,3232,3405,0,0,0,1.0,1,1.0,1,1.0,1,0.23092930780121118,66
4082,0,6637,3232,3405,0,0,0,1.0,1,1.0,1,1.0,1,0.24543399424274873,65
4083,2,6639,3233,3406,0,0,0,1.0,1,1.0,1,1.0,1,0.25065185077362884,64
4084,4,6643,3235,3408,0,0,0,1.0,1,1.0,1,1.0,1,0.2601063773573799,64
4085,3,6646,3235,3411,0,0,0,1.0,1,1.0,1,1.0,1,0.21819773072566043,65
4086,1,6647,3236,3411,0,0,0,1.0,1,1.0,1,1.0,1,0.2124089467685855,66
4087,2,6649,3237,3412,0,0,0,1.0,1,1.0,1,1.0,1,0.19847894227031693,66
4088,0,6649,3237,3412,0,0,0,1.0,1,1.0,1,1.0,1,0.2204473496165408,65
4089,0,6649,3237,3412,0,0,0,1.0,1,1.0,1,1.0,1,0.2204473496165408,65
4090,0,6649,3237,3412,0,0,0,1.0,1,1.0,1,1.0,1,0.23037174353105783,65
4091,1,6650,3237,3413,0,0,0,1.0,1,1.0,1,1.0,1,0.21902717487945136,65
4092,0,6650,3237,3413,0,0,0,1.0,1,1.0,1,1.0,1,0.23195250526632338,64
4093,1,6651,3237,3414,0,0,0,1.0,1,1.0,1,1.0,1,0.2110527854932956,66
4094,2,6653,3239,3414,0,0,0,1.0,1,1.0,1,1.0,1,0.2459652635044884,65
4095,3,6656,3240,3416,0,0,0,1.0,1,1.0,1,1.0,1,0.2394339783155898,65
4096,2,6658,3241,3417,0,0,0,1.0,1,1.0,1,1.0,1,0.22165365171680637,67
4097,5,6663,3242,3421,0,0,0,1.0,1,1.0,1,1.0,1,0.1833686345312883,67
4098,3,6666,3244,3422,0,0,0,1.0,1,1.0,1,1.0,1,0.19975646417652526,68
4099,5,6671,3245,3426,0,0,0,1.0,1,1.0,1,1.0,1,0.16256773835990665,69
4100,1,6672,3245,3427,0,0,0,1.0,1,1.0,1,1.0,1,0.15909444041155205,70
4101,3,6675,3245,3430,0,0,0,1.0,1,1.0,1,1.0,1,0.15948160634994302,71
4102,1,6676,3246,3430,0,0,0,1.0,1,1.0,1,1.0,1,0.16504824441010008,71
4103,3,6679,3247,3432,0,0,0,1.0,1,1.0,1,1.0,1,0.1763693971821134,71
4104,3,6682,3249,3433,0,0,0,1.0,1,1.0,1,1.0,1,0.1814344631804296,69
4105,3,6685,3250,3435,0,0,0,1.0,1,1.0,1,1.0,1,0.16893480098889863,67
4106,1,6686,3251,3435,0,0,0,1.0,1,1.0,1,1.0,1,0.1891261217581019,68
4107,3,6689,3251,3438,0,0,0,1.0,1,1.0,1,1.0,1,0.16784431760311047,70
4108,0,6689,3251,3438,0,0,0,1.0,1,1.0,1,1.0,1,0.16803361579108594,70
4109,0,6689,3251,3438,0,0,0,1.0,1,1.0,1,1.0,1,0.16906974244216835,69
4110,0,6689,3251,3438,0,0,0,1.0,1,1.0,1,1.0,1,0.16018838310269912,71
4111,2,6691,3251,3440,0,0,0,1.0,1,1.0,1,1.0,1,0.13005404369249612,70
4112,2,6693,3251,3442,0,0,0,1.0,1,1.0,1,1.0,1,0.11966446243288584,72
4113,0,6693,3251,3442,0,0,0,1.0,1,1.0,1,1.0,1,0.11966446243288584,72
4114,3,6696,3254,3442,0,0,0,1.0,1,1.0,1,1.0,1,0.1746587226771467,72
4115,2,6698,3255,3443,0,0,0,1.0,1,1.0,1,1.0,1,0.16801933968962915,70
4116,1,6699,3256,3443,0,0,0,1.0,1,1.0,1,1.0,1,0.18003659370081904,67
4117,2,6701,3257,3444,0,0,0,1.0,1,1.0,1,1.0,1,0.20586195913305866,67
4118,0,6701,3257,3444,0,0,0,1.0,1,1.0,1,1.0,1,0.22185319404635898,66
4119,3,6704,3258,3446,0,0,0,1.0,1,1.0,1,1.0,1,0.2253834313674671,67
4120,1,6705,3259,3446,0,0,0,1.0,1,1.0,1,1.0,1,0.2600612560262715,64
4121,3,6708,3259,3449,0,0,0,1.0,1,1.0,1,1.0,1,0.24716007943897458,63
4122,3,6711,3261,3450,0,0,0,1.0,1,1.0,1,1.0,1,0.2443826607377607,63
4123,2,6713,3263,3450,0,0,0,1.0,1,1.0,1,1.0,1,0.2400124661583163,61
4124,2,6715,3265,3450,0,0,0,1.0,1,1.0,1,1.0,1,0.2621871975219808,62
4125,2,6717,3266,3451,0,0,0,1.0,1,1.0,1,1.0,1,0.25001906888019193,60
4126,4,6721,3269,3452,0,0,0,1.0,1,1.0,1,1.0,1,0.24523186746605763,59
4127,3,6724,3270,3454,0,0,0,1.0,1,1.0,1,1.0,1,0.24147752675111692,60
4128,2,6726,3272,3454,0,0,0,1.0,1,1.0,1,1.0,1,0.24530818392869996,60
4129,3,6729,3272,3457,0,0,0,1.0,1,1.0,1,1.0,1,0.22963927854394647,60
4130,2,6731,3273,3458,0,0,0,1.0,1,1.0,1,1.0,1,0.22098916581426878,61
4131,2,6733,3274,3459,0,0,0,1.0,1,1.0,1,1.0,1,0.23144554140898224,60
4132,1,6734,3275,3459,0,0,0,1.0,1,1.0,1,1.0,1,0.24771260736607306,60
4133,3,6737,3276,3461,0,0,0,1.0,1,1.0,1,1.0,1,0.24507429074079495,62
4134,2,6739,3278,3461,0,0,0,1.0,1,1.0,1,1.0,1,0.2382946538897604,63
4135,4,6743,3279,3464,0,0,0,1.0,1,1.0,1,1.0,1,0.21510831412497872,65
4136,0,6743,3279,3464,0,0,0,1.0,1,1.0,1,1.0,1,0.21510831412497872,65
4137,1,6744,3280,3464,0,0,0,1.0,1,1.0,1,1.0,1,0.22712072009140993,66
4138,3,6747,3280,3467,0,0,0,1.0,1,1.0,1,1.0,1,0.20042598202959608,67
4139,3,6750,3282,3468,0,0,0,1.0,1,1.0,1,1.0,1,0.21997069408439568,67
4140,0,6750,3282,3468,0,0,0,1.0,1,1.0,1,1.0,1,0.20873483781056612,66
4141,1,6751,3282,3469,0,0,0,1.0,1,1.0,1,1.0,1,0.20137238590412382,67
4142,0,6751,3282,3469,0,0,0,1.0,1,1.0,1,1.0,1,0.20137238590412382,67
4143,1,6752,3282,3470,0,0,0,1.0,1,1.0,1,1.0,1,0.18526677769189578,66
4144,0,6752,3282,3470,0,0,0,1.0,1,1.0,1,1.0,1,0.1969792012182536,64
4145,2,6754,3283,3471,0,0,0,1.0,1,1.0,1,1.0,1,0.19642119238493985,63
4146,3,6757,3286,3471,0,0,0,1.0,1,1.0,1,1.0,1,0.20239491597494985,62
4147,0,6757,3286,3471,0,0,0,1.0,1,1.0,1,1.0,1,0.20779937125781775,60
4148,3,6760,3288,3472,0,0,0,1.0,1,1.0,1,1.0,1,0.1955575570911889,62
4149,2,6762,3290,3472,0,0,0,1.0,1,1.0,1,1.0,1,0.20241701872595794,61
4150,1,6763,3291,3472,0,0,0,1.0,1,1.0,1,1.0,1,0.20179787835898644,60
4151,3,6766,3291,3475,0,0,0,1.0,1,1.0,1,1.0,1,0.1829006380951836,60
4152,1,6767,3292,3475,0,0,0,1.0,1,1.0,1,1.0,1,0.20146356416388714,60
4153,1,6768,3293,3475,0,0,0,1.0,1,1.0,1,1.0,1,0.19328690457445158,58
4154,1,6769,3294,3475,0,0,0,1.0,1,1.0,1,1.0,1,0.19829403660314177,57
4155,4,6773,3297,3476,0,0,0,1.0,1,1.0,1,1.0,1,0.23175234224465402,57
4156,5,6778,3300,3478,0,0,0,1.0,1,1.0,1,1.0,1,0.2624176011775731,58
4157,3,6781,3300,3481,0,0,0,1.0,1,1.0,1,1.0,1,0.20741234006746948,57
4158,1,6782,3301,3481,0,0,0,1.0,1,1.0,1,1.0,1,0.22152016980176042,55
4159,1,6783,3301,3482,0,0,0,1.0,1,1.0,1,1.0,1,0.2147589998185711,57
4160,1,6784,3302,3482,0,0,0,1.0,1,1.0,1,1.0,1,0.22338470749874326,58
4161,2,6786,3302,3484,0,0,0,1.0,1,1.0,1,1.0,1,0.18808504317210487,58
4162,0,6786,3302,3484,0,0,0,1.0,1,1.0,1,1.0,1,0.19382116279105555,57
4163,0,6786,3302,3484,0,0,0,1.0,1,1.0,1,1.0,1,0.18994225212866594,58
4164,4,6790,3305,3485,0,0,0,1.0,1,1.0,1,1.0,1,0.2307398427446719,56
4165,3,6793,3306,3487,0,0,0,1.0,1,1.0,1,1.0,1,0.24111541004350903,58
4166,1,6794,3306,3488,0,0,0,1.0,1,1.0,1,1.0,1,0.22841480013807883,57
4167,0,6794,3306,3488,0,0,0,1.0,1,1.0,1,1.0,1,0.2431407711264279,57
4168,0,6794,3306,3488,0,0,0,1.0,1,1.0,1,1.0,1,0.239264434536977,58
4169,1,6795,3307,3488,0,0,0,1.0,1,1.0,1,1.0,1,0.2367931295582743,58
4170,1,6796,3308,3488,0,0,0,1.0,1,1.0,1,1.0,1,0.2601057500105373,58
4171,0,6796,3308,3488,0,0,0,1.0,1,1.0,1,1.0,1,0.27648763089376194,57
4172,0,6796,3308,3488,0,0,0,1.0,1,1.0,1,1.0,1,0.27648763089376194,57
4173,1,6797,3308,3489,0,0,0,1.0,1,1.0,1,1.0,1,0.29267967876797435,56
4174,0,6797,3308,3489,0,0,0,1.0,1,1.0,1,1.0,1,0.29267967876797435,56
4175,3,6800,3308,3492,0,0,0,1.0,1,1.0,1,1.0,1,0.25606810048203393,55
4176,1,6801,3309,3492,0,0,0,1.0,1,1.0,1,1.0,1,0.2663346582039466,57
4177,2,6803,3309,3494,0,0,0,1.0,1,1.0,1,1.0,1,0.26247397015868784,58
4178,8,6811,3312,3499,0,0,0,1.0,1,1.0,1,1.0,1,0.24135426696248918,60
4179,4,6815,3313,3502,0,0,0,1.0,1,1.0,1,1.0,1,0.21655550867764603,61
4180,1,6816,3313,3503,0,0,0,1.0,1,1.0,1,1.0,1,0.2022950346978306,62
4181,2,6818,3313,3505,0,0,0,1.0,1,1.0,1,1.0,1,0.1832049364371554,63
4182,1,6819,3314,3505,0,0,0,1.0,1,1.0,1,1.0,1,0.2003945350896243,63
4183,0,6819,3314,3505,0,0,0,1.0,1,1.0,1,1.0,1,0.2047680530639836,63
4184,2,6821,3316,3505,0,0,0,1.0,1,1.0,1,1.0,1,0.2200902511238021,63
4185,2,6823,3316,3507,0,0,0,1.0,1,1.0,1,1.0,1,0.19836122564472602,61
4186,6,6829,3319,3510,0,0,0,1.0,1,1.0,1,1.0,1,0.15223121180757124,62
4187,1,6830,3319,3511,0,0,0,1.0,1,1.0,1,1.0,1,0.14070677230328502,60
4188,1,6831,3320,3511,0,0,0,1.0,1,1.0,1,1.0,1,0.1570373711545875,60
4189,0,6831,3320,3511,0,0,0,1.0,1,1.0,1,1.0,1,0.1570373711545875,60
4190,3,6834,3322,3512,0,0,0,1.0,1,1.0,1,1.0,1,0.1570655754626157,61
4191,1,6835,3323,3512,0,0,0,1.0,1,1.0,1,1.0,1,0.18906622846049503,59
4192,1,6836,3324,3512,0,0,0,1.0,1,1.0,1,1.0,1,0.20288116987498023,58
4193,1,6837,3325,3512,0,0,0,1.0,1,1.0,1,1.0,1,0.21622409652346045,57
4194,0,6837,3325,3512,0,0,0,1.0,1,1.0,1,1.0,1,0.23270385912864408,54
4195,1,6838,3326,3512,0,0,0,1.0,1,1.0,1,1.0,1,0.23657292330490667,55
4196,2,6840,3327,3513,0,0,0,1.0,1,1.0,1,1.0,1,0.22253265209783377,56
4197,2,6842,3328,3514,0,0,0,1.0,1,1.0,1,1.0,1,0.23467382941318238,55
4198,2,6844,3329,3515,0,0,0,1.0,1,1.0,1,1.0,1,0.2515978161972861,56
4199,1,6845,3329,3516,0,0,0,1.0,1,1.0,1,1.0,1,0.25222545457214357,55
4200,0,6845,3329,3516,0,0,0,1.0,1,1.0,1,1.0,1,0.25223287964844937,55
4201,0,6845,3329,3516,0,0,0,1.0,1,1.0,1,1.0,1,0.23910862666519975,56
4202,0,6845,3329,3516,0,0,0,1.0,1,1.0,1,1.0,1,0.23910862666519975,56
4203,0,6845,3329,3516,0,0,0,1.0,1,1.0,1,1.0,1,0.24964657433924034,57
4204,1,6846,3330,3516,0,0,0,1.0,1,1.0,1,1.0,1,0.24480353392868137,57
4205,1,6847,3330,3517,0,0,0,1.0,1,1.0,1,1.0,1,0.2294505157992204,58
4206,3,6850,3332,3518,0,0,0,1.0,1,1.0,1,1.0,1,0.21644760290536333,58
4207,4,6854,3334,3520,0,0,0,1.0,1,1.0,1,1.0,1,0.19038091311306962,58
4208,2,6856,3335,3521,0,0,0,1.0,1,1.0,1,1.0,1,0.1964194564532965,60
4209,5,6861,3338,3523,0,0,0,1.0,1,1.0,1,1.0,1,0.1740216020080614,61
4210,0,6861,3338,3523,0,0,0,1.0,1,1.0,1,1.0,1,0.15543056346082684,62
4211,2,6863,3339,3524,0,0,0,1.0,1,1.0,1,1.0,1,0.16972641920209003,63
4212,0,6863,3339,3524,0,0,0,1.0,1,1.0,1,1.0,1,0.1603627310100774,64
4213,0,6863,3339,3524,0,0,0,1.0,1,1.0,1,1.0,1,0.1565228683170161,65
4214,0,6863,3339,3524,0,0,0,1.0,1,1.0,1,1.0,1,0.16990518011112296,65
4215,0,6863,3339,3524,0,0,0,1.0,1,1.0,1,1.0,1,0.16990518011112296,65
4216,0,6863,3339,3524,0,0,0,1.0,1,1.0,1,1.0,1,0.18154923072349052,64
4217,1,6864,3340,3524,0,0,0,1.0,1,1.0,1,1.0,1,0.19909110500100938,65
4218,0,6864,3340,3524,0,0,0,1.0,1,1.0,1,1.0,1,0.19909110500100938,65
4219,3,6867,3341,3526,0,0,0,1.0,1,1.0,1,1.0,1,0.20225765090507092,65
4220,1,6868,3341,3527,0,0,0,1.0,1,1.0,1,1.0,1,0.19455198722914863,65
4221,1,6869,3342,3527,0,0,0,1.0,1,1.0,1,1.0,1,0.23364721845433975,67
4222,2,6871,3343,3528,0,0,0,1.0,1,1.0,1,1.0,1,0.23093638738308908,68
4223,3,6874,3345,3529,0,0,0,1.0,1,1.0,1,1.0,1,0.24864258912888038,68
4224,2,6876,3346,3530,0,0,0,1.0,1,1.0,1,1.0,1,0.2607789041485659,68
4225,4,6880,3346,3534,0,0,0,1.0,1,1.0,1,1.0,1,0.22490605865506447,66
4226,1,6881,3347,3534,0,0,0,1.0,1,1.0,1,1.0,1,0.2352864997278805,66
4227,0,6881,3347,3534,0,0,0,1.0,1,1.0,1,1.0,1,0.2352864997278805,66
4228,0,6881,3347,3534,0,0,0,1.0,1,1.0,1,1.0,1,0.23554957298417592,65
4229,1,6882,3348,3534,0,0,0,1.0,1,1.0,1,1.0,1,0.2455182151650574,65
4230,2,6884,3349,3535,0,0,0,1.0,1,1.0,1,1.0,1,0.2428858580204181,64
4231,1,6885,3349,3536,0,0,0,1.0,1,1.0,1,1.0,1,0.2352127220115353,64
4232,2,6887,3350,3537,0,0,0,1.0,1,1.0,1,1.0,1,0.23144972873572658,65
4233,2,6889,3350,3539,0,0,0,1.0,1,1.0,1,1.0,1,0.2203041448523429,64
4234,1,6890,3350,3540,0,0,0,1.0,1,1.0,1,1.0,1,0.21207000584613805,63
4235,2,6892,3352,3540,0,0,0,1.0,1,1.0,1,1.0,1,0.21194193972910533,63
4236,0,6892,3352,3540,0,0,0,1.0,1,1.0,1,1.0,1,0.21194193972910533,63
4237,4,6896,3354,3542,0,0,0,1.0,1,1.0,1,1.0,1,0.22414920912534114,65
4238,0,6896,3354,3542,0,0,0,1.0,1,1.0,1,1.0,1,0.22414920912534114,65
4239,1,6897,3354,3543,0,0,0,1.0,1,1.0,1,1.0,1,0.207739087412831,65
4240,1,6898,3355,3543,0,0,0,1.0,1,1.0,1,1.0,1,0.1886094467781649,66
4241,0,6898,3355,3543,0,0,0,1.0,1,1.0,1,1.0,1,0.1886094467781649,66
4242,2,6900,3355,3545,0,0,0,1.0,1,1.0,1,1.0,1,0.16058701807218922,69
4243,0,6900,3355,3545,0,0,0,1.0,1,1.0,1,1.0,1,0.1696879057333255,71
4244,0,6900,3355,3545,0,0,0,1.0,1,1.0,1,1.0,1,0.1696879057333255,71
4245,2,6902,3355,3547,0,0,0,1.0,1,1.0,1,1.0,1,0.1611376932865882,73
4246,1,6903,3355,3548,0,0,0,1.0,1,1.0,1,1.0,1,0.13572572756781662,74
4247,0,6903,3355,3548,0,0,0,1.0,1,1.0,1,1.0,1,0.13572572756781662,74
4248,0,6903,3355,3548,0,0,0,1.0,1,1.0,1,1.0,1,0.13572572756781662,74
4249,0,6903,3355,3548,0,0,0,1.0,1,1.0,1,1.0,1,0.13572572756781662,74
4250,0,6903,3355,3548,0,0,0,1.0,1,1.0,1,1.0,1,0.13572572756781662,74
4251,2,6905,3356,3549,0,0,0,1.0,1,1.0,1,1.0,1,0.14504046236334228,75
4252,2,6907,3358,3549,0,0,0,1.0,1,1.0,1,1.0,1,0.17802381455229532,75
4253,2,6909,3358,3551,0,0,0,1.0,1,1.0,1,1.0,1,0.1596812738006015,76
4254,1,6910,3359,3551,0,0,0,1.0,1,1.0,1,1.0,1,0.18131037892816632,75
4255,4,6914,3361,3553,0,0,0,1.0,1,1.0,1,1.0,1,0.16510055561675402,76
4256,0,6914,3361,3553,0,0,0,1.0,1,1.0,1,1.0,1,0.17147512380623706,78
4257,1,6915,3362,3553,0,0,0,1.0,1,1.0,1,1.0,1,0.16895169667991516,78
4258,1,6916,3363,3553,0,0,0,1.0,1,1.0,1,1.0,1,0.1942306084816603,77
4259,5,6921,3366,3555,0,0,0,1.0,1,1.0,1,1.0,1,0.21391980762762702,78
4260,3,6924,3366,3558,0,0,0,1.0,1,1.0,1,1.0,1,0.1634622084062032,77
4261,2,6926,3367,3559,0,0,0,1.0,1,1.0,1,1.0,1,0.17264234229865164,76
4262,0,6926,3367,3559,0,0,0,1.0,1,1.0,1,1.0,1,0.1703252957610031,75
4263,3,6929,3369,3560,0,0,0,1.0,1,1.0,1,1.0,1,0.1611237401571578,74
4264,0,6929,3369,3560,0,0,0,1.0,1,1.0,1,1.0,1,0.19443508089055067,74
4265,4,6933,3372,3561,0,0,0,1.0,1,1.0,1,1.0,1,0.19493954176092892,73
4266,1,6934,3373,3561,0,0,0,1.0,1,1.0,1,1.0,1,0.2109728443431599,71
4267,5,6939,3376,3563,0,0,0,1.0,1,1.0,1,1.0,1,0.20376403013042527,69
4268,3,6942,3377,3565,0,0,0,1.0,1,1.0,1,1.0,1,0.2286864756174253,67
4269,3,6945,3378,3567,0,0,0,1.0,1,1.0,1,1.0,1,0.20385863255870115,64
4270,3,6948,3380,3568,0,0,0,1.0,1,1.0,1,1.0,1,0.20030887128458413,63
4271,3,6951,3381,3570,0,0,0,1.0,1,1.0,1,1.0,1,0.21245715330578527,63
4272,2,6953,3382,3571,0,0,0,1.0,1,1.0,1,1.0,1,0.2264083818310554,62
4273,1,6954,3382,3572,0,0,0,1.0,1,1.0,1,1.0,1,0.21792242825193717,62
4274,0,6954,3382,3572,0,0,0,1.0,1,1.0,1,1.0,1,0.23193992967602248,62
4275,0,6954,3382,3572,0,0,0,1.0,1,1.0,1,1.0,1,0.22779814502829987,61
4276,1,6955,3382,3573,0,0,0,1.0,1,1.0,1,1.0,1,0.22367090591074743,62
4277,0,6955,3382,3573,0,0,0,1.0,1,1.0,1,1.0,1,0.23524233915990383,63
4278,2,6957,3383,3574,0,0,0,1.0,1,1.0,1,1.0,1,0.21602235000727732,64
4279,4,6961,3386,3575,0,0,0,1.0,1,1.0,1,1.0,1,0.24129123854300769,65
4280,3,6964,3387,3577,0,0,0,1.0,1,1.0,1,1.0,1,0.22624943117896715,65
4281,1,6965,3387,3578,0,0,0,1.0,1,1.0,1,1.0,1,0.22156754745615476,65
4282,4,6969,3391,3578,0,0,0,1.0,1,1.0,1,1.0,1,0.26552286348087223,66
4283,2,6971,3391,3580,0,0,0,1.0,1,1.0,1,1.0,1,0.2539167213323786,66
4284,1,6972,3392,3580,0,0,0,1.0,1,1.0,1,1.0,1,0.26282599465521816,66
4285,1,6973,3392,3581,0,0,0,1.0,1,1.0,1,1.0,1,0.2510783728407157,67
4286,1,6974,3392,3582,0,0,0,1.0,1,1.0,1,1.0,1,0.2562752964667814,67
4287,2,6976,3392,3584,0,0,0,1.0,1,1.0,1,1.0,1,0.24484818088142477,67
4288,0,6976,3392,3584,0,0,0,1.0,1,1.0,1,1.0,1,0.23812564030668365,68
4289,1,6977,3393,3584,0,0,0,1.0,1,1.0,1,1.0,1,0.2530686143156621,68
4290,1,6978,3394,3584,0,0,0,1.0,1,1.0,1,1.0,1,0.24559036808273968,70
4291,1,6979,3394,3585,0,0,0,1.0,1,1.0,1,1.0,1,0.23341071844865882,71
4292,0,6979,3394,3585,0,0,0,1.0,1,1.0,1,1.0,1,0.23341071844865882,71
4293,1,6980,3394,3586,0,0,0,1.0,1,1.0,1,1.0,1,0.22176300429522341,71
4294,0,6980,3394,3586,0,0,0,1.0,1,1.0,1,1.0,1,0.22176300429522341,71
4295,1,6981,3395,3586,0,0,0,1.0,1,1.0,1,1.0,1,0.23774214637039717,72
4296,0,6981,3395,3586,0,0,0,1.0,1,1.0,1,1.0,1,0.24562697851164847,73
4297,2,6983,3395,3588,0,0,0,1.0,1,1.0,1,1.0,1,0.21858329308895014,73
4298,2,6985,3395,3590,0,0,0,1.0,1,1.0,1,1.0,1,0.2190528879365239,74
4299,1,6986,3395,3591,0,0,0,1.0,1,1.0,1,1.0,1,0.2035613244063159,75
4300,1,6987,3395,3592,0,0,0,1.0,1,1.0,1,1.0,1,0.1890877324886741,75
4301,1,6988,3395,3593,0,0,0,1.0,1,1.0,1,1.0,1,0.18057494440600805,76
4302,1,6989,3396,3593,0,0,0,1.0,1,1.0,1,1.0,1,0.1806231489167597,76
4303,2,6991,3396,3595,0,0,0,1.0,1,1.0,1,1.0,1,0.1524886829546132,75
4304,3,6994,3398,3596,0,0,0,1.0,1,1.0,1,1.0,1,0.17712758066382708,75
4305,2,6996,3399,3597,0,0,0,1.0,1,1.0,1,1.0,1,0.19300787011818998,73
4306,5,7001,3402,3599,0,0,0,1.0,1,1.0,1,1.0,1,0.22858035868937315,74
4307,2,7003,3404,3599,0,0,0,1.0,1,1.0,1,1.0,1,0.24636676023656262,73
4308,1,7004,3404,3600,0,0,0,1.0,1,1.0,1,1.0,1,0.2648054893909488,71
4309,3,7007,3404,3603,0,0,0,1.0,1,1.0,1,1.0,1,0.2506308978629451,70
4310,4,7011,3407,3604,0,0,0,1.0,1,1.0,1,1.0,1,0.21954868417212112,69
4311,4,7015,3409,3606,0,0,0,1.0,1,1.0,1,1.0,1,0.20566394730179705,69
4312,3,7018,3411,3607,0,0,0,1.0,1,1.0,1,1.0,1,0.22042786008466034,66
4313,2,7020,3412,3608,0,0,0,1.0,1,1.0,1,1.0,1,0.20774182119036974,64
4314,1,7021,3413,3608,0,0,0,1.0,1,1.0,1,1.0,1,0.24504122995278318,61
4315,1,7022,3414,3608,0,0,0,1.0,1,1.0,1,1.0,1,0.2453200005180588,61
4316,3,7025,3417,3608,0,0,0,1.0,1,1.0,1,1.0,1,0.24805442145847506,60
4317,4,7029,3417,3612,0,0,0,1.0,1,1.0,1,1.0,1,0.1916024820566185,62
4318,0,7029,3417,3612,0,0,0,1.0,1,1.0,1,1.0,1,0.227610957679994,59
4319,1,7030,3417,3613,0,0,0,1.0,1,1.0,1,1.0,1,0.21433402762006987,60
4320,0,7030,3417,3613,0,0,0,1.0,1,1.0,1,1.0,1,0.21433402762006987,60
4321,3,7033,3420,3613,0,0,0,1.0,1,1.0,1,1.0,1,0.22330215765396108,61
4322,1,7034,3421,3613,0,0,0,1.0,1,1.0,1,1.0,1,0.23338172620916706,61
4323,0,7034,3421,3613,0,0,0,1.0,1,1.0,1,1.0,1,0.23338172620916706,61
4324,0,7034,3421,3613,0,0,0,1.0,1,1.0,1,1.0,1,0.24328082780887422,60
4325,2,7036,3422,3614,0,0,0,1.0,1,1.0,1,1.0,1,0.26118531933926914,60
4326,1,7037,3423,3614,0,0,0,1.0,1,1.0,1,1.0,1,0.2669662066041618,61
4327,1,7038,3423,3615,0,0,0,1.0,1,1.0,1,1.0,1,0.257335042168185,62
4328,0,7038,3423,3615,0,0,0,1.0,1,1.0,1,1.0,1,0.257335042168185,62
4329,1,7039,3423,3616,0,0,0,1.0,1,1.0,1,1.0,1,0.23520101332586776,65
4330,1,7040,3423,3617,0,0,0,1.0,1,1.0,1,1.0,1,0.22594939841469833,65
4331,0,7040,3423,3617,0,0,0,1.0,1,1.0,1,1.0,1,0.22594939841469833,65
4332,2,7042,3424,3618,0,0,0,1.0,1,1.0,1,1.0,1,0.22435596134947466,66
4333,2,7044,3425,3619,0,0,0,1.0,1,1.0,1,1.0,1,0.21266038590990938,66
4334,1,7045,3426,3619,0,0,0,1.0,1,1.0,1,1.0,1,0.22906819038811244,66
4335,1,7046,3426,3620,0,0,0,1.0,1,1.0,1,1.0,1,0.23462160862739212,65
4336,3,7049,3428,3621,0,0,0,1.0,1,1.0,1,1.0,1,0.22364613447540688,67
4337,3,7052,3428,3624,0,0,0,1.0,1,1.0,1,1.0,1,0.21758693411519947,69
4338,0,7052,3428,3624,0,0,0,1.0,1,1.0,1,1.0,1,0.2244129936970409,70
4339,1,7053,3428,3625,0,0,0,1.0,1,1.0,1,1.0,1,0.22889708317908997,70
4340,1,7054,3428,3626,0,0,0,1.0,1,1.0,1,1.0,1,0.22502356808727392,71
4341,4,7058,3429,3629,0,0,0,1.0,1,1.0,1,1.0,1,0.21811490691640215,70
4342,2,7060,3431,3629,0,0,0,1.0,1,1.0,1,1.0,1,0.23805455793011995,71
4343,7,7067,3435,3632,0,0,0,1.0,1,1.0,1,1.0,1,0.24086102457114078,67
4344,5,7072,3438,3634,0,0,0,1.0,1,1.0,1,1.0,1,0.25966402404921035,67
4345,5,7077,3441,3636,0,0,0,1.0,1,1.0,1,1.0,1,0.254480497603582,64
4346,4,7081,3443,3638,0,0,0,1.0,1,1.0,1,1.0,1,0.24118930673418842,64
4347,4,7085,3445,3640,0,0,0,1.0,1,1.0,1,1.0,1,0.25327275443371916,62
4348,4,7089,3448,3641,0,0,0,1.0,1,1.0,1,1.0,1,0.24475899109699908,62
4349,4,7093,3449,3644,0,0,0,1.0,1,1.0,1,1.0,1,0.25563042934460095,61
4350,2,7095,3451,3644,0,0,0,1.0,1,1.0,1,1.0,1,0.27471456042845827,60
4351,3,7098,3453,3645,0,0,0,1.0,1,1.0,1,1.0,1,0.2829695094263539,60
4352,0,7098,3453,3645,0,0,0,1.0,1,1.0,1,1.0,1,0.3002041586660806,57
4353,2,7100,3453,3647,0,0,0,1.0,1,1.0,1,1.0,1,0.2785997680232639,55
4354,2,7102,3454,3648,0,0,0,1.0,1,1.0,1,1.0,1,0.2618662929488622,55
4355,0,7102,3454,3648,0,0,0,1.0,1,1.0,1,1.0,1,0.287996340587388,53
4356,2,7104,3454,3650,0,0,0,1.0,1,1.0,1,1.0,1,0.23614864561182958,55
4357,1,7105,3455,3650,0,0,0,1.0,1,1.0,1,1.0,1,0.24100372904088688,55
4358,1,7106,3455,3651,0,0,0,1.0,1,1.0,1,1.0,1,0.22370678382245504,55
4359,0,7106,3455,3651,0,0,0,1.0,1,1.0,1,1.0,1,0.23616478967217025,54
4360,2,7108,3456,3652,0,0,0,1.0,1,1.0,1,1.0,1,0.21992569949322743,55
4361,2,7110,3457,3653,0,0,0,1.0,1,1.0,1,1.0,1,0.23772057757858808,54
4362,0,7110,3457,3653,0,0,0,1.0,1,1.0,1,1.0,1,0.22650767235735436,55
4363,4,7114,3459,3655,0,0,0,1.0,1,1.0,1,1.0,1,0.19242530634374452,55
4364,1,7115,3459,3656,0,0,0,1.0,1,1.0,1,1.0,1,0.1822107924207532,55
4365,0,7115,3459,3656,0,0,0,1.0,1,1.0,1,1.0,1,0.19355426715459575,54
4366,2,7117,3461,3656,0,0,0,1.0,1,1.0,1,1.0,1,0.20570422834050556,54
4367,1,7118,3461,3657,0,0,0,1.0,1,1.0,1,1.0,1,0.1946082266880042,57
4368,2,7120,3462,3658,0,0,0,1.0,1,1.0,1,1.0,1,0.2275732053833819,57
4369,1,7121,3462,3659,0,0,0,1.0,1,1.0,1,1.0,1,0.21350024841598075,58
4370,2,7123,3463,3660,0,0,0,1.0,1,1.0,1,1.0,1,0.22563556462141426,59
4371,0,7123,3463,3660,0,0,0,1.0,1,1.0,1,1.0,1,0.22171728906658514,60
4372,2,7125,3465,3660,0,0,0,1.0,1,1.0,1,1.0,1,0.24395668456404995,60
4373,1,7126,3465,3661,0,0,0,1.0,1,1.0,1,1.0,1,0.22202738326167112,60
4374,3,7129,3466,3663,0,0,0,1.0,1,1.0,1,1.0,1,0.23879267303119442,59
4375,0,7129,3466,3663,0,0,0,1.0,1,1.0,1,1.0,1,0.24644668306871503,60
4376,0,7129,3466,3663,0,0,0,1.0,1,1.0,1,1.0,1,0.26113843042247026,60
4377,1,7130,3467,3663,0,0,0,1.0,1,1.0,1,1.0,1,0.2800887307431458,61
4378,1,7131,3467,3664,0,0,0,1.0,1,1.0,1,1.0,1,0.24230141717206619,64
4379,0,7131,3467,3664,0,0,0,1.0,1,1.0,1,1.0,1,0.24230141717206619,64
4380,1,7132,3468,3664,0,0,0,1.0,1,1.0,1,1.0,1,0.22246153630070672,65
4381,1,7133,3468,3665,0,0,0,1.0,1,1.0,1,1.0,1,0.2173358475762388,64
4382,2,7135,3470,3665,0,0,0,1.0,1,1.0,1,1.0,1,0.2607531738876692,64
4383,6,7141,3473,3668,0,0,0,1.0,1,1.0,1,1.0,1,0.26416738241629045,64
4384,1,7142,3474,3668,0,0,0,1.0,1,1.0,1,1.0,1,0.272121826677498,60
4385,2,7144,3474,3670,0,0,0,1.0,1,1.0,1,1.0,1,0.2433228306097441,58
4386,2,7146,3476,3670,0,0,0,1.0,1,1.0,1,1.0,1,0.26494422863427275,58
4387,2,7148,3476,3672,0,0,0,1.0,1,1.0,1,1.0,1,0.24585486518561642,55
4388,2,7150,3478,3672,0,0,0,1.0,1,1.0,1,1.0,1,0.26950221412629105,56
4389,0,7150,3478,3672,0,0,0,1.0,1,1.0,1,1.0,1,0.2597117145185924,55
4390,7,7157,3480,3677,0,0,0,1.0,1,1.0,1,1.0,1,0.212638548180445,55
4391,3,7160,3482,3678,0,0,0,1.0,1,1.0,1,1.0,1,0.20966351239558784,56
4392,0,7160,3482,3678,0,0,0,1.0,1,1.0,1,1.0,1,0.22680825052323064,56
4393,2,7162,3483,3679,0,0,0,1.0,1,1.0,1,1.0,1,0.2541755469847995,55
4394,2,7164,3485,3679,0,0,0,1.0,1,1.0,1,1.0,1,0.2645686304085775,53
4395,1,7165,3486,3679,0,0,0,1.0,1,1.0,1,1.0,1,0.27914095422994367,53
4396,2,7167,3488,3679,0,0,0,1.0,1,1.0,1,1.0,1,0.30071557542093963,53
4397,1,7168,3489,3679,0,0,0,1.0,1,1.0,1,1.0,1,0.3130502392923769,50
4398,4,7172,3491,3681,0,0,0,1.0,1,1.0,1,1.0,1,0.3688211425957355,50
4399,1,7173,3491,3682,0,0,0,1.0,1,1.0,1,1.0,1,0.3532900778719462,52
4400,1,7174,3491,3683,0,0,0,1.0,1,1.0,1,1.0,1,0.32962901964240376,55
4401,0,7174,3491,3683,0,0,0,1.0,1,1.0,1,1.0,1,0.31412077505985814,56
4402,0,7174,3491,3683,0,0,0,1.0,1,1.0,1,1.0,1,0.31412077505985814,56
4403,4,7178,3493,3685,0,0,0,1.0,1,1.0,1,1.0,1,0.30450884305958903,57
4404,0,7178,3493,3685,0,0,0,1.0,1,1.0,1,1.0,1,0.30450884305958903,57
4405,0,7178,3493,3685,0,0,0,1.0,1,1.0,1,1.0,1,0.3007598664984065,58
4406,0,7178,3493,3685,0,0,0,1.0,1,1.0,1,1.0,1,0.3007598664984065,58
4407,0,7178,3493,3685,0,0,0,1.0,1,1.0,1,1.0,1,0.3007598664984065,58
4408,0,7178,3493,3685,0,0,0,1.0,1,1.0,1,1.0,1,0.3054240946603812,59
4409,0,7178,3493,3685,0,0,0,1.0,1,1.0,1,1.0,1,0.3054240946603812,59
4410,0,7178,3493,3685,0,0,0,1.0,1,1.0,1,1.0,1,0.3054240946603812,59
4411,1,7179,3493,3686,0,0,0,1.0,1,1.0,1,1.0,1,0.28674852663711425,62
4412,0,7179,3493,3686,0,0,0,1.0,1,1.0,1,1.0,1,0.2810271200959022,63
4413,1,7180,3494,3686,0,0,0,1.0,1,1.0,1,1.0,1,0.2887656543144248,63
4414,2,7182,3494,3688,0,0,0,1.0,1,1.0,1,1.0,1,0.27182188969659715,64
4415,1,7183,3494,3689,0,0,0,1.0,1,1.0,1,1.0,1,0.2598063677464726,64
4416,0,7183,3494,3689,0,0,0,1.0,1,1.0,1,1.0,1,0.2598063677464726,64
4417,1,7184,3494,3690,0,0,0,1.0,1,1.0,1,1.0,1,0.2541143013824901,65
4418,1,7185,3495,3690,0,0,0,1.0,1,1.0,1,1.0,1,0.2677823186004706,65
4419,0,7185,3495,3690,0,0,0,1.0,1,1.0,1,1.0,1,0.31920884434881813,62
4420,2,7187,3495,3692,0,0,0,1.0,1,1.0,1,1.0,1,0.31300351688615874,62
4421,3,7190,3496,3694,0,0,0,1.0,1,1.0,1,1.0,1,0.31049285796684223,65
4422,5,7195,3498,3697,0,0,0,1.0,1,1.0,1,1.0,1,0.31810317327990356,64
4423,1,7196,3499,3697,0,0,0,1.0,1,1.0,1,1.0,1,0.31837011891436545,63
4424,1,7197,3499,3698,0,0,0,1.0,1,1.0,1,1.0,1,0.3035259284784747,63
4425,5,7202,3501,3701,0,0,0,1.0,1,1.0,1,1.0,1,0.2915723265716194,63
4426,1,7203,3502,3701,0,0,0,1.0,1,1.0,1,1.0,1,0.2814201448460278,63
4427,4,7207,3502,3705,0,0,0,1.0,1,1.0,1,1.0,1,0.2345369388694796,62
4428,1,7208,3502,3706,0,0,0,1.0,1,1.0,1,1.0,1,0.22270050932922275,61
4429,2,7210,3503,3707,0,0,0,1.0,1,1.0,1,1.0,1,0.24496990385654446,62
4430,2,7212,3504,3708,0,0,0,1.0,1,1.0,1,1.0,1,0.24498629856242568,60
4431,4,7216,3507,3709,0,0,0,1.0,1,1.0,1,1.0,1,0.21581744396568672,59
4432,2,7218,3507,3711,0,0,0,1.0,1,1.0,1,1.0,1,0.16968680564537011,60
4433,3,7221,3509,3712,0,0,0,1.0,1,1.0,1,1.0,1,0.1598661433760889,61
4434,2,7223,3510,3713,0,0,0,1.0,1,1.0,1,1.0,1,0.15447407493471957,61
4435,4,7227,3512,3715,0,0,0,1.0,1,1.0,1,1.0,1,0.1290477280452585,61
4436,1,7228,3513,3715,0,0,0,1.0,1,1.0,1,1.0,1,0.16827951611095807,61
4437,6,7234,3517,3717,0,0,0,1.0,1,1.0,1,1.0,1,0.17941767000287828,61
4438,0,7234,3517,3717,0,0,0,1.0,1,1.0,1,1.0,1,0.1799812476321043,62
4439,0,7234,3517,3717,0,0,0,1.0,1,1.0,1,1.0,1,0.18481479134150855,63
4440,0,7234,3517,3717,0,0,0,1.0,1,1.0,1,1.0,1,0.1854159753930889,64
4441,1,7235,3517,3718,0,0,0,1.0,1,1.0,1,1.0,1,0.1703473295297196,64
4442,3,7238,3519,3719,0,0,0,1.0,1,1.0,1,1.0,1,0.1600552834394879,67
4443,1,7239,3519,3720,0,0,0,1.0,1,1.0,1,1.0,1,0.13552327084901486,68
4444,1,7240,3519,3721,0,0,0,1.0,1,1.0,1,1.0,1,0.12664508230545585,69
4445,1,7241,3520,3721,0,0,0,1.0,1,1.0,1,1.0,1,0.1534243183820342,71
4446,1,7242,3520,3722,0,0,0,1.0,1,1.0,1,1.0,1,0.14245171390370873,71
4447,2,7244,3520,3724,0,0,0,1.0,1,1.0,1,1.0,1,0.1283587122384122,72
4448,0,7244,3520,3724,0,0,0,1.0,1,1.0,1,1.0,1,0.13831205436456856,71
4449,1,7245,3521,3724,0,0,0,1.0,1,1.0,1,1.0,1,0.14706726702849968,70
4450,1,7246,3521,3725,0,0,0,1.0,1,1.0,1,1.0,1,0.14498767609353996,69
4451,0,7246,3521,3725,0,0,0,1.0,1,1.0,1,1.0,1,0.14926544235501085,69
4452,0,7246,3521,3725,0,0,0,1.0,1,1.0,1,1.0,1,0.1530555098022816,70
4453,1,7247,3521,3726,0,0,0,1.0,1,1.0,1,1.0,1,0.16605364767878494,70
4454,3,7250,3522,3728,0,0,0,1.0,1,1.0,1,1.0,1,0.15568398176329268,71
4455,2,7252,3524,3728,0,0,0,1.0,1,1.0,1,1.0,1,0.16833392501753683,71
4456,6,7258,3527,3731,0,0,0,1.0,1,1.0,1,1.0,1,0.15976880492727577,71
4457,2,7260,3528,3732,0,0,0,1.0,1,1.0,1,1.0,1,0.14542224352404134,69
4458,4,7264,3531,3733,0,0,0,1.0,1,1.0,1,1.0,1,0.1786284140814697,70
4459,3,7267,3534,3733,0,0,0,1.0,1,1.0,1,1.0,1,0.18091332025468396,68
4460,6,7273,3537,3736,0,0,0,1.0,1,1.0,1,1.0,1,0.1596867501878079,68
4461,2,7275,3538,3737,0,0,0,1.0,1,1.0,1,1.0,1,0.1537197076995924,67
4462,5,7280,3542,3738,0,0,0,1.0,1,1.0,1,1.0,1,0.16505040931162945,66
4463,3,7283,3544,3739,0,0,0,1.0,1,1.0,1,1.0,1,0.19266938973365416,65
4464,4,7287,3547,3740,0,0,0,1.0,1,1.0,1,1.0,1,0.23541320443401292,62
4465,5,7292,3550,3742,0,0,0,1.0,1,1.0,1,1.0,1,0.21450666091635942,61
4466,1,7293,3550,3743,0,0,0,1.0,1,1.0,1,1.0,1,0.2065394859705116,60
4467,4,7297,3551,3746,0,0,0,1.0,1,1.0,1,1.0,1,0.17251081816132086,58
4468,1,7298,3552,3746,0,0,0,1.0,1,1.0,1,1.0,1,0.18883522742903772,57
4469,4,7302,3554,3748,0,0,0,1.0,1,1.0,1,1.0,1,0.19121828733281993,56
4470,1,7303,3555,3748,0,0,0,1.0,1,1.0,1,1.0,1,0.19170376796279706,55
4471,1,7304,3556,3748,0,0,0,1.0,1,1.0,1,1.0,1,0.2023408438700596,55
4472,2,7306,3558,3748,0,0,0,1.0,1,1.0,1,1.0,1,0.2145625055665787,55
4473,1,7307,3559,3748,0,0,0,1.0,1,1.0,1,1.0,1,0.2149064185324583,55
4474,5,7312,3562,3750,0,0,0,1.0,1,1.0,1,1.0,1,0.21298793390706763,55
4475,2,7314,3562,3752,0,0,0,1.0,1,1.0,1,1.0,1,0.16298767656450264,56
4476,2,7316,3563,3753,0,0,0,1.0,1,1.0,1,1.0,1,0.16470244328407924,56
4477,2,7318,3563,3755,0,0,0,1.0,1,1.0,1,1.0,1,0.1430149260023499,57
4478,1,7319,3563,3756,0,0,0,1.0,1,1.0,1,1.0,1,0.14633534174024113,55
4479,2,7321,3564,3757,0,0,0,1.0,1,1.0,1,1.0,1,0.1646726833039036,55
4480,0,7321,3564,3757,0,0,0,1.0,1,1.0,1,1.0,1,0.16044979668684187,54
4481,0,7321,3564,3757,0,0,0,1.0,1,1.0,1,1.0,1,0.18811903278186043,53
4482,1,7322,3565,3757,0,0,0,1.0,1,1.0,1,1.0,1,0.1962513593377386,54
4483,0,7322,3565,3757,0,0,0,1.0,1,1.0,1,1.0,1,0.19659903289822253,55
4484,2,7324,3567,3757,0,0,0,1.0,1,1.0,1,1.0,1,0.21510658216819412,57
4485,3,7327,3569,3758,0,0,0,1.0,1,1.0,1,1.0,1,0.22872361572333938,60
4486,5,7332,3571,3761,0,0,0,1.0,1,1.0,1,1.0,1,0.18186272385135996,60
4487,0,7332,3571,3761,0,0,0,1.0,1,1.0,1,1.0,1,0.18186272385135996,60
4488,0,7332,3571,3761,0,0,0,1.0,1,1.0,1,1.0,1,0.18186272385135996,60
4489,1,7333,3572,3761,0,0,0,1.0,1,1.0,1,1.0,1,0.18276425107020403,60
4490,0,7333,3572,3761,0,0,0,1.0,1,1.0,1,1.0,1,0.18276425107020403,60
4491,2,7335,3573,3762,0,0,0,1.0,1,1.0,1,1.0,1,0.1691354914315735,61
4492,1,7336,3574,3762,0,0,0,1.0,1,1.0,1,1.0,1,0.1464167386960996,61
4493,1,7337,3575,3762,0,0,0,1.0,1,1.0,1,1.0,1,0.15205060295430933,60
4494,4,7341,3577,3764,0,0,0,1.0,1,1.0,1,1.0,1,0.13840958976810672,61
4495,1,7342,3577,3765,0,0,0,1.0,1,1.0,1,1.0,1,0.12609267191580842,59
4496,0,7342,3577,3765,0,0,0,1.0,1,1.0,1,1.0,1,0.15980179661508662,60
4497,1,7343,3578,3765,0,0,0,1.0,1,1.0,1,1.0,1,0.19654971567417345,59
4498,1,7344,3579,3765,0,0,0,1.0,1,1.0,1,1.0,1,0.19257272538129383,57
4499,3,7347,3581,3766,0,0,0,1.0,1,1.0,1,1.0,1,0.20865515664425677,58
4500,1,7348,3582,3766,0,0,0,1.0,1,1.0,1,1.0,1,0.20728788142211627,56
4501,4,7352,3584,3768,0,0,0,1.0,1,1.0,1,1.0,1,0.20417508231008738,57
4502,3,7355,3587,3768,0,0,0,1.0,1,1.0,1,1.0,1,0.2423119778866997,56
4503,4,7359,3588,3771,0,0,0,1.0,1,1.0,1,1.0,1,0.22114447971874682,54
4504,1,7360,3589,3771,0,0,0,1.0,1,1.0,1,1.0,1,0.22037058594857206,54
4505,1,7361,3590,3771,0,0,0,1.0,1,1.0,1,1.0,1,0.23059711243634795,51
4506,0,7361,3590,3771,0,0,0,1.0,1,1.0,1,1.0,1,0.2200212414549873,49
4507,2,7363,3592,3771,0,0,0,1.0,1,1.0,1,1.0,1,0.2614606057030871,48
4508,3,7366,3592,3774,0,0,0,1.0,1,1.0,1,1.0,1,0.24106955050074821,48
4509,2,7368,3594,3774,0,0,0,1.0,1,1.0,1,1.0,1,0.24931398197841487,46
4510,1,7369,3594,3775,0,0,0,1.0,1,1.0,1,1.0,1,0.24633677810145688,44
4511,3,7372,3595,3777,0,0,0,1.0,1,1.0,1,1.0,1,0.25032831749611173,45
4512,2,7374,3596,3778,0,0,0,1.0,1,1.0,1,1.0,1,0.2384646466013258,46
4513,4,7378,3596,3782,0,0,0,1.0,1,1.0,1,1.0,1,0.192722220740749,45
4514,2,7380,3597,3783,0,0,0,1.0,1,1.0,1,1.0,1,0.17809441060393288,46
4515,1,7381,3597,3784,0,0,0,1.0,1,1.0,1,1.0,1,0.18248191648428655,48
4516,1,7382,3598,3784,0,0,0,1.0,1,1.0,1,1.0,1,0.20258431907068775,49
4517,2,7384,3599,3785,0,0,0,1.0,1,1.0,1,1.0,1,0.19288296904896457,50
4518,1,7385,3600,3785,0,0,0,1.0,1,1.0,1,1.0,1,0.19327828575948217,50
4519,2,7387,3602,3785,0,0,0,1.0,1,1.0,1,1.0,1,0.22028861746022624,49
4520,1,7388,3602,3786,0,0,0,1.0,1,1.0,1,1.0,1,0.22222535563535625,50
4521,0,7388,3602,3786,0,0,0,1.0,1,1.0,1,1.0,1,0.22222535563535625,50
4522,0,7388,3602,3786,0,0,0,1.0,1,1.0,1,1.0,1,0.22222535563535625,50
4523,0,7388,3602,3786,0,0,0,1.0,1,1.0,1,1.0,1,0.22303829611404796,51
4524,2,7390,3603,3787,0,0,0,1.0,1,1.0,1,1.0,1,0.2086770863998508,52
4525,3,7393,3604,3789,0,0,0,1.0,1,1.0,1,1.0,1,0.19249958745730805,53
4526,0,7393,3604,3789,0,0,0,1.0,1,1.0,1,1.0,1,0.1837730026849083,54
4527,2,7395,3606,3789,0,0,0,1.0,1,1.0,1,1.0,1,0.18892132073744555,55
4528,1,7396,3606,3790,0,0,0,1.0,1,1.0,1,1.0,1,0.18255023634736123,55
4529,2,7398,3606,3792,0,0,0,1.0,1,1.0,1,1.0,1,0.1777100478200239,55
4530,1,7399,3606,3793,0,0,0,1.0,1,1.0,1,1.0,1,0.14785787602032535,56
4531,2,7401,3608,3793,0,0,0,1.0,1,1.0,1,1.0,1,0.21791064491773168,56
4532,1,7402,3608,3794,0,0,0,1.0,1,1.0,1,1.0,1,0.22054909411705456,55
4533,2,7404,3608,3796,0,0,0,1.0,1,1.0,1,1.0,1,0.1938433588023624,54
4534,0,7404,3608,3796,0,0,0,1.0,1,1.0,1,1.0,1,0.20674952914726144,55
4535,1,7405,3608,3797,0,0,0,1.0,1,1.0,1,1.0,1,0.18746420886583495,52
4536,4,7409,3612,3797,0,0,0,1.0,1,1.0,1,1.0,1,0.25890790825617555,53
4537,4,7413,3614,3799,0,0,0,1.0,1,1.0,1,1.0,1,0.23603609957441815,52
4538,2,7415,3616,3799,0,0,0,1.0,1,1.0,1,1.0,1,0.26208545108114656,52
4539,5,7420,3617,3803,0,0,0,1.0,1,1.0,1,1.0,1,0.24186460066553273,53
4540,1,7421,3618,3803,0,0,0,1.0,1,1.0,1,1.0,1,0.2546783772640986,54
4541,4,7425,3618,3807,0,0,0,1.0,1,1.0,1,1.0,1,0.19423962163176234,53
4542,2,7427,3620,3807,0,0,0,1.0,1,1.0,1,1.0,1,0.2205706919735559,53
4543,2,7429,3621,3808,0,0,0,1.0,1,1.0,1,1.0,1,0.22472494051419362,53
4544,4,7433,3622,3811,0,0,0,1.0,1,1.0,1,1.0,1,0.18238543895179693,52
4545,2,7435,3622,3813,0,0,0,1.0,1,1.0,1,1.0,1,0.17902181369445824,50
4546,1,7436,3623,3813,0,0,0,1.0,1,1.0,1,1.0,1,0.1857273340919501,49
4547,1,7437,3624,3813,0,0,0,1.0,1,1.0,1,1.0,1,0.18502998929860415,49
4548,0,7437,3624,3813,0,0,0,1.0,1,1.0,1,1.0,1,0.18502998929860415,49
4549,2,7439,3626,3813,0,0,0,1.0,1,1.0,1,1.0,1,0.19846308976166752,50
4550,1,7440,3627,3813,0,0,0,1.0,1,1.0,1,1.0,1,0.20491197417396834,49
4551,1,7441,3627,3814,0,0,0,1.0,1,1.0,1,1.0,1,0.19286293967815224,49
4552,0,7441,3627,3814,0,0,0,1.0,1,1.0,1,1.0,1,0.19286293967815224,49
4553,1,7442,3628,3814,0,0,0,1.0,1,1.0,1,1.0,1,0.2343256349496525,49
4554,0,7442,3628,3814,0,0,0,1.0,1,1.0,1,1.0,1,0.2343256349496525,49
4555,2,7444,3629,3815,0,0,0,1.0,1,1.0,1,1.0,1,0.21969916401020337,48
4556,1,7445,3630,3815,0,0,0,1.0,1,1.0,1,1.0,1,0.20369057820288816,48
4557,1,7446,3631,3815,0,0,0,1.0,1,1.0,1,1.0,1,0.23038102133129404,49
4558,2,7448,3633,3815,0,0,0,1.0,1,1.0,1,1.0,1,0.1982459071726262,49
4559,1,7449,3633,3816,0,0,0,1.0,1,1.0,1,1.0,1,0.2134228950562932,50
4560,1,7450,3633,3817,0,0,0,1.0,1,1.0,1,1.0,1,0.21322364162679705,51
4561,2,7452,3633,3819,0,0,0,1.0,1,1.0,1,1.0,1,0.19036327937234157,52
4562,2,7454,3634,3820,0,0,0,1.0,1,1.0,1,1.0,1,0.22621542449239337,53
4563,0,7454,3634,3820,0,0,0,1.0,1,1.0,1,1.0,1,0.21342313920474493,52
4564,0,7454,3634,3820,0,0,0,1.0,1,1.0,1,1.0,1,0.220010049765437,54
4565,3,7457,3636,3821,0,0,0,1.0,1,1.0,1,1.0,1,0.21175581755190237,55
4566,2,7459,3637,3822,0,0,0,1.0,1,1.0,1,1.0,1,0.1799780420720536,55
4567,2,7461,3638,3823,0,0,0,1.0,1,1.0,1,1.0,1,0.17250432395751916,56
4568,3,7464,3639,3825,0,0,0,1.0,1,1.0,1,1.0,1,0.15998515775090325,58
4569,0,7464,3639,3825,0,0,0,1.0,1,1.0,1,1.0,1,0.16123868951379697,59
4570,1,7465,3640,3825,0,0,0,1.0,1,1.0,1,1.0,1,0.15279241925473483,59
4571,0,7465,3640,3825,0,0,0,1.0,1,1.0,1,1.0,1,0.13736224205011724,57
4572,2,7467,3642,3825,0,0,0,1.0,1,1.0,1,1.0,1,0.17707297638802202,56
4573,1,7468,3643,3825,0,0,0,1.0,1,1.0,1,1.0,1,0.2017875773966247,56
4574,1,7469,3643,3826,0,0,0,1.0,1,1.0,1,1.0,1,0.22719568760701694,55
4575,2,7471,3644,3827,0,0,0,1.0,1,1.0,1,1.0,1,0.21370065030326038,55
4576,0,7471,3644,3827,0,0,0,1.0,1,1.0,1,1.0,1,0.23875312560654283,55
4577,1,7472,3644,3828,0,0,0,1.0,1,1.0,1,1.0,1,0.23865768804040077,54
4578,1,7473,3645,3828,0,0,0,1.0,1,1.0,1,1.0,1,0.2386401793225436,54
4579,1,7474,3645,3829,0,0,0,1.0,1,1.0,1,1.0,1,0.21912667448777962,54
4580,0,7474,3645,3829,0,0,0,1.0,1,1.0,1,1.0,1,0.21101907010092624,55
4581,1,7475,3646,3829,0,0,0,1.0,1,1.0,1,1.0,1,0.2375776682179764,56
4582,0,7475,3646,3829,0,0,0,1.0,1,1.0,1,1.0,1,0.2375776682179764,56
4583,1,7476,3647,3829,0,0,0,1.0,1,1.0,1,1.0,1,0.2505905482817139,57
4584,1,7477,3648,3829,0,0,0,1.0,1,1.0,1,1.0,1,0.27592728422996377,57
4585,0,7477,3648,3829,0,0,0,1.0,1,1.0,1,1.0,1,0.27592728422996377,57
4586,0,7477,3648,3829,0,0,0,1.0,1,1.0,1,1.0,1,0.27592728422996377,57
4587,0,7477,3648,3829,0,0,0,1.0,1,1.0,1,1.0,1,0.27592728422996377,57
4588,2,7479,3648,3831,0,0,0,1.0,1,1.0,1,1.0,1,0.26514423569890844,58
4589,1,7480,3648,3832,0,0,0,1.0,1,1.0,1,1.0,1,0.24653021411835654,59
4590,0,7480,3648,3832,0,0,0,1.0,1,1.0,1,1.0,1,0.256058534522078,60
4591,0,7480,3648,3832,0,0,0,1.0,1,1.0,1,1.0,1,0.26319004671686574,61
4592,0,7480,3648,3832,0,0,0,1.0,1,1.0,1,1.0,1,0.26589683634997735,62
4593,3,7483,3649,3834,0,0,0,1.0,1,1.0,1,1.0,1,0.25210362049324736,64
4594,0,7483,3649,3834,0,0,0,1.0,1,1.0,1,1.0,1,0.25210362049324736,64
4595,0,7483,3649,3834,0,0,0,1.0,1,1.0,1,1.0,1,0.265037094072527,63
4596,0,7483,3649,3834,0,0,0,1.0,1,1.0,1,1.0,1,0.265037094072527,63
4597,3,7486,3651,3835,0,0,0,1.0,1,1.0,1,1.0,1,0.24176770786601548,63
4598,2,7488,3652,3836,0,0,0,1.0,1,1.0,1,1.0,1,0.22856749722706143,65
4599,3,7491,3653,3838,0,0,0,1.0,1,1.0,1,1.0,1,0.21114751710648968,66
4600,3,7494,3654,3840,0,0,0,1.0,1,1.0,1,1.0,1,0.2107161889239036,67
4601,1,7495,3654,3841,0,0,0,1.0,1,1.0,1,1.0,1,0.20267918014266795,67
4602,2,7497,3654,3843,0,0,0,1.0,1,1.0,1,1.0,1,0.177090998925962,69
4603,2,7499,3655,3844,0,0,0,1.0,1,1.0,1,1.0,1,0.18127650325127567,69
4604,1,7500,3656,3844,0,0,0,1.0,1,1.0,1,1.0,1,0.178191998210292,69
4605,0,7500,3656,3844,0,0,0,1.0,1,1.0,1,1.0,1,0.17393905041813434,70
4606,0,7500,3656,3844,0,0,0,1.0,1,1.0,1,1.0,1,0.17393905041813434,70
4607,1,7501,3656,3845,0,0,0,1.0,1,1.0,1,1.0,1,0.16588768386471306,72
4608,1,7502,3656,3846,0,0,0,1.0,1,1.0,1,1.0,1,0.16452362077510263,73
4609,1,7503,3657,3846,0,0,0,1.0,1,1.0,1,1.0,1,0.17209895281899273,72
4610,1,7504,3657,3847,0,0,0,1.0,1,1.0,1,1.0,1,0.15262676830601488,72
4611,1,7505,3657,3848,0,0,0,1.0,1,1.0,1,1.0,1,0.1656002671065656,71
4612,2,7507,3659,3848,0,0,0,1.0,1,1.0,1,1.0,1,0.20936433143255703,70
4613,0,7507,3659,3848,0,0,0,1.0,1,1.0,1,1.0,1,0.20001433620991366,69
4614,0,7507,3659,3848,0,0,0,1.0,1,1.0,1,1.0,1,0.20710846461181995,68
4615,1,7508,3660,3848,0,0,0,1.0,1,1.0,1,1.0,1,0.20668498356876477,68
4616,0,7508,3660,3848,0,0,0,1.0,1,1.0,1,1.0,1,0.2403339246586661,65
4617,4,7512,3661,3851,0,0,0,1.0,1,1.0,1,1.0,1,0.2200526493753476,66
4618,1,7513,3662,3851,0,0,0,1.0,1,1.0,1,1.0,1,0.23130361194122004,66
4619,2,7515,3662,3853,0,0,0,1.0,1,1.0,1,1.0,1,0.21970036700053816,65
4620,1,7516,3662,3854,0,0,0,1.0,1,1.0,1,1.0,1,0.2065890340169068,65
4621,7,7523,3667,3856,0,0,0,1.0,1,1.0,1,1.0,1,0.24169664651984202,67
4622,0,7523,3667,3856,0,0,0,1.0,1,1.0,1,1.0,1,0.2545811342152686,65
4623,3,7526,3670,3856,0,0,0,1.0,1,1.0,1,1.0,1,0.2776999472549943,66
4624,3,7529,3673,3856,0,0,0,1.0,1,1.0,1,1.0,1,0.28098679738038695,65
4625,5,7534,3673,3861,0,0,0,1.0,1,1.0,1,1.0,1,0.23548602566576823,64
4626,3,7537,3675,3862,0,0,0,1.0,1,1.0,1,1.0,1,0.22382653881722422,63
4627,5,7542,3676,3866,0,0,0,1.0,1,1.0,1,1.0,1,0.19083429419682443,65
4628,1,7543,3676,3867,0,0,0,1.0,1,1.0,1,1.0,1,0.1872449909226677,64
4629,2,7545,3677,3868,0,0,0,1.0,1,1.0,1,1.0,1,0.16576739231640356,64
4630,1,7546,3677,3869,0,0,0,1.0,1,1.0,1,1.0,1,0.14879785132878726,64
4631,4,7550,3678,3872,0,0,0,1.0,1,1.0,1,1.0,1,0.1743117998243821,66
4632,0,7550,3678,3872,0,0,0,1.0,1,1.0,1,1.0,1,0.18598803913748688,65
4633,1,7551,3678,3873,0,0,0,1.0,1,1.0,1,1.0,1,0.16661865300127685,66
4634,0,7551,3678,3873,0,0,0,1.0,1,1.0,1,1.0,1,0.16661865300127685,66
4635,0,7551,3678,3873,0,0,0,1.0,1,1.0,1,1.0,1,0.16644597980258818,66
4636,0,7551,3678,3873,0,0,0,1.0,1,1.0,1,1.0,1,0.16644597980258818,66
4637,1,7552,3678,3874,0,0,0,1.0,1,1.0,1,1.0,1,0.15007034390315235,68
4638,0,7552,3678,3874,0,0,0,1.0,1,1.0,1,1.0,1,0.15007034390315235,68
4639,2,7554,3679,3875,0,0,0,1.0,1,1.0,1,1.0,1,0.15430021266362579,69
4640,1,7555,3679,3876,0,0,0,1.0,1,1.0,1,1.0,1,0.15178651520718747,69
4641,2,7557,3680,3877,0,0,0,1.0,1,1.0,1,1.0,1,0.16793186478613897,70
4642,0,7557,3680,3877,0,0,0,1.0,1,1.0,1,1.0,1,0.1808102829575718,69
4643,4,7561,3681,3880,0,0,0,1.0,1,1.0,1,1.0,1,0.16274414265793927,70
4644,1,7562,3682,3880,0,0,0,1.0,1,1.0,1,1.0,1,0.1928053175950229,69
4645,2,7564,3682,3882,0,0,0,1.0,1,1.0,1,1.0,1,0.17168454403841985,70
4646,2,7566,3684,3882,0,0,0,1.0,1,1.0,1,1.0,1,0.2140840792809084,68
4647,2,7568,3686,3882,0,0,0,1.0,1,1.0,1,1.0,1,0.23213425963889273,68
4648,1,7569,3686,3883,0,0,0,1.0,1,1.0,1,1.0,1,0.2537486469750333,67
4649,4,7573,3687,3886,0,0,0,1.0,1,1.0,1,1.0,1,0.2438245386940681,67
4650,1,7574,3687,3887,0,0,0,1.0,1,1.0,1,1.0,1,0.2213040097890961,67
4651,4,7578,3689,3889,0,0,0,1.0,1,1.0,1,1.0,1,0.24804338971701714,68
4652,3,7581,3690,3891,0,0,0,1.0,1,1.0,1,1.0,1,0.24927991461026788,66
4653,1,7582,3690,3892,0,0,0,1.0,1,1.0,1,1.0,1,0.22484469984561917,64
4654,1,7583,3690,3893,0,0,0,1.0,1,1.0,1,1.0,1,0.2528031796111709,65
4655,3,7586,3690,3896,0,0,0,1.0,1,1.0,1,1.0,1,0.21982289955644205,64
4656,2,7588,3691,3897,0,0,0,1.0,1,1.0,1,1.0,1,0.2250402179611222,65
4657,2,7590,3692,3898,0,0,0,1.0,1,1.0,1,1.0,1,0.23477144051611085,66
4658,1,7591,3693,3898,0,0,0,1.0,1,1.0,1,1.0,1,0.2664364012093186,65
4659,0,7591,3693,3898,0,0,0,1.0,1,1.0,1,1.0,1,0.2664364012093186,65
4660,2,7593,3694,3899,0,0,0,1.0,1,1.0,1,1.0,1,0.26732803224480406,66
4661,0,7593,3694,3899,0,0,0,1.0,1,1.0,1,1.0,1,0.29030391935501304,66
4662,5,7598,3695,3903,0,0,0,1.0,1,1.0,1,1.0,1,0.26290933849649056,68
4663,1,7599,3695,3904,0,0,0,1.0,1,1.0,1,1.0,1,0.254751975030506,67
4664,4,7603,3697,3906,0,0,0,1.0,1,1.0,1,1.0,1,0.25623689954252055,67
4665,2,7605,3698,3907,0,0,0,1.0,1,1.0,1,1.0,1,0.24910750872269227,67
4666,5,7610,3698,3912,0,0,0,1.0,1,1.0,1,1.0,1,0.2115549408787263,67
4667,2,7612,3699,3913,0,0,0,1.0,1,1.0,1,1.0,1,0.2056477717426179,66
4668,1,7613,3700,3913,0,0,0,1.0,1,1.0,1,1.0,1,0.20740115436991424,66
4669,5,7618,3703,3915,0,0,0,1.0,1,1.0,1,1.0,1,0.2187053212054434,66
4670,1,7619,3704,3915,0,0,0,1.0,1,1.0,1,1.0,1,0.24478714954029354,64
4671,0,7619,3704,3915,0,0,0,1.0,1,1.0,1,1.0,1,0.24478714954029354,64
4672,2,7621,3706,3915,0,0,0,1.0,1,1.0,1,1.0,1,0.2869712811860863,64
4673,2,7623,3706,3917,0,0,0,1.0,1,1.0,1,1.0,1,0.26416481714134843,65
4674,3,7626,3708,3918,0,0,0,1.0,1,1.0,1,1.0,1,0.27458555010054875,66
4675,5,7631,3708,3923,0,0,0,1.0,1,1.0,1,1.0,1,0.2487380277583001,65
4676,2,7633,3709,3924,0,0,0,1.0,1,1.0,1,1.0,1,0.25379291821776895,65
4677,1,7634,3709,3925,0,0,0,1.0,1,1.0,1,1.0,1,0.25415531102583416,65
4678,0,7634,3709,3925,0,0,0,1.0,1,1.0,1,1.0,1,0.27061622497887555,64
4679,1,7635,3710,3925,0,0,0,1.0,1,1.0,1,1.0,1,0.2653536790533451,66
4680,0,7635,3710,3925,0,0,0,1.0,1,1.0,1,1.0,1,0.27707652896052826,67
4681,4,7639,3711,3928,0,0,0,1.0,1,1.0,1,1.0,1,0.2541750323200261,67
4682,4,7643,3713,3930,0,0,0,1.0,1,1.0,1,1.0,1,0.2484936729201465,67
4683,3,7646,3714,3932,0,0,0,1.0,1,1.0,1,1.0,1,0.23465078879264506,67
4684,2,7648,3715,3933,0,0,0,1.0,1,1.0,1,1.0,1,0.2254695320386832,66
4685,1,7649,3715,3934,0,0,0,1.0,1,1.0,1,1.0,1,0.2056424831517111,65
4686,1,7650,3716,3934,0,0,0,1.0,1,1.0,1,1.0,1,0.23380660483771973,65
4687,0,7650,3716,3934,0,0,0,1.0,1,1.0,1,1.0,1,0.22561681989725238,65
4688,2,7652,3718,3934,0,0,0,1.0,1,1.0,1,1.0,1,0.27010752530600585,64
4689,4,7656,3720,3936,0,0,0,1.0,1,1.0,1,1.0,1,0.30822587619675257,65
4690,4,7660,3720,3940,0,0,0,1.0,1,1.0,1,1.0,1,0.28515612999138396,63
4691,5,7665,3723,3942,0,0,0,1.0,1,1.0,1,1.0,1,0.3054183271298846,64
4692,2,7667,3723,3944,0,0,0,1.0,1,1.0,1,1.0,1,0.256007124936594,63
4693,3,7670,3723,3947,0,0,0,1.0,1,1.0,1,1.0,1,0.23966202330208,64
4694,0,7670,3723,3947,0,0,0,1.0,1,1.0,1,1.0,1,0.22458091650674272,63
4695,0,7670,3723,3947,0,0,0,1.0,1,1.0,1,1.0,1,0.2246028362517061,62
4696,2,7672,3724,3948,0,0,0,1.0,1,1.0,1,1.0,1,0.21851354148833013,61
4697,1,7673,3724,3949,0,0,0,1.0,1,1.0,1,1.0,1,0.19791214600350482,63
4698,1,7674,3724,3950,0,0,0,1.0,1,1.0,1,1.0,1,0.19794542426146014,63
4699,1,7675,3724,3951,0,0,0,1.0,1,1.0,1,1.0,1,0.18219583374102388,65
4700,0,7675,3724,3951,0,0,0,1.0,1,1.0,1,1.0,1,0.18808831268102116,64
4701,1,7676,3725,3951,0,0,0,1.0,1,1.0,1,1.0,1,0.20187346124603908,64
4702,0,7676,3725,3951,0,0,0,1.0,1,1.0,1,1.0,1,0.21310137945310445,66
4703,2,7678,3726,3952,0,0,0,1.0,1,1.0,1,1.0,1,0.19582241481777699,65
4704,3,7681,3728,3953,0,0,0,1.0,1,1.0,1,1.0,1,0.194326544716256,64
4705,3,7684,3730,3954,0,0,0,1.0,1,1.0,1,1.0,1,0.24457148890517605,65
4706,6,7690,3734,3956,0,0,0,1.0,1,1.0,1,1.0,1,0.24863045434143932,65
4707,2,7692,3734,3958,0,0,0,1.0,1,1.0,1,1.0,1,0.22394593264507648,63
4708,2,7694,3735,3959,0,0,0,1.0,1,1.0,1,1.0,1,0.21597551472471802,62
4709,6,7700,3738,3962,0,0,0,1.0,1,1.0,1,1.0,1,0.25253871189501204,61
4710,0,7700,3738,3962,0,0,0,1.0,1,1.0,1,1.0,1,0.2551369169935213,60
4711,3,7703,3739,3964,0,0,0,1.0,1,1.0,1,1.0,1,0.22295175423267774,59
4712,0,7703,3739,3964,0,0,0,1.0,1,1.0,1,1.0,1,0.2251489729013305,58
4713,2,7705,3741,3964,0,0,0,1.0,1,1.0,1,1.0,1,0.23174538669401926,58
4714,0,7705,3741,3964,0,0,0,1.0,1,1.0,1,1.0,1,0.22978978000017777,57
4715,2,7707,3741,3966,0,0,0,1.0,1,1.0,1,1.0,1,0.21859164626927263,57
4716,2,7709,3742,3967,0,0,0,1.0,1,1.0,1,1.0,1,0.2145523664697184,55
4717,1,7710,3743,3967,0,0,0,1.0,1,1.0,1,1.0,1,0.23114332389699224,57
4718,2,7712,3743,3969,0,0,0,1.0,1,1.0,1,1.0,1,0.1928836333635516,56
4719,4,7716,3744,3972,0,0,0,1.0,1,1.0,1,1.0,1,0.20543518578183081,56
4720,2,7718,3744,3974,0,0,0,1.0,1,1.0,1,1.0,1,0.19539125807970767,57
4721,1,7719,3744,3975,0,0,0,1.0,1,1.0,1,1.0,1,0.18135258802462492,57
4722,1,7720,3745,3975,0,0,0,1.0,1,1.0,1,1.0,1,0.1782598176218853,57
4723,1,7721,3746,3975,0,0,0,1.0,1,1.0,1,1.0,1,0.18699081755230426,57
4724,0,7721,3746,3975,0,0,0,1.0,1,1.0,1,1.0,1,0.18851947562252744,57
4725,1,7722,3747,3975,0,0,0,1.0,1,1.0,1,1.0,1,0.23480104959157774,57
4726,2,7724,3749,3975,0,0,0,1.0,1,1.0,1,1.0,1,0.2658734865584205,57
4727,1,7725,3749,3976,0,0,0,1.0,1,1.0,1,1.0,1,0.26390045239111753,56
4728,1,7726,3749,3977,0,0,0,1.0,1,1.0,1,1.0,1,0.26140020967240635,57
4729,0,7726,3749,3977,0,0,0,1.0,1,1.0,1,1.0,1,0.2763716624656827,56
4730,2,7728,3751,3977,0,0,0,1.0,1,1.0,1,1.0,1,0.30697215953447665,54
4731,1,7729,3751,3978,0,0,0,1.0,1,1.0,1,1.0,1,0.28910870819534107,54
4732,1,7730,3752,3978,0,0,0,1.0,1,1.0,1,1.0,1,0.3167512802268081,54
4733,1,7731,3753,3978,0,0,0,1.0,1,1.0,1,1.0,1,0.3323911043444156,55
4734,4,7735,3755,3980,0,0,0,1.0,1,1.0,1,1.0,1,0.3346225024108057,56
4735,4,7739,3757,3982,0,0,0,1.0,1,1.0,1,1.0,1,0.3319533130843537,56
4736,1,7740,3757,3983,0,0,0,1.0,1,1.0,1,1.0,1,0.32823736152992156,58
4737,1,7741,3757,3984,0,0,0,1.0,1,1.0,1,1.0,1,0.3014550005648944,59
4738,4,7745,3760,3985,0,0,0,1.0,1,1.0,1,1.0,1,0.3385887928766233,60
4739,1,7746,3760,3986,0,0,0,1.0,1,1.0,1,1.0,1,0.32863378966586165,60
4740,0,7746,3760,3986,0,0,0,1.0,1,1.0,1,1.0,1,0.32863378966586165,60
4741,4,7750,3761,3989,0,0,0,1.0,1,1.0,1,1.0,1,0.31276106628448497,61
4742,4,7754,3763,3991,0,0,0,1.0,1,1.0,1,1.0,1,0.3055717714877568,61
4743,0,7754,3763,3991,0,0,0,1.0,1,1.0,1,1.0,1,0.29615604040969185,60
4744,2,7756,3765,3991,0,0,0,1.0,1,1.0,1,1.0,1,0.3008530394008687,60
4745,1,7757,3765,3992,0,0,0,1.0,1,1.0,1,1.0,1,0.2844884329076854,59
4746,2,7759,3766,3993,0,0,0,1.0,1,1.0,1,1.0,1,0.28197062934982975,59
4747,4,7763,3767,3996,0,0,0,1.0,1,1.0,1,1.0,1,0.24141484160418533,58
4748,3,7766,3769,3997,0,0,0,1.0,1,1.0,1,1.0,1,0.2333106796240781,58
4749,4,7770,3771,3999,0,0,0,1.0,1,1.0,1,1.0,1,0.2251209893091155,58
4750,1,7771,3772,3999,0,0,0,1.0,1,1.0,1,1.0,1,0.2267066061340121,56
4751,4,7775,3774,4001,0,0,0,1.0,1,1.0,1,1.0,1,0.20362386498092702,58
4752,0,7775,3774,4001,0,0,0,1.0,1,1.0,1,1.0,1,0.19425048051896876,55
4753,1,7776,3775,4001,0,0,0,1.0,1,1.0,1,1.0,1,0.18953071021817272,55
4754,0,7776,3775,4001,0,0,0,1.0,1,1.0,1,1.0,1,0.19410774595654218,54
4755,2,7778,3776,4002,0,0,0,1.0,1,1.0,1,1.0,1,0.20508843638543067,54
4756,3,7781,3779,4002,0,0,0,1.0,1,1.0,1,1.0,1,0.23459029239622847,54
4757,0,7781,3779,4002,0,0,0,1.0,1,1.0,1,1.0,1,0.22550583336723892,53
4758,0,7781,3779,4002,0,0,0,1.0,1,1.0,1,1.0,1,0.22550583336723892,53
4759,2,7783,3779,4004,0,0,0,1.0,1,1.0,1,1.0,1,0.20110902877512268,53
4760,1,7784,3780,4004,0,0,0,1.0,1,1.0,1,1.0,1,0.22642581103699838,53
4761,4,7788,3783,4005,0,0,0,1.0,1,1.0,1,1.0,1,0.2525913624942614,52
4762,5,7793,3783,4010,0,0,0,1.0,1,1.0,1,1.0,1,0.2026143625275543,54
4763,2,7795,3784,4011,0,0,0,1.0,1,1.0,1,1.0,1,0.20770290855464402,54
4764,1,7796,3785,4011,0,0,0,1.0,1,1.0,1,1.0,1,0.222051282300581,55
4765,2,7798,3787,4011,0,0,0,1.0,1,1.0,1,1.0,1,0.2880842765729332,56
4766,3,7801,3788,4013,0,0,0,1.0,1,1.0,1,1.0,1,0.2630107068609967,58
4767,3,7804,3789,4015,0,0,0,1.0,1,1.0,1,1.0,1,0.22982408190769096,59
4768,6,7810,3790,4020,0,0,0,1.0,1,1.0,1,1.0,1,0.19742527088202305,60
4769,2,7812,3790,4022,0,0,0,1.0,1,1.0,1,1.0,1,0.18566272660778,59
4770,2,7814,3790,4024,0,0,0,1.0,1,1.0,1,1.0,1,0.1684350452595499,60
4771,0,7814,3790,4024,0,0,0,1.0,1,1.0,1,1.0,1,0.1886440731601806,59
4772,0,7814,3790,4024,0,0,0,1.0,1,1.0,1,1.0,1,0.1886440731601806,59
4773,0,7814,3790,4024,0,0,0,1.0,1,1.0,1,1.0,1,0.1733045618432823,60
4774,1,7815,3790,4025,0,0,0,1.0,1,1.0,1,1.0,1,0.16993938649194518,60
4775,0,7815,3790,4025,0,0,0,1.0,1,1.0,1,1.0,1,0.1773693994140425,62
4776,0,7815,3790,4025,0,0,0,1.0,1,1.0,1,1.0,1,0.16610671054425336,63
4777,0,7815,3790,4025,0,0,0,1.0,1,1.0,1,1.0,1,0.16610671054425336,63
4778,0,7815,3790,4025,0,0,0,1.0,1,1.0,1,1.0,1,0.16610671054425336,63
4779,0,7815,3790,4025,0,0,0,1.0,1,1.0,1,1.0,1,0.16610671054425336,63
4780,3,7818,3791,4027,0,0,0,1.0,1,1.0,1,1.0,1,0.16691802099828068,65
4781,1,7819,3791,4028,0,0,0,1.0,1,1.0,1,1.0,1,0.16700169632299078,64
4782,2,7821,3792,4029,0,0,0,1.0,1,1.0,1,1.0,1,0.183469743775709,65
4783,6,7827,3794,4033,0,0,0,1.0,1,1.0,1,1.0,1,0.16352678853245994,66
4784,1,7828,3794,4034,0,0,0,1.0,1,1.0,1,1.0,1,0.12925859264110248,64
4785,3,7831,3796,4035,0,0,0,1.0,1,1.0,1,1.0,1,0.15297332300953728,65
4786,3,7834,3799,4035,0,0,0,1.0,1,1.0,1,1.0,1,0.238791784889867,66
4787,6,7840,3801,4039,0,0,0,1.0,1,1.0,1,1.0,1,0.1465845258674972,63
4788,5,7845,3804,4041,0,0,0,1.0,1,1.0,1,1.0,1,0.16461502205369194,63
4789,3,7848,3806,4042,0,0,0,1.0,1,1.0,1,1.0,1,0.1627390817023905,60
4790,3,7851,3809,4042,0,0,0,1.0,1,1.0,1,1.0,1,0.1954371463241394,61
4791,4,7855,3811,4044,0,0,0,1.0,1,1.0,1,1.0,1,0.20940829828340157,59
4792,3,7858,3812,4046,0,0,0,1.0,1,1.0,1,1.0,1,0.16849572828636952,59
4793,3,7861,3814,4047,0,0,0,1.0,1,1.0,1,1.0,1,0.18380516503415292,61
4794,3,7864,3816,4048,0,0,0,1.0,1,1.0,1,1.0,1,0.16886591889393368,60
4795,2,7866,3817,4049,0,0,0,1.0,1,1.0,1,1.0,1,0.17835751939506855,61
4796,3,7869,3819,4050,0,0,0,1.0,1,1.0,1,1.0,1,0.17488256790260917,60
4797,4,7873,3821,4052,0,0,0,1.0,1,1.0,1,1.0,1,0.1762292768294837,61
4798,4,7877,3822,4055,0,0,0,1.0,1,1.0,1,1.0,1,0.15561717991254712,61
4799,5,7882,3822,4060,0,0,0,1.0,1,1.0,1,1.0,1,0.11853728791093156,59
4800,0,7882,3822,4060,0,0,0,1.0,1,1.0,1,1.0,1,0.1350130718242472,57
4801,2,7884,3823,4061,0,0,0,1.0,1,1.0,1,1.0,1,0.12262254916460115,58
4802,0,7884,3823,4061,0,0,0,1.0,1,1.0,1,1.0,1,0.1328625116240756,56
4803,2,7886,3824,4062,0,0,0,1.0,1,1.0,1,1.0,1,0.12777567552749985,57
4804,1,7887,3824,4063,0,0,0,1.0,1,1.0,1,1.0,1,0.11831776401538623,55
4805,0,7887,3824,4063,0,0,0,1.0,1,1.0,1,1.0,1,0.1145861738279572,56
4806,0,7887,3824,4063,0,0,0,1.0,1,1.0,1,1.0,1,0.1371786633413488,55
4807,1,7888,3824,4064,0,0,0,1.0,1,1.0,1,1.0,1,0.15390519718738557,53
4808,5,7893,3826,4067,0,0,0,1.0,1,1.0,1,1.0,1,0.12898575364057696,54
4809,1,7894,3826,4068,0,0,0,1.0,1,1.0,1,1.0,1,0.15390594640394978,53
4810,0,7894,3826,4068,0,0,0,1.0,1,1.0,1,1.0,1,0.15390594640394978,53
4811,0,7894,3826,4068,0,0,0,1.0,1,1.0,1,1.0,1,0.13540420621407126,54
4812,1,7895,3827,4068,0,0,0,1.0,1,1.0,1,1.0,1,0.1274050087442853,54
4813,1,7896,3827,4069,0,0,0,1.0,1,1.0,1,1.0,1,0.10016194109559126,55
4814,2,7898,3829,4069,0,0,0,1.0,1,1.0,1,1.0,1,0.11569344350487754,55
4815,1,7899,3829,4070,0,0,0,1.0,1,1.0,1,1.0,1,0.09985357382088914,56
4816,2,7901,3831,4070,0,0,0,1.0,1,1.0,1,1.0,1,0.14796909955725665,56
4817,3,7904,3833,4071,0,0,0,1.0,1,1.0,1,1.0,1,0.1994890895276141,58
4818,6,7910,3835,4075,0,0,0,1.0,1,1.0,1,1.0,1,0.2232999678066655,58
4819,5,7915,3835,4080,0,0,0,1.0,1,1.0,1,1.0,1,0.15168887504108583,58
4820,1,7916,3835,4081,0,0,0,1.0,1,1.0,1,1.0,1,0.14421286045471696,58
4821,0,7916,3835,4081,0,0,0,1.0,1,1.0,1,1.0,1,0.16367187142119802,58
4822,2,7918,3837,4081,0,0,0,1.0,1,1.0,1,1.0,1,0.20114403020469077,58
4823,3,7921,3838,4083,0,0,0,1.0,1,1.0,1,1.0,1,0.18510265959510985,57
4824,0,7921,3838,4083,0,0,0,1.0,1,1.0,1,1.0,1,0.1746502498470351,56
4825,2,7923,3838,4085,0,0,0,1.0,1,1.0,1,1.0,1,0.18831891015974128,57
4826,0,7923,3838,4085,0,0,0,1.0,1,1.0,1,1.0,1,0.18831891015974128,57
4827,1,7924,3838,4086,0,0,0,1.0,1,1.0,1,1.0,1,0.2057379058001585,56
4828,1,7925,3839,4086,0,0,0,1.0,1,1.0,1,1.0,1,0.19169939419545134,57
4829,2,7927,3840,4087,0,0,0,1.0,1,1.0,1,1.0,1,0.2083735803499571,56
4830,1,7928,3841,4087,0,0,0,1.0,1,1.0,1,1.0,1,0.199273414533892,57
4831,3,7931,3843,4088,0,0,0,1.0,1,1.0,1,1.0,1,0.24019365978266602,57
4832,0,7931,3843,4088,0,0,0,1.0,1,1.0,1,1.0,1,0.2459205622166887,55
4833,2,7933,3845,4088,0,0,0,1.0,1,1.0,1,1.0,1,0.2826364958520122,55
4834,2,7935,3846,4089,0,0,0,1.0,1,1.0,1,1.0,1,0.2856791120214537,55
4835,4,7939,3846,4093,0,0,0,1.0,1,1.0,1,1.0,1,0.2520036120874604,55
4836,1,7940,3846,4094,0,0,0,1.0,1,1.0,1,1.0,1,0.23912990416398486,55
4837,0,7940,3846,4094,0,0,0,1.0,1,1.0,1,1.0,1,0.2309261742754249,53
4838,5,7945,3847,4098,0,0,0,1.0,1,1.0,1,1.0,1,0.19643513863473805,54
4839,1,7946,3848,4098,0,0,0,1.0,1,1.0,1,1.0,1,0.19045854794545192,53
4840,1,7947,3849,4098,0,0,0,1.0,1,1.0,1,1.0,1,0.22191650325333723,52
4841,3,7950,3851,4099,0,0,0,1.0,1,1.0,1,1.0,1,0.20908494715594308,51
4842,2,7952,3852,4100,0,0,0,1.0,1,1.0,1,1.0,1,0.22020901445658977,50
4843,5,7957,3854,4103,0,0,0,1.0,1,1.0,1,1.0,1,0.23380322612563778,51
4844,0,7957,3854,4103,0,0,0,1.0,1,1.0,1,1.0,1,0.2154138820135999,50
4845,2,7959,3856,4103,0,0,0,1.0,1,1.0,1,1.0,1,0.24527241592272253,49
4846,4,7963,3858,4105,0,0,0,1.0,1,1.0,1,1.0,1,0.20238757225388285,49
4847,5,7968,3859,4109,0,0,0,1.0,1,1.0,1,1.0,1,0.20624668283798395,48
4848,1,7969,3859,4110,0,0,0,1.0,1,1.0,1,1.0,1,0.19596821232915743,48
4849,1,7970,3860,4110,0,0,0,1.0,1,1.0,1,1.0,1,0.1972193196825294,48
4850,0,7970,3860,4110,0,0,0,1.0,1,1.0,1,1.0,1,0.2070062910572104,49
4851,1,7971,3860,4111,0,0,0,1.0,1,1.0,1,1.0,1,0.1847957848407167,49
4852,0,7971,3860,4111,0,0,0,1.0,1,1.0,1,1.0,1,0.19759868605493627,49
4853,0,7971,3860,4111,0,0,0,1.0,1,1.0,1,1.0,1,0.19511117094086702,50
4854,1,7972,3861,4111,0,0,0,1.0,1,1.0,1,1.0,1,0.20064917900923313,51
4855,0,7972,3861,4111,0,0,0,1.0,1,1.0,1,1.0,1,0.20064917900923313,51
4856,0,7972,3861,4111,0,0,0,1.0,1,1.0,1,1.0,1,0.21220300281040017,50
4857,2,7974,3861,4113,0,0,0,1.0,1,1.0,1,1.0,1,0.17794411749183886,51
4858,0,7974,3861,4113,0,0,0,1.0,1,1.0,1,1.0,1,0.16999571925299134,51
4859,0,7974,3861,4113,0,0,0,1.0,1,1.0,1,1.0,1,0.18491127181255448,52
4860,0,7974,3861,4113,0,0,0,1.0,1,1.0,1,1.0,1,0.18491127181255448,52
4861,1,7975,3861,4114,0,0,0,1.0,1,1.0,1,1.0,1,0.1971693106186036,53
4862,2,7977,3863,4114,0,0,0,1.0,1,1.0,1,1.0,1,0.23498712890425302,53
4863,2,7979,3863,4116,0,0,0,1.0,1,1.0,1,1.0,1,0.1837973926724293,51
4864,2,7981,3864,4117,0,0,0,1.0,1,1.0,1,1.0,1,0.19930639138451933,53
4865,1,7982,3864,4118,0,0,0,1.0,1,1.0,1,1.0,1,0.1793657387723337,52
4866,1,7983,3865,4118,0,0,0,1.0,1,1.0,1,1.0,1,0.22109301622054175,53
4867,5,7988,3866,4122,0,0,0,1.0,1,1.0,1,1.0,1,0.1504929290522476,51
4868,4,7992,3868,4124,0,0,0,1.0,1,1.0,1,1.0,1,0.14014320555260862,53
4869,0,7992,3868,4124,0,0,0,1.0,1,1.0,1,1.0,1,0.14014320555260862,53
4870,5,7997,3870,4127,0,0,0,1.0,1,1.0,1,1.0,1,0.14019062861355883,55
4871,2,7999,3871,4128,0,0,0,1.0,1,1.0,1,1.0,1,0.15194054180172978,55
4872,1,8000,3872,4128,0,0,0,1.0,1,1.0,1,1.0,1,0.19170328818963728,56
4873,3,8003,3873,4130,0,0,0,1.0,1,1.0,1,1.0,1,0.1702768495264097,56
4874,3,8006,3875,4131,0,0,0,1.0,1,1.0,1,1.0,1,0.1649593283121479,58
4875,2,8008,3876,4132,0,0,0,1.0,1,1.0,1,1.0,1,0.15546878113474374,56
4876,1,8009,3877,4132,0,0,0,1.0,1,1.0,1,1.0,1,0.17267307016798353,56
4877,2,8011,3879,4132,0,0,0,1.0,1,1.0,1,1.0,1,0.21759942142890493,54
4878,6,8017,3881,4136,0,0,0,1.0,1,1.0,1,1.0,1,0.20471305629002395,54
4879,3,8020,3883,4137,0,0,0,1.0,1,1.0,1,1.0,1,0.19638212361936727,54
4880,0,8020,3883,4137,0,0,0,1.0,1,1.0,1,1.0,1,0.1736478729802928,53
4881,6,8026,3885,4141,0,0,0,1.0,1,1.0,1,1.0,1,0.16542802232691048,54
4882,1,8027,3886,4141,0,0,0,1.0,1,1.0,1,1.0,1,0.174633963472382,52
4883,1,8028,3887,4141,0,0,0,1.0,1,1.0,1,1.0,1,0.22267398854403406,54
4884,0,8028,3887,4141,0,0,0,1.0,1,1.0,1,1.0,1,0.19974199758286082,52
4885,1,8029,3888,4141,0,0,0,1.0,1,1.0,1,1.0,1,0.21967003116265624,51
4886,0,8029,3888,4141,0,0,0,1.0,1,1.0,1,1.0,1,0.21883412231698446,50
4887,0,8029,3888,4141,0,0,0,1.0,1,1.0,1,1.0,1,0.2251728330752336,49
4888,0,8029,3888,4141,0,0,0,1.0,1,1.0,1,1.0,1,0.24070035697295938,48
4889,0,8029,3888,4141,0,0,0,1.0,1,1.0,1,1.0,1,0.24070035697295938,48
4890,0,8029,3888,4141,0,0,0,1.0,1,1.0,1,1.0,1,0.24070035697295938,48
4891,1,8030,3889,4141,0,0,0,1.0,1,1.0,1,1.0,1,0.26308897437971207,49
4892,0,8030,3889,4141,0,0,0,1.0,1,1.0,1,1.0,1,0.27912500577159377,51
4893,2,8032,3889,4143,0,0,0,1.0,1,1.0,1,1.0,1,0.28550640970296143,51
4894,1,8033,3889,4144,0,0,0,1.0,1,1.0,1,1.0,1,0.26674830085676554,52
4895,1,8034,3889,4145,0,0,0,1.0,1,1.0,1,1.0,1,0.2466405448337529,52
4896,2,8036,3890,4146,0,0,0,1.0,1,1.0,1,1.0,1,0.22187996742639143,51
4897,1,8037,3890,4147,0,0,0,1.0,1,1.0,1,1.0,1,0.21189868587042035,52
4898,1,8038,3891,4147,0,0,0,1.0,1,1.0,1,1.0,1,0.19878206344475666,52
4899,1,8039,3891,4148,0,0,0,1.0,1,1.0,1,1.0,1,0.18982968309905798,53
4900,3,8042,3893,4149,0,0,0,1.0,1,1.0,1,1.0,1,0.15329101272745335,54
4901,3,8045,3896,4149,0,0,0,1.0,1,1.0,1,1.0,1,0.16538660659021462,54
4902,2,8047,3897,4150,0,0,0,1.0,1,1.0,1,1.0,1,0.18198173714393398,55
4903,2,8049,3897,4152,0,0,0,1.0,1,1.0,1,1.0,1,0.18864116908135334,56
4904,1,8050,3898,4152,0,0,0,1.0,1,1.0,1,1.0,1,0.20759857967495005,55
4905,1,8051,3898,4153,0,0,0,1.0,1,1.0,1,1.0,1,0.1964739109408019,54
4906,2,8053,3899,4154,0,0,0,1.0,1,1.0,1,1.0,1,0.1974375256768237,54
4907,1,8054,3899,4155,0,0,0,1.0,1,1.0,1,1.0,1,0.18932891222308518,54
4908,0,8054,3899,4155,0,0,0,1.0,1,1.0,1,1.0,1,0.1845750771193353,53
4909,3,8057,3901,4156,0,0,0,1.0,1,1.0,1,1.0,1,0.18961791937881983,54
4910,2,8059,3901,4158,0,0,0,1.0,1,1.0,1,1.0,1,0.1836471988092317,55
4911,2,8061,3902,4159,0,0,0,1.0,1,1.0,1,1.0,1,0.17464459893910952,57
4912,6,8067,3904,4163,0,0,0,1.0,1,1.0,1,1.0,1,0.1396470097655709,57
4913,1,8068,3904,4164,0,0,0,1.0,1,1.0,1,1.0,1,0.12568295842395372,56
4914,1,8069,3905,4164,0,0,0,1.0,1,1.0,1,1.0,1,0.1448011251033398,56
4915,2,8071,3907,4164,0,0,0,1.0,1,1.0,1,1.0,1,0.16772668818131486,56
4916,0,8071,3907,4164,0,0,0,1.0,1,1.0,1,1.0,1,0.18486693651371358,54
4917,2,8073,3907,4166,0,0,0,1.0,1,1.0,1,1.0,1,0.170751046321047,53
4918,0,8073,3907,4166,0,0,0,1.0,1,1.0,1,1.0,1,0.17320403143637902,52
4919,1,8074,3907,4167,0,0,0,1.0,1,1.0,1,1.0,1,0.18724615310349926,49
4920,0,8074,3907,4167,0,0,0,1.0,1,1.0,1,1.0,1,0.18724615310349926,49
4921,2,8076,3909,4167,0,0,0,1.0,1,1.0,1,1.0,1,0.23854491819109747,50
4922,0,8076,3909,4167,0,0,0,1.0,1,1.0,1,1.0,1,0.23854491819109747,50
4923,4,8080,3912,4168,0,0,0,1.0,1,1.0,1,1.0,1,0.22149372783807297,52
4924,2,8082,3913,4169,0,0,0,1.0,1,1.0,1,1.0,1,0.23509806462648536,53
4925,4,8086,3914,4172,0,0,0,1.0,1,1.0,1,1.0,1,0.1581649567167793,54
4926,1,8087,3914,4173,0,0,0,1.0,1,1.0,1,1.0,1,0.14881304533106676,54
4927,2,8089,3916,4173,0,0,0,1.0,1,1.0,1,1.0,1,0.16867257429829047,54
4928,0,8089,3916,4173,0,0,0,1.0,1,1.0,1,1.0,1,0.16867257429829047,54
4929,0,8089,3916,4173,0,0,0,1.0,1,1.0,1,1.0,1,0.15677970779120787,55
4930,1,8090,3917,4173,0,0,0,1.0,1,1.0,1,1.0,1,0.20555350176051546,58
4931,2,8092,3917,4175,0,0,0,1.0,1,1.0,1,1.0,1,0.1775581341169073,58
4932,0,8092,3917,4175,0,0,0,1.0,1,1.0,1,1.0,1,0.18793499163089897,59
4933,0,8092,3917,4175,0,0,0,1.0,1,1.0,1,1.0,1,0.18793499163089897,59
4934,0,8092,3917,4175,0,0,0,1.0,1,1.0,1,1.0,1,0.18793499163089897,59
4935,2,8094,3917,4177,0,0,0,1.0,1,1.0,1,1.0,1,0.16216399363752457,59
4936,1,8095,3918,4177,0,0,0,1.0,1,1.0,1,1.0,1,0.1870368180996519,59
4937,1,8096,3918,4178,0,0,0,1.0,1,1.0,1,1.0,1,0.1895464698222419,61
4938,0,8096,3918,4178,0,0,0,1.0,1,1.0,1,1.0,1,0.19697310027866824,62
4939,2,8098,3918,4180,0,0,0,1.0,1,1.0,1,1.0,1,0.1740179354340226,63
4940,2,8100,3918,4182,0,0,0,1.0,1,1.0,1,1.0,1,0.18089769701725936,65
4941,1,8101,3919,4182,0,0,0,1.0,1,1.0,1,1.0,1,0.18881359590088068,65
4942,2,8103,3920,4183,0,0,0,1.0,1,1.0,1,1.0,1,0.19726024746298637,67
4943,2,8105,3921,4184,0,0,0,1.0,1,1.0,1,1.0,1,0.19900784303665325,66
4944,3,8108,3924,4184,0,0,0,1.0,1,1.0,1,1.0,1,0.24231992087104504,63
4945,7,8115,3926,4189,0,0,0,1.0,1,1.0,1,1.0,1,0.17055742040454938,61
4946,2,8117,3928,4189,0,0,0,1.0,1,1.0,1,1.0,1,0.21079240077285988,60
4947,1,8118,3928,4190,0,0,0,1.0,1,1.0,1,1.0,1,0.18222619476138896,58
4948,1,8119,3928,4191,0,0,0,1.0,1,1.0,1,1.0,1,0.17691616966334087,57
4949,1,8120,3929,4191,0,0,0,1.0,1,1.0,1,1.0,1,0.18560128983417265,56
4950,1,8121,3930,4191,0,0,0,1.0,1,1.0,1,1.0,1,0.19863300919553817,57
4951,3,8124,3932,4192,0,0,0,1.0,1,1.0,1,1.0,1,0.20014108373036585,55
4952,5,8129,3936,4193,0,0,0,1.0,1,1.0,1,1.0,1,0.2591788631727923,55
4953,6,8135,3938,4197,0,0,0,1.0,1,1.0,1,1.0,1,0.22587050036541173,54
4954,2,8137,3939,4198,0,0,0,1.0,1,1.0,1,1.0,1,0.22372885471125004,54
4955,1,8138,3939,4199,0,0,0,1.0,1,1.0,1,1.0,1,0.17813204491503534,52
4956,0,8138,3939,4199,0,0,0,1.0,1,1.0,1,1.0,1,0.17813204491503534,52
4957,1,8139,3940,4199,0,0,0,1.0,1,1.0,1,1.0,1,0.16149146598470285,53
4958,1,8140,3941,4199,0,0,0,1.0,1,1.0,1,1.0,1,0.17582978611256872,52
4959,4,8144,3942,4202,0,0,0,1.0,1,1.0,1,1.0,1,0.16505659701675546,51
4960,1,8145,3942,4203,0,0,0,1.0,1,1.0,1,1.0,1,0.14993207601596165,53
4961,2,8147,3943,4204,0,0,0,1.0,1,1.0,1,1.0,1,0.14684911222310762,53
4962,0,8147,3943,4204,0,0,0,1.0,1,1.0,1,1.0,1,0.14908752184239807,55
4963,0,8147,3943,4204,0,0,0,1.0,1,1.0,1,1.0,1,0.13113787192155205,54
4964,1,8148,3944,4204,0,0,0,1.0,1,1.0,1,1.0,1,0.13544476322550197,54
4965,0,8148,3944,4204,0,0,0,1.0,1,1.0,1,1.0,1,0.13544476322550197,54
4966,1,8149,3945,4204,0,0,0,1.0,1,1.0,1,1.0,1,0.1417128385483619,54
4967,3,8152,3948,4204,0,0,0,1.0,1,1.0,1,1.0,1,0.20728685738793515,55
4968,3,8155,3949,4206,0,0,0,1.0,1,1.0,1,1.0,1,0.1806540210435785,55
4969,5,8160,3951,4209,0,0,0,1.0,1,1.0,1,1.0,1,0.17392382672628606,57
4970,0,8160,3951,4209,0,0,0,1.0,1,1.0,1,1.0,1,0.19090963438363084,56
4971,4,8164,3952,4212,0,0,0,1.0,1,1.0,1,1.0,1,0.17953255856526448,57
4972,2,8166,3954,4212,0,0,0,1.0,1,1.0,1,1.0,1,0.22345834075312226,57
4973,2,8168,3954,4214,0,0,0,1.0,1,1.0,1,1.0,1,0.20049835267759025,60
4974,0,8168,3954,4214,0,0,0,1.0,1,1.0,1,1.0,1,0.20364052547844003,58
4975,1,8169,3954,4215,0,0,0,1.0,1,1.0,1,1.0,1,0.19564318609103193,59
4976,3,8172,3955,4217,0,0,0,1.0,1,1.0,1,1.0,1,0.16151992739434512,59
4977,4,8176,3959,4217,0,0,0,1.0,1,1.0,1,1.0,1,0.18568625653857757,59
4978,2,8178,3961,4217,0,0,0,1.0,1,1.0,1,1.0,1,0.16699549553096504,59
4979,1,8179,3961,4218,0,0,0,1.0,1,1.0,1,1.0,1,0.16459745654403773,61
4980,2,8181,3962,4219,0,0,0,1.0,1,1.0,1,1.0,1,0.1783916325670734,62
4981,3,8184,3963,4221,0,0,0,1.0,1,1.0,1,1.0,1,0.17465778869128018,62
4982,2,8186,3964,4222,0,0,0,1.0,1,1.0,1,1.0,1,0.1548982104102985,63
4983,1,8187,3964,4223,0,0,0,1.0,1,1.0,1,1.0,1,0.14955429419654545,63
4984,3,8190,3967,4223,0,0,0,1.0,1,1.0,1,1.0,1,0.19200616512230703,61
4985,3,8193,3967,4226,0,0,0,1.0,1,1.0,1,1.0,1,0.13774580269615697,59
4986,3,8196,3969,4227,0,0,0,1.0,1,1.0,1,1.0,1,0.18527522222397316,62
4987,1,8197,3969,4228,0,0,0,1.0,1,1.0,1,1.0,1,0.1602096139463679,60
4988,0,8197,3969,4228,0,0,0,1.0,1,1.0,1,1.0,1,0.1562838470581435,59
4989,6,8203,3971,4232,0,0,0,1.0,1,1.0,1,1.0,1,0.16097475557898708,57
4990,0,8203,3971,4232,0,0,0,1.0,1,1.0,1,1.0,1,0.18527563015141896,55
4991,4,8207,3974,4233,0,0,0,1.0,1,1.0,1,1.0,1,0.21040003927220272,54
4992,2,8209,3974,4235,0,0,0,1.0,1,1.0,1,1.0,1,0.20847299881555859,52
4993,0,8209,3974,4235,0,0,0,1.0,1,1.0,1,1.0,1,0.1923760540981215,51
4994,4,8213,3976,4237,0,0,0,1.0,1,1.0,1,1.0,1,0.17504641259777265,49
4995,2,8215,3977,4238,0,0,0,1.0,1,1.0,1,1.0,1,0.199013997046974,48
4996,3,8218,3980,4238,0,0,0,1.0,1,1.0,1,1.0,1,0.2075914225908696,48
4997,1,8219,3980,4239,0,0,0,1.0,1,1.0,1,1.0,1,0.1744593508977095,46
4998,1,8220,3981,4239,0,0,0,1.0,1,1.0,1,1.0,1,0.22063260226524636,48
4999,2,8222,3983,4239,0,0,0,1.0,1,1.0,1,1.0,1,0.2908250714905299,48
5000,2,8224,3984,4240,0,0,0,1.0,1,1.0,1,1.0,1,0.25879687354030306,47
5001,1,8225,3985,4240,0,0,0,1.0,1,1.0,1,1.0,1,0.32772408486397125,45
5002,2,8227,3987,4240,0,0,0,1.0,1,1.0,1,1.0,1,0.34318154455731104,46
5003,2,8229,3987,4242,0,0,0,1.0,1,1.0,1,1.0,1,0.31994007439388755,46
5004,2,8231,3987,4244,0,0,0,1.0,1,1.0,1,1.0,1,0.28546510983147816,46
5005,1,8232,3987,4245,0,0,0,1.0,1,1.0,1,1.0,1,0.2846218874100959,45
5006,0,8232,3987,4245,0,0,0,1.0,1,1.0,1,1.0,1,0.30548517764523136,45
5007,1,8233,3987,4246,0,0,0,1.0,1,1.0,1,1.0,1,0.28323710329145096,46
5008,0,8233,3987,4246,0,0,0,1.0,1,1.0,1,1.0,1,0.29124825453373265,49
5009,0,8233,3987,4246,0,0,0,1.0,1,1.0,1,1.0,1,0.29220295061939294,49
5010,0,8233,3987,4246,0,0,0,1.0,1,1.0,1,1.0,1,0.3004441658077977,50
5011,2,8235,3987,4248,0,0,0,1.0,1,1.0,1,1.0,1,0.2877275469101673,51
5012,0,8235,3987,4248,0,0,0,1.0,1,1.0,1,1.0,1,0.2948098381193483,52
5013,0,8235,3987,4248,0,0,0,1.0,1,1.0,1,1.0,1,0.2948098381193483,52
5014,0,8235,3987,4248,0,0,0,1.0,1,1.0,1,1.0,1,0.2936423156357894,53
5015,2,8237,3988,4249,0,0,0,1.0,1,1.0,1,1.0,1,0.3159664999001185,54
5016,0,8237,3988,4249,0,0,0,1.0,1,1.0,1,1.0,1,0.32428136491342524,55
5017,2,8239,3988,4251,0,0,0,1.0,1,1.0,1,1.0,1,0.3081239994778958,55
5018,4,8243,3989,4254,0,0,0,1.0,1,1.0,1,1.0,1,0.2654354679267533,56
5019,0,8243,3989,4254,0,0,0,1.0,1,1.0,1,1.0,1,0.2654354679267533,56
5020,1,8244,3990,4254,0,0,0,1.0,1,1.0,1,1.0,1,0.27824695008376454,55
5021,2,8246,3990,4256,0,0,0,1.0,1,1.0,1,1.0,1,0.2622341686117123,56
5022,3,8249,3993,4256,0,0,0,1.0,1,1.0,1,1.0,1,0.3024108095350156,56
5023,3,8252,3994,4258,0,0,0,1.0,1,1.0,1,1.0,1,0.26612726653456437,55
5024,4,8256,3997,4259,0,0,0,1.0,1,1.0,1,1.0,1,0.29257012182486514,55
5025,5,8261,3998,4263,0,0,0,1.0,1,1.0,1,1.0,1,0.23769851873675826,53
5026,3,8264,4001,4263,0,0,0,1.0,1,1.0,1,1.0,1,0.25638682718926714,52
5027,2,8266,4002,4264,0,0,0,1.0,1,1.0,1,1.0,1,0.26798022932894183,51
5028,2,8268,4004,4264,0,0,0,1.0,1,1.0,1,1.0,1,0.3165365133624898,51
5029,2,8270,4005,4265,0,0,0,1.0,1,1.0,1,1.0,1,0.31679977506429285,50
5030,2,8272,4007,4265,0,0,0,1.0,1,1.0,1,1.0,1,0.3250586324645829,49
5031,2,8274,4008,4266,0,0,0,1.0,1,1.0,1,1.0,1,0.3150312226287635,49
5032,0,8274,4008,4266,0,0,0,1.0,1,1.0,1,1.0,1,0.30681140421066516,48
5033,4,8278,4011,4267,0,0,0,1.0,1,1.0,1,1.0,1,0.3607209732230072,50
5034,2,8280,4011,4269,0,0,0,1.0,1,1.0,1,1.0,1,0.30880012147377833,49
5035,3,8283,4013,4270,0,0,0,1.0,1,1.0,1,1.0,1,0.34285851193787287,49
5036,2,8285,4014,4271,0,0,0,1.0,1,1.0,1,1.0,1,0.326985577795789,47
5037,6,8291,4015,4276,0,0,0,1.0,1,1.0,1,1.0,1,0.2735935282689585,47
5038,0,8291,4015,4276,0,0,0,1.0,1,1.0,1,1.0,1,0.2766076552427818,47
5039,3,8294,4015,4279,0,0,0,1.0,1,1.0,1,1.0,1,0.2633165041065576,48
5040,0,8294,4015,4279,0,0,0,1.0,1,1.0,1,1.0,1,0.2633165041065576,48
5041,0,8294,4015,4279,0,0,0,1.0,1,1.0,1,1.0,1,0.2633165041065576,48
5042,0,8294,4015,4279,0,0,0,1.0,1,1.0,1,1.0,1,0.2597620776670038,50
5043,0,8294,4015,4279,0,0,0,1.0,1,1.0,1,1.0,1,0.25906835310478155,51
5044,0,8294,4015,4279,0,0,0,1.0,1,1.0,1,1.0,1,0.25906835310478155,51
5045,1,8295,4015,4280,0,0,0,1.0,1,1.0,1,1.0,1,0.2577945107687982,52
5046,1,8296,4016,4280,0,0,0,1.0,1,1.0,1,1.0,1,0.28661486063215813,51
5047,1,8297,4016,4281,0,0,0,1.0,1,1.0,1,1.0,1,0.27106577979315366,51
5048,2,8299,4017,4282,0,0,0,1.0,1,1.0,1,1.0,1,0.25314249807854566,52
5049,1,8300,4018,4282,0,0,0,1.0,1,1.0,1,1.0,1,0.2833956802881593,54
5050,6,8306,4018,4288,0,0,0,1.0,1,1.0,1,1.0,1,0.21684109616960567,56
5051,3,8309,4018,4291,0,0,0,1.0,1,1.0,1,1.0,1,0.20323800986103707,55
5052,0,8309,4018,4291,0,0,0,1.0,1,1.0,1,1.0,1,0.20323800986103707,55
5053,1,8310,4018,4292,0,0,0,1.0,1,1.0,1,1.0,1,0.19936750104440984,55
5054,2,8312,4019,4293,0,0,0,1.0,1,1.0,1,1.0,1,0.18943588546552795,55
5055,2,8314,4019,4295,0,0,0,1.0,1,1.0,1,1.0,1,0.1890681187844558,55
5056,1,8315,4020,4295,0,0,0,1.0,1,1.0,1,1.0,1,0.22107081870708156,56
5057,2,8317,4020,4297,0,0,0,1.0,1,1.0,1,1.0,1,0.21145341249326421,58
5058,1,8318,4020,4298,0,0,0,1.0,1,1.0,1,1.0,1,0.21266873441879738,59
5059,1,8319,4020,4299,0,0,0,1.0,1,1.0,1,1.0,1,0.19643016455241252,59
5060,1,8320,4020,4300,0,0,0,1.0,1,1.0,1,1.0,1,0.17365818351620327,59
5061,2,8322,4020,4302,0,0,0,1.0,1,1.0,1,1.0,1,0.16205507885651305,59
5062,4,8326,4022,4304,0,0,0,1.0,1,1.0,1,1.0,1,0.1995147660094989,59
5063,3,8329,4023,4306,0,0,0,1.0,1,1.0,1,1.0,1,0.2148290897557367,59
5064,3,8332,4026,4306,0,0,0,1.0,1,1.0,1,1.0,1,0.24460215222902282,57
5065,3,8335,4028,4307,0,0,0,1.0,1,1.0,1,1.0,1,0.2338861754523163,55
5066,5,8340,4030,4310,0,0,0,1.0,1,1.0,1,1.0,1,0.25531566865837146,55
5067,6,8346,4032,4314,0,0,0,1.0,1,1.0,1,1.0,1,0.2320839953081276,54
5068,0,8346,4032,4314,0,0,0,1.0,1,1.0,1,1.0,1,0.22530844134288525,54
5069,2,8348,4033,4315,0,0,0,1.0,1,1.0,1,1.0,1,0.19429575722323242,54
5070,3,8351,4033,4318,0,0,0,1.0,1,1.0,1,1.0,1,0.1593614569000098,52
5071,1,8352,4034,4318,0,0,0,1.0,1,1.0,1,1.0,1,0.1729325101450986,54
5072,0,8352,4034,4318,0,0,0,1.0,1,1.0,1,1.0,1,0.1744518783584228,52
5073,1,8353,4034,4319,0,0,0,1.0,1,1.0,1,1.0,1,0.17240561794642834,51
5074,0,8353,4034,4319,0,0,0,1.0,1,1.0,1,1.0,1,0.1579724628346845,52
5075,0,8353,4034,4319,0,0,0,1.0,1,1.0,1,1.0,1,0.16729690152295493,53
5076,0,8353,4034,4319,0,0,0,1.0,1,1.0,1,1.0,1,0.16729690152295493,53
5077,1,8354,4035,4319,0,0,0,1.0,1,1.0,1,1.0,1,0.18879713505022724,56
5078,0,8354,4035,4319,0,0,0,1.0,1,1.0,1,1.0,1,0.20788387972999117,55
5079,3,8357,4035,4322,0,0,0,1.0,1,1.0,1,1.0,1,0.1694162397794292,56
5080,0,8357,4035,4322,0,0,0,1.0,1,1.0,1,1.0,1,0.16503764986921787,57
5081,1,8358,4035,4323,0,0,0,1.0,1,1.0,1,1.0,1,0.16235941552246808,58
5082,0,8358,4035,4323,0,0,0,1.0,1,1.0,1,1.0,1,0.16235941552246808,58
5083,0,8358,4035,4323,0,0,0,1.0,1,1.0,1,1.0,1,0.16993427782872506,59
5084,1,8359,4035,4324,0,0,0,1.0,1,1.0,1,1.0,1,0.15517773060389886,59
5085,1,8360,4036,4324,0,0,0,1.0,1,1.0,1,1.0,1,0.17280253797746525,60
5086,2,8362,4036,4326,0,0,0,1.0,1,1.0,1,1.0,1,0.15090640434614208,61
5087,2,8364,4038,4326,0,0,0,1.0,1,1.0,1,1.0,1,0.15539772046647482,62
5088,3,8367,4039,4328,0,0,0,1.0,1,1.0,1,1.0,1,0.16001342448973807,64
5089,2,8369,4041,4328,0,0,0,1.0,1,1.0,1,1.0,1,0.17871258593204223,64
5090,1,8370,4041,4329,0,0,0,1.0,1,1.0,1,1.0,1,0.16652193689522463,64
5091,2,8372,4043,4329,0,0,0,1.0,1,1.0,1,1.0,1,0.18080653902531507,64
5092,1,8373,4044,4329,0,0,0,1.0,1,1.0,1,1.0,1,0.1961141108538137,64
5093,0,8373,4044,4329,0,0,0,1.0,1,1.0,1,1.0,1,0.1961141108538137,64
5094,4,8377,4045,4332,0,0,0,1.0,1,1.0,1,1.0,1,0.17750991249907264,65
5095,5,8382,4047,4335,0,0,0,1.0,1,1.0,1,1.0,1,0.15470896307545018,66
5096,0,8382,4047,4335,0,0,0,1.0,1,1.0,1,1.0,1,0.15355997658044132,66
5097,2,8384,4048,4336,0,0,0,1.0,1,1.0,1,1.0,1,0.15023472470087731,67
5098,2,8386,4048,4338,0,0,0,1.0,1,1.0,1,1.0,1,0.1269940313223724,67
5099,1,8387,4048,4339,0,0,0,1.0,1,1.0,1,1.0,1,0.12596228356337774,70
5100,2,8389,4050,4339,0,0,0,1.0,1,1.0,1,1.0,1,0.1329910542899445,71
5101,2,8391,4050,4341,0,0,0,1.0,1,1.0,1,1.0,1,0.11881854890627792,72
5102,4,8395,4053,4342,0,0,0,1.0,1,1.0,1,1.0,1,0.1392478810362547,72
5103,8,8403,4057,4346,0,0,0,1.0,1,1.0,1,1.0,1,0.12872741602035814,70
5104,3,8406,4059,4347,0,0,0,1.0,1,1.0,1,1.0,1,0.1560976994851841,67
5105,2,8408,4060,4348,0,0,0,1.0,1,1.0,1,1.0,1,0.16974853796852374,66
5106,4,8412,4064,4348,0,0,0,1.0,1,1.0,1,1.0,1,0.21991566389207912,64
5107,3,8415,4067,4348,0,0,0,1.0,1,1.0,1,1.0,1,0.22066198556194191,61
5108,1,8416,4068,4348,0,0,0,1.0,1,1.0,1,1.0,1,0.22867970922781278,57
5109,4,8420,4071,4349,0,0,0,1.0,1,1.0,1,1.0,1,0.2596024062579927,55
5110,4,8424,4073,4351,0,0,0,1.0,1,1.0,1,1.0,1,0.2580623603378998,53
5111,5,8429,4076,4353,0,0,0,1.0,1,1.0,1,1.0,1,0.2703376380652281,52
5112,4,8433,4077,4356,0,0,0,1.0,1,1.0,1,1.0,1,0.22704003194069114,52
5113,2,8435,4077,4358,0,0,0,1.0,1,1.0,1,1.0,1,0.19998671415607527,49
5114,5,8440,4082,4358,0,0,0,1.0,1,1.0,1,1.0,1,0.20934006080128031,49
5115,1,8441,4082,4359,0,0,0,1.0,1,1.0,1,1.0,1,0.1890842973688118,48
5116,2,8443,4083,4360,0,0,0,1.0,1,1.0,1,1.0,1,0.20758496699483994,47
5117,2,8445,4083,4362,0,0,0,1.0,1,1.0,1,1.0,1,0.19616609478354816,48
5118,1,8446,4084,4362,0,0,0,1.0,1,1.0,1,1.0,1,0.2244157271903779,49
5119,3,8449,4085,4364,0,0,0,1.0,1,1.0,1,1.0,1,0.18341650134269688,49
5120,0,8449,4085,4364,0,0,0,1.0,1,1.0,1,1.0,1,0.19584299080429377,48
5121,3,8452,4086,4366,0,0,0,1.0,1,1.0,1,1.0,1,0.15665132029100118,48
5122,0,8452,4086,4366,0,0,0,1.0,1,1.0,1,1.0,1,0.16241328906392133,46
5123,1,8453,4087,4366,0,0,0,1.0,1,1.0,1,1.0,1,0.16882596996596655,46
5124,0,8453,4087,4366,0,0,0,1.0,1,1.0,1,1.0,1,0.16781664972894228,47
5125,5,8458,4088,4370,0,0,0,1.0,1,1.0,1,1.0,1,0.16160052329598013,49
5126,0,8458,4088,4370,0,0,0,1.0,1,1.0,1,1.0,1,0.16160052329598013,49
5127,1,8459,4089,4370,0,0,0,1.0,1,1.0,1,1.0,1,0.18684281843513614,51
5128,3,8462,4090,4372,0,0,0,1.0,1,1.0,1,1.0,1,0.21827493121724834,53
5129,4,8466,4091,4375,0,0,0,1.0,1,1.0,1,1.0,1,0.1863975078718477,55
5130,0,8466,4091,4375,0,0,0,1.0,1,1.0,1,1.0,1,0.1863975078718477,55
5131,3,8469,4091,4378,0,0,0,1.0,1,1.0,1,1.0,1,0.1562669849202078,55
5132,0,8469,4091,4378,0,0,0,1.0,1,1.0,1,1.0,1,0.1562669849202078,55
5133,0,8469,4091,4378,0,0,0,1.0,1,1.0,1,1.0,1,0.1650047440275346,56
5134,1,8470,4091,4379,0,0,0,1.0,1,1.0,1,1.0,1,0.17297852824854992,56
5135,1,8471,4092,4379,0,0,0,1.0,1,1.0,1,1.0,1,0.18135479062186588,56
5136,0,8471,4092,4379,0,0,0,1.0,1,1.0,1,1.0,1,0.1910314616444761,55
5137,2,8473,4093,4380,0,0,0,1.0,1,1.0,1,1.0,1,0.2090279474773417,55
5138,0,8473,4093,4380,0,0,0,1.0,1,1.0,1,1.0,1,0.21810041560968293,54
5139,3,8476,4096,4380,0,0,0,1.0,1,1.0,1,1.0,1,0.22809802623668918,54
5140,2,8478,4097,4381,0,0,0,1.0,1,1.0,1,1.0,1,0.23175500374276886,54
5141,5,8483,4100,4383,0,0,0,1.0,1,1.0,1,1.0,1,0.263970671443719,53
5142,8,8491,4102,4389,0,0,0,1.0,1,1.0,1,1.0,1,0.2166740735374568,55
5143,4,8495,4105,4390,0,0,0,1.0,1,1.0,1,1.0,1,0.2018971700386853,54
5144,1,8496,4106,4390,0,0,0,1.0,1,1.0,1,1.0,1,0.20514957717853344,50
5145,5,8501,4107,4394,0,0,0,1.0,1,1.0,1,1.0,1,0.1581197740195866,51
5146,1,8502,4108,4394,0,0,0,1.0,1,1.0,1,1.0,1,0.1413370107337905,48
5147,2,8504,4109,4395,0,0,0,1.0,1,1.0,1,1.0,1,0.15742237257667516,49
5148,0,8504,4109,4395,0,0,0,1.0,1,1.0,1,1.0,1,0.13321610154518937,47
5149,1,8505,4110,4395,0,0,0,1.0,1,1.0,1,1.0,1,0.15939035303939186,46
5150,5,8510,4115,4395,0,0,0,1.0,1,1.0,1,1.0,1,0.21552549721338304,46
5151,0,8510,4115,4395,0,0,0,1.0,1,1.0,1,1.0,1,0.1924097763107228,45
5152,5,8515,4119,4396,0,0,0,1.0,1,1.0,1,1.0,1,0.22646917538424932,45
5153,1,8516,4119,4397,0,0,0,1.0,1,1.0,1,1.0,1,0.21908537932576896,45
5154,2,8518,4120,4398,0,0,0,1.0,1,1.0,1,1.0,1,0.22602797723494492,45
5155,1,8519,4120,4399,0,0,0,1.0,1,1.0,1,1.0,1,0.20655952866032742,44
5156,1,8520,4121,4399,0,0,0,1.0,1,1.0,1,1.0,1,0.22710754129282718,44
5157,0,8520,4121,4399,0,0,0,1.0,1,1.0,1,1.0,1,0.21985495564384908,42
5158,1,8521,4122,4399,0,0,0,1.0,1,1.0,1,1.0,1,0.23909637113592586,43
5159,2,8523,4122,4401,0,0,0,1.0,1,1.0,1,1.0,1,0.24610949726110093,43
5160,0,8523,4122,4401,0,0,0,1.0,1,1.0,1,1.0,1,0.24610949726110093,43
5161,0,8523,4122,4401,0,0,0,1.0,1,1.0,1,1.0,1,0.24610949726110093,43
5162,0,8523,4122,4401,0,0,0,1.0,1,1.0,1,1.0,1,0.25003730866650553,44
5163,3,8526,4122,4404,0,0,0,1.0,1,1.0,1,1.0,1,0.22268788220250824,46
5164,4,8530,4124,4406,0,0,0,1.0,1,1.0,1,1.0,1,0.19169027056890367,46
5165,0,8530,4124,4406,0,0,0,1.0,1,1.0,1,1.0,1,0.19169027056890367,46
5166,5,8535,4127,4408,0,0,0,1.0,1,1.0,1,1.0,1,0.2081990761818628,47
5167,0,8535,4127,4408,0,0,0,1.0,1,1.0,1,1.0,1,0.2081990761818628,47
5168,2,8537,4129,4408,0,0,0,1.0,1,1.0,1,1.0,1,0.257979871064565,47
5169,3,8540,4129,4411,0,0,0,1.0,1,1.0,1,1.0,1,0.202997244262028,47
5170,2,8542,4130,4412,0,0,0,1.0,1,1.0,1,1.0,1,0.20037216810337422,48
5171,3,8545,4131,4414,0,0,0,1.0,1,1.0,1,1.0,1,0.2094685331097874,48
5172,0,8545,4131,4414,0,0,0,1.0,1,1.0,1,1.0,1,0.17981074813013573,49
5173,0,8545,4131,4414,0,0,0,1.0,1,1.0,1,1.0,1,0.18753576928282242,49
5174,3,8548,4132,4416,0,0,0,1.0,1,1.0,1,1.0,1,0.16341417139263575,52
5175,3,8551,4133,4418,0,0,0,1.0,1,1.0,1,1.0,1,0.11622336772585813,53
5176,0,8551,4133,4418,0,0,0,1.0,1,1.0,1,1.0,1,0.12975090352071134,54
5177,2,8553,4135,4418,0,0,0,1.0,1,1.0,1,1.0,1,0.16078189535555787,54
5178,3,8556,4137,4419,0,0,0,1.0,1,1.0,1,1.0,1,0.17921460706634149,55
5179,1,8557,4137,4420,0,0,0,1.0,1,1.0,1,1.0,1,0.1609313193054345,53
5180,0,8557,4137,4420,0,0,0,1.0,1,1.0,1,1.0,1,0.1739445097231921,52
5181,1,8558,4138,4420,0,0,0,1.0,1,1.0,1,1.0,1,0.17118889074933172,52
5182,1,8559,4139,4420,0,0,0,1.0,1,1.0,1,1.0,1,0.18982995311478795,52
5183,5,8564,4142,4422,0,0,0,1.0,1,1.0,1,1.0,1,0.2201890702048762,52
5184,0,8564,4142,4422,0,0,0,1.0,1,1.0,1,1.0,1,0.22043164595293763,52
5185,3,8567,4144,4423,0,0,0,1.0,1,1.0,1,1.0,1,0.23634004140860923,50
5186,1,8568,4145,4423,0,0,0,1.0,1,1.0,1,1.0,1,0.2841528932516395,48
5187,1,8569,4145,4424,0,0,0,1.0,1,1.0,1,1.0,1,0.2822410103273041,46
5188,0,8569,4145,4424,0,0,0,1.0,1,1.0,1,1.0,1,0.298286813342212,44
5189,0,8569,4145,4424,0,0,0,1.0,1,1.0,1,1.0,1,0.2837232314694728,44
5190,1,8570,4146,4424,0,0,0,1.0,1,1.0,1,1.0,1,0.30126832405622034,45
5191,1,8571,4146,4425,0,0,0,1.0,1,1.0,1,1.0,1,0.28255476934792173,45
5192,1,8572,4147,4425,0,0,0,1.0,1,1.0,1,1.0,1,0.2800644497748472,45
5193,1,8573,4147,4426,0,0,0,1.0,1,1.0,1,1.0,1,0.2670618839148864,45
5194,2,8575,4147,4428,0,0,0,1.0,1,1.0,1,1.0,1,0.2530015231548605,45
5195,3,8578,4148,4430,0,0,0,1.0,1,1.0,1,1.0,1,0.2077930993300038,46
5196,1,8579,4148,4431,0,0,0,1.0,1,1.0,1,1.0,1,0.1978639287563752,46
5197,2,8581,4150,4431,0,0,0,1.0,1,1.0,1,1.0,1,0.2110159172002536,46
5198,0,8581,4150,4431,0,0,0,1.0,1,1.0,1,1.0,1,0.20067508313936172,47
5199,2,8583,4151,4432,0,0,0,1.0,1,1.0,1,1.0,1,0.21255396535227344,49
5200,2,8585,4152,4433,0,0,0,1.0,1,1.0,1,1.0,1,0.2181997917017326,49
5201,5,8590,4154,4436,0,0,0,1.0,1,1.0,1,1.0,1,0.1822892814946795,50
5202,0,8590,4154,4436,0,0,0,1.0,1,1.0,1,1.0,1,0.18992968050575149,52
5203,0,8590,4154,4436,0,0,0,1.0,1,1.0,1,1.0,1,0.18992968050575149,52
5204,0,8590,4154,4436,0,0,0,1.0,1,1.0,1,1.0,1,0.20019149628271202,54
5205,0,8590,4154,4436,0,0,0,1.0,1,1.0,1,1.0,1,0.20019149628271202,54
5206,3,8593,4154,4439,0,0,0,1.0,1,1.0,1,1.0,1,0.16376896221793358,55
5207,0,8593,4154,4439,0,0,0,1.0,1,1.0,1,1.0,1,0.16726374983187012,54
5208,0,8593,4154,4439,0,0,0,1.0,1,1.0,1,1.0,1,0.16726374983187012,54
5209,0,8593,4154,4439,0,0,0,1.0,1,1.0,1,1.0,1,0.16726374983187012,54
5210,1,8594,4154,4440,0,0,0,1.0,1,1.0,1,1.0,1,0.14664202969715037,54
5211,1,8595,4154,4441,0,0,0,1.0,1,1.0,1,1.0,1,0.1414091410779227,56
5212,1,8596,4154,4442,0,0,0,1.0,1,1.0,1,1.0,1,0.13155664115483484,57
5213,1,8597,4155,4442,0,0,0,1.0,1,1.0,1,1.0,1,0.16934044120603708,57
5214,4,8601,4157,4444,0,0,0,1.0,1,1.0,1,1.0,1,0.2025531590480229,58
5215,0,8601,4157,4444,0,0,0,1.0,1,1.0,1,1.0,1,0.2152476202209855,57
5216,1,8602,4157,4445,0,0,0,1.0,1,1.0,1,1.0,1,0.19967032784776928,57
5217,5,8607,4159,4448,0,0,0,1.0,1,1.0,1,1.0,1,0.1571484853264411,56
5218,3,8610,4161,4449,0,0,0,1.0,1,1.0,1,1.0,1,0.16995439973848017,56
5219,0,8610,4161,4449,0,0,0,1.0,1,1.0,1,1.0,1,0.1826919201443983,54
5220,0,8610,4161,4449,0,0,0,1.0,1,1.0,1,1.0,1,0.21464058145147374,53
5221,0,8610,4161,4449,0,0,0,1.0,1,1.0,1,1.0,1,0.22718433243668418,52
5222,2,8612,4163,4449,0,0,0,1.0,1,1.0,1,1.0,1,0.2483799398661312,52
5223,4,8616,4166,4450,0,0,0,1.0,1,1.0,1,1.0,1,0.24383919739712512,52
5224,6,8622,4169,4453,0,0,0,1.0,1,1.0,1,1.0,1,0.2195231333196743,52
5225,1,8623,4169,4454,0,0,0,1.0,1,1.0,1,1.0,1,0.19025145308412836,50
5226,2,8625,4171,4454,0,0,0,1.0,1,1.0,1,1.0,1,0.21388745263841205,51
5227,3,8628,4172,4456,0,0,0,1.0,1,1.0,1,1.0,1,0.23615056908313586,49
5228,2,8630,4172,4458,0,0,0,1.0,1,1.0,1,1.0,1,0.21286237860235674,48
5229,1,8631,4172,4459,0,0,0,1.0,1,1.0,1,1.0,1,0.1883996184598296,49
5230,0,8631,4172,4459,0,0,0,1.0,1,1.0,1,1.0,1,0.1883996184598296,49
5231,1,8632,4173,4459,0,0,0,1.0,1,1.0,1,1.0,1,0.16919981395613556,49
5232,4,8636,4174,4462,0,0,0,1.0,1,1.0,1,1.0,1,0.1440225231058648,51
5233,2,8638,4175,4463,0,0,0,1.0,1,1.0,1,1.0,1,0.15337077002258684,51
5234,4,8642,4178,4464,0,0,0,1.0,1,1.0,1,1.0,1,0.1912018629515441,52
5235,1,8643,4178,4465,0,0,0,1.0,1,1.0,1,1.0,1,0.1761704847748448,52
5236,0,8643,4178,4465,0,0,0,1.0,1,1.0,1,1.0,1,0.1761704847748448,52
5237,1,8644,4178,4466,0,0,0,1.0,1,1.0,1,1.0,1,0.1895071138447874,53
5238,1,8645,4179,4466,0,0,0,1.0,1,1.0,1,1.0,1,0.18517595833282585,53
5239,1,8646,4179,4467,0,0,0,1.0,1,1.0,1,1.0,1,0.15724250955038385,53
5240,0,8646,4179,4467,0,0,0,1.0,1,1.0,1,1.0,1,0.17613499213226502,55
5241,1,8647,4179,4468,0,0,0,1.0,1,1.0,1,1.0,1,0.17237908987879585,56
5242,2,8649,4180,4469,0,0,0,1.0,1,1.0,1,1.0,1,0.1964884612436428,54
5243,3,8652,4181,4471,0,0,0,1.0,1,1.0,1,1.0,1,0.17657767630675988,55
5244,1,8653,4181,4472,0,0,0,1.0,1,1.0,1,1.0,1,0.169152024345385,55
5245,0,8653,4181,4472,0,0,0,1.0,1,1.0,1,1.0,1,0.169152024345385,55
5246,3,8656,4183,4473,0,0,0,1.0,1,1.0,1,1.0,1,0.2595764631282862,55
5247,6,8662,4184,4478,0,0,0,1.0,1,1.0,1,1.0,1,0.1696510637931065,54
5248,1,8663,4185,4478,0,0,0,1.0,1,1.0,1,1.0,1,0.203727417738334,53
5249,1,8664,4186,4478,0,0,0,1.0,1,1.0,1,1.0,1,0.18527094748323827,55
5250,2,8666,4188,4478,0,0,0,1.0,1,1.0,1,1.0,1,0.18624520088215968,55
5251,2,8668,4189,4479,0,0,0,1.0,1,1.0,1,1.0,1,0.20878749510410033,57
5252,0,8668,4189,4479,0,0,0,1.0,1,1.0,1,1.0,1,0.21824246299902308,58
5253,3,8671,4190,4481,0,0,0,1.0,1,1.0,1,1.0,1,0.22110935817361507,59
5254,2,8673,4191,4482,0,0,0,1.0,1,1.0,1,1.0,1,0.2031945891220025,59
5255,1,8674,4191,4483,0,0,0,1.0,1,1.0,1,1.0,1,0.1898354557817634,58
5256,4,8678,4193,4485,0,0,0,1.0,1,1.0,1,1.0,1,0.20287631985117127,59
5257,1,8679,4193,4486,0,0,0,1.0,1,1.0,1,1.0,1,0.1842810718672527,58
5258,0,8679,4193,4486,0,0,0,1.0,1,1.0,1,1.0,1,0.180671366523752,56
5259,0,8679,4193,4486,0,0,0,1.0,1,1.0,1,1.0,1,0.18443779790695658,56
5260,0,8679,4193,4486,0,0,0,1.0,1,1.0,1,1.0,1,0.17797707277848246,55
5261,1,8680,4194,4486,0,0,0,1.0,1,1.0,1,1.0,1,0.20219084705710333,54
5262,4,8684,4197,4487,0,0,0,1.0,1,1.0,1,1.0,1,0.21173247298951875,54
5263,4,8688,4199,4489,0,0,0,1.0,1,1.0,1,1.0,1,0.20013183280078722,53
5264,2,8690,4200,4490,0,0,0,1.0,1,1.0,1,1.0,1,0.20374788301730587,51
5265,4,8694,4202,4492,0,0,0,1.0,1,1.0,1,1.0,1,0.18283120601189956,50
5266,3,8697,4205,4492,0,0,0,1.0,1,1.0,1,1.0,1,0.19055399821140842,49
5267,0,8697,4205,4492,0,0,0,1.0,1,1.0,1,1.0,1,0.18185530797117963,48
5268,3,8700,4207,4493,0,0,0,1.0,1,1.0,1,1.0,1,0.17419011051460861,47
5269,0,8700,4207,4493,0,0,0,1.0,1,1.0,1,1.0,1,0.19964559026516093,45
5270,1,8701,4207,4494,0,0,0,1.0,1,1.0,1,1.0,1,0.18343798281486554,47
5271,1,8702,4207,4495,0,0,0,1.0,1,1.0,1,1.0,1,0.18178797023254945,45
5272,5,8707,4212,4495,0,0,0,1.0,1,1.0,1,1.0,1,0.23831529689548692,46
5273,1,8708,4212,4496,0,0,0,1.0,1,1.0,1,1.0,1,0.21928525800632206,44
5274,2,8710,4213,4497,0,0,0,1.0,1,1.0,1,1.0,1,0.2440988262213075,44
5275,5,8715,4215,4500,0,0,0,1.0,1,1.0,1,1.0,1,0.2259552078922941,46
5276,2,8717,4216,4501,0,0,0,1.0,1,1.0,1,1.0,1,0.2043644348547453,46
5277,1,8718,4216,4502,0,0,0,1.0,1,1.0,1,1.0,1,0.18189984831869213,46
5278,3,8721,4219,4502,0,0,0,1.0,1,1.0,1,1.0,1,0.20278216738143073,46
5279,1,8722,4220,4502,0,0,0,1.0,1,1.0,1,1.0,1,0.24784662364879959,47
5280,2,8724,4221,4503,0,0,0,1.0,1,1.0,1,1.0,1,0.222081616093165,47
5281,1,8725,4221,4504,0,0,0,1.0,1,1.0,1,1.0,1,0.2150833247955374,48
5282,2,8727,4223,4504,0,0,0,1.0,1,1.0,1,1.0,1,0.2578047072831577,48
5283,2,8729,4223,4506,0,0,0,1.0,1,1.0,1,1.0,1,0.25266746078996116,49
5284,0,8729,4223,4506,0,0,0,1.0,1,1.0,1,1.0,1,0.25266746078996116,49
5285,1,8730,4223,4507,0,0,0,1.0,1,1.0,1,1.0,1,0.2049519584677284,50
5286,0,8730,4223,4507,0,0,0,1.0,1,1.0,1,1.0,1,0.2184388267560179,51
5287,0,8730,4223,4507,0,0,0,1.0,1,1.0,1,1.0,1,0.2184388267560179,51
5288,1,8731,4223,4508,0,0,0,1.0,1,1.0,1,1.0,1,0.20645681224811635,51
5289,2,8733,4223,4510,0,0,0,1.0,1,1.0,1,1.0,1,0.19603415343240693,53
5290,0,8733,4223,4510,0,0,0,1.0,1,1.0,1,1.0,1,0.19603415343240693,53
5291,4,8737,4224,4513,0,0,0,1.0,1,1.0,1,1.0,1,0.16677551715288072,53
5292,2,8739,4225,4514,0,0,0,1.0,1,1.0,1,1.0,1,0.17302182049867865,53
5293,3,8742,4227,4515,0,0,0,1.0,1,1.0,1,1.0,1,0.2239749844404426,53
5294,3,8745,4229,4516,0,0,0,1.0,1,1.0,1,1.0,1,0.23962465968339383,54
5295,1,8746,4230,4516,0,0,0,1.0,1,1.0,1,1.0,1,0.2520997835921216,52
5296,2,8748,4231,4517,0,0,0,1.0,1,1.0,1,1.0,1,0.22809457330199862,49
5297,3,8751,4233,4518,0,0,0,1.0,1,1.0,1,1.0,1,0.2711527390206646,49
5298,2,8753,4234,4519,0,0,0,1.0,1,1.0,1,1.0,1,0.2560193263610422,49
5299,3,8756,4236,4520,0,0,0,1.0,1,1.0,1,1.0,1,0.2611367229044927,50
5300,0,8756,4236,4520,0,0,0,1.0,1,1.0,1,1.0,1,0.2650239378294463,48
5301,1,8757,4237,4520,0,0,0,1.0,1,1.0,1,1.0,1,0.29054920012118357,46
5302,1,8758,4237,4521,0,0,0,1.0,1,1.0,1,1.0,1,0.28181994766310337,47
5303,4,8762,4239,4523,0,0,0,1.0,1,1.0,1,1.0,1,0.254476775505313,46
5304,2,8764,4241,4523,0,0,0,1.0,1,1.0,1,1.0,1,0.2880504472760861,45
5305,1,8765,4241,4524,0,0,0,1.0,1,1.0,1,1.0,1,0.2611894893195843,44
5306,3,8768,4244,4524,0,0,0,1.0,1,1.0,1,1.0,1,0.34672591770843053,42
5307,4,8772,4246,4526,0,0,0,1.0,1,1.0,1,1.0,1,0.3047809617679749,42
5308,2,8774,4247,4527,0,0,0,1.0,1,1.0,1,1.0,1,0.30759729658672635,43
5309,2,8776,4248,4528,0,0,0,1.0,1,1.0,1,1.0,1,0.29857239794780016,41
5310,1,8777,4249,4528,0,0,0,1.0,1,1.0,1,1.0,1,0.34414656659946846,41
5311,0,8777,4249,4528,0,0,0,1.0,1,1.0,1,1.0,1,0.3269016594229268,42
5312,2,8779,4249,4530,0,0,0,1.0,1,1.0,1,1.0,1,0.3101460071707817,43
5313,0,8779,4249,4530,0,0,0,1.0,1,1.0,1,1.0,1,0.31580706651911084,44
5314,1,8780,4249,4531,0,0,0,1.0,1,1.0,1,1.0,1,0.2860794819658994,44
5315,5,8785,4251,4534,0,0,0,1.0,1,1.0,1,1.0,1,0.28027525896723293,45
5316,0,8785,4251,4534,0,0,0,1.0,1,1.0,1,1.0,1,0.28727974365057124,46
5317,3,8788,4251,4537,0,0,0,1.0,1,1.0,1,1.0,1,0.27068469747913104,46
5318,1,8789,4252,4537,0,0,0,1.0,1,1.0,1,1.0,1,0.2553225886608941,46
5319,1,8790,4252,4538,0,0,0,1.0,1,1.0,1,1.0,1,0.255156234174498,47
5320,2,8792,4253,4539,0,0,0,1.0,1,1.0,1,1.0,1,0.23374342796208497,48
5321,2,8794,4253,4541,0,0,0,1.0,1,1.0,1,1.0,1,0.2167337271733501,49
5322,1,8795,4253,4542,0,0,0,1.0,1,1.0,1,1.0,1,0.2088893302339423,49
5323,2,8797,4253,4544,0,0,0,1.0,1,1.0,1,1.0,1,0.21049137040679317,51
5324,0,8797,4253,4544,0,0,0,1.0,1,1.0,1,1.0,1,0.2008851849505778,53
5325,2,8799,4254,4545,0,0,0,1.0,1,1.0,1,1.0,1,0.21586214265024575,53
5326,3,8802,4255,4547,0,0,0,1.0,1,1.0,1,1.0,1,0.20784169176745448,53
5327,0,8802,4255,4547,0,0,0,1.0,1,1.0,1,1.0,1,0.24008552132534178,53
5328,0,8802,4255,4547,0,0,0,1.0,1,1.0,1,1.0,1,0.2454317286076771,54
5329,1,8803,4256,4547,0,0,0,1.0,1,1.0,1,1.0,1,0.2854117269363432,53
5330,0,8803,4256,4547,0,0,0,1.0,1,1.0,1,1.0,1,0.2757915484776857,52
5331,2,8805,4257,4548,0,0,0,1.0,1,1.0,1,1.0,1,0.26497691542122465,51
5332,2,8807,4258,4549,0,0,0,1.0,1,1.0,1,1.0,1,0.2846831284924642,52
5333,2,8809,4260,4549,0,0,0,1.0,1,1.0,1,1.0,1,0.3108413180603655,53
5334,3,8812,4261,4551,0,0,0,1.0,1,1.0,1,1.0,1,0.3301389210658714,54
5335,3,8815,4261,4554,0,0,0,1.0,1,1.0,1,1.0,1,0.28936825850797165,55
5336,0,8815,4261,4554,0,0,0,1.0,1,1.0,1,1.0,1,0.2907907938333707,54
5337,1,8816,4261,4555,0,0,0,1.0,1,1.0,1,1.0,1,0.2889686442243234,55
5338,1,8817,4262,4555,0,0,0,1.0,1,1.0,1,1.0,1,0.3071645872912808,55
5339,1,8818,4262,4556,0,0,0,1.0,1,1.0,1,1.0,1,0.2964896831673582,55
5340,0,8818,4262,4556,0,0,0,1.0,1,1.0,1,1.0,1,0.2964896831673582,55
5341,2,8820,4262,4558,0,0,0,1.0,1,1.0,1,1.0,1,0.3247163722972526,54
5342,2,8822,4263,4559,0,0,0,1.0,1,1.0,1,1.0,1,0.3291853578584534,55
5343,3,8825,4265,4560,0,0,0,1.0,1,1.0,1,1.0,1,0.33964798562840987,54
5344,2,8827,4267,4560,0,0,0,1.0,1,1.0,1,1.0,1,0.3617333606794578,55
5345,1,8828,4267,4561,0,0,0,1.0,1,1.0,1,1.0,1,0.3350509727447346,53
5346,2,8830,4268,4562,0,0,0,1.0,1,1.0,1,1.0,1,0.33079960995346236,53
5347,3,8833,4269,4564,0,0,0,1.0,1,1.0,1,1.0,1,0.3412798835533883,51
5348,5,8838,4270,4568,0,0,0,1.0,1,1.0,1,1.0,1,0.30481552596815137,53
5349,6,8844,4273,4571,0,0,0,1.0,1,1.0,1,1.0,1,0.3010527226453805,52
5350,1,8845,4274,4571,0,0,0,1.0,1,1.0,1,1.0,1,0.29586815048892195,50
5351,6,8851,4276,4575,0,0,0,1.0,1,1.0,1,1.0,1,0.29808454059034617,52
5352,2,8853,4277,4576,0,0,0,1.0,1,1.0,1,1.0,1,0.28131030913298133,49
5353,1,8854,4277,4577,0,0,0,1.0,1,1.0,1,1.0,1,0.24828821290468936,49
5354,1,8855,4278,4577,0,0,0,1.0,1,1.0,1,1.0,1,0.2612083139607822,49
5355,0,8855,4278,4577,0,0,0,1.0,1,1.0,1,1.0,1,0.24952207026670126,48
5356,1,8856,4278,4578,0,0,0,1.0,1,1.0,1,1.0,1,0.23249644883662385,49
5357,0,8856,4278,4578,0,0,0,1.0,1,1.0,1,1.0,1,0.23572210307420746,47
5358,2,8858,4279,4579,0,0,0,1.0,1,1.0,1,1.0,1,0.24202487276015341,48
5359,0,8858,4279,4579,0,0,0,1.0,1,1.0,1,1.0,1,0.24202487276015341,48
5360,1,8859,4279,4580,0,0,0,1.0,1,1.0,1,1.0,1,0.21968498808404258,48
5361,1,8860,4279,4581,0,0,0,1.0,1,1.0,1,1.0,1,0.22904374265794505,50
5362,0,8860,4279,4581,0,0,0,1.0,1,1.0,1,1.0,1,0.22904374265794505,50
5363,0,8860,4279,4581,0,0,0,1.0,1,1.0,1,1.0,1,0.22904374265794505,50
5364,1,8861,4280,4581,0,0,0,1.0,1,1.0,1,1.0,1,0.22282429202872153,51
5365,0,8861,4280,4581,0,0,0,1.0,1,1.0,1,1.0,1,0.2332994535255113,52
5366,1,8862,4280,4582,0,0,0,1.0,1,1.0,1,1.0,1,0.21219830967526498,52
5367,2,8864,4281,4583,0,0,0,1.0,1,1.0,1,1.0,1,0.22672402508237333,54
5368,4,8868,4282,4586,0,0,0,1.0,1,1.0,1,1.0,1,0.21839859162440065,55
5369,2,8870,4282,4588,0,0,0,1.0,1,1.0,1,1.0,1,0.18990404561111976,53
5370,5,8875,4284,4591,0,0,0,1.0,1,1.0,1,1.0,1,0.20263216973192902,54
5371,3,8878,4286,4592,0,0,0,1.0,1,1.0,1,1.0,1,0.1940680747405519,53
5372,4,8882,4288,4594,0,0,0,1.0,1,1.0,1,1.0,1,0.2309038045272451,53
5373,0,8882,4288,4594,0,0,0,1.0,1,1.0,1,1.0,1,0.22334502668695014,52
5374,0,8882,4288,4594,0,0,0,1.0,1,1.0,1,1.0,1,0.23680816359864235,51
5375,2,8884,4289,4595,0,0,0,1.0,1,1.0,1,1.0,1,0.19210788863650677,52
5376,2,8886,4291,4595,0,0,0,1.0,1,1.0,1,1.0,1,0.26387078797708735,51
5377,1,8887,4291,4596,0,0,0,1.0,1,1.0,1,1.0,1,0.26999524023458304,52
5378,4,8891,4293,4598,0,0,0,1.0,1,1.0,1,1.0,1,0.27537599412523917,50
5379,0,8891,4293,4598,0,0,0,1.0,1,1.0,1,1.0,1,0.27537599412523917,50
5380,2,8893,4293,4600,0,0,0,1.0,1,1.0,1,1.0,1,0.2709877417186209,52
5381,0,8893,4293,4600,0,0,0,1.0,1,1.0,1,1.0,1,0.2709877417186209,52
5382,0,8893,4293,4600,0,0,0,1.0,1,1.0,1,1.0,1,0.27060785844414376,52
5383,1,8894,4293,4601,0,0,0,1.0,1,1.0,1,1.0,1,0.22182645610825366,51
5384,3,8897,4294,4603,0,0,0,1.0,1,1.0,1,1.0,1,0.22406545273520037,52
5385,2,8899,4295,4604,0,0,0,1.0,1,1.0,1,1.0,1,0.24258678578360163,51
5386,6,8905,4297,4608,0,0,0,1.0,1,1.0,1,1.0,1,0.18537126444311003,52
5387,4,8909,4298,4611,0,0,0,1.0,1,1.0,1,1.0,1,0.1310092587169331,53
5388,0,8909,4298,4611,0,0,0,1.0,1,1.0,1,1.0,1,0.12912066297194993,54
5389,2,8911,4299,4612,0,0,0,1.0,1,1.0,1,1.0,1,0.10782449467740454,55
5390,1,8912,4300,4612,0,0,0,1.0,1,1.0,1,1.0,1,0.12147272425673304,56
5391,2,8914,4301,4613,0,0,0,1.0,1,1.0,1,1.0,1,0.1177809474605493,56
5392,3,8917,4304,4613,0,0,0,1.0,1,1.0,1,1.0,1,0.1380602209010913,56
5393,3,8920,4305,4615,0,0,0,1.0,1,1.0,1,1.0,1,0.13634861459043424,54
5394,1,8921,4306,4615,0,0,0,1.0,1,1.0,1,1.0,1,0.15013922075957048,53
5395,2,8923,4308,4615,0,0,0,1.0,1,1.0,1,1.0,1,0.20723674635087502,53
5396,1,8924,4308,4616,0,0,0,1.0,1,1.0,1,1.0,1,0.1948725759678536,54
5397,2,8926,4310,4616,0,0,0,1.0,1,1.0,1,1.0,1,0.2032924359028924,53
5398,1,8927,4310,4617,0,0,0,1.0,1,1.0,1,1.0,1,0.18299223311094487,53
5399,6,8933,4313,4620,0,0,0,1.0,1,1.0,1,1.0,1,0.18635509820102414,55
5400,3,8936,4313,4623,0,0,0,1.0,1,1.0,1,1.0,1,0.14419268476531885,55
5401,2,8938,4315,4623,0,0,0,1.0,1,1.0,1,1.0,1,0.19541012987819534,56
5402,0,8938,4315,4623,0,0,0,1.0,1,1.0,1,1.0,1,0.0,0
