,SuccessfulHandoverCount,TotalSuccessfulHandoverCount,TotalSuccessfulHandoverCountRange,TotalSuccessfulHandoverCountLoadBalancing,TotalSuccessfulHandoverCountOverload,FailedHandoverCount,TotalFailedHandoverCount,AvgQoS,MinQoS,AvgQoS_LoadBased,MinQoS_LoadBased,AvgQoS_RangeBased,MinQoS_RangeBased,GiniLoad,VehicleCount
0,0,0,0,0,0,0,0,1.0,1,1.0,1,1.0,1,0.0,0
1,0,0,0,0,0,0,0,1.0,1,1.0,1,1.0,1,0.5618419291985421,30
2,1,1,1,0,0,0,0,1.0,1,1.0,1,1.0,1,0.4959545183761622,32
3,7,8,8,0,0,0,0,1.0,1,1.0,1,1.0,1,0.6000191751321766,33
4,0,8,8,0,0,0,0,1.0,1,1.0,1,1.0,1,0.5791044429584261,34
5,3,11,11,0,0,0,0,1.0,1,1.0,1,1.0,1,0.5906427317156,36
6,3,14,14,0,0,0,0,1.0,1,1.0,1,1.0,1,0.5803256644866758,38
7,2,16,16,0,0,0,0,1.0,1,1.0,1,1.0,1,0.5337330393029686,40
8,6,22,22,0,0,0,0,1.0,1,1.0,1,1.0,1,0.49671682671103196,40
9,3,25,25,0,0,0,0,1.0,1,1.0,1,1.0,1,0.530157391025011,40
10,1,26,26,0,0,0,0,1.0,1,1.0,1,1.0,1,0.5116346076008764,41
11,1,27,27,0,0,0,0,1.0,1,1.0,1,1.0,1,0.4822097443689393,40
12,0,27,27,0,0,0,0,1.0,1,1.0,1,1.0,1,0.48283727279712635,39
13,1,28,28,0,0,0,0,1.0,1,1.0,1,1.0,1,0.487916286562022,37
14,1,29,29,0,0,0,0,1.0,1,1.0,1,1.0,1,0.47643172640113096,35
15,4,33,33,0,0,0,0,1.0,1,1.0,1,1.0,1,0.48382083867103637,36
16,0,33,33,0,0,0,0,1.0,1,1.0,1,1.0,1,0.5014200617111738,34
17,2,35,35,0,0,0,0,1.0,1,1.0,1,1.0,1,0.5403414766035671,33
18,1,36,36,0,0,0,0,1.0,1,1.0,1,1.0,1,0.5151380738426401,34
19,5,41,41,0,0,0,0,1.0,1,1.0,1,1.0,1,0.47754240401800524,34
20,1,42,42,0,0,0,0,1.0,1,1.0,1,1.0,1,0.4786640898635458,34
21,6,48,48,0,0,0,0,1.0,1,1.0,1,1.0,1,0.4508408481967432,36
22,2,50,50,0,0,0,0,1.0,1,1.0,1,1.0,1,0.4465471391910543,35
23,3,53,53,0,0,0,0,1.0,1,1.0,1,1.0,1,0.4981911258633249,35
24,6,59,59,0,0,0,0,1.0,1,1.0,1,1.0,1,0.4947287062285124,35
25,1,60,60,0,0,0,0,1.0,1,1.0,1,1.0,1,0.49819180034602045,35
26,5,65,65,0,0,0,0,1.0,1,1.0,1,1.0,1,0.528853929477782,36
27,2,67,67,0,0,0,0,1.0,1,1.0,1,1.0,1,0.5537731878248735,34
28,4,71,71,0,0,0,0,1.0,1,1.0,1,1.0,1,0.5137642006985882,35
29,1,72,72,0,0,0,0,1.0,1,1.0,1,1.0,1,0.519808587693272,33
30,2,74,74,0,0,0,0,1.0,1,1.0,1,1.0,1,0.4842687917300431,33
31,1,75,75,0,0,0,0,1.0,1,1.0,1,1.0,1,0.5305499165462457,33
32,1,76,76,0,0,0,0,1.0,1,1.0,1,1.0,1,0.5561126730177752,32
33,2,78,78,0,0,0,0,1.0,1,1.0,1,1.0,1,0.5773024483800008,33
34,3,81,81,0,0,0,0,1.0,1,1.0,1,1.0,1,0.6092721619301988,33
35,1,82,82,0,0,0,0,1.0,1,1.0,1,1.0,1,0.6137555464599347,35
36,2,84,84,0,0,0,0,1.0,1,1.0,1,1.0,1,0.6081448445009285,36
37,1,85,85,0,0,0,0,1.0,1,1.0,1,1.0,1,0.6023031600444783,37
38,1,86,86,0,0,0,0,1.0,1,1.0,1,1.0,1,0.6385879314626541,36
39,2,88,88,0,0,0,0,1.0,1,1.0,1,1.0,1,0.6028489999657662,38
40,1,89,89,0,0,0,0,1.0,1,1.0,1,1.0,1,0.578382207075402,40
41,1,90,90,0,0,0,0,1.0,1,1.0,1,1.0,1,0.5688056119681841,40
42,3,93,93,0,0,0,0,1.0,1,1.0,1,1.0,1,0.5725515612675159,40
43,1,94,94,0,0,0,0,1.0,1,1.0,1,1.0,1,0.5714912710447834,43
44,2,96,96,0,0,0,0,1.0,1,1.0,1,1.0,1,0.570703913283447,43
45,0,96,96,0,0,0,0,1.0,1,1.0,1,1.0,1,0.5603568114196733,44
46,2,98,98,0,0,0,0,1.0,1,1.0,1,1.0,1,0.5741746257524581,44
47,0,98,98,0,0,0,0,1.0,1,1.0,1,1.0,1,0.5741746257524581,44
48,1,99,99,0,0,0,0,1.0,1,1.0,1,1.0,1,0.5886938929141431,44
49,1,100,100,0,0,0,0,1.0,1,1.0,1,1.0,1,0.5778522906661128,41
50,3,103,103,0,0,0,0,1.0,1,1.0,1,1.0,1,0.571712710550155,40
51,0,103,103,0,0,0,0,1.0,1,1.0,1,1.0,1,0.5535062875332553,38
52,3,106,106,0,0,0,0,1.0,1,1.0,1,1.0,1,0.5516935212029375,37
53,3,109,109,0,0,0,0,1.0,1,1.0,1,1.0,1,0.5650406190486537,38
54,5,114,114,0,0,0,0,1.0,1,1.0,1,1.0,1,0.6141250851852352,38
55,4,118,118,0,0,0,0,1.0,1,1.0,1,1.0,1,0.6041543606735255,38
56,5,123,123,0,0,0,0,1.0,1,1.0,1,1.0,1,0.6433433005208448,38
57,4,127,127,0,0,0,0,1.0,1,1.0,1,1.0,1,0.6051301611415574,38
58,3,130,130,0,0,0,0,1.0,1,1.0,1,1.0,1,0.5802866391710106,38
59,2,132,132,0,0,0,0,1.0,1,1.0,1,1.0,1,0.5682664042155948,40
60,3,135,135,0,0,0,0,1.0,1,1.0,1,1.0,1,0.5667388469570385,40
61,1,136,136,0,0,0,0,1.0,1,1.0,1,1.0,1,0.5760641035114635,40
62,2,138,138,0,0,0,0,1.0,1,1.0,1,1.0,1,0.5728565303342149,42
63,1,139,139,0,0,0,0,1.0,1,1.0,1,1.0,1,0.6005178453706869,40
64,2,141,141,0,0,0,0,1.0,1,1.0,1,1.0,1,0.6053027132241842,41
65,1,142,142,0,0,0,0,1.0,1,1.0,1,1.0,1,0.5920452289236074,41
66,2,144,144,0,0,0,0,1.0,1,1.0,1,1.0,1,0.6096940391713748,41
67,0,144,144,0,0,0,0,1.0,1,1.0,1,1.0,1,0.6096940391713748,41
68,1,145,145,0,0,0,0,1.0,1,1.0,1,1.0,1,0.5723911723013327,41
69,4,149,149,0,0,0,0,1.0,1,1.0,1,1.0,1,0.53367665783035,41
70,3,152,152,0,0,0,0,1.0,1,1.0,1,1.0,1,0.5431503314526414,42
71,1,153,153,0,0,0,0,1.0,1,1.0,1,1.0,1,0.5026671462861525,44
72,2,155,155,0,0,0,0,1.0,1,1.0,1,1.0,1,0.524811454767739,44
73,2,157,157,0,0,0,0,1.0,1,1.0,1,1.0,1,0.5316557058519705,46
74,1,158,158,0,0,0,0,1.0,1,1.0,1,1.0,1,0.5369973117097108,44
75,5,163,163,0,0,0,0,1.0,1,1.0,1,1.0,1,0.49359935438547425,44
76,1,164,164,0,0,0,0,1.0,1,1.0,1,1.0,1,0.48713924835239836,45
77,6,170,170,0,0,0,0,1.0,1,1.0,1,1.0,1,0.4527078547949429,44
78,2,172,172,0,0,0,0,1.0,1,1.0,1,1.0,1,0.44441955029325486,44
79,4,176,176,0,0,0,0,1.0,1,1.0,1,1.0,1,0.49646701411077304,43
80,3,179,179,0,0,0,0,1.0,1,1.0,1,1.0,1,0.49684469443537704,43
81,5,184,184,0,0,0,0,1.0,1,1.0,1,1.0,1,0.503020760590359,44
82,3,187,187,0,0,0,0,1.0,1,1.0,1,1.0,1,0.4593123268021822,45
83,3,190,190,0,0,0,0,1.0,1,1.0,1,1.0,1,0.4867793752277482,45
84,3,193,193,0,0,0,0,1.0,1,1.0,1,1.0,1,0.4609973302258559,45
85,1,194,194,0,0,0,0,1.0,1,1.0,1,1.0,1,0.4793721652418829,45
86,0,194,194,0,0,0,0,1.0,1,1.0,1,1.0,1,0.4793721652418829,45
87,2,196,196,0,0,0,0,1.0,1,1.0,1,1.0,1,0.5162549940124799,44
88,1,197,197,0,0,0,0,1.0,1,1.0,1,1.0,1,0.4970546732877459,45
89,1,198,198,0,0,0,0,1.0,1,1.0,1,1.0,1,0.5056519628620956,46
90,1,199,199,0,0,0,0,1.0,1,1.0,1,1.0,1,0.5105186366329673,44
91,0,199,199,0,0,0,0,1.0,1,1.0,1,1.0,1,0.49829630769956956,45
92,2,201,201,0,0,0,0,1.0,1,1.0,1,1.0,1,0.48245232356411777,46
93,2,203,203,0,0,0,0,1.0,1,1.0,1,1.0,1,0.5406509904742315,46
94,4,207,207,0,0,0,0,1.0,1,1.0,1,1.0,1,0.5145816293129406,46
95,0,207,207,0,0,0,0,1.0,1,1.0,1,1.0,1,0.5212217587972422,46
96,2,209,209,0,0,0,0,1.0,1,1.0,1,1.0,1,0.5194164060603365,46
97,1,210,210,0,0,0,0,1.0,1,1.0,1,1.0,1,0.5375632534025712,47
98,2,212,212,0,0,0,0,1.0,1,1.0,1,1.0,1,0.5329427707548773,47
99,4,216,216,0,0,0,0,1.0,1,1.0,1,1.0,1,0.5107737072133087,46
100,2,218,218,0,0,0,0,1.0,1,1.0,1,1.0,1,0.54865765024733,48
101,1,219,219,0,0,0,0,1.0,1,1.0,1,1.0,1,0.5685618383552616,49
102,3,222,222,0,0,0,0,1.0,1,1.0,1,1.0,1,0.5690731296149965,49
103,4,226,226,0,0,0,0,1.0,1,1.0,1,1.0,1,0.5699858428338862,48
104,2,228,228,0,0,0,0,1.0,1,1.0,1,1.0,1,0.6154063002395694,49
105,3,231,231,0,0,0,0,1.0,1,1.0,1,1.0,1,0.566512575780739,48
106,3,234,234,0,0,0,0,1.0,1,1.0,1,1.0,1,0.5818041773824075,48
107,2,236,236,0,0,0,0,1.0,1,1.0,1,1.0,1,0.5729255718867389,47
108,7,243,243,0,0,0,0,1.0,1,1.0,1,1.0,1,0.569966159690662,47
109,2,245,245,0,0,0,0,1.0,1,1.0,1,1.0,1,0.5830604199518468,47
110,8,253,253,0,0,0,0,1.0,1,1.0,1,1.0,1,0.604397458582923,47
111,5,258,258,0,0,0,0,1.0,1,1.0,1,1.0,1,0.5815123940061757,46
112,8,266,266,0,0,0,0,1.0,1,1.0,1,1.0,1,0.606887581645003,46
113,4,270,270,0,0,0,0,1.0,1,1.0,1,1.0,1,0.616458140752397,45
114,4,274,274,0,0,0,0,1.0,1,1.0,1,1.0,1,0.5905020719205955,46
115,2,276,276,0,0,0,0,1.0,1,1.0,1,1.0,1,0.5704753140681917,47
116,2,278,278,0,0,0,0,1.0,1,1.0,1,1.0,1,0.5413561637029686,48
117,2,280,280,0,0,0,0,1.0,1,1.0,1,1.0,1,0.5271436407791906,48
118,1,281,281,0,0,0,0,1.0,1,1.0,1,1.0,1,0.5010032892525463,49
119,0,281,281,0,0,0,0,1.0,1,1.0,1,1.0,1,0.500241529639185,50
120,1,282,282,0,0,0,0,1.0,1,1.0,1,1.0,1,0.46649431278699427,51
121,0,282,282,0,0,0,0,1.0,1,1.0,1,1.0,1,0.46649431278699427,51
122,1,283,283,0,0,0,0,1.0,1,1.0,1,1.0,1,0.47086057395644826,51
123,1,284,284,0,0,0,0,1.0,1,1.0,1,1.0,1,0.47416795559147834,51
124,3,287,287,0,0,0,0,1.0,1,1.0,1,1.0,1,0.4858837184023085,51
125,2,289,289,0,0,0,0,1.0,1,1.0,1,1.0,1,0.50551736534638,50
126,4,293,293,0,0,0,0,1.0,1,1.0,1,1.0,1,0.5054323473878207,52
127,4,297,297,0,0,0,0,1.0,1,1.0,1,1.0,1,0.5054007927775278,50
128,0,297,297,0,0,0,0,1.0,1,1.0,1,1.0,1,0.5054007927775278,50
129,3,300,300,0,0,0,0,1.0,1,1.0,1,1.0,1,0.48913894907635824,52
130,3,303,303,0,0,0,0,1.0,1,1.0,1,1.0,1,0.5166602327593142,52
131,3,306,306,0,0,0,0,1.0,1,1.0,1,1.0,1,0.5012592229186816,54
132,5,311,311,0,0,0,0,1.0,1,1.0,1,1.0,1,0.5291812729747832,54
133,2,313,313,0,0,0,0,1.0,1,1.0,1,1.0,1,0.5396789219357688,52
134,4,317,317,0,0,0,0,1.0,1,1.0,1,1.0,1,0.5462176964571781,52
135,3,320,320,0,0,0,0,1.0,1,1.0,1,1.0,1,0.5374451706781144,51
136,4,324,324,0,0,0,0,1.0,1,1.0,1,1.0,1,0.537338179868455,51
137,4,328,328,0,0,0,0,1.0,1,1.0,1,1.0,1,0.5561773050281054,50
138,1,329,329,0,0,0,0,1.0,1,1.0,1,1.0,1,0.55214223675863,52
139,6,335,335,0,0,0,0,1.0,1,1.0,1,1.0,1,0.5275582646977622,51
140,2,337,337,0,0,0,0,1.0,1,1.0,1,1.0,1,0.5192877437239569,51
141,3,340,340,0,0,0,0,1.0,1,1.0,1,1.0,1,0.5042220179947268,50
142,6,346,346,0,0,0,0,1.0,1,1.0,1,1.0,1,0.532864275851197,51
143,3,349,349,0,0,0,0,1.0,1,1.0,1,1.0,1,0.5390868762375295,48
144,3,352,352,0,0,0,0,1.0,1,1.0,1,1.0,1,0.5365430478242942,49
145,3,355,355,0,0,0,0,1.0,1,1.0,1,1.0,1,0.5723220378663458,47
146,3,358,358,0,0,0,0,1.0,1,1.0,1,1.0,1,0.5950493406456182,49
147,4,362,362,0,0,0,0,1.0,1,1.0,1,1.0,1,0.6210243777864535,46
148,2,364,364,0,0,0,0,1.0,1,1.0,1,1.0,1,0.5828033127510248,47
149,4,368,368,0,0,0,0,1.0,1,1.0,1,1.0,1,0.5637347018122625,46
150,1,369,369,0,0,0,0,1.0,1,1.0,1,1.0,1,0.541264761857444,47
151,3,372,372,0,0,0,0,1.0,1,1.0,1,1.0,1,0.5639983870606362,46
152,2,374,374,0,0,0,0,1.0,1,1.0,1,1.0,1,0.5805350145443611,45
153,3,377,377,0,0,0,0,1.0,1,1.0,1,1.0,1,0.5676083015180564,46
154,2,379,379,0,0,0,0,1.0,1,1.0,1,1.0,1,0.5951076681532239,44
155,3,382,382,0,0,0,0,1.0,1,1.0,1,1.0,1,0.5850608794143007,45
156,3,385,385,0,0,0,0,1.0,1,1.0,1,1.0,1,0.6211046973035519,43
157,4,389,389,0,0,0,0,1.0,1,1.0,1,1.0,1,0.637099179358662,42
158,3,392,392,0,0,0,0,1.0,1,1.0,1,1.0,1,0.6425480053678077,43
159,4,396,396,0,0,0,0,1.0,1,1.0,1,1.0,1,0.6301111353833895,44
160,4,400,400,0,0,0,0,1.0,1,1.0,1,1.0,1,0.6356863859423634,44
161,5,405,405,0,0,0,0,1.0,1,1.0,1,1.0,1,0.6620762412024146,44
162,2,407,407,0,0,0,0,1.0,1,1.0,1,1.0,1,0.6528637942811782,44
163,6,413,413,0,0,0,0,1.0,1,1.0,1,1.0,1,0.6562316800482136,44
164,2,415,415,0,0,0,0,1.0,1,1.0,1,1.0,1,0.6564584992973582,44
165,4,419,419,0,0,0,0,1.0,1,1.0,1,1.0,1,0.63026544456018,43
166,3,422,422,0,0,0,0,1.0,1,1.0,1,1.0,1,0.6168867381663364,43
167,3,425,425,0,0,0,0,1.0,1,1.0,1,1.0,1,0.5907857555182932,42
168,1,426,426,0,0,0,0,1.0,1,1.0,1,1.0,1,0.5898358187378548,40
169,4,430,430,0,0,0,0,1.0,1,1.0,1,1.0,1,0.5827412198004552,41
170,0,430,430,0,0,0,0,1.0,1,1.0,1,1.0,1,0.5710013133369799,39
171,3,433,433,0,0,0,0,1.0,1,1.0,1,1.0,1,0.5763322066863481,39
172,0,433,433,0,0,0,0,1.0,1,1.0,1,1.0,1,0.5692571900308123,38
173,3,436,436,0,0,0,0,1.0,1,1.0,1,1.0,1,0.6018514330840745,38
174,2,438,438,0,0,0,0,1.0,1,1.0,1,1.0,1,0.5760062931793626,37
175,3,441,441,0,0,0,0,1.0,1,1.0,1,1.0,1,0.5713951571621525,36
176,2,443,443,0,0,0,0,1.0,1,1.0,1,1.0,1,0.5734641425104536,36
177,1,444,444,0,0,0,0,1.0,1,1.0,1,1.0,1,0.5627535834946652,38
178,3,447,447,0,0,0,0,1.0,1,1.0,1,1.0,1,0.5358182734018823,39
179,3,450,450,0,0,0,0,1.0,1,1.0,1,1.0,1,0.5560210078656788,40
180,1,451,451,0,0,0,0,1.0,1,1.0,1,1.0,1,0.5568864120433766,40
181,1,452,452,0,0,0,0,1.0,1,1.0,1,1.0,1,0.5768629211758225,39
182,3,455,455,0,0,0,0,1.0,1,1.0,1,1.0,1,0.5461366645439362,40
183,6,461,461,0,0,0,0,1.0,1,1.0,1,1.0,1,0.5612156270566407,40
184,4,465,465,0,0,0,0,1.0,1,1.0,1,1.0,1,0.564290600675659,38
185,6,471,471,0,0,0,0,1.0,1,1.0,1,1.0,1,0.5748733905015113,38
186,4,475,475,0,0,0,0,1.0,1,1.0,1,1.0,1,0.6019867019786048,37
187,2,477,477,0,0,0,0,1.0,1,1.0,1,1.0,1,0.6306980706872582,36
188,2,479,479,0,0,0,0,1.0,1,1.0,1,1.0,1,0.6082158505452362,36
189,5,484,484,0,0,0,0,1.0,1,1.0,1,1.0,1,0.5812693827319232,36
190,2,486,486,0,0,0,0,1.0,1,1.0,1,1.0,1,0.581878824879633,36
191,2,488,488,0,0,0,0,1.0,1,1.0,1,1.0,1,0.5990520995284925,37
192,4,492,492,0,0,0,0,1.0,1,1.0,1,1.0,1,0.61904754665964,37
193,2,494,494,0,0,0,0,1.0,1,1.0,1,1.0,1,0.6344126848232865,38
194,3,497,497,0,0,0,0,1.0,1,1.0,1,1.0,1,0.6590613916513224,39
195,2,499,499,0,0,0,0,1.0,1,1.0,1,1.0,1,0.6379545137917363,40
196,4,503,503,0,0,0,0,1.0,1,1.0,1,1.0,1,0.6244802275662782,40
197,4,507,507,0,0,0,0,1.0,1,1.0,1,1.0,1,0.5982566579429671,40
198,3,510,510,0,0,0,0,1.0,1,1.0,1,1.0,1,0.6076190746527645,40
199,2,512,512,0,0,0,0,1.0,1,1.0,1,1.0,1,0.6289712549625575,40
200,3,515,515,0,0,0,0,1.0,1,1.0,1,1.0,1,0.6356072577549265,40
201,0,515,515,0,0,0,0,1.0,1,1.0,1,1.0,1,0.6273003242469891,39
202,3,518,518,0,0,0,0,1.0,1,1.0,1,1.0,1,0.5930072588516206,40
203,2,520,520,0,0,0,0,1.0,1,1.0,1,1.0,1,0.5714825408310743,39
204,1,521,521,0,0,0,0,1.0,1,1.0,1,1.0,1,0.5667545557733691,38
205,3,524,524,0,0,0,0,1.0,1,1.0,1,1.0,1,0.568993700255851,37
206,1,525,525,0,0,0,0,1.0,1,1.0,1,1.0,1,0.5256479747122097,36
207,2,527,527,0,0,0,0,1.0,1,1.0,1,1.0,1,0.5373192323662009,37
208,1,528,528,0,0,0,0,1.0,1,1.0,1,1.0,1,0.4926894937657263,36
209,0,528,528,0,0,0,0,1.0,1,1.0,1,1.0,1,0.4926894937657263,36
210,4,532,532,0,0,0,0,1.0,1,1.0,1,1.0,1,0.46823581174543333,36
211,1,533,533,0,0,0,0,1.0,1,1.0,1,1.0,1,0.5020976921565209,34
212,6,539,539,0,0,0,0,1.0,1,1.0,1,1.0,1,0.5298558899375754,34
213,4,543,543,0,0,0,0,1.0,1,1.0,1,1.0,1,0.5253235142345402,36
214,4,547,547,0,0,0,0,1.0,1,1.0,1,1.0,1,0.591399813223,35
215,3,550,550,0,0,0,0,1.0,1,1.0,1,1.0,1,0.5990201042440244,35
216,3,553,553,0,0,0,0,1.0,1,1.0,1,1.0,1,0.6048715539900603,37
217,2,555,555,0,0,0,0,1.0,1,1.0,1,1.0,1,0.6285020885060113,37
218,3,558,558,0,0,0,0,1.0,1,1.0,1,1.0,1,0.6455658907409204,37
219,5,563,563,0,0,0,0,1.0,1,1.0,1,1.0,1,0.582865068561501,37
220,5,568,568,0,0,0,0,1.0,1,1.0,1,1.0,1,0.5592219592405487,38
221,5,573,573,0,0,0,0,1.0,1,1.0,1,1.0,1,0.5371521224297017,39
222,3,576,576,0,0,0,0,1.0,1,1.0,1,1.0,1,0.5169884839296116,39
223,4,580,580,0,0,0,0,1.0,1,1.0,1,1.0,1,0.5241932763114523,40
224,6,586,586,0,0,0,0,1.0,1,1.0,1,1.0,1,0.5371952710310145,40
225,1,587,587,0,0,0,0,1.0,1,1.0,1,1.0,1,0.5697848678227326,39
226,5,592,592,0,0,0,0,1.0,1,1.0,1,1.0,1,0.5397001089602496,39
227,3,595,595,0,0,0,0,1.0,1,1.0,1,1.0,1,0.5091858466603854,39
228,3,598,598,0,0,0,0,1.0,1,1.0,1,1.0,1,0.5186129879898819,38
229,2,600,600,0,0,0,0,1.0,1,1.0,1,1.0,1,0.5098915787607714,39
230,4,604,604,0,0,0,0,1.0,1,1.0,1,1.0,1,0.5640933213566477,38
231,3,607,607,0,0,0,0,1.0,1,1.0,1,1.0,1,0.5640651112573848,38
232,2,609,609,0,0,0,0,1.0,1,1.0,1,1.0,1,0.5610457310274949,37
233,2,611,611,0,0,0,0,1.0,1,1.0,1,1.0,1,0.5620087159608758,36
234,3,614,614,0,0,0,0,1.0,1,1.0,1,1.0,1,0.6138746904209792,34
235,1,615,615,0,0,0,0,1.0,1,1.0,1,1.0,1,0.640261026243131,34
236,1,616,616,0,0,0,0,1.0,1,1.0,1,1.0,1,0.6367594392993249,33
237,2,618,618,0,0,0,0,1.0,1,1.0,1,1.0,1,0.6275952255079651,32
238,2,620,620,0,0,0,0,1.0,1,1.0,1,1.0,1,0.6183770576527154,32
239,0,620,620,0,0,0,0,1.0,1,1.0,1,1.0,1,0.5751180643518898,31
240,2,622,622,0,0,0,0,1.0,1,1.0,1,1.0,1,0.6473759107933381,28
241,1,623,623,0,0,0,0,1.0,1,1.0,1,1.0,1,0.654854862718104,27
242,1,624,624,0,0,0,0,1.0,1,1.0,1,1.0,1,0.6267846856538432,29
243,3,627,627,0,0,0,0,1.0,1,1.0,1,1.0,1,0.6604451214335317,28
244,2,629,629,0,0,0,0,1.0,1,1.0,1,1.0,1,0.6126277440264601,28
245,2,631,631,0,0,0,0,1.0,1,1.0,1,1.0,1,0.6208543364987571,27
246,2,633,633,0,0,0,0,1.0,1,1.0,1,1.0,1,0.6501075362680696,25
247,0,633,633,0,0,0,0,1.0,1,1.0,1,1.0,1,0.6081767702198628,26
248,4,637,637,0,0,0,0,1.0,1,1.0,1,1.0,1,0.5855283466835682,27
249,2,639,639,0,0,0,0,1.0,1,1.0,1,1.0,1,0.5999844073203154,26
250,1,640,640,0,0,0,0,1.0,1,1.0,1,1.0,1,0.6442160229609103,27
251,3,643,643,0,0,0,0,1.0,1,1.0,1,1.0,1,0.6859236307184771,28
252,0,643,643,0,0,0,0,1.0,1,1.0,1,1.0,1,0.6859236307184771,28
253,4,647,647,0,0,0,0,1.0,1,1.0,1,1.0,1,0.6587811206213834,28
254,0,647,647,0,0,0,0,1.0,1,1.0,1,1.0,1,0.6691529881401413,29
255,1,648,648,0,0,0,0,1.0,1,1.0,1,1.0,1,0.6607733290286028,30
256,2,650,650,0,0,0,0,1.0,1,1.0,1,1.0,1,0.6399335245548281,30
257,1,651,651,0,0,0,0,1.0,1,1.0,1,1.0,1,0.6421449429810367,32
258,2,653,653,0,0,0,0,1.0,1,1.0,1,1.0,1,0.601805795818601,32
259,1,654,654,0,0,0,0,1.0,1,1.0,1,1.0,1,0.6140294276397293,32
260,3,657,657,0,0,0,0,1.0,1,1.0,1,1.0,1,0.6639575615025629,34
261,1,658,658,0,0,0,0,1.0,1,1.0,1,1.0,1,0.67465643968273,35
262,1,659,659,0,0,0,0,1.0,1,1.0,1,1.0,1,0.6946852244310229,36
263,0,659,659,0,0,0,0,1.0,1,1.0,1,1.0,1,0.6965098074925719,34
264,0,659,659,0,0,0,0,1.0,1,1.0,1,1.0,1,0.6965098074925719,34
265,1,660,660,0,0,0,0,1.0,1,1.0,1,1.0,1,0.6938645028715028,33
266,0,660,660,0,0,0,0,1.0,1,1.0,1,1.0,1,0.6736422552291231,34
267,1,661,661,0,0,0,0,1.0,1,1.0,1,1.0,1,0.6921052907807757,33
268,2,663,663,0,0,0,0,1.0,1,1.0,1,1.0,1,0.7190107387548195,34
269,0,663,663,0,0,0,0,1.0,1,1.0,1,1.0,1,0.7190107387548195,34
270,0,663,663,0,0,0,0,1.0,1,1.0,1,1.0,1,0.7170114012129027,36
271,2,665,665,0,0,0,0,1.0,1,1.0,1,1.0,1,0.7017349060748493,36
272,1,666,666,0,0,0,0,1.0,1,1.0,1,1.0,1,0.698078594538703,38
273,1,667,667,0,0,0,0,1.0,1,1.0,1,1.0,1,0.7195428362588294,38
274,1,668,668,0,0,0,0,1.0,1,1.0,1,1.0,1,0.7378717330332525,38
275,2,670,670,0,0,0,0,1.0,1,1.0,1,1.0,1,0.7298977125864294,38
276,1,671,671,0,0,0,0,1.0,1,1.0,1,1.0,1,0.6923325595857882,39
277,0,671,671,0,0,0,0,1.0,1,1.0,1,1.0,1,0.6889079881996648,38
278,1,672,672,0,0,0,0,1.0,1,1.0,1,1.0,1,0.6809377191788715,38
279,2,674,674,0,0,0,0,1.0,1,1.0,1,1.0,1,0.7028593347147317,38
280,0,674,674,0,0,0,0,1.0,1,1.0,1,1.0,1,0.7048696641636766,38
281,0,674,674,0,0,0,0,1.0,1,1.0,1,1.0,1,0.6969749850398872,38
282,2,676,676,0,0,0,0,1.0,1,1.0,1,1.0,1,0.7116247808870686,38
283,0,676,676,0,0,0,0,1.0,1,1.0,1,1.0,1,0.7116247808870686,38
284,2,678,678,0,0,0,0,1.0,1,1.0,1,1.0,1,0.7156261419988847,39
285,1,679,679,0,0,0,0,1.0,1,1.0,1,1.0,1,0.7060277560041629,39
286,4,683,683,0,0,0,0,1.0,1,1.0,1,1.0,1,0.6459077068347922,39
287,1,684,684,0,0,0,0,1.0,1,1.0,1,1.0,1,0.6395703130164023,39
288,5,689,689,0,0,0,0,1.0,1,1.0,1,1.0,1,0.5717626072547567,39
289,6,695,695,0,0,0,0,1.0,1,1.0,1,1.0,1,0.5811396376211743,39
290,3,698,698,0,0,0,0,1.0,1,1.0,1,1.0,1,0.5756614637149671,39
291,7,705,705,0,0,0,0,1.0,1,1.0,1,1.0,1,0.6071686049582251,39
292,7,712,712,0,0,0,0,1.0,1,1.0,1,1.0,1,0.5732439309106762,40
293,6,718,718,0,0,0,0,1.0,1,1.0,1,1.0,1,0.598161400633113,41
294,3,721,721,0,0,0,0,1.0,1,1.0,1,1.0,1,0.5924003525089871,40
295,8,729,729,0,0,0,0,1.0,1,1.0,1,1.0,1,0.5195941796084032,42
296,2,731,731,0,0,0,0,1.0,1,1.0,1,1.0,1,0.49170565643098835,42
297,3,734,734,0,0,0,0,1.0,1,1.0,1,1.0,1,0.5062316256359612,43
298,4,738,738,0,0,0,0,1.0,1,1.0,1,1.0,1,0.4633436448026678,44
299,7,745,745,0,0,0,0,1.0,1,1.0,1,1.0,1,0.4570433613137017,44
300,1,746,746,0,0,0,0,1.0,1,1.0,1,1.0,1,0.4789953805720822,45
301,3,749,749,0,0,0,0,1.0,1,1.0,1,1.0,1,0.46366175109261976,47
302,2,751,751,0,0,0,0,1.0,1,1.0,1,1.0,1,0.48100844989755237,46
303,5,756,756,0,0,0,0,1.0,1,1.0,1,1.0,1,0.5076187390319591,45
304,2,758,758,0,0,0,0,1.0,1,1.0,1,1.0,1,0.5427485301904665,45
305,1,759,759,0,0,0,0,1.0,1,1.0,1,1.0,1,0.5213167303225017,43
306,1,760,760,0,0,0,0,1.0,1,1.0,1,1.0,1,0.5508944926109998,44
307,1,761,761,0,0,0,0,1.0,1,1.0,1,1.0,1,0.5699799038226878,42
308,1,762,762,0,0,0,0,1.0,1,1.0,1,1.0,1,0.5847800736947578,41
309,0,762,762,0,0,0,0,1.0,1,1.0,1,1.0,1,0.5897228069907678,42
310,2,764,764,0,0,0,0,1.0,1,1.0,1,1.0,1,0.6420160231492558,41
311,0,764,764,0,0,0,0,1.0,1,1.0,1,1.0,1,0.6420160231492558,41
312,2,766,766,0,0,0,0,1.0,1,1.0,1,1.0,1,0.6320766714158021,44
313,2,768,768,0,0,0,0,1.0,1,1.0,1,1.0,1,0.653845627888347,43
314,1,769,769,0,0,0,0,1.0,1,1.0,1,1.0,1,0.6640170270717662,43
315,2,771,771,0,0,0,0,1.0,1,1.0,1,1.0,1,0.6579106287644417,43
316,0,771,771,0,0,0,0,1.0,1,1.0,1,1.0,1,0.6579106287644417,43
317,3,774,774,0,0,0,0,1.0,1,1.0,1,1.0,1,0.6566690788104194,44
318,1,775,775,0,0,0,0,1.0,1,1.0,1,1.0,1,0.6716615296420866,45
319,1,776,776,0,0,0,0,1.0,1,1.0,1,1.0,1,0.6657816768652861,46
320,0,776,776,0,0,0,0,1.0,1,1.0,1,1.0,1,0.66143846287116,45
321,2,778,778,0,0,0,0,1.0,1,1.0,1,1.0,1,0.6486845029341732,44
322,1,779,779,0,0,0,0,1.0,1,1.0,1,1.0,1,0.648573213148914,42
323,3,782,782,0,0,0,0,1.0,1,1.0,1,1.0,1,0.6675491626073269,42
324,2,784,784,0,0,0,0,1.0,1,1.0,1,1.0,1,0.6753949011835986,43
325,3,787,787,0,0,0,0,1.0,1,1.0,1,1.0,1,0.6669798833379036,43
326,2,789,789,0,0,0,0,1.0,1,1.0,1,1.0,1,0.6588262343716837,43
327,1,790,790,0,0,0,0,1.0,1,1.0,1,1.0,1,0.6695649603082884,44
328,0,790,790,0,0,0,0,1.0,1,1.0,1,1.0,1,0.6695649603082884,44
329,3,793,793,0,0,0,0,1.0,1,1.0,1,1.0,1,0.6874444320142512,45
330,0,793,793,0,0,0,0,1.0,1,1.0,1,1.0,1,0.6762641710439933,46
331,0,793,793,0,0,0,0,1.0,1,1.0,1,1.0,1,0.6762641710439933,46
332,0,793,793,0,0,0,0,1.0,1,1.0,1,1.0,1,0.6628947633052433,47
333,1,794,794,0,0,0,0,1.0,1,1.0,1,1.0,1,0.6707057296025732,48
334,1,795,795,0,0,0,0,1.0,1,1.0,1,1.0,1,0.6590542608463489,48
335,1,796,796,0,0,0,0,1.0,1,1.0,1,1.0,1,0.6383832624412932,49
336,4,800,800,0,0,0,0,1.0,1,1.0,1,1.0,1,0.6283915952189281,50
337,2,802,802,0,0,0,0,1.0,1,1.0,1,1.0,1,0.6241099164717063,51
338,4,806,806,0,0,0,0,1.0,1,1.0,1,1.0,1,0.611898053037508,51
339,3,809,809,0,0,0,0,1.0,1,1.0,1,1.0,1,0.6294454780991515,51
340,2,811,811,0,0,0,0,1.0,1,1.0,1,1.0,1,0.6060475576762377,51
341,3,814,814,0,0,0,0,1.0,1,1.0,1,1.0,1,0.588196711322984,51
342,0,814,814,0,0,0,0,1.0,1,1.0,1,1.0,1,0.588196711322984,51
343,1,815,815,0,0,0,0,1.0,1,1.0,1,1.0,1,0.6065671775402525,51
344,6,821,821,0,0,0,0,1.0,1,1.0,1,1.0,1,0.6409407505332522,50
345,2,823,823,0,0,0,0,1.0,1,1.0,1,1.0,1,0.6489577465616918,50
346,5,828,828,0,0,0,0,1.0,1,1.0,1,1.0,1,0.6578003114199933,50
347,1,829,829,0,0,0,0,1.0,1,1.0,1,1.0,1,0.6592476976756243,51
348,3,832,832,0,0,0,0,1.0,1,1.0,1,1.0,1,0.6430910539149922,52
349,2,834,834,0,0,0,0,1.0,1,1.0,1,1.0,1,0.6353026664800235,54
350,2,836,836,0,0,0,0,1.0,1,1.0,1,1.0,1,0.6449100701614527,54
351,4,840,840,0,0,0,0,1.0,1,1.0,1,1.0,1,0.6416712126275363,54
352,1,841,841,0,0,0,0,1.0,1,1.0,1,1.0,1,0.6493270561158188,56
353,7,848,848,0,0,0,0,1.0,1,1.0,1,1.0,1,0.639272409751534,54
354,1,849,849,0,0,0,0,1.0,1,1.0,1,1.0,1,0.6320903827426544,53
355,5,854,854,0,0,0,0,1.0,1,1.0,1,1.0,1,0.6086902340420055,54
356,2,856,856,0,0,0,0,1.0,1,1.0,1,1.0,1,0.5966204714768387,54
357,1,857,857,0,0,0,0,1.0,1,1.0,1,1.0,1,0.5947670259119778,53
358,0,857,857,0,0,0,0,1.0,1,1.0,1,1.0,1,0.6007574346012,49
359,1,858,858,0,0,0,0,1.0,1,1.0,1,1.0,1,0.5859601318217375,48
360,2,860,860,0,0,0,0,1.0,1,1.0,1,1.0,1,0.6077823353841917,47
361,2,862,862,0,0,0,0,1.0,1,1.0,1,1.0,1,0.5903533234383035,46
362,6,868,868,0,0,0,0,1.0,1,1.0,1,1.0,1,0.6061284972690864,46
363,6,874,874,0,0,0,0,1.0,1,1.0,1,1.0,1,0.5720656954093774,47
364,3,877,877,0,0,0,0,1.0,1,1.0,1,1.0,1,0.5747257923897068,47
365,7,884,884,0,0,0,0,1.0,1,1.0,1,1.0,1,0.5455878114972931,47
366,0,884,884,0,0,0,0,1.0,1,1.0,1,1.0,1,0.5428258711729382,50
367,5,889,889,0,0,0,0,1.0,1,1.0,1,1.0,1,0.5268844216375248,50
368,2,891,891,0,0,0,0,1.0,1,1.0,1,1.0,1,0.5039649230316657,51
369,1,892,892,0,0,0,0,1.0,1,1.0,1,1.0,1,0.5052060970624038,51
370,1,893,893,0,0,0,0,1.0,1,1.0,1,1.0,1,0.508644457291242,51
371,3,896,896,0,0,0,0,1.0,1,1.0,1,1.0,1,0.5451101292696692,52
372,1,897,897,0,0,0,0,1.0,1,1.0,1,1.0,1,0.5439276507691354,53
373,3,900,900,0,0,0,0,1.0,1,1.0,1,1.0,1,0.5862078190485934,53
374,2,902,902,0,0,0,0,1.0,1,1.0,1,1.0,1,0.6297543175703099,53
375,3,905,905,0,0,0,0,1.0,1,1.0,1,1.0,1,0.633844414163334,53
376,4,909,909,0,0,0,0,1.0,1,1.0,1,1.0,1,0.6160014089939934,53
377,4,913,913,0,0,0,0,1.0,1,1.0,1,1.0,1,0.6247792588987925,53
378,5,918,918,0,0,0,0,1.0,1,1.0,1,1.0,1,0.6227921768334129,53
379,6,924,924,0,0,0,0,1.0,1,1.0,1,1.0,1,0.5839406575075422,54
380,6,930,930,0,0,0,0,1.0,1,1.0,1,1.0,1,0.5850955542348659,54
381,5,935,935,0,0,0,0,1.0,1,1.0,1,1.0,1,0.5678341947379831,54
382,6,941,941,0,0,0,0,1.0,1,1.0,1,1.0,1,0.5702350109932659,55
383,1,942,942,0,0,0,0,1.0,1,1.0,1,1.0,1,0.568322307533125,55
384,4,946,946,0,0,0,0,1.0,1,1.0,1,1.0,1,0.6197136212509503,54
385,3,949,949,0,0,0,0,1.0,1,1.0,1,1.0,1,0.6207977571064807,52
386,3,952,952,0,0,0,0,1.0,1,1.0,1,1.0,1,0.6319490170035476,52
387,4,956,956,0,0,0,0,1.0,1,1.0,1,1.0,1,0.6324087068167221,50
388,2,958,958,0,0,0,0,1.0,1,1.0,1,1.0,1,0.603698045955599,52
389,7,965,965,0,0,0,0,1.0,1,1.0,1,1.0,1,0.5646501249626492,51
390,7,972,972,0,0,0,0,1.0,1,1.0,1,1.0,1,0.5469867168016698,50
391,3,975,975,0,0,0,0,1.0,1,1.0,1,1.0,1,0.5284389039105927,49
392,7,982,982,0,0,0,0,1.0,1,1.0,1,1.0,1,0.5379622234717252,47
393,4,986,986,0,0,0,0,1.0,1,1.0,1,1.0,1,0.5203443427588154,47
394,4,990,990,0,0,0,0,1.0,1,1.0,1,1.0,1,0.5200126654475971,48
395,2,992,992,0,0,0,0,1.0,1,1.0,1,1.0,1,0.5366520508891128,46
396,0,992,992,0,0,0,0,1.0,1,1.0,1,1.0,1,0.5406922686498206,43
397,3,995,995,0,0,0,0,1.0,1,1.0,1,1.0,1,0.5598196097078687,42
398,1,996,996,0,0,0,0,1.0,1,1.0,1,1.0,1,0.5781116706212169,40
399,0,996,996,0,0,0,0,1.0,1,1.0,1,1.0,1,0.5722313595016775,39
400,1,997,997,0,0,0,0,1.0,1,1.0,1,1.0,1,0.5927011115339582,38
401,0,997,997,0,0,0,0,1.0,1,1.0,1,1.0,1,0.6133920070657102,37
402,0,997,997,0,0,0,0,1.0,1,1.0,1,1.0,1,0.6119755277447063,36
403,2,999,999,0,0,0,0,1.0,1,1.0,1,1.0,1,0.5673407325655572,38
404,2,1001,1001,0,0,0,0,1.0,1,1.0,1,1.0,1,0.6002862871108279,39
405,1,1002,1002,0,0,0,0,1.0,1,1.0,1,1.0,1,0.5859360716617676,40
406,3,1005,1005,0,0,0,0,1.0,1,1.0,1,1.0,1,0.5837366808568001,41
407,1,1006,1006,0,0,0,0,1.0,1,1.0,1,1.0,1,0.5633327640048148,42
408,4,1010,1010,0,0,0,0,1.0,1,1.0,1,1.0,1,0.5624003244734161,43
409,1,1011,1011,0,0,0,0,1.0,1,1.0,1,1.0,1,0.5646057768738075,44
410,2,1013,1013,0,0,0,0,1.0,1,1.0,1,1.0,1,0.5600264243714307,46
411,4,1017,1017,0,0,0,0,1.0,1,1.0,1,1.0,1,0.5676886637388667,46
412,1,1018,1018,0,0,0,0,1.0,1,1.0,1,1.0,1,0.57027869641602,47
413,4,1022,1022,0,0,0,0,1.0,1,1.0,1,1.0,1,0.559420315027967,47
414,2,1024,1024,0,0,0,0,1.0,1,1.0,1,1.0,1,0.5647839747737583,47
415,3,1027,1027,0,0,0,0,1.0,1,1.0,1,1.0,1,0.5668302795257406,48
416,3,1030,1030,0,0,0,0,1.0,1,1.0,1,1.0,1,0.5243941066920772,49
417,2,1032,1032,0,0,0,0,1.0,1,1.0,1,1.0,1,0.5110327701459205,49
418,4,1036,1036,0,0,0,0,1.0,1,1.0,1,1.0,1,0.5241570632886309,50
419,5,1041,1041,0,0,0,0,1.0,1,1.0,1,1.0,1,0.4895696911088627,50
420,2,1043,1043,0,0,0,0,1.0,1,1.0,1,1.0,1,0.47518537214249723,50
421,2,1045,1045,0,0,0,0,1.0,1,1.0,1,1.0,1,0.4756647108690081,50
422,4,1049,1049,0,0,0,0,1.0,1,1.0,1,1.0,1,0.4895790788122903,50
423,4,1053,1053,0,0,0,0,1.0,1,1.0,1,1.0,1,0.4525251727834995,51
424,3,1056,1056,0,0,0,0,1.0,1,1.0,1,1.0,1,0.5013138255138042,49
425,6,1062,1062,0,0,0,0,1.0,1,1.0,1,1.0,1,0.5538762736609208,48
426,1,1063,1063,0,0,0,0,1.0,1,1.0,1,1.0,1,0.5473095597427623,50
427,3,1066,1066,0,0,0,0,1.0,1,1.0,1,1.0,1,0.5669479094649653,48
428,1,1067,1067,0,0,0,0,1.0,1,1.0,1,1.0,1,0.5621643285071429,49
429,1,1068,1068,0,0,0,0,1.0,1,1.0,1,1.0,1,0.5845627956267211,45
430,2,1070,1070,0,0,0,0,1.0,1,1.0,1,1.0,1,0.5690609520400972,44
431,3,1073,1073,0,0,0,0,1.0,1,1.0,1,1.0,1,0.5788750242852166,42
432,1,1074,1074,0,0,0,0,1.0,1,1.0,1,1.0,1,0.6224768105284746,40
433,2,1076,1076,0,0,0,0,1.0,1,1.0,1,1.0,1,0.6165701147051939,39
434,2,1078,1078,0,0,0,0,1.0,1,1.0,1,1.0,1,0.6484658816596338,39
435,1,1079,1079,0,0,0,0,1.0,1,1.0,1,1.0,1,0.6716411662848132,38
436,2,1081,1081,0,0,0,0,1.0,1,1.0,1,1.0,1,0.6572104769426307,38
437,4,1085,1085,0,0,0,0,1.0,1,1.0,1,1.0,1,0.6911772494137579,39
438,6,1091,1091,0,0,0,0,1.0,1,1.0,1,1.0,1,0.6650312685514526,38
439,4,1095,1095,0,0,0,0,1.0,1,1.0,1,1.0,1,0.6658054981928118,39
440,1,1096,1096,0,0,0,0,1.0,1,1.0,1,1.0,1,0.6727660024156207,39
441,7,1103,1103,0,0,0,0,1.0,1,1.0,1,1.0,1,0.63442457617138,41
442,3,1106,1106,0,0,0,0,1.0,1,1.0,1,1.0,1,0.6275169190143551,42
443,2,1108,1108,0,0,0,0,1.0,1,1.0,1,1.0,1,0.6362585320585462,42
444,4,1112,1112,0,0,0,0,1.0,1,1.0,1,1.0,1,0.5949722071527824,43
445,3,1115,1115,0,0,0,0,1.0,1,1.0,1,1.0,1,0.5509458188266099,44
446,3,1118,1118,0,0,0,0,1.0,1,1.0,1,1.0,1,0.5193523832869686,44
447,4,1122,1122,0,0,0,0,1.0,1,1.0,1,1.0,1,0.5055833495373095,47
448,0,1122,1122,0,0,0,0,1.0,1,1.0,1,1.0,1,0.5028687876066001,46
449,0,1122,1122,0,0,0,0,1.0,1,1.0,1,1.0,1,0.5028687876066001,46
450,0,1122,1122,0,0,0,0,1.0,1,1.0,1,1.0,1,0.502916773306736,46
451,1,1123,1123,0,0,0,0,1.0,1,1.0,1,1.0,1,0.5180126884371806,47
452,4,1127,1127,0,0,0,0,1.0,1,1.0,1,1.0,1,0.558441383139459,47
453,3,1130,1130,0,0,0,0,1.0,1,1.0,1,1.0,1,0.5788697613878127,47
454,2,1132,1132,0,0,0,0,1.0,1,1.0,1,1.0,1,0.6243434307095648,46
455,2,1134,1134,0,0,0,0,1.0,1,1.0,1,1.0,1,0.6173363705714583,47
456,3,1137,1137,0,0,0,0,1.0,1,1.0,1,1.0,1,0.6014066285098834,49
457,2,1139,1139,0,0,0,0,1.0,1,1.0,1,1.0,1,0.6143794469622491,50
458,2,1141,1141,0,0,0,0,1.0,1,1.0,1,1.0,1,0.59384858424841,50
459,5,1146,1146,0,0,0,0,1.0,1,1.0,1,1.0,1,0.5525295724424837,52
460,1,1147,1147,0,0,0,0,1.0,1,1.0,1,1.0,1,0.5542228226929338,53
461,3,1150,1150,0,0,0,0,1.0,1,1.0,1,1.0,1,0.5447980968263862,54
462,6,1156,1156,0,0,0,0,1.0,1,1.0,1,1.0,1,0.5447109395219178,54
463,2,1158,1158,0,0,0,0,1.0,1,1.0,1,1.0,1,0.5412639267939745,55
464,6,1164,1164,0,0,0,0,1.0,1,1.0,1,1.0,1,0.5409556085823194,56
465,10,1174,1174,0,0,0,0,1.0,1,1.0,1,1.0,1,0.5444176540841742,54
466,4,1178,1178,0,0,0,0,1.0,1,1.0,1,1.0,1,0.5544532206329347,54
467,4,1182,1182,0,0,0,0,1.0,1,1.0,1,1.0,1,0.5613115595137479,51
468,3,1185,1185,0,0,0,0,1.0,1,1.0,1,1.0,1,0.565483353160555,51
469,9,1194,1194,0,0,0,0,1.0,1,1.0,1,1.0,1,0.5198251794632026,48
470,2,1196,1196,0,0,0,0,1.0,1,1.0,1,1.0,1,0.51362770121622,47
471,10,1206,1206,0,0,0,0,1.0,1,1.0,1,1.0,1,0.5150712271272582,44
472,1,1207,1207,0,0,0,0,1.0,1,1.0,1,1.0,1,0.5043776356243049,43
473,6,1213,1213,0,0,0,0,1.0,1,1.0,1,1.0,1,0.48436321281322237,41
474,1,1214,1214,0,0,0,0,1.0,1,1.0,1,1.0,1,0.46711063803572483,39
475,3,1217,1217,0,0,0,0,1.0,1,1.0,1,1.0,1,0.5045900274322143,40
476,2,1219,1219,0,0,0,0,1.0,1,1.0,1,1.0,1,0.47477202212255937,38
477,1,1220,1220,0,0,0,0,1.0,1,1.0,1,1.0,1,0.46577105291826526,35
478,4,1224,1224,0,0,0,0,1.0,1,1.0,1,1.0,1,0.5266244080208327,35
479,2,1226,1226,0,0,0,0,1.0,1,1.0,1,1.0,1,0.4973091950131409,32
480,0,1226,1226,0,0,0,0,1.0,1,1.0,1,1.0,1,0.5272626026193652,32
481,1,1227,1227,0,0,0,0,1.0,1,1.0,1,1.0,1,0.5111306455951323,33
482,0,1227,1227,0,0,0,0,1.0,1,1.0,1,1.0,1,0.4833005101075257,34
483,3,1230,1230,0,0,0,0,1.0,1,1.0,1,1.0,1,0.48540758543844187,32
484,4,1234,1234,0,0,0,0,1.0,1,1.0,1,1.0,1,0.47436322334116343,33
485,3,1237,1237,0,0,0,0,1.0,1,1.0,1,1.0,1,0.47923403422274047,34
486,1,1238,1238,0,0,0,0,1.0,1,1.0,1,1.0,1,0.511768776463428,36
487,5,1243,1243,0,0,0,0,1.0,1,1.0,1,1.0,1,0.5283279466323143,36
488,2,1245,1245,0,0,0,0,1.0,1,1.0,1,1.0,1,0.5519419906867908,37
489,0,1245,1245,0,0,0,0,1.0,1,1.0,1,1.0,1,0.5582714567531348,38
490,1,1246,1246,0,0,0,0,1.0,1,1.0,1,1.0,1,0.5789323773710024,38
491,0,1246,1246,0,0,0,0,1.0,1,1.0,1,1.0,1,0.5900004301080868,37
492,2,1248,1248,0,0,0,0,1.0,1,1.0,1,1.0,1,0.6044813399576726,37
493,1,1249,1249,0,0,0,0,1.0,1,1.0,1,1.0,1,0.6351596527014185,37
494,1,1250,1250,0,0,0,0,1.0,1,1.0,1,1.0,1,0.6330622859500917,39
495,0,1250,1250,0,0,0,0,1.0,1,1.0,1,1.0,1,0.6257619779135032,40
496,2,1252,1252,0,0,0,0,1.0,1,1.0,1,1.0,1,0.640886952551461,40
497,1,1253,1253,0,0,0,0,1.0,1,1.0,1,1.0,1,0.601014647034498,43
498,4,1257,1257,0,0,0,0,1.0,1,1.0,1,1.0,1,0.5698155649460402,43
499,4,1261,1261,0,0,0,0,1.0,1,1.0,1,1.0,1,0.5551102409577998,44
500,4,1265,1265,0,0,0,0,1.0,1,1.0,1,1.0,1,0.5523251444413837,45
501,3,1268,1268,0,0,0,0,1.0,1,1.0,1,1.0,1,0.5741502846277118,45
502,2,1270,1270,0,0,0,0,1.0,1,1.0,1,1.0,1,0.6165558265818544,45
503,2,1272,1272,0,0,0,0,1.0,1,1.0,1,1.0,1,0.6163549462666851,46
504,1,1273,1273,0,0,0,0,1.0,1,1.0,1,1.0,1,0.6394539015495995,47
505,2,1275,1275,0,0,0,0,1.0,1,1.0,1,1.0,1,0.6597478013177642,42
506,0,1275,1275,0,0,0,0,1.0,1,1.0,1,1.0,1,0.6545127436894884,41
507,0,1275,1275,0,0,0,0,1.0,1,1.0,1,1.0,1,0.6602333598031039,38
508,1,1276,1276,0,0,0,0,1.0,1,1.0,1,1.0,1,0.6578343509691494,38
509,0,1276,1276,0,0,0,0,1.0,1,1.0,1,1.0,1,0.660037989532162,37
510,1,1277,1277,0,0,0,0,1.0,1,1.0,1,1.0,1,0.6316066084564743,36
511,1,1278,1278,0,0,0,0,1.0,1,1.0,1,1.0,1,0.6377534725489361,34
512,0,1278,1278,0,0,0,0,1.0,1,1.0,1,1.0,1,0.6243003687537224,32
513,4,1282,1282,0,0,0,0,1.0,1,1.0,1,1.0,1,0.6030306141710364,32
514,1,1283,1283,0,0,0,0,1.0,1,1.0,1,1.0,1,0.584514720544793,35
515,8,1291,1291,0,0,0,0,1.0,1,1.0,1,1.0,1,0.6188649426832518,35
516,1,1292,1292,0,0,0,0,1.0,1,1.0,1,1.0,1,0.6000229973031068,36
517,8,1300,1300,0,0,0,0,1.0,1,1.0,1,1.0,1,0.6091850897333263,36
518,2,1302,1302,0,0,0,0,1.0,1,1.0,1,1.0,1,0.5787447672418012,39
519,4,1306,1306,0,0,0,0,1.0,1,1.0,1,1.0,1,0.5599547341174987,39
520,2,1308,1308,0,0,0,0,1.0,1,1.0,1,1.0,1,0.5823398073655167,39
521,3,1311,1311,0,0,0,0,1.0,1,1.0,1,1.0,1,0.5372486855725852,40
522,1,1312,1312,0,0,0,0,1.0,1,1.0,1,1.0,1,0.5436768191682685,40
523,3,1315,1315,0,0,0,0,1.0,1,1.0,1,1.0,1,0.5302993684256264,41
524,1,1316,1316,0,0,0,0,1.0,1,1.0,1,1.0,1,0.5394872231660623,41
525,4,1320,1320,0,0,0,0,1.0,1,1.0,1,1.0,1,0.5365273196835253,40
526,2,1322,1322,0,0,0,0,1.0,1,1.0,1,1.0,1,0.49786986770176217,40
527,3,1325,1325,0,0,0,0,1.0,1,1.0,1,1.0,1,0.5190721934145439,40
528,1,1326,1326,0,0,0,0,1.0,1,1.0,1,1.0,1,0.4958847883362376,40
529,0,1326,1326,0,0,0,0,1.0,1,1.0,1,1.0,1,0.5121159734439804,39
530,5,1331,1331,0,0,0,0,1.0,1,1.0,1,1.0,1,0.5012295671420633,39
531,2,1333,1333,0,0,0,0,1.0,1,1.0,1,1.0,1,0.4726114256281092,39
532,1,1334,1334,0,0,0,0,1.0,1,1.0,1,1.0,1,0.4923786151999576,40
533,0,1334,1334,0,0,0,0,1.0,1,1.0,1,1.0,1,0.5258569127401154,40
534,1,1335,1335,0,0,0,0,1.0,1,1.0,1,1.0,1,0.5456227152920577,42
535,1,1336,1336,0,0,0,0,1.0,1,1.0,1,1.0,1,0.5411087286182236,42
536,0,1336,1336,0,0,0,0,1.0,1,1.0,1,1.0,1,0.5413055662877884,43
537,0,1336,1336,0,0,0,0,1.0,1,1.0,1,1.0,1,0.5413055662877884,43
538,2,1338,1338,0,0,0,0,1.0,1,1.0,1,1.0,1,0.5652748742452304,44
539,3,1341,1341,0,0,0,0,1.0,1,1.0,1,1.0,1,0.5644145417855265,44
540,1,1342,1342,0,0,0,0,1.0,1,1.0,1,1.0,1,0.5734161642162546,44
541,4,1346,1346,0,0,0,0,1.0,1,1.0,1,1.0,1,0.5852158136880324,45
542,2,1348,1348,0,0,0,0,1.0,1,1.0,1,1.0,1,0.6031568290637686,46
543,3,1351,1351,0,0,0,0,1.0,1,1.0,1,1.0,1,0.6019720116276239,43
544,4,1355,1355,0,0,0,0,1.0,1,1.0,1,1.0,1,0.6332613619591476,42
545,3,1358,1358,0,0,0,0,1.0,1,1.0,1,1.0,1,0.6455415397075087,43
546,3,1361,1361,0,0,0,0,1.0,1,1.0,1,1.0,1,0.665355093314861,41
547,1,1362,1362,0,0,0,0,1.0,1,1.0,1,1.0,1,0.6258395868104233,40
548,1,1363,1363,0,0,0,0,1.0,1,1.0,1,1.0,1,0.6567511512481555,40
549,1,1364,1364,0,0,0,0,1.0,1,1.0,1,1.0,1,0.6580301698231539,39
550,2,1366,1366,0,0,0,0,1.0,1,1.0,1,1.0,1,0.6737862049259833,38
551,2,1368,1368,0,0,0,0,1.0,1,1.0,1,1.0,1,0.6641717740693224,38
552,0,1368,1368,0,0,0,0,1.0,1,1.0,1,1.0,1,0.664249045659662,39
553,2,1370,1370,0,0,0,0,1.0,1,1.0,1,1.0,1,0.6485919208533465,38
554,0,1370,1370,0,0,0,0,1.0,1,1.0,1,1.0,1,0.6563420180034517,39
555,2,1372,1372,0,0,0,0,1.0,1,1.0,1,1.0,1,0.6281289904365261,39
556,2,1374,1374,0,0,0,0,1.0,1,1.0,1,1.0,1,0.6186355122935893,40
557,2,1376,1376,0,0,0,0,1.0,1,1.0,1,1.0,1,0.6368779695673024,40
558,2,1378,1378,0,0,0,0,1.0,1,1.0,1,1.0,1,0.6497961155655685,40
559,4,1382,1382,0,0,0,0,1.0,1,1.0,1,1.0,1,0.6561245792972046,40
560,5,1387,1387,0,0,0,0,1.0,1,1.0,1,1.0,1,0.6383229729998682,41
561,4,1391,1391,0,0,0,0,1.0,1,1.0,1,1.0,1,0.6522200393109733,42
562,2,1393,1393,0,0,0,0,1.0,1,1.0,1,1.0,1,0.6701185770086755,42
563,2,1395,1395,0,0,0,0,1.0,1,1.0,1,1.0,1,0.6794427256519219,42
564,5,1400,1400,0,0,0,0,1.0,1,1.0,1,1.0,1,0.6834851131785364,43
565,2,1402,1402,0,0,0,0,1.0,1,1.0,1,1.0,1,0.6778401574280009,44
566,4,1406,1406,0,0,0,0,1.0,1,1.0,1,1.0,1,0.6711452194766648,45
567,5,1411,1411,0,0,0,0,1.0,1,1.0,1,1.0,1,0.6760574208401562,45
568,4,1415,1415,0,0,0,0,1.0,1,1.0,1,1.0,1,0.6441247037054693,46
569,6,1421,1421,0,0,0,0,1.0,1,1.0,1,1.0,1,0.6150264832782153,47
570,3,1424,1424,0,0,0,0,1.0,1,1.0,1,1.0,1,0.6369866468070553,48
571,3,1427,1427,0,0,0,0,1.0,1,1.0,1,1.0,1,0.6351696290245048,48
572,0,1427,1427,0,0,0,0,1.0,1,1.0,1,1.0,1,0.6482016477141733,47
573,3,1430,1430,0,0,0,0,1.0,1,1.0,1,1.0,1,0.6368693072134501,49
574,3,1433,1433,0,0,0,0,1.0,1,1.0,1,1.0,1,0.6340996578721857,49
575,2,1435,1435,0,0,0,0,1.0,1,1.0,1,1.0,1,0.6371516253829586,50
576,3,1438,1438,0,0,0,0,1.0,1,1.0,1,1.0,1,0.6374187008498227,51
577,3,1441,1441,0,0,0,0,1.0,1,1.0,1,1.0,1,0.6625071429555882,51
578,1,1442,1442,0,0,0,0,1.0,1,1.0,1,1.0,1,0.6673879165170156,51
579,2,1444,1444,0,0,0,0,1.0,1,1.0,1,1.0,1,0.6541321570760971,52
580,3,1447,1447,0,0,0,0,1.0,1,1.0,1,1.0,1,0.67563930182653,52
581,1,1448,1448,0,0,0,0,1.0,1,1.0,1,1.0,1,0.6708046304003152,52
582,1,1449,1449,0,0,0,0,1.0,1,1.0,1,1.0,1,0.6823260550558172,53
583,3,1452,1452,0,0,0,0,1.0,1,1.0,1,1.0,1,0.6937776604153736,51
584,4,1456,1456,0,0,0,0,1.0,1,1.0,1,1.0,1,0.7191567651488884,51
585,7,1463,1463,0,0,0,0,1.0,1,1.0,1,1.0,1,0.7101277140222381,49
586,4,1467,1467,0,0,0,0,1.0,1,1.0,1,1.0,1,0.658799014969199,49
587,5,1472,1472,0,0,0,0,1.0,1,1.0,1,1.0,1,0.6477654477245728,48
588,3,1475,1475,0,0,0,0,1.0,1,1.0,1,1.0,1,0.6521066121063724,46
589,4,1479,1479,0,0,0,0,1.0,1,1.0,1,1.0,1,0.6232917603353446,48
590,3,1482,1482,0,0,0,0,1.0,1,1.0,1,1.0,1,0.58845577086144,47
591,5,1487,1487,0,0,0,0,1.0,1,1.0,1,1.0,1,0.5952567250297662,48
592,8,1495,1495,0,0,0,0,1.0,1,1.0,1,1.0,1,0.6392938997553618,47
593,5,1500,1500,0,0,0,0,1.0,1,1.0,1,1.0,1,0.5988185831609647,45
594,8,1508,1508,0,0,0,0,1.0,1,1.0,1,1.0,1,0.621865290564104,44
595,6,1514,1514,0,0,0,0,1.0,1,1.0,1,1.0,1,0.6213201418193052,43
596,6,1520,1520,0,0,0,0,1.0,1,1.0,1,1.0,1,0.6264705354240117,44
597,2,1522,1522,0,0,0,0,1.0,1,1.0,1,1.0,1,0.5823597231161698,43
598,3,1525,1525,0,0,0,0,1.0,1,1.0,1,1.0,1,0.56076860244674,45
599,2,1527,1527,0,0,0,0,1.0,1,1.0,1,1.0,1,0.5787834639454966,44
600,3,1530,1530,0,0,0,0,1.0,1,1.0,1,1.0,1,0.5330871009436519,44
601,4,1534,1534,0,0,0,0,1.0,1,1.0,1,1.0,1,0.5001534712269566,45
602,0,1534,1534,0,0,0,0,1.0,1,1.0,1,1.0,1,0.5086220145586068,46
603,2,1536,1536,0,0,0,0,1.0,1,1.0,1,1.0,1,0.5007338365503808,46
604,0,1536,1536,0,0,0,0,1.0,1,1.0,1,1.0,1,0.485335904952605,47
605,1,1537,1537,0,0,0,0,1.0,1,1.0,1,1.0,1,0.48642199819742465,47
606,1,1538,1538,0,0,0,0,1.0,1,1.0,1,1.0,1,0.49378516836775344,47
607,3,1541,1541,0,0,0,0,1.0,1,1.0,1,1.0,1,0.5177922164325746,48
608,3,1544,1544,0,0,0,0,1.0,1,1.0,1,1.0,1,0.5650854602917911,47
609,0,1544,1544,0,0,0,0,1.0,1,1.0,1,1.0,1,0.566643813320717,48
610,2,1546,1546,0,0,0,0,1.0,1,1.0,1,1.0,1,0.6116193212700206,48
611,0,1546,1546,0,0,0,0,1.0,1,1.0,1,1.0,1,0.6009667233145524,49
612,4,1550,1550,0,0,0,0,1.0,1,1.0,1,1.0,1,0.6135801079950471,50
613,1,1551,1551,0,0,0,0,1.0,1,1.0,1,1.0,1,0.587061822563064,50
614,2,1553,1553,0,0,0,0,1.0,1,1.0,1,1.0,1,0.5932283872602554,50
615,1,1554,1554,0,0,0,0,1.0,1,1.0,1,1.0,1,0.5796638447524037,50
616,3,1557,1557,0,0,0,0,1.0,1,1.0,1,1.0,1,0.5762631063914431,50
617,1,1558,1558,0,0,0,0,1.0,1,1.0,1,1.0,1,0.5675527732390993,52
618,5,1563,1563,0,0,0,0,1.0,1,1.0,1,1.0,1,0.5612590704002963,52
619,3,1566,1566,0,0,0,0,1.0,1,1.0,1,1.0,1,0.5358324598553518,50
620,4,1570,1570,0,0,0,0,1.0,1,1.0,1,1.0,1,0.5376796112640575,50
621,4,1574,1574,0,0,0,0,1.0,1,1.0,1,1.0,1,0.5306010162460492,49
622,4,1578,1578,0,0,0,0,1.0,1,1.0,1,1.0,1,0.5733622161401087,49
623,5,1583,1583,0,0,0,0,1.0,1,1.0,1,1.0,1,0.5435445297361776,48
624,4,1587,1587,0,0,0,0,1.0,1,1.0,1,1.0,1,0.5657404766424899,46
625,5,1592,1592,0,0,0,0,1.0,1,1.0,1,1.0,1,0.5082970604386429,45
626,3,1595,1595,0,0,0,0,1.0,1,1.0,1,1.0,1,0.49550153239244954,44
627,6,1601,1601,0,0,0,0,1.0,1,1.0,1,1.0,1,0.49895077538366817,44
628,1,1602,1602,0,0,0,0,1.0,1,1.0,1,1.0,1,0.5031079001963855,44
629,7,1609,1609,0,0,0,0,1.0,1,1.0,1,1.0,1,0.5040973451843366,41
630,1,1610,1610,0,0,0,0,1.0,1,1.0,1,1.0,1,0.5230364822476942,40
631,0,1610,1610,0,0,0,0,1.0,1,1.0,1,1.0,1,0.5352182118822012,38
632,3,1613,1613,0,0,0,0,1.0,1,1.0,1,1.0,1,0.5537102833474261,38
633,2,1615,1615,0,0,0,0,1.0,1,1.0,1,1.0,1,0.5708169181793933,36
634,3,1618,1618,0,0,0,0,1.0,1,1.0,1,1.0,1,0.5852110699419069,35
635,3,1621,1621,0,0,0,0,1.0,1,1.0,1,1.0,1,0.5399135012279356,35
636,2,1623,1623,0,0,0,0,1.0,1,1.0,1,1.0,1,0.5774971356347511,36
637,2,1625,1625,0,0,0,0,1.0,1,1.0,1,1.0,1,0.5739356544957227,35
638,0,1625,1625,0,0,0,0,1.0,1,1.0,1,1.0,1,0.6069592072806813,34
639,3,1628,1628,0,0,0,0,1.0,1,1.0,1,1.0,1,0.5703349194590359,36
640,2,1630,1630,0,0,0,0,1.0,1,1.0,1,1.0,1,0.565638827653394,37
641,1,1631,1631,0,0,0,0,1.0,1,1.0,1,1.0,1,0.5565400900896882,37
642,2,1633,1633,0,0,0,0,1.0,1,1.0,1,1.0,1,0.5539781162719064,38
643,1,1634,1634,0,0,0,0,1.0,1,1.0,1,1.0,1,0.5531418369396864,39
644,2,1636,1636,0,0,0,0,1.0,1,1.0,1,1.0,1,0.5626394993178175,39
645,2,1638,1638,0,0,0,0,1.0,1,1.0,1,1.0,1,0.5560235263580771,39
646,4,1642,1642,0,0,0,0,1.0,1,1.0,1,1.0,1,0.5880577952077278,40
647,3,1645,1645,0,0,0,0,1.0,1,1.0,1,1.0,1,0.5862714374937225,40
648,5,1650,1650,0,0,0,0,1.0,1,1.0,1,1.0,1,0.5713319876374707,40
649,0,1650,1650,0,0,0,0,1.0,1,1.0,1,1.0,1,0.5713319876374707,40
650,3,1653,1653,0,0,0,0,1.0,1,1.0,1,1.0,1,0.5602651947521263,41
651,4,1657,1657,0,0,0,0,1.0,1,1.0,1,1.0,1,0.5783241838450086,42
652,1,1658,1658,0,0,0,0,1.0,1,1.0,1,1.0,1,0.5686425031639558,41
653,2,1660,1660,0,0,0,0,1.0,1,1.0,1,1.0,1,0.5693835809773756,41
654,4,1664,1664,0,0,0,0,1.0,1,1.0,1,1.0,1,0.5572846055959266,42
655,2,1666,1666,0,0,0,0,1.0,1,1.0,1,1.0,1,0.541222975251003,45
656,2,1668,1668,0,0,0,0,1.0,1,1.0,1,1.0,1,0.5500832146795508,45
657,1,1669,1669,0,0,0,0,1.0,1,1.0,1,1.0,1,0.545554427338195,43
658,4,1673,1673,0,0,0,0,1.0,1,1.0,1,1.0,1,0.5451070296165078,43
659,3,1676,1676,0,0,0,0,1.0,1,1.0,1,1.0,1,0.5139930297018797,43
660,1,1677,1677,0,0,0,0,1.0,1,1.0,1,1.0,1,0.5399792439858969,43
661,4,1681,1681,0,0,0,0,1.0,1,1.0,1,1.0,1,0.5432834758207984,41
662,3,1684,1684,0,0,0,0,1.0,1,1.0,1,1.0,1,0.540594186800567,40
663,3,1687,1687,0,0,0,0,1.0,1,1.0,1,1.0,1,0.5474933351264211,39
664,3,1690,1690,0,0,0,0,1.0,1,1.0,1,1.0,1,0.5350012609086293,36
665,3,1693,1693,0,0,0,0,1.0,1,1.0,1,1.0,1,0.5719490713698934,36
666,8,1701,1701,0,0,0,0,1.0,1,1.0,1,1.0,1,0.569167508391068,36
667,2,1703,1703,0,0,0,0,1.0,1,1.0,1,1.0,1,0.5768327172924308,35
668,6,1709,1709,0,0,0,0,1.0,1,1.0,1,1.0,1,0.6084895721744724,34
669,7,1716,1716,0,0,0,0,1.0,1,1.0,1,1.0,1,0.5441152592464361,34
670,5,1721,1721,0,0,0,0,1.0,1,1.0,1,1.0,1,0.6143009696106273,32
671,1,1722,1722,0,0,0,0,1.0,1,1.0,1,1.0,1,0.6079854622329784,33
672,1,1723,1723,0,0,0,0,1.0,1,1.0,1,1.0,1,0.6198611544667992,32
673,3,1726,1726,0,0,0,0,1.0,1,1.0,1,1.0,1,0.6316692253176648,32
674,1,1727,1727,0,0,0,0,1.0,1,1.0,1,1.0,1,0.6617908516476151,32
675,3,1730,1730,0,0,0,0,1.0,1,1.0,1,1.0,1,0.6387083086315545,34
676,1,1731,1731,0,0,0,0,1.0,1,1.0,1,1.0,1,0.5989722315825085,35
677,3,1734,1734,0,0,0,0,1.0,1,1.0,1,1.0,1,0.5716295061805731,35
678,5,1739,1739,0,0,0,0,1.0,1,1.0,1,1.0,1,0.5418309596978981,35
679,2,1741,1741,0,0,0,0,1.0,1,1.0,1,1.0,1,0.5604551496284911,36
680,1,1742,1742,0,0,0,0,1.0,1,1.0,1,1.0,1,0.529813969197853,37
681,2,1744,1744,0,0,0,0,1.0,1,1.0,1,1.0,1,0.5025578972887681,37
682,2,1746,1746,0,0,0,0,1.0,1,1.0,1,1.0,1,0.49180277590655963,37
683,1,1747,1747,0,0,0,0,1.0,1,1.0,1,1.0,1,0.4538643676327496,38
684,4,1751,1751,0,0,0,0,1.0,1,1.0,1,1.0,1,0.49824071944943266,39
685,2,1753,1753,0,0,0,0,1.0,1,1.0,1,1.0,1,0.5093271307811539,38
686,3,1756,1756,0,0,0,0,1.0,1,1.0,1,1.0,1,0.537080295847809,37
687,2,1758,1758,0,0,0,0,1.0,1,1.0,1,1.0,1,0.5704493459796651,38
688,2,1760,1760,0,0,0,0,1.0,1,1.0,1,1.0,1,0.6182848801956372,37
689,2,1762,1762,0,0,0,0,1.0,1,1.0,1,1.0,1,0.5923883101800996,39
690,4,1766,1766,0,0,0,0,1.0,1,1.0,1,1.0,1,0.6363847718622886,38
691,2,1768,1768,0,0,0,0,1.0,1,1.0,1,1.0,1,0.6346485216317493,38
692,3,1771,1771,0,0,0,0,1.0,1,1.0,1,1.0,1,0.6081031191727124,38
693,4,1775,1775,0,0,0,0,1.0,1,1.0,1,1.0,1,0.5599512989526232,40
694,8,1783,1783,0,0,0,0,1.0,1,1.0,1,1.0,1,0.5169855631675233,42
695,3,1786,1786,0,0,0,0,1.0,1,1.0,1,1.0,1,0.5383164481039865,40
696,2,1788,1788,0,0,0,0,1.0,1,1.0,1,1.0,1,0.5279827811117385,39
697,4,1792,1792,0,0,0,0,1.0,1,1.0,1,1.0,1,0.5234280950037284,39
698,2,1794,1794,0,0,0,0,1.0,1,1.0,1,1.0,1,0.5077337454201568,37
699,2,1796,1796,0,0,0,0,1.0,1,1.0,1,1.0,1,0.4592566418148407,37
700,3,1799,1799,0,0,0,0,1.0,1,1.0,1,1.0,1,0.4391580527561938,37
701,3,1802,1802,0,0,0,0,1.0,1,1.0,1,1.0,1,0.49271884890448,37
702,4,1806,1806,0,0,0,0,1.0,1,1.0,1,1.0,1,0.507318243828217,38
703,3,1809,1809,0,0,0,0,1.0,1,1.0,1,1.0,1,0.5520427528459074,36
704,3,1812,1812,0,0,0,0,1.0,1,1.0,1,1.0,1,0.5976173809930657,36
705,4,1816,1816,0,0,0,0,1.0,1,1.0,1,1.0,1,0.490986865785334,36
706,4,1820,1820,0,0,0,0,1.0,1,1.0,1,1.0,1,0.4759983539424406,35
707,1,1821,1821,0,0,0,0,1.0,1,1.0,1,1.0,1,0.445445138262144,36
708,2,1823,1823,0,0,0,0,1.0,1,1.0,1,1.0,1,0.4822054429415597,36
709,3,1826,1826,0,0,0,0,1.0,1,1.0,1,1.0,1,0.48993820466423055,34
710,3,1829,1829,0,0,0,0,1.0,1,1.0,1,1.0,1,0.41799871258945376,34
711,2,1831,1831,0,0,0,0,1.0,1,1.0,1,1.0,1,0.42717896850255827,34
712,3,1834,1834,0,0,0,0,1.0,1,1.0,1,1.0,1,0.44682679306169504,35
713,5,1839,1839,0,0,0,0,1.0,1,1.0,1,1.0,1,0.5186230886999357,34
714,1,1840,1840,0,0,0,0,1.0,1,1.0,1,1.0,1,0.5106520113006925,34
715,3,1843,1843,0,0,0,0,1.0,1,1.0,1,1.0,1,0.4942896659306303,35
716,2,1845,1845,0,0,0,0,1.0,1,1.0,1,1.0,1,0.5285352019930918,33
717,1,1846,1846,0,0,0,0,1.0,1,1.0,1,1.0,1,0.5643543585298304,33
718,2,1848,1848,0,0,0,0,1.0,1,1.0,1,1.0,1,0.5794926951476099,32
719,1,1849,1849,0,0,0,0,1.0,1,1.0,1,1.0,1,0.600244441320931,32
720,3,1852,1852,0,0,0,0,1.0,1,1.0,1,1.0,1,0.5689987941302579,33
721,0,1852,1852,0,0,0,0,1.0,1,1.0,1,1.0,1,0.5689987941302579,33
722,2,1854,1854,0,0,0,0,1.0,1,1.0,1,1.0,1,0.603842751249085,34
723,3,1857,1857,0,0,0,0,1.0,1,1.0,1,1.0,1,0.6151099548354186,34
724,1,1858,1858,0,0,0,0,1.0,1,1.0,1,1.0,1,0.606334531186107,36
725,4,1862,1862,0,0,0,0,1.0,1,1.0,1,1.0,1,0.6402144610785259,36
726,2,1864,1864,0,0,0,0,1.0,1,1.0,1,1.0,1,0.6637959496438798,36
727,0,1864,1864,0,0,0,0,1.0,1,1.0,1,1.0,1,0.6637959496438798,36
728,0,1864,1864,0,0,0,0,1.0,1,1.0,1,1.0,1,0.6689104833244216,37
729,4,1868,1868,0,0,0,0,1.0,1,1.0,1,1.0,1,0.6442585856993033,37
730,1,1869,1869,0,0,0,0,1.0,1,1.0,1,1.0,1,0.6209004621004154,38
731,2,1871,1871,0,0,0,0,1.0,1,1.0,1,1.0,1,0.6499853018993076,39
732,2,1873,1873,0,0,0,0,1.0,1,1.0,1,1.0,1,0.6628244656090628,41
733,0,1873,1873,0,0,0,0,1.0,1,1.0,1,1.0,1,0.6485155637543102,39
734,0,1873,1873,0,0,0,0,1.0,1,1.0,1,1.0,1,0.6402260948909171,39
735,2,1875,1875,0,0,0,0,1.0,1,1.0,1,1.0,1,0.6227401696669556,39
736,0,1875,1875,0,0,0,0,1.0,1,1.0,1,1.0,1,0.587187501230267,38
737,0,1875,1875,0,0,0,0,1.0,1,1.0,1,1.0,1,0.5828827781901631,39
738,2,1877,1877,0,0,0,0,1.0,1,1.0,1,1.0,1,0.5811304008842372,37
739,4,1881,1881,0,0,0,0,1.0,1,1.0,1,1.0,1,0.5824155684009809,37
740,2,1883,1883,0,0,0,0,1.0,1,1.0,1,1.0,1,0.5721925189425802,35
741,6,1889,1889,0,0,0,0,1.0,1,1.0,1,1.0,1,0.6010215370218873,33
742,6,1895,1895,0,0,0,0,1.0,1,1.0,1,1.0,1,0.6097409952123309,35
743,5,1900,1900,0,0,0,0,1.0,1,1.0,1,1.0,1,0.6290511773359015,35
744,6,1906,1906,0,0,0,0,1.0,1,1.0,1,1.0,1,0.6484393008551548,34
745,2,1908,1908,0,0,0,0,1.0,1,1.0,1,1.0,1,0.6750051602069207,34
746,4,1912,1912,0,0,0,0,1.0,1,1.0,1,1.0,1,0.6243269568035061,33
747,3,1915,1915,0,0,0,0,1.0,1,1.0,1,1.0,1,0.6380530296627962,32
748,4,1919,1919,0,0,0,0,1.0,1,1.0,1,1.0,1,0.5973362218469678,33
749,2,1921,1921,0,0,0,0,1.0,1,1.0,1,1.0,1,0.556916777515649,33
750,4,1925,1925,0,0,0,0,1.0,1,1.0,1,1.0,1,0.5956006512943363,34
751,2,1927,1927,0,0,0,0,1.0,1,1.0,1,1.0,1,0.5346864248585331,36
752,4,1931,1931,0,0,0,0,1.0,1,1.0,1,1.0,1,0.575074905180934,35
753,1,1932,1932,0,0,0,0,1.0,1,1.0,1,1.0,1,0.59090276718687,37
754,1,1933,1933,0,0,0,0,1.0,1,1.0,1,1.0,1,0.6078625141531845,37
755,3,1936,1936,0,0,0,0,1.0,1,1.0,1,1.0,1,0.5939238117670896,35
756,0,1936,1936,0,0,0,0,1.0,1,1.0,1,1.0,1,0.6003040264916094,36
757,1,1937,1937,0,0,0,0,1.0,1,1.0,1,1.0,1,0.618324007738028,35
758,0,1937,1937,0,0,0,0,1.0,1,1.0,1,1.0,1,0.6124937878251345,36
759,0,1937,1937,0,0,0,0,1.0,1,1.0,1,1.0,1,0.6034338549620881,37
760,0,1937,1937,0,0,0,0,1.0,1,1.0,1,1.0,1,0.624579942046202,36
761,0,1937,1937,0,0,0,0,1.0,1,1.0,1,1.0,1,0.624579942046202,36
762,0,1937,1937,0,0,0,0,1.0,1,1.0,1,1.0,1,0.6138436942146356,37
763,2,1939,1939,0,0,0,0,1.0,1,1.0,1,1.0,1,0.658861811938785,38
764,0,1939,1939,0,0,0,0,1.0,1,1.0,1,1.0,1,0.658861811938785,38
765,1,1940,1940,0,0,0,0,1.0,1,1.0,1,1.0,1,0.6645273867282332,38
766,3,1943,1943,0,0,0,0,1.0,1,1.0,1,1.0,1,0.6568691659940047,40
767,0,1943,1943,0,0,0,0,1.0,1,1.0,1,1.0,1,0.6457094003648841,41
768,2,1945,1945,0,0,0,0,1.0,1,1.0,1,1.0,1,0.6685552724368201,41
769,0,1945,1945,0,0,0,0,1.0,1,1.0,1,1.0,1,0.672487636818107,42
770,0,1945,1945,0,0,0,0,1.0,1,1.0,1,1.0,1,0.6509245833881716,41
771,3,1948,1948,0,0,0,0,1.0,1,1.0,1,1.0,1,0.6698706748556615,41
772,1,1949,1949,0,0,0,0,1.0,1,1.0,1,1.0,1,0.6560801181771757,41
773,1,1950,1950,0,0,0,0,1.0,1,1.0,1,1.0,1,0.615425729415343,41
774,0,1950,1950,0,0,0,0,1.0,1,1.0,1,1.0,1,0.6165971435273677,42
775,3,1953,1953,0,0,0,0,1.0,1,1.0,1,1.0,1,0.607276971965382,42
776,1,1954,1954,0,0,0,0,1.0,1,1.0,1,1.0,1,0.6209141751577024,42
777,2,1956,1956,0,0,0,0,1.0,1,1.0,1,1.0,1,0.6281481382927503,42
778,2,1958,1958,0,0,0,0,1.0,1,1.0,1,1.0,1,0.6431049476492837,44
779,3,1961,1961,0,0,0,0,1.0,1,1.0,1,1.0,1,0.6635848911637635,44
780,2,1963,1963,0,0,0,0,1.0,1,1.0,1,1.0,1,0.663759237531377,44
781,0,1963,1963,0,0,0,0,1.0,1,1.0,1,1.0,1,0.6534249917533949,46
782,2,1965,1965,0,0,0,0,1.0,1,1.0,1,1.0,1,0.6765169562021761,45
783,1,1966,1966,0,0,0,0,1.0,1,1.0,1,1.0,1,0.6561683153188781,44
784,1,1967,1967,0,0,0,0,1.0,1,1.0,1,1.0,1,0.6484421888697351,44
785,2,1969,1969,0,0,0,0,1.0,1,1.0,1,1.0,1,0.6511170212512953,43
786,3,1972,1972,0,0,0,0,1.0,1,1.0,1,1.0,1,0.6365149970086411,43
787,2,1974,1974,0,0,0,0,1.0,1,1.0,1,1.0,1,0.6410254037052858,43
788,4,1978,1978,0,0,0,0,1.0,1,1.0,1,1.0,1,0.6304041847724648,45
789,3,1981,1981,0,0,0,0,1.0,1,1.0,1,1.0,1,0.6230934925657545,46
790,3,1984,1984,0,0,0,0,1.0,1,1.0,1,1.0,1,0.6252694244569604,45
791,3,1987,1987,0,0,0,0,1.0,1,1.0,1,1.0,1,0.6122422886066132,46
792,2,1989,1989,0,0,0,0,1.0,1,1.0,1,1.0,1,0.6105184069906787,46
793,6,1995,1995,0,0,0,0,1.0,1,1.0,1,1.0,1,0.623757203420574,46
794,3,1998,1998,0,0,0,0,1.0,1,1.0,1,1.0,1,0.6413538347485684,47
795,6,2004,2004,0,0,0,0,1.0,1,1.0,1,1.0,1,0.6636269859598822,47
796,5,2009,2009,0,0,0,0,1.0,1,1.0,1,1.0,1,0.6491364948824655,46
797,5,2014,2014,0,0,0,0,1.0,1,1.0,1,1.0,1,0.723320359388734,47
798,6,2020,2020,0,0,0,0,1.0,1,1.0,1,1.0,1,0.6537369938055445,48
799,3,2023,2023,0,0,0,0,1.0,1,1.0,1,1.0,1,0.6656576518979295,48
800,4,2027,2027,0,0,0,0,1.0,1,1.0,1,1.0,1,0.6494924828948078,48
801,4,2031,2031,0,0,0,0,1.0,1,1.0,1,1.0,1,0.6040187179127912,49
802,1,2032,2032,0,0,0,0,1.0,1,1.0,1,1.0,1,0.6053790359717202,50
803,1,2033,2033,0,0,0,0,1.0,1,1.0,1,1.0,1,0.6134300382666855,49
804,1,2034,2034,0,0,0,0,1.0,1,1.0,1,1.0,1,0.5919976703289159,50
805,0,2034,2034,0,0,0,0,1.0,1,1.0,1,1.0,1,0.5919976703289159,50
806,3,2037,2037,0,0,0,0,1.0,1,1.0,1,1.0,1,0.6100527893147119,50
807,2,2039,2039,0,0,0,0,1.0,1,1.0,1,1.0,1,0.6172458895860179,51
808,1,2040,2040,0,0,0,0,1.0,1,1.0,1,1.0,1,0.6302850881013179,51
809,3,2043,2043,0,0,0,0,1.0,1,1.0,1,1.0,1,0.6166061363238478,51
810,2,2045,2045,0,0,0,0,1.0,1,1.0,1,1.0,1,0.616443294629266,52
811,2,2047,2047,0,0,0,0,1.0,1,1.0,1,1.0,1,0.5953221269601928,50
812,3,2050,2050,0,0,0,0,1.0,1,1.0,1,1.0,1,0.5691865899288565,48
813,2,2052,2052,0,0,0,0,1.0,1,1.0,1,1.0,1,0.5760045629324836,49
814,3,2055,2055,0,0,0,0,1.0,1,1.0,1,1.0,1,0.5466419018885132,48
815,2,2057,2057,0,0,0,0,1.0,1,1.0,1,1.0,1,0.538734813032617,48
816,3,2060,2060,0,0,0,0,1.0,1,1.0,1,1.0,1,0.516285387968205,46
817,1,2061,2061,0,0,0,0,1.0,1,1.0,1,1.0,1,0.5162189452981175,44
818,5,2066,2066,0,0,0,0,1.0,1,1.0,1,1.0,1,0.5059949537075749,46
819,2,2068,2068,0,0,0,0,1.0,1,1.0,1,1.0,1,0.4958049538351099,44
820,4,2072,2072,0,0,0,0,1.0,1,1.0,1,1.0,1,0.5105883861921447,44
821,1,2073,2073,0,0,0,0,1.0,1,1.0,1,1.0,1,0.49524556481725296,44
822,6,2079,2079,0,0,0,0,1.0,1,1.0,1,1.0,1,0.5194294567751823,44
823,3,2082,2082,0,0,0,0,1.0,1,1.0,1,1.0,1,0.5218788860838666,42
824,7,2089,2089,0,0,0,0,1.0,1,1.0,1,1.0,1,0.512809847370464,42
825,6,2095,2095,0,0,0,0,1.0,1,1.0,1,1.0,1,0.5996245924037705,40
826,7,2102,2102,0,0,0,0,1.0,1,1.0,1,1.0,1,0.5203005542948733,41
827,3,2105,2105,0,0,0,0,1.0,1,1.0,1,1.0,1,0.5160671976996519,40
828,2,2107,2107,0,0,0,0,1.0,1,1.0,1,1.0,1,0.5219977035653719,40
829,1,2108,2108,0,0,0,0,1.0,1,1.0,1,1.0,1,0.5309221211937971,42
830,1,2109,2109,0,0,0,0,1.0,1,1.0,1,1.0,1,0.5321849021368186,42
831,4,2113,2113,0,0,0,0,1.0,1,1.0,1,1.0,1,0.4932471188160911,43
832,1,2114,2114,0,0,0,0,1.0,1,1.0,1,1.0,1,0.5034405198052003,42
833,5,2119,2119,0,0,0,0,1.0,1,1.0,1,1.0,1,0.501807417194077,41
834,1,2120,2120,0,0,0,0,1.0,1,1.0,1,1.0,1,0.5058602094360969,41
835,2,2122,2122,0,0,0,0,1.0,1,1.0,1,1.0,1,0.49658806728321875,41
836,1,2123,2123,0,0,0,0,1.0,1,1.0,1,1.0,1,0.4908737185856933,40
837,3,2126,2126,0,0,0,0,1.0,1,1.0,1,1.0,1,0.4801338226482881,41
838,0,2126,2126,0,0,0,0,1.0,1,1.0,1,1.0,1,0.4801338226482881,41
839,1,2127,2127,0,0,0,0,1.0,1,1.0,1,1.0,1,0.4628178673704987,41
840,6,2133,2133,0,0,0,0,1.0,1,1.0,1,1.0,1,0.5126399916742097,42
841,2,2135,2135,0,0,0,0,1.0,1,1.0,1,1.0,1,0.49611721297657346,42
842,7,2142,2142,0,0,0,0,1.0,1,1.0,1,1.0,1,0.49309636911607363,42
843,5,2147,2147,0,0,0,0,1.0,1,1.0,1,1.0,1,0.4719865419222157,42
844,2,2149,2149,0,0,0,0,1.0,1,1.0,1,1.0,1,0.5017506015060716,42
845,2,2151,2151,0,0,0,0,1.0,1,1.0,1,1.0,1,0.505732273474407,44
846,0,2151,2151,0,0,0,0,1.0,1,1.0,1,1.0,1,0.505732273474407,44
847,5,2156,2156,0,0,0,0,1.0,1,1.0,1,1.0,1,0.507361791518497,42
848,1,2157,2157,0,0,0,0,1.0,1,1.0,1,1.0,1,0.5087534740963082,43
849,1,2158,2158,0,0,0,0,1.0,1,1.0,1,1.0,1,0.5196682887850599,43
850,0,2158,2158,0,0,0,0,1.0,1,1.0,1,1.0,1,0.5293261344457638,41
851,1,2159,2159,0,0,0,0,1.0,1,1.0,1,1.0,1,0.5581578976963639,40
852,1,2160,2160,0,0,0,0,1.0,1,1.0,1,1.0,1,0.5320065097866582,40
853,1,2161,2161,0,0,0,0,1.0,1,1.0,1,1.0,1,0.5054260787444799,40
854,3,2164,2164,0,0,0,0,1.0,1,1.0,1,1.0,1,0.5625844937515362,40
855,2,2166,2166,0,0,0,0,1.0,1,1.0,1,1.0,1,0.5540979226057406,41
856,1,2167,2167,0,0,0,0,1.0,1,1.0,1,1.0,1,0.5671090442507919,41
857,1,2168,2168,0,0,0,0,1.0,1,1.0,1,1.0,1,0.5613904459740123,42
858,4,2172,2172,0,0,0,0,1.0,1,1.0,1,1.0,1,0.58033593279228,43
859,4,2176,2176,0,0,0,0,1.0,1,1.0,1,1.0,1,0.5546718776216087,43
860,3,2179,2179,0,0,0,0,1.0,1,1.0,1,1.0,1,0.5662919391700398,44
861,3,2182,2182,0,0,0,0,1.0,1,1.0,1,1.0,1,0.5467519787168701,44
862,6,2188,2188,0,0,0,0,1.0,1,1.0,1,1.0,1,0.5084336744553758,44
863,1,2189,2189,0,0,0,0,1.0,1,1.0,1,1.0,1,0.5244390990704032,44
864,4,2193,2193,0,0,0,0,1.0,1,1.0,1,1.0,1,0.5880614304336274,44
865,3,2196,2196,0,0,0,0,1.0,1,1.0,1,1.0,1,0.5825833933226882,43
866,6,2202,2202,0,0,0,0,1.0,1,1.0,1,1.0,1,0.6095886343130861,45
867,5,2207,2207,0,0,0,0,1.0,1,1.0,1,1.0,1,0.5246072751871327,44
868,5,2212,2212,0,0,0,0,1.0,1,1.0,1,1.0,1,0.577611365663788,45
869,2,2214,2214,0,0,0,0,1.0,1,1.0,1,1.0,1,0.5351448741957506,44
870,5,2219,2219,0,0,0,0,1.0,1,1.0,1,1.0,1,0.5479877316025489,44
871,2,2221,2221,0,0,0,0,1.0,1,1.0,1,1.0,1,0.5568002788331929,43
872,3,2224,2224,0,0,0,0,1.0,1,1.0,1,1.0,1,0.5656485671164421,43
873,6,2230,2230,0,0,0,0,1.0,1,1.0,1,1.0,1,0.5616468938185598,43
874,3,2233,2233,0,0,0,0,1.0,1,1.0,1,1.0,1,0.5879267841565218,46
875,7,2240,2240,0,0,0,0,1.0,1,1.0,1,1.0,1,0.5885814533887029,43
876,2,2242,2242,0,0,0,0,1.0,1,1.0,1,1.0,1,0.6145014878495078,44
877,2,2244,2244,0,0,0,0,1.0,1,1.0,1,1.0,1,0.6249504925543418,44
878,2,2246,2246,0,0,0,0,1.0,1,1.0,1,1.0,1,0.6283039604034166,44
879,4,2250,2250,0,0,0,0,1.0,1,1.0,1,1.0,1,0.6136484475522159,44
880,0,2250,2250,0,0,0,0,1.0,1,1.0,1,1.0,1,0.6136484475522159,44
881,4,2254,2254,0,0,0,0,1.0,1,1.0,1,1.0,1,0.5994506192195963,43
882,0,2254,2254,0,0,0,0,1.0,1,1.0,1,1.0,1,0.5727715509684234,45
883,1,2255,2255,0,0,0,0,1.0,1,1.0,1,1.0,1,0.594108492856175,45
884,3,2258,2258,0,0,0,0,1.0,1,1.0,1,1.0,1,0.597680085060788,45
885,2,2260,2260,0,0,0,0,1.0,1,1.0,1,1.0,1,0.5980361398806916,43
886,4,2264,2264,0,0,0,0,1.0,1,1.0,1,1.0,1,0.5656923998104713,43
887,2,2266,2266,0,0,0,0,1.0,1,1.0,1,1.0,1,0.5765099870846933,41
888,4,2270,2270,0,0,0,0,1.0,1,1.0,1,1.0,1,0.5732138511654967,40
889,2,2272,2272,0,0,0,0,1.0,1,1.0,1,1.0,1,0.6122992783600484,40
890,4,2276,2276,0,0,0,0,1.0,1,1.0,1,1.0,1,0.611817565838982,38
891,3,2279,2279,0,0,0,0,1.0,1,1.0,1,1.0,1,0.5235371234866847,39
892,5,2284,2284,0,0,0,0,1.0,1,1.0,1,1.0,1,0.5333216092871936,39
893,5,2289,2289,0,0,0,0,1.0,1,1.0,1,1.0,1,0.5225040240111651,37
894,5,2294,2294,0,0,0,0,1.0,1,1.0,1,1.0,1,0.5586587521284432,36
895,3,2297,2297,0,0,0,0,1.0,1,1.0,1,1.0,1,0.5426401533009159,37
896,2,2299,2299,0,0,0,0,1.0,1,1.0,1,1.0,1,0.5465829168699021,36
897,1,2300,2300,0,0,0,0,1.0,1,1.0,1,1.0,1,0.5390512377626783,36
898,2,2302,2302,0,0,0,0,1.0,1,1.0,1,1.0,1,0.5619978122087044,35
899,5,2307,2307,0,0,0,0,1.0,1,1.0,1,1.0,1,0.5538001183820989,35
900,3,2310,2310,0,0,0,0,1.0,1,1.0,1,1.0,1,0.5822674436442078,36
901,2,2312,2312,0,0,0,0,1.0,1,1.0,1,1.0,1,0.6193593876819854,36
902,5,2317,2317,0,0,0,0,1.0,1,1.0,1,1.0,1,0.5604506486066136,36
903,2,2319,2319,0,0,0,0,1.0,1,1.0,1,1.0,1,0.5651624180723169,35
904,8,2327,2327,0,0,0,0,1.0,1,1.0,1,1.0,1,0.5011585600682432,37
905,2,2329,2329,0,0,0,0,1.0,1,1.0,1,1.0,1,0.5259585043094098,36
906,5,2334,2334,0,0,0,0,1.0,1,1.0,1,1.0,1,0.5049525012698292,37
907,4,2338,2338,0,0,0,0,1.0,1,1.0,1,1.0,1,0.4714621271389101,37
908,2,2340,2340,0,0,0,0,1.0,1,1.0,1,1.0,1,0.5134332438683316,36
909,4,2344,2344,0,0,0,0,1.0,1,1.0,1,1.0,1,0.5433745490818875,36
910,4,2348,2348,0,0,0,0,1.0,1,1.0,1,1.0,1,0.5603145399314754,37
911,0,2348,2348,0,0,0,0,1.0,1,1.0,1,1.0,1,0.5953344452681252,36
912,1,2349,2349,0,0,0,0,1.0,1,1.0,1,1.0,1,0.6173818869105501,34
913,2,2351,2351,0,0,0,0,1.0,1,1.0,1,1.0,1,0.6449318354057779,34
914,3,2354,2354,0,0,0,0,1.0,1,1.0,1,1.0,1,0.6710673650682648,33
915,2,2356,2356,0,0,0,0,1.0,1,1.0,1,1.0,1,0.6499843553233493,33
916,1,2357,2357,0,0,0,0,1.0,1,1.0,1,1.0,1,0.6403369787193335,34
917,1,2358,2358,0,0,0,0,1.0,1,1.0,1,1.0,1,0.6454607122967116,34
918,4,2362,2362,0,0,0,0,1.0,1,1.0,1,1.0,1,0.6149827806422863,36
919,2,2364,2364,0,0,0,0,1.0,1,1.0,1,1.0,1,0.6099386823731161,36
920,2,2366,2366,0,0,0,0,1.0,1,1.0,1,1.0,1,0.5804537834443694,37
921,0,2366,2366,0,0,0,0,1.0,1,1.0,1,1.0,1,0.5804537834443694,37
922,2,2368,2368,0,0,0,0,1.0,1,1.0,1,1.0,1,0.5676531554585924,38
923,1,2369,2369,0,0,0,0,1.0,1,1.0,1,1.0,1,0.5469693914202494,36
924,4,2373,2373,0,0,0,0,1.0,1,1.0,1,1.0,1,0.5004351269370073,35
925,1,2374,2374,0,0,0,0,1.0,1,1.0,1,1.0,1,0.5080784040016622,35
926,2,2376,2376,0,0,0,0,1.0,1,1.0,1,1.0,1,0.5108192980713092,34
927,0,2376,2376,0,0,0,0,1.0,1,1.0,1,1.0,1,0.5150514364760078,32
928,6,2382,2382,0,0,0,0,1.0,1,1.0,1,1.0,1,0.4798665684504725,32
929,0,2382,2382,0,0,0,0,1.0,1,1.0,1,1.0,1,0.47285303482833735,31
930,3,2385,2385,0,0,0,0,1.0,1,1.0,1,1.0,1,0.5316721096039658,30
931,0,2385,2385,0,0,0,0,1.0,1,1.0,1,1.0,1,0.5267971044343672,29
932,3,2388,2388,0,0,0,0,1.0,1,1.0,1,1.0,1,0.5256640234682596,29
933,7,2395,2395,0,0,0,0,1.0,1,1.0,1,1.0,1,0.6015916187716324,29
934,0,2395,2395,0,0,0,0,1.0,1,1.0,1,1.0,1,0.6015916187716324,29
935,4,2399,2399,0,0,0,0,1.0,1,1.0,1,1.0,1,0.6344327284923217,31
936,0,2399,2399,0,0,0,0,1.0,1,1.0,1,1.0,1,0.6344327284923217,31
937,3,2402,2402,0,0,0,0,1.0,1,1.0,1,1.0,1,0.5989903019200234,34
938,2,2404,2404,0,0,0,0,1.0,1,1.0,1,1.0,1,0.6396656991382738,33
939,5,2409,2409,0,0,0,0,1.0,1,1.0,1,1.0,1,0.6478586432303467,36
940,3,2412,2412,0,0,0,0,1.0,1,1.0,1,1.0,1,0.6506259309993336,36
941,2,2414,2414,0,0,0,0,1.0,1,1.0,1,1.0,1,0.647621382584514,36
942,1,2415,2415,0,0,0,0,1.0,1,1.0,1,1.0,1,0.6581153422744821,36
943,3,2418,2418,0,0,0,0,1.0,1,1.0,1,1.0,1,0.6783998785742653,35
944,1,2419,2419,0,0,0,0,1.0,1,1.0,1,1.0,1,0.6618052587117387,35
945,2,2421,2421,0,0,0,0,1.0,1,1.0,1,1.0,1,0.683286339121666,33
946,1,2422,2422,0,0,0,0,1.0,1,1.0,1,1.0,1,0.6711918096559742,36
947,0,2422,2422,0,0,0,0,1.0,1,1.0,1,1.0,1,0.6714420330155901,34
948,1,2423,2423,0,0,0,0,1.0,1,1.0,1,1.0,1,0.6793572949314723,33
949,1,2424,2424,0,0,0,0,1.0,1,1.0,1,1.0,1,0.7074052387862428,34
950,1,2425,2425,0,0,0,0,1.0,1,1.0,1,1.0,1,0.7046264704912933,33
951,0,2425,2425,0,0,0,0,1.0,1,1.0,1,1.0,1,0.7046264704912933,33
952,1,2426,2426,0,0,0,0,1.0,1,1.0,1,1.0,1,0.6989126661744473,32
953,0,2426,2426,0,0,0,0,1.0,1,1.0,1,1.0,1,0.6989126661744473,32
954,0,2426,2426,0,0,0,0,1.0,1,1.0,1,1.0,1,0.7031177847869092,31
955,1,2427,2427,0,0,0,0,1.0,1,1.0,1,1.0,1,0.6978615896322443,32
956,1,2428,2428,0,0,0,0,1.0,1,1.0,1,1.0,1,0.718852302385169,32
957,3,2431,2431,0,0,0,0,1.0,1,1.0,1,1.0,1,0.6971151357979576,33
958,0,2431,2431,0,0,0,0,1.0,1,1.0,1,1.0,1,0.6843425235700331,35
959,3,2434,2434,0,0,0,0,1.0,1,1.0,1,1.0,1,0.7045032852660891,36
960,0,2434,2434,0,0,0,0,1.0,1,1.0,1,1.0,1,0.7079392841311464,38
961,1,2435,2435,0,0,0,0,1.0,1,1.0,1,1.0,1,0.6796732123560775,37
962,2,2437,2437,0,0,0,0,1.0,1,1.0,1,1.0,1,0.6706498095237546,35
963,4,2441,2441,0,0,0,0,1.0,1,1.0,1,1.0,1,0.6362991917935573,35
964,1,2442,2442,0,0,0,0,1.0,1,1.0,1,1.0,1,0.6286656848393447,34
965,5,2447,2447,0,0,0,0,1.0,1,1.0,1,1.0,1,0.6134285958882985,35
966,3,2450,2450,0,0,0,0,1.0,1,1.0,1,1.0,1,0.5655183373655586,34
967,6,2456,2456,0,0,0,0,1.0,1,1.0,1,1.0,1,0.5099239801310975,35
968,2,2458,2458,0,0,0,0,1.0,1,1.0,1,1.0,1,0.48464173582490255,36
969,5,2463,2463,0,0,0,0,1.0,1,1.0,1,1.0,1,0.484952937672144,35
970,1,2464,2464,0,0,0,0,1.0,1,1.0,1,1.0,1,0.4655006031442979,34
971,0,2464,2464,0,0,0,0,1.0,1,1.0,1,1.0,1,0.4749060561054216,35
972,3,2467,2467,0,0,0,0,1.0,1,1.0,1,1.0,1,0.4815851448508861,35
973,1,2468,2468,0,0,0,0,1.0,1,1.0,1,1.0,1,0.49530298955507307,36
974,4,2472,2472,0,0,0,0,1.0,1,1.0,1,1.0,1,0.5284221838460906,35
975,1,2473,2473,0,0,0,0,1.0,1,1.0,1,1.0,1,0.5034968527763527,36
976,3,2476,2476,0,0,0,0,1.0,1,1.0,1,1.0,1,0.5013271158446692,38
977,1,2477,2477,0,0,0,0,1.0,1,1.0,1,1.0,1,0.5116723490480525,38
978,2,2479,2479,0,0,0,0,1.0,1,1.0,1,1.0,1,0.5160941971580383,38
979,2,2481,2481,0,0,0,0,1.0,1,1.0,1,1.0,1,0.5358562025810965,39
980,6,2487,2487,0,0,0,0,1.0,1,1.0,1,1.0,1,0.6009761871604794,39
981,1,2488,2488,0,0,0,0,1.0,1,1.0,1,1.0,1,0.6243085953186118,40
982,4,2492,2492,0,0,0,0,1.0,1,1.0,1,1.0,1,0.6768991435876857,40
983,2,2494,2494,0,0,0,0,1.0,1,1.0,1,1.0,1,0.6645407055725536,38
984,2,2496,2496,0,0,0,0,1.0,1,1.0,1,1.0,1,0.6659438286989021,39
985,2,2498,2498,0,0,0,0,1.0,1,1.0,1,1.0,1,0.6720760863399123,38
986,0,2498,2498,0,0,0,0,1.0,1,1.0,1,1.0,1,0.6720760863399123,38
987,1,2499,2499,0,0,0,0,1.0,1,1.0,1,1.0,1,0.6933113962015112,38
988,1,2500,2500,0,0,0,0,1.0,1,1.0,1,1.0,1,0.7154016072382616,38
989,0,2500,2500,0,0,0,0,1.0,1,1.0,1,1.0,1,0.7199674010516158,38
990,0,2500,2500,0,0,0,0,1.0,1,1.0,1,1.0,1,0.7199674010516158,38
991,1,2501,2501,0,0,0,0,1.0,1,1.0,1,1.0,1,0.7026585609228513,40
992,1,2502,2502,0,0,0,0,1.0,1,1.0,1,1.0,1,0.6995014804780364,39
993,1,2503,2503,0,0,0,0,1.0,1,1.0,1,1.0,1,0.7054411530378795,38
994,1,2504,2504,0,0,0,0,1.0,1,1.0,1,1.0,1,0.716590583814502,39
995,2,2506,2506,0,0,0,0,1.0,1,1.0,1,1.0,1,0.7110691871818372,41
996,0,2506,2506,0,0,0,0,1.0,1,1.0,1,1.0,1,0.7074767540735826,40
997,0,2506,2506,0,0,0,0,1.0,1,1.0,1,1.0,1,0.7129804379777267,41
998,0,2506,2506,0,0,0,0,1.0,1,1.0,1,1.0,1,0.7207282184434337,40
999,0,2506,2506,0,0,0,0,1.0,1,1.0,1,1.0,1,0.7142772767784537,40
1000,0,2506,2506,0,0,0,0,1.0,1,1.0,1,1.0,1,0.7142772767784537,40
1001,0,2506,2506,0,0,0,0,1.0,1,1.0,1,1.0,1,0.6967668382841125,39
1002,0,2506,2506,0,0,0,0,1.0,1,1.0,1,1.0,1,0.6967668382841125,39
1003,2,2508,2508,0,0,0,0,1.0,1,1.0,1,1.0,1,0.6793371710613225,39
1004,0,2508,2508,0,0,0,0,1.0,1,1.0,1,1.0,1,0.6793371710613225,39
1005,2,2510,2510,0,0,0,0,1.0,1,1.0,1,1.0,1,0.6720177973690293,40
1006,1,2511,2511,0,0,0,0,1.0,1,1.0,1,1.0,1,0.6530841379145248,41
1007,2,2513,2513,0,0,0,0,1.0,1,1.0,1,1.0,1,0.6636763433366927,42
1008,3,2516,2516,0,0,0,0,1.0,1,1.0,1,1.0,1,0.6491980385088629,43
1009,2,2518,2518,0,0,0,0,1.0,1,1.0,1,1.0,1,0.6588509130004875,44
1010,2,2520,2520,0,0,0,0,1.0,1,1.0,1,1.0,1,0.6651730761900273,44
1011,2,2522,2522,0,0,0,0,1.0,1,1.0,1,1.0,1,0.6798411586961767,44
1012,4,2526,2526,0,0,0,0,1.0,1,1.0,1,1.0,1,0.6513978127723583,46
1013,1,2527,2527,0,0,0,0,1.0,1,1.0,1,1.0,1,0.6558658062514183,46
1014,1,2528,2528,0,0,0,0,1.0,1,1.0,1,1.0,1,0.6608656034044622,46
1015,1,2529,2529,0,0,0,0,1.0,1,1.0,1,1.0,1,0.664131131353371,46
1016,4,2533,2533,0,0,0,0,1.0,1,1.0,1,1.0,1,0.6593809132038564,47
1017,1,2534,2534,0,0,0,0,1.0,1,1.0,1,1.0,1,0.6529913099758977,47
1018,4,2538,2538,0,0,0,0,1.0,1,1.0,1,1.0,1,0.6256243392447643,48
1019,5,2543,2543,0,0,0,0,1.0,1,1.0,1,1.0,1,0.6136772705661236,49
1020,2,2545,2545,0,0,0,0,1.0,1,1.0,1,1.0,1,0.5950016751376247,51
1021,3,2548,2548,0,0,0,0,1.0,1,1.0,1,1.0,1,0.5809053912468127,51
1022,1,2549,2549,0,0,0,0,1.0,1,1.0,1,1.0,1,0.5677723904137387,52
1023,2,2551,2551,0,0,0,0,1.0,1,1.0,1,1.0,1,0.5893790966331705,52
1024,2,2553,2553,0,0,0,0,1.0,1,1.0,1,1.0,1,0.5954128679951965,52
1025,4,2557,2557,0,0,0,0,1.0,1,1.0,1,1.0,1,0.5895406875223704,54
1026,2,2559,2559,0,0,0,0,1.0,1,1.0,1,1.0,1,0.6039310037856921,54
1027,4,2563,2563,0,0,0,0,1.0,1,1.0,1,1.0,1,0.5983702354079109,55
1028,2,2565,2565,0,0,0,0,1.0,1,1.0,1,1.0,1,0.6017459570855733,56
1029,2,2567,2567,0,0,0,0,1.0,1,1.0,1,1.0,1,0.5959322112134464,56
1030,5,2572,2572,0,0,0,0,1.0,1,1.0,1,1.0,1,0.647260540695664,57
1031,1,2573,2573,0,0,0,0,1.0,1,1.0,1,1.0,1,0.6264777690943815,58
1032,7,2580,2580,0,0,0,0,1.0,1,1.0,1,1.0,1,0.6593707067260558,58
1033,3,2583,2583,0,0,0,0,1.0,1,1.0,1,1.0,1,0.6847327741842486,57
1034,2,2585,2585,0,0,0,0,1.0,1,1.0,1,1.0,1,0.6968884337587247,57
1035,5,2590,2590,0,0,0,0,1.0,1,1.0,1,1.0,1,0.6727151368662249,57
1036,2,2592,2592,0,0,0,0,1.0,1,1.0,1,1.0,1,0.6674210094403563,59
1037,7,2599,2599,0,0,0,0,1.0,1,1.0,1,1.0,1,0.6819543247876279,57
1038,3,2602,2602,0,0,0,0,1.0,1,1.0,1,1.0,1,0.6803594455493555,59
1039,2,2604,2604,0,0,0,0,1.0,1,1.0,1,1.0,1,0.6712637150840582,57
1040,4,2608,2608,0,0,0,0,1.0,1,1.0,1,1.0,1,0.6657047118608083,56
1041,4,2612,2612,0,0,0,0,1.0,1,1.0,1,1.0,1,0.6576092530417169,54
1042,6,2618,2618,0,0,0,0,1.0,1,1.0,1,1.0,1,0.6705616788985356,52
1043,4,2622,2622,0,0,0,0,1.0,1,1.0,1,1.0,1,0.6765134963424021,52
1044,2,2624,2624,0,0,0,0,1.0,1,1.0,1,1.0,1,0.651463861593156,50
1045,7,2631,2631,0,0,0,0,1.0,1,1.0,1,1.0,1,0.6452822997714264,51
1046,3,2634,2634,0,0,0,0,1.0,1,1.0,1,1.0,1,0.6312751734941252,50
1047,4,2638,2638,0,0,0,0,1.0,1,1.0,1,1.0,1,0.599384221427937,50
1048,1,2639,2639,0,0,0,0,1.0,1,1.0,1,1.0,1,0.5887759188406367,50
1049,1,2640,2640,0,0,0,0,1.0,1,1.0,1,1.0,1,0.5710293854601584,50
1050,2,2642,2642,0,0,0,0,1.0,1,1.0,1,1.0,1,0.5447969085805634,50
1051,1,2643,2643,0,0,0,0,1.0,1,1.0,1,1.0,1,0.5278552489933999,50
1052,2,2645,2645,0,0,0,0,1.0,1,1.0,1,1.0,1,0.5319103568939099,51
1053,0,2645,2645,0,0,0,0,1.0,1,1.0,1,1.0,1,0.5319103568939099,51
1054,1,2646,2646,0,0,0,0,1.0,1,1.0,1,1.0,1,0.5279606251316461,53
1055,2,2648,2648,0,0,0,0,1.0,1,1.0,1,1.0,1,0.5269296506908937,54
1056,1,2649,2649,0,0,0,0,1.0,1,1.0,1,1.0,1,0.5265806074915276,54
1057,4,2653,2653,0,0,0,0,1.0,1,1.0,1,1.0,1,0.5563248204520419,55
1058,2,2655,2655,0,0,0,0,1.0,1,1.0,1,1.0,1,0.5779180810778595,54
1059,6,2661,2661,0,0,0,0,1.0,1,1.0,1,1.0,1,0.5860152093079197,53
1060,3,2664,2664,0,0,0,0,1.0,1,1.0,1,1.0,1,0.5940772680980324,53
1061,3,2667,2667,0,0,0,0,1.0,1,1.0,1,1.0,1,0.5903261457806168,53
1062,3,2670,2670,0,0,0,0,1.0,1,1.0,1,1.0,1,0.5753755600717648,54
1063,4,2674,2674,0,0,0,0,1.0,1,1.0,1,1.0,1,0.6020434942815638,53
1064,4,2678,2678,0,0,0,0,1.0,1,1.0,1,1.0,1,0.6081520067427811,55
1065,5,2683,2683,0,0,0,0,1.0,1,1.0,1,1.0,1,0.6415092424736992,54
1066,4,2687,2687,0,0,0,0,1.0,1,1.0,1,1.0,1,0.6347675986040882,55
1067,4,2691,2691,0,0,0,0,1.0,1,1.0,1,1.0,1,0.6397947062428742,55
1068,4,2695,2695,0,0,0,0,1.0,1,1.0,1,1.0,1,0.6480451685434871,55
1069,3,2698,2698,0,0,0,0,1.0,1,1.0,1,1.0,1,0.6300095231476657,55
1070,4,2702,2702,0,0,0,0,1.0,1,1.0,1,1.0,1,0.6524880626488523,54
1071,5,2707,2707,0,0,0,0,1.0,1,1.0,1,1.0,1,0.6260733255546707,55
1072,3,2710,2710,0,0,0,0,1.0,1,1.0,1,1.0,1,0.6143386161963261,54
1073,6,2716,2716,0,0,0,0,1.0,1,1.0,1,1.0,1,0.6486179674230177,54
1074,6,2722,2722,0,0,0,0,1.0,1,1.0,1,1.0,1,0.6223174734872619,52
1075,2,2724,2724,0,0,0,0,1.0,1,1.0,1,1.0,1,0.63208974901374,51
1076,5,2729,2729,0,0,0,0,1.0,1,1.0,1,1.0,1,0.6378833556311478,52
1077,3,2732,2732,0,0,0,0,1.0,1,1.0,1,1.0,1,0.6125817723327621,49
1078,1,2733,2733,0,0,0,0,1.0,1,1.0,1,1.0,1,0.6146386965197347,48
1079,4,2737,2737,0,0,0,0,1.0,1,1.0,1,1.0,1,0.5831171884248354,47
1080,0,2737,2737,0,0,0,0,1.0,1,1.0,1,1.0,1,0.5538527666634974,47
1081,1,2738,2738,0,0,0,0,1.0,1,1.0,1,1.0,1,0.5648535946463789,45
1082,4,2742,2742,0,0,0,0,1.0,1,1.0,1,1.0,1,0.572437234228265,42
1083,1,2743,2743,0,0,0,0,1.0,1,1.0,1,1.0,1,0.5660533611390761,42
1084,2,2745,2745,0,0,0,0,1.0,1,1.0,1,1.0,1,0.5748935343403785,40
1085,2,2747,2747,0,0,0,0,1.0,1,1.0,1,1.0,1,0.5388790034400991,43
1086,1,2748,2748,0,0,0,0,1.0,1,1.0,1,1.0,1,0.5539020650043989,41
1087,1,2749,2749,0,0,0,0,1.0,1,1.0,1,1.0,1,0.5785488365596334,41
1088,0,2749,2749,0,0,0,0,1.0,1,1.0,1,1.0,1,0.5785488365596334,41
1089,2,2751,2751,0,0,0,0,1.0,1,1.0,1,1.0,1,0.5661219076780831,42
1090,3,2754,2754,0,0,0,0,1.0,1,1.0,1,1.0,1,0.5237909230190673,43
1091,4,2758,2758,0,0,0,0,1.0,1,1.0,1,1.0,1,0.5288765722273426,43
1092,3,2761,2761,0,0,0,0,1.0,1,1.0,1,1.0,1,0.585918327143806,43
1093,4,2765,2765,0,0,0,0,1.0,1,1.0,1,1.0,1,0.5573475465860516,43
1094,2,2767,2767,0,0,0,0,1.0,1,1.0,1,1.0,1,0.5615554048518554,43
1095,4,2771,2771,0,0,0,0,1.0,1,1.0,1,1.0,1,0.6028730993759988,44
1096,3,2774,2774,0,0,0,0,1.0,1,1.0,1,1.0,1,0.6216049619221345,44
1097,3,2777,2777,0,0,0,0,1.0,1,1.0,1,1.0,1,0.6231079502574711,45
1098,2,2779,2779,0,0,0,0,1.0,1,1.0,1,1.0,1,0.5952930621130283,46
1099,6,2785,2785,0,0,0,0,1.0,1,1.0,1,1.0,1,0.5507623409396087,48
1100,5,2790,2790,0,0,0,0,1.0,1,1.0,1,1.0,1,0.5673772471968147,49
1101,3,2793,2793,0,0,0,0,1.0,1,1.0,1,1.0,1,0.5254821821286803,49
1102,5,2798,2798,0,0,0,0,1.0,1,1.0,1,1.0,1,0.5043775407133078,50
1103,1,2799,2799,0,0,0,0,1.0,1,1.0,1,1.0,1,0.4958323724832125,48
1104,4,2803,2803,0,0,0,0,1.0,1,1.0,1,1.0,1,0.5134832321467702,50
1105,5,2808,2808,0,0,0,0,1.0,1,1.0,1,1.0,1,0.5213937949571832,48
1106,2,2810,2810,0,0,0,0,1.0,1,1.0,1,1.0,1,0.5562633748323491,48
1107,3,2813,2813,0,0,0,0,1.0,1,1.0,1,1.0,1,0.5633220031725052,47
1108,4,2817,2817,0,0,0,0,1.0,1,1.0,1,1.0,1,0.5826979903977584,47
1109,4,2821,2821,0,0,0,0,1.0,1,1.0,1,1.0,1,0.521472862078813,46
1110,2,2823,2823,0,0,0,0,1.0,1,1.0,1,1.0,1,0.5549353968884706,43
1111,3,2826,2826,0,0,0,0,1.0,1,1.0,1,1.0,1,0.5946994247754653,44
1112,1,2827,2827,0,0,0,0,1.0,1,1.0,1,1.0,1,0.6197765910676477,43
1113,4,2831,2831,0,0,0,0,1.0,1,1.0,1,1.0,1,0.6633768030351602,39
1114,1,2832,2832,0,0,0,0,1.0,1,1.0,1,1.0,1,0.6782663419847759,39
1115,2,2834,2834,0,0,0,0,1.0,1,1.0,1,1.0,1,0.653242008461916,37
1116,5,2839,2839,0,0,0,0,1.0,1,1.0,1,1.0,1,0.6025357919309527,37
1117,2,2841,2841,0,0,0,0,1.0,1,1.0,1,1.0,1,0.6051789845358291,36
1118,2,2843,2843,0,0,0,0,1.0,1,1.0,1,1.0,1,0.5483850507916135,36
1119,2,2845,2845,0,0,0,0,1.0,1,1.0,1,1.0,1,0.5475523769504118,36
1120,1,2846,2846,0,0,0,0,1.0,1,1.0,1,1.0,1,0.5486295952074572,36
1121,2,2848,2848,0,0,0,0,1.0,1,1.0,1,1.0,1,0.5711545024666029,36
1122,3,2851,2851,0,0,0,0,1.0,1,1.0,1,1.0,1,0.6043039812621406,37
1123,4,2855,2855,0,0,0,0,1.0,1,1.0,1,1.0,1,0.6175292973087739,37
1124,3,2858,2858,0,0,0,0,1.0,1,1.0,1,1.0,1,0.6129687775883774,37
1125,1,2859,2859,0,0,0,0,1.0,1,1.0,1,1.0,1,0.6066953715929122,38
1126,2,2861,2861,0,0,0,0,1.0,1,1.0,1,1.0,1,0.6002138761507556,38
1127,0,2861,2861,0,0,0,0,1.0,1,1.0,1,1.0,1,0.6092483328463265,39
1128,3,2864,2864,0,0,0,0,1.0,1,1.0,1,1.0,1,0.5892184554314746,39
1129,0,2864,2864,0,0,0,0,1.0,1,1.0,1,1.0,1,0.5892184554314746,39
1130,2,2866,2866,0,0,0,0,1.0,1,1.0,1,1.0,1,0.5769830725974242,39
1131,2,2868,2868,0,0,0,0,1.0,1,1.0,1,1.0,1,0.5953315593630624,39
1132,3,2871,2871,0,0,0,0,1.0,1,1.0,1,1.0,1,0.5668932439938094,39
1133,2,2873,2873,0,0,0,0,1.0,1,1.0,1,1.0,1,0.5092997601977144,42
1134,1,2874,2874,0,0,0,0,1.0,1,1.0,1,1.0,1,0.5233676001486773,42
1135,2,2876,2876,0,0,0,0,1.0,1,1.0,1,1.0,1,0.5217143547432043,44
1136,1,2877,2877,0,0,0,0,1.0,1,1.0,1,1.0,1,0.5445899507314109,46
1137,0,2877,2877,0,0,0,0,1.0,1,1.0,1,1.0,1,0.5601445947460589,45
1138,5,2882,2882,0,0,0,0,1.0,1,1.0,1,1.0,1,0.59568027536822,46
1139,3,2885,2885,0,0,0,0,1.0,1,1.0,1,1.0,1,0.6026704384658902,47
1140,3,2888,2888,0,0,0,0,1.0,1,1.0,1,1.0,1,0.6187618053595076,46
1141,8,2896,2896,0,0,0,0,1.0,1,1.0,1,1.0,1,0.6137313527633839,45
1142,3,2899,2899,0,0,0,0,1.0,1,1.0,1,1.0,1,0.6184107579920126,45
1143,9,2908,2908,0,0,0,0,1.0,1,1.0,1,1.0,1,0.5834052740785811,43
1144,4,2912,2912,0,0,0,0,1.0,1,1.0,1,1.0,1,0.526428786644285,45
1145,8,2920,2920,0,0,0,0,1.0,1,1.0,1,1.0,1,0.49004942032620136,44
1146,3,2923,2923,0,0,0,0,1.0,1,1.0,1,1.0,1,0.5198183302114409,45
1147,5,2928,2928,0,0,0,0,1.0,1,1.0,1,1.0,1,0.5160138820061361,44
1148,3,2931,2931,0,0,0,0,1.0,1,1.0,1,1.0,1,0.5410844773082777,43
1149,3,2934,2934,0,0,0,0,1.0,1,1.0,1,1.0,1,0.6094950826667606,42
1150,5,2939,2939,0,0,0,0,1.0,1,1.0,1,1.0,1,0.5913165012038998,45
1151,1,2940,2940,0,0,0,0,1.0,1,1.0,1,1.0,1,0.6134898727900543,40
1152,2,2942,2942,0,0,0,0,1.0,1,1.0,1,1.0,1,0.5966880621554937,41
1153,3,2945,2945,0,0,0,0,1.0,1,1.0,1,1.0,1,0.5688983135932659,38
1154,3,2948,2948,0,0,0,0,1.0,1,1.0,1,1.0,1,0.5883812827334638,37
1155,3,2951,2951,0,0,0,0,1.0,1,1.0,1,1.0,1,0.5444544657820055,38
1156,1,2952,2952,0,0,0,0,1.0,1,1.0,1,1.0,1,0.5477590818852822,38
1157,0,2952,2952,0,0,0,0,1.0,1,1.0,1,1.0,1,0.5412911257979572,37
1158,2,2954,2954,0,0,0,0,1.0,1,1.0,1,1.0,1,0.5072923653805435,36
1159,0,2954,2954,0,0,0,0,1.0,1,1.0,1,1.0,1,0.5181190251294185,35
1160,2,2956,2956,0,0,0,0,1.0,1,1.0,1,1.0,1,0.5036885924824479,35
1161,1,2957,2957,0,0,0,0,1.0,1,1.0,1,1.0,1,0.5050170357917855,36
1162,0,2957,2957,0,0,0,0,1.0,1,1.0,1,1.0,1,0.4995863789345684,37
1163,3,2960,2960,0,0,0,0,1.0,1,1.0,1,1.0,1,0.5310303424225337,37
1164,3,2963,2963,0,0,0,0,1.0,1,1.0,1,1.0,1,0.5220703272352832,38
1165,1,2964,2964,0,0,0,0,1.0,1,1.0,1,1.0,1,0.538941480864602,38
1166,3,2967,2967,0,0,0,0,1.0,1,1.0,1,1.0,1,0.612507239857688,40
1167,1,2968,2968,0,0,0,0,1.0,1,1.0,1,1.0,1,0.6446338358011651,40
1168,2,2970,2970,0,0,0,0,1.0,1,1.0,1,1.0,1,0.6999492774373014,40
1169,2,2972,2972,0,0,0,0,1.0,1,1.0,1,1.0,1,0.6458139587584696,41
1170,0,2972,2972,0,0,0,0,1.0,1,1.0,1,1.0,1,0.6458139587584696,41
1171,2,2974,2974,0,0,0,0,1.0,1,1.0,1,1.0,1,0.6079825282970889,43
1172,2,2976,2976,0,0,0,0,1.0,1,1.0,1,1.0,1,0.581679400791579,43
1173,2,2978,2978,0,0,0,0,1.0,1,1.0,1,1.0,1,0.5959904520702087,43
1174,0,2978,2978,0,0,0,0,1.0,1,1.0,1,1.0,1,0.5959904520702087,43
1175,0,2978,2978,0,0,0,0,1.0,1,1.0,1,1.0,1,0.6020530856799476,44
1176,0,2978,2978,0,0,0,0,1.0,1,1.0,1,1.0,1,0.6075371079946962,45
1177,1,2979,2979,0,0,0,0,1.0,1,1.0,1,1.0,1,0.6253404905974069,45
1178,3,2982,2982,0,0,0,0,1.0,1,1.0,1,1.0,1,0.6026961479415014,45
1179,2,2984,2984,0,0,0,0,1.0,1,1.0,1,1.0,1,0.6055633779231471,46
1180,4,2988,2988,0,0,0,0,1.0,1,1.0,1,1.0,1,0.6262550240393967,47
1181,3,2991,2991,0,0,0,0,1.0,1,1.0,1,1.0,1,0.6522118590336371,48
1182,0,2991,2991,0,0,0,0,1.0,1,1.0,1,1.0,1,0.6522118590336371,48
1183,2,2993,2993,0,0,0,0,1.0,1,1.0,1,1.0,1,0.6793968937694795,46
1184,0,2993,2993,0,0,0,0,1.0,1,1.0,1,1.0,1,0.6609250813352321,47
1185,0,2993,2993,0,0,0,0,1.0,1,1.0,1,1.0,1,0.6842948340639149,44
1186,0,2993,2993,0,0,0,0,1.0,1,1.0,1,1.0,1,0.6830127217903705,47
1187,0,2993,2993,0,0,0,0,1.0,1,1.0,1,1.0,1,0.6833072989749454,49
1188,1,2994,2994,0,0,0,0,1.0,1,1.0,1,1.0,1,0.6734708810940324,50
1189,2,2996,2996,0,0,0,0,1.0,1,1.0,1,1.0,1,0.6576344231342378,48
1190,1,2997,2997,0,0,0,0,1.0,1,1.0,1,1.0,1,0.6553416625300356,48
1191,4,3001,3001,0,0,0,0,1.0,1,1.0,1,1.0,1,0.627655621434928,46
1192,3,3004,3004,0,0,0,0,1.0,1,1.0,1,1.0,1,0.6309439324116684,46
1193,4,3008,3008,0,0,0,0,1.0,1,1.0,1,1.0,1,0.6295853722029378,45
1194,1,3009,3009,0,0,0,0,1.0,1,1.0,1,1.0,1,0.6216805063827144,45
1195,2,3011,3011,0,0,0,0,1.0,1,1.0,1,1.0,1,0.6152851734216958,47
1196,3,3014,3014,0,0,0,0,1.0,1,1.0,1,1.0,1,0.6305255684957123,48
1197,3,3017,3017,0,0,0,0,1.0,1,1.0,1,1.0,1,0.6598381425735441,49
1198,2,3019,3019,0,0,0,0,1.0,1,1.0,1,1.0,1,0.631516671122021,49
1199,0,3019,3019,0,0,0,0,1.0,1,1.0,1,1.0,1,0.626754304525882,50
1200,1,3020,3020,0,0,0,0,1.0,1,1.0,1,1.0,1,0.6225960184053383,50
1201,1,3021,3021,0,0,0,0,1.0,1,1.0,1,1.0,1,0.6380265261021989,50
1202,3,3024,3024,0,0,0,0,1.0,1,1.0,1,1.0,1,0.6246841323692525,51
1203,0,3024,3024,0,0,0,0,1.0,1,1.0,1,1.0,1,0.6151542237876875,52
1204,1,3025,3025,0,0,0,0,1.0,1,1.0,1,1.0,1,0.6157247873044837,52
1205,2,3027,3027,0,0,0,0,1.0,1,1.0,1,1.0,1,0.6405402711756666,53
1206,0,3027,3027,0,0,0,0,1.0,1,1.0,1,1.0,1,0.6405402711756666,53
1207,1,3028,3028,0,0,0,0,1.0,1,1.0,1,1.0,1,0.6130578831545963,55
1208,1,3029,3029,0,0,0,0,1.0,1,1.0,1,1.0,1,0.6215349499209948,56
1209,1,3030,3030,0,0,0,0,1.0,1,1.0,1,1.0,1,0.6098583205705029,55
1210,1,3031,3031,0,0,0,0,1.0,1,1.0,1,1.0,1,0.6173063423584989,55
1211,1,3032,3032,0,0,0,0,1.0,1,1.0,1,1.0,1,0.593150491630982,57
1212,5,3037,3037,0,0,0,0,1.0,1,1.0,1,1.0,1,0.6002831318205729,57
1213,1,3038,3038,0,0,0,0,1.0,1,1.0,1,1.0,1,0.5950964388265841,57
1214,5,3043,3043,0,0,0,0,1.0,1,1.0,1,1.0,1,0.6135741975039978,57
1215,2,3045,3045,0,0,0,0,1.0,1,1.0,1,1.0,1,0.5962559605777368,59
1216,5,3050,3050,0,0,0,0,1.0,1,1.0,1,1.0,1,0.5783439838032625,61
1217,2,3052,3052,0,0,0,0,1.0,1,1.0,1,1.0,1,0.5849348536946594,61
1218,4,3056,3056,0,0,0,0,1.0,1,1.0,1,1.0,1,0.5888839653332463,61
1219,6,3062,3062,0,0,0,0,1.0,1,1.0,1,1.0,1,0.5824603901236184,61
1220,3,3065,3065,0,0,0,0,1.0,1,1.0,1,1.0,1,0.5854976920260697,60
1221,5,3070,3070,0,0,0,0,1.0,1,1.0,1,1.0,1,0.581999801920957,61
1222,10,3080,3080,0,0,0,0,1.0,1,1.0,1,1.0,1,0.5854893454004084,61
1223,5,3085,3085,0,0,0,0,1.0,1,1.0,1,1.0,1,0.5925941812251925,59
1224,2,3087,3087,0,0,0,0,1.0,1,1.0,1,1.0,1,0.5702448759394589,60
1225,6,3093,3093,0,0,0,0,1.0,1,1.0,1,1.0,1,0.5447944948816363,60
1226,4,3097,3097,0,0,0,0,1.0,1,1.0,1,1.0,1,0.5415870449338924,61
1227,5,3102,3102,0,0,0,0,1.0,1,1.0,1,1.0,1,0.517564133359898,59
1228,3,3105,3105,0,0,0,0,1.0,1,1.0,1,1.0,1,0.5246862168524754,58
1229,4,3109,3109,0,0,0,0,1.0,1,1.0,1,1.0,1,0.53373681865698,57
1230,5,3114,3114,0,0,0,0,1.0,1,1.0,1,1.0,1,0.5637759353490417,55
1231,2,3116,3116,0,0,0,0,1.0,1,1.0,1,1.0,1,0.5420366767584082,54
1232,4,3120,3120,0,0,0,0,1.0,1,1.0,1,1.0,1,0.5749474914600238,51
1233,5,3125,3125,0,0,0,0,1.0,1,1.0,1,1.0,1,0.5869439816438419,49
1234,1,3126,3126,0,0,0,0,1.0,1,1.0,1,1.0,1,0.5884878994923599,49
1235,1,3127,3127,0,0,0,0,1.0,1,1.0,1,1.0,1,0.5897238626481929,48
1236,3,3130,3130,0,0,0,0,1.0,1,1.0,1,1.0,1,0.5973723144807194,49
1237,2,3132,3132,0,0,0,0,1.0,1,1.0,1,1.0,1,0.6108449780850683,48
1238,3,3135,3135,0,0,0,0,1.0,1,1.0,1,1.0,1,0.5818345268645806,47
1239,2,3137,3137,0,0,0,0,1.0,1,1.0,1,1.0,1,0.5551604216861886,48
1240,3,3140,3140,0,0,0,0,1.0,1,1.0,1,1.0,1,0.5522158386101788,49
1241,4,3144,3144,0,0,0,0,1.0,1,1.0,1,1.0,1,0.542333887109246,49
1242,0,3144,3144,0,0,0,0,1.0,1,1.0,1,1.0,1,0.5433659624113164,49
1243,3,3147,3147,0,0,0,0,1.0,1,1.0,1,1.0,1,0.551974755439507,50
1244,3,3150,3150,0,0,0,0,1.0,1,1.0,1,1.0,1,0.5498572646020465,50
1245,2,3152,3152,0,0,0,0,1.0,1,1.0,1,1.0,1,0.5698452971240673,51
1246,7,3159,3159,0,0,0,0,1.0,1,1.0,1,1.0,1,0.6195181887442112,52
1247,1,3160,3160,0,0,0,0,1.0,1,1.0,1,1.0,1,0.6156736200722551,52
1248,7,3167,3167,0,0,0,0,1.0,1,1.0,1,1.0,1,0.6546351920005438,51
1249,1,3168,3168,0,0,0,0,1.0,1,1.0,1,1.0,1,0.6748805213024089,51
1250,3,3171,3171,0,0,0,0,1.0,1,1.0,1,1.0,1,0.645953874517442,51
1251,5,3176,3176,0,0,0,0,1.0,1,1.0,1,1.0,1,0.6131930677743066,53
1252,1,3177,3177,0,0,0,0,1.0,1,1.0,1,1.0,1,0.6296658027383634,52
1253,3,3180,3180,0,0,0,0,1.0,1,1.0,1,1.0,1,0.6294313036952326,52
1254,1,3181,3181,0,0,0,0,1.0,1,1.0,1,1.0,1,0.6145149419167588,53
1255,1,3182,3182,0,0,0,0,1.0,1,1.0,1,1.0,1,0.6022361998652576,55
1256,1,3183,3183,0,0,0,0,1.0,1,1.0,1,1.0,1,0.6050751712467811,55
1257,0,3183,3183,0,0,0,0,1.0,1,1.0,1,1.0,1,0.6009991205872464,57
1258,1,3184,3184,0,0,0,0,1.0,1,1.0,1,1.0,1,0.6163671189876815,57
1259,3,3187,3187,0,0,0,0,1.0,1,1.0,1,1.0,1,0.6108751535285177,57
1260,2,3189,3189,0,0,0,0,1.0,1,1.0,1,1.0,1,0.6163543810369393,56
1261,3,3192,3192,0,0,0,0,1.0,1,1.0,1,1.0,1,0.6268804103663554,57
1262,2,3194,3194,0,0,0,0,1.0,1,1.0,1,1.0,1,0.6430241523095729,58
1263,4,3198,3198,0,0,0,0,1.0,1,1.0,1,1.0,1,0.6060321392378779,58
1264,4,3202,3202,0,0,0,0,1.0,1,1.0,1,1.0,1,0.6023465359808838,57
1265,7,3209,3209,0,0,0,0,1.0,1,1.0,1,1.0,1,0.5847673913823228,56
1266,3,3212,3212,0,0,0,0,1.0,1,1.0,1,1.0,1,0.5826609943171706,55
1267,9,3221,3221,0,0,0,0,1.0,1,1.0,1,1.0,1,0.5565319141713608,53
1268,0,3221,3221,0,0,0,0,1.0,1,1.0,1,1.0,1,0.5509645620545397,52
1269,4,3225,3225,0,0,0,0,1.0,1,1.0,1,1.0,1,0.5244517386448744,51
1270,2,3227,3227,0,0,0,0,1.0,1,1.0,1,1.0,1,0.5260441970988579,47
1271,2,3229,3229,0,0,0,0,1.0,1,1.0,1,1.0,1,0.5459076773465772,46
1272,1,3230,3230,0,0,0,0,1.0,1,1.0,1,1.0,1,0.5395137309600937,43
1273,3,3233,3233,0,0,0,0,1.0,1,1.0,1,1.0,1,0.5770012082106117,44
1274,4,3237,3237,0,0,0,0,1.0,1,1.0,1,1.0,1,0.6047299258687239,44
1275,2,3239,3239,0,0,0,0,1.0,1,1.0,1,1.0,1,0.6215096918719055,45
1276,4,3243,3243,0,0,0,0,1.0,1,1.0,1,1.0,1,0.6309013255342858,43
1277,1,3244,3244,0,0,0,0,1.0,1,1.0,1,1.0,1,0.6245130620982122,44
1278,2,3246,3246,0,0,0,0,1.0,1,1.0,1,1.0,1,0.6201531637526954,45
1279,5,3251,3251,0,0,0,0,1.0,1,1.0,1,1.0,1,0.6298193075043167,47
1280,3,3254,3254,0,0,0,0,1.0,1,1.0,1,1.0,1,0.6209080734931638,47
1281,2,3256,3256,0,0,0,0,1.0,1,1.0,1,1.0,1,0.6357867085299513,47
1282,2,3258,3258,0,0,0,0,1.0,1,1.0,1,1.0,1,0.648488078940695,46
1283,2,3260,3260,0,0,0,0,1.0,1,1.0,1,1.0,1,0.6397583931283284,46
1284,0,3260,3260,0,0,0,0,1.0,1,1.0,1,1.0,1,0.6397583931283284,46
1285,2,3262,3262,0,0,0,0,1.0,1,1.0,1,1.0,1,0.6684548793286312,46
1286,1,3263,3263,0,0,0,0,1.0,1,1.0,1,1.0,1,0.6957542870107476,45
1287,0,3263,3263,0,0,0,0,1.0,1,1.0,1,1.0,1,0.675257177862614,49
1288,3,3266,3266,0,0,0,0,1.0,1,1.0,1,1.0,1,0.6726473925892905,49
1289,1,3267,3267,0,0,0,0,1.0,1,1.0,1,1.0,1,0.6509992759913394,52
1290,4,3271,3271,0,0,0,0,1.0,1,1.0,1,1.0,1,0.6577985859483024,52
1291,5,3276,3276,0,0,0,0,1.0,1,1.0,1,1.0,1,0.6487831765467114,52
1292,2,3278,3278,0,0,0,0,1.0,1,1.0,1,1.0,1,0.6253467648319795,53
1293,3,3281,3281,0,0,0,0,1.0,1,1.0,1,1.0,1,0.5894563363621949,53
1294,1,3282,3282,0,0,0,0,1.0,1,1.0,1,1.0,1,0.5992337273171803,53
1295,4,3286,3286,0,0,0,0,1.0,1,1.0,1,1.0,1,0.5976161754338628,54
1296,2,3288,3288,0,0,0,0,1.0,1,1.0,1,1.0,1,0.5680336663094208,55
1297,3,3291,3291,0,0,0,0,1.0,1,1.0,1,1.0,1,0.5626493810762344,54
1298,4,3295,3295,0,0,0,0,1.0,1,1.0,1,1.0,1,0.560944810225098,55
1299,4,3299,3299,0,0,0,0,1.0,1,1.0,1,1.0,1,0.572795112556775,54
1300,4,3303,3303,0,0,0,0,1.0,1,1.0,1,1.0,1,0.6114899401573588,55
1301,1,3304,3304,0,0,0,0,1.0,1,1.0,1,1.0,1,0.6271037995372253,54
1302,4,3308,3308,0,0,0,0,1.0,1,1.0,1,1.0,1,0.641632001945454,54
1303,3,3311,3311,0,0,0,0,1.0,1,1.0,1,1.0,1,0.6778231717204297,50
1304,2,3313,3313,0,0,0,0,1.0,1,1.0,1,1.0,1,0.6547173748201638,51
1305,4,3317,3317,0,0,0,0,1.0,1,1.0,1,1.0,1,0.6350908861807614,48
1306,5,3322,3322,0,0,0,0,1.0,1,1.0,1,1.0,1,0.6544250087701939,48
1307,4,3326,3326,0,0,0,0,1.0,1,1.0,1,1.0,1,0.6261842085162191,48
1308,2,3328,3328,0,0,0,0,1.0,1,1.0,1,1.0,1,0.6396258486487424,46
1309,1,3329,3329,0,0,0,0,1.0,1,1.0,1,1.0,1,0.636300060533361,47
1310,3,3332,3332,0,0,0,0,1.0,1,1.0,1,1.0,1,0.6338929917926199,46
1311,1,3333,3333,0,0,0,0,1.0,1,1.0,1,1.0,1,0.6404009684480358,46
1312,0,3333,3333,0,0,0,0,1.0,1,1.0,1,1.0,1,0.6332187993073081,45
1313,3,3336,3336,0,0,0,0,1.0,1,1.0,1,1.0,1,0.6444441516132715,44
1314,1,3337,3337,0,0,0,0,1.0,1,1.0,1,1.0,1,0.6520169540097238,42
1315,4,3341,3341,0,0,0,0,1.0,1,1.0,1,1.0,1,0.6504964044294808,40
1316,1,3342,3342,0,0,0,0,1.0,1,1.0,1,1.0,1,0.6132620657575664,42
1317,5,3347,3347,0,0,0,0,1.0,1,1.0,1,1.0,1,0.5884876907618339,42
1318,1,3348,3348,0,0,0,0,1.0,1,1.0,1,1.0,1,0.5908270720082487,42
1319,1,3349,3349,0,0,0,0,1.0,1,1.0,1,1.0,1,0.5826581919711751,42
1320,2,3351,3351,0,0,0,0,1.0,1,1.0,1,1.0,1,0.5566402277407952,42
1321,3,3354,3354,0,0,0,0,1.0,1,1.0,1,1.0,1,0.5253203258417547,45
1322,2,3356,3356,0,0,0,0,1.0,1,1.0,1,1.0,1,0.5164979788473095,45
1323,4,3360,3360,0,0,0,0,1.0,1,1.0,1,1.0,1,0.4931100794614184,46
1324,1,3361,3361,0,0,0,0,1.0,1,1.0,1,1.0,1,0.5069833433809612,45
1325,2,3363,3363,0,0,0,0,1.0,1,1.0,1,1.0,1,0.517778131652931,46
1326,2,3365,3365,0,0,0,0,1.0,1,1.0,1,1.0,1,0.5182626083445827,45
1327,1,3366,3366,0,0,0,0,1.0,1,1.0,1,1.0,1,0.5428003416800765,46
1328,1,3367,3367,0,0,0,0,1.0,1,1.0,1,1.0,1,0.5637717751464609,47
1329,2,3369,3369,0,0,0,0,1.0,1,1.0,1,1.0,1,0.5931640539215934,47
1330,2,3371,3371,0,0,0,0,1.0,1,1.0,1,1.0,1,0.637797460250023,46
1331,0,3371,3371,0,0,0,0,1.0,1,1.0,1,1.0,1,0.637797460250023,46
1332,2,3373,3373,0,0,0,0,1.0,1,1.0,1,1.0,1,0.5919802842815493,49
1333,2,3375,3375,0,0,0,0,1.0,1,1.0,1,1.0,1,0.5892508698857414,50
1334,2,3377,3377,0,0,0,0,1.0,1,1.0,1,1.0,1,0.6149668824619066,50
1335,1,3378,3378,0,0,0,0,1.0,1,1.0,1,1.0,1,0.6319429083360693,52
1336,3,3381,3381,0,0,0,0,1.0,1,1.0,1,1.0,1,0.626805743970607,53
1337,2,3383,3383,0,0,0,0,1.0,1,1.0,1,1.0,1,0.62884086908648,54
1338,3,3386,3386,0,0,0,0,1.0,1,1.0,1,1.0,1,0.6342276511678276,54
1339,4,3390,3390,0,0,0,0,1.0,1,1.0,1,1.0,1,0.6221016985721585,54
1340,4,3394,3394,0,0,0,0,1.0,1,1.0,1,1.0,1,0.6162441038244819,53
1341,1,3395,3395,0,0,0,0,1.0,1,1.0,1,1.0,1,0.6028752476442246,53
1342,7,3402,3402,0,0,0,0,1.0,1,1.0,1,1.0,1,0.577801134700574,52
1343,0,3402,3402,0,0,0,0,1.0,1,1.0,1,1.0,1,0.5805517060755294,50
1344,4,3406,3406,0,0,0,0,1.0,1,1.0,1,1.0,1,0.5659551757241486,51
1345,2,3408,3408,0,0,0,0,1.0,1,1.0,1,1.0,1,0.5477113370783743,50
1346,3,3411,3411,0,0,0,0,1.0,1,1.0,1,1.0,1,0.5449713239588495,50
1347,1,3412,3412,0,0,0,0,1.0,1,1.0,1,1.0,1,0.5727534857029573,48
1348,1,3413,3413,0,0,0,0,1.0,1,1.0,1,1.0,1,0.5876682089734305,49
1349,3,3416,3416,0,0,0,0,1.0,1,1.0,1,1.0,1,0.5908788835587486,48
1350,0,3416,3416,0,0,0,0,1.0,1,1.0,1,1.0,1,0.5875521879584933,49
1351,3,3419,3419,0,0,0,0,1.0,1,1.0,1,1.0,1,0.6097772314217305,48
1352,1,3420,3420,0,0,0,0,1.0,1,1.0,1,1.0,1,0.6114754413121938,49
1353,6,3426,3426,0,0,0,0,1.0,1,1.0,1,1.0,1,0.6388483713571369,49
1354,2,3428,3428,0,0,0,0,1.0,1,1.0,1,1.0,1,0.6335113829473236,49
1355,2,3430,3430,0,0,0,0,1.0,1,1.0,1,1.0,1,0.6201475745274996,50
1356,3,3433,3433,0,0,0,0,1.0,1,1.0,1,1.0,1,0.639780302318501,50
1357,2,3435,3435,0,0,0,0,1.0,1,1.0,1,1.0,1,0.6299581823364451,50
1358,2,3437,3437,0,0,0,0,1.0,1,1.0,1,1.0,1,0.6258374985961399,51
1359,0,3437,3437,0,0,0,0,1.0,1,1.0,1,1.0,1,0.616713922860591,53
1360,1,3438,3438,0,0,0,0,1.0,1,1.0,1,1.0,1,0.6057114380033839,54
1361,3,3441,3441,0,0,0,0,1.0,1,1.0,1,1.0,1,0.608453967843277,54
1362,3,3444,3444,0,0,0,0,1.0,1,1.0,1,1.0,1,0.6056005845799716,55
1363,1,3445,3445,0,0,0,0,1.0,1,1.0,1,1.0,1,0.60870984086139,55
1364,2,3447,3447,0,0,0,0,1.0,1,1.0,1,1.0,1,0.6311715156954186,55
1365,4,3451,3451,0,0,0,0,1.0,1,1.0,1,1.0,1,0.6321317550066822,56
1366,0,3451,3451,0,0,0,0,1.0,1,1.0,1,1.0,1,0.6321317550066822,56
1367,3,3454,3454,0,0,0,0,1.0,1,1.0,1,1.0,1,0.6309049296426137,56
1368,2,3456,3456,0,0,0,0,1.0,1,1.0,1,1.0,1,0.6131283359947619,58
1369,1,3457,3457,0,0,0,0,1.0,1,1.0,1,1.0,1,0.6119490315294656,59
1370,5,3462,3462,0,0,0,0,1.0,1,1.0,1,1.0,1,0.6195277448725158,59
1371,1,3463,3463,0,0,0,0,1.0,1,1.0,1,1.0,1,0.6118692388127103,59
1372,4,3467,3467,0,0,0,0,1.0,1,1.0,1,1.0,1,0.6174403629662334,59
1373,3,3470,3470,0,0,0,0,1.0,1,1.0,1,1.0,1,0.5977901765473157,59
1374,2,3472,3472,0,0,0,0,1.0,1,1.0,1,1.0,1,0.60615065838712,60
1375,5,3477,3477,0,0,0,0,1.0,1,1.0,1,1.0,1,0.5950770989724692,61
1376,0,3477,3477,0,0,0,0,1.0,1,1.0,1,1.0,1,0.6058720583656776,61
1377,2,3479,3479,0,0,0,0,1.0,1,1.0,1,1.0,1,0.6136862028117156,61
1378,3,3482,3482,0,0,0,0,1.0,1,1.0,1,1.0,1,0.6101724630606374,61
1379,4,3486,3486,0,0,0,0,1.0,1,1.0,1,1.0,1,0.5967328479662822,60
1380,3,3489,3489,0,0,0,0,1.0,1,1.0,1,1.0,1,0.5746619742985822,60
1381,3,3492,3492,0,0,0,0,1.0,1,1.0,1,1.0,1,0.5680370419466276,58
1382,3,3495,3495,0,0,0,0,1.0,1,1.0,1,1.0,1,0.5653591652535357,58
1383,6,3501,3501,0,0,0,0,1.0,1,1.0,1,1.0,1,0.5652180777227522,57
1384,2,3503,3503,0,0,0,0,1.0,1,1.0,1,1.0,1,0.5969023353128671,54
1385,5,3508,3508,0,0,0,0,1.0,1,1.0,1,1.0,1,0.5919976001126557,52
1386,2,3510,3510,0,0,0,0,1.0,1,1.0,1,1.0,1,0.5963915584277135,51
1387,1,3511,3511,0,0,0,0,1.0,1,1.0,1,1.0,1,0.5900844365852654,51
1388,2,3513,3513,0,0,0,0,1.0,1,1.0,1,1.0,1,0.6055298247950589,52
1389,1,3514,3514,0,0,0,0,1.0,1,1.0,1,1.0,1,0.6493357355783251,50
1390,2,3516,3516,0,0,0,0,1.0,1,1.0,1,1.0,1,0.6661005788059421,51
1391,1,3517,3517,0,0,0,0,1.0,1,1.0,1,1.0,1,0.6632468242588113,50
1392,1,3518,3518,0,0,0,0,1.0,1,1.0,1,1.0,1,0.6699692057426081,50
1393,1,3519,3519,0,0,0,0,1.0,1,1.0,1,1.0,1,0.6860463540220355,49
1394,1,3520,3520,0,0,0,0,1.0,1,1.0,1,1.0,1,0.694670055463221,50
1395,3,3523,3523,0,0,0,0,1.0,1,1.0,1,1.0,1,0.6742020860598517,51
1396,0,3523,3523,0,0,0,0,1.0,1,1.0,1,1.0,1,0.67878519322559,52
1397,4,3527,3527,0,0,0,0,1.0,1,1.0,1,1.0,1,0.6874533777619681,52
1398,5,3532,3532,0,0,0,0,1.0,1,1.0,1,1.0,1,0.6768627125872789,53
1399,3,3535,3535,0,0,0,0,1.0,1,1.0,1,1.0,1,0.6696312687453679,54
1400,2,3537,3537,0,0,0,0,1.0,1,1.0,1,1.0,1,0.6767986808459376,54
1401,4,3541,3541,0,0,0,0,1.0,1,1.0,1,1.0,1,0.6711259026535388,54
1402,1,3542,3542,0,0,0,0,1.0,1,1.0,1,1.0,1,0.6691876592286256,53
1403,2,3544,3544,0,0,0,0,1.0,1,1.0,1,1.0,1,0.6739292514538805,52
1404,2,3546,3546,0,0,0,0,1.0,1,1.0,1,1.0,1,0.6681221236032965,53
1405,1,3547,3547,0,0,0,0,1.0,1,1.0,1,1.0,1,0.6631079799561197,52
1406,0,3547,3547,0,0,0,0,1.0,1,1.0,1,1.0,1,0.6489001314563356,53
1407,1,3548,3548,0,0,0,0,1.0,1,1.0,1,1.0,1,0.6725121520464298,54
1408,1,3549,3549,0,0,0,0,1.0,1,1.0,1,1.0,1,0.6846844555235887,53
1409,0,3549,3549,0,0,0,0,1.0,1,1.0,1,1.0,1,0.6735783438332922,55
1410,0,3549,3549,0,0,0,0,1.0,1,1.0,1,1.0,1,0.6813505245449227,54
1411,1,3550,3550,0,0,0,0,1.0,1,1.0,1,1.0,1,0.6980512486855655,54
1412,1,3551,3551,0,0,0,0,1.0,1,1.0,1,1.0,1,0.7157118866113455,53
1413,2,3553,3553,0,0,0,0,1.0,1,1.0,1,1.0,1,0.7109825644670804,54
1414,4,3557,3557,0,0,0,0,1.0,1,1.0,1,1.0,1,0.7304466187843829,55
1415,2,3559,3559,0,0,0,0,1.0,1,1.0,1,1.0,1,0.6830888260922333,57
1416,4,3563,3563,0,0,0,0,1.0,1,1.0,1,1.0,1,0.6835316768895479,59
1417,5,3568,3568,0,0,0,0,1.0,1,1.0,1,1.0,1,0.6543158396440444,58
1418,3,3571,3571,0,0,0,0,1.0,1,1.0,1,1.0,1,0.6261863725962594,57
1419,5,3576,3576,0,0,0,0,1.0,1,1.0,1,1.0,1,0.6256396027021197,56
1420,3,3579,3579,0,0,0,0,1.0,1,1.0,1,1.0,1,0.6044409696945306,54
1421,3,3582,3582,0,0,0,0,1.0,1,1.0,1,1.0,1,0.6296313153937102,55
1422,2,3584,3584,0,0,0,0,1.0,1,1.0,1,1.0,1,0.6161596731382215,52
1423,2,3586,3586,0,0,0,0,1.0,1,1.0,1,1.0,1,0.6026728085579699,52
1424,2,3588,3588,0,0,0,0,1.0,1,1.0,1,1.0,1,0.6046253248436968,51
1425,1,3589,3589,0,0,0,0,1.0,1,1.0,1,1.0,1,0.6294500783899113,50
1426,2,3591,3591,0,0,0,0,1.0,1,1.0,1,1.0,1,0.634623442955867,50
1427,3,3594,3594,0,0,0,0,1.0,1,1.0,1,1.0,1,0.6398440540584699,48
1428,2,3596,3596,0,0,0,0,1.0,1,1.0,1,1.0,1,0.6337937340162995,48
1429,4,3600,3600,0,0,0,0,1.0,1,1.0,1,1.0,1,0.6467980256983091,48
1430,3,3603,3603,0,0,0,0,1.0,1,1.0,1,1.0,1,0.6391044932487873,48
1431,7,3610,3610,0,0,0,0,1.0,1,1.0,1,1.0,1,0.639109629612211,48
1432,1,3611,3611,0,0,0,0,1.0,1,1.0,1,1.0,1,0.6258267003258343,50
1433,4,3615,3615,0,0,0,0,1.0,1,1.0,1,1.0,1,0.6246304821983474,51
1434,4,3619,3619,0,0,0,0,1.0,1,1.0,1,1.0,1,0.6325126046179462,51
1435,4,3623,3623,0,0,0,0,1.0,1,1.0,1,1.0,1,0.6213542113341145,50
1436,3,3626,3626,0,0,0,0,1.0,1,1.0,1,1.0,1,0.6165642233489388,51
1437,3,3629,3629,0,0,0,0,1.0,1,1.0,1,1.0,1,0.6187233735243792,51
1438,5,3634,3634,0,0,0,0,1.0,1,1.0,1,1.0,1,0.6245844891599129,51
1439,3,3637,3637,0,0,0,0,1.0,1,1.0,1,1.0,1,0.633287766401399,50
1440,3,3640,3640,0,0,0,0,1.0,1,1.0,1,1.0,1,0.6387170974935129,51
1441,6,3646,3646,0,0,0,0,1.0,1,1.0,1,1.0,1,0.6051844487300836,51
1442,5,3651,3651,0,0,0,0,1.0,1,1.0,1,1.0,1,0.590497078431756,52
1443,3,3654,3654,0,0,0,0,1.0,1,1.0,1,1.0,1,0.5911797195629805,53
1444,2,3656,3656,0,0,0,0,1.0,1,1.0,1,1.0,1,0.5785301435954575,54
1445,4,3660,3660,0,0,0,0,1.0,1,1.0,1,1.0,1,0.5961100911653283,54
1446,4,3664,3664,0,0,0,0,1.0,1,1.0,1,1.0,1,0.5868859847147486,54
1447,2,3666,3666,0,0,0,0,1.0,1,1.0,1,1.0,1,0.6063977880577999,55
1448,0,3666,3666,0,0,0,0,1.0,1,1.0,1,1.0,1,0.6063977880577999,55
1449,3,3669,3669,0,0,0,0,1.0,1,1.0,1,1.0,1,0.5999445917711975,55
1450,0,3669,3669,0,0,0,0,1.0,1,1.0,1,1.0,1,0.5914129024122708,57
1451,3,3672,3672,0,0,0,0,1.0,1,1.0,1,1.0,1,0.5892075210142098,57
1452,1,3673,3673,0,0,0,0,1.0,1,1.0,1,1.0,1,0.5828412944487228,57
1453,1,3674,3674,0,0,0,0,1.0,1,1.0,1,1.0,1,0.5799414393743209,57
1454,1,3675,3675,0,0,0,0,1.0,1,1.0,1,1.0,1,0.5927564831407617,58
1455,0,3675,3675,0,0,0,0,1.0,1,1.0,1,1.0,1,0.5717513106922292,56
1456,3,3678,3678,0,0,0,0,1.0,1,1.0,1,1.0,1,0.5959215480513516,55
1457,0,3678,3678,0,0,0,0,1.0,1,1.0,1,1.0,1,0.6073878149864917,54
1458,6,3684,3684,0,0,0,0,1.0,1,1.0,1,1.0,1,0.6207931022071831,53
1459,5,3689,3689,0,0,0,0,1.0,1,1.0,1,1.0,1,0.6366814701500563,52
1460,4,3693,3693,0,0,0,0,1.0,1,1.0,1,1.0,1,0.6496390872533632,51
1461,4,3697,3697,0,0,0,0,1.0,1,1.0,1,1.0,1,0.6300519743909799,51
1462,5,3702,3702,0,0,0,0,1.0,1,1.0,1,1.0,1,0.6417002157649642,51
1463,3,3705,3705,0,0,0,0,1.0,1,1.0,1,1.0,1,0.6367503260193427,52
1464,8,3713,3713,0,0,0,0,1.0,1,1.0,1,1.0,1,0.6357086937317156,52
1465,6,3719,3719,0,0,0,0,1.0,1,1.0,1,1.0,1,0.6300329537452272,51
1466,4,3723,3723,0,0,0,0,1.0,1,1.0,1,1.0,1,0.6178522299617271,50
1467,3,3726,3726,0,0,0,0,1.0,1,1.0,1,1.0,1,0.6421376077391143,48
1468,8,3734,3734,0,0,0,0,1.0,1,1.0,1,1.0,1,0.590658011832273,48
1469,4,3738,3738,0,0,0,0,1.0,1,1.0,1,1.0,1,0.6028262050770311,48
1470,3,3741,3741,0,0,0,0,1.0,1,1.0,1,1.0,1,0.5706904091666972,48
1471,6,3747,3747,0,0,0,0,1.0,1,1.0,1,1.0,1,0.5765335407040801,45
1472,2,3749,3749,0,0,0,0,1.0,1,1.0,1,1.0,1,0.5799415376962453,45
1473,4,3753,3753,0,0,0,0,1.0,1,1.0,1,1.0,1,0.5603456874324466,46
1474,2,3755,3755,0,0,0,0,1.0,1,1.0,1,1.0,1,0.5747869509345043,46
1475,2,3757,3757,0,0,0,0,1.0,1,1.0,1,1.0,1,0.5687746338344992,46
1476,3,3760,3760,0,0,0,0,1.0,1,1.0,1,1.0,1,0.5663010962132401,47
1477,2,3762,3762,0,0,0,0,1.0,1,1.0,1,1.0,1,0.5623416005874418,47
1478,2,3764,3764,0,0,0,0,1.0,1,1.0,1,1.0,1,0.6013146604355333,47
1479,4,3768,3768,0,0,0,0,1.0,1,1.0,1,1.0,1,0.5960862278902268,48
1480,0,3768,3768,0,0,0,0,1.0,1,1.0,1,1.0,1,0.6057538668639989,47
1481,1,3769,3769,0,0,0,0,1.0,1,1.0,1,1.0,1,0.6139817895957995,47
1482,0,3769,3769,0,0,0,0,1.0,1,1.0,1,1.0,1,0.6209230767074417,46
1483,3,3772,3772,0,0,0,0,1.0,1,1.0,1,1.0,1,0.6536619157748198,47
1484,2,3774,3774,0,0,0,0,1.0,1,1.0,1,1.0,1,0.6670494090438597,47
1485,3,3777,3777,0,0,0,0,1.0,1,1.0,1,1.0,1,0.7037210315264517,47
1486,2,3779,3779,0,0,0,0,1.0,1,1.0,1,1.0,1,0.6841518698987729,49
1487,4,3783,3783,0,0,0,0,1.0,1,1.0,1,1.0,1,0.6694450066384331,49
1488,6,3789,3789,0,0,0,0,1.0,1,1.0,1,1.0,1,0.6353232757356875,51
1489,4,3793,3793,0,0,0,0,1.0,1,1.0,1,1.0,1,0.626079780935942,52
1490,3,3796,3796,0,0,0,0,1.0,1,1.0,1,1.0,1,0.6368670124812625,52
1491,6,3802,3802,0,0,0,0,1.0,1,1.0,1,1.0,1,0.6475864912124573,53
1492,5,3807,3807,0,0,0,0,1.0,1,1.0,1,1.0,1,0.622302178506316,53
1493,2,3809,3809,0,0,0,0,1.0,1,1.0,1,1.0,1,0.6082979733857861,52
1494,5,3814,3814,0,0,0,0,1.0,1,1.0,1,1.0,1,0.6179680578889449,50
1495,1,3815,3815,0,0,0,0,1.0,1,1.0,1,1.0,1,0.5792935181632113,50
1496,3,3818,3818,0,0,0,0,1.0,1,1.0,1,1.0,1,0.614473606511408,52
1497,0,3818,3818,0,0,0,0,1.0,1,1.0,1,1.0,1,0.6078107425235362,51
1498,3,3821,3821,0,0,0,0,1.0,1,1.0,1,1.0,1,0.5968065857724874,50
1499,4,3825,3825,0,0,0,0,1.0,1,1.0,1,1.0,1,0.563494534371876,50
1500,4,3829,3829,0,0,0,0,1.0,1,1.0,1,1.0,1,0.5328620893961354,49
1501,1,3830,3830,0,0,0,0,1.0,1,1.0,1,1.0,1,0.5069124451303831,47
1502,4,3834,3834,0,0,0,0,1.0,1,1.0,1,1.0,1,0.5203201441362443,47
1503,3,3837,3837,0,0,0,0,1.0,1,1.0,1,1.0,1,0.5022092765773355,47
1504,5,3842,3842,0,0,0,0,1.0,1,1.0,1,1.0,1,0.5038689573757841,48
1505,5,3847,3847,0,0,0,0,1.0,1,1.0,1,1.0,1,0.5209398849316389,47
1506,1,3848,3848,0,0,0,0,1.0,1,1.0,1,1.0,1,0.5248850189437492,47
1507,4,3852,3852,0,0,0,0,1.0,1,1.0,1,1.0,1,0.5643754517999497,45
1508,0,3852,3852,0,0,0,0,1.0,1,1.0,1,1.0,1,0.5713629358061432,45
1509,3,3855,3855,0,0,0,0,1.0,1,1.0,1,1.0,1,0.6289331813034971,44
1510,3,3858,3858,0,0,0,0,1.0,1,1.0,1,1.0,1,0.6619312647342663,42
1511,1,3859,3859,0,0,0,0,1.0,1,1.0,1,1.0,1,0.6692172130962653,40
1512,0,3859,3859,0,0,0,0,1.0,1,1.0,1,1.0,1,0.6917812585841853,39
1513,3,3862,3862,0,0,0,0,1.0,1,1.0,1,1.0,1,0.6581737318454286,39
1514,3,3865,3865,0,0,0,0,1.0,1,1.0,1,1.0,1,0.6624584658684418,38
1515,2,3867,3867,0,0,0,0,1.0,1,1.0,1,1.0,1,0.674208462453409,39
1516,6,3873,3873,0,0,0,0,1.0,1,1.0,1,1.0,1,0.6223889369684,39
1517,5,3878,3878,0,0,0,0,1.0,1,1.0,1,1.0,1,0.5817060424722799,39
1518,6,3884,3884,0,0,0,0,1.0,1,1.0,1,1.0,1,0.5747341617446579,39
1519,5,3889,3889,0,0,0,0,1.0,1,1.0,1,1.0,1,0.5976641363062613,39
1520,6,3895,3895,0,0,0,0,1.0,1,1.0,1,1.0,1,0.5676788803023288,39
1521,1,3896,3896,0,0,0,0,1.0,1,1.0,1,1.0,1,0.5768012581906451,40
1522,3,3899,3899,0,0,0,0,1.0,1,1.0,1,1.0,1,0.5622003697878576,40
1523,1,3900,3900,0,0,0,0,1.0,1,1.0,1,1.0,1,0.5847924201705337,41
1524,2,3902,3902,0,0,0,0,1.0,1,1.0,1,1.0,1,0.5726043536021146,42
1525,0,3902,3902,0,0,0,0,1.0,1,1.0,1,1.0,1,0.5578276810189849,45
1526,1,3903,3903,0,0,0,0,1.0,1,1.0,1,1.0,1,0.5423734168956605,46
1527,0,3903,3903,0,0,0,0,1.0,1,1.0,1,1.0,1,0.5423734168956605,46
1528,0,3903,3903,0,0,0,0,1.0,1,1.0,1,1.0,1,0.5334312928827322,47
1529,0,3903,3903,0,0,0,0,1.0,1,1.0,1,1.0,1,0.5334312928827322,47
1530,1,3904,3904,0,0,0,0,1.0,1,1.0,1,1.0,1,0.5146831734620763,48
1531,0,3904,3904,0,0,0,0,1.0,1,1.0,1,1.0,1,0.502391290901845,46
1532,2,3906,3906,0,0,0,0,1.0,1,1.0,1,1.0,1,0.5219793809333964,47
1533,1,3907,3907,0,0,0,0,1.0,1,1.0,1,1.0,1,0.5016219697991555,46
1534,2,3909,3909,0,0,0,0,1.0,1,1.0,1,1.0,1,0.5171524021380322,47
1535,1,3910,3910,0,0,0,0,1.0,1,1.0,1,1.0,1,0.533018946495067,47
1536,1,3911,3911,0,0,0,0,1.0,1,1.0,1,1.0,1,0.5338936145287869,48
1537,0,3911,3911,0,0,0,0,1.0,1,1.0,1,1.0,1,0.5301239950365624,46
1538,3,3914,3914,0,0,0,0,1.0,1,1.0,1,1.0,1,0.564582646796779,47
1539,3,3917,3917,0,0,0,0,1.0,1,1.0,1,1.0,1,0.573395675075929,47
1540,3,3920,3920,0,0,0,0,1.0,1,1.0,1,1.0,1,0.6040221007397393,47
1541,5,3925,3925,0,0,0,0,1.0,1,1.0,1,1.0,1,0.5916720481561202,47
1542,2,3927,3927,0,0,0,0,1.0,1,1.0,1,1.0,1,0.6090027530779769,50
1543,5,3932,3932,0,0,0,0,1.0,1,1.0,1,1.0,1,0.6234049440685,47
1544,3,3935,3935,0,0,0,0,1.0,1,1.0,1,1.0,1,0.6343173781831208,48
1545,6,3941,3941,0,0,0,0,1.0,1,1.0,1,1.0,1,0.6395159603370573,47
1546,6,3947,3947,0,0,0,0,1.0,1,1.0,1,1.0,1,0.610711378243264,47
1547,6,3953,3953,0,0,0,0,1.0,1,1.0,1,1.0,1,0.6047822496329567,47
1548,5,3958,3958,0,0,0,0,1.0,1,1.0,1,1.0,1,0.5869424491511638,47
1549,9,3967,3967,0,0,0,0,1.0,1,1.0,1,1.0,1,0.6092643290858185,46
1550,4,3971,3971,0,0,0,0,1.0,1,1.0,1,1.0,1,0.6193536326397407,44
1551,10,3981,3981,0,0,0,0,1.0,1,1.0,1,1.0,1,0.5895123592629925,45
1552,3,3984,3984,0,0,0,0,1.0,1,1.0,1,1.0,1,0.6118293083094118,43
1553,7,3991,3991,0,0,0,0,1.0,1,1.0,1,1.0,1,0.5909940913275298,43
1554,5,3996,3996,0,0,0,0,1.0,1,1.0,1,1.0,1,0.5943951970220157,41
1555,3,3999,3999,0,0,0,0,1.0,1,1.0,1,1.0,1,0.5926341671433527,44
1556,4,4003,4003,0,0,0,0,1.0,1,1.0,1,1.0,1,0.6181802404079068,45
1557,2,4005,4005,0,0,0,0,1.0,1,1.0,1,1.0,1,0.5924423366793321,45
1558,1,4006,4006,0,0,0,0,1.0,1,1.0,1,1.0,1,0.6009036096543988,46
1559,1,4007,4007,0,0,0,0,1.0,1,1.0,1,1.0,1,0.5738383453888453,47
1560,3,4010,4010,0,0,0,0,1.0,1,1.0,1,1.0,1,0.5785245503782217,46
1561,0,4010,4010,0,0,0,0,1.0,1,1.0,1,1.0,1,0.5586431542180533,47
1562,3,4013,4013,0,0,0,0,1.0,1,1.0,1,1.0,1,0.5467930022154912,47
1563,3,4016,4016,0,0,0,0,1.0,1,1.0,1,1.0,1,0.5514842251149291,47
1564,2,4018,4018,0,0,0,0,1.0,1,1.0,1,1.0,1,0.5565535889726583,47
1565,1,4019,4019,0,0,0,0,1.0,1,1.0,1,1.0,1,0.5709799599068849,48
1566,0,4019,4019,0,0,0,0,1.0,1,1.0,1,1.0,1,0.5709799599068849,48
1567,0,4019,4019,0,0,0,0,1.0,1,1.0,1,1.0,1,0.5766318083406082,48
1568,1,4020,4020,0,0,0,0,1.0,1,1.0,1,1.0,1,0.5878504860727096,48
1569,3,4023,4023,0,0,0,0,1.0,1,1.0,1,1.0,1,0.613866172681293,45
1570,3,4026,4026,0,0,0,0,1.0,1,1.0,1,1.0,1,0.6164026490833817,44
1571,2,4028,4028,0,0,0,0,1.0,1,1.0,1,1.0,1,0.6359186734492559,42
1572,7,4035,4035,0,0,0,0,1.0,1,1.0,1,1.0,1,0.6181600546491708,43
1573,5,4040,4040,0,0,0,0,1.0,1,1.0,1,1.0,1,0.6301867732267371,43
1574,3,4043,4043,0,0,0,0,1.0,1,1.0,1,1.0,1,0.612058924646438,42
1575,5,4048,4048,0,0,0,0,1.0,1,1.0,1,1.0,1,0.6240139154194045,43
1576,5,4053,4053,0,0,0,0,1.0,1,1.0,1,1.0,1,0.5669381628731385,41
1577,3,4056,4056,0,0,0,0,1.0,1,1.0,1,1.0,1,0.5738164443867059,40
1578,3,4059,4059,0,0,0,0,1.0,1,1.0,1,1.0,1,0.5484640461836646,40
1579,4,4063,4063,0,0,0,0,1.0,1,1.0,1,1.0,1,0.48896268377543856,40
1580,4,4067,4067,0,0,0,0,1.0,1,1.0,1,1.0,1,0.4786516009499598,40
1581,4,4071,4071,0,0,0,0,1.0,1,1.0,1,1.0,1,0.49134616258185415,40
1582,6,4077,4077,0,0,0,0,1.0,1,1.0,1,1.0,1,0.5242890089587177,40
1583,5,4082,4082,0,0,0,0,1.0,1,1.0,1,1.0,1,0.5402333642258144,38
1584,4,4086,4086,0,0,0,0,1.0,1,1.0,1,1.0,1,0.5250019048010555,39
1585,6,4092,4092,0,0,0,0,1.0,1,1.0,1,1.0,1,0.47645319721249535,38
1586,4,4096,4096,0,0,0,0,1.0,1,1.0,1,1.0,1,0.4658223757130461,38
1587,5,4101,4101,0,0,0,0,1.0,1,1.0,1,1.0,1,0.48599210495703943,37
1588,5,4106,4106,0,0,0,0,1.0,1,1.0,1,1.0,1,0.5004230366523404,39
1589,1,4107,4107,0,0,0,0,1.0,1,1.0,1,1.0,1,0.5137767269924044,37
1590,1,4108,4108,0,0,0,0,1.0,1,1.0,1,1.0,1,0.5517228667228562,37
1591,2,4110,4110,0,0,0,0,1.0,1,1.0,1,1.0,1,0.5799545674728138,36
1592,1,4111,4111,0,0,0,0,1.0,1,1.0,1,1.0,1,0.5925731801511052,34
1593,1,4112,4112,0,0,0,0,1.0,1,1.0,1,1.0,1,0.609826730251239,33
1594,0,4112,4112,0,0,0,0,1.0,1,1.0,1,1.0,1,0.6177562221424096,31
1595,3,4115,4115,0,0,0,0,1.0,1,1.0,1,1.0,1,0.5905351482512559,34
1596,2,4117,4117,0,0,0,0,1.0,1,1.0,1,1.0,1,0.5854961897316231,33
1597,1,4118,4118,0,0,0,0,1.0,1,1.0,1,1.0,1,0.6024202288205297,33
1598,2,4120,4120,0,0,0,0,1.0,1,1.0,1,1.0,1,0.5915576383044869,33
1599,0,4120,4120,0,0,0,0,1.0,1,1.0,1,1.0,1,0.5915576383044869,33
1600,3,4123,4123,0,0,0,0,1.0,1,1.0,1,1.0,1,0.621031393839959,34
1601,2,4125,4125,0,0,0,0,1.0,1,1.0,1,1.0,1,0.6261614012241203,35
1602,2,4127,4127,0,0,0,0,1.0,1,1.0,1,1.0,1,0.6088158889364964,36
1603,3,4130,4130,0,0,0,0,1.0,1,1.0,1,1.0,1,0.58084218888873,38
1604,7,4137,4137,0,0,0,0,1.0,1,1.0,1,1.0,1,0.6310967956423521,38
1605,3,4140,4140,0,0,0,0,1.0,1,1.0,1,1.0,1,0.5887126024577812,38
1606,5,4145,4145,0,0,0,0,1.0,1,1.0,1,1.0,1,0.6054161283218712,39
1607,4,4149,4149,0,0,0,0,1.0,1,1.0,1,1.0,1,0.5604653533318246,37
1608,5,4154,4154,0,0,0,0,1.0,1,1.0,1,1.0,1,0.554324634744605,36
1609,3,4157,4157,0,0,0,0,1.0,1,1.0,1,1.0,1,0.5543614972222715,34
1610,1,4158,4158,0,0,0,0,1.0,1,1.0,1,1.0,1,0.514228558026089,34
1611,3,4161,4161,0,0,0,0,1.0,1,1.0,1,1.0,1,0.5103502783525651,35
1612,4,4165,4165,0,0,0,0,1.0,1,1.0,1,1.0,1,0.5354997648358287,33
1613,4,4169,4169,0,0,0,0,1.0,1,1.0,1,1.0,1,0.5513205517004588,34
1614,3,4172,4172,0,0,0,0,1.0,1,1.0,1,1.0,1,0.5526114946106708,35
1615,1,4173,4173,0,0,0,0,1.0,1,1.0,1,1.0,1,0.5410413026813234,35
1616,4,4177,4177,0,0,0,0,1.0,1,1.0,1,1.0,1,0.5236077106226913,37
1617,2,4179,4179,0,0,0,0,1.0,1,1.0,1,1.0,1,0.5162214374280808,38
1618,3,4182,4182,0,0,0,0,1.0,1,1.0,1,1.0,1,0.47152032727944587,38
1619,3,4185,4185,0,0,0,0,1.0,1,1.0,1,1.0,1,0.4587959549361771,38
1620,2,4187,4187,0,0,0,0,1.0,1,1.0,1,1.0,1,0.46721717955163083,39
1621,1,4188,4188,0,0,0,0,1.0,1,1.0,1,1.0,1,0.4517838338552201,37
1622,3,4191,4191,0,0,0,0,1.0,1,1.0,1,1.0,1,0.5210651465741059,37
1623,3,4194,4194,0,0,0,0,1.0,1,1.0,1,1.0,1,0.5496356425545391,37
1624,2,4196,4196,0,0,0,0,1.0,1,1.0,1,1.0,1,0.5677020907960675,37
1625,4,4200,4200,0,0,0,0,1.0,1,1.0,1,1.0,1,0.5963504265821661,35
1626,0,4200,4200,0,0,0,0,1.0,1,1.0,1,1.0,1,0.5963504265821661,35
1627,2,4202,4202,0,0,0,0,1.0,1,1.0,1,1.0,1,0.5613195245381661,34
1628,3,4205,4205,0,0,0,0,1.0,1,1.0,1,1.0,1,0.5710870511796065,35
1629,1,4206,4206,0,0,0,0,1.0,1,1.0,1,1.0,1,0.5379821592306409,34
1630,2,4208,4208,0,0,0,0,1.0,1,1.0,1,1.0,1,0.5520227476598729,32
1631,3,4211,4211,0,0,0,0,1.0,1,1.0,1,1.0,1,0.5399215313956041,33
1632,2,4213,4213,0,0,0,0,1.0,1,1.0,1,1.0,1,0.5810429474618382,32
1633,4,4217,4217,0,0,0,0,1.0,1,1.0,1,1.0,1,0.678432533406804,31
1634,3,4220,4220,0,0,0,0,1.0,1,1.0,1,1.0,1,0.6697953323453624,31
1635,0,4220,4220,0,0,0,0,1.0,1,1.0,1,1.0,1,0.6845052504902561,31
1636,1,4221,4221,0,0,0,0,1.0,1,1.0,1,1.0,1,0.6561973946502149,33
1637,1,4222,4222,0,0,0,0,1.0,1,1.0,1,1.0,1,0.664388066880611,33
1638,0,4222,4222,0,0,0,0,1.0,1,1.0,1,1.0,1,0.6394281316783971,36
1639,0,4222,4222,0,0,0,0,1.0,1,1.0,1,1.0,1,0.6394281316783971,36
1640,0,4222,4222,0,0,0,0,1.0,1,1.0,1,1.0,1,0.6394281316783971,36
1641,0,4222,4222,0,0,0,0,1.0,1,1.0,1,1.0,1,0.6250997103602586,38
1642,1,4223,4223,0,0,0,0,1.0,1,1.0,1,1.0,1,0.5994963146774623,37
1643,2,4225,4225,0,0,0,0,1.0,1,1.0,1,1.0,1,0.6096934281540647,37
1644,2,4227,4227,0,0,0,0,1.0,1,1.0,1,1.0,1,0.5899665310540485,38
1645,3,4230,4230,0,0,0,0,1.0,1,1.0,1,1.0,1,0.590501047403058,36
1646,1,4231,4231,0,0,0,0,1.0,1,1.0,1,1.0,1,0.5820611888048384,37
1647,1,4232,4232,0,0,0,0,1.0,1,1.0,1,1.0,1,0.5825407399929142,35
1648,0,4232,4232,0,0,0,0,1.0,1,1.0,1,1.0,1,0.5924417325123983,38
1649,1,4233,4233,0,0,0,0,1.0,1,1.0,1,1.0,1,0.592677050996862,35
1650,0,4233,4233,0,0,0,0,1.0,1,1.0,1,1.0,1,0.6064865269600548,34
1651,0,4233,4233,0,0,0,0,1.0,1,1.0,1,1.0,1,0.599245578021975,32
1652,4,4237,4237,0,0,0,0,1.0,1,1.0,1,1.0,1,0.5489109587111264,33
1653,3,4240,4240,0,0,0,0,1.0,1,1.0,1,1.0,1,0.5515180430432881,33
1654,2,4242,4242,0,0,0,0,1.0,1,1.0,1,1.0,1,0.573917203448348,34
1655,8,4250,4250,0,0,0,0,1.0,1,1.0,1,1.0,1,0.5535335785324411,35
1656,4,4254,4254,0,0,0,0,1.0,1,1.0,1,1.0,1,0.5420950636380651,35
1657,6,4260,4260,0,0,0,0,1.0,1,1.0,1,1.0,1,0.5316041889240837,36
1658,5,4265,4265,0,0,0,0,1.0,1,1.0,1,1.0,1,0.4952383627319201,36
1659,2,4267,4267,0,0,0,0,1.0,1,1.0,1,1.0,1,0.48492893825193534,36
1660,3,4270,4270,0,0,0,0,1.0,1,1.0,1,1.0,1,0.5116792824624055,38
1661,3,4273,4273,0,0,0,0,1.0,1,1.0,1,1.0,1,0.5144552448638113,38
1662,3,4276,4276,0,0,0,0,1.0,1,1.0,1,1.0,1,0.559698187043116,39
1663,2,4278,4278,0,0,0,0,1.0,1,1.0,1,1.0,1,0.5415944135968417,40
1664,6,4284,4284,0,0,0,0,1.0,1,1.0,1,1.0,1,0.5926055010458937,39
1665,5,4289,4289,0,0,0,0,1.0,1,1.0,1,1.0,1,0.5972393070650885,40
1666,2,4291,4291,0,0,0,0,1.0,1,1.0,1,1.0,1,0.5698352513987099,40
1667,4,4295,4295,0,0,0,0,1.0,1,1.0,1,1.0,1,0.5652421081724971,40
1668,2,4297,4297,0,0,0,0,1.0,1,1.0,1,1.0,1,0.5210610257368644,41
1669,3,4300,4300,0,0,0,0,1.0,1,1.0,1,1.0,1,0.496867860113112,40
1670,2,4302,4302,0,0,0,0,1.0,1,1.0,1,1.0,1,0.5155520142875356,40
1671,3,4305,4305,0,0,0,0,1.0,1,1.0,1,1.0,1,0.5729725304751719,41
1672,2,4307,4307,0,0,0,0,1.0,1,1.0,1,1.0,1,0.5611113741773226,40
1673,1,4308,4308,0,0,0,0,1.0,1,1.0,1,1.0,1,0.5459791196789924,39
1674,0,4308,4308,0,0,0,0,1.0,1,1.0,1,1.0,1,0.5557543425213269,40
1675,1,4309,4309,0,0,0,0,1.0,1,1.0,1,1.0,1,0.5789542005342793,38
1676,0,4309,4309,0,0,0,0,1.0,1,1.0,1,1.0,1,0.5846351379492545,39
1677,3,4312,4312,0,0,0,0,1.0,1,1.0,1,1.0,1,0.5920487548614927,39
1678,4,4316,4316,0,0,0,0,1.0,1,1.0,1,1.0,1,0.5841017833538059,39
1679,7,4323,4323,0,0,0,0,1.0,1,1.0,1,1.0,1,0.6163553849112248,39
1680,4,4327,4327,0,0,0,0,1.0,1,1.0,1,1.0,1,0.5984401861219645,41
1681,8,4335,4335,0,0,0,0,1.0,1,1.0,1,1.0,1,0.5505332331001672,41
1682,5,4340,4340,0,0,0,0,1.0,1,1.0,1,1.0,1,0.5782926532548206,43
1683,7,4347,4347,0,0,0,0,1.0,1,1.0,1,1.0,1,0.547108841619727,43
1684,3,4350,4350,0,0,0,0,1.0,1,1.0,1,1.0,1,0.5112771602863463,42
1685,3,4353,4353,0,0,0,0,1.0,1,1.0,1,1.0,1,0.484520701115104,41
1686,7,4360,4360,0,0,0,0,1.0,1,1.0,1,1.0,1,0.49985455105703347,41
1687,0,4360,4360,0,0,0,0,1.0,1,1.0,1,1.0,1,0.48982180217388943,40
1688,2,4362,4362,0,0,0,0,1.0,1,1.0,1,1.0,1,0.4778871888794171,39
1689,2,4364,4364,0,0,0,0,1.0,1,1.0,1,1.0,1,0.49153699156326897,38
1690,1,4365,4365,0,0,0,0,1.0,1,1.0,1,1.0,1,0.49511246030832157,38
1691,1,4366,4366,0,0,0,0,1.0,1,1.0,1,1.0,1,0.4996689910494698,36
1692,0,4366,4366,0,0,0,0,1.0,1,1.0,1,1.0,1,0.46954950388536987,36
1693,3,4369,4369,0,0,0,0,1.0,1,1.0,1,1.0,1,0.48612252279929347,35
1694,1,4370,4370,0,0,0,0,1.0,1,1.0,1,1.0,1,0.49380882770917106,33
1695,3,4373,4373,0,0,0,0,1.0,1,1.0,1,1.0,1,0.5413145882954746,34
1696,3,4376,4376,0,0,0,0,1.0,1,1.0,1,1.0,1,0.532688014139827,35
1697,1,4377,4377,0,0,0,0,1.0,1,1.0,1,1.0,1,0.5374928546165751,36
1698,3,4380,4380,0,0,0,0,1.0,1,1.0,1,1.0,1,0.5260893671237762,38
1699,3,4383,4383,0,0,0,0,1.0,1,1.0,1,1.0,1,0.5403471289709735,38
1700,4,4387,4387,0,0,0,0,1.0,1,1.0,1,1.0,1,0.5290327526248785,39
1701,2,4389,4389,0,0,0,0,1.0,1,1.0,1,1.0,1,0.5171249877698126,40
1702,2,4391,4391,0,0,0,0,1.0,1,1.0,1,1.0,1,0.502096346327484,41
1703,2,4393,4393,0,0,0,0,1.0,1,1.0,1,1.0,1,0.5372027726071533,41
1704,4,4397,4397,0,0,0,0,1.0,1,1.0,1,1.0,1,0.5109353857112947,41
1705,1,4398,4398,0,0,0,0,1.0,1,1.0,1,1.0,1,0.526870274823115,40
1706,6,4404,4404,0,0,0,0,1.0,1,1.0,1,1.0,1,0.6235077897410385,40
1707,1,4405,4405,0,0,0,0,1.0,1,1.0,1,1.0,1,0.6557478601386054,39
1708,4,4409,4409,0,0,0,0,1.0,1,1.0,1,1.0,1,0.624954593564965,39
1709,2,4411,4411,0,0,0,0,1.0,1,1.0,1,1.0,1,0.6347816374622574,38
1710,4,4415,4415,0,0,0,0,1.0,1,1.0,1,1.0,1,0.6104553426784692,39
1711,4,4419,4419,0,0,0,0,1.0,1,1.0,1,1.0,1,0.6005995856115977,38
1712,2,4421,4421,0,0,0,0,1.0,1,1.0,1,1.0,1,0.6283435589039591,38
1713,2,4423,4423,0,0,0,0,1.0,1,1.0,1,1.0,1,0.6585984223325411,37
1714,3,4426,4426,0,0,0,0,1.0,1,1.0,1,1.0,1,0.684006909414053,38
1715,0,4426,4426,0,0,0,0,1.0,1,1.0,1,1.0,1,0.6780132330407452,40
1716,0,4426,4426,0,0,0,0,1.0,1,1.0,1,1.0,1,0.6874948128907226,39
1717,2,4428,4428,0,0,0,0,1.0,1,1.0,1,1.0,1,0.712001188921208,38
1718,0,4428,4428,0,0,0,0,1.0,1,1.0,1,1.0,1,0.729404072760543,38
1719,0,4428,4428,0,0,0,0,1.0,1,1.0,1,1.0,1,0.729404072760543,38
1720,1,4429,4429,0,0,0,0,1.0,1,1.0,1,1.0,1,0.7005985471064687,41
1721,0,4429,4429,0,0,0,0,1.0,1,1.0,1,1.0,1,0.692050286559963,39
1722,1,4430,4430,0,0,0,0,1.0,1,1.0,1,1.0,1,0.6781568987679547,40
1723,1,4431,4431,0,0,0,0,1.0,1,1.0,1,1.0,1,0.6648028129967846,38
1724,2,4433,4433,0,0,0,0,1.0,1,1.0,1,1.0,1,0.6435885301143124,37
1725,1,4434,4434,0,0,0,0,1.0,1,1.0,1,1.0,1,0.6425237784515418,38
1726,1,4435,4435,0,0,0,0,1.0,1,1.0,1,1.0,1,0.6210644355738492,37
1727,3,4438,4438,0,0,0,0,1.0,1,1.0,1,1.0,1,0.6072973326493938,37
1728,1,4439,4439,0,0,0,0,1.0,1,1.0,1,1.0,1,0.5972830500293421,35
1729,4,4443,4443,0,0,0,0,1.0,1,1.0,1,1.0,1,0.5751748222308892,37
1730,0,4443,4443,0,0,0,0,1.0,1,1.0,1,1.0,1,0.593539649584306,37
1731,5,4448,4448,0,0,0,0,1.0,1,1.0,1,1.0,1,0.5938503560236825,37
1732,3,4451,4451,0,0,0,0,1.0,1,1.0,1,1.0,1,0.606392904266833,37
1733,4,4455,4455,0,0,0,0,1.0,1,1.0,1,1.0,1,0.5867544076220502,36
1734,6,4461,4461,0,0,0,0,1.0,1,1.0,1,1.0,1,0.6598578855573211,35
1735,5,4466,4466,0,0,0,0,1.0,1,1.0,1,1.0,1,0.6324197254516887,34
1736,9,4475,4475,0,0,0,0,1.0,1,1.0,1,1.0,1,0.6121531984030498,35
1737,3,4478,4478,0,0,0,0,1.0,1,1.0,1,1.0,1,0.5903301427989601,36
1738,4,4482,4482,0,0,0,0,1.0,1,1.0,1,1.0,1,0.564716167010956,37
1739,1,4483,4483,0,0,0,0,1.0,1,1.0,1,1.0,1,0.552812974767824,38
1740,5,4488,4488,0,0,0,0,1.0,1,1.0,1,1.0,1,0.5351719520358148,37
1741,1,4489,4489,0,0,0,0,1.0,1,1.0,1,1.0,1,0.5492198715689455,38
1742,3,4492,4492,0,0,0,0,1.0,1,1.0,1,1.0,1,0.5769947583925282,39
1743,4,4496,4496,0,0,0,0,1.0,1,1.0,1,1.0,1,0.6292280422403581,37
1744,2,4498,4498,0,0,0,0,1.0,1,1.0,1,1.0,1,0.6277692742374646,38
1745,0,4498,4498,0,0,0,0,1.0,1,1.0,1,1.0,1,0.650936442555837,37
1746,2,4500,4500,0,0,0,0,1.0,1,1.0,1,1.0,1,0.6256285647299328,38
1747,0,4500,4500,0,0,0,0,1.0,1,1.0,1,1.0,1,0.6294233893649396,38
1748,1,4501,4501,0,0,0,0,1.0,1,1.0,1,1.0,1,0.6189234415735759,38
1749,0,4501,4501,0,0,0,0,1.0,1,1.0,1,1.0,1,0.6368237965336855,37
1750,2,4503,4503,0,0,0,0,1.0,1,1.0,1,1.0,1,0.6223522717166554,39
1751,1,4504,4504,0,0,0,0,1.0,1,1.0,1,1.0,1,0.6051965819042584,38
1752,1,4505,4505,0,0,0,0,1.0,1,1.0,1,1.0,1,0.6113106205793738,39
1753,1,4506,4506,0,0,0,0,1.0,1,1.0,1,1.0,1,0.5842900246619392,40
1754,2,4508,4508,0,0,0,0,1.0,1,1.0,1,1.0,1,0.5995072685848023,41
1755,7,4515,4515,0,0,0,0,1.0,1,1.0,1,1.0,1,0.5859509575138999,41
1756,3,4518,4518,0,0,0,0,1.0,1,1.0,1,1.0,1,0.5514163642009138,42
1757,5,4523,4523,0,0,0,0,1.0,1,1.0,1,1.0,1,0.5609386106265436,42
1758,6,4529,4529,0,0,0,0,1.0,1,1.0,1,1.0,1,0.5785257857173556,42
1759,6,4535,4535,0,0,0,0,1.0,1,1.0,1,1.0,1,0.578263541037956,39
1760,6,4541,4541,0,0,0,0,1.0,1,1.0,1,1.0,1,0.6131767523015051,39
1761,5,4546,4546,0,0,0,0,1.0,1,1.0,1,1.0,1,0.5667511865623474,38
1762,3,4549,4549,0,0,0,0,1.0,1,1.0,1,1.0,1,0.5476558559600561,37
1763,3,4552,4552,0,0,0,0,1.0,1,1.0,1,1.0,1,0.6235446493215004,37
1764,2,4554,4554,0,0,0,0,1.0,1,1.0,1,1.0,1,0.5789272761309958,36
1765,1,4555,4555,0,0,0,0,1.0,1,1.0,1,1.0,1,0.5766554983189495,37
1766,2,4557,4557,0,0,0,0,1.0,1,1.0,1,1.0,1,0.544053101467157,36
1767,3,4560,4560,0,0,0,0,1.0,1,1.0,1,1.0,1,0.5641550248332761,36
1768,1,4561,4561,0,0,0,0,1.0,1,1.0,1,1.0,1,0.5862796937832868,36
1769,2,4563,4563,0,0,0,0,1.0,1,1.0,1,1.0,1,0.6049694159121702,38
1770,1,4564,4564,0,0,0,0,1.0,1,1.0,1,1.0,1,0.6006231513299695,38
1771,2,4566,4566,0,0,0,0,1.0,1,1.0,1,1.0,1,0.5786667492386218,38
1772,1,4567,4567,0,0,0,0,1.0,1,1.0,1,1.0,1,0.5823717857833044,40
1773,1,4568,4568,0,0,0,0,1.0,1,1.0,1,1.0,1,0.5824114999620247,40
1774,0,4568,4568,0,0,0,0,1.0,1,1.0,1,1.0,1,0.5824114999620247,40
1775,2,4570,4570,0,0,0,0,1.0,1,1.0,1,1.0,1,0.5720652523759167,41
1776,1,4571,4571,0,0,0,0,1.0,1,1.0,1,1.0,1,0.5252683260521389,43
1777,1,4572,4572,0,0,0,0,1.0,1,1.0,1,1.0,1,0.5157208100937624,44
1778,2,4574,4574,0,0,0,0,1.0,1,1.0,1,1.0,1,0.5305814378718016,44
1779,7,4581,4581,0,0,0,0,1.0,1,1.0,1,1.0,1,0.48024787106821215,44
1780,4,4585,4585,0,0,0,0,1.0,1,1.0,1,1.0,1,0.48027669192356304,46
1781,2,4587,4587,0,0,0,0,1.0,1,1.0,1,1.0,1,0.46936394188931,46
1782,8,4595,4595,0,0,0,0,1.0,1,1.0,1,1.0,1,0.4395085509366601,45
1783,4,4599,4599,0,0,0,0,1.0,1,1.0,1,1.0,1,0.4428105682033873,44
1784,2,4601,4601,0,0,0,0,1.0,1,1.0,1,1.0,1,0.45124395738434897,44
1785,3,4604,4604,0,0,0,0,1.0,1,1.0,1,1.0,1,0.4805876247902229,42
1786,9,4613,4613,0,0,0,0,1.0,1,1.0,1,1.0,1,0.49969862671935383,42
1787,3,4616,4616,0,0,0,0,1.0,1,1.0,1,1.0,1,0.5423529445603483,41
1788,5,4621,4621,0,0,0,0,1.0,1,1.0,1,1.0,1,0.5589189323616929,41
1789,5,4626,4626,0,0,0,0,1.0,1,1.0,1,1.0,1,0.5815336895085708,41
1790,3,4629,4629,0,0,0,0,1.0,1,1.0,1,1.0,1,0.563232317387457,41
1791,7,4636,4636,0,0,0,0,1.0,1,1.0,1,1.0,1,0.6072989143253272,41
1792,3,4639,4639,0,0,0,0,1.0,1,1.0,1,1.0,1,0.6006757493159587,43
1793,3,4642,4642,0,0,0,0,1.0,1,1.0,1,1.0,1,0.5444550951710131,43
1794,2,4644,4644,0,0,0,0,1.0,1,1.0,1,1.0,1,0.5757225908869217,41
1795,4,4648,4648,0,0,0,0,1.0,1,1.0,1,1.0,1,0.548826566475117,41
1796,5,4653,4653,0,0,0,0,1.0,1,1.0,1,1.0,1,0.5869988246542094,40
1797,1,4654,4654,0,0,0,0,1.0,1,1.0,1,1.0,1,0.5783079090443121,38
1798,2,4656,4656,0,0,0,0,1.0,1,1.0,1,1.0,1,0.5746337472764673,38
1799,0,4656,4656,0,0,0,0,1.0,1,1.0,1,1.0,1,0.5650660480192568,37
1800,1,4657,4657,0,0,0,0,1.0,1,1.0,1,1.0,1,0.5967300508212351,35
1801,2,4659,4659,0,0,0,0,1.0,1,1.0,1,1.0,1,0.5833173554203644,34
1802,2,4661,4661,0,0,0,0,1.0,1,1.0,1,1.0,1,0.5557254783740424,33
1803,3,4664,4664,0,0,0,0,1.0,1,1.0,1,1.0,1,0.5850562997928893,33
1804,2,4666,4666,0,0,0,0,1.0,1,1.0,1,1.0,1,0.5926250547462744,33
1805,3,4669,4669,0,0,0,0,1.0,1,1.0,1,1.0,1,0.5751495569816916,35
1806,4,4673,4673,0,0,0,0,1.0,1,1.0,1,1.0,1,0.5819809848796368,36
1807,0,4673,4673,0,0,0,0,1.0,1,1.0,1,1.0,1,0.5463784259672811,35
1808,4,4677,4677,0,0,0,0,1.0,1,1.0,1,1.0,1,0.5006214936011123,37
1809,0,4677,4677,0,0,0,0,1.0,1,1.0,1,1.0,1,0.4957511634367936,35
1810,5,4682,4682,0,0,0,0,1.0,1,1.0,1,1.0,1,0.4421003580931039,36
1811,3,4685,4685,0,0,0,0,1.0,1,1.0,1,1.0,1,0.432029389285884,34
1812,5,4690,4690,0,0,0,0,1.0,1,1.0,1,1.0,1,0.5041904402769994,36
1813,1,4691,4691,0,0,0,0,1.0,1,1.0,1,1.0,1,0.5120320191575077,35
1814,4,4695,4695,0,0,0,0,1.0,1,1.0,1,1.0,1,0.5417616139837158,36
1815,3,4698,4698,0,0,0,0,1.0,1,1.0,1,1.0,1,0.5886315677286684,35
1816,0,4698,4698,0,0,0,0,1.0,1,1.0,1,1.0,1,0.5886315677286684,35
1817,6,4704,4704,0,0,0,0,1.0,1,1.0,1,1.0,1,0.6034207523438371,35
1818,5,4709,4709,0,0,0,0,1.0,1,1.0,1,1.0,1,0.6026817515060112,36
1819,6,4715,4715,0,0,0,0,1.0,1,1.0,1,1.0,1,0.5203020512340528,37
1820,1,4716,4716,0,0,0,0,1.0,1,1.0,1,1.0,1,0.5022778244843841,37
1821,3,4719,4719,0,0,0,0,1.0,1,1.0,1,1.0,1,0.4701519145957386,38
1822,4,4723,4723,0,0,0,0,1.0,1,1.0,1,1.0,1,0.4513112808423574,37
1823,4,4727,4727,0,0,0,0,1.0,1,1.0,1,1.0,1,0.4581041008890935,36
1824,3,4730,4730,0,0,0,0,1.0,1,1.0,1,1.0,1,0.4743168618853589,36
1825,1,4731,4731,0,0,0,0,1.0,1,1.0,1,1.0,1,0.4464088091212829,34
1826,5,4736,4736,0,0,0,0,1.0,1,1.0,1,1.0,1,0.4891783885615676,35
1827,0,4736,4736,0,0,0,0,1.0,1,1.0,1,1.0,1,0.4909005377816255,34
1828,4,4740,4740,0,0,0,0,1.0,1,1.0,1,1.0,1,0.4527318693667167,33
1829,4,4744,4744,0,0,0,0,1.0,1,1.0,1,1.0,1,0.42689211894146756,31
1830,3,4747,4747,0,0,0,0,1.0,1,1.0,1,1.0,1,0.4931879109941825,31
1831,3,4750,4750,0,0,0,0,1.0,1,1.0,1,1.0,1,0.5497323624545193,30
1832,5,4755,4755,0,0,0,0,1.0,1,1.0,1,1.0,1,0.5137977166279395,29
1833,2,4757,4757,0,0,0,0,1.0,1,1.0,1,1.0,1,0.5022459672593431,28
1834,2,4759,4759,0,0,0,0,1.0,1,1.0,1,1.0,1,0.5444460140027162,27
1835,2,4761,4761,0,0,0,0,1.0,1,1.0,1,1.0,1,0.5497389943743475,26
1836,1,4762,4762,0,0,0,0,1.0,1,1.0,1,1.0,1,0.5801047569350151,26
1837,1,4763,4763,0,0,0,0,1.0,1,1.0,1,1.0,1,0.5447630970548807,25
1838,1,4764,4764,0,0,0,0,1.0,1,1.0,1,1.0,1,0.573184984336005,25
1839,2,4766,4766,0,0,0,0,1.0,1,1.0,1,1.0,1,0.6289425093846989,24
1840,0,4766,4766,0,0,0,0,1.0,1,1.0,1,1.0,1,0.6148946090497299,23
1841,1,4767,4767,0,0,0,0,1.0,1,1.0,1,1.0,1,0.6432231843369581,22
1842,1,4768,4768,0,0,0,0,1.0,1,1.0,1,1.0,1,0.6379240347792854,23
1843,1,4769,4769,0,0,0,0,1.0,1,1.0,1,1.0,1,0.6549027071822608,23
1844,2,4771,4771,0,0,0,0,1.0,1,1.0,1,1.0,1,0.6297448939188096,23
1845,2,4773,4773,0,0,0,0,1.0,1,1.0,1,1.0,1,0.6250853853303122,23
1846,3,4776,4776,0,0,0,0,1.0,1,1.0,1,1.0,1,0.5273553429040185,23
1847,0,4776,4776,0,0,0,0,1.0,1,1.0,1,1.0,1,0.5325723714547439,24
1848,0,4776,4776,0,0,0,0,1.0,1,1.0,1,1.0,1,0.5325723714547439,24
1849,0,4776,4776,0,0,0,0,1.0,1,1.0,1,1.0,1,0.5456476463596314,25
1850,1,4777,4777,0,0,0,0,1.0,1,1.0,1,1.0,1,0.5872242610772068,25
1851,0,4777,4777,0,0,0,0,1.0,1,1.0,1,1.0,1,0.5872242610772068,25
1852,2,4779,4779,0,0,0,0,1.0,1,1.0,1,1.0,1,0.6026610642120208,25
1853,2,4781,4781,0,0,0,0,1.0,1,1.0,1,1.0,1,0.5688145824827876,25
1854,1,4782,4782,0,0,0,0,1.0,1,1.0,1,1.0,1,0.5799111216379599,25
1855,5,4787,4787,0,0,0,0,1.0,1,1.0,1,1.0,1,0.6023755031123064,26
1856,3,4790,4790,0,0,0,0,1.0,1,1.0,1,1.0,1,0.5740355203851348,27
1857,4,4794,4794,0,0,0,0,1.0,1,1.0,1,1.0,1,0.5635109317498066,28
1858,1,4795,4795,0,0,0,0,1.0,1,1.0,1,1.0,1,0.5563537579308769,28
1859,3,4798,4798,0,0,0,0,1.0,1,1.0,1,1.0,1,0.5939596025055558,28
1860,3,4801,4801,0,0,0,0,1.0,1,1.0,1,1.0,1,0.6291088691874501,28
1861,0,4801,4801,0,0,0,0,1.0,1,1.0,1,1.0,1,0.6291088691874501,28
1862,1,4802,4802,0,0,0,0,1.0,1,1.0,1,1.0,1,0.6652572344723865,28
1863,2,4804,4804,0,0,0,0,1.0,1,1.0,1,1.0,1,0.624078690657908,29
1864,1,4805,4805,0,0,0,0,1.0,1,1.0,1,1.0,1,0.6522517317704821,27
1865,2,4807,4807,0,0,0,0,1.0,1,1.0,1,1.0,1,0.6562121034041507,26
1866,0,4807,4807,0,0,0,0,1.0,1,1.0,1,1.0,1,0.6562121034041507,26
1867,1,4808,4808,0,0,0,0,1.0,1,1.0,1,1.0,1,0.6902151411292178,26
1868,0,4808,4808,0,0,0,0,1.0,1,1.0,1,1.0,1,0.6902151411292178,26
1869,1,4809,4809,0,0,0,0,1.0,1,1.0,1,1.0,1,0.7113394261195632,26
1870,0,4809,4809,0,0,0,0,1.0,1,1.0,1,1.0,1,0.7098130047823671,27
1871,0,4809,4809,0,0,0,0,1.0,1,1.0,1,1.0,1,0.7098130047823671,27
1872,1,4810,4810,0,0,0,0,1.0,1,1.0,1,1.0,1,0.6985595781377756,25
1873,0,4810,4810,0,0,0,0,1.0,1,1.0,1,1.0,1,0.6985595781377756,25
1874,1,4811,4811,0,0,0,0,1.0,1,1.0,1,1.0,1,0.7190005365234956,25
1875,0,4811,4811,0,0,0,0,1.0,1,1.0,1,1.0,1,0.7190005365234956,25
1876,1,4812,4812,0,0,0,0,1.0,1,1.0,1,1.0,1,0.6895299558414129,26
1877,3,4815,4815,0,0,0,0,1.0,1,1.0,1,1.0,1,0.7182981899948417,27
1878,1,4816,4816,0,0,0,0,1.0,1,1.0,1,1.0,1,0.6769175057211149,28
1879,0,4816,4816,0,0,0,0,1.0,1,1.0,1,1.0,1,0.6712704047381424,29
1880,3,4819,4819,0,0,0,0,1.0,1,1.0,1,1.0,1,0.6687698415876318,29
1881,0,4819,4819,0,0,0,0,1.0,1,1.0,1,1.0,1,0.6687698415876318,29
1882,1,4820,4820,0,0,0,0,1.0,1,1.0,1,1.0,1,0.7187436069606747,28
1883,3,4823,4823,0,0,0,0,1.0,1,1.0,1,1.0,1,0.7410044230679216,28
1884,0,4823,4823,0,0,0,0,1.0,1,1.0,1,1.0,1,0.7410044230679216,28
1885,2,4825,4825,0,0,0,0,1.0,1,1.0,1,1.0,1,0.7669731863022833,28
1886,1,4826,4826,0,0,0,0,1.0,1,1.0,1,1.0,1,0.7575415943484038,29
1887,0,4826,4826,0,0,0,0,1.0,1,1.0,1,1.0,1,0.7575415943484038,29
1888,1,4827,4827,0,0,0,0,1.0,1,1.0,1,1.0,1,0.7316630161117128,31
1889,0,4827,4827,0,0,0,0,1.0,1,1.0,1,1.0,1,0.7316630161117128,31
1890,1,4828,4828,0,0,0,0,1.0,1,1.0,1,1.0,1,0.7203202444748047,31
1891,1,4829,4829,0,0,0,0,1.0,1,1.0,1,1.0,1,0.7398096058439136,32
1892,0,4829,4829,0,0,0,0,1.0,1,1.0,1,1.0,1,0.7398096058439136,32
1893,0,4829,4829,0,0,0,0,1.0,1,1.0,1,1.0,1,0.7398096058439136,32
1894,1,4830,4830,0,0,0,0,1.0,1,1.0,1,1.0,1,0.7138899343179316,33
1895,1,4831,4831,0,0,0,0,1.0,1,1.0,1,1.0,1,0.6791122652830005,35
1896,0,4831,4831,0,0,0,0,1.0,1,1.0,1,1.0,1,0.6846083163226911,34
1897,1,4832,4832,0,0,0,0,1.0,1,1.0,1,1.0,1,0.7026011263118277,34
1898,0,4832,4832,0,0,0,0,1.0,1,1.0,1,1.0,1,0.7026011263118277,34
1899,0,4832,4832,0,0,0,0,1.0,1,1.0,1,1.0,1,0.7026011263118277,34
1900,1,4833,4833,0,0,0,0,1.0,1,1.0,1,1.0,1,0.6843007101022958,35
1901,0,4833,4833,0,0,0,0,1.0,1,1.0,1,1.0,1,0.6843007101022958,35
1902,0,4833,4833,0,0,0,0,1.0,1,1.0,1,1.0,1,0.6843007101022958,35
1903,1,4834,4834,0,0,0,0,1.0,1,1.0,1,1.0,1,0.7031676460302392,35
1904,0,4834,4834,0,0,0,0,1.0,1,1.0,1,1.0,1,0.7031676460302392,35
1905,0,4834,4834,0,0,0,0,1.0,1,1.0,1,1.0,1,0.6695114652870034,37
1906,0,4834,4834,0,0,0,0,1.0,1,1.0,1,1.0,1,0.6695114652870034,37
1907,0,4834,4834,0,0,0,0,1.0,1,1.0,1,1.0,1,0.6644825773648247,39
1908,3,4837,4837,0,0,0,0,1.0,1,1.0,1,1.0,1,0.6368732591299818,39
1909,2,4839,4839,0,0,0,0,1.0,1,1.0,1,1.0,1,0.6133205484752926,41
1910,5,4844,4844,0,0,0,0,1.0,1,1.0,1,1.0,1,0.5761476886847184,41
1911,3,4847,4847,0,0,0,0,1.0,1,1.0,1,1.0,1,0.5837562929983294,40
1912,6,4853,4853,0,0,0,0,1.0,1,1.0,1,1.0,1,0.5986259389210812,39
1913,4,4857,4857,0,0,0,0,1.0,1,1.0,1,1.0,1,0.57137988793867,40
1914,5,4862,4862,0,0,0,0,1.0,1,1.0,1,1.0,1,0.5759922572811924,41
1915,1,4863,4863,0,0,0,0,1.0,1,1.0,1,1.0,1,0.5787288535435374,42
1916,2,4865,4865,0,0,0,0,1.0,1,1.0,1,1.0,1,0.5513203162626451,42
1917,2,4867,4867,0,0,0,0,1.0,1,1.0,1,1.0,1,0.5610311057376784,41
1918,2,4869,4869,0,0,0,0,1.0,1,1.0,1,1.0,1,0.5992104827922943,38
1919,1,4870,4870,0,0,0,0,1.0,1,1.0,1,1.0,1,0.5989655638249262,38
1920,3,4873,4873,0,0,0,0,1.0,1,1.0,1,1.0,1,0.6368683015431749,38
1921,1,4874,4874,0,0,0,0,1.0,1,1.0,1,1.0,1,0.6306314837917009,39
1922,3,4877,4877,0,0,0,0,1.0,1,1.0,1,1.0,1,0.6083010147024409,40
1923,5,4882,4882,0,0,0,0,1.0,1,1.0,1,1.0,1,0.5940204546490206,41
1924,2,4884,4884,0,0,0,0,1.0,1,1.0,1,1.0,1,0.573849909454886,41
1925,2,4886,4886,0,0,0,0,1.0,1,1.0,1,1.0,1,0.5922089625501341,41
1926,2,4888,4888,0,0,0,0,1.0,1,1.0,1,1.0,1,0.5886682439213684,41
1927,2,4890,4890,0,0,0,0,1.0,1,1.0,1,1.0,1,0.5814240986546542,41
1928,2,4892,4892,0,0,0,0,1.0,1,1.0,1,1.0,1,0.571321619812795,42
1929,2,4894,4894,0,0,0,0,1.0,1,1.0,1,1.0,1,0.5759478812249048,41
1930,2,4896,4896,0,0,0,0,1.0,1,1.0,1,1.0,1,0.5733279732522393,41
1931,1,4897,4897,0,0,0,0,1.0,1,1.0,1,1.0,1,0.5945509516573864,41
1932,0,4897,4897,0,0,0,0,1.0,1,1.0,1,1.0,1,0.5945509516573864,41
1933,2,4899,4899,0,0,0,0,1.0,1,1.0,1,1.0,1,0.5840820619289665,43
1934,1,4900,4900,0,0,0,0,1.0,1,1.0,1,1.0,1,0.6087915598357404,44
1935,1,4901,4901,0,0,0,0,1.0,1,1.0,1,1.0,1,0.5754197158530712,45
1936,1,4902,4902,0,0,0,0,1.0,1,1.0,1,1.0,1,0.5333232390557958,48
1937,1,4903,4903,0,0,0,0,1.0,1,1.0,1,1.0,1,0.52768171008765,48
1938,2,4905,4905,0,0,0,0,1.0,1,1.0,1,1.0,1,0.5120546962735103,48
1939,3,4908,4908,0,0,0,0,1.0,1,1.0,1,1.0,1,0.49165827738057155,48
1940,5,4913,4913,0,0,0,0,1.0,1,1.0,1,1.0,1,0.46923448218535346,48
1941,2,4915,4915,0,0,0,0,1.0,1,1.0,1,1.0,1,0.4681378685974493,48
1942,2,4917,4917,0,0,0,0,1.0,1,1.0,1,1.0,1,0.4667920975610645,49
1943,1,4918,4918,0,0,0,0,1.0,1,1.0,1,1.0,1,0.49616055113444163,48
1944,6,4924,4924,0,0,0,0,1.0,1,1.0,1,1.0,1,0.534360217621371,47
1945,4,4928,4928,0,0,0,0,1.0,1,1.0,1,1.0,1,0.5488055683365242,46
1946,2,4930,4930,0,0,0,0,1.0,1,1.0,1,1.0,1,0.557919964293619,46
1947,2,4932,4932,0,0,0,0,1.0,1,1.0,1,1.0,1,0.5974953229907575,45
1948,1,4933,4933,0,0,0,0,1.0,1,1.0,1,1.0,1,0.5919133351562219,46
1949,3,4936,4936,0,0,0,0,1.0,1,1.0,1,1.0,1,0.6372643022411166,42
1950,1,4937,4937,0,0,0,0,1.0,1,1.0,1,1.0,1,0.6491520869793475,40
1951,1,4938,4938,0,0,0,0,1.0,1,1.0,1,1.0,1,0.6334429350110118,39
1952,1,4939,4939,0,0,0,0,1.0,1,1.0,1,1.0,1,0.622813554167692,35
1953,4,4943,4943,0,0,0,0,1.0,1,1.0,1,1.0,1,0.6137799180066952,36
1954,4,4947,4947,0,0,0,0,1.0,1,1.0,1,1.0,1,0.6411642873644363,34
1955,5,4952,4952,0,0,0,0,1.0,1,1.0,1,1.0,1,0.6266852677607858,35
1956,8,4960,4960,0,0,0,0,1.0,1,1.0,1,1.0,1,0.609487139230197,37
1957,3,4963,4963,0,0,0,0,1.0,1,1.0,1,1.0,1,0.6167114572808299,37
1958,4,4967,4967,0,0,0,0,1.0,1,1.0,1,1.0,1,0.604875183848074,39
1959,2,4969,4969,0,0,0,0,1.0,1,1.0,1,1.0,1,0.6227688617751637,41
1960,2,4971,4971,0,0,0,0,1.0,1,1.0,1,1.0,1,0.6392236134687066,40
1961,3,4974,4974,0,0,0,0,1.0,1,1.0,1,1.0,1,0.6165163190081395,41
1962,2,4976,4976,0,0,0,0,1.0,1,1.0,1,1.0,1,0.6047651238368856,40
1963,1,4977,4977,0,0,0,0,1.0,1,1.0,1,1.0,1,0.5930341220712348,41
1964,2,4979,4979,0,0,0,0,1.0,1,1.0,1,1.0,1,0.5828498780689501,40
1965,1,4980,4980,0,0,0,0,1.0,1,1.0,1,1.0,1,0.5689001323263622,41
1966,1,4981,4981,0,0,0,0,1.0,1,1.0,1,1.0,1,0.560957673424308,41
1967,4,4985,4985,0,0,0,0,1.0,1,1.0,1,1.0,1,0.5399586220722755,42
1968,2,4987,4987,0,0,0,0,1.0,1,1.0,1,1.0,1,0.5170165010243574,42
1969,2,4989,4989,0,0,0,0,1.0,1,1.0,1,1.0,1,0.501944714169044,43
1970,1,4990,4990,0,0,0,0,1.0,1,1.0,1,1.0,1,0.5239587022444535,42
1971,2,4992,4992,0,0,0,0,1.0,1,1.0,1,1.0,1,0.5064438377016925,42
1972,3,4995,4995,0,0,0,0,1.0,1,1.0,1,1.0,1,0.5226661050229451,42
1973,1,4996,4996,0,0,0,0,1.0,1,1.0,1,1.0,1,0.5372847842867674,43
1974,1,4997,4997,0,0,0,0,1.0,1,1.0,1,1.0,1,0.5520350694459416,43
1975,3,5000,5000,0,0,0,0,1.0,1,1.0,1,1.0,1,0.5807886619052076,43
1976,0,5000,5000,0,0,0,0,1.0,1,1.0,1,1.0,1,0.5807886619052076,43
1977,1,5001,5001,0,0,0,0,1.0,1,1.0,1,1.0,1,0.568210938701425,48
1978,4,5005,5005,0,0,0,0,1.0,1,1.0,1,1.0,1,0.5490031833188299,48
1979,7,5012,5012,0,0,0,0,1.0,1,1.0,1,1.0,1,0.5518090939400685,49
1980,5,5017,5017,0,0,0,0,1.0,1,1.0,1,1.0,1,0.5626710642015306,50
1981,3,5020,5020,0,0,0,0,1.0,1,1.0,1,1.0,1,0.541837732666344,50
1982,7,5027,5027,0,0,0,0,1.0,1,1.0,1,1.0,1,0.5653042582084042,50
1983,4,5031,5031,0,0,0,0,1.0,1,1.0,1,1.0,1,0.5732809070146483,49
1984,7,5038,5038,0,0,0,0,1.0,1,1.0,1,1.0,1,0.5627043290041472,48
1985,5,5043,5043,0,0,0,0,1.0,1,1.0,1,1.0,1,0.5850375006907234,46
1986,4,5047,5047,0,0,0,0,1.0,1,1.0,1,1.0,1,0.5869781090614928,46
1987,3,5050,5050,0,0,0,0,1.0,1,1.0,1,1.0,1,0.6456529851167943,42
1988,5,5055,5055,0,0,0,0,1.0,1,1.0,1,1.0,1,0.6422822761705258,40
1989,3,5058,5058,0,0,0,0,1.0,1,1.0,1,1.0,1,0.6265927483830555,38
1990,1,5059,5059,0,0,0,0,1.0,1,1.0,1,1.0,1,0.6201055241493203,38
1991,4,5063,5063,0,0,0,0,1.0,1,1.0,1,1.0,1,0.6144730315603005,38
1992,0,5063,5063,0,0,0,0,1.0,1,1.0,1,1.0,1,0.6219885864345821,39
1993,3,5066,5066,0,0,0,0,1.0,1,1.0,1,1.0,1,0.59606672407842,38
1994,1,5067,5067,0,0,0,0,1.0,1,1.0,1,1.0,1,0.5872000170576589,37
1995,4,5071,5071,0,0,0,0,1.0,1,1.0,1,1.0,1,0.5923144728732979,37
1996,2,5073,5073,0,0,0,0,1.0,1,1.0,1,1.0,1,0.5728037337006685,37
1997,3,5076,5076,0,0,0,0,1.0,1,1.0,1,1.0,1,0.5692946132774118,35
1998,3,5079,5079,0,0,0,0,1.0,1,1.0,1,1.0,1,0.5771225796898075,34
1999,2,5081,5081,0,0,0,0,1.0,1,1.0,1,1.0,1,0.5658408147995295,35
2000,0,5081,5081,0,0,0,0,1.0,1,1.0,1,1.0,1,0.5756969072013595,34
2001,4,5085,5085,0,0,0,0,1.0,1,1.0,1,1.0,1,0.5544006828024404,35
2002,2,5087,5087,0,0,0,0,1.0,1,1.0,1,1.0,1,0.547444691324714,36
2003,3,5090,5090,0,0,0,0,1.0,1,1.0,1,1.0,1,0.5616866079118374,37
2004,1,5091,5091,0,0,0,0,1.0,1,1.0,1,1.0,1,0.5885885633541929,38
2005,3,5094,5094,0,0,0,0,1.0,1,1.0,1,1.0,1,0.5716998254256441,38
2006,2,5096,5096,0,0,0,0,1.0,1,1.0,1,1.0,1,0.6005726558365178,38
2007,3,5099,5099,0,0,0,0,1.0,1,1.0,1,1.0,1,0.5657238554295554,40
2008,1,5100,5100,0,0,0,0,1.0,1,1.0,1,1.0,1,0.5434922674287738,40
2009,0,5100,5100,0,0,0,0,1.0,1,1.0,1,1.0,1,0.5217064360290314,41
2010,1,5101,5101,0,0,0,0,1.0,1,1.0,1,1.0,1,0.505260900303538,41
2011,1,5102,5102,0,0,0,0,1.0,1,1.0,1,1.0,1,0.5044656830477141,41
2012,3,5105,5105,0,0,0,0,1.0,1,1.0,1,1.0,1,0.5279339223929533,41
2013,4,5109,5109,0,0,0,0,1.0,1,1.0,1,1.0,1,0.5635169833029041,43
2014,2,5111,5111,0,0,0,0,1.0,1,1.0,1,1.0,1,0.5762622355003482,43
2015,4,5115,5115,0,0,0,0,1.0,1,1.0,1,1.0,1,0.63049137152638,43
2016,2,5117,5117,0,0,0,0,1.0,1,1.0,1,1.0,1,0.6212082555862023,44
2017,3,5120,5120,0,0,0,0,1.0,1,1.0,1,1.0,1,0.5882651052339912,45
2018,3,5123,5123,0,0,0,0,1.0,1,1.0,1,1.0,1,0.5935968998795083,46
2019,4,5127,5127,0,0,0,0,1.0,1,1.0,1,1.0,1,0.5234044781949145,47
2020,5,5132,5132,0,0,0,0,1.0,1,1.0,1,1.0,1,0.5221192115543253,47
2021,2,5134,5134,0,0,0,0,1.0,1,1.0,1,1.0,1,0.5164157243655418,47
2022,4,5138,5138,0,0,0,0,1.0,1,1.0,1,1.0,1,0.5130255827392474,48
2023,3,5141,5141,0,0,0,0,1.0,1,1.0,1,1.0,1,0.5058244898222582,48
2024,2,5143,5143,0,0,0,0,1.0,1,1.0,1,1.0,1,0.5258406589904537,45
2025,2,5145,5145,0,0,0,0,1.0,1,1.0,1,1.0,1,0.5373995545257768,42
2026,4,5149,5149,0,0,0,0,1.0,1,1.0,1,1.0,1,0.5071521215619738,44
2027,2,5151,5151,0,0,0,0,1.0,1,1.0,1,1.0,1,0.5346099324688761,40
2028,3,5154,5154,0,0,0,0,1.0,1,1.0,1,1.0,1,0.4966070123723739,39
2029,5,5159,5159,0,0,0,0,1.0,1,1.0,1,1.0,1,0.5801873928818965,37
2030,3,5162,5162,0,0,0,0,1.0,1,1.0,1,1.0,1,0.5577897981480969,34
2031,3,5165,5165,0,0,0,0,1.0,1,1.0,1,1.0,1,0.5822090618779476,35
2032,2,5167,5167,0,0,0,0,1.0,1,1.0,1,1.0,1,0.6077352408945297,34
2033,5,5172,5172,0,0,0,0,1.0,1,1.0,1,1.0,1,0.561229919878911,36
2034,2,5174,5174,0,0,0,0,1.0,1,1.0,1,1.0,1,0.6071155034757603,34
2035,1,5175,5175,0,0,0,0,1.0,1,1.0,1,1.0,1,0.5682049759847644,35
2036,0,5175,5175,0,0,0,0,1.0,1,1.0,1,1.0,1,0.5860780107433683,34
2037,3,5178,5178,0,0,0,0,1.0,1,1.0,1,1.0,1,0.5454421552374802,35
2038,1,5179,5179,0,0,0,0,1.0,1,1.0,1,1.0,1,0.5501821743704657,36
2039,1,5180,5180,0,0,0,0,1.0,1,1.0,1,1.0,1,0.5225469438107826,38
2040,0,5180,5180,0,0,0,0,1.0,1,1.0,1,1.0,1,0.5225469438107826,38
2041,0,5180,5180,0,0,0,0,1.0,1,1.0,1,1.0,1,0.509574573722983,39
2042,0,5180,5180,0,0,0,0,1.0,1,1.0,1,1.0,1,0.509574573722983,39
2043,2,5182,5182,0,0,0,0,1.0,1,1.0,1,1.0,1,0.4900300890010587,39
2044,0,5182,5182,0,0,0,0,1.0,1,1.0,1,1.0,1,0.4900300890010587,39
2045,4,5186,5186,0,0,0,0,1.0,1,1.0,1,1.0,1,0.4750526206223254,41
2046,0,5186,5186,0,0,0,0,1.0,1,1.0,1,1.0,1,0.4792212270444148,42
2047,5,5191,5191,0,0,0,0,1.0,1,1.0,1,1.0,1,0.5130466691871319,42
2048,1,5192,5192,0,0,0,0,1.0,1,1.0,1,1.0,1,0.5149990478739724,43
2049,5,5197,5197,0,0,0,0,1.0,1,1.0,1,1.0,1,0.46755356041061746,44
2050,1,5198,5198,0,0,0,0,1.0,1,1.0,1,1.0,1,0.4877167276863183,44
2051,3,5201,5201,0,0,0,0,1.0,1,1.0,1,1.0,1,0.5308660541362871,45
2052,0,5201,5201,0,0,0,0,1.0,1,1.0,1,1.0,1,0.5308660541362871,45
2053,6,5207,5207,0,0,0,0,1.0,1,1.0,1,1.0,1,0.5305835119844348,45
2054,3,5210,5210,0,0,0,0,1.0,1,1.0,1,1.0,1,0.5109647345980682,46
2055,4,5214,5214,0,0,0,0,1.0,1,1.0,1,1.0,1,0.5505297366264137,46
2056,4,5218,5218,0,0,0,0,1.0,1,1.0,1,1.0,1,0.5442115270883453,46
2057,2,5220,5220,0,0,0,0,1.0,1,1.0,1,1.0,1,0.5243393088619265,47
2058,8,5228,5228,0,0,0,0,1.0,1,1.0,1,1.0,1,0.4924509244347225,47
2059,6,5234,5234,0,0,0,0,1.0,1,1.0,1,1.0,1,0.4705852021244157,48
2060,3,5237,5237,0,0,0,0,1.0,1,1.0,1,1.0,1,0.47768678494779143,50
2061,2,5239,5239,0,0,0,0,1.0,1,1.0,1,1.0,1,0.47119642075861745,51
2062,3,5242,5242,0,0,0,0,1.0,1,1.0,1,1.0,1,0.44989438889847316,49
2063,3,5245,5245,0,0,0,0,1.0,1,1.0,1,1.0,1,0.4851140017822973,48
2064,1,5246,5246,0,0,0,0,1.0,1,1.0,1,1.0,1,0.4962595541371929,45
2065,6,5252,5252,0,0,0,0,1.0,1,1.0,1,1.0,1,0.5614506396719098,44
2066,0,5252,5252,0,0,0,0,1.0,1,1.0,1,1.0,1,0.567616703837177,42
2067,3,5255,5255,0,0,0,0,1.0,1,1.0,1,1.0,1,0.6319559150715868,41
2068,2,5257,5257,0,0,0,0,1.0,1,1.0,1,1.0,1,0.6406938150130214,40
2069,0,5257,5257,0,0,0,0,1.0,1,1.0,1,1.0,1,0.6361784613332926,40
2070,2,5259,5259,0,0,0,0,1.0,1,1.0,1,1.0,1,0.6217006518055582,40
2071,1,5260,5260,0,0,0,0,1.0,1,1.0,1,1.0,1,0.604270788310295,40
2072,2,5262,5262,0,0,0,0,1.0,1,1.0,1,1.0,1,0.5971150154642656,41
2073,1,5263,5263,0,0,0,0,1.0,1,1.0,1,1.0,1,0.6112902743063792,41
2074,2,5265,5265,0,0,0,0,1.0,1,1.0,1,1.0,1,0.6044790481344287,41
2075,2,5267,5267,0,0,0,0,1.0,1,1.0,1,1.0,1,0.585830904578565,41
2076,2,5269,5269,0,0,0,0,1.0,1,1.0,1,1.0,1,0.5742060267814407,41
2077,2,5271,5271,0,0,0,0,1.0,1,1.0,1,1.0,1,0.5996190428598623,40
2078,3,5274,5274,0,0,0,0,1.0,1,1.0,1,1.0,1,0.6029662555992956,40
2079,3,5277,5277,0,0,0,0,1.0,1,1.0,1,1.0,1,0.5587149855182457,39
2080,6,5283,5283,0,0,0,0,1.0,1,1.0,1,1.0,1,0.6000006840165724,38
2081,2,5285,5285,0,0,0,0,1.0,1,1.0,1,1.0,1,0.5777503941978672,40
2082,9,5294,5294,0,0,0,0,1.0,1,1.0,1,1.0,1,0.600756503649391,41
2083,3,5297,5297,0,0,0,0,1.0,1,1.0,1,1.0,1,0.5730967367041409,40
2084,5,5302,5302,0,0,0,0,1.0,1,1.0,1,1.0,1,0.5704866188705914,42
2085,7,5309,5309,0,0,0,0,1.0,1,1.0,1,1.0,1,0.525696468973197,42
2086,4,5313,5313,0,0,0,0,1.0,1,1.0,1,1.0,1,0.5091421530628646,43
2087,1,5314,5314,0,0,0,0,1.0,1,1.0,1,1.0,1,0.48470004310097825,45
2088,2,5316,5316,0,0,0,0,1.0,1,1.0,1,1.0,1,0.5057187343722952,46
2089,0,5316,5316,0,0,0,0,1.0,1,1.0,1,1.0,1,0.49024448211012783,47
2090,0,5316,5316,0,0,0,0,1.0,1,1.0,1,1.0,1,0.4827928664182441,49
2091,1,5317,5317,0,0,0,0,1.0,1,1.0,1,1.0,1,0.4921941307222209,49
2092,0,5317,5317,0,0,0,0,1.0,1,1.0,1,1.0,1,0.4921941307222209,49
2093,1,5318,5318,0,0,0,0,1.0,1,1.0,1,1.0,1,0.4712127584587392,49
2094,4,5322,5322,0,0,0,0,1.0,1,1.0,1,1.0,1,0.4579450116016632,49
2095,2,5324,5324,0,0,0,0,1.0,1,1.0,1,1.0,1,0.4404033006006899,49
2096,2,5326,5326,0,0,0,0,1.0,1,1.0,1,1.0,1,0.48014383826172813,51
2097,2,5328,5328,0,0,0,0,1.0,1,1.0,1,1.0,1,0.468132311683298,51
2098,2,5330,5330,0,0,0,0,1.0,1,1.0,1,1.0,1,0.4727610989589865,52
2099,4,5334,5334,0,0,0,0,1.0,1,1.0,1,1.0,1,0.4542790859676656,51
2100,3,5337,5337,0,0,0,0,1.0,1,1.0,1,1.0,1,0.4734792376373411,51
2101,1,5338,5338,0,0,0,0,1.0,1,1.0,1,1.0,1,0.47737041778868616,48
2102,2,5340,5340,0,0,0,0,1.0,1,1.0,1,1.0,1,0.48993528656328206,49
2103,4,5344,5344,0,0,0,0,1.0,1,1.0,1,1.0,1,0.49237843274376303,48
2104,1,5345,5345,0,0,0,0,1.0,1,1.0,1,1.0,1,0.5109278812012906,43
2105,5,5350,5350,0,0,0,0,1.0,1,1.0,1,1.0,1,0.5290540846091585,42
2106,0,5350,5350,0,0,0,0,1.0,1,1.0,1,1.0,1,0.5245368903549893,40
2107,4,5354,5354,0,0,0,0,1.0,1,1.0,1,1.0,1,0.5808563881065065,39
2108,2,5356,5356,0,0,0,0,1.0,1,1.0,1,1.0,1,0.6226941490086175,38
2109,2,5358,5358,0,0,0,0,1.0,1,1.0,1,1.0,1,0.6224641721552867,37
2110,1,5359,5359,0,0,0,0,1.0,1,1.0,1,1.0,1,0.6322385293348597,38
2111,1,5360,5360,0,0,0,0,1.0,1,1.0,1,1.0,1,0.6219339337215906,37
2112,1,5361,5361,0,0,0,0,1.0,1,1.0,1,1.0,1,0.6492753651341564,36
2113,0,5361,5361,0,0,0,0,1.0,1,1.0,1,1.0,1,0.6499686841397349,36
2114,0,5361,5361,0,0,0,0,1.0,1,1.0,1,1.0,1,0.6418870344768394,36
2115,0,5361,5361,0,0,0,0,1.0,1,1.0,1,1.0,1,0.6354067667117264,35
2116,0,5361,5361,0,0,0,0,1.0,1,1.0,1,1.0,1,0.6282834983157176,37
2117,2,5363,5363,0,0,0,0,1.0,1,1.0,1,1.0,1,0.5796794254318263,38
2118,0,5363,5363,0,0,0,0,1.0,1,1.0,1,1.0,1,0.5756705669504966,40
2119,3,5366,5366,0,0,0,0,1.0,1,1.0,1,1.0,1,0.5877242555253532,40
2120,0,5366,5366,0,0,0,0,1.0,1,1.0,1,1.0,1,0.5896425018982969,41
2121,1,5367,5367,0,0,0,0,1.0,1,1.0,1,1.0,1,0.5849527436502647,41
2122,1,5368,5368,0,0,0,0,1.0,1,1.0,1,1.0,1,0.6060513926694928,42
2123,0,5368,5368,0,0,0,0,1.0,1,1.0,1,1.0,1,0.6007891404930343,43
2124,0,5368,5368,0,0,0,0,1.0,1,1.0,1,1.0,1,0.6007096210010496,41
2125,0,5368,5368,0,0,0,0,1.0,1,1.0,1,1.0,1,0.6007096210010496,41
2126,0,5368,5368,0,0,0,0,1.0,1,1.0,1,1.0,1,0.6104648878805577,40
2127,2,5370,5370,0,0,0,0,1.0,1,1.0,1,1.0,1,0.6246354594852155,40
2128,2,5372,5372,0,0,0,0,1.0,1,1.0,1,1.0,1,0.6175101768200835,41
2129,1,5373,5373,0,0,0,0,1.0,1,1.0,1,1.0,1,0.6132862141961386,42
2130,3,5376,5376,0,0,0,0,1.0,1,1.0,1,1.0,1,0.6087093420658161,45
2131,1,5377,5377,0,0,0,0,1.0,1,1.0,1,1.0,1,0.6129876889735562,45
2132,5,5382,5382,0,0,0,0,1.0,1,1.0,1,1.0,1,0.6318547156624323,46
2133,5,5387,5387,0,0,0,0,1.0,1,1.0,1,1.0,1,0.6296476619089886,46
2134,3,5390,5390,0,0,0,0,1.0,1,1.0,1,1.0,1,0.595755278854297,47
2135,10,5400,5400,0,0,0,0,1.0,1,1.0,1,1.0,1,0.6190133207490385,47
2136,4,5404,5404,0,0,0,0,1.0,1,1.0,1,1.0,1,0.6148692621658549,47
2137,5,5409,5409,0,0,0,0,1.0,1,1.0,1,1.0,1,0.5804822311523826,49
2138,4,5413,5413,0,0,0,0,1.0,1,1.0,1,1.0,1,0.5796388912978486,49
2139,1,5414,5414,0,0,0,0,1.0,1,1.0,1,1.0,1,0.5902172641797573,47
2140,2,5416,5416,0,0,0,0,1.0,1,1.0,1,1.0,1,0.587070757303026,48
2141,3,5419,5419,0,0,0,0,1.0,1,1.0,1,1.0,1,0.5900994917663044,47
2142,3,5422,5422,0,0,0,0,1.0,1,1.0,1,1.0,1,0.5934482002633691,47
2143,2,5424,5424,0,0,0,0,1.0,1,1.0,1,1.0,1,0.5865468338853105,48
2144,6,5430,5430,0,0,0,0,1.0,1,1.0,1,1.0,1,0.5908378384185816,48
2145,2,5432,5432,0,0,0,0,1.0,1,1.0,1,1.0,1,0.639291769063135,46
2146,3,5435,5435,0,0,0,0,1.0,1,1.0,1,1.0,1,0.6027048519224634,47
2147,6,5441,5441,0,0,0,0,1.0,1,1.0,1,1.0,1,0.5873504204168483,48
2148,1,5442,5442,0,0,0,0,1.0,1,1.0,1,1.0,1,0.5611231064026372,46
2149,9,5451,5451,0,0,0,0,1.0,1,1.0,1,1.0,1,0.5292476315425035,46
2150,3,5454,5454,0,0,0,0,1.0,1,1.0,1,1.0,1,0.5036690180299546,46
2151,6,5460,5460,0,0,0,0,1.0,1,1.0,1,1.0,1,0.5044836270061689,44
2152,4,5464,5464,0,0,0,0,1.0,1,1.0,1,1.0,1,0.5323587226256763,45
2153,3,5467,5467,0,0,0,0,1.0,1,1.0,1,1.0,1,0.5425747577083634,48
2154,0,5467,5467,0,0,0,0,1.0,1,1.0,1,1.0,1,0.5459304869084819,47
2155,5,5472,5472,0,0,0,0,1.0,1,1.0,1,1.0,1,0.5577609207659829,48
2156,0,5472,5472,0,0,0,0,1.0,1,1.0,1,1.0,1,0.5657494514910615,45
2157,5,5477,5477,0,0,0,0,1.0,1,1.0,1,1.0,1,0.5319207558127993,43
2158,3,5480,5480,0,0,0,0,1.0,1,1.0,1,1.0,1,0.5520780882160596,43
2159,4,5484,5484,0,0,0,0,1.0,1,1.0,1,1.0,1,0.5486116330251148,43
2160,7,5491,5491,0,0,0,0,1.0,1,1.0,1,1.0,1,0.5884813243893546,41
2161,6,5497,5497,0,0,0,0,1.0,1,1.0,1,1.0,1,0.5925680485706146,41
2162,2,5499,5499,0,0,0,0,1.0,1,1.0,1,1.0,1,0.5494895261498143,42
2163,3,5502,5502,0,0,0,0,1.0,1,1.0,1,1.0,1,0.5650272692013375,43
2164,0,5502,5502,0,0,0,0,1.0,1,1.0,1,1.0,1,0.5595053380624196,44
2165,3,5505,5505,0,0,0,0,1.0,1,1.0,1,1.0,1,0.5632440552073439,44
2166,2,5507,5507,0,0,0,0,1.0,1,1.0,1,1.0,1,0.5264366665129454,46
2167,3,5510,5510,0,0,0,0,1.0,1,1.0,1,1.0,1,0.5681265924395044,46
2168,0,5510,5510,0,0,0,0,1.0,1,1.0,1,1.0,1,0.5730489983782203,45
2169,0,5510,5510,0,0,0,0,1.0,1,1.0,1,1.0,1,0.5533068890326506,49
2170,1,5511,5511,0,0,0,0,1.0,1,1.0,1,1.0,1,0.5693699780987859,49
2171,3,5514,5514,0,0,0,0,1.0,1,1.0,1,1.0,1,0.5249721295565096,51
2172,3,5517,5517,0,0,0,0,1.0,1,1.0,1,1.0,1,0.5422737327918083,52
2173,4,5521,5521,0,0,0,0,1.0,1,1.0,1,1.0,1,0.5760549916234695,52
2174,6,5527,5527,0,0,0,0,1.0,1,1.0,1,1.0,1,0.5829282520675513,52
2175,3,5530,5530,0,0,0,0,1.0,1,1.0,1,1.0,1,0.5632035767063435,53
2176,2,5532,5532,0,0,0,0,1.0,1,1.0,1,1.0,1,0.5443723616351913,54
2177,4,5536,5536,0,0,0,0,1.0,1,1.0,1,1.0,1,0.5601562529165536,55
2178,5,5541,5541,0,0,0,0,1.0,1,1.0,1,1.0,1,0.5609014565550821,54
2179,4,5545,5545,0,0,0,0,1.0,1,1.0,1,1.0,1,0.5358965391329767,52
2180,2,5547,5547,0,0,0,0,1.0,1,1.0,1,1.0,1,0.5439737904863408,51
2181,5,5552,5552,0,0,0,0,1.0,1,1.0,1,1.0,1,0.5443312452579117,49
2182,8,5560,5560,0,0,0,0,1.0,1,1.0,1,1.0,1,0.5528473200397818,49
2183,5,5565,5565,0,0,0,0,1.0,1,1.0,1,1.0,1,0.5511951295635887,46
2184,7,5572,5572,0,0,0,0,1.0,1,1.0,1,1.0,1,0.520693602341918,45
2185,7,5579,5579,0,0,0,0,1.0,1,1.0,1,1.0,1,0.5584503708506646,44
2186,7,5586,5586,0,0,0,0,1.0,1,1.0,1,1.0,1,0.5421099463840334,42
2187,6,5592,5592,0,0,0,0,1.0,1,1.0,1,1.0,1,0.5098379327117768,40
2188,4,5596,5596,0,0,0,0,1.0,1,1.0,1,1.0,1,0.5216892574512373,38
2189,5,5601,5601,0,0,0,0,1.0,1,1.0,1,1.0,1,0.5533715228563408,36
2190,3,5604,5604,0,0,0,0,1.0,1,1.0,1,1.0,1,0.5725152803927052,34
2191,3,5607,5607,0,0,0,0,1.0,1,1.0,1,1.0,1,0.577101649501669,34
2192,6,5613,5613,0,0,0,0,1.0,1,1.0,1,1.0,1,0.5739148944045009,33
2193,1,5614,5614,0,0,0,0,1.0,1,1.0,1,1.0,1,0.5950491147483321,32
2194,1,5615,5615,0,0,0,0,1.0,1,1.0,1,1.0,1,0.5856789228066861,32
2195,1,5616,5616,0,0,0,0,1.0,1,1.0,1,1.0,1,0.5720545534682173,31
2196,2,5618,5618,0,0,0,0,1.0,1,1.0,1,1.0,1,0.5831112256019024,32
2197,0,5618,5618,0,0,0,0,1.0,1,1.0,1,1.0,1,0.6082301917116228,31
2198,1,5619,5619,0,0,0,0,1.0,1,1.0,1,1.0,1,0.5769354391845324,31
2199,3,5622,5622,0,0,0,0,1.0,1,1.0,1,1.0,1,0.509938850896281,32
2200,0,5622,5622,0,0,0,0,1.0,1,1.0,1,1.0,1,0.5093284544714182,35
2201,2,5624,5624,0,0,0,0,1.0,1,1.0,1,1.0,1,0.4914276127770422,36
2202,0,5624,5624,0,0,0,0,1.0,1,1.0,1,1.0,1,0.4914276127770422,36
2203,3,5627,5627,0,0,0,0,1.0,1,1.0,1,1.0,1,0.48482586263738814,37
2204,5,5632,5632,0,0,0,0,1.0,1,1.0,1,1.0,1,0.4656186308038442,36
2205,5,5637,5637,0,0,0,0,1.0,1,1.0,1,1.0,1,0.4973219468557693,37
2206,3,5640,5640,0,0,0,0,1.0,1,1.0,1,1.0,1,0.5009465079223518,35
2207,1,5641,5641,0,0,0,0,1.0,1,1.0,1,1.0,1,0.4989096642673797,37
2208,3,5644,5644,0,0,0,0,1.0,1,1.0,1,1.0,1,0.528856991493684,36
2209,2,5646,5646,0,0,0,0,1.0,1,1.0,1,1.0,1,0.576913879812112,35
2210,0,5646,5646,0,0,0,0,1.0,1,1.0,1,1.0,1,0.5594041886214379,38
2211,3,5649,5649,0,0,0,0,1.0,1,1.0,1,1.0,1,0.6036353685583301,37
2212,0,5649,5649,0,0,0,0,1.0,1,1.0,1,1.0,1,0.6097910229410609,38
2213,3,5652,5652,0,0,0,0,1.0,1,1.0,1,1.0,1,0.6066709128764894,38
2214,0,5652,5652,0,0,0,0,1.0,1,1.0,1,1.0,1,0.589541770157721,39
2215,1,5653,5653,0,0,0,0,1.0,1,1.0,1,1.0,1,0.588920349116963,39
2216,4,5657,5657,0,0,0,0,1.0,1,1.0,1,1.0,1,0.5548493762980722,39
2217,2,5659,5659,0,0,0,0,1.0,1,1.0,1,1.0,1,0.47667796955862207,38
2218,3,5662,5662,0,0,0,0,1.0,1,1.0,1,1.0,1,0.4459629792751412,37
2219,2,5664,5664,0,0,0,0,1.0,1,1.0,1,1.0,1,0.42022405762208537,36
2220,2,5666,5666,0,0,0,0,1.0,1,1.0,1,1.0,1,0.39010664220931296,34
2221,5,5671,5671,0,0,0,0,1.0,1,1.0,1,1.0,1,0.4252545320057666,35
2222,2,5673,5673,0,0,0,0,1.0,1,1.0,1,1.0,1,0.45562508432132515,33
2223,3,5676,5676,0,0,0,0,1.0,1,1.0,1,1.0,1,0.5107493558522356,34
2224,2,5678,5678,0,0,0,0,1.0,1,1.0,1,1.0,1,0.5402483436536776,32
2225,2,5680,5680,0,0,0,0,1.0,1,1.0,1,1.0,1,0.5810823703336463,33
2226,1,5681,5681,0,0,0,0,1.0,1,1.0,1,1.0,1,0.5645943207242952,32
2227,3,5684,5684,0,0,0,0,1.0,1,1.0,1,1.0,1,0.5031790859445109,31
2228,2,5686,5686,0,0,0,0,1.0,1,1.0,1,1.0,1,0.5177634097890453,32
2229,0,5686,5686,0,0,0,0,1.0,1,1.0,1,1.0,1,0.5177634097890453,32
2230,3,5689,5689,0,0,0,0,1.0,1,1.0,1,1.0,1,0.5339129642507704,31
2231,0,5689,5689,0,0,0,0,1.0,1,1.0,1,1.0,1,0.5219911833112689,32
2232,4,5693,5693,0,0,0,0,1.0,1,1.0,1,1.0,1,0.4950972010034129,32
2233,3,5696,5696,0,0,0,0,1.0,1,1.0,1,1.0,1,0.5161551842659521,31
2234,4,5700,5700,0,0,0,0,1.0,1,1.0,1,1.0,1,0.5558661542316933,32
2235,6,5706,5706,0,0,0,0,1.0,1,1.0,1,1.0,1,0.5426831101126356,31
2236,5,5711,5711,0,0,0,0,1.0,1,1.0,1,1.0,1,0.5501637073269807,31
2237,6,5717,5717,0,0,0,0,1.0,1,1.0,1,1.0,1,0.5457823913359335,31
2238,4,5721,5721,0,0,0,0,1.0,1,1.0,1,1.0,1,0.5581865098244737,31
2239,3,5724,5724,0,0,0,0,1.0,1,1.0,1,1.0,1,0.5999128223043466,31
2240,3,5727,5727,0,0,0,0,1.0,1,1.0,1,1.0,1,0.6500414219034079,32
2241,1,5728,5728,0,0,0,0,1.0,1,1.0,1,1.0,1,0.6321728203498277,32
2242,2,5730,5730,0,0,0,0,1.0,1,1.0,1,1.0,1,0.5908795583764604,34
2243,0,5730,5730,0,0,0,0,1.0,1,1.0,1,1.0,1,0.5908795583764604,34
2244,1,5731,5731,0,0,0,0,1.0,1,1.0,1,1.0,1,0.5927273256211707,36
2245,3,5734,5734,0,0,0,0,1.0,1,1.0,1,1.0,1,0.5791461339613202,36
2246,0,5734,5734,0,0,0,0,1.0,1,1.0,1,1.0,1,0.5651172604261102,39
2247,1,5735,5735,0,0,0,0,1.0,1,1.0,1,1.0,1,0.5488103735491251,40
2248,2,5737,5737,0,0,0,0,1.0,1,1.0,1,1.0,1,0.5793067930992026,40
2249,0,5737,5737,0,0,0,0,1.0,1,1.0,1,1.0,1,0.5632296515452468,41
2250,0,5737,5737,0,0,0,0,1.0,1,1.0,1,1.0,1,0.5632296515452468,41
2251,2,5739,5739,0,0,0,0,1.0,1,1.0,1,1.0,1,0.5991587808319249,42
2252,0,5739,5739,0,0,0,0,1.0,1,1.0,1,1.0,1,0.593672639255663,41
2253,3,5742,5742,0,0,0,0,1.0,1,1.0,1,1.0,1,0.6093129015735155,40
2254,2,5744,5744,0,0,0,0,1.0,1,1.0,1,1.0,1,0.6442084834920974,39
2255,3,5747,5747,0,0,0,0,1.0,1,1.0,1,1.0,1,0.6565638479807147,39
2256,1,5748,5748,0,0,0,0,1.0,1,1.0,1,1.0,1,0.637334151164175,40
2257,2,5750,5750,0,0,0,0,1.0,1,1.0,1,1.0,1,0.5958612525448725,40
2258,3,5753,5753,0,0,0,0,1.0,1,1.0,1,1.0,1,0.5572846838941784,39
2259,5,5758,5758,0,0,0,0,1.0,1,1.0,1,1.0,1,0.5239878317781242,41
2260,4,5762,5762,0,0,0,0,1.0,1,1.0,1,1.0,1,0.4993071293316943,38
2261,7,5769,5769,0,0,0,0,1.0,1,1.0,1,1.0,1,0.47642427828515016,38
2262,3,5772,5772,0,0,0,0,1.0,1,1.0,1,1.0,1,0.5353442288648373,36
2263,7,5779,5779,0,0,0,0,1.0,1,1.0,1,1.0,1,0.5185922343929557,35
2264,4,5783,5783,0,0,0,0,1.0,1,1.0,1,1.0,1,0.5671983747503815,33
2265,7,5790,5790,0,0,0,0,1.0,1,1.0,1,1.0,1,0.5547782295211033,33
2266,3,5793,5793,0,0,0,0,1.0,1,1.0,1,1.0,1,0.5491157107421156,33
2267,4,5797,5797,0,0,0,0,1.0,1,1.0,1,1.0,1,0.4910426419012669,33
2268,3,5800,5800,0,0,0,0,1.0,1,1.0,1,1.0,1,0.5470354188567438,35
2269,4,5804,5804,0,0,0,0,1.0,1,1.0,1,1.0,1,0.5103379038073179,36
2270,5,5809,5809,0,0,0,0,1.0,1,1.0,1,1.0,1,0.5468657405578271,34
2271,4,5813,5813,0,0,0,0,1.0,1,1.0,1,1.0,1,0.5294584577435166,34
2272,3,5816,5816,0,0,0,0,1.0,1,1.0,1,1.0,1,0.6031520652969162,33
2273,4,5820,5820,0,0,0,0,1.0,1,1.0,1,1.0,1,0.5744725557413279,32
2274,2,5822,5822,0,0,0,0,1.0,1,1.0,1,1.0,1,0.5495503021128555,32
2275,2,5824,5824,0,0,0,0,1.0,1,1.0,1,1.0,1,0.5505480340708924,32
2276,3,5827,5827,0,0,0,0,1.0,1,1.0,1,1.0,1,0.5907437592377617,31
2277,1,5828,5828,0,0,0,0,1.0,1,1.0,1,1.0,1,0.6268425769943256,30
2278,3,5831,5831,0,0,0,0,1.0,1,1.0,1,1.0,1,0.5412616160564387,33
2279,0,5831,5831,0,0,0,0,1.0,1,1.0,1,1.0,1,0.5412616160564387,33
2280,1,5832,5832,0,0,0,0,1.0,1,1.0,1,1.0,1,0.5267671826760132,35
2281,0,5832,5832,0,0,0,0,1.0,1,1.0,1,1.0,1,0.534763268283851,36
2282,4,5836,5836,0,0,0,0,1.0,1,1.0,1,1.0,1,0.5494457403880773,36
2283,1,5837,5837,0,0,0,0,1.0,1,1.0,1,1.0,1,0.5688902342867243,36
2284,1,5838,5838,0,0,0,0,1.0,1,1.0,1,1.0,1,0.5662684430223828,36
2285,6,5844,5844,0,0,0,0,1.0,1,1.0,1,1.0,1,0.6113512165337404,37
2286,1,5845,5845,0,0,0,0,1.0,1,1.0,1,1.0,1,0.5847613209369138,38
2287,1,5846,5846,0,0,0,0,1.0,1,1.0,1,1.0,1,0.5798212960259769,38
2288,0,5846,5846,0,0,0,0,1.0,1,1.0,1,1.0,1,0.5656978529898431,40
2289,0,5846,5846,0,0,0,0,1.0,1,1.0,1,1.0,1,0.5951000497258021,40
2290,0,5846,5846,0,0,0,0,1.0,1,1.0,1,1.0,1,0.6102815065023532,39
2291,1,5847,5847,0,0,0,0,1.0,1,1.0,1,1.0,1,0.5852741258047232,37
2292,0,5847,5847,0,0,0,0,1.0,1,1.0,1,1.0,1,0.6041434617818359,35
2293,0,5847,5847,0,0,0,0,1.0,1,1.0,1,1.0,1,0.6044928687111507,35
2294,1,5848,5848,0,0,0,0,1.0,1,1.0,1,1.0,1,0.5379164818013429,35
2295,0,5848,5848,0,0,0,0,1.0,1,1.0,1,1.0,1,0.5373917399098207,36
2296,1,5849,5849,0,0,0,0,1.0,1,1.0,1,1.0,1,0.5521927310633715,34
2297,0,5849,5849,0,0,0,0,1.0,1,1.0,1,1.0,1,0.5561938787645536,35
2298,1,5850,5850,0,0,0,0,1.0,1,1.0,1,1.0,1,0.5664356790184882,34
2299,1,5851,5851,0,0,0,0,1.0,1,1.0,1,1.0,1,0.5584426605815895,35
2300,2,5853,5853,0,0,0,0,1.0,1,1.0,1,1.0,1,0.6043474434001928,35
2301,2,5855,5855,0,0,0,0,1.0,1,1.0,1,1.0,1,0.6075275420644034,35
2302,2,5857,5857,0,0,0,0,1.0,1,1.0,1,1.0,1,0.622965102692223,37
2303,1,5858,5858,0,0,0,0,1.0,1,1.0,1,1.0,1,0.6005236628907725,35
2304,0,5858,5858,0,0,0,0,1.0,1,1.0,1,1.0,1,0.6107648766219244,36
2305,1,5859,5859,0,0,0,0,1.0,1,1.0,1,1.0,1,0.5964834338253215,34
2306,0,5859,5859,0,0,0,0,1.0,1,1.0,1,1.0,1,0.5965949684217842,35
2307,2,5861,5861,0,0,0,0,1.0,1,1.0,1,1.0,1,0.5754849806828792,35
2308,0,5861,5861,0,0,0,0,1.0,1,1.0,1,1.0,1,0.5754849806828792,35
2309,5,5866,5866,0,0,0,0,1.0,1,1.0,1,1.0,1,0.575309613976891,34
2310,2,5868,5868,0,0,0,0,1.0,1,1.0,1,1.0,1,0.5477246782007872,36
2311,2,5870,5870,0,0,0,0,1.0,1,1.0,1,1.0,1,0.5559799532072947,38
2312,4,5874,5874,0,0,0,0,1.0,1,1.0,1,1.0,1,0.5381156171778465,39
2313,8,5882,5882,0,0,0,0,1.0,1,1.0,1,1.0,1,0.6091282593709999,39
2314,4,5886,5886,0,0,0,0,1.0,1,1.0,1,1.0,1,0.602305286485869,39
2315,7,5893,5893,0,0,0,0,1.0,1,1.0,1,1.0,1,0.6185028004196663,40
2316,2,5895,5895,0,0,0,0,1.0,1,1.0,1,1.0,1,0.5890430316825659,40
2317,5,5900,5900,0,0,0,0,1.0,1,1.0,1,1.0,1,0.5673729589868962,41
2318,4,5904,5904,0,0,0,0,1.0,1,1.0,1,1.0,1,0.6419183779621274,41
2319,4,5908,5908,0,0,0,0,1.0,1,1.0,1,1.0,1,0.6036059252227504,41
2320,2,5910,5910,0,0,0,0,1.0,1,1.0,1,1.0,1,0.5973750680429244,42
2321,0,5910,5910,0,0,0,0,1.0,1,1.0,1,1.0,1,0.5819755889883262,43
2322,1,5911,5911,0,0,0,0,1.0,1,1.0,1,1.0,1,0.586686320235653,42
2323,0,5911,5911,0,0,0,0,1.0,1,1.0,1,1.0,1,0.5888349768647151,43
2324,1,5912,5912,0,0,0,0,1.0,1,1.0,1,1.0,1,0.5907529551626184,44
2325,1,5913,5913,0,0,0,0,1.0,1,1.0,1,1.0,1,0.6071729491414987,44
2326,2,5915,5915,0,0,0,0,1.0,1,1.0,1,1.0,1,0.5925033321813833,45
2327,2,5917,5917,0,0,0,0,1.0,1,1.0,1,1.0,1,0.5804255272062151,45
2328,4,5921,5921,0,0,0,0,1.0,1,1.0,1,1.0,1,0.5954387996202469,46
2329,2,5923,5923,0,0,0,0,1.0,1,1.0,1,1.0,1,0.589071512204827,45
2330,5,5928,5928,0,0,0,0,1.0,1,1.0,1,1.0,1,0.6182652536415143,47
2331,1,5929,5929,0,0,0,0,1.0,1,1.0,1,1.0,1,0.6164923112512796,48
2332,2,5931,5931,0,0,0,0,1.0,1,1.0,1,1.0,1,0.6078185052716278,48
2333,1,5932,5932,0,0,0,0,1.0,1,1.0,1,1.0,1,0.6162464752501068,49
2334,3,5935,5935,0,0,0,0,1.0,1,1.0,1,1.0,1,0.6362340012130743,47
2335,1,5936,5936,0,0,0,0,1.0,1,1.0,1,1.0,1,0.6304524684463619,46
2336,1,5937,5937,0,0,0,0,1.0,1,1.0,1,1.0,1,0.6513497361558354,46
2337,2,5939,5939,0,0,0,0,1.0,1,1.0,1,1.0,1,0.6552519716276303,45
2338,2,5941,5941,0,0,0,0,1.0,1,1.0,1,1.0,1,0.6278516102561015,44
2339,4,5945,5945,0,0,0,0,1.0,1,1.0,1,1.0,1,0.6176418373841465,45
2340,2,5947,5947,0,0,0,0,1.0,1,1.0,1,1.0,1,0.6373180492676975,44
2341,2,5949,5949,0,0,0,0,1.0,1,1.0,1,1.0,1,0.6046932831122291,45
2342,1,5950,5950,0,0,0,0,1.0,1,1.0,1,1.0,1,0.5998172413657133,47
2343,0,5950,5950,0,0,0,0,1.0,1,1.0,1,1.0,1,0.6121917920248621,46
2344,1,5951,5951,0,0,0,0,1.0,1,1.0,1,1.0,1,0.6330532240461467,46
2345,1,5952,5952,0,0,0,0,1.0,1,1.0,1,1.0,1,0.6621236502558094,45
2346,2,5954,5954,0,0,0,0,1.0,1,1.0,1,1.0,1,0.6507450047566854,46
2347,0,5954,5954,0,0,0,0,1.0,1,1.0,1,1.0,1,0.6511301926501876,47
2348,2,5956,5956,0,0,0,0,1.0,1,1.0,1,1.0,1,0.6531304536175331,49
2349,0,5956,5956,0,0,0,0,1.0,1,1.0,1,1.0,1,0.6531304536175331,49
2350,2,5958,5958,0,0,0,0,1.0,1,1.0,1,1.0,1,0.6269993553046248,50
2351,0,5958,5958,0,0,0,0,1.0,1,1.0,1,1.0,1,0.6269993553046248,50
2352,1,5959,5959,0,0,0,0,1.0,1,1.0,1,1.0,1,0.6179618706363385,51
2353,2,5961,5961,0,0,0,0,1.0,1,1.0,1,1.0,1,0.6033911871732999,51
2354,2,5963,5963,0,0,0,0,1.0,1,1.0,1,1.0,1,0.5676156160464461,51
2355,1,5964,5964,0,0,0,0,1.0,1,1.0,1,1.0,1,0.5661425811956834,50
2356,4,5968,5968,0,0,0,0,1.0,1,1.0,1,1.0,1,0.562970900593304,50
2357,3,5971,5971,0,0,0,0,1.0,1,1.0,1,1.0,1,0.5713952325409689,49
2358,3,5974,5974,0,0,0,0,1.0,1,1.0,1,1.0,1,0.5336562984398319,51
2359,6,5980,5980,0,0,0,0,1.0,1,1.0,1,1.0,1,0.5558692957641345,51
2360,5,5985,5985,0,0,0,0,1.0,1,1.0,1,1.0,1,0.5282122855766735,51
2361,5,5990,5990,0,0,0,0,1.0,1,1.0,1,1.0,1,0.5465526353091799,52
2362,6,5996,5996,0,0,0,0,1.0,1,1.0,1,1.0,1,0.5217117138581139,53
2363,5,6001,6001,0,0,0,0,1.0,1,1.0,1,1.0,1,0.5405013206641399,54
2364,8,6009,6009,0,0,0,0,1.0,1,1.0,1,1.0,1,0.5614615094012771,55
2365,5,6014,6014,0,0,0,0,1.0,1,1.0,1,1.0,1,0.5652102043155652,53
2366,7,6021,6021,0,0,0,0,1.0,1,1.0,1,1.0,1,0.555175709447676,53
2367,4,6025,6025,0,0,0,0,1.0,1,1.0,1,1.0,1,0.5711455097284993,51
2368,5,6030,6030,0,0,0,0,1.0,1,1.0,1,1.0,1,0.5783860812335042,50
2369,3,6033,6033,0,0,0,0,1.0,1,1.0,1,1.0,1,0.6191606880145453,47
2370,2,6035,6035,0,0,0,0,1.0,1,1.0,1,1.0,1,0.6017471492027487,48
2371,1,6036,6036,0,0,0,0,1.0,1,1.0,1,1.0,1,0.5529463908261261,49
2372,2,6038,6038,0,0,0,0,1.0,1,1.0,1,1.0,1,0.5518957922659797,48
2373,0,6038,6038,0,0,0,0,1.0,1,1.0,1,1.0,1,0.5418960466498323,49
2374,0,6038,6038,0,0,0,0,1.0,1,1.0,1,1.0,1,0.5401738660777856,50
2375,2,6040,6040,0,0,0,0,1.0,1,1.0,1,1.0,1,0.5806681610469974,50
2376,0,6040,6040,0,0,0,0,1.0,1,1.0,1,1.0,1,0.5716143255338074,50
2377,1,6041,6041,0,0,0,0,1.0,1,1.0,1,1.0,1,0.600367392954984,49
2378,4,6045,6045,0,0,0,0,1.0,1,1.0,1,1.0,1,0.6214907347049838,49
2379,4,6049,6049,0,0,0,0,1.0,1,1.0,1,1.0,1,0.5536158109863302,50
2380,3,6052,6052,0,0,0,0,1.0,1,1.0,1,1.0,1,0.521164704529775,50
2381,4,6056,6056,0,0,0,0,1.0,1,1.0,1,1.0,1,0.501282684398374,51
2382,2,6058,6058,0,0,0,0,1.0,1,1.0,1,1.0,1,0.5099740483328544,51
2383,1,6059,6059,0,0,0,0,1.0,1,1.0,1,1.0,1,0.5309307658565547,52
2384,2,6061,6061,0,0,0,0,1.0,1,1.0,1,1.0,1,0.5279671664777328,52
2385,1,6062,6062,0,0,0,0,1.0,1,1.0,1,1.0,1,0.551148229318983,51
2386,6,6068,6068,0,0,0,0,1.0,1,1.0,1,1.0,1,0.5627498556661682,52
2387,2,6070,6070,0,0,0,0,1.0,1,1.0,1,1.0,1,0.5766407589203336,49
2388,6,6076,6076,0,0,0,0,1.0,1,1.0,1,1.0,1,0.6254113567412075,48
2389,5,6081,6081,0,0,0,0,1.0,1,1.0,1,1.0,1,0.649808286769894,48
2390,7,6088,6088,0,0,0,0,1.0,1,1.0,1,1.0,1,0.6431655995563833,49
2391,6,6094,6094,0,0,0,0,1.0,1,1.0,1,1.0,1,0.616154060024523,48
2392,2,6096,6096,0,0,0,0,1.0,1,1.0,1,1.0,1,0.5902671619850033,49
2393,3,6099,6099,0,0,0,0,1.0,1,1.0,1,1.0,1,0.558504209217542,50
2394,4,6103,6103,0,0,0,0,1.0,1,1.0,1,1.0,1,0.5482355437663585,50
2395,4,6107,6107,0,0,0,0,1.0,1,1.0,1,1.0,1,0.5724143830750141,49
2396,5,6112,6112,0,0,0,0,1.0,1,1.0,1,1.0,1,0.5470440867181885,50
2397,3,6115,6115,0,0,0,0,1.0,1,1.0,1,1.0,1,0.5409697817695839,51
2398,1,6116,6116,0,0,0,0,1.0,1,1.0,1,1.0,1,0.5592616328153763,49
2399,1,6117,6117,0,0,0,0,1.0,1,1.0,1,1.0,1,0.5533757952154802,50
2400,3,6120,6120,0,0,0,0,1.0,1,1.0,1,1.0,1,0.5729495207707007,51
2401,0,6120,6120,0,0,0,0,1.0,1,1.0,1,1.0,1,0.5773103406015694,50
2402,1,6121,6121,0,0,0,0,1.0,1,1.0,1,1.0,1,0.5741343452676617,51
2403,0,6121,6121,0,0,0,0,1.0,1,1.0,1,1.0,1,0.5628170265042944,52
2404,0,6121,6121,0,0,0,0,1.0,1,1.0,1,1.0,1,0.5701694086305023,53
2405,3,6124,6124,0,0,0,0,1.0,1,1.0,1,1.0,1,0.5400801450945932,52
2406,2,6126,6126,0,0,0,0,1.0,1,1.0,1,1.0,1,0.5653624818316029,52
2407,1,6127,6127,0,0,0,0,1.0,1,1.0,1,1.0,1,0.5450104195402424,51
2408,2,6129,6129,0,0,0,0,1.0,1,1.0,1,1.0,1,0.547904385938885,50
2409,2,6131,6131,0,0,0,0,1.0,1,1.0,1,1.0,1,0.5184626373363439,50
2410,3,6134,6134,0,0,0,0,1.0,1,1.0,1,1.0,1,0.5122556408502806,49
2411,1,6135,6135,0,0,0,0,1.0,1,1.0,1,1.0,1,0.5295314751628735,48
2412,2,6137,6137,0,0,0,0,1.0,1,1.0,1,1.0,1,0.5188093955989953,47
2413,0,6137,6137,0,0,0,0,1.0,1,1.0,1,1.0,1,0.5144751037544689,47
2414,1,6138,6138,0,0,0,0,1.0,1,1.0,1,1.0,1,0.4940705829123042,47
2415,2,6140,6140,0,0,0,0,1.0,1,1.0,1,1.0,1,0.5397763748737294,46
2416,1,6141,6141,0,0,0,0,1.0,1,1.0,1,1.0,1,0.5308403874880862,47
2417,2,6143,6143,0,0,0,0,1.0,1,1.0,1,1.0,1,0.579949191455961,46
2418,3,6146,6146,0,0,0,0,1.0,1,1.0,1,1.0,1,0.571953602571707,48
2419,4,6150,6150,0,0,0,0,1.0,1,1.0,1,1.0,1,0.551376014869137,47
2420,4,6154,6154,0,0,0,0,1.0,1,1.0,1,1.0,1,0.5292767059100596,49
2421,4,6158,6158,0,0,0,0,1.0,1,1.0,1,1.0,1,0.5164766360036016,50
2422,4,6162,6162,0,0,0,0,1.0,1,1.0,1,1.0,1,0.5247654620389552,50
2423,6,6168,6168,0,0,0,0,1.0,1,1.0,1,1.0,1,0.47849790446515156,51
2424,4,6172,6172,0,0,0,0,1.0,1,1.0,1,1.0,1,0.5078834701380651,50
2425,4,6176,6176,0,0,0,0,1.0,1,1.0,1,1.0,1,0.5275314965986732,48
2426,1,6177,6177,0,0,0,0,1.0,1,1.0,1,1.0,1,0.5349255640842241,51
2427,4,6181,6181,0,0,0,0,1.0,1,1.0,1,1.0,1,0.5841848135227067,50
2428,2,6183,6183,0,0,0,0,1.0,1,1.0,1,1.0,1,0.6094932599493599,49
2429,2,6185,6185,0,0,0,0,1.0,1,1.0,1,1.0,1,0.6239177908995636,49
2430,0,6185,6185,0,0,0,0,1.0,1,1.0,1,1.0,1,0.646565191914526,46
2431,2,6187,6187,0,0,0,0,1.0,1,1.0,1,1.0,1,0.644225121677857,45
2432,1,6188,6188,0,0,0,0,1.0,1,1.0,1,1.0,1,0.6742806261354456,44
2433,3,6191,6191,0,0,0,0,1.0,1,1.0,1,1.0,1,0.6201644767802688,45
2434,3,6194,6194,0,0,0,0,1.0,1,1.0,1,1.0,1,0.625753470480896,44
2435,5,6199,6199,0,0,0,0,1.0,1,1.0,1,1.0,1,0.5585369117030499,44
2436,1,6200,6200,0,0,0,0,1.0,1,1.0,1,1.0,1,0.5666293345725275,44
2437,9,6209,6209,0,0,0,0,1.0,1,1.0,1,1.0,1,0.5243702373177409,45
2438,5,6214,6214,0,0,0,0,1.0,1,1.0,1,1.0,1,0.5308491063908094,45
2439,3,6217,6217,0,0,0,0,1.0,1,1.0,1,1.0,1,0.5484055905681995,46
2440,4,6221,6221,0,0,0,0,1.0,1,1.0,1,1.0,1,0.5686292151669596,45
2441,1,6222,6222,0,0,0,0,1.0,1,1.0,1,1.0,1,0.5757985602912963,45
2442,4,6226,6226,0,0,0,0,1.0,1,1.0,1,1.0,1,0.5812344467404212,46
2443,0,6226,6226,0,0,0,0,1.0,1,1.0,1,1.0,1,0.5900530130394472,45
2444,2,6228,6228,0,0,0,0,1.0,1,1.0,1,1.0,1,0.5787408376199737,46
2445,2,6230,6230,0,0,0,0,1.0,1,1.0,1,1.0,1,0.6175823748466522,44
2446,4,6234,6234,0,0,0,0,1.0,1,1.0,1,1.0,1,0.5968553035366377,44
2447,1,6235,6235,0,0,0,0,1.0,1,1.0,1,1.0,1,0.6013879590364841,42
2448,3,6238,6238,0,0,0,0,1.0,1,1.0,1,1.0,1,0.6071738781809916,41
2449,1,6239,6239,0,0,0,0,1.0,1,1.0,1,1.0,1,0.6155334502564251,40
2450,4,6243,6243,0,0,0,0,1.0,1,1.0,1,1.0,1,0.6378222382054864,42
2451,5,6248,6248,0,0,0,0,1.0,1,1.0,1,1.0,1,0.5702895653112274,43
2452,2,6250,6250,0,0,0,0,1.0,1,1.0,1,1.0,1,0.5785845036178313,43
2453,2,6252,6252,0,0,0,0,1.0,1,1.0,1,1.0,1,0.5920525272589447,45
2454,2,6254,6254,0,0,0,0,1.0,1,1.0,1,1.0,1,0.5824425453846686,47
2455,1,6255,6255,0,0,0,0,1.0,1,1.0,1,1.0,1,0.5752460796861822,48
2456,2,6257,6257,0,0,0,0,1.0,1,1.0,1,1.0,1,0.581329574350845,49
2457,0,6257,6257,0,0,0,0,1.0,1,1.0,1,1.0,1,0.576683459602731,48
2458,2,6259,6259,0,0,0,0,1.0,1,1.0,1,1.0,1,0.5604791960960822,49
2459,3,6262,6262,0,0,0,0,1.0,1,1.0,1,1.0,1,0.5390346170149836,49
2460,4,6266,6266,0,0,0,0,1.0,1,1.0,1,1.0,1,0.49679666969754804,50
2461,4,6270,6270,0,0,0,0,1.0,1,1.0,1,1.0,1,0.4726123992999533,50
2462,8,6278,6278,0,0,0,0,1.0,1,1.0,1,1.0,1,0.5098974912066482,51
2463,7,6285,6285,0,0,0,0,1.0,1,1.0,1,1.0,1,0.5062929820533894,51
2464,7,6292,6292,0,0,0,0,1.0,1,1.0,1,1.0,1,0.5296676598798801,50
2465,3,6295,6295,0,0,0,0,1.0,1,1.0,1,1.0,1,0.5222972836702864,49
2466,5,6300,6300,0,0,0,0,1.0,1,1.0,1,1.0,1,0.5140100785885976,49
2467,2,6302,6302,0,0,0,0,1.0,1,1.0,1,1.0,1,0.5225454471860193,48
2468,4,6306,6306,0,0,0,0,1.0,1,1.0,1,1.0,1,0.5779161876043214,47
2469,2,6308,6308,0,0,0,0,1.0,1,1.0,1,1.0,1,0.5989799131320573,46
2470,0,6308,6308,0,0,0,0,1.0,1,1.0,1,1.0,1,0.6167927171704006,44
2471,2,6310,6310,0,0,0,0,1.0,1,1.0,1,1.0,1,0.6406563922597612,44
2472,1,6311,6311,0,0,0,0,1.0,1,1.0,1,1.0,1,0.6500418912106631,44
2473,1,6312,6312,0,0,0,0,1.0,1,1.0,1,1.0,1,0.6546471324516282,43
2474,3,6315,6315,0,0,0,0,1.0,1,1.0,1,1.0,1,0.6343382920733885,44
2475,4,6319,6319,0,0,0,0,1.0,1,1.0,1,1.0,1,0.5636207974729386,46
2476,2,6321,6321,0,0,0,0,1.0,1,1.0,1,1.0,1,0.5664191931166498,46
2477,0,6321,6321,0,0,0,0,1.0,1,1.0,1,1.0,1,0.5664191931166498,46
2478,4,6325,6325,0,0,0,0,1.0,1,1.0,1,1.0,1,0.5986709637159748,46
2479,0,6325,6325,0,0,0,0,1.0,1,1.0,1,1.0,1,0.5986709637159748,46
2480,2,6327,6327,0,0,0,0,1.0,1,1.0,1,1.0,1,0.5904268836344505,47
2481,1,6328,6328,0,0,0,0,1.0,1,1.0,1,1.0,1,0.5913348904941447,47
2482,3,6331,6331,0,0,0,0,1.0,1,1.0,1,1.0,1,0.5980800334107402,45
2483,1,6332,6332,0,0,0,0,1.0,1,1.0,1,1.0,1,0.5912126897582982,45
2484,1,6333,6333,0,0,0,0,1.0,1,1.0,1,1.0,1,0.5866249395534282,46
2485,2,6335,6335,0,0,0,0,1.0,1,1.0,1,1.0,1,0.5730406704921303,44
2486,3,6338,6338,0,0,0,0,1.0,1,1.0,1,1.0,1,0.5456801530787395,43
2487,2,6340,6340,0,0,0,0,1.0,1,1.0,1,1.0,1,0.532956178072066,44
2488,5,6345,6345,0,0,0,0,1.0,1,1.0,1,1.0,1,0.5061871612174178,45
2489,1,6346,6346,0,0,0,0,1.0,1,1.0,1,1.0,1,0.5120891161059342,44
2490,4,6350,6350,0,0,0,0,1.0,1,1.0,1,1.0,1,0.5045701216374673,44
2491,2,6352,6352,0,0,0,0,1.0,1,1.0,1,1.0,1,0.5101706403505365,44
2492,4,6356,6356,0,0,0,0,1.0,1,1.0,1,1.0,1,0.5025247175013263,44
2493,4,6360,6360,0,0,0,0,1.0,1,1.0,1,1.0,1,0.53571305522357,42
2494,1,6361,6361,0,0,0,0,1.0,1,1.0,1,1.0,1,0.5399812150407263,42
2495,2,6363,6363,0,0,0,0,1.0,1,1.0,1,1.0,1,0.542214192995096,42
2496,2,6365,6365,0,0,0,0,1.0,1,1.0,1,1.0,1,0.5539109102597267,42
2497,1,6366,6366,0,0,0,0,1.0,1,1.0,1,1.0,1,0.538186302385741,44
2498,1,6367,6367,0,0,0,0,1.0,1,1.0,1,1.0,1,0.5763168456169979,43
2499,4,6371,6371,0,0,0,0,1.0,1,1.0,1,1.0,1,0.6029053097359083,43
2500,3,6374,6374,0,0,0,0,1.0,1,1.0,1,1.0,1,0.5394866427031288,44
2501,4,6378,6378,0,0,0,0,1.0,1,1.0,1,1.0,1,0.5750124005088484,46
2502,5,6383,6383,0,0,0,0,1.0,1,1.0,1,1.0,1,0.5592690839779814,47
2503,2,6385,6385,0,0,0,0,1.0,1,1.0,1,1.0,1,0.543242946041987,47
2504,4,6389,6389,0,0,0,0,1.0,1,1.0,1,1.0,1,0.5068970453932264,46
2505,5,6394,6394,0,0,0,0,1.0,1,1.0,1,1.0,1,0.5249848707571377,46
2506,2,6396,6396,0,0,0,0,1.0,1,1.0,1,1.0,1,0.529059353273422,45
2507,4,6400,6400,0,0,0,0,1.0,1,1.0,1,1.0,1,0.5611170705699707,45
2508,1,6401,6401,0,0,0,0,1.0,1,1.0,1,1.0,1,0.5683269051052234,46
2509,3,6404,6404,0,0,0,0,1.0,1,1.0,1,1.0,1,0.5870184757136816,45
2510,3,6407,6407,0,0,0,0,1.0,1,1.0,1,1.0,1,0.598959994178581,46
2511,1,6408,6408,0,0,0,0,1.0,1,1.0,1,1.0,1,0.6068465797832008,47
2512,2,6410,6410,0,0,0,0,1.0,1,1.0,1,1.0,1,0.5943571223021646,47
2513,4,6414,6414,0,0,0,0,1.0,1,1.0,1,1.0,1,0.5731247725276213,48
2514,3,6417,6417,0,0,0,0,1.0,1,1.0,1,1.0,1,0.5529280785990563,48
2515,2,6419,6419,0,0,0,0,1.0,1,1.0,1,1.0,1,0.5541679743483334,49
2516,5,6424,6424,0,0,0,0,1.0,1,1.0,1,1.0,1,0.5224430218965745,49
2517,2,6426,6426,0,0,0,0,1.0,1,1.0,1,1.0,1,0.5191143538513145,49
2518,1,6427,6427,0,0,0,0,1.0,1,1.0,1,1.0,1,0.5372790945732417,48
2519,2,6429,6429,0,0,0,0,1.0,1,1.0,1,1.0,1,0.527501436123337,48
2520,0,6429,6429,0,0,0,0,1.0,1,1.0,1,1.0,1,0.5201878311899297,46
2521,0,6429,6429,0,0,0,0,1.0,1,1.0,1,1.0,1,0.509501251597489,47
2522,2,6431,6431,0,0,0,0,1.0,1,1.0,1,1.0,1,0.5152645959955063,45
2523,3,6434,6434,0,0,0,0,1.0,1,1.0,1,1.0,1,0.4772800638002358,44
2524,1,6435,6435,0,0,0,0,1.0,1,1.0,1,1.0,1,0.44037764376081445,42
2525,1,6436,6436,0,0,0,0,1.0,1,1.0,1,1.0,1,0.4471394348108247,42
2526,0,6436,6436,0,0,0,0,1.0,1,1.0,1,1.0,1,0.43949758779049947,41
2527,2,6438,6438,0,0,0,0,1.0,1,1.0,1,1.0,1,0.43858041502372186,41
2528,0,6438,6438,0,0,0,0,1.0,1,1.0,1,1.0,1,0.470980653113032,41
2529,0,6438,6438,0,0,0,0,1.0,1,1.0,1,1.0,1,0.46637847616051736,42
2530,2,6440,6440,0,0,0,0,1.0,1,1.0,1,1.0,1,0.46603302483476433,41
2531,1,6441,6441,0,0,0,0,1.0,1,1.0,1,1.0,1,0.4835454446521601,41
2532,2,6443,6443,0,0,0,0,1.0,1,1.0,1,1.0,1,0.5351748704226145,43
2533,0,6443,6443,0,0,0,0,1.0,1,1.0,1,1.0,1,0.5351748704226145,43
2534,1,6444,6444,0,0,0,0,1.0,1,1.0,1,1.0,1,0.5389027456442953,43
2535,2,6446,6446,0,0,0,0,1.0,1,1.0,1,1.0,1,0.5143051288051931,44
2536,2,6448,6448,0,0,0,0,1.0,1,1.0,1,1.0,1,0.5190003376327998,44
2537,2,6450,6450,0,0,0,0,1.0,1,1.0,1,1.0,1,0.5120465218804502,45
2538,4,6454,6454,0,0,0,0,1.0,1,1.0,1,1.0,1,0.5149910787813827,48
2539,5,6459,6459,0,0,0,0,1.0,1,1.0,1,1.0,1,0.5187871693523856,48
2540,5,6464,6464,0,0,0,0,1.0,1,1.0,1,1.0,1,0.5567201066466926,50
2541,9,6473,6473,0,0,0,0,1.0,1,1.0,1,1.0,1,0.4915835072512421,52
2542,3,6476,6476,0,0,0,0,1.0,1,1.0,1,1.0,1,0.48776759047607793,52
2543,5,6481,6481,0,0,0,0,1.0,1,1.0,1,1.0,1,0.4683223964906104,51
2544,3,6484,6484,0,0,0,0,1.0,1,1.0,1,1.0,1,0.5045890519891472,51
2545,4,6488,6488,0,0,0,0,1.0,1,1.0,1,1.0,1,0.5277904525240388,50
2546,4,6492,6492,0,0,0,0,1.0,1,1.0,1,1.0,1,0.540821512954078,50
2547,0,6492,6492,0,0,0,0,1.0,1,1.0,1,1.0,1,0.5451095067321329,47
2548,3,6495,6495,0,0,0,0,1.0,1,1.0,1,1.0,1,0.5226826382751545,46
2549,0,6495,6495,0,0,0,0,1.0,1,1.0,1,1.0,1,0.5309841915813789,46
2550,2,6497,6497,0,0,0,0,1.0,1,1.0,1,1.0,1,0.5346634431519363,44
2551,2,6499,6499,0,0,0,0,1.0,1,1.0,1,1.0,1,0.5378433485510793,43
2552,2,6501,6501,0,0,0,0,1.0,1,1.0,1,1.0,1,0.5599744269343677,43
2553,3,6504,6504,0,0,0,0,1.0,1,1.0,1,1.0,1,0.5787734183588764,44
2554,1,6505,6505,0,0,0,0,1.0,1,1.0,1,1.0,1,0.5573030161998127,45
2555,2,6507,6507,0,0,0,0,1.0,1,1.0,1,1.0,1,0.5596519979600858,44
2556,1,6508,6508,0,0,0,0,1.0,1,1.0,1,1.0,1,0.5504336603116263,44
2557,2,6510,6510,0,0,0,0,1.0,1,1.0,1,1.0,1,0.5372303523088613,41
2558,0,6510,6510,0,0,0,0,1.0,1,1.0,1,1.0,1,0.5124301668639692,40
2559,0,6510,6510,0,0,0,0,1.0,1,1.0,1,1.0,1,0.5034991224296379,41
2560,1,6511,6511,0,0,0,0,1.0,1,1.0,1,1.0,1,0.4989239376508007,41
2561,4,6515,6515,0,0,0,0,1.0,1,1.0,1,1.0,1,0.5300041887094512,43
2562,4,6519,6519,0,0,0,0,1.0,1,1.0,1,1.0,1,0.5609257928575755,44
2563,3,6522,6522,0,0,0,0,1.0,1,1.0,1,1.0,1,0.577864062224029,44
2564,4,6526,6526,0,0,0,0,1.0,1,1.0,1,1.0,1,0.574542931496645,44
2565,4,6530,6530,0,0,0,0,1.0,1,1.0,1,1.0,1,0.5874716319387501,45
2566,1,6531,6531,0,0,0,0,1.0,1,1.0,1,1.0,1,0.5913235747836135,46
2567,4,6535,6535,0,0,0,0,1.0,1,1.0,1,1.0,1,0.5564855344695875,48
2568,3,6538,6538,0,0,0,0,1.0,1,1.0,1,1.0,1,0.5604847025093216,48
2569,2,6540,6540,0,0,0,0,1.0,1,1.0,1,1.0,1,0.546953453344274,49
2570,0,6540,6540,0,0,0,0,1.0,1,1.0,1,1.0,1,0.5485901980816289,48
2571,1,6541,6541,0,0,0,0,1.0,1,1.0,1,1.0,1,0.5306571068077388,48
2572,0,6541,6541,0,0,0,0,1.0,1,1.0,1,1.0,1,0.5130225784205203,49
2573,1,6542,6542,0,0,0,0,1.0,1,1.0,1,1.0,1,0.4950387087790063,50
2574,0,6542,6542,0,0,0,0,1.0,1,1.0,1,1.0,1,0.49279874443749466,49
2575,1,6543,6543,0,0,0,0,1.0,1,1.0,1,1.0,1,0.4875315477400307,48
2576,1,6544,6544,0,0,0,0,1.0,1,1.0,1,1.0,1,0.47221789845843287,48
2577,0,6544,6544,0,0,0,0,1.0,1,1.0,1,1.0,1,0.49655807876038416,50
2578,2,6546,6546,0,0,0,0,1.0,1,1.0,1,1.0,1,0.5255926529774133,50
2579,5,6551,6551,0,0,0,0,1.0,1,1.0,1,1.0,1,0.49214525211255045,51
2580,2,6553,6553,0,0,0,0,1.0,1,1.0,1,1.0,1,0.535820651496369,52
2581,4,6557,6557,0,0,0,0,1.0,1,1.0,1,1.0,1,0.5364194353784288,51
2582,5,6562,6562,0,0,0,0,1.0,1,1.0,1,1.0,1,0.5822548694663131,51
2583,4,6566,6566,0,0,0,0,1.0,1,1.0,1,1.0,1,0.5887966807206988,51
2584,7,6573,6573,0,0,0,0,1.0,1,1.0,1,1.0,1,0.58804281924059,51
2585,6,6579,6579,0,0,0,0,1.0,1,1.0,1,1.0,1,0.5546668524172066,50
2586,6,6585,6585,0,0,0,0,1.0,1,1.0,1,1.0,1,0.5507904267976784,50
2587,1,6586,6586,0,0,0,0,1.0,1,1.0,1,1.0,1,0.5561813314223036,48
2588,4,6590,6590,0,0,0,0,1.0,1,1.0,1,1.0,1,0.5108271199403189,50
2589,2,6592,6592,0,0,0,0,1.0,1,1.0,1,1.0,1,0.5040430651378658,48
2590,6,6598,6598,0,0,0,0,1.0,1,1.0,1,1.0,1,0.5213469880299382,47
2591,3,6601,6601,0,0,0,0,1.0,1,1.0,1,1.0,1,0.5450309497525402,47
2592,6,6607,6607,0,0,0,0,1.0,1,1.0,1,1.0,1,0.6296362081218942,47
2593,2,6609,6609,0,0,0,0,1.0,1,1.0,1,1.0,1,0.6148412839545372,47
2594,2,6611,6611,0,0,0,0,1.0,1,1.0,1,1.0,1,0.597056650215345,49
2595,4,6615,6615,0,0,0,0,1.0,1,1.0,1,1.0,1,0.5944397111822949,48
2596,1,6616,6616,0,0,0,0,1.0,1,1.0,1,1.0,1,0.5870079566211115,47
2597,3,6619,6619,0,0,0,0,1.0,1,1.0,1,1.0,1,0.575668263082487,48
2598,1,6620,6620,0,0,0,0,1.0,1,1.0,1,1.0,1,0.5647296083944828,48
2599,4,6624,6624,0,0,0,0,1.0,1,1.0,1,1.0,1,0.5098772216532933,49
2600,0,6624,6624,0,0,0,0,1.0,1,1.0,1,1.0,1,0.5037591002985883,52
2601,3,6627,6627,0,0,0,0,1.0,1,1.0,1,1.0,1,0.501128556050159,51
2602,1,6628,6628,0,0,0,0,1.0,1,1.0,1,1.0,1,0.5048958773532958,52
2603,3,6631,6631,0,0,0,0,1.0,1,1.0,1,1.0,1,0.4761549219552992,53
2604,1,6632,6632,0,0,0,0,1.0,1,1.0,1,1.0,1,0.48502121936856685,53
2605,0,6632,6632,0,0,0,0,1.0,1,1.0,1,1.0,1,0.48607303620338277,52
2606,3,6635,6635,0,0,0,0,1.0,1,1.0,1,1.0,1,0.5120711930458577,52
2607,3,6638,6638,0,0,0,0,1.0,1,1.0,1,1.0,1,0.5008721790334401,52
2608,4,6642,6642,0,0,0,0,1.0,1,1.0,1,1.0,1,0.5449330777170627,52
2609,3,6645,6645,0,0,0,0,1.0,1,1.0,1,1.0,1,0.5542765226408716,53
2610,5,6650,6650,0,0,0,0,1.0,1,1.0,1,1.0,1,0.5363918772257823,54
2611,5,6655,6655,0,0,0,0,1.0,1,1.0,1,1.0,1,0.4962319193011833,54
2612,3,6658,6658,0,0,0,0,1.0,1,1.0,1,1.0,1,0.5131950572279417,56
2613,3,6661,6661,0,0,0,0,1.0,1,1.0,1,1.0,1,0.523913132071996,56
2614,5,6666,6666,0,0,0,0,1.0,1,1.0,1,1.0,1,0.5564716434451328,56
2615,2,6668,6668,0,0,0,0,1.0,1,1.0,1,1.0,1,0.5502107415802716,57
2616,3,6671,6671,0,0,0,0,1.0,1,1.0,1,1.0,1,0.5490320546228312,57
2617,3,6674,6674,0,0,0,0,1.0,1,1.0,1,1.0,1,0.5490396105324421,58
2618,2,6676,6676,0,0,0,0,1.0,1,1.0,1,1.0,1,0.5402745525355817,58
2619,3,6679,6679,0,0,0,0,1.0,1,1.0,1,1.0,1,0.5257191218494758,58
2620,1,6680,6680,0,0,0,0,1.0,1,1.0,1,1.0,1,0.5144978411310818,60
2621,2,6682,6682,0,0,0,0,1.0,1,1.0,1,1.0,1,0.5327540679662972,59
2622,2,6684,6684,0,0,0,0,1.0,1,1.0,1,1.0,1,0.5338373136715486,60
2623,5,6689,6689,0,0,0,0,1.0,1,1.0,1,1.0,1,0.5317274126853888,59
2624,5,6694,6694,0,0,0,0,1.0,1,1.0,1,1.0,1,0.5613421586158739,58
2625,3,6697,6697,0,0,0,0,1.0,1,1.0,1,1.0,1,0.579687153497588,58
2626,1,6698,6698,0,0,0,0,1.0,1,1.0,1,1.0,1,0.5921107874713133,57
2627,2,6700,6700,0,0,0,0,1.0,1,1.0,1,1.0,1,0.6184288413163254,55
2628,2,6702,6702,0,0,0,0,1.0,1,1.0,1,1.0,1,0.6027386253626384,55
2629,1,6703,6703,0,0,0,0,1.0,1,1.0,1,1.0,1,0.6159612785517667,54
2630,1,6704,6704,0,0,0,0,1.0,1,1.0,1,1.0,1,0.6149411691818613,55
2631,0,6704,6704,0,0,0,0,1.0,1,1.0,1,1.0,1,0.6026168999818906,55
2632,2,6706,6706,0,0,0,0,1.0,1,1.0,1,1.0,1,0.594821422529769,55
2633,4,6710,6710,0,0,0,0,1.0,1,1.0,1,1.0,1,0.5954474990653885,53
2634,3,6713,6713,0,0,0,0,1.0,1,1.0,1,1.0,1,0.5806345559467528,52
2635,6,6719,6719,0,0,0,0,1.0,1,1.0,1,1.0,1,0.6042564403424723,52
2636,7,6726,6726,0,0,0,0,1.0,1,1.0,1,1.0,1,0.6136124966950944,51
2637,6,6732,6732,0,0,0,0,1.0,1,1.0,1,1.0,1,0.6352435198984151,50
2638,8,6740,6740,0,0,0,0,1.0,1,1.0,1,1.0,1,0.5538312926950948,48
2639,6,6746,6746,0,0,0,0,1.0,1,1.0,1,1.0,1,0.5951002858762613,48
2640,4,6750,6750,0,0,0,0,1.0,1,1.0,1,1.0,1,0.5677709843713377,46
2641,4,6754,6754,0,0,0,0,1.0,1,1.0,1,1.0,1,0.5793246599024774,46
2642,4,6758,6758,0,0,0,0,1.0,1,1.0,1,1.0,1,0.547907981056292,47
2643,3,6761,6761,0,0,0,0,1.0,1,1.0,1,1.0,1,0.5575787265170211,45
2644,3,6764,6764,0,0,0,0,1.0,1,1.0,1,1.0,1,0.5719824215393896,44
2645,6,6770,6770,0,0,0,0,1.0,1,1.0,1,1.0,1,0.5274449748848976,42
2646,3,6773,6773,0,0,0,0,1.0,1,1.0,1,1.0,1,0.5430940883543309,43
2647,5,6778,6778,0,0,0,0,1.0,1,1.0,1,1.0,1,0.5513140081970465,40
2648,2,6780,6780,0,0,0,0,1.0,1,1.0,1,1.0,1,0.555617962265197,41
2649,1,6781,6781,0,0,0,0,1.0,1,1.0,1,1.0,1,0.545378428186046,43
2650,1,6782,6782,0,0,0,0,1.0,1,1.0,1,1.0,1,0.5668757087285593,43
2651,3,6785,6785,0,0,0,0,1.0,1,1.0,1,1.0,1,0.5254177866697205,44
2652,1,6786,6786,0,0,0,0,1.0,1,1.0,1,1.0,1,0.529602321435529,44
2653,1,6787,6787,0,0,0,0,1.0,1,1.0,1,1.0,1,0.5236009255763407,44
2654,5,6792,6792,0,0,0,0,1.0,1,1.0,1,1.0,1,0.5307279349077823,45
2655,0,6792,6792,0,0,0,0,1.0,1,1.0,1,1.0,1,0.5307279349077823,45
2656,2,6794,6794,0,0,0,0,1.0,1,1.0,1,1.0,1,0.5445811210800352,45
2657,2,6796,6796,0,0,0,0,1.0,1,1.0,1,1.0,1,0.533368525635227,45
2658,4,6800,6800,0,0,0,0,1.0,1,1.0,1,1.0,1,0.529011170332399,47
2659,5,6805,6805,0,0,0,0,1.0,1,1.0,1,1.0,1,0.5392477905736514,46
2660,9,6814,6814,0,0,0,0,1.0,1,1.0,1,1.0,1,0.526196428228027,46
2661,2,6816,6816,0,0,0,0,1.0,1,1.0,1,1.0,1,0.5318477440173697,46
2662,8,6824,6824,0,0,0,0,1.0,1,1.0,1,1.0,1,0.5339978621111753,47
2663,7,6831,6831,0,0,0,0,1.0,1,1.0,1,1.0,1,0.5432355076376424,46
2664,3,6834,6834,0,0,0,0,1.0,1,1.0,1,1.0,1,0.5431951714004366,45
2665,3,6837,6837,0,0,0,0,1.0,1,1.0,1,1.0,1,0.5484140443526057,47
2666,6,6843,6843,0,0,0,0,1.0,1,1.0,1,1.0,1,0.532193992597043,47
2667,4,6847,6847,0,0,0,0,1.0,1,1.0,1,1.0,1,0.5183381338512354,45
2668,3,6850,6850,0,0,0,0,1.0,1,1.0,1,1.0,1,0.575973213993935,45
2669,3,6853,6853,0,0,0,0,1.0,1,1.0,1,1.0,1,0.5628569115902219,45
2670,4,6857,6857,0,0,0,0,1.0,1,1.0,1,1.0,1,0.5809583181229065,45
2671,3,6860,6860,0,0,0,0,1.0,1,1.0,1,1.0,1,0.602173174107932,41
2672,2,6862,6862,0,0,0,0,1.0,1,1.0,1,1.0,1,0.6321148564233107,40
2673,3,6865,6865,0,0,0,0,1.0,1,1.0,1,1.0,1,0.6421463978407167,39
2674,6,6871,6871,0,0,0,0,1.0,1,1.0,1,1.0,1,0.6341352754208996,37
2675,1,6872,6872,0,0,0,0,1.0,1,1.0,1,1.0,1,0.6190666099245622,35
2676,3,6875,6875,0,0,0,0,1.0,1,1.0,1,1.0,1,0.6265556703542593,34
2677,2,6877,6877,0,0,0,0,1.0,1,1.0,1,1.0,1,0.5806343300251161,32
2678,2,6879,6879,0,0,0,0,1.0,1,1.0,1,1.0,1,0.5768286037871718,33
2679,1,6880,6880,0,0,0,0,1.0,1,1.0,1,1.0,1,0.5729673896700714,33
2680,1,6881,6881,0,0,0,0,1.0,1,1.0,1,1.0,1,0.5797300089018129,33
2681,1,6882,6882,0,0,0,0,1.0,1,1.0,1,1.0,1,0.5341832135277887,32
2682,0,6882,6882,0,0,0,0,1.0,1,1.0,1,1.0,1,0.5341832135277887,32
2683,2,6884,6884,0,0,0,0,1.0,1,1.0,1,1.0,1,0.5178726140298942,32
2684,1,6885,6885,0,0,0,0,1.0,1,1.0,1,1.0,1,0.4968206971250642,31
2685,2,6887,6887,0,0,0,0,1.0,1,1.0,1,1.0,1,0.4984687341577652,30
2686,3,6890,6890,0,0,0,0,1.0,1,1.0,1,1.0,1,0.4656923216175658,29
2687,1,6891,6891,0,0,0,0,1.0,1,1.0,1,1.0,1,0.5031333408159591,28
2688,3,6894,6894,0,0,0,0,1.0,1,1.0,1,1.0,1,0.5530079231073068,28
2689,3,6897,6897,0,0,0,0,1.0,1,1.0,1,1.0,1,0.6150354243253745,29
2690,1,6898,6898,0,0,0,0,1.0,1,1.0,1,1.0,1,0.6389751674925261,29
2691,0,6898,6898,0,0,0,0,1.0,1,1.0,1,1.0,1,0.6389751674925261,29
2692,5,6903,6903,0,0,0,0,1.0,1,1.0,1,1.0,1,0.6286412996253905,31
2693,3,6906,6906,0,0,0,0,1.0,1,1.0,1,1.0,1,0.5447124453994056,32
2694,2,6908,6908,0,0,0,0,1.0,1,1.0,1,1.0,1,0.5147923599391434,32
2695,2,6910,6910,0,0,0,0,1.0,1,1.0,1,1.0,1,0.539842648801697,33
2696,2,6912,6912,0,0,0,0,1.0,1,1.0,1,1.0,1,0.5731561467334956,33
2697,1,6913,6913,0,0,0,0,1.0,1,1.0,1,1.0,1,0.573456837381257,34
2698,0,6913,6913,0,0,0,0,1.0,1,1.0,1,1.0,1,0.573456837381257,34
2699,5,6918,6918,0,0,0,0,1.0,1,1.0,1,1.0,1,0.5327162697236963,36
2700,4,6922,6922,0,0,0,0,1.0,1,1.0,1,1.0,1,0.5596669787288316,36
2701,2,6924,6924,0,0,0,0,1.0,1,1.0,1,1.0,1,0.5721398883054327,36
2702,3,6927,6927,0,0,0,0,1.0,1,1.0,1,1.0,1,0.5783289016771185,36
2703,3,6930,6930,0,0,0,0,1.0,1,1.0,1,1.0,1,0.5732528455316923,38
2704,3,6933,6933,0,0,0,0,1.0,1,1.0,1,1.0,1,0.590073597846991,37
2705,3,6936,6936,0,0,0,0,1.0,1,1.0,1,1.0,1,0.6098191269513276,36
2706,3,6939,6939,0,0,0,0,1.0,1,1.0,1,1.0,1,0.6642428366734889,34
2707,3,6942,6942,0,0,0,0,1.0,1,1.0,1,1.0,1,0.630965742892854,36
2708,3,6945,6945,0,0,0,0,1.0,1,1.0,1,1.0,1,0.5955356467364451,36
2709,5,6950,6950,0,0,0,0,1.0,1,1.0,1,1.0,1,0.5763605320267602,33
2710,5,6955,6955,0,0,0,0,1.0,1,1.0,1,1.0,1,0.5465595380956655,32
2711,3,6958,6958,0,0,0,0,1.0,1,1.0,1,1.0,1,0.5249582362973452,29
2712,2,6960,6960,0,0,0,0,1.0,1,1.0,1,1.0,1,0.49065344774178193,28
2713,1,6961,6961,0,0,0,0,1.0,1,1.0,1,1.0,1,0.5129797234063659,28
2714,4,6965,6965,0,0,0,0,1.0,1,1.0,1,1.0,1,0.5104340466468831,25
2715,1,6966,6966,0,0,0,0,1.0,1,1.0,1,1.0,1,0.4785585980904406,24
2716,6,6972,6972,0,0,0,0,1.0,1,1.0,1,1.0,1,0.5683887949078817,23
2717,2,6974,6974,0,0,0,0,1.0,1,1.0,1,1.0,1,0.5583919974246289,24
2718,3,6977,6977,0,0,0,0,1.0,1,1.0,1,1.0,1,0.5746019987230282,24
2719,2,6979,6979,0,0,0,0,1.0,1,1.0,1,1.0,1,0.5288463003620845,25
2720,2,6981,6981,0,0,0,0,1.0,1,1.0,1,1.0,1,0.547825857920969,25
2721,2,6983,6983,0,0,0,0,1.0,1,1.0,1,1.0,1,0.5189303154379165,26
2722,2,6985,6985,0,0,0,0,1.0,1,1.0,1,1.0,1,0.5827308528310099,26
2723,2,6987,6987,0,0,0,0,1.0,1,1.0,1,1.0,1,0.5462822202636092,26
2724,2,6989,6989,0,0,0,0,1.0,1,1.0,1,1.0,1,0.5013433890375061,27
2725,2,6991,6991,0,0,0,0,1.0,1,1.0,1,1.0,1,0.5009751414439246,27
2726,0,6991,6991,0,0,0,0,1.0,1,1.0,1,1.0,1,0.5179391138521033,28
2727,0,6991,6991,0,0,0,0,1.0,1,1.0,1,1.0,1,0.4979748933176053,29
2728,3,6994,6994,0,0,0,0,1.0,1,1.0,1,1.0,1,0.5474349452643459,28
2729,1,6995,6995,0,0,0,0,1.0,1,1.0,1,1.0,1,0.49273467668415394,28
2730,1,6996,6996,0,0,0,0,1.0,1,1.0,1,1.0,1,0.4786116279649482,29
2731,3,6999,6999,0,0,0,0,1.0,1,1.0,1,1.0,1,0.5045127753796635,30
2732,2,7001,7001,0,0,0,0,1.0,1,1.0,1,1.0,1,0.5749711612613418,29
2733,3,7004,7004,0,0,0,0,1.0,1,1.0,1,1.0,1,0.6073556907640637,29
2734,2,7006,7006,0,0,0,0,1.0,1,1.0,1,1.0,1,0.6094475469672072,29
2735,3,7009,7009,0,0,0,0,1.0,1,1.0,1,1.0,1,0.6631400804951806,29
2736,0,7009,7009,0,0,0,0,1.0,1,1.0,1,1.0,1,0.6683844220612849,30
2737,0,7009,7009,0,0,0,0,1.0,1,1.0,1,1.0,1,0.6683844220612849,30
2738,0,7009,7009,0,0,0,0,1.0,1,1.0,1,1.0,1,0.6961308225104736,29
2739,3,7012,7012,0,0,0,0,1.0,1,1.0,1,1.0,1,0.6672031837781746,30
2740,3,7015,7015,0,0,0,0,1.0,1,1.0,1,1.0,1,0.684856975195739,29
2741,0,7015,7015,0,0,0,0,1.0,1,1.0,1,1.0,1,0.684856975195739,29
2742,2,7017,7017,0,0,0,0,1.0,1,1.0,1,1.0,1,0.7136184088962807,29
2743,0,7017,7017,0,0,0,0,1.0,1,1.0,1,1.0,1,0.7119715944092496,30
2744,2,7019,7019,0,0,0,0,1.0,1,1.0,1,1.0,1,0.7369566658136896,28
2745,0,7019,7019,0,0,0,0,1.0,1,1.0,1,1.0,1,0.7477281048351438,27
2746,2,7021,7021,0,0,0,0,1.0,1,1.0,1,1.0,1,0.7050941967907446,26
2747,1,7022,7022,0,0,0,0,1.0,1,1.0,1,1.0,1,0.709020618971783,22
2748,5,7027,7027,0,0,0,0,1.0,1,1.0,1,1.0,1,0.6023843837221526,22
2749,2,7029,7029,0,0,0,0,1.0,1,1.0,1,1.0,1,0.5400130886807144,20
2750,3,7032,7032,0,0,0,0,1.0,1,1.0,1,1.0,1,0.5498256778665201,17
2751,4,7036,7036,0,0,0,0,1.0,1,1.0,1,1.0,1,0.5967727412469266,17
2752,3,7039,7039,0,0,0,0,1.0,1,1.0,1,1.0,1,0.6288798810316465,16
2753,1,7040,7040,0,0,0,0,1.0,1,1.0,1,1.0,1,0.5961174770146218,16
2754,2,7042,7042,0,0,0,0,1.0,1,1.0,1,1.0,1,0.5976052216972926,16
2755,1,7043,7043,0,0,0,0,1.0,1,1.0,1,1.0,1,0.6057989723072996,16
2756,0,7043,7043,0,0,0,0,1.0,1,1.0,1,1.0,1,0.6222261743890916,17
2757,0,7043,7043,0,0,0,0,1.0,1,1.0,1,1.0,1,0.5816407496237971,18
2758,0,7043,7043,0,0,0,0,1.0,1,1.0,1,1.0,1,0.5816407496237971,18
2759,1,7044,7044,0,0,0,0,1.0,1,1.0,1,1.0,1,0.5680117800426131,19
2760,1,7045,7045,0,0,0,0,1.0,1,1.0,1,1.0,1,0.4700920081607569,18
2761,1,7046,7046,0,0,0,0,1.0,1,1.0,1,1.0,1,0.4810305846807166,18
2762,1,7047,7047,0,0,0,0,1.0,1,1.0,1,1.0,1,0.5015632973233071,18
2763,0,7047,7047,0,0,0,0,1.0,1,1.0,1,1.0,1,0.5015632973233071,18
2764,0,7047,7047,0,0,0,0,1.0,1,1.0,1,1.0,1,0.5015632973233071,18
2765,0,7047,7047,0,0,0,0,1.0,1,1.0,1,1.0,1,0.5358404223506994,18
2766,0,7047,7047,0,0,0,0,1.0,1,1.0,1,1.0,1,0.5358404223506994,18
2767,0,7047,7047,0,0,0,0,1.0,1,1.0,1,1.0,1,0.577902048207028,17
2768,2,7049,7049,0,0,0,0,1.0,1,1.0,1,1.0,1,0.5752158369284126,17
2769,1,7050,7050,0,0,0,0,1.0,1,1.0,1,1.0,1,0.5911689242702133,17
2770,0,7050,7050,0,0,0,0,1.0,1,1.0,1,1.0,1,0.5911689242702133,17
2771,3,7053,7053,0,0,0,0,1.0,1,1.0,1,1.0,1,0.5840677146626035,17
2772,1,7054,7054,0,0,0,0,1.0,1,1.0,1,1.0,1,0.5919835202640606,17
2773,0,7054,7054,0,0,0,0,1.0,1,1.0,1,1.0,1,0.5919835202640606,17
2774,4,7058,7058,0,0,0,0,1.0,1,1.0,1,1.0,1,0.4821844356772019,18
2775,1,7059,7059,0,0,0,0,1.0,1,1.0,1,1.0,1,0.5017203514380324,20
2776,3,7062,7062,0,0,0,0,1.0,1,1.0,1,1.0,1,0.5104198351347847,21
2777,0,7062,7062,0,0,0,0,1.0,1,1.0,1,1.0,1,0.5104198351347847,21
2778,3,7065,7065,0,0,0,0,1.0,1,1.0,1,1.0,1,0.5614624179313692,21
2779,2,7067,7067,0,0,0,0,1.0,1,1.0,1,1.0,1,0.5429655748827242,22
2780,2,7069,7069,0,0,0,0,1.0,1,1.0,1,1.0,1,0.600637511168217,22
2781,1,7070,7070,0,0,0,0,1.0,1,1.0,1,1.0,1,0.6484807222447191,22
2782,2,7072,7072,0,0,0,0,1.0,1,1.0,1,1.0,1,0.6579857124166354,23
2783,1,7073,7073,0,0,0,0,1.0,1,1.0,1,1.0,1,0.6820744532815283,22
2784,0,7073,7073,0,0,0,0,1.0,1,1.0,1,1.0,1,0.6737380136455796,21
2785,0,7073,7073,0,0,0,0,1.0,1,1.0,1,1.0,1,0.6516121687464975,19
2786,0,7073,7073,0,0,0,0,1.0,1,1.0,1,1.0,1,0.6516121687464975,19
2787,0,7073,7073,0,0,0,0,1.0,1,1.0,1,1.0,1,0.6061199226674843,20
2788,1,7074,7074,0,0,0,0,1.0,1,1.0,1,1.0,1,0.595281387818586,20
2789,0,7074,7074,0,0,0,0,1.0,1,1.0,1,1.0,1,0.5848076408803758,19
2790,1,7075,7075,0,0,0,0,1.0,1,1.0,1,1.0,1,0.5376120188990846,20
2791,0,7075,7075,0,0,0,0,1.0,1,1.0,1,1.0,1,0.5376120188990846,20
2792,2,7077,7077,0,0,0,0,1.0,1,1.0,1,1.0,1,0.5478110021359026,20
2793,1,7078,7078,0,0,0,0,1.0,1,1.0,1,1.0,1,0.5815558587826847,19
2794,1,7079,7079,0,0,0,0,1.0,1,1.0,1,1.0,1,0.5407247740667398,20
2795,1,7080,7080,0,0,0,0,1.0,1,1.0,1,1.0,1,0.549947878237082,21
2796,0,7080,7080,0,0,0,0,1.0,1,1.0,1,1.0,1,0.5604825785618323,22
2797,0,7080,7080,0,0,0,0,1.0,1,1.0,1,1.0,1,0.5823529977842835,21
2798,0,7080,7080,0,0,0,0,1.0,1,1.0,1,1.0,1,0.5823529977842835,21
2799,0,7080,7080,0,0,0,0,1.0,1,1.0,1,1.0,1,0.5986751191151419,20
2800,1,7081,7081,0,0,0,0,1.0,1,1.0,1,1.0,1,0.607227267156312,20
2801,2,7083,7083,0,0,0,0,1.0,1,1.0,1,1.0,1,0.6140235834390396,20
2802,2,7085,7085,0,0,0,0,1.0,1,1.0,1,1.0,1,0.6623599194758844,20
2803,6,7091,7091,0,0,0,0,1.0,1,1.0,1,1.0,1,0.6487608180807352,21
2804,3,7094,7094,0,0,0,0,1.0,1,1.0,1,1.0,1,0.6794640282668304,22
2805,3,7097,7097,0,0,0,0,1.0,1,1.0,1,1.0,1,0.7074459186605918,22
2806,5,7102,7102,0,0,0,0,1.0,1,1.0,1,1.0,1,0.7043918153811617,23
2807,2,7104,7104,0,0,0,0,1.0,1,1.0,1,1.0,1,0.6684365459678531,24
2808,3,7107,7107,0,0,0,0,1.0,1,1.0,1,1.0,1,0.6080800802394329,24
2809,2,7109,7109,0,0,0,0,1.0,1,1.0,1,1.0,1,0.6178387844021093,26
2810,3,7112,7112,0,0,0,0,1.0,1,1.0,1,1.0,1,0.56377866457668,26
2811,2,7114,7114,0,0,0,0,1.0,1,1.0,1,1.0,1,0.567977795031373,27
2812,2,7116,7116,0,0,0,0,1.0,1,1.0,1,1.0,1,0.5301954917263408,27
2813,0,7116,7116,0,0,0,0,1.0,1,1.0,1,1.0,1,0.5041329648491313,28
2814,0,7116,7116,0,0,0,0,1.0,1,1.0,1,1.0,1,0.5107123776445803,29
2815,1,7117,7117,0,0,0,0,1.0,1,1.0,1,1.0,1,0.5290462637359925,30
2816,0,7117,7117,0,0,0,0,1.0,1,1.0,1,1.0,1,0.5207256391557992,31
2817,0,7117,7117,0,0,0,0,1.0,1,1.0,1,1.0,1,0.5207256391557992,31
2818,2,7119,7119,0,0,0,0,1.0,1,1.0,1,1.0,1,0.48381210195994157,32
2819,3,7122,7122,0,0,0,0,1.0,1,1.0,1,1.0,1,0.4457067911853438,32
2820,1,7123,7123,0,0,0,0,1.0,1,1.0,1,1.0,1,0.4579471794098414,33
2821,1,7124,7124,0,0,0,0,1.0,1,1.0,1,1.0,1,0.49276374946220886,34
2822,3,7127,7127,0,0,0,0,1.0,1,1.0,1,1.0,1,0.5222462827316159,35
2823,1,7128,7128,0,0,0,0,1.0,1,1.0,1,1.0,1,0.5540719425571552,31
2824,4,7132,7132,0,0,0,0,1.0,1,1.0,1,1.0,1,0.5131346842856997,33
2825,1,7133,7133,0,0,0,0,1.0,1,1.0,1,1.0,1,0.5436847956692024,31
2826,3,7136,7136,0,0,0,0,1.0,1,1.0,1,1.0,1,0.5747957637029658,31
2827,3,7139,7139,0,0,0,0,1.0,1,1.0,1,1.0,1,0.5819640039733962,32
2828,10,7149,7149,0,0,0,0,1.0,1,1.0,1,1.0,1,0.625548700234797,33
2829,1,7150,7150,0,0,0,0,1.0,1,1.0,1,1.0,1,0.6038721943993367,33
2830,8,7158,7158,0,0,0,0,1.0,1,1.0,1,1.0,1,0.6328557817903481,32
2831,2,7160,7160,0,0,0,0,1.0,1,1.0,1,1.0,1,0.6015046404267715,31
2832,4,7164,7164,0,0,0,0,1.0,1,1.0,1,1.0,1,0.65202892894385,30
2833,5,7169,7169,0,0,0,0,1.0,1,1.0,1,1.0,1,0.6355749119111564,29
2834,3,7172,7172,0,0,0,0,1.0,1,1.0,1,1.0,1,0.6173072070574672,29
2835,4,7176,7176,0,0,0,0,1.0,1,1.0,1,1.0,1,0.6000207991701804,27
2836,3,7179,7179,0,0,0,0,1.0,1,1.0,1,1.0,1,0.5376542124836463,27
2837,4,7183,7183,0,0,0,0,1.0,1,1.0,1,1.0,1,0.5572708487856016,28
2838,2,7185,7185,0,0,0,0,1.0,1,1.0,1,1.0,1,0.5066159212678916,29
2839,2,7187,7187,0,0,0,0,1.0,1,1.0,1,1.0,1,0.5255746693987083,29
2840,2,7189,7189,0,0,0,0,1.0,1,1.0,1,1.0,1,0.5396298901993268,29
2841,2,7191,7191,0,0,0,0,1.0,1,1.0,1,1.0,1,0.4984134513553003,31
2842,3,7194,7194,0,0,0,0,1.0,1,1.0,1,1.0,1,0.5311543678067432,32
2843,1,7195,7195,0,0,0,0,1.0,1,1.0,1,1.0,1,0.5263859276509747,32
2844,1,7196,7196,0,0,0,0,1.0,1,1.0,1,1.0,1,0.5493414990339917,33
2845,1,7197,7197,0,0,0,0,1.0,1,1.0,1,1.0,1,0.5013034455519922,34
2846,2,7199,7199,0,0,0,0,1.0,1,1.0,1,1.0,1,0.4707330883550944,34
2847,2,7201,7201,0,0,0,0,1.0,1,1.0,1,1.0,1,0.42983528860565184,35
2848,1,7202,7202,0,0,0,0,1.0,1,1.0,1,1.0,1,0.43385549912534616,37
2849,1,7203,7203,0,0,0,0,1.0,1,1.0,1,1.0,1,0.4271287873583088,37
2850,0,7203,7203,0,0,0,0,1.0,1,1.0,1,1.0,1,0.4271287873583088,37
2851,0,7203,7203,0,0,0,0,1.0,1,1.0,1,1.0,1,0.4365920828059438,38
2852,3,7206,7206,0,0,0,0,1.0,1,1.0,1,1.0,1,0.4239521495784649,36
2853,4,7210,7210,0,0,0,0,1.0,1,1.0,1,1.0,1,0.49108892682515415,36
2854,0,7210,7210,0,0,0,0,1.0,1,1.0,1,1.0,1,0.4824118286626795,37
2855,5,7215,7215,0,0,0,0,1.0,1,1.0,1,1.0,1,0.6026823224974986,37
2856,1,7216,7216,0,0,0,0,1.0,1,1.0,1,1.0,1,0.5764804668015544,38
2857,2,7218,7218,0,0,0,0,1.0,1,1.0,1,1.0,1,0.6150295298239687,39
2858,4,7222,7222,0,0,0,0,1.0,1,1.0,1,1.0,1,0.6050748385663227,39
2859,5,7227,7227,0,0,0,0,1.0,1,1.0,1,1.0,1,0.6052097855868213,39
2860,5,7232,7232,0,0,0,0,1.0,1,1.0,1,1.0,1,0.5988696667981719,40
2861,4,7236,7236,0,0,0,0,1.0,1,1.0,1,1.0,1,0.5903503518257683,38
2862,3,7239,7239,0,0,0,0,1.0,1,1.0,1,1.0,1,0.5926492775134355,38
2863,5,7244,7244,0,0,0,0,1.0,1,1.0,1,1.0,1,0.5434031026358511,37
2864,5,7249,7249,0,0,0,0,1.0,1,1.0,1,1.0,1,0.591595519584733,35
2865,3,7252,7252,0,0,0,0,1.0,1,1.0,1,1.0,1,0.617968226994281,33
2866,1,7253,7253,0,0,0,0,1.0,1,1.0,1,1.0,1,0.6095533361749059,31
2867,2,7255,7255,0,0,0,0,1.0,1,1.0,1,1.0,1,0.6525488258198658,30
2868,1,7256,7256,0,0,0,0,1.0,1,1.0,1,1.0,1,0.6376513903721891,31
2869,0,7256,7256,0,0,0,0,1.0,1,1.0,1,1.0,1,0.6425119295167518,30
2870,0,7256,7256,0,0,0,0,1.0,1,1.0,1,1.0,1,0.6641545784756373,26
2871,1,7257,7257,0,0,0,0,1.0,1,1.0,1,1.0,1,0.6588523255303399,27
2872,1,7258,7258,0,0,0,0,1.0,1,1.0,1,1.0,1,0.6870168906491418,25
2873,0,7258,7258,0,0,0,0,1.0,1,1.0,1,1.0,1,0.6903915599533722,24
2874,0,7258,7258,0,0,0,0,1.0,1,1.0,1,1.0,1,0.6618428368713676,25
2875,2,7260,7260,0,0,0,0,1.0,1,1.0,1,1.0,1,0.6713976755496556,26
2876,3,7263,7263,0,0,0,0,1.0,1,1.0,1,1.0,1,0.6463909582492264,28
2877,1,7264,7264,0,0,0,0,1.0,1,1.0,1,1.0,1,0.61355791703191,29
2878,4,7268,7268,0,0,0,0,1.0,1,1.0,1,1.0,1,0.5586221145167755,31
2879,3,7271,7271,0,0,0,0,1.0,1,1.0,1,1.0,1,0.5328284165968605,31
2880,4,7275,7275,0,0,0,0,1.0,1,1.0,1,1.0,1,0.5142544888892859,32
2881,1,7276,7276,0,0,0,0,1.0,1,1.0,1,1.0,1,0.5364983760228702,31
2882,5,7281,7281,0,0,0,0,1.0,1,1.0,1,1.0,1,0.5517123352916519,31
2883,3,7284,7284,0,0,0,0,1.0,1,1.0,1,1.0,1,0.5540718663103057,32
2884,2,7286,7286,0,0,0,0,1.0,1,1.0,1,1.0,1,0.5649773758977086,32
2885,3,7289,7289,0,0,0,0,1.0,1,1.0,1,1.0,1,0.5953220025476161,33
2886,2,7291,7291,0,0,0,0,1.0,1,1.0,1,1.0,1,0.5641207709066826,34
2887,3,7294,7294,0,0,0,0,1.0,1,1.0,1,1.0,1,0.5164263159469251,34
2888,0,7294,7294,0,0,0,0,1.0,1,1.0,1,1.0,1,0.5164263159469251,34
2889,4,7298,7298,0,0,0,0,1.0,1,1.0,1,1.0,1,0.5718736549205085,37
2890,1,7299,7299,0,0,0,0,1.0,1,1.0,1,1.0,1,0.577051959341164,37
2891,3,7302,7302,0,0,0,0,1.0,1,1.0,1,1.0,1,0.5957376214028733,37
2892,4,7306,7306,0,0,0,0,1.0,1,1.0,1,1.0,1,0.6075979866128626,37
2893,2,7308,7308,0,0,0,0,1.0,1,1.0,1,1.0,1,0.6247667004886139,38
2894,2,7310,7310,0,0,0,0,1.0,1,1.0,1,1.0,1,0.6313066321752723,39
2895,1,7311,7311,0,0,0,0,1.0,1,1.0,1,1.0,1,0.5932429701066149,40
2896,3,7314,7314,0,0,0,0,1.0,1,1.0,1,1.0,1,0.5945836038756457,41
2897,0,7314,7314,0,0,0,0,1.0,1,1.0,1,1.0,1,0.5945836038756457,41
2898,2,7316,7316,0,0,0,0,1.0,1,1.0,1,1.0,1,0.6025298556693298,41
2899,2,7318,7318,0,0,0,0,1.0,1,1.0,1,1.0,1,0.5800449461465755,39
2900,3,7321,7321,0,0,0,0,1.0,1,1.0,1,1.0,1,0.598641978757911,40
2901,1,7322,7322,0,0,0,0,1.0,1,1.0,1,1.0,1,0.5872683802488086,40
2902,2,7324,7324,0,0,0,0,1.0,1,1.0,1,1.0,1,0.5590198056081254,38
2903,2,7326,7326,0,0,0,0,1.0,1,1.0,1,1.0,1,0.5898468732380233,36
2904,4,7330,7330,0,0,0,0,1.0,1,1.0,1,1.0,1,0.6464605093704352,36
2905,2,7332,7332,0,0,0,0,1.0,1,1.0,1,1.0,1,0.6345769652331382,35
2906,7,7339,7339,0,0,0,0,1.0,1,1.0,1,1.0,1,0.5974615702834847,36
2907,3,7342,7342,0,0,0,0,1.0,1,1.0,1,1.0,1,0.562745599778836,37
2908,7,7349,7349,0,0,0,0,1.0,1,1.0,1,1.0,1,0.6405553622893259,38
2909,1,7350,7350,0,0,0,0,1.0,1,1.0,1,1.0,1,0.628343918524434,37
2910,6,7356,7356,0,0,0,0,1.0,1,1.0,1,1.0,1,0.5816594669959313,37
2911,1,7357,7357,0,0,0,0,1.0,1,1.0,1,1.0,1,0.6010476700803353,36
2912,3,7360,7360,0,0,0,0,1.0,1,1.0,1,1.0,1,0.6300431100833738,36
2913,2,7362,7362,0,0,0,0,1.0,1,1.0,1,1.0,1,0.6430866647804853,36
2914,3,7365,7365,0,0,0,0,1.0,1,1.0,1,1.0,1,0.6348351623303328,38
2915,1,7366,7366,0,0,0,0,1.0,1,1.0,1,1.0,1,0.6523818523992487,37
2916,2,7368,7368,0,0,0,0,1.0,1,1.0,1,1.0,1,0.6310843367854512,39
2917,2,7370,7370,0,0,0,0,1.0,1,1.0,1,1.0,1,0.5582990153637302,40
2918,2,7372,7372,0,0,0,0,1.0,1,1.0,1,1.0,1,0.6273901651766887,40
2919,2,7374,7374,0,0,0,0,1.0,1,1.0,1,1.0,1,0.6223359286901391,42
2920,3,7377,7377,0,0,0,0,1.0,1,1.0,1,1.0,1,0.5998744631665218,42
2921,3,7380,7380,0,0,0,0,1.0,1,1.0,1,1.0,1,0.6283756323808074,42
2922,1,7381,7381,0,0,0,0,1.0,1,1.0,1,1.0,1,0.592894901679997,43
2923,2,7383,7383,0,0,0,0,1.0,1,1.0,1,1.0,1,0.5938722295738,45
2924,2,7385,7385,0,0,0,0,1.0,1,1.0,1,1.0,1,0.5793223081615575,46
2925,2,7387,7387,0,0,0,0,1.0,1,1.0,1,1.0,1,0.5890027973140215,46
2926,2,7389,7389,0,0,0,0,1.0,1,1.0,1,1.0,1,0.568027496569289,46
2927,0,7389,7389,0,0,0,0,1.0,1,1.0,1,1.0,1,0.5594625806418285,48
2928,3,7392,7392,0,0,0,0,1.0,1,1.0,1,1.0,1,0.5599154554451162,48
2929,1,7393,7393,0,0,0,0,1.0,1,1.0,1,1.0,1,0.5519512045067793,48
2930,3,7396,7396,0,0,0,0,1.0,1,1.0,1,1.0,1,0.5349472241566614,50
2931,4,7400,7400,0,0,0,0,1.0,1,1.0,1,1.0,1,0.5356182295898128,51
2932,3,7403,7403,0,0,0,0,1.0,1,1.0,1,1.0,1,0.5591921085127295,52
2933,3,7406,7406,0,0,0,0,1.0,1,1.0,1,1.0,1,0.5656786951108341,53
2934,1,7407,7407,0,0,0,0,1.0,1,1.0,1,1.0,1,0.5810704485516963,54
2935,0,7407,7407,0,0,0,0,1.0,1,1.0,1,1.0,1,0.5845553461658711,53
2936,0,7407,7407,0,0,0,0,1.0,1,1.0,1,1.0,1,0.5845553461658711,53
2937,1,7408,7408,0,0,0,0,1.0,1,1.0,1,1.0,1,0.576468192968062,51
2938,1,7409,7409,0,0,0,0,1.0,1,1.0,1,1.0,1,0.5755464062274407,53
2939,2,7411,7411,0,0,0,0,1.0,1,1.0,1,1.0,1,0.5739366273489999,52
2940,3,7414,7414,0,0,0,0,1.0,1,1.0,1,1.0,1,0.6015784153452503,52
2941,3,7417,7417,0,0,0,0,1.0,1,1.0,1,1.0,1,0.5990252534236047,50
2942,3,7420,7420,0,0,0,0,1.0,1,1.0,1,1.0,1,0.6398303610576574,50
2943,0,7420,7420,0,0,0,0,1.0,1,1.0,1,1.0,1,0.6509730122570578,49
2944,1,7421,7421,0,0,0,0,1.0,1,1.0,1,1.0,1,0.6662877036198676,48
2945,4,7425,7425,0,0,0,0,1.0,1,1.0,1,1.0,1,0.6423473603375877,48
2946,0,7425,7425,0,0,0,0,1.0,1,1.0,1,1.0,1,0.6511569299084837,47
2947,4,7429,7429,0,0,0,0,1.0,1,1.0,1,1.0,1,0.6508939880071946,47
2948,1,7430,7430,0,0,0,0,1.0,1,1.0,1,1.0,1,0.6391223508554794,48
2949,5,7435,7435,0,0,0,0,1.0,1,1.0,1,1.0,1,0.6337883713556682,48
2950,0,7435,7435,0,0,0,0,1.0,1,1.0,1,1.0,1,0.6337883713556682,48
2951,4,7439,7439,0,0,0,0,1.0,1,1.0,1,1.0,1,0.6415806806249977,50
2952,2,7441,7441,0,0,0,0,1.0,1,1.0,1,1.0,1,0.6532158423688812,50
2953,4,7445,7445,0,0,0,0,1.0,1,1.0,1,1.0,1,0.6580377712039748,51
2954,1,7446,7446,0,0,0,0,1.0,1,1.0,1,1.0,1,0.66429950587695,51
2955,2,7448,7448,0,0,0,0,1.0,1,1.0,1,1.0,1,0.6563909163786643,51
2956,0,7448,7448,0,0,0,0,1.0,1,1.0,1,1.0,1,0.6563909163786643,51
2957,2,7450,7450,0,0,0,0,1.0,1,1.0,1,1.0,1,0.647330044054244,52
2958,1,7451,7451,0,0,0,0,1.0,1,1.0,1,1.0,1,0.6340718668303928,52
2959,3,7454,7454,0,0,0,0,1.0,1,1.0,1,1.0,1,0.6168857381687363,53
2960,1,7455,7455,0,0,0,0,1.0,1,1.0,1,1.0,1,0.6023945376683726,52
2961,1,7456,7456,0,0,0,0,1.0,1,1.0,1,1.0,1,0.5911891916315563,53
2962,3,7459,7459,0,0,0,0,1.0,1,1.0,1,1.0,1,0.5273087091772245,54
2963,1,7460,7460,0,0,0,0,1.0,1,1.0,1,1.0,1,0.5242760486353967,55
2964,4,7464,7464,0,0,0,0,1.0,1,1.0,1,1.0,1,0.5078962360171915,55
2965,4,7468,7468,0,0,0,0,1.0,1,1.0,1,1.0,1,0.4994363014759996,55
2966,1,7469,7469,0,0,0,0,1.0,1,1.0,1,1.0,1,0.5026467397918646,55
2967,4,7473,7473,0,0,0,0,1.0,1,1.0,1,1.0,1,0.5171279942610484,56
2968,2,7475,7475,0,0,0,0,1.0,1,1.0,1,1.0,1,0.5154730794268358,56
2969,2,7477,7477,0,0,0,0,1.0,1,1.0,1,1.0,1,0.5498921686360791,55
2970,2,7479,7479,0,0,0,0,1.0,1,1.0,1,1.0,1,0.552942293195791,57
2971,0,7479,7479,0,0,0,0,1.0,1,1.0,1,1.0,1,0.562972425631047,56
2972,4,7483,7483,0,0,0,0,1.0,1,1.0,1,1.0,1,0.5715469622083494,57
2973,2,7485,7485,0,0,0,0,1.0,1,1.0,1,1.0,1,0.5528321676110931,59
2974,1,7486,7486,0,0,0,0,1.0,1,1.0,1,1.0,1,0.5418962990382856,60
2975,1,7487,7487,0,0,0,0,1.0,1,1.0,1,1.0,1,0.5311956621939969,58
2976,3,7490,7490,0,0,0,0,1.0,1,1.0,1,1.0,1,0.5718407778557294,59
2977,2,7492,7492,0,0,0,0,1.0,1,1.0,1,1.0,1,0.5702800417013283,59
2978,7,7499,7499,0,0,0,0,1.0,1,1.0,1,1.0,1,0.5429796234135531,58
2979,4,7503,7503,0,0,0,0,1.0,1,1.0,1,1.0,1,0.5278009706481787,57
2980,8,7511,7511,0,0,0,0,1.0,1,1.0,1,1.0,1,0.4978088877807507,56
2981,5,7516,7516,0,0,0,0,1.0,1,1.0,1,1.0,1,0.5243823919825791,56
2982,4,7520,7520,0,0,0,0,1.0,1,1.0,1,1.0,1,0.5318401425108586,57
2983,3,7523,7523,0,0,0,0,1.0,1,1.0,1,1.0,1,0.552386494276104,57
2984,5,7528,7528,0,0,0,0,1.0,1,1.0,1,1.0,1,0.5437608835448671,56
2985,1,7529,7529,0,0,0,0,1.0,1,1.0,1,1.0,1,0.5492760437044552,55
2986,2,7531,7531,0,0,0,0,1.0,1,1.0,1,1.0,1,0.5611571619404975,55
2987,1,7532,7532,0,0,0,0,1.0,1,1.0,1,1.0,1,0.5767917364813031,51
2988,2,7534,7534,0,0,0,0,1.0,1,1.0,1,1.0,1,0.5679744968077036,52
2989,1,7535,7535,0,0,0,0,1.0,1,1.0,1,1.0,1,0.5809937071792629,50
2990,3,7538,7538,0,0,0,0,1.0,1,1.0,1,1.0,1,0.5635098563433466,50
2991,3,7541,7541,0,0,0,0,1.0,1,1.0,1,1.0,1,0.5430030884798251,50
2992,1,7542,7542,0,0,0,0,1.0,1,1.0,1,1.0,1,0.5358256560293779,50
2993,2,7544,7544,0,0,0,0,1.0,1,1.0,1,1.0,1,0.5491063160065472,51
2994,5,7549,7549,0,0,0,0,1.0,1,1.0,1,1.0,1,0.5364474477843953,51
2995,3,7552,7552,0,0,0,0,1.0,1,1.0,1,1.0,1,0.5610325832662945,51
2996,3,7555,7555,0,0,0,0,1.0,1,1.0,1,1.0,1,0.5445979071575497,52
2997,4,7559,7559,0,0,0,0,1.0,1,1.0,1,1.0,1,0.599926429882746,52
2998,3,7562,7562,0,0,0,0,1.0,1,1.0,1,1.0,1,0.6343418594223647,51
2999,1,7563,7563,0,0,0,0,1.0,1,1.0,1,1.0,1,0.6233778743256619,51
3000,2,7565,7565,0,0,0,0,1.0,1,1.0,1,1.0,1,0.5916582255665248,52
3001,0,7565,7565,0,0,0,0,1.0,1,1.0,1,1.0,1,0.5916582255665248,52
3002,4,7569,7569,0,0,0,0,1.0,1,1.0,1,1.0,1,0.5886753757735664,53
3003,1,7570,7570,0,0,0,0,1.0,1,1.0,1,1.0,1,0.5762215136981111,54
3004,5,7575,7575,0,0,0,0,1.0,1,1.0,1,1.0,1,0.5925392928423641,55
3005,2,7577,7577,0,0,0,0,1.0,1,1.0,1,1.0,1,0.5907024341830639,56
3006,5,7582,7582,0,0,0,0,1.0,1,1.0,1,1.0,1,0.5762583239473917,57
3007,3,7585,7585,0,0,0,0,1.0,1,1.0,1,1.0,1,0.5804107170108462,58
3008,5,7590,7590,0,0,0,0,1.0,1,1.0,1,1.0,1,0.5832253205808475,59
3009,0,7590,7590,0,0,0,0,1.0,1,1.0,1,1.0,1,0.5832253205808475,59
3010,4,7594,7594,0,0,0,0,1.0,1,1.0,1,1.0,1,0.5780026616583758,59
3011,4,7598,7598,0,0,0,0,1.0,1,1.0,1,1.0,1,0.5532218072676017,59
3012,2,7600,7600,0,0,0,0,1.0,1,1.0,1,1.0,1,0.5514952382564953,61
3013,1,7601,7601,0,0,0,0,1.0,1,1.0,1,1.0,1,0.5437735721622425,59
3014,2,7603,7603,0,0,0,0,1.0,1,1.0,1,1.0,1,0.5357471048999223,60
3015,2,7605,7605,0,0,0,0,1.0,1,1.0,1,1.0,1,0.5181559623936562,58
3016,0,7605,7605,0,0,0,0,1.0,1,1.0,1,1.0,1,0.515799332130282,57
3017,0,7605,7605,0,0,0,0,1.0,1,1.0,1,1.0,1,0.5063493257683634,58
3018,3,7608,7608,0,0,0,0,1.0,1,1.0,1,1.0,1,0.4993716442780836,55
3019,3,7611,7611,0,0,0,0,1.0,1,1.0,1,1.0,1,0.49887441834182933,56
3020,1,7612,7612,0,0,0,0,1.0,1,1.0,1,1.0,1,0.5072363640517824,55
3021,4,7616,7616,0,0,0,0,1.0,1,1.0,1,1.0,1,0.5246186980549985,55
3022,3,7619,7619,0,0,0,0,1.0,1,1.0,1,1.0,1,0.5320323040916257,55
3023,4,7623,7623,0,0,0,0,1.0,1,1.0,1,1.0,1,0.5607904717296065,54
3024,2,7625,7625,0,0,0,0,1.0,1,1.0,1,1.0,1,0.5715106010317975,54
3025,4,7629,7629,0,0,0,0,1.0,1,1.0,1,1.0,1,0.5303028079865396,54
3026,5,7634,7634,0,0,0,0,1.0,1,1.0,1,1.0,1,0.5653394584996081,53
3027,3,7637,7637,0,0,0,0,1.0,1,1.0,1,1.0,1,0.5378944546039333,53
3028,3,7640,7640,0,0,0,0,1.0,1,1.0,1,1.0,1,0.5513288600269144,51
3029,6,7646,7646,0,0,0,0,1.0,1,1.0,1,1.0,1,0.5171682480235781,51
3030,3,7649,7649,0,0,0,0,1.0,1,1.0,1,1.0,1,0.514127072595783,52
3031,3,7652,7652,0,0,0,0,1.0,1,1.0,1,1.0,1,0.5515623598792986,51
3032,4,7656,7656,0,0,0,0,1.0,1,1.0,1,1.0,1,0.5832822803833805,50
3033,1,7657,7657,0,0,0,0,1.0,1,1.0,1,1.0,1,0.5541912719610176,52
3034,0,7657,7657,0,0,0,0,1.0,1,1.0,1,1.0,1,0.564538119865921,51
3035,2,7659,7659,0,0,0,0,1.0,1,1.0,1,1.0,1,0.5776501074934876,51
3036,0,7659,7659,0,0,0,0,1.0,1,1.0,1,1.0,1,0.5777257993009937,53
3037,0,7659,7659,0,0,0,0,1.0,1,1.0,1,1.0,1,0.5864463919503418,52
3038,2,7661,7661,0,0,0,0,1.0,1,1.0,1,1.0,1,0.6209601208803522,52
3039,1,7662,7662,0,0,0,0,1.0,1,1.0,1,1.0,1,0.5957482720973124,54
3040,1,7663,7663,0,0,0,0,1.0,1,1.0,1,1.0,1,0.6124315099424203,55
3041,3,7666,7666,0,0,0,0,1.0,1,1.0,1,1.0,1,0.5817695241382405,56
3042,2,7668,7668,0,0,0,0,1.0,1,1.0,1,1.0,1,0.582868203043175,56
3043,3,7671,7671,0,0,0,0,1.0,1,1.0,1,1.0,1,0.5771881778058382,57
3044,3,7674,7674,0,0,0,0,1.0,1,1.0,1,1.0,1,0.5865780601701509,57
3045,6,7680,7680,0,0,0,0,1.0,1,1.0,1,1.0,1,0.5622043491664366,56
3046,2,7682,7682,0,0,0,0,1.0,1,1.0,1,1.0,1,0.5701232118927831,57
3047,2,7684,7684,0,0,0,0,1.0,1,1.0,1,1.0,1,0.5853053715179048,56
3048,3,7687,7687,0,0,0,0,1.0,1,1.0,1,1.0,1,0.5611056575171286,58
3049,1,7688,7688,0,0,0,0,1.0,1,1.0,1,1.0,1,0.5648138424739672,59
3050,2,7690,7690,0,0,0,0,1.0,1,1.0,1,1.0,1,0.519838609798158,60
3051,1,7691,7691,0,0,0,0,1.0,1,1.0,1,1.0,1,0.524307667760611,59
3052,1,7692,7692,0,0,0,0,1.0,1,1.0,1,1.0,1,0.5119381013959103,58
3053,2,7694,7694,0,0,0,0,1.0,1,1.0,1,1.0,1,0.49885303121946944,57
3054,2,7696,7696,0,0,0,0,1.0,1,1.0,1,1.0,1,0.4817439843151325,55
3055,5,7701,7701,0,0,0,0,1.0,1,1.0,1,1.0,1,0.45860261197790797,54
3056,5,7706,7706,0,0,0,0,1.0,1,1.0,1,1.0,1,0.42797159868465934,55
3057,6,7712,7712,0,0,0,0,1.0,1,1.0,1,1.0,1,0.47832896838226524,54
3058,4,7716,7716,0,0,0,0,1.0,1,1.0,1,1.0,1,0.5348420213571728,55
3059,5,7721,7721,0,0,0,0,1.0,1,1.0,1,1.0,1,0.5432214332821366,56
3060,3,7724,7724,0,0,0,0,1.0,1,1.0,1,1.0,1,0.5452437995526023,56
3061,3,7727,7727,0,0,0,0,1.0,1,1.0,1,1.0,1,0.5420444123500019,56
3062,2,7729,7729,0,0,0,0,1.0,1,1.0,1,1.0,1,0.5480785207563211,57
3063,4,7733,7733,0,0,0,0,1.0,1,1.0,1,1.0,1,0.5339443403226133,55
3064,2,7735,7735,0,0,0,0,1.0,1,1.0,1,1.0,1,0.5613651395954865,56
3065,3,7738,7738,0,0,0,0,1.0,1,1.0,1,1.0,1,0.5531675330349971,55
3066,3,7741,7741,0,0,0,0,1.0,1,1.0,1,1.0,1,0.5543248963791441,55
3067,1,7742,7742,0,0,0,0,1.0,1,1.0,1,1.0,1,0.5443183854125128,54
3068,4,7746,7746,0,0,0,0,1.0,1,1.0,1,1.0,1,0.5556487776705732,53
3069,3,7749,7749,0,0,0,0,1.0,1,1.0,1,1.0,1,0.5776393873858915,51
3070,3,7752,7752,0,0,0,0,1.0,1,1.0,1,1.0,1,0.5621936817802428,50
3071,2,7754,7754,0,0,0,0,1.0,1,1.0,1,1.0,1,0.5786126561850563,51
3072,2,7756,7756,0,0,0,0,1.0,1,1.0,1,1.0,1,0.5765929229144829,53
3073,1,7757,7757,0,0,0,0,1.0,1,1.0,1,1.0,1,0.5758982458136602,51
3074,4,7761,7761,0,0,0,0,1.0,1,1.0,1,1.0,1,0.5680978897583268,50
3075,1,7762,7762,0,0,0,0,1.0,1,1.0,1,1.0,1,0.5620960729481104,52
3076,2,7764,7764,0,0,0,0,1.0,1,1.0,1,1.0,1,0.5648456528462058,53
3077,2,7766,7766,0,0,0,0,1.0,1,1.0,1,1.0,1,0.5545690697613047,52
3078,4,7770,7770,0,0,0,0,1.0,1,1.0,1,1.0,1,0.537327020882312,53
3079,0,7770,7770,0,0,0,0,1.0,1,1.0,1,1.0,1,0.537327020882312,53
3080,8,7778,7778,0,0,0,0,1.0,1,1.0,1,1.0,1,0.5114124348448328,52
3081,2,7780,7780,0,0,0,0,1.0,1,1.0,1,1.0,1,0.5267907260285667,54
3082,4,7784,7784,0,0,0,0,1.0,1,1.0,1,1.0,1,0.5097176119729129,54
3083,4,7788,7788,0,0,0,0,1.0,1,1.0,1,1.0,1,0.503579082211172,54
3084,3,7791,7791,0,0,0,0,1.0,1,1.0,1,1.0,1,0.4953150683585183,55
3085,2,7793,7793,0,0,0,0,1.0,1,1.0,1,1.0,1,0.5023394653049366,55
3086,2,7795,7795,0,0,0,0,1.0,1,1.0,1,1.0,1,0.4975666593197546,56
3087,1,7796,7796,0,0,0,0,1.0,1,1.0,1,1.0,1,0.5152376162457647,57
3088,2,7798,7798,0,0,0,0,1.0,1,1.0,1,1.0,1,0.5271657415844367,56
3089,0,7798,7798,0,0,0,0,1.0,1,1.0,1,1.0,1,0.5336704835523954,55
3090,1,7799,7799,0,0,0,0,1.0,1,1.0,1,1.0,1,0.550078294797029,54
3091,2,7801,7801,0,0,0,0,1.0,1,1.0,1,1.0,1,0.538204764929279,53
3092,0,7801,7801,0,0,0,0,1.0,1,1.0,1,1.0,1,0.5171175735145083,56
3093,4,7805,7805,0,0,0,0,1.0,1,1.0,1,1.0,1,0.5007362310688033,56
3094,0,7805,7805,0,0,0,0,1.0,1,1.0,1,1.0,1,0.5099170611109527,58
3095,3,7808,7808,0,0,0,0,1.0,1,1.0,1,1.0,1,0.49152424801185673,59
3096,0,7808,7808,0,0,0,0,1.0,1,1.0,1,1.0,1,0.4961932620215909,60
3097,1,7809,7809,0,0,0,0,1.0,1,1.0,1,1.0,1,0.4961182994446283,60
3098,2,7811,7811,0,0,0,0,1.0,1,1.0,1,1.0,1,0.5286262078850327,58
3099,4,7815,7815,0,0,0,0,1.0,1,1.0,1,1.0,1,0.5253265509897401,57
3100,1,7816,7816,0,0,0,0,1.0,1,1.0,1,1.0,1,0.5375005604257136,57
3101,4,7820,7820,0,0,0,0,1.0,1,1.0,1,1.0,1,0.5525208980862641,58
3102,5,7825,7825,0,0,0,0,1.0,1,1.0,1,1.0,1,0.5789998080023129,59
3103,2,7827,7827,0,0,0,0,1.0,1,1.0,1,1.0,1,0.5935656544001539,58
3104,5,7832,7832,0,0,0,0,1.0,1,1.0,1,1.0,1,0.5823628158387122,58
3105,3,7835,7835,0,0,0,0,1.0,1,1.0,1,1.0,1,0.575345372529212,56
3106,6,7841,7841,0,0,0,0,1.0,1,1.0,1,1.0,1,0.5770120385950492,57
3107,7,7848,7848,0,0,0,0,1.0,1,1.0,1,1.0,1,0.5631335209971369,55
3108,5,7853,7853,0,0,0,0,1.0,1,1.0,1,1.0,1,0.5978926810916937,55
3109,9,7862,7862,0,0,0,0,1.0,1,1.0,1,1.0,1,0.5819799053170149,54
3110,9,7871,7871,0,0,0,0,1.0,1,1.0,1,1.0,1,0.5910579846607906,54
3111,11,7882,7882,0,0,0,0,1.0,1,1.0,1,1.0,1,0.5837450173842281,54
3112,6,7888,7888,0,0,0,0,1.0,1,1.0,1,1.0,1,0.5659831930402932,56
3113,9,7897,7897,0,0,0,0,1.0,1,1.0,1,1.0,1,0.551706858310274,55
3114,6,7903,7903,0,0,0,0,1.0,1,1.0,1,1.0,1,0.5173309725777722,54
3115,1,7904,7904,0,0,0,0,1.0,1,1.0,1,1.0,1,0.49972319344153276,56
3116,1,7905,7905,0,0,0,0,1.0,1,1.0,1,1.0,1,0.5067167631745654,56
3117,2,7907,7907,0,0,0,0,1.0,1,1.0,1,1.0,1,0.49709843635202744,58
3118,0,7907,7907,0,0,0,0,1.0,1,1.0,1,1.0,1,0.5037601494628894,57
3119,2,7909,7909,0,0,0,0,1.0,1,1.0,1,1.0,1,0.5005643284717943,57
3120,1,7910,7910,0,0,0,0,1.0,1,1.0,1,1.0,1,0.49367229133793,56
3121,3,7913,7913,0,0,0,0,1.0,1,1.0,1,1.0,1,0.5167180612759525,57
3122,2,7915,7915,0,0,0,0,1.0,1,1.0,1,1.0,1,0.49908194538935025,57
3123,5,7920,7920,0,0,0,0,1.0,1,1.0,1,1.0,1,0.4908278827243908,57
3124,3,7923,7923,0,0,0,0,1.0,1,1.0,1,1.0,1,0.47413550928481013,59
3125,0,7923,7923,0,0,0,0,1.0,1,1.0,1,1.0,1,0.47857046072028037,61
3126,2,7925,7925,0,0,0,0,1.0,1,1.0,1,1.0,1,0.4947582897149074,60
3127,1,7926,7926,0,0,0,0,1.0,1,1.0,1,1.0,1,0.46728514856758496,58
3128,0,7926,7926,0,0,0,0,1.0,1,1.0,1,1.0,1,0.462823018575071,58
3129,3,7929,7929,0,0,0,0,1.0,1,1.0,1,1.0,1,0.4763913616118176,56
3130,0,7929,7929,0,0,0,0,1.0,1,1.0,1,1.0,1,0.4635663259231539,56
3131,3,7932,7932,0,0,0,0,1.0,1,1.0,1,1.0,1,0.5082052843821357,55
3132,2,7934,7934,0,0,0,0,1.0,1,1.0,1,1.0,1,0.5382424128370621,53
3133,5,7939,7939,0,0,0,0,1.0,1,1.0,1,1.0,1,0.5855779408440303,52
3134,6,7945,7945,0,0,0,0,1.0,1,1.0,1,1.0,1,0.5522477228759886,52
3135,3,7948,7948,0,0,0,0,1.0,1,1.0,1,1.0,1,0.6084170717168129,53
3136,8,7956,7956,0,0,0,0,1.0,1,1.0,1,1.0,1,0.5796114471879268,54
3137,5,7961,7961,0,0,0,0,1.0,1,1.0,1,1.0,1,0.5638661408897141,55
3138,7,7968,7968,0,0,0,0,1.0,1,1.0,1,1.0,1,0.5664101359963106,57
3139,5,7973,7973,0,0,0,0,1.0,1,1.0,1,1.0,1,0.5514436917105859,56
3140,6,7979,7979,0,0,0,0,1.0,1,1.0,1,1.0,1,0.5413026466641145,56
3141,4,7983,7983,0,0,0,0,1.0,1,1.0,1,1.0,1,0.5558138045575657,56
3142,5,7988,7988,0,0,0,0,1.0,1,1.0,1,1.0,1,0.5632711566901215,56
3143,0,7988,7988,0,0,0,0,1.0,1,1.0,1,1.0,1,0.5632711566901215,56
3144,3,7991,7991,0,0,0,0,1.0,1,1.0,1,1.0,1,0.5667327507307793,54
3145,1,7992,7992,0,0,0,0,1.0,1,1.0,1,1.0,1,0.5790504491949676,55
3146,2,7994,7994,0,0,0,0,1.0,1,1.0,1,1.0,1,0.5844367778797946,53
3147,1,7995,7995,0,0,0,0,1.0,1,1.0,1,1.0,1,0.5743420858890333,54
3148,1,7996,7996,0,0,0,0,1.0,1,1.0,1,1.0,1,0.5651362813866615,54
3149,2,7998,7998,0,0,0,0,1.0,1,1.0,1,1.0,1,0.5577272028719988,53
3150,4,8002,8002,0,0,0,0,1.0,1,1.0,1,1.0,1,0.5740762987754149,53
3151,4,8006,8006,0,0,0,0,1.0,1,1.0,1,1.0,1,0.59307023327967,53
3152,4,8010,8010,0,0,0,0,1.0,1,1.0,1,1.0,1,0.5825274187236426,54
3153,3,8013,8013,0,0,0,0,1.0,1,1.0,1,1.0,1,0.5993992337519298,53
3154,0,8013,8013,0,0,0,0,1.0,1,1.0,1,1.0,1,0.5956502402222186,55
3155,1,8014,8014,0,0,0,0,1.0,1,1.0,1,1.0,1,0.5971173680541965,56
3156,3,8017,8017,0,0,0,0,1.0,1,1.0,1,1.0,1,0.620893103283393,56
3157,3,8020,8020,0,0,0,0,1.0,1,1.0,1,1.0,1,0.6078381434922479,56
3158,2,8022,8022,0,0,0,0,1.0,1,1.0,1,1.0,1,0.6257488514328313,57
3159,1,8023,8023,0,0,0,0,1.0,1,1.0,1,1.0,1,0.608583971159211,56
3160,1,8024,8024,0,0,0,0,1.0,1,1.0,1,1.0,1,0.6253255195070946,58
3161,3,8027,8027,0,0,0,0,1.0,1,1.0,1,1.0,1,0.6382329972689325,59
3162,1,8028,8028,0,0,0,0,1.0,1,1.0,1,1.0,1,0.6492039978319611,59
3163,2,8030,8030,0,0,0,0,1.0,1,1.0,1,1.0,1,0.6434972370434558,59
3164,1,8031,8031,0,0,0,0,1.0,1,1.0,1,1.0,1,0.6322399072458502,60
3165,3,8034,8034,0,0,0,0,1.0,1,1.0,1,1.0,1,0.6285883831161273,58
3166,2,8036,8036,0,0,0,0,1.0,1,1.0,1,1.0,1,0.6267942465963554,59
3167,2,8038,8038,0,0,0,0,1.0,1,1.0,1,1.0,1,0.6452560579790501,57
3168,2,8040,8040,0,0,0,0,1.0,1,1.0,1,1.0,1,0.6111695550660563,58
3169,3,8043,8043,0,0,0,0,1.0,1,1.0,1,1.0,1,0.6358491494018716,57
3170,2,8045,8045,0,0,0,0,1.0,1,1.0,1,1.0,1,0.6394404603902486,55
3171,4,8049,8049,0,0,0,0,1.0,1,1.0,1,1.0,1,0.5987316067744062,56
3172,2,8051,8051,0,0,0,0,1.0,1,1.0,1,1.0,1,0.6196731163628463,54
3173,5,8056,8056,0,0,0,0,1.0,1,1.0,1,1.0,1,0.5870562213867296,53
3174,2,8058,8058,0,0,0,0,1.0,1,1.0,1,1.0,1,0.571445348370525,53
3175,5,8063,8063,0,0,0,0,1.0,1,1.0,1,1.0,1,0.5623228797788992,52
3176,1,8064,8064,0,0,0,0,1.0,1,1.0,1,1.0,1,0.5458535882393515,53
3177,2,8066,8066,0,0,0,0,1.0,1,1.0,1,1.0,1,0.5194345987636902,52
3178,3,8069,8069,0,0,0,0,1.0,1,1.0,1,1.0,1,0.5288898561117938,53
3179,4,8073,8073,0,0,0,0,1.0,1,1.0,1,1.0,1,0.4743820763234315,54
3180,2,8075,8075,0,0,0,0,1.0,1,1.0,1,1.0,1,0.48961869179728873,54
3181,5,8080,8080,0,0,0,0,1.0,1,1.0,1,1.0,1,0.4909047212773042,55
3182,3,8083,8083,0,0,0,0,1.0,1,1.0,1,1.0,1,0.5093148379854983,54
3183,3,8086,8086,0,0,0,0,1.0,1,1.0,1,1.0,1,0.5170218767675481,56
3184,7,8093,8093,0,0,0,0,1.0,1,1.0,1,1.0,1,0.5775817135298833,54
3185,2,8095,8095,0,0,0,0,1.0,1,1.0,1,1.0,1,0.5960422397903703,53
3186,4,8099,8099,0,0,0,0,1.0,1,1.0,1,1.0,1,0.6328135604052821,52
3187,2,8101,8101,0,0,0,0,1.0,1,1.0,1,1.0,1,0.6556394653410399,50
3188,3,8104,8104,0,0,0,0,1.0,1,1.0,1,1.0,1,0.6557755050727396,50
3189,3,8107,8107,0,0,0,0,1.0,1,1.0,1,1.0,1,0.6771142751783689,49
3190,0,8107,8107,0,0,0,0,1.0,1,1.0,1,1.0,1,0.6826166088491692,50
3191,0,8107,8107,0,0,0,0,1.0,1,1.0,1,1.0,1,0.6862753751891528,49
3192,0,8107,8107,0,0,0,0,1.0,1,1.0,1,1.0,1,0.6862753751891528,49
3193,1,8108,8108,0,0,0,0,1.0,1,1.0,1,1.0,1,0.6985590927727465,49
3194,0,8108,8108,0,0,0,0,1.0,1,1.0,1,1.0,1,0.7024307923053539,50
3195,2,8110,8110,0,0,0,0,1.0,1,1.0,1,1.0,1,0.7187456812316405,49
3196,6,8116,8116,0,0,0,0,1.0,1,1.0,1,1.0,1,0.7186097273963691,49
3197,1,8117,8117,0,0,0,0,1.0,1,1.0,1,1.0,1,0.7069224845394667,50
3198,5,8122,8122,0,0,0,0,1.0,1,1.0,1,1.0,1,0.6787777831172481,50
3199,8,8130,8130,0,0,0,0,1.0,1,1.0,1,1.0,1,0.675256600206545,52
3200,3,8133,8133,0,0,0,0,1.0,1,1.0,1,1.0,1,0.6614842071646577,53
3201,3,8136,8136,0,0,0,0,1.0,1,1.0,1,1.0,1,0.6569734489499605,55
3202,5,8141,8141,0,0,0,0,1.0,1,1.0,1,1.0,1,0.6588070107004593,55
3203,1,8142,8142,0,0,0,0,1.0,1,1.0,1,1.0,1,0.6468786153588649,53
3204,1,8143,8143,0,0,0,0,1.0,1,1.0,1,1.0,1,0.6476489110551729,53
3205,3,8146,8146,0,0,0,0,1.0,1,1.0,1,1.0,1,0.6389991015507444,53
3206,0,8146,8146,0,0,0,0,1.0,1,1.0,1,1.0,1,0.63149203854037,52
3207,1,8147,8147,0,0,0,0,1.0,1,1.0,1,1.0,1,0.6150478386021352,53
3208,1,8148,8148,0,0,0,0,1.0,1,1.0,1,1.0,1,0.6212466166510728,51
3209,2,8150,8150,0,0,0,0,1.0,1,1.0,1,1.0,1,0.6436893231243191,52
3210,1,8151,8151,0,0,0,0,1.0,1,1.0,1,1.0,1,0.6412846345791788,49
3211,2,8153,8153,0,0,0,0,1.0,1,1.0,1,1.0,1,0.675321110808324,48
3212,0,8153,8153,0,0,0,0,1.0,1,1.0,1,1.0,1,0.6765832328663997,48
3213,4,8157,8157,0,0,0,0,1.0,1,1.0,1,1.0,1,0.6604508776373781,49
3214,2,8159,8159,0,0,0,0,1.0,1,1.0,1,1.0,1,0.6453272348846563,51
3215,1,8160,8160,0,0,0,0,1.0,1,1.0,1,1.0,1,0.634602004914234,51
3216,2,8162,8162,0,0,0,0,1.0,1,1.0,1,1.0,1,0.6084167280074714,51
3217,0,8162,8162,0,0,0,0,1.0,1,1.0,1,1.0,1,0.6084167280074714,51
3218,0,8162,8162,0,0,0,0,1.0,1,1.0,1,1.0,1,0.6084167280074714,51
3219,1,8163,8163,0,0,0,0,1.0,1,1.0,1,1.0,1,0.6280761498526334,52
3220,1,8164,8164,0,0,0,0,1.0,1,1.0,1,1.0,1,0.6499946565639393,52
3221,0,8164,8164,0,0,0,0,1.0,1,1.0,1,1.0,1,0.6399319365186984,54
3222,1,8165,8165,0,0,0,0,1.0,1,1.0,1,1.0,1,0.6365967316428685,54
3223,0,8165,8165,0,0,0,0,1.0,1,1.0,1,1.0,1,0.6345564401355697,56
3224,1,8166,8166,0,0,0,0,1.0,1,1.0,1,1.0,1,0.6458518832973439,57
3225,0,8166,8166,0,0,0,0,1.0,1,1.0,1,1.0,1,0.6416535731819719,58
3226,0,8166,8166,0,0,0,0,1.0,1,1.0,1,1.0,1,0.6416535731819719,58
3227,4,8170,8170,0,0,0,0,1.0,1,1.0,1,1.0,1,0.6541220340059017,58
3228,1,8171,8171,0,0,0,0,1.0,1,1.0,1,1.0,1,0.6457001118773051,58
3229,2,8173,8173,0,0,0,0,1.0,1,1.0,1,1.0,1,0.6322300142384004,60
3230,0,8173,8173,0,0,0,0,1.0,1,1.0,1,1.0,1,0.6273904517197008,61
3231,2,8175,8175,0,0,0,0,1.0,1,1.0,1,1.0,1,0.6402020660953593,61
3232,0,8175,8175,0,0,0,0,1.0,1,1.0,1,1.0,1,0.6402020660953593,61
3233,1,8176,8176,0,0,0,0,1.0,1,1.0,1,1.0,1,0.639145248329859,63
3234,0,8176,8176,0,0,0,0,1.0,1,1.0,1,1.0,1,0.6369156906995177,64
3235,1,8177,8177,0,0,0,0,1.0,1,1.0,1,1.0,1,0.6392909353612612,65
3236,0,8177,8177,0,0,0,0,1.0,1,1.0,1,1.0,1,0.6419959087371797,66
3237,3,8180,8180,0,0,0,0,1.0,1,1.0,1,1.0,1,0.6505709950019389,67
3238,1,8181,8181,0,0,0,0,1.0,1,1.0,1,1.0,1,0.6592755193622071,67
3239,1,8182,8182,0,0,0,0,1.0,1,1.0,1,1.0,1,0.6635125356893162,69
3240,1,8183,8183,0,0,0,0,1.0,1,1.0,1,1.0,1,0.657135172379157,69
3241,2,8185,8185,0,0,0,0,1.0,1,1.0,1,1.0,1,0.6415625713392024,68
3242,1,8186,8186,0,0,0,0,1.0,1,1.0,1,1.0,1,0.6287322935804364,67
3243,3,8189,8189,0,0,0,0,1.0,1,1.0,1,1.0,1,0.6433060388658437,68
3244,2,8191,8191,0,0,0,0,1.0,1,1.0,1,1.0,1,0.6327857102566687,68
3245,0,8191,8191,0,0,0,0,1.0,1,1.0,1,1.0,1,0.633418101336434,69
3246,1,8192,8192,0,0,0,0,1.0,1,1.0,1,1.0,1,0.6295657948778505,68
3247,0,8192,8192,0,0,0,0,1.0,1,1.0,1,1.0,1,0.6295657948778505,68
3248,2,8194,8194,0,0,0,0,1.0,1,1.0,1,1.0,1,0.627495663645496,68
3249,2,8196,8196,0,0,0,0,1.0,1,1.0,1,1.0,1,0.6500671060600224,69
3250,2,8198,8198,0,0,0,0,1.0,1,1.0,1,1.0,1,0.6404269388042506,69
3251,0,8198,8198,0,0,0,0,1.0,1,1.0,1,1.0,1,0.6448322292508228,68
3252,2,8200,8200,0,0,0,0,1.0,1,1.0,1,1.0,1,0.6127196383165524,68
3253,1,8201,8201,0,0,0,0,1.0,1,1.0,1,1.0,1,0.6208611802523768,69
3254,2,8203,8203,0,0,0,0,1.0,1,1.0,1,1.0,1,0.6016875888471557,69
3255,5,8208,8208,0,0,0,0,1.0,1,1.0,1,1.0,1,0.6090749046961358,70
3256,2,8210,8210,0,0,0,0,1.0,1,1.0,1,1.0,1,0.5999821590143075,70
3257,5,8215,8215,0,0,0,0,1.0,1,1.0,1,1.0,1,0.5917816364084222,71
3258,7,8222,8222,0,0,0,0,1.0,1,1.0,1,1.0,1,0.569998940678265,72
3259,7,8229,8229,0,0,0,0,1.0,1,1.0,1,1.0,1,0.565381143532625,71
3260,6,8235,8235,0,0,0,0,1.0,1,1.0,1,1.0,1,0.569976804931482,72
3261,4,8239,8239,0,0,0,0,1.0,1,1.0,1,1.0,1,0.5725939340139328,74
3262,8,8247,8247,0,0,0,0,1.0,1,1.0,1,1.0,1,0.605612441288277,73
3263,3,8250,8250,0,0,0,0,1.0,1,1.0,1,1.0,1,0.6025706453817143,73
3264,3,8253,8253,0,0,0,0,1.0,1,1.0,1,1.0,1,0.6330353294899469,71
3265,4,8257,8257,0,0,0,0,1.0,1,1.0,1,1.0,1,0.6419516927790305,70
3266,5,8262,8262,0,0,0,0,1.0,1,1.0,1,1.0,1,0.6672932206892485,69
3267,4,8266,8266,0,0,0,0,1.0,1,1.0,1,1.0,1,0.645141005656025,69
3268,2,8268,8268,0,0,0,0,1.0,1,1.0,1,1.0,1,0.6544927305632589,68
3269,2,8270,8270,0,0,0,0,1.0,1,1.0,1,1.0,1,0.666975162656509,68
3270,0,8270,8270,0,0,0,0,1.0,1,1.0,1,1.0,1,0.6746339661663828,67
3271,2,8272,8272,0,0,0,0,1.0,1,1.0,1,1.0,1,0.6701890928514103,66
3272,2,8274,8274,0,0,0,0,1.0,1,1.0,1,1.0,1,0.6739983506439767,67
3273,3,8277,8277,0,0,0,0,1.0,1,1.0,1,1.0,1,0.6805914778066882,66
3274,3,8280,8280,0,0,0,0,1.0,1,1.0,1,1.0,1,0.6626563773984475,68
3275,2,8282,8282,0,0,0,0,1.0,1,1.0,1,1.0,1,0.6574557181074281,68
3276,1,8283,8283,0,0,0,0,1.0,1,1.0,1,1.0,1,0.6532706447228498,69
3277,4,8287,8287,0,0,0,0,1.0,1,1.0,1,1.0,1,0.6445102650484977,68
3278,3,8290,8290,0,0,0,0,1.0,1,1.0,1,1.0,1,0.6477445640424865,69
3279,5,8295,8295,0,0,0,0,1.0,1,1.0,1,1.0,1,0.6480847146560296,67
3280,0,8295,8295,0,0,0,0,1.0,1,1.0,1,1.0,1,0.645572754298988,66
3281,3,8298,8298,0,0,0,0,1.0,1,1.0,1,1.0,1,0.6416338374771512,67
3282,1,8299,8299,0,0,0,0,1.0,1,1.0,1,1.0,1,0.6365358770036287,66
3283,2,8301,8301,0,0,0,0,1.0,1,1.0,1,1.0,1,0.6314230012266149,67
3284,1,8302,8302,0,0,0,0,1.0,1,1.0,1,1.0,1,0.6118022945174025,66
3285,3,8305,8305,0,0,0,0,1.0,1,1.0,1,1.0,1,0.6040756699339872,66
3286,3,8308,8308,0,0,0,0,1.0,1,1.0,1,1.0,1,0.5872740471994969,63
3287,1,8309,8309,0,0,0,0,1.0,1,1.0,1,1.0,1,0.5947319865250671,61
3288,0,8309,8309,0,0,0,0,1.0,1,1.0,1,1.0,1,0.5900245722042525,63
3289,7,8316,8316,0,0,0,0,1.0,1,1.0,1,1.0,1,0.6187997739628117,62
3290,0,8316,8316,0,0,0,0,1.0,1,1.0,1,1.0,1,0.6073620956731461,63
3291,5,8321,8321,0,0,0,0,1.0,1,1.0,1,1.0,1,0.6373709113185552,62
3292,1,8322,8322,0,0,0,0,1.0,1,1.0,1,1.0,1,0.6361278190604089,63
3293,1,8323,8323,0,0,0,0,1.0,1,1.0,1,1.0,1,0.6459858494803097,65
3294,3,8326,8326,0,0,0,0,1.0,1,1.0,1,1.0,1,0.641154980232098,65
3295,2,8328,8328,0,0,0,0,1.0,1,1.0,1,1.0,1,0.6554197913012039,65
3296,2,8330,8330,0,0,0,0,1.0,1,1.0,1,1.0,1,0.6486512567175453,65
3297,3,8333,8333,0,0,0,0,1.0,1,1.0,1,1.0,1,0.6412585497592279,66
3298,3,8336,8336,0,0,0,0,1.0,1,1.0,1,1.0,1,0.6484546029563705,66
3299,5,8341,8341,0,0,0,0,1.0,1,1.0,1,1.0,1,0.6529696586578587,67
3300,3,8344,8344,0,0,0,0,1.0,1,1.0,1,1.0,1,0.6468907295782348,67
3301,4,8348,8348,0,0,0,0,1.0,1,1.0,1,1.0,1,0.6450638252093016,68
3302,2,8350,8350,0,0,0,0,1.0,1,1.0,1,1.0,1,0.6527413979900561,67
3303,1,8351,8351,0,0,0,0,1.0,1,1.0,1,1.0,1,0.6551682585525407,67
3304,1,8352,8352,0,0,0,0,1.0,1,1.0,1,1.0,1,0.6582026361535067,67
3305,2,8354,8354,0,0,0,0,1.0,1,1.0,1,1.0,1,0.6733767253412322,69
3306,0,8354,8354,0,0,0,0,1.0,1,1.0,1,1.0,1,0.6651876575174195,70
3307,1,8355,8355,0,0,0,0,1.0,1,1.0,1,1.0,1,0.6607442801699762,70
3308,2,8357,8357,0,0,0,0,1.0,1,1.0,1,1.0,1,0.6519568601995704,70
3309,3,8360,8360,0,0,0,0,1.0,1,1.0,1,1.0,1,0.660871066712651,72
3310,1,8361,8361,0,0,0,0,1.0,1,1.0,1,1.0,1,0.6637123419616583,74
3311,1,8362,8362,0,0,0,0,1.0,1,1.0,1,1.0,1,0.6530074444668028,74
3312,2,8364,8364,0,0,0,0,1.0,1,1.0,1,1.0,1,0.6605171730993807,74
3313,3,8367,8367,0,0,0,0,1.0,1,1.0,1,1.0,1,0.6454027378731699,75
3314,1,8368,8368,0,0,0,0,1.0,1,1.0,1,1.0,1,0.6426053169230029,76
3315,2,8370,8370,0,0,0,0,1.0,1,1.0,1,1.0,1,0.6490556540130782,75
3316,6,8376,8376,0,0,0,0,1.0,1,1.0,1,1.0,1,0.6371641903599007,76
3317,3,8379,8379,0,0,0,0,1.0,1,1.0,1,1.0,1,0.6525259392000312,73
3318,1,8380,8380,0,0,0,0,1.0,1,1.0,1,1.0,1,0.6550471651100913,72
3319,5,8385,8385,0,0,0,0,1.0,1,1.0,1,1.0,1,0.6647133866234259,71
3320,1,8386,8386,0,0,0,0,1.0,1,1.0,1,1.0,1,0.6680642784192744,70
3321,6,8392,8392,0,0,0,0,1.0,1,1.0,1,1.0,1,0.6551110308530858,69
3322,1,8393,8393,0,0,0,0,1.0,1,1.0,1,1.0,1,0.6473957899348397,68
3323,2,8395,8395,0,0,0,0,1.0,1,1.0,1,1.0,1,0.6491051899773451,69
3324,2,8397,8397,0,0,0,0,1.0,1,1.0,1,1.0,1,0.6344733718750026,69
3325,7,8404,8404,0,0,0,0,1.0,1,1.0,1,1.0,1,0.6369499550095414,70
3326,3,8407,8407,0,0,0,0,1.0,1,1.0,1,1.0,1,0.6123413952106446,69
3327,5,8412,8412,0,0,0,0,1.0,1,1.0,1,1.0,1,0.6047703300848893,70
3328,4,8416,8416,0,0,0,0,1.0,1,1.0,1,1.0,1,0.5923002582074361,73
3329,5,8421,8421,0,0,0,0,1.0,1,1.0,1,1.0,1,0.5969667008907702,72
3330,3,8424,8424,0,0,0,0,1.0,1,1.0,1,1.0,1,0.6065799205989623,72
3331,1,8425,8425,0,0,0,0,1.0,1,1.0,1,1.0,1,0.6001080911939852,72
3332,3,8428,8428,0,0,0,0,1.0,1,1.0,1,1.0,1,0.5999342992228079,73
3333,1,8429,8429,0,0,0,0,1.0,1,1.0,1,1.0,1,0.590476682797242,72
3334,2,8431,8431,0,0,0,0,1.0,1,1.0,1,1.0,1,0.5877619260443772,73
3335,2,8433,8433,0,0,0,0,1.0,1,1.0,1,1.0,1,0.5788547197864873,74
3336,3,8436,8436,0,0,0,0,1.0,1,1.0,1,1.0,1,0.5909145643726701,74
3337,2,8438,8438,0,0,0,0,1.0,1,1.0,1,1.0,1,0.5815087980005428,74
3338,6,8444,8444,0,0,0,0,1.0,1,1.0,1,1.0,1,0.6114179408525227,74
3339,4,8448,8448,0,0,0,0,1.0,1,1.0,1,1.0,1,0.5992870044929999,75
3340,1,8449,8449,0,0,0,0,1.0,1,1.0,1,1.0,1,0.599538957382342,75
3341,3,8452,8452,0,0,0,0,1.0,1,1.0,1,1.0,1,0.5958602817376878,76
3342,3,8455,8455,0,0,0,0,1.0,1,1.0,1,1.0,1,0.6164008984916908,76
3343,2,8457,8457,0,0,0,0,1.0,1,1.0,1,1.0,1,0.6167538389772631,75
3344,4,8461,8461,0,0,0,0,1.0,1,1.0,1,1.0,1,0.6293229778375327,75
3345,4,8465,8465,0,0,0,0,1.0,1,1.0,1,1.0,1,0.6488622896854319,72
3346,3,8468,8468,0,0,0,0,1.0,1,1.0,1,1.0,1,0.6419558247625476,73
3347,5,8473,8473,0,0,0,0,1.0,1,1.0,1,1.0,1,0.622832320603917,73
3348,2,8475,8475,0,0,0,0,1.0,1,1.0,1,1.0,1,0.6321116765915709,73
3349,5,8480,8480,0,0,0,0,1.0,1,1.0,1,1.0,1,0.6411697255917345,74
3350,0,8480,8480,0,0,0,0,1.0,1,1.0,1,1.0,1,0.6453940860843148,73
3351,3,8483,8483,0,0,0,0,1.0,1,1.0,1,1.0,1,0.6425782167508718,72
3352,4,8487,8487,0,0,0,0,1.0,1,1.0,1,1.0,1,0.6581971189304678,72
3353,2,8489,8489,0,0,0,0,1.0,1,1.0,1,1.0,1,0.6431914318113752,72
3354,4,8493,8493,0,0,0,0,1.0,1,1.0,1,1.0,1,0.633505742578084,70
3355,4,8497,8497,0,0,0,0,1.0,1,1.0,1,1.0,1,0.643339653567421,69
3356,6,8503,8503,0,0,0,0,1.0,1,1.0,1,1.0,1,0.6220073345260092,69
3357,4,8507,8507,0,0,0,0,1.0,1,1.0,1,1.0,1,0.632160794541132,68
3358,5,8512,8512,0,0,0,0,1.0,1,1.0,1,1.0,1,0.6170767750807225,68
3359,1,8513,8513,0,0,0,0,1.0,1,1.0,1,1.0,1,0.620567609839898,66
3360,3,8516,8516,0,0,0,0,1.0,1,1.0,1,1.0,1,0.6336800282622977,65
3361,1,8517,8517,0,0,0,0,1.0,1,1.0,1,1.0,1,0.6176883409722507,64
3362,1,8518,8518,0,0,0,0,1.0,1,1.0,1,1.0,1,0.609400276651226,64
3363,1,8519,8519,0,0,0,0,1.0,1,1.0,1,1.0,1,0.6158639585316839,65
3364,1,8520,8520,0,0,0,0,1.0,1,1.0,1,1.0,1,0.6033753245805408,66
3365,1,8521,8521,0,0,0,0,1.0,1,1.0,1,1.0,1,0.6004893125519631,68
3366,0,8521,8521,0,0,0,0,1.0,1,1.0,1,1.0,1,0.6007112110504013,66
3367,5,8526,8526,0,0,0,0,1.0,1,1.0,1,1.0,1,0.6279216585974436,68
3368,2,8528,8528,0,0,0,0,1.0,1,1.0,1,1.0,1,0.6176460215784717,68
3369,4,8532,8532,0,0,0,0,1.0,1,1.0,1,1.0,1,0.6506346136164913,69
3370,3,8535,8535,0,0,0,0,1.0,1,1.0,1,1.0,1,0.6321171729883972,71
3371,1,8536,8536,0,0,0,0,1.0,1,1.0,1,1.0,1,0.6384233212066991,71
3372,4,8540,8540,0,0,0,0,1.0,1,1.0,1,1.0,1,0.6165136887659892,71
3373,1,8541,8541,0,0,0,0,1.0,1,1.0,1,1.0,1,0.6103019773490316,72
3374,0,8541,8541,0,0,0,0,1.0,1,1.0,1,1.0,1,0.6034037364054653,72
3375,3,8544,8544,0,0,0,0,1.0,1,1.0,1,1.0,1,0.589121423740636,73
3376,0,8544,8544,0,0,0,0,1.0,1,1.0,1,1.0,1,0.583544438589729,75
3377,3,8547,8547,0,0,0,0,1.0,1,1.0,1,1.0,1,0.5632619801734797,77
3378,3,8550,8550,0,0,0,0,1.0,1,1.0,1,1.0,1,0.553598913301669,77
3379,4,8554,8554,0,0,0,0,1.0,1,1.0,1,1.0,1,0.5585827414358677,77
3380,5,8559,8559,0,0,0,0,1.0,1,1.0,1,1.0,1,0.5853495293277722,76
3381,4,8563,8563,0,0,0,0,1.0,1,1.0,1,1.0,1,0.5995323583054146,76
3382,6,8569,8569,0,0,0,0,1.0,1,1.0,1,1.0,1,0.591475685712691,78
3383,1,8570,8570,0,0,0,0,1.0,1,1.0,1,1.0,1,0.603912682070639,77
3384,5,8575,8575,0,0,0,0,1.0,1,1.0,1,1.0,1,0.5935047010093771,77
3385,4,8579,8579,0,0,0,0,1.0,1,1.0,1,1.0,1,0.6025239170842649,75
3386,1,8580,8580,0,0,0,0,1.0,1,1.0,1,1.0,1,0.6005522196616365,76
3387,1,8581,8581,0,0,0,0,1.0,1,1.0,1,1.0,1,0.6005047047563875,75
3388,4,8585,8585,0,0,0,0,1.0,1,1.0,1,1.0,1,0.6057909468505996,76
3389,1,8586,8586,0,0,0,0,1.0,1,1.0,1,1.0,1,0.6106675949068693,77
3390,2,8588,8588,0,0,0,0,1.0,1,1.0,1,1.0,1,0.6250570991974799,76
3391,0,8588,8588,0,0,0,0,1.0,1,1.0,1,1.0,1,0.6149356060231898,77
3392,0,8588,8588,0,0,0,0,1.0,1,1.0,1,1.0,1,0.6162729753942954,78
3393,1,8589,8589,0,0,0,0,1.0,1,1.0,1,1.0,1,0.6082775016513933,76
3394,3,8592,8592,0,0,0,0,1.0,1,1.0,1,1.0,1,0.6191353618508925,75
3395,0,8592,8592,0,0,0,0,1.0,1,1.0,1,1.0,1,0.6251688117048491,73
3396,2,8594,8594,0,0,0,0,1.0,1,1.0,1,1.0,1,0.643735470359809,73
3397,2,8596,8596,0,0,0,0,1.0,1,1.0,1,1.0,1,0.6314042371053291,74
3398,4,8600,8600,0,0,0,0,1.0,1,1.0,1,1.0,1,0.659525202232099,74
3399,2,8602,8602,0,0,0,0,1.0,1,1.0,1,1.0,1,0.6586466555733447,75
3400,4,8606,8606,0,0,0,0,1.0,1,1.0,1,1.0,1,0.6587601181501547,75
3401,2,8608,8608,0,0,0,0,1.0,1,1.0,1,1.0,1,0.6388631852364111,77
3402,0,8608,8608,0,0,0,0,1.0,1,1.0,1,1.0,1,0.6388631852364111,77
3403,2,8610,8610,0,0,0,0,1.0,1,1.0,1,1.0,1,0.6426683565187399,78
3404,2,8612,8612,0,0,0,0,1.0,1,1.0,1,1.0,1,0.6438005200918753,78
3405,2,8614,8614,0,0,0,0,1.0,1,1.0,1,1.0,1,0.6495499533075478,78
3406,1,8615,8615,0,0,0,0,1.0,1,1.0,1,1.0,1,0.6529425645695945,78
3407,2,8617,8617,0,0,0,0,1.0,1,1.0,1,1.0,1,0.6594273849492993,78
3408,0,8617,8617,0,0,0,0,1.0,1,1.0,1,1.0,1,0.6574432237546957,79
3409,0,8617,8617,0,0,0,0,1.0,1,1.0,1,1.0,1,0.6450087076434248,81
3410,0,8617,8617,0,0,0,0,1.0,1,1.0,1,1.0,1,0.6477733224814902,82
3411,2,8619,8619,0,0,0,0,1.0,1,1.0,1,1.0,1,0.6412845743572528,84
3412,1,8620,8620,0,0,0,0,1.0,1,1.0,1,1.0,1,0.6391179137926084,84
3413,3,8623,8623,0,0,0,0,1.0,1,1.0,1,1.0,1,0.6259122319465145,84
3414,3,8626,8626,0,0,0,0,1.0,1,1.0,1,1.0,1,0.6367549789806438,84
3415,3,8629,8629,0,0,0,0,1.0,1,1.0,1,1.0,1,0.6329935284306442,85
3416,2,8631,8631,0,0,0,0,1.0,1,1.0,1,1.0,1,0.6306693586171896,85
3417,3,8634,8634,0,0,0,0,1.0,1,1.0,1,1.0,1,0.6344094845087055,86
3418,2,8636,8636,0,0,0,0,1.0,1,1.0,1,1.0,1,0.6437718834445876,86
3419,3,8639,8639,0,0,0,0,1.0,1,1.0,1,1.0,1,0.6470148711192711,87
3420,3,8642,8642,0,0,0,0,1.0,1,1.0,1,1.0,1,0.6607239921996391,88
3421,4,8646,8646,0,0,0,0,1.0,1,1.0,1,1.0,1,0.6659695068390948,89
3422,1,8647,8647,0,0,0,0,1.0,1,1.0,1,1.0,1,0.6695725491730774,90
3423,2,8649,8649,0,0,0,0,1.0,1,1.0,1,1.0,1,0.6691293233776188,90
3424,1,8650,8650,0,0,0,0,1.0,1,1.0,1,1.0,1,0.6608624439608501,91
3425,0,8650,8650,0,0,0,0,1.0,1,1.0,1,1.0,1,0.6605914528119348,90
3426,1,8651,8651,0,0,0,0,1.0,1,1.0,1,1.0,1,0.6478693207276612,92
3427,1,8652,8652,0,0,0,0,1.0,1,1.0,1,1.0,1,0.6596373054518033,92
3428,3,8655,8655,0,0,0,0,1.0,1,1.0,1,1.0,1,0.6520062554910134,91
3429,3,8658,8658,0,0,0,0,1.0,1,1.0,1,1.0,1,0.6540141700480748,91
3430,3,8661,8661,0,0,0,0,1.0,1,1.0,1,1.0,1,0.6495850191510989,91
3431,2,8663,8663,0,0,0,0,1.0,1,1.0,1,1.0,1,0.6568429111108467,90
3432,3,8666,8666,0,0,0,0,1.0,1,1.0,1,1.0,1,0.6552318679549339,91
3433,1,8667,8667,0,0,0,0,1.0,1,1.0,1,1.0,1,0.6590545124700385,90
3434,1,8668,8668,0,0,0,0,1.0,1,1.0,1,1.0,1,0.6614792289760792,89
3435,1,8669,8669,0,0,0,0,1.0,1,1.0,1,1.0,1,0.6644027629042756,88
3436,1,8670,8670,0,0,0,0,1.0,1,1.0,1,1.0,1,0.6611346672992284,86
3437,1,8671,8671,0,0,0,0,1.0,1,1.0,1,1.0,1,0.6547093053130824,86
3438,1,8672,8672,0,0,0,0,1.0,1,1.0,1,1.0,1,0.647246176413529,87
3439,2,8674,8674,0,0,0,0,1.0,1,1.0,1,1.0,1,0.634363731586311,86
3440,1,8675,8675,0,0,0,0,1.0,1,1.0,1,1.0,1,0.632179902898856,86
3441,2,8677,8677,0,0,0,0,1.0,1,1.0,1,1.0,1,0.6302227842064493,85
3442,1,8678,8678,0,0,0,0,1.0,1,1.0,1,1.0,1,0.6279901952497254,85
3443,2,8680,8680,0,0,0,0,1.0,1,1.0,1,1.0,1,0.6132479979679095,85
3444,5,8685,8685,0,0,0,0,1.0,1,1.0,1,1.0,1,0.6208153314411295,85
3445,3,8688,8688,0,0,0,0,1.0,1,1.0,1,1.0,1,0.6205534880212294,84
3446,5,8693,8693,0,0,0,0,1.0,1,1.0,1,1.0,1,0.6286717106467375,85
3447,2,8695,8695,0,0,0,0,1.0,1,1.0,1,1.0,1,0.6310304027525556,85
3448,4,8699,8699,0,0,0,0,1.0,1,1.0,1,1.0,1,0.650553188355602,85
3449,1,8700,8700,0,0,0,0,1.0,1,1.0,1,1.0,1,0.665477168244286,84
3450,0,8700,8700,0,0,0,0,1.0,1,1.0,1,1.0,1,0.665477168244286,84
3451,4,8704,8704,0,0,0,0,1.0,1,1.0,1,1.0,1,0.6563950291704026,85
3452,3,8707,8707,0,0,0,0,1.0,1,1.0,1,1.0,1,0.6665990954345901,86
3453,4,8711,8711,0,0,0,0,1.0,1,1.0,1,1.0,1,0.6469777660685595,85
3454,3,8714,8714,0,0,0,0,1.0,1,1.0,1,1.0,1,0.6273581920048964,88
3455,1,8715,8715,0,0,0,0,1.0,1,1.0,1,1.0,1,0.6324225331198888,88
3456,0,8715,8715,0,0,0,0,1.0,1,1.0,1,1.0,1,0.6324225331198888,88
3457,4,8719,8719,0,0,0,0,1.0,1,1.0,1,1.0,1,0.6271915157420557,89
3458,2,8721,8721,0,0,0,0,1.0,1,1.0,1,1.0,1,0.6354166902590787,88
3459,4,8725,8725,0,0,0,0,1.0,1,1.0,1,1.0,1,0.6219089967779986,88
3460,5,8730,8730,0,0,0,0,1.0,1,1.0,1,1.0,1,0.6378007171170451,89
3461,2,8732,8732,0,0,0,0,1.0,1,1.0,1,1.0,1,0.6391594689868169,89
3462,1,8733,8733,0,0,0,0,1.0,1,1.0,1,1.0,1,0.6429752599135848,90
3463,5,8738,8738,0,0,0,0,1.0,1,1.0,1,1.0,1,0.6556219301385894,89
3464,0,8738,8738,0,0,0,0,1.0,1,1.0,1,1.0,1,0.6596889171496781,88
3465,2,8740,8740,0,0,0,0,1.0,1,1.0,1,1.0,1,0.6640296542652513,87
3466,1,8741,8741,0,0,0,0,1.0,1,1.0,1,1.0,1,0.6610301305062865,87
3467,2,8743,8743,0,0,0,0,1.0,1,1.0,1,1.0,1,0.648358830922515,87
3468,2,8745,8745,0,0,0,0,1.0,1,1.0,1,1.0,1,0.6460726502844184,88
3469,3,8748,8748,0,0,0,0,1.0,1,1.0,1,1.0,1,0.6340002347793128,85
3470,0,8748,8748,0,0,0,0,1.0,1,1.0,1,1.0,1,0.6342878320936721,86
3471,4,8752,8752,0,0,0,0,1.0,1,1.0,1,1.0,1,0.6367445357088525,84
3472,4,8756,8756,0,0,0,0,1.0,1,1.0,1,1.0,1,0.6363979666469031,83
3473,4,8760,8760,0,0,0,0,1.0,1,1.0,1,1.0,1,0.6390741940230906,81
3474,2,8762,8762,0,0,0,0,1.0,1,1.0,1,1.0,1,0.6235544508445472,80
3475,5,8767,8767,0,0,0,0,1.0,1,1.0,1,1.0,1,0.640213441434106,82
3476,0,8767,8767,0,0,0,0,1.0,1,1.0,1,1.0,1,0.6324793072843163,81
3477,4,8771,8771,0,0,0,0,1.0,1,1.0,1,1.0,1,0.6460122486454646,83
3478,4,8775,8775,0,0,0,0,1.0,1,1.0,1,1.0,1,0.6166872365801345,83
3479,3,8778,8778,0,0,0,0,1.0,1,1.0,1,1.0,1,0.6133848192076626,83
3480,3,8781,8781,0,0,0,0,1.0,1,1.0,1,1.0,1,0.6196335892595165,83
3481,8,8789,8789,0,0,0,0,1.0,1,1.0,1,1.0,1,0.6072188010890305,83
3482,7,8796,8796,0,0,0,0,1.0,1,1.0,1,1.0,1,0.6163852997322324,83
3483,2,8798,8798,0,0,0,0,1.0,1,1.0,1,1.0,1,0.6142176524598062,82
3484,4,8802,8802,0,0,0,0,1.0,1,1.0,1,1.0,1,0.6260358090847734,82
3485,2,8804,8804,0,0,0,0,1.0,1,1.0,1,1.0,1,0.6224986112519084,83
3486,1,8805,8805,0,0,0,0,1.0,1,1.0,1,1.0,1,0.6170014931835469,83
3487,1,8806,8806,0,0,0,0,1.0,1,1.0,1,1.0,1,0.6285759193682438,84
3488,1,8807,8807,0,0,0,0,1.0,1,1.0,1,1.0,1,0.6306550432550072,84
3489,0,8807,8807,0,0,0,0,1.0,1,1.0,1,1.0,1,0.6306550432550072,84
3490,1,8808,8808,0,0,0,0,1.0,1,1.0,1,1.0,1,0.6277309452668282,84
3491,3,8811,8811,0,0,0,0,1.0,1,1.0,1,1.0,1,0.6239080148910118,86
3492,0,8811,8811,0,0,0,0,1.0,1,1.0,1,1.0,1,0.6239080148910118,86
3493,2,8813,8813,0,0,0,0,1.0,1,1.0,1,1.0,1,0.6258602685975342,86
3494,2,8815,8815,0,0,0,0,1.0,1,1.0,1,1.0,1,0.6271510963623792,86
3495,2,8817,8817,0,0,0,0,1.0,1,1.0,1,1.0,1,0.611336172457404,87
3496,2,8819,8819,0,0,0,0,1.0,1,1.0,1,1.0,1,0.614493797936525,88
3497,1,8820,8820,0,0,0,0,1.0,1,1.0,1,1.0,1,0.6031490318735324,89
3498,3,8823,8823,0,0,0,0,1.0,1,1.0,1,1.0,1,0.6092743582069888,89
3499,4,8827,8827,0,0,0,0,1.0,1,1.0,1,1.0,1,0.591214927148228,91
3500,2,8829,8829,0,0,0,0,1.0,1,1.0,1,1.0,1,0.5967883743318579,90
3501,3,8832,8832,0,0,0,0,1.0,1,1.0,1,1.0,1,0.592954845456204,90
3502,4,8836,8836,0,0,0,0,1.0,1,1.0,1,1.0,1,0.5807363547604406,91
3503,6,8842,8842,0,0,0,0,1.0,1,1.0,1,1.0,1,0.574016272027067,91
3504,5,8847,8847,0,0,0,0,1.0,1,1.0,1,1.0,1,0.5868820219706105,89
3505,4,8851,8851,0,0,0,0,1.0,1,1.0,1,1.0,1,0.5954228713351137,87
3506,9,8860,8860,0,0,0,0,1.0,1,1.0,1,1.0,1,0.6063094328211158,87
3507,3,8863,8863,0,0,0,0,1.0,1,1.0,1,1.0,1,0.591897354428601,84
3508,7,8870,8870,0,0,0,0,1.0,1,1.0,1,1.0,1,0.6122733278269191,83
3509,3,8873,8873,0,0,0,0,1.0,1,1.0,1,1.0,1,0.6080824597469637,80
3510,4,8877,8877,0,0,0,0,1.0,1,1.0,1,1.0,1,0.6066922616708775,78
3511,2,8879,8879,0,0,0,0,1.0,1,1.0,1,1.0,1,0.6082455731539627,77
3512,3,8882,8882,0,0,0,0,1.0,1,1.0,1,1.0,1,0.6335537199809265,74
3513,2,8884,8884,0,0,0,0,1.0,1,1.0,1,1.0,1,0.6189442324181196,76
3514,1,8885,8885,0,0,0,0,1.0,1,1.0,1,1.0,1,0.6325497709214126,76
3515,3,8888,8888,0,0,0,0,1.0,1,1.0,1,1.0,1,0.6113911014592863,75
3516,1,8889,8889,0,0,0,0,1.0,1,1.0,1,1.0,1,0.6158896034189408,73
3517,2,8891,8891,0,0,0,0,1.0,1,1.0,1,1.0,1,0.5881272717788062,74
3518,1,8892,8892,0,0,0,0,1.0,1,1.0,1,1.0,1,0.5876694647427445,74
3519,4,8896,8896,0,0,0,0,1.0,1,1.0,1,1.0,1,0.6276133142748745,73
3520,1,8897,8897,0,0,0,0,1.0,1,1.0,1,1.0,1,0.6148862762552624,74
3521,0,8897,8897,0,0,0,0,1.0,1,1.0,1,1.0,1,0.6155885668553901,75
3522,2,8899,8899,0,0,0,0,1.0,1,1.0,1,1.0,1,0.6153007196992633,75
3523,3,8902,8902,0,0,0,0,1.0,1,1.0,1,1.0,1,0.6066342988758285,75
3524,2,8904,8904,0,0,0,0,1.0,1,1.0,1,1.0,1,0.5787931367562702,75
3525,2,8906,8906,0,0,0,0,1.0,1,1.0,1,1.0,1,0.5909273618178078,75
3526,3,8909,8909,0,0,0,0,1.0,1,1.0,1,1.0,1,0.5879142398897684,76
3527,3,8912,8912,0,0,0,0,1.0,1,1.0,1,1.0,1,0.5696321030947693,77
3528,2,8914,8914,0,0,0,0,1.0,1,1.0,1,1.0,1,0.5676262126479079,77
3529,4,8918,8918,0,0,0,0,1.0,1,1.0,1,1.0,1,0.5507144008690344,78
3530,2,8920,8920,0,0,0,0,1.0,1,1.0,1,1.0,1,0.5623490780465685,78
3531,7,8927,8927,0,0,0,0,1.0,1,1.0,1,1.0,1,0.5585302256887839,79
3532,2,8929,8929,0,0,0,0,1.0,1,1.0,1,1.0,1,0.5761375161203662,79
3533,2,8931,8931,0,0,0,0,1.0,1,1.0,1,1.0,1,0.5781963835777094,79
3534,1,8932,8932,0,0,0,0,1.0,1,1.0,1,1.0,1,0.5674021868620905,80
3535,2,8934,8934,0,0,0,0,1.0,1,1.0,1,1.0,1,0.5892694825801433,81
3536,3,8937,8937,0,0,0,0,1.0,1,1.0,1,1.0,1,0.5857532396877314,82
3537,0,8937,8937,0,0,0,0,1.0,1,1.0,1,1.0,1,0.5857532396877314,82
3538,3,8940,8940,0,0,0,0,1.0,1,1.0,1,1.0,1,0.6009195326078511,83
3539,3,8943,8943,0,0,0,0,1.0,1,1.0,1,1.0,1,0.5951113511591953,83
3540,1,8944,8944,0,0,0,0,1.0,1,1.0,1,1.0,1,0.5853558025889625,85
3541,1,8945,8945,0,0,0,0,1.0,1,1.0,1,1.0,1,0.5945336334965651,85
3542,2,8947,8947,0,0,0,0,1.0,1,1.0,1,1.0,1,0.5985456690062141,88
3543,1,8948,8948,0,0,0,0,1.0,1,1.0,1,1.0,1,0.5959339489369322,87
3544,3,8951,8951,0,0,0,0,1.0,1,1.0,1,1.0,1,0.5981321472035186,87
3545,4,8955,8955,0,0,0,0,1.0,1,1.0,1,1.0,1,0.6046423520176716,85
3546,1,8956,8956,0,0,0,0,1.0,1,1.0,1,1.0,1,0.6005881580939496,83
3547,5,8961,8961,0,0,0,0,1.0,1,1.0,1,1.0,1,0.5860049206214554,82
3548,0,8961,8961,0,0,0,0,1.0,1,1.0,1,1.0,1,0.5860049206214554,82
3549,2,8963,8963,0,0,0,0,1.0,1,1.0,1,1.0,1,0.5915103392384514,81
3550,2,8965,8965,0,0,0,0,1.0,1,1.0,1,1.0,1,0.6025030407520018,79
3551,1,8966,8966,0,0,0,0,1.0,1,1.0,1,1.0,1,0.6133710597227503,80
3552,1,8967,8967,0,0,0,0,1.0,1,1.0,1,1.0,1,0.6291389998304219,78
3553,2,8969,8969,0,0,0,0,1.0,1,1.0,1,1.0,1,0.6318605358590518,79
3554,4,8973,8973,0,0,0,0,1.0,1,1.0,1,1.0,1,0.6177354293147621,77
3555,2,8975,8975,0,0,0,0,1.0,1,1.0,1,1.0,1,0.617905836169372,77
3556,5,8980,8980,0,0,0,0,1.0,1,1.0,1,1.0,1,0.6241508986426503,76
3557,1,8981,8981,0,0,0,0,1.0,1,1.0,1,1.0,1,0.6210179644242887,76
3558,5,8986,8986,0,0,0,0,1.0,1,1.0,1,1.0,1,0.6000431935845508,76
3559,5,8991,8991,0,0,0,0,1.0,1,1.0,1,1.0,1,0.5797933327906059,76
3560,5,8996,8996,0,0,0,0,1.0,1,1.0,1,1.0,1,0.574003301822418,78
3561,4,9000,9000,0,0,0,0,1.0,1,1.0,1,1.0,1,0.5790200417842478,79
3562,5,9005,9005,0,0,0,0,1.0,1,1.0,1,1.0,1,0.5712194479397513,79
3563,6,9011,9011,0,0,0,0,1.0,1,1.0,1,1.0,1,0.5695502594099124,79
3564,6,9017,9017,0,0,0,0,1.0,1,1.0,1,1.0,1,0.5743065806319056,80
3565,8,9025,9025,0,0,0,0,1.0,1,1.0,1,1.0,1,0.5738396982763304,83
3566,1,9026,9026,0,0,0,0,1.0,1,1.0,1,1.0,1,0.574678312603709,84
3567,3,9029,9029,0,0,0,0,1.0,1,1.0,1,1.0,1,0.5858317748834059,84
3568,2,9031,9031,0,0,0,0,1.0,1,1.0,1,1.0,1,0.5803341895190329,84
3569,3,9034,9034,0,0,0,0,1.0,1,1.0,1,1.0,1,0.5855934526811397,84
3570,2,9036,9036,0,0,0,0,1.0,1,1.0,1,1.0,1,0.5890655125152604,87
3571,1,9037,9037,0,0,0,0,1.0,1,1.0,1,1.0,1,0.6015415380496788,86
3572,3,9040,9040,0,0,0,0,1.0,1,1.0,1,1.0,1,0.6002383696759099,87
3573,3,9043,9043,0,0,0,0,1.0,1,1.0,1,1.0,1,0.589477207515226,87
3574,2,9045,9045,0,0,0,0,1.0,1,1.0,1,1.0,1,0.5824053685818196,88
3575,5,9050,9050,0,0,0,0,1.0,1,1.0,1,1.0,1,0.5934352531926116,88
3576,3,9053,9053,0,0,0,0,1.0,1,1.0,1,1.0,1,0.5761869544501388,90
3577,1,9054,9054,0,0,0,0,1.0,1,1.0,1,1.0,1,0.5680127817149052,90
3578,0,9054,9054,0,0,0,0,1.0,1,1.0,1,1.0,1,0.5719866218251844,91
3579,4,9058,9058,0,0,0,0,1.0,1,1.0,1,1.0,1,0.573404781557521,91
3580,2,9060,9060,0,0,0,0,1.0,1,1.0,1,1.0,1,0.5988844939641187,91
3581,3,9063,9063,0,0,0,0,1.0,1,1.0,1,1.0,1,0.6002430629726024,91
3582,3,9066,9066,0,0,0,0,1.0,1,1.0,1,1.0,1,0.6001651337499577,92
3583,6,9072,9072,0,0,0,0,1.0,1,1.0,1,1.0,1,0.5967254139260317,88
3584,6,9078,9078,0,0,0,0,1.0,1,1.0,1,1.0,1,0.5891996966434432,87
3585,7,9085,9085,0,0,0,0,1.0,1,1.0,1,1.0,1,0.6149476086179152,84
3586,9,9094,9094,0,0,0,0,1.0,1,1.0,1,1.0,1,0.5932231886393938,83
3587,9,9103,9103,0,0,0,0,1.0,1,1.0,1,1.0,1,0.5843102861815197,82
3588,5,9108,9108,0,0,0,0,1.0,1,1.0,1,1.0,1,0.5941718667778801,81
3589,7,9115,9115,0,0,0,0,1.0,1,1.0,1,1.0,1,0.6031881517884456,80
3590,3,9118,9118,0,0,0,0,1.0,1,1.0,1,1.0,1,0.6130115669340322,78
3591,4,9122,9122,0,0,0,0,1.0,1,1.0,1,1.0,1,0.6058061787135827,77
3592,3,9125,9125,0,0,0,0,1.0,1,1.0,1,1.0,1,0.6205898367725862,75
3593,4,9129,9129,0,0,0,0,1.0,1,1.0,1,1.0,1,0.6076989247008162,76
3594,1,9130,9130,0,0,0,0,1.0,1,1.0,1,1.0,1,0.6234068163886963,74
3595,1,9131,9131,0,0,0,0,1.0,1,1.0,1,1.0,1,0.6179234168448949,74
3596,2,9133,9133,0,0,0,0,1.0,1,1.0,1,1.0,1,0.6192050819713723,73
3597,2,9135,9135,0,0,0,0,1.0,1,1.0,1,1.0,1,0.622636573202131,73
3598,0,9135,9135,0,0,0,0,1.0,1,1.0,1,1.0,1,0.622636573202131,73
3599,3,9138,9138,0,0,0,0,1.0,1,1.0,1,1.0,1,0.629409663500247,73
3600,2,9140,9140,0,0,0,0,1.0,1,1.0,1,1.0,1,0.6227590336003777,74
3601,5,9145,9145,0,0,0,0,1.0,1,1.0,1,1.0,1,0.6358677611725808,75
3602,1,9146,9146,0,0,0,0,1.0,1,1.0,1,1.0,1,0.6286494660371922,76
3603,7,9153,9153,0,0,0,0,1.0,1,1.0,1,1.0,1,0.6093180273405859,77
3604,3,9156,9156,0,0,0,0,1.0,1,1.0,1,1.0,1,0.6036834769893177,78
3605,3,9159,9159,0,0,0,0,1.0,1,1.0,1,1.0,1,0.5867444789474969,77
3606,2,9161,9161,0,0,0,0,1.0,1,1.0,1,1.0,1,0.5852825379836365,79
3607,2,9163,9163,0,0,0,0,1.0,1,1.0,1,1.0,1,0.5746977557145093,79
3608,5,9168,9168,0,0,0,0,1.0,1,1.0,1,1.0,1,0.5999915043535935,79
3609,3,9171,9171,0,0,0,0,1.0,1,1.0,1,1.0,1,0.5838568454169821,79
3610,2,9173,9173,0,0,0,0,1.0,1,1.0,1,1.0,1,0.5875623314946263,80
3611,7,9180,9180,0,0,0,0,1.0,1,1.0,1,1.0,1,0.5788218192998031,80
3612,1,9181,9181,0,0,0,0,1.0,1,1.0,1,1.0,1,0.5812373308564028,79
3613,4,9185,9185,0,0,0,0,1.0,1,1.0,1,1.0,1,0.5874047577127812,79
3614,3,9188,9188,0,0,0,0,1.0,1,1.0,1,1.0,1,0.5787332728450578,78
3615,2,9190,9190,0,0,0,0,1.0,1,1.0,1,1.0,1,0.5745642263059748,79
3616,3,9193,9193,0,0,0,0,1.0,1,1.0,1,1.0,1,0.5807668744524984,79
3617,3,9196,9196,0,0,0,0,1.0,1,1.0,1,1.0,1,0.5922135064089029,80
3618,0,9196,9196,0,0,0,0,1.0,1,1.0,1,1.0,1,0.6042552092272464,82
3619,4,9200,9200,0,0,0,0,1.0,1,1.0,1,1.0,1,0.5972239411891191,82
3620,2,9202,9202,0,0,0,0,1.0,1,1.0,1,1.0,1,0.5886508026716412,81
3621,3,9205,9205,0,0,0,0,1.0,1,1.0,1,1.0,1,0.6016376929278597,83
3622,4,9209,9209,0,0,0,0,1.0,1,1.0,1,1.0,1,0.606131187689493,81
3623,1,9210,9210,0,0,0,0,1.0,1,1.0,1,1.0,1,0.5990668771535256,81
3624,2,9212,9212,0,0,0,0,1.0,1,1.0,1,1.0,1,0.5895936541709049,79
3625,1,9213,9213,0,0,0,0,1.0,1,1.0,1,1.0,1,0.6005637731057877,80
3626,3,9216,9216,0,0,0,0,1.0,1,1.0,1,1.0,1,0.5845592627819423,78
3627,3,9219,9219,0,0,0,0,1.0,1,1.0,1,1.0,1,0.6024274423473066,78
3628,4,9223,9223,0,0,0,0,1.0,1,1.0,1,1.0,1,0.5699632358662828,77
3629,3,9226,9226,0,0,0,0,1.0,1,1.0,1,1.0,1,0.5688080369228398,76
3630,2,9228,9228,0,0,0,0,1.0,1,1.0,1,1.0,1,0.5775270645146717,77
3631,2,9230,9230,0,0,0,0,1.0,1,1.0,1,1.0,1,0.5894967263377601,75
3632,3,9233,9233,0,0,0,0,1.0,1,1.0,1,1.0,1,0.5946946724328155,74
3633,4,9237,9237,0,0,0,0,1.0,1,1.0,1,1.0,1,0.6007755583505525,75
3634,3,9240,9240,0,0,0,0,1.0,1,1.0,1,1.0,1,0.6017490871954074,74
3635,5,9245,9245,0,0,0,0,1.0,1,1.0,1,1.0,1,0.606882462986836,74
3636,4,9249,9249,0,0,0,0,1.0,1,1.0,1,1.0,1,0.6232939874137903,74
3637,4,9253,9253,0,0,0,0,1.0,1,1.0,1,1.0,1,0.6396181256538385,74
3638,1,9254,9254,0,0,0,0,1.0,1,1.0,1,1.0,1,0.6463575729719809,75
3639,2,9256,9256,0,0,0,0,1.0,1,1.0,1,1.0,1,0.6481057898324428,76
3640,1,9257,9257,0,0,0,0,1.0,1,1.0,1,1.0,1,0.6445904762475444,76
3641,3,9260,9260,0,0,0,0,1.0,1,1.0,1,1.0,1,0.6418480300472615,75
3642,0,9260,9260,0,0,0,0,1.0,1,1.0,1,1.0,1,0.6418480300472615,75
3643,1,9261,9261,0,0,0,0,1.0,1,1.0,1,1.0,1,0.6451833507411756,74
3644,1,9262,9262,0,0,0,0,1.0,1,1.0,1,1.0,1,0.6481044113921902,74
3645,1,9263,9263,0,0,0,0,1.0,1,1.0,1,1.0,1,0.6447236938680856,74
3646,3,9266,9266,0,0,0,0,1.0,1,1.0,1,1.0,1,0.6398916685320766,75
3647,2,9268,9268,0,0,0,0,1.0,1,1.0,1,1.0,1,0.6377658486224735,77
3648,2,9270,9270,0,0,0,0,1.0,1,1.0,1,1.0,1,0.6451642278540206,78
3649,0,9270,9270,0,0,0,0,1.0,1,1.0,1,1.0,1,0.6411016361376971,80
3650,1,9271,9271,0,0,0,0,1.0,1,1.0,1,1.0,1,0.6520073652795007,81
3651,1,9272,9272,0,0,0,0,1.0,1,1.0,1,1.0,1,0.6430304912109495,81
3652,1,9273,9273,0,0,0,0,1.0,1,1.0,1,1.0,1,0.6462330939353252,83
3653,3,9276,9276,0,0,0,0,1.0,1,1.0,1,1.0,1,0.6488450094677987,83
3654,0,9276,9276,0,0,0,0,1.0,1,1.0,1,1.0,1,0.6488450094677987,83
3655,0,9276,9276,0,0,0,0,1.0,1,1.0,1,1.0,1,0.6390627637208786,84
3656,0,9276,9276,0,0,0,0,1.0,1,1.0,1,1.0,1,0.6421318409767559,85
3657,0,9276,9276,0,0,0,0,1.0,1,1.0,1,1.0,1,0.6327866039280938,86
3658,2,9278,9278,0,0,0,0,1.0,1,1.0,1,1.0,1,0.6391658862502227,87
3659,2,9280,9280,0,0,0,0,1.0,1,1.0,1,1.0,1,0.6317380712566415,87
3660,3,9283,9283,0,0,0,0,1.0,1,1.0,1,1.0,1,0.6250416868272791,86
3661,6,9289,9289,0,0,0,0,1.0,1,1.0,1,1.0,1,0.6234355061752884,86
3662,5,9294,9294,0,0,0,0,1.0,1,1.0,1,1.0,1,0.6110810570986746,83
3663,6,9300,9300,0,0,0,0,1.0,1,1.0,1,1.0,1,0.6138382006538786,85
3664,7,9307,9307,0,0,0,0,1.0,1,1.0,1,1.0,1,0.6057928043470151,82
3665,5,9312,9312,0,0,0,0,1.0,1,1.0,1,1.0,1,0.6159023228838452,81
3666,6,9318,9318,0,0,0,0,1.0,1,1.0,1,1.0,1,0.6415924795130487,79
3667,3,9321,9321,0,0,0,0,1.0,1,1.0,1,1.0,1,0.6313729016075333,79
3668,2,9323,9323,0,0,0,0,1.0,1,1.0,1,1.0,1,0.6356411293780688,77
3669,3,9326,9326,0,0,0,0,1.0,1,1.0,1,1.0,1,0.6467667560637043,75
3670,5,9331,9331,0,0,0,0,1.0,1,1.0,1,1.0,1,0.6574892839700255,76
3671,2,9333,9333,0,0,0,0,1.0,1,1.0,1,1.0,1,0.6604027338175047,74
3672,2,9335,9335,0,0,0,0,1.0,1,1.0,1,1.0,1,0.6528478788880507,75
3673,4,9339,9339,0,0,0,0,1.0,1,1.0,1,1.0,1,0.6535853171994801,75
3674,1,9340,9340,0,0,0,0,1.0,1,1.0,1,1.0,1,0.6566085217720329,75
3675,0,9340,9340,0,0,0,0,1.0,1,1.0,1,1.0,1,0.6581750380853043,75
3676,0,9340,9340,0,0,0,0,1.0,1,1.0,1,1.0,1,0.6581750380853043,75
3677,2,9342,9342,0,0,0,0,1.0,1,1.0,1,1.0,1,0.6622003598342161,75
3678,0,9342,9342,0,0,0,0,1.0,1,1.0,1,1.0,1,0.6623111032534973,77
3679,1,9343,9343,0,0,0,0,1.0,1,1.0,1,1.0,1,0.6698828307727911,78
3680,1,9344,9344,0,0,0,0,1.0,1,1.0,1,1.0,1,0.6688380846021343,80
3681,0,9344,9344,0,0,0,0,1.0,1,1.0,1,1.0,1,0.6688049239048075,81
3682,1,9345,9345,0,0,0,0,1.0,1,1.0,1,1.0,1,0.6710702013020302,81
3683,0,9345,9345,0,0,0,0,1.0,1,1.0,1,1.0,1,0.6710702013020302,81
3684,0,9345,9345,0,0,0,0,1.0,1,1.0,1,1.0,1,0.6710702013020302,81
3685,0,9345,9345,0,0,0,0,1.0,1,1.0,1,1.0,1,0.6710702013020302,81
3686,0,9345,9345,0,0,0,0,1.0,1,1.0,1,1.0,1,0.6710702013020302,81
3687,1,9346,9346,0,0,0,0,1.0,1,1.0,1,1.0,1,0.6662282970581025,82
3688,0,9346,9346,0,0,0,0,1.0,1,1.0,1,1.0,1,0.668196004650904,84
3689,1,9347,9347,0,0,0,0,1.0,1,1.0,1,1.0,1,0.67323577158758,84
3690,0,9347,9347,0,0,0,0,1.0,1,1.0,1,1.0,1,0.6731437238729729,85
3691,1,9348,9348,0,0,0,0,1.0,1,1.0,1,1.0,1,0.6759187705479568,86
3692,2,9350,9350,0,0,0,0,1.0,1,1.0,1,1.0,1,0.6759854912360658,86
3693,1,9351,9351,0,0,0,0,1.0,1,1.0,1,1.0,1,0.6784524132476228,86
3694,2,9353,9353,0,0,0,0,1.0,1,1.0,1,1.0,1,0.6844878390469267,86
3695,1,9354,9354,0,0,0,0,1.0,1,1.0,1,1.0,1,0.6878802990160632,86
3696,1,9355,9355,0,0,0,0,1.0,1,1.0,1,1.0,1,0.6776116330952151,87
3697,2,9357,9357,0,0,0,0,1.0,1,1.0,1,1.0,1,0.685871766126401,85
3698,3,9360,9360,0,0,0,0,1.0,1,1.0,1,1.0,1,0.6822365038067127,85
3699,0,9360,9360,0,0,0,0,1.0,1,1.0,1,1.0,1,0.6744954400783413,85
3700,4,9364,9364,0,0,0,0,1.0,1,1.0,1,1.0,1,0.6789437437179817,84
3701,2,9366,9366,0,0,0,0,1.0,1,1.0,1,1.0,1,0.6801693660967721,85
3702,3,9369,9369,0,0,0,0,1.0,1,1.0,1,1.0,1,0.6714942888304861,85
3703,2,9371,9371,0,0,0,0,1.0,1,1.0,1,1.0,1,0.6775090583406477,85
3704,1,9372,9372,0,0,0,0,1.0,1,1.0,1,1.0,1,0.6843023735089157,85
3705,0,9372,9372,0,0,0,0,1.0,1,1.0,1,1.0,1,0.6792365540264863,86
3706,2,9374,9374,0,0,0,0,1.0,1,1.0,1,1.0,1,0.6762470261601846,86
3707,1,9375,9375,0,0,0,0,1.0,1,1.0,1,1.0,1,0.6777262288623742,85
3708,1,9376,9376,0,0,0,0,1.0,1,1.0,1,1.0,1,0.6728729751055235,84
3709,2,9378,9378,0,0,0,0,1.0,1,1.0,1,1.0,1,0.6753684744917273,85
3710,2,9380,9380,0,0,0,0,1.0,1,1.0,1,1.0,1,0.6644162725104688,84
3711,4,9384,9384,0,0,0,0,1.0,1,1.0,1,1.0,1,0.6566893757567568,85
3712,2,9386,9386,0,0,0,0,1.0,1,1.0,1,1.0,1,0.6540097661431817,85
3713,4,9390,9390,0,0,0,0,1.0,1,1.0,1,1.0,1,0.6522973671114671,85
3714,3,9393,9393,0,0,0,0,1.0,1,1.0,1,1.0,1,0.6358345076875409,85
3715,4,9397,9397,0,0,0,0,1.0,1,1.0,1,1.0,1,0.6293182965779575,85
3716,1,9398,9398,0,0,0,0,1.0,1,1.0,1,1.0,1,0.6304952494343404,84
3717,5,9403,9403,0,0,0,0,1.0,1,1.0,1,1.0,1,0.6045075660154862,86
3718,0,9403,9403,0,0,0,0,1.0,1,1.0,1,1.0,1,0.6145858379775186,85
3719,4,9407,9407,0,0,0,0,1.0,1,1.0,1,1.0,1,0.6340106997001772,84
3720,5,9412,9412,0,0,0,0,1.0,1,1.0,1,1.0,1,0.6548265962763331,84
3721,1,9413,9413,0,0,0,0,1.0,1,1.0,1,1.0,1,0.6553143036049969,85
3722,4,9417,9417,0,0,0,0,1.0,1,1.0,1,1.0,1,0.6503411611283745,85
3723,3,9420,9420,0,0,0,0,1.0,1,1.0,1,1.0,1,0.6591967866866202,85
3724,3,9423,9423,0,0,0,0,1.0,1,1.0,1,1.0,1,0.6341532527263714,86
3725,2,9425,9425,0,0,0,0,1.0,1,1.0,1,1.0,1,0.6258927594616076,86
3726,2,9427,9427,0,0,0,0,1.0,1,1.0,1,1.0,1,0.6276125755354452,86
3727,1,9428,9428,0,0,0,0,1.0,1,1.0,1,1.0,1,0.6340401748210092,86
3728,3,9431,9431,0,0,0,0,1.0,1,1.0,1,1.0,1,0.6533333671667121,86
3729,0,9431,9431,0,0,0,0,1.0,1,1.0,1,1.0,1,0.6533333671667121,86
3730,1,9432,9432,0,0,0,0,1.0,1,1.0,1,1.0,1,0.6657956649829876,85
3731,2,9434,9434,0,0,0,0,1.0,1,1.0,1,1.0,1,0.6796274647943996,86
3732,1,9435,9435,0,0,0,0,1.0,1,1.0,1,1.0,1,0.6661740096340579,87
3733,1,9436,9436,0,0,0,0,1.0,1,1.0,1,1.0,1,0.6746805577822664,87
3734,1,9437,9437,0,0,0,0,1.0,1,1.0,1,1.0,1,0.6798829884770197,87
3735,1,9438,9438,0,0,0,0,1.0,1,1.0,1,1.0,1,0.6848751998027007,86
3736,2,9440,9440,0,0,0,0,1.0,1,1.0,1,1.0,1,0.66266542059775,87
3737,0,9440,9440,0,0,0,0,1.0,1,1.0,1,1.0,1,0.6512316383991529,87
3738,4,9444,9444,0,0,0,0,1.0,1,1.0,1,1.0,1,0.6325702914281196,87
3739,3,9447,9447,0,0,0,0,1.0,1,1.0,1,1.0,1,0.6273385681854972,88
3740,3,9450,9450,0,0,0,0,1.0,1,1.0,1,1.0,1,0.6165069899415364,87
3741,2,9452,9452,0,0,0,0,1.0,1,1.0,1,1.0,1,0.6107888600879133,87
3742,7,9459,9459,0,0,0,0,1.0,1,1.0,1,1.0,1,0.6093218029816835,86
3743,1,9460,9460,0,0,0,0,1.0,1,1.0,1,1.0,1,0.6158774968354338,84
3744,5,9465,9465,0,0,0,0,1.0,1,1.0,1,1.0,1,0.6247644408255,83
3745,2,9467,9467,0,0,0,0,1.0,1,1.0,1,1.0,1,0.6195425289135168,83
3746,6,9473,9473,0,0,0,0,1.0,1,1.0,1,1.0,1,0.6289831977497607,83
3747,3,9476,9476,0,0,0,0,1.0,1,1.0,1,1.0,1,0.6324644440534162,81
3748,3,9479,9479,0,0,0,0,1.0,1,1.0,1,1.0,1,0.6318496864050354,81
3749,2,9481,9481,0,0,0,0,1.0,1,1.0,1,1.0,1,0.63788748195699,80
3750,2,9483,9483,0,0,0,0,1.0,1,1.0,1,1.0,1,0.6418494760375205,79
3751,2,9485,9485,0,0,0,0,1.0,1,1.0,1,1.0,1,0.6478089792020614,80
3752,4,9489,9489,0,0,0,0,1.0,1,1.0,1,1.0,1,0.653064589542313,80
3753,4,9493,9493,0,0,0,0,1.0,1,1.0,1,1.0,1,0.6577069595143723,81
3754,6,9499,9499,0,0,0,0,1.0,1,1.0,1,1.0,1,0.6671896296133173,81
3755,3,9502,9502,0,0,0,0,1.0,1,1.0,1,1.0,1,0.6688180227535131,80
3756,1,9503,9503,0,0,0,0,1.0,1,1.0,1,1.0,1,0.6806773705445283,79
3757,1,9504,9504,0,0,0,0,1.0,1,1.0,1,1.0,1,0.6885519409296531,80
3758,1,9505,9505,0,0,0,0,1.0,1,1.0,1,1.0,1,0.6916949176305509,79
3759,2,9507,9507,0,0,0,0,1.0,1,1.0,1,1.0,1,0.6992094702217119,79
3760,0,9507,9507,0,0,0,0,1.0,1,1.0,1,1.0,1,0.6992094702217119,79
3761,3,9510,9510,0,0,0,0,1.0,1,1.0,1,1.0,1,0.6984152815666775,78
3762,0,9510,9510,0,0,0,0,1.0,1,1.0,1,1.0,1,0.6917983887043045,80
3763,2,9512,9512,0,0,0,0,1.0,1,1.0,1,1.0,1,0.6839643497477621,80
3764,2,9514,9514,0,0,0,0,1.0,1,1.0,1,1.0,1,0.684175439571572,80
3765,4,9518,9518,0,0,0,0,1.0,1,1.0,1,1.0,1,0.6806897064146796,81
3766,2,9520,9520,0,0,0,0,1.0,1,1.0,1,1.0,1,0.6705569527374514,83
3767,3,9523,9523,0,0,0,0,1.0,1,1.0,1,1.0,1,0.6620515127788158,83
3768,1,9524,9524,0,0,0,0,1.0,1,1.0,1,1.0,1,0.6675085774450067,84
3769,4,9528,9528,0,0,0,0,1.0,1,1.0,1,1.0,1,0.6441152843981026,86
3770,3,9531,9531,0,0,0,0,1.0,1,1.0,1,1.0,1,0.6465716549805455,87
3771,3,9534,9534,0,0,0,0,1.0,1,1.0,1,1.0,1,0.6486223044346608,87
3772,3,9537,9537,0,0,0,0,1.0,1,1.0,1,1.0,1,0.6476492007817755,88
3773,5,9542,9542,0,0,0,0,1.0,1,1.0,1,1.0,1,0.647698231740935,85
3774,2,9544,9544,0,0,0,0,1.0,1,1.0,1,1.0,1,0.6488895470111101,85
3775,3,9547,9547,0,0,0,0,1.0,1,1.0,1,1.0,1,0.6662009046495839,83
3776,2,9549,9549,0,0,0,0,1.0,1,1.0,1,1.0,1,0.6696950182685601,82
3777,3,9552,9552,0,0,0,0,1.0,1,1.0,1,1.0,1,0.6649869904003979,81
3778,3,9555,9555,0,0,0,0,1.0,1,1.0,1,1.0,1,0.6646014330298341,81
3779,4,9559,9559,0,0,0,0,1.0,1,1.0,1,1.0,1,0.6470714023036724,80
3780,3,9562,9562,0,0,0,0,1.0,1,1.0,1,1.0,1,0.6409868331116021,80
3781,6,9568,9568,0,0,0,0,1.0,1,1.0,1,1.0,1,0.646297053781544,80
3782,3,9571,9571,0,0,0,0,1.0,1,1.0,1,1.0,1,0.6578156960471114,80
3783,4,9575,9575,0,0,0,0,1.0,1,1.0,1,1.0,1,0.6499389078011462,80
3784,3,9578,9578,0,0,0,0,1.0,1,1.0,1,1.0,1,0.6681679399531633,79
3785,3,9581,9581,0,0,0,0,1.0,1,1.0,1,1.0,1,0.6898280632255315,77
3786,2,9583,9583,0,0,0,0,1.0,1,1.0,1,1.0,1,0.6775564430849628,78
3787,4,9587,9587,0,0,0,0,1.0,1,1.0,1,1.0,1,0.6762251403022861,77
3788,5,9592,9592,0,0,0,0,1.0,1,1.0,1,1.0,1,0.6677435228570775,78
3789,1,9593,9593,0,0,0,0,1.0,1,1.0,1,1.0,1,0.6757288432061315,77
3790,3,9596,9596,0,0,0,0,1.0,1,1.0,1,1.0,1,0.6783960049876093,77
3791,1,9597,9597,0,0,0,0,1.0,1,1.0,1,1.0,1,0.6842973771913481,77
3792,2,9599,9599,0,0,0,0,1.0,1,1.0,1,1.0,1,0.6674775397544842,78
3793,0,9599,9599,0,0,0,0,1.0,1,1.0,1,1.0,1,0.6611055897308278,80
3794,3,9602,9602,0,0,0,0,1.0,1,1.0,1,1.0,1,0.6447015844083819,82
3795,3,9605,9605,0,0,0,0,1.0,1,1.0,1,1.0,1,0.6359039806219103,83
3796,4,9609,9609,0,0,0,0,1.0,1,1.0,1,1.0,1,0.62962367196355,83
3797,3,9612,9612,0,0,0,0,1.0,1,1.0,1,1.0,1,0.614253611384311,82
3798,0,9612,9612,0,0,0,0,1.0,1,1.0,1,1.0,1,0.6122775613752225,82
3799,2,9614,9614,0,0,0,0,1.0,1,1.0,1,1.0,1,0.6051494417756567,83
3800,5,9619,9619,0,0,0,0,1.0,1,1.0,1,1.0,1,0.6269529187156135,83
3801,4,9623,9623,0,0,0,0,1.0,1,1.0,1,1.0,1,0.6337611471985182,83
3802,0,9623,9623,0,0,0,0,1.0,1,1.0,1,1.0,1,0.646991918983923,82
3803,4,9627,9627,0,0,0,0,1.0,1,1.0,1,1.0,1,0.6576418108819587,84
3804,2,9629,9629,0,0,0,0,1.0,1,1.0,1,1.0,1,0.6525667390504548,84
3805,2,9631,9631,0,0,0,0,1.0,1,1.0,1,1.0,1,0.6606344604020786,86
3806,1,9632,9632,0,0,0,0,1.0,1,1.0,1,1.0,1,0.6642600386479823,86
3807,4,9636,9636,0,0,0,0,1.0,1,1.0,1,1.0,1,0.6523767373280672,86
3808,3,9639,9639,0,0,0,0,1.0,1,1.0,1,1.0,1,0.643071367564844,85
3809,2,9641,9641,0,0,0,0,1.0,1,1.0,1,1.0,1,0.6611694573999061,85
3810,0,9641,9641,0,0,0,0,1.0,1,1.0,1,1.0,1,0.6611694573999061,85
3811,2,9643,9643,0,0,0,0,1.0,1,1.0,1,1.0,1,0.6534218124197843,84
3812,0,9643,9643,0,0,0,0,1.0,1,1.0,1,1.0,1,0.6516050925609714,83
3813,4,9647,9647,0,0,0,0,1.0,1,1.0,1,1.0,1,0.6314297276432412,82
3814,0,9647,9647,0,0,0,0,1.0,1,1.0,1,1.0,1,0.6284052364687477,81
3815,2,9649,9649,0,0,0,0,1.0,1,1.0,1,1.0,1,0.6195971349625005,82
3816,2,9651,9651,0,0,0,0,1.0,1,1.0,1,1.0,1,0.6305192921869521,81
3817,2,9653,9653,0,0,0,0,1.0,1,1.0,1,1.0,1,0.6318924048382351,81
3818,3,9656,9656,0,0,0,0,1.0,1,1.0,1,1.0,1,0.6386016768122472,81
3819,5,9661,9661,0,0,0,0,1.0,1,1.0,1,1.0,1,0.6206839542581364,82
3820,4,9665,9665,0,0,0,0,1.0,1,1.0,1,1.0,1,0.6422520973131293,84
3821,3,9668,9668,0,0,0,0,1.0,1,1.0,1,1.0,1,0.6296634683557968,84
3822,2,9670,9670,0,0,0,0,1.0,1,1.0,1,1.0,1,0.6326960503060126,82
3823,2,9672,9672,0,0,0,0,1.0,1,1.0,1,1.0,1,0.6309268626925056,81
3824,5,9677,9677,0,0,0,0,1.0,1,1.0,1,1.0,1,0.6399747413549525,78
3825,4,9681,9681,0,0,0,0,1.0,1,1.0,1,1.0,1,0.6453677027923882,76
3826,1,9682,9682,0,0,0,0,1.0,1,1.0,1,1.0,1,0.6493651783052355,76
3827,5,9687,9687,0,0,0,0,1.0,1,1.0,1,1.0,1,0.6445327431226638,75
3828,2,9689,9689,0,0,0,0,1.0,1,1.0,1,1.0,1,0.6480266979621673,74
3829,6,9695,9695,0,0,0,0,1.0,1,1.0,1,1.0,1,0.6432554877550601,74
3830,7,9702,9702,0,0,0,0,1.0,1,1.0,1,1.0,1,0.6377737134026159,74
3831,4,9706,9706,0,0,0,0,1.0,1,1.0,1,1.0,1,0.6211317851660593,74
3832,7,9713,9713,0,0,0,0,1.0,1,1.0,1,1.0,1,0.6321353840483185,73
3833,8,9721,9721,0,0,0,0,1.0,1,1.0,1,1.0,1,0.644642687834514,73
3834,5,9726,9726,0,0,0,0,1.0,1,1.0,1,1.0,1,0.6242023349561231,74
3835,3,9729,9729,0,0,0,0,1.0,1,1.0,1,1.0,1,0.6255022948050712,75
3836,3,9732,9732,0,0,0,0,1.0,1,1.0,1,1.0,1,0.6311371722549957,75
3837,2,9734,9734,0,0,0,0,1.0,1,1.0,1,1.0,1,0.6234286989924746,78
3838,2,9736,9736,0,0,0,0,1.0,1,1.0,1,1.0,1,0.6136040355876229,78
3839,0,9736,9736,0,0,0,0,1.0,1,1.0,1,1.0,1,0.6144153944144476,79
3840,4,9740,9740,0,0,0,0,1.0,1,1.0,1,1.0,1,0.5934323452271798,82
3841,0,9740,9740,0,0,0,0,1.0,1,1.0,1,1.0,1,0.5934323452271798,82
3842,3,9743,9743,0,0,0,0,1.0,1,1.0,1,1.0,1,0.5785406784352607,82
3843,2,9745,9745,0,0,0,0,1.0,1,1.0,1,1.0,1,0.5637177866467882,82
3844,1,9746,9746,0,0,0,0,1.0,1,1.0,1,1.0,1,0.5650658922768069,83
3845,1,9747,9747,0,0,0,0,1.0,1,1.0,1,1.0,1,0.5555516645312232,84
3846,3,9750,9750,0,0,0,0,1.0,1,1.0,1,1.0,1,0.5520567159213278,85
3847,1,9751,9751,0,0,0,0,1.0,1,1.0,1,1.0,1,0.5564100931292308,84
3848,1,9752,9752,0,0,0,0,1.0,1,1.0,1,1.0,1,0.5493649274745588,84
3849,1,9753,9753,0,0,0,0,1.0,1,1.0,1,1.0,1,0.553519262482688,83
3850,1,9754,9754,0,0,0,0,1.0,1,1.0,1,1.0,1,0.5550184731740153,80
3851,2,9756,9756,0,0,0,0,1.0,1,1.0,1,1.0,1,0.5505739194776186,80
3852,4,9760,9760,0,0,0,0,1.0,1,1.0,1,1.0,1,0.551813086972759,79
3853,5,9765,9765,0,0,0,0,1.0,1,1.0,1,1.0,1,0.5490225936288693,79
3854,2,9767,9767,0,0,0,0,1.0,1,1.0,1,1.0,1,0.5609752140539213,78
3855,0,9767,9767,0,0,0,0,1.0,1,1.0,1,1.0,1,0.5609752140539213,78
3856,3,9770,9770,0,0,0,0,1.0,1,1.0,1,1.0,1,0.5561729524281411,80
3857,1,9771,9771,0,0,0,0,1.0,1,1.0,1,1.0,1,0.5538967791771912,81
3858,1,9772,9772,0,0,0,0,1.0,1,1.0,1,1.0,1,0.5573359958278467,81
3859,3,9775,9775,0,0,0,0,1.0,1,1.0,1,1.0,1,0.5498373178936703,83
3860,1,9776,9776,0,0,0,0,1.0,1,1.0,1,1.0,1,0.5595367808556359,82
3861,3,9779,9779,0,0,0,0,1.0,1,1.0,1,1.0,1,0.5529741420002865,84
3862,5,9784,9784,0,0,0,0,1.0,1,1.0,1,1.0,1,0.5797452640575763,85
3863,3,9787,9787,0,0,0,0,1.0,1,1.0,1,1.0,1,0.5772460075817202,84
3864,6,9793,9793,0,0,0,0,1.0,1,1.0,1,1.0,1,0.596423555347662,83
3865,1,9794,9794,0,0,0,0,1.0,1,1.0,1,1.0,1,0.5944785557695517,82
3866,2,9796,9796,0,0,0,0,1.0,1,1.0,1,1.0,1,0.6062022121672971,81
3867,5,9801,9801,0,0,0,0,1.0,1,1.0,1,1.0,1,0.597843953464443,81
3868,2,9803,9803,0,0,0,0,1.0,1,1.0,1,1.0,1,0.6005736484057291,81
3869,3,9806,9806,0,0,0,0,1.0,1,1.0,1,1.0,1,0.6165233921129006,81
3870,3,9809,9809,0,0,0,0,1.0,1,1.0,1,1.0,1,0.6053043430921885,80
3871,1,9810,9810,0,0,0,0,1.0,1,1.0,1,1.0,1,0.6084209421426595,82
3872,3,9813,9813,0,0,0,0,1.0,1,1.0,1,1.0,1,0.6288022743504377,81
3873,2,9815,9815,0,0,0,0,1.0,1,1.0,1,1.0,1,0.6108697963737199,81
3874,1,9816,9816,0,0,0,0,1.0,1,1.0,1,1.0,1,0.6229965822289772,78
3875,2,9818,9818,0,0,0,0,1.0,1,1.0,1,1.0,1,0.6067621717904991,77
3876,0,9818,9818,0,0,0,0,1.0,1,1.0,1,1.0,1,0.6092178202223303,78
3877,3,9821,9821,0,0,0,0,1.0,1,1.0,1,1.0,1,0.6054887072851579,75
3878,1,9822,9822,0,0,0,0,1.0,1,1.0,1,1.0,1,0.6025761130608546,75
3879,1,9823,9823,0,0,0,0,1.0,1,1.0,1,1.0,1,0.6069026530413442,73
3880,1,9824,9824,0,0,0,0,1.0,1,1.0,1,1.0,1,0.6084248369458749,74
3881,2,9826,9826,0,0,0,0,1.0,1,1.0,1,1.0,1,0.6002288070914759,75
3882,3,9829,9829,0,0,0,0,1.0,1,1.0,1,1.0,1,0.5767171599933106,76
3883,3,9832,9832,0,0,0,0,1.0,1,1.0,1,1.0,1,0.5781689056192733,77
3884,5,9837,9837,0,0,0,0,1.0,1,1.0,1,1.0,1,0.5726566465400895,78
3885,5,9842,9842,0,0,0,0,1.0,1,1.0,1,1.0,1,0.5764518924668294,78
3886,8,9850,9850,0,0,0,0,1.0,1,1.0,1,1.0,1,0.5533362938223606,79
3887,5,9855,9855,0,0,0,0,1.0,1,1.0,1,1.0,1,0.547656778830258,78
3888,8,9863,9863,0,0,0,0,1.0,1,1.0,1,1.0,1,0.5754444761866347,80
3889,5,9868,9868,0,0,0,0,1.0,1,1.0,1,1.0,1,0.545551461263407,82
3890,6,9874,9874,0,0,0,0,1.0,1,1.0,1,1.0,1,0.5402325280329516,82
3891,5,9879,9879,0,0,0,0,1.0,1,1.0,1,1.0,1,0.512522804544164,85
3892,3,9882,9882,0,0,0,0,1.0,1,1.0,1,1.0,1,0.5069228721581075,87
3893,0,9882,9882,0,0,0,0,1.0,1,1.0,1,1.0,1,0.5038590868971722,86
3894,4,9886,9886,0,0,0,0,1.0,1,1.0,1,1.0,1,0.5172808686377872,87
3895,2,9888,9888,0,0,0,0,1.0,1,1.0,1,1.0,1,0.5241468225722721,87
3896,2,9890,9890,0,0,0,0,1.0,1,1.0,1,1.0,1,0.5220858529966955,85
3897,3,9893,9893,0,0,0,0,1.0,1,1.0,1,1.0,1,0.5371520190047521,85
3898,2,9895,9895,0,0,0,0,1.0,1,1.0,1,1.0,1,0.5540511766904223,86
3899,5,9900,9900,0,0,0,0,1.0,1,1.0,1,1.0,1,0.5408185546534345,86
3900,3,9903,9903,0,0,0,0,1.0,1,1.0,1,1.0,1,0.5546374028144284,86
3901,4,9907,9907,0,0,0,0,1.0,1,1.0,1,1.0,1,0.5450602003996187,86
3902,3,9910,9910,0,0,0,0,1.0,1,1.0,1,1.0,1,0.5539035384879659,87
3903,4,9914,9914,0,0,0,0,1.0,1,1.0,1,1.0,1,0.5320042221850342,87
3904,3,9917,9917,0,0,0,0,1.0,1,1.0,1,1.0,1,0.5404903459830294,85
3905,4,9921,9921,0,0,0,0,1.0,1,1.0,1,1.0,1,0.539575728512799,84
3906,2,9923,9923,0,0,0,0,1.0,1,1.0,1,1.0,1,0.545253185426901,86
3907,5,9928,9928,0,0,0,0,1.0,1,1.0,1,1.0,1,0.539105521098075,84
3908,4,9932,9932,0,0,0,0,1.0,1,1.0,1,1.0,1,0.5424271310033755,83
3909,4,9936,9936,0,0,0,0,1.0,1,1.0,1,1.0,1,0.5607567786100448,81
3910,6,9942,9942,0,0,0,0,1.0,1,1.0,1,1.0,1,0.5812008071381448,82
3911,3,9945,9945,0,0,0,0,1.0,1,1.0,1,1.0,1,0.5993040397757464,81
3912,3,9948,9948,0,0,0,0,1.0,1,1.0,1,1.0,1,0.6081236075985651,80
3913,5,9953,9953,0,0,0,0,1.0,1,1.0,1,1.0,1,0.6212470666404515,80
3914,5,9958,9958,0,0,0,0,1.0,1,1.0,1,1.0,1,0.6256597618296765,81
3915,3,9961,9961,0,0,0,0,1.0,1,1.0,1,1.0,1,0.6326593378711067,81
3916,7,9968,9968,0,0,0,0,1.0,1,1.0,1,1.0,1,0.6425209508322978,81
3917,3,9971,9971,0,0,0,0,1.0,1,1.0,1,1.0,1,0.6288128807325839,82
3918,0,9971,9971,0,0,0,0,1.0,1,1.0,1,1.0,1,0.6365344062899964,85
3919,4,9975,9975,0,0,0,0,1.0,1,1.0,1,1.0,1,0.6325394422450787,85
3920,2,9977,9977,0,0,0,0,1.0,1,1.0,1,1.0,1,0.6337025633858483,85
3921,1,9978,9978,0,0,0,0,1.0,1,1.0,1,1.0,1,0.6367891186291504,88
3922,2,9980,9980,0,0,0,0,1.0,1,1.0,1,1.0,1,0.6409824006227748,88
3923,1,9981,9981,0,0,0,0,1.0,1,1.0,1,1.0,1,0.6409285386705311,89
3924,0,9981,9981,0,0,0,0,1.0,1,1.0,1,1.0,1,0.6412230367426986,90
3925,3,9984,9984,0,0,0,0,1.0,1,1.0,1,1.0,1,0.6488881348089222,88
3926,1,9985,9985,0,0,0,0,1.0,1,1.0,1,1.0,1,0.6412649576782982,89
3927,0,9985,9985,0,0,0,0,1.0,1,1.0,1,1.0,1,0.6436450396632903,89
3928,4,9989,9989,0,0,0,0,1.0,1,1.0,1,1.0,1,0.6459614062781923,88
3929,1,9990,9990,0,0,0,0,1.0,1,1.0,1,1.0,1,0.6480554970162317,88
3930,3,9993,9993,0,0,0,0,1.0,1,1.0,1,1.0,1,0.6449552987013406,87
3931,1,9994,9994,0,0,0,0,1.0,1,1.0,1,1.0,1,0.6472560031461823,86
3932,3,9997,9997,0,0,0,0,1.0,1,1.0,1,1.0,1,0.6281696721543581,85
3933,2,9999,9999,0,0,0,0,1.0,1,1.0,1,1.0,1,0.6182095350227735,84
3934,1,10000,10000,0,0,0,0,1.0,1,1.0,1,1.0,1,0.6028256577351363,85
3935,1,10001,10001,0,0,0,0,1.0,1,1.0,1,1.0,1,0.6090222908093088,84
3936,1,10002,10002,0,0,0,0,1.0,1,1.0,1,1.0,1,0.6019093589490386,84
3937,3,10005,10005,0,0,0,0,1.0,1,1.0,1,1.0,1,0.6026203932994731,82
3938,2,10007,10007,0,0,0,0,1.0,1,1.0,1,1.0,1,0.608392583865649,82
3939,3,10010,10010,0,0,0,0,1.0,1,1.0,1,1.0,1,0.6184947026953533,84
3940,3,10013,10013,0,0,0,0,1.0,1,1.0,1,1.0,1,0.6005356943914728,84
3941,4,10017,10017,0,0,0,0,1.0,1,1.0,1,1.0,1,0.5925435746854253,85
3942,5,10022,10022,0,0,0,0,1.0,1,1.0,1,1.0,1,0.6024639333399727,85
3943,2,10024,10024,0,0,0,0,1.0,1,1.0,1,1.0,1,0.6076312375425166,84
3944,4,10028,10028,0,0,0,0,1.0,1,1.0,1,1.0,1,0.6175793799470641,83
3945,3,10031,10031,0,0,0,0,1.0,1,1.0,1,1.0,1,0.6172561214559125,83
3946,5,10036,10036,0,0,0,0,1.0,1,1.0,1,1.0,1,0.6328680624701875,83
3947,1,10037,10037,0,0,0,0,1.0,1,1.0,1,1.0,1,0.6301178536796878,83
3948,6,10043,10043,0,0,0,0,1.0,1,1.0,1,1.0,1,0.6342818770069033,84
3949,3,10046,10046,0,0,0,0,1.0,1,1.0,1,1.0,1,0.6576969150487177,84
3950,2,10048,10048,0,0,0,0,1.0,1,1.0,1,1.0,1,0.6486907306103685,86
3951,2,10050,10050,0,0,0,0,1.0,1,1.0,1,1.0,1,0.6529218819650046,87
3952,3,10053,10053,0,0,0,0,1.0,1,1.0,1,1.0,1,0.6483324099618918,86
3953,2,10055,10055,0,0,0,0,1.0,1,1.0,1,1.0,1,0.6480009962022245,86
3954,3,10058,10058,0,0,0,0,1.0,1,1.0,1,1.0,1,0.6410908812869374,85
3955,2,10060,10060,0,0,0,0,1.0,1,1.0,1,1.0,1,0.6408958194110165,85
3956,1,10061,10061,0,0,0,0,1.0,1,1.0,1,1.0,1,0.6506821695099625,84
3957,5,10066,10066,0,0,0,0,1.0,1,1.0,1,1.0,1,0.6341156822345643,85
3958,3,10069,10069,0,0,0,0,1.0,1,1.0,1,1.0,1,0.6192690541311789,84
3959,2,10071,10071,0,0,0,0,1.0,1,1.0,1,1.0,1,0.6141390247848146,83
3960,5,10076,10076,0,0,0,0,1.0,1,1.0,1,1.0,1,0.6017197923602972,84
3961,3,10079,10079,0,0,0,0,1.0,1,1.0,1,1.0,1,0.6042719930771907,83
3962,6,10085,10085,0,0,0,0,1.0,1,1.0,1,1.0,1,0.6112895958233404,84
3963,5,10090,10090,0,0,0,0,1.0,1,1.0,1,1.0,1,0.6086222237096779,81
3964,3,10093,10093,0,0,0,0,1.0,1,1.0,1,1.0,1,0.6256252279037444,81
3965,3,10096,10096,0,0,0,0,1.0,1,1.0,1,1.0,1,0.6188285972700583,81
3966,3,10099,10099,0,0,0,0,1.0,1,1.0,1,1.0,1,0.6212236562905029,79
3967,4,10103,10103,0,0,0,0,1.0,1,1.0,1,1.0,1,0.6035877724847953,81
3968,2,10105,10105,0,0,0,0,1.0,1,1.0,1,1.0,1,0.6031432457884676,79
3969,2,10107,10107,0,0,0,0,1.0,1,1.0,1,1.0,1,0.5919447041354312,79
3970,2,10109,10109,0,0,0,0,1.0,1,1.0,1,1.0,1,0.5922836405815688,78
3971,1,10110,10110,0,0,0,0,1.0,1,1.0,1,1.0,1,0.5922016552853878,77
3972,2,10112,10112,0,0,0,0,1.0,1,1.0,1,1.0,1,0.5948892107927617,78
3973,4,10116,10116,0,0,0,0,1.0,1,1.0,1,1.0,1,0.6023600222847297,77
3974,0,10116,10116,0,0,0,0,1.0,1,1.0,1,1.0,1,0.6023600222847297,77
3975,1,10117,10117,0,0,0,0,1.0,1,1.0,1,1.0,1,0.6153304714154394,76
3976,1,10118,10118,0,0,0,0,1.0,1,1.0,1,1.0,1,0.6191094579292408,77
3977,1,10119,10119,0,0,0,0,1.0,1,1.0,1,1.0,1,0.6250210144323317,78
3978,1,10120,10120,0,0,0,0,1.0,1,1.0,1,1.0,1,0.6258899324665282,79
3979,3,10123,10123,0,0,0,0,1.0,1,1.0,1,1.0,1,0.6067282352216327,79
3980,2,10125,10125,0,0,0,0,1.0,1,1.0,1,1.0,1,0.6068095157866188,79
3981,5,10130,10130,0,0,0,0,1.0,1,1.0,1,1.0,1,0.6085024647617866,83
3982,2,10132,10132,0,0,0,0,1.0,1,1.0,1,1.0,1,0.6091476659027604,83
3983,6,10138,10138,0,0,0,0,1.0,1,1.0,1,1.0,1,0.6214383222494019,82
3984,5,10143,10143,0,0,0,0,1.0,1,1.0,1,1.0,1,0.6117827605624275,83
3985,2,10145,10145,0,0,0,0,1.0,1,1.0,1,1.0,1,0.6042889886379372,84
3986,4,10149,10149,0,0,0,0,1.0,1,1.0,1,1.0,1,0.6024630373444281,83
3987,3,10152,10152,0,0,0,0,1.0,1,1.0,1,1.0,1,0.6318170125350278,82
3988,6,10158,10158,0,0,0,0,1.0,1,1.0,1,1.0,1,0.612058339460634,83
3989,4,10162,10162,0,0,0,0,1.0,1,1.0,1,1.0,1,0.6231702810799745,81
3990,1,10163,10163,0,0,0,0,1.0,1,1.0,1,1.0,1,0.6205214649439926,81
3991,7,10170,10170,0,0,0,0,1.0,1,1.0,1,1.0,1,0.6611868904842524,79
3992,3,10173,10173,0,0,0,0,1.0,1,1.0,1,1.0,1,0.6599000978489113,81
3993,3,10176,10176,0,0,0,0,1.0,1,1.0,1,1.0,1,0.6601299599911656,80
3994,0,10176,10176,0,0,0,0,1.0,1,1.0,1,1.0,1,0.6601299599911656,80
3995,4,10180,10180,0,0,0,0,1.0,1,1.0,1,1.0,1,0.6327892854975891,81
3996,1,10181,10181,0,0,0,0,1.0,1,1.0,1,1.0,1,0.6446750896110203,80
3997,2,10183,10183,0,0,0,0,1.0,1,1.0,1,1.0,1,0.644369962271452,81
3998,2,10185,10185,0,0,0,0,1.0,1,1.0,1,1.0,1,0.6399752619071023,82
3999,2,10187,10187,0,0,0,0,1.0,1,1.0,1,1.0,1,0.6457113969793435,82
4000,0,10187,10187,0,0,0,0,1.0,1,1.0,1,1.0,1,0.6457113969793435,82
4001,2,10189,10189,0,0,0,0,1.0,1,1.0,1,1.0,1,0.6345260168223164,81
4002,4,10193,10193,0,0,0,0,1.0,1,1.0,1,1.0,1,0.6473170086648137,81
4003,2,10195,10195,0,0,0,0,1.0,1,1.0,1,1.0,1,0.6524647768276238,81
4004,2,10197,10197,0,0,0,0,1.0,1,1.0,1,1.0,1,0.640234062151864,80
4005,3,10200,10200,0,0,0,0,1.0,1,1.0,1,1.0,1,0.6420451156332374,78
4006,2,10202,10202,0,0,0,0,1.0,1,1.0,1,1.0,1,0.6308843510942774,76
4007,3,10205,10205,0,0,0,0,1.0,1,1.0,1,1.0,1,0.6382414567843211,75
4008,5,10210,10210,0,0,0,0,1.0,1,1.0,1,1.0,1,0.6224025234605062,74
4009,5,10215,10215,0,0,0,0,1.0,1,1.0,1,1.0,1,0.6197606490133343,75
4010,4,10219,10219,0,0,0,0,1.0,1,1.0,1,1.0,1,0.6121460821508328,75
4011,3,10222,10222,0,0,0,0,1.0,1,1.0,1,1.0,1,0.5915886223621072,74
4012,3,10225,10225,0,0,0,0,1.0,1,1.0,1,1.0,1,0.5866812173558766,74
4013,4,10229,10229,0,0,0,0,1.0,1,1.0,1,1.0,1,0.5654707260130325,74
4014,3,10232,10232,0,0,0,0,1.0,1,1.0,1,1.0,1,0.5730864139212347,73
4015,5,10237,10237,0,0,0,0,1.0,1,1.0,1,1.0,1,0.5796022840895889,74
4016,1,10238,10238,0,0,0,0,1.0,1,1.0,1,1.0,1,0.5808946367279053,74
4017,7,10245,10245,0,0,0,0,1.0,1,1.0,1,1.0,1,0.5494459176957143,78
4018,6,10251,10251,0,0,0,0,1.0,1,1.0,1,1.0,1,0.5858050060062174,78
4019,5,10256,10256,0,0,0,0,1.0,1,1.0,1,1.0,1,0.5793255783678405,78
4020,5,10261,10261,0,0,0,0,1.0,1,1.0,1,1.0,1,0.5918804751203544,78
4021,4,10265,10265,0,0,0,0,1.0,1,1.0,1,1.0,1,0.5861857194656761,78
4022,5,10270,10270,0,0,0,0,1.0,1,1.0,1,1.0,1,0.5860725921552155,79
4023,4,10274,10274,0,0,0,0,1.0,1,1.0,1,1.0,1,0.5989468701902265,78
4024,4,10278,10278,0,0,0,0,1.0,1,1.0,1,1.0,1,0.6046843566018599,77
4025,2,10280,10280,0,0,0,0,1.0,1,1.0,1,1.0,1,0.6020230066017627,76
4026,5,10285,10285,0,0,0,0,1.0,1,1.0,1,1.0,1,0.6080220400755982,76
4027,3,10288,10288,0,0,0,0,1.0,1,1.0,1,1.0,1,0.6133410793045255,75
4028,2,10290,10290,0,0,0,0,1.0,1,1.0,1,1.0,1,0.5958038402897645,76
4029,5,10295,10295,0,0,0,0,1.0,1,1.0,1,1.0,1,0.6223751956508741,75
4030,1,10296,10296,0,0,0,0,1.0,1,1.0,1,1.0,1,0.6226462845834208,74
4031,1,10297,10297,0,0,0,0,1.0,1,1.0,1,1.0,1,0.6328112348805719,73
4032,3,10300,10300,0,0,0,0,1.0,1,1.0,1,1.0,1,0.6408573889423789,71
4033,1,10301,10301,0,0,0,0,1.0,1,1.0,1,1.0,1,0.6239628907213416,73
4034,5,10306,10306,0,0,0,0,1.0,1,1.0,1,1.0,1,0.6051694425047337,72
4035,0,10306,10306,0,0,0,0,1.0,1,1.0,1,1.0,1,0.6155695784870383,71
4036,5,10311,10311,0,0,0,0,1.0,1,1.0,1,1.0,1,0.6059892483642481,71
4037,1,10312,10312,0,0,0,0,1.0,1,1.0,1,1.0,1,0.603802474284091,70
4038,4,10316,10316,0,0,0,0,1.0,1,1.0,1,1.0,1,0.5953945665477306,69
4039,1,10317,10317,0,0,0,0,1.0,1,1.0,1,1.0,1,0.6044999392730434,68
4040,3,10320,10320,0,0,0,0,1.0,1,1.0,1,1.0,1,0.5885104743908689,69
4041,1,10321,10321,0,0,0,0,1.0,1,1.0,1,1.0,1,0.6029582775272919,67
4042,2,10323,10323,0,0,0,0,1.0,1,1.0,1,1.0,1,0.5885399390974018,67
4043,1,10324,10324,0,0,0,0,1.0,1,1.0,1,1.0,1,0.5897493864053482,66
4044,2,10326,10326,0,0,0,0,1.0,1,1.0,1,1.0,1,0.5878920673746617,65
4045,2,10328,10328,0,0,0,0,1.0,1,1.0,1,1.0,1,0.5951292268339824,66
4046,4,10332,10332,0,0,0,0,1.0,1,1.0,1,1.0,1,0.582504141057198,68
4047,2,10334,10334,0,0,0,0,1.0,1,1.0,1,1.0,1,0.5813843855365836,68
4048,1,10335,10335,0,0,0,0,1.0,1,1.0,1,1.0,1,0.5891548310502881,69
4049,3,10338,10338,0,0,0,0,1.0,1,1.0,1,1.0,1,0.612256669736074,69
4050,1,10339,10339,0,0,0,0,1.0,1,1.0,1,1.0,1,0.6112902258746574,69
4051,0,10339,10339,0,0,0,0,1.0,1,1.0,1,1.0,1,0.6112902258746574,69
4052,2,10341,10341,0,0,0,0,1.0,1,1.0,1,1.0,1,0.6010897317438517,69
4053,3,10344,10344,0,0,0,0,1.0,1,1.0,1,1.0,1,0.5815168148209214,69
4054,1,10345,10345,0,0,0,0,1.0,1,1.0,1,1.0,1,0.5737930730828509,70
4055,3,10348,10348,0,0,0,0,1.0,1,1.0,1,1.0,1,0.5567917898861866,70
4056,1,10349,10349,0,0,0,0,1.0,1,1.0,1,1.0,1,0.5450191665771018,70
4057,2,10351,10351,0,0,0,0,1.0,1,1.0,1,1.0,1,0.5367140055870244,71
4058,1,10352,10352,0,0,0,0,1.0,1,1.0,1,1.0,1,0.5407202510041142,71
4059,4,10356,10356,0,0,0,0,1.0,1,1.0,1,1.0,1,0.5277300661366419,72
4060,2,10358,10358,0,0,0,0,1.0,1,1.0,1,1.0,1,0.5528587251951114,71
4061,2,10360,10360,0,0,0,0,1.0,1,1.0,1,1.0,1,0.5573437661707725,72
4062,3,10363,10363,0,0,0,0,1.0,1,1.0,1,1.0,1,0.5757996449081436,72
4063,1,10364,10364,0,0,0,0,1.0,1,1.0,1,1.0,1,0.5891900815766016,72
4064,7,10371,10371,0,0,0,0,1.0,1,1.0,1,1.0,1,0.5803155258389981,71
4065,1,10372,10372,0,0,0,0,1.0,1,1.0,1,1.0,1,0.5885537670914576,70
4066,6,10378,10378,0,0,0,0,1.0,1,1.0,1,1.0,1,0.5707292441020269,70
4067,2,10380,10380,0,0,0,0,1.0,1,1.0,1,1.0,1,0.5781025250705775,68
4068,6,10386,10386,0,0,0,0,1.0,1,1.0,1,1.0,1,0.5777330722912434,70
4069,4,10390,10390,0,0,0,0,1.0,1,1.0,1,1.0,1,0.5929536718336686,68
4070,8,10398,10398,0,0,0,0,1.0,1,1.0,1,1.0,1,0.6053904386440074,67
4071,8,10406,10406,0,0,0,0,1.0,1,1.0,1,1.0,1,0.6055166681697489,68
4072,7,10413,10413,0,0,0,0,1.0,1,1.0,1,1.0,1,0.6126227145156262,70
4073,8,10421,10421,0,0,0,0,1.0,1,1.0,1,1.0,1,0.620653985137987,70
4074,11,10432,10432,0,0,0,0,1.0,1,1.0,1,1.0,1,0.6020077716056861,71
4075,8,10440,10440,0,0,0,0,1.0,1,1.0,1,1.0,1,0.5917548540952238,72
4076,5,10445,10445,0,0,0,0,1.0,1,1.0,1,1.0,1,0.578256141110347,73
4077,2,10447,10447,0,0,0,0,1.0,1,1.0,1,1.0,1,0.5773819808336472,72
4078,4,10451,10451,0,0,0,0,1.0,1,1.0,1,1.0,1,0.5705568115763728,71
4079,0,10451,10451,0,0,0,0,1.0,1,1.0,1,1.0,1,0.5796683166263411,69
4080,3,10454,10454,0,0,0,0,1.0,1,1.0,1,1.0,1,0.6001428088739066,67
4081,2,10456,10456,0,0,0,0,1.0,1,1.0,1,1.0,1,0.5982219726724745,66
4082,2,10458,10458,0,0,0,0,1.0,1,1.0,1,1.0,1,0.6145524862141021,65
4083,3,10461,10461,0,0,0,0,1.0,1,1.0,1,1.0,1,0.5981764245941722,64
4084,1,10462,10462,0,0,0,0,1.0,1,1.0,1,1.0,1,0.5881466114465838,64
4085,5,10467,10467,0,0,0,0,1.0,1,1.0,1,1.0,1,0.5713665279055815,65
4086,0,10467,10467,0,0,0,0,1.0,1,1.0,1,1.0,1,0.5658192370369021,66
4087,3,10470,10470,0,0,0,0,1.0,1,1.0,1,1.0,1,0.5546189531965897,66
4088,1,10471,10471,0,0,0,0,1.0,1,1.0,1,1.0,1,0.5683654893972033,65
4089,0,10471,10471,0,0,0,0,1.0,1,1.0,1,1.0,1,0.5683654893972033,65
4090,0,10471,10471,0,0,0,0,1.0,1,1.0,1,1.0,1,0.5708531410156231,65
4091,2,10473,10473,0,0,0,0,1.0,1,1.0,1,1.0,1,0.5799309692704789,65
4092,1,10474,10474,0,0,0,0,1.0,1,1.0,1,1.0,1,0.5958246103176656,64
4093,2,10476,10476,0,0,0,0,1.0,1,1.0,1,1.0,1,0.6015432976555749,66
4094,5,10481,10481,0,0,0,0,1.0,1,1.0,1,1.0,1,0.6287987923208973,65
4095,3,10484,10484,0,0,0,0,1.0,1,1.0,1,1.0,1,0.6347404265574973,65
4096,5,10489,10489,0,0,0,0,1.0,1,1.0,1,1.0,1,0.6458846420253133,67
4097,5,10494,10494,0,0,0,0,1.0,1,1.0,1,1.0,1,0.6234401853910353,67
4098,3,10497,10497,0,0,0,0,1.0,1,1.0,1,1.0,1,0.639044432325036,68
4099,4,10501,10501,0,0,0,0,1.0,1,1.0,1,1.0,1,0.6337366090769222,69
4100,4,10505,10505,0,0,0,0,1.0,1,1.0,1,1.0,1,0.6186261722238732,70
4101,3,10508,10508,0,0,0,0,1.0,1,1.0,1,1.0,1,0.6255460202188943,71
4102,5,10513,10513,0,0,0,0,1.0,1,1.0,1,1.0,1,0.622541616705005,71
4103,2,10515,10515,0,0,0,0,1.0,1,1.0,1,1.0,1,0.625687030540252,71
4104,1,10516,10516,0,0,0,0,1.0,1,1.0,1,1.0,1,0.6337118757057238,69
4105,3,10519,10519,0,0,0,0,1.0,1,1.0,1,1.0,1,0.662478102906824,67
4106,2,10521,10521,0,0,0,0,1.0,1,1.0,1,1.0,1,0.6601085123273011,68
4107,0,10521,10521,0,0,0,0,1.0,1,1.0,1,1.0,1,0.6573176645240292,70
4108,3,10524,10524,0,0,0,0,1.0,1,1.0,1,1.0,1,0.6297692822639912,70
4109,1,10525,10525,0,0,0,0,1.0,1,1.0,1,1.0,1,0.6398002644370895,69
4110,1,10526,10526,0,0,0,0,1.0,1,1.0,1,1.0,1,0.6203727606111505,71
4111,4,10530,10530,0,0,0,0,1.0,1,1.0,1,1.0,1,0.6356345102960247,70
4112,1,10531,10531,0,0,0,0,1.0,1,1.0,1,1.0,1,0.6254794018938248,72
4113,3,10534,10534,0,0,0,0,1.0,1,1.0,1,1.0,1,0.615389872395413,72
4114,2,10536,10536,0,0,0,0,1.0,1,1.0,1,1.0,1,0.5991206670984413,72
4115,1,10537,10537,0,0,0,0,1.0,1,1.0,1,1.0,1,0.6134545163913164,70
4116,4,10541,10541,0,0,0,0,1.0,1,1.0,1,1.0,1,0.6027626012408172,67
4117,0,10541,10541,0,0,0,0,1.0,1,1.0,1,1.0,1,0.6097889860384172,67
4118,5,10546,10546,0,0,0,0,1.0,1,1.0,1,1.0,1,0.6140605412287241,66
4119,2,10548,10548,0,0,0,0,1.0,1,1.0,1,1.0,1,0.6057217182045965,67
4120,8,10556,10556,0,0,0,0,1.0,1,1.0,1,1.0,1,0.6421094977376054,64
4121,2,10558,10558,0,0,0,0,1.0,1,1.0,1,1.0,1,0.6459998212484599,63
4122,3,10561,10561,0,0,0,0,1.0,1,1.0,1,1.0,1,0.6290171712390493,63
4123,4,10565,10565,0,0,0,0,1.0,1,1.0,1,1.0,1,0.6455947420411723,61
4124,3,10568,10568,0,0,0,0,1.0,1,1.0,1,1.0,1,0.6380329860446846,62
4125,2,10570,10570,0,0,0,0,1.0,1,1.0,1,1.0,1,0.6627630100450762,60
4126,4,10574,10574,0,0,0,0,1.0,1,1.0,1,1.0,1,0.6649851917456121,59
4127,3,10577,10577,0,0,0,0,1.0,1,1.0,1,1.0,1,0.6522283738482478,60
4128,2,10579,10579,0,0,0,0,1.0,1,1.0,1,1.0,1,0.6524299788681565,60
4129,5,10584,10584,0,0,0,0,1.0,1,1.0,1,1.0,1,0.6657325265848246,60
4130,2,10586,10586,0,0,0,0,1.0,1,1.0,1,1.0,1,0.6627436265077766,61
4131,3,10589,10589,0,0,0,0,1.0,1,1.0,1,1.0,1,0.6864950748781199,60
4132,3,10592,10592,0,0,0,0,1.0,1,1.0,1,1.0,1,0.679618382344763,60
4133,1,10593,10593,0,0,0,0,1.0,1,1.0,1,1.0,1,0.6674513549805414,62
4134,3,10596,10596,0,0,0,0,1.0,1,1.0,1,1.0,1,0.6510557198031545,63
4135,1,10597,10597,0,0,0,0,1.0,1,1.0,1,1.0,1,0.6195000654503067,65
4136,1,10598,10598,0,0,0,0,1.0,1,1.0,1,1.0,1,0.6158331607569895,65
4137,2,10600,10600,0,0,0,0,1.0,1,1.0,1,1.0,1,0.6129002103521166,66
4138,1,10601,10601,0,0,0,0,1.0,1,1.0,1,1.0,1,0.5992334125634186,67
4139,6,10607,10607,0,0,0,0,1.0,1,1.0,1,1.0,1,0.5789454676007278,67
4140,1,10608,10608,0,0,0,0,1.0,1,1.0,1,1.0,1,0.5742333946325184,66
4141,2,10610,10610,0,0,0,0,1.0,1,1.0,1,1.0,1,0.5666092293250468,67
4142,4,10614,10614,0,0,0,0,1.0,1,1.0,1,1.0,1,0.5756444900973666,67
4143,5,10619,10619,0,0,0,0,1.0,1,1.0,1,1.0,1,0.5683025368903608,66
4144,5,10624,10624,0,0,0,0,1.0,1,1.0,1,1.0,1,0.5934500491578245,64
4145,4,10628,10628,0,0,0,0,1.0,1,1.0,1,1.0,1,0.5994638491359909,63
4146,8,10636,10636,0,0,0,0,1.0,1,1.0,1,1.0,1,0.620794286132739,62
4147,6,10642,10642,0,0,0,0,1.0,1,1.0,1,1.0,1,0.6441478727097416,60
4148,2,10644,10644,0,0,0,0,1.0,1,1.0,1,1.0,1,0.6392108844651905,62
4149,4,10648,10648,0,0,0,0,1.0,1,1.0,1,1.0,1,0.645916754504041,61
4150,0,10648,10648,0,0,0,0,1.0,1,1.0,1,1.0,1,0.6539524717924968,60
4151,1,10649,10649,0,0,0,0,1.0,1,1.0,1,1.0,1,0.6500072813962146,60
4152,1,10650,10650,0,0,0,0,1.0,1,1.0,1,1.0,1,0.6584209829076784,60
4153,0,10650,10650,0,0,0,0,1.0,1,1.0,1,1.0,1,0.6654435821296154,58
4154,3,10653,10653,0,0,0,0,1.0,1,1.0,1,1.0,1,0.6713276105442546,57
4155,2,10655,10655,0,0,0,0,1.0,1,1.0,1,1.0,1,0.6819684066375483,57
4156,1,10656,10656,0,0,0,0,1.0,1,1.0,1,1.0,1,0.6803178521809926,58
4157,3,10659,10659,0,0,0,0,1.0,1,1.0,1,1.0,1,0.6744993054697749,57
4158,3,10662,10662,0,0,0,0,1.0,1,1.0,1,1.0,1,0.6857728279819965,55
4159,3,10665,10665,0,0,0,0,1.0,1,1.0,1,1.0,1,0.6970236902014448,57
4160,2,10667,10667,0,0,0,0,1.0,1,1.0,1,1.0,1,0.6925456842414381,58
4161,2,10669,10669,0,0,0,0,1.0,1,1.0,1,1.0,1,0.6924924906825751,58
4162,2,10671,10671,0,0,0,0,1.0,1,1.0,1,1.0,1,0.6860780317576105,57
4163,2,10673,10673,0,0,0,0,1.0,1,1.0,1,1.0,1,0.6638506923971645,58
4164,1,10674,10674,0,0,0,0,1.0,1,1.0,1,1.0,1,0.6731753531701677,56
4165,2,10676,10676,0,0,0,0,1.0,1,1.0,1,1.0,1,0.6454067218627023,58
4166,4,10680,10680,0,0,0,0,1.0,1,1.0,1,1.0,1,0.6203495939481288,57
4167,1,10681,10681,0,0,0,0,1.0,1,1.0,1,1.0,1,0.6113977643170848,57
4168,5,10686,10686,0,0,0,0,1.0,1,1.0,1,1.0,1,0.5595189304381305,58
4169,0,10686,10686,0,0,0,0,1.0,1,1.0,1,1.0,1,0.5595189304381305,58
4170,1,10687,10687,0,0,0,0,1.0,1,1.0,1,1.0,1,0.5675473783345271,58
4171,1,10688,10688,0,0,0,0,1.0,1,1.0,1,1.0,1,0.5791337545067533,57
4172,5,10693,10693,0,0,0,0,1.0,1,1.0,1,1.0,1,0.5543651845411566,57
4173,4,10697,10697,0,0,0,0,1.0,1,1.0,1,1.0,1,0.5804324483806866,56
4174,5,10702,10702,0,0,0,0,1.0,1,1.0,1,1.0,1,0.6163451622770136,56
4175,1,10703,10703,0,0,0,0,1.0,1,1.0,1,1.0,1,0.6279669307996742,55
4176,3,10706,10706,0,0,0,0,1.0,1,1.0,1,1.0,1,0.632105512894904,57
4177,3,10709,10709,0,0,0,0,1.0,1,1.0,1,1.0,1,0.6141245210840858,58
4178,3,10712,10712,0,0,0,0,1.0,1,1.0,1,1.0,1,0.6139798162415933,60
4179,2,10714,10714,0,0,0,0,1.0,1,1.0,1,1.0,1,0.5837341809421273,61
4180,2,10716,10716,0,0,0,0,1.0,1,1.0,1,1.0,1,0.5567689248524769,62
4181,2,10718,10718,0,0,0,0,1.0,1,1.0,1,1.0,1,0.5734543882615686,63
4182,2,10720,10720,0,0,0,0,1.0,1,1.0,1,1.0,1,0.5875439163253511,63
4183,2,10722,10722,0,0,0,0,1.0,1,1.0,1,1.0,1,0.5900638568779608,63
4184,1,10723,10723,0,0,0,0,1.0,1,1.0,1,1.0,1,0.5978461986560502,63
4185,4,10727,10727,0,0,0,0,1.0,1,1.0,1,1.0,1,0.6092645846746505,61
4186,3,10730,10730,0,0,0,0,1.0,1,1.0,1,1.0,1,0.6143150891174061,62
4187,6,10736,10736,0,0,0,0,1.0,1,1.0,1,1.0,1,0.5884518953108914,60
4188,3,10739,10739,0,0,0,0,1.0,1,1.0,1,1.0,1,0.595544935731702,60
4189,2,10741,10741,0,0,0,0,1.0,1,1.0,1,1.0,1,0.584470121641277,60
4190,5,10746,10746,0,0,0,0,1.0,1,1.0,1,1.0,1,0.6038747889062862,61
4191,1,10747,10747,0,0,0,0,1.0,1,1.0,1,1.0,1,0.5894283424936296,59
4192,6,10753,10753,0,0,0,0,1.0,1,1.0,1,1.0,1,0.5949735876653933,58
4193,0,10753,10753,0,0,0,0,1.0,1,1.0,1,1.0,1,0.5969588020821922,57
4194,2,10755,10755,0,0,0,0,1.0,1,1.0,1,1.0,1,0.616307893987262,54
4195,5,10760,10760,0,0,0,0,1.0,1,1.0,1,1.0,1,0.6137366899179051,55
4196,1,10761,10761,0,0,0,0,1.0,1,1.0,1,1.0,1,0.5930928744367406,56
4197,4,10765,10765,0,0,0,0,1.0,1,1.0,1,1.0,1,0.6043261759069014,55
4198,1,10766,10766,0,0,0,0,1.0,1,1.0,1,1.0,1,0.5849930332800651,56
4199,2,10768,10768,0,0,0,0,1.0,1,1.0,1,1.0,1,0.562461701351724,55
4200,0,10768,10768,0,0,0,0,1.0,1,1.0,1,1.0,1,0.5625459023586381,55
4201,1,10769,10769,0,0,0,0,1.0,1,1.0,1,1.0,1,0.5707189035073665,56
4202,3,10772,10772,0,0,0,0,1.0,1,1.0,1,1.0,1,0.5638365329503249,56
4203,3,10775,10775,0,0,0,0,1.0,1,1.0,1,1.0,1,0.587122897785952,57
4204,2,10777,10777,0,0,0,0,1.0,1,1.0,1,1.0,1,0.6218576080995384,57
4205,1,10778,10778,0,0,0,0,1.0,1,1.0,1,1.0,1,0.5985352830044526,58
4206,3,10781,10781,0,0,0,0,1.0,1,1.0,1,1.0,1,0.6453326007242114,58
4207,2,10783,10783,0,0,0,0,1.0,1,1.0,1,1.0,1,0.6279160208262944,58
4208,0,10783,10783,0,0,0,0,1.0,1,1.0,1,1.0,1,0.619986082799367,60
4209,4,10787,10787,0,0,0,0,1.0,1,1.0,1,1.0,1,0.6345212001302909,61
4210,2,10789,10789,0,0,0,0,1.0,1,1.0,1,1.0,1,0.6021844376666537,62
4211,0,10789,10789,0,0,0,0,1.0,1,1.0,1,1.0,1,0.5991542323320234,63
4212,1,10790,10790,0,0,0,0,1.0,1,1.0,1,1.0,1,0.5873488004019503,64
4213,0,10790,10790,0,0,0,0,1.0,1,1.0,1,1.0,1,0.571900274105618,65
4214,0,10790,10790,0,0,0,0,1.0,1,1.0,1,1.0,1,0.5636732939386244,65
4215,0,10790,10790,0,0,0,0,1.0,1,1.0,1,1.0,1,0.5636732939386244,65
4216,0,10790,10790,0,0,0,0,1.0,1,1.0,1,1.0,1,0.5703591395536416,64
4217,4,10794,10794,0,0,0,0,1.0,1,1.0,1,1.0,1,0.5940885097096413,65
4218,3,10797,10797,0,0,0,0,1.0,1,1.0,1,1.0,1,0.6010991197481267,65
4219,5,10802,10802,0,0,0,0,1.0,1,1.0,1,1.0,1,0.6242705363216854,65
4220,4,10806,10806,0,0,0,0,1.0,1,1.0,1,1.0,1,0.6334997482951297,65
4221,5,10811,10811,0,0,0,0,1.0,1,1.0,1,1.0,1,0.6523969723100022,67
4222,2,10813,10813,0,0,0,0,1.0,1,1.0,1,1.0,1,0.6495422367331739,68
4223,2,10815,10815,0,0,0,0,1.0,1,1.0,1,1.0,1,0.6551236035546887,68
4224,1,10816,10816,0,0,0,0,1.0,1,1.0,1,1.0,1,0.6612729904769943,68
4225,0,10816,10816,0,0,0,0,1.0,1,1.0,1,1.0,1,0.6644799715305311,66
4226,0,10816,10816,0,0,0,0,1.0,1,1.0,1,1.0,1,0.6641669138781648,66
4227,0,10816,10816,0,0,0,0,1.0,1,1.0,1,1.0,1,0.6641669138781648,66
4228,0,10816,10816,0,0,0,0,1.0,1,1.0,1,1.0,1,0.6685914273235531,65
4229,1,10817,10817,0,0,0,0,1.0,1,1.0,1,1.0,1,0.6610235196860945,65
4230,2,10819,10819,0,0,0,0,1.0,1,1.0,1,1.0,1,0.6784235134119957,64
4231,0,10819,10819,0,0,0,0,1.0,1,1.0,1,1.0,1,0.6769974252924267,64
4232,2,10821,10821,0,0,0,0,1.0,1,1.0,1,1.0,1,0.6871114802141255,65
4233,0,10821,10821,0,0,0,0,1.0,1,1.0,1,1.0,1,0.6913074941926727,64
4234,1,10822,10822,0,0,0,0,1.0,1,1.0,1,1.0,1,0.7021831484831779,63
4235,4,10826,10826,0,0,0,0,1.0,1,1.0,1,1.0,1,0.7223570186314914,63
4236,3,10829,10829,0,0,0,0,1.0,1,1.0,1,1.0,1,0.711001582051371,63
4237,2,10831,10831,0,0,0,0,1.0,1,1.0,1,1.0,1,0.7082845045682058,65
4238,3,10834,10834,0,0,0,0,1.0,1,1.0,1,1.0,1,0.7016244589514399,65
4239,0,10834,10834,0,0,0,0,1.0,1,1.0,1,1.0,1,0.7016244589514399,65
4240,1,10835,10835,0,0,0,0,1.0,1,1.0,1,1.0,1,0.6802262495760512,66
4241,1,10836,10836,0,0,0,0,1.0,1,1.0,1,1.0,1,0.6773233327626828,66
4242,0,10836,10836,0,0,0,0,1.0,1,1.0,1,1.0,1,0.652389019301833,69
4243,0,10836,10836,0,0,0,0,1.0,1,1.0,1,1.0,1,0.6536375749951193,71
4244,0,10836,10836,0,0,0,0,1.0,1,1.0,1,1.0,1,0.6536375749951193,71
4245,0,10836,10836,0,0,0,0,1.0,1,1.0,1,1.0,1,0.6477031531128792,73
4246,0,10836,10836,0,0,0,0,1.0,1,1.0,1,1.0,1,0.6405127378901078,74
4247,3,10839,10839,0,0,0,0,1.0,1,1.0,1,1.0,1,0.6535526110061562,74
4248,1,10840,10840,0,0,0,0,1.0,1,1.0,1,1.0,1,0.6496651518185776,74
4249,2,10842,10842,0,0,0,0,1.0,1,1.0,1,1.0,1,0.6506924292362481,74
4250,4,10846,10846,0,0,0,0,1.0,1,1.0,1,1.0,1,0.6436677544234262,74
4251,4,10850,10850,0,0,0,0,1.0,1,1.0,1,1.0,1,0.6424050711196314,75
4252,4,10854,10854,0,0,0,0,1.0,1,1.0,1,1.0,1,0.6306788292027757,75
4253,4,10858,10858,0,0,0,0,1.0,1,1.0,1,1.0,1,0.6175107843939199,76
4254,6,10864,10864,0,0,0,0,1.0,1,1.0,1,1.0,1,0.620340639959426,75
4255,1,10865,10865,0,0,0,0,1.0,1,1.0,1,1.0,1,0.6099063551874927,76
4256,2,10867,10867,0,0,0,0,1.0,1,1.0,1,1.0,1,0.5862573137067392,78
4257,6,10873,10873,0,0,0,0,1.0,1,1.0,1,1.0,1,0.5904477333598102,78
4258,4,10877,10877,0,0,0,0,1.0,1,1.0,1,1.0,1,0.5966637587884037,77
4259,5,10882,10882,0,0,0,0,1.0,1,1.0,1,1.0,1,0.6022948555947774,78
4260,1,10883,10883,0,0,0,0,1.0,1,1.0,1,1.0,1,0.604542409515449,77
4261,4,10887,10887,0,0,0,0,1.0,1,1.0,1,1.0,1,0.6200294668781361,76
4262,3,10890,10890,0,0,0,0,1.0,1,1.0,1,1.0,1,0.6168320057835576,75
4263,5,10895,10895,0,0,0,0,1.0,1,1.0,1,1.0,1,0.6165211592797624,74
4264,2,10897,10897,0,0,0,0,1.0,1,1.0,1,1.0,1,0.634201167219846,74
4265,2,10899,10899,0,0,0,0,1.0,1,1.0,1,1.0,1,0.6383463202114447,73
4266,3,10902,10902,0,0,0,0,1.0,1,1.0,1,1.0,1,0.6603673874215933,71
4267,1,10903,10903,0,0,0,0,1.0,1,1.0,1,1.0,1,0.6498800198430577,69
4268,4,10907,10907,0,0,0,0,1.0,1,1.0,1,1.0,1,0.6562299222783915,67
4269,2,10909,10909,0,0,0,0,1.0,1,1.0,1,1.0,1,0.6736142395340599,64
4270,3,10912,10912,0,0,0,0,1.0,1,1.0,1,1.0,1,0.6548399515358623,63
4271,2,10914,10914,0,0,0,0,1.0,1,1.0,1,1.0,1,0.6595117142981647,63
4272,1,10915,10915,0,0,0,0,1.0,1,1.0,1,1.0,1,0.6618165250652448,62
4273,0,10915,10915,0,0,0,0,1.0,1,1.0,1,1.0,1,0.6618165250652448,62
4274,2,10917,10917,0,0,0,0,1.0,1,1.0,1,1.0,1,0.651516241003955,62
4275,0,10917,10917,0,0,0,0,1.0,1,1.0,1,1.0,1,0.6555521376231072,61
4276,2,10919,10919,0,0,0,0,1.0,1,1.0,1,1.0,1,0.6427215995245464,62
4277,2,10921,10921,0,0,0,0,1.0,1,1.0,1,1.0,1,0.6407214463313025,63
4278,1,10922,10922,0,0,0,0,1.0,1,1.0,1,1.0,1,0.6415192611447362,64
4279,6,10928,10928,0,0,0,0,1.0,1,1.0,1,1.0,1,0.6329413391625922,65
4280,2,10930,10930,0,0,0,0,1.0,1,1.0,1,1.0,1,0.615328816680835,65
4281,5,10935,10935,0,0,0,0,1.0,1,1.0,1,1.0,1,0.6091482784208789,65
4282,2,10937,10937,0,0,0,0,1.0,1,1.0,1,1.0,1,0.6124108956761019,66
4283,4,10941,10941,0,0,0,0,1.0,1,1.0,1,1.0,1,0.6177841616445029,66
4284,4,10945,10945,0,0,0,0,1.0,1,1.0,1,1.0,1,0.6390589270104381,66
4285,2,10947,10947,0,0,0,0,1.0,1,1.0,1,1.0,1,0.6486120316666679,67
4286,2,10949,10949,0,0,0,0,1.0,1,1.0,1,1.0,1,0.664352378621824,67
4287,0,10949,10949,0,0,0,0,1.0,1,1.0,1,1.0,1,0.664352378621824,67
4288,2,10951,10951,0,0,0,0,1.0,1,1.0,1,1.0,1,0.6498574508775458,68
4289,1,10952,10952,0,0,0,0,1.0,1,1.0,1,1.0,1,0.6409831563326496,68
4290,2,10954,10954,0,0,0,0,1.0,1,1.0,1,1.0,1,0.6294113656220361,70
4291,1,10955,10955,0,0,0,0,1.0,1,1.0,1,1.0,1,0.6288395749407926,71
4292,2,10957,10957,0,0,0,0,1.0,1,1.0,1,1.0,1,0.6222734803982019,71
4293,2,10959,10959,0,0,0,0,1.0,1,1.0,1,1.0,1,0.6207575100546084,71
4294,4,10963,10963,0,0,0,0,1.0,1,1.0,1,1.0,1,0.6252294344166206,71
4295,2,10965,10965,0,0,0,0,1.0,1,1.0,1,1.0,1,0.6302937634332021,72
4296,5,10970,10970,0,0,0,0,1.0,1,1.0,1,1.0,1,0.6451757842342245,73
4297,4,10974,10974,0,0,0,0,1.0,1,1.0,1,1.0,1,0.660885214904373,73
4298,3,10977,10977,0,0,0,0,1.0,1,1.0,1,1.0,1,0.6623964044793782,74
4299,1,10978,10978,0,0,0,0,1.0,1,1.0,1,1.0,1,0.6522889202160966,75
4300,3,10981,10981,0,0,0,0,1.0,1,1.0,1,1.0,1,0.6688298607457119,75
4301,1,10982,10982,0,0,0,0,1.0,1,1.0,1,1.0,1,0.6670515214704789,76
4302,1,10983,10983,0,0,0,0,1.0,1,1.0,1,1.0,1,0.6625390179064063,76
4303,1,10984,10984,0,0,0,0,1.0,1,1.0,1,1.0,1,0.6652558915027281,75
4304,2,10986,10986,0,0,0,0,1.0,1,1.0,1,1.0,1,0.6516832001563053,75
4305,3,10989,10989,0,0,0,0,1.0,1,1.0,1,1.0,1,0.6383022712801512,73
4306,2,10991,10991,0,0,0,0,1.0,1,1.0,1,1.0,1,0.6249188170865589,74
4307,5,10996,10996,0,0,0,0,1.0,1,1.0,1,1.0,1,0.5916488395856339,73
4308,3,10999,10999,0,0,0,0,1.0,1,1.0,1,1.0,1,0.574526395026941,71
4309,7,11006,11006,0,0,0,0,1.0,1,1.0,1,1.0,1,0.5757342645825742,70
4310,0,11006,11006,0,0,0,0,1.0,1,1.0,1,1.0,1,0.5747277219139839,69
4311,6,11012,11012,0,0,0,0,1.0,1,1.0,1,1.0,1,0.5934936238697925,69
4312,3,11015,11015,0,0,0,0,1.0,1,1.0,1,1.0,1,0.5954030672598133,66
4313,9,11024,11024,0,0,0,0,1.0,1,1.0,1,1.0,1,0.6083264457067296,64
4314,3,11027,11027,0,0,0,0,1.0,1,1.0,1,1.0,1,0.6205306711604296,61
4315,2,11029,11029,0,0,0,0,1.0,1,1.0,1,1.0,1,0.6174829295404458,61
4316,3,11032,11032,0,0,0,0,1.0,1,1.0,1,1.0,1,0.6253971540842936,60
4317,3,11035,11035,0,0,0,0,1.0,1,1.0,1,1.0,1,0.6120266299721292,62
4318,6,11041,11041,0,0,0,0,1.0,1,1.0,1,1.0,1,0.600928444389105,59
4319,2,11043,11043,0,0,0,0,1.0,1,1.0,1,1.0,1,0.6065877395933544,60
4320,7,11050,11050,0,0,0,0,1.0,1,1.0,1,1.0,1,0.6077760218252812,60
4321,6,11056,11056,0,0,0,0,1.0,1,1.0,1,1.0,1,0.6024410182621348,61
4322,2,11058,11058,0,0,0,0,1.0,1,1.0,1,1.0,1,0.60415091566752,61
4323,6,11064,11064,0,0,0,0,1.0,1,1.0,1,1.0,1,0.6163998588132835,61
4324,1,11065,11065,0,0,0,0,1.0,1,1.0,1,1.0,1,0.6197332114160071,60
4325,2,11067,11067,0,0,0,0,1.0,1,1.0,1,1.0,1,0.6209890001339124,60
4326,1,11068,11068,0,0,0,0,1.0,1,1.0,1,1.0,1,0.6145697244857757,61
4327,0,11068,11068,0,0,0,0,1.0,1,1.0,1,1.0,1,0.6113354404980819,62
4328,6,11074,11074,0,0,0,0,1.0,1,1.0,1,1.0,1,0.6163259795310413,62
4329,2,11076,11076,0,0,0,0,1.0,1,1.0,1,1.0,1,0.6048058094819652,65
4330,2,11078,11078,0,0,0,0,1.0,1,1.0,1,1.0,1,0.6024658744589356,65
4331,1,11079,11079,0,0,0,0,1.0,1,1.0,1,1.0,1,0.5989448175602189,65
4332,0,11079,11079,0,0,0,0,1.0,1,1.0,1,1.0,1,0.5930391866609888,66
4333,1,11080,11080,0,0,0,0,1.0,1,1.0,1,1.0,1,0.5831617812661622,66
4334,3,11083,11083,0,0,0,0,1.0,1,1.0,1,1.0,1,0.5589076272304694,66
4335,2,11085,11085,0,0,0,0,1.0,1,1.0,1,1.0,1,0.5605698014455133,65
4336,0,11085,11085,0,0,0,0,1.0,1,1.0,1,1.0,1,0.5522751577700713,67
4337,2,11087,11087,0,0,0,0,1.0,1,1.0,1,1.0,1,0.5624755679684615,69
4338,3,11090,11090,0,0,0,0,1.0,1,1.0,1,1.0,1,0.5774841458032429,70
4339,3,11093,11093,0,0,0,0,1.0,1,1.0,1,1.0,1,0.5734001407031032,70
4340,3,11096,11096,0,0,0,0,1.0,1,1.0,1,1.0,1,0.5808322358720474,71
4341,5,11101,11101,0,0,0,0,1.0,1,1.0,1,1.0,1,0.5957323154441111,70
4342,5,11106,11106,0,0,0,0,1.0,1,1.0,1,1.0,1,0.612650237507209,71
4343,7,11113,11113,0,0,0,0,1.0,1,1.0,1,1.0,1,0.617540243063018,67
4344,4,11117,11117,0,0,0,0,1.0,1,1.0,1,1.0,1,0.630867132222107,67
4345,9,11126,11126,0,0,0,0,1.0,1,1.0,1,1.0,1,0.6406580886152891,64
4346,8,11134,11134,0,0,0,0,1.0,1,1.0,1,1.0,1,0.6438105696129994,64
4347,6,11140,11140,0,0,0,0,1.0,1,1.0,1,1.0,1,0.6507286930237725,62
4348,6,11146,11146,0,0,0,0,1.0,1,1.0,1,1.0,1,0.6285595461193232,62
4349,3,11149,11149,0,0,0,0,1.0,1,1.0,1,1.0,1,0.6218815803223761,61
4350,4,11153,11153,0,0,0,0,1.0,1,1.0,1,1.0,1,0.6109564088636554,60
4351,0,11153,11153,0,0,0,0,1.0,1,1.0,1,1.0,1,0.6137354134876595,60
4352,2,11155,11155,0,0,0,0,1.0,1,1.0,1,1.0,1,0.6424398244885344,57
4353,4,11159,11159,0,0,0,0,1.0,1,1.0,1,1.0,1,0.6611979752596766,55
4354,1,11160,11160,0,0,0,0,1.0,1,1.0,1,1.0,1,0.6706759809090446,55
4355,4,11164,11164,0,0,0,0,1.0,1,1.0,1,1.0,1,0.6510415716259457,53
4356,1,11165,11165,0,0,0,0,1.0,1,1.0,1,1.0,1,0.6218652940052888,55
4357,3,11168,11168,0,0,0,0,1.0,1,1.0,1,1.0,1,0.5876422255730721,55
4358,2,11170,11170,0,0,0,0,1.0,1,1.0,1,1.0,1,0.6160579252700729,55
4359,2,11172,11172,0,0,0,0,1.0,1,1.0,1,1.0,1,0.645229732279297,54
4360,1,11173,11173,0,0,0,0,1.0,1,1.0,1,1.0,1,0.6411638144953766,55
4361,1,11174,11174,0,0,0,0,1.0,1,1.0,1,1.0,1,0.637885432930006,54
4362,3,11177,11177,0,0,0,0,1.0,1,1.0,1,1.0,1,0.6316061885363526,55
4363,1,11178,11178,0,0,0,0,1.0,1,1.0,1,1.0,1,0.62373994027944,55
4364,1,11179,11179,0,0,0,0,1.0,1,1.0,1,1.0,1,0.6199948084100032,55
4365,2,11181,11181,0,0,0,0,1.0,1,1.0,1,1.0,1,0.6214868437794346,54
4366,3,11184,11184,0,0,0,0,1.0,1,1.0,1,1.0,1,0.5970629311030471,54
4367,3,11187,11187,0,0,0,0,1.0,1,1.0,1,1.0,1,0.5671663397398772,57
4368,3,11190,11190,0,0,0,0,1.0,1,1.0,1,1.0,1,0.5510625597551423,57
4369,2,11192,11192,0,0,0,0,1.0,1,1.0,1,1.0,1,0.5506125463424896,58
4370,3,11195,11195,0,0,0,0,1.0,1,1.0,1,1.0,1,0.5365337165603578,59
4371,1,11196,11196,0,0,0,0,1.0,1,1.0,1,1.0,1,0.5476444520350631,60
4372,0,11196,11196,0,0,0,0,1.0,1,1.0,1,1.0,1,0.5476444520350631,60
4373,1,11197,11197,0,0,0,0,1.0,1,1.0,1,1.0,1,0.56295468700974,60
4374,1,11198,11198,0,0,0,0,1.0,1,1.0,1,1.0,1,0.5786277313737137,59
4375,2,11200,11200,0,0,0,0,1.0,1,1.0,1,1.0,1,0.5662733953279493,60
4376,4,11204,11204,0,0,0,0,1.0,1,1.0,1,1.0,1,0.5674587731414286,60
4377,2,11206,11206,0,0,0,0,1.0,1,1.0,1,1.0,1,0.5834704026259087,61
4378,6,11212,11212,0,0,0,0,1.0,1,1.0,1,1.0,1,0.5716562530900711,64
4379,5,11217,11217,0,0,0,0,1.0,1,1.0,1,1.0,1,0.5825255072043514,64
4380,3,11220,11220,0,0,0,0,1.0,1,1.0,1,1.0,1,0.6004897709691954,65
4381,4,11224,11224,0,0,0,0,1.0,1,1.0,1,1.0,1,0.6157521719425221,64
4382,3,11227,11227,0,0,0,0,1.0,1,1.0,1,1.0,1,0.6468542749253315,64
4383,2,11229,11229,0,0,0,0,1.0,1,1.0,1,1.0,1,0.6390864769384039,64
4384,2,11231,11231,0,0,0,0,1.0,1,1.0,1,1.0,1,0.6962652563462268,60
4385,5,11236,11236,0,0,0,0,1.0,1,1.0,1,1.0,1,0.6726227144889055,58
4386,0,11236,11236,0,0,0,0,1.0,1,1.0,1,1.0,1,0.659420632980356,58
4387,4,11240,11240,0,0,0,0,1.0,1,1.0,1,1.0,1,0.6211785469664893,55
4388,1,11241,11241,0,0,0,0,1.0,1,1.0,1,1.0,1,0.6458683516500058,56
4389,4,11245,11245,0,0,0,0,1.0,1,1.0,1,1.0,1,0.6226985483207933,55
4390,6,11251,11251,0,0,0,0,1.0,1,1.0,1,1.0,1,0.6486948615149035,55
4391,0,11251,11251,0,0,0,0,1.0,1,1.0,1,1.0,1,0.6423973012542141,56
4392,2,11253,11253,0,0,0,0,1.0,1,1.0,1,1.0,1,0.6655987903885628,56
4393,1,11254,11254,0,0,0,0,1.0,1,1.0,1,1.0,1,0.6749562382292364,55
4394,2,11256,11256,0,0,0,0,1.0,1,1.0,1,1.0,1,0.6497692493665725,53
4395,1,11257,11257,0,0,0,0,1.0,1,1.0,1,1.0,1,0.6387199136391766,53
4396,2,11259,11259,0,0,0,0,1.0,1,1.0,1,1.0,1,0.6163733032347102,53
4397,0,11259,11259,0,0,0,0,1.0,1,1.0,1,1.0,1,0.623815725725837,50
4398,4,11263,11263,0,0,0,0,1.0,1,1.0,1,1.0,1,0.5985362857019577,50
4399,0,11263,11263,0,0,0,0,1.0,1,1.0,1,1.0,1,0.5956211256432962,52
4400,2,11265,11265,0,0,0,0,1.0,1,1.0,1,1.0,1,0.5898953312671652,55
4401,1,11266,11266,0,0,0,0,1.0,1,1.0,1,1.0,1,0.5696308109926,56
4402,2,11268,11268,0,0,0,0,1.0,1,1.0,1,1.0,1,0.5874285084179304,56
4403,0,11268,11268,0,0,0,0,1.0,1,1.0,1,1.0,1,0.5779543321801258,57
4404,1,11269,11269,0,0,0,0,1.0,1,1.0,1,1.0,1,0.5719497067212757,57
4405,1,11270,11270,0,0,0,0,1.0,1,1.0,1,1.0,1,0.5672163905806179,58
4406,2,11272,11272,0,0,0,0,1.0,1,1.0,1,1.0,1,0.5685456117741652,58
4407,0,11272,11272,0,0,0,0,1.0,1,1.0,1,1.0,1,0.5685456117741652,58
4408,0,11272,11272,0,0,0,0,1.0,1,1.0,1,1.0,1,0.569796363823501,59
4409,0,11272,11272,0,0,0,0,1.0,1,1.0,1,1.0,1,0.569796363823501,59
4410,0,11272,11272,0,0,0,0,1.0,1,1.0,1,1.0,1,0.569796363823501,59
4411,0,11272,11272,0,0,0,0,1.0,1,1.0,1,1.0,1,0.5566021916639442,62
4412,1,11273,11273,0,0,0,0,1.0,1,1.0,1,1.0,1,0.5466258141315792,63
4413,2,11275,11275,0,0,0,0,1.0,1,1.0,1,1.0,1,0.5280101671026924,63
4414,1,11276,11276,0,0,0,0,1.0,1,1.0,1,1.0,1,0.534599882144376,64
4415,3,11279,11279,0,0,0,0,1.0,1,1.0,1,1.0,1,0.507830128267989,64
4416,1,11280,11280,0,0,0,0,1.0,1,1.0,1,1.0,1,0.49876190239699436,64
4417,1,11281,11281,0,0,0,0,1.0,1,1.0,1,1.0,1,0.4914209391010064,65
4418,2,11283,11283,0,0,0,0,1.0,1,1.0,1,1.0,1,0.49629135721805556,65
4419,2,11285,11285,0,0,0,0,1.0,1,1.0,1,1.0,1,0.530809765445382,62
4420,3,11288,11288,0,0,0,0,1.0,1,1.0,1,1.0,1,0.5531526525751856,62
4421,2,11290,11290,0,0,0,0,1.0,1,1.0,1,1.0,1,0.5631773194109307,65
4422,2,11292,11292,0,0,0,0,1.0,1,1.0,1,1.0,1,0.5796077673493744,64
4423,2,11294,11294,0,0,0,0,1.0,1,1.0,1,1.0,1,0.5918110920914972,63
4424,4,11298,11298,0,0,0,0,1.0,1,1.0,1,1.0,1,0.5896883784808513,63
4425,0,11298,11298,0,0,0,0,1.0,1,1.0,1,1.0,1,0.5963697373006367,63
4426,3,11301,11301,0,0,0,0,1.0,1,1.0,1,1.0,1,0.5639883705496131,63
4427,3,11304,11304,0,0,0,0,1.0,1,1.0,1,1.0,1,0.579482369423604,62
4428,3,11307,11307,0,0,0,0,1.0,1,1.0,1,1.0,1,0.5840914188237634,61
4429,6,11313,11313,0,0,0,0,1.0,1,1.0,1,1.0,1,0.6074928990332868,62
4430,7,11320,11320,0,0,0,0,1.0,1,1.0,1,1.0,1,0.6112112462000742,60
4431,5,11325,11325,0,0,0,0,1.0,1,1.0,1,1.0,1,0.6389902909563754,59
4432,5,11330,11330,0,0,0,0,1.0,1,1.0,1,1.0,1,0.6531328346902072,60
4433,7,11337,11337,0,0,0,0,1.0,1,1.0,1,1.0,1,0.6166440439132538,61
4434,4,11341,11341,0,0,0,0,1.0,1,1.0,1,1.0,1,0.6108053965330174,61
4435,5,11346,11346,0,0,0,0,1.0,1,1.0,1,1.0,1,0.609440623925418,61
4436,4,11350,11350,0,0,0,0,1.0,1,1.0,1,1.0,1,0.5953724496406105,61
4437,3,11353,11353,0,0,0,0,1.0,1,1.0,1,1.0,1,0.5832483975615597,61
4438,1,11354,11354,0,0,0,0,1.0,1,1.0,1,1.0,1,0.5757088550416398,62
4439,2,11356,11356,0,0,0,0,1.0,1,1.0,1,1.0,1,0.563346124814499,63
4440,4,11360,11360,0,0,0,0,1.0,1,1.0,1,1.0,1,0.5466196683584159,64
4441,2,11362,11362,0,0,0,0,1.0,1,1.0,1,1.0,1,0.5564605968073671,64
4442,3,11365,11365,0,0,0,0,1.0,1,1.0,1,1.0,1,0.5350063989690261,67
4443,4,11369,11369,0,0,0,0,1.0,1,1.0,1,1.0,1,0.5277335891422585,68
4444,4,11373,11373,0,0,0,0,1.0,1,1.0,1,1.0,1,0.551359423718667,69
4445,4,11377,11377,0,0,0,0,1.0,1,1.0,1,1.0,1,0.5467053041631629,71
4446,1,11378,11378,0,0,0,0,1.0,1,1.0,1,1.0,1,0.5399366547864277,71
4447,2,11380,11380,0,0,0,0,1.0,1,1.0,1,1.0,1,0.5302235843161441,72
4448,1,11381,11381,0,0,0,0,1.0,1,1.0,1,1.0,1,0.5279483131034097,71
4449,1,11382,11382,0,0,0,0,1.0,1,1.0,1,1.0,1,0.5257250668796771,70
4450,0,11382,11382,0,0,0,0,1.0,1,1.0,1,1.0,1,0.5336546170861741,69
4451,2,11384,11384,0,0,0,0,1.0,1,1.0,1,1.0,1,0.5389721539151086,69
4452,3,11387,11387,0,0,0,0,1.0,1,1.0,1,1.0,1,0.5562214073954118,70
4453,5,11392,11392,0,0,0,0,1.0,1,1.0,1,1.0,1,0.5542242768634298,70
4454,4,11396,11396,0,0,0,0,1.0,1,1.0,1,1.0,1,0.5830211587510472,71
4455,4,11400,11400,0,0,0,0,1.0,1,1.0,1,1.0,1,0.5965130065540032,71
4456,10,11410,11410,0,0,0,0,1.0,1,1.0,1,1.0,1,0.5898641947666785,71
4457,5,11415,11415,0,0,0,0,1.0,1,1.0,1,1.0,1,0.5976061985507832,69
4458,5,11420,11420,0,0,0,0,1.0,1,1.0,1,1.0,1,0.5907294256913191,70
4459,4,11424,11424,0,0,0,0,1.0,1,1.0,1,1.0,1,0.5687506897065606,68
4460,8,11432,11432,0,0,0,0,1.0,1,1.0,1,1.0,1,0.5512395583319855,68
4461,2,11434,11434,0,0,0,0,1.0,1,1.0,1,1.0,1,0.5414831269065723,67
4462,5,11439,11439,0,0,0,0,1.0,1,1.0,1,1.0,1,0.5463186959244711,66
4463,4,11443,11443,0,0,0,0,1.0,1,1.0,1,1.0,1,0.549351255282837,65
4464,6,11449,11449,0,0,0,0,1.0,1,1.0,1,1.0,1,0.5748574528605733,62
4465,3,11452,11452,0,0,0,0,1.0,1,1.0,1,1.0,1,0.5620492523052859,61
4466,3,11455,11455,0,0,0,0,1.0,1,1.0,1,1.0,1,0.5798713411550469,60
4467,4,11459,11459,0,0,0,0,1.0,1,1.0,1,1.0,1,0.5905748915919085,58
4468,2,11461,11461,0,0,0,0,1.0,1,1.0,1,1.0,1,0.6101445500196043,57
4469,5,11466,11466,0,0,0,0,1.0,1,1.0,1,1.0,1,0.5974764937454881,56
4470,1,11467,11467,0,0,0,0,1.0,1,1.0,1,1.0,1,0.5905212186438719,55
4471,6,11473,11473,0,0,0,0,1.0,1,1.0,1,1.0,1,0.5888533956402617,55
4472,4,11477,11477,0,0,0,0,1.0,1,1.0,1,1.0,1,0.5826692836036215,55
4473,4,11481,11481,0,0,0,0,1.0,1,1.0,1,1.0,1,0.5888890131374146,55
4474,2,11483,11483,0,0,0,0,1.0,1,1.0,1,1.0,1,0.591921691066543,55
4475,2,11485,11485,0,0,0,0,1.0,1,1.0,1,1.0,1,0.5578443011966939,56
4476,3,11488,11488,0,0,0,0,1.0,1,1.0,1,1.0,1,0.5567162991277633,56
4477,2,11490,11490,0,0,0,0,1.0,1,1.0,1,1.0,1,0.5484859308776928,57
4478,4,11494,11494,0,0,0,0,1.0,1,1.0,1,1.0,1,0.5654762968946743,55
4479,1,11495,11495,0,0,0,0,1.0,1,1.0,1,1.0,1,0.5634580949849358,55
4480,4,11499,11499,0,0,0,0,1.0,1,1.0,1,1.0,1,0.590357660435232,54
4481,4,11503,11503,0,0,0,0,1.0,1,1.0,1,1.0,1,0.6209413864126851,53
4482,2,11505,11505,0,0,0,0,1.0,1,1.0,1,1.0,1,0.6443853781780078,54
4483,5,11510,11510,0,0,0,0,1.0,1,1.0,1,1.0,1,0.6570908618265197,55
4484,2,11512,11512,0,0,0,0,1.0,1,1.0,1,1.0,1,0.6187884872345704,57
4485,3,11515,11515,0,0,0,0,1.0,1,1.0,1,1.0,1,0.6023459950977028,60
4486,2,11517,11517,0,0,0,0,1.0,1,1.0,1,1.0,1,0.6023294203159263,60
4487,2,11519,11519,0,0,0,0,1.0,1,1.0,1,1.0,1,0.5882861640657966,60
4488,0,11519,11519,0,0,0,0,1.0,1,1.0,1,1.0,1,0.5882861640657966,60
4489,1,11520,11520,0,0,0,0,1.0,1,1.0,1,1.0,1,0.5835268639752567,60
4490,2,11522,11522,0,0,0,0,1.0,1,1.0,1,1.0,1,0.5937633886884651,60
4491,1,11523,11523,0,0,0,0,1.0,1,1.0,1,1.0,1,0.6003470278363418,61
4492,0,11523,11523,0,0,0,0,1.0,1,1.0,1,1.0,1,0.6003470278363418,61
4493,0,11523,11523,0,0,0,0,1.0,1,1.0,1,1.0,1,0.6088883535004184,60
4494,1,11524,11524,0,0,0,0,1.0,1,1.0,1,1.0,1,0.6092796892403567,61
4495,1,11525,11525,0,0,0,0,1.0,1,1.0,1,1.0,1,0.6086651766383442,59
4496,4,11529,11529,0,0,0,0,1.0,1,1.0,1,1.0,1,0.6177421288427523,60
4497,1,11530,11530,0,0,0,0,1.0,1,1.0,1,1.0,1,0.6152912677252236,59
4498,5,11535,11535,0,0,0,0,1.0,1,1.0,1,1.0,1,0.6394305460813646,57
4499,4,11539,11539,0,0,0,0,1.0,1,1.0,1,1.0,1,0.6008610238312548,58
4500,5,11544,11544,0,0,0,0,1.0,1,1.0,1,1.0,1,0.5782041373408104,56
4501,1,11545,11545,0,0,0,0,1.0,1,1.0,1,1.0,1,0.5765575192595993,57
4502,7,11552,11552,0,0,0,0,1.0,1,1.0,1,1.0,1,0.5783862210961451,56
4503,5,11557,11557,0,0,0,0,1.0,1,1.0,1,1.0,1,0.5699738387238359,54
4504,2,11559,11559,0,0,0,0,1.0,1,1.0,1,1.0,1,0.5605614770787567,54
4505,6,11565,11565,0,0,0,0,1.0,1,1.0,1,1.0,1,0.5618306396683732,51
4506,2,11567,11567,0,0,0,0,1.0,1,1.0,1,1.0,1,0.5683125463922168,49
4507,3,11570,11570,0,0,0,0,1.0,1,1.0,1,1.0,1,0.586058790136145,48
4508,1,11571,11571,0,0,0,0,1.0,1,1.0,1,1.0,1,0.6026691528463334,48
4509,1,11572,11572,0,0,0,0,1.0,1,1.0,1,1.0,1,0.626786506324384,46
4510,2,11574,11574,0,0,0,0,1.0,1,1.0,1,1.0,1,0.623847886396415,44
4511,1,11575,11575,0,0,0,0,1.0,1,1.0,1,1.0,1,0.6247966483441405,45
4512,3,11578,11578,0,0,0,0,1.0,1,1.0,1,1.0,1,0.6205151412857738,46
4513,3,11581,11581,0,0,0,0,1.0,1,1.0,1,1.0,1,0.6083530279918575,45
4514,5,11586,11586,0,0,0,0,1.0,1,1.0,1,1.0,1,0.6238812705885826,46
4515,3,11589,11589,0,0,0,0,1.0,1,1.0,1,1.0,1,0.6339417908298031,48
4516,4,11593,11593,0,0,0,0,1.0,1,1.0,1,1.0,1,0.6054455384602956,49
4517,2,11595,11595,0,0,0,0,1.0,1,1.0,1,1.0,1,0.5939113812423357,50
4518,3,11598,11598,0,0,0,0,1.0,1,1.0,1,1.0,1,0.573356042251724,50
4519,0,11598,11598,0,0,0,0,1.0,1,1.0,1,1.0,1,0.5796446710911931,49
4520,3,11601,11601,0,0,0,0,1.0,1,1.0,1,1.0,1,0.5728241064926392,50
4521,0,11601,11601,0,0,0,0,1.0,1,1.0,1,1.0,1,0.5728241064926392,50
4522,3,11604,11604,0,0,0,0,1.0,1,1.0,1,1.0,1,0.5526369085506504,50
4523,1,11605,11605,0,0,0,0,1.0,1,1.0,1,1.0,1,0.53873130308248,51
4524,2,11607,11607,0,0,0,0,1.0,1,1.0,1,1.0,1,0.5197608002587174,52
4525,2,11609,11609,0,0,0,0,1.0,1,1.0,1,1.0,1,0.5108176107652026,53
4526,1,11610,11610,0,0,0,0,1.0,1,1.0,1,1.0,1,0.5098499808852124,54
4527,3,11613,11613,0,0,0,0,1.0,1,1.0,1,1.0,1,0.5099232889076571,55
4528,3,11616,11616,0,0,0,0,1.0,1,1.0,1,1.0,1,0.48594784190495055,55
4529,6,11622,11622,0,0,0,0,1.0,1,1.0,1,1.0,1,0.49091943913862995,55
4530,4,11626,11626,0,0,0,0,1.0,1,1.0,1,1.0,1,0.47831519902750175,56
4531,4,11630,11630,0,0,0,0,1.0,1,1.0,1,1.0,1,0.5001394794307767,56
4532,4,11634,11634,0,0,0,0,1.0,1,1.0,1,1.0,1,0.5190857207105117,55
4533,3,11637,11637,0,0,0,0,1.0,1,1.0,1,1.0,1,0.5103045007853244,54
4534,3,11640,11640,0,0,0,0,1.0,1,1.0,1,1.0,1,0.528982602644579,55
4535,1,11641,11641,0,0,0,0,1.0,1,1.0,1,1.0,1,0.5405940615303704,52
4536,3,11644,11644,0,0,0,0,1.0,1,1.0,1,1.0,1,0.5504710619919785,53
4537,3,11647,11647,0,0,0,0,1.0,1,1.0,1,1.0,1,0.5678465999845539,52
4538,5,11652,11652,0,0,0,0,1.0,1,1.0,1,1.0,1,0.5858121615045015,52
4539,3,11655,11655,0,0,0,0,1.0,1,1.0,1,1.0,1,0.5577601357668304,53
4540,1,11656,11656,0,0,0,0,1.0,1,1.0,1,1.0,1,0.5521512139339091,54
4541,4,11660,11660,0,0,0,0,1.0,1,1.0,1,1.0,1,0.5390758923819421,53
4542,4,11664,11664,0,0,0,0,1.0,1,1.0,1,1.0,1,0.535308591851566,53
4543,0,11664,11664,0,0,0,0,1.0,1,1.0,1,1.0,1,0.535308591851566,53
4544,1,11665,11665,0,0,0,0,1.0,1,1.0,1,1.0,1,0.5616536210236517,52
4545,6,11671,11671,0,0,0,0,1.0,1,1.0,1,1.0,1,0.5925495412933629,50
4546,1,11672,11672,0,0,0,0,1.0,1,1.0,1,1.0,1,0.5717729946870999,49
4547,4,11676,11676,0,0,0,0,1.0,1,1.0,1,1.0,1,0.5763062095732545,49
4548,3,11679,11679,0,0,0,0,1.0,1,1.0,1,1.0,1,0.5527526511323604,49
4549,2,11681,11681,0,0,0,0,1.0,1,1.0,1,1.0,1,0.5244433853798474,50
4550,2,11683,11683,0,0,0,0,1.0,1,1.0,1,1.0,1,0.5536488405740236,49
4551,1,11684,11684,0,0,0,0,1.0,1,1.0,1,1.0,1,0.564838046454796,49
4552,4,11688,11688,0,0,0,0,1.0,1,1.0,1,1.0,1,0.5693530085286608,49
4553,3,11691,11691,0,0,0,0,1.0,1,1.0,1,1.0,1,0.5979816859418033,49
4554,4,11695,11695,0,0,0,0,1.0,1,1.0,1,1.0,1,0.6228149036236513,49
4555,2,11697,11697,0,0,0,0,1.0,1,1.0,1,1.0,1,0.6241401054825043,48
4556,7,11704,11704,0,0,0,0,1.0,1,1.0,1,1.0,1,0.6511548173029443,48
4557,3,11707,11707,0,0,0,0,1.0,1,1.0,1,1.0,1,0.6510691208571727,49
4558,2,11709,11709,0,0,0,0,1.0,1,1.0,1,1.0,1,0.6465650883047517,49
4559,0,11709,11709,0,0,0,0,1.0,1,1.0,1,1.0,1,0.647535661594344,50
4560,4,11713,11713,0,0,0,0,1.0,1,1.0,1,1.0,1,0.6214666005996379,51
4561,3,11716,11716,0,0,0,0,1.0,1,1.0,1,1.0,1,0.6340227748215584,52
4562,2,11718,11718,0,0,0,0,1.0,1,1.0,1,1.0,1,0.6193379315182962,53
4563,0,11718,11718,0,0,0,0,1.0,1,1.0,1,1.0,1,0.6139875256882565,52
4564,1,11719,11719,0,0,0,0,1.0,1,1.0,1,1.0,1,0.6175286806142651,54
4565,0,11719,11719,0,0,0,0,1.0,1,1.0,1,1.0,1,0.6224915635000524,55
4566,2,11721,11721,0,0,0,0,1.0,1,1.0,1,1.0,1,0.6302363506932457,55
4567,1,11722,11722,0,0,0,0,1.0,1,1.0,1,1.0,1,0.6053215188062662,56
4568,3,11725,11725,0,0,0,0,1.0,1,1.0,1,1.0,1,0.6105280079650117,58
4569,4,11729,11729,0,0,0,0,1.0,1,1.0,1,1.0,1,0.6064386263037583,59
4570,3,11732,11732,0,0,0,0,1.0,1,1.0,1,1.0,1,0.6304499980120729,59
4571,1,11733,11733,0,0,0,0,1.0,1,1.0,1,1.0,1,0.6320445797467913,57
4572,1,11734,11734,0,0,0,0,1.0,1,1.0,1,1.0,1,0.6333388671980053,56
4573,1,11735,11735,0,0,0,0,1.0,1,1.0,1,1.0,1,0.6276059904104392,56
4574,0,11735,11735,0,0,0,0,1.0,1,1.0,1,1.0,1,0.614046226012087,55
4575,1,11736,11736,0,0,0,0,1.0,1,1.0,1,1.0,1,0.628696680962292,55
4576,2,11738,11738,0,0,0,0,1.0,1,1.0,1,1.0,1,0.6375942706699338,55
4577,0,11738,11738,0,0,0,0,1.0,1,1.0,1,1.0,1,0.6401353427307407,54
4578,0,11738,11738,0,0,0,0,1.0,1,1.0,1,1.0,1,0.6420937173255464,54
4579,3,11741,11741,0,0,0,0,1.0,1,1.0,1,1.0,1,0.6519976515788123,54
4580,4,11745,11745,0,0,0,0,1.0,1,1.0,1,1.0,1,0.6687002488023903,55
4581,0,11745,11745,0,0,0,0,1.0,1,1.0,1,1.0,1,0.6720793655138743,56
4582,3,11748,11748,0,0,0,0,1.0,1,1.0,1,1.0,1,0.676705214220831,56
4583,1,11749,11749,0,0,0,0,1.0,1,1.0,1,1.0,1,0.6756489508163385,57
4584,1,11750,11750,0,0,0,0,1.0,1,1.0,1,1.0,1,0.6776569941102379,57
4585,0,11750,11750,0,0,0,0,1.0,1,1.0,1,1.0,1,0.6776569941102379,57
4586,0,11750,11750,0,0,0,0,1.0,1,1.0,1,1.0,1,0.6776569941102379,57
4587,0,11750,11750,0,0,0,0,1.0,1,1.0,1,1.0,1,0.6776569941102379,57
4588,0,11750,11750,0,0,0,0,1.0,1,1.0,1,1.0,1,0.6733647388868778,58
4589,1,11751,11751,0,0,0,0,1.0,1,1.0,1,1.0,1,0.6769914052000615,59
4590,1,11752,11752,0,0,0,0,1.0,1,1.0,1,1.0,1,0.6761368415914035,60
4591,2,11754,11754,0,0,0,0,1.0,1,1.0,1,1.0,1,0.6649872175258554,61
4592,3,11757,11757,0,0,0,0,1.0,1,1.0,1,1.0,1,0.6743529083918822,62
4593,0,11757,11757,0,0,0,0,1.0,1,1.0,1,1.0,1,0.6614303716333719,64
4594,2,11759,11759,0,0,0,0,1.0,1,1.0,1,1.0,1,0.6733945227397221,64
4595,4,11763,11763,0,0,0,0,1.0,1,1.0,1,1.0,1,0.6748411071867672,63
4596,2,11765,11765,0,0,0,0,1.0,1,1.0,1,1.0,1,0.6763175763514974,63
4597,3,11768,11768,0,0,0,0,1.0,1,1.0,1,1.0,1,0.6923875123060493,63
4598,3,11771,11771,0,0,0,0,1.0,1,1.0,1,1.0,1,0.6698689669024904,65
4599,0,11771,11771,0,0,0,0,1.0,1,1.0,1,1.0,1,0.6619050697154826,66
4600,1,11772,11772,0,0,0,0,1.0,1,1.0,1,1.0,1,0.6748005520432685,67
4601,4,11776,11776,0,0,0,0,1.0,1,1.0,1,1.0,1,0.6687926667159937,67
4602,0,11776,11776,0,0,0,0,1.0,1,1.0,1,1.0,1,0.6531978773516338,69
4603,3,11779,11779,0,0,0,0,1.0,1,1.0,1,1.0,1,0.6501061277460581,69
4604,3,11782,11782,0,0,0,0,1.0,1,1.0,1,1.0,1,0.6460272027301187,69
4605,1,11783,11783,0,0,0,0,1.0,1,1.0,1,1.0,1,0.647087490152617,70
4606,1,11784,11784,0,0,0,0,1.0,1,1.0,1,1.0,1,0.6494430799558377,70
4607,4,11788,11788,0,0,0,0,1.0,1,1.0,1,1.0,1,0.6629411335612178,72
4608,0,11788,11788,0,0,0,0,1.0,1,1.0,1,1.0,1,0.6651188994731947,73
4609,4,11792,11792,0,0,0,0,1.0,1,1.0,1,1.0,1,0.6568060121368287,72
4610,0,11792,11792,0,0,0,0,1.0,1,1.0,1,1.0,1,0.6568060121368287,72
4611,2,11794,11794,0,0,0,0,1.0,1,1.0,1,1.0,1,0.6490293009075828,71
4612,0,11794,11794,0,0,0,0,1.0,1,1.0,1,1.0,1,0.6525704274461035,70
4613,1,11795,11795,0,0,0,0,1.0,1,1.0,1,1.0,1,0.6523292071423191,69
4614,3,11798,11798,0,0,0,0,1.0,1,1.0,1,1.0,1,0.6145648620990339,68
4615,4,11802,11802,0,0,0,0,1.0,1,1.0,1,1.0,1,0.5789891765784752,68
4616,0,11802,11802,0,0,0,0,1.0,1,1.0,1,1.0,1,0.588199780667882,65
4617,3,11805,11805,0,0,0,0,1.0,1,1.0,1,1.0,1,0.5716023848263755,66
4618,1,11806,11806,0,0,0,0,1.0,1,1.0,1,1.0,1,0.5834961106718068,66
4619,6,11812,11812,0,0,0,0,1.0,1,1.0,1,1.0,1,0.6163935793698763,65
4620,2,11814,11814,0,0,0,0,1.0,1,1.0,1,1.0,1,0.6103285162699433,65
4621,5,11819,11819,0,0,0,0,1.0,1,1.0,1,1.0,1,0.6498981816396863,67
4622,5,11824,11824,0,0,0,0,1.0,1,1.0,1,1.0,1,0.6404400843200427,65
4623,4,11828,11828,0,0,0,0,1.0,1,1.0,1,1.0,1,0.6283225904339604,66
4624,4,11832,11832,0,0,0,0,1.0,1,1.0,1,1.0,1,0.63476508945071,65
4625,5,11837,11837,0,0,0,0,1.0,1,1.0,1,1.0,1,0.6368618367925172,64
4626,1,11838,11838,0,0,0,0,1.0,1,1.0,1,1.0,1,0.6285160892552525,63
4627,5,11843,11843,0,0,0,0,1.0,1,1.0,1,1.0,1,0.6079707773470324,65
4628,2,11845,11845,0,0,0,0,1.0,1,1.0,1,1.0,1,0.6229371057010649,64
4629,3,11848,11848,0,0,0,0,1.0,1,1.0,1,1.0,1,0.6054112524293904,64
4630,3,11851,11851,0,0,0,0,1.0,1,1.0,1,1.0,1,0.6182740169567594,64
4631,2,11853,11853,0,0,0,0,1.0,1,1.0,1,1.0,1,0.6386985089743671,66
4632,3,11856,11856,0,0,0,0,1.0,1,1.0,1,1.0,1,0.651303336445485,65
4633,0,11856,11856,0,0,0,0,1.0,1,1.0,1,1.0,1,0.6425625893466343,66
4634,1,11857,11857,0,0,0,0,1.0,1,1.0,1,1.0,1,0.6463413090016261,66
4635,2,11859,11859,0,0,0,0,1.0,1,1.0,1,1.0,1,0.6480385956672993,66
4636,1,11860,11860,0,0,0,0,1.0,1,1.0,1,1.0,1,0.6423493084964337,66
4637,1,11861,11861,0,0,0,0,1.0,1,1.0,1,1.0,1,0.6322992134314412,68
4638,4,11865,11865,0,0,0,0,1.0,1,1.0,1,1.0,1,0.638575773612645,68
4639,1,11866,11866,0,0,0,0,1.0,1,1.0,1,1.0,1,0.6391841850406288,69
4640,1,11867,11867,0,0,0,0,1.0,1,1.0,1,1.0,1,0.6354586120062621,69
4641,1,11868,11868,0,0,0,0,1.0,1,1.0,1,1.0,1,0.6355658262342623,70
4642,0,11868,11868,0,0,0,0,1.0,1,1.0,1,1.0,1,0.640602828668747,69
4643,3,11871,11871,0,0,0,0,1.0,1,1.0,1,1.0,1,0.6257621860278797,70
4644,0,11871,11871,0,0,0,0,1.0,1,1.0,1,1.0,1,0.6328955253989286,69
4645,4,11875,11875,0,0,0,0,1.0,1,1.0,1,1.0,1,0.6089548957776717,70
4646,4,11879,11879,0,0,0,0,1.0,1,1.0,1,1.0,1,0.6184037042552447,68
4647,1,11880,11880,0,0,0,0,1.0,1,1.0,1,1.0,1,0.6244192028639196,68
4648,4,11884,11884,0,0,0,0,1.0,1,1.0,1,1.0,1,0.6429925710047253,67
4649,1,11885,11885,0,0,0,0,1.0,1,1.0,1,1.0,1,0.6344167631436187,67
4650,1,11886,11886,0,0,0,0,1.0,1,1.0,1,1.0,1,0.6243606396765351,67
4651,1,11887,11887,0,0,0,0,1.0,1,1.0,1,1.0,1,0.6220222970555938,68
4652,2,11889,11889,0,0,0,0,1.0,1,1.0,1,1.0,1,0.5976387615025099,66
4653,4,11893,11893,0,0,0,0,1.0,1,1.0,1,1.0,1,0.5931071721738437,64
4654,6,11899,11899,0,0,0,0,1.0,1,1.0,1,1.0,1,0.6039164720810394,65
4655,3,11902,11902,0,0,0,0,1.0,1,1.0,1,1.0,1,0.5926795243941647,64
4656,5,11907,11907,0,0,0,0,1.0,1,1.0,1,1.0,1,0.6026383874352106,65
4657,1,11908,11908,0,0,0,0,1.0,1,1.0,1,1.0,1,0.5916151695414025,66
4658,4,11912,11912,0,0,0,0,1.0,1,1.0,1,1.0,1,0.5962472084497935,65
4659,3,11915,11915,0,0,0,0,1.0,1,1.0,1,1.0,1,0.5806622750517821,65
4660,2,11917,11917,0,0,0,0,1.0,1,1.0,1,1.0,1,0.593278947495638,66
4661,2,11919,11919,0,0,0,0,1.0,1,1.0,1,1.0,1,0.6032714283083638,66
4662,2,11921,11921,0,0,0,0,1.0,1,1.0,1,1.0,1,0.6049624290232759,68
4663,3,11924,11924,0,0,0,0,1.0,1,1.0,1,1.0,1,0.5906011201383792,67
4664,3,11927,11927,0,0,0,0,1.0,1,1.0,1,1.0,1,0.60603675408457,67
4665,3,11930,11930,0,0,0,0,1.0,1,1.0,1,1.0,1,0.6000544942600438,67
4666,0,11930,11930,0,0,0,0,1.0,1,1.0,1,1.0,1,0.6119435371360038,67
4667,4,11934,11934,0,0,0,0,1.0,1,1.0,1,1.0,1,0.5962092985010659,66
4668,2,11936,11936,0,0,0,0,1.0,1,1.0,1,1.0,1,0.5962450454439172,66
4669,6,11942,11942,0,0,0,0,1.0,1,1.0,1,1.0,1,0.6053220596126305,66
4670,2,11944,11944,0,0,0,0,1.0,1,1.0,1,1.0,1,0.6214127476237081,64
4671,4,11948,11948,0,0,0,0,1.0,1,1.0,1,1.0,1,0.6259482224807644,64
4672,5,11953,11953,0,0,0,0,1.0,1,1.0,1,1.0,1,0.6341800981691648,64
4673,3,11956,11956,0,0,0,0,1.0,1,1.0,1,1.0,1,0.6408253907611092,65
4674,3,11959,11959,0,0,0,0,1.0,1,1.0,1,1.0,1,0.6197111360564811,66
4675,1,11960,11960,0,0,0,0,1.0,1,1.0,1,1.0,1,0.6390612516980809,65
4676,3,11963,11963,0,0,0,0,1.0,1,1.0,1,1.0,1,0.6344169590389473,65
4677,1,11964,11964,0,0,0,0,1.0,1,1.0,1,1.0,1,0.6395798935670572,65
4678,4,11968,11968,0,0,0,0,1.0,1,1.0,1,1.0,1,0.6264970010985519,64
4679,2,11970,11970,0,0,0,0,1.0,1,1.0,1,1.0,1,0.5988499601889775,66
4680,5,11975,11975,0,0,0,0,1.0,1,1.0,1,1.0,1,0.5824862241770069,67
4681,4,11979,11979,0,0,0,0,1.0,1,1.0,1,1.0,1,0.608226245360712,67
4682,7,11986,11986,0,0,0,0,1.0,1,1.0,1,1.0,1,0.597136916563139,67
4683,5,11991,11991,0,0,0,0,1.0,1,1.0,1,1.0,1,0.6004481892882644,67
4684,3,11994,11994,0,0,0,0,1.0,1,1.0,1,1.0,1,0.6106607812615463,66
4685,6,12000,12000,0,0,0,0,1.0,1,1.0,1,1.0,1,0.6129963691431548,65
4686,4,12004,12004,0,0,0,0,1.0,1,1.0,1,1.0,1,0.6306825007094219,65
4687,3,12007,12007,0,0,0,0,1.0,1,1.0,1,1.0,1,0.610749559899568,65
4688,4,12011,12011,0,0,0,0,1.0,1,1.0,1,1.0,1,0.6390292317213361,64
4689,2,12013,12013,0,0,0,0,1.0,1,1.0,1,1.0,1,0.6311791815753683,65
4690,3,12016,12016,0,0,0,0,1.0,1,1.0,1,1.0,1,0.6286876206996875,63
4691,1,12017,12017,0,0,0,0,1.0,1,1.0,1,1.0,1,0.6169256019177308,64
4692,1,12018,12018,0,0,0,0,1.0,1,1.0,1,1.0,1,0.6023400853417499,63
4693,1,12019,12019,0,0,0,0,1.0,1,1.0,1,1.0,1,0.6014129408474621,64
4694,3,12022,12022,0,0,0,0,1.0,1,1.0,1,1.0,1,0.5673103829055697,63
4695,0,12022,12022,0,0,0,0,1.0,1,1.0,1,1.0,1,0.5663870487397206,62
4696,3,12025,12025,0,0,0,0,1.0,1,1.0,1,1.0,1,0.5524780098315852,61
4697,0,12025,12025,0,0,0,0,1.0,1,1.0,1,1.0,1,0.5327864567362189,63
4698,2,12027,12027,0,0,0,0,1.0,1,1.0,1,1.0,1,0.5340641222213002,63
4699,5,12032,12032,0,0,0,0,1.0,1,1.0,1,1.0,1,0.5154766969224469,65
4700,2,12034,12034,0,0,0,0,1.0,1,1.0,1,1.0,1,0.5180943240809417,64
4701,5,12039,12039,0,0,0,0,1.0,1,1.0,1,1.0,1,0.5171509517752277,64
4702,2,12041,12041,0,0,0,0,1.0,1,1.0,1,1.0,1,0.5068837915670366,66
4703,7,12048,12048,0,0,0,0,1.0,1,1.0,1,1.0,1,0.49790220827058795,65
4704,4,12052,12052,0,0,0,0,1.0,1,1.0,1,1.0,1,0.5141617501642437,64
4705,6,12058,12058,0,0,0,0,1.0,1,1.0,1,1.0,1,0.5403629965317805,65
4706,7,12065,12065,0,0,0,0,1.0,1,1.0,1,1.0,1,0.5353552176899568,65
4707,5,12070,12070,0,0,0,0,1.0,1,1.0,1,1.0,1,0.5417436525520214,63
4708,5,12075,12075,0,0,0,0,1.0,1,1.0,1,1.0,1,0.5497086313826872,62
4709,4,12079,12079,0,0,0,0,1.0,1,1.0,1,1.0,1,0.5886338667781721,61
4710,2,12081,12081,0,0,0,0,1.0,1,1.0,1,1.0,1,0.6211298472354347,60
4711,2,12083,12083,0,0,0,0,1.0,1,1.0,1,1.0,1,0.6214792877056663,59
4712,1,12084,12084,0,0,0,0,1.0,1,1.0,1,1.0,1,0.6142595816897206,58
4713,3,12087,12087,0,0,0,0,1.0,1,1.0,1,1.0,1,0.6229968998006263,58
4714,2,12089,12089,0,0,0,0,1.0,1,1.0,1,1.0,1,0.5999259150493689,57
4715,1,12090,12090,0,0,0,0,1.0,1,1.0,1,1.0,1,0.5985391828191189,57
4716,3,12093,12093,0,0,0,0,1.0,1,1.0,1,1.0,1,0.5882499483995891,55
4717,2,12095,12095,0,0,0,0,1.0,1,1.0,1,1.0,1,0.5834572849553814,57
4718,0,12095,12095,0,0,0,0,1.0,1,1.0,1,1.0,1,0.5859155414670811,56
4719,1,12096,12096,0,0,0,0,1.0,1,1.0,1,1.0,1,0.5877434508906944,56
4720,4,12100,12100,0,0,0,0,1.0,1,1.0,1,1.0,1,0.5934467623461114,57
4721,0,12100,12100,0,0,0,0,1.0,1,1.0,1,1.0,1,0.5934467623461114,57
4722,3,12103,12103,0,0,0,0,1.0,1,1.0,1,1.0,1,0.5837176415368662,57
4723,0,12103,12103,0,0,0,0,1.0,1,1.0,1,1.0,1,0.5841325549876525,57
4724,4,12107,12107,0,0,0,0,1.0,1,1.0,1,1.0,1,0.5685754102178222,57
4725,4,12111,12111,0,0,0,0,1.0,1,1.0,1,1.0,1,0.5835445921951069,57
4726,2,12113,12113,0,0,0,0,1.0,1,1.0,1,1.0,1,0.586087220660229,57
4727,2,12115,12115,0,0,0,0,1.0,1,1.0,1,1.0,1,0.5740220578948447,56
4728,4,12119,12119,0,0,0,0,1.0,1,1.0,1,1.0,1,0.5413336176631734,57
4729,1,12120,12120,0,0,0,0,1.0,1,1.0,1,1.0,1,0.5434128436356099,56
4730,2,12122,12122,0,0,0,0,1.0,1,1.0,1,1.0,1,0.5204726718661316,54
4731,8,12130,12130,0,0,0,0,1.0,1,1.0,1,1.0,1,0.5409332722475206,54
4732,5,12135,12135,0,0,0,0,1.0,1,1.0,1,1.0,1,0.5342411471705998,54
4733,5,12140,12140,0,0,0,0,1.0,1,1.0,1,1.0,1,0.5369411068506406,55
4734,4,12144,12144,0,0,0,0,1.0,1,1.0,1,1.0,1,0.5618500569184698,56
4735,1,12145,12145,0,0,0,0,1.0,1,1.0,1,1.0,1,0.5647406136895256,56
4736,3,12148,12148,0,0,0,0,1.0,1,1.0,1,1.0,1,0.5630691501724205,58
4737,1,12149,12149,0,0,0,0,1.0,1,1.0,1,1.0,1,0.5500308006031116,59
4738,3,12152,12152,0,0,0,0,1.0,1,1.0,1,1.0,1,0.5647141474842732,60
4739,4,12156,12156,0,0,0,0,1.0,1,1.0,1,1.0,1,0.5505156268499304,60
4740,1,12157,12157,0,0,0,0,1.0,1,1.0,1,1.0,1,0.561373400455554,60
4741,3,12160,12160,0,0,0,0,1.0,1,1.0,1,1.0,1,0.5615001630150324,61
4742,2,12162,12162,0,0,0,0,1.0,1,1.0,1,1.0,1,0.5940296600322275,61
4743,4,12166,12166,0,0,0,0,1.0,1,1.0,1,1.0,1,0.5629927687781713,60
4744,4,12170,12170,0,0,0,0,1.0,1,1.0,1,1.0,1,0.5754150761428919,60
4745,5,12175,12175,0,0,0,0,1.0,1,1.0,1,1.0,1,0.5785902454986571,59
4746,1,12176,12176,0,0,0,0,1.0,1,1.0,1,1.0,1,0.5700559888726686,59
4747,5,12181,12181,0,0,0,0,1.0,1,1.0,1,1.0,1,0.5719601166757943,58
4748,0,12181,12181,0,0,0,0,1.0,1,1.0,1,1.0,1,0.5645660906136877,58
4749,3,12184,12184,0,0,0,0,1.0,1,1.0,1,1.0,1,0.5520301729488771,58
4750,1,12185,12185,0,0,0,0,1.0,1,1.0,1,1.0,1,0.565599286043646,56
4751,0,12185,12185,0,0,0,0,1.0,1,1.0,1,1.0,1,0.5600831141216678,58
4752,1,12186,12186,0,0,0,0,1.0,1,1.0,1,1.0,1,0.5839759733564449,55
4753,0,12186,12186,0,0,0,0,1.0,1,1.0,1,1.0,1,0.5839759733564449,55
4754,3,12189,12189,0,0,0,0,1.0,1,1.0,1,1.0,1,0.561078845314869,54
4755,2,12191,12191,0,0,0,0,1.0,1,1.0,1,1.0,1,0.5634688051859955,54
4756,4,12195,12195,0,0,0,0,1.0,1,1.0,1,1.0,1,0.5328788902521316,54
4757,4,12199,12199,0,0,0,0,1.0,1,1.0,1,1.0,1,0.5092402982210741,53
4758,6,12205,12205,0,0,0,0,1.0,1,1.0,1,1.0,1,0.4753553714383453,53
4759,5,12210,12210,0,0,0,0,1.0,1,1.0,1,1.0,1,0.4817638076560905,53
4760,8,12218,12218,0,0,0,0,1.0,1,1.0,1,1.0,1,0.5056019883831808,53
4761,8,12226,12226,0,0,0,0,1.0,1,1.0,1,1.0,1,0.5430266447118681,52
4762,4,12230,12230,0,0,0,0,1.0,1,1.0,1,1.0,1,0.5515624321649216,54
4763,8,12238,12238,0,0,0,0,1.0,1,1.0,1,1.0,1,0.5792320611469572,54
4764,3,12241,12241,0,0,0,0,1.0,1,1.0,1,1.0,1,0.5365910031884862,55
4765,6,12247,12247,0,0,0,0,1.0,1,1.0,1,1.0,1,0.540673699565783,56
4766,1,12248,12248,0,0,0,0,1.0,1,1.0,1,1.0,1,0.5122579748115144,58
4767,1,12249,12249,0,0,0,0,1.0,1,1.0,1,1.0,1,0.5206937917053542,59
4768,0,12249,12249,0,0,0,0,1.0,1,1.0,1,1.0,1,0.5101434420872667,60
4769,1,12250,12250,0,0,0,0,1.0,1,1.0,1,1.0,1,0.5032424340628056,59
4770,0,12250,12250,0,0,0,0,1.0,1,1.0,1,1.0,1,0.506791302394665,60
4771,0,12250,12250,0,0,0,0,1.0,1,1.0,1,1.0,1,0.5227150954938081,59
4772,0,12250,12250,0,0,0,0,1.0,1,1.0,1,1.0,1,0.5227150954938081,59
4773,2,12252,12252,0,0,0,0,1.0,1,1.0,1,1.0,1,0.5188999802004108,60
4774,1,12253,12253,0,0,0,0,1.0,1,1.0,1,1.0,1,0.5158733309165145,60
4775,2,12255,12255,0,0,0,0,1.0,1,1.0,1,1.0,1,0.5197339996553101,62
4776,2,12257,12257,0,0,0,0,1.0,1,1.0,1,1.0,1,0.5183747570833674,63
4777,2,12259,12259,0,0,0,0,1.0,1,1.0,1,1.0,1,0.5209370636359105,63
4778,2,12261,12261,0,0,0,0,1.0,1,1.0,1,1.0,1,0.4844858746696638,63
4779,6,12267,12267,0,0,0,0,1.0,1,1.0,1,1.0,1,0.4629955427715016,63
4780,2,12269,12269,0,0,0,0,1.0,1,1.0,1,1.0,1,0.474553364386443,65
4781,8,12277,12277,0,0,0,0,1.0,1,1.0,1,1.0,1,0.45036334505605774,64
4782,4,12281,12281,0,0,0,0,1.0,1,1.0,1,1.0,1,0.45875919632273165,65
4783,7,12288,12288,0,0,0,0,1.0,1,1.0,1,1.0,1,0.48212615216724336,66
4784,8,12296,12296,0,0,0,0,1.0,1,1.0,1,1.0,1,0.5086703407919293,64
4785,6,12302,12302,0,0,0,0,1.0,1,1.0,1,1.0,1,0.4901427416649229,65
4786,8,12310,12310,0,0,0,0,1.0,1,1.0,1,1.0,1,0.5013051250408439,66
4787,9,12319,12319,0,0,0,0,1.0,1,1.0,1,1.0,1,0.5278398834769883,63
4788,8,12327,12327,0,0,0,0,1.0,1,1.0,1,1.0,1,0.5335398872534369,63
4789,8,12335,12335,0,0,0,0,1.0,1,1.0,1,1.0,1,0.5622987308568713,60
4790,6,12341,12341,0,0,0,0,1.0,1,1.0,1,1.0,1,0.5076735329233749,61
4791,6,12347,12347,0,0,0,0,1.0,1,1.0,1,1.0,1,0.5236442878969602,59
4792,5,12352,12352,0,0,0,0,1.0,1,1.0,1,1.0,1,0.5160510200988527,59
4793,6,12358,12358,0,0,0,0,1.0,1,1.0,1,1.0,1,0.5547677511666473,61
4794,2,12360,12360,0,0,0,0,1.0,1,1.0,1,1.0,1,0.5567682000869123,60
4795,0,12360,12360,0,0,0,0,1.0,1,1.0,1,1.0,1,0.5582556460009452,61
4796,3,12363,12363,0,0,0,0,1.0,1,1.0,1,1.0,1,0.5480744848869593,60
4797,0,12363,12363,0,0,0,0,1.0,1,1.0,1,1.0,1,0.5500033589043801,61
4798,1,12364,12364,0,0,0,0,1.0,1,1.0,1,1.0,1,0.5619828970600748,61
4799,4,12368,12368,0,0,0,0,1.0,1,1.0,1,1.0,1,0.5396361387275708,59
4800,0,12368,12368,0,0,0,0,1.0,1,1.0,1,1.0,1,0.5421131750449719,57
4801,0,12368,12368,0,0,0,0,1.0,1,1.0,1,1.0,1,0.5353082870871958,58
4802,3,12371,12371,0,0,0,0,1.0,1,1.0,1,1.0,1,0.5287463971963919,56
4803,1,12372,12372,0,0,0,0,1.0,1,1.0,1,1.0,1,0.5229376421915176,57
4804,1,12373,12373,0,0,0,0,1.0,1,1.0,1,1.0,1,0.5169088333419791,55
4805,3,12376,12376,0,0,0,0,1.0,1,1.0,1,1.0,1,0.5082722193422164,56
4806,0,12376,12376,0,0,0,0,1.0,1,1.0,1,1.0,1,0.5097570662011257,55
4807,3,12379,12379,0,0,0,0,1.0,1,1.0,1,1.0,1,0.5318747500626799,53
4808,3,12382,12382,0,0,0,0,1.0,1,1.0,1,1.0,1,0.5481467614366251,54
4809,3,12385,12385,0,0,0,0,1.0,1,1.0,1,1.0,1,0.5223896617680633,53
4810,2,12387,12387,0,0,0,0,1.0,1,1.0,1,1.0,1,0.530989929872874,53
4811,5,12392,12392,0,0,0,0,1.0,1,1.0,1,1.0,1,0.5367109749450223,54
4812,1,12393,12393,0,0,0,0,1.0,1,1.0,1,1.0,1,0.5340400800968508,54
4813,6,12399,12399,0,0,0,0,1.0,1,1.0,1,1.0,1,0.5405508022416009,55
4814,5,12404,12404,0,0,0,0,1.0,1,1.0,1,1.0,1,0.5791556259727516,55
4815,4,12408,12408,0,0,0,0,1.0,1,1.0,1,1.0,1,0.594901254134781,56
4816,1,12409,12409,0,0,0,0,1.0,1,1.0,1,1.0,1,0.585071523408962,56
4817,3,12412,12412,0,0,0,0,1.0,1,1.0,1,1.0,1,0.5963511088110025,58
4818,5,12417,12417,0,0,0,0,1.0,1,1.0,1,1.0,1,0.5886835776730436,58
4819,3,12420,12420,0,0,0,0,1.0,1,1.0,1,1.0,1,0.5625610400702951,58
4820,1,12421,12421,0,0,0,0,1.0,1,1.0,1,1.0,1,0.5610127639380712,58
4821,4,12425,12425,0,0,0,0,1.0,1,1.0,1,1.0,1,0.5473282287801572,58
4822,2,12427,12427,0,0,0,0,1.0,1,1.0,1,1.0,1,0.5537504943509118,58
4823,1,12428,12428,0,0,0,0,1.0,1,1.0,1,1.0,1,0.5561583075290256,57
4824,3,12431,12431,0,0,0,0,1.0,1,1.0,1,1.0,1,0.5850320124845079,56
4825,3,12434,12434,0,0,0,0,1.0,1,1.0,1,1.0,1,0.5745593046969455,57
4826,1,12435,12435,0,0,0,0,1.0,1,1.0,1,1.0,1,0.5860963444600055,57
4827,2,12437,12437,0,0,0,0,1.0,1,1.0,1,1.0,1,0.6023462063811426,56
4828,1,12438,12438,0,0,0,0,1.0,1,1.0,1,1.0,1,0.561587716286841,57
4829,2,12440,12440,0,0,0,0,1.0,1,1.0,1,1.0,1,0.5696036748818101,56
4830,1,12441,12441,0,0,0,0,1.0,1,1.0,1,1.0,1,0.5537659659990266,57
4831,1,12442,12442,0,0,0,0,1.0,1,1.0,1,1.0,1,0.577647121354266,57
4832,1,12443,12443,0,0,0,0,1.0,1,1.0,1,1.0,1,0.5996317703718682,55
4833,1,12444,12444,0,0,0,0,1.0,1,1.0,1,1.0,1,0.6041537950293685,55
4834,1,12445,12445,0,0,0,0,1.0,1,1.0,1,1.0,1,0.622661449180354,55
4835,4,12449,12449,0,0,0,0,1.0,1,1.0,1,1.0,1,0.6456785441259271,55
4836,4,12453,12453,0,0,0,0,1.0,1,1.0,1,1.0,1,0.6732876409167514,55
4837,3,12456,12456,0,0,0,0,1.0,1,1.0,1,1.0,1,0.6580264868691901,53
4838,0,12456,12456,0,0,0,0,1.0,1,1.0,1,1.0,1,0.6490982218414508,54
4839,3,12459,12459,0,0,0,0,1.0,1,1.0,1,1.0,1,0.6467281968491929,53
4840,3,12462,12462,0,0,0,0,1.0,1,1.0,1,1.0,1,0.6553956446567999,52
4841,1,12463,12463,0,0,0,0,1.0,1,1.0,1,1.0,1,0.6458296241442878,51
4842,3,12466,12466,0,0,0,0,1.0,1,1.0,1,1.0,1,0.6365955408585784,50
4843,3,12469,12469,0,0,0,0,1.0,1,1.0,1,1.0,1,0.6351345086170662,51
4844,2,12471,12471,0,0,0,0,1.0,1,1.0,1,1.0,1,0.6423304526499135,50
4845,2,12473,12473,0,0,0,0,1.0,1,1.0,1,1.0,1,0.6300991938520096,49
4846,2,12475,12475,0,0,0,0,1.0,1,1.0,1,1.0,1,0.6375106751756427,49
4847,1,12476,12476,0,0,0,0,1.0,1,1.0,1,1.0,1,0.6374799001844405,48
4848,2,12478,12478,0,0,0,0,1.0,1,1.0,1,1.0,1,0.6475570833416454,48
4849,1,12479,12479,0,0,0,0,1.0,1,1.0,1,1.0,1,0.6357738603532436,48
4850,3,12482,12482,0,0,0,0,1.0,1,1.0,1,1.0,1,0.6153675574033466,49
4851,2,12484,12484,0,0,0,0,1.0,1,1.0,1,1.0,1,0.5849728215123323,49
4852,1,12485,12485,0,0,0,0,1.0,1,1.0,1,1.0,1,0.6120356456022259,49
4853,3,12488,12488,0,0,0,0,1.0,1,1.0,1,1.0,1,0.6289045946660377,50
4854,0,12488,12488,0,0,0,0,1.0,1,1.0,1,1.0,1,0.6320282853921505,51
4855,2,12490,12490,0,0,0,0,1.0,1,1.0,1,1.0,1,0.6552197150031893,51
4856,1,12491,12491,0,0,0,0,1.0,1,1.0,1,1.0,1,0.6446002833012568,50
4857,1,12492,12492,0,0,0,0,1.0,1,1.0,1,1.0,1,0.6472834842641632,51
4858,1,12493,12493,0,0,0,0,1.0,1,1.0,1,1.0,1,0.6657485394269386,51
4859,2,12495,12495,0,0,0,0,1.0,1,1.0,1,1.0,1,0.6955496593322623,52
4860,4,12499,12499,0,0,0,0,1.0,1,1.0,1,1.0,1,0.6737914711126983,52
4861,2,12501,12501,0,0,0,0,1.0,1,1.0,1,1.0,1,0.675211949589998,53
4862,4,12505,12505,0,0,0,0,1.0,1,1.0,1,1.0,1,0.659858623353827,53
4863,5,12510,12510,0,0,0,0,1.0,1,1.0,1,1.0,1,0.6622082869368133,51
4864,6,12516,12516,0,0,0,0,1.0,1,1.0,1,1.0,1,0.6653201095907747,53
4865,3,12519,12519,0,0,0,0,1.0,1,1.0,1,1.0,1,0.6672777806211676,52
4866,7,12526,12526,0,0,0,0,1.0,1,1.0,1,1.0,1,0.6446555900536202,53
4867,4,12530,12530,0,0,0,0,1.0,1,1.0,1,1.0,1,0.6524075480609143,51
4868,1,12531,12531,0,0,0,0,1.0,1,1.0,1,1.0,1,0.6234158663148971,53
4869,7,12538,12538,0,0,0,0,1.0,1,1.0,1,1.0,1,0.6072414704683003,53
4870,4,12542,12542,0,0,0,0,1.0,1,1.0,1,1.0,1,0.6112257188121729,55
4871,4,12546,12546,0,0,0,0,1.0,1,1.0,1,1.0,1,0.6238114646322097,55
4872,2,12548,12548,0,0,0,0,1.0,1,1.0,1,1.0,1,0.6411073049818544,56
4873,1,12549,12549,0,0,0,0,1.0,1,1.0,1,1.0,1,0.6488991525727286,56
4874,5,12554,12554,0,0,0,0,1.0,1,1.0,1,1.0,1,0.6559209445361169,58
4875,2,12556,12556,0,0,0,0,1.0,1,1.0,1,1.0,1,0.6319801555708378,56
4876,2,12558,12558,0,0,0,0,1.0,1,1.0,1,1.0,1,0.6312965107426638,56
4877,2,12560,12560,0,0,0,0,1.0,1,1.0,1,1.0,1,0.6327977365946209,54
4878,2,12562,12562,0,0,0,0,1.0,1,1.0,1,1.0,1,0.6346490480505427,54
4879,3,12565,12565,0,0,0,0,1.0,1,1.0,1,1.0,1,0.5978814627454719,54
4880,0,12565,12565,0,0,0,0,1.0,1,1.0,1,1.0,1,0.5755267894292827,53
4881,4,12569,12569,0,0,0,0,1.0,1,1.0,1,1.0,1,0.5877092813689916,54
4882,0,12569,12569,0,0,0,0,1.0,1,1.0,1,1.0,1,0.5771790375608488,52
4883,0,12569,12569,0,0,0,0,1.0,1,1.0,1,1.0,1,0.5754569972622029,54
4884,2,12571,12571,0,0,0,0,1.0,1,1.0,1,1.0,1,0.5549769819583058,52
4885,0,12571,12571,0,0,0,0,1.0,1,1.0,1,1.0,1,0.5469132091764759,51
4886,2,12573,12573,0,0,0,0,1.0,1,1.0,1,1.0,1,0.5507577881424828,50
4887,2,12575,12575,0,0,0,0,1.0,1,1.0,1,1.0,1,0.572795201771508,49
4888,3,12578,12578,0,0,0,0,1.0,1,1.0,1,1.0,1,0.577951578999595,48
4889,0,12578,12578,0,0,0,0,1.0,1,1.0,1,1.0,1,0.577951578999595,48
4890,1,12579,12579,0,0,0,0,1.0,1,1.0,1,1.0,1,0.5841467968592324,48
4891,0,12579,12579,0,0,0,0,1.0,1,1.0,1,1.0,1,0.591568423376657,49
4892,2,12581,12581,0,0,0,0,1.0,1,1.0,1,1.0,1,0.6226496051276319,51
4893,0,12581,12581,0,0,0,0,1.0,1,1.0,1,1.0,1,0.6231927634650548,51
4894,2,12583,12583,0,0,0,0,1.0,1,1.0,1,1.0,1,0.6370985221187253,52
4895,0,12583,12583,0,0,0,0,1.0,1,1.0,1,1.0,1,0.6370985221187253,52
4896,0,12583,12583,0,0,0,0,1.0,1,1.0,1,1.0,1,0.6398887557380463,51
4897,2,12585,12585,0,0,0,0,1.0,1,1.0,1,1.0,1,0.6215605313714742,52
4898,3,12588,12588,0,0,0,0,1.0,1,1.0,1,1.0,1,0.5895933740997109,52
4899,2,12590,12590,0,0,0,0,1.0,1,1.0,1,1.0,1,0.6079822990476785,53
4900,4,12594,12594,0,0,0,0,1.0,1,1.0,1,1.0,1,0.5950971824481478,54
4901,2,12596,12596,0,0,0,0,1.0,1,1.0,1,1.0,1,0.6059069973076433,54
4902,3,12599,12599,0,0,0,0,1.0,1,1.0,1,1.0,1,0.6194214061513036,55
4903,6,12605,12605,0,0,0,0,1.0,1,1.0,1,1.0,1,0.6488234807353035,56
4904,2,12607,12607,0,0,0,0,1.0,1,1.0,1,1.0,1,0.6667070731683247,55
4905,1,12608,12608,0,0,0,0,1.0,1,1.0,1,1.0,1,0.6727063746102944,54
4906,1,12609,12609,0,0,0,0,1.0,1,1.0,1,1.0,1,0.6892878183501006,54
4907,2,12611,12611,0,0,0,0,1.0,1,1.0,1,1.0,1,0.6880689111453652,54
4908,1,12612,12612,0,0,0,0,1.0,1,1.0,1,1.0,1,0.6966369775652155,53
4909,2,12614,12614,0,0,0,0,1.0,1,1.0,1,1.0,1,0.6676820328596503,54
4910,0,12614,12614,0,0,0,0,1.0,1,1.0,1,1.0,1,0.6631168717376892,55
4911,5,12619,12619,0,0,0,0,1.0,1,1.0,1,1.0,1,0.6347380129772988,57
4912,3,12622,12622,0,0,0,0,1.0,1,1.0,1,1.0,1,0.6296448373130896,57
4913,6,12628,12628,0,0,0,0,1.0,1,1.0,1,1.0,1,0.5980391471329926,56
4914,6,12634,12634,0,0,0,0,1.0,1,1.0,1,1.0,1,0.5633986687095334,56
4915,2,12636,12636,0,0,0,0,1.0,1,1.0,1,1.0,1,0.5354936697562878,56
4916,5,12641,12641,0,0,0,0,1.0,1,1.0,1,1.0,1,0.5346099574512285,54
4917,7,12648,12648,0,0,0,0,1.0,1,1.0,1,1.0,1,0.5312356779504762,53
4918,3,12651,12651,0,0,0,0,1.0,1,1.0,1,1.0,1,0.5129141193970981,52
4919,7,12658,12658,0,0,0,0,1.0,1,1.0,1,1.0,1,0.5393576627466379,49
4920,2,12660,12660,0,0,0,0,1.0,1,1.0,1,1.0,1,0.5248678891667773,49
4921,2,12662,12662,0,0,0,0,1.0,1,1.0,1,1.0,1,0.5559509387106505,50
4922,3,12665,12665,0,0,0,0,1.0,1,1.0,1,1.0,1,0.5848230036000136,50
4923,2,12667,12667,0,0,0,0,1.0,1,1.0,1,1.0,1,0.6002164913320173,52
4924,3,12670,12670,0,0,0,0,1.0,1,1.0,1,1.0,1,0.5978070152317803,53
4925,2,12672,12672,0,0,0,0,1.0,1,1.0,1,1.0,1,0.5590328882637569,54
4926,0,12672,12672,0,0,0,0,1.0,1,1.0,1,1.0,1,0.5590328882637569,54
4927,1,12673,12673,0,0,0,0,1.0,1,1.0,1,1.0,1,0.5690192125230087,54
4928,0,12673,12673,0,0,0,0,1.0,1,1.0,1,1.0,1,0.5690192125230087,54
4929,2,12675,12675,0,0,0,0,1.0,1,1.0,1,1.0,1,0.5817066865381681,55
4930,1,12676,12676,0,0,0,0,1.0,1,1.0,1,1.0,1,0.5831194838077511,58
4931,2,12678,12678,0,0,0,0,1.0,1,1.0,1,1.0,1,0.5814645390877382,58
4932,3,12681,12681,0,0,0,0,1.0,1,1.0,1,1.0,1,0.5589754805479891,59
4933,1,12682,12682,0,0,0,0,1.0,1,1.0,1,1.0,1,0.5596622197215051,59
4934,2,12684,12684,0,0,0,0,1.0,1,1.0,1,1.0,1,0.5802195023798634,59
4935,0,12684,12684,0,0,0,0,1.0,1,1.0,1,1.0,1,0.5802195023798634,59
4936,3,12687,12687,0,0,0,0,1.0,1,1.0,1,1.0,1,0.5712519537546772,59
4937,0,12687,12687,0,0,0,0,1.0,1,1.0,1,1.0,1,0.5611988332133356,61
4938,2,12689,12689,0,0,0,0,1.0,1,1.0,1,1.0,1,0.551903437032859,62
4939,4,12693,12693,0,0,0,0,1.0,1,1.0,1,1.0,1,0.5182449653173021,63
4940,2,12695,12695,0,0,0,0,1.0,1,1.0,1,1.0,1,0.5435473529737873,65
4941,3,12698,12698,0,0,0,0,1.0,1,1.0,1,1.0,1,0.52245746156029,65
4942,3,12701,12701,0,0,0,0,1.0,1,1.0,1,1.0,1,0.55470841081375,67
4943,3,12704,12704,0,0,0,0,1.0,1,1.0,1,1.0,1,0.5571573169708107,66
4944,2,12706,12706,0,0,0,0,1.0,1,1.0,1,1.0,1,0.5758640721786117,63
4945,3,12709,12709,0,0,0,0,1.0,1,1.0,1,1.0,1,0.592353939560834,61
4946,4,12713,12713,0,0,0,0,1.0,1,1.0,1,1.0,1,0.5907667949543772,60
4947,3,12716,12716,0,0,0,0,1.0,1,1.0,1,1.0,1,0.6098474388831546,58
4948,6,12722,12722,0,0,0,0,1.0,1,1.0,1,1.0,1,0.6481143384009401,57
4949,1,12723,12723,0,0,0,0,1.0,1,1.0,1,1.0,1,0.6494496453182945,56
4950,6,12729,12729,0,0,0,0,1.0,1,1.0,1,1.0,1,0.6300197989780936,57
4951,2,12731,12731,0,0,0,0,1.0,1,1.0,1,1.0,1,0.6202112698387423,55
4952,1,12732,12732,0,0,0,0,1.0,1,1.0,1,1.0,1,0.6244738375729378,55
4953,5,12737,12737,0,0,0,0,1.0,1,1.0,1,1.0,1,0.6374231495529774,54
4954,3,12740,12740,0,0,0,0,1.0,1,1.0,1,1.0,1,0.6356221915275099,54
4955,1,12741,12741,0,0,0,0,1.0,1,1.0,1,1.0,1,0.6366564625746861,52
4956,1,12742,12742,0,0,0,0,1.0,1,1.0,1,1.0,1,0.6417305297001152,52
4957,2,12744,12744,0,0,0,0,1.0,1,1.0,1,1.0,1,0.6178800128536127,53
4958,1,12745,12745,0,0,0,0,1.0,1,1.0,1,1.0,1,0.6319623649314351,52
4959,2,12747,12747,0,0,0,0,1.0,1,1.0,1,1.0,1,0.6327262474104292,51
4960,1,12748,12748,0,0,0,0,1.0,1,1.0,1,1.0,1,0.6335486859306696,53
4961,1,12749,12749,0,0,0,0,1.0,1,1.0,1,1.0,1,0.6493367693498606,53
4962,3,12752,12752,0,0,0,0,1.0,1,1.0,1,1.0,1,0.6695500951314691,55
4963,2,12754,12754,0,0,0,0,1.0,1,1.0,1,1.0,1,0.6689223235790284,54
4964,6,12760,12760,0,0,0,0,1.0,1,1.0,1,1.0,1,0.6479607877049904,54
4965,6,12766,12766,0,0,0,0,1.0,1,1.0,1,1.0,1,0.6196661773469324,54
4966,3,12769,12769,0,0,0,0,1.0,1,1.0,1,1.0,1,0.6217962196415437,54
4967,8,12777,12777,0,0,0,0,1.0,1,1.0,1,1.0,1,0.5833431027057548,55
4968,2,12779,12779,0,0,0,0,1.0,1,1.0,1,1.0,1,0.5925721973104279,55
4969,7,12786,12786,0,0,0,0,1.0,1,1.0,1,1.0,1,0.5722444732498005,57
4970,2,12788,12788,0,0,0,0,1.0,1,1.0,1,1.0,1,0.5737137576552559,56
4971,5,12793,12793,0,0,0,0,1.0,1,1.0,1,1.0,1,0.5764514489005462,57
4972,2,12795,12795,0,0,0,0,1.0,1,1.0,1,1.0,1,0.5834924202539578,57
4973,3,12798,12798,0,0,0,0,1.0,1,1.0,1,1.0,1,0.5924780138860916,60
4974,1,12799,12799,0,0,0,0,1.0,1,1.0,1,1.0,1,0.6165581015908693,58
4975,2,12801,12801,0,0,0,0,1.0,1,1.0,1,1.0,1,0.6400317269932589,59
4976,2,12803,12803,0,0,0,0,1.0,1,1.0,1,1.0,1,0.6395282942581088,59
4977,2,12805,12805,0,0,0,0,1.0,1,1.0,1,1.0,1,0.6393086290855831,59
4978,5,12810,12810,0,0,0,0,1.0,1,1.0,1,1.0,1,0.6100877732212622,59
4979,6,12816,12816,0,0,0,0,1.0,1,1.0,1,1.0,1,0.5862981213715629,61
4980,4,12820,12820,0,0,0,0,1.0,1,1.0,1,1.0,1,0.5818269773104877,62
4981,4,12824,12824,0,0,0,0,1.0,1,1.0,1,1.0,1,0.5679520957348083,62
4982,4,12828,12828,0,0,0,0,1.0,1,1.0,1,1.0,1,0.5652332313699425,63
4983,3,12831,12831,0,0,0,0,1.0,1,1.0,1,1.0,1,0.5527965092564691,63
4984,2,12833,12833,0,0,0,0,1.0,1,1.0,1,1.0,1,0.5837792540759994,61
4985,4,12837,12837,0,0,0,0,1.0,1,1.0,1,1.0,1,0.6255607246963276,59
4986,0,12837,12837,0,0,0,0,1.0,1,1.0,1,1.0,1,0.6208843968724561,62
4987,2,12839,12839,0,0,0,0,1.0,1,1.0,1,1.0,1,0.6166837379390482,60
4988,3,12842,12842,0,0,0,0,1.0,1,1.0,1,1.0,1,0.6206720017727588,59
4989,1,12843,12843,0,0,0,0,1.0,1,1.0,1,1.0,1,0.621562568722058,57
4990,2,12845,12845,0,0,0,0,1.0,1,1.0,1,1.0,1,0.6405499589400107,55
4991,1,12846,12846,0,0,0,0,1.0,1,1.0,1,1.0,1,0.6483542380444335,54
4992,3,12849,12849,0,0,0,0,1.0,1,1.0,1,1.0,1,0.6685813598404485,52
4993,4,12853,12853,0,0,0,0,1.0,1,1.0,1,1.0,1,0.629760644932145,51
4994,4,12857,12857,0,0,0,0,1.0,1,1.0,1,1.0,1,0.6210001461701669,49
4995,2,12859,12859,0,0,0,0,1.0,1,1.0,1,1.0,1,0.6428005564599056,48
4996,3,12862,12862,0,0,0,0,1.0,1,1.0,1,1.0,1,0.6283825725833193,48
4997,1,12863,12863,0,0,0,0,1.0,1,1.0,1,1.0,1,0.6307391870255248,46
4998,5,12868,12868,0,0,0,0,1.0,1,1.0,1,1.0,1,0.5986726197982521,48
4999,0,12868,12868,0,0,0,0,1.0,1,1.0,1,1.0,1,0.5991899061212577,48
5000,2,12870,12870,0,0,0,0,1.0,1,1.0,1,1.0,1,0.589896931814153,47
5001,0,12870,12870,0,0,0,0,1.0,1,1.0,1,1.0,1,0.5849928238000324,45
5002,1,12871,12871,0,0,0,0,1.0,1,1.0,1,1.0,1,0.5932156386344305,46
5003,0,12871,12871,0,0,0,0,1.0,1,1.0,1,1.0,1,0.5937911439642063,46
5004,1,12872,12872,0,0,0,0,1.0,1,1.0,1,1.0,1,0.6100190035197485,46
5005,1,12873,12873,0,0,0,0,1.0,1,1.0,1,1.0,1,0.6431556850474126,45
5006,1,12874,12874,0,0,0,0,1.0,1,1.0,1,1.0,1,0.65241810168043,45
5007,0,12874,12874,0,0,0,0,1.0,1,1.0,1,1.0,1,0.6526835150674282,46
5008,1,12875,12875,0,0,0,0,1.0,1,1.0,1,1.0,1,0.638689777502119,49
5009,1,12876,12876,0,0,0,0,1.0,1,1.0,1,1.0,1,0.6472489445458651,49
5010,2,12878,12878,0,0,0,0,1.0,1,1.0,1,1.0,1,0.6704239530608539,50
5011,1,12879,12879,0,0,0,0,1.0,1,1.0,1,1.0,1,0.6562039899142404,51
5012,1,12880,12880,0,0,0,0,1.0,1,1.0,1,1.0,1,0.6494355283002322,52
5013,4,12884,12884,0,0,0,0,1.0,1,1.0,1,1.0,1,0.6349899322686476,52
5014,2,12886,12886,0,0,0,0,1.0,1,1.0,1,1.0,1,0.6283930038049841,53
5015,4,12890,12890,0,0,0,0,1.0,1,1.0,1,1.0,1,0.6258617631996607,54
5016,3,12893,12893,0,0,0,0,1.0,1,1.0,1,1.0,1,0.6082821426447674,55
5017,7,12900,12900,0,0,0,0,1.0,1,1.0,1,1.0,1,0.5870500549178745,55
5018,3,12903,12903,0,0,0,0,1.0,1,1.0,1,1.0,1,0.578401687515324,56
5019,5,12908,12908,0,0,0,0,1.0,1,1.0,1,1.0,1,0.567132626158533,56
5020,3,12911,12911,0,0,0,0,1.0,1,1.0,1,1.0,1,0.5856280986209871,55
5021,3,12914,12914,0,0,0,0,1.0,1,1.0,1,1.0,1,0.5947436599392467,56
5022,2,12916,12916,0,0,0,0,1.0,1,1.0,1,1.0,1,0.6129773271671914,56
5023,5,12921,12921,0,0,0,0,1.0,1,1.0,1,1.0,1,0.5768645571151331,55
5024,4,12925,12925,0,0,0,0,1.0,1,1.0,1,1.0,1,0.6020066005023395,55
5025,5,12930,12930,0,0,0,0,1.0,1,1.0,1,1.0,1,0.61067950419498,53
5026,2,12932,12932,0,0,0,0,1.0,1,1.0,1,1.0,1,0.6065416975201633,52
5027,5,12937,12937,0,0,0,0,1.0,1,1.0,1,1.0,1,0.6232779927506767,51
5028,1,12938,12938,0,0,0,0,1.0,1,1.0,1,1.0,1,0.6106977639842487,51
5029,6,12944,12944,0,0,0,0,1.0,1,1.0,1,1.0,1,0.6304542532832479,50
5030,2,12946,12946,0,0,0,0,1.0,1,1.0,1,1.0,1,0.5892752988197293,49
5031,5,12951,12951,0,0,0,0,1.0,1,1.0,1,1.0,1,0.6101149974559337,49
5032,1,12952,12952,0,0,0,0,1.0,1,1.0,1,1.0,1,0.6131352237203952,48
5033,5,12957,12957,0,0,0,0,1.0,1,1.0,1,1.0,1,0.6281830969770018,50
5034,0,12957,12957,0,0,0,0,1.0,1,1.0,1,1.0,1,0.6074251932469844,49
5035,3,12960,12960,0,0,0,0,1.0,1,1.0,1,1.0,1,0.6010787406816334,49
5036,0,12960,12960,0,0,0,0,1.0,1,1.0,1,1.0,1,0.595447911997867,47
5037,0,12960,12960,0,0,0,0,1.0,1,1.0,1,1.0,1,0.6014653360989659,47
5038,1,12961,12961,0,0,0,0,1.0,1,1.0,1,1.0,1,0.6055396246979015,47
5039,0,12961,12961,0,0,0,0,1.0,1,1.0,1,1.0,1,0.6067648596886958,48
5040,0,12961,12961,0,0,0,0,1.0,1,1.0,1,1.0,1,0.6067648596886958,48
5041,3,12964,12964,0,0,0,0,1.0,1,1.0,1,1.0,1,0.6398006620587752,48
5042,1,12965,12965,0,0,0,0,1.0,1,1.0,1,1.0,1,0.6390195574810582,50
5043,2,12967,12967,0,0,0,0,1.0,1,1.0,1,1.0,1,0.6227563100895164,51
5044,1,12968,12968,0,0,0,0,1.0,1,1.0,1,1.0,1,0.6373736537538348,51
5045,2,12970,12970,0,0,0,0,1.0,1,1.0,1,1.0,1,0.6361121563482036,52
5046,0,12970,12970,0,0,0,0,1.0,1,1.0,1,1.0,1,0.6318368418555957,51
5047,1,12971,12971,0,0,0,0,1.0,1,1.0,1,1.0,1,0.6441036231767631,51
5048,1,12972,12972,0,0,0,0,1.0,1,1.0,1,1.0,1,0.6412600434784601,52
5049,0,12972,12972,0,0,0,0,1.0,1,1.0,1,1.0,1,0.646761312689102,54
5050,0,12972,12972,0,0,0,0,1.0,1,1.0,1,1.0,1,0.6523791456196968,56
5051,1,12973,12973,0,0,0,0,1.0,1,1.0,1,1.0,1,0.6543872931383101,55
5052,0,12973,12973,0,0,0,0,1.0,1,1.0,1,1.0,1,0.6543872931383101,55
5053,2,12975,12975,0,0,0,0,1.0,1,1.0,1,1.0,1,0.6649620208803096,55
5054,2,12977,12977,0,0,0,0,1.0,1,1.0,1,1.0,1,0.6490630659329621,55
5055,1,12978,12978,0,0,0,0,1.0,1,1.0,1,1.0,1,0.6706712274040453,55
5056,3,12981,12981,0,0,0,0,1.0,1,1.0,1,1.0,1,0.6501825584905737,56
5057,1,12982,12982,0,0,0,0,1.0,1,1.0,1,1.0,1,0.6377416355812976,58
5058,2,12984,12984,0,0,0,0,1.0,1,1.0,1,1.0,1,0.6290518695537659,59
5059,5,12989,12989,0,0,0,0,1.0,1,1.0,1,1.0,1,0.62995112841843,59
5060,5,12994,12994,0,0,0,0,1.0,1,1.0,1,1.0,1,0.6421591454061354,59
5061,3,12997,12997,0,0,0,0,1.0,1,1.0,1,1.0,1,0.6499457319541004,59
5062,5,13002,13002,0,0,0,0,1.0,1,1.0,1,1.0,1,0.6755815889970402,59
5063,3,13005,13005,0,0,0,0,1.0,1,1.0,1,1.0,1,0.6998847690493248,59
5064,4,13009,13009,0,0,0,0,1.0,1,1.0,1,1.0,1,0.7062503340832298,57
5065,4,13013,13013,0,0,0,0,1.0,1,1.0,1,1.0,1,0.6738904071463521,55
5066,3,13016,13016,0,0,0,0,1.0,1,1.0,1,1.0,1,0.6790109044112338,55
5067,6,13022,13022,0,0,0,0,1.0,1,1.0,1,1.0,1,0.655664753575266,54
5068,3,13025,13025,0,0,0,0,1.0,1,1.0,1,1.0,1,0.6515982473222336,54
5069,3,13028,13028,0,0,0,0,1.0,1,1.0,1,1.0,1,0.6286124716505977,54
5070,2,13030,13030,0,0,0,0,1.0,1,1.0,1,1.0,1,0.6214029862242042,52
5071,3,13033,13033,0,0,0,0,1.0,1,1.0,1,1.0,1,0.5932162970872088,54
5072,5,13038,13038,0,0,0,0,1.0,1,1.0,1,1.0,1,0.5969147017284623,52
5073,2,13040,13040,0,0,0,0,1.0,1,1.0,1,1.0,1,0.5875766297919328,51
5074,1,13041,13041,0,0,0,0,1.0,1,1.0,1,1.0,1,0.5725687123708096,52
5075,4,13045,13045,0,0,0,0,1.0,1,1.0,1,1.0,1,0.5651326584471892,53
5076,0,13045,13045,0,0,0,0,1.0,1,1.0,1,1.0,1,0.5651326584471892,53
5077,0,13045,13045,0,0,0,0,1.0,1,1.0,1,1.0,1,0.5650204065815079,56
5078,0,13045,13045,0,0,0,0,1.0,1,1.0,1,1.0,1,0.5750273956896058,55
5079,0,13045,13045,0,0,0,0,1.0,1,1.0,1,1.0,1,0.5721093083435382,56
5080,1,13046,13046,0,0,0,0,1.0,1,1.0,1,1.0,1,0.5536661497372601,57
5081,2,13048,13048,0,0,0,0,1.0,1,1.0,1,1.0,1,0.5679580712053157,58
5082,0,13048,13048,0,0,0,0,1.0,1,1.0,1,1.0,1,0.5679580712053157,58
5083,3,13051,13051,0,0,0,0,1.0,1,1.0,1,1.0,1,0.5863823717275973,59
5084,2,13053,13053,0,0,0,0,1.0,1,1.0,1,1.0,1,0.5949037212678092,59
5085,7,13060,13060,0,0,0,0,1.0,1,1.0,1,1.0,1,0.6084195589666446,60
5086,1,13061,13061,0,0,0,0,1.0,1,1.0,1,1.0,1,0.5866134974792483,61
5087,6,13067,13067,0,0,0,0,1.0,1,1.0,1,1.0,1,0.6214583241032718,62
5088,4,13071,13071,0,0,0,0,1.0,1,1.0,1,1.0,1,0.5983020741708037,64
5089,7,13078,13078,0,0,0,0,1.0,1,1.0,1,1.0,1,0.6224255159520377,64
5090,4,13082,13082,0,0,0,0,1.0,1,1.0,1,1.0,1,0.6034818518798697,64
5091,6,13088,13088,0,0,0,0,1.0,1,1.0,1,1.0,1,0.6241124264960005,64
5092,3,13091,13091,0,0,0,0,1.0,1,1.0,1,1.0,1,0.6194165693985194,64
5093,5,13096,13096,0,0,0,0,1.0,1,1.0,1,1.0,1,0.6318797892799204,64
5094,3,13099,13099,0,0,0,0,1.0,1,1.0,1,1.0,1,0.6020365440912181,65
5095,6,13105,13105,0,0,0,0,1.0,1,1.0,1,1.0,1,0.6228726910348846,66
5096,4,13109,13109,0,0,0,0,1.0,1,1.0,1,1.0,1,0.6334298007697817,66
5097,5,13114,13114,0,0,0,0,1.0,1,1.0,1,1.0,1,0.6090590940196206,67
5098,5,13119,13119,0,0,0,0,1.0,1,1.0,1,1.0,1,0.5681846178646537,67
5099,5,13124,13124,0,0,0,0,1.0,1,1.0,1,1.0,1,0.5389368807664524,70
5100,6,13130,13130,0,0,0,0,1.0,1,1.0,1,1.0,1,0.513770047354593,71
5101,2,13132,13132,0,0,0,0,1.0,1,1.0,1,1.0,1,0.49053997345871186,72
5102,4,13136,13136,0,0,0,0,1.0,1,1.0,1,1.0,1,0.5133284844416743,72
5103,5,13141,13141,0,0,0,0,1.0,1,1.0,1,1.0,1,0.5160021853788178,70
5104,4,13145,13145,0,0,0,0,1.0,1,1.0,1,1.0,1,0.524654090872601,67
5105,4,13149,13149,0,0,0,0,1.0,1,1.0,1,1.0,1,0.5429556449884456,66
5106,3,13152,13152,0,0,0,0,1.0,1,1.0,1,1.0,1,0.583127386591258,64
5107,5,13157,13157,0,0,0,0,1.0,1,1.0,1,1.0,1,0.5951283988099336,61
5108,3,13160,13160,0,0,0,0,1.0,1,1.0,1,1.0,1,0.6072519257724707,57
5109,3,13163,13163,0,0,0,0,1.0,1,1.0,1,1.0,1,0.6320213119833256,55
5110,2,13165,13165,0,0,0,0,1.0,1,1.0,1,1.0,1,0.6408958630192118,53
5111,3,13168,13168,0,0,0,0,1.0,1,1.0,1,1.0,1,0.6482023691910631,52
5112,1,13169,13169,0,0,0,0,1.0,1,1.0,1,1.0,1,0.6360145562068454,52
5113,2,13171,13171,0,0,0,0,1.0,1,1.0,1,1.0,1,0.6368408582580907,49
5114,3,13174,13174,0,0,0,0,1.0,1,1.0,1,1.0,1,0.6514815385857792,49
5115,3,13177,13177,0,0,0,0,1.0,1,1.0,1,1.0,1,0.6286934679142264,48
5116,3,13180,13180,0,0,0,0,1.0,1,1.0,1,1.0,1,0.6283852016504333,47
5117,6,13186,13186,0,0,0,0,1.0,1,1.0,1,1.0,1,0.5987109576173093,48
5118,6,13192,13192,0,0,0,0,1.0,1,1.0,1,1.0,1,0.586154488934701,49
5119,4,13196,13196,0,0,0,0,1.0,1,1.0,1,1.0,1,0.5837328144626261,49
5120,4,13200,13200,0,0,0,0,1.0,1,1.0,1,1.0,1,0.6163153184215509,48
5121,2,13202,13202,0,0,0,0,1.0,1,1.0,1,1.0,1,0.6420155335422947,48
5122,5,13207,13207,0,0,0,0,1.0,1,1.0,1,1.0,1,0.6562529519883538,46
5123,3,13210,13210,0,0,0,0,1.0,1,1.0,1,1.0,1,0.6549330314968638,46
5124,4,13214,13214,0,0,0,0,1.0,1,1.0,1,1.0,1,0.6211630903323343,47
5125,4,13218,13218,0,0,0,0,1.0,1,1.0,1,1.0,1,0.6185490916383858,49
5126,4,13222,13222,0,0,0,0,1.0,1,1.0,1,1.0,1,0.5998619688264877,49
5127,4,13226,13226,0,0,0,0,1.0,1,1.0,1,1.0,1,0.5949873349424888,51
5128,1,13227,13227,0,0,0,0,1.0,1,1.0,1,1.0,1,0.5647390253883281,53
5129,2,13229,13229,0,0,0,0,1.0,1,1.0,1,1.0,1,0.5391378116864002,55
5130,2,13231,13231,0,0,0,0,1.0,1,1.0,1,1.0,1,0.5385852781547741,55
5131,2,13233,13233,0,0,0,0,1.0,1,1.0,1,1.0,1,0.5228001848513008,55
5132,1,13234,13234,0,0,0,0,1.0,1,1.0,1,1.0,1,0.5257293438134041,55
5133,2,13236,13236,0,0,0,0,1.0,1,1.0,1,1.0,1,0.5143907273127949,56
5134,2,13238,13238,0,0,0,0,1.0,1,1.0,1,1.0,1,0.5700971655654316,56
5135,2,13240,13240,0,0,0,0,1.0,1,1.0,1,1.0,1,0.5957652496305451,56
5136,1,13241,13241,0,0,0,0,1.0,1,1.0,1,1.0,1,0.6169563705902279,55
5137,1,13242,13242,0,0,0,0,1.0,1,1.0,1,1.0,1,0.6432464144681884,55
5138,3,13245,13245,0,0,0,0,1.0,1,1.0,1,1.0,1,0.6913160693862802,54
5139,5,13250,13250,0,0,0,0,1.0,1,1.0,1,1.0,1,0.6905159343739007,54
5140,1,13251,13251,0,0,0,0,1.0,1,1.0,1,1.0,1,0.6709210491492286,54
5141,4,13255,13255,0,0,0,0,1.0,1,1.0,1,1.0,1,0.6128349830473242,53
5142,3,13258,13258,0,0,0,0,1.0,1,1.0,1,1.0,1,0.5828892927624528,55
5143,3,13261,13261,0,0,0,0,1.0,1,1.0,1,1.0,1,0.5831366012404289,54
5144,2,13263,13263,0,0,0,0,1.0,1,1.0,1,1.0,1,0.6038738603963955,50
5145,3,13266,13266,0,0,0,0,1.0,1,1.0,1,1.0,1,0.6176203282312637,51
5146,5,13271,13271,0,0,0,0,1.0,1,1.0,1,1.0,1,0.6005119917825469,48
5147,6,13277,13277,0,0,0,0,1.0,1,1.0,1,1.0,1,0.5844584563263251,49
5148,2,13279,13279,0,0,0,0,1.0,1,1.0,1,1.0,1,0.5926850661962844,47
5149,7,13286,13286,0,0,0,0,1.0,1,1.0,1,1.0,1,0.6184688648945744,46
5150,2,13288,13288,0,0,0,0,1.0,1,1.0,1,1.0,1,0.6472600014067337,46
5151,5,13293,13293,0,0,0,0,1.0,1,1.0,1,1.0,1,0.6546182028378366,45
5152,1,13294,13294,0,0,0,0,1.0,1,1.0,1,1.0,1,0.6652784911834929,45
5153,3,13297,13297,0,0,0,0,1.0,1,1.0,1,1.0,1,0.7033849762784499,45
5154,2,13299,13299,0,0,0,0,1.0,1,1.0,1,1.0,1,0.695472410073366,45
5155,0,13299,13299,0,0,0,0,1.0,1,1.0,1,1.0,1,0.6890353642456791,44
5156,0,13299,13299,0,0,0,0,1.0,1,1.0,1,1.0,1,0.6890955180725898,44
5157,1,13300,13300,0,0,0,0,1.0,1,1.0,1,1.0,1,0.7034113389081571,42
5158,0,13300,13300,0,0,0,0,1.0,1,1.0,1,1.0,1,0.688001440889184,43
5159,1,13301,13301,0,0,0,0,1.0,1,1.0,1,1.0,1,0.673091907842905,43
5160,3,13304,13304,0,0,0,0,1.0,1,1.0,1,1.0,1,0.6615352795651657,43
5161,0,13304,13304,0,0,0,0,1.0,1,1.0,1,1.0,1,0.6615352795651657,43
5162,3,13307,13307,0,0,0,0,1.0,1,1.0,1,1.0,1,0.6813234899407471,44
5163,3,13310,13310,0,0,0,0,1.0,1,1.0,1,1.0,1,0.682058935344378,46
5164,1,13311,13311,0,0,0,0,1.0,1,1.0,1,1.0,1,0.6770307525858738,46
5165,6,13317,13317,0,0,0,0,1.0,1,1.0,1,1.0,1,0.6775235170568308,46
5166,7,13324,13324,0,0,0,0,1.0,1,1.0,1,1.0,1,0.6613940376574314,47
5167,8,13332,13332,0,0,0,0,1.0,1,1.0,1,1.0,1,0.658816403623661,47
5168,4,13336,13336,0,0,0,0,1.0,1,1.0,1,1.0,1,0.6739508366029747,47
5169,4,13340,13340,0,0,0,0,1.0,1,1.0,1,1.0,1,0.6729827473609609,47
5170,2,13342,13342,0,0,0,0,1.0,1,1.0,1,1.0,1,0.6425246098133336,48
5171,0,13342,13342,0,0,0,0,1.0,1,1.0,1,1.0,1,0.6425246098133336,48
5172,4,13346,13346,0,0,0,0,1.0,1,1.0,1,1.0,1,0.6178135737830964,49
5173,0,13346,13346,0,0,0,0,1.0,1,1.0,1,1.0,1,0.6288377151673581,49
5174,2,13348,13348,0,0,0,0,1.0,1,1.0,1,1.0,1,0.616410114702668,52
5175,2,13350,13350,0,0,0,0,1.0,1,1.0,1,1.0,1,0.6235003997869367,53
5176,3,13353,13353,0,0,0,0,1.0,1,1.0,1,1.0,1,0.628833026389088,54
5177,2,13355,13355,0,0,0,0,1.0,1,1.0,1,1.0,1,0.6245781427822387,54
5178,4,13359,13359,0,0,0,0,1.0,1,1.0,1,1.0,1,0.6383036553939875,55
5179,5,13364,13364,0,0,0,0,1.0,1,1.0,1,1.0,1,0.6333795487214747,53
5180,5,13369,13369,0,0,0,0,1.0,1,1.0,1,1.0,1,0.61615257347366,52
5181,1,13370,13370,0,0,0,0,1.0,1,1.0,1,1.0,1,0.6000893386521501,52
5182,5,13375,13375,0,0,0,0,1.0,1,1.0,1,1.0,1,0.6248717634627102,52
5183,1,13376,13376,0,0,0,0,1.0,1,1.0,1,1.0,1,0.6099209762220507,52
5184,3,13379,13379,0,0,0,0,1.0,1,1.0,1,1.0,1,0.6293218555216192,52
5185,1,13380,13380,0,0,0,0,1.0,1,1.0,1,1.0,1,0.6255460048502997,50
5186,2,13382,13382,0,0,0,0,1.0,1,1.0,1,1.0,1,0.6493504903508751,48
5187,1,13383,13383,0,0,0,0,1.0,1,1.0,1,1.0,1,0.6661124021406877,46
5188,0,13383,13383,0,0,0,0,1.0,1,1.0,1,1.0,1,0.6682753399038923,44
5189,1,13384,13384,0,0,0,0,1.0,1,1.0,1,1.0,1,0.6574257940923967,44
5190,0,13384,13384,0,0,0,0,1.0,1,1.0,1,1.0,1,0.6524847680481732,45
5191,1,13385,13385,0,0,0,0,1.0,1,1.0,1,1.0,1,0.6642831096846167,45
5192,1,13386,13386,0,0,0,0,1.0,1,1.0,1,1.0,1,0.6761150423696547,45
5193,1,13387,13387,0,0,0,0,1.0,1,1.0,1,1.0,1,0.6827163866949776,45
5194,1,13388,13388,0,0,0,0,1.0,1,1.0,1,1.0,1,0.6968926761231594,45
5195,0,13388,13388,0,0,0,0,1.0,1,1.0,1,1.0,1,0.7022572081355978,46
5196,4,13392,13392,0,0,0,0,1.0,1,1.0,1,1.0,1,0.7217303576519384,46
5197,2,13394,13394,0,0,0,0,1.0,1,1.0,1,1.0,1,0.7244137035897955,46
5198,0,13394,13394,0,0,0,0,1.0,1,1.0,1,1.0,1,0.7138616352527735,47
5199,1,13395,13395,0,0,0,0,1.0,1,1.0,1,1.0,1,0.6980201715043775,49
5200,1,13396,13396,0,0,0,0,1.0,1,1.0,1,1.0,1,0.6893340310421039,49
5201,1,13397,13397,0,0,0,0,1.0,1,1.0,1,1.0,1,0.6760472135343379,50
5202,0,13397,13397,0,0,0,0,1.0,1,1.0,1,1.0,1,0.6637078402817067,52
5203,0,13397,13397,0,0,0,0,1.0,1,1.0,1,1.0,1,0.6637078402817067,52
5204,1,13398,13398,0,0,0,0,1.0,1,1.0,1,1.0,1,0.6464967830772743,54
5205,1,13399,13399,0,0,0,0,1.0,1,1.0,1,1.0,1,0.6548664504410614,54
5206,0,13399,13399,0,0,0,0,1.0,1,1.0,1,1.0,1,0.6585336650944629,55
5207,0,13399,13399,0,0,0,0,1.0,1,1.0,1,1.0,1,0.6662850850321855,54
5208,3,13402,13402,0,0,0,0,1.0,1,1.0,1,1.0,1,0.6643231908084548,54
5209,1,13403,13403,0,0,0,0,1.0,1,1.0,1,1.0,1,0.6692389432357528,54
5210,3,13406,13406,0,0,0,0,1.0,1,1.0,1,1.0,1,0.6510926317691232,54
5211,3,13409,13409,0,0,0,0,1.0,1,1.0,1,1.0,1,0.6660389374905425,56
5212,1,13410,13410,0,0,0,0,1.0,1,1.0,1,1.0,1,0.6462005374837667,57
5213,2,13412,13412,0,0,0,0,1.0,1,1.0,1,1.0,1,0.6565143598492247,57
5214,8,13420,13420,0,0,0,0,1.0,1,1.0,1,1.0,1,0.6336875525860388,58
5215,4,13424,13424,0,0,0,0,1.0,1,1.0,1,1.0,1,0.6274633390590674,57
5216,6,13430,13430,0,0,0,0,1.0,1,1.0,1,1.0,1,0.6040256857761522,57
5217,8,13438,13438,0,0,0,0,1.0,1,1.0,1,1.0,1,0.5565223700129505,56
5218,4,13442,13442,0,0,0,0,1.0,1,1.0,1,1.0,1,0.573676868021876,56
5219,6,13448,13448,0,0,0,0,1.0,1,1.0,1,1.0,1,0.5388497771003138,54
5220,6,13454,13454,0,0,0,0,1.0,1,1.0,1,1.0,1,0.5634068373683908,53
5221,0,13454,13454,0,0,0,0,1.0,1,1.0,1,1.0,1,0.5587742158716785,52
5222,3,13457,13457,0,0,0,0,1.0,1,1.0,1,1.0,1,0.5663994825467483,52
5223,7,13464,13464,0,0,0,0,1.0,1,1.0,1,1.0,1,0.5721757890702162,52
5224,3,13467,13467,0,0,0,0,1.0,1,1.0,1,1.0,1,0.5690338612666135,52
5225,0,13467,13467,0,0,0,0,1.0,1,1.0,1,1.0,1,0.5767513929074206,50
5226,2,13469,13469,0,0,0,0,1.0,1,1.0,1,1.0,1,0.575306752842741,51
5227,3,13472,13472,0,0,0,0,1.0,1,1.0,1,1.0,1,0.597804302449331,49
5228,4,13476,13476,0,0,0,0,1.0,1,1.0,1,1.0,1,0.6166852697036925,48
5229,2,13478,13478,0,0,0,0,1.0,1,1.0,1,1.0,1,0.5953593429018118,49
5230,2,13480,13480,0,0,0,0,1.0,1,1.0,1,1.0,1,0.6051025104188709,49
5231,2,13482,13482,0,0,0,0,1.0,1,1.0,1,1.0,1,0.6156121675849869,49
5232,1,13483,13483,0,0,0,0,1.0,1,1.0,1,1.0,1,0.6250791634352636,51
5233,3,13486,13486,0,0,0,0,1.0,1,1.0,1,1.0,1,0.6410562202587289,51
5234,1,13487,13487,0,0,0,0,1.0,1,1.0,1,1.0,1,0.6372127828229628,52
5235,2,13489,13489,0,0,0,0,1.0,1,1.0,1,1.0,1,0.6390987217210427,52
5236,2,13491,13491,0,0,0,0,1.0,1,1.0,1,1.0,1,0.6144610367127664,52
5237,2,13493,13493,0,0,0,0,1.0,1,1.0,1,1.0,1,0.6193226326387878,53
5238,5,13498,13498,0,0,0,0,1.0,1,1.0,1,1.0,1,0.592153221417693,53
5239,3,13501,13501,0,0,0,0,1.0,1,1.0,1,1.0,1,0.5884330662581806,53
5240,3,13504,13504,0,0,0,0,1.0,1,1.0,1,1.0,1,0.5799761654272483,55
5241,3,13507,13507,0,0,0,0,1.0,1,1.0,1,1.0,1,0.5657283112394135,56
5242,6,13513,13513,0,0,0,0,1.0,1,1.0,1,1.0,1,0.5484426542390414,54
5243,2,13515,13515,0,0,0,0,1.0,1,1.0,1,1.0,1,0.535582384881097,55
5244,10,13525,13525,0,0,0,0,1.0,1,1.0,1,1.0,1,0.5588102908177842,55
5245,6,13531,13531,0,0,0,0,1.0,1,1.0,1,1.0,1,0.5696116040614937,55
5246,5,13536,13536,0,0,0,0,1.0,1,1.0,1,1.0,1,0.6074617808674019,55
5247,6,13542,13542,0,0,0,0,1.0,1,1.0,1,1.0,1,0.6394431965598523,54
5248,3,13545,13545,0,0,0,0,1.0,1,1.0,1,1.0,1,0.6540653476116939,53
5249,3,13548,13548,0,0,0,0,1.0,1,1.0,1,1.0,1,0.6193952730652543,55
5250,1,13549,13549,0,0,0,0,1.0,1,1.0,1,1.0,1,0.6080820170876616,55
5251,3,13552,13552,0,0,0,0,1.0,1,1.0,1,1.0,1,0.6194682405460549,57
5252,3,13555,13555,0,0,0,0,1.0,1,1.0,1,1.0,1,0.6088598310197694,58
5253,1,13556,13556,0,0,0,0,1.0,1,1.0,1,1.0,1,0.6170095223186837,59
5254,1,13557,13557,0,0,0,0,1.0,1,1.0,1,1.0,1,0.6065616210586877,59
5255,3,13560,13560,0,0,0,0,1.0,1,1.0,1,1.0,1,0.6208006821314457,58
5256,3,13563,13563,0,0,0,0,1.0,1,1.0,1,1.0,1,0.6117263941477868,59
5257,1,13564,13564,0,0,0,0,1.0,1,1.0,1,1.0,1,0.5795543631248965,58
5258,2,13566,13566,0,0,0,0,1.0,1,1.0,1,1.0,1,0.6103126738280522,56
5259,4,13570,13570,0,0,0,0,1.0,1,1.0,1,1.0,1,0.5661793444901265,56
5260,0,13570,13570,0,0,0,0,1.0,1,1.0,1,1.0,1,0.5617953973745906,55
5261,3,13573,13573,0,0,0,0,1.0,1,1.0,1,1.0,1,0.5673184411796853,54
5262,6,13579,13579,0,0,0,0,1.0,1,1.0,1,1.0,1,0.5648013293283952,54
5263,1,13580,13580,0,0,0,0,1.0,1,1.0,1,1.0,1,0.5576858771120322,53
5264,7,13587,13587,0,0,0,0,1.0,1,1.0,1,1.0,1,0.5539612652558504,51
5265,1,13588,13588,0,0,0,0,1.0,1,1.0,1,1.0,1,0.5345286187571311,50
5266,6,13594,13594,0,0,0,0,1.0,1,1.0,1,1.0,1,0.5128336902223888,49
5267,5,13599,13599,0,0,0,0,1.0,1,1.0,1,1.0,1,0.5110009576971495,48
5268,4,13603,13603,0,0,0,0,1.0,1,1.0,1,1.0,1,0.520288883757219,47
5269,5,13608,13608,0,0,0,0,1.0,1,1.0,1,1.0,1,0.5451687620110398,45
5270,4,13612,13612,0,0,0,0,1.0,1,1.0,1,1.0,1,0.5656806465680136,47
5271,5,13617,13617,0,0,0,0,1.0,1,1.0,1,1.0,1,0.5395912019216275,45
5272,5,13622,13622,0,0,0,0,1.0,1,1.0,1,1.0,1,0.60372079279477,46
5273,5,13627,13627,0,0,0,0,1.0,1,1.0,1,1.0,1,0.6050205326565526,44
5274,3,13630,13630,0,0,0,0,1.0,1,1.0,1,1.0,1,0.6331442734523235,44
5275,4,13634,13634,0,0,0,0,1.0,1,1.0,1,1.0,1,0.6065724670782864,46
5276,2,13636,13636,0,0,0,0,1.0,1,1.0,1,1.0,1,0.6229196320253346,46
5277,2,13638,13638,0,0,0,0,1.0,1,1.0,1,1.0,1,0.5974016741833209,46
5278,2,13640,13640,0,0,0,0,1.0,1,1.0,1,1.0,1,0.5364867974238557,46
5279,4,13644,13644,0,0,0,0,1.0,1,1.0,1,1.0,1,0.5608645422019403,47
5280,2,13646,13646,0,0,0,0,1.0,1,1.0,1,1.0,1,0.5784285081150945,47
5281,4,13650,13650,0,0,0,0,1.0,1,1.0,1,1.0,1,0.5994133883527265,48
5282,2,13652,13652,0,0,0,0,1.0,1,1.0,1,1.0,1,0.593252194267054,48
5283,3,13655,13655,0,0,0,0,1.0,1,1.0,1,1.0,1,0.5906356751137216,49
5284,1,13656,13656,0,0,0,0,1.0,1,1.0,1,1.0,1,0.609661080472262,49
5285,1,13657,13657,0,0,0,0,1.0,1,1.0,1,1.0,1,0.5812120131634798,50
5286,0,13657,13657,0,0,0,0,1.0,1,1.0,1,1.0,1,0.5872792310950072,51
5287,0,13657,13657,0,0,0,0,1.0,1,1.0,1,1.0,1,0.5872792310950072,51
5288,1,13658,13658,0,0,0,0,1.0,1,1.0,1,1.0,1,0.6119472879130651,51
5289,1,13659,13659,0,0,0,0,1.0,1,1.0,1,1.0,1,0.5911387784708069,53
5290,1,13660,13660,0,0,0,0,1.0,1,1.0,1,1.0,1,0.6023300395932083,53
5291,2,13662,13662,0,0,0,0,1.0,1,1.0,1,1.0,1,0.6066096343218987,53
5292,2,13664,13664,0,0,0,0,1.0,1,1.0,1,1.0,1,0.5917526833824002,53
5293,2,13666,13666,0,0,0,0,1.0,1,1.0,1,1.0,1,0.5624215907414364,53
5294,2,13668,13668,0,0,0,0,1.0,1,1.0,1,1.0,1,0.5673856062796507,54
5295,2,13670,13670,0,0,0,0,1.0,1,1.0,1,1.0,1,0.5435236670342095,52
5296,1,13671,13671,0,0,0,0,1.0,1,1.0,1,1.0,1,0.5501424094694121,49
5297,0,13671,13671,0,0,0,0,1.0,1,1.0,1,1.0,1,0.5574304299359444,49
5298,2,13673,13673,0,0,0,0,1.0,1,1.0,1,1.0,1,0.5314160627374922,49
5299,4,13677,13677,0,0,0,0,1.0,1,1.0,1,1.0,1,0.48749243737786213,50
5300,1,13678,13678,0,0,0,0,1.0,1,1.0,1,1.0,1,0.500178491800484,48
5301,3,13681,13681,0,0,0,0,1.0,1,1.0,1,1.0,1,0.5287185334864286,46
5302,1,13682,13682,0,0,0,0,1.0,1,1.0,1,1.0,1,0.5497243741230551,47
5303,2,13684,13684,0,0,0,0,1.0,1,1.0,1,1.0,1,0.55025166266034,46
5304,5,13689,13689,0,0,0,0,1.0,1,1.0,1,1.0,1,0.6220779848692471,45
5305,2,13691,13691,0,0,0,0,1.0,1,1.0,1,1.0,1,0.6231984388057662,44
5306,0,13691,13691,0,0,0,0,1.0,1,1.0,1,1.0,1,0.6401028463063619,42
5307,3,13694,13694,0,0,0,0,1.0,1,1.0,1,1.0,1,0.6781598698738435,42
5308,2,13696,13696,0,0,0,0,1.0,1,1.0,1,1.0,1,0.6900881897414284,43
5309,0,13696,13696,0,0,0,0,1.0,1,1.0,1,1.0,1,0.6910873462305298,41
5310,1,13697,13697,0,0,0,0,1.0,1,1.0,1,1.0,1,0.6667881593678435,41
5311,0,13697,13697,0,0,0,0,1.0,1,1.0,1,1.0,1,0.6511300518068133,42
5312,2,13699,13699,0,0,0,0,1.0,1,1.0,1,1.0,1,0.674969227364994,43
5313,3,13702,13702,0,0,0,0,1.0,1,1.0,1,1.0,1,0.6402792722511852,44
5314,2,13704,13704,0,0,0,0,1.0,1,1.0,1,1.0,1,0.6388983222965382,44
5315,6,13710,13710,0,0,0,0,1.0,1,1.0,1,1.0,1,0.5944182785661095,45
5316,2,13712,13712,0,0,0,0,1.0,1,1.0,1,1.0,1,0.600611995933986,46
5317,5,13717,13717,0,0,0,0,1.0,1,1.0,1,1.0,1,0.5695412751752886,46
5318,3,13720,13720,0,0,0,0,1.0,1,1.0,1,1.0,1,0.5280866641118434,46
5319,3,13723,13723,0,0,0,0,1.0,1,1.0,1,1.0,1,0.5142697056112459,47
5320,4,13727,13727,0,0,0,0,1.0,1,1.0,1,1.0,1,0.5237060498188757,48
5321,1,13728,13728,0,0,0,0,1.0,1,1.0,1,1.0,1,0.5344239935437431,49
5322,2,13730,13730,0,0,0,0,1.0,1,1.0,1,1.0,1,0.5301206168296471,49
5323,2,13732,13732,0,0,0,0,1.0,1,1.0,1,1.0,1,0.550688132977362,51
5324,3,13735,13735,0,0,0,0,1.0,1,1.0,1,1.0,1,0.5249108734880276,53
5325,1,13736,13736,0,0,0,0,1.0,1,1.0,1,1.0,1,0.521654290667025,53
5326,5,13741,13741,0,0,0,0,1.0,1,1.0,1,1.0,1,0.5066593312446009,53
5327,2,13743,13743,0,0,0,0,1.0,1,1.0,1,1.0,1,0.5394217851200148,53
5328,1,13744,13744,0,0,0,0,1.0,1,1.0,1,1.0,1,0.5472057914918013,54
5329,2,13746,13746,0,0,0,0,1.0,1,1.0,1,1.0,1,0.5597062910221472,53
5330,4,13750,13750,0,0,0,0,1.0,1,1.0,1,1.0,1,0.5265558636745672,52
5331,3,13753,13753,0,0,0,0,1.0,1,1.0,1,1.0,1,0.5231648149258554,51
5332,1,13754,13754,0,0,0,0,1.0,1,1.0,1,1.0,1,0.537887861754812,52
5333,2,13756,13756,0,0,0,0,1.0,1,1.0,1,1.0,1,0.5512568293915112,53
5334,0,13756,13756,0,0,0,0,1.0,1,1.0,1,1.0,1,0.5594972864364604,54
5335,0,13756,13756,0,0,0,0,1.0,1,1.0,1,1.0,1,0.5617728067355693,55
5336,4,13760,13760,0,0,0,0,1.0,1,1.0,1,1.0,1,0.6057726976550001,54
5337,0,13760,13760,0,0,0,0,1.0,1,1.0,1,1.0,1,0.6108693092395892,55
5338,1,13761,13761,0,0,0,0,1.0,1,1.0,1,1.0,1,0.6186377294634025,55
5339,3,13764,13764,0,0,0,0,1.0,1,1.0,1,1.0,1,0.6182231295993311,55
5340,1,13765,13765,0,0,0,0,1.0,1,1.0,1,1.0,1,0.6245493046623241,55
5341,3,13768,13768,0,0,0,0,1.0,1,1.0,1,1.0,1,0.6192309757521086,54
5342,3,13771,13771,0,0,0,0,1.0,1,1.0,1,1.0,1,0.6377447841646545,55
5343,5,13776,13776,0,0,0,0,1.0,1,1.0,1,1.0,1,0.638546492051011,54
5344,2,13778,13778,0,0,0,0,1.0,1,1.0,1,1.0,1,0.6399943512516016,55
5345,3,13781,13781,0,0,0,0,1.0,1,1.0,1,1.0,1,0.6489708669358456,53
5346,3,13784,13784,0,0,0,0,1.0,1,1.0,1,1.0,1,0.6748156540869709,53
5347,2,13786,13786,0,0,0,0,1.0,1,1.0,1,1.0,1,0.6713147245424386,51
5348,2,13788,13788,0,0,0,0,1.0,1,1.0,1,1.0,1,0.6884452796134343,53
5349,2,13790,13790,0,0,0,0,1.0,1,1.0,1,1.0,1,0.685367127930557,52
5350,3,13793,13793,0,0,0,0,1.0,1,1.0,1,1.0,1,0.7188763270273232,50
5351,1,13794,13794,0,0,0,0,1.0,1,1.0,1,1.0,1,0.6983662521288033,52
5352,1,13795,13795,0,0,0,0,1.0,1,1.0,1,1.0,1,0.713146023170501,49
5353,0,13795,13795,0,0,0,0,1.0,1,1.0,1,1.0,1,0.713146023170501,49
5354,4,13799,13799,0,0,0,0,1.0,1,1.0,1,1.0,1,0.7041654157283569,49
5355,0,13799,13799,0,0,0,0,1.0,1,1.0,1,1.0,1,0.7049998690928387,48
5356,3,13802,13802,0,0,0,0,1.0,1,1.0,1,1.0,1,0.6953412399121157,49
5357,1,13803,13803,0,0,0,0,1.0,1,1.0,1,1.0,1,0.7096272269320403,47
5358,3,13806,13806,0,0,0,0,1.0,1,1.0,1,1.0,1,0.6932998129262081,48
5359,2,13808,13808,0,0,0,0,1.0,1,1.0,1,1.0,1,0.6827410468896615,48
5360,3,13811,13811,0,0,0,0,1.0,1,1.0,1,1.0,1,0.6847669575961782,48
5361,1,13812,13812,0,0,0,0,1.0,1,1.0,1,1.0,1,0.6766458877218473,50
5362,1,13813,13813,0,0,0,0,1.0,1,1.0,1,1.0,1,0.665025774720152,50
5363,1,13814,13814,0,0,0,0,1.0,1,1.0,1,1.0,1,0.6726770294338532,50
5364,1,13815,13815,0,0,0,0,1.0,1,1.0,1,1.0,1,0.6724920819648949,51
5365,0,13815,13815,0,0,0,0,1.0,1,1.0,1,1.0,1,0.6719546269575751,52
5366,4,13819,13819,0,0,0,0,1.0,1,1.0,1,1.0,1,0.6774867242945009,52
5367,4,13823,13823,0,0,0,0,1.0,1,1.0,1,1.0,1,0.6751107553340174,54
5368,4,13827,13827,0,0,0,0,1.0,1,1.0,1,1.0,1,0.6709882371707809,55
5369,6,13833,13833,0,0,0,0,1.0,1,1.0,1,1.0,1,0.6424073567893003,53
5370,4,13837,13837,0,0,0,0,1.0,1,1.0,1,1.0,1,0.6406902382202657,54
5371,6,13843,13843,0,0,0,0,1.0,1,1.0,1,1.0,1,0.6295704722292574,53
5372,6,13849,13849,0,0,0,0,1.0,1,1.0,1,1.0,1,0.6218161943209315,53
5373,5,13854,13854,0,0,0,0,1.0,1,1.0,1,1.0,1,0.6230149027583938,52
5374,2,13856,13856,0,0,0,0,1.0,1,1.0,1,1.0,1,0.6249323898237356,51
5375,3,13859,13859,0,0,0,0,1.0,1,1.0,1,1.0,1,0.6051573406689772,52
5376,2,13861,13861,0,0,0,0,1.0,1,1.0,1,1.0,1,0.6134159233625057,51
5377,0,13861,13861,0,0,0,0,1.0,1,1.0,1,1.0,1,0.6144115948750063,52
5378,2,13863,13863,0,0,0,0,1.0,1,1.0,1,1.0,1,0.6419291568114956,50
5379,2,13865,13865,0,0,0,0,1.0,1,1.0,1,1.0,1,0.6386078803597723,50
5380,0,13865,13865,0,0,0,0,1.0,1,1.0,1,1.0,1,0.6369127604155641,52
5381,3,13868,13868,0,0,0,0,1.0,1,1.0,1,1.0,1,0.6216036083523553,52
5382,4,13872,13872,0,0,0,0,1.0,1,1.0,1,1.0,1,0.6214435459885361,52
5383,2,13874,13874,0,0,0,0,1.0,1,1.0,1,1.0,1,0.6100099735469012,51
5384,5,13879,13879,0,0,0,0,1.0,1,1.0,1,1.0,1,0.6461434593093783,52
5385,3,13882,13882,0,0,0,0,1.0,1,1.0,1,1.0,1,0.6356439523099676,51
5386,7,13889,13889,0,0,0,0,1.0,1,1.0,1,1.0,1,0.6279956533451317,52
5387,4,13893,13893,0,0,0,0,1.0,1,1.0,1,1.0,1,0.604613535004633,53
5388,5,13898,13898,0,0,0,0,1.0,1,1.0,1,1.0,1,0.6394880355231579,54
5389,3,13901,13901,0,0,0,0,1.0,1,1.0,1,1.0,1,0.605846398541347,55
5390,2,13903,13903,0,0,0,0,1.0,1,1.0,1,1.0,1,0.6244685129690438,56
5391,3,13906,13906,0,0,0,0,1.0,1,1.0,1,1.0,1,0.5993381100425915,56
5392,2,13908,13908,0,0,0,0,1.0,1,1.0,1,1.0,1,0.6168642505449342,56
5393,3,13911,13911,0,0,0,0,1.0,1,1.0,1,1.0,1,0.5946024949177438,54
5394,5,13916,13916,0,0,0,0,1.0,1,1.0,1,1.0,1,0.582027180459936,53
5395,3,13919,13919,0,0,0,0,1.0,1,1.0,1,1.0,1,0.5825927932278218,53
5396,9,13928,13928,0,0,0,0,1.0,1,1.0,1,1.0,1,0.5872343664278478,54
5397,8,13936,13936,0,0,0,0,1.0,1,1.0,1,1.0,1,0.5794569975313559,53
5398,5,13941,13941,0,0,0,0,1.0,1,1.0,1,1.0,1,0.5634985677698962,53
5399,5,13946,13946,0,0,0,0,1.0,1,1.0,1,1.0,1,0.541017143078934,55
5400,5,13951,13951,0,0,0,0,1.0,1,1.0,1,1.0,1,0.5564837885382572,55
5401,3,13954,13954,0,0,0,0,1.0,1,1.0,1,1.0,1,0.5443433241881047,56
5402,0,13954,13954,0,0,0,0,1.0,1,1.0,1,1.0,1,0.0,0
