,SuccessfulHandoverCount,TotalSuccessfulHandoverCount,TotalSuccessfulHandoverCountRange,TotalSuccessfulHandoverCountLoadBalancing,TotalSuccessfulHandoverCountOverload,FailedHandoverCount,TotalFailedHandoverCount,AvgQoS,MinQoS,AvgQoS_LoadBased,MinQoS_LoadBased,AvgQoS_RangeBased,MinQoS_RangeBased,GiniLoad,VehicleCount
0,0,0,0,0,0,0,0,1.0,1,1.0,1,1.0,1,0.0,0
1,21,21,0,21,0,0,0,1.0,1,1.0,1,1.0,1,0.2165790718897854,26
2,17,38,0,38,0,0,0,1.0,1,1.0,1,1.0,1,0.18791858244832024,27
3,17,55,0,55,0,0,0,1.0,1,1.0,1,1.0,1,0.25024768830641797,28
4,13,68,0,68,0,0,0,1.0,1,1.0,1,1.0,1,0.22822342948356183,29
5,15,83,0,83,0,0,0,1.0,1,1.0,1,1.0,1,0.26922230265739816,29
6,17,100,0,100,0,0,0,1.0,1,1.0,1,1.0,1,0.22708442386982752,32
7,20,120,0,120,0,0,0,1.0,1,1.0,1,1.0,1,0.19626410754392068,33
8,20,140,0,140,0,0,0,1.0,1,1.0,1,1.0,1,0.21547705794871122,35
9,18,158,0,158,0,0,0,1.0,1,1.0,1,1.0,1,0.23368209851404168,35
10,18,176,0,176,0,0,0,1.0,1,1.0,1,1.0,1,0.1876986438900981,35
11,18,194,0,194,0,0,0,1.0,1,1.0,1,1.0,1,0.1679553681716169,35
12,12,206,0,206,0,0,0,1.0,1,1.0,1,1.0,1,0.23891437697563497,34
13,9,215,0,215,0,0,0,1.0,1,1.0,1,1.0,1,0.2024936641852062,32
14,13,228,1,227,0,0,0,1.0,1,1.0,1,1.0,1,0.31933410371690674,31
15,12,240,1,239,0,0,0,1.0,1,1.0,1,1.0,1,0.22971736660152747,30
16,2,242,1,241,0,0,0,1.0,1,1.0,1,1.0,1,0.18205589367375186,30
17,0,242,1,241,0,0,0,1.0,1,1.0,1,1.0,1,0.15355129982202648,29
18,1,243,2,241,0,0,0,1.0,1,1.0,1,1.0,1,0.20145086156740172,29
19,2,245,2,243,0,0,0,1.0,1,1.0,1,1.0,1,0.1341817193013814,28
20,0,245,2,243,0,0,0,1.0,1,1.0,1,1.0,1,0.17648202782951325,28
21,0,245,2,243,0,0,0,1.0,1,1.0,1,1.0,1,0.17648202782951325,28
22,4,249,5,244,0,0,0,1.0,1,1.0,1,1.0,1,0.22544544805530897,28
23,2,251,6,245,0,0,0,1.0,1,1.0,1,1.0,1,0.29734576898433146,27
24,2,253,8,245,0,0,0,1.0,1,1.0,1,1.0,1,0.30996406491563977,28
25,3,256,10,246,0,0,0,1.0,1,1.0,1,1.0,1,0.24350755806238494,28
26,2,258,12,246,0,0,0,1.0,1,1.0,1,1.0,1,0.26186742558978715,30
27,1,259,12,247,0,0,0,1.0,1,1.0,1,1.0,1,0.27620707773077413,30
28,6,265,14,251,0,0,0,1.0,1,1.0,1,1.0,1,0.2440884287733001,31
29,1,266,14,252,0,0,0,1.0,1,1.0,1,1.0,1,0.2510756831635871,30
30,3,269,15,254,0,0,0,1.0,1,1.0,1,1.0,1,0.2608023491914753,30
31,5,274,16,258,0,0,0,1.0,1,1.0,1,1.0,1,0.13369108410222175,31
32,0,274,16,258,0,0,0,1.0,1,1.0,1,1.0,1,0.1592550022472353,31
33,3,277,18,259,0,0,0,1.0,1,1.0,1,1.0,1,0.18328562594576878,31
34,2,279,19,260,0,0,0,1.0,1,1.0,1,1.0,1,0.18550089065608188,29
35,4,283,20,263,0,0,0,1.0,1,1.0,1,1.0,1,0.20534808997464693,30
36,0,283,20,263,0,0,0,1.0,1,1.0,1,1.0,1,0.218716618393352,30
37,1,284,20,264,0,0,0,1.0,1,1.0,1,1.0,1,0.20818120639959614,31
38,0,284,20,264,0,0,0,1.0,1,1.0,1,1.0,1,0.20602316593393147,32
39,3,287,20,267,0,0,0,1.0,1,1.0,1,1.0,1,0.20183678056788887,36
40,3,290,20,270,0,0,0,1.0,1,1.0,1,1.0,1,0.1994130465610384,37
41,4,294,20,274,0,0,0,1.0,1,1.0,1,1.0,1,0.15506908097641123,37
42,3,297,20,277,0,0,0,1.0,1,1.0,1,1.0,1,0.1696906958138357,38
43,4,301,20,281,0,0,0,1.0,1,1.0,1,1.0,1,0.21452848365710322,40
44,2,303,20,283,0,0,0,1.0,1,1.0,1,1.0,1,0.1636974452695664,39
45,6,309,21,288,0,0,0,1.0,1,1.0,1,1.0,1,0.20470049055915795,40
46,1,310,21,289,0,0,0,1.0,1,1.0,1,1.0,1,0.16917663963117197,39
47,0,310,21,289,0,0,0,1.0,1,1.0,1,1.0,1,0.16917663963117197,39
48,0,310,21,289,0,0,0,1.0,1,1.0,1,1.0,1,0.16917663963117197,39
49,4,314,23,291,0,0,0,1.0,1,1.0,1,1.0,1,0.1995170089865703,37
50,2,316,24,292,0,0,0,1.0,1,1.0,1,1.0,1,0.1707908170159364,35
51,0,316,24,292,0,0,0,1.0,1,1.0,1,1.0,1,0.17466637261519175,34
52,0,316,24,292,0,0,0,1.0,1,1.0,1,1.0,1,0.20277473178049343,34
53,1,317,24,293,0,0,0,1.0,1,1.0,1,1.0,1,0.1820779083052865,35
54,1,318,24,294,0,0,0,1.0,1,1.0,1,1.0,1,0.21033901365992666,36
55,4,322,25,297,0,0,0,1.0,1,1.0,1,1.0,1,0.17433393172654374,36
56,4,326,27,299,0,0,0,1.0,1,1.0,1,1.0,1,0.20894628214615424,36
57,2,328,27,301,0,0,0,1.0,1,1.0,1,1.0,1,0.20313896114011096,37
58,5,333,29,304,0,0,0,1.0,1,1.0,1,1.0,1,0.20746354910284198,38
59,3,336,29,307,0,0,0,1.0,1,1.0,1,1.0,1,0.2029113952248725,37
60,0,336,29,307,0,0,0,1.0,1,1.0,1,1.0,1,0.19116379025865027,38
61,3,339,29,310,0,0,0,1.0,1,1.0,1,1.0,1,0.17168541289304934,37
62,1,340,30,310,0,0,0,1.0,1,1.0,1,1.0,1,0.1718809469360336,39
63,2,342,31,311,0,0,0,1.0,1,1.0,1,1.0,1,0.17186164045793748,39
64,2,344,33,311,0,0,0,1.0,1,1.0,1,1.0,1,0.22755083739419016,38
65,2,346,35,311,0,0,0,1.0,1,1.0,1,1.0,1,0.23279020938715486,39
66,3,349,37,312,0,0,0,1.0,1,1.0,1,1.0,1,0.26894508628517516,39
67,4,353,37,316,0,0,0,1.0,1,1.0,1,1.0,1,0.2008857577319355,36
68,3,356,38,318,0,0,0,1.0,1,1.0,1,1.0,1,0.24140813205696046,36
69,2,358,38,320,0,0,0,1.0,1,1.0,1,1.0,1,0.21329655826913488,37
70,3,361,38,323,0,0,0,1.0,1,1.0,1,1.0,1,0.20599847670818855,36
71,2,363,38,325,0,0,0,1.0,1,1.0,1,1.0,1,0.1971606991356189,38
72,3,366,38,328,0,0,0,1.0,1,1.0,1,1.0,1,0.20274369829507835,38
73,3,369,38,331,0,0,0,1.0,1,1.0,1,1.0,1,0.18545825269455193,37
74,3,372,39,333,0,0,0,1.0,1,1.0,1,1.0,1,0.23374397053417897,38
75,3,375,39,336,0,0,0,1.0,1,1.0,1,1.0,1,0.21866694980350246,38
76,6,381,40,341,0,0,0,1.0,1,1.0,1,1.0,1,0.2123192079111878,39
77,3,384,40,344,0,0,0,1.0,1,1.0,1,1.0,1,0.15614719371357536,40
78,4,388,40,348,0,0,0,1.0,1,1.0,1,1.0,1,0.16822880906199397,41
79,4,392,40,352,0,0,0,1.0,1,1.0,1,1.0,1,0.16822880906199397,41
80,3,395,40,355,0,0,0,1.0,1,1.0,1,1.0,1,0.16327192750886357,41
81,3,398,41,357,0,0,0,1.0,1,1.0,1,1.0,1,0.2539768207160292,41
82,8,406,41,365,0,0,0,1.0,1,1.0,1,1.0,1,0.18011768816374368,44
83,7,413,41,372,0,0,0,1.0,1,1.0,1,1.0,1,0.17297828713974545,44
84,4,417,41,376,0,0,0,1.0,1,1.0,1,1.0,1,0.16669843636272855,45
85,2,419,41,378,0,0,0,1.0,1,1.0,1,1.0,1,0.17445253149838333,45
86,4,423,41,382,0,0,0,1.0,1,1.0,1,1.0,1,0.11107652412849696,45
87,0,423,41,382,0,0,0,1.0,1,1.0,1,1.0,1,0.12228849173946178,44
88,1,424,41,383,0,0,0,1.0,1,1.0,1,1.0,1,0.14387701161336103,44
89,2,426,42,384,0,0,0,1.0,1,1.0,1,1.0,1,0.12932432793070944,43
90,1,427,42,385,0,0,0,1.0,1,1.0,1,1.0,1,0.1840811554059696,44
91,3,430,44,386,0,0,0,1.0,1,1.0,1,1.0,1,0.21882841357268304,44
92,0,430,44,386,0,0,0,1.0,1,1.0,1,1.0,1,0.20618823942225178,43
93,3,433,44,389,0,0,0,1.0,1,1.0,1,1.0,1,0.18535518649154253,44
94,1,434,45,389,0,0,0,1.0,1,1.0,1,1.0,1,0.20338399875756463,44
95,3,437,45,392,0,0,0,1.0,1,1.0,1,1.0,1,0.1510046389277682,43
96,0,437,45,392,0,0,0,1.0,1,1.0,1,1.0,1,0.15240959878807653,44
97,0,437,45,392,0,0,0,1.0,1,1.0,1,1.0,1,0.15240959878807653,44
98,0,437,45,392,0,0,0,1.0,1,1.0,1,1.0,1,0.1738016653956716,43
99,0,437,45,392,0,0,0,1.0,1,1.0,1,1.0,1,0.1738016653956716,43
100,0,437,45,392,0,0,0,1.0,1,1.0,1,1.0,1,0.1681426211514829,47
101,0,437,45,392,0,0,0,1.0,1,1.0,1,1.0,1,0.1681426211514829,47
102,3,440,47,393,0,0,0,1.0,1,1.0,1,1.0,1,0.1619080710931919,47
103,3,443,49,394,0,0,0,1.0,1,1.0,1,1.0,1,0.15340515858981238,46
104,2,445,51,394,0,0,0,1.0,1,1.0,1,1.0,1,0.15188387907237474,45
105,3,448,53,395,0,0,0,1.0,1,1.0,1,1.0,1,0.14813765349622007,44
106,5,453,56,397,0,0,0,1.0,1,1.0,1,1.0,1,0.1624546217417097,45
107,2,455,57,398,0,0,0,1.0,1,1.0,1,1.0,1,0.16302434670834376,44
108,5,460,59,401,0,0,0,1.0,1,1.0,1,1.0,1,0.1306880725857552,46
109,2,462,60,402,0,0,0,1.0,1,1.0,1,1.0,1,0.13835953333126902,46
110,4,466,62,404,0,0,0,1.0,1,1.0,1,1.0,1,0.13976739008802433,46
111,3,469,63,406,0,0,0,1.0,1,1.0,1,1.0,1,0.1475783040841367,46
112,3,472,63,409,0,0,0,1.0,1,1.0,1,1.0,1,0.11115688573620756,46
113,1,473,64,409,0,0,0,1.0,1,1.0,1,1.0,1,0.11899827938510137,46
114,1,474,64,410,0,0,0,1.0,1,1.0,1,1.0,1,0.10896178277827355,46
115,0,474,64,410,0,0,0,1.0,1,1.0,1,1.0,1,0.08025142810352638,47
116,5,479,66,413,0,0,0,1.0,1,1.0,1,1.0,1,0.11899836890143745,47
117,3,482,67,415,0,0,0,1.0,1,1.0,1,1.0,1,0.09472085502709902,45
118,2,484,67,417,0,0,0,1.0,1,1.0,1,1.0,1,0.07703360452402057,46
119,1,485,67,418,0,0,0,1.0,1,1.0,1,1.0,1,0.0964953188849612,46
120,0,485,67,418,0,0,0,1.0,1,1.0,1,1.0,1,0.10565081449038706,47
121,1,486,67,419,0,0,0,1.0,1,1.0,1,1.0,1,0.09019253496485537,46
122,1,487,68,419,0,0,0,1.0,1,1.0,1,1.0,1,0.10854297556917292,46
123,0,487,68,419,0,0,0,1.0,1,1.0,1,1.0,1,0.12630153295714608,45
124,0,487,68,419,0,0,0,1.0,1,1.0,1,1.0,1,0.12506154948743045,46
125,1,488,69,419,0,0,0,1.0,1,1.0,1,1.0,1,0.15376588875517616,44
126,1,489,70,419,0,0,0,1.0,1,1.0,1,1.0,1,0.15160944481842376,45
127,0,489,70,419,0,0,0,1.0,1,1.0,1,1.0,1,0.1472664202606866,45
128,1,490,70,420,0,0,0,1.0,1,1.0,1,1.0,1,0.13064009050306066,46
129,3,493,72,421,0,0,0,1.0,1,1.0,1,1.0,1,0.13033005083191965,48
130,4,497,73,424,0,0,0,1.0,1,1.0,1,1.0,1,0.11132099426822659,48
131,2,499,73,426,0,0,0,1.0,1,1.0,1,1.0,1,0.10311993233502921,49
132,4,503,75,428,0,0,0,1.0,1,1.0,1,1.0,1,0.16728217545803814,51
133,2,505,77,428,0,0,0,1.0,1,1.0,1,1.0,1,0.1625836474755693,49
134,5,510,80,430,0,0,0,1.0,1,1.0,1,1.0,1,0.18341939735974738,49
135,4,514,81,433,0,0,0,1.0,1,1.0,1,1.0,1,0.19469061028151421,49
136,16,530,87,443,0,0,0,1.0,1,1.0,1,1.0,1,0.23170198439063794,48
137,10,540,87,453,0,0,0,1.0,1,1.0,1,1.0,1,0.2294499802213887,47
138,7,547,87,460,0,0,0,1.0,1,1.0,1,1.0,1,0.20137672859264585,48
139,10,557,88,469,0,0,0,1.0,1,1.0,1,1.0,1,0.2474012446174221,48
140,9,566,89,477,0,0,0,1.0,1,1.0,1,1.0,1,0.2432502441533036,49
141,7,573,90,483,0,0,0,1.0,1,1.0,1,1.0,1,0.19884381860099487,49
142,7,580,91,489,0,0,0,1.0,1,1.0,1,1.0,1,0.2764020689858495,49
143,8,588,92,496,0,0,0,1.0,1,1.0,1,1.0,1,0.2569007086512594,47
144,8,596,94,502,0,0,0,1.0,1,1.0,1,1.0,1,0.25903642297439505,46
145,7,603,95,508,0,0,0,1.0,1,1.0,1,1.0,1,0.27085723279597007,44
146,8,611,96,515,0,0,0,1.0,1,1.0,1,1.0,1,0.2550004889252561,44
147,7,618,97,521,0,0,0,1.0,1,1.0,1,1.0,1,0.2786637222783797,43
148,8,626,98,528,0,0,0,1.0,1,1.0,1,1.0,1,0.2836548753900361,43
149,8,634,100,534,0,0,0,1.0,1,1.0,1,1.0,1,0.2819665260625561,43
150,8,642,101,541,0,0,0,1.0,1,1.0,1,1.0,1,0.31694653245268584,42
151,11,653,102,551,0,0,0,1.0,1,1.0,1,1.0,1,0.16221023864147108,42
152,3,656,102,554,0,0,0,1.0,1,1.0,1,1.0,1,0.1484679489886562,42
153,2,658,102,556,0,0,0,1.0,1,1.0,1,1.0,1,0.1578770750491945,42
154,2,660,103,557,0,0,0,1.0,1,1.0,1,1.0,1,0.19853429301319855,43
155,3,663,103,560,0,0,0,1.0,1,1.0,1,1.0,1,0.1586713738499327,43
156,3,666,104,562,0,0,0,1.0,1,1.0,1,1.0,1,0.16663877185433573,42
157,5,671,104,567,0,0,0,1.0,1,1.0,1,1.0,1,0.19006256464665644,41
158,4,675,105,570,0,0,0,1.0,1,1.0,1,1.0,1,0.22496996937661004,42
159,2,677,105,572,0,0,0,1.0,1,1.0,1,1.0,1,0.18334633893090324,43
160,11,688,107,581,0,0,0,1.0,1,1.0,1,1.0,1,0.2837885919134361,44
161,9,697,108,589,0,0,0,1.0,1,1.0,1,1.0,1,0.2832840388429834,44
162,10,707,111,596,0,0,0,1.0,1,1.0,1,1.0,1,0.35603744499449547,45
163,8,715,112,603,0,0,0,1.0,1,1.0,1,1.0,1,0.29996668641723323,43
164,7,722,113,609,0,0,0,1.0,1,1.0,1,1.0,1,0.271491311089965,42
165,9,731,114,617,0,0,0,1.0,1,1.0,1,1.0,1,0.2238274856213384,42
166,9,740,114,626,0,0,0,1.0,1,1.0,1,1.0,1,0.12679831431892646,42
167,3,743,115,628,0,0,0,1.0,1,1.0,1,1.0,1,0.13231587000522885,41
168,0,743,115,628,0,0,0,1.0,1,1.0,1,1.0,1,0.12080095778931343,40
169,0,743,115,628,0,0,0,1.0,1,1.0,1,1.0,1,0.12767102793468432,40
170,2,745,115,630,0,0,0,1.0,1,1.0,1,1.0,1,0.16955153583478894,38
171,1,746,115,631,0,0,0,1.0,1,1.0,1,1.0,1,0.13986565309271495,37
172,3,749,118,631,0,0,0,1.0,1,1.0,1,1.0,1,0.1488372945345417,35
173,4,753,120,633,0,0,0,1.0,1,1.0,1,1.0,1,0.20479809019735365,36
174,2,755,121,634,0,0,0,1.0,1,1.0,1,1.0,1,0.17036962062760433,34
175,0,755,121,634,0,0,0,1.0,1,1.0,1,1.0,1,0.21923844495577366,33
176,0,755,121,634,0,0,0,1.0,1,1.0,1,1.0,1,0.235117654848706,34
177,2,757,122,635,0,0,0,1.0,1,1.0,1,1.0,1,0.2323403460971376,36
178,1,758,122,636,0,0,0,1.0,1,1.0,1,1.0,1,0.21873191690802904,37
179,1,759,123,636,0,0,0,1.0,1,1.0,1,1.0,1,0.25348380193927955,37
180,0,759,123,636,0,0,0,1.0,1,1.0,1,1.0,1,0.2591512248115946,36
181,3,762,123,639,0,0,0,1.0,1,1.0,1,1.0,1,0.14352343685022623,36
182,2,764,123,641,0,0,0,1.0,1,1.0,1,1.0,1,0.10341977947758715,38
183,1,765,124,641,0,0,0,1.0,1,1.0,1,1.0,1,0.11109459692875566,37
184,2,767,126,641,0,0,0,1.0,1,1.0,1,1.0,1,0.14167965208956504,36
185,3,770,127,643,0,0,0,1.0,1,1.0,1,1.0,1,0.15761847498929105,35
186,2,772,129,643,0,0,0,1.0,1,1.0,1,1.0,1,0.21503540170829594,34
187,2,774,130,644,0,0,0,1.0,1,1.0,1,1.0,1,0.18794017686053138,33
188,1,775,130,645,0,0,0,1.0,1,1.0,1,1.0,1,0.22454815201714706,33
189,6,781,134,647,0,0,0,1.0,1,1.0,1,1.0,1,0.2775592466011421,33
190,1,782,134,648,0,0,0,1.0,1,1.0,1,1.0,1,0.2699622536205812,32
191,1,783,135,648,0,0,0,1.0,1,1.0,1,1.0,1,0.28301525307794434,34
192,5,788,136,652,0,0,0,1.0,1,1.0,1,1.0,1,0.303321604024307,34
193,3,791,136,655,0,0,0,1.0,1,1.0,1,1.0,1,0.27050713515937286,35
194,3,794,137,657,0,0,0,1.0,1,1.0,1,1.0,1,0.25280059032863517,37
195,1,795,137,658,0,0,0,1.0,1,1.0,1,1.0,1,0.233713802444514,36
196,3,798,137,661,0,0,0,1.0,1,1.0,1,1.0,1,0.17949345677158726,36
197,0,798,137,661,0,0,0,1.0,1,1.0,1,1.0,1,0.18098305164433678,37
198,0,798,137,661,0,0,0,1.0,1,1.0,1,1.0,1,0.18098305164433678,37
199,0,798,137,661,0,0,0,1.0,1,1.0,1,1.0,1,0.18098305164433678,37
200,1,799,138,661,0,0,0,1.0,1,1.0,1,1.0,1,0.2124139865630395,37
201,3,802,139,663,0,0,0,1.0,1,1.0,1,1.0,1,0.18278928130807273,36
202,1,803,140,663,0,0,0,1.0,1,1.0,1,1.0,1,0.1939017808887641,36
203,1,804,141,663,0,0,0,1.0,1,1.0,1,1.0,1,0.18815442902924207,35
204,2,806,143,663,0,0,0,1.0,1,1.0,1,1.0,1,0.20691137775061919,35
205,3,809,144,665,0,0,0,1.0,1,1.0,1,1.0,1,0.22350444390742083,35
206,5,814,146,668,0,0,0,1.0,1,1.0,1,1.0,1,0.25032334213792323,34
207,2,816,146,670,0,0,0,1.0,1,1.0,1,1.0,1,0.26580339806157566,34
208,6,822,147,675,0,0,0,1.0,1,1.0,1,1.0,1,0.28767383440117156,33
209,2,824,147,677,0,0,0,1.0,1,1.0,1,1.0,1,0.30575462320517804,33
210,6,830,149,681,0,0,0,1.0,1,1.0,1,1.0,1,0.3541080199552105,34
211,8,838,150,688,0,0,0,1.0,1,1.0,1,1.0,1,0.24175458571729747,33
212,3,841,150,691,0,0,0,1.0,1,1.0,1,1.0,1,0.1788033936006745,33
213,1,842,150,692,0,0,0,1.0,1,1.0,1,1.0,1,0.19316235755481923,35
214,3,845,150,695,0,0,0,1.0,1,1.0,1,1.0,1,0.16094705441813825,34
215,3,848,150,698,0,0,0,1.0,1,1.0,1,1.0,1,0.12137443293766713,35
216,5,853,150,703,0,0,0,1.0,1,1.0,1,1.0,1,0.1251888729959288,36
217,3,856,151,705,0,0,0,1.0,1,1.0,1,1.0,1,0.14335341043858044,36
218,4,860,153,707,0,0,0,1.0,1,1.0,1,1.0,1,0.19709382277249562,36
219,6,866,154,712,0,0,0,1.0,1,1.0,1,1.0,1,0.15711075701129448,37
220,7,873,155,718,0,0,0,1.0,1,1.0,1,1.0,1,0.23303803016913857,38
221,5,878,156,722,0,0,0,1.0,1,1.0,1,1.0,1,0.22124297115929195,37
222,1,879,157,722,0,0,0,1.0,1,1.0,1,1.0,1,0.20178696476576974,38
223,2,881,158,723,0,0,0,1.0,1,1.0,1,1.0,1,0.20419058204650606,38
224,3,884,160,724,0,0,0,1.0,1,1.0,1,1.0,1,0.18380923094374801,38
225,1,885,161,724,0,0,0,1.0,1,1.0,1,1.0,1,0.23498440833809792,36
226,7,892,163,729,0,0,0,1.0,1,1.0,1,1.0,1,0.1490562922386568,37
227,3,895,165,730,0,0,0,1.0,1,1.0,1,1.0,1,0.18141961435723095,35
228,4,899,167,732,0,0,0,1.0,1,1.0,1,1.0,1,0.15149058842465613,35
229,4,903,169,734,0,0,0,1.0,1,1.0,1,1.0,1,0.1575405676849702,35
230,3,906,171,735,0,0,0,1.0,1,1.0,1,1.0,1,0.22046516136519648,35
231,3,909,172,737,0,0,0,1.0,1,1.0,1,1.0,1,0.16241703141011105,35
232,1,910,173,737,0,0,0,1.0,1,1.0,1,1.0,1,0.14065196929317944,36
233,0,910,173,737,0,0,0,1.0,1,1.0,1,1.0,1,0.14065196929317944,36
234,0,910,173,737,0,0,0,1.0,1,1.0,1,1.0,1,0.12698791065675644,34
235,2,912,175,737,0,0,0,1.0,1,1.0,1,1.0,1,0.1477159561379502,33
236,0,912,175,737,0,0,0,1.0,1,1.0,1,1.0,1,0.15732614326775682,31
237,1,913,176,737,0,0,0,1.0,1,1.0,1,1.0,1,0.1676684682961063,32
238,1,914,177,737,0,0,0,1.0,1,1.0,1,1.0,1,0.20519277626227664,31
239,1,915,178,737,0,0,0,1.0,1,1.0,1,1.0,1,0.2529894512206,30
240,1,916,179,737,0,0,0,1.0,1,1.0,1,1.0,1,0.29489778173599207,27
241,8,924,182,742,0,0,0,1.0,1,1.0,1,1.0,1,0.21448071954559708,27
242,2,926,182,744,0,0,0,1.0,1,1.0,1,1.0,1,0.1627625781196657,28
243,2,928,183,745,0,0,0,1.0,1,1.0,1,1.0,1,0.14725993589449543,28
244,2,930,184,746,0,0,0,1.0,1,1.0,1,1.0,1,0.17043947578377544,27
245,0,930,184,746,0,0,0,1.0,1,1.0,1,1.0,1,0.17043947578377544,27
246,3,933,186,747,0,0,0,1.0,1,1.0,1,1.0,1,0.20957328292111532,25
247,0,933,186,747,0,0,0,1.0,1,1.0,1,1.0,1,0.19527032014453843,24
248,0,933,186,747,0,0,0,1.0,1,1.0,1,1.0,1,0.19768118065108886,24
249,1,934,187,747,0,0,0,1.0,1,1.0,1,1.0,1,0.23934308972801366,25
250,0,934,187,747,0,0,0,1.0,1,1.0,1,1.0,1,0.2308178830753791,27
251,0,934,187,747,0,0,0,1.0,1,1.0,1,1.0,1,0.2308178830753791,27
252,1,935,187,748,0,0,0,1.0,1,1.0,1,1.0,1,0.20220042572321065,27
253,1,936,187,749,0,0,0,1.0,1,1.0,1,1.0,1,0.1860954846726658,29
254,0,936,187,749,0,0,0,1.0,1,1.0,1,1.0,1,0.15931516174564275,30
255,3,939,188,751,0,0,0,1.0,1,1.0,1,1.0,1,0.1647299485318998,31
256,2,941,189,752,0,0,0,1.0,1,1.0,1,1.0,1,0.13470611298281582,31
257,1,942,190,752,0,0,0,1.0,1,1.0,1,1.0,1,0.16448203315070895,33
258,1,943,191,752,0,0,0,1.0,1,1.0,1,1.0,1,0.18290505929650674,33
259,2,945,192,753,0,0,0,1.0,1,1.0,1,1.0,1,0.17360074044856008,33
260,5,950,194,756,0,0,0,1.0,1,1.0,1,1.0,1,0.2334808622289419,35
261,7,957,195,762,0,0,0,1.0,1,1.0,1,1.0,1,0.21248309437883953,35
262,3,960,196,764,0,0,0,1.0,1,1.0,1,1.0,1,0.24871356568608974,35
263,5,965,197,768,0,0,0,1.0,1,1.0,1,1.0,1,0.23762120048086455,34
264,4,969,199,770,0,0,0,1.0,1,1.0,1,1.0,1,0.24561365577297148,32
265,0,969,199,770,0,0,0,1.0,1,1.0,1,1.0,1,0.19282566375666912,30
266,0,969,199,770,0,0,0,1.0,1,1.0,1,1.0,1,0.17252525466951874,31
267,1,970,200,770,0,0,0,1.0,1,1.0,1,1.0,1,0.17404269189926436,30
268,1,971,200,771,0,0,0,1.0,1,1.0,1,1.0,1,0.1971337380791651,31
269,1,972,201,771,0,0,0,1.0,1,1.0,1,1.0,1,0.21238797765878473,31
270,2,974,202,772,0,0,0,1.0,1,1.0,1,1.0,1,0.24754597406796072,32
271,3,977,203,774,0,0,0,1.0,1,1.0,1,1.0,1,0.24555669286575746,31
272,1,978,204,774,0,0,0,1.0,1,1.0,1,1.0,1,0.33623622994586505,32
273,2,980,204,776,0,0,0,1.0,1,1.0,1,1.0,1,0.30617960481995377,32
274,1,981,204,777,0,0,0,1.0,1,1.0,1,1.0,1,0.29566479887607716,32
275,0,981,204,777,0,0,0,1.0,1,1.0,1,1.0,1,0.2698889044740145,33
276,3,984,205,779,0,0,0,1.0,1,1.0,1,1.0,1,0.2477669522418263,34
277,2,986,205,781,0,0,0,1.0,1,1.0,1,1.0,1,0.23281710773654476,32
278,0,986,205,781,0,0,0,1.0,1,1.0,1,1.0,1,0.2542599687989988,31
279,2,988,205,783,0,0,0,1.0,1,1.0,1,1.0,1,0.19015011872461135,31
280,1,989,205,784,0,0,0,1.0,1,1.0,1,1.0,1,0.18341371369615253,30
281,2,991,207,784,0,0,0,1.0,1,1.0,1,1.0,1,0.22631940025472885,31
282,3,994,207,787,0,0,0,1.0,1,1.0,1,1.0,1,0.21299031342266753,30
283,7,1001,209,792,0,0,0,1.0,1,1.0,1,1.0,1,0.18564220331985107,31
284,3,1004,209,795,0,0,0,1.0,1,1.0,1,1.0,1,0.21431650241584846,31
285,7,1011,211,800,0,0,0,1.0,1,1.0,1,1.0,1,0.2753272409851918,31
286,4,1015,211,804,0,0,0,1.0,1,1.0,1,1.0,1,0.1544307077071575,31
287,5,1020,213,807,0,0,0,1.0,1,1.0,1,1.0,1,0.12707664920203451,33
288,1,1021,213,808,0,0,0,1.0,1,1.0,1,1.0,1,0.13702886090690333,32
289,1,1022,214,808,0,0,0,1.0,1,1.0,1,1.0,1,0.15293183786912334,32
290,0,1022,214,808,0,0,0,1.0,1,1.0,1,1.0,1,0.17481952482364804,31
291,0,1022,214,808,0,0,0,1.0,1,1.0,1,1.0,1,0.16886940641258075,30
292,1,1023,215,808,0,0,0,1.0,1,1.0,1,1.0,1,0.19130436908408777,32
293,1,1024,215,809,0,0,0,1.0,1,1.0,1,1.0,1,0.18527692612373114,32
294,0,1024,215,809,0,0,0,1.0,1,1.0,1,1.0,1,0.18527692612373114,32
295,1,1025,215,810,0,0,0,1.0,1,1.0,1,1.0,1,0.15848339512266627,34
296,2,1027,216,811,0,0,0,1.0,1,1.0,1,1.0,1,0.15453438764724955,34
297,1,1028,216,812,0,0,0,1.0,1,1.0,1,1.0,1,0.12890930081885665,34
298,1,1029,216,813,0,0,0,1.0,1,1.0,1,1.0,1,0.12639133540501135,35
299,0,1029,216,813,0,0,0,1.0,1,1.0,1,1.0,1,0.10478053023582574,35
300,0,1029,216,813,0,0,0,1.0,1,1.0,1,1.0,1,0.10478053023582574,35
301,2,1031,217,814,0,0,0,1.0,1,1.0,1,1.0,1,0.1258151992429406,38
302,1,1032,218,814,0,0,0,1.0,1,1.0,1,1.0,1,0.13283957100058283,38
303,2,1034,220,814,0,0,0,1.0,1,1.0,1,1.0,1,0.15448485786041743,37
304,4,1038,222,816,0,0,0,1.0,1,1.0,1,1.0,1,0.20298171924882055,37
305,6,1044,223,821,0,0,0,1.0,1,1.0,1,1.0,1,0.20107780404587142,36
306,5,1049,226,823,0,0,0,1.0,1,1.0,1,1.0,1,0.2884256462813058,36
307,1,1050,226,824,0,0,0,1.0,1,1.0,1,1.0,1,0.2929304326513954,35
308,5,1055,227,828,0,0,0,1.0,1,1.0,1,1.0,1,0.2798207274385599,37
309,5,1060,227,833,0,0,0,1.0,1,1.0,1,1.0,1,0.2653660937906914,37
310,3,1063,227,836,0,0,0,1.0,1,1.0,1,1.0,1,0.29923712105756506,37
311,4,1067,227,840,0,0,0,1.0,1,1.0,1,1.0,1,0.24712105493230563,39
312,5,1072,227,845,0,0,0,1.0,1,1.0,1,1.0,1,0.22388393576218854,40
313,2,1074,227,847,0,0,0,1.0,1,1.0,1,1.0,1,0.22070145263346216,39
314,4,1078,227,851,0,0,0,1.0,1,1.0,1,1.0,1,0.2085348649609511,40
315,2,1080,229,851,0,0,0,1.0,1,1.0,1,1.0,1,0.23434382476995422,39
316,7,1087,229,858,0,0,0,1.0,1,1.0,1,1.0,1,0.10625390277308704,39
317,2,1089,229,860,0,0,0,1.0,1,1.0,1,1.0,1,0.11195136860421652,40
318,4,1093,229,864,0,0,0,1.0,1,1.0,1,1.0,1,0.123836570009864,41
319,3,1096,229,867,0,0,0,1.0,1,1.0,1,1.0,1,0.16046716260328478,41
320,0,1096,229,867,0,0,0,1.0,1,1.0,1,1.0,1,0.18291284180394513,41
321,0,1096,229,867,0,0,0,1.0,1,1.0,1,1.0,1,0.18291284180394513,41
322,4,1100,232,868,0,0,0,1.0,1,1.0,1,1.0,1,0.20766136224133494,41
323,4,1104,232,872,0,0,0,1.0,1,1.0,1,1.0,1,0.20066611068783613,41
324,8,1112,234,878,0,0,0,1.0,1,1.0,1,1.0,1,0.24623800331765303,42
325,7,1119,234,885,0,0,0,1.0,1,1.0,1,1.0,1,0.24232911876332022,42
326,5,1124,235,889,0,0,0,1.0,1,1.0,1,1.0,1,0.2520474367955996,42
327,9,1133,236,897,0,0,0,1.0,1,1.0,1,1.0,1,0.25895376740103826,42
328,7,1140,236,904,0,0,0,1.0,1,1.0,1,1.0,1,0.22179225498752944,43
329,6,1146,236,910,0,0,0,1.0,1,1.0,1,1.0,1,0.2564857845717228,43
330,8,1154,236,918,0,0,0,1.0,1,1.0,1,1.0,1,0.24848153048553417,45
331,10,1164,237,927,0,0,0,1.0,1,1.0,1,1.0,1,0.08684865723072586,45
332,5,1169,238,931,0,0,0,1.0,1,1.0,1,1.0,1,0.13413594906712262,45
333,4,1173,239,934,0,0,0,1.0,1,1.0,1,1.0,1,0.11657268464395741,46
334,3,1176,239,937,0,0,0,1.0,1,1.0,1,1.0,1,0.10339931541675647,48
335,1,1177,239,938,0,0,0,1.0,1,1.0,1,1.0,1,0.09895234020564257,48
336,2,1179,239,940,0,0,0,1.0,1,1.0,1,1.0,1,0.09895234020564257,48
337,2,1181,239,942,0,0,0,1.0,1,1.0,1,1.0,1,0.12059164420556327,49
338,2,1183,240,943,0,0,0,1.0,1,1.0,1,1.0,1,0.12425860809181694,50
339,1,1184,240,944,0,0,0,1.0,1,1.0,1,1.0,1,0.10389870012998102,50
340,0,1184,240,944,0,0,0,1.0,1,1.0,1,1.0,1,0.10389870012998102,50
341,1,1185,240,945,0,0,0,1.0,1,1.0,1,1.0,1,0.11383289282028827,51
342,1,1186,241,945,0,0,0,1.0,1,1.0,1,1.0,1,0.12690685852512615,51
343,4,1190,241,949,0,0,0,1.0,1,1.0,1,1.0,1,0.08715549852966606,51
344,4,1194,242,952,0,0,0,1.0,1,1.0,1,1.0,1,0.11012969845563286,50
345,3,1197,242,955,0,0,0,1.0,1,1.0,1,1.0,1,0.09950717029157671,51
346,3,1200,242,958,0,0,0,1.0,1,1.0,1,1.0,1,0.07600935430075002,51
347,1,1201,243,958,0,0,0,1.0,1,1.0,1,1.0,1,0.06494950432430252,51
348,2,1203,245,958,0,0,0,1.0,1,1.0,1,1.0,1,0.0927435235905072,53
349,4,1207,247,960,0,0,0,1.0,1,1.0,1,1.0,1,0.09525118674830567,55
350,1,1208,248,960,0,0,0,1.0,1,1.0,1,1.0,1,0.11069091597634799,54
351,7,1215,252,963,0,0,0,1.0,1,1.0,1,1.0,1,0.13347209438025615,54
352,3,1218,254,964,0,0,0,1.0,1,1.0,1,1.0,1,0.17634292220158448,53
353,1,1219,254,965,0,0,0,1.0,1,1.0,1,1.0,1,0.14250726185688628,53
354,1,1220,254,966,0,0,0,1.0,1,1.0,1,1.0,1,0.1598773997043004,50
355,0,1220,254,966,0,0,0,1.0,1,1.0,1,1.0,1,0.17439842455864144,51
356,1,1221,255,966,0,0,0,1.0,1,1.0,1,1.0,1,0.16044785818603272,51
357,1,1222,256,966,0,0,0,1.0,1,1.0,1,1.0,1,0.16060271718347854,50
358,1,1223,257,966,0,0,0,1.0,1,1.0,1,1.0,1,0.18037510958355016,48
359,1,1224,258,966,0,0,0,1.0,1,1.0,1,1.0,1,0.168927367034342,47
360,0,1224,258,966,0,0,0,1.0,1,1.0,1,1.0,1,0.2059425610327445,45
361,5,1229,260,969,0,0,0,1.0,1,1.0,1,1.0,1,0.18618321099707505,44
362,3,1232,260,972,0,0,0,1.0,1,1.0,1,1.0,1,0.15598730969618854,44
363,2,1234,262,972,0,0,0,1.0,1,1.0,1,1.0,1,0.15701466798089725,44
364,1,1235,263,972,0,0,0,1.0,1,1.0,1,1.0,1,0.16799601257896193,43
365,3,1238,265,973,0,0,0,1.0,1,1.0,1,1.0,1,0.18909761473037864,43
366,1,1239,265,974,0,0,0,1.0,1,1.0,1,1.0,1,0.17723227020774274,45
367,2,1241,266,975,0,0,0,1.0,1,1.0,1,1.0,1,0.20118114302022566,44
368,3,1244,268,976,0,0,0,1.0,1,1.0,1,1.0,1,0.16462626911844638,46
369,3,1247,269,978,0,0,0,1.0,1,1.0,1,1.0,1,0.18090908579441678,45
370,1,1248,269,979,0,0,0,1.0,1,1.0,1,1.0,1,0.18581330611954353,46
371,2,1250,269,981,0,0,0,1.0,1,1.0,1,1.0,1,0.16253448528345454,47
372,0,1250,269,981,0,0,0,1.0,1,1.0,1,1.0,1,0.174141297832684,48
373,1,1251,269,982,0,0,0,1.0,1,1.0,1,1.0,1,0.14983004218486382,48
374,3,1254,269,985,0,0,0,1.0,1,1.0,1,1.0,1,0.17576318150997255,49
375,1,1255,269,986,0,0,0,1.0,1,1.0,1,1.0,1,0.16331468919724565,49
376,4,1259,273,986,0,0,0,1.0,1,1.0,1,1.0,1,0.1379736522142335,49
377,3,1262,276,986,0,0,0,1.0,1,1.0,1,1.0,1,0.16832542592747377,49
378,1,1263,277,986,0,0,0,1.0,1,1.0,1,1.0,1,0.18565704813660133,49
379,1,1264,277,987,0,0,0,1.0,1,1.0,1,1.0,1,0.19652855375777342,50
380,5,1269,279,990,0,0,0,1.0,1,1.0,1,1.0,1,0.21450331896087388,50
381,2,1271,279,992,0,0,0,1.0,1,1.0,1,1.0,1,0.19748552897697091,51
382,1,1272,279,993,0,0,0,1.0,1,1.0,1,1.0,1,0.2172977630187948,50
383,5,1277,281,996,0,0,0,1.0,1,1.0,1,1.0,1,0.17955746928431518,51
384,3,1280,284,996,0,0,0,1.0,1,1.0,1,1.0,1,0.17391173075939995,50
385,2,1282,286,996,0,0,0,1.0,1,1.0,1,1.0,1,0.18116239350357663,50
386,4,1286,288,998,0,0,0,1.0,1,1.0,1,1.0,1,0.19340961550431465,48
387,1,1287,288,999,0,0,0,1.0,1,1.0,1,1.0,1,0.18412417648313972,47
388,2,1289,288,1001,0,0,0,1.0,1,1.0,1,1.0,1,0.20050490361412707,48
389,2,1291,288,1003,0,0,0,1.0,1,1.0,1,1.0,1,0.19436796438123347,47
390,4,1295,290,1005,0,0,0,1.0,1,1.0,1,1.0,1,0.17446825648642972,49
391,7,1302,292,1010,0,0,0,1.0,1,1.0,1,1.0,1,0.08499858712288802,46
392,3,1305,293,1012,0,0,0,1.0,1,1.0,1,1.0,1,0.1222190883224085,46
393,3,1308,296,1012,0,0,0,1.0,1,1.0,1,1.0,1,0.15697221200505,44
394,4,1312,297,1015,0,0,0,1.0,1,1.0,1,1.0,1,0.16648341876578227,43
395,2,1314,297,1017,0,0,0,1.0,1,1.0,1,1.0,1,0.21324966598737544,42
396,2,1316,299,1017,0,0,0,1.0,1,1.0,1,1.0,1,0.23705934611473237,39
397,2,1318,300,1018,0,0,0,1.0,1,1.0,1,1.0,1,0.28567236142125485,39
398,3,1321,300,1021,0,0,0,1.0,1,1.0,1,1.0,1,0.26627766684913257,36
399,0,1321,300,1021,0,0,0,1.0,1,1.0,1,1.0,1,0.26627766684913257,36
400,2,1323,302,1021,0,0,0,1.0,1,1.0,1,1.0,1,0.2806674372336602,34
401,2,1325,303,1022,0,0,0,1.0,1,1.0,1,1.0,1,0.2789948079567022,33
402,0,1325,303,1022,0,0,0,1.0,1,1.0,1,1.0,1,0.26158075452774465,34
403,0,1325,303,1022,0,0,0,1.0,1,1.0,1,1.0,1,0.2625831985669694,36
404,3,1328,305,1023,0,0,0,1.0,1,1.0,1,1.0,1,0.2588823967745025,36
405,3,1331,308,1023,0,0,0,1.0,1,1.0,1,1.0,1,0.3294303367075252,37
406,7,1338,308,1030,0,0,0,1.0,1,1.0,1,1.0,1,0.18769845920429531,37
407,3,1341,309,1032,0,0,0,1.0,1,1.0,1,1.0,1,0.17591080320489674,39
408,2,1343,310,1033,0,0,0,1.0,1,1.0,1,1.0,1,0.15321836980455122,40
409,5,1348,312,1036,0,0,0,1.0,1,1.0,1,1.0,1,0.18319700236389566,41
410,3,1351,313,1038,0,0,0,1.0,1,1.0,1,1.0,1,0.1972348358389738,42
411,1,1352,313,1039,0,0,0,1.0,1,1.0,1,1.0,1,0.2036006397406832,43
412,2,1354,315,1039,0,0,0,1.0,1,1.0,1,1.0,1,0.24334008748692929,44
413,0,1354,315,1039,0,0,0,1.0,1,1.0,1,1.0,1,0.24334008748692929,44
414,1,1355,315,1040,0,0,0,1.0,1,1.0,1,1.0,1,0.21535894396654093,45
415,2,1357,315,1042,0,0,0,1.0,1,1.0,1,1.0,1,0.20688194087407047,45
416,4,1361,315,1046,0,0,0,1.0,1,1.0,1,1.0,1,0.23947140052329072,46
417,4,1365,316,1049,0,0,0,1.0,1,1.0,1,1.0,1,0.20243553920176022,46
418,3,1368,316,1052,0,0,0,1.0,1,1.0,1,1.0,1,0.18271350442065,47
419,2,1370,316,1054,0,0,0,1.0,1,1.0,1,1.0,1,0.19930779920256106,47
420,2,1372,316,1056,0,0,0,1.0,1,1.0,1,1.0,1,0.19930779920256106,47
421,2,1374,316,1058,0,0,0,1.0,1,1.0,1,1.0,1,0.16937767019539726,47
422,2,1376,317,1059,0,0,0,1.0,1,1.0,1,1.0,1,0.16995788689171257,49
423,1,1377,317,1060,0,0,0,1.0,1,1.0,1,1.0,1,0.14883717382928682,47
424,2,1379,317,1062,0,0,0,1.0,1,1.0,1,1.0,1,0.11507497828374377,45
425,1,1380,317,1063,0,0,0,1.0,1,1.0,1,1.0,1,0.13700490054336395,46
426,3,1383,318,1065,0,0,0,1.0,1,1.0,1,1.0,1,0.14355945150445518,46
427,1,1384,319,1065,0,0,0,1.0,1,1.0,1,1.0,1,0.1392965266072009,45
428,1,1385,319,1066,0,0,0,1.0,1,1.0,1,1.0,1,0.1382741182446887,45
429,8,1393,323,1070,0,0,0,1.0,1,1.0,1,1.0,1,0.16591972532430768,42
430,0,1393,323,1070,0,0,0,1.0,1,1.0,1,1.0,1,0.1893978085246991,40
431,1,1394,324,1070,0,0,0,1.0,1,1.0,1,1.0,1,0.21724534526649036,39
432,1,1395,325,1070,0,0,0,1.0,1,1.0,1,1.0,1,0.26752482042229075,37
433,3,1398,328,1070,0,0,0,1.0,1,1.0,1,1.0,1,0.2792554773035259,35
434,0,1398,328,1070,0,0,0,1.0,1,1.0,1,1.0,1,0.3260699889675088,33
435,1,1399,328,1071,0,0,0,1.0,1,1.0,1,1.0,1,0.3116316162373517,33
436,9,1408,328,1080,0,0,0,1.0,1,1.0,1,1.0,1,0.14257268528151404,33
437,3,1411,329,1082,0,0,0,1.0,1,1.0,1,1.0,1,0.15480411841430708,33
438,3,1414,329,1085,0,0,0,1.0,1,1.0,1,1.0,1,0.11606180432684463,32
439,4,1418,330,1088,0,0,0,1.0,1,1.0,1,1.0,1,0.1716037608143197,34
440,4,1422,331,1091,0,0,0,1.0,1,1.0,1,1.0,1,0.21635115351023748,34
441,3,1425,332,1093,0,0,0,1.0,1,1.0,1,1.0,1,0.25897137744970494,35
442,8,1433,333,1100,0,0,0,1.0,1,1.0,1,1.0,1,0.2385951936587285,37
443,10,1443,337,1106,0,0,0,1.0,1,1.0,1,1.0,1,0.23744771269477702,37
444,6,1449,338,1111,0,0,0,1.0,1,1.0,1,1.0,1,0.22887919819443425,38
445,8,1457,340,1117,0,0,0,1.0,1,1.0,1,1.0,1,0.28005469727438237,39
446,9,1466,340,1126,0,0,0,1.0,1,1.0,1,1.0,1,0.33891056259444907,39
447,12,1478,340,1138,0,0,0,1.0,1,1.0,1,1.0,1,0.2578576234748466,41
448,10,1488,340,1148,0,0,0,1.0,1,1.0,1,1.0,1,0.24590600973517143,41
449,10,1498,341,1157,0,0,0,1.0,1,1.0,1,1.0,1,0.32064890459013745,40
450,7,1505,341,1164,0,0,0,1.0,1,1.0,1,1.0,1,0.2690132942302105,40
451,3,1508,341,1167,0,0,0,1.0,1,1.0,1,1.0,1,0.2478562630728766,41
452,2,1510,341,1169,0,0,0,1.0,1,1.0,1,1.0,1,0.21093043644722048,41
453,2,1512,341,1171,0,0,0,1.0,1,1.0,1,1.0,1,0.22617808868970032,40
454,3,1515,341,1174,0,0,0,1.0,1,1.0,1,1.0,1,0.16566707022281463,41
455,4,1519,341,1178,0,0,0,1.0,1,1.0,1,1.0,1,0.11603648510471343,41
456,6,1525,341,1184,0,0,0,1.0,1,1.0,1,1.0,1,0.17449808384085685,43
457,8,1533,342,1191,0,0,0,1.0,1,1.0,1,1.0,1,0.13887165137415466,43
458,4,1537,342,1195,0,0,0,1.0,1,1.0,1,1.0,1,0.16293603846187413,43
459,3,1540,342,1198,0,0,0,1.0,1,1.0,1,1.0,1,0.1354966006301814,44
460,5,1545,342,1203,0,0,0,1.0,1,1.0,1,1.0,1,0.16105490369421158,47
461,4,1549,342,1207,0,0,0,1.0,1,1.0,1,1.0,1,0.17159548884253437,48
462,5,1554,345,1209,0,0,0,1.0,1,1.0,1,1.0,1,0.21025564888271356,49
463,6,1560,345,1215,0,0,0,1.0,1,1.0,1,1.0,1,0.1777655485590469,47
464,6,1566,347,1219,0,0,0,1.0,1,1.0,1,1.0,1,0.21510917785169242,48
465,6,1572,349,1223,0,0,0,1.0,1,1.0,1,1.0,1,0.2159919288793607,47
466,10,1582,349,1233,0,0,0,1.0,1,1.0,1,1.0,1,0.12876653630775411,46
467,7,1589,350,1239,0,0,0,1.0,1,1.0,1,1.0,1,0.15728556655276305,44
468,4,1593,350,1243,0,0,0,1.0,1,1.0,1,1.0,1,0.17157238983475373,41
469,2,1595,350,1245,0,0,0,1.0,1,1.0,1,1.0,1,0.13411555396960606,40
470,3,1598,352,1246,0,0,0,1.0,1,1.0,1,1.0,1,0.10605142512624681,39
471,3,1601,353,1248,0,0,0,1.0,1,1.0,1,1.0,1,0.11739635061463048,38
472,4,1605,355,1250,0,0,0,1.0,1,1.0,1,1.0,1,0.23326195565836225,36
473,5,1610,358,1252,0,0,0,1.0,1,1.0,1,1.0,1,0.20971915197506472,36
474,1,1611,359,1252,0,0,0,1.0,1,1.0,1,1.0,1,0.26763946190528554,34
475,3,1614,362,1252,0,0,0,1.0,1,1.0,1,1.0,1,0.29520843351430875,34
476,0,1614,362,1252,0,0,0,1.0,1,1.0,1,1.0,1,0.32819295864352716,32
477,3,1617,363,1254,0,0,0,1.0,1,1.0,1,1.0,1,0.3045679620158143,32
478,1,1618,363,1255,0,0,0,1.0,1,1.0,1,1.0,1,0.2792958279294483,30
479,2,1620,364,1256,0,0,0,1.0,1,1.0,1,1.0,1,0.27468387089262286,31
480,1,1621,364,1257,0,0,0,1.0,1,1.0,1,1.0,1,0.3570610935319807,27
481,7,1628,365,1263,0,0,0,1.0,1,1.0,1,1.0,1,0.1987044299475645,28
482,0,1628,365,1263,0,0,0,1.0,1,1.0,1,1.0,1,0.16908199734586643,28
483,4,1632,366,1266,0,0,0,1.0,1,1.0,1,1.0,1,0.18359821969266238,29
484,2,1634,367,1267,0,0,0,1.0,1,1.0,1,1.0,1,0.17073860730218277,29
485,3,1637,368,1269,0,0,0,1.0,1,1.0,1,1.0,1,0.12194926675724091,29
486,1,1638,368,1270,0,0,0,1.0,1,1.0,1,1.0,1,0.1244788828991089,31
487,4,1642,368,1274,0,0,0,1.0,1,1.0,1,1.0,1,0.12684559884203078,33
488,2,1644,368,1276,0,0,0,1.0,1,1.0,1,1.0,1,0.10034569778758792,34
489,1,1645,369,1276,0,0,0,1.0,1,1.0,1,1.0,1,0.1882683646073414,34
490,0,1645,369,1276,0,0,0,1.0,1,1.0,1,1.0,1,0.1882683646073414,34
491,0,1645,369,1276,0,0,0,1.0,1,1.0,1,1.0,1,0.1882683646073414,34
492,0,1645,369,1276,0,0,0,1.0,1,1.0,1,1.0,1,0.1882683646073414,34
493,5,1650,370,1280,0,0,0,1.0,1,1.0,1,1.0,1,0.194037701506072,34
494,5,1655,371,1284,0,0,0,1.0,1,1.0,1,1.0,1,0.17913858639291147,36
495,3,1658,372,1286,0,0,0,1.0,1,1.0,1,1.0,1,0.20486015186250892,36
496,5,1663,372,1291,0,0,0,1.0,1,1.0,1,1.0,1,0.10325056840140122,37
497,2,1665,372,1293,0,0,0,1.0,1,1.0,1,1.0,1,0.13091408425670728,39
498,2,1667,372,1295,0,0,0,1.0,1,1.0,1,1.0,1,0.12638209917971988,40
499,2,1669,373,1296,0,0,0,1.0,1,1.0,1,1.0,1,0.1817134094399555,40
500,7,1676,373,1303,0,0,0,1.0,1,1.0,1,1.0,1,0.15017485829875338,42
501,2,1678,373,1305,0,0,0,1.0,1,1.0,1,1.0,1,0.15017485829875338,42
502,5,1683,375,1308,0,0,0,1.0,1,1.0,1,1.0,1,0.14350817883467773,42
503,1,1684,376,1308,0,0,0,1.0,1,1.0,1,1.0,1,0.18811744488714732,41
504,3,1687,379,1308,0,0,0,1.0,1,1.0,1,1.0,1,0.24042159027082757,42
505,3,1690,380,1310,0,0,0,1.0,1,1.0,1,1.0,1,0.22754167034585304,38
506,2,1692,381,1311,0,0,0,1.0,1,1.0,1,1.0,1,0.1845712584562309,37
507,5,1697,382,1315,0,0,0,1.0,1,1.0,1,1.0,1,0.19921386034569658,35
508,2,1699,383,1316,0,0,0,1.0,1,1.0,1,1.0,1,0.20329232598396998,35
509,0,1699,383,1316,0,0,0,1.0,1,1.0,1,1.0,1,0.21875741494302034,34
510,2,1701,385,1316,0,0,0,1.0,1,1.0,1,1.0,1,0.2701012925945096,34
511,1,1702,385,1317,0,0,0,1.0,1,1.0,1,1.0,1,0.2208477845631635,32
512,0,1702,385,1317,0,0,0,1.0,1,1.0,1,1.0,1,0.21757579378765962,30
513,0,1702,385,1317,0,0,0,1.0,1,1.0,1,1.0,1,0.20817935638594948,31
514,0,1702,385,1317,0,0,0,1.0,1,1.0,1,1.0,1,0.20817935638594948,31
515,4,1706,387,1319,0,0,0,1.0,1,1.0,1,1.0,1,0.1789688421436372,32
516,1,1707,387,1320,0,0,0,1.0,1,1.0,1,1.0,1,0.15408890315798665,31
517,2,1709,388,1321,0,0,0,1.0,1,1.0,1,1.0,1,0.1763356051956457,32
518,1,1710,388,1322,0,0,0,1.0,1,1.0,1,1.0,1,0.15150007595644288,31
519,3,1713,390,1323,0,0,0,1.0,1,1.0,1,1.0,1,0.14490907110118487,31
520,0,1713,390,1323,0,0,0,1.0,1,1.0,1,1.0,1,0.17346106242234932,33
521,1,1714,391,1323,0,0,0,1.0,1,1.0,1,1.0,1,0.18363805805637218,34
522,3,1717,393,1324,0,0,0,1.0,1,1.0,1,1.0,1,0.155096498303805,34
523,0,1717,393,1324,0,0,0,1.0,1,1.0,1,1.0,1,0.16030463532683656,33
524,5,1722,396,1326,0,0,0,1.0,1,1.0,1,1.0,1,0.18417737173666118,34
525,2,1724,396,1328,0,0,0,1.0,1,1.0,1,1.0,1,0.17592439969569632,32
526,2,1726,396,1330,0,0,0,1.0,1,1.0,1,1.0,1,0.14104445980956315,32
527,0,1726,396,1330,0,0,0,1.0,1,1.0,1,1.0,1,0.1406050996231069,31
528,4,1730,399,1331,0,0,0,1.0,1,1.0,1,1.0,1,0.22270437771735146,31
529,0,1730,399,1331,0,0,0,1.0,1,1.0,1,1.0,1,0.2405439857965404,30
530,2,1732,400,1332,0,0,0,1.0,1,1.0,1,1.0,1,0.222342314517034,30
531,0,1732,400,1332,0,0,0,1.0,1,1.0,1,1.0,1,0.24788629071031468,32
532,4,1736,403,1333,0,0,0,1.0,1,1.0,1,1.0,1,0.2610225945115193,32
533,4,1740,405,1335,0,0,0,1.0,1,1.0,1,1.0,1,0.27446524031215025,34
534,2,1742,406,1336,0,0,0,1.0,1,1.0,1,1.0,1,0.27772202712341953,34
535,3,1745,406,1339,0,0,0,1.0,1,1.0,1,1.0,1,0.2850726977839441,37
536,2,1747,406,1341,0,0,0,1.0,1,1.0,1,1.0,1,0.28669298125044884,37
537,4,1751,408,1343,0,0,0,1.0,1,1.0,1,1.0,1,0.30463170596850103,37
538,6,1757,408,1349,0,0,0,1.0,1,1.0,1,1.0,1,0.2756932121013692,38
539,3,1760,408,1352,0,0,0,1.0,1,1.0,1,1.0,1,0.24487139122865145,38
540,1,1761,408,1353,0,0,0,1.0,1,1.0,1,1.0,1,0.23399668124087808,38
541,0,1761,408,1353,0,0,0,1.0,1,1.0,1,1.0,1,0.22076666211677162,39
542,6,1767,410,1357,0,0,0,1.0,1,1.0,1,1.0,1,0.19184134307005,40
543,1,1768,411,1357,0,0,0,1.0,1,1.0,1,1.0,1,0.22424670447527495,37
544,2,1770,412,1358,0,0,0,1.0,1,1.0,1,1.0,1,0.23786561881107204,35
545,1,1771,413,1358,0,0,0,1.0,1,1.0,1,1.0,1,0.17290165122778364,35
546,4,1775,415,1360,0,0,0,1.0,1,1.0,1,1.0,1,0.16191544979324993,35
547,2,1777,416,1361,0,0,0,1.0,1,1.0,1,1.0,1,0.15089417787581508,34
548,5,1782,419,1363,0,0,0,1.0,1,1.0,1,1.0,1,0.18709322078772722,34
549,2,1784,421,1363,0,0,0,1.0,1,1.0,1,1.0,1,0.22807425351219499,31
550,0,1784,421,1363,0,0,0,1.0,1,1.0,1,1.0,1,0.2158022056276895,30
551,3,1787,424,1363,0,0,0,1.0,1,1.0,1,1.0,1,0.2710340177771773,31
552,1,1788,424,1364,0,0,0,1.0,1,1.0,1,1.0,1,0.1853569194951195,29
553,3,1791,425,1366,0,0,0,1.0,1,1.0,1,1.0,1,0.22019330322790326,30
554,2,1793,425,1368,0,0,0,1.0,1,1.0,1,1.0,1,0.17747898437071144,30
555,2,1795,425,1370,0,0,0,1.0,1,1.0,1,1.0,1,0.17998007194971433,30
556,2,1797,425,1372,0,0,0,1.0,1,1.0,1,1.0,1,0.08562284321061918,31
557,0,1797,425,1372,0,0,0,1.0,1,1.0,1,1.0,1,0.1300812528571196,31
558,1,1798,425,1373,0,0,0,1.0,1,1.0,1,1.0,1,0.11481502698952736,31
559,0,1798,425,1373,0,0,0,1.0,1,1.0,1,1.0,1,0.11481502698952736,31
560,0,1798,425,1373,0,0,0,1.0,1,1.0,1,1.0,1,0.09632885988041687,32
561,3,1801,427,1374,0,0,0,1.0,1,1.0,1,1.0,1,0.14224811588446268,33
562,0,1801,427,1374,0,0,0,1.0,1,1.0,1,1.0,1,0.14224811588446268,33
563,3,1804,429,1375,0,0,0,1.0,1,1.0,1,1.0,1,0.140935316651147,33
564,4,1808,431,1377,0,0,0,1.0,1,1.0,1,1.0,1,0.16856288302335212,34
565,4,1812,432,1380,0,0,0,1.0,1,1.0,1,1.0,1,0.1580409893253793,35
566,3,1815,433,1382,0,0,0,1.0,1,1.0,1,1.0,1,0.15707147485931947,36
567,8,1823,436,1387,0,0,0,1.0,1,1.0,1,1.0,1,0.24618934682494298,37
568,5,1828,436,1392,0,0,0,1.0,1,1.0,1,1.0,1,0.27457032526682246,36
569,4,1832,436,1396,0,0,0,1.0,1,1.0,1,1.0,1,0.2299128103417843,37
570,3,1835,436,1399,0,0,0,1.0,1,1.0,1,1.0,1,0.22238753992958882,38
571,6,1841,436,1405,0,0,0,1.0,1,1.0,1,1.0,1,0.14890716883865218,38
572,0,1841,436,1405,0,0,0,1.0,1,1.0,1,1.0,1,0.15135507620024316,39
573,0,1841,436,1405,0,0,0,1.0,1,1.0,1,1.0,1,0.15135507620024316,39
574,0,1841,436,1405,0,0,0,1.0,1,1.0,1,1.0,1,0.14983824152059086,41
575,1,1842,436,1406,0,0,0,1.0,1,1.0,1,1.0,1,0.13085914881541555,41
576,3,1845,436,1409,0,0,0,1.0,1,1.0,1,1.0,1,0.11837349927089062,42
577,0,1845,436,1409,0,0,0,1.0,1,1.0,1,1.0,1,0.11837349927089062,42
578,1,1846,437,1409,0,0,0,1.0,1,1.0,1,1.0,1,0.169580219553001,41
579,3,1849,438,1411,0,0,0,1.0,1,1.0,1,1.0,1,0.18732392214467733,42
580,5,1854,438,1416,0,0,0,1.0,1,1.0,1,1.0,1,0.200512556986907,43
581,5,1859,440,1419,0,0,0,1.0,1,1.0,1,1.0,1,0.1820687107550099,42
582,6,1865,441,1424,0,0,0,1.0,1,1.0,1,1.0,1,0.17486989813637926,41
583,6,1871,443,1428,0,0,0,1.0,1,1.0,1,1.0,1,0.15770564933155454,40
584,1,1872,443,1429,0,0,0,1.0,1,1.0,1,1.0,1,0.16465772841261836,38
585,5,1877,445,1432,0,0,0,1.0,1,1.0,1,1.0,1,0.21006988467670393,38
586,6,1883,446,1437,0,0,0,1.0,1,1.0,1,1.0,1,0.12444476190039369,37
587,5,1888,447,1441,0,0,0,1.0,1,1.0,1,1.0,1,0.12801159576163046,35
588,5,1893,448,1445,0,0,0,1.0,1,1.0,1,1.0,1,0.14262452369913806,35
589,1,1894,448,1446,0,0,0,1.0,1,1.0,1,1.0,1,0.10783511408085217,34
590,4,1898,449,1449,0,0,0,1.0,1,1.0,1,1.0,1,0.16262020849908862,36
591,2,1900,450,1450,0,0,0,1.0,1,1.0,1,1.0,1,0.15102318334160275,35
592,1,1901,451,1450,0,0,0,1.0,1,1.0,1,1.0,1,0.16945359133617083,37
593,3,1904,451,1453,0,0,0,1.0,1,1.0,1,1.0,1,0.13728783025821875,36
594,2,1906,452,1454,0,0,0,1.0,1,1.0,1,1.0,1,0.18246479515358963,35
595,0,1906,452,1454,0,0,0,1.0,1,1.0,1,1.0,1,0.18386180357758078,34
596,1,1907,452,1455,0,0,0,1.0,1,1.0,1,1.0,1,0.20630156520194648,34
597,5,1912,454,1458,0,0,0,1.0,1,1.0,1,1.0,1,0.24185861524514898,33
598,2,1914,454,1460,0,0,0,1.0,1,1.0,1,1.0,1,0.29495845779907415,33
599,3,1917,454,1463,0,0,0,1.0,1,1.0,1,1.0,1,0.25873391499445136,33
600,4,1921,457,1464,0,0,0,1.0,1,1.0,1,1.0,1,0.3699365146520238,33
601,6,1927,458,1469,0,0,0,1.0,1,1.0,1,1.0,1,0.2959241495954032,34
602,1,1928,458,1470,0,0,0,1.0,1,1.0,1,1.0,1,0.3097330365580563,35
603,5,1933,458,1475,0,0,0,1.0,1,1.0,1,1.0,1,0.22464296084234994,35
604,1,1934,458,1476,0,0,0,1.0,1,1.0,1,1.0,1,0.22937614495857772,35
605,3,1937,458,1479,0,0,0,1.0,1,1.0,1,1.0,1,0.21106115156281574,35
606,1,1938,458,1480,0,0,0,1.0,1,1.0,1,1.0,1,0.18619194895846627,35
607,1,1939,459,1480,0,0,0,1.0,1,1.0,1,1.0,1,0.20495160447365593,35
608,3,1942,459,1483,0,0,0,1.0,1,1.0,1,1.0,1,0.18341464889664919,36
609,1,1943,459,1484,0,0,0,1.0,1,1.0,1,1.0,1,0.1449716139255815,37
610,3,1946,459,1487,0,0,0,1.0,1,1.0,1,1.0,1,0.1428290325732131,37
611,3,1949,459,1490,0,0,0,1.0,1,1.0,1,1.0,1,0.1811680997387772,39
612,5,1954,460,1494,0,0,0,1.0,1,1.0,1,1.0,1,0.13625165270364364,39
613,2,1956,460,1496,0,0,0,1.0,1,1.0,1,1.0,1,0.13625165270364364,39
614,7,1963,461,1502,0,0,0,1.0,1,1.0,1,1.0,1,0.13420692840156034,39
615,7,1970,462,1508,0,0,0,1.0,1,1.0,1,1.0,1,0.1628849745863861,39
616,4,1974,463,1511,0,0,0,1.0,1,1.0,1,1.0,1,0.11320596871404778,38
617,0,1974,463,1511,0,0,0,1.0,1,1.0,1,1.0,1,0.12765706433525512,39
618,2,1976,463,1513,0,0,0,1.0,1,1.0,1,1.0,1,0.11285816759292186,40
619,1,1977,464,1513,0,0,0,1.0,1,1.0,1,1.0,1,0.09621216171971532,39
620,1,1978,464,1514,0,0,0,1.0,1,1.0,1,1.0,1,0.08759430994387715,38
621,1,1979,465,1514,0,0,0,1.0,1,1.0,1,1.0,1,0.12707236384291573,38
622,2,1981,466,1515,0,0,0,1.0,1,1.0,1,1.0,1,0.2221078333733684,38
623,4,1985,469,1516,0,0,0,1.0,1,1.0,1,1.0,1,0.16983478012824668,37
624,3,1988,471,1517,0,0,0,1.0,1,1.0,1,1.0,1,0.15494091234226065,33
625,0,1988,471,1517,0,0,0,1.0,1,1.0,1,1.0,1,0.13833404353881104,32
626,1,1989,472,1517,0,0,0,1.0,1,1.0,1,1.0,1,0.15787650483663937,31
627,4,1993,474,1519,0,0,0,1.0,1,1.0,1,1.0,1,0.2856687469461937,30
628,4,1997,478,1519,0,0,0,1.0,1,1.0,1,1.0,1,0.3290829204848609,32
629,5,2002,481,1521,0,0,0,1.0,1,1.0,1,1.0,1,0.37084651599197077,29
630,4,2006,483,1523,0,0,0,1.0,1,1.0,1,1.0,1,0.4123952573031026,29
631,5,2011,484,1527,0,0,0,1.0,1,1.0,1,1.0,1,0.2860256231724257,25
632,0,2011,484,1527,0,0,0,1.0,1,1.0,1,1.0,1,0.2967481186061685,24
633,2,2013,484,1529,0,0,0,1.0,1,1.0,1,1.0,1,0.20375677528553968,23
634,1,2014,484,1530,0,0,0,1.0,1,1.0,1,1.0,1,0.2060381126008364,23
635,2,2016,485,1531,0,0,0,1.0,1,1.0,1,1.0,1,0.19366912348969578,22
636,1,2017,485,1532,0,0,0,1.0,1,1.0,1,1.0,1,0.21008787259611514,22
637,2,2019,486,1533,0,0,0,1.0,1,1.0,1,1.0,1,0.21381033238906255,23
638,2,2021,486,1535,0,0,0,1.0,1,1.0,1,1.0,1,0.21553495336017098,23
639,2,2023,486,1537,0,0,0,1.0,1,1.0,1,1.0,1,0.20937548558586958,24
640,3,2026,487,1539,0,0,0,1.0,1,1.0,1,1.0,1,0.24332738810190227,24
641,1,2027,487,1540,0,0,0,1.0,1,1.0,1,1.0,1,0.22383770923335397,25
642,0,2027,487,1540,0,0,0,1.0,1,1.0,1,1.0,1,0.17651350365236798,26
643,1,2028,487,1541,0,0,0,1.0,1,1.0,1,1.0,1,0.18994073295481556,28
644,1,2029,488,1541,0,0,0,1.0,1,1.0,1,1.0,1,0.1805122314255924,28
645,1,2030,489,1541,0,0,0,1.0,1,1.0,1,1.0,1,0.19313770954396428,28
646,1,2031,489,1542,0,0,0,1.0,1,1.0,1,1.0,1,0.1524181908378394,29
647,2,2033,491,1542,0,0,0,1.0,1,1.0,1,1.0,1,0.21551215631307533,30
648,1,2034,491,1543,0,0,0,1.0,1,1.0,1,1.0,1,0.19826965246992242,30
649,1,2035,492,1543,0,0,0,1.0,1,1.0,1,1.0,1,0.2282668371519007,31
650,1,2036,493,1543,0,0,0,1.0,1,1.0,1,1.0,1,0.21844967302414145,31
651,3,2039,493,1546,0,0,0,1.0,1,1.0,1,1.0,1,0.14544429813794826,32
652,0,2039,493,1546,0,0,0,1.0,1,1.0,1,1.0,1,0.14544429813794826,32
653,1,2040,493,1547,0,0,0,1.0,1,1.0,1,1.0,1,0.1357249511989986,33
654,3,2043,494,1549,0,0,0,1.0,1,1.0,1,1.0,1,0.17766992731221187,33
655,7,2050,497,1553,0,0,0,1.0,1,1.0,1,1.0,1,0.15691626834343933,36
656,3,2053,498,1555,0,0,0,1.0,1,1.0,1,1.0,1,0.1764139956129111,36
657,3,2056,499,1557,0,0,0,1.0,1,1.0,1,1.0,1,0.1680170374293518,35
658,3,2059,501,1558,0,0,0,1.0,1,1.0,1,1.0,1,0.26291679073632773,33
659,3,2062,501,1561,0,0,0,1.0,1,1.0,1,1.0,1,0.2473333773956777,35
660,4,2066,502,1564,0,0,0,1.0,1,1.0,1,1.0,1,0.3161008384273534,34
661,6,2072,502,1570,0,0,0,1.0,1,1.0,1,1.0,1,0.20604581243509984,33
662,2,2074,503,1571,0,0,0,1.0,1,1.0,1,1.0,1,0.20999445517615783,31
663,2,2076,504,1572,0,0,0,1.0,1,1.0,1,1.0,1,0.22690789999714991,29
664,1,2077,505,1572,0,0,0,1.0,1,1.0,1,1.0,1,0.27380774832156207,27
665,4,2081,505,1576,0,0,0,1.0,1,1.0,1,1.0,1,0.21170633541021616,27
666,2,2083,506,1577,0,0,0,1.0,1,1.0,1,1.0,1,0.1936827079039929,28
667,2,2085,507,1578,0,0,0,1.0,1,1.0,1,1.0,1,0.22045985553118447,26
668,3,2088,510,1578,0,0,0,1.0,1,1.0,1,1.0,1,0.16444801144900908,26
669,2,2090,512,1578,0,0,0,1.0,1,1.0,1,1.0,1,0.13432392186985637,25
670,0,2090,512,1578,0,0,0,1.0,1,1.0,1,1.0,1,0.1368704876518459,24
671,0,2090,512,1578,0,0,0,1.0,1,1.0,1,1.0,1,0.1368704876518459,24
672,2,2092,513,1579,0,0,0,1.0,1,1.0,1,1.0,1,0.22749401861142074,25
673,1,2093,513,1580,0,0,0,1.0,1,1.0,1,1.0,1,0.1809270165585993,25
674,1,2094,514,1580,0,0,0,1.0,1,1.0,1,1.0,1,0.1836322315924148,25
675,4,2098,516,1582,0,0,0,1.0,1,1.0,1,1.0,1,0.21787008805087069,26
676,4,2102,517,1585,0,0,0,1.0,1,1.0,1,1.0,1,0.15244832493952948,27
677,2,2104,517,1587,0,0,0,1.0,1,1.0,1,1.0,1,0.15222544665942897,28
678,2,2106,518,1588,0,0,0,1.0,1,1.0,1,1.0,1,0.12453173481150127,28
679,3,2109,519,1590,0,0,0,1.0,1,1.0,1,1.0,1,0.14748380591063362,30
680,2,2111,519,1592,0,0,0,1.0,1,1.0,1,1.0,1,0.13048211095479761,29
681,1,2112,519,1593,0,0,0,1.0,1,1.0,1,1.0,1,0.15108901062333135,29
682,2,2114,519,1595,0,0,0,1.0,1,1.0,1,1.0,1,0.15957253475695235,30
683,1,2115,519,1596,0,0,0,1.0,1,1.0,1,1.0,1,0.13238262582410965,30
684,2,2117,519,1598,0,0,0,1.0,1,1.0,1,1.0,1,0.16278140260290738,31
685,2,2119,519,1600,0,0,0,1.0,1,1.0,1,1.0,1,0.1880132160664718,30
686,6,2125,522,1603,0,0,0,1.0,1,1.0,1,1.0,1,0.20480021670482348,30
687,4,2129,523,1606,0,0,0,1.0,1,1.0,1,1.0,1,0.2381743152791954,30
688,3,2132,523,1609,0,0,0,1.0,1,1.0,1,1.0,1,0.26998831987080063,31
689,5,2137,524,1613,0,0,0,1.0,1,1.0,1,1.0,1,0.33131810877633244,32
690,7,2144,524,1620,0,0,0,1.0,1,1.0,1,1.0,1,0.2647814491233989,32
691,6,2150,525,1625,0,0,0,1.0,1,1.0,1,1.0,1,0.16468661436988208,32
692,1,2151,526,1625,0,0,0,1.0,1,1.0,1,1.0,1,0.21965212486645141,32
693,1,2152,527,1625,0,0,0,1.0,1,1.0,1,1.0,1,0.20247444912454227,34
694,4,2156,528,1628,0,0,0,1.0,1,1.0,1,1.0,1,0.15036262398020528,36
695,3,2159,530,1629,0,0,0,1.0,1,1.0,1,1.0,1,0.19323623385316124,34
696,2,2161,531,1630,0,0,0,1.0,1,1.0,1,1.0,1,0.12937006155423944,33
697,0,2161,531,1630,0,0,0,1.0,1,1.0,1,1.0,1,0.1302127553179433,33
698,1,2162,531,1631,0,0,0,1.0,1,1.0,1,1.0,1,0.11431061817805238,34
699,1,2163,532,1631,0,0,0,1.0,1,1.0,1,1.0,1,0.10389807656990376,33
700,1,2164,533,1631,0,0,0,1.0,1,1.0,1,1.0,1,0.1267831696535733,32
701,1,2165,533,1632,0,0,0,1.0,1,1.0,1,1.0,1,0.13296790652988613,33
702,1,2166,534,1632,0,0,0,1.0,1,1.0,1,1.0,1,0.21370991155411495,34
703,7,2173,536,1637,0,0,0,1.0,1,1.0,1,1.0,1,0.1465445935426798,32
704,0,2173,536,1637,0,0,0,1.0,1,1.0,1,1.0,1,0.16499693812549998,31
705,2,2175,538,1637,0,0,0,1.0,1,1.0,1,1.0,1,0.13812216231320074,33
706,3,2178,539,1639,0,0,0,1.0,1,1.0,1,1.0,1,0.09698365250175477,33
707,1,2179,540,1639,0,0,0,1.0,1,1.0,1,1.0,1,0.16948175693701664,31
708,2,2181,542,1639,0,0,0,1.0,1,1.0,1,1.0,1,0.20142206721333153,31
709,2,2183,543,1640,0,0,0,1.0,1,1.0,1,1.0,1,0.23797273962135207,30
710,1,2184,543,1641,0,0,0,1.0,1,1.0,1,1.0,1,0.23918724531208405,30
711,0,2184,543,1641,0,0,0,1.0,1,1.0,1,1.0,1,0.22470249923813246,30
712,1,2185,543,1642,0,0,0,1.0,1,1.0,1,1.0,1,0.2102601218148853,30
713,0,2185,543,1642,0,0,0,1.0,1,1.0,1,1.0,1,0.23345386085080783,31
714,0,2185,543,1642,0,0,0,1.0,1,1.0,1,1.0,1,0.24880643820017456,31
715,0,2185,543,1642,0,0,0,1.0,1,1.0,1,1.0,1,0.2465552129102052,30
716,0,2185,543,1642,0,0,0,1.0,1,1.0,1,1.0,1,0.2190257900823939,31
717,1,2186,543,1643,0,0,0,1.0,1,1.0,1,1.0,1,0.22421512353999432,32
718,0,2186,543,1643,0,0,0,1.0,1,1.0,1,1.0,1,0.22421512353999432,32
719,0,2186,543,1643,0,0,0,1.0,1,1.0,1,1.0,1,0.22421512353999432,32
720,0,2186,543,1643,0,0,0,1.0,1,1.0,1,1.0,1,0.20599430165455854,34
721,2,2188,544,1644,0,0,0,1.0,1,1.0,1,1.0,1,0.22912309680231727,34
722,3,2191,545,1646,0,0,0,1.0,1,1.0,1,1.0,1,0.25066609852481714,34
723,1,2192,545,1647,0,0,0,1.0,1,1.0,1,1.0,1,0.2498597595731135,35
724,1,2193,546,1647,0,0,0,1.0,1,1.0,1,1.0,1,0.2781460970591103,36
725,2,2195,546,1649,0,0,0,1.0,1,1.0,1,1.0,1,0.2472252618915062,37
726,1,2196,546,1650,0,0,0,1.0,1,1.0,1,1.0,1,0.2342851548942483,37
727,0,2196,546,1650,0,0,0,1.0,1,1.0,1,1.0,1,0.2454090882646915,38
728,0,2196,546,1650,0,0,0,1.0,1,1.0,1,1.0,1,0.23635664705825254,39
729,0,2196,546,1650,0,0,0,1.0,1,1.0,1,1.0,1,0.23635664705825254,39
730,1,2197,547,1650,0,0,0,1.0,1,1.0,1,1.0,1,0.23816850713979712,40
731,2,2199,548,1651,0,0,0,1.0,1,1.0,1,1.0,1,0.1893995901328285,40
732,1,2200,548,1652,0,0,0,1.0,1,1.0,1,1.0,1,0.207702470611407,41
733,1,2201,548,1653,0,0,0,1.0,1,1.0,1,1.0,1,0.13969904635397254,41
734,1,2202,549,1653,0,0,0,1.0,1,1.0,1,1.0,1,0.15529083451171002,42
735,2,2204,550,1654,0,0,0,1.0,1,1.0,1,1.0,1,0.13091479955206814,42
736,1,2205,550,1655,0,0,0,1.0,1,1.0,1,1.0,1,0.14674691468062287,41
737,5,2210,553,1657,0,0,0,1.0,1,1.0,1,1.0,1,0.20570477131357143,41
738,1,2211,553,1658,0,0,0,1.0,1,1.0,1,1.0,1,0.16498058708385258,39
739,0,2211,553,1658,0,0,0,1.0,1,1.0,1,1.0,1,0.16498058708385258,39
740,3,2214,555,1659,0,0,0,1.0,1,1.0,1,1.0,1,0.18920207487623472,39
741,1,2215,555,1660,0,0,0,1.0,1,1.0,1,1.0,1,0.19366158402125025,38
742,2,2217,557,1660,0,0,0,1.0,1,1.0,1,1.0,1,0.1705198334674536,39
743,6,2223,561,1662,0,0,0,1.0,1,1.0,1,1.0,1,0.1952717894686026,39
744,2,2225,562,1663,0,0,0,1.0,1,1.0,1,1.0,1,0.17699199905599183,39
745,2,2227,564,1663,0,0,0,1.0,1,1.0,1,1.0,1,0.20480469192039316,39
746,7,2234,567,1667,0,0,0,1.0,1,1.0,1,1.0,1,0.2372233083425024,40
747,3,2237,568,1669,0,0,0,1.0,1,1.0,1,1.0,1,0.21910269629812734,41
748,6,2243,570,1673,0,0,0,1.0,1,1.0,1,1.0,1,0.2034400348258256,41
749,5,2248,571,1677,0,0,0,1.0,1,1.0,1,1.0,1,0.1960028192407088,41
750,6,2254,573,1681,0,0,0,1.0,1,1.0,1,1.0,1,0.23233208889440035,39
751,8,2262,573,1689,0,0,0,1.0,1,1.0,1,1.0,1,0.13441783924021475,41
752,5,2267,574,1693,0,0,0,1.0,1,1.0,1,1.0,1,0.17736068861876458,41
753,3,2270,574,1696,0,0,0,1.0,1,1.0,1,1.0,1,0.16518351847846124,41
754,3,2273,575,1698,0,0,0,1.0,1,1.0,1,1.0,1,0.187696690236378,41
755,3,2276,576,1700,0,0,0,1.0,1,1.0,1,1.0,1,0.2127079705825799,41
756,4,2280,576,1704,0,0,0,1.0,1,1.0,1,1.0,1,0.21387301272184714,41
757,4,2284,576,1708,0,0,0,1.0,1,1.0,1,1.0,1,0.2299572505346974,39
758,4,2288,576,1712,0,0,0,1.0,1,1.0,1,1.0,1,0.23003450412451548,39
759,1,2289,576,1713,0,0,0,1.0,1,1.0,1,1.0,1,0.1970946812884101,39
760,2,2291,576,1715,0,0,0,1.0,1,1.0,1,1.0,1,0.21338797527323589,40
761,2,2293,576,1717,0,0,0,1.0,1,1.0,1,1.0,1,0.22495016314844932,41
762,4,2297,576,1721,0,0,0,1.0,1,1.0,1,1.0,1,0.1989307356970718,42
763,5,2302,576,1726,0,0,0,1.0,1,1.0,1,1.0,1,0.21623274104298262,43
764,5,2307,576,1731,0,0,0,1.0,1,1.0,1,1.0,1,0.21600205278683351,43
765,5,2312,576,1736,0,0,0,1.0,1,1.0,1,1.0,1,0.16986293313097123,45
766,3,2315,576,1739,0,0,0,1.0,1,1.0,1,1.0,1,0.11962727471974988,45
767,0,2315,576,1739,0,0,0,1.0,1,1.0,1,1.0,1,0.11854464522614296,46
768,0,2315,576,1739,0,0,0,1.0,1,1.0,1,1.0,1,0.12393533138293648,45
769,2,2317,576,1741,0,0,0,1.0,1,1.0,1,1.0,1,0.11001827160098601,46
770,5,2322,577,1745,0,0,0,1.0,1,1.0,1,1.0,1,0.09669681957705213,47
771,4,2326,578,1748,0,0,0,1.0,1,1.0,1,1.0,1,0.13698993555108158,47
772,3,2329,579,1750,0,0,0,1.0,1,1.0,1,1.0,1,0.13693147537354816,46
773,2,2331,580,1751,0,0,0,1.0,1,1.0,1,1.0,1,0.13749168021975652,45
774,2,2333,580,1753,0,0,0,1.0,1,1.0,1,1.0,1,0.12094189020150327,45
775,4,2337,583,1754,0,0,0,1.0,1,1.0,1,1.0,1,0.15603771218321683,45
776,1,2338,583,1755,0,0,0,1.0,1,1.0,1,1.0,1,0.14954909778197437,43
777,2,2340,583,1757,0,0,0,1.0,1,1.0,1,1.0,1,0.16443856780261296,44
778,6,2346,584,1762,0,0,0,1.0,1,1.0,1,1.0,1,0.16309290454211767,45
779,4,2350,584,1766,0,0,0,1.0,1,1.0,1,1.0,1,0.16309290454211767,45
780,6,2356,586,1770,0,0,0,1.0,1,1.0,1,1.0,1,0.18698646270693697,45
781,4,2360,586,1774,0,0,0,1.0,1,1.0,1,1.0,1,0.1438275557357906,46
782,2,2362,587,1775,0,0,0,1.0,1,1.0,1,1.0,1,0.21515305045974886,47
783,3,2365,588,1777,0,0,0,1.0,1,1.0,1,1.0,1,0.14730414247790466,46
784,1,2366,588,1778,0,0,0,1.0,1,1.0,1,1.0,1,0.13777590505586504,45
785,0,2366,588,1778,0,0,0,1.0,1,1.0,1,1.0,1,0.14751593582341865,43
786,1,2367,588,1779,0,0,0,1.0,1,1.0,1,1.0,1,0.13860439484156867,43
787,2,2369,589,1780,0,0,0,1.0,1,1.0,1,1.0,1,0.16610978063507756,43
788,4,2373,590,1783,0,0,0,1.0,1,1.0,1,1.0,1,0.14754559377593904,44
789,2,2375,590,1785,0,0,0,1.0,1,1.0,1,1.0,1,0.12338150387192644,46
790,2,2377,592,1785,0,0,0,1.0,1,1.0,1,1.0,1,0.14658593963064834,46
791,0,2377,592,1785,0,0,0,1.0,1,1.0,1,1.0,1,0.17264484525382587,46
792,0,2377,592,1785,0,0,0,1.0,1,1.0,1,1.0,1,0.17793278079150054,47
793,3,2380,592,1788,0,0,0,1.0,1,1.0,1,1.0,1,0.15945802019714428,48
794,2,2382,592,1790,0,0,0,1.0,1,1.0,1,1.0,1,0.16447747220399103,48
795,3,2385,593,1792,0,0,0,1.0,1,1.0,1,1.0,1,0.16065249372736065,47
796,4,2389,594,1795,0,0,0,1.0,1,1.0,1,1.0,1,0.1322530373157642,45
797,4,2393,594,1799,0,0,0,1.0,1,1.0,1,1.0,1,0.14309808272290792,47
798,1,2394,594,1800,0,0,0,1.0,1,1.0,1,1.0,1,0.16261756415471812,48
799,4,2398,595,1803,0,0,0,1.0,1,1.0,1,1.0,1,0.16844901680669483,48
800,5,2403,597,1806,0,0,0,1.0,1,1.0,1,1.0,1,0.19496138829738174,48
801,3,2406,598,1808,0,0,0,1.0,1,1.0,1,1.0,1,0.17140025716969756,49
802,7,2413,600,1813,0,0,0,1.0,1,1.0,1,1.0,1,0.20501733550591003,50
803,2,2415,600,1815,0,0,0,1.0,1,1.0,1,1.0,1,0.20669059813069407,50
804,1,2416,600,1816,0,0,0,1.0,1,1.0,1,1.0,1,0.2041254421744671,50
805,2,2418,601,1817,0,0,0,1.0,1,1.0,1,1.0,1,0.22465669183287976,50
806,2,2420,601,1819,0,0,0,1.0,1,1.0,1,1.0,1,0.2041950563929595,51
807,4,2424,603,1821,0,0,0,1.0,1,1.0,1,1.0,1,0.210644910246628,51
808,1,2425,603,1822,0,0,0,1.0,1,1.0,1,1.0,1,0.20574909744375833,53
809,1,2426,603,1823,0,0,0,1.0,1,1.0,1,1.0,1,0.15226373016525693,51
810,0,2426,603,1823,0,0,0,1.0,1,1.0,1,1.0,1,0.16512482856539237,52
811,4,2430,603,1827,0,0,0,1.0,1,1.0,1,1.0,1,0.10589154910492764,50
812,1,2431,603,1828,0,0,0,1.0,1,1.0,1,1.0,1,0.08973242961891052,51
813,3,2434,604,1830,0,0,0,1.0,1,1.0,1,1.0,1,0.10887382382368337,51
814,3,2437,606,1831,0,0,0,1.0,1,1.0,1,1.0,1,0.1668078735859507,52
815,1,2438,607,1831,0,0,0,1.0,1,1.0,1,1.0,1,0.22207105084502746,50
816,0,2438,607,1831,0,0,0,1.0,1,1.0,1,1.0,1,0.22207105084502746,50
817,0,2438,607,1831,0,0,0,1.0,1,1.0,1,1.0,1,0.2382176427555267,49
818,4,2442,608,1834,0,0,0,1.0,1,1.0,1,1.0,1,0.2408764360225139,49
819,2,2444,608,1836,0,0,0,1.0,1,1.0,1,1.0,1,0.23803874613636716,50
820,1,2445,609,1836,0,0,0,1.0,1,1.0,1,1.0,1,0.25377853768454234,49
821,0,2445,609,1836,0,0,0,1.0,1,1.0,1,1.0,1,0.25243188818754825,49
822,3,2448,610,1838,0,0,0,1.0,1,1.0,1,1.0,1,0.2390457737933664,49
823,3,2451,612,1839,0,0,0,1.0,1,1.0,1,1.0,1,0.27044905693996013,47
824,7,2458,616,1842,0,0,0,1.0,1,1.0,1,1.0,1,0.2482028889807563,45
825,0,2458,616,1842,0,0,0,1.0,1,1.0,1,1.0,1,0.24099375066473322,43
826,7,2465,618,1847,0,0,0,1.0,1,1.0,1,1.0,1,0.1988818848251076,44
827,4,2469,618,1851,0,0,0,1.0,1,1.0,1,1.0,1,0.1225475284418866,43
828,5,2474,620,1854,0,0,0,1.0,1,1.0,1,1.0,1,0.14164451924615032,43
829,3,2477,622,1855,0,0,0,1.0,1,1.0,1,1.0,1,0.10750021316927429,45
830,4,2481,623,1858,0,0,0,1.0,1,1.0,1,1.0,1,0.1170435660029356,46
831,2,2483,624,1859,0,0,0,1.0,1,1.0,1,1.0,1,0.10846056756628789,48
832,2,2485,625,1860,0,0,0,1.0,1,1.0,1,1.0,1,0.08812058872501714,47
833,3,2488,626,1862,0,0,0,1.0,1,1.0,1,1.0,1,0.10224176758145971,47
834,4,2492,626,1866,0,0,0,1.0,1,1.0,1,1.0,1,0.13576493787096497,46
835,2,2494,626,1868,0,0,0,1.0,1,1.0,1,1.0,1,0.12259222796183629,45
836,3,2497,627,1870,0,0,0,1.0,1,1.0,1,1.0,1,0.13086926697670218,46
837,3,2500,627,1873,0,0,0,1.0,1,1.0,1,1.0,1,0.1171244922373708,46
838,4,2504,628,1876,0,0,0,1.0,1,1.0,1,1.0,1,0.13802267321366044,45
839,4,2508,630,1878,0,0,0,1.0,1,1.0,1,1.0,1,0.18232188748205702,46
840,5,2513,630,1883,0,0,0,1.0,1,1.0,1,1.0,1,0.16814304641194522,46
841,4,2517,630,1887,0,0,0,1.0,1,1.0,1,1.0,1,0.10577538558630738,46
842,4,2521,631,1890,0,0,0,1.0,1,1.0,1,1.0,1,0.07719966050369784,46
843,1,2522,631,1891,0,0,0,1.0,1,1.0,1,1.0,1,0.055619751033113396,46
844,3,2525,633,1892,0,0,0,1.0,1,1.0,1,1.0,1,0.11221521990052703,47
845,6,2531,634,1897,0,0,0,1.0,1,1.0,1,1.0,1,0.12668183065430286,48
846,4,2535,635,1900,0,0,0,1.0,1,1.0,1,1.0,1,0.15370535809221772,47
847,5,2540,635,1905,0,0,0,1.0,1,1.0,1,1.0,1,0.10288274418475855,48
848,3,2543,635,1908,0,0,0,1.0,1,1.0,1,1.0,1,0.15126983404218125,48
849,6,2549,635,1914,0,0,0,1.0,1,1.0,1,1.0,1,0.18658324149751546,48
850,6,2555,635,1920,0,0,0,1.0,1,1.0,1,1.0,1,0.19011818981548806,46
851,3,2558,635,1923,0,0,0,1.0,1,1.0,1,1.0,1,0.2009738071725855,45
852,5,2563,636,1927,0,0,0,1.0,1,1.0,1,1.0,1,0.18402355152514083,44
853,5,2568,637,1931,0,0,0,1.0,1,1.0,1,1.0,1,0.17195181721894356,44
854,4,2572,639,1933,0,0,0,1.0,1,1.0,1,1.0,1,0.20517112795500805,45
855,4,2576,639,1937,0,0,0,1.0,1,1.0,1,1.0,1,0.20188090791376706,46
856,8,2584,641,1943,0,0,0,1.0,1,1.0,1,1.0,1,0.15078759447071194,46
857,3,2587,641,1946,0,0,0,1.0,1,1.0,1,1.0,1,0.12606708292560725,47
858,1,2588,641,1947,0,0,0,1.0,1,1.0,1,1.0,1,0.1280706529067078,48
859,2,2590,641,1949,0,0,0,1.0,1,1.0,1,1.0,1,0.1280706529067078,48
860,1,2591,641,1950,0,0,0,1.0,1,1.0,1,1.0,1,0.1397872670519239,49
861,2,2593,642,1951,0,0,0,1.0,1,1.0,1,1.0,1,0.1475747245116709,49
862,4,2597,644,1953,0,0,0,1.0,1,1.0,1,1.0,1,0.14565094760275224,49
863,5,2602,646,1956,0,0,0,1.0,1,1.0,1,1.0,1,0.20367518569431053,48
864,7,2609,648,1961,0,0,0,1.0,1,1.0,1,1.0,1,0.18120611067107914,49
865,5,2614,649,1965,0,0,0,1.0,1,1.0,1,1.0,1,0.21568515478465305,48
866,4,2618,650,1968,0,0,0,1.0,1,1.0,1,1.0,1,0.17922359703672758,50
867,3,2621,651,1970,0,0,0,1.0,1,1.0,1,1.0,1,0.17386547317781248,50
868,4,2625,652,1973,0,0,0,1.0,1,1.0,1,1.0,1,0.17728182249615526,51
869,5,2630,652,1978,0,0,0,1.0,1,1.0,1,1.0,1,0.18184573781433427,49
870,5,2635,654,1981,0,0,0,1.0,1,1.0,1,1.0,1,0.2109796574579241,49
871,11,2646,654,1992,0,0,0,1.0,1,1.0,1,1.0,1,0.08973234724178816,49
872,5,2651,655,1996,0,0,0,1.0,1,1.0,1,1.0,1,0.07475606952331795,48
873,5,2656,656,2000,0,0,0,1.0,1,1.0,1,1.0,1,0.17152300335649423,49
874,5,2661,656,2005,0,0,0,1.0,1,1.0,1,1.0,1,0.13681162316726345,49
875,10,2671,658,2013,0,0,0,1.0,1,1.0,1,1.0,1,0.13359219104127212,50
876,6,2677,659,2018,0,0,0,1.0,1,1.0,1,1.0,1,0.18871303826481695,50
877,9,2686,662,2024,0,0,0,1.0,1,1.0,1,1.0,1,0.18747905210220778,50
878,5,2691,663,2028,0,0,0,1.0,1,1.0,1,1.0,1,0.17361590045904982,49
879,7,2698,664,2034,0,0,0,1.0,1,1.0,1,1.0,1,0.19044698328253648,49
880,5,2703,664,2039,0,0,0,1.0,1,1.0,1,1.0,1,0.18798575480042354,48
881,6,2709,664,2045,0,0,0,1.0,1,1.0,1,1.0,1,0.199144639802806,49
882,2,2711,664,2047,0,0,0,1.0,1,1.0,1,1.0,1,0.2000707188113485,48
883,7,2718,664,2054,0,0,0,1.0,1,1.0,1,1.0,1,0.21917820959687306,50
884,8,2726,664,2062,0,0,0,1.0,1,1.0,1,1.0,1,0.24998749322244757,50
885,13,2739,665,2074,0,0,0,1.0,1,1.0,1,1.0,1,0.26553517077909755,49
886,11,2750,666,2084,0,0,0,1.0,1,1.0,1,1.0,1,0.12583293930396539,49
887,1,2751,666,2085,0,0,0,1.0,1,1.0,1,1.0,1,0.12929608166281953,49
888,0,2751,666,2085,0,0,0,1.0,1,1.0,1,1.0,1,0.1475861855010142,47
889,1,2752,667,2085,0,0,0,1.0,1,1.0,1,1.0,1,0.1747636368899908,46
890,0,2752,667,2085,0,0,0,1.0,1,1.0,1,1.0,1,0.14799121441148222,44
891,1,2753,668,2085,0,0,0,1.0,1,1.0,1,1.0,1,0.19202210075379,45
892,8,2761,669,2092,0,0,0,1.0,1,1.0,1,1.0,1,0.19694611269574447,45
893,0,2761,669,2092,0,0,0,1.0,1,1.0,1,1.0,1,0.19694611269574447,45
894,0,2761,669,2092,0,0,0,1.0,1,1.0,1,1.0,1,0.21510149287123018,44
895,2,2763,669,2094,0,0,0,1.0,1,1.0,1,1.0,1,0.22306586620662686,45
896,1,2764,670,2094,0,0,0,1.0,1,1.0,1,1.0,1,0.24319839068261606,44
897,1,2765,670,2095,0,0,0,1.0,1,1.0,1,1.0,1,0.19980183836196827,44
898,0,2765,670,2095,0,0,0,1.0,1,1.0,1,1.0,1,0.20278515739422204,45
899,0,2765,670,2095,0,0,0,1.0,1,1.0,1,1.0,1,0.19887905356086705,44
900,3,2768,670,2098,0,0,0,1.0,1,1.0,1,1.0,1,0.19541983919316783,46
901,2,2770,670,2100,0,0,0,1.0,1,1.0,1,1.0,1,0.16335535062009984,45
902,4,2774,673,2101,0,0,0,1.0,1,1.0,1,1.0,1,0.17855482914742493,45
903,1,2775,673,2102,0,0,0,1.0,1,1.0,1,1.0,1,0.1783535494942499,44
904,2,2777,673,2104,0,0,0,1.0,1,1.0,1,1.0,1,0.16419668474057378,45
905,1,2778,673,2105,0,0,0,1.0,1,1.0,1,1.0,1,0.1824403249717589,45
906,1,2779,674,2105,0,0,0,1.0,1,1.0,1,1.0,1,0.2096352736316985,45
907,4,2783,675,2108,0,0,0,1.0,1,1.0,1,1.0,1,0.17474004358169543,46
908,0,2783,675,2108,0,0,0,1.0,1,1.0,1,1.0,1,0.16672511875000637,46
909,5,2788,679,2109,0,0,0,1.0,1,1.0,1,1.0,1,0.1553732703321796,46
910,2,2790,679,2111,0,0,0,1.0,1,1.0,1,1.0,1,0.17936585635360655,44
911,3,2793,680,2113,0,0,0,1.0,1,1.0,1,1.0,1,0.18408527315317524,45
912,1,2794,680,2114,0,0,0,1.0,1,1.0,1,1.0,1,0.18798641884670633,44
913,2,2796,680,2116,0,0,0,1.0,1,1.0,1,1.0,1,0.2058920007040535,45
914,3,2799,680,2119,0,0,0,1.0,1,1.0,1,1.0,1,0.21593665870321127,45
915,5,2804,681,2123,0,0,0,1.0,1,1.0,1,1.0,1,0.20856405789928684,45
916,6,2810,681,2129,0,0,0,1.0,1,1.0,1,1.0,1,0.10009910369317934,45
917,4,2814,681,2133,0,0,0,1.0,1,1.0,1,1.0,1,0.09360692085533491,46
918,3,2817,681,2136,0,0,0,1.0,1,1.0,1,1.0,1,0.08330894484386231,47
919,2,2819,681,2138,0,0,0,1.0,1,1.0,1,1.0,1,0.08330894484386231,47
920,1,2820,681,2139,0,0,0,1.0,1,1.0,1,1.0,1,0.0880826568790771,47
921,5,2825,683,2142,0,0,0,1.0,1,1.0,1,1.0,1,0.17580860330417597,49
922,5,2830,683,2147,0,0,0,1.0,1,1.0,1,1.0,1,0.12941884456598748,49
923,5,2835,684,2151,0,0,0,1.0,1,1.0,1,1.0,1,0.1321058359282841,47
924,3,2838,684,2154,0,0,0,1.0,1,1.0,1,1.0,1,0.10639279970158545,47
925,6,2844,686,2158,0,0,0,1.0,1,1.0,1,1.0,1,0.1711191543754195,47
926,12,2856,689,2167,0,0,0,1.0,1,1.0,1,1.0,1,0.22097668470813583,46
927,9,2865,690,2175,0,0,0,1.0,1,1.0,1,1.0,1,0.21522768329786812,45
928,5,2870,691,2179,0,0,0,1.0,1,1.0,1,1.0,1,0.227922158204316,43
929,4,2874,691,2183,0,0,0,1.0,1,1.0,1,1.0,1,0.22128529366919225,42
930,9,2883,692,2191,0,0,0,1.0,1,1.0,1,1.0,1,0.2328521009876981,41
931,4,2887,693,2194,0,0,0,1.0,1,1.0,1,1.0,1,0.2066530770781879,40
932,1,2888,693,2195,0,0,0,1.0,1,1.0,1,1.0,1,0.19450742116345413,40
933,2,2890,695,2195,0,0,0,1.0,1,1.0,1,1.0,1,0.25365905053443216,39
934,6,2896,696,2200,0,0,0,1.0,1,1.0,1,1.0,1,0.2229339708873854,39
935,5,2901,698,2203,0,0,0,1.0,1,1.0,1,1.0,1,0.2177916160942585,41
936,4,2905,698,2207,0,0,0,1.0,1,1.0,1,1.0,1,0.19040002425707303,42
937,5,2910,698,2212,0,0,0,1.0,1,1.0,1,1.0,1,0.17717687203312166,43
938,7,2917,698,2219,0,0,0,1.0,1,1.0,1,1.0,1,0.2024971428730761,44
939,9,2926,698,2228,0,0,0,1.0,1,1.0,1,1.0,1,0.2770584199393831,46
940,8,2934,698,2236,0,0,0,1.0,1,1.0,1,1.0,1,0.2728704168147849,46
941,7,2941,698,2243,0,0,0,1.0,1,1.0,1,1.0,1,0.2071612448961056,46
942,6,2947,699,2248,0,0,0,1.0,1,1.0,1,1.0,1,0.2690091350803846,46
943,6,2953,700,2253,0,0,0,1.0,1,1.0,1,1.0,1,0.24516595073706712,45
944,6,2959,702,2257,0,0,0,1.0,1,1.0,1,1.0,1,0.2628088729369436,45
945,7,2966,703,2263,0,0,0,1.0,1,1.0,1,1.0,1,0.18172079228824933,44
946,8,2974,705,2269,0,0,0,1.0,1,1.0,1,1.0,1,0.1049370214139988,46
947,0,2974,705,2269,0,0,0,1.0,1,1.0,1,1.0,1,0.13425812182202454,44
948,0,2974,705,2269,0,0,0,1.0,1,1.0,1,1.0,1,0.13425812182202454,44
949,6,2980,707,2273,0,0,0,1.0,1,1.0,1,1.0,1,0.2029808771939206,44
950,1,2981,708,2273,0,0,0,1.0,1,1.0,1,1.0,1,0.2647384732852059,43
951,4,2985,708,2277,0,0,0,1.0,1,1.0,1,1.0,1,0.2587591033042819,42
952,2,2987,709,2278,0,0,0,1.0,1,1.0,1,1.0,1,0.2624863969151526,42
953,0,2987,709,2278,0,0,0,1.0,1,1.0,1,1.0,1,0.2503466963070425,41
954,1,2988,710,2278,0,0,0,1.0,1,1.0,1,1.0,1,0.24303931754373434,40
955,1,2989,710,2279,0,0,0,1.0,1,1.0,1,1.0,1,0.19646843665691047,42
956,3,2992,712,2280,0,0,0,1.0,1,1.0,1,1.0,1,0.1776537534204943,43
957,1,2993,712,2281,0,0,0,1.0,1,1.0,1,1.0,1,0.18258129153333064,42
958,2,2995,712,2283,0,0,0,1.0,1,1.0,1,1.0,1,0.20630992898469513,43
959,1,2996,712,2284,0,0,0,1.0,1,1.0,1,1.0,1,0.17860066844547826,45
960,3,2999,713,2286,0,0,0,1.0,1,1.0,1,1.0,1,0.197346737991468,47
961,2,3001,713,2288,0,0,0,1.0,1,1.0,1,1.0,1,0.14542807893630405,45
962,1,3002,713,2289,0,0,0,1.0,1,1.0,1,1.0,1,0.13875358902400298,45
963,2,3004,714,2290,0,0,0,1.0,1,1.0,1,1.0,1,0.17334328625717213,44
964,0,3004,714,2290,0,0,0,1.0,1,1.0,1,1.0,1,0.16118626053435103,44
965,1,3005,714,2291,0,0,0,1.0,1,1.0,1,1.0,1,0.16444610475765867,45
966,2,3007,715,2292,0,0,0,1.0,1,1.0,1,1.0,1,0.16805349407180437,43
967,1,3008,716,2292,0,0,0,1.0,1,1.0,1,1.0,1,0.16258785907680326,43
968,1,3009,717,2292,0,0,0,1.0,1,1.0,1,1.0,1,0.18744837951807006,43
969,3,3012,718,2294,0,0,0,1.0,1,1.0,1,1.0,1,0.2035362402089509,42
970,2,3014,718,2296,0,0,0,1.0,1,1.0,1,1.0,1,0.19490216971439075,42
971,2,3016,718,2298,0,0,0,1.0,1,1.0,1,1.0,1,0.19490216971439075,42
972,3,3019,719,2300,0,0,0,1.0,1,1.0,1,1.0,1,0.1585973661433225,42
973,1,3020,719,2301,0,0,0,1.0,1,1.0,1,1.0,1,0.15151893656747717,43
974,5,3025,720,2305,0,0,0,1.0,1,1.0,1,1.0,1,0.1457934234196775,43
975,4,3029,720,2309,0,0,0,1.0,1,1.0,1,1.0,1,0.14581080226280113,43
976,4,3033,721,2312,0,0,0,1.0,1,1.0,1,1.0,1,0.11934239403618037,45
977,0,3033,721,2312,0,0,0,1.0,1,1.0,1,1.0,1,0.13704210288068228,44
978,1,3034,721,2313,0,0,0,1.0,1,1.0,1,1.0,1,0.1017206776179451,44
979,0,3034,721,2313,0,0,0,1.0,1,1.0,1,1.0,1,0.11729241684481072,45
980,1,3035,722,2313,0,0,0,1.0,1,1.0,1,1.0,1,0.14501045809385207,45
981,0,3035,722,2313,0,0,0,1.0,1,1.0,1,1.0,1,0.14501045809385207,45
982,3,3038,724,2314,0,0,0,1.0,1,1.0,1,1.0,1,0.20839069744892105,46
983,3,3041,725,2316,0,0,0,1.0,1,1.0,1,1.0,1,0.19209130664100196,45
984,1,3042,726,2316,0,0,0,1.0,1,1.0,1,1.0,1,0.1883486638559466,45
985,6,3048,730,2318,0,0,0,1.0,1,1.0,1,1.0,1,0.2276125027060943,45
986,1,3049,731,2318,0,0,0,1.0,1,1.0,1,1.0,1,0.23597609460826816,44
987,4,3053,732,2321,0,0,0,1.0,1,1.0,1,1.0,1,0.24267925066756066,45
988,4,3057,734,2323,0,0,0,1.0,1,1.0,1,1.0,1,0.2481369815709043,44
989,2,3059,735,2324,0,0,0,1.0,1,1.0,1,1.0,1,0.23844240099496275,43
990,3,3062,737,2325,0,0,0,1.0,1,1.0,1,1.0,1,0.2458166708564157,42
991,3,3065,737,2328,0,0,0,1.0,1,1.0,1,1.0,1,0.16629021017786433,42
992,1,3066,737,2329,0,0,0,1.0,1,1.0,1,1.0,1,0.14294716090217044,43
993,2,3068,739,2329,0,0,0,1.0,1,1.0,1,1.0,1,0.1980107018800753,43
994,2,3070,739,2331,0,0,0,1.0,1,1.0,1,1.0,1,0.15483238114757342,43
995,0,3070,739,2331,0,0,0,1.0,1,1.0,1,1.0,1,0.15462053840122036,43
996,1,3071,739,2332,0,0,0,1.0,1,1.0,1,1.0,1,0.14525899082486463,44
997,1,3072,740,2332,0,0,0,1.0,1,1.0,1,1.0,1,0.17700814191635508,44
998,2,3074,740,2334,0,0,0,1.0,1,1.0,1,1.0,1,0.16916981631285274,45
999,0,3074,740,2334,0,0,0,1.0,1,1.0,1,1.0,1,0.1647386150368416,42
1000,0,3074,740,2334,0,0,0,1.0,1,1.0,1,1.0,1,0.17927095302509427,43
1001,0,3074,740,2334,0,0,0,1.0,1,1.0,1,1.0,1,0.18307537062083085,42
1002,1,3075,740,2335,0,0,0,1.0,1,1.0,1,1.0,1,0.16228091284626806,43
1003,0,3075,740,2335,0,0,0,1.0,1,1.0,1,1.0,1,0.16228091284626806,43
1004,1,3076,740,2336,0,0,0,1.0,1,1.0,1,1.0,1,0.1678539378629869,43
1005,0,3076,740,2336,0,0,0,1.0,1,1.0,1,1.0,1,0.16384045024233868,44
1006,1,3077,740,2337,0,0,0,1.0,1,1.0,1,1.0,1,0.15005156098251035,46
1007,3,3080,740,2340,0,0,0,1.0,1,1.0,1,1.0,1,0.10794121268436313,46
1008,1,3081,740,2341,0,0,0,1.0,1,1.0,1,1.0,1,0.11374252754813333,47
1009,3,3084,740,2344,0,0,0,1.0,1,1.0,1,1.0,1,0.1247513749637439,48
1010,0,3084,740,2344,0,0,0,1.0,1,1.0,1,1.0,1,0.1247513749637439,48
1011,1,3085,740,2345,0,0,0,1.0,1,1.0,1,1.0,1,0.11313347222724048,48
1012,6,3091,742,2349,0,0,0,1.0,1,1.0,1,1.0,1,0.15162205530082623,49
1013,4,3095,744,2351,0,0,0,1.0,1,1.0,1,1.0,1,0.18396236827334655,50
1014,4,3099,744,2355,0,0,0,1.0,1,1.0,1,1.0,1,0.18063144757860358,50
1015,5,3104,744,2360,0,0,0,1.0,1,1.0,1,1.0,1,0.16279507894499173,51
1016,7,3111,744,2367,0,0,0,1.0,1,1.0,1,1.0,1,0.16571317019237128,51
1017,8,3119,744,2375,0,0,0,1.0,1,1.0,1,1.0,1,0.17133850394957478,52
1018,5,3124,746,2378,0,0,0,1.0,1,1.0,1,1.0,1,0.1843545193897755,52
1019,8,3132,748,2384,0,0,0,1.0,1,1.0,1,1.0,1,0.19256421432540233,52
1020,7,3139,748,2391,0,0,0,1.0,1,1.0,1,1.0,1,0.13255048027964525,53
1021,6,3145,748,2397,0,0,0,1.0,1,1.0,1,1.0,1,0.08737590668089068,53
1022,1,3146,748,2398,0,0,0,1.0,1,1.0,1,1.0,1,0.09738673084039481,54
1023,3,3149,749,2400,0,0,0,1.0,1,1.0,1,1.0,1,0.08318406693649666,55
1024,4,3153,751,2402,0,0,0,1.0,1,1.0,1,1.0,1,0.1158263566760687,55
1025,1,3154,751,2403,0,0,0,1.0,1,1.0,1,1.0,1,0.11064278566979127,56
1026,3,3157,752,2405,0,0,0,1.0,1,1.0,1,1.0,1,0.1455366837078945,57
1027,1,3158,752,2406,0,0,0,1.0,1,1.0,1,1.0,1,0.1504101302006671,58
1028,4,3162,752,2410,0,0,0,1.0,1,1.0,1,1.0,1,0.13954455766588117,58
1029,5,3167,752,2415,0,0,0,1.0,1,1.0,1,1.0,1,0.12449182847549367,59
1030,5,3172,752,2420,0,0,0,1.0,1,1.0,1,1.0,1,0.16278271837795577,60
1031,4,3176,752,2424,0,0,0,1.0,1,1.0,1,1.0,1,0.16278271837795577,60
1032,1,3177,752,2425,0,0,0,1.0,1,1.0,1,1.0,1,0.15079524574599942,61
1033,4,3181,754,2427,0,0,0,1.0,1,1.0,1,1.0,1,0.14322048543399782,60
1034,3,3184,755,2429,0,0,0,1.0,1,1.0,1,1.0,1,0.15829340790082935,60
1035,2,3186,756,2430,0,0,0,1.0,1,1.0,1,1.0,1,0.14448047192541777,59
1036,5,3191,759,2432,0,0,0,1.0,1,1.0,1,1.0,1,0.12462849920471535,60
1037,4,3195,762,2433,0,0,0,1.0,1,1.0,1,1.0,1,0.12581602499764222,59
1038,7,3202,765,2437,0,0,0,1.0,1,1.0,1,1.0,1,0.12935408921097954,60
1039,5,3207,767,2440,0,0,0,1.0,1,1.0,1,1.0,1,0.12053331925488998,60
1040,0,3207,767,2440,0,0,0,1.0,1,1.0,1,1.0,1,0.146708435863084,58
1041,1,3208,768,2440,0,0,0,1.0,1,1.0,1,1.0,1,0.14332806363894854,56
1042,1,3209,768,2441,0,0,0,1.0,1,1.0,1,1.0,1,0.12921208428810463,55
1043,1,3210,768,2442,0,0,0,1.0,1,1.0,1,1.0,1,0.12202613373696843,55
1044,0,3210,768,2442,0,0,0,1.0,1,1.0,1,1.0,1,0.10977621234468724,52
1045,0,3210,768,2442,0,0,0,1.0,1,1.0,1,1.0,1,0.11412314057902288,52
1046,2,3212,769,2443,0,0,0,1.0,1,1.0,1,1.0,1,0.14921600488026474,53
1047,1,3213,769,2444,0,0,0,1.0,1,1.0,1,1.0,1,0.14437114822893934,54
1048,3,3216,771,2445,0,0,0,1.0,1,1.0,1,1.0,1,0.15575709425574874,56
1049,3,3219,772,2447,0,0,0,1.0,1,1.0,1,1.0,1,0.15873473961110432,55
1050,1,3220,772,2448,0,0,0,1.0,1,1.0,1,1.0,1,0.16978547792503493,56
1051,9,3229,772,2457,0,0,0,1.0,1,1.0,1,1.0,1,0.1225637149433221,55
1052,5,3234,772,2462,0,0,0,1.0,1,1.0,1,1.0,1,0.08672968591255234,56
1053,10,3244,774,2470,0,0,0,1.0,1,1.0,1,1.0,1,0.08202223825418167,56
1054,7,3251,775,2476,0,0,0,1.0,1,1.0,1,1.0,1,0.08924683906574858,57
1055,4,3255,775,2480,0,0,0,1.0,1,1.0,1,1.0,1,0.08935242121989713,58
1056,6,3261,775,2486,0,0,0,1.0,1,1.0,1,1.0,1,0.09632129604099667,59
1057,8,3269,775,2494,0,0,0,1.0,1,1.0,1,1.0,1,0.10570204592818036,60
1058,4,3273,776,2497,0,0,0,1.0,1,1.0,1,1.0,1,0.16066715157492567,60
1059,7,3280,776,2504,0,0,0,1.0,1,1.0,1,1.0,1,0.14622101979071384,60
1060,8,3288,777,2511,0,0,0,1.0,1,1.0,1,1.0,1,0.1497062471425888,60
1061,7,3295,779,2516,0,0,0,1.0,1,1.0,1,1.0,1,0.2252632779316186,59
1062,15,3310,781,2529,0,0,0,1.0,1,1.0,1,1.0,1,0.2610997709971658,59
1063,15,3325,784,2541,0,0,0,1.0,1,1.0,1,1.0,1,0.3286848648238711,58
1064,15,3340,785,2555,0,0,0,1.0,1,1.0,1,1.0,1,0.3088167517352988,58
1065,10,3350,786,2564,0,0,0,1.0,1,1.0,1,1.0,1,0.2955505777753951,60
1066,17,3367,788,2579,0,0,0,1.0,1,1.0,1,1.0,1,0.13379396614896857,58
1067,3,3370,789,2581,0,0,0,1.0,1,1.0,1,1.0,1,0.14973066954156003,59
1068,3,3373,789,2584,0,0,0,1.0,1,1.0,1,1.0,1,0.1416523068942047,59
1069,1,3374,789,2585,0,0,0,1.0,1,1.0,1,1.0,1,0.16541277331489326,58
1070,7,3381,790,2591,0,0,0,1.0,1,1.0,1,1.0,1,0.15180505925520163,58
1071,5,3386,791,2595,0,0,0,1.0,1,1.0,1,1.0,1,0.17067695879454667,57
1072,7,3393,791,2602,0,0,0,1.0,1,1.0,1,1.0,1,0.1737141627022477,56
1073,4,3397,791,2606,0,0,0,1.0,1,1.0,1,1.0,1,0.18928999527957968,54
1074,3,3400,792,2608,0,0,0,1.0,1,1.0,1,1.0,1,0.19589656248341625,54
1075,4,3404,792,2612,0,0,0,1.0,1,1.0,1,1.0,1,0.19258609894123344,51
1076,9,3413,794,2619,0,0,0,1.0,1,1.0,1,1.0,1,0.2297646752272387,51
1077,7,3420,794,2626,0,0,0,1.0,1,1.0,1,1.0,1,0.23779613025088917,51
1078,7,3427,795,2632,0,0,0,1.0,1,1.0,1,1.0,1,0.24220466825275727,52
1079,6,3433,796,2637,0,0,0,1.0,1,1.0,1,1.0,1,0.26210741323917824,51
1080,7,3440,797,2643,0,0,0,1.0,1,1.0,1,1.0,1,0.2419537256643761,51
1081,9,3449,797,2652,0,0,0,1.0,1,1.0,1,1.0,1,0.18506792081942317,48
1082,1,3450,798,2652,0,0,0,1.0,1,1.0,1,1.0,1,0.23428005526355486,47
1083,6,3456,800,2656,0,0,0,1.0,1,1.0,1,1.0,1,0.2662290429439122,46
1084,2,3458,800,2658,0,0,0,1.0,1,1.0,1,1.0,1,0.24096833612296745,45
1085,6,3464,800,2664,0,0,0,1.0,1,1.0,1,1.0,1,0.2242046368983967,46
1086,4,3468,800,2668,0,0,0,1.0,1,1.0,1,1.0,1,0.20514344551574684,45
1087,2,3470,800,2670,0,0,0,1.0,1,1.0,1,1.0,1,0.2213988131318557,44
1088,4,3474,800,2674,0,0,0,1.0,1,1.0,1,1.0,1,0.2521947097901397,45
1089,3,3477,801,2676,0,0,0,1.0,1,1.0,1,1.0,1,0.22108115278199583,46
1090,4,3481,801,2680,0,0,0,1.0,1,1.0,1,1.0,1,0.20577396782310542,47
1091,4,3485,803,2682,0,0,0,1.0,1,1.0,1,1.0,1,0.22228302123865606,47
1092,2,3487,803,2684,0,0,0,1.0,1,1.0,1,1.0,1,0.21168093613118244,48
1093,4,3491,804,2687,0,0,0,1.0,1,1.0,1,1.0,1,0.20230587342814654,48
1094,5,3496,805,2691,0,0,0,1.0,1,1.0,1,1.0,1,0.2200483672950401,48
1095,3,3499,805,2694,0,0,0,1.0,1,1.0,1,1.0,1,0.21673760525148666,49
1096,7,3506,806,2700,0,0,0,1.0,1,1.0,1,1.0,1,0.12813254781958025,49
1097,1,3507,807,2700,0,0,0,1.0,1,1.0,1,1.0,1,0.13914729664371195,50
1098,1,3508,807,2701,0,0,0,1.0,1,1.0,1,1.0,1,0.14453078161978064,51
1099,0,3508,807,2701,0,0,0,1.0,1,1.0,1,1.0,1,0.14055472722923854,54
1100,0,3508,807,2701,0,0,0,1.0,1,1.0,1,1.0,1,0.14055472722923854,54
1101,2,3510,807,2703,0,0,0,1.0,1,1.0,1,1.0,1,0.1404450285524159,54
1102,0,3510,807,2703,0,0,0,1.0,1,1.0,1,1.0,1,0.13330628511125214,54
1103,4,3514,809,2705,0,0,0,1.0,1,1.0,1,1.0,1,0.14001491834539437,53
1104,4,3518,812,2706,0,0,0,1.0,1,1.0,1,1.0,1,0.1616087937341831,53
1105,7,3525,814,2711,0,0,0,1.0,1,1.0,1,1.0,1,0.16160157047563786,52
1106,7,3532,816,2716,0,0,0,1.0,1,1.0,1,1.0,1,0.1636582393388847,52
1107,5,3537,817,2720,0,0,0,1.0,1,1.0,1,1.0,1,0.1642823184347437,52
1108,3,3540,819,2721,0,0,0,1.0,1,1.0,1,1.0,1,0.19118316775557395,51
1109,1,3541,820,2721,0,0,0,1.0,1,1.0,1,1.0,1,0.21421173562518547,49
1110,1,3542,821,2721,0,0,0,1.0,1,1.0,1,1.0,1,0.24061730384077595,48
1111,10,3552,823,2729,0,0,0,1.0,1,1.0,1,1.0,1,0.24383919580341,47
1112,6,3558,824,2734,0,0,0,1.0,1,1.0,1,1.0,1,0.2160934407398256,46
1113,4,3562,826,2736,0,0,0,1.0,1,1.0,1,1.0,1,0.23279503484879954,43
1114,3,3565,827,2738,0,0,0,1.0,1,1.0,1,1.0,1,0.2535877663680964,41
1115,6,3571,828,2743,0,0,0,1.0,1,1.0,1,1.0,1,0.227169566387105,40
1116,6,3577,829,2748,0,0,0,1.0,1,1.0,1,1.0,1,0.210166094143824,39
1117,4,3581,830,2751,0,0,0,1.0,1,1.0,1,1.0,1,0.2662206933077432,40
1118,5,3586,830,2756,0,0,0,1.0,1,1.0,1,1.0,1,0.2084661116730212,40
1119,9,3595,831,2764,0,0,0,1.0,1,1.0,1,1.0,1,0.2951211904989501,40
1120,9,3604,833,2771,0,0,0,1.0,1,1.0,1,1.0,1,0.2916245977384188,40
1121,10,3614,834,2780,0,0,0,1.0,1,1.0,1,1.0,1,0.3134188022082351,40
1122,10,3624,835,2789,0,0,0,1.0,1,1.0,1,1.0,1,0.31848277019534854,41
1123,7,3631,835,2796,0,0,0,1.0,1,1.0,1,1.0,1,0.354390302523132,41
1124,7,3638,835,2803,0,0,0,1.0,1,1.0,1,1.0,1,0.3635128498538799,41
1125,9,3647,837,2810,0,0,0,1.0,1,1.0,1,1.0,1,0.4080605490485117,41
1126,9,3656,837,2819,0,0,0,1.0,1,1.0,1,1.0,1,0.2234509045544336,41
1127,3,3659,837,2822,0,0,0,1.0,1,1.0,1,1.0,1,0.18428887260304583,41
1128,6,3665,837,2828,0,0,0,1.0,1,1.0,1,1.0,1,0.1704232982365667,42
1129,4,3669,837,2832,0,0,0,1.0,1,1.0,1,1.0,1,0.1680069362870436,42
1130,5,3674,837,2837,0,0,0,1.0,1,1.0,1,1.0,1,0.1615879961341344,42
1131,1,3675,837,2838,0,0,0,1.0,1,1.0,1,1.0,1,0.1678769620429155,42
1132,6,3681,837,2844,0,0,0,1.0,1,1.0,1,1.0,1,0.11504967927253237,43
1133,4,3685,837,2848,0,0,0,1.0,1,1.0,1,1.0,1,0.11578963781900004,45
1134,2,3687,837,2850,0,0,0,1.0,1,1.0,1,1.0,1,0.12466733015272655,46
1135,2,3689,837,2852,0,0,0,1.0,1,1.0,1,1.0,1,0.11904052799255334,45
1136,1,3690,837,2853,0,0,0,1.0,1,1.0,1,1.0,1,0.13470315739988148,48
1137,4,3694,837,2857,0,0,0,1.0,1,1.0,1,1.0,1,0.14998295900321945,49
1138,3,3697,837,2860,0,0,0,1.0,1,1.0,1,1.0,1,0.15551018438983333,49
1139,2,3699,837,2862,0,0,0,1.0,1,1.0,1,1.0,1,0.16093893464175968,49
1140,1,3700,837,2863,0,0,0,1.0,1,1.0,1,1.0,1,0.1535534282252242,49
1141,2,3702,837,2865,0,0,0,1.0,1,1.0,1,1.0,1,0.15767205219345495,48
1142,7,3709,840,2869,0,0,0,1.0,1,1.0,1,1.0,1,0.13485074865923433,48
1143,1,3710,841,2869,0,0,0,1.0,1,1.0,1,1.0,1,0.17726076300466706,48
1144,4,3714,843,2871,0,0,0,1.0,1,1.0,1,1.0,1,0.13984260238731633,48
1145,1,3715,844,2871,0,0,0,1.0,1,1.0,1,1.0,1,0.1768647326454034,48
1146,2,3717,845,2872,0,0,0,1.0,1,1.0,1,1.0,1,0.14891780167436455,48
1147,1,3718,845,2873,0,0,0,1.0,1,1.0,1,1.0,1,0.16909442014353962,46
1148,2,3720,847,2873,0,0,0,1.0,1,1.0,1,1.0,1,0.13003192742084652,46
1149,2,3722,848,2874,0,0,0,1.0,1,1.0,1,1.0,1,0.24294585650415104,45
1150,5,3727,851,2876,0,0,0,1.0,1,1.0,1,1.0,1,0.24233346949104848,46
1151,3,3730,853,2877,0,0,0,1.0,1,1.0,1,1.0,1,0.26728506708560806,44
1152,3,3733,854,2879,0,0,0,1.0,1,1.0,1,1.0,1,0.25767869173775354,44
1153,6,3739,856,2883,0,0,0,1.0,1,1.0,1,1.0,1,0.251982231953904,43
1154,3,3742,858,2884,0,0,0,1.0,1,1.0,1,1.0,1,0.22582980868413727,43
1155,3,3745,859,2886,0,0,0,1.0,1,1.0,1,1.0,1,0.26349984441020036,43
1156,4,3749,859,2890,0,0,0,1.0,1,1.0,1,1.0,1,0.18993994156601382,42
1157,0,3749,859,2890,0,0,0,1.0,1,1.0,1,1.0,1,0.1916413560469759,42
1158,0,3749,859,2890,0,0,0,1.0,1,1.0,1,1.0,1,0.18038896946723518,41
1159,0,3749,859,2890,0,0,0,1.0,1,1.0,1,1.0,1,0.18213108777649306,41
1160,1,3750,859,2891,0,0,0,1.0,1,1.0,1,1.0,1,0.18911436711421376,41
1161,2,3752,859,2893,0,0,0,1.0,1,1.0,1,1.0,1,0.17759756229378718,42
1162,5,3757,859,2898,0,0,0,1.0,1,1.0,1,1.0,1,0.13813723347360113,43
1163,2,3759,859,2900,0,0,0,1.0,1,1.0,1,1.0,1,0.12958522270296935,43
1164,2,3761,859,2902,0,0,0,1.0,1,1.0,1,1.0,1,0.11940938393841509,44
1165,0,3761,859,2902,0,0,0,1.0,1,1.0,1,1.0,1,0.11940938393841509,44
1166,4,3765,860,2905,0,0,0,1.0,1,1.0,1,1.0,1,0.13942937481783385,46
1167,5,3770,861,2909,0,0,0,1.0,1,1.0,1,1.0,1,0.12633091489874596,46
1168,9,3779,861,2918,0,0,0,1.0,1,1.0,1,1.0,1,0.09710906172433813,47
1169,5,3784,861,2923,0,0,0,1.0,1,1.0,1,1.0,1,0.13307704386197722,46
1170,7,3791,862,2929,0,0,0,1.0,1,1.0,1,1.0,1,0.13964305207056946,48
1171,5,3796,863,2933,0,0,0,1.0,1,1.0,1,1.0,1,0.08321356075391068,49
1172,2,3798,863,2935,0,0,0,1.0,1,1.0,1,1.0,1,0.08321356075391068,49
1173,2,3800,863,2937,0,0,0,1.0,1,1.0,1,1.0,1,0.08321356075391068,49
1174,2,3802,864,2938,0,0,0,1.0,1,1.0,1,1.0,1,0.09636773795540891,49
1175,3,3805,864,2941,0,0,0,1.0,1,1.0,1,1.0,1,0.08793328809431954,50
1176,0,3805,864,2941,0,0,0,1.0,1,1.0,1,1.0,1,0.10879300650088054,52
1177,3,3808,865,2943,0,0,0,1.0,1,1.0,1,1.0,1,0.13243955699054216,52
1178,1,3809,865,2944,0,0,0,1.0,1,1.0,1,1.0,1,0.12528230855275574,52
1179,0,3809,865,2944,0,0,0,1.0,1,1.0,1,1.0,1,0.11259010570763002,53
1180,1,3810,865,2945,0,0,0,1.0,1,1.0,1,1.0,1,0.1064009479574319,54
1181,3,3813,865,2948,0,0,0,1.0,1,1.0,1,1.0,1,0.11741837342014752,55
1182,5,3818,867,2951,0,0,0,1.0,1,1.0,1,1.0,1,0.15293595787128142,55
1183,9,3827,868,2959,0,0,0,1.0,1,1.0,1,1.0,1,0.15115287474807335,53
1184,7,3834,870,2964,0,0,0,1.0,1,1.0,1,1.0,1,0.1559993445425497,54
1185,4,3838,870,2968,0,0,0,1.0,1,1.0,1,1.0,1,0.16555361136436214,53
1186,6,3844,871,2973,0,0,0,1.0,1,1.0,1,1.0,1,0.14955894306891254,54
1187,1,3845,872,2973,0,0,0,1.0,1,1.0,1,1.0,1,0.18426296187530627,55
1188,0,3845,872,2973,0,0,0,1.0,1,1.0,1,1.0,1,0.18426296187530627,55
1189,2,3847,872,2975,0,0,0,1.0,1,1.0,1,1.0,1,0.15216362458439558,54
1190,1,3848,872,2976,0,0,0,1.0,1,1.0,1,1.0,1,0.14180316393858408,55
1191,3,3851,872,2979,0,0,0,1.0,1,1.0,1,1.0,1,0.14218223447375716,54
1192,9,3860,875,2985,0,0,0,1.0,1,1.0,1,1.0,1,0.1934985206602584,52
1193,7,3867,875,2992,0,0,0,1.0,1,1.0,1,1.0,1,0.1651771987987873,53
1194,5,3872,876,2996,0,0,0,1.0,1,1.0,1,1.0,1,0.1828517642100603,53
1195,7,3879,877,3002,0,0,0,1.0,1,1.0,1,1.0,1,0.1473758457095573,54
1196,5,3884,877,3007,0,0,0,1.0,1,1.0,1,1.0,1,0.13243299290360783,56
1197,5,3889,879,3010,0,0,0,1.0,1,1.0,1,1.0,1,0.12688089750510415,56
1198,5,3894,880,3014,0,0,0,1.0,1,1.0,1,1.0,1,0.1476649799025555,58
1199,6,3900,881,3019,0,0,0,1.0,1,1.0,1,1.0,1,0.1476515496344863,58
1200,3,3903,881,3022,0,0,0,1.0,1,1.0,1,1.0,1,0.15108894398448344,58
1201,8,3911,883,3028,0,0,0,1.0,1,1.0,1,1.0,1,0.10087819405424873,58
1202,4,3915,884,3031,0,0,0,1.0,1,1.0,1,1.0,1,0.11080277667509185,60
1203,3,3918,884,3034,0,0,0,1.0,1,1.0,1,1.0,1,0.12092379376959914,58
1204,2,3920,885,3035,0,0,0,1.0,1,1.0,1,1.0,1,0.1301472900186521,59
1205,3,3923,886,3037,0,0,0,1.0,1,1.0,1,1.0,1,0.15131761921690207,59
1206,5,3928,886,3042,0,0,0,1.0,1,1.0,1,1.0,1,0.14250921917000395,58
1207,3,3931,886,3045,0,0,0,1.0,1,1.0,1,1.0,1,0.17753717315143885,60
1208,3,3934,886,3048,0,0,0,1.0,1,1.0,1,1.0,1,0.14220059061224613,60
1209,4,3938,886,3052,0,0,0,1.0,1,1.0,1,1.0,1,0.1307574034372016,61
1210,1,3939,886,3053,0,0,0,1.0,1,1.0,1,1.0,1,0.14227794033055827,61
1211,2,3941,886,3055,0,0,0,1.0,1,1.0,1,1.0,1,0.09729135715740475,63
1212,2,3943,886,3057,0,0,0,1.0,1,1.0,1,1.0,1,0.09729135715740475,63
1213,3,3946,887,3059,0,0,0,1.0,1,1.0,1,1.0,1,0.1089379176248564,63
1214,6,3952,888,3064,0,0,0,1.0,1,1.0,1,1.0,1,0.149449830489573,62
1215,9,3961,888,3073,0,0,0,1.0,1,1.0,1,1.0,1,0.16041607863210766,63
1216,8,3969,888,3081,0,0,0,1.0,1,1.0,1,1.0,1,0.08721029393743086,64
1217,2,3971,888,3083,0,0,0,1.0,1,1.0,1,1.0,1,0.09420865169168104,65
1218,3,3974,889,3085,0,0,0,1.0,1,1.0,1,1.0,1,0.1114037327256274,64
1219,0,3974,889,3085,0,0,0,1.0,1,1.0,1,1.0,1,0.11916056651404529,65
1220,0,3974,889,3085,0,0,0,1.0,1,1.0,1,1.0,1,0.12855055078297195,64
1221,2,3976,890,3086,0,0,0,1.0,1,1.0,1,1.0,1,0.14387438051214957,65
1222,3,3979,891,3088,0,0,0,1.0,1,1.0,1,1.0,1,0.14279754528697483,66
1223,2,3981,892,3089,0,0,0,1.0,1,1.0,1,1.0,1,0.12599482207185372,64
1224,5,3986,893,3093,0,0,0,1.0,1,1.0,1,1.0,1,0.11011242371468616,66
1225,3,3989,895,3094,0,0,0,1.0,1,1.0,1,1.0,1,0.12977388683149965,66
1226,4,3993,897,3096,0,0,0,1.0,1,1.0,1,1.0,1,0.11551216861722152,68
1227,2,3995,898,3097,0,0,0,1.0,1,1.0,1,1.0,1,0.09616507480652672,64
1228,1,3996,898,3098,0,0,0,1.0,1,1.0,1,1.0,1,0.11276544284975498,62
1229,2,3998,899,3099,0,0,0,1.0,1,1.0,1,1.0,1,0.10619428277403105,61
1230,1,3999,900,3099,0,0,0,1.0,1,1.0,1,1.0,1,0.1299370965381466,58
1231,3,4002,901,3101,0,0,0,1.0,1,1.0,1,1.0,1,0.08972204114556602,57
1232,1,4003,902,3101,0,0,0,1.0,1,1.0,1,1.0,1,0.1508711177118781,53
1233,1,4004,903,3101,0,0,0,1.0,1,1.0,1,1.0,1,0.1572670578009955,53
1234,0,4004,903,3101,0,0,0,1.0,1,1.0,1,1.0,1,0.13558986979399323,54
1235,2,4006,903,3103,0,0,0,1.0,1,1.0,1,1.0,1,0.15005709851012808,55
1236,5,4011,904,3107,0,0,0,1.0,1,1.0,1,1.0,1,0.18234079295452024,55
1237,4,4015,905,3110,0,0,0,1.0,1,1.0,1,1.0,1,0.17855414585752152,55
1238,3,4018,907,3111,0,0,0,1.0,1,1.0,1,1.0,1,0.16823970856492299,54
1239,2,4020,907,3113,0,0,0,1.0,1,1.0,1,1.0,1,0.1399997047995898,55
1240,1,4021,907,3114,0,0,0,1.0,1,1.0,1,1.0,1,0.13287376822089553,55
1241,2,4023,908,3115,0,0,0,1.0,1,1.0,1,1.0,1,0.09037843840861687,54
1242,0,4023,908,3115,0,0,0,1.0,1,1.0,1,1.0,1,0.09966636619932627,54
1243,1,4024,909,3115,0,0,0,1.0,1,1.0,1,1.0,1,0.14301568003022305,55
1244,0,4024,909,3115,0,0,0,1.0,1,1.0,1,1.0,1,0.15835987623673117,55
1245,2,4026,910,3116,0,0,0,1.0,1,1.0,1,1.0,1,0.15757689701381056,55
1246,6,4032,911,3121,0,0,0,1.0,1,1.0,1,1.0,1,0.13617953420187007,55
1247,3,4035,913,3122,0,0,0,1.0,1,1.0,1,1.0,1,0.14414893030852685,57
1248,3,4038,913,3125,0,0,0,1.0,1,1.0,1,1.0,1,0.14926640774152547,56
1249,2,4040,915,3125,0,0,0,1.0,1,1.0,1,1.0,1,0.21159990154835465,56
1250,8,4048,918,3130,0,0,0,1.0,1,1.0,1,1.0,1,0.18059772456499246,56
1251,1,4049,918,3131,0,0,0,1.0,1,1.0,1,1.0,1,0.1680124091025944,58
1252,4,4053,921,3132,0,0,0,1.0,1,1.0,1,1.0,1,0.20719839390485448,58
1253,2,4055,922,3133,0,0,0,1.0,1,1.0,1,1.0,1,0.2011502970137447,58
1254,0,4055,922,3133,0,0,0,1.0,1,1.0,1,1.0,1,0.171145210076019,60
1255,3,4058,923,3135,0,0,0,1.0,1,1.0,1,1.0,1,0.18302166516786367,61
1256,4,4062,923,3139,0,0,0,1.0,1,1.0,1,1.0,1,0.15245936148592937,61
1257,3,4065,923,3142,0,0,0,1.0,1,1.0,1,1.0,1,0.13929346477214172,62
1258,5,4070,924,3146,0,0,0,1.0,1,1.0,1,1.0,1,0.134357709999994,63
1259,2,4072,924,3148,0,0,0,1.0,1,1.0,1,1.0,1,0.134357709999994,63
1260,1,4073,924,3149,0,0,0,1.0,1,1.0,1,1.0,1,0.1439040131038505,63
1261,3,4076,924,3152,0,0,0,1.0,1,1.0,1,1.0,1,0.11814642111836315,63
1262,2,4078,924,3154,0,0,0,1.0,1,1.0,1,1.0,1,0.0990053875030548,64
1263,1,4079,925,3154,0,0,0,1.0,1,1.0,1,1.0,1,0.1087672920750417,63
1264,2,4081,927,3154,0,0,0,1.0,1,1.0,1,1.0,1,0.0905257080644779,63
1265,4,4085,931,3154,0,0,0,1.0,1,1.0,1,1.0,1,0.16294910584773795,60
1266,6,4091,935,3156,0,0,0,1.0,1,1.0,1,1.0,1,0.18547999077096156,61
1267,2,4093,937,3156,0,0,0,1.0,1,1.0,1,1.0,1,0.15160244740441425,58
1268,3,4096,939,3157,0,0,0,1.0,1,1.0,1,1.0,1,0.1874196877429728,54
1269,0,4096,939,3157,0,0,0,1.0,1,1.0,1,1.0,1,0.16484043900847709,54
1270,2,4098,940,3158,0,0,0,1.0,1,1.0,1,1.0,1,0.17108688333246339,51
1271,1,4099,941,3158,0,0,0,1.0,1,1.0,1,1.0,1,0.1642024536957316,50
1272,2,4101,943,3158,0,0,0,1.0,1,1.0,1,1.0,1,0.25306857922800585,47
1273,1,4102,944,3158,0,0,0,1.0,1,1.0,1,1.0,1,0.2482250722018693,47
1274,2,4104,945,3159,0,0,0,1.0,1,1.0,1,1.0,1,0.2817423803327474,49
1275,4,4108,946,3162,0,0,0,1.0,1,1.0,1,1.0,1,0.27151858577557353,48
1276,9,4117,946,3171,0,0,0,1.0,1,1.0,1,1.0,1,0.16570667003139122,49
1277,6,4123,949,3174,0,0,0,1.0,1,1.0,1,1.0,1,0.15127347959795695,50
1278,7,4130,949,3181,0,0,0,1.0,1,1.0,1,1.0,1,0.07834871895759848,51
1279,4,4134,950,3184,0,0,0,1.0,1,1.0,1,1.0,1,0.10973455555354576,51
1280,2,4136,950,3186,0,0,0,1.0,1,1.0,1,1.0,1,0.1179165630356,52
1281,2,4138,950,3188,0,0,0,1.0,1,1.0,1,1.0,1,0.09101118349432456,52
1282,4,4142,952,3190,0,0,0,1.0,1,1.0,1,1.0,1,0.14748427814856113,52
1283,3,4145,952,3193,0,0,0,1.0,1,1.0,1,1.0,1,0.14681753140486845,52
1284,6,4151,953,3198,0,0,0,1.0,1,1.0,1,1.0,1,0.18202647908005842,52
1285,3,4154,953,3201,0,0,0,1.0,1,1.0,1,1.0,1,0.20175925295505523,51
1286,5,4159,953,3206,0,0,0,1.0,1,1.0,1,1.0,1,0.20049119467423737,52
1287,5,4164,953,3211,0,0,0,1.0,1,1.0,1,1.0,1,0.1923441147488066,54
1288,9,4173,953,3220,0,0,0,1.0,1,1.0,1,1.0,1,0.167207308167089,55
1289,8,4181,953,3228,0,0,0,1.0,1,1.0,1,1.0,1,0.1575621597855512,56
1290,10,4191,955,3236,0,0,0,1.0,1,1.0,1,1.0,1,0.1177236076388101,57
1291,3,4194,955,3239,0,0,0,1.0,1,1.0,1,1.0,1,0.09873301968620359,58
1292,1,4195,956,3239,0,0,0,1.0,1,1.0,1,1.0,1,0.0983376000756039,59
1293,3,4198,956,3242,0,0,0,1.0,1,1.0,1,1.0,1,0.10627554730878348,59
1294,5,4203,957,3246,0,0,0,1.0,1,1.0,1,1.0,1,0.10505757865390516,59
1295,5,4208,958,3250,0,0,0,1.0,1,1.0,1,1.0,1,0.08210482822540119,59
1296,0,4208,958,3250,0,0,0,1.0,1,1.0,1,1.0,1,0.10451582046683405,59
1297,4,4212,959,3253,0,0,0,1.0,1,1.0,1,1.0,1,0.10201512200929906,61
1298,1,4213,959,3254,0,0,0,1.0,1,1.0,1,1.0,1,0.11187398706356655,61
1299,2,4215,959,3256,0,0,0,1.0,1,1.0,1,1.0,1,0.13184201059353856,60
1300,4,4219,960,3259,0,0,0,1.0,1,1.0,1,1.0,1,0.11549533760448323,59
1301,4,4223,961,3262,0,0,0,1.0,1,1.0,1,1.0,1,0.13118093887786947,59
1302,6,4229,965,3264,0,0,0,1.0,1,1.0,1,1.0,1,0.11394642949652133,59
1303,7,4236,969,3267,0,0,0,1.0,1,1.0,1,1.0,1,0.20511086745147833,55
1304,7,4243,974,3269,0,0,0,1.0,1,1.0,1,1.0,1,0.21727918585618658,56
1305,7,4250,976,3274,0,0,0,1.0,1,1.0,1,1.0,1,0.20024010439059226,54
1306,5,4255,977,3278,0,0,0,1.0,1,1.0,1,1.0,1,0.1414402751819119,53
1307,6,4261,979,3282,0,0,0,1.0,1,1.0,1,1.0,1,0.1484952516707883,52
1308,3,4264,982,3282,0,0,0,1.0,1,1.0,1,1.0,1,0.1495142422717171,52
1309,6,4270,985,3285,0,0,0,1.0,1,1.0,1,1.0,1,0.1386058194798068,54
1310,3,4273,987,3286,0,0,0,1.0,1,1.0,1,1.0,1,0.1579464256100721,52
1311,1,4274,988,3286,0,0,0,1.0,1,1.0,1,1.0,1,0.16629627723857549,51
1312,1,4275,989,3286,0,0,0,1.0,1,1.0,1,1.0,1,0.1965055538073903,49
1313,1,4276,989,3287,0,0,0,1.0,1,1.0,1,1.0,1,0.2263586819415115,47
1314,0,4276,989,3287,0,0,0,1.0,1,1.0,1,1.0,1,0.25347167854379316,46
1315,1,4277,989,3288,0,0,0,1.0,1,1.0,1,1.0,1,0.2427298601196007,45
1316,4,4281,992,3289,0,0,0,1.0,1,1.0,1,1.0,1,0.16744403052103582,46
1317,0,4281,992,3289,0,0,0,1.0,1,1.0,1,1.0,1,0.18711046855310137,45
1318,2,4283,994,3289,0,0,0,1.0,1,1.0,1,1.0,1,0.1829666599627193,46
1319,2,4285,994,3291,0,0,0,1.0,1,1.0,1,1.0,1,0.18417577956367226,46
1320,0,4285,994,3291,0,0,0,1.0,1,1.0,1,1.0,1,0.18417577956367226,46
1321,6,4291,995,3296,0,0,0,1.0,1,1.0,1,1.0,1,0.09027935448971663,48
1322,1,4292,996,3296,0,0,0,1.0,1,1.0,1,1.0,1,0.09580613422398751,49
1323,0,4292,996,3296,0,0,0,1.0,1,1.0,1,1.0,1,0.10070050044839612,49
1324,2,4294,996,3298,0,0,0,1.0,1,1.0,1,1.0,1,0.09986319159449919,50
1325,2,4296,996,3300,0,0,0,1.0,1,1.0,1,1.0,1,0.10894165849753078,49
1326,3,4299,997,3302,0,0,0,1.0,1,1.0,1,1.0,1,0.1638458233712374,50
1327,7,4306,998,3308,0,0,0,1.0,1,1.0,1,1.0,1,0.17016458714421054,50
1328,2,4308,998,3310,0,0,0,1.0,1,1.0,1,1.0,1,0.15949892975853838,49
1329,6,4314,998,3316,0,0,0,1.0,1,1.0,1,1.0,1,0.1787853530172123,50
1330,5,4319,998,3321,0,0,0,1.0,1,1.0,1,1.0,1,0.15683234010612845,50
1331,3,4322,999,3323,0,0,0,1.0,1,1.0,1,1.0,1,0.1619130289898796,50
1332,3,4325,999,3326,0,0,0,1.0,1,1.0,1,1.0,1,0.18250953985427687,51
1333,6,4331,1000,3331,0,0,0,1.0,1,1.0,1,1.0,1,0.2081083976074758,52
1334,7,4338,1000,3338,0,0,0,1.0,1,1.0,1,1.0,1,0.2079212361156666,54
1335,8,4346,1000,3346,0,0,0,1.0,1,1.0,1,1.0,1,0.24817335030408846,54
1336,8,4354,1000,3354,0,0,0,1.0,1,1.0,1,1.0,1,0.11402292649866203,56
1337,6,4360,1002,3358,0,0,0,1.0,1,1.0,1,1.0,1,0.14362933989756121,57
1338,5,4365,1003,3362,0,0,0,1.0,1,1.0,1,1.0,1,0.13915711817394863,57
1339,4,4369,1005,3364,0,0,0,1.0,1,1.0,1,1.0,1,0.17245148141270225,58
1340,4,4373,1005,3368,0,0,0,1.0,1,1.0,1,1.0,1,0.17519829482667537,59
1341,2,4375,1005,3370,0,0,0,1.0,1,1.0,1,1.0,1,0.17326180334041963,57
1342,9,4384,1007,3377,0,0,0,1.0,1,1.0,1,1.0,1,0.13354919312623154,57
1343,2,4386,1007,3379,0,0,0,1.0,1,1.0,1,1.0,1,0.11967695768602328,55
1344,5,4391,1009,3382,0,0,0,1.0,1,1.0,1,1.0,1,0.12367472890717567,54
1345,0,4391,1009,3382,0,0,0,1.0,1,1.0,1,1.0,1,0.12921603656951255,53
1346,1,4392,1010,3382,0,0,0,1.0,1,1.0,1,1.0,1,0.14369804612525383,53
1347,0,4392,1010,3382,0,0,0,1.0,1,1.0,1,1.0,1,0.1512608977658964,51
1348,2,4394,1012,3382,0,0,0,1.0,1,1.0,1,1.0,1,0.16430666465248264,52
1349,0,4394,1012,3382,0,0,0,1.0,1,1.0,1,1.0,1,0.17315012178347589,50
1350,3,4397,1014,3383,0,0,0,1.0,1,1.0,1,1.0,1,0.2005800234133966,51
1351,7,4404,1015,3389,0,0,0,1.0,1,1.0,1,1.0,1,0.11988148859262389,50
1352,0,4404,1015,3389,0,0,0,1.0,1,1.0,1,1.0,1,0.11589118054122795,50
1353,0,4404,1015,3389,0,0,0,1.0,1,1.0,1,1.0,1,0.11589118054122795,50
1354,2,4406,1015,3391,0,0,0,1.0,1,1.0,1,1.0,1,0.12680061901038497,51
1355,1,4407,1016,3391,0,0,0,1.0,1,1.0,1,1.0,1,0.1264246201000074,53
1356,2,4409,1018,3391,0,0,0,1.0,1,1.0,1,1.0,1,0.14418839208531326,52
1357,4,4413,1018,3395,0,0,0,1.0,1,1.0,1,1.0,1,0.13456690293808213,52
1358,5,4418,1019,3399,0,0,0,1.0,1,1.0,1,1.0,1,0.1733384687823341,53
1359,2,4420,1019,3401,0,0,0,1.0,1,1.0,1,1.0,1,0.15843400076547343,54
1360,6,4426,1020,3406,0,0,0,1.0,1,1.0,1,1.0,1,0.16797960954435218,55
1361,5,4431,1021,3410,0,0,0,1.0,1,1.0,1,1.0,1,0.20000881004989596,55
1362,4,4435,1021,3414,0,0,0,1.0,1,1.0,1,1.0,1,0.16824259695194438,56
1363,6,4441,1021,3420,0,0,0,1.0,1,1.0,1,1.0,1,0.15353930539554042,56
1364,2,4443,1021,3422,0,0,0,1.0,1,1.0,1,1.0,1,0.14436955081247857,55
1365,4,4447,1022,3425,0,0,0,1.0,1,1.0,1,1.0,1,0.16685063749189874,56
1366,8,4455,1023,3432,0,0,0,1.0,1,1.0,1,1.0,1,0.11740075495916337,57
1367,2,4457,1023,3434,0,0,0,1.0,1,1.0,1,1.0,1,0.1010310480268279,57
1368,1,4458,1023,3435,0,0,0,1.0,1,1.0,1,1.0,1,0.11258648985020518,58
1369,4,4462,1024,3438,0,0,0,1.0,1,1.0,1,1.0,1,0.10566029122936715,59
1370,4,4466,1025,3441,0,0,0,1.0,1,1.0,1,1.0,1,0.12709304631231283,60
1371,5,4471,1025,3446,0,0,0,1.0,1,1.0,1,1.0,1,0.11181969738850837,59
1372,4,4475,1027,3448,0,0,0,1.0,1,1.0,1,1.0,1,0.1247791560370768,59
1373,3,4478,1028,3450,0,0,0,1.0,1,1.0,1,1.0,1,0.13622177149989584,59
1374,4,4482,1028,3454,0,0,0,1.0,1,1.0,1,1.0,1,0.1342438438619027,59
1375,7,4489,1028,3461,0,0,0,1.0,1,1.0,1,1.0,1,0.11654885655817022,62
1376,9,4498,1030,3468,0,0,0,1.0,1,1.0,1,1.0,1,0.1639014413841024,61
1377,8,4506,1031,3475,0,0,0,1.0,1,1.0,1,1.0,1,0.15729337405598573,63
1378,3,4509,1031,3478,0,0,0,1.0,1,1.0,1,1.0,1,0.1845061876947665,62
1379,11,4520,1033,3487,0,0,0,1.0,1,1.0,1,1.0,1,0.26870858824988564,61
1380,7,4527,1033,3494,0,0,0,1.0,1,1.0,1,1.0,1,0.2587818757161498,60
1381,10,4537,1034,3503,0,0,0,1.0,1,1.0,1,1.0,1,0.13905955245290252,58
1382,5,4542,1034,3508,0,0,0,1.0,1,1.0,1,1.0,1,0.10411013570484691,56
1383,6,4548,1035,3513,0,0,0,1.0,1,1.0,1,1.0,1,0.14633253707461305,57
1384,7,4555,1035,3520,0,0,0,1.0,1,1.0,1,1.0,1,0.14544924984991323,55
1385,3,4558,1035,3523,0,0,0,1.0,1,1.0,1,1.0,1,0.20182403692529557,55
1386,3,4561,1036,3525,0,0,0,1.0,1,1.0,1,1.0,1,0.1500179910815384,54
1387,6,4567,1036,3531,0,0,0,1.0,1,1.0,1,1.0,1,0.17565299365855602,53
1388,5,4572,1038,3534,0,0,0,1.0,1,1.0,1,1.0,1,0.18302476014892038,52
1389,2,4574,1039,3535,0,0,0,1.0,1,1.0,1,1.0,1,0.1989016915829013,52
1390,3,4577,1039,3538,0,0,0,1.0,1,1.0,1,1.0,1,0.20196245190517698,51
1391,4,4581,1039,3542,0,0,0,1.0,1,1.0,1,1.0,1,0.18186173521764687,52
1392,4,4585,1039,3546,0,0,0,1.0,1,1.0,1,1.0,1,0.18130999278176296,51
1393,3,4588,1040,3548,0,0,0,1.0,1,1.0,1,1.0,1,0.1769216347970627,51
1394,1,4589,1040,3549,0,0,0,1.0,1,1.0,1,1.0,1,0.18672343503823977,52
1395,0,4589,1040,3549,0,0,0,1.0,1,1.0,1,1.0,1,0.18672343503823977,52
1396,5,4594,1040,3554,0,0,0,1.0,1,1.0,1,1.0,1,0.0980132950343687,53
1397,5,4599,1040,3559,0,0,0,1.0,1,1.0,1,1.0,1,0.11285651061870548,56
1398,3,4602,1041,3561,0,0,0,1.0,1,1.0,1,1.0,1,0.10942126654065946,56
1399,5,4607,1043,3564,0,0,0,1.0,1,1.0,1,1.0,1,0.1319925749867865,57
1400,2,4609,1043,3566,0,0,0,1.0,1,1.0,1,1.0,1,0.12744325439459087,57
1401,2,4611,1043,3568,0,0,0,1.0,1,1.0,1,1.0,1,0.1182405567106649,57
1402,5,4616,1045,3571,0,0,0,1.0,1,1.0,1,1.0,1,0.13583533768471484,57
1403,4,4620,1045,3575,0,0,0,1.0,1,1.0,1,1.0,1,0.14763634431285155,56
1404,2,4622,1045,3577,0,0,0,1.0,1,1.0,1,1.0,1,0.15322811666714747,58
1405,8,4630,1046,3584,0,0,0,1.0,1,1.0,1,1.0,1,0.2037079582397613,58
1406,7,4637,1046,3591,0,0,0,1.0,1,1.0,1,1.0,1,0.20222049754480007,58
1407,7,4644,1046,3598,0,0,0,1.0,1,1.0,1,1.0,1,0.21672624993546713,57
1408,6,4650,1046,3604,0,0,0,1.0,1,1.0,1,1.0,1,0.23909988527978862,58
1409,8,4658,1046,3612,0,0,0,1.0,1,1.0,1,1.0,1,0.23022084629981937,57
1410,10,4668,1046,3622,0,0,0,1.0,1,1.0,1,1.0,1,0.23022084629981937,57
1411,12,4680,1047,3633,0,0,0,1.0,1,1.0,1,1.0,1,0.1731660766148983,56
1412,1,4681,1047,3634,0,0,0,1.0,1,1.0,1,1.0,1,0.16277083279220553,55
1413,1,4682,1047,3635,0,0,0,1.0,1,1.0,1,1.0,1,0.14724687651473292,57
1414,0,4682,1047,3635,0,0,0,1.0,1,1.0,1,1.0,1,0.14724687651473292,57
1415,6,4688,1049,3639,0,0,0,1.0,1,1.0,1,1.0,1,0.14030102172637757,60
1416,3,4691,1049,3642,0,0,0,1.0,1,1.0,1,1.0,1,0.15316490565496502,61
1417,4,4695,1049,3646,0,0,0,1.0,1,1.0,1,1.0,1,0.1481946252214487,59
1418,4,4699,1049,3650,0,0,0,1.0,1,1.0,1,1.0,1,0.16613783735027876,60
1419,7,4706,1050,3656,0,0,0,1.0,1,1.0,1,1.0,1,0.17814940397380719,59
1420,6,4712,1050,3662,0,0,0,1.0,1,1.0,1,1.0,1,0.13322527942200774,58
1421,6,4718,1051,3667,0,0,0,1.0,1,1.0,1,1.0,1,0.14746493619527531,57
1422,6,4724,1052,3672,0,0,0,1.0,1,1.0,1,1.0,1,0.14247129838760558,57
1423,7,4731,1054,3677,0,0,0,1.0,1,1.0,1,1.0,1,0.09677247893500165,56
1424,1,4732,1055,3677,0,0,0,1.0,1,1.0,1,1.0,1,0.0992701414846621,57
1425,3,4735,1056,3679,0,0,0,1.0,1,1.0,1,1.0,1,0.10415679014046694,54
1426,3,4738,1057,3681,0,0,0,1.0,1,1.0,1,1.0,1,0.09216699479730714,54
1427,6,4744,1059,3685,0,0,0,1.0,1,1.0,1,1.0,1,0.11873600242921979,53
1428,0,4744,1059,3685,0,0,0,1.0,1,1.0,1,1.0,1,0.1255283878418604,52
1429,2,4746,1060,3686,0,0,0,1.0,1,1.0,1,1.0,1,0.10507911860638573,52
1430,4,4750,1062,3688,0,0,0,1.0,1,1.0,1,1.0,1,0.15615937393620558,51
1431,3,4753,1062,3691,0,0,0,1.0,1,1.0,1,1.0,1,0.14293870279211415,51
1432,3,4756,1064,3692,0,0,0,1.0,1,1.0,1,1.0,1,0.14818324026588314,52
1433,1,4757,1065,3692,0,0,0,1.0,1,1.0,1,1.0,1,0.16529696046410217,52
1434,0,4757,1065,3692,0,0,0,1.0,1,1.0,1,1.0,1,0.17567234524777822,52
1435,2,4759,1067,3692,0,0,0,1.0,1,1.0,1,1.0,1,0.19241513526473952,50
1436,1,4760,1068,3692,0,0,0,1.0,1,1.0,1,1.0,1,0.20733835515935656,50
1437,3,4763,1070,3693,0,0,0,1.0,1,1.0,1,1.0,1,0.23947470183728797,49
1438,3,4766,1071,3695,0,0,0,1.0,1,1.0,1,1.0,1,0.2031045801206284,49
1439,4,4770,1072,3698,0,0,0,1.0,1,1.0,1,1.0,1,0.21119286641517568,50
1440,5,4775,1076,3699,0,0,0,1.0,1,1.0,1,1.0,1,0.2207020744957044,50
1441,5,4780,1076,3704,0,0,0,1.0,1,1.0,1,1.0,1,0.16252865097669794,51
1442,0,4780,1076,3704,0,0,0,1.0,1,1.0,1,1.0,1,0.18616461851013072,50
1443,3,4783,1076,3707,0,0,0,1.0,1,1.0,1,1.0,1,0.17566191581700133,51
1444,3,4786,1076,3710,0,0,0,1.0,1,1.0,1,1.0,1,0.15140016028405462,51
1445,3,4789,1077,3712,0,0,0,1.0,1,1.0,1,1.0,1,0.16918579486203675,51
1446,4,4793,1079,3714,0,0,0,1.0,1,1.0,1,1.0,1,0.18843097812052986,51
1447,4,4797,1079,3718,0,0,0,1.0,1,1.0,1,1.0,1,0.16602421320917998,51
1448,3,4800,1079,3721,0,0,0,1.0,1,1.0,1,1.0,1,0.1698945802017125,51
1449,3,4803,1079,3724,0,0,0,1.0,1,1.0,1,1.0,1,0.17224306104882559,51
1450,6,4809,1079,3730,0,0,0,1.0,1,1.0,1,1.0,1,0.13485903524377396,52
1451,2,4811,1079,3732,0,0,0,1.0,1,1.0,1,1.0,1,0.1387611447239238,54
1452,4,4815,1079,3736,0,0,0,1.0,1,1.0,1,1.0,1,0.15398288578873992,56
1453,5,4820,1079,3741,0,0,0,1.0,1,1.0,1,1.0,1,0.14728397541770702,56
1454,13,4833,1082,3751,0,0,0,1.0,1,1.0,1,1.0,1,0.15670100241678547,58
1455,7,4840,1083,3757,0,0,0,1.0,1,1.0,1,1.0,1,0.16788343024537083,55
1456,3,4843,1084,3759,0,0,0,1.0,1,1.0,1,1.0,1,0.1810569097943459,56
1457,2,4845,1085,3760,0,0,0,1.0,1,1.0,1,1.0,1,0.21374832011458808,54
1458,1,4846,1085,3761,0,0,0,1.0,1,1.0,1,1.0,1,0.18160558380570177,52
1459,1,4847,1085,3762,0,0,0,1.0,1,1.0,1,1.0,1,0.17821536605087399,52
1460,0,4847,1085,3762,0,0,0,1.0,1,1.0,1,1.0,1,0.1722462936169718,50
1461,1,4848,1085,3763,0,0,0,1.0,1,1.0,1,1.0,1,0.15478037837339498,53
1462,6,4854,1090,3764,0,0,0,1.0,1,1.0,1,1.0,1,0.15492783027355583,51
1463,2,4856,1091,3765,0,0,0,1.0,1,1.0,1,1.0,1,0.17040826516205734,51
1464,3,4859,1093,3766,0,0,0,1.0,1,1.0,1,1.0,1,0.17203102579133586,51
1465,1,4860,1094,3766,0,0,0,1.0,1,1.0,1,1.0,1,0.18245736618769715,49
1466,3,4863,1096,3767,0,0,0,1.0,1,1.0,1,1.0,1,0.1919210640183607,49
1467,2,4865,1098,3767,0,0,0,1.0,1,1.0,1,1.0,1,0.23057279328657185,47
1468,1,4866,1099,3767,0,0,0,1.0,1,1.0,1,1.0,1,0.232333774417926,48
1469,0,4866,1099,3767,0,0,0,1.0,1,1.0,1,1.0,1,0.2455893076638258,47
1470,3,4869,1100,3769,0,0,0,1.0,1,1.0,1,1.0,1,0.232412622360539,49
1471,10,4879,1100,3779,0,0,0,1.0,1,1.0,1,1.0,1,0.19897696627385747,48
1472,5,4884,1100,3784,0,0,0,1.0,1,1.0,1,1.0,1,0.17400542450454284,48
1473,6,4890,1100,3790,0,0,0,1.0,1,1.0,1,1.0,1,0.17764282990168484,49
1474,6,4896,1100,3796,0,0,0,1.0,1,1.0,1,1.0,1,0.17764282990168484,49
1475,8,4904,1100,3804,0,0,0,1.0,1,1.0,1,1.0,1,0.17297952728441288,49
1476,6,4910,1101,3809,0,0,0,1.0,1,1.0,1,1.0,1,0.1685747169304287,51
1477,5,4915,1101,3814,0,0,0,1.0,1,1.0,1,1.0,1,0.17675482989104294,51
1478,7,4922,1101,3821,0,0,0,1.0,1,1.0,1,1.0,1,0.13700017252657662,52
1479,3,4925,1101,3824,0,0,0,1.0,1,1.0,1,1.0,1,0.13576838090808346,53
1480,5,4930,1102,3828,0,0,0,1.0,1,1.0,1,1.0,1,0.1590101819212765,53
1481,5,4935,1102,3833,0,0,0,1.0,1,1.0,1,1.0,1,0.144987030038342,53
1482,3,4938,1103,3835,0,0,0,1.0,1,1.0,1,1.0,1,0.14771584709606417,52
1483,5,4943,1103,3840,0,0,0,1.0,1,1.0,1,1.0,1,0.1268090462783356,52
1484,7,4950,1104,3846,0,0,0,1.0,1,1.0,1,1.0,1,0.17558472636505845,53
1485,9,4959,1104,3855,0,0,0,1.0,1,1.0,1,1.0,1,0.14905744231410134,53
1486,6,4965,1104,3861,0,0,0,1.0,1,1.0,1,1.0,1,0.08468712077109665,54
1487,1,4966,1104,3862,0,0,0,1.0,1,1.0,1,1.0,1,0.07322442208965008,55
1488,0,4966,1104,3862,0,0,0,1.0,1,1.0,1,1.0,1,0.0812469184783778,57
1489,1,4967,1105,3862,0,0,0,1.0,1,1.0,1,1.0,1,0.11098410700111405,58
1490,4,4971,1106,3865,0,0,0,1.0,1,1.0,1,1.0,1,0.10026876915755976,58
1491,4,4975,1108,3867,0,0,0,1.0,1,1.0,1,1.0,1,0.14043563031712014,59
1492,5,4980,1109,3871,0,0,0,1.0,1,1.0,1,1.0,1,0.15415466818576012,59
1493,4,4984,1111,3873,0,0,0,1.0,1,1.0,1,1.0,1,0.19301978981441759,58
1494,5,4989,1112,3877,0,0,0,1.0,1,1.0,1,1.0,1,0.20097096196518388,58
1495,10,4999,1113,3886,0,0,0,1.0,1,1.0,1,1.0,1,0.2467559891822056,57
1496,7,5006,1113,3893,0,0,0,1.0,1,1.0,1,1.0,1,0.24863390208904954,59
1497,8,5014,1114,3900,0,0,0,1.0,1,1.0,1,1.0,1,0.2671929619040102,58
1498,9,5023,1115,3908,0,0,0,1.0,1,1.0,1,1.0,1,0.2626984299839336,58
1499,4,5027,1115,3912,0,0,0,1.0,1,1.0,1,1.0,1,0.23045923956354916,56
1500,4,5031,1115,3916,0,0,0,1.0,1,1.0,1,1.0,1,0.23323162341376744,57
1501,6,5037,1116,3921,0,0,0,1.0,1,1.0,1,1.0,1,0.1509453446748201,55
1502,3,5040,1117,3923,0,0,0,1.0,1,1.0,1,1.0,1,0.11144417591992685,55
1503,1,5041,1117,3924,0,0,0,1.0,1,1.0,1,1.0,1,0.09551326590919257,54
1504,2,5043,1118,3925,0,0,0,1.0,1,1.0,1,1.0,1,0.09421788568539789,55
1505,1,5044,1118,3926,0,0,0,1.0,1,1.0,1,1.0,1,0.1009326910327636,53
1506,4,5048,1119,3929,0,0,0,1.0,1,1.0,1,1.0,1,0.1335791235803989,55
1507,4,5052,1119,3933,0,0,0,1.0,1,1.0,1,1.0,1,0.16411630405178607,53
1508,5,5057,1121,3936,0,0,0,1.0,1,1.0,1,1.0,1,0.11461334002856662,53
1509,6,5063,1122,3941,0,0,0,1.0,1,1.0,1,1.0,1,0.14273076021801567,52
1510,6,5069,1124,3945,0,0,0,1.0,1,1.0,1,1.0,1,0.189442906217987,50
1511,4,5073,1125,3948,0,0,0,1.0,1,1.0,1,1.0,1,0.18143714139523884,49
1512,4,5077,1126,3951,0,0,0,1.0,1,1.0,1,1.0,1,0.2093269678749012,48
1513,6,5083,1126,3957,0,0,0,1.0,1,1.0,1,1.0,1,0.25951551605779083,47
1514,4,5087,1126,3961,0,0,0,1.0,1,1.0,1,1.0,1,0.24924242101494973,48
1515,6,5093,1127,3966,0,0,0,1.0,1,1.0,1,1.0,1,0.2667452950799377,48
1516,9,5102,1127,3975,0,0,0,1.0,1,1.0,1,1.0,1,0.21220123672886493,47
1517,6,5108,1127,3981,0,0,0,1.0,1,1.0,1,1.0,1,0.15765819550398105,48
1518,3,5111,1127,3984,0,0,0,1.0,1,1.0,1,1.0,1,0.1517104703288532,48
1519,4,5115,1127,3988,0,0,0,1.0,1,1.0,1,1.0,1,0.1914488434477418,47
1520,10,5125,1128,3997,0,0,0,1.0,1,1.0,1,1.0,1,0.19533845364586486,48
1521,6,5131,1128,4003,0,0,0,1.0,1,1.0,1,1.0,1,0.1592894333533032,49
1522,3,5134,1128,4006,0,0,0,1.0,1,1.0,1,1.0,1,0.1567661600977006,48
1523,4,5138,1129,4009,0,0,0,1.0,1,1.0,1,1.0,1,0.1994781661182545,49
1524,6,5144,1131,4013,0,0,0,1.0,1,1.0,1,1.0,1,0.20362198944382365,49
1525,10,5154,1132,4022,0,0,0,1.0,1,1.0,1,1.0,1,0.18476974028678653,51
1526,7,5161,1132,4029,0,0,0,1.0,1,1.0,1,1.0,1,0.20235289755739685,52
1527,10,5171,1133,4038,0,0,0,1.0,1,1.0,1,1.0,1,0.20252459552009952,54
1528,15,5186,1135,4051,0,0,0,1.0,1,1.0,1,1.0,1,0.2085966079621303,54
1529,8,5194,1135,4059,0,0,0,1.0,1,1.0,1,1.0,1,0.22000279139295514,54
1530,10,5204,1136,4068,0,0,0,1.0,1,1.0,1,1.0,1,0.2180054378421057,54
1531,7,5211,1136,4075,0,0,0,1.0,1,1.0,1,1.0,1,0.0828768527584006,54
1532,1,5212,1136,4076,0,0,0,1.0,1,1.0,1,1.0,1,0.06967110361619985,54
1533,3,5215,1136,4079,0,0,0,1.0,1,1.0,1,1.0,1,0.07368291062344337,54
1534,5,5220,1136,4084,0,0,0,1.0,1,1.0,1,1.0,1,0.07645931320001802,54
1535,3,5223,1136,4087,0,0,0,1.0,1,1.0,1,1.0,1,0.06996406725324766,54
1536,5,5228,1136,4092,0,0,0,1.0,1,1.0,1,1.0,1,0.06354192430306037,55
1537,2,5230,1136,4094,0,0,0,1.0,1,1.0,1,1.0,1,0.0789861812914433,53
1538,5,5235,1136,4099,0,0,0,1.0,1,1.0,1,1.0,1,0.10274354488043279,54
1539,3,5238,1136,4102,0,0,0,1.0,1,1.0,1,1.0,1,0.1108084693819934,54
1540,7,5245,1137,4108,0,0,0,1.0,1,1.0,1,1.0,1,0.10183110033998287,54
1541,5,5250,1137,4113,0,0,0,1.0,1,1.0,1,1.0,1,0.10134966110384572,54
1542,6,5256,1139,4117,0,0,0,1.0,1,1.0,1,1.0,1,0.10622392592250737,57
1543,5,5261,1140,4121,0,0,0,1.0,1,1.0,1,1.0,1,0.12152283340240341,55
1544,6,5267,1143,4124,0,0,0,1.0,1,1.0,1,1.0,1,0.16792912585647968,54
1545,5,5272,1143,4129,0,0,0,1.0,1,1.0,1,1.0,1,0.14663544416603702,54
1546,3,5275,1143,4132,0,0,0,1.0,1,1.0,1,1.0,1,0.1061906765920831,53
1547,5,5280,1147,4133,0,0,0,1.0,1,1.0,1,1.0,1,0.1459165483506164,53
1548,1,5281,1148,4133,0,0,0,1.0,1,1.0,1,1.0,1,0.15320556861312215,54
1549,1,5282,1148,4134,0,0,0,1.0,1,1.0,1,1.0,1,0.1687375159654977,52
1550,4,5286,1151,4135,0,0,0,1.0,1,1.0,1,1.0,1,0.17603643965122914,52
1551,5,5291,1153,4138,0,0,0,1.0,1,1.0,1,1.0,1,0.19428071963183413,52
1552,7,5298,1156,4142,0,0,0,1.0,1,1.0,1,1.0,1,0.2140521873737099,51
1553,6,5304,1158,4146,0,0,0,1.0,1,1.0,1,1.0,1,0.22880740108700043,51
1554,5,5309,1160,4149,0,0,0,1.0,1,1.0,1,1.0,1,0.21406941908315621,51
1555,3,5312,1161,4151,0,0,0,1.0,1,1.0,1,1.0,1,0.19489116490667022,50
1556,3,5315,1162,4153,0,0,0,1.0,1,1.0,1,1.0,1,0.23335006754221055,51
1557,4,5319,1164,4155,0,0,0,1.0,1,1.0,1,1.0,1,0.2513306532650459,51
1558,4,5323,1165,4158,0,0,0,1.0,1,1.0,1,1.0,1,0.2711682969997767,52
1559,8,5331,1168,4163,0,0,0,1.0,1,1.0,1,1.0,1,0.23639098403278871,53
1560,3,5334,1169,4165,0,0,0,1.0,1,1.0,1,1.0,1,0.24951923942059948,51
1561,11,5345,1169,4176,0,0,0,1.0,1,1.0,1,1.0,1,0.1226616055773354,51
1562,6,5351,1169,4182,0,0,0,1.0,1,1.0,1,1.0,1,0.14202630481328643,52
1563,3,5354,1169,4185,0,0,0,1.0,1,1.0,1,1.0,1,0.12085506383858581,52
1564,0,5354,1169,4185,0,0,0,1.0,1,1.0,1,1.0,1,0.13562576909746782,51
1565,6,5360,1170,4190,0,0,0,1.0,1,1.0,1,1.0,1,0.13477139924428377,53
1566,5,5365,1170,4195,0,0,0,1.0,1,1.0,1,1.0,1,0.14362062875552165,53
1567,6,5371,1170,4201,0,0,0,1.0,1,1.0,1,1.0,1,0.1664457854508832,52
1568,5,5376,1171,4205,0,0,0,1.0,1,1.0,1,1.0,1,0.1789399474086529,52
1569,6,5382,1172,4210,0,0,0,1.0,1,1.0,1,1.0,1,0.23529289853642235,49
1570,2,5384,1172,4212,0,0,0,1.0,1,1.0,1,1.0,1,0.2101802411415939,48
1571,5,5389,1174,4215,0,0,0,1.0,1,1.0,1,1.0,1,0.23046606369905875,46
1572,4,5393,1176,4217,0,0,0,1.0,1,1.0,1,1.0,1,0.2758929168589506,47
1573,6,5399,1176,4223,0,0,0,1.0,1,1.0,1,1.0,1,0.2228155723463705,48
1574,7,5406,1178,4228,0,0,0,1.0,1,1.0,1,1.0,1,0.1998352248742554,46
1575,5,5411,1179,4232,0,0,0,1.0,1,1.0,1,1.0,1,0.18433297280640198,47
1576,5,5416,1181,4235,0,0,0,1.0,1,1.0,1,1.0,1,0.09584472567339157,46
1577,1,5417,1182,4235,0,0,0,1.0,1,1.0,1,1.0,1,0.129799051266864,45
1578,5,5422,1185,4237,0,0,0,1.0,1,1.0,1,1.0,1,0.14590609363980614,44
1579,2,5424,1186,4238,0,0,0,1.0,1,1.0,1,1.0,1,0.18167172539676535,43
1580,0,5424,1186,4238,0,0,0,1.0,1,1.0,1,1.0,1,0.18167172539676535,43
1581,0,5424,1186,4238,0,0,0,1.0,1,1.0,1,1.0,1,0.20290885534335934,42
1582,3,5427,1186,4241,0,0,0,1.0,1,1.0,1,1.0,1,0.19789895515601622,42
1583,5,5432,1189,4243,0,0,0,1.0,1,1.0,1,1.0,1,0.18904558391300394,43
1584,4,5436,1191,4245,0,0,0,1.0,1,1.0,1,1.0,1,0.15567258174804852,41
1585,6,5442,1194,4248,0,0,0,1.0,1,1.0,1,1.0,1,0.18634937664912732,43
1586,4,5446,1195,4251,0,0,0,1.0,1,1.0,1,1.0,1,0.22880540029474059,42
1587,5,5451,1196,4255,0,0,0,1.0,1,1.0,1,1.0,1,0.25536887357826377,42
1588,12,5463,1201,4262,0,0,0,1.0,1,1.0,1,1.0,1,0.30243125426373074,42
1589,6,5469,1201,4268,0,0,0,1.0,1,1.0,1,1.0,1,0.2394805405405343,42
1590,6,5475,1202,4273,0,0,0,1.0,1,1.0,1,1.0,1,0.2808029853844693,41
1591,7,5482,1203,4279,0,0,0,1.0,1,1.0,1,1.0,1,0.19001469473955113,40
1592,3,5485,1203,4282,0,0,0,1.0,1,1.0,1,1.0,1,0.17632385182026533,39
1593,7,5492,1205,4287,0,0,0,1.0,1,1.0,1,1.0,1,0.19682625495449133,39
1594,4,5496,1205,4291,0,0,0,1.0,1,1.0,1,1.0,1,0.17505843591519496,39
1595,3,5499,1205,4294,0,0,0,1.0,1,1.0,1,1.0,1,0.16801732460808008,42
1596,2,5501,1205,4296,0,0,0,1.0,1,1.0,1,1.0,1,0.19920502347571942,41
1597,2,5503,1205,4298,0,0,0,1.0,1,1.0,1,1.0,1,0.18719513229244183,41
1598,3,5506,1206,4300,0,0,0,1.0,1,1.0,1,1.0,1,0.22175368140061935,39
1599,2,5508,1206,4302,0,0,0,1.0,1,1.0,1,1.0,1,0.18231897741292055,39
1600,5,5513,1209,4304,0,0,0,1.0,1,1.0,1,1.0,1,0.1876060165485697,40
1601,7,5520,1210,4310,0,0,0,1.0,1,1.0,1,1.0,1,0.2261652517615789,41
1602,4,5524,1210,4314,0,0,0,1.0,1,1.0,1,1.0,1,0.21710429544190663,41
1603,9,5533,1211,4322,0,0,0,1.0,1,1.0,1,1.0,1,0.2689191992829873,43
1604,10,5543,1211,4332,0,0,0,1.0,1,1.0,1,1.0,1,0.2374157051367808,43
1605,5,5548,1212,4336,0,0,0,1.0,1,1.0,1,1.0,1,0.24377923091160425,44
1606,12,5560,1214,4346,0,0,0,1.0,1,1.0,1,1.0,1,0.13822325422704382,44
1607,1,5561,1214,4347,0,0,0,1.0,1,1.0,1,1.0,1,0.15793432802162555,42
1608,1,5562,1215,4347,0,0,0,1.0,1,1.0,1,1.0,1,0.16833562933678997,41
1609,2,5564,1215,4349,0,0,0,1.0,1,1.0,1,1.0,1,0.20277996741734247,39
1610,0,5564,1215,4349,0,0,0,1.0,1,1.0,1,1.0,1,0.20535887655902127,39
1611,1,5565,1215,4350,0,0,0,1.0,1,1.0,1,1.0,1,0.1583365832533832,40
1612,0,5565,1215,4350,0,0,0,1.0,1,1.0,1,1.0,1,0.1608462208945653,39
1613,0,5565,1215,4350,0,0,0,1.0,1,1.0,1,1.0,1,0.14408339505771905,41
1614,3,5568,1215,4353,0,0,0,1.0,1,1.0,1,1.0,1,0.10282686385949869,41
1615,3,5571,1215,4356,0,0,0,1.0,1,1.0,1,1.0,1,0.12504296145813915,41
1616,0,5571,1215,4356,0,0,0,1.0,1,1.0,1,1.0,1,0.11603700251283852,43
1617,0,5571,1215,4356,0,0,0,1.0,1,1.0,1,1.0,1,0.11908785357214206,44
1618,2,5573,1215,4358,0,0,0,1.0,1,1.0,1,1.0,1,0.12017627754478888,44
1619,2,5575,1216,4359,0,0,0,1.0,1,1.0,1,1.0,1,0.1390100902536927,44
1620,3,5578,1217,4361,0,0,0,1.0,1,1.0,1,1.0,1,0.20681350845853494,45
1621,4,5582,1217,4365,0,0,0,1.0,1,1.0,1,1.0,1,0.12017173257862031,44
1622,2,5584,1219,4365,0,0,0,1.0,1,1.0,1,1.0,1,0.15332002985691195,44
1623,3,5587,1219,4368,0,0,0,1.0,1,1.0,1,1.0,1,0.10726433514821666,43
1624,2,5589,1220,4369,0,0,0,1.0,1,1.0,1,1.0,1,0.11841694027545545,43
1625,3,5592,1221,4371,0,0,0,1.0,1,1.0,1,1.0,1,0.12090945967695754,43
1626,5,5597,1222,4375,0,0,0,1.0,1,1.0,1,1.0,1,0.18105122779291966,42
1627,1,5598,1223,4375,0,0,0,1.0,1,1.0,1,1.0,1,0.18185381001364453,42
1628,1,5599,1224,4375,0,0,0,1.0,1,1.0,1,1.0,1,0.20543324758516876,42
1629,1,5600,1224,4376,0,0,0,1.0,1,1.0,1,1.0,1,0.20044383046964445,41
1630,3,5603,1227,4376,0,0,0,1.0,1,1.0,1,1.0,1,0.24556708593312146,41
1631,3,5606,1229,4377,0,0,0,1.0,1,1.0,1,1.0,1,0.25192032829429795,40
1632,0,5606,1229,4377,0,0,0,1.0,1,1.0,1,1.0,1,0.2578307773566436,39
1633,0,5606,1229,4377,0,0,0,1.0,1,1.0,1,1.0,1,0.2578307773566436,39
1634,0,5606,1229,4377,0,0,0,1.0,1,1.0,1,1.0,1,0.2578307773566436,39
1635,2,5608,1230,4378,0,0,0,1.0,1,1.0,1,1.0,1,0.21219930507598048,40
1636,9,5617,1230,4387,0,0,0,1.0,1,1.0,1,1.0,1,0.13648603880302917,41
1637,2,5619,1230,4389,0,0,0,1.0,1,1.0,1,1.0,1,0.13881817068595356,41
1638,3,5622,1232,4390,0,0,0,1.0,1,1.0,1,1.0,1,0.13613992130717287,42
1639,7,5629,1232,4397,0,0,0,1.0,1,1.0,1,1.0,1,0.12006819517807245,43
1640,4,5633,1232,4401,0,0,0,1.0,1,1.0,1,1.0,1,0.1498940425479824,43
1641,8,5641,1232,4409,0,0,0,1.0,1,1.0,1,1.0,1,0.14498429515518227,44
1642,12,5653,1233,4420,0,0,0,1.0,1,1.0,1,1.0,1,0.19788563788251068,45
1643,6,5659,1234,4425,0,0,0,1.0,1,1.0,1,1.0,1,0.1209724187509109,44
1644,9,5668,1236,4432,0,0,0,1.0,1,1.0,1,1.0,1,0.09870806507761329,45
1645,5,5673,1236,4437,0,0,0,1.0,1,1.0,1,1.0,1,0.1442936908595036,44
1646,7,5680,1237,4443,0,0,0,1.0,1,1.0,1,1.0,1,0.1729156269186677,43
1647,9,5689,1238,4451,0,0,0,1.0,1,1.0,1,1.0,1,0.19816827919118862,43
1648,9,5698,1238,4460,0,0,0,1.0,1,1.0,1,1.0,1,0.20924457096063853,42
1649,6,5704,1238,4466,0,0,0,1.0,1,1.0,1,1.0,1,0.21668813662727762,41
1650,5,5709,1238,4471,0,0,0,1.0,1,1.0,1,1.0,1,0.2485796149862495,41
1651,5,5714,1239,4475,0,0,0,1.0,1,1.0,1,1.0,1,0.17726386287081733,40
1652,0,5714,1239,4475,0,0,0,1.0,1,1.0,1,1.0,1,0.16730869015738772,39
1653,2,5716,1239,4477,0,0,0,1.0,1,1.0,1,1.0,1,0.19675119656348564,39
1654,1,5717,1239,4478,0,0,0,1.0,1,1.0,1,1.0,1,0.16664519740081798,39
1655,4,5721,1241,4480,0,0,0,1.0,1,1.0,1,1.0,1,0.19631967487371005,40
1656,2,5723,1241,4482,0,0,0,1.0,1,1.0,1,1.0,1,0.19627511326666153,40
1657,2,5725,1242,4483,0,0,0,1.0,1,1.0,1,1.0,1,0.22172150752261943,40
1658,2,5727,1242,4485,0,0,0,1.0,1,1.0,1,1.0,1,0.20393743287221053,40
1659,2,5729,1242,4487,0,0,0,1.0,1,1.0,1,1.0,1,0.18709525714508807,40
1660,1,5730,1243,4487,0,0,0,1.0,1,1.0,1,1.0,1,0.1980784400017133,41
1661,2,5732,1244,4488,0,0,0,1.0,1,1.0,1,1.0,1,0.2248758085647582,42
1662,3,5735,1245,4490,0,0,0,1.0,1,1.0,1,1.0,1,0.16553832868009266,44
1663,3,5738,1246,4492,0,0,0,1.0,1,1.0,1,1.0,1,0.16514471884339074,43
1664,9,5747,1251,4496,0,0,0,1.0,1,1.0,1,1.0,1,0.1818373646944791,42
1665,2,5749,1251,4498,0,0,0,1.0,1,1.0,1,1.0,1,0.10914436334854924,42
1666,4,5753,1254,4499,0,0,0,1.0,1,1.0,1,1.0,1,0.16586430013135509,43
1667,1,5754,1255,4499,0,0,0,1.0,1,1.0,1,1.0,1,0.1627331564309705,40
1668,1,5755,1256,4499,0,0,0,1.0,1,1.0,1,1.0,1,0.14105979019195589,40
1669,2,5757,1258,4499,0,0,0,1.0,1,1.0,1,1.0,1,0.17339957116302648,40
1670,1,5758,1259,4499,0,0,0,1.0,1,1.0,1,1.0,1,0.18020114474589494,39
1671,0,5758,1259,4499,0,0,0,1.0,1,1.0,1,1.0,1,0.1610088980331675,39
1672,2,5760,1261,4499,0,0,0,1.0,1,1.0,1,1.0,1,0.1712277799974123,38
1673,2,5762,1262,4500,0,0,0,1.0,1,1.0,1,1.0,1,0.13861069699343545,38
1674,0,5762,1262,4500,0,0,0,1.0,1,1.0,1,1.0,1,0.1396557841039066,38
1675,6,5768,1264,4504,0,0,0,1.0,1,1.0,1,1.0,1,0.1525510519383928,39
1676,3,5771,1265,4506,0,0,0,1.0,1,1.0,1,1.0,1,0.1809737201014201,39
1677,7,5778,1266,4512,0,0,0,1.0,1,1.0,1,1.0,1,0.1975158672248742,40
1678,4,5782,1266,4516,0,0,0,1.0,1,1.0,1,1.0,1,0.1634249510520223,39
1679,1,5783,1267,4516,0,0,0,1.0,1,1.0,1,1.0,1,0.21860864166858093,39
1680,1,5784,1267,4517,0,0,0,1.0,1,1.0,1,1.0,1,0.23513046037357033,40
1681,4,5788,1267,4521,0,0,0,1.0,1,1.0,1,1.0,1,0.1889265241382542,41
1682,2,5790,1267,4523,0,0,0,1.0,1,1.0,1,1.0,1,0.1494610878930043,40
1683,1,5791,1267,4524,0,0,0,1.0,1,1.0,1,1.0,1,0.14645792252397904,43
1684,1,5792,1268,4524,0,0,0,1.0,1,1.0,1,1.0,1,0.18137854119484378,42
1685,2,5794,1269,4525,0,0,0,1.0,1,1.0,1,1.0,1,0.14329784493675804,41
1686,2,5796,1271,4525,0,0,0,1.0,1,1.0,1,1.0,1,0.1767498468974923,39
1687,8,5804,1274,4530,0,0,0,1.0,1,1.0,1,1.0,1,0.2074347039293624,41
1688,3,5807,1276,4531,0,0,0,1.0,1,1.0,1,1.0,1,0.2554647566375542,39
1689,5,5812,1278,4534,0,0,0,1.0,1,1.0,1,1.0,1,0.28076251238164307,37
1690,1,5813,1278,4535,0,0,0,1.0,1,1.0,1,1.0,1,0.2312063968544103,36
1691,5,5818,1281,4537,0,0,0,1.0,1,1.0,1,1.0,1,0.24289813283449443,36
1692,0,5818,1281,4537,0,0,0,1.0,1,1.0,1,1.0,1,0.23303986925629097,34
1693,0,5818,1281,4537,0,0,0,1.0,1,1.0,1,1.0,1,0.2013367271816901,33
1694,1,5819,1282,4537,0,0,0,1.0,1,1.0,1,1.0,1,0.2630294352067,32
1695,0,5819,1282,4537,0,0,0,1.0,1,1.0,1,1.0,1,0.25931306890531586,32
1696,5,5824,1283,4541,0,0,0,1.0,1,1.0,1,1.0,1,0.22302423937943205,34
1697,2,5826,1284,4542,0,0,0,1.0,1,1.0,1,1.0,1,0.2165536903844104,34
1698,3,5829,1285,4544,0,0,0,1.0,1,1.0,1,1.0,1,0.22076416375920532,36
1699,4,5833,1286,4547,0,0,0,1.0,1,1.0,1,1.0,1,0.23063479104888435,36
1700,3,5836,1286,4550,0,0,0,1.0,1,1.0,1,1.0,1,0.21872999586773556,37
1701,0,5836,1286,4550,0,0,0,1.0,1,1.0,1,1.0,1,0.24997048558212948,39
1702,5,5841,1287,4554,0,0,0,1.0,1,1.0,1,1.0,1,0.19425652564992857,39
1703,2,5843,1287,4556,0,0,0,1.0,1,1.0,1,1.0,1,0.1947178720196896,38
1704,3,5846,1289,4557,0,0,0,1.0,1,1.0,1,1.0,1,0.17046991789930957,38
1705,2,5848,1291,4557,0,0,0,1.0,1,1.0,1,1.0,1,0.16651021476574715,37
1706,2,5850,1292,4558,0,0,0,1.0,1,1.0,1,1.0,1,0.1655201907369939,37
1707,7,5857,1294,4563,0,0,0,1.0,1,1.0,1,1.0,1,0.11578352014102505,36
1708,2,5859,1294,4565,0,0,0,1.0,1,1.0,1,1.0,1,0.11691635250648079,34
1709,5,5864,1295,4569,0,0,0,1.0,1,1.0,1,1.0,1,0.11526548345067873,34
1710,6,5870,1295,4575,0,0,0,1.0,1,1.0,1,1.0,1,0.2147220251142574,33
1711,5,5875,1298,4577,0,0,0,1.0,1,1.0,1,1.0,1,0.2130544264773613,32
1712,1,5876,1299,4577,0,0,0,1.0,1,1.0,1,1.0,1,0.24976483981757183,31
1713,1,5877,1299,4578,0,0,0,1.0,1,1.0,1,1.0,1,0.25457740532066553,32
1714,1,5878,1299,4579,0,0,0,1.0,1,1.0,1,1.0,1,0.24116954449027098,32
1715,1,5879,1299,4580,0,0,0,1.0,1,1.0,1,1.0,1,0.2308061594462785,32
1716,2,5881,1299,4582,0,0,0,1.0,1,1.0,1,1.0,1,0.2378466801833928,34
1717,0,5881,1299,4582,0,0,0,1.0,1,1.0,1,1.0,1,0.2378466801833928,34
1718,3,5884,1299,4585,0,0,0,1.0,1,1.0,1,1.0,1,0.2514382111145236,34
1719,2,5886,1299,4587,0,0,0,1.0,1,1.0,1,1.0,1,0.2514382111145236,34
1720,3,5889,1300,4589,0,0,0,1.0,1,1.0,1,1.0,1,0.257864064399136,34
1721,1,5890,1300,4590,0,0,0,1.0,1,1.0,1,1.0,1,0.2290472974309265,35
1722,1,5891,1300,4591,0,0,0,1.0,1,1.0,1,1.0,1,0.23750871275203783,35
1723,1,5892,1300,4592,0,0,0,1.0,1,1.0,1,1.0,1,0.2418849928614436,34
1724,2,5894,1301,4593,0,0,0,1.0,1,1.0,1,1.0,1,0.21483526455276883,33
1725,3,5897,1302,4595,0,0,0,1.0,1,1.0,1,1.0,1,0.23397676198768652,35
1726,3,5900,1302,4598,0,0,0,1.0,1,1.0,1,1.0,1,0.15170935176827477,34
1727,2,5902,1303,4599,0,0,0,1.0,1,1.0,1,1.0,1,0.16074870038375844,34
1728,2,5904,1303,4601,0,0,0,1.0,1,1.0,1,1.0,1,0.11872192737024044,35
1729,0,5904,1303,4601,0,0,0,1.0,1,1.0,1,1.0,1,0.13540822458958537,35
1730,1,5905,1304,4601,0,0,0,1.0,1,1.0,1,1.0,1,0.16246871830781795,35
1731,1,5906,1305,4601,0,0,0,1.0,1,1.0,1,1.0,1,0.1908203659659449,35
1732,1,5907,1305,4602,0,0,0,1.0,1,1.0,1,1.0,1,0.16367290971971418,35
1733,2,5909,1305,4604,0,0,0,1.0,1,1.0,1,1.0,1,0.1951561497272543,33
1734,4,5913,1308,4605,0,0,0,1.0,1,1.0,1,1.0,1,0.23756522749323358,34
1735,1,5914,1308,4606,0,0,0,1.0,1,1.0,1,1.0,1,0.20759096941705904,33
1736,3,5917,1310,4607,0,0,0,1.0,1,1.0,1,1.0,1,0.24007973728541326,33
1737,3,5920,1310,4610,0,0,0,1.0,1,1.0,1,1.0,1,0.2270498432867531,35
1738,6,5926,1312,4614,0,0,0,1.0,1,1.0,1,1.0,1,0.20508166333211383,36
1739,5,5931,1313,4618,0,0,0,1.0,1,1.0,1,1.0,1,0.25135591242747335,36
1740,3,5934,1313,4621,0,0,0,1.0,1,1.0,1,1.0,1,0.21856166665693771,37
1741,4,5938,1313,4625,0,0,0,1.0,1,1.0,1,1.0,1,0.12705264743756262,36
1742,1,5939,1314,4625,0,0,0,1.0,1,1.0,1,1.0,1,0.13033408703733929,36
1743,4,5943,1315,4628,0,0,0,1.0,1,1.0,1,1.0,1,0.13120610762621635,37
1744,1,5944,1315,4629,0,0,0,1.0,1,1.0,1,1.0,1,0.13228126217092806,37
1745,9,5953,1319,4634,0,0,0,1.0,1,1.0,1,1.0,1,0.27642032976128494,38
1746,5,5958,1320,4638,0,0,0,1.0,1,1.0,1,1.0,1,0.2477245583399727,38
1747,1,5959,1320,4639,0,0,0,1.0,1,1.0,1,1.0,1,0.25665438098469456,37
1748,2,5961,1320,4641,0,0,0,1.0,1,1.0,1,1.0,1,0.25566223014157097,38
1749,3,5964,1321,4643,0,0,0,1.0,1,1.0,1,1.0,1,0.26817491403031735,38
1750,6,5970,1321,4649,0,0,0,1.0,1,1.0,1,1.0,1,0.23256248702032453,39
1751,5,5975,1321,4654,0,0,0,1.0,1,1.0,1,1.0,1,0.22134041118941022,41
1752,3,5978,1322,4656,0,0,0,1.0,1,1.0,1,1.0,1,0.21126820748738212,41
1753,2,5980,1323,4657,0,0,0,1.0,1,1.0,1,1.0,1,0.23114477991509955,41
1754,4,5984,1324,4660,0,0,0,1.0,1,1.0,1,1.0,1,0.20271577935784124,40
1755,3,5987,1325,4662,0,0,0,1.0,1,1.0,1,1.0,1,0.1767555274770497,41
1756,6,5993,1325,4668,0,0,0,1.0,1,1.0,1,1.0,1,0.12284654394174702,41
1757,1,5994,1325,4669,0,0,0,1.0,1,1.0,1,1.0,1,0.1412858008979219,40
1758,3,5997,1326,4671,0,0,0,1.0,1,1.0,1,1.0,1,0.16682297022086207,41
1759,2,5999,1326,4673,0,0,0,1.0,1,1.0,1,1.0,1,0.19110336868929184,38
1760,2,6001,1326,4675,0,0,0,1.0,1,1.0,1,1.0,1,0.1743058839169636,38
1761,7,6008,1328,4680,0,0,0,1.0,1,1.0,1,1.0,1,0.2397942628307848,37
1762,3,6011,1328,4683,0,0,0,1.0,1,1.0,1,1.0,1,0.18922849018665297,37
1763,6,6017,1331,4686,0,0,0,1.0,1,1.0,1,1.0,1,0.24333776887862826,37
1764,2,6019,1331,4688,0,0,0,1.0,1,1.0,1,1.0,1,0.23593519185028464,36
1765,5,6024,1332,4692,0,0,0,1.0,1,1.0,1,1.0,1,0.22848819367777623,36
1766,5,6029,1333,4696,0,0,0,1.0,1,1.0,1,1.0,1,0.24077334007379012,37
1767,5,6034,1335,4699,0,0,0,1.0,1,1.0,1,1.0,1,0.2366238844868556,37
1768,3,6037,1336,4701,0,0,0,1.0,1,1.0,1,1.0,1,0.2388834962711733,37
1769,2,6039,1337,4702,0,0,0,1.0,1,1.0,1,1.0,1,0.20388558934876336,38
1770,7,6046,1339,4707,0,0,0,1.0,1,1.0,1,1.0,1,0.25651811124978396,39
1771,3,6049,1339,4710,0,0,0,1.0,1,1.0,1,1.0,1,0.19769130440508736,39
1772,1,6050,1339,4711,0,0,0,1.0,1,1.0,1,1.0,1,0.1882681086412603,39
1773,1,6051,1340,4711,0,0,0,1.0,1,1.0,1,1.0,1,0.18940524326933275,41
1774,1,6052,1340,4712,0,0,0,1.0,1,1.0,1,1.0,1,0.1891143075618473,41
1775,0,6052,1340,4712,0,0,0,1.0,1,1.0,1,1.0,1,0.18504623842630794,42
1776,2,6054,1340,4714,0,0,0,1.0,1,1.0,1,1.0,1,0.16385385790924298,43
1777,0,6054,1340,4714,0,0,0,1.0,1,1.0,1,1.0,1,0.16385385790924298,43
1778,2,6056,1340,4716,0,0,0,1.0,1,1.0,1,1.0,1,0.1427504759385385,44
1779,3,6059,1340,4719,0,0,0,1.0,1,1.0,1,1.0,1,0.12906458655713,46
1780,0,6059,1340,4719,0,0,0,1.0,1,1.0,1,1.0,1,0.12906458655713,46
1781,0,6059,1340,4719,0,0,0,1.0,1,1.0,1,1.0,1,0.12906458655713,46
1782,1,6060,1341,4719,0,0,0,1.0,1,1.0,1,1.0,1,0.18151214356668904,46
1783,1,6061,1342,4719,0,0,0,1.0,1,1.0,1,1.0,1,0.17349266272561037,44
1784,4,6065,1343,4722,0,0,0,1.0,1,1.0,1,1.0,1,0.16893814079167577,45
1785,2,6067,1343,4724,0,0,0,1.0,1,1.0,1,1.0,1,0.15282953814775643,42
1786,9,6076,1347,4729,0,0,0,1.0,1,1.0,1,1.0,1,0.16660553870155562,43
1787,1,6077,1347,4730,0,0,0,1.0,1,1.0,1,1.0,1,0.14132945228245108,41
1788,3,6080,1348,4732,0,0,0,1.0,1,1.0,1,1.0,1,0.19535851070717622,41
1789,5,6085,1350,4735,0,0,0,1.0,1,1.0,1,1.0,1,0.22405334189954962,41
1790,3,6088,1351,4737,0,0,0,1.0,1,1.0,1,1.0,1,0.2263234023118989,41
1791,7,6095,1355,4740,0,0,0,1.0,1,1.0,1,1.0,1,0.22822467119415474,40
1792,5,6100,1356,4744,0,0,0,1.0,1,1.0,1,1.0,1,0.1997867454931987,40
1793,3,6103,1357,4746,0,0,0,1.0,1,1.0,1,1.0,1,0.2419200249518354,41
1794,4,6107,1359,4748,0,0,0,1.0,1,1.0,1,1.0,1,0.20649108828010335,41
1795,3,6110,1362,4748,0,0,0,1.0,1,1.0,1,1.0,1,0.26355211223025327,40
1796,6,6116,1363,4753,0,0,0,1.0,1,1.0,1,1.0,1,0.2436839945632505,40
1797,5,6121,1365,4756,0,0,0,1.0,1,1.0,1,1.0,1,0.2914608585003727,37
1798,4,6125,1366,4759,0,0,0,1.0,1,1.0,1,1.0,1,0.2882578329114229,37
1799,9,6134,1368,4766,0,0,0,1.0,1,1.0,1,1.0,1,0.32597180060622355,36
1800,3,6137,1368,4769,0,0,0,1.0,1,1.0,1,1.0,1,0.293097504407152,36
1801,4,6141,1368,4773,0,0,0,1.0,1,1.0,1,1.0,1,0.18761301336286143,34
1802,1,6142,1368,4774,0,0,0,1.0,1,1.0,1,1.0,1,0.18493720790635274,33
1803,4,6146,1368,4778,0,0,0,1.0,1,1.0,1,1.0,1,0.13487254819439048,33
1804,4,6150,1369,4781,0,0,0,1.0,1,1.0,1,1.0,1,0.15956900780490418,33
1805,2,6152,1369,4783,0,0,0,1.0,1,1.0,1,1.0,1,0.15183498270695725,35
1806,2,6154,1369,4785,0,0,0,1.0,1,1.0,1,1.0,1,0.15183498270695725,35
1807,4,6158,1369,4789,0,0,0,1.0,1,1.0,1,1.0,1,0.0918319819703477,35
1808,6,6164,1369,4795,0,0,0,1.0,1,1.0,1,1.0,1,0.12061752553273157,36
1809,1,6165,1369,4796,0,0,0,1.0,1,1.0,1,1.0,1,0.1467907581789518,36
1810,1,6166,1369,4797,0,0,0,1.0,1,1.0,1,1.0,1,0.14261532522937093,35
1811,2,6168,1369,4799,0,0,0,1.0,1,1.0,1,1.0,1,0.1983777438507719,36
1812,4,6172,1369,4803,0,0,0,1.0,1,1.0,1,1.0,1,0.19267222137803985,36
1813,4,6176,1370,4806,0,0,0,1.0,1,1.0,1,1.0,1,0.21859474128389828,36
1814,4,6180,1371,4809,0,0,0,1.0,1,1.0,1,1.0,1,0.27121435744105865,34
1815,8,6188,1371,4817,0,0,0,1.0,1,1.0,1,1.0,1,0.25654123001843654,35
1816,5,6193,1371,4822,0,0,0,1.0,1,1.0,1,1.0,1,0.21320837693865619,34
1817,3,6196,1372,4824,0,0,0,1.0,1,1.0,1,1.0,1,0.1552311965541386,34
1818,0,6196,1372,4824,0,0,0,1.0,1,1.0,1,1.0,1,0.1552311965541386,34
1819,4,6200,1373,4827,0,0,0,1.0,1,1.0,1,1.0,1,0.12295780757476808,35
1820,3,6203,1373,4830,0,0,0,1.0,1,1.0,1,1.0,1,0.13550246971870492,36
1821,2,6205,1373,4832,0,0,0,1.0,1,1.0,1,1.0,1,0.13550246971870492,36
1822,2,6207,1375,4832,0,0,0,1.0,1,1.0,1,1.0,1,0.19764835832945082,37
1823,6,6213,1377,4836,0,0,0,1.0,1,1.0,1,1.0,1,0.21283776587204795,38
1824,1,6214,1378,4836,0,0,0,1.0,1,1.0,1,1.0,1,0.237325414188845,37
1825,4,6218,1380,4838,0,0,0,1.0,1,1.0,1,1.0,1,0.23684134612472216,36
1826,1,6219,1381,4838,0,0,0,1.0,1,1.0,1,1.0,1,0.24387751960928092,35
1827,1,6220,1382,4838,0,0,0,1.0,1,1.0,1,1.0,1,0.2490317822407641,35
1828,3,6223,1383,4840,0,0,0,1.0,1,1.0,1,1.0,1,0.2625911536626474,33
1829,1,6224,1383,4841,0,0,0,1.0,1,1.0,1,1.0,1,0.2763134825122568,32
1830,3,6227,1384,4843,0,0,0,1.0,1,1.0,1,1.0,1,0.31858068465503275,32
1831,3,6230,1384,4846,0,0,0,1.0,1,1.0,1,1.0,1,0.3046083807397745,30
1832,1,6231,1384,4847,0,0,0,1.0,1,1.0,1,1.0,1,0.2901710340005472,30
1833,2,6233,1384,4849,0,0,0,1.0,1,1.0,1,1.0,1,0.2465133493748721,29
1834,1,6234,1385,4849,0,0,0,1.0,1,1.0,1,1.0,1,0.2668778257468469,28
1835,0,6234,1385,4849,0,0,0,1.0,1,1.0,1,1.0,1,0.25509449436035336,28
1836,2,6236,1385,4851,0,0,0,1.0,1,1.0,1,1.0,1,0.230044573646019,29
1837,0,6236,1385,4851,0,0,0,1.0,1,1.0,1,1.0,1,0.221705522317336,28
1838,0,6236,1385,4851,0,0,0,1.0,1,1.0,1,1.0,1,0.2060394882781635,28
1839,1,6237,1386,4851,0,0,0,1.0,1,1.0,1,1.0,1,0.3170758504231216,27
1840,2,6239,1386,4853,0,0,0,1.0,1,1.0,1,1.0,1,0.2720109644385952,26
1841,0,6239,1386,4853,0,0,0,1.0,1,1.0,1,1.0,1,0.2534352527405909,25
1842,4,6243,1387,4856,0,0,0,1.0,1,1.0,1,1.0,1,0.19536963042683028,26
1843,2,6245,1387,4858,0,0,0,1.0,1,1.0,1,1.0,1,0.19536963042683028,26
1844,5,6250,1387,4863,0,0,0,1.0,1,1.0,1,1.0,1,0.242902170659861,26
1845,3,6253,1388,4865,0,0,0,1.0,1,1.0,1,1.0,1,0.224292730205473,26
1846,3,6256,1388,4868,0,0,0,1.0,1,1.0,1,1.0,1,0.1260562727002316,26
1847,0,6256,1388,4868,0,0,0,1.0,1,1.0,1,1.0,1,0.1260562727002316,26
1848,1,6257,1389,4868,0,0,0,1.0,1,1.0,1,1.0,1,0.19130170946809347,27
1849,0,6257,1389,4868,0,0,0,1.0,1,1.0,1,1.0,1,0.19130170946809347,27
1850,3,6260,1390,4870,0,0,0,1.0,1,1.0,1,1.0,1,0.16592510876010097,28
1851,0,6260,1390,4870,0,0,0,1.0,1,1.0,1,1.0,1,0.16592510876010097,28
1852,0,6260,1390,4870,0,0,0,1.0,1,1.0,1,1.0,1,0.16592510876010097,28
1853,0,6260,1390,4870,0,0,0,1.0,1,1.0,1,1.0,1,0.19052365308979016,27
1854,1,6261,1390,4871,0,0,0,1.0,1,1.0,1,1.0,1,0.2114994437082943,28
1855,1,6262,1390,4872,0,0,0,1.0,1,1.0,1,1.0,1,0.20615522088305838,28
1856,5,6267,1391,4876,0,0,0,1.0,1,1.0,1,1.0,1,0.22106238560941904,30
1857,3,6270,1392,4878,0,0,0,1.0,1,1.0,1,1.0,1,0.2594676383473884,31
1858,4,6274,1393,4881,0,0,0,1.0,1,1.0,1,1.0,1,0.27026712681778503,31
1859,3,6277,1393,4884,0,0,0,1.0,1,1.0,1,1.0,1,0.2449547738624394,31
1860,2,6279,1393,4886,0,0,0,1.0,1,1.0,1,1.0,1,0.2449547738624394,31
1861,1,6280,1393,4887,0,0,0,1.0,1,1.0,1,1.0,1,0.22588464169821695,31
1862,1,6281,1394,4887,0,0,0,1.0,1,1.0,1,1.0,1,0.21526346765048074,31
1863,2,6283,1395,4888,0,0,0,1.0,1,1.0,1,1.0,1,0.22744167378280136,31
1864,2,6285,1397,4888,0,0,0,1.0,1,1.0,1,1.0,1,0.2527276024892138,30
1865,0,6285,1397,4888,0,0,0,1.0,1,1.0,1,1.0,1,0.24895969099349585,27
1866,4,6289,1400,4889,0,0,0,1.0,1,1.0,1,1.0,1,0.31914402093753597,28
1867,1,6290,1401,4889,0,0,0,1.0,1,1.0,1,1.0,1,0.31773854461860335,26
1868,0,6290,1401,4889,0,0,0,1.0,1,1.0,1,1.0,1,0.31773854461860335,26
1869,0,6290,1401,4889,0,0,0,1.0,1,1.0,1,1.0,1,0.31934543043077157,25
1870,2,6292,1402,4890,0,0,0,1.0,1,1.0,1,1.0,1,0.2996960217883671,25
1871,0,6292,1402,4890,0,0,0,1.0,1,1.0,1,1.0,1,0.3216897167946052,26
1872,0,6292,1402,4890,0,0,0,1.0,1,1.0,1,1.0,1,0.30726219870900146,25
1873,0,6292,1402,4890,0,0,0,1.0,1,1.0,1,1.0,1,0.3457011150590559,23
1874,1,6293,1403,4890,0,0,0,1.0,1,1.0,1,1.0,1,0.2763608668807789,23
1875,1,6294,1404,4890,0,0,0,1.0,1,1.0,1,1.0,1,0.38661084191900896,21
1876,6,6300,1405,4895,0,0,0,1.0,1,1.0,1,1.0,1,0.2813832349786841,24
1877,4,6304,1406,4898,0,0,0,1.0,1,1.0,1,1.0,1,0.28242466580061526,24
1878,4,6308,1407,4901,0,0,0,1.0,1,1.0,1,1.0,1,0.2301642062679794,26
1879,2,6310,1407,4903,0,0,0,1.0,1,1.0,1,1.0,1,0.2301642062679794,26
1880,2,6312,1407,4905,0,0,0,1.0,1,1.0,1,1.0,1,0.18934056596021817,26
1881,4,6316,1407,4909,0,0,0,1.0,1,1.0,1,1.0,1,0.2071858464168533,26
1882,2,6318,1407,4911,0,0,0,1.0,1,1.0,1,1.0,1,0.23071460901720983,25
1883,3,6321,1407,4914,0,0,0,1.0,1,1.0,1,1.0,1,0.22852204952258318,25
1884,5,6326,1407,4919,0,0,0,1.0,1,1.0,1,1.0,1,0.2236090865763422,25
1885,3,6329,1407,4922,0,0,0,1.0,1,1.0,1,1.0,1,0.22580164607096892,25
1886,3,6332,1407,4925,0,0,0,1.0,1,1.0,1,1.0,1,0.1989791854925851,26
1887,3,6335,1407,4928,0,0,0,1.0,1,1.0,1,1.0,1,0.20105822640826865,26
1888,6,6341,1408,4933,0,0,0,1.0,1,1.0,1,1.0,1,0.2358201070326046,27
1889,3,6344,1408,4936,0,0,0,1.0,1,1.0,1,1.0,1,0.24489599101665557,28
1890,2,6346,1408,4938,0,0,0,1.0,1,1.0,1,1.0,1,0.26209339546591814,28
1891,3,6349,1408,4941,0,0,0,1.0,1,1.0,1,1.0,1,0.21719386930555315,29
1892,0,6349,1408,4941,0,0,0,1.0,1,1.0,1,1.0,1,0.21719386930555315,29
1893,0,6349,1408,4941,0,0,0,1.0,1,1.0,1,1.0,1,0.21719386930555315,29
1894,0,6349,1408,4941,0,0,0,1.0,1,1.0,1,1.0,1,0.21719386930555315,29
1895,2,6351,1408,4943,0,0,0,1.0,1,1.0,1,1.0,1,0.2584490060281339,31
1896,1,6352,1408,4944,0,0,0,1.0,1,1.0,1,1.0,1,0.2431755484316038,31
1897,0,6352,1408,4944,0,0,0,1.0,1,1.0,1,1.0,1,0.2431755484316038,31
1898,0,6352,1408,4944,0,0,0,1.0,1,1.0,1,1.0,1,0.2431755484316038,31
1899,0,6352,1408,4944,0,0,0,1.0,1,1.0,1,1.0,1,0.22575468778989333,32
1900,0,6352,1408,4944,0,0,0,1.0,1,1.0,1,1.0,1,0.22575468778989333,32
1901,0,6352,1408,4944,0,0,0,1.0,1,1.0,1,1.0,1,0.22575468778989333,32
1902,1,6353,1408,4945,0,0,0,1.0,1,1.0,1,1.0,1,0.2222300577544763,32
1903,0,6353,1408,4945,0,0,0,1.0,1,1.0,1,1.0,1,0.2222300577544763,32
1904,2,6355,1408,4947,0,0,0,1.0,1,1.0,1,1.0,1,0.23404118109136793,34
1905,4,6359,1409,4950,0,0,0,1.0,1,1.0,1,1.0,1,0.24210335675090047,34
1906,4,6363,1409,4954,0,0,0,1.0,1,1.0,1,1.0,1,0.16725867841952027,35
1907,0,6363,1409,4954,0,0,0,1.0,1,1.0,1,1.0,1,0.1796542894544638,36
1908,1,6364,1409,4955,0,0,0,1.0,1,1.0,1,1.0,1,0.1642388933845604,36
1909,3,6367,1410,4957,0,0,0,1.0,1,1.0,1,1.0,1,0.1763413823127141,37
1910,3,6370,1411,4959,0,0,0,1.0,1,1.0,1,1.0,1,0.19025208504291496,38
1911,2,6372,1411,4961,0,0,0,1.0,1,1.0,1,1.0,1,0.11851779462939326,37
1912,1,6373,1412,4961,0,0,0,1.0,1,1.0,1,1.0,1,0.12636903053218113,37
1913,0,6373,1412,4961,0,0,0,1.0,1,1.0,1,1.0,1,0.13799825464939736,36
1914,0,6373,1412,4961,0,0,0,1.0,1,1.0,1,1.0,1,0.14309096825003473,37
1915,2,6375,1413,4962,0,0,0,1.0,1,1.0,1,1.0,1,0.1478805868564044,37
1916,0,6375,1413,4962,0,0,0,1.0,1,1.0,1,1.0,1,0.12521572411836124,39
1917,3,6378,1415,4963,0,0,0,1.0,1,1.0,1,1.0,1,0.17987016790723137,38
1918,1,6379,1415,4964,0,0,0,1.0,1,1.0,1,1.0,1,0.17255223728706132,38
1919,1,6380,1416,4964,0,0,0,1.0,1,1.0,1,1.0,1,0.2405340640455233,38
1920,1,6381,1416,4965,0,0,0,1.0,1,1.0,1,1.0,1,0.23802586740798487,39
1921,2,6383,1416,4967,0,0,0,1.0,1,1.0,1,1.0,1,0.18122119472292741,38
1922,3,6386,1418,4968,0,0,0,1.0,1,1.0,1,1.0,1,0.1740583656636841,39
1923,2,6388,1420,4968,0,0,0,1.0,1,1.0,1,1.0,1,0.23638243133749998,40
1924,2,6390,1420,4970,0,0,0,1.0,1,1.0,1,1.0,1,0.21953548348013566,40
1925,3,6393,1420,4973,0,0,0,1.0,1,1.0,1,1.0,1,0.22431510145335054,40
1926,0,6393,1420,4973,0,0,0,1.0,1,1.0,1,1.0,1,0.22431510145335054,40
1927,0,6393,1420,4973,0,0,0,1.0,1,1.0,1,1.0,1,0.19995639695706285,41
1928,2,6395,1421,4974,0,0,0,1.0,1,1.0,1,1.0,1,0.2120500839631191,41
1929,1,6396,1421,4975,0,0,0,1.0,1,1.0,1,1.0,1,0.15516730538023882,40
1930,1,6397,1422,4975,0,0,0,1.0,1,1.0,1,1.0,1,0.18853214782688088,40
1931,0,6397,1422,4975,0,0,0,1.0,1,1.0,1,1.0,1,0.18853214782688088,40
1932,0,6397,1422,4975,0,0,0,1.0,1,1.0,1,1.0,1,0.18853214782688088,40
1933,1,6398,1422,4976,0,0,0,1.0,1,1.0,1,1.0,1,0.1713088848375419,42
1934,3,6401,1422,4979,0,0,0,1.0,1,1.0,1,1.0,1,0.18134585687652532,44
1935,1,6402,1422,4980,0,0,0,1.0,1,1.0,1,1.0,1,0.17143467702401083,44
1936,6,6408,1423,4985,0,0,0,1.0,1,1.0,1,1.0,1,0.12115917163110232,46
1937,2,6410,1424,4986,0,0,0,1.0,1,1.0,1,1.0,1,0.11719614918726347,47
1938,3,6413,1424,4989,0,0,0,1.0,1,1.0,1,1.0,1,0.1282861398669262,47
1939,2,6415,1424,4991,0,0,0,1.0,1,1.0,1,1.0,1,0.11637047876703704,47
1940,2,6417,1424,4993,0,0,0,1.0,1,1.0,1,1.0,1,0.12395746383691884,47
1941,7,6424,1426,4998,0,0,0,1.0,1,1.0,1,1.0,1,0.11004338581509202,47
1942,5,6429,1427,5002,0,0,0,1.0,1,1.0,1,1.0,1,0.12528509263975876,49
1943,1,6430,1428,5002,0,0,0,1.0,1,1.0,1,1.0,1,0.09785327392925937,47
1944,1,6431,1429,5002,0,0,0,1.0,1,1.0,1,1.0,1,0.12862539340538698,47
1945,3,6434,1431,5003,0,0,0,1.0,1,1.0,1,1.0,1,0.14542841252612587,45
1946,5,6439,1432,5007,0,0,0,1.0,1,1.0,1,1.0,1,0.15542774422249928,45
1947,10,6449,1435,5014,0,0,0,1.0,1,1.0,1,1.0,1,0.1730381075122518,45
1948,2,6451,1435,5016,0,0,0,1.0,1,1.0,1,1.0,1,0.18656393329226012,45
1949,4,6455,1437,5018,0,0,0,1.0,1,1.0,1,1.0,1,0.19996180160928065,42
1950,6,6461,1440,5021,0,0,0,1.0,1,1.0,1,1.0,1,0.21863361415883814,42
1951,6,6467,1441,5026,0,0,0,1.0,1,1.0,1,1.0,1,0.21240954150935717,38
1952,3,6470,1442,5028,0,0,0,1.0,1,1.0,1,1.0,1,0.1256023737716552,36
1953,2,6472,1443,5029,0,0,0,1.0,1,1.0,1,1.0,1,0.18482069008511315,35
1954,1,6473,1443,5030,0,0,0,1.0,1,1.0,1,1.0,1,0.20145542880750286,32
1955,1,6474,1444,5030,0,0,0,1.0,1,1.0,1,1.0,1,0.21669852583870672,33
1956,1,6475,1445,5030,0,0,0,1.0,1,1.0,1,1.0,1,0.27460468729021226,31
1957,1,6476,1446,5030,0,0,0,1.0,1,1.0,1,1.0,1,0.2923220535837555,33
1958,7,6483,1448,5035,0,0,0,1.0,1,1.0,1,1.0,1,0.2806922978365857,34
1959,0,6483,1448,5035,0,0,0,1.0,1,1.0,1,1.0,1,0.28346004716710416,35
1960,2,6485,1449,5036,0,0,0,1.0,1,1.0,1,1.0,1,0.3387104117253638,36
1961,4,6489,1450,5039,0,0,0,1.0,1,1.0,1,1.0,1,0.24263164747874716,36
1962,0,6489,1450,5039,0,0,0,1.0,1,1.0,1,1.0,1,0.22668079817613332,35
1963,3,6492,1451,5041,0,0,0,1.0,1,1.0,1,1.0,1,0.25232117101587437,36
1964,4,6496,1453,5043,0,0,0,1.0,1,1.0,1,1.0,1,0.1844600163971499,35
1965,1,6497,1454,5043,0,0,0,1.0,1,1.0,1,1.0,1,0.14742661407235672,36
1966,1,6498,1455,5043,0,0,0,1.0,1,1.0,1,1.0,1,0.19535058557897494,36
1967,2,6500,1456,5044,0,0,0,1.0,1,1.0,1,1.0,1,0.19930393395903673,36
1968,1,6501,1456,5045,0,0,0,1.0,1,1.0,1,1.0,1,0.17784695215128524,37
1969,0,6501,1456,5045,0,0,0,1.0,1,1.0,1,1.0,1,0.17784695215128524,37
1970,1,6502,1457,5045,0,0,0,1.0,1,1.0,1,1.0,1,0.18774643877751843,38
1971,0,6502,1457,5045,0,0,0,1.0,1,1.0,1,1.0,1,0.2069065524782796,37
1972,1,6503,1458,5045,0,0,0,1.0,1,1.0,1,1.0,1,0.20665311826535815,37
1973,6,6509,1461,5048,0,0,0,1.0,1,1.0,1,1.0,1,0.24242952059944492,37
1974,5,6514,1461,5053,0,0,0,1.0,1,1.0,1,1.0,1,0.24937173067286567,38
1975,4,6518,1461,5057,0,0,0,1.0,1,1.0,1,1.0,1,0.2500265240236653,37
1976,3,6521,1462,5059,0,0,0,1.0,1,1.0,1,1.0,1,0.23625000329012055,39
1977,7,6528,1462,5066,0,0,0,1.0,1,1.0,1,1.0,1,0.1880998275908297,42
1978,3,6531,1463,5068,0,0,0,1.0,1,1.0,1,1.0,1,0.2147404266960662,42
1979,3,6534,1463,5071,0,0,0,1.0,1,1.0,1,1.0,1,0.18228827233046652,42
1980,4,6538,1463,5075,0,0,0,1.0,1,1.0,1,1.0,1,0.1877660276910389,43
1981,5,6543,1463,5080,0,0,0,1.0,1,1.0,1,1.0,1,0.09337196679220423,44
1982,0,6543,1463,5080,0,0,0,1.0,1,1.0,1,1.0,1,0.09337196679220423,44
1983,0,6543,1463,5080,0,0,0,1.0,1,1.0,1,1.0,1,0.09337196679220423,44
1984,1,6544,1464,5080,0,0,0,1.0,1,1.0,1,1.0,1,0.1268697006195,42
1985,0,6544,1464,5080,0,0,0,1.0,1,1.0,1,1.0,1,0.142243105300958,41
1986,1,6545,1465,5080,0,0,0,1.0,1,1.0,1,1.0,1,0.14782510922958664,40
1987,2,6547,1467,5080,0,0,0,1.0,1,1.0,1,1.0,1,0.13770538340683502,37
1988,5,6552,1471,5081,0,0,0,1.0,1,1.0,1,1.0,1,0.28017176504231495,35
1989,3,6555,1473,5082,0,0,0,1.0,1,1.0,1,1.0,1,0.34139719133801716,32
1990,0,6555,1473,5082,0,0,0,1.0,1,1.0,1,1.0,1,0.31596805891471125,31
1991,1,6556,1474,5082,0,0,0,1.0,1,1.0,1,1.0,1,0.31233534547474406,32
1992,2,6558,1475,5083,0,0,0,1.0,1,1.0,1,1.0,1,0.3038749424641853,32
1993,1,6559,1476,5083,0,0,0,1.0,1,1.0,1,1.0,1,0.31777478574270823,32
1994,1,6560,1477,5083,0,0,0,1.0,1,1.0,1,1.0,1,0.33518170166444117,31
1995,2,6562,1478,5084,0,0,0,1.0,1,1.0,1,1.0,1,0.36725434690264647,32
1996,7,6569,1478,5091,0,0,0,1.0,1,1.0,1,1.0,1,0.16959272417230986,32
1997,0,6569,1478,5091,0,0,0,1.0,1,1.0,1,1.0,1,0.1965711221049222,31
1998,0,6569,1478,5091,0,0,0,1.0,1,1.0,1,1.0,1,0.19460860077895062,32
1999,0,6569,1478,5091,0,0,0,1.0,1,1.0,1,1.0,1,0.1994862064325668,31
2000,0,6569,1478,5091,0,0,0,1.0,1,1.0,1,1.0,1,0.1730853189084158,30
2001,1,6570,1478,5092,0,0,0,1.0,1,1.0,1,1.0,1,0.16901066354380043,29
2002,2,6572,1478,5094,0,0,0,1.0,1,1.0,1,1.0,1,0.16845950977879626,31
2003,3,6575,1480,5095,0,0,0,1.0,1,1.0,1,1.0,1,0.16080711317736232,33
2004,6,6581,1481,5100,0,0,0,1.0,1,1.0,1,1.0,1,0.21298653347556623,34
2005,6,6587,1481,5106,0,0,0,1.0,1,1.0,1,1.0,1,0.23413975993487746,35
2006,5,6592,1482,5110,0,0,0,1.0,1,1.0,1,1.0,1,0.21457549854146418,36
2007,7,6599,1482,5117,0,0,0,1.0,1,1.0,1,1.0,1,0.19542745967244557,36
2008,7,6606,1483,5123,0,0,0,1.0,1,1.0,1,1.0,1,0.24322327556082876,36
2009,7,6613,1483,5130,0,0,0,1.0,1,1.0,1,1.0,1,0.2105809246222717,37
2010,8,6621,1484,5137,0,0,0,1.0,1,1.0,1,1.0,1,0.2013329379749772,37
2011,2,6623,1484,5139,0,0,0,1.0,1,1.0,1,1.0,1,0.15213414798183117,37
2012,1,6624,1484,5140,0,0,0,1.0,1,1.0,1,1.0,1,0.10442955076577466,37
2013,1,6625,1484,5141,0,0,0,1.0,1,1.0,1,1.0,1,0.11602556471804834,39
2014,2,6627,1484,5143,0,0,0,1.0,1,1.0,1,1.0,1,0.09017442930673294,39
2015,2,6629,1484,5145,0,0,0,1.0,1,1.0,1,1.0,1,0.11966567466072042,39
2016,2,6631,1484,5147,0,0,0,1.0,1,1.0,1,1.0,1,0.0830472883923381,41
2017,2,6633,1484,5149,0,0,0,1.0,1,1.0,1,1.0,1,0.08102502676814223,41
2018,4,6637,1485,5152,0,0,0,1.0,1,1.0,1,1.0,1,0.11341498333163078,42
2019,2,6639,1485,5154,0,0,0,1.0,1,1.0,1,1.0,1,0.09508234085411534,43
2020,3,6642,1487,5155,0,0,0,1.0,1,1.0,1,1.0,1,0.16640577215914473,43
2021,4,6646,1487,5159,0,0,0,1.0,1,1.0,1,1.0,1,0.11665982516334375,43
2022,3,6649,1487,5162,0,0,0,1.0,1,1.0,1,1.0,1,0.17903413585034325,44
2023,6,6655,1489,5166,0,0,0,1.0,1,1.0,1,1.0,1,0.21826497560225866,42
2024,3,6658,1490,5168,0,0,0,1.0,1,1.0,1,1.0,1,0.20582432419365515,41
2025,4,6662,1492,5170,0,0,0,1.0,1,1.0,1,1.0,1,0.21398079476163445,39
2026,5,6667,1493,5174,0,0,0,1.0,1,1.0,1,1.0,1,0.1868431499091025,39
2027,4,6671,1494,5177,0,0,0,1.0,1,1.0,1,1.0,1,0.20737052651551002,38
2028,2,6673,1494,5179,0,0,0,1.0,1,1.0,1,1.0,1,0.18851214256505447,37
2029,1,6674,1494,5180,0,0,0,1.0,1,1.0,1,1.0,1,0.13506993131074282,35
2030,1,6675,1495,5180,0,0,0,1.0,1,1.0,1,1.0,1,0.2234772489571969,32
2031,2,6677,1496,5181,0,0,0,1.0,1,1.0,1,1.0,1,0.2711236931290349,34
2032,3,6680,1496,5184,0,0,0,1.0,1,1.0,1,1.0,1,0.27638374045190583,35
2033,7,6687,1499,5188,0,0,0,1.0,1,1.0,1,1.0,1,0.3010418291041929,35
2034,2,6689,1499,5190,0,0,0,1.0,1,1.0,1,1.0,1,0.31628358574038057,35
2035,5,6694,1501,5193,0,0,0,1.0,1,1.0,1,1.0,1,0.2605294953935083,36
2036,4,6698,1501,5197,0,0,0,1.0,1,1.0,1,1.0,1,0.22677798560517345,35
2037,5,6703,1503,5200,0,0,0,1.0,1,1.0,1,1.0,1,0.2869835403879094,36
2038,2,6705,1504,5201,0,0,0,1.0,1,1.0,1,1.0,1,0.2384942076139134,38
2039,4,6709,1504,5205,0,0,0,1.0,1,1.0,1,1.0,1,0.24717887251694923,38
2040,3,6712,1504,5208,0,0,0,1.0,1,1.0,1,1.0,1,0.2589613126958989,37
2041,5,6717,1505,5212,0,0,0,1.0,1,1.0,1,1.0,1,0.2275878410748726,38
2042,2,6719,1505,5214,0,0,0,1.0,1,1.0,1,1.0,1,0.2275878410748726,38
2043,3,6722,1506,5216,0,0,0,1.0,1,1.0,1,1.0,1,0.2106957648052917,38
2044,3,6725,1506,5219,0,0,0,1.0,1,1.0,1,1.0,1,0.1763290401887968,39
2045,3,6728,1507,5221,0,0,0,1.0,1,1.0,1,1.0,1,0.1832199553857934,40
2046,5,6733,1507,5226,0,0,0,1.0,1,1.0,1,1.0,1,0.1324385105418868,41
2047,2,6735,1507,5228,0,0,0,1.0,1,1.0,1,1.0,1,0.1324385105418868,41
2048,5,6740,1507,5233,0,0,0,1.0,1,1.0,1,1.0,1,0.11374371384508208,43
2049,2,6742,1508,5234,0,0,0,1.0,1,1.0,1,1.0,1,0.13852374208180698,43
2050,1,6743,1508,5235,0,0,0,1.0,1,1.0,1,1.0,1,0.10840235210850838,43
2051,1,6744,1508,5236,0,0,0,1.0,1,1.0,1,1.0,1,0.142795481123938,43
2052,3,6747,1508,5239,0,0,0,1.0,1,1.0,1,1.0,1,0.1643655912025836,44
2053,5,6752,1509,5243,0,0,0,1.0,1,1.0,1,1.0,1,0.20446904782275463,43
2054,8,6760,1509,5251,0,0,0,1.0,1,1.0,1,1.0,1,0.21239959920329612,44
2055,7,6767,1509,5258,0,0,0,1.0,1,1.0,1,1.0,1,0.25909084402278443,43
2056,11,6778,1511,5267,0,0,0,1.0,1,1.0,1,1.0,1,0.1180485287770721,44
2057,3,6781,1511,5270,0,0,0,1.0,1,1.0,1,1.0,1,0.11361841383414802,44
2058,1,6782,1511,5271,0,0,0,1.0,1,1.0,1,1.0,1,0.10726814032657575,44
2059,1,6783,1511,5272,0,0,0,1.0,1,1.0,1,1.0,1,0.13250121032281245,45
2060,4,6787,1512,5275,0,0,0,1.0,1,1.0,1,1.0,1,0.1255687503546657,46
2061,5,6792,1513,5279,0,0,0,1.0,1,1.0,1,1.0,1,0.11050112172937386,48
2062,5,6797,1515,5282,0,0,0,1.0,1,1.0,1,1.0,1,0.10300704717883245,48
2063,2,6799,1515,5284,0,0,0,1.0,1,1.0,1,1.0,1,0.11683818827035429,45
2064,2,6801,1516,5285,0,0,0,1.0,1,1.0,1,1.0,1,0.09723041503549665,44
2065,1,6802,1517,5285,0,0,0,1.0,1,1.0,1,1.0,1,0.14544843846015482,42
2066,5,6807,1522,5285,0,0,0,1.0,1,1.0,1,1.0,1,0.13775619257049546,42
2067,2,6809,1523,5286,0,0,0,1.0,1,1.0,1,1.0,1,0.1656580979696238,38
2068,0,6809,1523,5286,0,0,0,1.0,1,1.0,1,1.0,1,0.18974297538052276,37
2069,1,6810,1524,5286,0,0,0,1.0,1,1.0,1,1.0,1,0.2035564765972814,35
2070,2,6812,1526,5286,0,0,0,1.0,1,1.0,1,1.0,1,0.1833772641853988,35
2071,3,6815,1527,5288,0,0,0,1.0,1,1.0,1,1.0,1,0.17789755566642756,34
2072,4,6819,1528,5291,0,0,0,1.0,1,1.0,1,1.0,1,0.1593840351104287,35
2073,2,6821,1528,5293,0,0,0,1.0,1,1.0,1,1.0,1,0.16081920639223365,37
2074,4,6825,1528,5297,0,0,0,1.0,1,1.0,1,1.0,1,0.0814184514409247,36
2075,3,6828,1528,5300,0,0,0,1.0,1,1.0,1,1.0,1,0.094543319021948,38
2076,0,6828,1528,5300,0,0,0,1.0,1,1.0,1,1.0,1,0.07484759606296404,37
2077,1,6829,1528,5301,0,0,0,1.0,1,1.0,1,1.0,1,0.0713013259994855,37
2078,3,6832,1529,5303,0,0,0,1.0,1,1.0,1,1.0,1,0.11282880581162578,37
2079,4,6836,1530,5306,0,0,0,1.0,1,1.0,1,1.0,1,0.12234238117611418,37
2080,1,6837,1531,5306,0,0,0,1.0,1,1.0,1,1.0,1,0.0897206106488248,36
2081,3,6840,1534,5306,0,0,0,1.0,1,1.0,1,1.0,1,0.1781418727266613,37
2082,8,6848,1536,5312,0,0,0,1.0,1,1.0,1,1.0,1,0.21062390322072722,38
2083,4,6852,1537,5315,0,0,0,1.0,1,1.0,1,1.0,1,0.2256208154693938,39
2084,7,6859,1538,5321,0,0,0,1.0,1,1.0,1,1.0,1,0.27348934268852393,41
2085,6,6865,1538,5327,0,0,0,1.0,1,1.0,1,1.0,1,0.27348934268852393,41
2086,8,6873,1538,5335,0,0,0,1.0,1,1.0,1,1.0,1,0.1359194239552733,44
2087,5,6878,1538,5340,0,0,0,1.0,1,1.0,1,1.0,1,0.16681025757551982,44
2088,2,6880,1538,5342,0,0,0,1.0,1,1.0,1,1.0,1,0.13076624467122877,45
2089,3,6883,1538,5345,0,0,0,1.0,1,1.0,1,1.0,1,0.13756377449432844,46
2090,3,6886,1538,5348,0,0,0,1.0,1,1.0,1,1.0,1,0.1498857829446841,47
2091,6,6892,1540,5352,0,0,0,1.0,1,1.0,1,1.0,1,0.12923101160097442,48
2092,1,6893,1541,5352,0,0,0,1.0,1,1.0,1,1.0,1,0.11433147756896608,48
2093,1,6894,1542,5352,0,0,0,1.0,1,1.0,1,1.0,1,0.1325422209108,48
2094,1,6895,1542,5353,0,0,0,1.0,1,1.0,1,1.0,1,0.1044035907682729,47
2095,3,6898,1542,5356,0,0,0,1.0,1,1.0,1,1.0,1,0.12146576703428079,49
2096,8,6906,1543,5363,0,0,0,1.0,1,1.0,1,1.0,1,0.13821621763612388,50
2097,4,6910,1543,5367,0,0,0,1.0,1,1.0,1,1.0,1,0.13990098174820642,50
2098,7,6917,1544,5373,0,0,0,1.0,1,1.0,1,1.0,1,0.1322153280320515,51
2099,1,6918,1544,5374,0,0,0,1.0,1,1.0,1,1.0,1,0.1121522299503663,50
2100,3,6921,1546,5375,0,0,0,1.0,1,1.0,1,1.0,1,0.12839285603402592,49
2101,4,6925,1546,5379,0,0,0,1.0,1,1.0,1,1.0,1,0.10575079722331245,48
2102,3,6928,1548,5380,0,0,0,1.0,1,1.0,1,1.0,1,0.17328544728455145,49
2103,1,6929,1548,5381,0,0,0,1.0,1,1.0,1,1.0,1,0.16063379409998968,44
2104,3,6932,1550,5382,0,0,0,1.0,1,1.0,1,1.0,1,0.17857236219866396,42
2105,3,6935,1551,5384,0,0,0,1.0,1,1.0,1,1.0,1,0.22099087290038738,40
2106,1,6936,1552,5384,0,0,0,1.0,1,1.0,1,1.0,1,0.2303024866182184,39
2107,1,6937,1553,5384,0,0,0,1.0,1,1.0,1,1.0,1,0.2147332751938605,37
2108,1,6938,1554,5384,0,0,0,1.0,1,1.0,1,1.0,1,0.2042183081073724,37
2109,3,6941,1556,5385,0,0,0,1.0,1,1.0,1,1.0,1,0.2226245142524407,36
2110,0,6941,1556,5385,0,0,0,1.0,1,1.0,1,1.0,1,0.23602950379533907,35
2111,1,6942,1557,5385,0,0,0,1.0,1,1.0,1,1.0,1,0.19599106118302603,35
2112,1,6943,1558,5385,0,0,0,1.0,1,1.0,1,1.0,1,0.2009081004694012,35
2113,1,6944,1559,5385,0,0,0,1.0,1,1.0,1,1.0,1,0.2184957962151577,35
2114,3,6947,1560,5387,0,0,0,1.0,1,1.0,1,1.0,1,0.2325798463080649,36
2115,2,6949,1560,5389,0,0,0,1.0,1,1.0,1,1.0,1,0.21640600768076232,37
2116,5,6954,1562,5392,0,0,0,1.0,1,1.0,1,1.0,1,0.15830351898117012,39
2117,3,6957,1562,5395,0,0,0,1.0,1,1.0,1,1.0,1,0.11118172357812556,39
2118,2,6959,1563,5396,0,0,0,1.0,1,1.0,1,1.0,1,0.1591419820352288,41
2119,4,6963,1564,5399,0,0,0,1.0,1,1.0,1,1.0,1,0.15701541419213744,42
2120,5,6968,1564,5404,0,0,0,1.0,1,1.0,1,1.0,1,0.12975762554940035,42
2121,3,6971,1565,5406,0,0,0,1.0,1,1.0,1,1.0,1,0.16258533281558718,42
2122,3,6974,1565,5409,0,0,0,1.0,1,1.0,1,1.0,1,0.13789198596932867,43
2123,4,6978,1565,5413,0,0,0,1.0,1,1.0,1,1.0,1,0.1251887515541925,42
2124,3,6981,1565,5416,0,0,0,1.0,1,1.0,1,1.0,1,0.13907389234582274,42
2125,1,6982,1565,5417,0,0,0,1.0,1,1.0,1,1.0,1,0.1494269442090627,41
2126,3,6985,1565,5420,0,0,0,1.0,1,1.0,1,1.0,1,0.17245027481203418,41
2127,4,6989,1565,5424,0,0,0,1.0,1,1.0,1,1.0,1,0.17245027481203418,41
2128,3,6992,1565,5427,0,0,0,1.0,1,1.0,1,1.0,1,0.15852367892050076,42
2129,4,6996,1565,5431,0,0,0,1.0,1,1.0,1,1.0,1,0.17465093778956614,43
2130,5,7001,1565,5436,0,0,0,1.0,1,1.0,1,1.0,1,0.17256183777441095,45
2131,7,7008,1566,5442,0,0,0,1.0,1,1.0,1,1.0,1,0.131665756751258,44
2132,2,7010,1566,5444,0,0,0,1.0,1,1.0,1,1.0,1,0.138367549909844,44
2133,6,7016,1567,5449,0,0,0,1.0,1,1.0,1,1.0,1,0.1506393092957968,45
2134,1,7017,1567,5450,0,0,0,1.0,1,1.0,1,1.0,1,0.15992661527485677,45
2135,3,7020,1567,5453,0,0,0,1.0,1,1.0,1,1.0,1,0.12254453524991019,46
2136,3,7023,1568,5455,0,0,0,1.0,1,1.0,1,1.0,1,0.12846296826116194,47
2137,3,7026,1570,5456,0,0,0,1.0,1,1.0,1,1.0,1,0.13458091770788405,47
2138,1,7027,1570,5457,0,0,0,1.0,1,1.0,1,1.0,1,0.16941423902229422,45
2139,5,7032,1572,5460,0,0,0,1.0,1,1.0,1,1.0,1,0.16540484876024306,45
2140,3,7035,1573,5462,0,0,0,1.0,1,1.0,1,1.0,1,0.1840468882457195,44
2141,3,7038,1573,5465,0,0,0,1.0,1,1.0,1,1.0,1,0.17494659205851978,45
2142,4,7042,1576,5466,0,0,0,1.0,1,1.0,1,1.0,1,0.12335757088952867,46
2143,2,7044,1578,5466,0,0,0,1.0,1,1.0,1,1.0,1,0.16002648455468996,46
2144,8,7052,1581,5471,0,0,0,1.0,1,1.0,1,1.0,1,0.17198782567727763,48
2145,4,7056,1582,5474,0,0,0,1.0,1,1.0,1,1.0,1,0.1451903621219275,46
2146,5,7061,1583,5478,0,0,0,1.0,1,1.0,1,1.0,1,0.06986339005423026,45
2147,3,7064,1585,5479,0,0,0,1.0,1,1.0,1,1.0,1,0.10688394160374963,44
2148,2,7066,1586,5480,0,0,0,1.0,1,1.0,1,1.0,1,0.15956237178666322,44
2149,6,7072,1589,5483,0,0,0,1.0,1,1.0,1,1.0,1,0.17614207119181668,42
2150,3,7075,1591,5484,0,0,0,1.0,1,1.0,1,1.0,1,0.17214907476349436,40
2151,0,7075,1591,5484,0,0,0,1.0,1,1.0,1,1.0,1,0.16512832517462567,39
2152,1,7076,1592,5484,0,0,0,1.0,1,1.0,1,1.0,1,0.22041526649267615,40
2153,7,7083,1594,5489,0,0,0,1.0,1,1.0,1,1.0,1,0.22972548964913397,42
2154,3,7086,1595,5491,0,0,0,1.0,1,1.0,1,1.0,1,0.23928856113945546,42
2155,1,7087,1596,5491,0,0,0,1.0,1,1.0,1,1.0,1,0.23478330130574804,41
2156,2,7089,1596,5493,0,0,0,1.0,1,1.0,1,1.0,1,0.19871921732613035,40
2157,2,7091,1597,5494,0,0,0,1.0,1,1.0,1,1.0,1,0.2251911988101802,40
2158,1,7092,1598,5494,0,0,0,1.0,1,1.0,1,1.0,1,0.2276228277295679,38
2159,0,7092,1598,5494,0,0,0,1.0,1,1.0,1,1.0,1,0.22840439857067227,38
2160,2,7094,1598,5496,0,0,0,1.0,1,1.0,1,1.0,1,0.22840439857067227,38
2161,7,7101,1599,5502,0,0,0,1.0,1,1.0,1,1.0,1,0.1197017406723493,38
2162,4,7105,1602,5503,0,0,0,1.0,1,1.0,1,1.0,1,0.14064407578004143,38
2163,2,7107,1602,5505,0,0,0,1.0,1,1.0,1,1.0,1,0.16447949238575932,40
2164,2,7109,1604,5505,0,0,0,1.0,1,1.0,1,1.0,1,0.16026636640519862,41
2165,2,7111,1605,5506,0,0,0,1.0,1,1.0,1,1.0,1,0.17507039252840959,42
2166,0,7111,1605,5506,0,0,0,1.0,1,1.0,1,1.0,1,0.17507039252840959,42
2167,1,7112,1605,5507,0,0,0,1.0,1,1.0,1,1.0,1,0.13147221900864925,43
2168,2,7114,1605,5509,0,0,0,1.0,1,1.0,1,1.0,1,0.148807747332062,43
2169,2,7116,1605,5511,0,0,0,1.0,1,1.0,1,1.0,1,0.16486041368684826,45
2170,2,7118,1606,5512,0,0,0,1.0,1,1.0,1,1.0,1,0.13312315384025766,46
2171,5,7123,1606,5517,0,0,0,1.0,1,1.0,1,1.0,1,0.1336129272101418,48
2172,5,7128,1606,5522,0,0,0,1.0,1,1.0,1,1.0,1,0.16855818721294624,49
2173,3,7131,1606,5525,0,0,0,1.0,1,1.0,1,1.0,1,0.15845662411827416,49
2174,6,7137,1609,5528,0,0,0,1.0,1,1.0,1,1.0,1,0.15497529790918738,49
2175,4,7141,1609,5532,0,0,0,1.0,1,1.0,1,1.0,1,0.13475946299503935,49
2176,2,7143,1609,5534,0,0,0,1.0,1,1.0,1,1.0,1,0.12793508092938172,51
2177,4,7147,1611,5536,0,0,0,1.0,1,1.0,1,1.0,1,0.11116182701991417,51
2178,5,7152,1612,5540,0,0,0,1.0,1,1.0,1,1.0,1,0.10848150717004576,50
2179,4,7156,1613,5543,0,0,0,1.0,1,1.0,1,1.0,1,0.10932561413628022,49
2180,0,7156,1613,5543,0,0,0,1.0,1,1.0,1,1.0,1,0.11784121236592038,47
2181,1,7157,1614,5543,0,0,0,1.0,1,1.0,1,1.0,1,0.1235394341740228,47
2182,2,7159,1615,5544,0,0,0,1.0,1,1.0,1,1.0,1,0.15460966059646156,45
2183,4,7163,1618,5545,0,0,0,1.0,1,1.0,1,1.0,1,0.19479914745644705,44
2184,4,7167,1620,5547,0,0,0,1.0,1,1.0,1,1.0,1,0.2271981987032145,43
2185,5,7172,1623,5549,0,0,0,1.0,1,1.0,1,1.0,1,0.21145341101261955,40
2186,1,7173,1624,5549,0,0,0,1.0,1,1.0,1,1.0,1,0.24733400065772335,38
2187,0,7173,1624,5549,0,0,0,1.0,1,1.0,1,1.0,1,0.24026199350284863,35
2188,1,7174,1625,5549,0,0,0,1.0,1,1.0,1,1.0,1,0.30394367633312597,34
2189,1,7175,1626,5549,0,0,0,1.0,1,1.0,1,1.0,1,0.325719012050975,31
2190,3,7178,1629,5549,0,0,0,1.0,1,1.0,1,1.0,1,0.3320153694027377,29
2191,8,7186,1630,5556,0,0,0,1.0,1,1.0,1,1.0,1,0.19922841162318158,28
2192,2,7188,1631,5557,0,0,0,1.0,1,1.0,1,1.0,1,0.1982489355099766,29
2193,0,7188,1631,5557,0,0,0,1.0,1,1.0,1,1.0,1,0.23709909078470479,28
2194,0,7188,1631,5557,0,0,0,1.0,1,1.0,1,1.0,1,0.24896063871627666,27
2195,2,7190,1633,5557,0,0,0,1.0,1,1.0,1,1.0,1,0.2946798036597524,27
2196,2,7192,1634,5558,0,0,0,1.0,1,1.0,1,1.0,1,0.3800875049607078,27
2197,0,7192,1634,5558,0,0,0,1.0,1,1.0,1,1.0,1,0.3800875049607078,27
2198,0,7192,1634,5558,0,0,0,1.0,1,1.0,1,1.0,1,0.35190045476683685,28
2199,5,7197,1634,5563,0,0,0,1.0,1,1.0,1,1.0,1,0.3274889108157546,29
2200,3,7200,1634,5566,0,0,0,1.0,1,1.0,1,1.0,1,0.3078107411043794,31
2201,3,7203,1635,5568,0,0,0,1.0,1,1.0,1,1.0,1,0.3134104324105321,32
2202,2,7205,1635,5570,0,0,0,1.0,1,1.0,1,1.0,1,0.30234798879843805,31
2203,5,7210,1635,5575,0,0,0,1.0,1,1.0,1,1.0,1,0.26533870122476866,32
2204,1,7211,1635,5576,0,0,0,1.0,1,1.0,1,1.0,1,0.26569848542301316,32
2205,2,7213,1636,5577,0,0,0,1.0,1,1.0,1,1.0,1,0.22878507502501552,33
2206,6,7219,1637,5582,0,0,0,1.0,1,1.0,1,1.0,1,0.17291870854090902,32
2207,2,7221,1637,5584,0,0,0,1.0,1,1.0,1,1.0,1,0.1792771288263482,33
2208,3,7224,1638,5586,0,0,0,1.0,1,1.0,1,1.0,1,0.2108288216079064,35
2209,5,7229,1639,5590,0,0,0,1.0,1,1.0,1,1.0,1,0.22188204203037742,36
2210,1,7230,1639,5591,0,0,0,1.0,1,1.0,1,1.0,1,0.24980878036394039,35
2211,1,7231,1639,5592,0,0,0,1.0,1,1.0,1,1.0,1,0.24228430897649283,36
2212,8,7239,1639,5600,0,0,0,1.0,1,1.0,1,1.0,1,0.2536704025542698,37
2213,4,7243,1640,5603,0,0,0,1.0,1,1.0,1,1.0,1,0.22780764758330374,37
2214,0,7243,1640,5603,0,0,0,1.0,1,1.0,1,1.0,1,0.2130126479576248,39
2215,2,7245,1641,5604,0,0,0,1.0,1,1.0,1,1.0,1,0.2552403785276071,36
2216,2,7247,1643,5604,0,0,0,1.0,1,1.0,1,1.0,1,0.31542582822033643,37
2217,5,7252,1646,5606,0,0,0,1.0,1,1.0,1,1.0,1,0.2849263922065294,35
2218,9,7261,1649,5612,0,0,0,1.0,1,1.0,1,1.0,1,0.32460489443998775,35
2219,4,7265,1649,5616,0,0,0,1.0,1,1.0,1,1.0,1,0.3125036356966571,33
2220,3,7268,1649,5619,0,0,0,1.0,1,1.0,1,1.0,1,0.3181546166588679,31
2221,7,7275,1650,5625,0,0,0,1.0,1,1.0,1,1.0,1,0.16030528616938333,31
2222,4,7279,1652,5627,0,0,0,1.0,1,1.0,1,1.0,1,0.19866764727900127,30
2223,1,7280,1653,5627,0,0,0,1.0,1,1.0,1,1.0,1,0.20731825695741538,28
2224,5,7285,1655,5630,0,0,0,1.0,1,1.0,1,1.0,1,0.2544834231687228,29
2225,6,7291,1657,5634,0,0,0,1.0,1,1.0,1,1.0,1,0.25082515127641153,28
2226,4,7295,1657,5638,0,0,0,1.0,1,1.0,1,1.0,1,0.24057968630590548,30
2227,4,7299,1658,5641,0,0,0,1.0,1,1.0,1,1.0,1,0.2951426024189721,28
2228,3,7302,1659,5643,0,0,0,1.0,1,1.0,1,1.0,1,0.2868582111036924,29
2229,3,7305,1660,5645,0,0,0,1.0,1,1.0,1,1.0,1,0.32370936523532107,28
2230,2,7307,1660,5647,0,0,0,1.0,1,1.0,1,1.0,1,0.323395297492839,28
2231,2,7309,1660,5649,0,0,0,1.0,1,1.0,1,1.0,1,0.2712724353616858,27
2232,1,7310,1660,5650,0,0,0,1.0,1,1.0,1,1.0,1,0.2669708110080281,27
2233,0,7310,1660,5650,0,0,0,1.0,1,1.0,1,1.0,1,0.2637348534080331,28
2234,5,7315,1664,5651,0,0,0,1.0,1,1.0,1,1.0,1,0.18237998630524732,26
2235,3,7318,1665,5653,0,0,0,1.0,1,1.0,1,1.0,1,0.1970591451367546,26
2236,3,7321,1666,5655,0,0,0,1.0,1,1.0,1,1.0,1,0.1272072279440888,26
2237,2,7323,1668,5655,0,0,0,1.0,1,1.0,1,1.0,1,0.14709111744472925,26
2238,4,7327,1671,5656,0,0,0,1.0,1,1.0,1,1.0,1,0.21496418307149076,27
2239,3,7330,1672,5658,0,0,0,1.0,1,1.0,1,1.0,1,0.2207233991020489,28
2240,3,7333,1674,5659,0,0,0,1.0,1,1.0,1,1.0,1,0.20005400787548722,30
2241,0,7333,1674,5659,0,0,0,1.0,1,1.0,1,1.0,1,0.24743035276210337,29
2242,1,7334,1674,5660,0,0,0,1.0,1,1.0,1,1.0,1,0.2508329364834155,29
2243,2,7336,1676,5660,0,0,0,1.0,1,1.0,1,1.0,1,0.2682906601827423,29
2244,1,7337,1676,5661,0,0,0,1.0,1,1.0,1,1.0,1,0.23445757428253547,29
2245,6,7343,1677,5666,0,0,0,1.0,1,1.0,1,1.0,1,0.2787304763634896,30
2246,2,7345,1677,5668,0,0,0,1.0,1,1.0,1,1.0,1,0.25953689921966877,33
2247,7,7352,1677,5675,0,0,0,1.0,1,1.0,1,1.0,1,0.2691921697006632,34
2248,7,7359,1677,5682,0,0,0,1.0,1,1.0,1,1.0,1,0.30014871395032694,34
2249,5,7364,1677,5687,0,0,0,1.0,1,1.0,1,1.0,1,0.2617731644786869,35
2250,4,7368,1677,5691,0,0,0,1.0,1,1.0,1,1.0,1,0.285826613646365,35
2251,6,7374,1678,5696,0,0,0,1.0,1,1.0,1,1.0,1,0.18729385530018425,36
2252,3,7377,1679,5698,0,0,0,1.0,1,1.0,1,1.0,1,0.18295774734954168,37
2253,2,7379,1680,5699,0,0,0,1.0,1,1.0,1,1.0,1,0.16049278927022503,35
2254,0,7379,1680,5699,0,0,0,1.0,1,1.0,1,1.0,1,0.18373468752680475,33
2255,2,7381,1680,5701,0,0,0,1.0,1,1.0,1,1.0,1,0.13914200558288778,35
2256,1,7382,1680,5702,0,0,0,1.0,1,1.0,1,1.0,1,0.17057588654738182,34
2257,1,7383,1681,5702,0,0,0,1.0,1,1.0,1,1.0,1,0.1260589663966231,36
2258,0,7383,1681,5702,0,0,0,1.0,1,1.0,1,1.0,1,0.15836706304029516,35
2259,1,7384,1682,5702,0,0,0,1.0,1,1.0,1,1.0,1,0.16629337483625417,35
2260,4,7388,1682,5706,0,0,0,1.0,1,1.0,1,1.0,1,0.1652360084333814,33
2261,3,7391,1683,5708,0,0,0,1.0,1,1.0,1,1.0,1,0.16187091893715763,33
2262,3,7394,1684,5710,0,0,0,1.0,1,1.0,1,1.0,1,0.24026558096599793,32
2263,2,7396,1686,5710,0,0,0,1.0,1,1.0,1,1.0,1,0.27172798888378497,31
2264,2,7398,1688,5710,0,0,0,1.0,1,1.0,1,1.0,1,0.3366578897004975,30
2265,3,7401,1688,5713,0,0,0,1.0,1,1.0,1,1.0,1,0.2305538201720388,29
2266,2,7403,1688,5715,0,0,0,1.0,1,1.0,1,1.0,1,0.16121341108866125,30
2267,2,7405,1690,5715,0,0,0,1.0,1,1.0,1,1.0,1,0.21003368781654658,29
2268,5,7410,1693,5717,0,0,0,1.0,1,1.0,1,1.0,1,0.23031469751519518,30
2269,4,7414,1696,5718,0,0,0,1.0,1,1.0,1,1.0,1,0.2871424217939677,31
2270,4,7418,1696,5722,0,0,0,1.0,1,1.0,1,1.0,1,0.23701598547480834,31
2271,2,7420,1697,5723,0,0,0,1.0,1,1.0,1,1.0,1,0.22788234024424187,31
2272,5,7425,1699,5726,0,0,0,1.0,1,1.0,1,1.0,1,0.25982010485653895,31
2273,0,7425,1699,5726,0,0,0,1.0,1,1.0,1,1.0,1,0.2663773731372191,30
2274,0,7425,1699,5726,0,0,0,1.0,1,1.0,1,1.0,1,0.26288827390140995,31
2275,1,7426,1699,5727,0,0,0,1.0,1,1.0,1,1.0,1,0.23731930804614795,32
2276,1,7427,1700,5727,0,0,0,1.0,1,1.0,1,1.0,1,0.25861575196435127,31
2277,1,7428,1700,5728,0,0,0,1.0,1,1.0,1,1.0,1,0.24626775230217657,31
2278,1,7429,1701,5728,0,0,0,1.0,1,1.0,1,1.0,1,0.26755811393774326,32
2279,0,7429,1701,5728,0,0,0,1.0,1,1.0,1,1.0,1,0.27321769553610425,32
2280,2,7431,1701,5730,0,0,0,1.0,1,1.0,1,1.0,1,0.27091343240701554,33
2281,8,7439,1701,5738,0,0,0,1.0,1,1.0,1,1.0,1,0.11260097501531065,34
2282,1,7440,1701,5739,0,0,0,1.0,1,1.0,1,1.0,1,0.12557579964427384,34
2283,0,7440,1701,5739,0,0,0,1.0,1,1.0,1,1.0,1,0.12557579964427384,34
2284,2,7442,1701,5741,0,0,0,1.0,1,1.0,1,1.0,1,0.13634472563917982,34
2285,2,7444,1701,5743,0,0,0,1.0,1,1.0,1,1.0,1,0.14194891750951086,35
2286,0,7444,1701,5743,0,0,0,1.0,1,1.0,1,1.0,1,0.15744306069245942,34
2287,1,7445,1702,5743,0,0,0,1.0,1,1.0,1,1.0,1,0.150855402908118,35
2288,1,7446,1702,5744,0,0,0,1.0,1,1.0,1,1.0,1,0.2213554409167144,35
2289,4,7450,1703,5747,0,0,0,1.0,1,1.0,1,1.0,1,0.24460148876796783,37
2290,5,7455,1704,5751,0,0,0,1.0,1,1.0,1,1.0,1,0.2701802261414918,37
2291,3,7458,1705,5753,0,0,0,1.0,1,1.0,1,1.0,1,0.28266646069266943,35
2292,4,7462,1705,5757,0,0,0,1.0,1,1.0,1,1.0,1,0.2896838965599769,35
2293,2,7464,1705,5759,0,0,0,1.0,1,1.0,1,1.0,1,0.26287306588598797,34
2294,5,7469,1705,5764,0,0,0,1.0,1,1.0,1,1.0,1,0.302740323637791,33
2295,6,7475,1705,5770,0,0,0,1.0,1,1.0,1,1.0,1,0.2782790224092875,34
2296,3,7478,1705,5773,0,0,0,1.0,1,1.0,1,1.0,1,0.21216758078285566,33
2297,4,7482,1706,5776,0,0,0,1.0,1,1.0,1,1.0,1,0.18006732261648614,32
2298,1,7483,1706,5777,0,0,0,1.0,1,1.0,1,1.0,1,0.19215451861304628,32
2299,0,7483,1706,5777,0,0,0,1.0,1,1.0,1,1.0,1,0.19580476110544703,33
2300,2,7485,1706,5779,0,0,0,1.0,1,1.0,1,1.0,1,0.16447049591640303,33
2301,0,7485,1706,5779,0,0,0,1.0,1,1.0,1,1.0,1,0.16447049591640303,33
2302,5,7490,1708,5782,0,0,0,1.0,1,1.0,1,1.0,1,0.19863170475587832,34
2303,6,7496,1711,5785,0,0,0,1.0,1,1.0,1,1.0,1,0.18252242102261393,34
2304,5,7501,1713,5788,0,0,0,1.0,1,1.0,1,1.0,1,0.14866918352106073,33
2305,3,7504,1714,5790,0,0,0,1.0,1,1.0,1,1.0,1,0.15856023038343622,33
2306,4,7508,1715,5793,0,0,0,1.0,1,1.0,1,1.0,1,0.2048557330138924,33
2307,3,7511,1716,5795,0,0,0,1.0,1,1.0,1,1.0,1,0.19178520562254142,35
2308,3,7514,1717,5797,0,0,0,1.0,1,1.0,1,1.0,1,0.2091620208428074,34
2309,4,7518,1719,5799,0,0,0,1.0,1,1.0,1,1.0,1,0.21476583828334384,34
2310,3,7521,1719,5802,0,0,0,1.0,1,1.0,1,1.0,1,0.18673936990983322,34
2311,4,7525,1720,5805,0,0,0,1.0,1,1.0,1,1.0,1,0.10032351017012522,35
2312,1,7526,1721,5805,0,0,0,1.0,1,1.0,1,1.0,1,0.11005622770353733,34
2313,4,7530,1722,5808,0,0,0,1.0,1,1.0,1,1.0,1,0.12361175237391464,35
2314,1,7531,1722,5809,0,0,0,1.0,1,1.0,1,1.0,1,0.09619611862209759,35
2315,0,7531,1722,5809,0,0,0,1.0,1,1.0,1,1.0,1,0.10550980666152444,34
2316,4,7535,1724,5811,0,0,0,1.0,1,1.0,1,1.0,1,0.16887672989675298,35
2317,1,7536,1724,5812,0,0,0,1.0,1,1.0,1,1.0,1,0.1869045751312611,32
2318,3,7539,1725,5814,0,0,0,1.0,1,1.0,1,1.0,1,0.21954300456779172,32
2319,2,7541,1726,5815,0,0,0,1.0,1,1.0,1,1.0,1,0.28160083010759945,32
2320,4,7545,1726,5819,0,0,0,1.0,1,1.0,1,1.0,1,0.29924772051383136,32
2321,5,7550,1726,5824,0,0,0,1.0,1,1.0,1,1.0,1,0.2838658469526735,33
2322,4,7554,1726,5828,0,0,0,1.0,1,1.0,1,1.0,1,0.2838658469526735,33
2323,4,7558,1727,5831,0,0,0,1.0,1,1.0,1,1.0,1,0.3278961813592617,33
2324,4,7562,1727,5835,0,0,0,1.0,1,1.0,1,1.0,1,0.2842871564074983,34
2325,5,7567,1727,5840,0,0,0,1.0,1,1.0,1,1.0,1,0.31483708507772473,35
2326,11,7578,1728,5850,0,0,0,1.0,1,1.0,1,1.0,1,0.12719337307818407,35
2327,2,7580,1728,5852,0,0,0,1.0,1,1.0,1,1.0,1,0.1349108782569558,36
2328,3,7583,1728,5855,0,0,0,1.0,1,1.0,1,1.0,1,0.1325210249720519,37
2329,3,7586,1728,5858,0,0,0,1.0,1,1.0,1,1.0,1,0.17096599402661755,37
2330,3,7589,1728,5861,0,0,0,1.0,1,1.0,1,1.0,1,0.19235702695070475,38
2331,3,7592,1728,5864,0,0,0,1.0,1,1.0,1,1.0,1,0.1931736478245126,40
2332,6,7598,1728,5870,0,0,0,1.0,1,1.0,1,1.0,1,0.19356410664091223,40
2333,3,7601,1728,5873,0,0,0,1.0,1,1.0,1,1.0,1,0.16157601119076914,41
2334,2,7603,1728,5875,0,0,0,1.0,1,1.0,1,1.0,1,0.15573934432276954,41
2335,4,7607,1728,5879,0,0,0,1.0,1,1.0,1,1.0,1,0.15573934432276954,41
2336,8,7615,1728,5887,0,0,0,1.0,1,1.0,1,1.0,1,0.153836792143234,41
2337,6,7621,1728,5893,0,0,0,1.0,1,1.0,1,1.0,1,0.14723253205990378,42
2338,6,7627,1728,5899,0,0,0,1.0,1,1.0,1,1.0,1,0.16437299874832387,43
2339,6,7633,1728,5905,0,0,0,1.0,1,1.0,1,1.0,1,0.1702832982041143,43
2340,7,7640,1728,5912,0,0,0,1.0,1,1.0,1,1.0,1,0.14751927398528894,45
2341,7,7647,1728,5919,0,0,0,1.0,1,1.0,1,1.0,1,0.09143814373289448,45
2342,7,7654,1728,5926,0,0,0,1.0,1,1.0,1,1.0,1,0.14654165011798623,46
2343,6,7660,1729,5931,0,0,0,1.0,1,1.0,1,1.0,1,0.1385086733739958,45
2344,7,7667,1731,5936,0,0,0,1.0,1,1.0,1,1.0,1,0.10977258406131626,44
2345,8,7675,1731,5944,0,0,0,1.0,1,1.0,1,1.0,1,0.166259437439804,44
2346,11,7686,1732,5954,0,0,0,1.0,1,1.0,1,1.0,1,0.1973795956156093,44
2347,9,7695,1733,5962,0,0,0,1.0,1,1.0,1,1.0,1,0.12023933170054073,44
2348,10,7705,1733,5972,0,0,0,1.0,1,1.0,1,1.0,1,0.12688921692137148,45
2349,12,7717,1733,5984,0,0,0,1.0,1,1.0,1,1.0,1,0.13120485105110918,46
2350,9,7726,1733,5993,0,0,0,1.0,1,1.0,1,1.0,1,0.23160769541050247,47
2351,9,7735,1733,6002,0,0,0,1.0,1,1.0,1,1.0,1,0.19827186716096298,47
2352,10,7745,1733,6012,0,0,0,1.0,1,1.0,1,1.0,1,0.19736621883546918,47
2353,7,7752,1733,6019,0,0,0,1.0,1,1.0,1,1.0,1,0.2154842746552966,46
2354,6,7758,1734,6024,0,0,0,1.0,1,1.0,1,1.0,1,0.1534010362093221,47
2355,9,7767,1734,6033,0,0,0,1.0,1,1.0,1,1.0,1,0.18889777208966615,47
2356,5,7772,1735,6037,0,0,0,1.0,1,1.0,1,1.0,1,0.1348361572398362,47
2357,2,7774,1735,6039,0,0,0,1.0,1,1.0,1,1.0,1,0.11380057249038855,47
2358,4,7778,1736,6042,0,0,0,1.0,1,1.0,1,1.0,1,0.15694526744051096,48
2359,3,7781,1736,6045,0,0,0,1.0,1,1.0,1,1.0,1,0.14164021924166048,49
2360,1,7782,1736,6046,0,0,0,1.0,1,1.0,1,1.0,1,0.14416583703598537,49
2361,4,7786,1736,6050,0,0,0,1.0,1,1.0,1,1.0,1,0.12499821689973328,50
2362,2,7788,1736,6052,0,0,0,1.0,1,1.0,1,1.0,1,0.1610969256694358,51
2363,4,7792,1736,6056,0,0,0,1.0,1,1.0,1,1.0,1,0.1610969256694358,51
2364,6,7798,1736,6062,0,0,0,1.0,1,1.0,1,1.0,1,0.12754590199363183,52
2365,9,7807,1739,6068,0,0,0,1.0,1,1.0,1,1.0,1,0.12899512140678726,53
2366,11,7818,1741,6077,0,0,0,1.0,1,1.0,1,1.0,1,0.17061440224519892,54
2367,8,7826,1742,6084,0,0,0,1.0,1,1.0,1,1.0,1,0.17231345782553636,52
2368,4,7830,1743,6087,0,0,0,1.0,1,1.0,1,1.0,1,0.13719067538622784,51
2369,4,7834,1743,6091,0,0,0,1.0,1,1.0,1,1.0,1,0.21331093697668096,51
2370,7,7841,1747,6094,0,0,0,1.0,1,1.0,1,1.0,1,0.1889294665618718,52
2371,18,7859,1750,6109,0,0,0,1.0,1,1.0,1,1.0,1,0.16589378604941946,52
2372,8,7867,1751,6116,0,0,0,1.0,1,1.0,1,1.0,1,0.18225145157789058,49
2373,9,7876,1752,6124,0,0,0,1.0,1,1.0,1,1.0,1,0.21819683897522857,47
2374,8,7884,1752,6132,0,0,0,1.0,1,1.0,1,1.0,1,0.22024094360512017,45
2375,6,7890,1752,6138,0,0,0,1.0,1,1.0,1,1.0,1,0.19595603526114122,45
2376,4,7894,1752,6142,0,0,0,1.0,1,1.0,1,1.0,1,0.23841915340531936,43
2377,7,7901,1752,6149,0,0,0,1.0,1,1.0,1,1.0,1,0.18325942469782566,44
2378,5,7906,1752,6154,0,0,0,1.0,1,1.0,1,1.0,1,0.21200904387432176,43
2379,2,7908,1752,6156,0,0,0,1.0,1,1.0,1,1.0,1,0.1763228288757543,43
2380,4,7912,1752,6160,0,0,0,1.0,1,1.0,1,1.0,1,0.21200904387432176,43
2381,6,7918,1755,6163,0,0,0,1.0,1,1.0,1,1.0,1,0.25960987765564003,44
2382,6,7924,1756,6168,0,0,0,1.0,1,1.0,1,1.0,1,0.24213908903109968,44
2383,6,7930,1757,6173,0,0,0,1.0,1,1.0,1,1.0,1,0.2596743872408699,45
2384,7,7937,1758,6179,0,0,0,1.0,1,1.0,1,1.0,1,0.1903519247149974,45
2385,3,7940,1758,6182,0,0,0,1.0,1,1.0,1,1.0,1,0.21695247607677687,45
2386,10,7950,1760,6190,0,0,0,1.0,1,1.0,1,1.0,1,0.1340267128910447,46
2387,3,7953,1761,6192,0,0,0,1.0,1,1.0,1,1.0,1,0.12387085856143451,44
2388,1,7954,1761,6193,0,0,0,1.0,1,1.0,1,1.0,1,0.11817906635445818,44
2389,2,7956,1761,6195,0,0,0,1.0,1,1.0,1,1.0,1,0.16397558490302908,43
2390,9,7965,1765,6200,0,0,0,1.0,1,1.0,1,1.0,1,0.10108021302414971,44
2391,2,7967,1766,6201,0,0,0,1.0,1,1.0,1,1.0,1,0.10940854504842831,43
2392,3,7970,1767,6203,0,0,0,1.0,1,1.0,1,1.0,1,0.16487536256850305,44
2393,2,7972,1768,6204,0,0,0,1.0,1,1.0,1,1.0,1,0.12620793459248297,45
2394,0,7972,1768,6204,0,0,0,1.0,1,1.0,1,1.0,1,0.15109569584870558,44
2395,1,7973,1768,6205,0,0,0,1.0,1,1.0,1,1.0,1,0.131130078835338,44
2396,2,7975,1770,6205,0,0,0,1.0,1,1.0,1,1.0,1,0.14769158693485224,45
2397,1,7976,1770,6206,0,0,0,1.0,1,1.0,1,1.0,1,0.14687679329736053,44
2398,2,7978,1771,6207,0,0,0,1.0,1,1.0,1,1.0,1,0.21065579630414488,44
2399,0,7978,1771,6207,0,0,0,1.0,1,1.0,1,1.0,1,0.21717785047309643,45
2400,2,7980,1771,6209,0,0,0,1.0,1,1.0,1,1.0,1,0.21717785047309643,45
2401,4,7984,1771,6213,0,0,0,1.0,1,1.0,1,1.0,1,0.16699393905182983,46
2402,2,7986,1771,6215,0,0,0,1.0,1,1.0,1,1.0,1,0.13595642305936453,47
2403,5,7991,1772,6219,0,0,0,1.0,1,1.0,1,1.0,1,0.11411102215723211,48
2404,4,7995,1773,6222,0,0,0,1.0,1,1.0,1,1.0,1,0.14348931571706564,47
2405,3,7998,1773,6225,0,0,0,1.0,1,1.0,1,1.0,1,0.1452474708634753,45
2406,5,8003,1774,6229,0,0,0,1.0,1,1.0,1,1.0,1,0.1290291999705384,45
2407,3,8006,1774,6232,0,0,0,1.0,1,1.0,1,1.0,1,0.1793270015241157,42
2408,6,8012,1774,6238,0,0,0,1.0,1,1.0,1,1.0,1,0.19434832267262334,41
2409,3,8015,1774,6241,0,0,0,1.0,1,1.0,1,1.0,1,0.23153706725650156,41
2410,7,8022,1774,6248,0,0,0,1.0,1,1.0,1,1.0,1,0.25051288283161827,40
2411,7,8029,1778,6251,0,0,0,1.0,1,1.0,1,1.0,1,0.2824146033180258,40
2412,5,8034,1780,6254,0,0,0,1.0,1,1.0,1,1.0,1,0.31762929419355024,38
2413,11,8045,1784,6261,0,0,0,1.0,1,1.0,1,1.0,1,0.33108513749782265,38
2414,5,8050,1785,6265,0,0,0,1.0,1,1.0,1,1.0,1,0.33312436849424,36
2415,4,8054,1785,6269,0,0,0,1.0,1,1.0,1,1.0,1,0.34857741318219737,36
2416,7,8061,1787,6274,0,0,0,1.0,1,1.0,1,1.0,1,0.26292190766059576,35
2417,1,8062,1787,6275,0,0,0,1.0,1,1.0,1,1.0,1,0.31408126901121725,33
2418,3,8065,1787,6278,0,0,0,1.0,1,1.0,1,1.0,1,0.2872628306886592,33
2419,2,8067,1788,6279,0,0,0,1.0,1,1.0,1,1.0,1,0.3040867623000251,33
2420,4,8071,1788,6283,0,0,0,1.0,1,1.0,1,1.0,1,0.2347831905395892,34
2421,3,8074,1788,6286,0,0,0,1.0,1,1.0,1,1.0,1,0.2225741515765305,34
2422,12,8086,1790,6296,0,0,0,1.0,1,1.0,1,1.0,1,0.23174342172808374,35
2423,7,8093,1791,6302,0,0,0,1.0,1,1.0,1,1.0,1,0.2518754658098722,36
2424,6,8099,1793,6306,0,0,0,1.0,1,1.0,1,1.0,1,0.22878101585145788,35
2425,4,8103,1794,6309,0,0,0,1.0,1,1.0,1,1.0,1,0.2042397271490205,33
2426,8,8111,1795,6316,0,0,0,1.0,1,1.0,1,1.0,1,0.2055316265391887,34
2427,5,8116,1796,6320,0,0,0,1.0,1,1.0,1,1.0,1,0.21366501060782897,34
2428,6,8122,1797,6325,0,0,0,1.0,1,1.0,1,1.0,1,0.2216814207417091,34
2429,4,8126,1797,6329,0,0,0,1.0,1,1.0,1,1.0,1,0.2107781870539294,34
2430,3,8129,1797,6332,0,0,0,1.0,1,1.0,1,1.0,1,0.2195959795318175,33
2431,3,8132,1798,6334,0,0,0,1.0,1,1.0,1,1.0,1,0.15764936353370054,33
2432,1,8133,1798,6335,0,0,0,1.0,1,1.0,1,1.0,1,0.1705950968426162,33
2433,1,8134,1799,6335,0,0,0,1.0,1,1.0,1,1.0,1,0.15458934215369977,34
2434,1,8135,1800,6335,0,0,0,1.0,1,1.0,1,1.0,1,0.12920390542506968,34
2435,0,8135,1800,6335,0,0,0,1.0,1,1.0,1,1.0,1,0.12920390542506968,34
2436,0,8135,1800,6335,0,0,0,1.0,1,1.0,1,1.0,1,0.12319061820235276,33
2437,2,8137,1801,6336,0,0,0,1.0,1,1.0,1,1.0,1,0.16026151191069435,33
2438,2,8139,1802,6337,0,0,0,1.0,1,1.0,1,1.0,1,0.1972265835391826,34
2439,4,8143,1802,6341,0,0,0,1.0,1,1.0,1,1.0,1,0.1584697460123731,35
2440,1,8144,1802,6342,0,0,0,1.0,1,1.0,1,1.0,1,0.14591512318935704,35
2441,2,8146,1804,6342,0,0,0,1.0,1,1.0,1,1.0,1,0.187810453047141,35
2442,3,8149,1804,6345,0,0,0,1.0,1,1.0,1,1.0,1,0.16213989303510723,35
2443,3,8152,1804,6348,0,0,0,1.0,1,1.0,1,1.0,1,0.1344721165547768,35
2444,3,8155,1805,6350,0,0,0,1.0,1,1.0,1,1.0,1,0.16254465644093022,34
2445,3,8158,1806,6352,0,0,0,1.0,1,1.0,1,1.0,1,0.24483651481596366,33
2446,5,8163,1807,6356,0,0,0,1.0,1,1.0,1,1.0,1,0.26668201803650926,30
2447,0,8163,1807,6356,0,0,0,1.0,1,1.0,1,1.0,1,0.24374474805041693,29
2448,1,8164,1808,6356,0,0,0,1.0,1,1.0,1,1.0,1,0.3035954596738678,27
2449,1,8165,1808,6357,0,0,0,1.0,1,1.0,1,1.0,1,0.265987352686175,26
2450,4,8169,1810,6359,0,0,0,1.0,1,1.0,1,1.0,1,0.2239760955682474,28
2451,3,8172,1810,6362,0,0,0,1.0,1,1.0,1,1.0,1,0.19600455416657536,28
2452,0,8172,1810,6362,0,0,0,1.0,1,1.0,1,1.0,1,0.22203904312127418,29
2453,1,8173,1811,6362,0,0,0,1.0,1,1.0,1,1.0,1,0.1914638884230351,30
2454,0,8173,1811,6362,0,0,0,1.0,1,1.0,1,1.0,1,0.20619941558968738,32
2455,2,8175,1813,6362,0,0,0,1.0,1,1.0,1,1.0,1,0.2102860261919978,33
2456,3,8178,1814,6364,0,0,0,1.0,1,1.0,1,1.0,1,0.1988200211633615,34
2457,1,8179,1815,6364,0,0,0,1.0,1,1.0,1,1.0,1,0.1823810732128723,34
2458,4,8183,1815,6368,0,0,0,1.0,1,1.0,1,1.0,1,0.16951967188972045,36
2459,1,8184,1815,6369,0,0,0,1.0,1,1.0,1,1.0,1,0.19310419024846995,36
2460,3,8187,1817,6370,0,0,0,1.0,1,1.0,1,1.0,1,0.2521758287060612,37
2461,6,8193,1818,6375,0,0,0,1.0,1,1.0,1,1.0,1,0.1246964038132585,37
2462,2,8195,1820,6375,0,0,0,1.0,1,1.0,1,1.0,1,0.19040607350369917,38
2463,1,8196,1820,6376,0,0,0,1.0,1,1.0,1,1.0,1,0.1307959238248867,38
2464,0,8196,1820,6376,0,0,0,1.0,1,1.0,1,1.0,1,0.11756915522092216,37
2465,1,8197,1821,6376,0,0,0,1.0,1,1.0,1,1.0,1,0.10242724036471278,36
2466,5,8202,1825,6377,0,0,0,1.0,1,1.0,1,1.0,1,0.24013665861809036,36
2467,2,8204,1826,6378,0,0,0,1.0,1,1.0,1,1.0,1,0.19727460498654328,34
2468,2,8206,1827,6379,0,0,0,1.0,1,1.0,1,1.0,1,0.2127339660995037,33
2469,2,8208,1828,6380,0,0,0,1.0,1,1.0,1,1.0,1,0.20520669922397772,32
2470,5,8213,1830,6383,0,0,0,1.0,1,1.0,1,1.0,1,0.2545737929833516,33
2471,3,8216,1830,6386,0,0,0,1.0,1,1.0,1,1.0,1,0.24870795450283814,31
2472,3,8219,1831,6388,0,0,0,1.0,1,1.0,1,1.0,1,0.2811236770766864,32
2473,2,8221,1832,6389,0,0,0,1.0,1,1.0,1,1.0,1,0.25093095196306286,31
2474,4,8225,1833,6392,0,0,0,1.0,1,1.0,1,1.0,1,0.30505784830842136,33
2475,2,8227,1834,6393,0,0,0,1.0,1,1.0,1,1.0,1,0.2666198525468009,33
2476,5,8232,1835,6397,0,0,0,1.0,1,1.0,1,1.0,1,0.12110482478665009,33
2477,5,8237,1836,6401,0,0,0,1.0,1,1.0,1,1.0,1,0.14378261674121076,33
2478,2,8239,1837,6402,0,0,0,1.0,1,1.0,1,1.0,1,0.14441935112299686,33
2479,8,8247,1839,6408,0,0,0,1.0,1,1.0,1,1.0,1,0.20272948429133938,33
2480,7,8254,1840,6414,0,0,0,1.0,1,1.0,1,1.0,1,0.2377934404711162,34
2481,4,8258,1840,6418,0,0,0,1.0,1,1.0,1,1.0,1,0.3168798074481137,33
2482,5,8263,1840,6423,0,0,0,1.0,1,1.0,1,1.0,1,0.3402464351533852,34
2483,3,8266,1840,6426,0,0,0,1.0,1,1.0,1,1.0,1,0.29842953570286634,33
2484,5,8271,1840,6431,0,0,0,1.0,1,1.0,1,1.0,1,0.3045848766057418,32
2485,3,8274,1841,6433,0,0,0,1.0,1,1.0,1,1.0,1,0.34845757944011696,31
2486,4,8278,1843,6435,0,0,0,1.0,1,1.0,1,1.0,1,0.26586280119098665,29
2487,3,8281,1844,6437,0,0,0,1.0,1,1.0,1,1.0,1,0.27484912157895247,29
2488,4,8285,1845,6440,0,0,0,1.0,1,1.0,1,1.0,1,0.3183137554760416,30
2489,3,8288,1845,6443,0,0,0,1.0,1,1.0,1,1.0,1,0.29583407912439885,29
2490,3,8291,1846,6445,0,0,0,1.0,1,1.0,1,1.0,1,0.32605066746233613,30
2491,4,8295,1846,6449,0,0,0,1.0,1,1.0,1,1.0,1,0.2075533298579879,30
2492,1,8296,1846,6450,0,0,0,1.0,1,1.0,1,1.0,1,0.22952407647830383,29
2493,1,8297,1846,6451,0,0,0,1.0,1,1.0,1,1.0,1,0.22367878229610605,29
2494,2,8299,1846,6453,0,0,0,1.0,1,1.0,1,1.0,1,0.25505466605706845,28
2495,1,8300,1846,6454,0,0,0,1.0,1,1.0,1,1.0,1,0.2504789156936575,29
2496,1,8301,1846,6455,0,0,0,1.0,1,1.0,1,1.0,1,0.24721040387325904,28
2497,3,8304,1846,6458,0,0,0,1.0,1,1.0,1,1.0,1,0.24386288079311055,28
2498,2,8306,1846,6460,0,0,0,1.0,1,1.0,1,1.0,1,0.2079490325420159,29
2499,4,8310,1846,6464,0,0,0,1.0,1,1.0,1,1.0,1,0.2662775516052262,30
2500,5,8315,1846,6469,0,0,0,1.0,1,1.0,1,1.0,1,0.24809250949336692,29
2501,4,8319,1848,6471,0,0,0,1.0,1,1.0,1,1.0,1,0.20207334692175788,33
2502,8,8327,1850,6477,0,0,0,1.0,1,1.0,1,1.0,1,0.264394786001637,33
2503,7,8334,1851,6483,0,0,0,1.0,1,1.0,1,1.0,1,0.22381846754816187,31
2504,6,8340,1854,6486,0,0,0,1.0,1,1.0,1,1.0,1,0.26973890009366985,31
2505,3,8343,1855,6488,0,0,0,1.0,1,1.0,1,1.0,1,0.253645453739707,32
2506,5,8348,1857,6491,0,0,0,1.0,1,1.0,1,1.0,1,0.22321508448936145,31
2507,3,8351,1859,6492,0,0,0,1.0,1,1.0,1,1.0,1,0.19090731062945224,29
2508,6,8357,1862,6495,0,0,0,1.0,1,1.0,1,1.0,1,0.1819688626069528,31
2509,2,8359,1863,6496,0,0,0,1.0,1,1.0,1,1.0,1,0.16310222418419904,30
2510,4,8363,1863,6500,0,0,0,1.0,1,1.0,1,1.0,1,0.15695344968238983,31
2511,3,8366,1864,6502,0,0,0,1.0,1,1.0,1,1.0,1,0.13735184552607277,32
2512,2,8368,1864,6504,0,0,0,1.0,1,1.0,1,1.0,1,0.13735184552607277,32
2513,6,8374,1865,6509,0,0,0,1.0,1,1.0,1,1.0,1,0.11116512239612897,34
2514,1,8375,1865,6510,0,0,0,1.0,1,1.0,1,1.0,1,0.13956665105597796,35
2515,5,8380,1866,6514,0,0,0,1.0,1,1.0,1,1.0,1,0.15247998553207193,35
2516,8,8388,1867,6521,0,0,0,1.0,1,1.0,1,1.0,1,0.19564045842743513,34
2517,5,8393,1868,6525,0,0,0,1.0,1,1.0,1,1.0,1,0.20196526662018652,34
2518,4,8397,1870,6527,0,0,0,1.0,1,1.0,1,1.0,1,0.24276702068837222,33
2519,6,8403,1870,6533,0,0,0,1.0,1,1.0,1,1.0,1,0.1904460412943146,32
2520,6,8409,1872,6537,0,0,0,1.0,1,1.0,1,1.0,1,0.22571794721001706,31
2521,2,8411,1872,6539,0,0,0,1.0,1,1.0,1,1.0,1,0.13960647967952042,31
2522,0,8411,1872,6539,0,0,0,1.0,1,1.0,1,1.0,1,0.13698822957604356,30
2523,0,8411,1872,6539,0,0,0,1.0,1,1.0,1,1.0,1,0.14275959622077436,30
2524,0,8411,1872,6539,0,0,0,1.0,1,1.0,1,1.0,1,0.1907157162042864,29
2525,2,8413,1873,6540,0,0,0,1.0,1,1.0,1,1.0,1,0.20439626288403476,29
2526,0,8413,1873,6540,0,0,0,1.0,1,1.0,1,1.0,1,0.20266211486262314,27
2527,0,8413,1873,6540,0,0,0,1.0,1,1.0,1,1.0,1,0.22906714690714355,28
2528,0,8413,1873,6540,0,0,0,1.0,1,1.0,1,1.0,1,0.22906714690714355,28
2529,0,8413,1873,6540,0,0,0,1.0,1,1.0,1,1.0,1,0.22906714690714355,28
2530,0,8413,1873,6540,0,0,0,1.0,1,1.0,1,1.0,1,0.23785593696262194,29
2531,2,8415,1873,6542,0,0,0,1.0,1,1.0,1,1.0,1,0.17937893860753265,30
2532,1,8416,1873,6543,0,0,0,1.0,1,1.0,1,1.0,1,0.17079381129563828,31
2533,0,8416,1873,6543,0,0,0,1.0,1,1.0,1,1.0,1,0.17079381129563828,31
2534,0,8416,1873,6543,0,0,0,1.0,1,1.0,1,1.0,1,0.17079381129563828,31
2535,1,8417,1874,6543,0,0,0,1.0,1,1.0,1,1.0,1,0.24078602717912595,31
2536,2,8419,1874,6545,0,0,0,1.0,1,1.0,1,1.0,1,0.22604124811899554,32
2537,2,8421,1875,6546,0,0,0,1.0,1,1.0,1,1.0,1,0.16371026568629773,33
2538,1,8422,1875,6547,0,0,0,1.0,1,1.0,1,1.0,1,0.1882239839007943,35
2539,2,8424,1876,6548,0,0,0,1.0,1,1.0,1,1.0,1,0.19180991721253135,37
2540,3,8427,1878,6549,0,0,0,1.0,1,1.0,1,1.0,1,0.21705627468587363,38
2541,6,8433,1879,6554,0,0,0,1.0,1,1.0,1,1.0,1,0.20941138446523125,39
2542,11,8444,1880,6564,0,0,0,1.0,1,1.0,1,1.0,1,0.17722461986590435,38
2543,6,8450,1883,6567,0,0,0,1.0,1,1.0,1,1.0,1,0.18628899485438982,41
2544,4,8454,1883,6571,0,0,0,1.0,1,1.0,1,1.0,1,0.1265014880300306,39
2545,5,8459,1884,6575,0,0,0,1.0,1,1.0,1,1.0,1,0.11848051296828024,40
2546,2,8461,1885,6576,0,0,0,1.0,1,1.0,1,1.0,1,0.1640954682889028,38
2547,5,8466,1887,6579,0,0,0,1.0,1,1.0,1,1.0,1,0.15195665150336912,38
2548,0,8466,1887,6579,0,0,0,1.0,1,1.0,1,1.0,1,0.19924183509217744,35
2549,3,8469,1889,6580,0,0,0,1.0,1,1.0,1,1.0,1,0.23664854795760568,35
2550,1,8470,1890,6580,0,0,0,1.0,1,1.0,1,1.0,1,0.25846704942726995,33
2551,5,8475,1891,6584,0,0,0,1.0,1,1.0,1,1.0,1,0.16585757449877087,31
2552,0,8475,1891,6584,0,0,0,1.0,1,1.0,1,1.0,1,0.14749561193110117,30
2553,0,8475,1891,6584,0,0,0,1.0,1,1.0,1,1.0,1,0.14749561193110117,30
2554,0,8475,1891,6584,0,0,0,1.0,1,1.0,1,1.0,1,0.1496448636377672,32
2555,1,8476,1891,6585,0,0,0,1.0,1,1.0,1,1.0,1,0.14809464017521226,32
2556,1,8477,1892,6585,0,0,0,1.0,1,1.0,1,1.0,1,0.16020558436522914,32
2557,1,8478,1893,6585,0,0,0,1.0,1,1.0,1,1.0,1,0.20281109916199738,30
2558,1,8479,1894,6585,0,0,0,1.0,1,1.0,1,1.0,1,0.2025628348532642,31
2559,0,8479,1894,6585,0,0,0,1.0,1,1.0,1,1.0,1,0.22935889172222645,30
2560,0,8479,1894,6585,0,0,0,1.0,1,1.0,1,1.0,1,0.22935889172222645,30
2561,0,8479,1894,6585,0,0,0,1.0,1,1.0,1,1.0,1,0.22935889172222645,30
2562,3,8482,1894,6588,0,0,0,1.0,1,1.0,1,1.0,1,0.16807733249823995,33
2563,3,8485,1894,6591,0,0,0,1.0,1,1.0,1,1.0,1,0.15623742342123462,33
2564,2,8487,1894,6593,0,0,0,1.0,1,1.0,1,1.0,1,0.16041409606186488,33
2565,1,8488,1894,6594,0,0,0,1.0,1,1.0,1,1.0,1,0.15997293797115267,33
2566,1,8489,1894,6595,0,0,0,1.0,1,1.0,1,1.0,1,0.13443624174620655,35
2567,1,8490,1895,6595,0,0,0,1.0,1,1.0,1,1.0,1,0.14493255112293021,36
2568,1,8491,1896,6595,0,0,0,1.0,1,1.0,1,1.0,1,0.22265554684807926,37
2569,4,8495,1896,6599,0,0,0,1.0,1,1.0,1,1.0,1,0.1183443349180803,37
2570,0,8495,1896,6599,0,0,0,1.0,1,1.0,1,1.0,1,0.14981367535009402,37
2571,0,8495,1896,6599,0,0,0,1.0,1,1.0,1,1.0,1,0.14981367535009402,37
2572,0,8495,1896,6599,0,0,0,1.0,1,1.0,1,1.0,1,0.12755932626127278,39
2573,1,8496,1896,6600,0,0,0,1.0,1,1.0,1,1.0,1,0.09792405932083917,39
2574,1,8497,1896,6601,0,0,0,1.0,1,1.0,1,1.0,1,0.14053164264659157,38
2575,2,8499,1897,6602,0,0,0,1.0,1,1.0,1,1.0,1,0.12596208283773977,38
2576,1,8500,1897,6603,0,0,0,1.0,1,1.0,1,1.0,1,0.14673392064324683,37
2577,3,8503,1898,6605,0,0,0,1.0,1,1.0,1,1.0,1,0.22944478038320706,39
2578,3,8506,1898,6608,0,0,0,1.0,1,1.0,1,1.0,1,0.21682512248223126,40
2579,2,8508,1898,6610,0,0,0,1.0,1,1.0,1,1.0,1,0.2085529915443899,41
2580,4,8512,1898,6614,0,0,0,1.0,1,1.0,1,1.0,1,0.1741095098944363,42
2581,4,8516,1898,6618,0,0,0,1.0,1,1.0,1,1.0,1,0.11605055307223283,43
2582,1,8517,1899,6618,0,0,0,1.0,1,1.0,1,1.0,1,0.1275134455752293,43
2583,3,8520,1900,6620,0,0,0,1.0,1,1.0,1,1.0,1,0.13076467681498521,43
2584,2,8522,1900,6622,0,0,0,1.0,1,1.0,1,1.0,1,0.13245618657961186,43
2585,5,8527,1900,6627,0,0,0,1.0,1,1.0,1,1.0,1,0.10007314747979822,44
2586,3,8530,1901,6629,0,0,0,1.0,1,1.0,1,1.0,1,0.11375003648818482,43
2587,8,8538,1905,6633,0,0,0,1.0,1,1.0,1,1.0,1,0.18510980611381941,44
2588,6,8544,1905,6639,0,0,0,1.0,1,1.0,1,1.0,1,0.17979544953675916,44
2589,5,8549,1907,6642,0,0,0,1.0,1,1.0,1,1.0,1,0.1649324401798068,44
2590,0,8549,1907,6642,0,0,0,1.0,1,1.0,1,1.0,1,0.1649324401798068,44
2591,0,8549,1907,6642,0,0,0,1.0,1,1.0,1,1.0,1,0.1649324401798068,44
2592,0,8549,1907,6642,0,0,0,1.0,1,1.0,1,1.0,1,0.1649324401798068,44
2593,0,8549,1907,6642,0,0,0,1.0,1,1.0,1,1.0,1,0.14867107621193287,43
2594,8,8557,1909,6648,0,0,0,1.0,1,1.0,1,1.0,1,0.149246315099595,48
2595,4,8561,1909,6652,0,0,0,1.0,1,1.0,1,1.0,1,0.13894639258681182,45
2596,2,8563,1910,6653,0,0,0,1.0,1,1.0,1,1.0,1,0.0993359429960195,46
2597,0,8563,1910,6653,0,0,0,1.0,1,1.0,1,1.0,1,0.1106249565992819,45
2598,1,8564,1911,6653,0,0,0,1.0,1,1.0,1,1.0,1,0.09529735737110745,45
2599,5,8569,1915,6654,0,0,0,1.0,1,1.0,1,1.0,1,0.09318174653066898,45
2600,5,8574,1917,6657,0,0,0,1.0,1,1.0,1,1.0,1,0.15900829246261375,48
2601,1,8575,1917,6658,0,0,0,1.0,1,1.0,1,1.0,1,0.145348896533479,47
2602,3,8578,1917,6661,0,0,0,1.0,1,1.0,1,1.0,1,0.1533867553189974,48
2603,1,8579,1917,6662,0,0,0,1.0,1,1.0,1,1.0,1,0.16047579375984616,48
2604,1,8580,1917,6663,0,0,0,1.0,1,1.0,1,1.0,1,0.16648145452678803,47
2605,2,8582,1919,6663,0,0,0,1.0,1,1.0,1,1.0,1,0.1894966716652774,47
2606,2,8584,1919,6665,0,0,0,1.0,1,1.0,1,1.0,1,0.1726017967218221,46
2607,3,8587,1919,6668,0,0,0,1.0,1,1.0,1,1.0,1,0.19888643301473774,45
2608,4,8591,1920,6671,0,0,0,1.0,1,1.0,1,1.0,1,0.17030071733731547,45
2609,2,8593,1921,6672,0,0,0,1.0,1,1.0,1,1.0,1,0.16665282827184527,44
2610,4,8597,1923,6674,0,0,0,1.0,1,1.0,1,1.0,1,0.21684340712603878,45
2611,4,8601,1923,6678,0,0,0,1.0,1,1.0,1,1.0,1,0.1319198056012796,46
2612,3,8604,1923,6681,0,0,0,1.0,1,1.0,1,1.0,1,0.11584038315846343,47
2613,4,8608,1924,6684,0,0,0,1.0,1,1.0,1,1.0,1,0.1407343453998836,48
2614,4,8612,1927,6685,0,0,0,1.0,1,1.0,1,1.0,1,0.19989003365662575,48
2615,2,8614,1929,6685,0,0,0,1.0,1,1.0,1,1.0,1,0.20793379244875723,49
2616,5,8619,1929,6690,0,0,0,1.0,1,1.0,1,1.0,1,0.15223090271651799,49
2617,3,8622,1929,6693,0,0,0,1.0,1,1.0,1,1.0,1,0.16232040291508484,48
2618,1,8623,1930,6693,0,0,0,1.0,1,1.0,1,1.0,1,0.13501779635920924,47
2619,3,8626,1930,6696,0,0,0,1.0,1,1.0,1,1.0,1,0.12441346949091726,50
2620,1,8627,1931,6696,0,0,0,1.0,1,1.0,1,1.0,1,0.15592382126942278,51
2621,0,8627,1931,6696,0,0,0,1.0,1,1.0,1,1.0,1,0.14777428195330436,52
2622,2,8629,1932,6697,0,0,0,1.0,1,1.0,1,1.0,1,0.14534920370998053,52
2623,3,8632,1933,6699,0,0,0,1.0,1,1.0,1,1.0,1,0.14337599178171412,53
2624,4,8636,1936,6700,0,0,0,1.0,1,1.0,1,1.0,1,0.16564445641575182,51
2625,3,8639,1937,6702,0,0,0,1.0,1,1.0,1,1.0,1,0.16189865398966347,50
2626,5,8644,1939,6705,0,0,0,1.0,1,1.0,1,1.0,1,0.12754952561728394,49
2627,2,8646,1940,6706,0,0,0,1.0,1,1.0,1,1.0,1,0.11742000180342302,48
2628,5,8651,1942,6709,0,0,0,1.0,1,1.0,1,1.0,1,0.10942252080510347,48
2629,0,8651,1942,6709,0,0,0,1.0,1,1.0,1,1.0,1,0.12476653568141223,47
2630,1,8652,1942,6710,0,0,0,1.0,1,1.0,1,1.0,1,0.14388241731058735,47
2631,1,8653,1943,6710,0,0,0,1.0,1,1.0,1,1.0,1,0.13781292203552592,47
2632,1,8654,1944,6710,0,0,0,1.0,1,1.0,1,1.0,1,0.13269089569095457,47
2633,1,8655,1945,6710,0,0,0,1.0,1,1.0,1,1.0,1,0.13651967251113578,44
2634,1,8656,1946,6710,0,0,0,1.0,1,1.0,1,1.0,1,0.14236906372415797,44
2635,3,8659,1948,6711,0,0,0,1.0,1,1.0,1,1.0,1,0.1909204717718437,45
2636,2,8661,1949,6712,0,0,0,1.0,1,1.0,1,1.0,1,0.16851269035039618,40
2637,2,8663,1951,6712,0,0,0,1.0,1,1.0,1,1.0,1,0.1878400754983489,41
2638,5,8668,1953,6715,0,0,0,1.0,1,1.0,1,1.0,1,0.2712425934934099,38
2639,4,8672,1953,6719,0,0,0,1.0,1,1.0,1,1.0,1,0.2642740620211241,39
2640,7,8679,1955,6724,0,0,0,1.0,1,1.0,1,1.0,1,0.28927619713846,38
2641,8,8687,1957,6730,0,0,0,1.0,1,1.0,1,1.0,1,0.20185199509528115,37
2642,4,8691,1959,6732,0,0,0,1.0,1,1.0,1,1.0,1,0.19593688585811547,38
2643,2,8693,1959,6734,0,0,0,1.0,1,1.0,1,1.0,1,0.17849139642616715,37
2644,4,8697,1960,6737,0,0,0,1.0,1,1.0,1,1.0,1,0.14786555462486226,36
2645,2,8699,1960,6739,0,0,0,1.0,1,1.0,1,1.0,1,0.13658663244721728,35
2646,0,8699,1960,6739,0,0,0,1.0,1,1.0,1,1.0,1,0.13629667137834292,35
2647,0,8699,1960,6739,0,0,0,1.0,1,1.0,1,1.0,1,0.1412375588076314,35
2648,2,8701,1960,6741,0,0,0,1.0,1,1.0,1,1.0,1,0.1237842152900969,36
2649,2,8703,1960,6743,0,0,0,1.0,1,1.0,1,1.0,1,0.0933397552478726,37
2650,2,8705,1961,6744,0,0,0,1.0,1,1.0,1,1.0,1,0.1344461569505697,39
2651,0,8705,1961,6744,0,0,0,1.0,1,1.0,1,1.0,1,0.1344461569505697,39
2652,0,8705,1961,6744,0,0,0,1.0,1,1.0,1,1.0,1,0.1344461569505697,39
2653,0,8705,1961,6744,0,0,0,1.0,1,1.0,1,1.0,1,0.1344461569505697,39
2654,1,8706,1962,6744,0,0,0,1.0,1,1.0,1,1.0,1,0.12343332015446495,40
2655,2,8708,1962,6746,0,0,0,1.0,1,1.0,1,1.0,1,0.12461325134258985,40
2656,6,8714,1963,6751,0,0,0,1.0,1,1.0,1,1.0,1,0.12960176669006426,39
2657,4,8718,1963,6755,0,0,0,1.0,1,1.0,1,1.0,1,0.12445494647018225,40
2658,2,8720,1963,6757,0,0,0,1.0,1,1.0,1,1.0,1,0.13770490231087293,41
2659,4,8724,1965,6759,0,0,0,1.0,1,1.0,1,1.0,1,0.17815815659607256,41
2660,4,8728,1966,6762,0,0,0,1.0,1,1.0,1,1.0,1,0.22343584684917606,40
2661,8,8736,1967,6769,0,0,0,1.0,1,1.0,1,1.0,1,0.21584212685212512,40
2662,7,8743,1969,6774,0,0,0,1.0,1,1.0,1,1.0,1,0.2372111408152182,42
2663,6,8749,1971,6778,0,0,0,1.0,1,1.0,1,1.0,1,0.23417390197719534,41
2664,5,8754,1973,6781,0,0,0,1.0,1,1.0,1,1.0,1,0.2614937498623632,42
2665,6,8760,1974,6786,0,0,0,1.0,1,1.0,1,1.0,1,0.2500925713224395,43
2666,6,8766,1975,6791,0,0,0,1.0,1,1.0,1,1.0,1,0.21419693429475103,44
2667,4,8770,1976,6794,0,0,0,1.0,1,1.0,1,1.0,1,0.23058472228894508,42
2668,8,8778,1977,6801,0,0,0,1.0,1,1.0,1,1.0,1,0.27079877651371853,41
2669,9,8787,1978,6809,0,0,0,1.0,1,1.0,1,1.0,1,0.20645113614810298,42
2670,5,8792,1979,6813,0,0,0,1.0,1,1.0,1,1.0,1,0.224513050423973,40
2671,5,8797,1981,6816,0,0,0,1.0,1,1.0,1,1.0,1,0.195474306796341,39
2672,2,8799,1983,6816,0,0,0,1.0,1,1.0,1,1.0,1,0.2902273385530421,36
2673,6,8805,1984,6821,0,0,0,1.0,1,1.0,1,1.0,1,0.23397840807895864,35
2674,3,8808,1985,6823,0,0,0,1.0,1,1.0,1,1.0,1,0.2408639318912717,33
2675,1,8809,1985,6824,0,0,0,1.0,1,1.0,1,1.0,1,0.20200811181762823,34
2676,0,8809,1985,6824,0,0,0,1.0,1,1.0,1,1.0,1,0.19921855653490492,32
2677,3,8812,1987,6825,0,0,0,1.0,1,1.0,1,1.0,1,0.21796358953190353,33
2678,4,8816,1988,6828,0,0,0,1.0,1,1.0,1,1.0,1,0.21934651353281495,33
2679,5,8821,1988,6833,0,0,0,1.0,1,1.0,1,1.0,1,0.17241112546269904,32
2680,3,8824,1988,6836,0,0,0,1.0,1,1.0,1,1.0,1,0.1946377608461921,32
2681,1,8825,1988,6837,0,0,0,1.0,1,1.0,1,1.0,1,0.19663837269016812,32
2682,1,8826,1989,6837,0,0,0,1.0,1,1.0,1,1.0,1,0.2101341676322289,33
2683,0,8826,1989,6837,0,0,0,1.0,1,1.0,1,1.0,1,0.24638647431914207,32
2684,1,8827,1989,6838,0,0,0,1.0,1,1.0,1,1.0,1,0.26704998887789655,31
2685,2,8829,1989,6840,0,0,0,1.0,1,1.0,1,1.0,1,0.27339577707777096,31
2686,3,8832,1989,6843,0,0,0,1.0,1,1.0,1,1.0,1,0.21996718654317046,30
2687,2,8834,1990,6844,0,0,0,1.0,1,1.0,1,1.0,1,0.22178004809354332,30
2688,1,8835,1991,6844,0,0,0,1.0,1,1.0,1,1.0,1,0.24787598955472948,30
2689,3,8838,1992,6846,0,0,0,1.0,1,1.0,1,1.0,1,0.22256925483357076,31
2690,2,8840,1994,6846,0,0,0,1.0,1,1.0,1,1.0,1,0.19698426880876097,31
2691,3,8843,1995,6848,0,0,0,1.0,1,1.0,1,1.0,1,0.17676218850254688,32
2692,3,8846,1996,6850,0,0,0,1.0,1,1.0,1,1.0,1,0.22509209637604094,32
2693,3,8849,1998,6851,0,0,0,1.0,1,1.0,1,1.0,1,0.22182204138435832,33
2694,2,8851,1998,6853,0,0,0,1.0,1,1.0,1,1.0,1,0.22789324142469786,34
2695,2,8853,1998,6855,0,0,0,1.0,1,1.0,1,1.0,1,0.16393679514549206,35
2696,4,8857,1998,6859,0,0,0,1.0,1,1.0,1,1.0,1,0.16393679514549206,35
2697,2,8859,1999,6860,0,0,0,1.0,1,1.0,1,1.0,1,0.179014050790779,35
2698,0,8859,1999,6860,0,0,0,1.0,1,1.0,1,1.0,1,0.16169795836071996,36
2699,0,8859,1999,6860,0,0,0,1.0,1,1.0,1,1.0,1,0.17901378609355065,36
2700,3,8862,2000,6862,0,0,0,1.0,1,1.0,1,1.0,1,0.14913831719686016,37
2701,0,8862,2000,6862,0,0,0,1.0,1,1.0,1,1.0,1,0.14913831719686016,37
2702,4,8866,2002,6864,0,0,0,1.0,1,1.0,1,1.0,1,0.17601245679424132,37
2703,1,8867,2003,6864,0,0,0,1.0,1,1.0,1,1.0,1,0.17935568018006964,38
2704,1,8868,2004,6864,0,0,0,1.0,1,1.0,1,1.0,1,0.21108259548329822,37
2705,1,8869,2005,6864,0,0,0,1.0,1,1.0,1,1.0,1,0.2149463872537434,36
2706,2,8871,2007,6864,0,0,0,1.0,1,1.0,1,1.0,1,0.28022970610629117,36
2707,4,8875,2008,6867,0,0,0,1.0,1,1.0,1,1.0,1,0.29183877975250155,35
2708,4,8879,2011,6868,0,0,0,1.0,1,1.0,1,1.0,1,0.2770892654493074,36
2709,2,8881,2012,6869,0,0,0,1.0,1,1.0,1,1.0,1,0.3009385263776905,32
2710,3,8884,2014,6870,0,0,0,1.0,1,1.0,1,1.0,1,0.33753232135675054,29
2711,3,8887,2015,6872,0,0,0,1.0,1,1.0,1,1.0,1,0.3016639932282356,29
2712,0,8887,2015,6872,0,0,0,1.0,1,1.0,1,1.0,1,0.3648033134272671,28
2713,0,8887,2015,6872,0,0,0,1.0,1,1.0,1,1.0,1,0.3449294226239771,28
2714,2,8889,2017,6872,0,0,0,1.0,1,1.0,1,1.0,1,0.36762666569160823,26
2715,1,8890,2018,6872,0,0,0,1.0,1,1.0,1,1.0,1,0.39314288065531966,24
2716,7,8897,2018,6879,0,0,0,1.0,1,1.0,1,1.0,1,0.2222835325952631,24
2717,3,8900,2018,6882,0,0,0,1.0,1,1.0,1,1.0,1,0.244884508554674,25
2718,5,8905,2019,6886,0,0,0,1.0,1,1.0,1,1.0,1,0.32482025789959523,25
2719,7,8912,2022,6890,0,0,0,1.0,1,1.0,1,1.0,1,0.3879127022734447,25
2720,3,8915,2022,6893,0,0,0,1.0,1,1.0,1,1.0,1,0.35741019266231217,25
2721,4,8919,2024,6895,0,0,0,1.0,1,1.0,1,1.0,1,0.3342965111135014,25
2722,3,8922,2025,6897,0,0,0,1.0,1,1.0,1,1.0,1,0.3339089761423617,26
2723,5,8927,2026,6901,0,0,0,1.0,1,1.0,1,1.0,1,0.3434165529883588,26
2724,3,8930,2027,6903,0,0,0,1.0,1,1.0,1,1.0,1,0.28637170337416845,27
2725,1,8931,2027,6904,0,0,0,1.0,1,1.0,1,1.0,1,0.2522612912743751,28
2726,0,8931,2027,6904,0,0,0,1.0,1,1.0,1,1.0,1,0.2522612912743751,28
2727,2,8933,2027,6906,0,0,0,1.0,1,1.0,1,1.0,1,0.2309294074733361,29
2728,2,8935,2028,6907,0,0,0,1.0,1,1.0,1,1.0,1,0.3141629965660048,29
2729,4,8939,2029,6910,0,0,0,1.0,1,1.0,1,1.0,1,0.31931697648929425,29
2730,4,8943,2029,6914,0,0,0,1.0,1,1.0,1,1.0,1,0.27209951988876513,29
2731,3,8946,2029,6917,0,0,0,1.0,1,1.0,1,1.0,1,0.21817909793030948,30
2732,3,8949,2029,6920,0,0,0,1.0,1,1.0,1,1.0,1,0.20284421016058235,29
2733,1,8950,2029,6921,0,0,0,1.0,1,1.0,1,1.0,1,0.17114964683594913,29
2734,0,8950,2029,6921,0,0,0,1.0,1,1.0,1,1.0,1,0.17114964683594913,29
2735,0,8950,2029,6921,0,0,0,1.0,1,1.0,1,1.0,1,0.17114964683594913,29
2736,1,8951,2030,6921,0,0,0,1.0,1,1.0,1,1.0,1,0.18548408020533463,30
2737,2,8953,2030,6923,0,0,0,1.0,1,1.0,1,1.0,1,0.17150912691262446,30
2738,2,8955,2031,6924,0,0,0,1.0,1,1.0,1,1.0,1,0.2156505603538951,30
2739,2,8957,2032,6925,0,0,0,1.0,1,1.0,1,1.0,1,0.2446577727496059,29
2740,0,8957,2032,6925,0,0,0,1.0,1,1.0,1,1.0,1,0.2446577727496059,29
2741,1,8958,2032,6926,0,0,0,1.0,1,1.0,1,1.0,1,0.2517122166950126,28
2742,3,8961,2033,6928,0,0,0,1.0,1,1.0,1,1.0,1,0.25029657054196264,28
2743,2,8963,2034,6929,0,0,0,1.0,1,1.0,1,1.0,1,0.24257385322641706,29
2744,2,8965,2035,6930,0,0,0,1.0,1,1.0,1,1.0,1,0.19808697967776046,27
2745,1,8966,2036,6930,0,0,0,1.0,1,1.0,1,1.0,1,0.18070878733000925,25
2746,5,8971,2038,6933,0,0,0,1.0,1,1.0,1,1.0,1,0.20996896803776574,25
2747,2,8973,2038,6935,0,0,0,1.0,1,1.0,1,1.0,1,0.14277334655816498,23
2748,1,8974,2038,6936,0,0,0,1.0,1,1.0,1,1.0,1,0.0976629564104025,22
2749,0,8974,2038,6936,0,0,0,1.0,1,1.0,1,1.0,1,0.2449419791487107,19
2750,2,8976,2040,6936,0,0,0,1.0,1,1.0,1,1.0,1,0.21310107281571822,18
2751,0,8976,2040,6936,0,0,0,1.0,1,1.0,1,1.0,1,0.2859631147067406,16
2752,0,8976,2040,6936,0,0,0,1.0,1,1.0,1,1.0,1,0.3307190717305278,15
2753,0,8976,2040,6936,0,0,0,1.0,1,1.0,1,1.0,1,0.3307190717305278,15
2754,0,8976,2040,6936,0,0,0,1.0,1,1.0,1,1.0,1,0.3307190717305278,15
2755,0,8976,2040,6936,0,0,0,1.0,1,1.0,1,1.0,1,0.3307190717305278,15
2756,0,8976,2040,6936,0,0,0,1.0,1,1.0,1,1.0,1,0.33410251068686936,16
2757,0,8976,2040,6936,0,0,0,1.0,1,1.0,1,1.0,1,0.2710560705819665,17
2758,0,8976,2040,6936,0,0,0,1.0,1,1.0,1,1.0,1,0.2710560705819665,17
2759,0,8976,2040,6936,0,0,0,1.0,1,1.0,1,1.0,1,0.23710898373180728,18
2760,0,8976,2040,6936,0,0,0,1.0,1,1.0,1,1.0,1,0.23710898373180728,18
2761,0,8976,2040,6936,0,0,0,1.0,1,1.0,1,1.0,1,0.23710898373180728,18
2762,0,8976,2040,6936,0,0,0,1.0,1,1.0,1,1.0,1,0.23710898373180728,18
2763,0,8976,2040,6936,0,0,0,1.0,1,1.0,1,1.0,1,0.2665263932971987,17
2764,2,8978,2042,6936,0,0,0,1.0,1,1.0,1,1.0,1,0.3470122443542984,17
2765,1,8979,2042,6937,0,0,0,1.0,1,1.0,1,1.0,1,0.2943684339317033,18
2766,0,8979,2042,6937,0,0,0,1.0,1,1.0,1,1.0,1,0.2943684339317033,18
2767,0,8979,2042,6937,0,0,0,1.0,1,1.0,1,1.0,1,0.2943684339317033,18
2768,1,8980,2042,6938,0,0,0,1.0,1,1.0,1,1.0,1,0.2362809753434113,18
2769,3,8983,2044,6939,0,0,0,1.0,1,1.0,1,1.0,1,0.2089966618157305,18
2770,0,8983,2044,6939,0,0,0,1.0,1,1.0,1,1.0,1,0.2089966618157305,18
2771,0,8983,2044,6939,0,0,0,1.0,1,1.0,1,1.0,1,0.2089966618157305,18
2772,0,8983,2044,6939,0,0,0,1.0,1,1.0,1,1.0,1,0.2089966618157305,18
2773,0,8983,2044,6939,0,0,0,1.0,1,1.0,1,1.0,1,0.2089966618157305,18
2774,2,8985,2045,6940,0,0,0,1.0,1,1.0,1,1.0,1,0.2265318095439511,20
2775,0,8985,2045,6940,0,0,0,1.0,1,1.0,1,1.0,1,0.23220300851640965,21
2776,1,8986,2045,6941,0,0,0,1.0,1,1.0,1,1.0,1,0.2084028352752835,21
2777,0,8986,2045,6941,0,0,0,1.0,1,1.0,1,1.0,1,0.19698735711133064,22
2778,3,8989,2046,6943,0,0,0,1.0,1,1.0,1,1.0,1,0.19062807213313335,24
2779,2,8991,2048,6943,0,0,0,1.0,1,1.0,1,1.0,1,0.23882402226854252,24
2780,1,8992,2048,6944,0,0,0,1.0,1,1.0,1,1.0,1,0.1804942161626325,24
2781,0,8992,2048,6944,0,0,0,1.0,1,1.0,1,1.0,1,0.1804942161626325,24
2782,0,8992,2048,6944,0,0,0,1.0,1,1.0,1,1.0,1,0.1804942161626325,24
2783,0,8992,2048,6944,0,0,0,1.0,1,1.0,1,1.0,1,0.1804942161626325,24
2784,3,8995,2048,6947,0,0,0,1.0,1,1.0,1,1.0,1,0.157287724405397,24
2785,1,8996,2049,6947,0,0,0,1.0,1,1.0,1,1.0,1,0.15599960504274007,22
2786,1,8997,2050,6947,0,0,0,1.0,1,1.0,1,1.0,1,0.20424226601940162,22
2787,0,8997,2050,6947,0,0,0,1.0,1,1.0,1,1.0,1,0.20374467169290852,21
2788,0,8997,2050,6947,0,0,0,1.0,1,1.0,1,1.0,1,0.20619602167576015,20
2789,1,8998,2051,6947,0,0,0,1.0,1,1.0,1,1.0,1,0.218565826339919,20
2790,0,8998,2051,6947,0,0,0,1.0,1,1.0,1,1.0,1,0.24119915048843327,21
2791,1,8999,2052,6947,0,0,0,1.0,1,1.0,1,1.0,1,0.29045850208487134,21
2792,0,8999,2052,6947,0,0,0,1.0,1,1.0,1,1.0,1,0.29045850208487134,21
2793,0,8999,2052,6947,0,0,0,1.0,1,1.0,1,1.0,1,0.33789996916490733,18
2794,0,8999,2052,6947,0,0,0,1.0,1,1.0,1,1.0,1,0.33789996916490733,18
2795,0,8999,2052,6947,0,0,0,1.0,1,1.0,1,1.0,1,0.3264089096108459,20
2796,1,9000,2053,6947,0,0,0,1.0,1,1.0,1,1.0,1,0.3181957704575337,21
2797,3,9003,2053,6950,0,0,0,1.0,1,1.0,1,1.0,1,0.2090846042045832,21
2798,0,9003,2053,6950,0,0,0,1.0,1,1.0,1,1.0,1,0.2090846042045832,21
2799,1,9004,2053,6951,0,0,0,1.0,1,1.0,1,1.0,1,0.1797916774109236,22
2800,0,9004,2053,6951,0,0,0,1.0,1,1.0,1,1.0,1,0.1797916774109236,22
2801,2,9006,2055,6951,0,0,0,1.0,1,1.0,1,1.0,1,0.20561349414059377,22
2802,0,9006,2055,6951,0,0,0,1.0,1,1.0,1,1.0,1,0.20561349414059377,22
2803,0,9006,2055,6951,0,0,0,1.0,1,1.0,1,1.0,1,0.20561349414059377,22
2804,0,9006,2055,6951,0,0,0,1.0,1,1.0,1,1.0,1,0.2244799665758902,23
2805,0,9006,2055,6951,0,0,0,1.0,1,1.0,1,1.0,1,0.2244799665758902,23
2806,0,9006,2055,6951,0,0,0,1.0,1,1.0,1,1.0,1,0.2244799665758902,23
2807,1,9007,2055,6952,0,0,0,1.0,1,1.0,1,1.0,1,0.1763341591838329,24
2808,0,9007,2055,6952,0,0,0,1.0,1,1.0,1,1.0,1,0.1763341591838329,24
2809,1,9008,2056,6952,0,0,0,1.0,1,1.0,1,1.0,1,0.20814962162312795,25
2810,0,9008,2056,6952,0,0,0,1.0,1,1.0,1,1.0,1,0.19801012113253497,24
2811,1,9009,2056,6953,0,0,0,1.0,1,1.0,1,1.0,1,0.21120539543515404,26
2812,1,9010,2057,6953,0,0,0,1.0,1,1.0,1,1.0,1,0.24960747609107428,26
2813,1,9011,2058,6953,0,0,0,1.0,1,1.0,1,1.0,1,0.22946908772630362,27
2814,5,9016,2060,6956,0,0,0,1.0,1,1.0,1,1.0,1,0.2036224679525747,29
2815,2,9018,2060,6958,0,0,0,1.0,1,1.0,1,1.0,1,0.2036224679525747,29
2816,3,9021,2060,6961,0,0,0,1.0,1,1.0,1,1.0,1,0.21876878893644894,29
2817,4,9025,2061,6964,0,0,0,1.0,1,1.0,1,1.0,1,0.26823686945650566,29
2818,5,9030,2061,6969,0,0,0,1.0,1,1.0,1,1.0,1,0.3208523029899804,29
2819,5,9035,2061,6974,0,0,0,1.0,1,1.0,1,1.0,1,0.32961732170976255,30
2820,4,9039,2062,6977,0,0,0,1.0,1,1.0,1,1.0,1,0.3169565236528132,30
2821,7,9046,2062,6984,0,0,0,1.0,1,1.0,1,1.0,1,0.17978242207682354,31
2822,4,9050,2063,6987,0,0,0,1.0,1,1.0,1,1.0,1,0.19038401072198938,30
2823,1,9051,2063,6988,0,0,0,1.0,1,1.0,1,1.0,1,0.21941089409972608,27
2824,2,9053,2063,6990,0,0,0,1.0,1,1.0,1,1.0,1,0.19371107043551333,28
2825,3,9056,2065,6991,0,0,0,1.0,1,1.0,1,1.0,1,0.1753595329729835,28
2826,1,9057,2066,6991,0,0,0,1.0,1,1.0,1,1.0,1,0.24033495874364186,27
2827,3,9060,2067,6993,0,0,0,1.0,1,1.0,1,1.0,1,0.21332227640113288,28
2828,4,9064,2067,6997,0,0,0,1.0,1,1.0,1,1.0,1,0.2287894600366809,28
2829,1,9065,2068,6997,0,0,0,1.0,1,1.0,1,1.0,1,0.24540893019434937,27
2830,1,9066,2068,6998,0,0,0,1.0,1,1.0,1,1.0,1,0.23222904122077526,27
2831,0,9066,2068,6998,0,0,0,1.0,1,1.0,1,1.0,1,0.23222904122077526,27
2832,4,9070,2068,7002,0,0,0,1.0,1,1.0,1,1.0,1,0.22387755436550041,27
2833,4,9074,2068,7006,0,0,0,1.0,1,1.0,1,1.0,1,0.19912449434672863,26
2834,1,9075,2069,7006,0,0,0,1.0,1,1.0,1,1.0,1,0.1963063584836784,26
2835,0,9075,2069,7006,0,0,0,1.0,1,1.0,1,1.0,1,0.23004144512150063,25
2836,3,9078,2069,7009,0,0,0,1.0,1,1.0,1,1.0,1,0.16760349668488073,27
2837,0,9078,2069,7009,0,0,0,1.0,1,1.0,1,1.0,1,0.17329464505803172,27
2838,3,9081,2069,7012,0,0,0,1.0,1,1.0,1,1.0,1,0.1522400611839897,27
2839,0,9081,2069,7012,0,0,0,1.0,1,1.0,1,1.0,1,0.18804277271279848,29
2840,2,9083,2070,7013,0,0,0,1.0,1,1.0,1,1.0,1,0.19576378568047909,29
2841,1,9084,2070,7014,0,0,0,1.0,1,1.0,1,1.0,1,0.17624968456809262,31
2842,0,9084,2070,7014,0,0,0,1.0,1,1.0,1,1.0,1,0.17624968456809262,31
2843,4,9088,2070,7018,0,0,0,1.0,1,1.0,1,1.0,1,0.17941072218058923,32
2844,4,9092,2072,7020,0,0,0,1.0,1,1.0,1,1.0,1,0.2027944761083728,33
2845,9,9101,2072,7029,0,0,0,1.0,1,1.0,1,1.0,1,0.2111867207678558,32
2846,5,9106,2073,7033,0,0,0,1.0,1,1.0,1,1.0,1,0.25665160022362415,33
2847,4,9110,2074,7036,0,0,0,1.0,1,1.0,1,1.0,1,0.3190772309032683,32
2848,3,9113,2074,7039,0,0,0,1.0,1,1.0,1,1.0,1,0.33880536307285763,33
2849,9,9122,2074,7048,0,0,0,1.0,1,1.0,1,1.0,1,0.3059942501454877,34
2850,8,9130,2074,7056,0,0,0,1.0,1,1.0,1,1.0,1,0.3059942501454877,34
2851,8,9138,2074,7064,0,0,0,1.0,1,1.0,1,1.0,1,0.08279881142878094,34
2852,3,9141,2075,7066,0,0,0,1.0,1,1.0,1,1.0,1,0.06079409237478502,35
2853,3,9144,2076,7068,0,0,0,1.0,1,1.0,1,1.0,1,0.07048115851112174,36
2854,0,9144,2076,7068,0,0,0,1.0,1,1.0,1,1.0,1,0.09830111542092862,37
2855,0,9144,2076,7068,0,0,0,1.0,1,1.0,1,1.0,1,0.10876070304732426,38
2856,0,9144,2076,7068,0,0,0,1.0,1,1.0,1,1.0,1,0.10876070304732426,38
2857,4,9148,2077,7071,0,0,0,1.0,1,1.0,1,1.0,1,0.1613839809688857,39
2858,4,9152,2079,7073,0,0,0,1.0,1,1.0,1,1.0,1,0.18433975174774486,40
2859,7,9159,2080,7079,0,0,0,1.0,1,1.0,1,1.0,1,0.14328642738995187,40
2860,4,9163,2080,7083,0,0,0,1.0,1,1.0,1,1.0,1,0.17381420197264016,40
2861,2,9165,2080,7085,0,0,0,1.0,1,1.0,1,1.0,1,0.16871287399754295,38
2862,5,9170,2081,7089,0,0,0,1.0,1,1.0,1,1.0,1,0.18519619552591382,38
2863,6,9176,2083,7093,0,0,0,1.0,1,1.0,1,1.0,1,0.2528555694438252,38
2864,6,9182,2086,7096,0,0,0,1.0,1,1.0,1,1.0,1,0.3150988991582139,36
2865,13,9195,2091,7104,0,0,0,1.0,1,1.0,1,1.0,1,0.3211909562003024,34
2866,8,9203,2092,7111,0,0,0,1.0,1,1.0,1,1.0,1,0.19229763701915972,31
2867,0,9203,2092,7111,0,0,0,1.0,1,1.0,1,1.0,1,0.19160942447774082,30
2868,2,9205,2094,7111,0,0,0,1.0,1,1.0,1,1.0,1,0.25676903267729423,27
2869,2,9207,2095,7112,0,0,0,1.0,1,1.0,1,1.0,1,0.3116528137648432,27
2870,4,9211,2096,7115,0,0,0,1.0,1,1.0,1,1.0,1,0.2758096065731807,25
2871,1,9212,2097,7115,0,0,0,1.0,1,1.0,1,1.0,1,0.3073562961982072,25
2872,2,9214,2098,7116,0,0,0,1.0,1,1.0,1,1.0,1,0.28611843529873765,23
2873,1,9215,2099,7116,0,0,0,1.0,1,1.0,1,1.0,1,0.35152138559474777,24
2874,3,9218,2100,7118,0,0,0,1.0,1,1.0,1,1.0,1,0.3443684050998835,24
2875,0,9218,2100,7118,0,0,0,1.0,1,1.0,1,1.0,1,0.3960541097586959,23
2876,0,9218,2100,7118,0,0,0,1.0,1,1.0,1,1.0,1,0.3720514423074274,24
2877,2,9220,2100,7120,0,0,0,1.0,1,1.0,1,1.0,1,0.32861839894110584,24
2878,3,9223,2101,7122,0,0,0,1.0,1,1.0,1,1.0,1,0.31518184851540576,24
2879,3,9226,2102,7124,0,0,0,1.0,1,1.0,1,1.0,1,0.3681834163523176,25
2880,3,9229,2102,7127,0,0,0,1.0,1,1.0,1,1.0,1,0.43174041855248557,26
2881,5,9234,2102,7132,0,0,0,1.0,1,1.0,1,1.0,1,0.303259229767049,26
2882,1,9235,2102,7133,0,0,0,1.0,1,1.0,1,1.0,1,0.2789311525188112,27
2883,1,9236,2102,7134,0,0,0,1.0,1,1.0,1,1.0,1,0.2736890941455516,28
2884,2,9238,2102,7136,0,0,0,1.0,1,1.0,1,1.0,1,0.2723161433286243,29
2885,2,9240,2102,7138,0,0,0,1.0,1,1.0,1,1.0,1,0.23951209601153065,31
2886,5,9245,2103,7142,0,0,0,1.0,1,1.0,1,1.0,1,0.2655818193601863,31
2887,8,9253,2103,7150,0,0,0,1.0,1,1.0,1,1.0,1,0.28788015914277887,33
2888,7,9260,2103,7157,0,0,0,1.0,1,1.0,1,1.0,1,0.23996049545778889,34
2889,7,9267,2103,7164,0,0,0,1.0,1,1.0,1,1.0,1,0.22561245105417677,35
2890,4,9271,2103,7168,0,0,0,1.0,1,1.0,1,1.0,1,0.23951622645231452,35
2891,5,9276,2104,7172,0,0,0,1.0,1,1.0,1,1.0,1,0.2707098963188644,35
2892,6,9282,2106,7176,0,0,0,1.0,1,1.0,1,1.0,1,0.287976899111356,35
2893,7,9289,2106,7183,0,0,0,1.0,1,1.0,1,1.0,1,0.25339222724489,37
2894,8,9297,2106,7191,0,0,0,1.0,1,1.0,1,1.0,1,0.29323164883837316,37
2895,8,9305,2106,7199,0,0,0,1.0,1,1.0,1,1.0,1,0.2904237959524901,37
2896,6,9311,2106,7205,0,0,0,1.0,1,1.0,1,1.0,1,0.20746247736307996,38
2897,0,9311,2106,7205,0,0,0,1.0,1,1.0,1,1.0,1,0.2346137976837371,37
2898,1,9312,2107,7205,0,0,0,1.0,1,1.0,1,1.0,1,0.26751878902593923,38
2899,1,9313,2108,7205,0,0,0,1.0,1,1.0,1,1.0,1,0.23170546639459996,37
2900,2,9315,2109,7206,0,0,0,1.0,1,1.0,1,1.0,1,0.22017934324890462,36
2901,1,9316,2109,7207,0,0,0,1.0,1,1.0,1,1.0,1,0.18703190416148113,37
2902,1,9317,2110,7207,0,0,0,1.0,1,1.0,1,1.0,1,0.19085702045825645,35
2903,1,9318,2111,7207,0,0,0,1.0,1,1.0,1,1.0,1,0.22298086708631915,35
2904,0,9318,2111,7207,0,0,0,1.0,1,1.0,1,1.0,1,0.20940316380550578,33
2905,1,9319,2111,7208,0,0,0,1.0,1,1.0,1,1.0,1,0.18581324328376717,34
2906,2,9321,2113,7208,0,0,0,1.0,1,1.0,1,1.0,1,0.20813963481088546,34
2907,0,9321,2113,7208,0,0,0,1.0,1,1.0,1,1.0,1,0.20464046620713294,35
2908,2,9323,2113,7210,0,0,0,1.0,1,1.0,1,1.0,1,0.19646108676102456,36
2909,2,9325,2113,7212,0,0,0,1.0,1,1.0,1,1.0,1,0.19733007335777233,38
2910,0,9325,2113,7212,0,0,0,1.0,1,1.0,1,1.0,1,0.19733007335777233,38
2911,1,9326,2114,7212,0,0,0,1.0,1,1.0,1,1.0,1,0.21775229185843809,37
2912,1,9327,2114,7213,0,0,0,1.0,1,1.0,1,1.0,1,0.20205649014371152,37
2913,0,9327,2114,7213,0,0,0,1.0,1,1.0,1,1.0,1,0.20737032665475644,38
2914,1,9328,2114,7214,0,0,0,1.0,1,1.0,1,1.0,1,0.17931292840024524,38
2915,3,9331,2114,7217,0,0,0,1.0,1,1.0,1,1.0,1,0.12777913708194982,39
2916,0,9331,2114,7217,0,0,0,1.0,1,1.0,1,1.0,1,0.13734580621593442,40
2917,2,9333,2115,7218,0,0,0,1.0,1,1.0,1,1.0,1,0.15327348453049824,41
2918,3,9336,2116,7220,0,0,0,1.0,1,1.0,1,1.0,1,0.19155405910212203,41
2919,2,9338,2116,7222,0,0,0,1.0,1,1.0,1,1.0,1,0.19155405910212203,41
2920,1,9339,2116,7223,0,0,0,1.0,1,1.0,1,1.0,1,0.20563530448338443,43
2921,1,9340,2116,7224,0,0,0,1.0,1,1.0,1,1.0,1,0.22099679437449302,42
2922,4,9344,2117,7227,0,0,0,1.0,1,1.0,1,1.0,1,0.19916397976049632,43
2923,1,9345,2117,7228,0,0,0,1.0,1,1.0,1,1.0,1,0.1995819976673744,44
2924,0,9345,2117,7228,0,0,0,1.0,1,1.0,1,1.0,1,0.17904027091407268,45
2925,4,9349,2117,7232,0,0,0,1.0,1,1.0,1,1.0,1,0.21551894410432065,45
2926,5,9354,2117,7237,0,0,0,1.0,1,1.0,1,1.0,1,0.10302324196171214,47
2927,1,9355,2118,7237,0,0,0,1.0,1,1.0,1,1.0,1,0.12850749687327334,47
2928,4,9359,2119,7240,0,0,0,1.0,1,1.0,1,1.0,1,0.14058057817945743,48
2929,6,9365,2120,7245,0,0,0,1.0,1,1.0,1,1.0,1,0.1771578465441234,48
2930,7,9372,2120,7252,0,0,0,1.0,1,1.0,1,1.0,1,0.13792108198251726,50
2931,3,9375,2120,7255,0,0,0,1.0,1,1.0,1,1.0,1,0.15203669712029028,51
2932,2,9377,2120,7257,0,0,0,1.0,1,1.0,1,1.0,1,0.15203669712029028,51
2933,4,9381,2121,7260,0,0,0,1.0,1,1.0,1,1.0,1,0.19962985229629707,52
2934,5,9386,2122,7264,0,0,0,1.0,1,1.0,1,1.0,1,0.1764315999596947,52
2935,3,9389,2122,7267,0,0,0,1.0,1,1.0,1,1.0,1,0.19901411005669453,51
2936,2,9391,2122,7269,0,0,0,1.0,1,1.0,1,1.0,1,0.16350699373144603,49
2937,2,9393,2122,7271,0,0,0,1.0,1,1.0,1,1.0,1,0.1735056211170889,50
2938,3,9396,2123,7273,0,0,0,1.0,1,1.0,1,1.0,1,0.2001827325447706,50
2939,4,9400,2123,7277,0,0,0,1.0,1,1.0,1,1.0,1,0.18320196412529338,51
2940,8,9408,2124,7284,0,0,0,1.0,1,1.0,1,1.0,1,0.1711011003059914,52
2941,6,9414,2125,7289,0,0,0,1.0,1,1.0,1,1.0,1,0.128466842535318,53
2942,2,9416,2127,7289,0,0,0,1.0,1,1.0,1,1.0,1,0.13746747871013298,52
2943,0,9416,2127,7289,0,0,0,1.0,1,1.0,1,1.0,1,0.12800593674326402,51
2944,4,9420,2129,7291,0,0,0,1.0,1,1.0,1,1.0,1,0.10788795474913679,52
2945,1,9421,2130,7291,0,0,0,1.0,1,1.0,1,1.0,1,0.10143785171196343,50
2946,3,9424,2131,7293,0,0,0,1.0,1,1.0,1,1.0,1,0.11711475804013692,51
2947,3,9427,2133,7294,0,0,0,1.0,1,1.0,1,1.0,1,0.11495716000183134,50
2948,4,9431,2135,7296,0,0,0,1.0,1,1.0,1,1.0,1,0.11856777521002039,50
2949,0,9431,2135,7296,0,0,0,1.0,1,1.0,1,1.0,1,0.1106294824139424,49
2950,0,9431,2135,7296,0,0,0,1.0,1,1.0,1,1.0,1,0.13233306020529845,48
2951,3,9434,2136,7298,0,0,0,1.0,1,1.0,1,1.0,1,0.14277403359241966,48
2952,1,9435,2136,7299,0,0,0,1.0,1,1.0,1,1.0,1,0.16239512989395008,46
2953,0,9435,2136,7299,0,0,0,1.0,1,1.0,1,1.0,1,0.16239512989395008,46
2954,1,9436,2136,7300,0,0,0,1.0,1,1.0,1,1.0,1,0.1493202456274903,48
2955,1,9437,2136,7301,0,0,0,1.0,1,1.0,1,1.0,1,0.12492223663244785,48
2956,2,9439,2137,7302,0,0,0,1.0,1,1.0,1,1.0,1,0.09380114729602436,47
2957,5,9444,2139,7305,0,0,0,1.0,1,1.0,1,1.0,1,0.09900563962495319,48
2958,0,9444,2139,7305,0,0,0,1.0,1,1.0,1,1.0,1,0.09812863046642958,49
2959,3,9447,2140,7307,0,0,0,1.0,1,1.0,1,1.0,1,0.12337712974764438,49
2960,2,9449,2140,7309,0,0,0,1.0,1,1.0,1,1.0,1,0.11576119447528863,49
2961,4,9453,2143,7310,0,0,0,1.0,1,1.0,1,1.0,1,0.17709755541131994,51
2962,3,9456,2143,7313,0,0,0,1.0,1,1.0,1,1.0,1,0.15880644611129682,51
2963,3,9459,2143,7316,0,0,0,1.0,1,1.0,1,1.0,1,0.1553698957999361,51
2964,2,9461,2143,7318,0,0,0,1.0,1,1.0,1,1.0,1,0.15669772859268777,52
2965,0,9461,2143,7318,0,0,0,1.0,1,1.0,1,1.0,1,0.16011174727687263,53
2966,3,9464,2144,7320,0,0,0,1.0,1,1.0,1,1.0,1,0.1669048642424977,53
2967,3,9467,2145,7322,0,0,0,1.0,1,1.0,1,1.0,1,0.20475620869871372,53
2968,2,9469,2145,7324,0,0,0,1.0,1,1.0,1,1.0,1,0.20245102056406636,54
2969,3,9472,2146,7326,0,0,0,1.0,1,1.0,1,1.0,1,0.22360266909437593,55
2970,2,9474,2146,7328,0,0,0,1.0,1,1.0,1,1.0,1,0.19887605758323026,55
2971,8,9482,2146,7336,0,0,0,1.0,1,1.0,1,1.0,1,0.1214853113212137,55
2972,1,9483,2146,7337,0,0,0,1.0,1,1.0,1,1.0,1,0.1111108124089554,55
2973,2,9485,2146,7339,0,0,0,1.0,1,1.0,1,1.0,1,0.12069758385179989,55
2974,2,9487,2147,7340,0,0,0,1.0,1,1.0,1,1.0,1,0.11167644151076167,56
2975,2,9489,2147,7342,0,0,0,1.0,1,1.0,1,1.0,1,0.12447721128029655,55
2976,3,9492,2147,7345,0,0,0,1.0,1,1.0,1,1.0,1,0.10721600327081728,57
2977,3,9495,2148,7347,0,0,0,1.0,1,1.0,1,1.0,1,0.14057996810968948,59
2978,3,9498,2149,7349,0,0,0,1.0,1,1.0,1,1.0,1,0.09080070574649185,59
2979,9,9507,2149,7358,0,0,0,1.0,1,1.0,1,1.0,1,0.11754157717149347,59
2980,3,9510,2150,7360,0,0,0,1.0,1,1.0,1,1.0,1,0.09283862831578871,59
2981,5,9515,2150,7365,0,0,0,1.0,1,1.0,1,1.0,1,0.14179490833374675,59
2982,7,9522,2152,7370,0,0,0,1.0,1,1.0,1,1.0,1,0.14648923014340978,61
2983,9,9531,2155,7376,0,0,0,1.0,1,1.0,1,1.0,1,0.15207216864202927,61
2984,11,9542,2158,7384,0,0,0,1.0,1,1.0,1,1.0,1,0.19497143083210572,61
2985,7,9549,2161,7388,0,0,0,1.0,1,1.0,1,1.0,1,0.1995391925091721,57
2986,9,9558,2163,7395,0,0,0,1.0,1,1.0,1,1.0,1,0.141900823698032,58
2987,4,9562,2164,7398,0,0,0,1.0,1,1.0,1,1.0,1,0.12507022900711987,56
2988,4,9566,2164,7402,0,0,0,1.0,1,1.0,1,1.0,1,0.11787171859371505,55
2989,10,9576,2168,7408,0,0,0,1.0,1,1.0,1,1.0,1,0.12684624895254948,53
2990,2,9578,2170,7408,0,0,0,1.0,1,1.0,1,1.0,1,0.13950361703406636,52
2991,4,9582,2171,7411,0,0,0,1.0,1,1.0,1,1.0,1,0.08894173464747143,54
2992,1,9583,2172,7411,0,0,0,1.0,1,1.0,1,1.0,1,0.10941050668840051,55
2993,3,9586,2175,7411,0,0,0,1.0,1,1.0,1,1.0,1,0.09729064605515625,53
2994,5,9591,2177,7414,0,0,0,1.0,1,1.0,1,1.0,1,0.08771139016422821,53
2995,0,9591,2177,7414,0,0,0,1.0,1,1.0,1,1.0,1,0.11594841997327086,51
2996,1,9592,2178,7414,0,0,0,1.0,1,1.0,1,1.0,1,0.13006220503259966,52
2997,3,9595,2180,7415,0,0,0,1.0,1,1.0,1,1.0,1,0.1466809909530618,50
2998,2,9597,2181,7416,0,0,0,1.0,1,1.0,1,1.0,1,0.12262628254958907,51
2999,0,9597,2181,7416,0,0,0,1.0,1,1.0,1,1.0,1,0.1410475943341357,48
3000,1,9598,2181,7417,0,0,0,1.0,1,1.0,1,1.0,1,0.1348766387266316,48
3001,1,9599,2181,7418,0,0,0,1.0,1,1.0,1,1.0,1,0.09550591755799763,49
3002,2,9601,2182,7419,0,0,0,1.0,1,1.0,1,1.0,1,0.09774081104985455,50
3003,0,9601,2182,7419,0,0,0,1.0,1,1.0,1,1.0,1,0.09774081104985455,50
3004,1,9602,2183,7419,0,0,0,1.0,1,1.0,1,1.0,1,0.09293092780337535,51
3005,0,9602,2183,7419,0,0,0,1.0,1,1.0,1,1.0,1,0.10230798534805183,50
3006,2,9604,2183,7421,0,0,0,1.0,1,1.0,1,1.0,1,0.09038718092618703,51
3007,0,9604,2183,7421,0,0,0,1.0,1,1.0,1,1.0,1,0.10457980385928242,51
3008,4,9608,2184,7424,0,0,0,1.0,1,1.0,1,1.0,1,0.11698049785211502,53
3009,3,9611,2184,7427,0,0,0,1.0,1,1.0,1,1.0,1,0.13580316543014243,52
3010,6,9617,2186,7431,0,0,0,1.0,1,1.0,1,1.0,1,0.16383169042733167,52
3011,2,9619,2186,7433,0,0,0,1.0,1,1.0,1,1.0,1,0.16620830880389503,51
3012,8,9627,2189,7438,0,0,0,1.0,1,1.0,1,1.0,1,0.17293768556812236,54
3013,4,9631,2190,7441,0,0,0,1.0,1,1.0,1,1.0,1,0.186128645157858,52
3014,5,9636,2191,7445,0,0,0,1.0,1,1.0,1,1.0,1,0.24079964393878397,51
3015,8,9644,2194,7450,0,0,0,1.0,1,1.0,1,1.0,1,0.24695983405105754,50
3016,12,9656,2197,7459,0,0,0,1.0,1,1.0,1,1.0,1,0.12843295893515486,50
3017,3,9659,2198,7461,0,0,0,1.0,1,1.0,1,1.0,1,0.17474200582280572,48
3018,6,9665,2199,7466,0,0,0,1.0,1,1.0,1,1.0,1,0.15389232108991577,48
3019,1,9666,2200,7466,0,0,0,1.0,1,1.0,1,1.0,1,0.14649408152888183,47
3020,2,9668,2202,7466,0,0,0,1.0,1,1.0,1,1.0,1,0.1380803136295347,47
3021,1,9669,2203,7466,0,0,0,1.0,1,1.0,1,1.0,1,0.17535039415557488,46
3022,2,9671,2205,7466,0,0,0,1.0,1,1.0,1,1.0,1,0.13664567719442874,45
3023,1,9672,2206,7466,0,0,0,1.0,1,1.0,1,1.0,1,0.1298998795048619,41
3024,7,9679,2210,7469,0,0,0,1.0,1,1.0,1,1.0,1,0.13524184415180446,43
3025,2,9681,2211,7470,0,0,0,1.0,1,1.0,1,1.0,1,0.18017711128420705,39
3026,5,9686,2213,7473,0,0,0,1.0,1,1.0,1,1.0,1,0.18468769486430034,38
3027,1,9687,2214,7473,0,0,0,1.0,1,1.0,1,1.0,1,0.19053189127828227,38
3028,1,9688,2214,7474,0,0,0,1.0,1,1.0,1,1.0,1,0.20813395629414247,38
3029,1,9689,2215,7474,0,0,0,1.0,1,1.0,1,1.0,1,0.2433414144568652,37
3030,1,9690,2215,7475,0,0,0,1.0,1,1.0,1,1.0,1,0.21991219042352395,38
3031,7,9697,2216,7481,0,0,0,1.0,1,1.0,1,1.0,1,0.13360905826886751,39
3032,3,9700,2217,7483,0,0,0,1.0,1,1.0,1,1.0,1,0.19187647907106462,39
3033,4,9704,2217,7487,0,0,0,1.0,1,1.0,1,1.0,1,0.2063134757259987,39
3034,3,9707,2217,7490,0,0,0,1.0,1,1.0,1,1.0,1,0.16410346522490754,38
3035,4,9711,2218,7493,0,0,0,1.0,1,1.0,1,1.0,1,0.19100677314733827,39
3036,3,9714,2218,7496,0,0,0,1.0,1,1.0,1,1.0,1,0.20220399028622607,39
3037,3,9717,2218,7499,0,0,0,1.0,1,1.0,1,1.0,1,0.16643679631020927,39
3038,3,9720,2219,7501,0,0,0,1.0,1,1.0,1,1.0,1,0.15239081111080802,40
3039,4,9724,2220,7504,0,0,0,1.0,1,1.0,1,1.0,1,0.12162150016012237,41
3040,6,9730,2222,7508,0,0,0,1.0,1,1.0,1,1.0,1,0.12221888466893639,42
3041,6,9736,2223,7513,0,0,0,1.0,1,1.0,1,1.0,1,0.16924518788594767,43
3042,15,9751,2225,7526,0,0,0,1.0,1,1.0,1,1.0,1,0.24136204005193576,45
3043,12,9763,2227,7536,0,0,0,1.0,1,1.0,1,1.0,1,0.31974701389567156,45
3044,11,9774,2228,7546,0,0,0,1.0,1,1.0,1,1.0,1,0.2592552023374342,45
3045,10,9784,2229,7555,0,0,0,1.0,1,1.0,1,1.0,1,0.30015403762545456,45
3046,14,9798,2229,7569,0,0,0,1.0,1,1.0,1,1.0,1,0.10591055180839667,46
3047,9,9807,2229,7578,0,0,0,1.0,1,1.0,1,1.0,1,0.13116902656976687,46
3048,6,9813,2229,7584,0,0,0,1.0,1,1.0,1,1.0,1,0.14355498524236715,49
3049,9,9822,2229,7593,0,0,0,1.0,1,1.0,1,1.0,1,0.17279208706650573,50
3050,7,9829,2229,7600,0,0,0,1.0,1,1.0,1,1.0,1,0.1556257327682513,50
3051,10,9839,2230,7609,0,0,0,1.0,1,1.0,1,1.0,1,0.2765891804076846,50
3052,13,9852,2231,7621,0,0,0,1.0,1,1.0,1,1.0,1,0.21499877669295786,50
3053,8,9860,2232,7628,0,0,0,1.0,1,1.0,1,1.0,1,0.25541212101800626,49
3054,7,9867,2232,7635,0,0,0,1.0,1,1.0,1,1.0,1,0.27053640246585464,47
3055,10,9877,2232,7645,0,0,0,1.0,1,1.0,1,1.0,1,0.2552931818057369,48
3056,9,9886,2232,7654,0,0,0,1.0,1,1.0,1,1.0,1,0.24753391938983482,47
3057,8,9894,2232,7662,0,0,0,1.0,1,1.0,1,1.0,1,0.25416368779199344,48
3058,9,9903,2233,7670,0,0,0,1.0,1,1.0,1,1.0,1,0.2528979557824289,46
3059,5,9908,2234,7674,0,0,0,1.0,1,1.0,1,1.0,1,0.3321291559046946,44
3060,6,9914,2234,7680,0,0,0,1.0,1,1.0,1,1.0,1,0.3326417878944411,44
3061,6,9920,2234,7686,0,0,0,1.0,1,1.0,1,1.0,1,0.19172401098325118,42
3062,6,9926,2236,7690,0,0,0,1.0,1,1.0,1,1.0,1,0.17166033099332859,42
3063,5,9931,2238,7693,0,0,0,1.0,1,1.0,1,1.0,1,0.17167909114522348,41
3064,6,9937,2240,7697,0,0,0,1.0,1,1.0,1,1.0,1,0.18843651318513865,42
3065,5,9942,2240,7702,0,0,0,1.0,1,1.0,1,1.0,1,0.15473415285587117,40
3066,9,9951,2242,7709,0,0,0,1.0,1,1.0,1,1.0,1,0.19187260923403598,42
3067,5,9956,2244,7712,0,0,0,1.0,1,1.0,1,1.0,1,0.16052820479698474,40
3068,3,9959,2244,7715,0,0,0,1.0,1,1.0,1,1.0,1,0.1576763969382655,39
3069,0,9959,2244,7715,0,0,0,1.0,1,1.0,1,1.0,1,0.19581996392310735,38
3070,1,9960,2245,7715,0,0,0,1.0,1,1.0,1,1.0,1,0.1909119055575972,39
3071,1,9961,2245,7716,0,0,0,1.0,1,1.0,1,1.0,1,0.22770037644297367,39
3072,6,9967,2247,7720,0,0,0,1.0,1,1.0,1,1.0,1,0.23571933881187093,40
3073,5,9972,2247,7725,0,0,0,1.0,1,1.0,1,1.0,1,0.27817348277661286,38
3074,5,9977,2248,7729,0,0,0,1.0,1,1.0,1,1.0,1,0.25792973180501366,38
3075,11,9988,2250,7738,0,0,0,1.0,1,1.0,1,1.0,1,0.317470996885286,41
3076,13,10001,2251,7750,0,0,0,1.0,1,1.0,1,1.0,1,0.11903573067860479,42
3077,6,10007,2253,7754,0,0,0,1.0,1,1.0,1,1.0,1,0.14394361484682275,42
3078,4,10011,2253,7758,0,0,0,1.0,1,1.0,1,1.0,1,0.14394361484682275,42
3079,3,10014,2253,7761,0,0,0,1.0,1,1.0,1,1.0,1,0.2151773127474603,42
3080,4,10018,2253,7765,0,0,0,1.0,1,1.0,1,1.0,1,0.1296918577477571,43
3081,4,10022,2253,7769,0,0,0,1.0,1,1.0,1,1.0,1,0.1410350801682752,44
3082,5,10027,2254,7773,0,0,0,1.0,1,1.0,1,1.0,1,0.1529040155169649,45
3083,4,10031,2254,7777,0,0,0,1.0,1,1.0,1,1.0,1,0.1529040155169649,45
3084,9,10040,2256,7784,0,0,0,1.0,1,1.0,1,1.0,1,0.19677161567811793,45
3085,9,10049,2256,7793,0,0,0,1.0,1,1.0,1,1.0,1,0.17707078644350993,46
3086,7,10056,2256,7800,0,0,0,1.0,1,1.0,1,1.0,1,0.19346248709459382,46
3087,5,10061,2256,7805,0,0,0,1.0,1,1.0,1,1.0,1,0.2312325982997014,47
3088,7,10068,2257,7811,0,0,0,1.0,1,1.0,1,1.0,1,0.19671518073536354,48
3089,8,10076,2257,7819,0,0,0,1.0,1,1.0,1,1.0,1,0.18645856688573273,46
3090,4,10080,2257,7823,0,0,0,1.0,1,1.0,1,1.0,1,0.22953036948707212,46
3091,6,10086,2257,7829,0,0,0,1.0,1,1.0,1,1.0,1,0.15908550827553108,46
3092,7,10093,2259,7834,0,0,0,1.0,1,1.0,1,1.0,1,0.15665304933789115,47
3093,3,10096,2260,7836,0,0,0,1.0,1,1.0,1,1.0,1,0.16831507625921535,47
3094,4,10100,2260,7840,0,0,0,1.0,1,1.0,1,1.0,1,0.13262797842972304,45
3095,0,10100,2260,7840,0,0,0,1.0,1,1.0,1,1.0,1,0.14749878804867764,46
3096,1,10101,2260,7841,0,0,0,1.0,1,1.0,1,1.0,1,0.1395179263224745,46
3097,3,10104,2261,7843,0,0,0,1.0,1,1.0,1,1.0,1,0.09514978370163281,47
3098,1,10105,2261,7844,0,0,0,1.0,1,1.0,1,1.0,1,0.11650794684212168,47
3099,0,10105,2261,7844,0,0,0,1.0,1,1.0,1,1.0,1,0.11650794684212168,47
3100,0,10105,2261,7844,0,0,0,1.0,1,1.0,1,1.0,1,0.11650794684212168,47
3101,0,10105,2261,7844,0,0,0,1.0,1,1.0,1,1.0,1,0.10004562227514509,48
3102,3,10108,2263,7845,0,0,0,1.0,1,1.0,1,1.0,1,0.11366708089456165,48
3103,4,10112,2264,7848,0,0,0,1.0,1,1.0,1,1.0,1,0.09731838899164677,49
3104,2,10114,2265,7849,0,0,0,1.0,1,1.0,1,1.0,1,0.1041231618165716,48
3105,2,10116,2266,7850,0,0,0,1.0,1,1.0,1,1.0,1,0.11671876248542902,45
3106,3,10119,2267,7852,0,0,0,1.0,1,1.0,1,1.0,1,0.08900300606279486,46
3107,0,10119,2267,7852,0,0,0,1.0,1,1.0,1,1.0,1,0.11701973736066754,44
3108,0,10119,2267,7852,0,0,0,1.0,1,1.0,1,1.0,1,0.10192276696065342,45
3109,1,10120,2267,7853,0,0,0,1.0,1,1.0,1,1.0,1,0.10111442275593478,44
3110,2,10122,2268,7854,0,0,0,1.0,1,1.0,1,1.0,1,0.11934094540049395,46
3111,1,10123,2269,7854,0,0,0,1.0,1,1.0,1,1.0,1,0.1317934784068681,46
3112,2,10125,2270,7855,0,0,0,1.0,1,1.0,1,1.0,1,0.13015088908517347,47
3113,1,10126,2271,7855,0,0,0,1.0,1,1.0,1,1.0,1,0.116417206127441,48
3114,1,10127,2271,7856,0,0,0,1.0,1,1.0,1,1.0,1,0.11772955516288185,48
3115,0,10127,2271,7856,0,0,0,1.0,1,1.0,1,1.0,1,0.1387039066235477,49
3116,0,10127,2271,7856,0,0,0,1.0,1,1.0,1,1.0,1,0.16480448217070243,48
3117,3,10130,2272,7858,0,0,0,1.0,1,1.0,1,1.0,1,0.16996166603720744,49
3118,2,10132,2272,7860,0,0,0,1.0,1,1.0,1,1.0,1,0.166830545579422,50
3119,1,10133,2272,7861,0,0,0,1.0,1,1.0,1,1.0,1,0.13768298789288733,50
3120,3,10136,2273,7863,0,0,0,1.0,1,1.0,1,1.0,1,0.16039381699095992,50
3121,3,10139,2273,7866,0,0,0,1.0,1,1.0,1,1.0,1,0.12656637705971396,50
3122,1,10140,2273,7867,0,0,0,1.0,1,1.0,1,1.0,1,0.12287327610899154,50
3123,1,10141,2274,7867,0,0,0,1.0,1,1.0,1,1.0,1,0.11444804006525637,51
3124,1,10142,2275,7867,0,0,0,1.0,1,1.0,1,1.0,1,0.14637572773006402,51
3125,2,10144,2276,7868,0,0,0,1.0,1,1.0,1,1.0,1,0.12481573428148664,51
3126,1,10145,2277,7868,0,0,0,1.0,1,1.0,1,1.0,1,0.12905016410773662,54
3127,3,10148,2279,7869,0,0,0,1.0,1,1.0,1,1.0,1,0.13686070122739738,53
3128,2,10150,2280,7870,0,0,0,1.0,1,1.0,1,1.0,1,0.15032285389598266,52
3129,1,10151,2281,7870,0,0,0,1.0,1,1.0,1,1.0,1,0.14938851156905744,51
3130,0,10151,2281,7870,0,0,0,1.0,1,1.0,1,1.0,1,0.15709850118524887,50
3131,1,10152,2282,7870,0,0,0,1.0,1,1.0,1,1.0,1,0.15811031139772655,50
3132,2,10154,2284,7870,0,0,0,1.0,1,1.0,1,1.0,1,0.20795497066708704,49
3133,2,10156,2286,7870,0,0,0,1.0,1,1.0,1,1.0,1,0.21748512628537506,49
3134,0,10156,2286,7870,0,0,0,1.0,1,1.0,1,1.0,1,0.2336848014184979,46
3135,1,10157,2287,7870,0,0,0,1.0,1,1.0,1,1.0,1,0.23011883121793839,47
3136,8,10165,2288,7877,0,0,0,1.0,1,1.0,1,1.0,1,0.1144509095773388,46
3137,4,10169,2291,7878,0,0,0,1.0,1,1.0,1,1.0,1,0.13773208986809277,49
3138,1,10170,2291,7879,0,0,0,1.0,1,1.0,1,1.0,1,0.12498112246292378,49
3139,1,10171,2292,7879,0,0,0,1.0,1,1.0,1,1.0,1,0.15186596723810902,50
3140,5,10176,2293,7883,0,0,0,1.0,1,1.0,1,1.0,1,0.14792634282036,51
3141,1,10177,2294,7883,0,0,0,1.0,1,1.0,1,1.0,1,0.17832212768172925,50
3142,2,10179,2294,7885,0,0,0,1.0,1,1.0,1,1.0,1,0.18017355219054854,50
3143,3,10182,2295,7887,0,0,0,1.0,1,1.0,1,1.0,1,0.2020906959633883,49
3144,6,10188,2296,7892,0,0,0,1.0,1,1.0,1,1.0,1,0.22400857368372787,49
3145,3,10191,2296,7895,0,0,0,1.0,1,1.0,1,1.0,1,0.19251049518256702,48
3146,7,10198,2298,7900,0,0,0,1.0,1,1.0,1,1.0,1,0.19140870206747218,49
3147,3,10201,2298,7903,0,0,0,1.0,1,1.0,1,1.0,1,0.17388761809566938,48
3148,6,10207,2299,7908,0,0,0,1.0,1,1.0,1,1.0,1,0.17364866993220557,48
3149,2,10209,2299,7910,0,0,0,1.0,1,1.0,1,1.0,1,0.17490116903624825,47
3150,2,10211,2299,7912,0,0,0,1.0,1,1.0,1,1.0,1,0.17490116903624825,47
3151,5,10216,2300,7916,0,0,0,1.0,1,1.0,1,1.0,1,0.14382619708649386,48
3152,1,10217,2300,7917,0,0,0,1.0,1,1.0,1,1.0,1,0.1337873539171712,47
3153,3,10220,2301,7919,0,0,0,1.0,1,1.0,1,1.0,1,0.11434933857199628,47
3154,2,10222,2302,7920,0,0,0,1.0,1,1.0,1,1.0,1,0.13269615552528635,48
3155,2,10224,2303,7921,0,0,0,1.0,1,1.0,1,1.0,1,0.14798228428859933,48
3156,2,10226,2303,7923,0,0,0,1.0,1,1.0,1,1.0,1,0.0852356423970485,48
3157,0,10226,2303,7923,0,0,0,1.0,1,1.0,1,1.0,1,0.1168229604933614,48
3158,1,10227,2304,7923,0,0,0,1.0,1,1.0,1,1.0,1,0.13860348346334864,48
3159,1,10228,2304,7924,0,0,0,1.0,1,1.0,1,1.0,1,0.13862150776239343,49
3160,2,10230,2304,7926,0,0,0,1.0,1,1.0,1,1.0,1,0.1520981257923303,51
3161,1,10231,2304,7927,0,0,0,1.0,1,1.0,1,1.0,1,0.1403703931404003,52
3162,1,10232,2305,7927,0,0,0,1.0,1,1.0,1,1.0,1,0.15151895721400085,51
3163,2,10234,2306,7928,0,0,0,1.0,1,1.0,1,1.0,1,0.16290808909210558,51
3164,2,10236,2307,7929,0,0,0,1.0,1,1.0,1,1.0,1,0.1930474559836029,52
3165,7,10243,2309,7934,0,0,0,1.0,1,1.0,1,1.0,1,0.1901250692028718,50
3166,7,10250,2309,7941,0,0,0,1.0,1,1.0,1,1.0,1,0.09957426453070253,50
3167,4,10254,2312,7942,0,0,0,1.0,1,1.0,1,1.0,1,0.16072114743373084,49
3168,3,10257,2313,7944,0,0,0,1.0,1,1.0,1,1.0,1,0.1301828279022619,47
3169,3,10260,2316,7944,0,0,0,1.0,1,1.0,1,1.0,1,0.15689169977996634,48
3170,2,10262,2316,7946,0,0,0,1.0,1,1.0,1,1.0,1,0.17295787817982688,47
3171,2,10264,2316,7948,0,0,0,1.0,1,1.0,1,1.0,1,0.18645698446266207,47
3172,3,10267,2317,7950,0,0,0,1.0,1,1.0,1,1.0,1,0.22427634609556726,46
3173,4,10271,2317,7954,0,0,0,1.0,1,1.0,1,1.0,1,0.1521741273901518,45
3174,1,10272,2318,7954,0,0,0,1.0,1,1.0,1,1.0,1,0.18376641831385707,43
3175,1,10273,2319,7954,0,0,0,1.0,1,1.0,1,1.0,1,0.15638426303437047,43
3176,1,10274,2320,7954,0,0,0,1.0,1,1.0,1,1.0,1,0.14326724918013006,44
3177,2,10276,2321,7955,0,0,0,1.0,1,1.0,1,1.0,1,0.14532854900655376,44
3178,0,10276,2321,7955,0,0,0,1.0,1,1.0,1,1.0,1,0.1420262351945073,47
3179,6,10282,2325,7957,0,0,0,1.0,1,1.0,1,1.0,1,0.1180183229866601,48
3180,3,10285,2326,7959,0,0,0,1.0,1,1.0,1,1.0,1,0.16025823047485,48
3181,4,10289,2326,7963,0,0,0,1.0,1,1.0,1,1.0,1,0.08608688562296672,48
3182,1,10290,2327,7963,0,0,0,1.0,1,1.0,1,1.0,1,0.095622937732779,51
3183,2,10292,2328,7964,0,0,0,1.0,1,1.0,1,1.0,1,0.1079527869497809,50
3184,6,10298,2330,7968,0,0,0,1.0,1,1.0,1,1.0,1,0.11876406010708061,50
3185,2,10300,2330,7970,0,0,0,1.0,1,1.0,1,1.0,1,0.14173689045837387,48
3186,3,10303,2331,7972,0,0,0,1.0,1,1.0,1,1.0,1,0.15436178717499405,48
3187,8,10311,2331,7980,0,0,0,1.0,1,1.0,1,1.0,1,0.1785680540874439,48
3188,4,10315,2332,7983,0,0,0,1.0,1,1.0,1,1.0,1,0.21675876666007104,48
3189,9,10324,2332,7992,0,0,0,1.0,1,1.0,1,1.0,1,0.21350640339287566,49
3190,4,10328,2332,7996,0,0,0,1.0,1,1.0,1,1.0,1,0.19996924813479175,51
3191,6,10334,2332,8002,0,0,0,1.0,1,1.0,1,1.0,1,0.19623700023058002,52
3192,5,10339,2332,8007,0,0,0,1.0,1,1.0,1,1.0,1,0.17599278803672763,52
3193,4,10343,2332,8011,0,0,0,1.0,1,1.0,1,1.0,1,0.1715362327216306,52
3194,5,10348,2332,8016,0,0,0,1.0,1,1.0,1,1.0,1,0.16641965988807242,54
3195,4,10352,2332,8020,0,0,0,1.0,1,1.0,1,1.0,1,0.13828677111701831,54
3196,5,10357,2335,8022,0,0,0,1.0,1,1.0,1,1.0,1,0.12767814745623682,54
3197,1,10358,2335,8023,0,0,0,1.0,1,1.0,1,1.0,1,0.13296302536833818,54
3198,3,10361,2336,8025,0,0,0,1.0,1,1.0,1,1.0,1,0.14078632994754028,54
3199,5,10366,2336,8030,0,0,0,1.0,1,1.0,1,1.0,1,0.1496200691176885,56
3200,4,10370,2338,8032,0,0,0,1.0,1,1.0,1,1.0,1,0.21348172842520596,56
3201,4,10374,2338,8036,0,0,0,1.0,1,1.0,1,1.0,1,0.17891106921229727,56
3202,3,10377,2338,8039,0,0,0,1.0,1,1.0,1,1.0,1,0.1808407681555353,57
3203,2,10379,2338,8041,0,0,0,1.0,1,1.0,1,1.0,1,0.18293301674185478,56
3204,8,10387,2341,8046,0,0,0,1.0,1,1.0,1,1.0,1,0.21318919133020972,55
3205,2,10389,2341,8048,0,0,0,1.0,1,1.0,1,1.0,1,0.19185783494374117,54
3206,8,10397,2344,8053,0,0,0,1.0,1,1.0,1,1.0,1,0.22654400558205637,56
3207,4,10401,2345,8056,0,0,0,1.0,1,1.0,1,1.0,1,0.23541570922232008,54
3208,6,10407,2346,8061,0,0,0,1.0,1,1.0,1,1.0,1,0.27720098699661416,53
3209,6,10413,2346,8067,0,0,0,1.0,1,1.0,1,1.0,1,0.2601112784169484,54
3210,4,10417,2347,8070,0,0,0,1.0,1,1.0,1,1.0,1,0.26895874307398054,53
3211,8,10425,2348,8077,0,0,0,1.0,1,1.0,1,1.0,1,0.17789165967399306,53
3212,2,10427,2348,8079,0,0,0,1.0,1,1.0,1,1.0,1,0.18402389043799292,54
3213,2,10429,2348,8081,0,0,0,1.0,1,1.0,1,1.0,1,0.16848368827242302,54
3214,2,10431,2348,8083,0,0,0,1.0,1,1.0,1,1.0,1,0.16560614912041058,55
3215,2,10433,2348,8085,0,0,0,1.0,1,1.0,1,1.0,1,0.16560614912041058,55
3216,0,10433,2348,8085,0,0,0,1.0,1,1.0,1,1.0,1,0.16560614912041058,55
3217,4,10437,2351,8086,0,0,0,1.0,1,1.0,1,1.0,1,0.21021742343882935,54
3218,2,10439,2351,8088,0,0,0,1.0,1,1.0,1,1.0,1,0.16173817385985892,54
3219,3,10442,2351,8091,0,0,0,1.0,1,1.0,1,1.0,1,0.18537947383052933,55
3220,1,10443,2351,8092,0,0,0,1.0,1,1.0,1,1.0,1,0.15868017251251515,56
3221,2,10445,2352,8093,0,0,0,1.0,1,1.0,1,1.0,1,0.17082745446332978,57
3222,4,10449,2353,8096,0,0,0,1.0,1,1.0,1,1.0,1,0.16386269543246343,57
3223,5,10454,2354,8100,0,0,0,1.0,1,1.0,1,1.0,1,0.18322566569159868,56
3224,9,10463,2357,8106,0,0,0,1.0,1,1.0,1,1.0,1,0.15765147185297382,58
3225,4,10467,2358,8109,0,0,0,1.0,1,1.0,1,1.0,1,0.14959898052857523,55
3226,6,10473,2360,8113,0,0,0,1.0,1,1.0,1,1.0,1,0.12741384942881762,54
3227,0,10473,2360,8113,0,0,0,1.0,1,1.0,1,1.0,1,0.09413964730071779,53
3228,5,10478,2362,8116,0,0,0,1.0,1,1.0,1,1.0,1,0.11174826826511161,52
3229,4,10482,2365,8117,0,0,0,1.0,1,1.0,1,1.0,1,0.15114657270994125,52
3230,2,10484,2366,8118,0,0,0,1.0,1,1.0,1,1.0,1,0.18717366188422907,50
3231,5,10489,2369,8120,0,0,0,1.0,1,1.0,1,1.0,1,0.20499771213784249,50
3232,2,10491,2371,8120,0,0,0,1.0,1,1.0,1,1.0,1,0.2215488486015863,50
3233,2,10493,2372,8121,0,0,0,1.0,1,1.0,1,1.0,1,0.18402626284613227,50
3234,3,10496,2374,8122,0,0,0,1.0,1,1.0,1,1.0,1,0.20142091173516066,49
3235,6,10502,2376,8126,0,0,0,1.0,1,1.0,1,1.0,1,0.2690862863801237,49
3236,4,10506,2376,8130,0,0,0,1.0,1,1.0,1,1.0,1,0.2451551029491098,51
3237,5,10511,2377,8134,0,0,0,1.0,1,1.0,1,1.0,1,0.2302835159044571,53
3238,5,10516,2377,8139,0,0,0,1.0,1,1.0,1,1.0,1,0.2535141288525877,53
3239,5,10521,2377,8144,0,0,0,1.0,1,1.0,1,1.0,1,0.25667808052641566,53
3240,3,10524,2377,8147,0,0,0,1.0,1,1.0,1,1.0,1,0.24616460055605824,53
3241,8,10532,2377,8155,0,0,0,1.0,1,1.0,1,1.0,1,0.18854540320034247,53
3242,1,10533,2377,8156,0,0,0,1.0,1,1.0,1,1.0,1,0.1843626548166934,53
3243,1,10534,2377,8157,0,0,0,1.0,1,1.0,1,1.0,1,0.1593659059114344,56
3244,3,10537,2377,8160,0,0,0,1.0,1,1.0,1,1.0,1,0.16118850756633496,57
3245,8,10545,2377,8168,0,0,0,1.0,1,1.0,1,1.0,1,0.14032737054147312,59
3246,4,10549,2377,8172,0,0,0,1.0,1,1.0,1,1.0,1,0.14043051881255716,59
3247,7,10556,2378,8178,0,0,0,1.0,1,1.0,1,1.0,1,0.122782812635889,59
3248,9,10565,2379,8186,0,0,0,1.0,1,1.0,1,1.0,1,0.13212650575167226,59
3249,4,10569,2379,8190,0,0,0,1.0,1,1.0,1,1.0,1,0.15957055247518637,58
3250,7,10576,2379,8197,0,0,0,1.0,1,1.0,1,1.0,1,0.10594070685608643,58
3251,4,10580,2379,8201,0,0,0,1.0,1,1.0,1,1.0,1,0.15736932137004037,57
3252,8,10588,2379,8209,0,0,0,1.0,1,1.0,1,1.0,1,0.16331813072049375,57
3253,4,10592,2379,8213,0,0,0,1.0,1,1.0,1,1.0,1,0.1706596384915375,56
3254,4,10596,2380,8216,0,0,0,1.0,1,1.0,1,1.0,1,0.16013771018997466,57
3255,6,10602,2381,8221,0,0,0,1.0,1,1.0,1,1.0,1,0.184210615958134,57
3256,5,10607,2381,8226,0,0,0,1.0,1,1.0,1,1.0,1,0.12226465655792088,57
3257,0,10607,2381,8226,0,0,0,1.0,1,1.0,1,1.0,1,0.12226465655792088,57
3258,4,10611,2381,8230,0,0,0,1.0,1,1.0,1,1.0,1,0.14050003660047222,58
3259,4,10615,2382,8233,0,0,0,1.0,1,1.0,1,1.0,1,0.10525456733684425,59
3260,1,10616,2382,8234,0,0,0,1.0,1,1.0,1,1.0,1,0.13745148712009833,60
3261,5,10621,2384,8237,0,0,0,1.0,1,1.0,1,1.0,1,0.14518506092324315,60
3262,4,10625,2387,8238,0,0,0,1.0,1,1.0,1,1.0,1,0.17141428014901106,61
3263,4,10629,2390,8239,0,0,0,1.0,1,1.0,1,1.0,1,0.1655172273891893,62
3264,6,10635,2395,8240,0,0,0,1.0,1,1.0,1,1.0,1,0.17093772245234323,60
3265,2,10637,2396,8241,0,0,0,1.0,1,1.0,1,1.0,1,0.18460665221426914,58
3266,8,10645,2402,8243,0,0,0,1.0,1,1.0,1,1.0,1,0.20974469761551823,59
3267,6,10651,2404,8247,0,0,0,1.0,1,1.0,1,1.0,1,0.20856515702121267,60
3268,7,10658,2408,8250,0,0,0,1.0,1,1.0,1,1.0,1,0.24747268320680846,58
3269,3,10661,2409,8252,0,0,0,1.0,1,1.0,1,1.0,1,0.20387700170033773,57
3270,2,10663,2410,8253,0,0,0,1.0,1,1.0,1,1.0,1,0.1770412233766477,56
3271,7,10670,2411,8259,0,0,0,1.0,1,1.0,1,1.0,1,0.09048185475231443,55
3272,0,10670,2411,8259,0,0,0,1.0,1,1.0,1,1.0,1,0.0900515289350662,55
3273,4,10674,2413,8261,0,0,0,1.0,1,1.0,1,1.0,1,0.14270120646088577,55
3274,1,10675,2414,8261,0,0,0,1.0,1,1.0,1,1.0,1,0.15815968375543588,55
3275,2,10677,2415,8262,0,0,0,1.0,1,1.0,1,1.0,1,0.15924025775582512,55
3276,2,10679,2415,8264,0,0,0,1.0,1,1.0,1,1.0,1,0.1595739550077832,55
3277,6,10685,2416,8269,0,0,0,1.0,1,1.0,1,1.0,1,0.17835736289930645,57
3278,4,10689,2417,8272,0,0,0,1.0,1,1.0,1,1.0,1,0.1300887784815829,56
3279,2,10691,2417,8274,0,0,0,1.0,1,1.0,1,1.0,1,0.10294350263008842,54
3280,2,10693,2418,8275,0,0,0,1.0,1,1.0,1,1.0,1,0.11581565032729077,53
3281,0,10693,2418,8275,0,0,0,1.0,1,1.0,1,1.0,1,0.113693737858885,52
3282,0,10693,2418,8275,0,0,0,1.0,1,1.0,1,1.0,1,0.12353536333844291,50
3283,5,10698,2420,8278,0,0,0,1.0,1,1.0,1,1.0,1,0.11095290186329759,50
3284,0,10698,2420,8278,0,0,0,1.0,1,1.0,1,1.0,1,0.12918103318397564,47
3285,2,10700,2420,8280,0,0,0,1.0,1,1.0,1,1.0,1,0.1338224074761164,48
3286,7,10707,2423,8284,0,0,0,1.0,1,1.0,1,1.0,1,0.09123342180822556,46
3287,5,10712,2425,8287,0,0,0,1.0,1,1.0,1,1.0,1,0.059263786385262134,46
3288,6,10718,2428,8290,0,0,0,1.0,1,1.0,1,1.0,1,0.09510353233737244,46
3289,5,10723,2429,8294,0,0,0,1.0,1,1.0,1,1.0,1,0.1565457699773663,48
3290,4,10727,2430,8297,0,0,0,1.0,1,1.0,1,1.0,1,0.14385268673208723,48
3291,6,10733,2431,8302,0,0,0,1.0,1,1.0,1,1.0,1,0.18905738778612532,50
3292,8,10741,2432,8309,0,0,0,1.0,1,1.0,1,1.0,1,0.18586225829709968,50
3293,8,10749,2433,8316,0,0,0,1.0,1,1.0,1,1.0,1,0.20582831783133984,51
3294,6,10755,2433,8322,0,0,0,1.0,1,1.0,1,1.0,1,0.18796479944699593,50
3295,3,10758,2433,8325,0,0,0,1.0,1,1.0,1,1.0,1,0.1914087629031188,50
3296,5,10763,2435,8328,0,0,0,1.0,1,1.0,1,1.0,1,0.2202601965848805,50
3297,3,10766,2435,8331,0,0,0,1.0,1,1.0,1,1.0,1,0.20470729164451226,51
3298,6,10772,2435,8337,0,0,0,1.0,1,1.0,1,1.0,1,0.2132047124838174,52
3299,4,10776,2435,8341,0,0,0,1.0,1,1.0,1,1.0,1,0.21762845061446962,53
3300,3,10779,2435,8344,0,0,0,1.0,1,1.0,1,1.0,1,0.1963076604474186,53
3301,10,10789,2436,8353,0,0,0,1.0,1,1.0,1,1.0,1,0.07235937437648893,53
3302,5,10794,2437,8357,0,0,0,1.0,1,1.0,1,1.0,1,0.06588323540985534,53
3303,4,10798,2438,8360,0,0,0,1.0,1,1.0,1,1.0,1,0.061606934073139434,52
3304,8,10806,2442,8364,0,0,0,1.0,1,1.0,1,1.0,1,0.10539722044814047,52
3305,3,10809,2444,8365,0,0,0,1.0,1,1.0,1,1.0,1,0.1552042890629531,51
3306,7,10816,2446,8370,0,0,0,1.0,1,1.0,1,1.0,1,0.10485429790240833,51
3307,5,10821,2446,8375,0,0,0,1.0,1,1.0,1,1.0,1,0.10531318793270915,48
3308,7,10828,2448,8380,0,0,0,1.0,1,1.0,1,1.0,1,0.11008436366369324,48
3309,5,10833,2448,8385,0,0,0,1.0,1,1.0,1,1.0,1,0.17210296501983546,48
3310,3,10836,2448,8388,0,0,0,1.0,1,1.0,1,1.0,1,0.21888050599332065,47
3311,4,10840,2449,8391,0,0,0,1.0,1,1.0,1,1.0,1,0.21912903750551047,49
3312,6,10846,2449,8397,0,0,0,1.0,1,1.0,1,1.0,1,0.236688305816198,48
3313,7,10853,2452,8401,0,0,0,1.0,1,1.0,1,1.0,1,0.23462033225550727,49
3314,4,10857,2452,8405,0,0,0,1.0,1,1.0,1,1.0,1,0.2557546634905867,47
3315,8,10865,2454,8411,0,0,0,1.0,1,1.0,1,1.0,1,0.2889254183765489,47
3316,6,10871,2454,8417,0,0,0,1.0,1,1.0,1,1.0,1,0.19787284800242652,47
3317,3,10874,2455,8419,0,0,0,1.0,1,1.0,1,1.0,1,0.14944796988539177,46
3318,2,10876,2456,8420,0,0,0,1.0,1,1.0,1,1.0,1,0.14028264751090794,45
3319,3,10879,2456,8423,0,0,0,1.0,1,1.0,1,1.0,1,0.13253259850359733,44
3320,1,10880,2456,8424,0,0,0,1.0,1,1.0,1,1.0,1,0.17141952057498885,43
3321,2,10882,2457,8425,0,0,0,1.0,1,1.0,1,1.0,1,0.14339196253251052,43
3322,0,10882,2457,8425,0,0,0,1.0,1,1.0,1,1.0,1,0.1715335348628789,40
3323,0,10882,2457,8425,0,0,0,1.0,1,1.0,1,1.0,1,0.20352331474006133,40
3324,6,10888,2460,8428,0,0,0,1.0,1,1.0,1,1.0,1,0.20645901368520886,40
3325,3,10891,2462,8429,0,0,0,1.0,1,1.0,1,1.0,1,0.25277980771760133,40
3326,4,10895,2462,8433,0,0,0,1.0,1,1.0,1,1.0,1,0.22438529339619617,41
3327,2,10897,2463,8434,0,0,0,1.0,1,1.0,1,1.0,1,0.23269286372985676,39
3328,7,10904,2467,8437,0,0,0,1.0,1,1.0,1,1.0,1,0.30947187207554355,41
3329,3,10907,2468,8439,0,0,0,1.0,1,1.0,1,1.0,1,0.256499450684802,39
3330,3,10910,2470,8440,0,0,0,1.0,1,1.0,1,1.0,1,0.2924189422866231,40
3331,6,10916,2470,8446,0,0,0,1.0,1,1.0,1,1.0,1,0.15196005498107937,38
3332,1,10917,2470,8447,0,0,0,1.0,1,1.0,1,1.0,1,0.20945795308198642,38
3333,1,10918,2470,8448,0,0,0,1.0,1,1.0,1,1.0,1,0.18397677930184522,38
3334,3,10921,2470,8451,0,0,0,1.0,1,1.0,1,1.0,1,0.166375942874651,40
3335,2,10923,2470,8453,0,0,0,1.0,1,1.0,1,1.0,1,0.15041740004392792,40
3336,0,10923,2470,8453,0,0,0,1.0,1,1.0,1,1.0,1,0.18466312901435092,39
3337,2,10925,2470,8455,0,0,0,1.0,1,1.0,1,1.0,1,0.1596244968122538,40
3338,1,10926,2471,8455,0,0,0,1.0,1,1.0,1,1.0,1,0.2026660215178712,41
3339,2,10928,2472,8456,0,0,0,1.0,1,1.0,1,1.0,1,0.15270346997451809,42
3340,4,10932,2474,8458,0,0,0,1.0,1,1.0,1,1.0,1,0.19559615148364387,43
3341,6,10938,2474,8464,0,0,0,1.0,1,1.0,1,1.0,1,0.1901802986971655,43
3342,8,10946,2475,8471,0,0,0,1.0,1,1.0,1,1.0,1,0.2625589703165969,44
3343,8,10954,2477,8477,0,0,0,1.0,1,1.0,1,1.0,1,0.22627925067183305,44
3344,12,10966,2479,8487,0,0,0,1.0,1,1.0,1,1.0,1,0.2539224912256533,44
3345,7,10973,2479,8494,0,0,0,1.0,1,1.0,1,1.0,1,0.24883671487806466,43
3346,1,10974,2479,8495,0,0,0,1.0,1,1.0,1,1.0,1,0.26715078706799483,42
3347,0,10974,2479,8495,0,0,0,1.0,1,1.0,1,1.0,1,0.23547763946475378,44
3348,1,10975,2479,8496,0,0,0,1.0,1,1.0,1,1.0,1,0.23232155172658167,45
3349,1,10976,2480,8496,0,0,0,1.0,1,1.0,1,1.0,1,0.23172730293937005,45
3350,2,10978,2480,8498,0,0,0,1.0,1,1.0,1,1.0,1,0.20526102922563266,46
3351,1,10979,2480,8499,0,0,0,1.0,1,1.0,1,1.0,1,0.1794383070635754,47
3352,3,10982,2481,8501,0,0,0,1.0,1,1.0,1,1.0,1,0.19169148255872995,47
3353,5,10987,2482,8505,0,0,0,1.0,1,1.0,1,1.0,1,0.19176565672446227,48
3354,4,10991,2483,8508,0,0,0,1.0,1,1.0,1,1.0,1,0.18655700809415576,48
3355,2,10993,2484,8509,0,0,0,1.0,1,1.0,1,1.0,1,0.15965402138813176,48
3356,2,10995,2484,8511,0,0,0,1.0,1,1.0,1,1.0,1,0.1335257172058473,48
3357,1,10996,2484,8512,0,0,0,1.0,1,1.0,1,1.0,1,0.15613462769431652,47
3358,2,10998,2485,8513,0,0,0,1.0,1,1.0,1,1.0,1,0.11016209301406665,46
3359,3,11001,2486,8515,0,0,0,1.0,1,1.0,1,1.0,1,0.09840487378953429,45
3360,3,11004,2488,8516,0,0,0,1.0,1,1.0,1,1.0,1,0.14755524091592145,44
3361,2,11006,2489,8517,0,0,0,1.0,1,1.0,1,1.0,1,0.12962361650840631,43
3362,4,11010,2490,8520,0,0,0,1.0,1,1.0,1,1.0,1,0.19740022878344438,42
3363,5,11015,2491,8524,0,0,0,1.0,1,1.0,1,1.0,1,0.24924270570140059,41
3364,1,11016,2491,8525,0,0,0,1.0,1,1.0,1,1.0,1,0.2922680732076529,41
3365,0,11016,2491,8525,0,0,0,1.0,1,1.0,1,1.0,1,0.29317459035651333,41
3366,2,11018,2491,8527,0,0,0,1.0,1,1.0,1,1.0,1,0.25214231974657464,40
3367,2,11020,2492,8528,0,0,0,1.0,1,1.0,1,1.0,1,0.21181274359689425,39
3368,0,11020,2492,8528,0,0,0,1.0,1,1.0,1,1.0,1,0.21181274359689425,39
3369,0,11020,2492,8528,0,0,0,1.0,1,1.0,1,1.0,1,0.20039227435331244,40
3370,2,11022,2494,8528,0,0,0,1.0,1,1.0,1,1.0,1,0.2102339198232866,41
3371,1,11023,2495,8528,0,0,0,1.0,1,1.0,1,1.0,1,0.21875763271121315,41
3372,2,11025,2497,8528,0,0,0,1.0,1,1.0,1,1.0,1,0.21279765756268273,40
3373,3,11028,2498,8530,0,0,0,1.0,1,1.0,1,1.0,1,0.23622275878528684,41
3374,1,11029,2498,8531,0,0,0,1.0,1,1.0,1,1.0,1,0.24374096377593488,42
3375,5,11034,2498,8536,0,0,0,1.0,1,1.0,1,1.0,1,0.1947678667414948,44
3376,7,11041,2499,8542,0,0,0,1.0,1,1.0,1,1.0,1,0.11634910260544189,46
3377,2,11043,2499,8544,0,0,0,1.0,1,1.0,1,1.0,1,0.11122297708050838,47
3378,3,11046,2500,8546,0,0,0,1.0,1,1.0,1,1.0,1,0.12024696140812223,48
3379,2,11048,2500,8548,0,0,0,1.0,1,1.0,1,1.0,1,0.12024696140812223,48
3380,3,11051,2502,8549,0,0,0,1.0,1,1.0,1,1.0,1,0.17759166126703374,48
3381,3,11054,2502,8552,0,0,0,1.0,1,1.0,1,1.0,1,0.16597757841793584,48
3382,4,11058,2503,8555,0,0,0,1.0,1,1.0,1,1.0,1,0.1631322153136647,49
3383,0,11058,2503,8555,0,0,0,1.0,1,1.0,1,1.0,1,0.14803342055065852,47
3384,10,11068,2506,8562,0,0,0,1.0,1,1.0,1,1.0,1,0.2039471951400809,48
3385,0,11068,2506,8562,0,0,0,1.0,1,1.0,1,1.0,1,0.16887580555749904,47
3386,9,11077,2508,8569,0,0,0,1.0,1,1.0,1,1.0,1,0.1829783075762382,49
3387,2,11079,2508,8571,0,0,0,1.0,1,1.0,1,1.0,1,0.1700961365409153,48
3388,3,11082,2508,8574,0,0,0,1.0,1,1.0,1,1.0,1,0.17135423163128163,48
3389,2,11084,2508,8576,0,0,0,1.0,1,1.0,1,1.0,1,0.1873548119205288,50
3390,2,11086,2509,8577,0,0,0,1.0,1,1.0,1,1.0,1,0.18204719893042975,51
3391,4,11090,2509,8581,0,0,0,1.0,1,1.0,1,1.0,1,0.11946703786539284,51
3392,1,11091,2509,8582,0,0,0,1.0,1,1.0,1,1.0,1,0.11216316976322152,52
3393,2,11093,2509,8584,0,0,0,1.0,1,1.0,1,1.0,1,0.10500230803845849,52
3394,0,11093,2509,8584,0,0,0,1.0,1,1.0,1,1.0,1,0.10500230803845849,52
3395,0,11093,2509,8584,0,0,0,1.0,1,1.0,1,1.0,1,0.11385788040059688,50
3396,0,11093,2509,8584,0,0,0,1.0,1,1.0,1,1.0,1,0.11880326252466414,49
3397,0,11093,2509,8584,0,0,0,1.0,1,1.0,1,1.0,1,0.12486182754390605,49
3398,0,11093,2509,8584,0,0,0,1.0,1,1.0,1,1.0,1,0.1399822297036168,48
3399,3,11096,2510,8586,0,0,0,1.0,1,1.0,1,1.0,1,0.14951631347650648,49
3400,2,11098,2511,8587,0,0,0,1.0,1,1.0,1,1.0,1,0.15182978324575738,50
3401,3,11101,2511,8590,0,0,0,1.0,1,1.0,1,1.0,1,0.1446053350137882,51
3402,4,11105,2512,8593,0,0,0,1.0,1,1.0,1,1.0,1,0.18428275185533996,51
3403,3,11108,2512,8596,0,0,0,1.0,1,1.0,1,1.0,1,0.16702114712877592,51
3404,1,11109,2512,8597,0,0,0,1.0,1,1.0,1,1.0,1,0.15492370884856563,51
3405,0,11109,2512,8597,0,0,0,1.0,1,1.0,1,1.0,1,0.15492370884856563,51
3406,2,11111,2512,8599,0,0,0,1.0,1,1.0,1,1.0,1,0.10268617575855349,51
3407,1,11112,2512,8600,0,0,0,1.0,1,1.0,1,1.0,1,0.08192269150565233,52
3408,1,11113,2512,8601,0,0,0,1.0,1,1.0,1,1.0,1,0.102043212741971,53
3409,1,11114,2513,8601,0,0,0,1.0,1,1.0,1,1.0,1,0.09839093609139624,54
3410,3,11117,2515,8602,0,0,0,1.0,1,1.0,1,1.0,1,0.1235950188779371,54
3411,3,11120,2515,8605,0,0,0,1.0,1,1.0,1,1.0,1,0.11573368029247981,54
3412,4,11124,2516,8608,0,0,0,1.0,1,1.0,1,1.0,1,0.15032755573443693,55
3413,3,11127,2516,8611,0,0,0,1.0,1,1.0,1,1.0,1,0.1582751711461533,55
3414,3,11130,2516,8614,0,0,0,1.0,1,1.0,1,1.0,1,0.18211775738285604,55
3415,7,11137,2519,8618,0,0,0,1.0,1,1.0,1,1.0,1,0.20435447091885925,56
3416,5,11142,2519,8623,0,0,0,1.0,1,1.0,1,1.0,1,0.18688668793433713,55
3417,8,11150,2519,8631,0,0,0,1.0,1,1.0,1,1.0,1,0.18408759496578153,56
3418,6,11156,2520,8636,0,0,0,1.0,1,1.0,1,1.0,1,0.23245100500495458,55
3419,10,11166,2521,8645,0,0,0,1.0,1,1.0,1,1.0,1,0.24912882245789672,56
3420,5,11171,2521,8650,0,0,0,1.0,1,1.0,1,1.0,1,0.27499020290848086,55
3421,11,11182,2522,8660,0,0,0,1.0,1,1.0,1,1.0,1,0.18837280897338707,57
3422,2,11184,2523,8661,0,0,0,1.0,1,1.0,1,1.0,1,0.200179209907234,56
3423,2,11186,2524,8662,0,0,0,1.0,1,1.0,1,1.0,1,0.18628803980713615,56
3424,1,11187,2524,8663,0,0,0,1.0,1,1.0,1,1.0,1,0.1904924003886301,56
3425,2,11189,2524,8665,0,0,0,1.0,1,1.0,1,1.0,1,0.19081097771381778,56
3426,4,11193,2525,8668,0,0,0,1.0,1,1.0,1,1.0,1,0.1971475176995508,55
3427,6,11199,2526,8673,0,0,0,1.0,1,1.0,1,1.0,1,0.19407344390706066,55
3428,6,11205,2528,8677,0,0,0,1.0,1,1.0,1,1.0,1,0.2099418363484416,55
3429,3,11208,2528,8680,0,0,0,1.0,1,1.0,1,1.0,1,0.21838208504769754,54
3430,2,11210,2529,8681,0,0,0,1.0,1,1.0,1,1.0,1,0.2065728518081908,56
3431,0,11210,2529,8681,0,0,0,1.0,1,1.0,1,1.0,1,0.20775427542745017,54
3432,1,11211,2529,8682,0,0,0,1.0,1,1.0,1,1.0,1,0.22519089558587085,56
3433,5,11216,2531,8685,0,0,0,1.0,1,1.0,1,1.0,1,0.2470496291259869,53
3434,4,11220,2531,8689,0,0,0,1.0,1,1.0,1,1.0,1,0.23282990008987983,51
3435,4,11224,2531,8693,0,0,0,1.0,1,1.0,1,1.0,1,0.2193966437532605,51
3436,9,11233,2532,8701,0,0,0,1.0,1,1.0,1,1.0,1,0.10527799927157162,51
3437,8,11241,2533,8708,0,0,0,1.0,1,1.0,1,1.0,1,0.1318907596047611,53
3438,4,11245,2533,8712,0,0,0,1.0,1,1.0,1,1.0,1,0.06472705879484802,52
3439,8,11253,2534,8719,0,0,0,1.0,1,1.0,1,1.0,1,0.1573763330282062,54
3440,6,11259,2535,8724,0,0,0,1.0,1,1.0,1,1.0,1,0.0954532593297477,52
3441,6,11265,2535,8730,0,0,0,1.0,1,1.0,1,1.0,1,0.10669178826709902,53
3442,7,11272,2536,8736,0,0,0,1.0,1,1.0,1,1.0,1,0.14259350251305877,53
3443,8,11280,2537,8743,0,0,0,1.0,1,1.0,1,1.0,1,0.15877655475869246,53
3444,7,11287,2538,8749,0,0,0,1.0,1,1.0,1,1.0,1,0.17736440623794142,52
3445,7,11294,2538,8756,0,0,0,1.0,1,1.0,1,1.0,1,0.18385447824193876,53
3446,17,11311,2541,8770,0,0,0,1.0,1,1.0,1,1.0,1,0.20934819995256054,53
3447,12,11323,2542,8781,0,0,0,1.0,1,1.0,1,1.0,1,0.23548134828592135,53
3448,12,11335,2544,8791,0,0,0,1.0,1,1.0,1,1.0,1,0.30953693650097164,52
3449,11,11346,2547,8799,0,0,0,1.0,1,1.0,1,1.0,1,0.2420067521246084,52
3450,9,11355,2547,8808,0,0,0,1.0,1,1.0,1,1.0,1,0.25337307689743144,52
3451,9,11364,2549,8815,0,0,0,1.0,1,1.0,1,1.0,1,0.11367166400931089,54
3452,0,11364,2549,8815,0,0,0,1.0,1,1.0,1,1.0,1,0.11367166400931089,54
3453,1,11365,2550,8815,0,0,0,1.0,1,1.0,1,1.0,1,0.11044662225861618,54
3454,1,11366,2550,8816,0,0,0,1.0,1,1.0,1,1.0,1,0.10678278356650005,57
3455,1,11367,2550,8817,0,0,0,1.0,1,1.0,1,1.0,1,0.08516878211068689,57
3456,2,11369,2551,8818,0,0,0,1.0,1,1.0,1,1.0,1,0.13928526323521082,58
3457,2,11371,2551,8820,0,0,0,1.0,1,1.0,1,1.0,1,0.16018454649300853,57
3458,2,11373,2551,8822,0,0,0,1.0,1,1.0,1,1.0,1,0.14822904949885718,57
3459,2,11375,2551,8824,0,0,0,1.0,1,1.0,1,1.0,1,0.14822904949885718,57
3460,1,11376,2551,8825,0,0,0,1.0,1,1.0,1,1.0,1,0.16809458509088565,58
3461,5,11381,2551,8830,0,0,0,1.0,1,1.0,1,1.0,1,0.13739922048704478,59
3462,2,11383,2551,8832,0,0,0,1.0,1,1.0,1,1.0,1,0.13739922048704478,59
3463,1,11384,2551,8833,0,0,0,1.0,1,1.0,1,1.0,1,0.1392411269269363,59
3464,6,11390,2553,8837,0,0,0,1.0,1,1.0,1,1.0,1,0.1341595406120452,59
3465,6,11396,2554,8842,0,0,0,1.0,1,1.0,1,1.0,1,0.13837071090382186,57
3466,7,11403,2556,8847,0,0,0,1.0,1,1.0,1,1.0,1,0.08745246880136864,57
3467,3,11406,2557,8849,0,0,0,1.0,1,1.0,1,1.0,1,0.08074039055360956,57
3468,1,11407,2558,8849,0,0,0,1.0,1,1.0,1,1.0,1,0.10375652547271792,57
3469,4,11411,2562,8849,0,0,0,1.0,1,1.0,1,1.0,1,0.13239950076473775,53
3470,4,11415,2564,8851,0,0,0,1.0,1,1.0,1,1.0,1,0.09294116306674254,50
3471,1,11416,2565,8851,0,0,0,1.0,1,1.0,1,1.0,1,0.09194457642015487,49
3472,2,11418,2567,8851,0,0,0,1.0,1,1.0,1,1.0,1,0.10165465106269995,47
3473,3,11421,2570,8851,0,0,0,1.0,1,1.0,1,1.0,1,0.14382452389887182,45
3474,2,11423,2571,8852,0,0,0,1.0,1,1.0,1,1.0,1,0.12437791984964287,42
3475,2,11425,2573,8852,0,0,0,1.0,1,1.0,1,1.0,1,0.18508604579052795,43
3476,2,11427,2575,8852,0,0,0,1.0,1,1.0,1,1.0,1,0.20861414721501936,41
3477,4,11431,2578,8853,0,0,0,1.0,1,1.0,1,1.0,1,0.1530584222711523,42
3478,2,11433,2580,8853,0,0,0,1.0,1,1.0,1,1.0,1,0.17739714768944115,40
3479,2,11435,2582,8853,0,0,0,1.0,1,1.0,1,1.0,1,0.20576497970817267,40
3480,0,11435,2582,8853,0,0,0,1.0,1,1.0,1,1.0,1,0.20032642461179406,40
3481,5,11440,2582,8858,0,0,0,1.0,1,1.0,1,1.0,1,0.1381578670633513,40
3482,1,11441,2582,8859,0,0,0,1.0,1,1.0,1,1.0,1,0.12605900774366466,40
3483,0,11441,2582,8859,0,0,0,1.0,1,1.0,1,1.0,1,0.1257090647934895,39
3484,0,11441,2582,8859,0,0,0,1.0,1,1.0,1,1.0,1,0.1257090647934895,39
3485,4,11445,2583,8862,0,0,0,1.0,1,1.0,1,1.0,1,0.11255923184480093,40
3486,2,11447,2583,8864,0,0,0,1.0,1,1.0,1,1.0,1,0.11334737097319846,41
3487,1,11448,2583,8865,0,0,0,1.0,1,1.0,1,1.0,1,0.1648365325512958,41
3488,2,11450,2584,8866,0,0,0,1.0,1,1.0,1,1.0,1,0.14548243787522033,42
3489,2,11452,2584,8868,0,0,0,1.0,1,1.0,1,1.0,1,0.12944032833136365,44
3490,1,11453,2584,8869,0,0,0,1.0,1,1.0,1,1.0,1,0.13708886616330715,44
3491,4,11457,2584,8873,0,0,0,1.0,1,1.0,1,1.0,1,0.13684144634225426,45
3492,3,11460,2585,8875,0,0,0,1.0,1,1.0,1,1.0,1,0.15992587197978042,45
3493,2,11462,2586,8876,0,0,0,1.0,1,1.0,1,1.0,1,0.13774112713069586,45
3494,4,11466,2586,8880,0,0,0,1.0,1,1.0,1,1.0,1,0.13774112713069586,45
3495,4,11470,2588,8882,0,0,0,1.0,1,1.0,1,1.0,1,0.16168001145174146,45
3496,5,11475,2588,8887,0,0,0,1.0,1,1.0,1,1.0,1,0.11249958224454383,46
3497,3,11478,2588,8890,0,0,0,1.0,1,1.0,1,1.0,1,0.10826650118744716,47
3498,5,11483,2589,8894,0,0,0,1.0,1,1.0,1,1.0,1,0.12509073837025983,48
3499,1,11484,2589,8895,0,0,0,1.0,1,1.0,1,1.0,1,0.13609309068173817,47
3500,2,11486,2589,8897,0,0,0,1.0,1,1.0,1,1.0,1,0.15303863029921055,50
3501,8,11494,2590,8904,0,0,0,1.0,1,1.0,1,1.0,1,0.17499768044773506,50
3502,5,11499,2590,8909,0,0,0,1.0,1,1.0,1,1.0,1,0.19790687263315393,50
3503,4,11503,2592,8911,0,0,0,1.0,1,1.0,1,1.0,1,0.23358472856241724,50
3504,9,11512,2595,8917,0,0,0,1.0,1,1.0,1,1.0,1,0.2683043029521655,47
3505,10,11522,2596,8926,0,0,0,1.0,1,1.0,1,1.0,1,0.28583280584560156,48
3506,12,11534,2598,8936,0,0,0,1.0,1,1.0,1,1.0,1,0.3401737330191568,49
3507,7,11541,2598,8943,0,0,0,1.0,1,1.0,1,1.0,1,0.34964731574390967,46
3508,13,11554,2599,8955,0,0,0,1.0,1,1.0,1,1.0,1,0.3316607113773737,47
3509,5,11559,2599,8960,0,0,0,1.0,1,1.0,1,1.0,1,0.3382557145429904,44
3510,2,11561,2599,8962,0,0,0,1.0,1,1.0,1,1.0,1,0.3277514328092589,45
3511,5,11566,2600,8966,0,0,0,1.0,1,1.0,1,1.0,1,0.23245732686120024,44
3512,0,11566,2600,8966,0,0,0,1.0,1,1.0,1,1.0,1,0.24037559506763553,42
3513,2,11568,2600,8968,0,0,0,1.0,1,1.0,1,1.0,1,0.2066803711573796,42
3514,0,11568,2600,8968,0,0,0,1.0,1,1.0,1,1.0,1,0.2218298415429539,42
3515,5,11573,2601,8972,0,0,0,1.0,1,1.0,1,1.0,1,0.18776824544317283,42
3516,3,11576,2601,8975,0,0,0,1.0,1,1.0,1,1.0,1,0.21631956577979464,41
3517,4,11580,2601,8979,0,0,0,1.0,1,1.0,1,1.0,1,0.17669431506544256,44
3518,1,11581,2601,8980,0,0,0,1.0,1,1.0,1,1.0,1,0.19286189620317848,43
3519,2,11583,2601,8982,0,0,0,1.0,1,1.0,1,1.0,1,0.18577795994497834,44
3520,5,11588,2601,8987,0,0,0,1.0,1,1.0,1,1.0,1,0.17397789980223116,45
3521,4,11592,2601,8991,0,0,0,1.0,1,1.0,1,1.0,1,0.16517887340839438,45
3522,5,11597,2601,8996,0,0,0,1.0,1,1.0,1,1.0,1,0.16911647398516563,46
3523,6,11603,2601,9002,0,0,0,1.0,1,1.0,1,1.0,1,0.16758411559385405,46
3524,6,11609,2601,9008,0,0,0,1.0,1,1.0,1,1.0,1,0.12831561897051805,47
3525,7,11616,2601,9015,0,0,0,1.0,1,1.0,1,1.0,1,0.16485283969666667,48
3526,4,11620,2601,9019,0,0,0,1.0,1,1.0,1,1.0,1,0.12415819267653616,49
3527,4,11624,2603,9021,0,0,0,1.0,1,1.0,1,1.0,1,0.17429841887980138,49
3528,3,11627,2603,9024,0,0,0,1.0,1,1.0,1,1.0,1,0.17040201547053938,51
3529,3,11630,2603,9027,0,0,0,1.0,1,1.0,1,1.0,1,0.14042637090230634,51
3530,3,11633,2603,9030,0,0,0,1.0,1,1.0,1,1.0,1,0.15683444142129885,52
3531,3,11636,2603,9033,0,0,0,1.0,1,1.0,1,1.0,1,0.11744445897709761,52
3532,0,11636,2603,9033,0,0,0,1.0,1,1.0,1,1.0,1,0.11744445897709761,52
3533,0,11636,2603,9033,0,0,0,1.0,1,1.0,1,1.0,1,0.11744445897709761,52
3534,0,11636,2603,9033,0,0,0,1.0,1,1.0,1,1.0,1,0.11744445897709761,52
3535,1,11637,2604,9033,0,0,0,1.0,1,1.0,1,1.0,1,0.11748267030201066,52
3536,5,11642,2605,9037,0,0,0,1.0,1,1.0,1,1.0,1,0.14200452904826236,54
3537,2,11644,2605,9039,0,0,0,1.0,1,1.0,1,1.0,1,0.12528510472523544,55
3538,0,11644,2605,9039,0,0,0,1.0,1,1.0,1,1.0,1,0.12528510472523544,55
3539,3,11647,2605,9042,0,0,0,1.0,1,1.0,1,1.0,1,0.13236184770150372,58
3540,5,11652,2606,9046,0,0,0,1.0,1,1.0,1,1.0,1,0.12254176565142076,59
3541,4,11656,2606,9050,0,0,0,1.0,1,1.0,1,1.0,1,0.08052395209197287,59
3542,1,11657,2607,9050,0,0,0,1.0,1,1.0,1,1.0,1,0.09260247170992597,61
3543,4,11661,2609,9052,0,0,0,1.0,1,1.0,1,1.0,1,0.09486266051184239,62
3544,2,11663,2611,9052,0,0,0,1.0,1,1.0,1,1.0,1,0.08689850280597314,59
3545,1,11664,2612,9052,0,0,0,1.0,1,1.0,1,1.0,1,0.11946732480171633,59
3546,5,11669,2614,9055,0,0,0,1.0,1,1.0,1,1.0,1,0.083427731978352,57
3547,1,11670,2615,9055,0,0,0,1.0,1,1.0,1,1.0,1,0.07359887391700858,53
3548,2,11672,2616,9056,0,0,0,1.0,1,1.0,1,1.0,1,0.0739426802195677,53
3549,0,11672,2616,9056,0,0,0,1.0,1,1.0,1,1.0,1,0.07168418393069906,52
3550,2,11674,2617,9057,0,0,0,1.0,1,1.0,1,1.0,1,0.09220644659146648,51
3551,1,11675,2618,9057,0,0,0,1.0,1,1.0,1,1.0,1,0.11490891858713431,51
3552,2,11677,2619,9058,0,0,0,1.0,1,1.0,1,1.0,1,0.12696355434482087,51
3553,0,11677,2619,9058,0,0,0,1.0,1,1.0,1,1.0,1,0.14866120671860963,49
3554,0,11677,2619,9058,0,0,0,1.0,1,1.0,1,1.0,1,0.14866120671860963,49
3555,0,11677,2619,9058,0,0,0,1.0,1,1.0,1,1.0,1,0.1521291929249129,51
3556,4,11681,2619,9062,0,0,0,1.0,1,1.0,1,1.0,1,0.08104702810842732,51
3557,1,11682,2620,9062,0,0,0,1.0,1,1.0,1,1.0,1,0.097441236410252,52
3558,4,11686,2622,9064,0,0,0,1.0,1,1.0,1,1.0,1,0.09500238639952167,52
3559,2,11688,2623,9065,0,0,0,1.0,1,1.0,1,1.0,1,0.10595099185020958,52
3560,0,11688,2623,9065,0,0,0,1.0,1,1.0,1,1.0,1,0.09043970707981147,53
3561,2,11690,2623,9067,0,0,0,1.0,1,1.0,1,1.0,1,0.08652402797645026,54
3562,2,11692,2625,9067,0,0,0,1.0,1,1.0,1,1.0,1,0.11011765717592659,54
3563,3,11695,2626,9069,0,0,0,1.0,1,1.0,1,1.0,1,0.14761633420097015,55
3564,2,11697,2626,9071,0,0,0,1.0,1,1.0,1,1.0,1,0.12315043833236354,57
3565,1,11698,2626,9072,0,0,0,1.0,1,1.0,1,1.0,1,0.13905558800162002,56
3566,0,11698,2626,9072,0,0,0,1.0,1,1.0,1,1.0,1,0.14990199568261953,57
3567,0,11698,2626,9072,0,0,0,1.0,1,1.0,1,1.0,1,0.14990199568261953,57
3568,1,11699,2627,9072,0,0,0,1.0,1,1.0,1,1.0,1,0.17031159939288196,57
3569,4,11703,2627,9076,0,0,0,1.0,1,1.0,1,1.0,1,0.17993360248391482,57
3570,7,11710,2628,9082,0,0,0,1.0,1,1.0,1,1.0,1,0.19648801010278635,59
3571,4,11714,2628,9086,0,0,0,1.0,1,1.0,1,1.0,1,0.15234568012799307,60
3572,2,11716,2628,9088,0,0,0,1.0,1,1.0,1,1.0,1,0.13036681280792006,61
3573,1,11717,2628,9089,0,0,0,1.0,1,1.0,1,1.0,1,0.1332275969674307,62
3574,0,11717,2628,9089,0,0,0,1.0,1,1.0,1,1.0,1,0.13207238478997624,63
3575,4,11721,2630,9091,0,0,0,1.0,1,1.0,1,1.0,1,0.15561254670061597,63
3576,4,11725,2631,9094,0,0,0,1.0,1,1.0,1,1.0,1,0.15163473733038724,63
3577,1,11726,2631,9095,0,0,0,1.0,1,1.0,1,1.0,1,0.1622818034010076,64
3578,1,11727,2632,9095,0,0,0,1.0,1,1.0,1,1.0,1,0.16579878067311193,64
3579,0,11727,2632,9095,0,0,0,1.0,1,1.0,1,1.0,1,0.16579878067311193,64
3580,1,11728,2632,9096,0,0,0,1.0,1,1.0,1,1.0,1,0.16730956480868694,65
3581,2,11730,2632,9098,0,0,0,1.0,1,1.0,1,1.0,1,0.16517322572116103,68
3582,4,11734,2635,9099,0,0,0,1.0,1,1.0,1,1.0,1,0.1722260976071307,68
3583,4,11738,2637,9101,0,0,0,1.0,1,1.0,1,1.0,1,0.18320047435995016,65
3584,7,11745,2641,9104,0,0,0,1.0,1,1.0,1,1.0,1,0.21150799679922797,64
3585,3,11748,2642,9106,0,0,0,1.0,1,1.0,1,1.0,1,0.16697666140715783,64
3586,9,11757,2645,9112,0,0,0,1.0,1,1.0,1,1.0,1,0.10722593962403798,65
3587,0,11757,2645,9112,0,0,0,1.0,1,1.0,1,1.0,1,0.07401763198127313,64
3588,2,11759,2647,9112,0,0,0,1.0,1,1.0,1,1.0,1,0.0793797325657276,62
3589,3,11762,2650,9112,0,0,0,1.0,1,1.0,1,1.0,1,0.10764414721276476,63
3590,0,11762,2650,9112,0,0,0,1.0,1,1.0,1,1.0,1,0.10812677018317772,63
3591,4,11766,2653,9113,0,0,0,1.0,1,1.0,1,1.0,1,0.11878939946329198,62
3592,1,11767,2654,9113,0,0,0,1.0,1,1.0,1,1.0,1,0.11939029204317936,59
3593,2,11769,2655,9114,0,0,0,1.0,1,1.0,1,1.0,1,0.08965770139239622,58
3594,0,11769,2655,9114,0,0,0,1.0,1,1.0,1,1.0,1,0.10844510670516896,57
3595,1,11770,2656,9114,0,0,0,1.0,1,1.0,1,1.0,1,0.11393159193756672,59
3596,2,11772,2658,9114,0,0,0,1.0,1,1.0,1,1.0,1,0.08878452451495736,57
3597,3,11775,2660,9115,0,0,0,1.0,1,1.0,1,1.0,1,0.09836088719546833,57
3598,3,11778,2662,9116,0,0,0,1.0,1,1.0,1,1.0,1,0.0994293135123203,57
3599,3,11781,2665,9116,0,0,0,1.0,1,1.0,1,1.0,1,0.09483802563423784,58
3600,0,11781,2665,9116,0,0,0,1.0,1,1.0,1,1.0,1,0.09346253541738622,58
3601,5,11786,2667,9119,0,0,0,1.0,1,1.0,1,1.0,1,0.054592452048604335,58
3602,2,11788,2668,9120,0,0,0,1.0,1,1.0,1,1.0,1,0.07561207728897858,60
3603,2,11790,2670,9120,0,0,0,1.0,1,1.0,1,1.0,1,0.10869781595258537,60
3604,6,11796,2670,9126,0,0,0,1.0,1,1.0,1,1.0,1,0.09283538089375235,60
3605,0,11796,2670,9126,0,0,0,1.0,1,1.0,1,1.0,1,0.10157131245550324,61
3606,5,11801,2672,9129,0,0,0,1.0,1,1.0,1,1.0,1,0.12282071381519395,63
3607,7,11808,2673,9135,0,0,0,1.0,1,1.0,1,1.0,1,0.1347661235825848,63
3608,2,11810,2673,9137,0,0,0,1.0,1,1.0,1,1.0,1,0.1115393287043057,64
3609,4,11814,2675,9139,0,0,0,1.0,1,1.0,1,1.0,1,0.11830385406228955,66
3610,3,11817,2675,9142,0,0,0,1.0,1,1.0,1,1.0,1,0.1184208185008275,67
3611,3,11820,2676,9144,0,0,0,1.0,1,1.0,1,1.0,1,0.13507551953353553,67
3612,4,11824,2677,9147,0,0,0,1.0,1,1.0,1,1.0,1,0.17251531014704988,66
3613,3,11827,2678,9149,0,0,0,1.0,1,1.0,1,1.0,1,0.17355138909012532,66
3614,3,11830,2679,9151,0,0,0,1.0,1,1.0,1,1.0,1,0.17090887857067252,65
3615,1,11831,2679,9152,0,0,0,1.0,1,1.0,1,1.0,1,0.15847982911378164,65
3616,6,11837,2680,9157,0,0,0,1.0,1,1.0,1,1.0,1,0.12083041641393796,65
3617,1,11838,2680,9158,0,0,0,1.0,1,1.0,1,1.0,1,0.12837013358833116,66
3618,1,11839,2681,9158,0,0,0,1.0,1,1.0,1,1.0,1,0.10285671587498585,66
3619,1,11840,2682,9158,0,0,0,1.0,1,1.0,1,1.0,1,0.13520136059987511,65
3620,3,11843,2683,9160,0,0,0,1.0,1,1.0,1,1.0,1,0.13757436364376585,66
3621,5,11848,2684,9164,0,0,0,1.0,1,1.0,1,1.0,1,0.12179989092301499,65
3622,1,11849,2684,9165,0,0,0,1.0,1,1.0,1,1.0,1,0.12537342472273452,65
3623,2,11851,2685,9166,0,0,0,1.0,1,1.0,1,1.0,1,0.1464274988046274,62
3624,6,11857,2689,9168,0,0,0,1.0,1,1.0,1,1.0,1,0.1481047922336256,62
3625,8,11865,2691,9174,0,0,0,1.0,1,1.0,1,1.0,1,0.17209558591260163,61
3626,4,11869,2692,9177,0,0,0,1.0,1,1.0,1,1.0,1,0.1965317651123735,58
3627,3,11872,2693,9179,0,0,0,1.0,1,1.0,1,1.0,1,0.19664656767104394,58
3628,2,11874,2694,9180,0,0,0,1.0,1,1.0,1,1.0,1,0.24234455198742053,57
3629,3,11877,2695,9182,0,0,0,1.0,1,1.0,1,1.0,1,0.25655392986904985,57
3630,5,11882,2696,9186,0,0,0,1.0,1,1.0,1,1.0,1,0.2878674976418041,56
3631,20,11902,2700,9202,0,0,0,1.0,1,1.0,1,1.0,1,0.1276517999000987,54
3632,7,11909,2700,9209,0,0,0,1.0,1,1.0,1,1.0,1,0.09951616059777718,52
3633,9,11918,2703,9215,0,0,0,1.0,1,1.0,1,1.0,1,0.1339351417283038,52
3634,7,11925,2705,9220,0,0,0,1.0,1,1.0,1,1.0,1,0.22277794045900723,49
3635,4,11929,2705,9224,0,0,0,1.0,1,1.0,1,1.0,1,0.23322078588778003,47
3636,5,11934,2706,9228,0,0,0,1.0,1,1.0,1,1.0,1,0.23127468885838492,48
3637,6,11940,2706,9234,0,0,0,1.0,1,1.0,1,1.0,1,0.26550631795286617,49
3638,5,11945,2706,9239,0,0,0,1.0,1,1.0,1,1.0,1,0.23994200811569869,50
3639,13,11958,2707,9251,0,0,0,1.0,1,1.0,1,1.0,1,0.20214709634183334,52
3640,7,11965,2709,9256,0,0,0,1.0,1,1.0,1,1.0,1,0.2825993123258973,52
3641,10,11975,2710,9265,0,0,0,1.0,1,1.0,1,1.0,1,0.2506603368228641,52
3642,14,11989,2710,9279,0,0,0,1.0,1,1.0,1,1.0,1,0.2241939876198784,52
3643,10,11999,2710,9289,0,0,0,1.0,1,1.0,1,1.0,1,0.26080081500002567,52
3644,11,12010,2710,9300,0,0,0,1.0,1,1.0,1,1.0,1,0.226841702074908,52
3645,8,12018,2710,9308,0,0,0,1.0,1,1.0,1,1.0,1,0.27910309711784503,53
3646,10,12028,2710,9318,0,0,0,1.0,1,1.0,1,1.0,1,0.17568281214392956,53
3647,6,12034,2711,9323,0,0,0,1.0,1,1.0,1,1.0,1,0.14598063558040691,55
3648,2,12036,2711,9325,0,0,0,1.0,1,1.0,1,1.0,1,0.13596403483428499,57
3649,4,12040,2711,9329,0,0,0,1.0,1,1.0,1,1.0,1,0.13596403483428499,57
3650,5,12045,2711,9334,0,0,0,1.0,1,1.0,1,1.0,1,0.13411579775263366,59
3651,7,12052,2711,9341,0,0,0,1.0,1,1.0,1,1.0,1,0.14806774645595508,59
3652,8,12060,2711,9349,0,0,0,1.0,1,1.0,1,1.0,1,0.14806774645595508,59
3653,8,12068,2711,9357,0,0,0,1.0,1,1.0,1,1.0,1,0.14806774645595508,59
3654,4,12072,2711,9361,0,0,0,1.0,1,1.0,1,1.0,1,0.1459492454952062,59
3655,8,12080,2711,9369,0,0,0,1.0,1,1.0,1,1.0,1,0.11163305916315451,62
3656,9,12089,2711,9378,0,0,0,1.0,1,1.0,1,1.0,1,0.13689102129635805,62
3657,5,12094,2711,9383,0,0,0,1.0,1,1.0,1,1.0,1,0.12870014988355122,63
3658,6,12100,2712,9388,0,0,0,1.0,1,1.0,1,1.0,1,0.14653088812032794,63
3659,8,12108,2712,9396,0,0,0,1.0,1,1.0,1,1.0,1,0.153206847960167,62
3660,8,12116,2714,9402,0,0,0,1.0,1,1.0,1,1.0,1,0.18122017195078394,62
3661,7,12123,2715,9408,0,0,0,1.0,1,1.0,1,1.0,1,0.10112951829863982,61
3662,3,12126,2717,9409,0,0,0,1.0,1,1.0,1,1.0,1,0.11188463018470834,60
3663,4,12130,2718,9412,0,0,0,1.0,1,1.0,1,1.0,1,0.093648701626075,61
3664,1,12131,2718,9413,0,0,0,1.0,1,1.0,1,1.0,1,0.10153611805839279,58
3665,1,12132,2718,9414,0,0,0,1.0,1,1.0,1,1.0,1,0.11391982946192249,58
3666,2,12134,2719,9415,0,0,0,1.0,1,1.0,1,1.0,1,0.10377483929304272,58
3667,1,12135,2720,9415,0,0,0,1.0,1,1.0,1,1.0,1,0.13562273663740748,58
3668,2,12137,2720,9417,0,0,0,1.0,1,1.0,1,1.0,1,0.1347292897692732,58
3669,2,12139,2721,9418,0,0,0,1.0,1,1.0,1,1.0,1,0.13271310478972503,57
3670,2,12141,2722,9419,0,0,0,1.0,1,1.0,1,1.0,1,0.13510732540740192,56
3671,2,12143,2723,9420,0,0,0,1.0,1,1.0,1,1.0,1,0.14228675784425368,57
3672,1,12144,2724,9420,0,0,0,1.0,1,1.0,1,1.0,1,0.16095439005051387,57
3673,0,12144,2724,9420,0,0,0,1.0,1,1.0,1,1.0,1,0.14583783123619973,58
3674,0,12144,2724,9420,0,0,0,1.0,1,1.0,1,1.0,1,0.15963018143289176,57
3675,0,12144,2724,9420,0,0,0,1.0,1,1.0,1,1.0,1,0.17391179434428605,58
3676,6,12150,2725,9425,0,0,0,1.0,1,1.0,1,1.0,1,0.15072375092532547,59
3677,4,12154,2726,9428,0,0,0,1.0,1,1.0,1,1.0,1,0.12506725619820758,60
3678,2,12156,2726,9430,0,0,0,1.0,1,1.0,1,1.0,1,0.14687881295837305,62
3679,0,12156,2726,9430,0,0,0,1.0,1,1.0,1,1.0,1,0.14687881295837305,62
3680,0,12156,2726,9430,0,0,0,1.0,1,1.0,1,1.0,1,0.13011846154339482,63
3681,5,12161,2726,9435,0,0,0,1.0,1,1.0,1,1.0,1,0.12253792212169123,64
3682,2,12163,2726,9437,0,0,0,1.0,1,1.0,1,1.0,1,0.12253792212169123,64
3683,2,12165,2726,9439,0,0,0,1.0,1,1.0,1,1.0,1,0.12253792212169123,64
3684,2,12167,2727,9440,0,0,0,1.0,1,1.0,1,1.0,1,0.14055050055969515,64
3685,1,12168,2727,9441,0,0,0,1.0,1,1.0,1,1.0,1,0.14113283734663248,64
3686,2,12170,2727,9443,0,0,0,1.0,1,1.0,1,1.0,1,0.1341108668110455,65
3687,2,12172,2727,9445,0,0,0,1.0,1,1.0,1,1.0,1,0.1341108668110455,65
3688,4,12176,2727,9449,0,0,0,1.0,1,1.0,1,1.0,1,0.15570535687624829,66
3689,2,12178,2727,9451,0,0,0,1.0,1,1.0,1,1.0,1,0.13404680388217133,66
3690,2,12180,2727,9453,0,0,0,1.0,1,1.0,1,1.0,1,0.1399739952294323,67
3691,3,12183,2727,9456,0,0,0,1.0,1,1.0,1,1.0,1,0.09669088148727209,68
3692,1,12184,2727,9457,0,0,0,1.0,1,1.0,1,1.0,1,0.08335497988289256,69
3693,3,12187,2727,9460,0,0,0,1.0,1,1.0,1,1.0,1,0.08225534230702043,69
3694,2,12189,2728,9461,0,0,0,1.0,1,1.0,1,1.0,1,0.09226407603713857,70
3695,0,12189,2728,9461,0,0,0,1.0,1,1.0,1,1.0,1,0.09226407603713857,70
3696,1,12190,2729,9461,0,0,0,1.0,1,1.0,1,1.0,1,0.07423854682094073,71
3697,1,12191,2730,9461,0,0,0,1.0,1,1.0,1,1.0,1,0.08759469909837952,70
3698,1,12192,2731,9461,0,0,0,1.0,1,1.0,1,1.0,1,0.10459973228377091,70
3699,1,12193,2732,9461,0,0,0,1.0,1,1.0,1,1.0,1,0.09539730318892696,70
3700,4,12197,2736,9461,0,0,0,1.0,1,1.0,1,1.0,1,0.13204718386735106,68
3701,1,12198,2737,9461,0,0,0,1.0,1,1.0,1,1.0,1,0.1617391407319448,69
3702,3,12201,2738,9463,0,0,0,1.0,1,1.0,1,1.0,1,0.1637693193085598,69
3703,2,12203,2738,9465,0,0,0,1.0,1,1.0,1,1.0,1,0.16054535903343942,70
3704,2,12205,2738,9467,0,0,0,1.0,1,1.0,1,1.0,1,0.16309194370719748,69
3705,2,12207,2739,9468,0,0,0,1.0,1,1.0,1,1.0,1,0.14314708933903172,69
3706,8,12215,2742,9473,0,0,0,1.0,1,1.0,1,1.0,1,0.14001606024746446,69
3707,0,12215,2742,9473,0,0,0,1.0,1,1.0,1,1.0,1,0.12113930486303362,67
3708,2,12217,2742,9475,0,0,0,1.0,1,1.0,1,1.0,1,0.10111589168672074,67
3709,1,12218,2742,9476,0,0,0,1.0,1,1.0,1,1.0,1,0.10006054994624126,67
3710,2,12220,2742,9478,0,0,0,1.0,1,1.0,1,1.0,1,0.10535834284407472,67
3711,1,12221,2742,9479,0,0,0,1.0,1,1.0,1,1.0,1,0.08591061578623796,68
3712,2,12223,2742,9481,0,0,0,1.0,1,1.0,1,1.0,1,0.08591061578623796,68
3713,3,12226,2744,9482,0,0,0,1.0,1,1.0,1,1.0,1,0.07646638537929884,68
3714,1,12227,2744,9483,0,0,0,1.0,1,1.0,1,1.0,1,0.08920191880342426,67
3715,0,12227,2744,9483,0,0,0,1.0,1,1.0,1,1.0,1,0.10030100973779146,68
3716,0,12227,2744,9483,0,0,0,1.0,1,1.0,1,1.0,1,0.1098800766368662,67
3717,2,12229,2744,9485,0,0,0,1.0,1,1.0,1,1.0,1,0.12531774878127291,68
3718,0,12229,2744,9485,0,0,0,1.0,1,1.0,1,1.0,1,0.14125260602879205,68
3719,1,12230,2745,9485,0,0,0,1.0,1,1.0,1,1.0,1,0.18257417301476878,68
3720,0,12230,2745,9485,0,0,0,1.0,1,1.0,1,1.0,1,0.18257417301476878,68
3721,9,12239,2748,9491,0,0,0,1.0,1,1.0,1,1.0,1,0.14931297074366917,70
3722,0,12239,2748,9491,0,0,0,1.0,1,1.0,1,1.0,1,0.15728196545872034,71
3723,5,12244,2749,9495,0,0,0,1.0,1,1.0,1,1.0,1,0.15442126095766204,71
3724,1,12245,2750,9495,0,0,0,1.0,1,1.0,1,1.0,1,0.15943038444540483,72
3725,2,12247,2750,9497,0,0,0,1.0,1,1.0,1,1.0,1,0.15309247104963253,72
3726,1,12248,2750,9498,0,0,0,1.0,1,1.0,1,1.0,1,0.1616790018799506,71
3727,4,12252,2751,9501,0,0,0,1.0,1,1.0,1,1.0,1,0.17218137165010058,71
3728,5,12257,2752,9505,0,0,0,1.0,1,1.0,1,1.0,1,0.17024957061576204,70
3729,8,12265,2752,9513,0,0,0,1.0,1,1.0,1,1.0,1,0.1457691852232241,70
3730,6,12271,2754,9517,0,0,0,1.0,1,1.0,1,1.0,1,0.16029444735489004,71
3731,3,12274,2754,9520,0,0,0,1.0,1,1.0,1,1.0,1,0.17135332022669145,71
3732,3,12277,2754,9523,0,0,0,1.0,1,1.0,1,1.0,1,0.16805603358054702,72
3733,6,12283,2755,9528,0,0,0,1.0,1,1.0,1,1.0,1,0.180123345621219,73
3734,10,12293,2756,9537,0,0,0,1.0,1,1.0,1,1.0,1,0.1851125965678059,74
3735,7,12300,2757,9543,0,0,0,1.0,1,1.0,1,1.0,1,0.1649289163435548,72
3736,3,12303,2757,9546,0,0,0,1.0,1,1.0,1,1.0,1,0.1170349497519655,72
3737,3,12306,2757,9549,0,0,0,1.0,1,1.0,1,1.0,1,0.08501450139115746,73
3738,0,12306,2757,9549,0,0,0,1.0,1,1.0,1,1.0,1,0.10235079476775834,72
3739,0,12306,2757,9549,0,0,0,1.0,1,1.0,1,1.0,1,0.10580808927623744,73
3740,0,12306,2757,9549,0,0,0,1.0,1,1.0,1,1.0,1,0.11849623446814966,70
3741,1,12307,2757,9550,0,0,0,1.0,1,1.0,1,1.0,1,0.10301895175827272,70
3742,0,12307,2757,9550,0,0,0,1.0,1,1.0,1,1.0,1,0.10301895175827272,70
3743,0,12307,2757,9550,0,0,0,1.0,1,1.0,1,1.0,1,0.11060759675137705,69
3744,4,12311,2760,9551,0,0,0,1.0,1,1.0,1,1.0,1,0.1387927186041474,69
3745,3,12314,2761,9553,0,0,0,1.0,1,1.0,1,1.0,1,0.10147434391139844,68
3746,1,12315,2761,9554,0,0,0,1.0,1,1.0,1,1.0,1,0.12038173755960296,66
3747,2,12317,2762,9555,0,0,0,1.0,1,1.0,1,1.0,1,0.11139553776291392,66
3748,1,12318,2762,9556,0,0,0,1.0,1,1.0,1,1.0,1,0.09652682830471333,65
3749,3,12321,2763,9558,0,0,0,1.0,1,1.0,1,1.0,1,0.10346692289704076,64
3750,1,12322,2763,9559,0,0,0,1.0,1,1.0,1,1.0,1,0.11912155059773481,63
3751,4,12326,2763,9563,0,0,0,1.0,1,1.0,1,1.0,1,0.0825335650425142,64
3752,2,12328,2765,9563,0,0,0,1.0,1,1.0,1,1.0,1,0.1037608933677473,64
3753,4,12332,2767,9565,0,0,0,1.0,1,1.0,1,1.0,1,0.12253495994861363,65
3754,5,12337,2770,9567,0,0,0,1.0,1,1.0,1,1.0,1,0.16044759658494256,65
3755,6,12343,2771,9572,0,0,0,1.0,1,1.0,1,1.0,1,0.17464672674255824,65
3756,4,12347,2771,9576,0,0,0,1.0,1,1.0,1,1.0,1,0.17334098142569995,65
3757,3,12350,2771,9579,0,0,0,1.0,1,1.0,1,1.0,1,0.1499818758920219,65
3758,1,12351,2771,9580,0,0,0,1.0,1,1.0,1,1.0,1,0.15654290677020977,64
3759,2,12353,2772,9581,0,0,0,1.0,1,1.0,1,1.0,1,0.15862359870209597,64
3760,1,12354,2772,9582,0,0,0,1.0,1,1.0,1,1.0,1,0.18395070182875994,63
3761,1,12355,2772,9583,0,0,0,1.0,1,1.0,1,1.0,1,0.1849950003811719,63
3762,2,12357,2772,9585,0,0,0,1.0,1,1.0,1,1.0,1,0.18577090397595614,65
3763,3,12360,2774,9586,0,0,0,1.0,1,1.0,1,1.0,1,0.1964480302144272,65
3764,4,12364,2774,9590,0,0,0,1.0,1,1.0,1,1.0,1,0.2018866360774071,66
3765,7,12371,2774,9597,0,0,0,1.0,1,1.0,1,1.0,1,0.19550948318347255,67
3766,11,12382,2776,9606,0,0,0,1.0,1,1.0,1,1.0,1,0.14622900648766124,67
3767,4,12386,2777,9609,0,0,0,1.0,1,1.0,1,1.0,1,0.1280446234457444,68
3768,6,12392,2779,9613,0,0,0,1.0,1,1.0,1,1.0,1,0.1632311969690593,67
3769,3,12395,2779,9616,0,0,0,1.0,1,1.0,1,1.0,1,0.15763559443067537,69
3770,3,12398,2779,9619,0,0,0,1.0,1,1.0,1,1.0,1,0.15051577667471278,69
3771,2,12400,2779,9621,0,0,0,1.0,1,1.0,1,1.0,1,0.1674325456741061,69
3772,5,12405,2779,9626,0,0,0,1.0,1,1.0,1,1.0,1,0.18051796501827108,70
3773,6,12411,2779,9632,0,0,0,1.0,1,1.0,1,1.0,1,0.16239146365372933,68
3774,3,12414,2780,9634,0,0,0,1.0,1,1.0,1,1.0,1,0.14105641349523854,68
3775,4,12418,2782,9636,0,0,0,1.0,1,1.0,1,1.0,1,0.17184201280169406,68
3776,2,12420,2783,9637,0,0,0,1.0,1,1.0,1,1.0,1,0.1739326956758515,66
3777,3,12423,2784,9639,0,0,0,1.0,1,1.0,1,1.0,1,0.15526441686441722,65
3778,2,12425,2785,9640,0,0,0,1.0,1,1.0,1,1.0,1,0.14184082124688946,65
3779,2,12427,2786,9641,0,0,0,1.0,1,1.0,1,1.0,1,0.1483349840442989,65
3780,3,12430,2788,9642,0,0,0,1.0,1,1.0,1,1.0,1,0.15849682969195414,64
3781,6,12436,2788,9648,0,0,0,1.0,1,1.0,1,1.0,1,0.10125369677237638,64
3782,6,12442,2790,9652,0,0,0,1.0,1,1.0,1,1.0,1,0.12512769738663915,67
3783,2,12444,2791,9653,0,0,0,1.0,1,1.0,1,1.0,1,0.1313270988028327,65
3784,7,12451,2793,9658,0,0,0,1.0,1,1.0,1,1.0,1,0.11304378144614606,65
3785,2,12453,2793,9660,0,0,0,1.0,1,1.0,1,1.0,1,0.12175350744879603,63
3786,3,12456,2793,9663,0,0,0,1.0,1,1.0,1,1.0,1,0.11466582710531244,66
3787,2,12458,2795,9663,0,0,0,1.0,1,1.0,1,1.0,1,0.15145728118871635,65
3788,3,12461,2796,9665,0,0,0,1.0,1,1.0,1,1.0,1,0.1514725481243107,65
3789,2,12463,2798,9665,0,0,0,1.0,1,1.0,1,1.0,1,0.18512820761817145,65
3790,3,12466,2799,9667,0,0,0,1.0,1,1.0,1,1.0,1,0.17902704470356742,64
3791,2,12468,2801,9667,0,0,0,1.0,1,1.0,1,1.0,1,0.20574654797805234,64
3792,2,12470,2802,9668,0,0,0,1.0,1,1.0,1,1.0,1,0.20549702530454836,65
3793,5,12475,2803,9672,0,0,0,1.0,1,1.0,1,1.0,1,0.20772632258156795,68
3794,5,12480,2804,9676,0,0,0,1.0,1,1.0,1,1.0,1,0.22497167510050037,68
3795,3,12483,2804,9679,0,0,0,1.0,1,1.0,1,1.0,1,0.21070246279688337,69
3796,13,12496,2804,9692,0,0,0,1.0,1,1.0,1,1.0,1,0.14361139484571256,69
3797,5,12501,2805,9696,0,0,0,1.0,1,1.0,1,1.0,1,0.16567604967041558,70
3798,5,12506,2805,9701,0,0,0,1.0,1,1.0,1,1.0,1,0.13483547731449774,70
3799,2,12508,2806,9702,0,0,0,1.0,1,1.0,1,1.0,1,0.15635803609029297,69
3800,2,12510,2806,9704,0,0,0,1.0,1,1.0,1,1.0,1,0.13289490517910593,69
3801,3,12513,2806,9707,0,0,0,1.0,1,1.0,1,1.0,1,0.13173981674642202,67
3802,3,12516,2806,9710,0,0,0,1.0,1,1.0,1,1.0,1,0.13434174746895486,67
3803,3,12519,2807,9712,0,0,0,1.0,1,1.0,1,1.0,1,0.13916901651703906,69
3804,3,12522,2808,9714,0,0,0,1.0,1,1.0,1,1.0,1,0.14272822174441543,70
3805,2,12524,2809,9715,0,0,0,1.0,1,1.0,1,1.0,1,0.15750328647578696,71
3806,2,12526,2810,9716,0,0,0,1.0,1,1.0,1,1.0,1,0.1555308523312735,71
3807,6,12532,2810,9722,0,0,0,1.0,1,1.0,1,1.0,1,0.1530182893766629,72
3808,5,12537,2810,9727,0,0,0,1.0,1,1.0,1,1.0,1,0.15556414554105638,72
3809,2,12539,2810,9729,0,0,0,1.0,1,1.0,1,1.0,1,0.16266663738595058,72
3810,6,12545,2812,9733,0,0,0,1.0,1,1.0,1,1.0,1,0.1914969153011992,72
3811,8,12553,2812,9741,0,0,0,1.0,1,1.0,1,1.0,1,0.09742509518445934,71
3812,0,12553,2812,9741,0,0,0,1.0,1,1.0,1,1.0,1,0.10269401820077456,72
3813,1,12554,2813,9741,0,0,0,1.0,1,1.0,1,1.0,1,0.13195286943176085,71
3814,1,12555,2814,9741,0,0,0,1.0,1,1.0,1,1.0,1,0.1363889467290127,72
3815,0,12555,2814,9741,0,0,0,1.0,1,1.0,1,1.0,1,0.14400919895080028,71
3816,1,12556,2815,9741,0,0,0,1.0,1,1.0,1,1.0,1,0.16233004547207866,69
3817,0,12556,2815,9741,0,0,0,1.0,1,1.0,1,1.0,1,0.16319158266400102,72
3818,4,12560,2817,9743,0,0,0,1.0,1,1.0,1,1.0,1,0.1416902565705817,72
3819,0,12560,2817,9743,0,0,0,1.0,1,1.0,1,1.0,1,0.1416902565705817,72
3820,5,12565,2818,9747,0,0,0,1.0,1,1.0,1,1.0,1,0.16352592068866867,72
3821,2,12567,2819,9748,0,0,0,1.0,1,1.0,1,1.0,1,0.1659822273877998,72
3822,0,12567,2819,9748,0,0,0,1.0,1,1.0,1,1.0,1,0.19210376934430104,69
3823,3,12570,2821,9749,0,0,0,1.0,1,1.0,1,1.0,1,0.1883955415683707,69
3824,3,12573,2822,9751,0,0,0,1.0,1,1.0,1,1.0,1,0.20489989954628637,65
3825,0,12573,2822,9751,0,0,0,1.0,1,1.0,1,1.0,1,0.2006846505161885,64
3826,5,12578,2823,9755,0,0,0,1.0,1,1.0,1,1.0,1,0.15725242684691812,65
3827,2,12580,2823,9757,0,0,0,1.0,1,1.0,1,1.0,1,0.13180070678705783,64
3828,2,12582,2823,9759,0,0,0,1.0,1,1.0,1,1.0,1,0.12530991171781636,65
3829,7,12589,2826,9763,0,0,0,1.0,1,1.0,1,1.0,1,0.14998919992579016,65
3830,3,12592,2826,9766,0,0,0,1.0,1,1.0,1,1.0,1,0.12741456944224883,64
3831,10,12602,2830,9772,0,0,0,1.0,1,1.0,1,1.0,1,0.1344620080316725,63
3832,6,12608,2831,9777,0,0,0,1.0,1,1.0,1,1.0,1,0.15490461993995663,64
3833,2,12610,2831,9779,0,0,0,1.0,1,1.0,1,1.0,1,0.13821560777693542,64
3834,5,12615,2832,9783,0,0,0,1.0,1,1.0,1,1.0,1,0.17458696693071835,63
3835,4,12619,2833,9786,0,0,0,1.0,1,1.0,1,1.0,1,0.1939270271885502,63
3836,5,12624,2834,9790,0,0,0,1.0,1,1.0,1,1.0,1,0.15859845662499786,63
3837,4,12628,2836,9792,0,0,0,1.0,1,1.0,1,1.0,1,0.19392790478999433,62
3838,3,12631,2837,9794,0,0,0,1.0,1,1.0,1,1.0,1,0.190857220325905,62
3839,4,12635,2839,9796,0,0,0,1.0,1,1.0,1,1.0,1,0.23735026142419136,60
3840,2,12637,2840,9797,0,0,0,1.0,1,1.0,1,1.0,1,0.23912852836286658,62
3841,10,12647,2841,9806,0,0,0,1.0,1,1.0,1,1.0,1,0.1717575274063433,62
3842,1,12648,2841,9807,0,0,0,1.0,1,1.0,1,1.0,1,0.15005564393998422,63
3843,1,12649,2841,9808,0,0,0,1.0,1,1.0,1,1.0,1,0.15814604289549128,64
3844,2,12651,2841,9810,0,0,0,1.0,1,1.0,1,1.0,1,0.15988202112197364,65
3845,5,12656,2841,9815,0,0,0,1.0,1,1.0,1,1.0,1,0.13627094089411815,66
3846,4,12660,2841,9819,0,0,0,1.0,1,1.0,1,1.0,1,0.13119676640587175,67
3847,6,12666,2841,9825,0,0,0,1.0,1,1.0,1,1.0,1,0.10404425357239538,67
3848,4,12670,2843,9827,0,0,0,1.0,1,1.0,1,1.0,1,0.10662779894476784,67
3849,5,12675,2843,9832,0,0,0,1.0,1,1.0,1,1.0,1,0.13443428470482083,67
3850,6,12681,2844,9837,0,0,0,1.0,1,1.0,1,1.0,1,0.13594907169026998,68
3851,3,12684,2844,9840,0,0,0,1.0,1,1.0,1,1.0,1,0.11507988054884029,68
3852,4,12688,2845,9843,0,0,0,1.0,1,1.0,1,1.0,1,0.12175849881789845,70
3853,3,12691,2845,9846,0,0,0,1.0,1,1.0,1,1.0,1,0.1468311289978789,70
3854,2,12693,2845,9848,0,0,0,1.0,1,1.0,1,1.0,1,0.1168895013814216,70
3855,1,12694,2845,9849,0,0,0,1.0,1,1.0,1,1.0,1,0.12980426816505172,69
3856,6,12700,2845,9855,0,0,0,1.0,1,1.0,1,1.0,1,0.1182070019107073,70
3857,4,12704,2847,9857,0,0,0,1.0,1,1.0,1,1.0,1,0.1649828031458453,68
3858,7,12711,2848,9863,0,0,0,1.0,1,1.0,1,1.0,1,0.1106906888008646,67
3859,0,12711,2848,9863,0,0,0,1.0,1,1.0,1,1.0,1,0.1083897408133372,66
3860,2,12713,2849,9864,0,0,0,1.0,1,1.0,1,1.0,1,0.1353989447404038,66
3861,1,12714,2849,9865,0,0,0,1.0,1,1.0,1,1.0,1,0.12284488289105555,66
3862,3,12717,2851,9866,0,0,0,1.0,1,1.0,1,1.0,1,0.15729179706848645,66
3863,3,12720,2852,9868,0,0,0,1.0,1,1.0,1,1.0,1,0.13746408223594217,63
3864,1,12721,2853,9868,0,0,0,1.0,1,1.0,1,1.0,1,0.14546013706182512,63
3865,1,12722,2854,9868,0,0,0,1.0,1,1.0,1,1.0,1,0.15369608466510593,61
3866,0,12722,2854,9868,0,0,0,1.0,1,1.0,1,1.0,1,0.15725256739989868,61
3867,0,12722,2854,9868,0,0,0,1.0,1,1.0,1,1.0,1,0.16366304397796605,60
3868,2,12724,2856,9868,0,0,0,1.0,1,1.0,1,1.0,1,0.17927091645828372,59
3869,2,12726,2857,9869,0,0,0,1.0,1,1.0,1,1.0,1,0.18133908497833262,61
3870,4,12730,2858,9872,0,0,0,1.0,1,1.0,1,1.0,1,0.20423870453417958,61
3871,20,12750,2859,9891,0,0,0,1.0,1,1.0,1,1.0,1,0.10746542874193878,64
3872,8,12758,2859,9899,0,0,0,1.0,1,1.0,1,1.0,1,0.10195243768227369,63
3873,6,12764,2859,9905,0,0,0,1.0,1,1.0,1,1.0,1,0.13771127242456857,62
3874,6,12770,2860,9910,0,0,0,1.0,1,1.0,1,1.0,1,0.10835180012980689,63
3875,5,12775,2861,9914,0,0,0,1.0,1,1.0,1,1.0,1,0.15729415176769293,61
3876,10,12785,2861,9924,0,0,0,1.0,1,1.0,1,1.0,1,0.1712576766527024,62
3877,10,12795,2861,9934,0,0,0,1.0,1,1.0,1,1.0,1,0.16093724471911597,63
3878,4,12799,2861,9938,0,0,0,1.0,1,1.0,1,1.0,1,0.1583790399237601,63
3879,9,12808,2862,9946,0,0,0,1.0,1,1.0,1,1.0,1,0.15860339948150898,63
3880,7,12815,2864,9951,0,0,0,1.0,1,1.0,1,1.0,1,0.1743359810168661,65
3881,11,12826,2865,9961,0,0,0,1.0,1,1.0,1,1.0,1,0.17959850526875124,65
3882,6,12832,2865,9967,0,0,0,1.0,1,1.0,1,1.0,1,0.211403506213372,66
3883,8,12840,2865,9975,0,0,0,1.0,1,1.0,1,1.0,1,0.2026926937969198,66
3884,14,12854,2865,9989,0,0,0,1.0,1,1.0,1,1.0,1,0.19624847345513802,66
3885,11,12865,2865,10000,0,0,0,1.0,1,1.0,1,1.0,1,0.2260831636172255,66
3886,10,12875,2867,10008,0,0,0,1.0,1,1.0,1,1.0,1,0.14897919102160695,65
3887,7,12882,2867,10015,0,0,0,1.0,1,1.0,1,1.0,1,0.09559941485579172,65
3888,2,12884,2868,10016,0,0,0,1.0,1,1.0,1,1.0,1,0.08480659240861893,66
3889,1,12885,2869,10016,0,0,0,1.0,1,1.0,1,1.0,1,0.10866942349214409,64
3890,3,12888,2869,10019,0,0,0,1.0,1,1.0,1,1.0,1,0.10043991437143748,63
3891,5,12893,2870,10023,0,0,0,1.0,1,1.0,1,1.0,1,0.10732215549069281,66
3892,6,12899,2871,10028,0,0,0,1.0,1,1.0,1,1.0,1,0.11760353628119061,67
3893,2,12901,2871,10030,0,0,0,1.0,1,1.0,1,1.0,1,0.11732888271158726,66
3894,4,12905,2871,10034,0,0,0,1.0,1,1.0,1,1.0,1,0.13125990078114763,67
3895,5,12910,2871,10039,0,0,0,1.0,1,1.0,1,1.0,1,0.13675846681110623,66
3896,5,12915,2872,10043,0,0,0,1.0,1,1.0,1,1.0,1,0.1300309741832363,66
3897,2,12917,2872,10045,0,0,0,1.0,1,1.0,1,1.0,1,0.14143922954674207,65
3898,11,12928,2877,10051,0,0,0,1.0,1,1.0,1,1.0,1,0.18921922412814746,65
3899,9,12937,2879,10058,0,0,0,1.0,1,1.0,1,1.0,1,0.17383640476606282,64
3900,5,12942,2880,10062,0,0,0,1.0,1,1.0,1,1.0,1,0.18292951378758687,63
3901,6,12948,2883,10065,0,0,0,1.0,1,1.0,1,1.0,1,0.1398418992007848,63
3902,2,12950,2883,10067,0,0,0,1.0,1,1.0,1,1.0,1,0.1289794944984165,64
3903,2,12952,2883,10069,0,0,0,1.0,1,1.0,1,1.0,1,0.11645571391182515,64
3904,0,12952,2883,10069,0,0,0,1.0,1,1.0,1,1.0,1,0.12978590794382422,63
3905,0,12952,2883,10069,0,0,0,1.0,1,1.0,1,1.0,1,0.14159797105827693,63
3906,3,12955,2885,10070,0,0,0,1.0,1,1.0,1,1.0,1,0.10231324328352662,64
3907,2,12957,2887,10070,0,0,0,1.0,1,1.0,1,1.0,1,0.14552081672150372,64
3908,0,12957,2887,10070,0,0,0,1.0,1,1.0,1,1.0,1,0.15278439899867208,63
3909,3,12960,2888,10072,0,0,0,1.0,1,1.0,1,1.0,1,0.1616050104434789,62
3910,2,12962,2888,10074,0,0,0,1.0,1,1.0,1,1.0,1,0.17743881245054985,62
3911,3,12965,2889,10076,0,0,0,1.0,1,1.0,1,1.0,1,0.15652826206216716,64
3912,6,12971,2891,10080,0,0,0,1.0,1,1.0,1,1.0,1,0.16240930826527805,64
3913,4,12975,2891,10084,0,0,0,1.0,1,1.0,1,1.0,1,0.1751696764842152,65
3914,3,12978,2891,10087,0,0,0,1.0,1,1.0,1,1.0,1,0.15781805374676963,65
3915,2,12980,2891,10089,0,0,0,1.0,1,1.0,1,1.0,1,0.15166645810074086,66
3916,5,12985,2892,10093,0,0,0,1.0,1,1.0,1,1.0,1,0.13352029424219838,66
3917,1,12986,2892,10094,0,0,0,1.0,1,1.0,1,1.0,1,0.13154858368789996,66
3918,4,12990,2892,10098,0,0,0,1.0,1,1.0,1,1.0,1,0.11496509700766648,67
3919,2,12992,2893,10099,0,0,0,1.0,1,1.0,1,1.0,1,0.10566507341538128,68
3920,1,12993,2893,10100,0,0,0,1.0,1,1.0,1,1.0,1,0.1063981592064602,69
3921,3,12996,2893,10103,0,0,0,1.0,1,1.0,1,1.0,1,0.11315256006038178,68
3922,4,13000,2895,10105,0,0,0,1.0,1,1.0,1,1.0,1,0.1521853361960792,68
3923,1,13001,2895,10106,0,0,0,1.0,1,1.0,1,1.0,1,0.16986432933530238,69
3924,2,13003,2895,10108,0,0,0,1.0,1,1.0,1,1.0,1,0.17442870769910962,69
3925,3,13006,2896,10110,0,0,0,1.0,1,1.0,1,1.0,1,0.15355937723539426,67
3926,4,13010,2896,10114,0,0,0,1.0,1,1.0,1,1.0,1,0.19438777229202014,67
3927,5,13015,2896,10119,0,0,0,1.0,1,1.0,1,1.0,1,0.1888662652194934,65
3928,5,13020,2897,10123,0,0,0,1.0,1,1.0,1,1.0,1,0.16544188658388292,65
3929,4,13024,2898,10126,0,0,0,1.0,1,1.0,1,1.0,1,0.15177681531449683,64
3930,3,13027,2900,10127,0,0,0,1.0,1,1.0,1,1.0,1,0.1697619532939444,64
3931,4,13031,2901,10130,0,0,0,1.0,1,1.0,1,1.0,1,0.12355798440229353,62
3932,0,13031,2901,10130,0,0,0,1.0,1,1.0,1,1.0,1,0.12355798440229353,62
3933,1,13032,2902,10130,0,0,0,1.0,1,1.0,1,1.0,1,0.127306077626021,62
3934,1,13033,2903,10130,0,0,0,1.0,1,1.0,1,1.0,1,0.12967190882022991,61
3935,2,13035,2904,10131,0,0,0,1.0,1,1.0,1,1.0,1,0.14315070163038907,64
3936,2,13037,2905,10132,0,0,0,1.0,1,1.0,1,1.0,1,0.17351939341554531,65
3937,5,13042,2906,10136,0,0,0,1.0,1,1.0,1,1.0,1,0.18689327245942225,66
3938,6,13048,2908,10140,0,0,0,1.0,1,1.0,1,1.0,1,0.2020970351694608,66
3939,2,13050,2908,10142,0,0,0,1.0,1,1.0,1,1.0,1,0.2008374440555039,67
3940,5,13055,2909,10146,0,0,0,1.0,1,1.0,1,1.0,1,0.19566591119898774,69
3941,5,13060,2909,10151,0,0,0,1.0,1,1.0,1,1.0,1,0.16132613795191286,69
3942,5,13065,2911,10154,0,0,0,1.0,1,1.0,1,1.0,1,0.16163277499184384,69
3943,3,13068,2912,10156,0,0,0,1.0,1,1.0,1,1.0,1,0.17627623420341543,68
3944,5,13073,2913,10160,0,0,0,1.0,1,1.0,1,1.0,1,0.15877660692634082,68
3945,5,13078,2916,10162,0,0,0,1.0,1,1.0,1,1.0,1,0.20796395494206563,67
3946,10,13088,2917,10171,0,0,0,1.0,1,1.0,1,1.0,1,0.1286401207595518,67
3947,2,13090,2917,10173,0,0,0,1.0,1,1.0,1,1.0,1,0.12695050938860206,66
3948,1,13091,2918,10173,0,0,0,1.0,1,1.0,1,1.0,1,0.13150969036706509,67
3949,3,13094,2921,10173,0,0,0,1.0,1,1.0,1,1.0,1,0.1788615487635815,66
3950,1,13095,2921,10174,0,0,0,1.0,1,1.0,1,1.0,1,0.18627783889092742,65
3951,1,13096,2921,10175,0,0,0,1.0,1,1.0,1,1.0,1,0.1655369251549506,65
3952,1,13097,2922,10175,0,0,0,1.0,1,1.0,1,1.0,1,0.16613042635462585,65
3953,1,13098,2922,10176,0,0,0,1.0,1,1.0,1,1.0,1,0.17686100001146696,65
3954,1,13099,2922,10177,0,0,0,1.0,1,1.0,1,1.0,1,0.17468214491295989,64
3955,2,13101,2923,10178,0,0,0,1.0,1,1.0,1,1.0,1,0.20455319135202113,64
3956,4,13105,2925,10180,0,0,0,1.0,1,1.0,1,1.0,1,0.21270901211350768,63
3957,1,13106,2925,10181,0,0,0,1.0,1,1.0,1,1.0,1,0.18442038827748158,63
3958,1,13107,2925,10182,0,0,0,1.0,1,1.0,1,1.0,1,0.19052971904283772,63
3959,1,13108,2926,10182,0,0,0,1.0,1,1.0,1,1.0,1,0.1957079684359917,62
3960,0,13108,2926,10182,0,0,0,1.0,1,1.0,1,1.0,1,0.1957079684359917,62
3961,7,13115,2928,10187,0,0,0,1.0,1,1.0,1,1.0,1,0.145528096252375,64
3962,5,13120,2930,10190,0,0,0,1.0,1,1.0,1,1.0,1,0.13343356198686812,64
3963,4,13124,2931,10193,0,0,0,1.0,1,1.0,1,1.0,1,0.14145226139827527,62
3964,8,13132,2933,10199,0,0,0,1.0,1,1.0,1,1.0,1,0.1331631899914353,63
3965,5,13137,2933,10204,0,0,0,1.0,1,1.0,1,1.0,1,0.11671729107239592,63
3966,5,13142,2934,10208,0,0,0,1.0,1,1.0,1,1.0,1,0.12101769898448429,62
3967,6,13148,2934,10214,0,0,0,1.0,1,1.0,1,1.0,1,0.14136286715795265,64
3968,4,13152,2935,10217,0,0,0,1.0,1,1.0,1,1.0,1,0.15384300437044987,63
3969,7,13159,2936,10223,0,0,0,1.0,1,1.0,1,1.0,1,0.14835666608176876,63
3970,4,13163,2936,10227,0,0,0,1.0,1,1.0,1,1.0,1,0.1743117153350183,65
3971,3,13166,2936,10230,0,0,0,1.0,1,1.0,1,1.0,1,0.1549706455383191,65
3972,6,13172,2937,10235,0,0,0,1.0,1,1.0,1,1.0,1,0.2164349021811165,66
3973,6,13178,2937,10241,0,0,0,1.0,1,1.0,1,1.0,1,0.19101715940817407,66
3974,17,13195,2939,10256,0,0,0,1.0,1,1.0,1,1.0,1,0.1842659863751218,66
3975,12,13207,2941,10266,0,0,0,1.0,1,1.0,1,1.0,1,0.19215554484117925,66
3976,9,13216,2941,10275,0,0,0,1.0,1,1.0,1,1.0,1,0.15004447187696773,66
3977,3,13219,2942,10277,0,0,0,1.0,1,1.0,1,1.0,1,0.15253481943086467,64
3978,4,13223,2944,10279,0,0,0,1.0,1,1.0,1,1.0,1,0.1906140153763841,63
3979,4,13227,2944,10283,0,0,0,1.0,1,1.0,1,1.0,1,0.1961472190257755,63
3980,4,13231,2944,10287,0,0,0,1.0,1,1.0,1,1.0,1,0.18305637297663852,63
3981,4,13235,2944,10291,0,0,0,1.0,1,1.0,1,1.0,1,0.16942951040795343,64
3982,2,13237,2944,10293,0,0,0,1.0,1,1.0,1,1.0,1,0.1655070493890717,65
3983,3,13240,2945,10295,0,0,0,1.0,1,1.0,1,1.0,1,0.15314899137772486,64
3984,2,13242,2946,10296,0,0,0,1.0,1,1.0,1,1.0,1,0.1527740238483792,65
3985,5,13247,2949,10298,0,0,0,1.0,1,1.0,1,1.0,1,0.18508531670482017,64
3986,3,13250,2949,10301,0,0,0,1.0,1,1.0,1,1.0,1,0.1749002522165672,63
3987,3,13253,2950,10303,0,0,0,1.0,1,1.0,1,1.0,1,0.21022187908949524,63
3988,7,13260,2952,10308,0,0,0,1.0,1,1.0,1,1.0,1,0.21754390543280921,63
3989,7,13267,2954,10313,0,0,0,1.0,1,1.0,1,1.0,1,0.24392450860541126,63
3990,12,13279,2957,10322,0,0,0,1.0,1,1.0,1,1.0,1,0.3056062392962157,62
3991,12,13291,2957,10334,0,0,0,1.0,1,1.0,1,1.0,1,0.15116601001227947,62
3992,7,13298,2957,10341,0,0,0,1.0,1,1.0,1,1.0,1,0.13543311356366786,65
3993,4,13302,2957,10345,0,0,0,1.0,1,1.0,1,1.0,1,0.1361994728606686,65
3994,7,13309,2957,10352,0,0,0,1.0,1,1.0,1,1.0,1,0.12944968242791,64
3995,6,13315,2957,10358,0,0,0,1.0,1,1.0,1,1.0,1,0.12944968242791,64
3996,8,13323,2957,10366,0,0,0,1.0,1,1.0,1,1.0,1,0.10690023105207325,67
3997,10,13333,2957,10376,0,0,0,1.0,1,1.0,1,1.0,1,0.08976193129120413,69
3998,10,13343,2958,10385,0,0,0,1.0,1,1.0,1,1.0,1,0.10514899615237998,69
3999,6,13349,2958,10391,0,0,0,1.0,1,1.0,1,1.0,1,0.12106426682491174,69
4000,11,13360,2958,10402,0,0,0,1.0,1,1.0,1,1.0,1,0.10197678979150573,69
4001,4,13364,2958,10406,0,0,0,1.0,1,1.0,1,1.0,1,0.0981727193963419,68
4002,7,13371,2958,10413,0,0,0,1.0,1,1.0,1,1.0,1,0.12860606388277804,68
4003,10,13381,2960,10421,0,0,0,1.0,1,1.0,1,1.0,1,0.16869301868756373,68
4004,7,13388,2961,10427,0,0,0,1.0,1,1.0,1,1.0,1,0.1630484869167699,67
4005,10,13398,2961,10437,0,0,0,1.0,1,1.0,1,1.0,1,0.16249826698046357,67
4006,10,13408,2963,10445,0,0,0,1.0,1,1.0,1,1.0,1,0.1415429922538629,67
4007,4,13412,2963,10449,0,0,0,1.0,1,1.0,1,1.0,1,0.13175070654803975,67
4008,4,13416,2964,10452,0,0,0,1.0,1,1.0,1,1.0,1,0.13918017632683838,67
4009,3,13419,2964,10455,0,0,0,1.0,1,1.0,1,1.0,1,0.13704217667468468,67
4010,8,13427,2966,10461,0,0,0,1.0,1,1.0,1,1.0,1,0.17474955239123718,66
4011,7,13434,2967,10467,0,0,0,1.0,1,1.0,1,1.0,1,0.15456192808766708,66
4012,4,13438,2967,10471,0,0,0,1.0,1,1.0,1,1.0,1,0.16705607905267186,66
4013,6,13444,2967,10477,0,0,0,1.0,1,1.0,1,1.0,1,0.17281937508741516,66
4014,5,13449,2968,10481,0,0,0,1.0,1,1.0,1,1.0,1,0.18655987468527557,66
4015,3,13452,2968,10484,0,0,0,1.0,1,1.0,1,1.0,1,0.2001840114828647,64
4016,6,13458,2970,10488,0,0,0,1.0,1,1.0,1,1.0,1,0.24885742814851342,64
4017,3,13461,2970,10491,0,0,0,1.0,1,1.0,1,1.0,1,0.2537473375259917,66
4018,9,13470,2970,10500,0,0,0,1.0,1,1.0,1,1.0,1,0.26529784430441616,67
4019,13,13483,2972,10511,0,0,0,1.0,1,1.0,1,1.0,1,0.3046174228078689,67
4020,11,13494,2972,10522,0,0,0,1.0,1,1.0,1,1.0,1,0.3003977458202908,66
4021,14,13508,2974,10534,0,0,0,1.0,1,1.0,1,1.0,1,0.21289529293789117,66
4022,4,13512,2975,10537,0,0,0,1.0,1,1.0,1,1.0,1,0.19794625675350155,66
4023,2,13514,2977,10537,0,0,0,1.0,1,1.0,1,1.0,1,0.18709471932767072,66
4024,2,13516,2978,10538,0,0,0,1.0,1,1.0,1,1.0,1,0.1933346787444959,66
4025,5,13521,2978,10543,0,0,0,1.0,1,1.0,1,1.0,1,0.15264139020128026,66
4026,4,13525,2978,10547,0,0,0,1.0,1,1.0,1,1.0,1,0.1513842538003859,66
4027,7,13532,2979,10553,0,0,0,1.0,1,1.0,1,1.0,1,0.16206304674224264,64
4028,6,13538,2980,10558,0,0,0,1.0,1,1.0,1,1.0,1,0.14281958497264455,63
4029,6,13544,2981,10563,0,0,0,1.0,1,1.0,1,1.0,1,0.1347100805631901,62
4030,5,13549,2982,10567,0,0,0,1.0,1,1.0,1,1.0,1,0.16487605761972318,63
4031,4,13553,2983,10570,0,0,0,1.0,1,1.0,1,1.0,1,0.15971213740972012,62
4032,7,13560,2986,10574,0,0,0,1.0,1,1.0,1,1.0,1,0.19852145462527696,62
4033,8,13568,2988,10580,0,0,0,1.0,1,1.0,1,1.0,1,0.19275973810885483,61
4034,6,13574,2988,10586,0,0,0,1.0,1,1.0,1,1.0,1,0.22423367663684865,60
4035,5,13579,2988,10591,0,0,0,1.0,1,1.0,1,1.0,1,0.23841692740551473,59
4036,8,13587,2989,10598,0,0,0,1.0,1,1.0,1,1.0,1,0.18443215756203402,58
4037,7,13594,2990,10604,0,0,0,1.0,1,1.0,1,1.0,1,0.1423026357001075,59
4038,5,13599,2990,10609,0,0,0,1.0,1,1.0,1,1.0,1,0.11286678381998666,58
4039,6,13605,2992,10613,0,0,0,1.0,1,1.0,1,1.0,1,0.14677901183159658,56
4040,6,13611,2992,10619,0,0,0,1.0,1,1.0,1,1.0,1,0.1583515572077613,55
4041,4,13615,2993,10622,0,0,0,1.0,1,1.0,1,1.0,1,0.24315818657837218,54
4042,10,13625,2995,10630,0,0,0,1.0,1,1.0,1,1.0,1,0.26220793638963463,56
4043,9,13634,2996,10638,0,0,0,1.0,1,1.0,1,1.0,1,0.2855925216249888,56
4044,6,13640,2996,10644,0,0,0,1.0,1,1.0,1,1.0,1,0.2704642605388833,56
4045,11,13651,2997,10654,0,0,0,1.0,1,1.0,1,1.0,1,0.2822931226083265,57
4046,7,13658,2997,10661,0,0,0,1.0,1,1.0,1,1.0,1,0.30700709393693776,59
4047,19,13677,2999,10678,0,0,0,1.0,1,1.0,1,1.0,1,0.29198211563550985,59
4048,7,13684,2999,10685,0,0,0,1.0,1,1.0,1,1.0,1,0.3189912094335335,59
4049,7,13691,2999,10692,0,0,0,1.0,1,1.0,1,1.0,1,0.280400032919417,60
4050,12,13703,2999,10704,0,0,0,1.0,1,1.0,1,1.0,1,0.2858681577646944,60
4051,7,13710,2999,10711,0,0,0,1.0,1,1.0,1,1.0,1,0.21911381229349536,60
4052,1,13711,2999,10712,0,0,0,1.0,1,1.0,1,1.0,1,0.21557707439646923,60
4053,0,13711,2999,10712,0,0,0,1.0,1,1.0,1,1.0,1,0.21557707439646923,60
4054,3,13714,3000,10714,0,0,0,1.0,1,1.0,1,1.0,1,0.21140239807311084,61
4055,0,13714,3000,10714,0,0,0,1.0,1,1.0,1,1.0,1,0.21140239807311084,61
4056,2,13716,3000,10716,0,0,0,1.0,1,1.0,1,1.0,1,0.20464550128508607,62
4057,2,13718,3000,10718,0,0,0,1.0,1,1.0,1,1.0,1,0.20792887418732395,63
4058,1,13719,3001,10718,0,0,0,1.0,1,1.0,1,1.0,1,0.21379861522127636,64
4059,0,13719,3001,10718,0,0,0,1.0,1,1.0,1,1.0,1,0.23040480769567445,63
4060,0,13719,3001,10718,0,0,0,1.0,1,1.0,1,1.0,1,0.23040480769567445,63
4061,0,13719,3001,10718,0,0,0,1.0,1,1.0,1,1.0,1,0.23422972797188668,63
4062,3,13722,3003,10719,0,0,0,1.0,1,1.0,1,1.0,1,0.22918387616916333,65
4063,4,13726,3003,10723,0,0,0,1.0,1,1.0,1,1.0,1,0.1824981996274231,64
4064,6,13732,3005,10727,0,0,0,1.0,1,1.0,1,1.0,1,0.17848037919494117,65
4065,4,13736,3006,10730,0,0,0,1.0,1,1.0,1,1.0,1,0.15559251447503547,64
4066,4,13740,3008,10732,0,0,0,1.0,1,1.0,1,1.0,1,0.14464850705783716,64
4067,2,13742,3009,10733,0,0,0,1.0,1,1.0,1,1.0,1,0.16236382760676213,63
4068,1,13743,3009,10734,0,0,0,1.0,1,1.0,1,1.0,1,0.17234408955807592,64
4069,8,13751,3013,10738,0,0,0,1.0,1,1.0,1,1.0,1,0.21289200202532485,62
4070,5,13756,3015,10741,0,0,0,1.0,1,1.0,1,1.0,1,0.22058009042536572,61
4071,8,13764,3018,10746,0,0,0,1.0,1,1.0,1,1.0,1,0.23924753818278616,61
4072,11,13775,3023,10752,0,0,0,1.0,1,1.0,1,1.0,1,0.24087024742380586,60
4073,6,13781,3025,10756,0,0,0,1.0,1,1.0,1,1.0,1,0.22506466967110458,60
4074,5,13786,3028,10758,0,0,0,1.0,1,1.0,1,1.0,1,0.21608863661225106,60
4075,3,13789,3029,10760,0,0,0,1.0,1,1.0,1,1.0,1,0.21591530616374188,59
4076,2,13791,3029,10762,0,0,0,1.0,1,1.0,1,1.0,1,0.20339496094084109,60
4077,2,13793,3029,10764,0,0,0,1.0,1,1.0,1,1.0,1,0.20984693226989312,61
4078,2,13795,3029,10766,0,0,0,1.0,1,1.0,1,1.0,1,0.21980402445115627,60
4079,2,13797,3030,10767,0,0,0,1.0,1,1.0,1,1.0,1,0.2523069231760893,58
4080,1,13798,3030,10768,0,0,0,1.0,1,1.0,1,1.0,1,0.27714944680065207,56
4081,10,13808,3031,10777,0,0,0,1.0,1,1.0,1,1.0,1,0.16313594190507433,56
4082,2,13810,3031,10779,0,0,0,1.0,1,1.0,1,1.0,1,0.16704043399928764,55
4083,1,13811,3032,10779,0,0,0,1.0,1,1.0,1,1.0,1,0.18297488227654785,55
4084,3,13814,3033,10781,0,0,0,1.0,1,1.0,1,1.0,1,0.19338335797373382,55
4085,7,13821,3035,10786,0,0,0,1.0,1,1.0,1,1.0,1,0.16719576588417223,56
4086,4,13825,3036,10789,0,0,0,1.0,1,1.0,1,1.0,1,0.14092740437520662,57
4087,4,13829,3037,10792,0,0,0,1.0,1,1.0,1,1.0,1,0.16882778209398325,57
4088,3,13832,3037,10795,0,0,0,1.0,1,1.0,1,1.0,1,0.1750027223906426,57
4089,6,13838,3037,10801,0,0,0,1.0,1,1.0,1,1.0,1,0.19887359331437893,56
4090,6,13844,3038,10806,0,0,0,1.0,1,1.0,1,1.0,1,0.19460830397081524,56
4091,4,13848,3038,10810,0,0,0,1.0,1,1.0,1,1.0,1,0.2488174656503211,56
4092,8,13856,3038,10818,0,0,0,1.0,1,1.0,1,1.0,1,0.21727344265767096,57
4093,8,13864,3039,10825,0,0,0,1.0,1,1.0,1,1.0,1,0.21712373252898834,58
4094,10,13874,3039,10835,0,0,0,1.0,1,1.0,1,1.0,1,0.18532759233888255,57
4095,4,13878,3039,10839,0,0,0,1.0,1,1.0,1,1.0,1,0.18806384251664932,57
4096,8,13886,3040,10846,0,0,0,1.0,1,1.0,1,1.0,1,0.12487466400075165,59
4097,3,13889,3040,10849,0,0,0,1.0,1,1.0,1,1.0,1,0.11799092550211165,59
4098,2,13891,3041,10850,0,0,0,1.0,1,1.0,1,1.0,1,0.10619019241218798,59
4099,2,13893,3043,10850,0,0,0,1.0,1,1.0,1,1.0,1,0.16105364000037836,60
4100,2,13895,3043,10852,0,0,0,1.0,1,1.0,1,1.0,1,0.1414234983088103,60
4101,3,13898,3043,10855,0,0,0,1.0,1,1.0,1,1.0,1,0.14132327172930212,60
4102,7,13905,3048,10857,0,0,0,1.0,1,1.0,1,1.0,1,0.13527434735274252,60
4103,3,13908,3049,10859,0,0,0,1.0,1,1.0,1,1.0,1,0.1818629533424732,58
4104,3,13911,3050,10861,0,0,0,1.0,1,1.0,1,1.0,1,0.13361222943128087,60
4105,5,13916,3052,10864,0,0,0,1.0,1,1.0,1,1.0,1,0.13298546701067607,59
4106,3,13919,3053,10866,0,0,0,1.0,1,1.0,1,1.0,1,0.15774168301483893,61
4107,2,13921,3054,10867,0,0,0,1.0,1,1.0,1,1.0,1,0.18111343982897377,59
4108,4,13925,3056,10869,0,0,0,1.0,1,1.0,1,1.0,1,0.18893271315554097,60
4109,5,13930,3056,10874,0,0,0,1.0,1,1.0,1,1.0,1,0.16985620055161152,59
4110,7,13937,3059,10878,0,0,0,1.0,1,1.0,1,1.0,1,0.1505712332407936,60
4111,6,13943,3059,10884,0,0,0,1.0,1,1.0,1,1.0,1,0.12251124476136281,61
4112,1,13944,3059,10885,0,0,0,1.0,1,1.0,1,1.0,1,0.12307526813462727,60
4113,1,13945,3060,10885,0,0,0,1.0,1,1.0,1,1.0,1,0.12007402478556903,61
4114,6,13951,3061,10890,0,0,0,1.0,1,1.0,1,1.0,1,0.1548698918480335,62
4115,4,13955,3062,10893,0,0,0,1.0,1,1.0,1,1.0,1,0.13711332450411118,60
4116,2,13957,3062,10895,0,0,0,1.0,1,1.0,1,1.0,1,0.1298533596858798,59
4117,3,13960,3064,10896,0,0,0,1.0,1,1.0,1,1.0,1,0.15331416235965395,56
4118,1,13961,3064,10897,0,0,0,1.0,1,1.0,1,1.0,1,0.12689433577856798,55
4119,3,13964,3064,10900,0,0,0,1.0,1,1.0,1,1.0,1,0.14807512546601204,53
4120,4,13968,3065,10903,0,0,0,1.0,1,1.0,1,1.0,1,0.20570970655657447,52
4121,2,13970,3066,10904,0,0,0,1.0,1,1.0,1,1.0,1,0.21434421529735123,53
4122,1,13971,3066,10905,0,0,0,1.0,1,1.0,1,1.0,1,0.2250866524862407,52
4123,2,13973,3067,10906,0,0,0,1.0,1,1.0,1,1.0,1,0.2059006174146355,51
4124,3,13976,3069,10907,0,0,0,1.0,1,1.0,1,1.0,1,0.21992586339802822,51
4125,3,13979,3069,10910,0,0,0,1.0,1,1.0,1,1.0,1,0.24842874576094773,50
4126,9,13988,3071,10917,0,0,0,1.0,1,1.0,1,1.0,1,0.14331439603371274,50
4127,3,13991,3072,10919,0,0,0,1.0,1,1.0,1,1.0,1,0.15060653457662804,49
4128,3,13994,3073,10921,0,0,0,1.0,1,1.0,1,1.0,1,0.17458509661235722,49
4129,3,13997,3073,10924,0,0,0,1.0,1,1.0,1,1.0,1,0.18693160891681684,49
4130,3,14000,3073,10927,0,0,0,1.0,1,1.0,1,1.0,1,0.13365190470772398,50
4131,4,14004,3073,10931,0,0,0,1.0,1,1.0,1,1.0,1,0.15007719974628025,50
4132,3,14007,3073,10934,0,0,0,1.0,1,1.0,1,1.0,1,0.14014962610025405,50
4133,4,14011,3074,10937,0,0,0,1.0,1,1.0,1,1.0,1,0.1794900686602664,51
4134,6,14017,3074,10943,0,0,0,1.0,1,1.0,1,1.0,1,0.19382742086224805,53
4135,6,14023,3074,10949,0,0,0,1.0,1,1.0,1,1.0,1,0.17680921862060173,54
4136,5,14028,3074,10954,0,0,0,1.0,1,1.0,1,1.0,1,0.157882012284955,54
4137,8,14036,3075,10961,0,0,0,1.0,1,1.0,1,1.0,1,0.16969845855921561,55
4138,3,14039,3076,10963,0,0,0,1.0,1,1.0,1,1.0,1,0.20418639301770294,54
4139,8,14047,3077,10970,0,0,0,1.0,1,1.0,1,1.0,1,0.23459376263556303,54
4140,15,14062,3079,10983,0,0,0,1.0,1,1.0,1,1.0,1,0.2714299114862103,55
4141,10,14072,3079,10993,0,0,0,1.0,1,1.0,1,1.0,1,0.18681087909047625,55
4142,9,14081,3081,11000,0,0,0,1.0,1,1.0,1,1.0,1,0.1693176064396328,55
4143,7,14088,3084,11004,0,0,0,1.0,1,1.0,1,1.0,1,0.2187425533836759,53
4144,6,14094,3084,11010,0,0,0,1.0,1,1.0,1,1.0,1,0.22740997483996975,52
4145,11,14105,3086,11019,0,0,0,1.0,1,1.0,1,1.0,1,0.23387811895778618,51
4146,4,14109,3086,11023,0,0,0,1.0,1,1.0,1,1.0,1,0.2139253493653432,51
4147,9,14118,3090,11028,0,0,0,1.0,1,1.0,1,1.0,1,0.30935279424768675,50
4148,9,14127,3090,11037,0,0,0,1.0,1,1.0,1,1.0,1,0.2886072993629652,52
4149,5,14132,3090,11042,0,0,0,1.0,1,1.0,1,1.0,1,0.26609838992668483,53
4150,8,14140,3091,11049,0,0,0,1.0,1,1.0,1,1.0,1,0.24135097232105313,53
4151,5,14145,3091,11054,0,0,0,1.0,1,1.0,1,1.0,1,0.2650326366459988,53
4152,6,14151,3091,11060,0,0,0,1.0,1,1.0,1,1.0,1,0.2429953947581963,54
4153,9,14160,3091,11069,0,0,0,1.0,1,1.0,1,1.0,1,0.22138222304138797,51
4154,7,14167,3091,11076,0,0,0,1.0,1,1.0,1,1.0,1,0.23083018237801115,51
4155,6,14173,3092,11081,0,0,0,1.0,1,1.0,1,1.0,1,0.2287693606540698,51
4156,10,14183,3093,11090,0,0,0,1.0,1,1.0,1,1.0,1,0.1316974147703904,52
4157,8,14191,3095,11096,0,0,0,1.0,1,1.0,1,1.0,1,0.17049400086144564,52
4158,4,14195,3095,11100,0,0,0,1.0,1,1.0,1,1.0,1,0.16243017279410543,52
4159,5,14200,3095,11105,0,0,0,1.0,1,1.0,1,1.0,1,0.16548337284953718,52
4160,6,14206,3095,11111,0,0,0,1.0,1,1.0,1,1.0,1,0.17859674403536016,50
4161,3,14209,3095,11114,0,0,0,1.0,1,1.0,1,1.0,1,0.16610053439552783,50
4162,4,14213,3096,11117,0,0,0,1.0,1,1.0,1,1.0,1,0.186268488130579,51
4163,7,14220,3097,11123,0,0,0,1.0,1,1.0,1,1.0,1,0.16678486148108593,48
4164,6,14226,3098,11128,0,0,0,1.0,1,1.0,1,1.0,1,0.16339560462164548,50
4165,2,14228,3098,11130,0,0,0,1.0,1,1.0,1,1.0,1,0.19326161325313554,49
4166,5,14233,3099,11134,0,0,0,1.0,1,1.0,1,1.0,1,0.17064962641898584,50
4167,4,14237,3099,11138,0,0,0,1.0,1,1.0,1,1.0,1,0.17077838337333884,50
4168,3,14240,3099,11141,0,0,0,1.0,1,1.0,1,1.0,1,0.19122269253446844,50
4169,6,14246,3100,11146,0,0,0,1.0,1,1.0,1,1.0,1,0.20957039781386863,51
4170,4,14250,3102,11148,0,0,0,1.0,1,1.0,1,1.0,1,0.2749324620829407,50
4171,9,14259,3103,11156,0,0,0,1.0,1,1.0,1,1.0,1,0.23965570767357172,50
4172,1,14260,3103,11157,0,0,0,1.0,1,1.0,1,1.0,1,0.2392860954348234,49
4173,0,14260,3103,11157,0,0,0,1.0,1,1.0,1,1.0,1,0.2661508287285546,48
4174,1,14261,3103,11158,0,0,0,1.0,1,1.0,1,1.0,1,0.2537289128663611,48
4175,1,14262,3103,11159,0,0,0,1.0,1,1.0,1,1.0,1,0.23434794519069496,48
4176,2,14264,3104,11160,0,0,0,1.0,1,1.0,1,1.0,1,0.22673076460134603,50
4177,5,14269,3106,11163,0,0,0,1.0,1,1.0,1,1.0,1,0.20973330083893402,52
4178,3,14272,3108,11164,0,0,0,1.0,1,1.0,1,1.0,1,0.21084655414995399,53
4179,2,14274,3109,11165,0,0,0,1.0,1,1.0,1,1.0,1,0.193054794851995,54
4180,2,14276,3109,11167,0,0,0,1.0,1,1.0,1,1.0,1,0.18618867503810094,55
4181,4,14280,3109,11171,0,0,0,1.0,1,1.0,1,1.0,1,0.17808243231795695,56
4182,3,14283,3109,11174,0,0,0,1.0,1,1.0,1,1.0,1,0.1813827531115639,56
4183,4,14287,3110,11177,0,0,0,1.0,1,1.0,1,1.0,1,0.16143560740622834,57
4184,6,14293,3113,11180,0,0,0,1.0,1,1.0,1,1.0,1,0.1985419319321191,57
4185,7,14300,3114,11186,0,0,0,1.0,1,1.0,1,1.0,1,0.22355957928222997,54
4186,8,14308,3115,11193,0,0,0,1.0,1,1.0,1,1.0,1,0.13934823492293805,55
4187,1,14309,3115,11194,0,0,0,1.0,1,1.0,1,1.0,1,0.14583889205357697,53
4188,2,14311,3115,11196,0,0,0,1.0,1,1.0,1,1.0,1,0.13469328687871465,53
4189,6,14317,3116,11201,0,0,0,1.0,1,1.0,1,1.0,1,0.1048869538252007,53
4190,2,14319,3117,11202,0,0,0,1.0,1,1.0,1,1.0,1,0.13024990782362195,53
4191,1,14320,3117,11203,0,0,0,1.0,1,1.0,1,1.0,1,0.14924670431194303,51
4192,4,14324,3119,11205,0,0,0,1.0,1,1.0,1,1.0,1,0.1498854737827821,51
4193,2,14326,3119,11207,0,0,0,1.0,1,1.0,1,1.0,1,0.14531048066197513,50
4194,1,14327,3119,11208,0,0,0,1.0,1,1.0,1,1.0,1,0.1622489408347556,50
4195,5,14332,3122,11210,0,0,0,1.0,1,1.0,1,1.0,1,0.14881979694613306,50
4196,4,14336,3124,11212,0,0,0,1.0,1,1.0,1,1.0,1,0.21861898144958555,51
4197,4,14340,3124,11216,0,0,0,1.0,1,1.0,1,1.0,1,0.22510688624464167,50
4198,2,14342,3126,11216,0,0,0,1.0,1,1.0,1,1.0,1,0.22481044982021853,48
4199,1,14343,3126,11217,0,0,0,1.0,1,1.0,1,1.0,1,0.24894493636261897,48
4200,4,14347,3127,11220,0,0,0,1.0,1,1.0,1,1.0,1,0.2726114938399605,48
4201,5,14352,3127,11225,0,0,0,1.0,1,1.0,1,1.0,1,0.2084834363037552,47
4202,4,14356,3128,11228,0,0,0,1.0,1,1.0,1,1.0,1,0.20264918625818826,47
4203,3,14359,3129,11230,0,0,0,1.0,1,1.0,1,1.0,1,0.2383898975064998,47
4204,2,14361,3130,11231,0,0,0,1.0,1,1.0,1,1.0,1,0.24843385747318178,48
4205,2,14363,3130,11233,0,0,0,1.0,1,1.0,1,1.0,1,0.23894043556991915,49
4206,2,14365,3130,11235,0,0,0,1.0,1,1.0,1,1.0,1,0.23894043556991915,49
4207,2,14367,3130,11237,0,0,0,1.0,1,1.0,1,1.0,1,0.25340583977432407,48
4208,1,14368,3131,11237,0,0,0,1.0,1,1.0,1,1.0,1,0.24250648759769758,49
4209,5,14373,3133,11240,0,0,0,1.0,1,1.0,1,1.0,1,0.21853085577227258,51
4210,4,14377,3134,11243,0,0,0,1.0,1,1.0,1,1.0,1,0.20412461507355864,52
4211,1,14378,3134,11244,0,0,0,1.0,1,1.0,1,1.0,1,0.18686955191283655,53
4212,1,14379,3134,11245,0,0,0,1.0,1,1.0,1,1.0,1,0.19328309973241528,53
4213,1,14380,3134,11246,0,0,0,1.0,1,1.0,1,1.0,1,0.17375636305571499,54
4214,6,14386,3135,11251,0,0,0,1.0,1,1.0,1,1.0,1,0.1814295608093583,54
4215,4,14390,3136,11254,0,0,0,1.0,1,1.0,1,1.0,1,0.17974439584454713,54
4216,2,14392,3136,11256,0,0,0,1.0,1,1.0,1,1.0,1,0.18151934749380408,53
4217,3,14395,3138,11257,0,0,0,1.0,1,1.0,1,1.0,1,0.24353507566044863,54
4218,2,14397,3138,11259,0,0,0,1.0,1,1.0,1,1.0,1,0.22724766016742334,53
4219,2,14399,3139,11260,0,0,0,1.0,1,1.0,1,1.0,1,0.23370320762402771,53
4220,1,14400,3140,11260,0,0,0,1.0,1,1.0,1,1.0,1,0.25370346058887605,53
4221,4,14404,3141,11263,0,0,0,1.0,1,1.0,1,1.0,1,0.2586274915994874,54
4222,5,14409,3144,11265,0,0,0,1.0,1,1.0,1,1.0,1,0.260775463574461,55
4223,5,14414,3146,11268,0,0,0,1.0,1,1.0,1,1.0,1,0.2678328781314824,56
4224,4,14418,3147,11271,0,0,0,1.0,1,1.0,1,1.0,1,0.26323319501385234,55
4225,0,14418,3147,11271,0,0,0,1.0,1,1.0,1,1.0,1,0.26502226265606105,53
4226,4,14422,3150,11272,0,0,0,1.0,1,1.0,1,1.0,1,0.27667154017158,54
4227,1,14423,3150,11273,0,0,0,1.0,1,1.0,1,1.0,1,0.27480230409171524,52
4228,5,14428,3151,11277,0,0,0,1.0,1,1.0,1,1.0,1,0.2789869597330977,51
4229,3,14431,3152,11279,0,0,0,1.0,1,1.0,1,1.0,1,0.284756085207539,48
4230,3,14434,3154,11280,0,0,0,1.0,1,1.0,1,1.0,1,0.2813544593841658,48
4231,6,14440,3154,11286,0,0,0,1.0,1,1.0,1,1.0,1,0.19062621493749118,48
4232,4,14444,3155,11289,0,0,0,1.0,1,1.0,1,1.0,1,0.1618749288708639,48
4233,3,14447,3155,11292,0,0,0,1.0,1,1.0,1,1.0,1,0.15149622450921577,48
4234,7,14454,3157,11297,0,0,0,1.0,1,1.0,1,1.0,1,0.15978110397470485,49
4235,5,14459,3157,11302,0,0,0,1.0,1,1.0,1,1.0,1,0.19135739302110805,47
4236,8,14467,3158,11309,0,0,0,1.0,1,1.0,1,1.0,1,0.13704875776951386,47
4237,6,14473,3158,11315,0,0,0,1.0,1,1.0,1,1.0,1,0.19333786156511323,48
4238,2,14475,3158,11317,0,0,0,1.0,1,1.0,1,1.0,1,0.16469666530676685,47
4239,2,14477,3158,11319,0,0,0,1.0,1,1.0,1,1.0,1,0.14831188180621982,48
4240,2,14479,3158,11321,0,0,0,1.0,1,1.0,1,1.0,1,0.1176780240375254,47
4241,3,14482,3158,11324,0,0,0,1.0,1,1.0,1,1.0,1,0.09922906960136202,49
4242,5,14487,3158,11329,0,0,0,1.0,1,1.0,1,1.0,1,0.10513612050194976,49
4243,1,14488,3158,11330,0,0,0,1.0,1,1.0,1,1.0,1,0.148480411735661,50
4244,5,14493,3158,11335,0,0,0,1.0,1,1.0,1,1.0,1,0.08735894162777723,51
4245,8,14501,3158,11343,0,0,0,1.0,1,1.0,1,1.0,1,0.1210084027721791,51
4246,3,14504,3158,11346,0,0,0,1.0,1,1.0,1,1.0,1,0.04623639261355679,51
4247,2,14506,3158,11348,0,0,0,1.0,1,1.0,1,1.0,1,0.04370673167227943,52
4248,1,14507,3159,11348,0,0,0,1.0,1,1.0,1,1.0,1,0.0626929793043706,52
4249,0,14507,3159,11348,0,0,0,1.0,1,1.0,1,1.0,1,0.0626929793043706,52
4250,2,14509,3161,11348,0,0,0,1.0,1,1.0,1,1.0,1,0.10692574048172435,52
4251,4,14513,3162,11351,0,0,0,1.0,1,1.0,1,1.0,1,0.0957273594724628,53
4252,6,14519,3164,11355,0,0,0,1.0,1,1.0,1,1.0,1,0.13385387808979451,53
4253,3,14522,3166,11356,0,0,0,1.0,1,1.0,1,1.0,1,0.1471771164785751,54
4254,2,14524,3166,11358,0,0,0,1.0,1,1.0,1,1.0,1,0.14660971578129733,54
4255,4,14528,3166,11362,0,0,0,1.0,1,1.0,1,1.0,1,0.157457019184572,55
4256,11,14539,3168,11371,0,0,0,1.0,1,1.0,1,1.0,1,0.1844977666059059,57
4257,10,14549,3169,11380,0,0,0,1.0,1,1.0,1,1.0,1,0.18206821412752422,57
4258,7,14556,3169,11387,0,0,0,1.0,1,1.0,1,1.0,1,0.1720356925733819,57
4259,6,14562,3169,11393,0,0,0,1.0,1,1.0,1,1.0,1,0.1720356925733819,57
4260,8,14570,3169,11401,0,0,0,1.0,1,1.0,1,1.0,1,0.18844870254975912,58
4261,10,14580,3170,11410,0,0,0,1.0,1,1.0,1,1.0,1,0.08600360471782731,59
4262,6,14586,3171,11415,0,0,0,1.0,1,1.0,1,1.0,1,0.09633372363715571,60
4263,2,14588,3172,11416,0,0,0,1.0,1,1.0,1,1.0,1,0.09828967974961327,59
4264,5,14593,3174,11419,0,0,0,1.0,1,1.0,1,1.0,1,0.1141551310416662,58
4265,3,14596,3175,11421,0,0,0,1.0,1,1.0,1,1.0,1,0.18756832198865647,58
4266,3,14599,3175,11424,0,0,0,1.0,1,1.0,1,1.0,1,0.17045543410265146,58
4267,3,14602,3177,11425,0,0,0,1.0,1,1.0,1,1.0,1,0.18434101103763434,55
4268,3,14605,3179,11426,0,0,0,1.0,1,1.0,1,1.0,1,0.18969151237916043,55
4269,2,14607,3180,11427,0,0,0,1.0,1,1.0,1,1.0,1,0.19629877170026247,50
4270,1,14608,3181,11427,0,0,0,1.0,1,1.0,1,1.0,1,0.20999726144537934,47
4271,2,14610,3182,11428,0,0,0,1.0,1,1.0,1,1.0,1,0.22933962319155007,47
4272,2,14612,3183,11429,0,0,0,1.0,1,1.0,1,1.0,1,0.21282950722093308,46
4273,2,14614,3184,11430,0,0,0,1.0,1,1.0,1,1.0,1,0.22886910750581205,47
4274,4,14618,3187,11431,0,0,0,1.0,1,1.0,1,1.0,1,0.210342344793249,45
4275,4,14622,3191,11431,0,0,0,1.0,1,1.0,1,1.0,1,0.3112427520415195,44
4276,11,14633,3193,11440,0,0,0,1.0,1,1.0,1,1.0,1,0.1334701359367382,43
4277,6,14639,3193,11446,0,0,0,1.0,1,1.0,1,1.0,1,0.15371601389970146,42
4278,7,14646,3193,11453,0,0,0,1.0,1,1.0,1,1.0,1,0.15784737698697562,43
4279,9,14655,3195,11460,0,0,0,1.0,1,1.0,1,1.0,1,0.2633975023027601,42
4280,9,14664,3195,11469,0,0,0,1.0,1,1.0,1,1.0,1,0.18542360085079254,44
4281,3,14667,3195,11472,0,0,0,1.0,1,1.0,1,1.0,1,0.21912064924122857,44
4282,4,14671,3195,11476,0,0,0,1.0,1,1.0,1,1.0,1,0.21904251935965519,44
4283,3,14674,3196,11478,0,0,0,1.0,1,1.0,1,1.0,1,0.17556588143491722,45
4284,3,14677,3196,11481,0,0,0,1.0,1,1.0,1,1.0,1,0.18036830648703261,45
4285,5,14682,3196,11486,0,0,0,1.0,1,1.0,1,1.0,1,0.17263257710177626,47
4286,6,14688,3196,11492,0,0,0,1.0,1,1.0,1,1.0,1,0.1682556427036833,47
4287,7,14695,3196,11499,0,0,0,1.0,1,1.0,1,1.0,1,0.17863065612048806,49
4288,7,14702,3196,11506,0,0,0,1.0,1,1.0,1,1.0,1,0.16769874401740062,49
4289,10,14712,3196,11516,0,0,0,1.0,1,1.0,1,1.0,1,0.17576467235260917,50
4290,8,14720,3197,11523,0,0,0,1.0,1,1.0,1,1.0,1,0.1417270869947497,51
4291,8,14728,3198,11530,0,0,0,1.0,1,1.0,1,1.0,1,0.09561370306947711,50
4292,2,14730,3199,11531,0,0,0,1.0,1,1.0,1,1.0,1,0.11141692348085531,51
4293,2,14732,3200,11532,0,0,0,1.0,1,1.0,1,1.0,1,0.0916948020924606,51
4294,3,14735,3201,11534,0,0,0,1.0,1,1.0,1,1.0,1,0.11883948676820379,50
4295,4,14739,3203,11536,0,0,0,1.0,1,1.0,1,1.0,1,0.1360241391258926,50
4296,3,14742,3203,11539,0,0,0,1.0,1,1.0,1,1.0,1,0.13431712668251347,49
4297,1,14743,3203,11540,0,0,0,1.0,1,1.0,1,1.0,1,0.13523673725747815,49
4298,2,14745,3204,11541,0,0,0,1.0,1,1.0,1,1.0,1,0.14440733992360003,49
4299,1,14746,3204,11542,0,0,0,1.0,1,1.0,1,1.0,1,0.14580448024339798,48
4300,0,14746,3204,11542,0,0,0,1.0,1,1.0,1,1.0,1,0.1277164351893476,49
4301,2,14748,3205,11543,0,0,0,1.0,1,1.0,1,1.0,1,0.09774550562388103,50
4302,1,14749,3206,11543,0,0,0,1.0,1,1.0,1,1.0,1,0.1311919876802491,51
4303,2,14751,3207,11544,0,0,0,1.0,1,1.0,1,1.0,1,0.12576033432934988,51
4304,3,14754,3209,11545,0,0,0,1.0,1,1.0,1,1.0,1,0.17594103165620484,51
4305,3,14757,3210,11547,0,0,0,1.0,1,1.0,1,1.0,1,0.1917993599857109,49
4306,10,14767,3213,11554,0,0,0,1.0,1,1.0,1,1.0,1,0.13892632393126458,49
4307,4,14771,3216,11555,0,0,0,1.0,1,1.0,1,1.0,1,0.16762293394387656,46
4308,0,14771,3216,11555,0,0,0,1.0,1,1.0,1,1.0,1,0.1699906086816053,44
4309,3,14774,3217,11557,0,0,0,1.0,1,1.0,1,1.0,1,0.1618682708797367,44
4310,1,14775,3218,11557,0,0,0,1.0,1,1.0,1,1.0,1,0.17536750909772247,42
4311,3,14778,3219,11559,0,0,0,1.0,1,1.0,1,1.0,1,0.18863344927107895,42
4312,3,14781,3220,11561,0,0,0,1.0,1,1.0,1,1.0,1,0.2236394405135775,40
4313,5,14786,3223,11563,0,0,0,1.0,1,1.0,1,1.0,1,0.1859580972360924,40
4314,1,14787,3223,11564,0,0,0,1.0,1,1.0,1,1.0,1,0.22735706935254227,36
4315,2,14789,3225,11564,0,0,0,1.0,1,1.0,1,1.0,1,0.1651583138544011,37
4316,1,14790,3226,11564,0,0,0,1.0,1,1.0,1,1.0,1,0.194858807847991,37
4317,5,14795,3231,11564,0,0,0,1.0,1,1.0,1,1.0,1,0.2846123107895841,36
4318,2,14797,3231,11566,0,0,0,1.0,1,1.0,1,1.0,1,0.22418974892824595,34
4319,0,14797,3231,11566,0,0,0,1.0,1,1.0,1,1.0,1,0.23579989584171873,34
4320,0,14797,3231,11566,0,0,0,1.0,1,1.0,1,1.0,1,0.23579989584171873,34
4321,7,14804,3231,11573,0,0,0,1.0,1,1.0,1,1.0,1,0.15562953312602706,35
4322,0,14804,3231,11573,0,0,0,1.0,1,1.0,1,1.0,1,0.15562953312602706,35
4323,2,14806,3233,11573,0,0,0,1.0,1,1.0,1,1.0,1,0.18822090905292582,35
4324,3,14809,3233,11576,0,0,0,1.0,1,1.0,1,1.0,1,0.17567085912613567,34
4325,3,14812,3234,11578,0,0,0,1.0,1,1.0,1,1.0,1,0.1688935182159179,34
4326,3,14815,3234,11581,0,0,0,1.0,1,1.0,1,1.0,1,0.10674925464863974,36
4327,1,14816,3234,11582,0,0,0,1.0,1,1.0,1,1.0,1,0.13230665869436917,35
4328,3,14819,3235,11584,0,0,0,1.0,1,1.0,1,1.0,1,0.13077803826020046,35
4329,1,14820,3235,11585,0,0,0,1.0,1,1.0,1,1.0,1,0.14002002344934364,38
4330,2,14822,3236,11586,0,0,0,1.0,1,1.0,1,1.0,1,0.14690364036625808,38
4331,2,14824,3236,11588,0,0,0,1.0,1,1.0,1,1.0,1,0.17242268083134435,39
4332,5,14829,3236,11593,0,0,0,1.0,1,1.0,1,1.0,1,0.13590646979443066,40
4333,1,14830,3236,11594,0,0,0,1.0,1,1.0,1,1.0,1,0.10110009197010968,41
4334,3,14833,3236,11597,0,0,0,1.0,1,1.0,1,1.0,1,0.07400125350473219,41
4335,3,14836,3237,11599,0,0,0,1.0,1,1.0,1,1.0,1,0.09600015898471218,42
4336,1,14837,3237,11600,0,0,0,1.0,1,1.0,1,1.0,1,0.09719073771742255,43
4337,0,14837,3237,11600,0,0,0,1.0,1,1.0,1,1.0,1,0.07683768248892602,44
4338,0,14837,3237,11600,0,0,0,1.0,1,1.0,1,1.0,1,0.07683768248892602,44
4339,2,14839,3238,11601,0,0,0,1.0,1,1.0,1,1.0,1,0.09540358978836219,46
4340,0,14839,3238,11601,0,0,0,1.0,1,1.0,1,1.0,1,0.10547366182698502,47
4341,1,14840,3239,11601,0,0,0,1.0,1,1.0,1,1.0,1,0.13878382808560413,47
4342,5,14845,3242,11603,0,0,0,1.0,1,1.0,1,1.0,1,0.18136192001120977,47
4343,1,14846,3243,11603,0,0,0,1.0,1,1.0,1,1.0,1,0.19247816978623733,42
4344,5,14851,3246,11605,0,0,0,1.0,1,1.0,1,1.0,1,0.23279190670877495,42
4345,3,14854,3248,11606,0,0,0,1.0,1,1.0,1,1.0,1,0.2271429555306372,39
4346,2,14856,3250,11606,0,0,0,1.0,1,1.0,1,1.0,1,0.24773150429639784,37
4347,1,14857,3251,11606,0,0,0,1.0,1,1.0,1,1.0,1,0.2757467070431914,37
4348,5,14862,3255,11607,0,0,0,1.0,1,1.0,1,1.0,1,0.35980393618398987,38
4349,3,14865,3255,11610,0,0,0,1.0,1,1.0,1,1.0,1,0.298008697245994,36
4350,1,14866,3256,11610,0,0,0,1.0,1,1.0,1,1.0,1,0.3156359140704719,37
4351,9,14875,3257,11618,0,0,0,1.0,1,1.0,1,1.0,1,0.22978564750424216,35
4352,7,14882,3259,11623,0,0,0,1.0,1,1.0,1,1.0,1,0.33102074910800294,34
4353,4,14886,3259,11627,0,0,0,1.0,1,1.0,1,1.0,1,0.29091333071449416,34
4354,2,14888,3259,11629,0,0,0,1.0,1,1.0,1,1.0,1,0.3060075104726348,32
4355,4,14892,3259,11633,0,0,0,1.0,1,1.0,1,1.0,1,0.21503262982979957,32
4356,4,14896,3260,11636,0,0,0,1.0,1,1.0,1,1.0,1,0.20050506201880994,34
4357,3,14899,3260,11639,0,0,0,1.0,1,1.0,1,1.0,1,0.2060786651478553,35
4358,7,14906,3262,11644,0,0,0,1.0,1,1.0,1,1.0,1,0.21317341361931813,35
4359,3,14909,3262,11647,0,0,0,1.0,1,1.0,1,1.0,1,0.2375643882483616,37
4360,5,14914,3262,11652,0,0,0,1.0,1,1.0,1,1.0,1,0.22338055418335623,38
4361,2,14916,3262,11654,0,0,0,1.0,1,1.0,1,1.0,1,0.1582908834568018,39
4362,7,14923,3264,11659,0,0,0,1.0,1,1.0,1,1.0,1,0.21062486670775657,38
4363,3,14926,3264,11662,0,0,0,1.0,1,1.0,1,1.0,1,0.24223638451373952,38
4364,4,14930,3265,11665,0,0,0,1.0,1,1.0,1,1.0,1,0.24565832801679943,39
4365,4,14934,3265,11669,0,0,0,1.0,1,1.0,1,1.0,1,0.25677060942799507,39
4366,7,14941,3265,11676,0,0,0,1.0,1,1.0,1,1.0,1,0.13112781412694496,39
4367,5,14946,3266,11680,0,0,0,1.0,1,1.0,1,1.0,1,0.11031558489717178,41
4368,5,14951,3266,11685,0,0,0,1.0,1,1.0,1,1.0,1,0.1036101755248675,41
4369,2,14953,3266,11687,0,0,0,1.0,1,1.0,1,1.0,1,0.12371899379612752,42
4370,1,14954,3266,11688,0,0,0,1.0,1,1.0,1,1.0,1,0.10359991630465366,42
4371,2,14956,3266,11690,0,0,0,1.0,1,1.0,1,1.0,1,0.1186570477943139,43
4372,3,14959,3268,11691,0,0,0,1.0,1,1.0,1,1.0,1,0.17271359494250757,43
4373,5,14964,3268,11696,0,0,0,1.0,1,1.0,1,1.0,1,0.18051096848516265,43
4374,3,14967,3268,11699,0,0,0,1.0,1,1.0,1,1.0,1,0.19089379022872552,44
4375,2,14969,3269,11700,0,0,0,1.0,1,1.0,1,1.0,1,0.19599495040270096,45
4376,6,14975,3269,11706,0,0,0,1.0,1,1.0,1,1.0,1,0.14657004785960437,46
4377,12,14987,3271,11716,0,0,0,1.0,1,1.0,1,1.0,1,0.19767156781244877,47
4378,12,14999,3272,11727,0,0,0,1.0,1,1.0,1,1.0,1,0.2198968496323809,49
4379,13,15012,3274,11738,0,0,0,1.0,1,1.0,1,1.0,1,0.18953997391840904,51
4380,13,15025,3274,11751,0,0,0,1.0,1,1.0,1,1.0,1,0.20425632850133194,50
4381,5,15030,3275,11755,0,0,0,1.0,1,1.0,1,1.0,1,0.14569251462469868,49
4382,1,15031,3276,11755,0,0,0,1.0,1,1.0,1,1.0,1,0.2107321484180963,47
4383,2,15033,3276,11757,0,0,0,1.0,1,1.0,1,1.0,1,0.20489536819854723,47
4384,2,15035,3277,11758,0,0,0,1.0,1,1.0,1,1.0,1,0.20842161939920378,44
4385,1,15036,3278,11758,0,0,0,1.0,1,1.0,1,1.0,1,0.22554642996336774,42
4386,3,15039,3279,11760,0,0,0,1.0,1,1.0,1,1.0,1,0.27184191788041584,41
4387,1,15040,3279,11761,0,0,0,1.0,1,1.0,1,1.0,1,0.2853945729903737,39
4388,1,15041,3280,11761,0,0,0,1.0,1,1.0,1,1.0,1,0.2802759260940068,39
4389,1,15042,3281,11761,0,0,0,1.0,1,1.0,1,1.0,1,0.29082992395261287,38
4390,1,15043,3281,11762,0,0,0,1.0,1,1.0,1,1.0,1,0.2227108785455881,38
4391,0,15043,3281,11762,0,0,0,1.0,1,1.0,1,1.0,1,0.2092059242986401,39
4392,0,15043,3281,11762,0,0,0,1.0,1,1.0,1,1.0,1,0.2092059242986401,39
4393,0,15043,3281,11762,0,0,0,1.0,1,1.0,1,1.0,1,0.2019592756927404,40
4394,0,15043,3281,11762,0,0,0,1.0,1,1.0,1,1.0,1,0.22099483327960376,39
4395,1,15044,3282,11762,0,0,0,1.0,1,1.0,1,1.0,1,0.21509209884409802,39
4396,8,15052,3283,11769,0,0,0,1.0,1,1.0,1,1.0,1,0.15495984618932704,39
4397,1,15053,3284,11769,0,0,0,1.0,1,1.0,1,1.0,1,0.188969058286365,38
4398,0,15053,3284,11769,0,0,0,1.0,1,1.0,1,1.0,1,0.1968396140054339,39
4399,2,15055,3284,11771,0,0,0,1.0,1,1.0,1,1.0,1,0.18675179923670748,42
4400,3,15058,3284,11774,0,0,0,1.0,1,1.0,1,1.0,1,0.17454534820189782,43
4401,0,15058,3284,11774,0,0,0,1.0,1,1.0,1,1.0,1,0.15753347437443752,44
4402,0,15058,3284,11774,0,0,0,1.0,1,1.0,1,1.0,1,0.15753347437443752,44
4403,0,15058,3284,11774,0,0,0,1.0,1,1.0,1,1.0,1,0.14143639259716365,45
4404,1,15059,3284,11775,0,0,0,1.0,1,1.0,1,1.0,1,0.14787996551345034,45
4405,3,15062,3284,11778,0,0,0,1.0,1,1.0,1,1.0,1,0.12919061489435943,46
4406,3,15065,3285,11780,0,0,0,1.0,1,1.0,1,1.0,1,0.18085136934810012,46
4407,3,15068,3285,11783,0,0,0,1.0,1,1.0,1,1.0,1,0.1752234129904305,46
4408,2,15070,3285,11785,0,0,0,1.0,1,1.0,1,1.0,1,0.17278471043097435,47
4409,4,15074,3285,11789,0,0,0,1.0,1,1.0,1,1.0,1,0.17238076521349552,48
4410,2,15076,3285,11791,0,0,0,1.0,1,1.0,1,1.0,1,0.17768525015477932,48
4411,3,15079,3285,11794,0,0,0,1.0,1,1.0,1,1.0,1,0.12584186683283105,50
4412,1,15080,3286,11794,0,0,0,1.0,1,1.0,1,1.0,1,0.13696056548656638,50
4413,1,15081,3286,11795,0,0,0,1.0,1,1.0,1,1.0,1,0.14897601409439945,50
4414,1,15082,3286,11796,0,0,0,1.0,1,1.0,1,1.0,1,0.14513077559200394,51
4415,0,15082,3286,11796,0,0,0,1.0,1,1.0,1,1.0,1,0.14513077559200394,51
4416,0,15082,3286,11796,0,0,0,1.0,1,1.0,1,1.0,1,0.14513077559200394,51
4417,2,15084,3288,11796,0,0,0,1.0,1,1.0,1,1.0,1,0.16717753459690693,51
4418,5,15089,3288,11801,0,0,0,1.0,1,1.0,1,1.0,1,0.16044164458624013,51
4419,2,15091,3288,11803,0,0,0,1.0,1,1.0,1,1.0,1,0.1609445287057609,50
4420,3,15094,3289,11805,0,0,0,1.0,1,1.0,1,1.0,1,0.1932578824593732,50
4421,1,15095,3289,11806,0,0,0,1.0,1,1.0,1,1.0,1,0.1690761227646875,52
4422,0,15095,3289,11806,0,0,0,1.0,1,1.0,1,1.0,1,0.18861930881032204,51
4423,4,15099,3290,11809,0,0,0,1.0,1,1.0,1,1.0,1,0.2142209336567472,51
4424,2,15101,3290,11811,0,0,0,1.0,1,1.0,1,1.0,1,0.20310568294325687,53
4425,4,15105,3290,11815,0,0,0,1.0,1,1.0,1,1.0,1,0.19577318657011958,54
4426,8,15113,3291,11822,0,0,0,1.0,1,1.0,1,1.0,1,0.09935720840741867,55
4427,1,15114,3291,11823,0,0,0,1.0,1,1.0,1,1.0,1,0.10270321396472973,55
4428,1,15115,3291,11824,0,0,0,1.0,1,1.0,1,1.0,1,0.08765347032790294,55
4429,3,15118,3291,11827,0,0,0,1.0,1,1.0,1,1.0,1,0.10717567093874383,56
4430,2,15120,3291,11829,0,0,0,1.0,1,1.0,1,1.0,1,0.11520432111645196,55
4431,1,15121,3291,11830,0,0,0,1.0,1,1.0,1,1.0,1,0.12521674757041604,56
4432,3,15124,3292,11832,0,0,0,1.0,1,1.0,1,1.0,1,0.11000379390183004,56
4433,2,15126,3292,11834,0,0,0,1.0,1,1.0,1,1.0,1,0.10095961834059207,57
4434,1,15127,3292,11835,0,0,0,1.0,1,1.0,1,1.0,1,0.10820085588446247,56
4435,3,15130,3292,11838,0,0,0,1.0,1,1.0,1,1.0,1,0.10035514998933211,56
4436,4,15134,3294,11840,0,0,0,1.0,1,1.0,1,1.0,1,0.13969549239115772,55
4437,1,15135,3294,11841,0,0,0,1.0,1,1.0,1,1.0,1,0.14855675901170926,54
4438,5,15140,3296,11844,0,0,0,1.0,1,1.0,1,1.0,1,0.19689919504680112,54
4439,5,15145,3297,11848,0,0,0,1.0,1,1.0,1,1.0,1,0.1913081023154291,55
4440,4,15149,3298,11851,0,0,0,1.0,1,1.0,1,1.0,1,0.20735142774923035,55
4441,8,15157,3301,11856,0,0,0,1.0,1,1.0,1,1.0,1,0.1068861499026523,59
4442,4,15161,3302,11859,0,0,0,1.0,1,1.0,1,1.0,1,0.1291085551109409,61
4443,3,15164,3303,11861,0,0,0,1.0,1,1.0,1,1.0,1,0.10665407315139437,60
4444,5,15169,3303,11866,0,0,0,1.0,1,1.0,1,1.0,1,0.11224294078182895,61
4445,3,15172,3303,11869,0,0,0,1.0,1,1.0,1,1.0,1,0.1289537876332866,61
4446,0,15172,3303,11869,0,0,0,1.0,1,1.0,1,1.0,1,0.14140222902525515,62
4447,0,15172,3303,11869,0,0,0,1.0,1,1.0,1,1.0,1,0.1318257780405566,63
4448,0,15172,3303,11869,0,0,0,1.0,1,1.0,1,1.0,1,0.1318257780405566,63
4449,1,15173,3304,11869,0,0,0,1.0,1,1.0,1,1.0,1,0.14574812245289678,63
4450,0,15173,3304,11869,0,0,0,1.0,1,1.0,1,1.0,1,0.1519190812445451,62
4451,0,15173,3304,11869,0,0,0,1.0,1,1.0,1,1.0,1,0.146850612089601,63
4452,3,15176,3304,11872,0,0,0,1.0,1,1.0,1,1.0,1,0.14507749843416035,64
4453,5,15181,3304,11877,0,0,0,1.0,1,1.0,1,1.0,1,0.1477520539159832,65
4454,4,15185,3304,11881,0,0,0,1.0,1,1.0,1,1.0,1,0.14801095987032928,66
4455,3,15188,3304,11884,0,0,0,1.0,1,1.0,1,1.0,1,0.12610426647395015,67
4456,5,15193,3304,11889,0,0,0,1.0,1,1.0,1,1.0,1,0.09209097921074921,67
4457,0,15193,3304,11889,0,0,0,1.0,1,1.0,1,1.0,1,0.09397884524470017,65
4458,5,15198,3305,11893,0,0,0,1.0,1,1.0,1,1.0,1,0.08962970202219576,65
4459,5,15203,3308,11895,0,0,0,1.0,1,1.0,1,1.0,1,0.11642023498387723,64
4460,2,15205,3308,11897,0,0,0,1.0,1,1.0,1,1.0,1,0.12655707531066168,63
4461,7,15212,3311,11901,0,0,0,1.0,1,1.0,1,1.0,1,0.17627359696934305,62
4462,3,15215,3314,11901,0,0,0,1.0,1,1.0,1,1.0,1,0.19374909927537093,61
4463,5,15220,3316,11904,0,0,0,1.0,1,1.0,1,1.0,1,0.2400077732488428,61
4464,3,15223,3318,11905,0,0,0,1.0,1,1.0,1,1.0,1,0.2461206784460143,58
4465,1,15224,3318,11906,0,0,0,1.0,1,1.0,1,1.0,1,0.2617374458441274,57
4466,3,15227,3320,11907,0,0,0,1.0,1,1.0,1,1.0,1,0.2712897974565519,54
4467,1,15228,3320,11908,0,0,0,1.0,1,1.0,1,1.0,1,0.21670902412380755,52
4468,3,15231,3322,11909,0,0,0,1.0,1,1.0,1,1.0,1,0.1934117850522225,52
4469,3,15234,3324,11910,0,0,0,1.0,1,1.0,1,1.0,1,0.17317377152617203,51
4470,1,15235,3324,11911,0,0,0,1.0,1,1.0,1,1.0,1,0.14568681478557607,51
4471,5,15240,3326,11914,0,0,0,1.0,1,1.0,1,1.0,1,0.08730635911022966,50
4472,2,15242,3327,11915,0,0,0,1.0,1,1.0,1,1.0,1,0.10582896572135968,48
4473,1,15243,3328,11915,0,0,0,1.0,1,1.0,1,1.0,1,0.15152487208371634,47
4474,3,15246,3329,11917,0,0,0,1.0,1,1.0,1,1.0,1,0.16055388018674235,49
4475,4,15250,3331,11919,0,0,0,1.0,1,1.0,1,1.0,1,0.24586746680830157,47
4476,4,15254,3333,11921,0,0,0,1.0,1,1.0,1,1.0,1,0.2523109151705976,49
4477,2,15256,3333,11923,0,0,0,1.0,1,1.0,1,1.0,1,0.2533654993647837,48
4478,1,15257,3333,11924,0,0,0,1.0,1,1.0,1,1.0,1,0.24556039031412655,48
4479,0,15257,3333,11924,0,0,0,1.0,1,1.0,1,1.0,1,0.24556039031412655,48
4480,2,15259,3333,11926,0,0,0,1.0,1,1.0,1,1.0,1,0.20788936672782163,49
4481,0,15259,3333,11926,0,0,0,1.0,1,1.0,1,1.0,1,0.22515741917655818,49
4482,1,15260,3333,11927,0,0,0,1.0,1,1.0,1,1.0,1,0.21803237706225467,49
4483,0,15260,3333,11927,0,0,0,1.0,1,1.0,1,1.0,1,0.21163190850373645,50
4484,6,15266,3335,11931,0,0,0,1.0,1,1.0,1,1.0,1,0.18827643349012088,52
4485,3,15269,3335,11934,0,0,0,1.0,1,1.0,1,1.0,1,0.18956771235982162,53
4486,7,15276,3336,11940,0,0,0,1.0,1,1.0,1,1.0,1,0.11869300074153831,55
4487,5,15281,3338,11943,0,0,0,1.0,1,1.0,1,1.0,1,0.127795685051015,55
4488,3,15284,3340,11944,0,0,0,1.0,1,1.0,1,1.0,1,0.16292540945149725,54
4489,7,15291,3340,11951,0,0,0,1.0,1,1.0,1,1.0,1,0.18675494533367867,53
4490,4,15295,3340,11955,0,0,0,1.0,1,1.0,1,1.0,1,0.18078228612958297,53
4491,4,15299,3340,11959,0,0,0,1.0,1,1.0,1,1.0,1,0.1970803759170786,52
4492,8,15307,3341,11966,0,0,0,1.0,1,1.0,1,1.0,1,0.20114410987848527,52
4493,6,15313,3341,11972,0,0,0,1.0,1,1.0,1,1.0,1,0.22165248053953038,52
4494,6,15319,3341,11978,0,0,0,1.0,1,1.0,1,1.0,1,0.22297542376535745,53
4495,11,15330,3344,11986,0,0,0,1.0,1,1.0,1,1.0,1,0.25611938637451764,50
4496,6,15336,3346,11990,0,0,0,1.0,1,1.0,1,1.0,1,0.2148686075114243,51
4497,3,15339,3346,11993,0,0,0,1.0,1,1.0,1,1.0,1,0.2173020184160888,50
4498,8,15347,3347,12000,0,0,0,1.0,1,1.0,1,1.0,1,0.253730962467158,49
4499,5,15352,3347,12005,0,0,0,1.0,1,1.0,1,1.0,1,0.24490004603192755,48
4500,4,15356,3347,12009,0,0,0,1.0,1,1.0,1,1.0,1,0.28865587979258345,48
4501,7,15363,3348,12015,0,0,0,1.0,1,1.0,1,1.0,1,0.1515455904333981,48
4502,1,15364,3348,12016,0,0,0,1.0,1,1.0,1,1.0,1,0.14224624127553298,49
4503,5,15369,3350,12019,0,0,0,1.0,1,1.0,1,1.0,1,0.1670720215050167,49
4504,3,15372,3350,12022,0,0,0,1.0,1,1.0,1,1.0,1,0.1836760247397467,45
4505,5,15377,3351,12026,0,0,0,1.0,1,1.0,1,1.0,1,0.17608958264556115,46
4506,2,15379,3351,12028,0,0,0,1.0,1,1.0,1,1.0,1,0.21826105981346378,45
4507,9,15388,3352,12036,0,0,0,1.0,1,1.0,1,1.0,1,0.25894217392428626,45
4508,5,15393,3355,12038,0,0,0,1.0,1,1.0,1,1.0,1,0.1981811428875736,43
4509,1,15394,3356,12038,0,0,0,1.0,1,1.0,1,1.0,1,0.20031860663192233,41
4510,2,15396,3357,12039,0,0,0,1.0,1,1.0,1,1.0,1,0.21909701392290826,42
4511,3,15399,3358,12041,0,0,0,1.0,1,1.0,1,1.0,1,0.21173149499694072,41
4512,5,15404,3358,12046,0,0,0,1.0,1,1.0,1,1.0,1,0.21682354082126673,41
4513,2,15406,3358,12048,0,0,0,1.0,1,1.0,1,1.0,1,0.26243097692181605,41
4514,7,15413,3360,12053,0,0,0,1.0,1,1.0,1,1.0,1,0.24774408228101152,42
4515,3,15416,3360,12056,0,0,0,1.0,1,1.0,1,1.0,1,0.23572524643357465,41
4516,5,15421,3361,12060,0,0,0,1.0,1,1.0,1,1.0,1,0.1787564236980194,42
4517,4,15425,3362,12063,0,0,0,1.0,1,1.0,1,1.0,1,0.18964081974640196,43
4518,1,15426,3362,12064,0,0,0,1.0,1,1.0,1,1.0,1,0.19449320824076402,42
4519,2,15428,3364,12064,0,0,0,1.0,1,1.0,1,1.0,1,0.2388527137175919,42
4520,5,15433,3364,12069,0,0,0,1.0,1,1.0,1,1.0,1,0.2697158511634818,42
4521,5,15438,3364,12074,0,0,0,1.0,1,1.0,1,1.0,1,0.21534294272209897,42
4522,3,15441,3366,12075,0,0,0,1.0,1,1.0,1,1.0,1,0.1911235829068915,42
4523,3,15444,3366,12078,0,0,0,1.0,1,1.0,1,1.0,1,0.20244427697499295,42
4524,6,15450,3369,12081,0,0,0,1.0,1,1.0,1,1.0,1,0.23189904879431172,43
4525,5,15455,3369,12086,0,0,0,1.0,1,1.0,1,1.0,1,0.1638652656012168,46
4526,9,15464,3371,12093,0,0,0,1.0,1,1.0,1,1.0,1,0.24579146130464086,46
4527,7,15471,3371,12100,0,0,0,1.0,1,1.0,1,1.0,1,0.1539656422477498,47
4528,12,15483,3371,12112,0,0,0,1.0,1,1.0,1,1.0,1,0.17548576233804572,49
4529,9,15492,3371,12121,0,0,0,1.0,1,1.0,1,1.0,1,0.18855860169911096,50
4530,6,15498,3371,12127,0,0,0,1.0,1,1.0,1,1.0,1,0.2405338794106181,51
4531,9,15507,3371,12136,0,0,0,1.0,1,1.0,1,1.0,1,0.09828007316357983,51
4532,1,15508,3371,12137,0,0,0,1.0,1,1.0,1,1.0,1,0.10855669464611559,51
4533,3,15511,3371,12140,0,0,0,1.0,1,1.0,1,1.0,1,0.16163965908206926,50
4534,7,15518,3371,12147,0,0,0,1.0,1,1.0,1,1.0,1,0.143980406913858,51
4535,4,15522,3372,12150,0,0,0,1.0,1,1.0,1,1.0,1,0.11144717467953542,50
4536,1,15523,3372,12151,0,0,0,1.0,1,1.0,1,1.0,1,0.15497193974243587,48
4537,1,15524,3372,12152,0,0,0,1.0,1,1.0,1,1.0,1,0.13455398034673838,49
4538,4,15528,3372,12156,0,0,0,1.0,1,1.0,1,1.0,1,0.1543774555975411,48
4539,8,15536,3373,12163,0,0,0,1.0,1,1.0,1,1.0,1,0.1792404874259763,50
4540,3,15539,3373,12166,0,0,0,1.0,1,1.0,1,1.0,1,0.21442912542482553,49
4541,7,15546,3374,12172,0,0,0,1.0,1,1.0,1,1.0,1,0.20580375767215556,49
4542,6,15552,3375,12177,0,0,0,1.0,1,1.0,1,1.0,1,0.24473171597953067,47
4543,4,15556,3375,12181,0,0,0,1.0,1,1.0,1,1.0,1,0.216693446885076,45
4544,4,15560,3376,12184,0,0,0,1.0,1,1.0,1,1.0,1,0.2496890476736345,45
4545,3,15563,3377,12186,0,0,0,1.0,1,1.0,1,1.0,1,0.23901525561033238,43
4546,6,15569,3379,12190,0,0,0,1.0,1,1.0,1,1.0,1,0.20765837661169848,43
4547,1,15570,3379,12191,0,0,0,1.0,1,1.0,1,1.0,1,0.1678095126399842,41
4548,2,15572,3380,12192,0,0,0,1.0,1,1.0,1,1.0,1,0.14743531707124918,42
4549,0,15572,3380,12192,0,0,0,1.0,1,1.0,1,1.0,1,0.1665390614113817,41
4550,3,15575,3382,12193,0,0,0,1.0,1,1.0,1,1.0,1,0.17023819343441998,41
4551,1,15576,3383,12193,0,0,0,1.0,1,1.0,1,1.0,1,0.19192750175370346,39
4552,0,15576,3383,12193,0,0,0,1.0,1,1.0,1,1.0,1,0.21815177873799974,38
4553,1,15577,3384,12193,0,0,0,1.0,1,1.0,1,1.0,1,0.19639496957857286,39
4554,3,15580,3387,12193,0,0,0,1.0,1,1.0,1,1.0,1,0.2489712186890834,38
4555,3,15583,3388,12195,0,0,0,1.0,1,1.0,1,1.0,1,0.21278045241706936,37
4556,0,15583,3388,12195,0,0,0,1.0,1,1.0,1,1.0,1,0.2524531542773272,36
4557,0,15583,3388,12195,0,0,0,1.0,1,1.0,1,1.0,1,0.1965989203669281,38
4558,1,15584,3388,12196,0,0,0,1.0,1,1.0,1,1.0,1,0.21529705993070752,39
4559,4,15588,3391,12197,0,0,0,1.0,1,1.0,1,1.0,1,0.2636128644409846,38
4560,1,15589,3391,12198,0,0,0,1.0,1,1.0,1,1.0,1,0.22674063597793578,41
4561,3,15592,3391,12201,0,0,0,1.0,1,1.0,1,1.0,1,0.15226117075188011,41
4562,1,15593,3391,12202,0,0,0,1.0,1,1.0,1,1.0,1,0.1485829450712715,43
4563,0,15593,3391,12202,0,0,0,1.0,1,1.0,1,1.0,1,0.16791856767947227,42
4564,1,15594,3391,12203,0,0,0,1.0,1,1.0,1,1.0,1,0.169802887790923,43
4565,2,15596,3391,12205,0,0,0,1.0,1,1.0,1,1.0,1,0.16747482719284776,44
4566,3,15599,3391,12208,0,0,0,1.0,1,1.0,1,1.0,1,0.13964336009121325,45
4567,6,15605,3393,12212,0,0,0,1.0,1,1.0,1,1.0,1,0.13105485191858726,47
4568,3,15608,3393,12215,0,0,0,1.0,1,1.0,1,1.0,1,0.14927551991954988,47
4569,7,15615,3395,12220,0,0,0,1.0,1,1.0,1,1.0,1,0.13647246540532051,49
4570,4,15619,3395,12224,0,0,0,1.0,1,1.0,1,1.0,1,0.12519071321348568,49
4571,4,15623,3397,12226,0,0,0,1.0,1,1.0,1,1.0,1,0.19409171292852465,48
4572,6,15629,3397,12232,0,0,0,1.0,1,1.0,1,1.0,1,0.2004919740008432,48
4573,2,15631,3397,12234,0,0,0,1.0,1,1.0,1,1.0,1,0.17951451885453587,48
4574,4,15635,3397,12238,0,0,0,1.0,1,1.0,1,1.0,1,0.20135380019555338,50
4575,5,15640,3399,12241,0,0,0,1.0,1,1.0,1,1.0,1,0.19046555935684434,51
4576,2,15642,3399,12243,0,0,0,1.0,1,1.0,1,1.0,1,0.1524757099602806,48
4577,0,15642,3399,12243,0,0,0,1.0,1,1.0,1,1.0,1,0.1581499853252899,47
4578,1,15643,3399,12244,0,0,0,1.0,1,1.0,1,1.0,1,0.1575234055312309,46
4579,2,15645,3399,12246,0,0,0,1.0,1,1.0,1,1.0,1,0.1704737424202545,46
4580,1,15646,3399,12247,0,0,0,1.0,1,1.0,1,1.0,1,0.15846453844117883,47
4581,0,15646,3399,12247,0,0,0,1.0,1,1.0,1,1.0,1,0.15846453844117883,47
4582,1,15647,3399,12248,0,0,0,1.0,1,1.0,1,1.0,1,0.14959462827722267,48
4583,0,15647,3399,12248,0,0,0,1.0,1,1.0,1,1.0,1,0.14959462827722267,48
4584,0,15647,3399,12248,0,0,0,1.0,1,1.0,1,1.0,1,0.16705257057320078,50
4585,1,15648,3400,12248,0,0,0,1.0,1,1.0,1,1.0,1,0.17411410761533877,50
4586,0,15648,3400,12248,0,0,0,1.0,1,1.0,1,1.0,1,0.17411410761533877,50
4587,0,15648,3400,12248,0,0,0,1.0,1,1.0,1,1.0,1,0.17411410761533877,50
4588,0,15648,3400,12248,0,0,0,1.0,1,1.0,1,1.0,1,0.17411410761533877,50
4589,2,15650,3401,12249,0,0,0,1.0,1,1.0,1,1.0,1,0.19474287841557913,52
4590,0,15650,3401,12249,0,0,0,1.0,1,1.0,1,1.0,1,0.19474287841557913,52
4591,2,15652,3401,12251,0,0,0,1.0,1,1.0,1,1.0,1,0.19147709675207059,53
4592,2,15654,3401,12253,0,0,0,1.0,1,1.0,1,1.0,1,0.17802447734778368,54
4593,3,15657,3403,12254,0,0,0,1.0,1,1.0,1,1.0,1,0.1610767429142826,56
4594,2,15659,3403,12256,0,0,0,1.0,1,1.0,1,1.0,1,0.1400600539018604,57
4595,0,15659,3403,12256,0,0,0,1.0,1,1.0,1,1.0,1,0.13133139164667937,56
4596,2,15661,3403,12258,0,0,0,1.0,1,1.0,1,1.0,1,0.11953389572489137,56
4597,1,15662,3404,12258,0,0,0,1.0,1,1.0,1,1.0,1,0.12263229492704927,56
4598,6,15668,3407,12261,0,0,0,1.0,1,1.0,1,1.0,1,0.16881507559632186,57
4599,2,15670,3407,12263,0,0,0,1.0,1,1.0,1,1.0,1,0.17121391196401606,59
4600,5,15675,3407,12268,0,0,0,1.0,1,1.0,1,1.0,1,0.16718714214430846,60
4601,6,15681,3409,12272,0,0,0,1.0,1,1.0,1,1.0,1,0.22017257164156007,60
4602,4,15685,3409,12276,0,0,0,1.0,1,1.0,1,1.0,1,0.17366028867727948,62
4603,4,15689,3409,12280,0,0,0,1.0,1,1.0,1,1.0,1,0.1825276735088621,62
4604,4,15693,3409,12284,0,0,0,1.0,1,1.0,1,1.0,1,0.18373154556623345,63
4605,4,15697,3409,12288,0,0,0,1.0,1,1.0,1,1.0,1,0.15278533956400417,63
4606,2,15699,3409,12290,0,0,0,1.0,1,1.0,1,1.0,1,0.142807544531666,64
4607,3,15702,3410,12292,0,0,0,1.0,1,1.0,1,1.0,1,0.14536823851920122,65
4608,1,15703,3410,12293,0,0,0,1.0,1,1.0,1,1.0,1,0.15142715059540268,66
4609,4,15707,3411,12296,0,0,0,1.0,1,1.0,1,1.0,1,0.16392932720142328,65
4610,0,15707,3411,12296,0,0,0,1.0,1,1.0,1,1.0,1,0.15927280583439554,63
4611,2,15709,3411,12298,0,0,0,1.0,1,1.0,1,1.0,1,0.1422995364360808,64
4612,0,15709,3411,12298,0,0,0,1.0,1,1.0,1,1.0,1,0.1471022386961244,62
4613,2,15711,3413,12298,0,0,0,1.0,1,1.0,1,1.0,1,0.14614830524273187,63
4614,2,15713,3415,12298,0,0,0,1.0,1,1.0,1,1.0,1,0.1580835883406752,61
4615,1,15714,3416,12298,0,0,0,1.0,1,1.0,1,1.0,1,0.194124097304749,59
4616,1,15715,3417,12298,0,0,0,1.0,1,1.0,1,1.0,1,0.19428535665843297,58
4617,0,15715,3417,12298,0,0,0,1.0,1,1.0,1,1.0,1,0.21363930392433345,58
4618,1,15716,3417,12299,0,0,0,1.0,1,1.0,1,1.0,1,0.2103841941150809,57
4619,2,15718,3418,12300,0,0,0,1.0,1,1.0,1,1.0,1,0.242946595999572,57
4620,0,15718,3418,12300,0,0,0,1.0,1,1.0,1,1.0,1,0.242946595999572,57
4621,7,15725,3419,12306,0,0,0,1.0,1,1.0,1,1.0,1,0.1610846355610532,59
4622,4,15729,3419,12310,0,0,0,1.0,1,1.0,1,1.0,1,0.15270839007783313,60
4623,3,15732,3419,12313,0,0,0,1.0,1,1.0,1,1.0,1,0.16255431433213074,59
4624,4,15736,3421,12315,0,0,0,1.0,1,1.0,1,1.0,1,0.15342892122535212,59
4625,3,15739,3422,12317,0,0,0,1.0,1,1.0,1,1.0,1,0.15718937641861327,57
4626,4,15743,3426,12317,0,0,0,1.0,1,1.0,1,1.0,1,0.22063329901289297,56
4627,3,15746,3427,12319,0,0,0,1.0,1,1.0,1,1.0,1,0.21830692224661924,56
4628,4,15750,3427,12323,0,0,0,1.0,1,1.0,1,1.0,1,0.2344284192785793,56
4629,1,15751,3427,12324,0,0,0,1.0,1,1.0,1,1.0,1,0.25161967775655647,56
4630,2,15753,3428,12325,0,0,0,1.0,1,1.0,1,1.0,1,0.24222293721947533,57
4631,3,15756,3429,12327,0,0,0,1.0,1,1.0,1,1.0,1,0.25982086684810207,56
4632,1,15757,3430,12327,0,0,0,1.0,1,1.0,1,1.0,1,0.30053615465129024,57
4633,2,15759,3430,12329,0,0,0,1.0,1,1.0,1,1.0,1,0.2852395625168771,58
4634,0,15759,3430,12329,0,0,0,1.0,1,1.0,1,1.0,1,0.2852395625168771,58
4635,4,15763,3430,12333,0,0,0,1.0,1,1.0,1,1.0,1,0.23238463790364997,59
4636,7,15770,3430,12340,0,0,0,1.0,1,1.0,1,1.0,1,0.15952589253758417,60
4637,1,15771,3430,12341,0,0,0,1.0,1,1.0,1,1.0,1,0.14836985207127454,60
4638,1,15772,3430,12342,0,0,0,1.0,1,1.0,1,1.0,1,0.15554424280126067,61
4639,4,15776,3430,12346,0,0,0,1.0,1,1.0,1,1.0,1,0.1275049549337337,62
4640,3,15779,3430,12349,0,0,0,1.0,1,1.0,1,1.0,1,0.1437901947370443,63
4641,3,15782,3432,12350,0,0,0,1.0,1,1.0,1,1.0,1,0.1542276801760293,63
4642,2,15784,3432,12352,0,0,0,1.0,1,1.0,1,1.0,1,0.149277926947793,62
4643,3,15787,3434,12353,0,0,0,1.0,1,1.0,1,1.0,1,0.17316083471933183,63
4644,4,15791,3435,12356,0,0,0,1.0,1,1.0,1,1.0,1,0.16166953274577772,62
4645,5,15796,3436,12360,0,0,0,1.0,1,1.0,1,1.0,1,0.16692053687170944,63
4646,6,15802,3437,12365,0,0,0,1.0,1,1.0,1,1.0,1,0.1747487508410853,63
4647,6,15808,3439,12369,0,0,0,1.0,1,1.0,1,1.0,1,0.17877965787407635,62
4648,6,15814,3441,12373,0,0,0,1.0,1,1.0,1,1.0,1,0.22778298981594755,63
4649,5,15819,3441,12378,0,0,0,1.0,1,1.0,1,1.0,1,0.19874256935608955,61
4650,7,15826,3442,12384,0,0,0,1.0,1,1.0,1,1.0,1,0.1523903044400256,63
4651,7,15833,3443,12390,0,0,0,1.0,1,1.0,1,1.0,1,0.11863380577859127,62
4652,0,15833,3443,12390,0,0,0,1.0,1,1.0,1,1.0,1,0.13526760044661798,59
4653,3,15836,3445,12391,0,0,0,1.0,1,1.0,1,1.0,1,0.15960091372874674,60
4654,2,15838,3446,12392,0,0,0,1.0,1,1.0,1,1.0,1,0.1770328962518348,60
4655,1,15839,3446,12393,0,0,0,1.0,1,1.0,1,1.0,1,0.16180738738161193,60
4656,7,15846,3448,12398,0,0,0,1.0,1,1.0,1,1.0,1,0.21709302981080394,61
4657,4,15850,3448,12402,0,0,0,1.0,1,1.0,1,1.0,1,0.20931531640042142,62
4658,5,15855,3449,12406,0,0,0,1.0,1,1.0,1,1.0,1,0.20516777823464794,62
4659,4,15859,3450,12409,0,0,0,1.0,1,1.0,1,1.0,1,0.23475001182424407,61
4660,7,15866,3451,12415,0,0,0,1.0,1,1.0,1,1.0,1,0.258109034956678,61
4661,6,15872,3451,12421,0,0,0,1.0,1,1.0,1,1.0,1,0.2709870628099253,61
4662,6,15878,3452,12426,0,0,0,1.0,1,1.0,1,1.0,1,0.2627866166503144,62
4663,5,15883,3452,12431,0,0,0,1.0,1,1.0,1,1.0,1,0.19980678053825204,61
4664,3,15886,3453,12433,0,0,0,1.0,1,1.0,1,1.0,1,0.20923532317940013,62
4665,5,15891,3455,12436,0,0,0,1.0,1,1.0,1,1.0,1,0.20960423777642334,61
4666,9,15900,3456,12444,0,0,0,1.0,1,1.0,1,1.0,1,0.11760934227652182,61
4667,1,15901,3456,12445,0,0,0,1.0,1,1.0,1,1.0,1,0.1378029076603044,59
4668,2,15903,3458,12445,0,0,0,1.0,1,1.0,1,1.0,1,0.1264826891380532,59
4669,0,15903,3458,12445,0,0,0,1.0,1,1.0,1,1.0,1,0.14527069525175948,58
4670,3,15906,3461,12445,0,0,0,1.0,1,1.0,1,1.0,1,0.1480297997779751,57
4671,0,15906,3461,12445,0,0,0,1.0,1,1.0,1,1.0,1,0.1525634687011083,55
4672,3,15909,3462,12447,0,0,0,1.0,1,1.0,1,1.0,1,0.16034010380584499,56
4673,2,15911,3463,12448,0,0,0,1.0,1,1.0,1,1.0,1,0.12854896124880122,58
4674,5,15916,3465,12451,0,0,0,1.0,1,1.0,1,1.0,1,0.15308329301953477,58
4675,3,15919,3465,12454,0,0,0,1.0,1,1.0,1,1.0,1,0.17527356865416327,57
4676,2,15921,3466,12455,0,0,0,1.0,1,1.0,1,1.0,1,0.1959690886641852,58
4677,1,15922,3466,12456,0,0,0,1.0,1,1.0,1,1.0,1,0.19918931451979716,57
4678,2,15924,3468,12456,0,0,0,1.0,1,1.0,1,1.0,1,0.19351889851439696,57
4679,0,15924,3468,12456,0,0,0,1.0,1,1.0,1,1.0,1,0.19351889851439696,57
4680,1,15925,3469,12456,0,0,0,1.0,1,1.0,1,1.0,1,0.18651079637951917,59
4681,6,15931,3470,12461,0,0,0,1.0,1,1.0,1,1.0,1,0.14736714993544556,60
4682,2,15933,3471,12462,0,0,0,1.0,1,1.0,1,1.0,1,0.17543546950746852,60
4683,4,15937,3472,12465,0,0,0,1.0,1,1.0,1,1.0,1,0.18003559806023708,60
4684,5,15942,3474,12468,0,0,0,1.0,1,1.0,1,1.0,1,0.1925108362405932,60
4685,5,15947,3476,12471,0,0,0,1.0,1,1.0,1,1.0,1,0.2092955155681089,59
4686,11,15958,3479,12479,0,0,0,1.0,1,1.0,1,1.0,1,0.24406423540338393,60
4687,6,15964,3480,12484,0,0,0,1.0,1,1.0,1,1.0,1,0.2693456125293887,59
4688,5,15969,3481,12488,0,0,0,1.0,1,1.0,1,1.0,1,0.24636054335161148,59
4689,4,15973,3481,12492,0,0,0,1.0,1,1.0,1,1.0,1,0.24782965741638052,59
4690,5,15978,3481,12497,0,0,0,1.0,1,1.0,1,1.0,1,0.2306694326106893,58
4691,3,15981,3482,12499,0,0,0,1.0,1,1.0,1,1.0,1,0.22583547180670102,57
4692,3,15984,3482,12502,0,0,0,1.0,1,1.0,1,1.0,1,0.2119621299446765,58
4693,1,15985,3482,12503,0,0,0,1.0,1,1.0,1,1.0,1,0.2248645143868256,57
4694,3,15988,3483,12505,0,0,0,1.0,1,1.0,1,1.0,1,0.24455227737361415,57
4695,3,15991,3484,12507,0,0,0,1.0,1,1.0,1,1.0,1,0.2539087814301217,56
4696,6,15997,3485,12512,0,0,0,1.0,1,1.0,1,1.0,1,0.20157100695499855,57
4697,2,15999,3485,12514,0,0,0,1.0,1,1.0,1,1.0,1,0.1895407024130321,58
4698,2,16001,3485,12516,0,0,0,1.0,1,1.0,1,1.0,1,0.15638602753430786,59
4699,3,16004,3486,12518,0,0,0,1.0,1,1.0,1,1.0,1,0.2005040781389786,58
4700,2,16006,3486,12520,0,0,0,1.0,1,1.0,1,1.0,1,0.15095650780903855,59
4701,1,16007,3486,12521,0,0,0,1.0,1,1.0,1,1.0,1,0.16177276124096326,60
4702,3,16010,3487,12523,0,0,0,1.0,1,1.0,1,1.0,1,0.14946126421886835,61
4703,5,16015,3489,12526,0,0,0,1.0,1,1.0,1,1.0,1,0.1251132415479572,59
4704,0,16015,3489,12526,0,0,0,1.0,1,1.0,1,1.0,1,0.1137787823538178,58
4705,2,16017,3490,12527,0,0,0,1.0,1,1.0,1,1.0,1,0.13661727956627132,58
4706,6,16023,3493,12530,0,0,0,1.0,1,1.0,1,1.0,1,0.16107676661110057,60
4707,3,16026,3494,12532,0,0,0,1.0,1,1.0,1,1.0,1,0.19707604196650363,57
4708,7,16033,3496,12537,0,0,0,1.0,1,1.0,1,1.0,1,0.22242291577164702,57
4709,4,16037,3498,12539,0,0,0,1.0,1,1.0,1,1.0,1,0.2080080033690793,55
4710,2,16039,3499,12540,0,0,0,1.0,1,1.0,1,1.0,1,0.2416700022056908,53
4711,8,16047,3501,12546,0,0,0,1.0,1,1.0,1,1.0,1,0.13887015333973723,52
4712,4,16051,3504,12547,0,0,0,1.0,1,1.0,1,1.0,1,0.1711899458487608,52
4713,4,16055,3505,12550,0,0,0,1.0,1,1.0,1,1.0,1,0.19288050105142326,51
4714,2,16057,3505,12552,0,0,0,1.0,1,1.0,1,1.0,1,0.1635464924384933,50
4715,4,16061,3506,12555,0,0,0,1.0,1,1.0,1,1.0,1,0.17861946231978165,50
4716,1,16062,3507,12555,0,0,0,1.0,1,1.0,1,1.0,1,0.18386927614844117,49
4717,2,16064,3508,12556,0,0,0,1.0,1,1.0,1,1.0,1,0.19694268610748666,49
4718,1,16065,3508,12557,0,0,0,1.0,1,1.0,1,1.0,1,0.19782746515853067,50
4719,1,16066,3508,12558,0,0,0,1.0,1,1.0,1,1.0,1,0.18630789512610116,49
4720,0,16066,3508,12558,0,0,0,1.0,1,1.0,1,1.0,1,0.18630789512610116,49
4721,1,16067,3509,12558,0,0,0,1.0,1,1.0,1,1.0,1,0.16573140385376167,50
4722,8,16075,3510,12565,0,0,0,1.0,1,1.0,1,1.0,1,0.18436137337332523,51
4723,3,16078,3510,12568,0,0,0,1.0,1,1.0,1,1.0,1,0.1566696111215465,50
4724,2,16080,3510,12570,0,0,0,1.0,1,1.0,1,1.0,1,0.14152841664234997,50
4725,1,16081,3510,12571,0,0,0,1.0,1,1.0,1,1.0,1,0.1607612399639661,52
4726,3,16084,3511,12573,0,0,0,1.0,1,1.0,1,1.0,1,0.13513031422296248,51
4727,0,16084,3511,12573,0,0,0,1.0,1,1.0,1,1.0,1,0.14973786645638856,52
4728,0,16084,3511,12573,0,0,0,1.0,1,1.0,1,1.0,1,0.14973786645638856,52
4729,5,16089,3513,12576,0,0,0,1.0,1,1.0,1,1.0,1,0.18233558408560732,52
4730,4,16093,3513,12580,0,0,0,1.0,1,1.0,1,1.0,1,0.20050481459208477,50
4731,6,16099,3514,12585,0,0,0,1.0,1,1.0,1,1.0,1,0.21059485903440553,51
4732,5,16104,3516,12588,0,0,0,1.0,1,1.0,1,1.0,1,0.23734019998516723,52
4733,6,16110,3516,12594,0,0,0,1.0,1,1.0,1,1.0,1,0.23588799616886244,53
4734,7,16117,3517,12600,0,0,0,1.0,1,1.0,1,1.0,1,0.2651493958997811,53
4735,8,16125,3518,12607,0,0,0,1.0,1,1.0,1,1.0,1,0.2982187949709807,53
4736,12,16137,3519,12618,0,0,0,1.0,1,1.0,1,1.0,1,0.3232989935398252,55
4737,12,16149,3519,12630,0,0,0,1.0,1,1.0,1,1.0,1,0.3054464579433621,57
4738,8,16157,3519,12638,0,0,0,1.0,1,1.0,1,1.0,1,0.2995181925705675,57
4739,8,16165,3519,12646,0,0,0,1.0,1,1.0,1,1.0,1,0.3007999261203554,57
4740,9,16174,3519,12655,0,0,0,1.0,1,1.0,1,1.0,1,0.28375307204444095,57
4741,11,16185,3519,12666,0,0,0,1.0,1,1.0,1,1.0,1,0.19818399429566141,58
4742,2,16187,3520,12667,0,0,0,1.0,1,1.0,1,1.0,1,0.19747176509662795,58
4743,4,16191,3520,12671,0,0,0,1.0,1,1.0,1,1.0,1,0.13672094901586532,56
4744,4,16195,3522,12673,0,0,0,1.0,1,1.0,1,1.0,1,0.14643277606589655,57
4745,3,16198,3522,12676,0,0,0,1.0,1,1.0,1,1.0,1,0.11648574029065119,56
4746,3,16201,3522,12679,0,0,0,1.0,1,1.0,1,1.0,1,0.1362004304658076,56
4747,3,16204,3523,12681,0,0,0,1.0,1,1.0,1,1.0,1,0.09920488893155137,55
4748,4,16208,3524,12684,0,0,0,1.0,1,1.0,1,1.0,1,0.10176552639443616,55
4749,5,16213,3526,12687,0,0,0,1.0,1,1.0,1,1.0,1,0.06840884573593994,54
4750,2,16215,3527,12688,0,0,0,1.0,1,1.0,1,1.0,1,0.11115966880427752,53
4751,4,16219,3529,12690,0,0,0,1.0,1,1.0,1,1.0,1,0.16098383657594123,53
4752,2,16221,3529,12692,0,0,0,1.0,1,1.0,1,1.0,1,0.12842296852336915,53
4753,6,16227,3530,12697,0,0,0,1.0,1,1.0,1,1.0,1,0.15083952725395527,52
4754,2,16229,3530,12699,0,0,0,1.0,1,1.0,1,1.0,1,0.16474124413777425,52
4755,3,16232,3530,12702,0,0,0,1.0,1,1.0,1,1.0,1,0.15537130365708426,51
4756,8,16240,3531,12709,0,0,0,1.0,1,1.0,1,1.0,1,0.08778489586127552,52
4757,3,16243,3531,12712,0,0,0,1.0,1,1.0,1,1.0,1,0.09395683527840197,51
4758,2,16245,3531,12714,0,0,0,1.0,1,1.0,1,1.0,1,0.0939088335056651,51
4759,2,16247,3532,12715,0,0,0,1.0,1,1.0,1,1.0,1,0.10551185281897964,51
4760,2,16249,3532,12717,0,0,0,1.0,1,1.0,1,1.0,1,0.10847350147038477,52
4761,6,16255,3535,12720,0,0,0,1.0,1,1.0,1,1.0,1,0.18684511416785043,50
4762,7,16262,3537,12725,0,0,0,1.0,1,1.0,1,1.0,1,0.2579424775342612,51
4763,5,16267,3537,12730,0,0,0,1.0,1,1.0,1,1.0,1,0.22689373574842256,51
4764,5,16272,3538,12734,0,0,0,1.0,1,1.0,1,1.0,1,0.1810764833963689,53
4765,7,16279,3539,12740,0,0,0,1.0,1,1.0,1,1.0,1,0.16845864044640477,53
4766,5,16284,3539,12745,0,0,0,1.0,1,1.0,1,1.0,1,0.17644288239032466,55
4767,8,16292,3540,12752,0,0,0,1.0,1,1.0,1,1.0,1,0.17769342697524781,56
4768,5,16297,3540,12757,0,0,0,1.0,1,1.0,1,1.0,1,0.16387975085267498,56
4769,11,16308,3540,12768,0,0,0,1.0,1,1.0,1,1.0,1,0.15866609136833487,56
4770,6,16314,3540,12774,0,0,0,1.0,1,1.0,1,1.0,1,0.1796887511723058,56
4771,7,16321,3540,12781,0,0,0,1.0,1,1.0,1,1.0,1,0.09123424509097937,55
4772,2,16323,3540,12783,0,0,0,1.0,1,1.0,1,1.0,1,0.11169630167021033,56
4773,3,16326,3540,12786,0,0,0,1.0,1,1.0,1,1.0,1,0.10103736036397239,56
4774,2,16328,3540,12788,0,0,0,1.0,1,1.0,1,1.0,1,0.07553217071169184,58
4775,3,16331,3541,12790,0,0,0,1.0,1,1.0,1,1.0,1,0.06857481775393681,59
4776,1,16332,3541,12791,0,0,0,1.0,1,1.0,1,1.0,1,0.062471622964456706,59
4777,2,16334,3541,12793,0,0,0,1.0,1,1.0,1,1.0,1,0.0733537397196958,60
4778,3,16337,3541,12796,0,0,0,1.0,1,1.0,1,1.0,1,0.06285332354060187,60
4779,7,16344,3541,12803,0,0,0,1.0,1,1.0,1,1.0,1,0.042231121688141186,61
4780,6,16350,3541,12809,0,0,0,1.0,1,1.0,1,1.0,1,0.07581931055227342,63
4781,3,16353,3542,12811,0,0,0,1.0,1,1.0,1,1.0,1,0.10046508297388963,62
4782,3,16356,3543,12813,0,0,0,1.0,1,1.0,1,1.0,1,0.13605106312674078,63
4783,4,16360,3544,12816,0,0,0,1.0,1,1.0,1,1.0,1,0.11704298846415064,62
4784,9,16369,3547,12822,0,0,0,1.0,1,1.0,1,1.0,1,0.09908594783526023,62
4785,11,16380,3548,12832,0,0,0,1.0,1,1.0,1,1.0,1,0.11255530295165075,62
4786,7,16387,3550,12837,0,0,0,1.0,1,1.0,1,1.0,1,0.11420466443549052,63
4787,7,16394,3552,12842,0,0,0,1.0,1,1.0,1,1.0,1,0.1606860812407832,62
4788,10,16404,3555,12849,0,0,0,1.0,1,1.0,1,1.0,1,0.17697735136021298,62
4789,5,16409,3555,12854,0,0,0,1.0,1,1.0,1,1.0,1,0.12053587095632212,60
4790,6,16415,3556,12859,0,0,0,1.0,1,1.0,1,1.0,1,0.15695732303320953,61
4791,7,16422,3558,12864,0,0,0,1.0,1,1.0,1,1.0,1,0.1428834773435108,60
4792,9,16431,3560,12871,0,0,0,1.0,1,1.0,1,1.0,1,0.12748360812990225,60
4793,6,16437,3562,12875,0,0,0,1.0,1,1.0,1,1.0,1,0.15576182247288925,61
4794,9,16446,3564,12882,0,0,0,1.0,1,1.0,1,1.0,1,0.19069866588782927,59
4795,11,16457,3565,12892,0,0,0,1.0,1,1.0,1,1.0,1,0.13993027785287193,61
4796,6,16463,3566,12897,0,0,0,1.0,1,1.0,1,1.0,1,0.16443100385622017,59
4797,7,16470,3566,12904,0,0,0,1.0,1,1.0,1,1.0,1,0.19471812248907616,58
4798,7,16477,3567,12910,0,0,0,1.0,1,1.0,1,1.0,1,0.22750731180250175,59
4799,10,16487,3568,12919,0,0,0,1.0,1,1.0,1,1.0,1,0.21850054509349034,57
4800,9,16496,3569,12927,0,0,0,1.0,1,1.0,1,1.0,1,0.2106505059520274,58
4801,10,16506,3570,12936,0,0,0,1.0,1,1.0,1,1.0,1,0.09560366397143111,57
4802,5,16511,3571,12940,0,0,0,1.0,1,1.0,1,1.0,1,0.12442191621289411,57
4803,4,16515,3572,12943,0,0,0,1.0,1,1.0,1,1.0,1,0.09726641737833287,56
4804,2,16517,3572,12945,0,0,0,1.0,1,1.0,1,1.0,1,0.07846111803293526,54
4805,2,16519,3572,12947,0,0,0,1.0,1,1.0,1,1.0,1,0.10121223926909306,56
4806,1,16520,3572,12948,0,0,0,1.0,1,1.0,1,1.0,1,0.1346746283060938,55
4807,1,16521,3572,12949,0,0,0,1.0,1,1.0,1,1.0,1,0.10839687463056183,54
4808,5,16526,3572,12954,0,0,0,1.0,1,1.0,1,1.0,1,0.12943725699214625,53
4809,7,16533,3573,12960,0,0,0,1.0,1,1.0,1,1.0,1,0.10988937962531603,53
4810,5,16538,3574,12964,0,0,0,1.0,1,1.0,1,1.0,1,0.13819915355924234,51
4811,2,16540,3574,12966,0,0,0,1.0,1,1.0,1,1.0,1,0.11468119292708688,52
4812,4,16544,3574,12970,0,0,0,1.0,1,1.0,1,1.0,1,0.13760217537997804,52
4813,4,16548,3574,12974,0,0,0,1.0,1,1.0,1,1.0,1,0.13899786733532352,52
4814,6,16554,3577,12977,0,0,0,1.0,1,1.0,1,1.0,1,0.16159275804018178,53
4815,9,16563,3582,12981,0,0,0,1.0,1,1.0,1,1.0,1,0.1532299676430326,54
4816,5,16568,3583,12985,0,0,0,1.0,1,1.0,1,1.0,1,0.10483967181950546,54
4817,3,16571,3585,12986,0,0,0,1.0,1,1.0,1,1.0,1,0.08717544487271356,55
4818,4,16575,3586,12989,0,0,0,1.0,1,1.0,1,1.0,1,0.07814256335484716,55
4819,2,16577,3588,12989,0,0,0,1.0,1,1.0,1,1.0,1,0.08440160200806367,55
4820,1,16578,3588,12990,0,0,0,1.0,1,1.0,1,1.0,1,0.08551343850004156,55
4821,3,16581,3590,12991,0,0,0,1.0,1,1.0,1,1.0,1,0.13345122445052765,55
4822,1,16582,3590,12992,0,0,0,1.0,1,1.0,1,1.0,1,0.12763448642446645,54
4823,1,16583,3591,12992,0,0,0,1.0,1,1.0,1,1.0,1,0.1363598310081588,54
4824,3,16586,3592,12994,0,0,0,1.0,1,1.0,1,1.0,1,0.13784976266522117,55
4825,3,16589,3595,12994,0,0,0,1.0,1,1.0,1,1.0,1,0.20662308617510128,53
4826,8,16597,3598,12999,0,0,0,1.0,1,1.0,1,1.0,1,0.1354208395974343,54
4827,9,16606,3599,13007,0,0,0,1.0,1,1.0,1,1.0,1,0.17210441064479054,53
4828,6,16612,3601,13011,0,0,0,1.0,1,1.0,1,1.0,1,0.13859831293624136,54
4829,2,16614,3601,13013,0,0,0,1.0,1,1.0,1,1.0,1,0.14124807762274225,54
4830,5,16619,3602,13017,0,0,0,1.0,1,1.0,1,1.0,1,0.17365845745661546,53
4831,6,16625,3604,13021,0,0,0,1.0,1,1.0,1,1.0,1,0.12455154820719996,52
4832,0,16625,3604,13021,0,0,0,1.0,1,1.0,1,1.0,1,0.1261090297576199,50
4833,0,16625,3604,13021,0,0,0,1.0,1,1.0,1,1.0,1,0.13768582278214175,51
4834,2,16627,3606,13021,0,0,0,1.0,1,1.0,1,1.0,1,0.20297429384842805,51
4835,1,16628,3606,13022,0,0,0,1.0,1,1.0,1,1.0,1,0.18147623185359818,50
4836,2,16630,3607,13023,0,0,0,1.0,1,1.0,1,1.0,1,0.21211347368309194,50
4837,2,16632,3608,13024,0,0,0,1.0,1,1.0,1,1.0,1,0.22536674317363048,46
4838,4,16636,3611,13025,0,0,0,1.0,1,1.0,1,1.0,1,0.24192898857866613,47
4839,3,16639,3612,13027,0,0,0,1.0,1,1.0,1,1.0,1,0.24964621169870835,45
4840,1,16640,3613,13027,0,0,0,1.0,1,1.0,1,1.0,1,0.25613311871995215,45
4841,2,16642,3614,13028,0,0,0,1.0,1,1.0,1,1.0,1,0.22632817439056507,43
4842,0,16642,3614,13028,0,0,0,1.0,1,1.0,1,1.0,1,0.20832344514190176,43
4843,1,16643,3615,13028,0,0,0,1.0,1,1.0,1,1.0,1,0.21525406317431633,44
4844,0,16643,3615,13028,0,0,0,1.0,1,1.0,1,1.0,1,0.2162061835393919,43
4845,3,16646,3618,13028,0,0,0,1.0,1,1.0,1,1.0,1,0.28997013370740116,44
4846,7,16653,3618,13035,0,0,0,1.0,1,1.0,1,1.0,1,0.16606495111671718,43
4847,2,16655,3619,13036,0,0,0,1.0,1,1.0,1,1.0,1,0.15529154635160639,42
4848,3,16658,3621,13037,0,0,0,1.0,1,1.0,1,1.0,1,0.1914158722153678,41
4849,1,16659,3622,13037,0,0,0,1.0,1,1.0,1,1.0,1,0.1598183176258929,41
4850,0,16659,3622,13037,0,0,0,1.0,1,1.0,1,1.0,1,0.18495038951280549,41
4851,0,16659,3622,13037,0,0,0,1.0,1,1.0,1,1.0,1,0.18495038951280549,41
4852,3,16662,3622,13040,0,0,0,1.0,1,1.0,1,1.0,1,0.18550653822335633,43
4853,2,16664,3624,13040,0,0,0,1.0,1,1.0,1,1.0,1,0.21834283331203128,44
4854,9,16673,3624,13049,0,0,0,1.0,1,1.0,1,1.0,1,0.2093063750991714,45
4855,4,16677,3624,13053,0,0,0,1.0,1,1.0,1,1.0,1,0.20962048062963226,44
4856,3,16680,3625,13055,0,0,0,1.0,1,1.0,1,1.0,1,0.1931181168663378,44
4857,2,16682,3625,13057,0,0,0,1.0,1,1.0,1,1.0,1,0.2192221436673654,44
4858,4,16686,3625,13061,0,0,0,1.0,1,1.0,1,1.0,1,0.23652314519526774,45
4859,6,16692,3625,13067,0,0,0,1.0,1,1.0,1,1.0,1,0.24864099197874232,46
4860,7,16699,3625,13074,0,0,0,1.0,1,1.0,1,1.0,1,0.19504843485522513,46
4861,3,16702,3625,13077,0,0,0,1.0,1,1.0,1,1.0,1,0.11724594083268494,46
4862,1,16703,3625,13078,0,0,0,1.0,1,1.0,1,1.0,1,0.10597166324431016,47
4863,4,16707,3625,13082,0,0,0,1.0,1,1.0,1,1.0,1,0.10213590741724003,47
4864,0,16707,3625,13082,0,0,0,1.0,1,1.0,1,1.0,1,0.101897908912626,47
4865,3,16710,3625,13085,0,0,0,1.0,1,1.0,1,1.0,1,0.09146987838956969,48
4866,1,16711,3625,13086,0,0,0,1.0,1,1.0,1,1.0,1,0.08688438172803024,49
4867,2,16713,3625,13088,0,0,0,1.0,1,1.0,1,1.0,1,0.0942329241691552,50
4868,3,16716,3625,13091,0,0,0,1.0,1,1.0,1,1.0,1,0.1232863470888015,50
4869,2,16718,3625,13093,0,0,0,1.0,1,1.0,1,1.0,1,0.13507111583880202,50
4870,10,16728,3628,13100,0,0,0,1.0,1,1.0,1,1.0,1,0.17350302209932147,52
4871,5,16733,3628,13105,0,0,0,1.0,1,1.0,1,1.0,1,0.16451800442158607,52
4872,4,16737,3628,13109,0,0,0,1.0,1,1.0,1,1.0,1,0.08897022080481015,53
4873,5,16742,3629,13113,0,0,0,1.0,1,1.0,1,1.0,1,0.1388304491247736,55
4874,1,16743,3629,13114,0,0,0,1.0,1,1.0,1,1.0,1,0.1310485712566449,56
4875,11,16754,3630,13124,0,0,0,1.0,1,1.0,1,1.0,1,0.16088557229230957,55
4876,8,16762,3632,13130,0,0,0,1.0,1,1.0,1,1.0,1,0.13347447121661835,55
4877,2,16764,3633,13131,0,0,0,1.0,1,1.0,1,1.0,1,0.13506465410775798,54
4878,2,16766,3633,13133,0,0,0,1.0,1,1.0,1,1.0,1,0.12597454110368916,53
4879,2,16768,3634,13134,0,0,0,1.0,1,1.0,1,1.0,1,0.1749906685115122,54
4880,4,16772,3634,13138,0,0,0,1.0,1,1.0,1,1.0,1,0.1810894066243789,54
4881,5,16777,3635,13142,0,0,0,1.0,1,1.0,1,1.0,1,0.16545028299395306,53
4882,3,16780,3637,13143,0,0,0,1.0,1,1.0,1,1.0,1,0.1966032987834547,53
4883,3,16783,3638,13145,0,0,0,1.0,1,1.0,1,1.0,1,0.21929414357196478,53
4884,4,16787,3639,13148,0,0,0,1.0,1,1.0,1,1.0,1,0.22717108060785024,51
4885,0,16787,3639,13148,0,0,0,1.0,1,1.0,1,1.0,1,0.2199686381263956,50
4886,0,16787,3639,13148,0,0,0,1.0,1,1.0,1,1.0,1,0.22305716907486325,48
4887,0,16787,3639,13148,0,0,0,1.0,1,1.0,1,1.0,1,0.22305716907486325,48
4888,1,16788,3640,13148,0,0,0,1.0,1,1.0,1,1.0,1,0.24863313222485953,48
4889,3,16791,3640,13151,0,0,0,1.0,1,1.0,1,1.0,1,0.25798631453726373,48
4890,3,16794,3640,13154,0,0,0,1.0,1,1.0,1,1.0,1,0.24961055440592486,49
4891,7,16801,3641,13160,0,0,0,1.0,1,1.0,1,1.0,1,0.18947069896671187,50
4892,3,16804,3641,13163,0,0,0,1.0,1,1.0,1,1.0,1,0.17292318578348034,49
4893,3,16807,3641,13166,0,0,0,1.0,1,1.0,1,1.0,1,0.1504742772467995,50
4894,1,16808,3641,13167,0,0,0,1.0,1,1.0,1,1.0,1,0.13122946380160908,51
4895,0,16808,3641,13167,0,0,0,1.0,1,1.0,1,1.0,1,0.12284540051519115,52
4896,4,16812,3641,13171,0,0,0,1.0,1,1.0,1,1.0,1,0.14292534203158072,53
4897,3,16815,3641,13174,0,0,0,1.0,1,1.0,1,1.0,1,0.10832960964822774,53
4898,1,16816,3641,13175,0,0,0,1.0,1,1.0,1,1.0,1,0.11941227108717634,53
4899,3,16819,3642,13177,0,0,0,1.0,1,1.0,1,1.0,1,0.07586797017921004,55
4900,2,16821,3643,13178,0,0,0,1.0,1,1.0,1,1.0,1,0.11943313230013652,55
4901,3,16824,3644,13180,0,0,0,1.0,1,1.0,1,1.0,1,0.09049068616053255,56
4902,4,16828,3645,13183,0,0,0,1.0,1,1.0,1,1.0,1,0.1247284918216839,58
4903,4,16832,3646,13186,0,0,0,1.0,1,1.0,1,1.0,1,0.13168966286310246,58
4904,11,16843,3648,13195,0,0,0,1.0,1,1.0,1,1.0,1,0.12957252436134345,57
4905,7,16850,3649,13201,0,0,0,1.0,1,1.0,1,1.0,1,0.1746065992952835,54
4906,3,16853,3650,13203,0,0,0,1.0,1,1.0,1,1.0,1,0.16496176177220803,55
4907,1,16854,3650,13204,0,0,0,1.0,1,1.0,1,1.0,1,0.1651731773155941,52
4908,4,16858,3652,13206,0,0,0,1.0,1,1.0,1,1.0,1,0.17390800409540236,53
4909,0,16858,3652,13206,0,0,0,1.0,1,1.0,1,1.0,1,0.17933299632965718,52
4910,2,16860,3652,13208,0,0,0,1.0,1,1.0,1,1.0,1,0.17778151829565278,53
4911,2,16862,3652,13210,0,0,0,1.0,1,1.0,1,1.0,1,0.1904589033284824,55
4912,1,16863,3652,13211,0,0,0,1.0,1,1.0,1,1.0,1,0.1721694188045822,54
4913,1,16864,3652,13212,0,0,0,1.0,1,1.0,1,1.0,1,0.15515693488107485,53
4914,2,16866,3653,13213,0,0,0,1.0,1,1.0,1,1.0,1,0.13822219666376537,53
4915,3,16869,3655,13214,0,0,0,1.0,1,1.0,1,1.0,1,0.13316663435827394,54
4916,7,16876,3656,13220,0,0,0,1.0,1,1.0,1,1.0,1,0.09542158505119534,52
4917,1,16877,3657,13220,0,0,0,1.0,1,1.0,1,1.0,1,0.12640324254751367,52
4918,1,16878,3658,13220,0,0,0,1.0,1,1.0,1,1.0,1,0.16431255792868843,51
4919,2,16880,3658,13222,0,0,0,1.0,1,1.0,1,1.0,1,0.16498643844701452,50
4920,2,16882,3658,13224,0,0,0,1.0,1,1.0,1,1.0,1,0.12934609571511088,51
4921,2,16884,3658,13226,0,0,0,1.0,1,1.0,1,1.0,1,0.12270216608088728,51
4922,2,16886,3659,13227,0,0,0,1.0,1,1.0,1,1.0,1,0.14283822224076198,53
4923,0,16886,3659,13227,0,0,0,1.0,1,1.0,1,1.0,1,0.14283822224076198,53
4924,2,16888,3659,13229,0,0,0,1.0,1,1.0,1,1.0,1,0.12304146274289875,55
4925,2,16890,3661,13229,0,0,0,1.0,1,1.0,1,1.0,1,0.09841123703133262,56
4926,0,16890,3661,13229,0,0,0,1.0,1,1.0,1,1.0,1,0.0838056999372289,55
4927,2,16892,3663,13229,0,0,0,1.0,1,1.0,1,1.0,1,0.10821013333263148,55
4928,0,16892,3663,13229,0,0,0,1.0,1,1.0,1,1.0,1,0.10821013333263148,55
4929,1,16893,3663,13230,0,0,0,1.0,1,1.0,1,1.0,1,0.09084464341290859,56
4930,4,16897,3665,13232,0,0,0,1.0,1,1.0,1,1.0,1,0.11593502546531481,58
4931,2,16899,3665,13234,0,0,0,1.0,1,1.0,1,1.0,1,0.12634489595852974,59
4932,4,16903,3666,13237,0,0,0,1.0,1,1.0,1,1.0,1,0.14738012637389886,60
4933,4,16907,3666,13241,0,0,0,1.0,1,1.0,1,1.0,1,0.14717182616227437,60
4934,3,16910,3666,13244,0,0,0,1.0,1,1.0,1,1.0,1,0.14888529807734177,60
4935,3,16913,3666,13247,0,0,0,1.0,1,1.0,1,1.0,1,0.15578564297168435,60
4936,5,16918,3666,13252,0,0,0,1.0,1,1.0,1,1.0,1,0.11240926825843019,61
4937,3,16921,3667,13254,0,0,0,1.0,1,1.0,1,1.0,1,0.14323746802224874,62
4938,1,16922,3667,13255,0,0,0,1.0,1,1.0,1,1.0,1,0.11835780075653872,62
4939,4,16926,3670,13256,0,0,0,1.0,1,1.0,1,1.0,1,0.14886072959346028,64
4940,6,16932,3670,13262,0,0,0,1.0,1,1.0,1,1.0,1,0.12711912713389373,67
4941,2,16934,3671,13263,0,0,0,1.0,1,1.0,1,1.0,1,0.15467244594620994,66
4942,6,16940,3673,13267,0,0,0,1.0,1,1.0,1,1.0,1,0.16908325137802965,67
4943,4,16944,3673,13271,0,0,0,1.0,1,1.0,1,1.0,1,0.15388957006145085,65
4944,4,16948,3675,13273,0,0,0,1.0,1,1.0,1,1.0,1,0.17499823835366715,65
4945,5,16953,3677,13276,0,0,0,1.0,1,1.0,1,1.0,1,0.17882981975693973,62
4946,3,16956,3679,13277,0,0,0,1.0,1,1.0,1,1.0,1,0.17936716465110847,61
4947,2,16958,3680,13278,0,0,0,1.0,1,1.0,1,1.0,1,0.17685828107891716,59
4948,4,16962,3682,13280,0,0,0,1.0,1,1.0,1,1.0,1,0.16685250285141778,59
4949,3,16965,3683,13282,0,0,0,1.0,1,1.0,1,1.0,1,0.1563049685424073,57
4950,6,16971,3685,13286,0,0,0,1.0,1,1.0,1,1.0,1,0.15087565667023423,58
4951,6,16977,3687,13290,0,0,0,1.0,1,1.0,1,1.0,1,0.09175888328229137,55
4952,3,16980,3690,13290,0,0,0,1.0,1,1.0,1,1.0,1,0.09217746626780629,53
4953,4,16984,3694,13290,0,0,0,1.0,1,1.0,1,1.0,1,0.07952795666407676,54
4954,0,16984,3694,13290,0,0,0,1.0,1,1.0,1,1.0,1,0.07780460869782971,52
4955,5,16989,3697,13292,0,0,0,1.0,1,1.0,1,1.0,1,0.1199397342398426,51
4956,0,16989,3697,13292,0,0,0,1.0,1,1.0,1,1.0,1,0.13319279950836432,47
4957,1,16990,3697,13293,0,0,0,1.0,1,1.0,1,1.0,1,0.1322712733248101,48
4958,0,16990,3697,13293,0,0,0,1.0,1,1.0,1,1.0,1,0.13358935991821339,47
4959,0,16990,3697,13293,0,0,0,1.0,1,1.0,1,1.0,1,0.13358935991821339,47
4960,0,16990,3697,13293,0,0,0,1.0,1,1.0,1,1.0,1,0.1308683608085782,48
4961,1,16991,3698,13293,0,0,0,1.0,1,1.0,1,1.0,1,0.12903137676059598,49
4962,0,16991,3698,13293,0,0,0,1.0,1,1.0,1,1.0,1,0.12903137676059598,49
4963,2,16993,3699,13294,0,0,0,1.0,1,1.0,1,1.0,1,0.11947278498048217,51
4964,4,16997,3702,13295,0,0,0,1.0,1,1.0,1,1.0,1,0.15144991465040195,51
4965,1,16998,3702,13296,0,0,0,1.0,1,1.0,1,1.0,1,0.14450411666812923,51
4966,4,17002,3702,13300,0,0,0,1.0,1,1.0,1,1.0,1,0.09531597157959369,51
4967,2,17004,3704,13300,0,0,0,1.0,1,1.0,1,1.0,1,0.1533862422710706,51
4968,3,17007,3705,13302,0,0,0,1.0,1,1.0,1,1.0,1,0.11761492794238856,52
4969,0,17007,3705,13302,0,0,0,1.0,1,1.0,1,1.0,1,0.12518074915348032,53
4970,4,17011,3707,13304,0,0,0,1.0,1,1.0,1,1.0,1,0.18296105373229188,54
4971,5,17016,3707,13309,0,0,0,1.0,1,1.0,1,1.0,1,0.19284352220054957,55
4972,6,17022,3707,13315,0,0,0,1.0,1,1.0,1,1.0,1,0.19896417521196305,56
4973,8,17030,3709,13321,0,0,0,1.0,1,1.0,1,1.0,1,0.1546222526458732,57
4974,5,17035,3710,13325,0,0,0,1.0,1,1.0,1,1.0,1,0.23352505354221523,56
4975,9,17044,3711,13333,0,0,0,1.0,1,1.0,1,1.0,1,0.16704138611798838,57
4976,4,17048,3712,13336,0,0,0,1.0,1,1.0,1,1.0,1,0.16747706908025417,57
4977,5,17053,3712,13341,0,0,0,1.0,1,1.0,1,1.0,1,0.1650841809726505,57
4978,9,17062,3713,13349,0,0,0,1.0,1,1.0,1,1.0,1,0.1255602712700728,58
4979,4,17066,3713,13353,0,0,0,1.0,1,1.0,1,1.0,1,0.15182770106185195,58
4980,8,17074,3713,13361,0,0,0,1.0,1,1.0,1,1.0,1,0.13051386083822605,59
4981,3,17077,3714,13363,0,0,0,1.0,1,1.0,1,1.0,1,0.09856128380550691,60
4982,1,17078,3715,13363,0,0,0,1.0,1,1.0,1,1.0,1,0.09304393270979563,61
4983,1,17079,3716,13363,0,0,0,1.0,1,1.0,1,1.0,1,0.10402812374270738,61
4984,1,17080,3717,13363,0,0,0,1.0,1,1.0,1,1.0,1,0.11050424668170927,59
4985,2,17082,3718,13364,0,0,0,1.0,1,1.0,1,1.0,1,0.12102945790270522,58
4986,4,17086,3720,13366,0,0,0,1.0,1,1.0,1,1.0,1,0.11067757573578152,59
4987,2,17088,3720,13368,0,0,0,1.0,1,1.0,1,1.0,1,0.10633203266096572,58
4988,2,17090,3722,13368,0,0,0,1.0,1,1.0,1,1.0,1,0.10407079915019335,57
4989,2,17092,3723,13369,0,0,0,1.0,1,1.0,1,1.0,1,0.12591013104410143,54
4990,1,17093,3723,13370,0,0,0,1.0,1,1.0,1,1.0,1,0.13523611091885177,53
4991,3,17096,3726,13370,0,0,0,1.0,1,1.0,1,1.0,1,0.15476024425165893,52
4992,3,17099,3728,13371,0,0,0,1.0,1,1.0,1,1.0,1,0.19882338864787005,48
4993,1,17100,3728,13372,0,0,0,1.0,1,1.0,1,1.0,1,0.187577576738402,48
4994,1,17101,3729,13372,0,0,0,1.0,1,1.0,1,1.0,1,0.19749891516951582,45
4995,5,17106,3733,13373,0,0,0,1.0,1,1.0,1,1.0,1,0.24216791004136923,45
4996,8,17114,3735,13379,0,0,0,1.0,1,1.0,1,1.0,1,0.08698625888689425,45
4997,3,17117,3735,13382,0,0,0,1.0,1,1.0,1,1.0,1,0.09269464662260646,42
4998,7,17124,3738,13386,0,0,0,1.0,1,1.0,1,1.0,1,0.1467857033001974,44
4999,7,17131,3738,13393,0,0,0,1.0,1,1.0,1,1.0,1,0.14338289851785202,44
5000,3,17134,3739,13395,0,0,0,1.0,1,1.0,1,1.0,1,0.17269204037857872,42
5001,5,17139,3739,13400,0,0,0,1.0,1,1.0,1,1.0,1,0.17049981860994176,42
5002,3,17142,3740,13402,0,0,0,1.0,1,1.0,1,1.0,1,0.18485187876693915,41
5003,7,17149,3741,13408,0,0,0,1.0,1,1.0,1,1.0,1,0.236801895767783,41
5004,3,17152,3741,13411,0,0,0,1.0,1,1.0,1,1.0,1,0.2110657952686117,41
5005,5,17157,3741,13416,0,0,0,1.0,1,1.0,1,1.0,1,0.22620551874541486,41
5006,3,17160,3741,13419,0,0,0,1.0,1,1.0,1,1.0,1,0.23471393165602128,42
5007,4,17164,3741,13423,0,0,0,1.0,1,1.0,1,1.0,1,0.241627464042695,43
5008,3,17167,3741,13426,0,0,0,1.0,1,1.0,1,1.0,1,0.18821103118073335,46
5009,6,17173,3741,13432,0,0,0,1.0,1,1.0,1,1.0,1,0.18821103118073335,46
5010,3,17176,3741,13435,0,0,0,1.0,1,1.0,1,1.0,1,0.23702421475944593,46
5011,7,17183,3741,13442,0,0,0,1.0,1,1.0,1,1.0,1,0.1334324385784024,47
5012,2,17185,3741,13444,0,0,0,1.0,1,1.0,1,1.0,1,0.12008741300524145,48
5013,0,17185,3741,13444,0,0,0,1.0,1,1.0,1,1.0,1,0.12008741300524145,48
5014,2,17187,3741,13446,0,0,0,1.0,1,1.0,1,1.0,1,0.11995779342894711,49
5015,2,17189,3741,13448,0,0,0,1.0,1,1.0,1,1.0,1,0.09909493279660718,50
5016,5,17194,3742,13452,0,0,0,1.0,1,1.0,1,1.0,1,0.1737426568581274,51
5017,4,17198,3742,13456,0,0,0,1.0,1,1.0,1,1.0,1,0.14645742215994326,51
5018,4,17202,3742,13460,0,0,0,1.0,1,1.0,1,1.0,1,0.1805590611084797,51
5019,5,17207,3743,13464,0,0,0,1.0,1,1.0,1,1.0,1,0.2136638333171203,51
5020,5,17212,3743,13469,0,0,0,1.0,1,1.0,1,1.0,1,0.19409586241051774,51
5021,4,17216,3743,13473,0,0,0,1.0,1,1.0,1,1.0,1,0.1996393068198442,52
5022,6,17222,3744,13478,0,0,0,1.0,1,1.0,1,1.0,1,0.19186666528374322,52
5023,9,17231,3747,13484,0,0,0,1.0,1,1.0,1,1.0,1,0.2035995037964281,52
5024,9,17240,3750,13490,0,0,0,1.0,1,1.0,1,1.0,1,0.19471311395503577,51
5025,5,17245,3750,13495,0,0,0,1.0,1,1.0,1,1.0,1,0.16120160711760992,50
5026,6,17251,3751,13500,0,0,0,1.0,1,1.0,1,1.0,1,0.15577296457541898,49
5027,1,17252,3751,13501,0,0,0,1.0,1,1.0,1,1.0,1,0.13591176975755623,47
5028,5,17257,3753,13504,0,0,0,1.0,1,1.0,1,1.0,1,0.23288023470364916,47
5029,3,17260,3754,13506,0,0,0,1.0,1,1.0,1,1.0,1,0.2193876106455895,46
5030,4,17264,3754,13510,0,0,0,1.0,1,1.0,1,1.0,1,0.19099186640333118,48
5031,6,17270,3756,13514,0,0,0,1.0,1,1.0,1,1.0,1,0.21442793116464812,46
5032,4,17274,3756,13518,0,0,0,1.0,1,1.0,1,1.0,1,0.21442793116464812,46
5033,4,17278,3756,13522,0,0,0,1.0,1,1.0,1,1.0,1,0.20620412073341038,47
5034,4,17282,3757,13525,0,0,0,1.0,1,1.0,1,1.0,1,0.2081262815933991,48
5035,2,17284,3757,13527,0,0,0,1.0,1,1.0,1,1.0,1,0.2150254776315507,47
5036,6,17290,3758,13532,0,0,0,1.0,1,1.0,1,1.0,1,0.2158212123705401,47
5037,2,17292,3758,13534,0,0,0,1.0,1,1.0,1,1.0,1,0.19453068979795482,47
5038,3,17295,3759,13536,0,0,0,1.0,1,1.0,1,1.0,1,0.23163421461923595,48
5039,5,17300,3759,13541,0,0,0,1.0,1,1.0,1,1.0,1,0.21598498449650075,47
5040,4,17304,3759,13545,0,0,0,1.0,1,1.0,1,1.0,1,0.2173131193068969,48
5041,7,17311,3760,13551,0,0,0,1.0,1,1.0,1,1.0,1,0.10478584014545399,49
5042,0,17311,3760,13551,0,0,0,1.0,1,1.0,1,1.0,1,0.11976842304445788,50
5043,2,17313,3761,13552,0,0,0,1.0,1,1.0,1,1.0,1,0.1218967051136963,51
5044,3,17316,3761,13555,0,0,0,1.0,1,1.0,1,1.0,1,0.09613381666838765,51
5045,1,17317,3761,13556,0,0,0,1.0,1,1.0,1,1.0,1,0.10390257365147283,51
5046,6,17323,3762,13561,0,0,0,1.0,1,1.0,1,1.0,1,0.10538794044177209,52
5047,3,17326,3762,13564,0,0,0,1.0,1,1.0,1,1.0,1,0.10336121000702722,52
5048,2,17328,3762,13566,0,0,0,1.0,1,1.0,1,1.0,1,0.09595555738226896,52
5049,1,17329,3762,13567,0,0,0,1.0,1,1.0,1,1.0,1,0.1164297432411593,52
5050,4,17333,3762,13571,0,0,0,1.0,1,1.0,1,1.0,1,0.10961481962418856,55
5051,0,17333,3762,13571,0,0,0,1.0,1,1.0,1,1.0,1,0.11524023836560035,55
5052,0,17333,3762,13571,0,0,0,1.0,1,1.0,1,1.0,1,0.11524023836560035,55
5053,0,17333,3762,13571,0,0,0,1.0,1,1.0,1,1.0,1,0.12325165641116888,54
5054,0,17333,3762,13571,0,0,0,1.0,1,1.0,1,1.0,1,0.12325165641116888,54
5055,1,17334,3762,13572,0,0,0,1.0,1,1.0,1,1.0,1,0.12054345871171424,54
5056,3,17337,3762,13575,0,0,0,1.0,1,1.0,1,1.0,1,0.07054007448981352,55
5057,0,17337,3762,13575,0,0,0,1.0,1,1.0,1,1.0,1,0.08098968669356962,56
5058,0,17337,3762,13575,0,0,0,1.0,1,1.0,1,1.0,1,0.0955079949832414,58
5059,0,17337,3762,13575,0,0,0,1.0,1,1.0,1,1.0,1,0.0955079949832414,58
5060,4,17341,3763,13578,0,0,0,1.0,1,1.0,1,1.0,1,0.08582924155850535,59
5061,2,17343,3764,13579,0,0,0,1.0,1,1.0,1,1.0,1,0.10470652237438031,58
5062,2,17345,3765,13580,0,0,0,1.0,1,1.0,1,1.0,1,0.08849787742276526,58
5063,6,17351,3768,13583,0,0,0,1.0,1,1.0,1,1.0,1,0.09311811724890423,57
5064,2,17353,3770,13583,0,0,0,1.0,1,1.0,1,1.0,1,0.14184880017750978,57
5065,2,17355,3771,13584,0,0,0,1.0,1,1.0,1,1.0,1,0.14329258422404606,56
5066,7,17362,3775,13587,0,0,0,1.0,1,1.0,1,1.0,1,0.2646843744735488,55
5067,5,17367,3776,13591,0,0,0,1.0,1,1.0,1,1.0,1,0.23831009153555685,54
5068,8,17375,3779,13596,0,0,0,1.0,1,1.0,1,1.0,1,0.2574144266609987,54
5069,3,17378,3779,13599,0,0,0,1.0,1,1.0,1,1.0,1,0.23303584689526,53
5070,2,17380,3779,13601,0,0,0,1.0,1,1.0,1,1.0,1,0.22685383394352898,53
5071,10,17390,3779,13611,0,0,0,1.0,1,1.0,1,1.0,1,0.14425607489326092,53
5072,1,17391,3780,13611,0,0,0,1.0,1,1.0,1,1.0,1,0.10822618559515486,53
5073,2,17393,3781,13612,0,0,0,1.0,1,1.0,1,1.0,1,0.08760441119999107,53
5074,2,17395,3781,13614,0,0,0,1.0,1,1.0,1,1.0,1,0.0993869930702041,52
5075,0,17395,3781,13614,0,0,0,1.0,1,1.0,1,1.0,1,0.0993869930702041,52
5076,1,17396,3781,13615,0,0,0,1.0,1,1.0,1,1.0,1,0.113199592997929,55
5077,3,17399,3782,13617,0,0,0,1.0,1,1.0,1,1.0,1,0.1526043545334261,55
5078,3,17402,3782,13620,0,0,0,1.0,1,1.0,1,1.0,1,0.16976254205193067,55
5079,2,17404,3782,13622,0,0,0,1.0,1,1.0,1,1.0,1,0.18522914075927285,54
5080,2,17406,3783,13623,0,0,0,1.0,1,1.0,1,1.0,1,0.17344885128102716,55
5081,2,17408,3783,13625,0,0,0,1.0,1,1.0,1,1.0,1,0.16644826578220406,57
5082,4,17412,3783,13629,0,0,0,1.0,1,1.0,1,1.0,1,0.15212255444644066,57
5083,9,17421,3784,13637,0,0,0,1.0,1,1.0,1,1.0,1,0.14821217170355233,58
5084,2,17423,3784,13639,0,0,0,1.0,1,1.0,1,1.0,1,0.10931316273468843,58
5085,6,17429,3785,13644,0,0,0,1.0,1,1.0,1,1.0,1,0.12313435637668765,59
5086,5,17434,3785,13649,0,0,0,1.0,1,1.0,1,1.0,1,0.06756615383121334,60
5087,3,17437,3786,13651,0,0,0,1.0,1,1.0,1,1.0,1,0.06704382947776791,61
5088,2,17439,3787,13652,0,0,0,1.0,1,1.0,1,1.0,1,0.09662977363779061,62
5089,2,17441,3789,13652,0,0,0,1.0,1,1.0,1,1.0,1,0.09512111415972554,63
5090,0,17441,3789,13652,0,0,0,1.0,1,1.0,1,1.0,1,0.09512111415972554,63
5091,2,17443,3791,13652,0,0,0,1.0,1,1.0,1,1.0,1,0.13540261909330412,63
5092,7,17450,3792,13658,0,0,0,1.0,1,1.0,1,1.0,1,0.14205980651800246,63
5093,5,17455,3792,13663,0,0,0,1.0,1,1.0,1,1.0,1,0.12141128805328646,63
5094,8,17463,3794,13669,0,0,0,1.0,1,1.0,1,1.0,1,0.13193761661775835,64
5095,3,17466,3794,13672,0,0,0,1.0,1,1.0,1,1.0,1,0.15436219168902265,64
5096,11,17477,3795,13682,0,0,0,1.0,1,1.0,1,1.0,1,0.13080795734777476,67
5097,13,17490,3795,13695,0,0,0,1.0,1,1.0,1,1.0,1,0.12789335137358082,67
5098,9,17499,3795,13704,0,0,0,1.0,1,1.0,1,1.0,1,0.16363318114578074,68
5099,7,17506,3795,13711,0,0,0,1.0,1,1.0,1,1.0,1,0.15414040784355773,70
5100,10,17516,3795,13721,0,0,0,1.0,1,1.0,1,1.0,1,0.15128764681274648,71
5101,6,17522,3796,13726,0,0,0,1.0,1,1.0,1,1.0,1,0.10197426667154233,71
5102,2,17524,3798,13726,0,0,0,1.0,1,1.0,1,1.0,1,0.1104450055061797,70
5103,1,17525,3799,13726,0,0,0,1.0,1,1.0,1,1.0,1,0.09433543856270758,67
5104,3,17528,3802,13726,0,0,0,1.0,1,1.0,1,1.0,1,0.12563265854516847,67
5105,3,17531,3804,13727,0,0,0,1.0,1,1.0,1,1.0,1,0.12625529918556042,63
5106,4,17535,3807,13728,0,0,0,1.0,1,1.0,1,1.0,1,0.15895810773943356,63
5107,5,17540,3812,13728,0,0,0,1.0,1,1.0,1,1.0,1,0.19079217365374201,60
5108,6,17546,3815,13731,0,0,0,1.0,1,1.0,1,1.0,1,0.20431533971575347,56
5109,5,17551,3819,13732,0,0,0,1.0,1,1.0,1,1.0,1,0.25552782074301605,56
5110,1,17552,3819,13733,0,0,0,1.0,1,1.0,1,1.0,1,0.2487914682784204,52
5111,3,17555,3822,13733,0,0,0,1.0,1,1.0,1,1.0,1,0.23393387400218113,51
5112,2,17557,3823,13734,0,0,0,1.0,1,1.0,1,1.0,1,0.22454926661335534,50
5113,3,17560,3826,13734,0,0,0,1.0,1,1.0,1,1.0,1,0.2777233822447102,48
5114,2,17562,3828,13734,0,0,0,1.0,1,1.0,1,1.0,1,0.2670527425334079,46
5115,0,17562,3828,13734,0,0,0,1.0,1,1.0,1,1.0,1,0.25029361159212166,44
5116,10,17572,3831,13741,0,0,0,1.0,1,1.0,1,1.0,1,0.1626862132672226,44
5117,2,17574,3831,13743,0,0,0,1.0,1,1.0,1,1.0,1,0.15087546746242972,46
5118,6,17580,3832,13748,0,0,0,1.0,1,1.0,1,1.0,1,0.14565830165404633,46
5119,5,17585,3833,13752,0,0,0,1.0,1,1.0,1,1.0,1,0.1591398199981192,46
5120,5,17590,3833,13757,0,0,0,1.0,1,1.0,1,1.0,1,0.17034473980413695,46
5121,11,17601,3835,13766,0,0,0,1.0,1,1.0,1,1.0,1,0.19926041424292495,46
5122,9,17610,3837,13773,0,0,0,1.0,1,1.0,1,1.0,1,0.19105093529707834,46
5123,4,17614,3837,13777,0,0,0,1.0,1,1.0,1,1.0,1,0.2282963147816432,45
5124,7,17621,3837,13784,0,0,0,1.0,1,1.0,1,1.0,1,0.1753104881942034,47
5125,9,17630,3837,13793,0,0,0,1.0,1,1.0,1,1.0,1,0.1810363092874577,50
5126,14,17644,3838,13806,0,0,0,1.0,1,1.0,1,1.0,1,0.203541225188825,50
5127,11,17655,3838,13817,0,0,0,1.0,1,1.0,1,1.0,1,0.19446619502363438,52
5128,11,17666,3840,13826,0,0,0,1.0,1,1.0,1,1.0,1,0.21891549818602804,53
5129,12,17678,3840,13838,0,0,0,1.0,1,1.0,1,1.0,1,0.23338875334964299,55
5130,16,17694,3841,13853,0,0,0,1.0,1,1.0,1,1.0,1,0.22366884023662473,55
5131,9,17703,3842,13861,0,0,0,1.0,1,1.0,1,1.0,1,0.08749848136794604,54
5132,0,17703,3842,13861,0,0,0,1.0,1,1.0,1,1.0,1,0.10785560133270887,54
5133,0,17703,3842,13861,0,0,0,1.0,1,1.0,1,1.0,1,0.10785560133270887,54
5134,0,17703,3842,13861,0,0,0,1.0,1,1.0,1,1.0,1,0.10755523643269278,53
5135,0,17703,3842,13861,0,0,0,1.0,1,1.0,1,1.0,1,0.11050110685330515,54
5136,4,17707,3842,13865,0,0,0,1.0,1,1.0,1,1.0,1,0.10338376645112919,54
5137,2,17709,3842,13867,0,0,0,1.0,1,1.0,1,1.0,1,0.09868034889759288,54
5138,2,17711,3843,13868,0,0,0,1.0,1,1.0,1,1.0,1,0.1524340671389791,54
5139,2,17713,3843,13870,0,0,0,1.0,1,1.0,1,1.0,1,0.14233439181067623,55
5140,2,17715,3844,13871,0,0,0,1.0,1,1.0,1,1.0,1,0.16080455249859144,55
5141,0,17715,3844,13871,0,0,0,1.0,1,1.0,1,1.0,1,0.15354908092425013,53
5142,3,17718,3846,13872,0,0,0,1.0,1,1.0,1,1.0,1,0.17152707020057886,54
5143,1,17719,3847,13872,0,0,0,1.0,1,1.0,1,1.0,1,0.19713843431970032,52
5144,2,17721,3849,13872,0,0,0,1.0,1,1.0,1,1.0,1,0.24130072245823153,50
5145,0,17721,3849,13872,0,0,0,1.0,1,1.0,1,1.0,1,0.23175420098898458,49
5146,14,17735,3851,13884,0,0,0,1.0,1,1.0,1,1.0,1,0.14521087276196984,49
5147,6,17741,3853,13888,0,0,0,1.0,1,1.0,1,1.0,1,0.12613583311067872,46
5148,3,17744,3853,13891,0,0,0,1.0,1,1.0,1,1.0,1,0.1219666336959173,46
5149,4,17748,3853,13895,0,0,0,1.0,1,1.0,1,1.0,1,0.15808086488960976,45
5150,4,17752,3855,13897,0,0,0,1.0,1,1.0,1,1.0,1,0.16743804768115697,47
5151,2,17754,3856,13898,0,0,0,1.0,1,1.0,1,1.0,1,0.2268404934377604,46
5152,4,17758,3858,13900,0,0,0,1.0,1,1.0,1,1.0,1,0.21217010119397867,46
5153,1,17759,3858,13901,0,0,0,1.0,1,1.0,1,1.0,1,0.23318279714145299,45
5154,2,17761,3859,13902,0,0,0,1.0,1,1.0,1,1.0,1,0.2048840784538501,47
5155,3,17764,3859,13905,0,0,0,1.0,1,1.0,1,1.0,1,0.20246030670266302,47
5156,4,17768,3860,13908,0,0,0,1.0,1,1.0,1,1.0,1,0.16538213499516285,47
5157,4,17772,3862,13910,0,0,0,1.0,1,1.0,1,1.0,1,0.1764156994487278,46
5158,2,17774,3862,13912,0,0,0,1.0,1,1.0,1,1.0,1,0.18717713080794207,47
5159,2,17776,3862,13914,0,0,0,1.0,1,1.0,1,1.0,1,0.19295238428564448,49
5160,3,17779,3862,13917,0,0,0,1.0,1,1.0,1,1.0,1,0.22579505285977486,48
5161,8,17787,3862,13925,0,0,0,1.0,1,1.0,1,1.0,1,0.09111255188963303,48
5162,0,17787,3862,13925,0,0,0,1.0,1,1.0,1,1.0,1,0.09177770885292176,49
5163,3,17790,3863,13927,0,0,0,1.0,1,1.0,1,1.0,1,0.09179079441669165,51
5164,0,17790,3863,13927,0,0,0,1.0,1,1.0,1,1.0,1,0.09179079441669165,51
5165,2,17792,3864,13928,0,0,0,1.0,1,1.0,1,1.0,1,0.12060588839913197,52
5166,0,17792,3864,13928,0,0,0,1.0,1,1.0,1,1.0,1,0.12060588839913197,52
5167,2,17794,3865,13929,0,0,0,1.0,1,1.0,1,1.0,1,0.12072120017358577,52
5168,3,17797,3865,13932,0,0,0,1.0,1,1.0,1,1.0,1,0.12331454398841352,52
5169,4,17801,3867,13934,0,0,0,1.0,1,1.0,1,1.0,1,0.12493423259185314,53
5170,2,17803,3867,13936,0,0,0,1.0,1,1.0,1,1.0,1,0.13252716760132274,53
5171,2,17805,3867,13938,0,0,0,1.0,1,1.0,1,1.0,1,0.1363623749334887,52
5172,4,17809,3868,13941,0,0,0,1.0,1,1.0,1,1.0,1,0.1453169811270326,53
5173,5,17814,3868,13946,0,0,0,1.0,1,1.0,1,1.0,1,0.14979657740686902,54
5174,7,17821,3869,13952,0,0,0,1.0,1,1.0,1,1.0,1,0.16068735966947578,56
5175,8,17829,3869,13960,0,0,0,1.0,1,1.0,1,1.0,1,0.1519140522723243,58
5176,8,17837,3869,13968,0,0,0,1.0,1,1.0,1,1.0,1,0.08056415384057782,58
5177,3,17840,3869,13971,0,0,0,1.0,1,1.0,1,1.0,1,0.0669993718587182,59
5178,7,17847,3871,13976,0,0,0,1.0,1,1.0,1,1.0,1,0.10266679569589204,57
5179,3,17850,3871,13979,0,0,0,1.0,1,1.0,1,1.0,1,0.1412919075358089,58
5180,4,17854,3873,13981,0,0,0,1.0,1,1.0,1,1.0,1,0.14323075976637323,56
5181,5,17859,3874,13985,0,0,0,1.0,1,1.0,1,1.0,1,0.15525757704691912,57
5182,4,17863,3876,13987,0,0,0,1.0,1,1.0,1,1.0,1,0.18633627197268138,56
5183,7,17870,3876,13994,0,0,0,1.0,1,1.0,1,1.0,1,0.17649428740942127,57
5184,5,17875,3878,13997,0,0,0,1.0,1,1.0,1,1.0,1,0.16664002032755124,56
5185,9,17884,3879,14005,0,0,0,1.0,1,1.0,1,1.0,1,0.16969474862434095,56
5186,4,17888,3881,14007,0,0,0,1.0,1,1.0,1,1.0,1,0.150562689876341,54
5187,5,17893,3881,14012,0,0,0,1.0,1,1.0,1,1.0,1,0.1697493899834714,51
5188,5,17898,3883,14015,0,0,0,1.0,1,1.0,1,1.0,1,0.18018712456583968,50
5189,3,17901,3883,14018,0,0,0,1.0,1,1.0,1,1.0,1,0.20317964722899076,49
5190,5,17906,3886,14020,0,0,0,1.0,1,1.0,1,1.0,1,0.1879860995946173,50
5191,8,17914,3887,14027,0,0,0,1.0,1,1.0,1,1.0,1,0.07759196737617961,50
5192,3,17917,3888,14029,0,0,0,1.0,1,1.0,1,1.0,1,0.07727827012920241,49
5193,3,17920,3889,14031,0,0,0,1.0,1,1.0,1,1.0,1,0.09790741930835092,50
5194,6,17926,3890,14036,0,0,0,1.0,1,1.0,1,1.0,1,0.12249033610459353,51
5195,2,17928,3890,14038,0,0,0,1.0,1,1.0,1,1.0,1,0.11379002414591403,51
5196,1,17929,3890,14039,0,0,0,1.0,1,1.0,1,1.0,1,0.12463761995589306,51
5197,4,17933,3890,14043,0,0,0,1.0,1,1.0,1,1.0,1,0.12463761995589306,51
5198,4,17937,3890,14047,0,0,0,1.0,1,1.0,1,1.0,1,0.12463761995589306,51
5199,4,17941,3890,14051,0,0,0,1.0,1,1.0,1,1.0,1,0.12731924015262078,54
5200,5,17946,3891,14055,0,0,0,1.0,1,1.0,1,1.0,1,0.12120477385947026,54
5201,4,17950,3893,14057,0,0,0,1.0,1,1.0,1,1.0,1,0.1285798243350571,55
5202,5,17955,3893,14062,0,0,0,1.0,1,1.0,1,1.0,1,0.1728496698592618,56
5203,6,17961,3893,14068,0,0,0,1.0,1,1.0,1,1.0,1,0.15994816493030745,56
5204,10,17971,3893,14078,0,0,0,1.0,1,1.0,1,1.0,1,0.14831564579367704,58
5205,8,17979,3893,14086,0,0,0,1.0,1,1.0,1,1.0,1,0.16191321247033214,58
5206,3,17982,3893,14089,0,0,0,1.0,1,1.0,1,1.0,1,0.11352637391220931,58
5207,1,17983,3893,14090,0,0,0,1.0,1,1.0,1,1.0,1,0.11831435423993274,59
5208,0,17983,3893,14090,0,0,0,1.0,1,1.0,1,1.0,1,0.12356127616832174,58
5209,0,17983,3893,14090,0,0,0,1.0,1,1.0,1,1.0,1,0.12356127616832174,58
5210,0,17983,3893,14090,0,0,0,1.0,1,1.0,1,1.0,1,0.1405789149999568,57
5211,1,17984,3894,14090,0,0,0,1.0,1,1.0,1,1.0,1,0.16415519393725078,57
5212,3,17987,3894,14093,0,0,0,1.0,1,1.0,1,1.0,1,0.1360349442258,59
5213,2,17989,3895,14094,0,0,0,1.0,1,1.0,1,1.0,1,0.15792559225817077,59
5214,1,17990,3895,14095,0,0,0,1.0,1,1.0,1,1.0,1,0.15597483602495493,59
5215,3,17993,3896,14097,0,0,0,1.0,1,1.0,1,1.0,1,0.20225436675826822,58
5216,7,18000,3897,14103,0,0,0,1.0,1,1.0,1,1.0,1,0.1824610305880424,59
5217,8,18008,3901,14107,0,0,0,1.0,1,1.0,1,1.0,1,0.16254214084917207,58
5218,9,18017,3905,14112,0,0,0,1.0,1,1.0,1,1.0,1,0.2022944927872291,58
5219,4,18021,3905,14116,0,0,0,1.0,1,1.0,1,1.0,1,0.16212119522393334,57
5220,5,18026,3906,14120,0,0,0,1.0,1,1.0,1,1.0,1,0.2085654043315482,56
5221,7,18033,3908,14125,0,0,0,1.0,1,1.0,1,1.0,1,0.22252561805197182,58
5222,2,18035,3909,14126,0,0,0,1.0,1,1.0,1,1.0,1,0.17770897493850682,56
5223,2,18037,3910,14127,0,0,0,1.0,1,1.0,1,1.0,1,0.1840366115216104,55
5224,1,18038,3911,14127,0,0,0,1.0,1,1.0,1,1.0,1,0.18424712700207277,56
5225,1,18039,3912,14127,0,0,0,1.0,1,1.0,1,1.0,1,0.20586253452452963,55
5226,1,18040,3913,14127,0,0,0,1.0,1,1.0,1,1.0,1,0.19509021192986573,55
5227,0,18040,3913,14127,0,0,0,1.0,1,1.0,1,1.0,1,0.1993766040862967,53
5228,1,18041,3914,14127,0,0,0,1.0,1,1.0,1,1.0,1,0.17304759408335338,51
5229,2,18043,3915,14128,0,0,0,1.0,1,1.0,1,1.0,1,0.154733519481686,51
5230,0,18043,3915,14128,0,0,0,1.0,1,1.0,1,1.0,1,0.15467142341578757,51
5231,2,18045,3916,14129,0,0,0,1.0,1,1.0,1,1.0,1,0.17409808150874678,52
5232,4,18049,3918,14131,0,0,0,1.0,1,1.0,1,1.0,1,0.17240745650757347,52
5233,1,18050,3918,14132,0,0,0,1.0,1,1.0,1,1.0,1,0.19040745098860035,53
5234,2,18052,3919,14133,0,0,0,1.0,1,1.0,1,1.0,1,0.2101661152352833,53
5235,2,18054,3920,14134,0,0,0,1.0,1,1.0,1,1.0,1,0.2103947317551237,53
5236,9,18063,3920,14143,0,0,0,1.0,1,1.0,1,1.0,1,0.1430255649392513,52
5237,5,18068,3920,14148,0,0,0,1.0,1,1.0,1,1.0,1,0.14355145955676932,52
5238,6,18074,3922,14152,0,0,0,1.0,1,1.0,1,1.0,1,0.1811436231262955,52
5239,3,18077,3922,14155,0,0,0,1.0,1,1.0,1,1.0,1,0.1624793131182795,51
5240,3,18080,3922,14158,0,0,0,1.0,1,1.0,1,1.0,1,0.1960606577431357,53
5241,6,18086,3922,14164,0,0,0,1.0,1,1.0,1,1.0,1,0.20967038607540028,53
5242,6,18092,3924,14168,0,0,0,1.0,1,1.0,1,1.0,1,0.21683261605242368,51
5243,13,18105,3926,14179,0,0,0,1.0,1,1.0,1,1.0,1,0.2095424699303689,51
5244,16,18121,3927,14194,0,0,0,1.0,1,1.0,1,1.0,1,0.23459448023842164,52
5245,15,18136,3929,14207,0,0,0,1.0,1,1.0,1,1.0,1,0.2951933606506788,53
5246,13,18149,3930,14219,0,0,0,1.0,1,1.0,1,1.0,1,0.24847752895499223,53
5247,16,18165,3931,14234,0,0,0,1.0,1,1.0,1,1.0,1,0.2730690877320912,54
5248,18,18183,3933,14250,0,0,0,1.0,1,1.0,1,1.0,1,0.26269249059049793,54
5249,10,18193,3934,14259,0,0,0,1.0,1,1.0,1,1.0,1,0.35423520847940815,55
5250,17,18210,3935,14275,0,0,0,1.0,1,1.0,1,1.0,1,0.28668976344309566,57
5251,12,18222,3935,14287,0,0,0,1.0,1,1.0,1,1.0,1,0.15584135555806397,58
5252,3,18225,3935,14290,0,0,0,1.0,1,1.0,1,1.0,1,0.14370501911742,58
5253,6,18231,3937,14294,0,0,0,1.0,1,1.0,1,1.0,1,0.17505600309977692,58
5254,6,18237,3938,14299,0,0,0,1.0,1,1.0,1,1.0,1,0.22790695351181414,59
5255,3,18240,3938,14302,0,0,0,1.0,1,1.0,1,1.0,1,0.1815379769700827,58
5256,3,18243,3938,14305,0,0,0,1.0,1,1.0,1,1.0,1,0.2019877505989008,58
5257,3,18246,3938,14308,0,0,0,1.0,1,1.0,1,1.0,1,0.1612441369213114,57
5258,3,18249,3939,14310,0,0,0,1.0,1,1.0,1,1.0,1,0.1944578101643107,55
5259,5,18254,3940,14314,0,0,0,1.0,1,1.0,1,1.0,1,0.1907808625237004,56
5260,4,18258,3940,14318,0,0,0,1.0,1,1.0,1,1.0,1,0.20579260488116902,55
5261,3,18261,3940,14321,0,0,0,1.0,1,1.0,1,1.0,1,0.24153866267945823,54
5262,5,18266,3941,14325,0,0,0,1.0,1,1.0,1,1.0,1,0.2535581757929409,54
5263,5,18271,3943,14328,0,0,0,1.0,1,1.0,1,1.0,1,0.23688458224195377,55
5264,2,18273,3943,14330,0,0,0,1.0,1,1.0,1,1.0,1,0.28935441312087057,53
5265,4,18277,3946,14331,0,0,0,1.0,1,1.0,1,1.0,1,0.2438814131652949,52
5266,6,18283,3946,14337,0,0,0,1.0,1,1.0,1,1.0,1,0.1929992435346317,49
5267,4,18287,3947,14340,0,0,0,1.0,1,1.0,1,1.0,1,0.20861445500063558,49
5268,2,18289,3947,14342,0,0,0,1.0,1,1.0,1,1.0,1,0.20739378304965062,46
5269,0,18289,3947,14342,0,0,0,1.0,1,1.0,1,1.0,1,0.2036704337431327,45
5270,7,18296,3949,14347,0,0,0,1.0,1,1.0,1,1.0,1,0.18271882427203323,46
5271,6,18302,3951,14351,0,0,0,1.0,1,1.0,1,1.0,1,0.16840176132791412,46
5272,4,18306,3951,14355,0,0,0,1.0,1,1.0,1,1.0,1,0.1939113863941419,45
5273,3,18309,3953,14356,0,0,0,1.0,1,1.0,1,1.0,1,0.19743746515474261,45
5274,2,18311,3953,14358,0,0,0,1.0,1,1.0,1,1.0,1,0.200590783182484,45
5275,6,18317,3956,14361,0,0,0,1.0,1,1.0,1,1.0,1,0.2627858092329815,46
5276,11,18328,3959,14369,0,0,0,1.0,1,1.0,1,1.0,1,0.28288335170165974,45
5277,7,18335,3960,14375,0,0,0,1.0,1,1.0,1,1.0,1,0.26092542683311637,45
5278,3,18338,3961,14377,0,0,0,1.0,1,1.0,1,1.0,1,0.27663772613203064,44
5279,3,18341,3961,14380,0,0,0,1.0,1,1.0,1,1.0,1,0.28164810493034914,45
5280,3,18344,3961,14383,0,0,0,1.0,1,1.0,1,1.0,1,0.26471278389704633,46
5281,8,18352,3961,14391,0,0,0,1.0,1,1.0,1,1.0,1,0.15532808890519295,46
5282,4,18356,3962,14394,0,0,0,1.0,1,1.0,1,1.0,1,0.17666622378688326,47
5283,5,18361,3962,14399,0,0,0,1.0,1,1.0,1,1.0,1,0.16777410349928426,48
5284,3,18364,3962,14402,0,0,0,1.0,1,1.0,1,1.0,1,0.17296780052008862,48
5285,1,18365,3962,14403,0,0,0,1.0,1,1.0,1,1.0,1,0.12864907015280863,48
5286,3,18368,3962,14406,0,0,0,1.0,1,1.0,1,1.0,1,0.11450604498095066,50
5287,3,18371,3962,14409,0,0,0,1.0,1,1.0,1,1.0,1,0.10678375807117334,50
5288,3,18374,3962,14412,0,0,0,1.0,1,1.0,1,1.0,1,0.11509006901780888,51
5289,2,18376,3962,14414,0,0,0,1.0,1,1.0,1,1.0,1,0.08878981817817477,51
5290,1,18377,3962,14415,0,0,0,1.0,1,1.0,1,1.0,1,0.1055973464476166,52
5291,7,18384,3964,14420,0,0,0,1.0,1,1.0,1,1.0,1,0.1520313986240554,52
5292,4,18388,3964,14424,0,0,0,1.0,1,1.0,1,1.0,1,0.159647968717364,53
5293,5,18393,3965,14428,0,0,0,1.0,1,1.0,1,1.0,1,0.18901264116573138,51
5294,3,18396,3965,14431,0,0,0,1.0,1,1.0,1,1.0,1,0.18301889339001573,50
5295,6,18402,3965,14437,0,0,0,1.0,1,1.0,1,1.0,1,0.2541661704977614,49
5296,4,18406,3966,14440,0,0,0,1.0,1,1.0,1,1.0,1,0.21477314038494769,48
5297,1,18407,3966,14441,0,0,0,1.0,1,1.0,1,1.0,1,0.24427924115731367,46
5298,0,18407,3966,14441,0,0,0,1.0,1,1.0,1,1.0,1,0.24505194907494565,46
5299,1,18408,3966,14442,0,0,0,1.0,1,1.0,1,1.0,1,0.24359618249485918,47
5300,1,18409,3966,14443,0,0,0,1.0,1,1.0,1,1.0,1,0.22764267355617238,48
5301,1,18410,3966,14444,0,0,0,1.0,1,1.0,1,1.0,1,0.2186222707588247,48
5302,3,18413,3968,14445,0,0,0,1.0,1,1.0,1,1.0,1,0.23462199934873307,49
5303,0,18413,3968,14445,0,0,0,1.0,1,1.0,1,1.0,1,0.22865910039062332,48
5304,1,18414,3969,14445,0,0,0,1.0,1,1.0,1,1.0,1,0.2231055530268745,48
5305,1,18415,3970,14445,0,0,0,1.0,1,1.0,1,1.0,1,0.2325184575422347,47
5306,3,18418,3973,14445,0,0,0,1.0,1,1.0,1,1.0,1,0.3074195629998094,48
5307,6,18424,3973,14451,0,0,0,1.0,1,1.0,1,1.0,1,0.2070557340552698,48
5308,1,18425,3974,14451,0,0,0,1.0,1,1.0,1,1.0,1,0.219314376872936,47
5309,1,18426,3975,14451,0,0,0,1.0,1,1.0,1,1.0,1,0.23517417321455195,46
5310,3,18429,3976,14453,0,0,0,1.0,1,1.0,1,1.0,1,0.22238691321918894,46
5311,4,18433,3976,14457,0,0,0,1.0,1,1.0,1,1.0,1,0.1311218717551459,46
5312,1,18434,3977,14457,0,0,0,1.0,1,1.0,1,1.0,1,0.15082346655162884,46
5313,2,18436,3977,14459,0,0,0,1.0,1,1.0,1,1.0,1,0.14555008461155444,46
5314,1,18437,3977,14460,0,0,0,1.0,1,1.0,1,1.0,1,0.14786968612773246,46
5315,7,18444,3979,14465,0,0,0,1.0,1,1.0,1,1.0,1,0.12337901908631957,47
5316,6,18450,3979,14471,0,0,0,1.0,1,1.0,1,1.0,1,0.1703514612659674,48
5317,8,18458,3980,14478,0,0,0,1.0,1,1.0,1,1.0,1,0.19379759768509144,49
5318,6,18464,3980,14484,0,0,0,1.0,1,1.0,1,1.0,1,0.1852167699294099,49
5319,7,18471,3981,14490,0,0,0,1.0,1,1.0,1,1.0,1,0.21316391351164105,50
5320,5,18476,3981,14495,0,0,0,1.0,1,1.0,1,1.0,1,0.1767072861265306,51
5321,4,18480,3981,14499,0,0,0,1.0,1,1.0,1,1.0,1,0.16840386221072495,52
5322,7,18487,3981,14506,0,0,0,1.0,1,1.0,1,1.0,1,0.12571996431354268,53
5323,5,18492,3981,14511,0,0,0,1.0,1,1.0,1,1.0,1,0.18766117002840915,53
5324,10,18502,3981,14521,0,0,0,1.0,1,1.0,1,1.0,1,0.21085011541148507,55
5325,7,18509,3981,14528,0,0,0,1.0,1,1.0,1,1.0,1,0.18639546553453118,55
5326,6,18515,3981,14534,0,0,0,1.0,1,1.0,1,1.0,1,0.10212697356313839,55
5327,2,18517,3981,14536,0,0,0,1.0,1,1.0,1,1.0,1,0.10743366787914775,56
5328,4,18521,3983,14538,0,0,0,1.0,1,1.0,1,1.0,1,0.11347547051427417,57
5329,0,18521,3983,14538,0,0,0,1.0,1,1.0,1,1.0,1,0.11347547051427417,57
5330,2,18523,3984,14539,0,0,0,1.0,1,1.0,1,1.0,1,0.12409330752293776,56
5331,4,18527,3985,14542,0,0,0,1.0,1,1.0,1,1.0,1,0.13124177509681595,57
5332,4,18531,3985,14546,0,0,0,1.0,1,1.0,1,1.0,1,0.10558722685217183,58
5333,8,18539,3986,14553,0,0,0,1.0,1,1.0,1,1.0,1,0.08718058238920265,59
5334,11,18550,3988,14562,0,0,0,1.0,1,1.0,1,1.0,1,0.13140852985690085,59
5335,7,18557,3988,14569,0,0,0,1.0,1,1.0,1,1.0,1,0.11432798696114782,58
5336,9,18566,3988,14578,0,0,0,1.0,1,1.0,1,1.0,1,0.10848979113037283,59
5337,9,18575,3989,14586,0,0,0,1.0,1,1.0,1,1.0,1,0.09139333991495932,60
5338,6,18581,3989,14592,0,0,0,1.0,1,1.0,1,1.0,1,0.10910199670937147,60
5339,5,18586,3989,14597,0,0,0,1.0,1,1.0,1,1.0,1,0.14484538452242524,60
5340,7,18593,3991,14602,0,0,0,1.0,1,1.0,1,1.0,1,0.1286255530220315,60
5341,3,18596,3991,14605,0,0,0,1.0,1,1.0,1,1.0,1,0.07212297376440518,61
5342,2,18598,3993,14605,0,0,0,1.0,1,1.0,1,1.0,1,0.1196673161998921,59
5343,5,18603,3994,14609,0,0,0,1.0,1,1.0,1,1.0,1,0.0795246270360009,58
5344,1,18604,3995,14609,0,0,0,1.0,1,1.0,1,1.0,1,0.1185777449953867,58
5345,1,18605,3996,14609,0,0,0,1.0,1,1.0,1,1.0,1,0.10750300836417649,54
5346,2,18607,3997,14610,0,0,0,1.0,1,1.0,1,1.0,1,0.11078399963846024,54
5347,0,18607,3997,14610,0,0,0,1.0,1,1.0,1,1.0,1,0.11167344542203468,54
5348,3,18610,3998,14612,0,0,0,1.0,1,1.0,1,1.0,1,0.11204278993485378,55
5349,1,18611,3999,14612,0,0,0,1.0,1,1.0,1,1.0,1,0.11359786438376526,56
5350,1,18612,3999,14613,0,0,0,1.0,1,1.0,1,1.0,1,0.11276272729446642,56
5351,4,18616,4001,14615,0,0,0,1.0,1,1.0,1,1.0,1,0.1379654549238347,57
5352,3,18619,4002,14617,0,0,0,1.0,1,1.0,1,1.0,1,0.11384510838812699,57
5353,0,18619,4002,14617,0,0,0,1.0,1,1.0,1,1.0,1,0.11384510838812699,57
5354,0,18619,4002,14617,0,0,0,1.0,1,1.0,1,1.0,1,0.11175100871167627,56
5355,1,18620,4003,14617,0,0,0,1.0,1,1.0,1,1.0,1,0.12056145650325256,57
5356,3,18623,4003,14620,0,0,0,1.0,1,1.0,1,1.0,1,0.11036782709116166,56
5357,1,18624,4003,14621,0,0,0,1.0,1,1.0,1,1.0,1,0.11626852008235998,56
5358,0,18624,4003,14621,0,0,0,1.0,1,1.0,1,1.0,1,0.10662087533027911,57
5359,1,18625,4004,14621,0,0,0,1.0,1,1.0,1,1.0,1,0.12904453448719877,57
5360,0,18625,4004,14621,0,0,0,1.0,1,1.0,1,1.0,1,0.1423661866355468,55
5361,4,18629,4006,14623,0,0,0,1.0,1,1.0,1,1.0,1,0.14927241131743912,56
5362,1,18630,4006,14624,0,0,0,1.0,1,1.0,1,1.0,1,0.13492427924514855,57
5363,2,18632,4007,14625,0,0,0,1.0,1,1.0,1,1.0,1,0.15916227230325186,57
5364,2,18634,4007,14627,0,0,0,1.0,1,1.0,1,1.0,1,0.1753808035907523,58
5365,2,18636,4007,14629,0,0,0,1.0,1,1.0,1,1.0,1,0.1509974420196122,59
5366,10,18646,4009,14637,0,0,0,1.0,1,1.0,1,1.0,1,0.17254627878557854,60
5367,6,18652,4010,14642,0,0,0,1.0,1,1.0,1,1.0,1,0.15662466554142632,60
5368,6,18658,4011,14647,0,0,0,1.0,1,1.0,1,1.0,1,0.14320774403009734,58
5369,1,18659,4012,14647,0,0,0,1.0,1,1.0,1,1.0,1,0.1543675021904031,58
5370,1,18660,4013,14647,0,0,0,1.0,1,1.0,1,1.0,1,0.17343008217010125,57
5371,8,18668,4015,14653,0,0,0,1.0,1,1.0,1,1.0,1,0.14659981297227043,56
5372,3,18671,4018,14653,0,0,0,1.0,1,1.0,1,1.0,1,0.17286895675564432,55
5373,3,18674,4020,14654,0,0,0,1.0,1,1.0,1,1.0,1,0.19257808490343292,54
5374,0,18674,4020,14654,0,0,0,1.0,1,1.0,1,1.0,1,0.1609093328976028,53
5375,2,18676,4021,14655,0,0,0,1.0,1,1.0,1,1.0,1,0.17793243163474742,52
5376,2,18678,4021,14657,0,0,0,1.0,1,1.0,1,1.0,1,0.15509638658768202,52
5377,3,18681,4023,14658,0,0,0,1.0,1,1.0,1,1.0,1,0.19515856438454524,51
5378,2,18683,4025,14658,0,0,0,1.0,1,1.0,1,1.0,1,0.2054873686533894,52
5379,1,18684,4026,14658,0,0,0,1.0,1,1.0,1,1.0,1,0.21607161015193832,50
5380,3,18687,4028,14659,0,0,0,1.0,1,1.0,1,1.0,1,0.2660389584130305,51
5381,2,18689,4029,14660,0,0,0,1.0,1,1.0,1,1.0,1,0.1985166293859738,50
5382,3,18692,4030,14662,0,0,0,1.0,1,1.0,1,1.0,1,0.17806723974364072,48
5383,1,18693,4030,14663,0,0,0,1.0,1,1.0,1,1.0,1,0.1820956300901869,48
5384,4,18697,4030,14667,0,0,0,1.0,1,1.0,1,1.0,1,0.17733984817569523,48
5385,0,18697,4030,14667,0,0,0,1.0,1,1.0,1,1.0,1,0.18768653670382004,47
5386,6,18703,4031,14672,0,0,0,1.0,1,1.0,1,1.0,1,0.12923232187115555,48
5387,0,18703,4031,14672,0,0,0,1.0,1,1.0,1,1.0,1,0.1313387904248023,48
5388,2,18705,4032,14673,0,0,0,1.0,1,1.0,1,1.0,1,0.10802449747147003,48
5389,4,18709,4033,14676,0,0,0,1.0,1,1.0,1,1.0,1,0.10347651474908148,50
5390,3,18712,4034,14678,0,0,0,1.0,1,1.0,1,1.0,1,0.14107723024562613,52
5391,1,18713,4034,14679,0,0,0,1.0,1,1.0,1,1.0,1,0.1477993182471593,52
5392,3,18716,4034,14682,0,0,0,1.0,1,1.0,1,1.0,1,0.15380090118314255,51
5393,4,18720,4034,14686,0,0,0,1.0,1,1.0,1,1.0,1,0.1635650021691493,50
5394,3,18723,4034,14689,0,0,0,1.0,1,1.0,1,1.0,1,0.15951959703881732,50
5395,3,18726,4036,14690,0,0,0,1.0,1,1.0,1,1.0,1,0.1856128277705874,49
5396,6,18732,4037,14695,0,0,0,1.0,1,1.0,1,1.0,1,0.1967960574155148,48
5397,6,18738,4039,14699,0,0,0,1.0,1,1.0,1,1.0,1,0.23889993037175142,48
5398,6,18744,4039,14705,0,0,0,1.0,1,1.0,1,1.0,1,0.2292588178747432,46
5399,7,18751,4041,14710,0,0,0,1.0,1,1.0,1,1.0,1,0.24977927844492182,46
5400,5,18756,4041,14715,0,0,0,1.0,1,1.0,1,1.0,1,0.2312711932704339,48
5401,11,18767,4041,14726,0,0,0,1.0,1,1.0,1,1.0,1,0.0703216577238787,49
5402,0,18767,4041,14726,0,0,0,1.0,1,1.0,1,1.0,1,0.0,0
