,SuccessfulHandoverCount,TotalSuccessfulHandoverCount,TotalSuccessfulHandoverCountRange,TotalSuccessfulHandoverCountLoadBalancing,TotalSuccessfulHandoverCountOverload,FailedHandoverCount,TotalFailedHandoverCount,AvgQoS,MinQoS,AvgQoS_LoadBased,MinQoS_LoadBased,AvgQoS_RangeBased,MinQoS_RangeBased,GiniLoad,VehicleCount
0,0,0,0,0,0,0,0,1.0,1,1.0,1,1.0,1,0.0,0
1,21,21,0,21,0,0,0,1.0,1,1.0,1,1.0,1,0.22146556179179222,30
2,17,38,0,38,0,0,0,1.0,1,1.0,1,1.0,1,0.23998861497877716,32
3,27,65,0,65,0,0,0,1.0,1,1.0,1,1.0,1,0.2620816184555264,33
4,4,69,0,69,0,0,0,1.0,1,1.0,1,1.0,1,0.19808098410390368,34
5,3,72,0,72,0,0,0,1.0,1,1.0,1,1.0,1,0.1600184232347665,36
6,3,75,0,75,0,0,0,1.0,1,1.0,1,1.0,1,0.1674625560733181,38
7,1,76,0,76,0,0,0,1.0,1,1.0,1,1.0,1,0.15439741637272222,40
8,0,76,0,76,0,0,0,1.0,1,1.0,1,1.0,1,0.15439741637272222,40
9,0,76,0,76,0,0,0,1.0,1,1.0,1,1.0,1,0.15439741637272222,40
10,0,76,0,76,0,0,0,1.0,1,1.0,1,1.0,1,0.16298713169811102,41
11,0,76,0,76,0,0,0,1.0,1,1.0,1,1.0,1,0.16852611601691653,40
12,2,78,1,77,0,0,0,1.0,1,1.0,1,1.0,1,0.10036923296032271,39
13,4,82,4,78,0,0,0,1.0,1,1.0,1,1.0,1,0.1561171618360895,37
14,1,83,4,79,0,0,0,1.0,1,1.0,1,1.0,1,0.16656717736879964,35
15,2,85,4,81,0,0,0,1.0,1,1.0,1,1.0,1,0.1517141335752837,36
16,2,87,5,82,0,0,0,1.0,1,1.0,1,1.0,1,0.1861286575666669,34
17,0,87,5,82,0,0,0,1.0,1,1.0,1,1.0,1,0.21007982685270535,33
18,0,87,5,82,0,0,0,1.0,1,1.0,1,1.0,1,0.22668897657734885,34
19,1,88,6,82,0,0,0,1.0,1,1.0,1,1.0,1,0.25037487730115343,34
20,0,88,6,82,0,0,0,1.0,1,1.0,1,1.0,1,0.22556039341892795,34
21,2,90,7,83,0,0,0,1.0,1,1.0,1,1.0,1,0.24046901682257024,36
22,5,95,7,88,0,0,0,1.0,1,1.0,1,1.0,1,0.19512208192418906,35
23,3,98,9,89,0,0,0,1.0,1,1.0,1,1.0,1,0.2149903526640428,35
24,1,99,10,89,0,0,0,1.0,1,1.0,1,1.0,1,0.1601050701535587,35
25,5,104,13,91,0,0,0,1.0,1,1.0,1,1.0,1,0.2142599450011632,35
26,4,108,15,93,0,0,0,1.0,1,1.0,1,1.0,1,0.21863895536826022,36
27,4,112,16,96,0,0,0,1.0,1,1.0,1,1.0,1,0.20597902541955934,34
28,10,122,18,104,0,0,0,1.0,1,1.0,1,1.0,1,0.08043922372286587,35
29,0,122,18,104,0,0,0,1.0,1,1.0,1,1.0,1,0.14003188786754542,33
30,3,125,19,106,0,0,0,1.0,1,1.0,1,1.0,1,0.0678983100439213,33
31,2,127,20,107,0,0,0,1.0,1,1.0,1,1.0,1,0.1395582332640198,33
32,0,127,20,107,0,0,0,1.0,1,1.0,1,1.0,1,0.1629771124373472,32
33,3,130,20,110,0,0,0,1.0,1,1.0,1,1.0,1,0.12411150930456195,33
34,1,131,20,111,0,0,0,1.0,1,1.0,1,1.0,1,0.09422103488465662,33
35,0,131,20,111,0,0,0,1.0,1,1.0,1,1.0,1,0.11311562207403109,35
36,4,135,22,113,0,0,0,1.0,1,1.0,1,1.0,1,0.20167694689931723,36
37,2,137,22,115,0,0,0,1.0,1,1.0,1,1.0,1,0.14921495398497528,37
38,1,138,23,115,0,0,0,1.0,1,1.0,1,1.0,1,0.16997094701314364,36
39,2,140,23,117,0,0,0,1.0,1,1.0,1,1.0,1,0.1859863446677478,38
40,2,142,23,119,0,0,0,1.0,1,1.0,1,1.0,1,0.10426831754942005,40
41,0,142,23,119,0,0,0,1.0,1,1.0,1,1.0,1,0.10426831754942005,40
42,2,144,25,119,0,0,0,1.0,1,1.0,1,1.0,1,0.14124590209153778,40
43,2,146,26,120,0,0,0,1.0,1,1.0,1,1.0,1,0.16844045375294084,43
44,0,146,26,120,0,0,0,1.0,1,1.0,1,1.0,1,0.16844045375294084,43
45,1,147,27,120,0,0,0,1.0,1,1.0,1,1.0,1,0.1833549105835059,44
46,1,148,27,121,0,0,0,1.0,1,1.0,1,1.0,1,0.16423651875420056,44
47,3,151,29,122,0,0,0,1.0,1,1.0,1,1.0,1,0.1846214579654218,44
48,3,154,30,124,0,0,0,1.0,1,1.0,1,1.0,1,0.20130403771503863,44
49,0,154,30,124,0,0,0,1.0,1,1.0,1,1.0,1,0.1791413617508543,41
50,1,155,31,124,0,0,0,1.0,1,1.0,1,1.0,1,0.15731411943886864,40
51,0,155,31,124,0,0,0,1.0,1,1.0,1,1.0,1,0.15366676011706826,38
52,1,156,31,125,0,0,0,1.0,1,1.0,1,1.0,1,0.14596707384737123,37
53,0,156,31,125,0,0,0,1.0,1,1.0,1,1.0,1,0.17402435197598587,38
54,0,156,31,125,0,0,0,1.0,1,1.0,1,1.0,1,0.18972113518847655,38
55,4,160,33,127,0,0,0,1.0,1,1.0,1,1.0,1,0.19089842947042954,38
56,3,163,33,130,0,0,0,1.0,1,1.0,1,1.0,1,0.18759541120752285,38
57,3,166,34,132,0,0,0,1.0,1,1.0,1,1.0,1,0.19696063355055857,38
58,3,169,36,133,0,0,0,1.0,1,1.0,1,1.0,1,0.17820363194653557,38
59,2,171,37,134,0,0,0,1.0,1,1.0,1,1.0,1,0.21323685317163152,40
60,1,172,38,134,0,0,0,1.0,1,1.0,1,1.0,1,0.22394562717425148,40
61,2,174,38,136,0,0,0,1.0,1,1.0,1,1.0,1,0.21172701908962951,40
62,4,178,39,139,0,0,0,1.0,1,1.0,1,1.0,1,0.15422124016610123,42
63,1,179,39,140,0,0,0,1.0,1,1.0,1,1.0,1,0.1558778880454075,40
64,0,179,39,140,0,0,0,1.0,1,1.0,1,1.0,1,0.1453896075870612,41
65,1,180,40,140,0,0,0,1.0,1,1.0,1,1.0,1,0.15899524578860924,41
66,0,180,40,140,0,0,0,1.0,1,1.0,1,1.0,1,0.15927971359611323,41
67,0,180,40,140,0,0,0,1.0,1,1.0,1,1.0,1,0.15927971359611323,41
68,1,181,40,141,0,0,0,1.0,1,1.0,1,1.0,1,0.12753100696467876,41
69,3,184,42,142,0,0,0,1.0,1,1.0,1,1.0,1,0.17372093678223272,41
70,3,187,42,145,0,0,0,1.0,1,1.0,1,1.0,1,0.1489739607936334,42
71,1,188,43,145,0,0,0,1.0,1,1.0,1,1.0,1,0.15164168552237964,44
72,3,191,43,148,0,0,0,1.0,1,1.0,1,1.0,1,0.09518556758546047,44
73,0,191,43,148,0,0,0,1.0,1,1.0,1,1.0,1,0.11325846780941623,46
74,0,191,43,148,0,0,0,1.0,1,1.0,1,1.0,1,0.1291683114719177,44
75,1,192,44,148,0,0,0,1.0,1,1.0,1,1.0,1,0.14148467703419665,44
76,5,197,46,151,0,0,0,1.0,1,1.0,1,1.0,1,0.1255825655811919,45
77,0,197,46,151,0,0,0,1.0,1,1.0,1,1.0,1,0.10578058688608757,44
78,1,198,47,151,0,0,0,1.0,1,1.0,1,1.0,1,0.1620319612831038,44
79,3,201,48,153,0,0,0,1.0,1,1.0,1,1.0,1,0.17106129572925008,43
80,1,202,49,153,0,0,0,1.0,1,1.0,1,1.0,1,0.1780175697486118,43
81,3,205,51,154,0,0,0,1.0,1,1.0,1,1.0,1,0.25050932476004023,44
82,6,211,54,157,0,0,0,1.0,1,1.0,1,1.0,1,0.2432345001080124,45
83,6,217,56,161,0,0,0,1.0,1,1.0,1,1.0,1,0.23820137354666557,45
84,1,218,56,162,0,0,0,1.0,1,1.0,1,1.0,1,0.24203894095541972,45
85,3,221,56,165,0,0,0,1.0,1,1.0,1,1.0,1,0.199164748738722,45
86,2,223,56,167,0,0,0,1.0,1,1.0,1,1.0,1,0.156006477726489,45
87,0,223,56,167,0,0,0,1.0,1,1.0,1,1.0,1,0.17359599044588242,44
88,0,223,56,167,0,0,0,1.0,1,1.0,1,1.0,1,0.1660540546072511,45
89,1,224,57,167,0,0,0,1.0,1,1.0,1,1.0,1,0.18843270814294075,46
90,0,224,57,167,0,0,0,1.0,1,1.0,1,1.0,1,0.21132324594943766,44
91,2,226,57,169,0,0,0,1.0,1,1.0,1,1.0,1,0.18211990785474924,45
92,0,226,57,169,0,0,0,1.0,1,1.0,1,1.0,1,0.18664728669302844,46
93,1,227,57,170,0,0,0,1.0,1,1.0,1,1.0,1,0.1810371421785628,46
94,0,227,57,170,0,0,0,1.0,1,1.0,1,1.0,1,0.1810371421785628,46
95,1,228,57,171,0,0,0,1.0,1,1.0,1,1.0,1,0.18985271607754417,46
96,0,228,57,171,0,0,0,1.0,1,1.0,1,1.0,1,0.18985271607754417,46
97,1,229,57,172,0,0,0,1.0,1,1.0,1,1.0,1,0.17171134863362586,47
98,0,229,57,172,0,0,0,1.0,1,1.0,1,1.0,1,0.17171134863362586,47
99,0,229,57,172,0,0,0,1.0,1,1.0,1,1.0,1,0.18696637966992197,46
100,2,231,58,173,0,0,0,1.0,1,1.0,1,1.0,1,0.20400523181326624,48
101,3,234,59,175,0,0,0,1.0,1,1.0,1,1.0,1,0.20068076248486005,49
102,1,235,60,175,0,0,0,1.0,1,1.0,1,1.0,1,0.2098335429468121,49
103,5,240,61,179,0,0,0,1.0,1,1.0,1,1.0,1,0.11830246187086998,48
104,2,242,63,179,0,0,0,1.0,1,1.0,1,1.0,1,0.14088540097093927,49
105,5,247,65,182,0,0,0,1.0,1,1.0,1,1.0,1,0.11035091729178084,48
106,3,250,67,183,0,0,0,1.0,1,1.0,1,1.0,1,0.10316873995643686,48
107,2,252,69,183,0,0,0,1.0,1,1.0,1,1.0,1,0.1641432730398828,47
108,1,253,70,183,0,0,0,1.0,1,1.0,1,1.0,1,0.15365031942887603,47
109,4,257,72,185,0,0,0,1.0,1,1.0,1,1.0,1,0.14094273092697304,47
110,2,259,72,187,0,0,0,1.0,1,1.0,1,1.0,1,0.11716062299884782,47
111,2,261,72,189,0,0,0,1.0,1,1.0,1,1.0,1,0.08771491156403381,46
112,3,264,74,190,0,0,0,1.0,1,1.0,1,1.0,1,0.08995902723812362,46
113,5,269,76,193,0,0,0,1.0,1,1.0,1,1.0,1,0.11102436629370543,45
114,0,269,76,193,0,0,0,1.0,1,1.0,1,1.0,1,0.10440894011893566,46
115,3,272,77,195,0,0,0,1.0,1,1.0,1,1.0,1,0.1196733908486223,47
116,0,272,77,195,0,0,0,1.0,1,1.0,1,1.0,1,0.10649217365974138,48
117,2,274,79,195,0,0,0,1.0,1,1.0,1,1.0,1,0.11241495197381418,48
118,0,274,79,195,0,0,0,1.0,1,1.0,1,1.0,1,0.11820961283529308,49
119,1,275,80,195,0,0,0,1.0,1,1.0,1,1.0,1,0.13417298626967675,50
120,1,276,80,196,0,0,0,1.0,1,1.0,1,1.0,1,0.11228124566927983,51
121,0,276,80,196,0,0,0,1.0,1,1.0,1,1.0,1,0.11228124566927983,51
122,0,276,80,196,0,0,0,1.0,1,1.0,1,1.0,1,0.11228124566927983,51
123,0,276,80,196,0,0,0,1.0,1,1.0,1,1.0,1,0.11228124566927983,51
124,0,276,80,196,0,0,0,1.0,1,1.0,1,1.0,1,0.11228124566927983,51
125,0,276,80,196,0,0,0,1.0,1,1.0,1,1.0,1,0.16740123879063418,50
126,3,279,82,197,0,0,0,1.0,1,1.0,1,1.0,1,0.15533944102069527,52
127,8,287,83,204,0,0,0,1.0,1,1.0,1,1.0,1,0.15267024803105272,50
128,3,290,83,207,0,0,0,1.0,1,1.0,1,1.0,1,0.16726826610731033,50
129,7,297,83,214,0,0,0,1.0,1,1.0,1,1.0,1,0.18687972259408675,52
130,7,304,84,220,0,0,0,1.0,1,1.0,1,1.0,1,0.14457515981556954,52
131,4,308,85,223,0,0,0,1.0,1,1.0,1,1.0,1,0.13548820486624652,54
132,7,315,86,229,0,0,0,1.0,1,1.0,1,1.0,1,0.12613873314014087,54
133,4,319,86,233,0,0,0,1.0,1,1.0,1,1.0,1,0.058914215886300934,52
134,0,319,86,233,0,0,0,1.0,1,1.0,1,1.0,1,0.05891301314805921,52
135,4,323,90,233,0,0,0,1.0,1,1.0,1,1.0,1,0.11576147994432796,51
136,4,327,91,236,0,0,0,1.0,1,1.0,1,1.0,1,0.06937875427783075,51
137,2,329,91,238,0,0,0,1.0,1,1.0,1,1.0,1,0.05450040315458464,50
138,2,331,92,239,0,0,0,1.0,1,1.0,1,1.0,1,0.062117044138515515,52
139,1,332,93,239,0,0,0,1.0,1,1.0,1,1.0,1,0.0747577644290689,51
140,2,334,94,240,0,0,0,1.0,1,1.0,1,1.0,1,0.0672275014487623,51
141,1,335,95,240,0,0,0,1.0,1,1.0,1,1.0,1,0.09674043609839168,50
142,1,336,96,240,0,0,0,1.0,1,1.0,1,1.0,1,0.11492472993850639,51
143,0,336,96,240,0,0,0,1.0,1,1.0,1,1.0,1,0.12727288237358234,48
144,2,338,98,240,0,0,0,1.0,1,1.0,1,1.0,1,0.1623185351354369,49
145,5,343,100,243,0,0,0,1.0,1,1.0,1,1.0,1,0.13958477751998266,47
146,3,346,102,244,0,0,0,1.0,1,1.0,1,1.0,1,0.1102881822032642,49
147,1,347,102,245,0,0,0,1.0,1,1.0,1,1.0,1,0.15110924663903788,46
148,2,349,103,246,0,0,0,1.0,1,1.0,1,1.0,1,0.10484040741488859,47
149,1,350,104,246,0,0,0,1.0,1,1.0,1,1.0,1,0.10781161236898393,46
150,0,350,104,246,0,0,0,1.0,1,1.0,1,1.0,1,0.09025471754728517,47
151,1,351,105,246,0,0,0,1.0,1,1.0,1,1.0,1,0.09799187955442466,46
152,0,351,105,246,0,0,0,1.0,1,1.0,1,1.0,1,0.12159704989928052,45
153,0,351,105,246,0,0,0,1.0,1,1.0,1,1.0,1,0.13200738451062094,46
154,1,352,105,247,0,0,0,1.0,1,1.0,1,1.0,1,0.14653923710406505,44
155,3,355,108,247,0,0,0,1.0,1,1.0,1,1.0,1,0.1832392784964075,45
156,5,360,109,251,0,0,0,1.0,1,1.0,1,1.0,1,0.15489707068533792,43
157,4,364,110,254,0,0,0,1.0,1,1.0,1,1.0,1,0.11455883088345654,42
158,2,366,110,256,0,0,0,1.0,1,1.0,1,1.0,1,0.10544487427911654,43
159,1,367,111,256,0,0,0,1.0,1,1.0,1,1.0,1,0.17046227119185653,44
160,3,370,111,259,0,0,0,1.0,1,1.0,1,1.0,1,0.09623734731537259,44
161,3,373,114,259,0,0,0,1.0,1,1.0,1,1.0,1,0.13612435791722108,44
162,2,375,115,260,0,0,0,1.0,1,1.0,1,1.0,1,0.16056150359533844,44
163,8,383,121,262,0,0,0,1.0,1,1.0,1,1.0,1,0.1875634891794017,44
164,3,386,122,264,0,0,0,1.0,1,1.0,1,1.0,1,0.15892821589180436,44
165,2,388,124,264,0,0,0,1.0,1,1.0,1,1.0,1,0.10410123584398374,43
166,2,390,124,266,0,0,0,1.0,1,1.0,1,1.0,1,0.11905700127785544,43
167,0,390,124,266,0,0,0,1.0,1,1.0,1,1.0,1,0.11587554030838297,42
168,1,391,125,266,0,0,0,1.0,1,1.0,1,1.0,1,0.16890973085600605,40
169,5,396,127,269,0,0,0,1.0,1,1.0,1,1.0,1,0.13926384087432297,41
170,1,397,127,270,0,0,0,1.0,1,1.0,1,1.0,1,0.16473538307001148,39
171,5,402,128,274,0,0,0,1.0,1,1.0,1,1.0,1,0.0803509505017451,39
172,0,402,128,274,0,0,0,1.0,1,1.0,1,1.0,1,0.07283006864269306,38
173,3,405,130,275,0,0,0,1.0,1,1.0,1,1.0,1,0.17988834831196018,38
174,1,406,130,276,0,0,0,1.0,1,1.0,1,1.0,1,0.12220238434993357,37
175,1,407,131,276,0,0,0,1.0,1,1.0,1,1.0,1,0.13235553347793702,36
176,0,407,131,276,0,0,0,1.0,1,1.0,1,1.0,1,0.13439963006147584,36
177,2,409,133,276,0,0,0,1.0,1,1.0,1,1.0,1,0.14641965952194866,38
178,3,412,134,278,0,0,0,1.0,1,1.0,1,1.0,1,0.16318936604138407,39
179,3,415,134,281,0,0,0,1.0,1,1.0,1,1.0,1,0.12208645303835947,40
180,1,416,135,281,0,0,0,1.0,1,1.0,1,1.0,1,0.1074923570443604,40
181,0,416,135,281,0,0,0,1.0,1,1.0,1,1.0,1,0.12645776608355,39
182,2,418,137,281,0,0,0,1.0,1,1.0,1,1.0,1,0.14595023928813225,40
183,2,420,139,281,0,0,0,1.0,1,1.0,1,1.0,1,0.2008540452419664,40
184,0,420,139,281,0,0,0,1.0,1,1.0,1,1.0,1,0.186977307299788,38
185,2,422,139,283,0,0,0,1.0,1,1.0,1,1.0,1,0.1476884744917415,38
186,3,425,142,283,0,0,0,1.0,1,1.0,1,1.0,1,0.22053542191773537,37
187,6,431,144,287,0,0,0,1.0,1,1.0,1,1.0,1,0.15049455690209154,36
188,3,434,145,289,0,0,0,1.0,1,1.0,1,1.0,1,0.17534531972541714,36
189,4,438,146,292,0,0,0,1.0,1,1.0,1,1.0,1,0.16825105883480956,36
190,3,441,147,294,0,0,0,1.0,1,1.0,1,1.0,1,0.1677271370341102,36
191,1,442,148,294,0,0,0,1.0,1,1.0,1,1.0,1,0.173331592996737,37
192,2,444,149,295,0,0,0,1.0,1,1.0,1,1.0,1,0.15778789066065738,37
193,2,446,149,297,0,0,0,1.0,1,1.0,1,1.0,1,0.0959019575055297,38
194,0,446,149,297,0,0,0,1.0,1,1.0,1,1.0,1,0.10065142313584109,39
195,2,448,150,298,0,0,0,1.0,1,1.0,1,1.0,1,0.10748656403285328,40
196,1,449,150,299,0,0,0,1.0,1,1.0,1,1.0,1,0.09563654391605551,40
197,2,451,150,301,0,0,0,1.0,1,1.0,1,1.0,1,0.10943833989163274,40
198,0,451,150,301,0,0,0,1.0,1,1.0,1,1.0,1,0.10943833989163274,40
199,1,452,151,301,0,0,0,1.0,1,1.0,1,1.0,1,0.1091813134137582,40
200,0,452,151,301,0,0,0,1.0,1,1.0,1,1.0,1,0.1091813134137582,40
201,1,453,152,301,0,0,0,1.0,1,1.0,1,1.0,1,0.14359642309271578,39
202,3,456,153,303,0,0,0,1.0,1,1.0,1,1.0,1,0.1535120832865967,40
203,3,459,155,304,0,0,0,1.0,1,1.0,1,1.0,1,0.17817643477210063,39
204,1,460,156,304,0,0,0,1.0,1,1.0,1,1.0,1,0.1352570031977678,38
205,1,461,157,304,0,0,0,1.0,1,1.0,1,1.0,1,0.14269089302898486,37
206,2,463,158,305,0,0,0,1.0,1,1.0,1,1.0,1,0.17970685176866077,36
207,3,466,159,307,0,0,0,1.0,1,1.0,1,1.0,1,0.13918848929059402,37
208,2,468,159,309,0,0,0,1.0,1,1.0,1,1.0,1,0.189788324884056,36
209,1,469,160,309,0,0,0,1.0,1,1.0,1,1.0,1,0.20672462906554043,36
210,2,471,161,310,0,0,0,1.0,1,1.0,1,1.0,1,0.23521763881171165,36
211,1,472,161,311,0,0,0,1.0,1,1.0,1,1.0,1,0.23677599781703146,34
212,2,474,162,312,0,0,0,1.0,1,1.0,1,1.0,1,0.24786076590628586,34
213,1,475,162,313,0,0,0,1.0,1,1.0,1,1.0,1,0.25813044815233405,36
214,2,477,162,315,0,0,0,1.0,1,1.0,1,1.0,1,0.20956341846254167,35
215,2,479,162,317,0,0,0,1.0,1,1.0,1,1.0,1,0.16329596407371802,35
216,2,481,162,319,0,0,0,1.0,1,1.0,1,1.0,1,0.15969952831722053,37
217,2,483,163,320,0,0,0,1.0,1,1.0,1,1.0,1,0.14909147061918707,37
218,3,486,166,320,0,0,0,1.0,1,1.0,1,1.0,1,0.17884452670083664,37
219,1,487,167,320,0,0,0,1.0,1,1.0,1,1.0,1,0.21282524134926437,37
220,4,491,168,323,0,0,0,1.0,1,1.0,1,1.0,1,0.1464434532963826,38
221,2,493,168,325,0,0,0,1.0,1,1.0,1,1.0,1,0.16304423824488662,39
222,2,495,169,326,0,0,0,1.0,1,1.0,1,1.0,1,0.15155576531743833,39
223,2,497,170,327,0,0,0,1.0,1,1.0,1,1.0,1,0.16881459034869953,40
224,3,500,171,329,0,0,0,1.0,1,1.0,1,1.0,1,0.10650539402359466,40
225,1,501,172,329,0,0,0,1.0,1,1.0,1,1.0,1,0.1493970875056102,39
226,4,505,174,331,0,0,0,1.0,1,1.0,1,1.0,1,0.13920405077556003,39
227,2,507,175,332,0,0,0,1.0,1,1.0,1,1.0,1,0.19576912528778262,39
228,5,512,178,334,0,0,0,1.0,1,1.0,1,1.0,1,0.21007533614325677,38
229,6,518,180,338,0,0,0,1.0,1,1.0,1,1.0,1,0.1349179210351201,39
230,2,520,181,339,0,0,0,1.0,1,1.0,1,1.0,1,0.09781042318849636,38
231,4,524,183,341,0,0,0,1.0,1,1.0,1,1.0,1,0.14268328545407907,38
232,3,527,185,342,0,0,0,1.0,1,1.0,1,1.0,1,0.1721918762767332,37
233,0,527,185,342,0,0,0,1.0,1,1.0,1,1.0,1,0.160729952340265,36
234,0,527,185,342,0,0,0,1.0,1,1.0,1,1.0,1,0.17854233653696622,34
235,3,530,187,343,0,0,0,1.0,1,1.0,1,1.0,1,0.2221539071944792,34
236,0,530,187,343,0,0,0,1.0,1,1.0,1,1.0,1,0.23126777698576806,33
237,0,530,187,343,0,0,0,1.0,1,1.0,1,1.0,1,0.2553471259335015,32
238,3,533,187,346,0,0,0,1.0,1,1.0,1,1.0,1,0.21061250288642483,32
239,2,535,189,346,0,0,0,1.0,1,1.0,1,1.0,1,0.22765092135579934,31
240,1,536,189,347,0,0,0,1.0,1,1.0,1,1.0,1,0.27968568822460543,28
241,2,538,190,348,0,0,0,1.0,1,1.0,1,1.0,1,0.27523243915733137,27
242,1,539,190,349,0,0,0,1.0,1,1.0,1,1.0,1,0.2626702231012855,29
243,1,540,191,349,0,0,0,1.0,1,1.0,1,1.0,1,0.24198339221414275,28
244,1,541,191,350,0,0,0,1.0,1,1.0,1,1.0,1,0.1913488557753515,28
245,2,543,191,352,0,0,0,1.0,1,1.0,1,1.0,1,0.12673350815261034,27
246,2,545,193,352,0,0,0,1.0,1,1.0,1,1.0,1,0.14957780469206086,25
247,1,546,193,353,0,0,0,1.0,1,1.0,1,1.0,1,0.16314106259161912,26
248,0,546,193,353,0,0,0,1.0,1,1.0,1,1.0,1,0.17118709580625904,27
249,3,549,195,354,0,0,0,1.0,1,1.0,1,1.0,1,0.20763552532411111,26
250,1,550,195,355,0,0,0,1.0,1,1.0,1,1.0,1,0.20109458957415427,27
251,1,551,195,356,0,0,0,1.0,1,1.0,1,1.0,1,0.19299533016021128,28
252,1,552,196,356,0,0,0,1.0,1,1.0,1,1.0,1,0.24056040222300126,28
253,2,554,197,357,0,0,0,1.0,1,1.0,1,1.0,1,0.20197881363079456,28
254,2,556,198,358,0,0,0,1.0,1,1.0,1,1.0,1,0.22539317783165053,29
255,1,557,199,358,0,0,0,1.0,1,1.0,1,1.0,1,0.28166250624657463,30
256,1,558,199,359,0,0,0,1.0,1,1.0,1,1.0,1,0.24670266690671344,30
257,0,558,199,359,0,0,0,1.0,1,1.0,1,1.0,1,0.24610316361893347,32
258,0,558,199,359,0,0,0,1.0,1,1.0,1,1.0,1,0.24610316361893347,32
259,2,560,199,361,0,0,0,1.0,1,1.0,1,1.0,1,0.21962894017886356,32
260,2,562,199,363,0,0,0,1.0,1,1.0,1,1.0,1,0.14944041171130215,34
261,3,565,199,366,0,0,0,1.0,1,1.0,1,1.0,1,0.11444426625267,35
262,4,569,201,368,0,0,0,1.0,1,1.0,1,1.0,1,0.16164979094445195,36
263,1,570,201,369,0,0,0,1.0,1,1.0,1,1.0,1,0.15860133763897205,34
264,1,571,202,369,0,0,0,1.0,1,1.0,1,1.0,1,0.17233068893102543,34
265,0,571,202,369,0,0,0,1.0,1,1.0,1,1.0,1,0.20375799714071974,33
266,2,573,202,371,0,0,0,1.0,1,1.0,1,1.0,1,0.1725816250216904,34
267,0,573,202,371,0,0,0,1.0,1,1.0,1,1.0,1,0.1925342387557372,33
268,1,574,202,372,0,0,0,1.0,1,1.0,1,1.0,1,0.19185441183854357,34
269,0,574,202,372,0,0,0,1.0,1,1.0,1,1.0,1,0.19185441183854357,34
270,0,574,202,372,0,0,0,1.0,1,1.0,1,1.0,1,0.20669262682735068,36
271,0,574,202,372,0,0,0,1.0,1,1.0,1,1.0,1,0.20669262682735068,36
272,1,575,202,373,0,0,0,1.0,1,1.0,1,1.0,1,0.2132744414035947,38
273,1,576,202,374,0,0,0,1.0,1,1.0,1,1.0,1,0.1944984740937199,38
274,6,582,204,378,0,0,0,1.0,1,1.0,1,1.0,1,0.19112958822385945,38
275,1,583,204,379,0,0,0,1.0,1,1.0,1,1.0,1,0.1843170491111253,38
276,1,584,204,380,0,0,0,1.0,1,1.0,1,1.0,1,0.18434651039966585,39
277,2,586,205,381,0,0,0,1.0,1,1.0,1,1.0,1,0.18302911337307656,38
278,1,587,205,382,0,0,0,1.0,1,1.0,1,1.0,1,0.17123290680432204,38
279,1,588,205,383,0,0,0,1.0,1,1.0,1,1.0,1,0.13773383426102945,38
280,2,590,206,384,0,0,0,1.0,1,1.0,1,1.0,1,0.16974673082986888,38
281,0,590,206,384,0,0,0,1.0,1,1.0,1,1.0,1,0.15259575505594708,38
282,0,590,206,384,0,0,0,1.0,1,1.0,1,1.0,1,0.13588214829243314,38
283,1,591,206,385,0,0,0,1.0,1,1.0,1,1.0,1,0.1275185696462545,38
284,0,591,206,385,0,0,0,1.0,1,1.0,1,1.0,1,0.13314207142412945,39
285,2,593,207,386,0,0,0,1.0,1,1.0,1,1.0,1,0.15132535399069177,39
286,1,594,207,387,0,0,0,1.0,1,1.0,1,1.0,1,0.14547872148330337,39
287,4,598,209,389,0,0,0,1.0,1,1.0,1,1.0,1,0.18041258448452824,39
288,1,599,209,390,0,0,0,1.0,1,1.0,1,1.0,1,0.16124366966765508,39
289,2,601,209,392,0,0,0,1.0,1,1.0,1,1.0,1,0.1275270041540051,39
290,2,603,210,393,0,0,0,1.0,1,1.0,1,1.0,1,0.12020707336724293,39
291,0,603,210,393,0,0,0,1.0,1,1.0,1,1.0,1,0.12020707336724293,39
292,2,605,211,394,0,0,0,1.0,1,1.0,1,1.0,1,0.1259766382098576,40
293,3,608,212,396,0,0,0,1.0,1,1.0,1,1.0,1,0.11444615134355889,41
294,3,611,213,398,0,0,0,1.0,1,1.0,1,1.0,1,0.1045677322314326,40
295,4,615,215,400,0,0,0,1.0,1,1.0,1,1.0,1,0.09465677362506703,42
296,2,617,217,400,0,0,0,1.0,1,1.0,1,1.0,1,0.11014026562290213,42
297,0,617,217,400,0,0,0,1.0,1,1.0,1,1.0,1,0.10991377698618825,43
298,2,619,218,401,0,0,0,1.0,1,1.0,1,1.0,1,0.13524584104251483,44
299,1,620,218,402,0,0,0,1.0,1,1.0,1,1.0,1,0.11278885496044454,44
300,6,626,218,408,0,0,0,1.0,1,1.0,1,1.0,1,0.05562530970322671,45
301,1,627,219,408,0,0,0,1.0,1,1.0,1,1.0,1,0.08855498963980087,47
302,3,630,220,410,0,0,0,1.0,1,1.0,1,1.0,1,0.08704768480440146,46
303,3,633,223,410,0,0,0,1.0,1,1.0,1,1.0,1,0.12490267647552011,45
304,5,638,226,412,0,0,0,1.0,1,1.0,1,1.0,1,0.16618234475733432,45
305,0,638,226,412,0,0,0,1.0,1,1.0,1,1.0,1,0.1584212188276511,43
306,1,639,226,413,0,0,0,1.0,1,1.0,1,1.0,1,0.17894305302504765,44
307,7,646,227,419,0,0,0,1.0,1,1.0,1,1.0,1,0.09930780481938303,42
308,4,650,228,422,0,0,0,1.0,1,1.0,1,1.0,1,0.12685859355270332,41
309,1,651,228,423,0,0,0,1.0,1,1.0,1,1.0,1,0.12006309456365769,42
310,3,654,228,426,0,0,0,1.0,1,1.0,1,1.0,1,0.10276312533409336,41
311,0,654,228,426,0,0,0,1.0,1,1.0,1,1.0,1,0.10276312533409336,41
312,2,656,229,427,0,0,0,1.0,1,1.0,1,1.0,1,0.1318695131444238,44
313,0,656,229,427,0,0,0,1.0,1,1.0,1,1.0,1,0.11669547001817782,43
314,2,658,230,428,0,0,0,1.0,1,1.0,1,1.0,1,0.11201537725183584,43
315,1,659,230,429,0,0,0,1.0,1,1.0,1,1.0,1,0.09476261145169906,43
316,2,661,231,430,0,0,0,1.0,1,1.0,1,1.0,1,0.07968931409851311,43
317,0,661,231,430,0,0,0,1.0,1,1.0,1,1.0,1,0.09391489283215249,44
318,3,664,234,430,0,0,0,1.0,1,1.0,1,1.0,1,0.1841166540152455,45
319,4,668,234,434,0,0,0,1.0,1,1.0,1,1.0,1,0.1406202410785821,46
320,0,668,234,434,0,0,0,1.0,1,1.0,1,1.0,1,0.1606616388760511,45
321,0,668,234,434,0,0,0,1.0,1,1.0,1,1.0,1,0.14659203492490824,44
322,1,669,234,435,0,0,0,1.0,1,1.0,1,1.0,1,0.1300901936654771,42
323,2,671,236,435,0,0,0,1.0,1,1.0,1,1.0,1,0.07446764446852887,42
324,0,671,236,435,0,0,0,1.0,1,1.0,1,1.0,1,0.07096453873744966,43
325,1,672,237,435,0,0,0,1.0,1,1.0,1,1.0,1,0.10454719278198907,43
326,0,672,237,435,0,0,0,1.0,1,1.0,1,1.0,1,0.10454719278198907,43
327,1,673,238,435,0,0,0,1.0,1,1.0,1,1.0,1,0.13794962170053424,44
328,1,674,239,435,0,0,0,1.0,1,1.0,1,1.0,1,0.14055661667634153,44
329,2,676,240,436,0,0,0,1.0,1,1.0,1,1.0,1,0.12465421766963876,45
330,1,677,240,437,0,0,0,1.0,1,1.0,1,1.0,1,0.11997863825921617,46
331,0,677,240,437,0,0,0,1.0,1,1.0,1,1.0,1,0.11997863825921617,46
332,1,678,240,438,0,0,0,1.0,1,1.0,1,1.0,1,0.09944795422177889,47
333,1,679,240,439,0,0,0,1.0,1,1.0,1,1.0,1,0.10458539474338364,48
334,0,679,240,439,0,0,0,1.0,1,1.0,1,1.0,1,0.10458539474338364,48
335,1,680,241,439,0,0,0,1.0,1,1.0,1,1.0,1,0.11685954822938761,49
336,2,682,241,441,0,0,0,1.0,1,1.0,1,1.0,1,0.10757872015728003,50
337,1,683,242,441,0,0,0,1.0,1,1.0,1,1.0,1,0.12011574011162765,51
338,1,684,243,441,0,0,0,1.0,1,1.0,1,1.0,1,0.14812995805050005,51
339,2,686,243,443,0,0,0,1.0,1,1.0,1,1.0,1,0.12536277459653217,51
340,3,689,244,445,0,0,0,1.0,1,1.0,1,1.0,1,0.11894407212643109,51
341,0,689,244,445,0,0,0,1.0,1,1.0,1,1.0,1,0.11904017821350286,51
342,1,690,245,445,0,0,0,1.0,1,1.0,1,1.0,1,0.14214776626055722,51
343,2,692,245,447,0,0,0,1.0,1,1.0,1,1.0,1,0.11914815604678451,51
344,1,693,246,447,0,0,0,1.0,1,1.0,1,1.0,1,0.130439718210314,50
345,0,693,246,447,0,0,0,1.0,1,1.0,1,1.0,1,0.130439718210314,50
346,5,698,249,449,0,0,0,1.0,1,1.0,1,1.0,1,0.1823902836551132,50
347,5,703,249,454,0,0,0,1.0,1,1.0,1,1.0,1,0.14942794077679863,51
348,5,708,250,458,0,0,0,1.0,1,1.0,1,1.0,1,0.1639341416180044,52
349,4,712,252,460,0,0,0,1.0,1,1.0,1,1.0,1,0.15767118968212165,54
350,6,718,252,466,0,0,0,1.0,1,1.0,1,1.0,1,0.14465044713757974,54
351,2,720,254,466,0,0,0,1.0,1,1.0,1,1.0,1,0.16569279033173484,54
352,1,721,254,467,0,0,0,1.0,1,1.0,1,1.0,1,0.16192992273382506,56
353,3,724,256,468,0,0,0,1.0,1,1.0,1,1.0,1,0.14914459146304757,54
354,1,725,256,469,0,0,0,1.0,1,1.0,1,1.0,1,0.118808842230492,53
355,2,727,257,470,0,0,0,1.0,1,1.0,1,1.0,1,0.10470978285107467,54
356,1,728,258,470,0,0,0,1.0,1,1.0,1,1.0,1,0.12208498673902186,54
357,3,731,261,470,0,0,0,1.0,1,1.0,1,1.0,1,0.15676711928501413,53
358,5,736,261,475,0,0,0,1.0,1,1.0,1,1.0,1,0.09743517158662789,49
359,0,736,261,475,0,0,0,1.0,1,1.0,1,1.0,1,0.1048708289046673,48
360,1,737,261,476,0,0,0,1.0,1,1.0,1,1.0,1,0.1178633903423384,47
361,0,737,261,476,0,0,0,1.0,1,1.0,1,1.0,1,0.11180827896952916,46
362,0,737,261,476,0,0,0,1.0,1,1.0,1,1.0,1,0.11220565912780593,46
363,2,739,261,478,0,0,0,1.0,1,1.0,1,1.0,1,0.10196079709187322,47
364,0,739,261,478,0,0,0,1.0,1,1.0,1,1.0,1,0.10196079709187322,47
365,2,741,262,479,0,0,0,1.0,1,1.0,1,1.0,1,0.10971702985060215,47
366,6,747,264,483,0,0,0,1.0,1,1.0,1,1.0,1,0.12170533579002213,50
367,2,749,265,484,0,0,0,1.0,1,1.0,1,1.0,1,0.11436517002893382,50
368,1,750,265,485,0,0,0,1.0,1,1.0,1,1.0,1,0.08115707127660923,51
369,0,750,265,485,0,0,0,1.0,1,1.0,1,1.0,1,0.09860882995360168,51
370,1,751,265,486,0,0,0,1.0,1,1.0,1,1.0,1,0.0742017803158711,51
371,1,752,266,486,0,0,0,1.0,1,1.0,1,1.0,1,0.1275391192424826,52
372,1,753,266,487,0,0,0,1.0,1,1.0,1,1.0,1,0.12459513321041692,53
373,4,757,268,489,0,0,0,1.0,1,1.0,1,1.0,1,0.11865401280190248,53
374,4,761,269,492,0,0,0,1.0,1,1.0,1,1.0,1,0.12295001942117491,53
375,4,765,271,494,0,0,0,1.0,1,1.0,1,1.0,1,0.13622808451264032,53
376,4,769,271,498,0,0,0,1.0,1,1.0,1,1.0,1,0.09695200302899065,53
377,3,772,273,499,0,0,0,1.0,1,1.0,1,1.0,1,0.1235092609297423,53
378,3,775,274,501,0,0,0,1.0,1,1.0,1,1.0,1,0.13383857300329097,53
379,5,780,275,505,0,0,0,1.0,1,1.0,1,1.0,1,0.09189489009850335,54
380,0,780,275,505,0,0,0,1.0,1,1.0,1,1.0,1,0.09189489009850335,54
381,2,782,276,506,0,0,0,1.0,1,1.0,1,1.0,1,0.09433455748900747,54
382,1,783,277,506,0,0,0,1.0,1,1.0,1,1.0,1,0.1049217206071184,55
383,1,784,278,506,0,0,0,1.0,1,1.0,1,1.0,1,0.12486717485143464,55
384,0,784,278,506,0,0,0,1.0,1,1.0,1,1.0,1,0.1375430169059626,54
385,2,786,279,507,0,0,0,1.0,1,1.0,1,1.0,1,0.10912273202719076,52
386,3,789,280,509,0,0,0,1.0,1,1.0,1,1.0,1,0.10483546797170128,52
387,2,791,281,510,0,0,0,1.0,1,1.0,1,1.0,1,0.10776070029683708,50
388,4,795,282,513,0,0,0,1.0,1,1.0,1,1.0,1,0.0952503091165436,52
389,3,798,283,515,0,0,0,1.0,1,1.0,1,1.0,1,0.06813146416760618,51
390,3,801,285,516,0,0,0,1.0,1,1.0,1,1.0,1,0.09545932756572603,50
391,5,806,289,517,0,0,0,1.0,1,1.0,1,1.0,1,0.08767808795328096,49
392,1,807,290,517,0,0,0,1.0,1,1.0,1,1.0,1,0.14707619221668497,47
393,5,812,292,520,0,0,0,1.0,1,1.0,1,1.0,1,0.21284702767436292,47
394,12,824,295,529,0,0,0,1.0,1,1.0,1,1.0,1,0.13687281950145266,48
395,6,830,297,533,0,0,0,1.0,1,1.0,1,1.0,1,0.158849770897,46
396,3,833,299,534,0,0,0,1.0,1,1.0,1,1.0,1,0.2556920681259958,43
397,5,838,299,539,0,0,0,1.0,1,1.0,1,1.0,1,0.1559621844712425,42
398,0,838,299,539,0,0,0,1.0,1,1.0,1,1.0,1,0.15986488614901273,40
399,1,839,299,540,0,0,0,1.0,1,1.0,1,1.0,1,0.1323516916840259,39
400,3,842,300,542,0,0,0,1.0,1,1.0,1,1.0,1,0.09541768621243714,38
401,0,842,300,542,0,0,0,1.0,1,1.0,1,1.0,1,0.12129089213967867,37
402,0,842,300,542,0,0,0,1.0,1,1.0,1,1.0,1,0.13618957233297196,36
403,1,843,301,542,0,0,0,1.0,1,1.0,1,1.0,1,0.11613384801611193,38
404,2,845,302,543,0,0,0,1.0,1,1.0,1,1.0,1,0.14792265624481346,39
405,1,846,302,544,0,0,0,1.0,1,1.0,1,1.0,1,0.13724345486402567,40
406,3,849,303,546,0,0,0,1.0,1,1.0,1,1.0,1,0.14124019150466222,41
407,1,850,303,547,0,0,0,1.0,1,1.0,1,1.0,1,0.1279238503559834,42
408,3,853,304,549,0,0,0,1.0,1,1.0,1,1.0,1,0.13823325582122503,43
409,2,855,305,550,0,0,0,1.0,1,1.0,1,1.0,1,0.13123003277899895,44
410,1,856,305,551,0,0,0,1.0,1,1.0,1,1.0,1,0.13331814374653347,46
411,1,857,306,551,0,0,0,1.0,1,1.0,1,1.0,1,0.14646709113110187,46
412,1,858,306,552,0,0,0,1.0,1,1.0,1,1.0,1,0.12734734484487137,47
413,0,858,306,552,0,0,0,1.0,1,1.0,1,1.0,1,0.12734734484487137,47
414,1,859,306,553,0,0,0,1.0,1,1.0,1,1.0,1,0.10003803557517402,47
415,0,859,306,553,0,0,0,1.0,1,1.0,1,1.0,1,0.12063179317719512,48
416,3,862,308,554,0,0,0,1.0,1,1.0,1,1.0,1,0.16011463531499873,49
417,2,864,308,556,0,0,0,1.0,1,1.0,1,1.0,1,0.14440472602580262,49
418,3,867,309,558,0,0,0,1.0,1,1.0,1,1.0,1,0.14527487058103908,50
419,0,867,309,558,0,0,0,1.0,1,1.0,1,1.0,1,0.14527487058103908,50
420,1,868,309,559,0,0,0,1.0,1,1.0,1,1.0,1,0.1459554325589772,50
421,1,869,309,560,0,0,0,1.0,1,1.0,1,1.0,1,0.1332052897486371,50
422,0,869,309,560,0,0,0,1.0,1,1.0,1,1.0,1,0.1522288994690124,50
423,3,872,311,561,0,0,0,1.0,1,1.0,1,1.0,1,0.1732274111780023,51
424,3,875,312,563,0,0,0,1.0,1,1.0,1,1.0,1,0.15227954975016353,49
425,0,875,312,563,0,0,0,1.0,1,1.0,1,1.0,1,0.1683378445269777,48
426,4,879,313,566,0,0,0,1.0,1,1.0,1,1.0,1,0.11910850054610073,50
427,3,882,315,567,0,0,0,1.0,1,1.0,1,1.0,1,0.12398272843598288,48
428,6,888,318,570,0,0,0,1.0,1,1.0,1,1.0,1,0.1663184257197857,49
429,1,889,319,570,0,0,0,1.0,1,1.0,1,1.0,1,0.15350421464952707,45
430,6,895,321,574,0,0,0,1.0,1,1.0,1,1.0,1,0.13852545989665827,44
431,1,896,321,575,0,0,0,1.0,1,1.0,1,1.0,1,0.13269135652930497,42
432,1,897,322,575,0,0,0,1.0,1,1.0,1,1.0,1,0.17078770938842266,40
433,5,902,323,579,0,0,0,1.0,1,1.0,1,1.0,1,0.14327036045539485,39
434,4,906,324,582,0,0,0,1.0,1,1.0,1,1.0,1,0.06851101170940009,39
435,3,909,326,583,0,0,0,1.0,1,1.0,1,1.0,1,0.15174571449225063,38
436,1,910,326,584,0,0,0,1.0,1,1.0,1,1.0,1,0.14663554972922258,38
437,1,911,326,585,0,0,0,1.0,1,1.0,1,1.0,1,0.1439185943240219,39
438,0,911,326,585,0,0,0,1.0,1,1.0,1,1.0,1,0.15547031306202663,38
439,1,912,326,586,0,0,0,1.0,1,1.0,1,1.0,1,0.15490464679188184,39
440,0,912,326,586,0,0,0,1.0,1,1.0,1,1.0,1,0.15490464679188184,39
441,3,915,327,588,0,0,0,1.0,1,1.0,1,1.0,1,0.11025747101032517,41
442,3,918,328,590,0,0,0,1.0,1,1.0,1,1.0,1,0.1147877090008335,42
443,1,919,329,590,0,0,0,1.0,1,1.0,1,1.0,1,0.14103533003065713,42
444,0,919,329,590,0,0,0,1.0,1,1.0,1,1.0,1,0.13992635668542336,43
445,4,923,329,594,0,0,0,1.0,1,1.0,1,1.0,1,0.09248592150725547,44
446,2,925,329,596,0,0,0,1.0,1,1.0,1,1.0,1,0.12060458183911184,44
447,4,929,330,599,0,0,0,1.0,1,1.0,1,1.0,1,0.1686128235280176,47
448,3,932,330,602,0,0,0,1.0,1,1.0,1,1.0,1,0.1415184646758942,46
449,0,932,330,602,0,0,0,1.0,1,1.0,1,1.0,1,0.1415184646758942,46
450,0,932,330,602,0,0,0,1.0,1,1.0,1,1.0,1,0.14173741199930043,46
451,3,935,330,605,0,0,0,1.0,1,1.0,1,1.0,1,0.11334761278326759,47
452,0,935,330,605,0,0,0,1.0,1,1.0,1,1.0,1,0.12739716359448164,47
453,0,935,330,605,0,0,0,1.0,1,1.0,1,1.0,1,0.12739716359448164,47
454,2,937,330,607,0,0,0,1.0,1,1.0,1,1.0,1,0.09269119183974137,46
455,3,940,331,609,0,0,0,1.0,1,1.0,1,1.0,1,0.08341652660393246,47
456,2,942,331,611,0,0,0,1.0,1,1.0,1,1.0,1,0.0773146084320557,49
457,0,942,331,611,0,0,0,1.0,1,1.0,1,1.0,1,0.07302466044215404,50
458,0,942,331,611,0,0,0,1.0,1,1.0,1,1.0,1,0.07302466044215404,50
459,0,942,331,611,0,0,0,1.0,1,1.0,1,1.0,1,0.06836648065101703,52
460,0,942,331,611,0,0,0,1.0,1,1.0,1,1.0,1,0.07284072005803115,53
461,2,944,331,613,0,0,0,1.0,1,1.0,1,1.0,1,0.058912020295803474,54
462,2,946,331,615,0,0,0,1.0,1,1.0,1,1.0,1,0.050849516879023934,54
463,4,950,333,617,0,0,0,1.0,1,1.0,1,1.0,1,0.04729390660336732,55
464,1,951,334,617,0,0,0,1.0,1,1.0,1,1.0,1,0.06976915413573165,56
465,1,952,335,617,0,0,0,1.0,1,1.0,1,1.0,1,0.06661008492098353,54
466,3,955,337,618,0,0,0,1.0,1,1.0,1,1.0,1,0.10532694835536167,54
467,3,958,339,619,0,0,0,1.0,1,1.0,1,1.0,1,0.12727142432603994,51
468,7,965,344,621,0,0,0,1.0,1,1.0,1,1.0,1,0.13327877118202625,51
469,4,969,345,624,0,0,0,1.0,1,1.0,1,1.0,1,0.06887632669069722,48
470,3,972,348,624,0,0,0,1.0,1,1.0,1,1.0,1,0.10200621986397192,47
471,4,976,352,624,0,0,0,1.0,1,1.0,1,1.0,1,0.1791342561579361,44
472,8,984,356,628,0,0,0,1.0,1,1.0,1,1.0,1,0.16899068746949916,43
473,1,985,356,629,0,0,0,1.0,1,1.0,1,1.0,1,0.15702989471859619,41
474,1,986,357,629,0,0,0,1.0,1,1.0,1,1.0,1,0.18851421582684585,39
475,5,991,358,633,0,0,0,1.0,1,1.0,1,1.0,1,0.13759251280394358,40
476,5,996,361,635,0,0,0,1.0,1,1.0,1,1.0,1,0.1876360996128301,38
477,2,998,362,636,0,0,0,1.0,1,1.0,1,1.0,1,0.25734380967631504,35
478,4,1002,362,640,0,0,0,1.0,1,1.0,1,1.0,1,0.18497691971508992,35
479,1,1003,363,640,0,0,0,1.0,1,1.0,1,1.0,1,0.2352841959560474,32
480,0,1003,363,640,0,0,0,1.0,1,1.0,1,1.0,1,0.27591287215837446,32
481,2,1005,363,642,0,0,0,1.0,1,1.0,1,1.0,1,0.22714092674518518,33
482,1,1006,364,642,0,0,0,1.0,1,1.0,1,1.0,1,0.2269914825408985,34
483,1,1007,364,643,0,0,0,1.0,1,1.0,1,1.0,1,0.19916514737275268,32
484,2,1009,365,644,0,0,0,1.0,1,1.0,1,1.0,1,0.1876674023782934,33
485,3,1012,365,647,0,0,0,1.0,1,1.0,1,1.0,1,0.15536879744501797,34
486,2,1014,365,649,0,0,0,1.0,1,1.0,1,1.0,1,0.1700793297180372,36
487,2,1016,365,651,0,0,0,1.0,1,1.0,1,1.0,1,0.13789547633573138,36
488,0,1016,365,651,0,0,0,1.0,1,1.0,1,1.0,1,0.14691701238711039,37
489,5,1021,367,654,0,0,0,1.0,1,1.0,1,1.0,1,0.1557894042339149,38
490,1,1022,367,655,0,0,0,1.0,1,1.0,1,1.0,1,0.13839374242078753,38
491,0,1022,367,655,0,0,0,1.0,1,1.0,1,1.0,1,0.1477312445272511,37
492,0,1022,367,655,0,0,0,1.0,1,1.0,1,1.0,1,0.1477312445272511,37
493,2,1024,367,657,0,0,0,1.0,1,1.0,1,1.0,1,0.10178138466704957,37
494,6,1030,369,661,0,0,0,1.0,1,1.0,1,1.0,1,0.14081684632772296,39
495,3,1033,369,664,0,0,0,1.0,1,1.0,1,1.0,1,0.1565387530595678,40
496,3,1036,369,667,0,0,0,1.0,1,1.0,1,1.0,1,0.09205039330200056,40
497,1,1037,369,668,0,0,0,1.0,1,1.0,1,1.0,1,0.07047559033470667,43
498,1,1038,370,668,0,0,0,1.0,1,1.0,1,1.0,1,0.09099858322014755,43
499,3,1041,372,669,0,0,0,1.0,1,1.0,1,1.0,1,0.12333670919048421,44
500,1,1042,372,670,0,0,0,1.0,1,1.0,1,1.0,1,0.14245761779650334,45
501,2,1044,372,672,0,0,0,1.0,1,1.0,1,1.0,1,0.11601094710683034,45
502,1,1045,373,672,0,0,0,1.0,1,1.0,1,1.0,1,0.12471137314218966,45
503,4,1049,375,674,0,0,0,1.0,1,1.0,1,1.0,1,0.13092222137372622,46
504,4,1053,377,676,0,0,0,1.0,1,1.0,1,1.0,1,0.1480029384525529,47
505,1,1054,377,677,0,0,0,1.0,1,1.0,1,1.0,1,0.15372446705221518,42
506,1,1055,378,677,0,0,0,1.0,1,1.0,1,1.0,1,0.1644643684337804,41
507,0,1055,378,677,0,0,0,1.0,1,1.0,1,1.0,1,0.17558013068952313,38
508,5,1060,380,680,0,0,0,1.0,1,1.0,1,1.0,1,0.18888362165321745,38
509,2,1062,380,682,0,0,0,1.0,1,1.0,1,1.0,1,0.2335157399964945,37
510,2,1064,380,684,0,0,0,1.0,1,1.0,1,1.0,1,0.233154539044412,36
511,1,1065,380,685,0,0,0,1.0,1,1.0,1,1.0,1,0.19220868181623374,34
512,0,1065,380,685,0,0,0,1.0,1,1.0,1,1.0,1,0.17794188730706784,32
513,1,1066,380,686,0,0,0,1.0,1,1.0,1,1.0,1,0.1185458589199471,32
514,1,1067,380,687,0,0,0,1.0,1,1.0,1,1.0,1,0.093316195109922,35
515,1,1068,380,688,0,0,0,1.0,1,1.0,1,1.0,1,0.0787516604063075,35
516,0,1068,380,688,0,0,0,1.0,1,1.0,1,1.0,1,0.08995522583353321,36
517,0,1068,380,688,0,0,0,1.0,1,1.0,1,1.0,1,0.08995522583353321,36
518,0,1068,380,688,0,0,0,1.0,1,1.0,1,1.0,1,0.12948221149455094,39
519,1,1069,381,688,0,0,0,1.0,1,1.0,1,1.0,1,0.14725728827127837,39
520,3,1072,382,690,0,0,0,1.0,1,1.0,1,1.0,1,0.16660948929462455,39
521,2,1074,383,691,0,0,0,1.0,1,1.0,1,1.0,1,0.11344129674591355,40
522,1,1075,383,692,0,0,0,1.0,1,1.0,1,1.0,1,0.10851708902677178,40
523,0,1075,383,692,0,0,0,1.0,1,1.0,1,1.0,1,0.12205254604286908,41
524,0,1075,383,692,0,0,0,1.0,1,1.0,1,1.0,1,0.12205254604286908,41
525,3,1078,385,693,0,0,0,1.0,1,1.0,1,1.0,1,0.1454256703136381,40
526,2,1080,386,694,0,0,0,1.0,1,1.0,1,1.0,1,0.17169792243710486,40
527,0,1080,386,694,0,0,0,1.0,1,1.0,1,1.0,1,0.17169792243710486,40
528,1,1081,387,694,0,0,0,1.0,1,1.0,1,1.0,1,0.1560628684944002,40
529,1,1082,387,695,0,0,0,1.0,1,1.0,1,1.0,1,0.1561143813773513,39
530,0,1082,387,695,0,0,0,1.0,1,1.0,1,1.0,1,0.1561143813773513,39
531,0,1082,387,695,0,0,0,1.0,1,1.0,1,1.0,1,0.17099747727277856,39
532,1,1083,388,695,0,0,0,1.0,1,1.0,1,1.0,1,0.23442806417051587,40
533,3,1086,388,698,0,0,0,1.0,1,1.0,1,1.0,1,0.19650819206721878,40
534,0,1086,388,698,0,0,0,1.0,1,1.0,1,1.0,1,0.21172750352343353,42
535,4,1090,389,701,0,0,0,1.0,1,1.0,1,1.0,1,0.22672605159912465,42
536,0,1090,389,701,0,0,0,1.0,1,1.0,1,1.0,1,0.23680354617670782,43
537,0,1090,389,701,0,0,0,1.0,1,1.0,1,1.0,1,0.23680354617670782,43
538,3,1093,389,704,0,0,0,1.0,1,1.0,1,1.0,1,0.17367273283983856,44
539,0,1093,389,704,0,0,0,1.0,1,1.0,1,1.0,1,0.17367273283983856,44
540,1,1094,390,704,0,0,0,1.0,1,1.0,1,1.0,1,0.18021491855703964,44
541,3,1097,391,706,0,0,0,1.0,1,1.0,1,1.0,1,0.1423044549104749,45
542,2,1099,392,707,0,0,0,1.0,1,1.0,1,1.0,1,0.1472626788160935,46
543,4,1103,395,708,0,0,0,1.0,1,1.0,1,1.0,1,0.1988865308684665,43
544,3,1106,397,709,0,0,0,1.0,1,1.0,1,1.0,1,0.2445035787278481,42
545,5,1111,399,712,0,0,0,1.0,1,1.0,1,1.0,1,0.16169060069895286,43
546,3,1114,401,713,0,0,0,1.0,1,1.0,1,1.0,1,0.18903279732079917,41
547,1,1115,401,714,0,0,0,1.0,1,1.0,1,1.0,1,0.10551973299093502,40
548,4,1119,404,715,0,0,0,1.0,1,1.0,1,1.0,1,0.17018097415910374,40
549,2,1121,406,715,0,0,0,1.0,1,1.0,1,1.0,1,0.215750424406898,39
550,4,1125,407,718,0,0,0,1.0,1,1.0,1,1.0,1,0.18102192012271748,38
551,1,1126,407,719,0,0,0,1.0,1,1.0,1,1.0,1,0.11809397135841393,38
552,1,1127,408,719,0,0,0,1.0,1,1.0,1,1.0,1,0.15357651252668886,39
553,0,1127,408,719,0,0,0,1.0,1,1.0,1,1.0,1,0.12888088501267925,38
554,2,1129,410,719,0,0,0,1.0,1,1.0,1,1.0,1,0.17896427073331717,39
555,0,1129,410,719,0,0,0,1.0,1,1.0,1,1.0,1,0.18607091825803515,39
556,4,1133,411,722,0,0,0,1.0,1,1.0,1,1.0,1,0.15609507520709276,40
557,2,1135,411,724,0,0,0,1.0,1,1.0,1,1.0,1,0.1484029847230192,40
558,2,1137,411,726,0,0,0,1.0,1,1.0,1,1.0,1,0.1038939034311554,40
559,1,1138,412,726,0,0,0,1.0,1,1.0,1,1.0,1,0.137222781768122,40
560,3,1141,412,729,0,0,0,1.0,1,1.0,1,1.0,1,0.09118025453373624,41
561,0,1141,412,729,0,0,0,1.0,1,1.0,1,1.0,1,0.10530663813989267,42
562,1,1142,413,729,0,0,0,1.0,1,1.0,1,1.0,1,0.14078928052090936,42
563,2,1144,415,729,0,0,0,1.0,1,1.0,1,1.0,1,0.211624144795748,42
564,0,1144,415,729,0,0,0,1.0,1,1.0,1,1.0,1,0.22309597203014256,43
565,3,1147,416,731,0,0,0,1.0,1,1.0,1,1.0,1,0.20732027464075053,44
566,1,1148,416,732,0,0,0,1.0,1,1.0,1,1.0,1,0.20100101380848706,45
567,0,1148,416,732,0,0,0,1.0,1,1.0,1,1.0,1,0.20100101380848706,45
568,2,1150,416,734,0,0,0,1.0,1,1.0,1,1.0,1,0.14682209828993104,46
569,3,1153,418,735,0,0,0,1.0,1,1.0,1,1.0,1,0.16852713471195332,47
570,1,1154,418,736,0,0,0,1.0,1,1.0,1,1.0,1,0.1703452147236175,48
571,5,1159,421,738,0,0,0,1.0,1,1.0,1,1.0,1,0.1834967227585348,48
572,0,1159,421,738,0,0,0,1.0,1,1.0,1,1.0,1,0.18918214778365292,47
573,2,1161,421,740,0,0,0,1.0,1,1.0,1,1.0,1,0.17002867252709117,49
574,2,1163,421,742,0,0,0,1.0,1,1.0,1,1.0,1,0.1422913468014576,49
575,2,1165,421,744,0,0,0,1.0,1,1.0,1,1.0,1,0.10044933130702519,50
576,0,1165,421,744,0,0,0,1.0,1,1.0,1,1.0,1,0.11722010610910183,51
577,2,1167,421,746,0,0,0,1.0,1,1.0,1,1.0,1,0.09664492729422382,51
578,0,1167,421,746,0,0,0,1.0,1,1.0,1,1.0,1,0.09664492729422382,51
579,1,1168,422,746,0,0,0,1.0,1,1.0,1,1.0,1,0.1207307037250234,52
580,2,1170,422,748,0,0,0,1.0,1,1.0,1,1.0,1,0.11963887861983404,52
581,4,1174,423,751,0,0,0,1.0,1,1.0,1,1.0,1,0.11546786054428274,52
582,4,1178,424,754,0,0,0,1.0,1,1.0,1,1.0,1,0.12581716922998984,53
583,4,1182,426,756,0,0,0,1.0,1,1.0,1,1.0,1,0.10179017848552371,51
584,5,1187,429,758,0,0,0,1.0,1,1.0,1,1.0,1,0.10601849403976571,51
585,1,1188,430,758,0,0,0,1.0,1,1.0,1,1.0,1,0.12894096807132788,49
586,5,1193,431,762,0,0,0,1.0,1,1.0,1,1.0,1,0.08933519919638741,49
587,1,1194,432,762,0,0,0,1.0,1,1.0,1,1.0,1,0.05633506399723677,48
588,0,1194,432,762,0,0,0,1.0,1,1.0,1,1.0,1,0.07421681131238,46
589,2,1196,433,763,0,0,0,1.0,1,1.0,1,1.0,1,0.08799172735421046,48
590,1,1197,434,763,0,0,0,1.0,1,1.0,1,1.0,1,0.11142525699331414,47
591,5,1202,436,766,0,0,0,1.0,1,1.0,1,1.0,1,0.12417037454601773,48
592,6,1208,437,771,0,0,0,1.0,1,1.0,1,1.0,1,0.13756238610855054,47
593,1,1209,438,771,0,0,0,1.0,1,1.0,1,1.0,1,0.16776153438239363,45
594,3,1212,440,772,0,0,0,1.0,1,1.0,1,1.0,1,0.2064509585355968,44
595,3,1215,441,774,0,0,0,1.0,1,1.0,1,1.0,1,0.1861707509049481,43
596,1,1216,442,774,0,0,0,1.0,1,1.0,1,1.0,1,0.1925599656005242,44
597,0,1216,442,774,0,0,0,1.0,1,1.0,1,1.0,1,0.19462177601455688,43
598,2,1218,443,775,0,0,0,1.0,1,1.0,1,1.0,1,0.16164670102210382,45
599,3,1221,445,776,0,0,0,1.0,1,1.0,1,1.0,1,0.16031827606313354,44
600,0,1221,445,776,0,0,0,1.0,1,1.0,1,1.0,1,0.16031827606313354,44
601,2,1223,446,777,0,0,0,1.0,1,1.0,1,1.0,1,0.16399008030195433,45
602,4,1227,447,780,0,0,0,1.0,1,1.0,1,1.0,1,0.18379692437282094,46
603,3,1230,447,783,0,0,0,1.0,1,1.0,1,1.0,1,0.15743137163176374,46
604,3,1233,448,785,0,0,0,1.0,1,1.0,1,1.0,1,0.14707072678262528,47
605,0,1233,448,785,0,0,0,1.0,1,1.0,1,1.0,1,0.14707072678262528,47
606,0,1233,448,785,0,0,0,1.0,1,1.0,1,1.0,1,0.17309958241622134,47
607,3,1236,448,788,0,0,0,1.0,1,1.0,1,1.0,1,0.1386476975490085,48
608,1,1237,448,789,0,0,0,1.0,1,1.0,1,1.0,1,0.10751015405195544,47
609,2,1239,448,791,0,0,0,1.0,1,1.0,1,1.0,1,0.07487131609095325,48
610,0,1239,448,791,0,0,0,1.0,1,1.0,1,1.0,1,0.09650058975776332,48
611,3,1242,450,792,0,0,0,1.0,1,1.0,1,1.0,1,0.08036696974750218,49
612,1,1243,450,793,0,0,0,1.0,1,1.0,1,1.0,1,0.08397732248010814,50
613,0,1243,450,793,0,0,0,1.0,1,1.0,1,1.0,1,0.08397732248010814,50
614,1,1244,451,793,0,0,0,1.0,1,1.0,1,1.0,1,0.09474222530800339,50
615,1,1245,452,793,0,0,0,1.0,1,1.0,1,1.0,1,0.08615903810985406,50
616,0,1245,452,793,0,0,0,1.0,1,1.0,1,1.0,1,0.08615903810985406,50
617,1,1246,452,794,0,0,0,1.0,1,1.0,1,1.0,1,0.08351736727099443,52
618,0,1246,452,794,0,0,0,1.0,1,1.0,1,1.0,1,0.08351736727099443,52
619,1,1247,453,794,0,0,0,1.0,1,1.0,1,1.0,1,0.07900025898580819,50
620,2,1249,455,794,0,0,0,1.0,1,1.0,1,1.0,1,0.13004602254682102,50
621,3,1252,457,795,0,0,0,1.0,1,1.0,1,1.0,1,0.11022728004086982,49
622,3,1255,458,797,0,0,0,1.0,1,1.0,1,1.0,1,0.13144668880806284,49
623,2,1257,459,798,0,0,0,1.0,1,1.0,1,1.0,1,0.1312300139398662,48
624,9,1266,462,804,0,0,0,1.0,1,1.0,1,1.0,1,0.15021664132400012,46
625,4,1270,464,806,0,0,0,1.0,1,1.0,1,1.0,1,0.157354672391018,45
626,2,1272,465,807,0,0,0,1.0,1,1.0,1,1.0,1,0.11712607441175929,44
627,1,1273,466,807,0,0,0,1.0,1,1.0,1,1.0,1,0.13953750668749512,44
628,2,1275,467,808,0,0,0,1.0,1,1.0,1,1.0,1,0.1534650335166432,44
629,0,1275,467,808,0,0,0,1.0,1,1.0,1,1.0,1,0.11242714406677191,41
630,1,1276,468,808,0,0,0,1.0,1,1.0,1,1.0,1,0.16606874652500986,40
631,5,1281,470,811,0,0,0,1.0,1,1.0,1,1.0,1,0.20786138826432174,38
632,6,1287,473,814,0,0,0,1.0,1,1.0,1,1.0,1,0.21265866349300996,38
633,0,1287,473,814,0,0,0,1.0,1,1.0,1,1.0,1,0.2511326256445611,36
634,0,1287,473,814,0,0,0,1.0,1,1.0,1,1.0,1,0.240595590951865,35
635,1,1288,473,815,0,0,0,1.0,1,1.0,1,1.0,1,0.21267478098896697,35
636,2,1290,473,817,0,0,0,1.0,1,1.0,1,1.0,1,0.20081574339345404,36
637,1,1291,473,818,0,0,0,1.0,1,1.0,1,1.0,1,0.18786345756360162,35
638,0,1291,473,818,0,0,0,1.0,1,1.0,1,1.0,1,0.214239480248407,34
639,3,1294,475,819,0,0,0,1.0,1,1.0,1,1.0,1,0.18243822906523674,36
640,3,1297,475,822,0,0,0,1.0,1,1.0,1,1.0,1,0.13739076473871778,37
641,0,1297,475,822,0,0,0,1.0,1,1.0,1,1.0,1,0.13739076473871778,37
642,0,1297,475,822,0,0,0,1.0,1,1.0,1,1.0,1,0.1198696393031598,38
643,1,1298,475,823,0,0,0,1.0,1,1.0,1,1.0,1,0.08945503563922348,39
644,1,1299,476,823,0,0,0,1.0,1,1.0,1,1.0,1,0.10703494813099446,39
645,0,1299,476,823,0,0,0,1.0,1,1.0,1,1.0,1,0.12648015567630738,39
646,4,1303,477,826,0,0,0,1.0,1,1.0,1,1.0,1,0.1408803405188616,40
647,0,1303,477,826,0,0,0,1.0,1,1.0,1,1.0,1,0.1408803405188616,40
648,1,1304,478,826,0,0,0,1.0,1,1.0,1,1.0,1,0.1571853640773174,40
649,2,1306,479,827,0,0,0,1.0,1,1.0,1,1.0,1,0.11714914224809235,40
650,5,1311,481,830,0,0,0,1.0,1,1.0,1,1.0,1,0.11786733847115637,41
651,1,1312,481,831,0,0,0,1.0,1,1.0,1,1.0,1,0.09913099577189192,42
652,0,1312,481,831,0,0,0,1.0,1,1.0,1,1.0,1,0.11181396786944618,41
653,0,1312,481,831,0,0,0,1.0,1,1.0,1,1.0,1,0.11181396786944618,41
654,0,1312,481,831,0,0,0,1.0,1,1.0,1,1.0,1,0.12117153098956121,42
655,2,1314,481,833,0,0,0,1.0,1,1.0,1,1.0,1,0.08875276937553409,45
656,5,1319,483,836,0,0,0,1.0,1,1.0,1,1.0,1,0.14226045125269465,45
657,2,1321,484,837,0,0,0,1.0,1,1.0,1,1.0,1,0.18804206629965864,43
658,3,1324,486,838,0,0,0,1.0,1,1.0,1,1.0,1,0.20979496665691932,43
659,4,1328,487,841,0,0,0,1.0,1,1.0,1,1.0,1,0.16076688812271644,43
660,4,1332,489,843,0,0,0,1.0,1,1.0,1,1.0,1,0.1824649715576338,43
661,1,1333,489,844,0,0,0,1.0,1,1.0,1,1.0,1,0.2077886316986044,41
662,2,1335,490,845,0,0,0,1.0,1,1.0,1,1.0,1,0.24916236790125856,40
663,3,1338,491,847,0,0,0,1.0,1,1.0,1,1.0,1,0.21120201713834538,39
664,7,1345,493,852,0,0,0,1.0,1,1.0,1,1.0,1,0.17759186669014812,36
665,1,1346,493,853,0,0,0,1.0,1,1.0,1,1.0,1,0.16755867074642816,36
666,3,1349,495,854,0,0,0,1.0,1,1.0,1,1.0,1,0.17907975356564462,36
667,1,1350,495,855,0,0,0,1.0,1,1.0,1,1.0,1,0.13803935115318475,35
668,2,1352,497,855,0,0,0,1.0,1,1.0,1,1.0,1,0.17685431646282523,34
669,4,1356,500,856,0,0,0,1.0,1,1.0,1,1.0,1,0.17538888612061912,34
670,7,1363,502,861,0,0,0,1.0,1,1.0,1,1.0,1,0.12956022519869062,32
671,5,1368,504,864,0,0,0,1.0,1,1.0,1,1.0,1,0.08117843463587003,33
672,0,1368,504,864,0,0,0,1.0,1,1.0,1,1.0,1,0.11274288335255236,32
673,1,1369,505,864,0,0,0,1.0,1,1.0,1,1.0,1,0.11796354640156692,32
674,1,1370,506,864,0,0,0,1.0,1,1.0,1,1.0,1,0.16722789060014814,32
675,2,1372,507,865,0,0,0,1.0,1,1.0,1,1.0,1,0.15956487990432527,34
676,2,1374,507,867,0,0,0,1.0,1,1.0,1,1.0,1,0.11898924770154047,35
677,1,1375,508,867,0,0,0,1.0,1,1.0,1,1.0,1,0.11310692803357567,35
678,0,1375,508,867,0,0,0,1.0,1,1.0,1,1.0,1,0.11310692803357567,35
679,4,1379,509,870,0,0,0,1.0,1,1.0,1,1.0,1,0.07122026482573918,36
680,0,1379,509,870,0,0,0,1.0,1,1.0,1,1.0,1,0.0814142389529045,37
681,1,1380,510,870,0,0,0,1.0,1,1.0,1,1.0,1,0.1323328992762088,37
682,3,1383,512,871,0,0,0,1.0,1,1.0,1,1.0,1,0.1362519764497038,37
683,1,1384,512,872,0,0,0,1.0,1,1.0,1,1.0,1,0.14142257247858436,38
684,4,1388,513,875,0,0,0,1.0,1,1.0,1,1.0,1,0.0953155985095017,39
685,0,1388,513,875,0,0,0,1.0,1,1.0,1,1.0,1,0.08885026136807127,38
686,0,1388,513,875,0,0,0,1.0,1,1.0,1,1.0,1,0.11875996212413549,37
687,1,1389,514,875,0,0,0,1.0,1,1.0,1,1.0,1,0.14480210288303527,38
688,1,1390,514,876,0,0,0,1.0,1,1.0,1,1.0,1,0.16262636562659696,37
689,1,1391,515,876,0,0,0,1.0,1,1.0,1,1.0,1,0.21460388425675153,39
690,1,1392,515,877,0,0,0,1.0,1,1.0,1,1.0,1,0.20872434251389757,38
691,2,1394,516,878,0,0,0,1.0,1,1.0,1,1.0,1,0.1827217508598584,38
692,1,1395,516,879,0,0,0,1.0,1,1.0,1,1.0,1,0.17158991484901803,38
693,3,1398,517,881,0,0,0,1.0,1,1.0,1,1.0,1,0.16584225748906312,40
694,3,1401,519,882,0,0,0,1.0,1,1.0,1,1.0,1,0.19697486148500182,42
695,2,1403,520,883,0,0,0,1.0,1,1.0,1,1.0,1,0.1593836924780096,40
696,6,1409,522,887,0,0,0,1.0,1,1.0,1,1.0,1,0.15423511263152392,39
697,0,1409,522,887,0,0,0,1.0,1,1.0,1,1.0,1,0.15740307110797924,39
698,3,1412,523,889,0,0,0,1.0,1,1.0,1,1.0,1,0.17516904641184383,37
699,0,1412,523,889,0,0,0,1.0,1,1.0,1,1.0,1,0.17255213135402264,37
700,2,1414,523,891,0,0,0,1.0,1,1.0,1,1.0,1,0.18128056830463513,37
701,1,1415,524,891,0,0,0,1.0,1,1.0,1,1.0,1,0.1887147590147645,37
702,1,1416,524,892,0,0,0,1.0,1,1.0,1,1.0,1,0.18448428315887663,38
703,6,1422,528,894,0,0,0,1.0,1,1.0,1,1.0,1,0.22989845690968605,36
704,6,1428,530,898,0,0,0,1.0,1,1.0,1,1.0,1,0.16270373389769996,36
705,2,1430,532,898,0,0,0,1.0,1,1.0,1,1.0,1,0.1508508933114508,36
706,5,1435,536,899,0,0,0,1.0,1,1.0,1,1.0,1,0.17775545449151492,35
707,2,1437,537,900,0,0,0,1.0,1,1.0,1,1.0,1,0.18814359981675788,36
708,2,1439,538,901,0,0,0,1.0,1,1.0,1,1.0,1,0.19280919033068178,36
709,3,1442,538,904,0,0,0,1.0,1,1.0,1,1.0,1,0.14550302563555453,34
710,1,1443,539,904,0,0,0,1.0,1,1.0,1,1.0,1,0.15634385187593622,34
711,0,1443,539,904,0,0,0,1.0,1,1.0,1,1.0,1,0.1487407186487023,34
712,3,1446,540,906,0,0,0,1.0,1,1.0,1,1.0,1,0.17466117904408054,35
713,3,1449,542,907,0,0,0,1.0,1,1.0,1,1.0,1,0.21805073023282984,34
714,1,1450,542,908,0,0,0,1.0,1,1.0,1,1.0,1,0.19591543774558678,34
715,3,1453,542,911,0,0,0,1.0,1,1.0,1,1.0,1,0.11560255585153485,35
716,2,1455,543,912,0,0,0,1.0,1,1.0,1,1.0,1,0.11601169456818146,33
717,4,1459,545,914,0,0,0,1.0,1,1.0,1,1.0,1,0.13861993463231392,33
718,1,1460,545,915,0,0,0,1.0,1,1.0,1,1.0,1,0.11620990420509526,32
719,0,1460,545,915,0,0,0,1.0,1,1.0,1,1.0,1,0.11620990420509526,32
720,1,1461,546,915,0,0,0,1.0,1,1.0,1,1.0,1,0.13582136887236454,33
721,0,1461,546,915,0,0,0,1.0,1,1.0,1,1.0,1,0.13582136887236454,33
722,0,1461,546,915,0,0,0,1.0,1,1.0,1,1.0,1,0.1535277594898107,34
723,1,1462,546,916,0,0,0,1.0,1,1.0,1,1.0,1,0.1289005047417015,34
724,3,1465,546,919,0,0,0,1.0,1,1.0,1,1.0,1,0.12214883165761882,36
725,0,1465,546,919,0,0,0,1.0,1,1.0,1,1.0,1,0.12214883165761882,36
726,0,1465,546,919,0,0,0,1.0,1,1.0,1,1.0,1,0.12214883165761882,36
727,1,1466,546,920,0,0,0,1.0,1,1.0,1,1.0,1,0.10513025789316235,36
728,0,1466,546,920,0,0,0,1.0,1,1.0,1,1.0,1,0.1229387332145751,37
729,0,1466,546,920,0,0,0,1.0,1,1.0,1,1.0,1,0.14410300611553511,37
730,3,1469,546,923,0,0,0,1.0,1,1.0,1,1.0,1,0.07471401059096608,38
731,2,1471,547,924,0,0,0,1.0,1,1.0,1,1.0,1,0.12875568002205004,39
732,0,1471,547,924,0,0,0,1.0,1,1.0,1,1.0,1,0.12490236027660441,41
733,1,1472,548,924,0,0,0,1.0,1,1.0,1,1.0,1,0.06606804260992793,39
734,1,1473,549,924,0,0,0,1.0,1,1.0,1,1.0,1,0.14766909246287835,39
735,2,1475,551,924,0,0,0,1.0,1,1.0,1,1.0,1,0.18011976891316375,39
736,1,1476,551,925,0,0,0,1.0,1,1.0,1,1.0,1,0.15310471841698708,38
737,2,1478,553,925,0,0,0,1.0,1,1.0,1,1.0,1,0.22119386919057754,39
738,4,1482,553,929,0,0,0,1.0,1,1.0,1,1.0,1,0.21498640183520082,37
739,2,1484,553,931,0,0,0,1.0,1,1.0,1,1.0,1,0.14951075527574692,37
740,1,1485,554,931,0,0,0,1.0,1,1.0,1,1.0,1,0.222792607592735,35
741,1,1486,554,932,0,0,0,1.0,1,1.0,1,1.0,1,0.21542286576765107,33
742,2,1488,555,933,0,0,0,1.0,1,1.0,1,1.0,1,0.20090787942904756,35
743,2,1490,557,933,0,0,0,1.0,1,1.0,1,1.0,1,0.2502773150464016,35
744,2,1492,559,933,0,0,0,1.0,1,1.0,1,1.0,1,0.21537902965533312,34
745,5,1497,561,936,0,0,0,1.0,1,1.0,1,1.0,1,0.2052173363588869,34
746,4,1501,563,938,0,0,0,1.0,1,1.0,1,1.0,1,0.1801469477417041,33
747,1,1502,563,939,0,0,0,1.0,1,1.0,1,1.0,1,0.16205867857038145,32
748,1,1503,563,940,0,0,0,1.0,1,1.0,1,1.0,1,0.14303572250421082,33
749,0,1503,563,940,0,0,0,1.0,1,1.0,1,1.0,1,0.14303572250421082,33
750,1,1504,564,940,0,0,0,1.0,1,1.0,1,1.0,1,0.141353790383015,34
751,2,1506,565,941,0,0,0,1.0,1,1.0,1,1.0,1,0.1481962195477401,36
752,3,1509,568,941,0,0,0,1.0,1,1.0,1,1.0,1,0.1352007465134395,35
753,4,1513,570,943,0,0,0,1.0,1,1.0,1,1.0,1,0.21544039718884103,37
754,5,1518,571,947,0,0,0,1.0,1,1.0,1,1.0,1,0.09210284721970925,37
755,2,1520,572,948,0,0,0,1.0,1,1.0,1,1.0,1,0.10739713950407084,35
756,1,1521,572,949,0,0,0,1.0,1,1.0,1,1.0,1,0.0925539356351643,36
757,1,1522,572,950,0,0,0,1.0,1,1.0,1,1.0,1,0.1219689853225252,35
758,0,1522,572,950,0,0,0,1.0,1,1.0,1,1.0,1,0.0883629678670591,36
759,1,1523,573,950,0,0,0,1.0,1,1.0,1,1.0,1,0.08324398436079927,37
760,0,1523,573,950,0,0,0,1.0,1,1.0,1,1.0,1,0.11578061416548786,36
761,0,1523,573,950,0,0,0,1.0,1,1.0,1,1.0,1,0.11578061416548786,36
762,0,1523,573,950,0,0,0,1.0,1,1.0,1,1.0,1,0.12629520477687675,37
763,2,1525,573,952,0,0,0,1.0,1,1.0,1,1.0,1,0.11833638223766886,38
764,1,1526,573,953,0,0,0,1.0,1,1.0,1,1.0,1,0.08754461288764186,38
765,0,1526,573,953,0,0,0,1.0,1,1.0,1,1.0,1,0.08754461288764186,38
766,0,1526,573,953,0,0,0,1.0,1,1.0,1,1.0,1,0.06352770498670768,40
767,0,1526,573,953,0,0,0,1.0,1,1.0,1,1.0,1,0.08483101691622097,41
768,3,1529,575,954,0,0,0,1.0,1,1.0,1,1.0,1,0.11997235752562553,41
769,4,1533,576,957,0,0,0,1.0,1,1.0,1,1.0,1,0.11533504420295783,42
770,2,1535,576,959,0,0,0,1.0,1,1.0,1,1.0,1,0.1208599386601261,41
771,2,1537,576,961,0,0,0,1.0,1,1.0,1,1.0,1,0.140437742991532,41
772,5,1542,577,965,0,0,0,1.0,1,1.0,1,1.0,1,0.13230199855134434,41
773,0,1542,577,965,0,0,0,1.0,1,1.0,1,1.0,1,0.1272970553180655,41
774,5,1547,579,968,0,0,0,1.0,1,1.0,1,1.0,1,0.19353219756226536,42
775,3,1550,579,971,0,0,0,1.0,1,1.0,1,1.0,1,0.1329864794388441,42
776,0,1550,579,971,0,0,0,1.0,1,1.0,1,1.0,1,0.1329864794388441,42
777,0,1550,579,971,0,0,0,1.0,1,1.0,1,1.0,1,0.1329864794388441,42
778,4,1554,580,974,0,0,0,1.0,1,1.0,1,1.0,1,0.12994380732733535,44
779,0,1554,580,974,0,0,0,1.0,1,1.0,1,1.0,1,0.12994380732733535,44
780,0,1554,580,974,0,0,0,1.0,1,1.0,1,1.0,1,0.12994380732733535,44
781,2,1556,580,976,0,0,0,1.0,1,1.0,1,1.0,1,0.0908526146743895,46
782,4,1560,582,978,0,0,0,1.0,1,1.0,1,1.0,1,0.1485302122479336,45
783,3,1563,583,980,0,0,0,1.0,1,1.0,1,1.0,1,0.1654862277669854,44
784,3,1566,583,983,0,0,0,1.0,1,1.0,1,1.0,1,0.11103592254819601,44
785,1,1567,584,983,0,0,0,1.0,1,1.0,1,1.0,1,0.12883401298131977,43
786,1,1568,585,983,0,0,0,1.0,1,1.0,1,1.0,1,0.1208683676716102,43
787,1,1569,585,984,0,0,0,1.0,1,1.0,1,1.0,1,0.09321530227623549,43
788,4,1573,587,986,0,0,0,1.0,1,1.0,1,1.0,1,0.14971208281553122,45
789,1,1574,588,986,0,0,0,1.0,1,1.0,1,1.0,1,0.14836774611555129,46
790,3,1577,588,989,0,0,0,1.0,1,1.0,1,1.0,1,0.13526654492953893,45
791,3,1580,589,991,0,0,0,1.0,1,1.0,1,1.0,1,0.11986398786331905,46
792,0,1580,589,991,0,0,0,1.0,1,1.0,1,1.0,1,0.12534405765803167,46
793,1,1581,590,991,0,0,0,1.0,1,1.0,1,1.0,1,0.12656000674293438,46
794,4,1585,591,994,0,0,0,1.0,1,1.0,1,1.0,1,0.13196584083916027,47
795,2,1587,591,996,0,0,0,1.0,1,1.0,1,1.0,1,0.10953132171618092,47
796,2,1589,592,997,0,0,0,1.0,1,1.0,1,1.0,1,0.1120175761722931,46
797,1,1590,593,997,0,0,0,1.0,1,1.0,1,1.0,1,0.15853448352227453,47
798,3,1593,595,998,0,0,0,1.0,1,1.0,1,1.0,1,0.18917698800126598,48
799,8,1601,595,1006,0,0,0,1.0,1,1.0,1,1.0,1,0.07487952662464285,48
800,2,1603,596,1007,0,0,0,1.0,1,1.0,1,1.0,1,0.09129492688435452,48
801,1,1604,596,1008,0,0,0,1.0,1,1.0,1,1.0,1,0.10740304899401262,49
802,2,1606,596,1010,0,0,0,1.0,1,1.0,1,1.0,1,0.08944307642270542,50
803,0,1606,596,1010,0,0,0,1.0,1,1.0,1,1.0,1,0.09984416635130179,49
804,2,1608,596,1012,0,0,0,1.0,1,1.0,1,1.0,1,0.11164608742958693,50
805,0,1608,596,1012,0,0,0,1.0,1,1.0,1,1.0,1,0.11164608742958693,50
806,0,1608,596,1012,0,0,0,1.0,1,1.0,1,1.0,1,0.11164608742958693,50
807,2,1610,596,1014,0,0,0,1.0,1,1.0,1,1.0,1,0.0935359557851681,51
808,1,1611,597,1014,0,0,0,1.0,1,1.0,1,1.0,1,0.11549627191985441,51
809,3,1614,599,1015,0,0,0,1.0,1,1.0,1,1.0,1,0.11499926073903742,51
810,3,1617,600,1017,0,0,0,1.0,1,1.0,1,1.0,1,0.11533178350066896,52
811,2,1619,601,1018,0,0,0,1.0,1,1.0,1,1.0,1,0.10261797067937206,50
812,2,1621,603,1018,0,0,0,1.0,1,1.0,1,1.0,1,0.16475411608583723,48
813,3,1624,604,1020,0,0,0,1.0,1,1.0,1,1.0,1,0.17090788962964518,49
814,3,1627,604,1023,0,0,0,1.0,1,1.0,1,1.0,1,0.09789348661951264,48
815,3,1630,606,1024,0,0,0,1.0,1,1.0,1,1.0,1,0.12023883647464749,48
816,1,1631,607,1024,0,0,0,1.0,1,1.0,1,1.0,1,0.14708987896034253,46
817,3,1634,607,1027,0,0,0,1.0,1,1.0,1,1.0,1,0.14167866307055724,44
818,1,1635,607,1028,0,0,0,1.0,1,1.0,1,1.0,1,0.12586099428224204,46
819,1,1636,608,1028,0,0,0,1.0,1,1.0,1,1.0,1,0.14932811097607587,44
820,1,1637,608,1029,0,0,0,1.0,1,1.0,1,1.0,1,0.14951115306452362,44
821,1,1638,608,1030,0,0,0,1.0,1,1.0,1,1.0,1,0.11803478941502982,44
822,2,1640,610,1030,0,0,0,1.0,1,1.0,1,1.0,1,0.16471221337338532,44
823,3,1643,611,1032,0,0,0,1.0,1,1.0,1,1.0,1,0.10547100552561765,42
824,3,1646,614,1032,0,0,0,1.0,1,1.0,1,1.0,1,0.13205659779693263,42
825,2,1648,616,1032,0,0,0,1.0,1,1.0,1,1.0,1,0.15805763706818454,40
826,8,1656,620,1036,0,0,0,1.0,1,1.0,1,1.0,1,0.14266874222424447,41
827,5,1661,623,1038,0,0,0,1.0,1,1.0,1,1.0,1,0.19254394162569052,40
828,6,1667,626,1041,0,0,0,1.0,1,1.0,1,1.0,1,0.1716511716231931,40
829,4,1671,627,1044,0,0,0,1.0,1,1.0,1,1.0,1,0.15077147388941933,42
830,3,1674,628,1046,0,0,0,1.0,1,1.0,1,1.0,1,0.1369820701363441,42
831,5,1679,629,1050,0,0,0,1.0,1,1.0,1,1.0,1,0.10904765015553189,43
832,2,1681,630,1051,0,0,0,1.0,1,1.0,1,1.0,1,0.08634679687632185,42
833,0,1681,630,1051,0,0,0,1.0,1,1.0,1,1.0,1,0.10440379331949594,41
834,2,1683,632,1051,0,0,0,1.0,1,1.0,1,1.0,1,0.14633841533634623,41
835,0,1683,632,1051,0,0,0,1.0,1,1.0,1,1.0,1,0.14177516164440004,41
836,0,1683,632,1051,0,0,0,1.0,1,1.0,1,1.0,1,0.12646656986354374,40
837,1,1684,632,1052,0,0,0,1.0,1,1.0,1,1.0,1,0.12269050605447059,41
838,2,1686,633,1053,0,0,0,1.0,1,1.0,1,1.0,1,0.12183731350885303,41
839,2,1688,634,1054,0,0,0,1.0,1,1.0,1,1.0,1,0.12795001599225508,41
840,3,1691,636,1055,0,0,0,1.0,1,1.0,1,1.0,1,0.18269181962799083,42
841,3,1694,637,1057,0,0,0,1.0,1,1.0,1,1.0,1,0.13709139160969944,42
842,1,1695,637,1058,0,0,0,1.0,1,1.0,1,1.0,1,0.13437273554633453,42
843,1,1696,638,1058,0,0,0,1.0,1,1.0,1,1.0,1,0.13723840469968865,42
844,0,1696,638,1058,0,0,0,1.0,1,1.0,1,1.0,1,0.15580891398558927,42
845,4,1700,638,1062,0,0,0,1.0,1,1.0,1,1.0,1,0.16298470020640224,44
846,2,1702,639,1063,0,0,0,1.0,1,1.0,1,1.0,1,0.1707216851122347,44
847,1,1703,640,1063,0,0,0,1.0,1,1.0,1,1.0,1,0.17867078393388894,42
848,3,1706,641,1065,0,0,0,1.0,1,1.0,1,1.0,1,0.19832481786620584,43
849,2,1708,641,1067,0,0,0,1.0,1,1.0,1,1.0,1,0.1730174604201856,43
850,5,1713,641,1072,0,0,0,1.0,1,1.0,1,1.0,1,0.14375537605509042,41
851,2,1715,642,1073,0,0,0,1.0,1,1.0,1,1.0,1,0.1265052446106654,40
852,1,1716,642,1074,0,0,0,1.0,1,1.0,1,1.0,1,0.14070255186875405,40
853,6,1722,643,1079,0,0,0,1.0,1,1.0,1,1.0,1,0.13250378077194377,40
854,4,1726,645,1081,0,0,0,1.0,1,1.0,1,1.0,1,0.16850983804734046,40
855,4,1730,646,1084,0,0,0,1.0,1,1.0,1,1.0,1,0.15379685233203724,41
856,3,1733,647,1086,0,0,0,1.0,1,1.0,1,1.0,1,0.13166810209095078,41
857,1,1734,648,1086,0,0,0,1.0,1,1.0,1,1.0,1,0.14486590184326323,42
858,2,1736,648,1088,0,0,0,1.0,1,1.0,1,1.0,1,0.08038152679468023,43
859,0,1736,648,1088,0,0,0,1.0,1,1.0,1,1.0,1,0.08038152679468023,43
860,0,1736,648,1088,0,0,0,1.0,1,1.0,1,1.0,1,0.09079546487439527,44
861,1,1737,649,1088,0,0,0,1.0,1,1.0,1,1.0,1,0.09615075533158117,44
862,0,1737,649,1088,0,0,0,1.0,1,1.0,1,1.0,1,0.09615075533158117,44
863,3,1740,651,1089,0,0,0,1.0,1,1.0,1,1.0,1,0.11993763284589438,44
864,5,1745,653,1092,0,0,0,1.0,1,1.0,1,1.0,1,0.1258539454975458,44
865,2,1747,655,1092,0,0,0,1.0,1,1.0,1,1.0,1,0.10852149821511912,43
866,7,1754,658,1096,0,0,0,1.0,1,1.0,1,1.0,1,0.11291111372025622,45
867,2,1756,658,1098,0,0,0,1.0,1,1.0,1,1.0,1,0.14196433043833454,44
868,4,1760,659,1101,0,0,0,1.0,1,1.0,1,1.0,1,0.12345644136949241,45
869,6,1766,662,1104,0,0,0,1.0,1,1.0,1,1.0,1,0.12471895729714794,44
870,2,1768,663,1105,0,0,0,1.0,1,1.0,1,1.0,1,0.1452841265068771,44
871,8,1776,664,1112,0,0,0,1.0,1,1.0,1,1.0,1,0.10281664678261118,43
872,1,1777,664,1113,0,0,0,1.0,1,1.0,1,1.0,1,0.06117125554772348,43
873,1,1778,665,1113,0,0,0,1.0,1,1.0,1,1.0,1,0.10167872567893915,43
874,1,1779,665,1114,0,0,0,1.0,1,1.0,1,1.0,1,0.08936909824604529,46
875,2,1781,666,1115,0,0,0,1.0,1,1.0,1,1.0,1,0.10282349544421425,43
876,0,1781,666,1115,0,0,0,1.0,1,1.0,1,1.0,1,0.11064567290633277,44
877,4,1785,666,1119,0,0,0,1.0,1,1.0,1,1.0,1,0.09252780983510073,44
878,0,1785,666,1119,0,0,0,1.0,1,1.0,1,1.0,1,0.09252780983510073,44
879,0,1785,666,1119,0,0,0,1.0,1,1.0,1,1.0,1,0.09252780983510073,44
880,2,1787,668,1119,0,0,0,1.0,1,1.0,1,1.0,1,0.14128481523301253,44
881,0,1787,668,1119,0,0,0,1.0,1,1.0,1,1.0,1,0.12592033736378974,43
882,2,1789,669,1120,0,0,0,1.0,1,1.0,1,1.0,1,0.10277792501235358,45
883,1,1790,669,1121,0,0,0,1.0,1,1.0,1,1.0,1,0.10971880629781122,45
884,3,1793,671,1122,0,0,0,1.0,1,1.0,1,1.0,1,0.1326842959226749,45
885,1,1794,672,1122,0,0,0,1.0,1,1.0,1,1.0,1,0.11742556514108721,43
886,6,1800,673,1127,0,0,0,1.0,1,1.0,1,1.0,1,0.13614536106998731,43
887,4,1804,675,1129,0,0,0,1.0,1,1.0,1,1.0,1,0.1263477547147698,41
888,1,1805,675,1130,0,0,0,1.0,1,1.0,1,1.0,1,0.11157930644174628,40
889,0,1805,675,1130,0,0,0,1.0,1,1.0,1,1.0,1,0.11157930644174628,40
890,1,1806,676,1130,0,0,0,1.0,1,1.0,1,1.0,1,0.08876077134665712,38
891,1,1807,677,1130,0,0,0,1.0,1,1.0,1,1.0,1,0.10408178935404837,39
892,6,1813,680,1133,0,0,0,1.0,1,1.0,1,1.0,1,0.16737867752592572,39
893,1,1814,680,1134,0,0,0,1.0,1,1.0,1,1.0,1,0.1346310373311566,37
894,2,1816,682,1134,0,0,0,1.0,1,1.0,1,1.0,1,0.21712004584431258,36
895,4,1820,682,1138,0,0,0,1.0,1,1.0,1,1.0,1,0.1608993744855562,37
896,3,1823,684,1139,0,0,0,1.0,1,1.0,1,1.0,1,0.21980957645038612,36
897,1,1824,685,1139,0,0,0,1.0,1,1.0,1,1.0,1,0.2051212894311584,36
898,2,1826,686,1140,0,0,0,1.0,1,1.0,1,1.0,1,0.19675826145269312,35
899,1,1827,687,1140,0,0,0,1.0,1,1.0,1,1.0,1,0.2160304102505411,35
900,0,1827,687,1140,0,0,0,1.0,1,1.0,1,1.0,1,0.24824783658224114,36
901,0,1827,687,1140,0,0,0,1.0,1,1.0,1,1.0,1,0.24824783658224114,36
902,6,1833,691,1142,0,0,0,1.0,1,1.0,1,1.0,1,0.3094403839680127,36
903,2,1835,691,1144,0,0,0,1.0,1,1.0,1,1.0,1,0.2707874171017467,35
904,4,1839,693,1146,0,0,0,1.0,1,1.0,1,1.0,1,0.2017808066993052,37
905,3,1842,695,1147,0,0,0,1.0,1,1.0,1,1.0,1,0.19464827177886085,36
906,3,1845,696,1149,0,0,0,1.0,1,1.0,1,1.0,1,0.17566501162441567,37
907,5,1850,698,1152,0,0,0,1.0,1,1.0,1,1.0,1,0.09219462602914394,37
908,6,1856,701,1155,0,0,0,1.0,1,1.0,1,1.0,1,0.13732265307151964,36
909,0,1856,701,1155,0,0,0,1.0,1,1.0,1,1.0,1,0.1351337635916585,36
910,2,1858,702,1156,0,0,0,1.0,1,1.0,1,1.0,1,0.14980332300093183,37
911,2,1860,703,1157,0,0,0,1.0,1,1.0,1,1.0,1,0.19907978326079587,36
912,1,1861,704,1157,0,0,0,1.0,1,1.0,1,1.0,1,0.18310262052291415,34
913,2,1863,704,1159,0,0,0,1.0,1,1.0,1,1.0,1,0.16543447605294273,34
914,2,1865,705,1160,0,0,0,1.0,1,1.0,1,1.0,1,0.1677480490266483,33
915,1,1866,705,1161,0,0,0,1.0,1,1.0,1,1.0,1,0.1786755683128646,33
916,2,1868,705,1163,0,0,0,1.0,1,1.0,1,1.0,1,0.14839845874738516,34
917,1,1869,706,1163,0,0,0,1.0,1,1.0,1,1.0,1,0.14395454336566427,34
918,3,1872,706,1166,0,0,0,1.0,1,1.0,1,1.0,1,0.12192636078602968,36
919,0,1872,706,1166,0,0,0,1.0,1,1.0,1,1.0,1,0.12192636078602968,36
920,0,1872,706,1166,0,0,0,1.0,1,1.0,1,1.0,1,0.12239143363466154,37
921,0,1872,706,1166,0,0,0,1.0,1,1.0,1,1.0,1,0.12239143363466154,37
922,2,1874,707,1167,0,0,0,1.0,1,1.0,1,1.0,1,0.11092364671886927,38
923,1,1875,708,1167,0,0,0,1.0,1,1.0,1,1.0,1,0.12325854572213608,36
924,2,1877,710,1167,0,0,0,1.0,1,1.0,1,1.0,1,0.16846555547250827,35
925,6,1883,711,1172,0,0,0,1.0,1,1.0,1,1.0,1,0.17600718555369643,35
926,3,1886,712,1174,0,0,0,1.0,1,1.0,1,1.0,1,0.11838270603223866,34
927,0,1886,712,1174,0,0,0,1.0,1,1.0,1,1.0,1,0.14501727216947943,32
928,1,1887,713,1174,0,0,0,1.0,1,1.0,1,1.0,1,0.19923919062613246,32
929,3,1890,715,1175,0,0,0,1.0,1,1.0,1,1.0,1,0.19549261502163795,31
930,1,1891,715,1176,0,0,0,1.0,1,1.0,1,1.0,1,0.1834921929463981,30
931,3,1894,716,1178,0,0,0,1.0,1,1.0,1,1.0,1,0.20644445037896184,29
932,0,1894,716,1178,0,0,0,1.0,1,1.0,1,1.0,1,0.20644445037896184,29
933,2,1896,716,1180,0,0,0,1.0,1,1.0,1,1.0,1,0.18347114009881865,29
934,0,1896,716,1180,0,0,0,1.0,1,1.0,1,1.0,1,0.18347114009881865,29
935,1,1897,716,1181,0,0,0,1.0,1,1.0,1,1.0,1,0.18646639860550956,31
936,2,1899,717,1182,0,0,0,1.0,1,1.0,1,1.0,1,0.15857503182011784,31
937,0,1899,717,1182,0,0,0,1.0,1,1.0,1,1.0,1,0.16711603070469014,34
938,0,1899,717,1182,0,0,0,1.0,1,1.0,1,1.0,1,0.17693263734016879,33
939,2,1901,717,1184,0,0,0,1.0,1,1.0,1,1.0,1,0.17120680147163259,36
940,2,1903,717,1186,0,0,0,1.0,1,1.0,1,1.0,1,0.14414219878229595,36
941,3,1906,719,1187,0,0,0,1.0,1,1.0,1,1.0,1,0.1874945976812499,36
942,4,1910,720,1190,0,0,0,1.0,1,1.0,1,1.0,1,0.17569026817950928,36
943,4,1914,720,1194,0,0,0,1.0,1,1.0,1,1.0,1,0.08767699734136589,35
944,1,1915,721,1194,0,0,0,1.0,1,1.0,1,1.0,1,0.08107096045899735,35
945,2,1917,722,1195,0,0,0,1.0,1,1.0,1,1.0,1,0.11676128432516594,33
946,3,1920,724,1196,0,0,0,1.0,1,1.0,1,1.0,1,0.12726826233011845,36
947,1,1921,725,1196,0,0,0,1.0,1,1.0,1,1.0,1,0.17077540539071426,34
948,1,1922,726,1196,0,0,0,1.0,1,1.0,1,1.0,1,0.24128975817424486,33
949,5,1927,727,1200,0,0,0,1.0,1,1.0,1,1.0,1,0.2528096873236328,34
950,0,1927,727,1200,0,0,0,1.0,1,1.0,1,1.0,1,0.2807801125733563,33
951,0,1927,727,1200,0,0,0,1.0,1,1.0,1,1.0,1,0.2807801125733563,33
952,2,1929,727,1202,0,0,0,1.0,1,1.0,1,1.0,1,0.2591904242343134,32
953,0,1929,727,1202,0,0,0,1.0,1,1.0,1,1.0,1,0.2591904242343134,32
954,2,1931,727,1204,0,0,0,1.0,1,1.0,1,1.0,1,0.25066433359047935,31
955,1,1932,727,1205,0,0,0,1.0,1,1.0,1,1.0,1,0.2278112733049152,32
956,2,1934,728,1206,0,0,0,1.0,1,1.0,1,1.0,1,0.18782652151325455,32
957,3,1937,728,1209,0,0,0,1.0,1,1.0,1,1.0,1,0.13022130741840868,33
958,0,1937,728,1209,0,0,0,1.0,1,1.0,1,1.0,1,0.14809465826274476,35
959,1,1938,729,1209,0,0,0,1.0,1,1.0,1,1.0,1,0.17139187815679768,36
960,1,1939,729,1210,0,0,0,1.0,1,1.0,1,1.0,1,0.15092840669018548,38
961,2,1941,731,1210,0,0,0,1.0,1,1.0,1,1.0,1,0.22445894576606373,37
962,3,1944,732,1212,0,0,0,1.0,1,1.0,1,1.0,1,0.30736956369341684,35
963,0,1944,732,1212,0,0,0,1.0,1,1.0,1,1.0,1,0.2878940325977386,35
964,5,1949,732,1217,0,0,0,1.0,1,1.0,1,1.0,1,0.16007224200639647,34
965,2,1951,732,1219,0,0,0,1.0,1,1.0,1,1.0,1,0.11676952798967899,35
966,3,1954,732,1222,0,0,0,1.0,1,1.0,1,1.0,1,0.1350865671822718,34
967,3,1957,733,1224,0,0,0,1.0,1,1.0,1,1.0,1,0.13220707061896106,35
968,0,1957,733,1224,0,0,0,1.0,1,1.0,1,1.0,1,0.11903943843864133,36
969,1,1958,734,1224,0,0,0,1.0,1,1.0,1,1.0,1,0.17204862789291572,35
970,3,1961,734,1227,0,0,0,1.0,1,1.0,1,1.0,1,0.13646279919042253,34
971,0,1961,734,1227,0,0,0,1.0,1,1.0,1,1.0,1,0.128699609940306,35
972,1,1962,735,1227,0,0,0,1.0,1,1.0,1,1.0,1,0.11564109255770354,35
973,0,1962,735,1227,0,0,0,1.0,1,1.0,1,1.0,1,0.12861877312112796,36
974,0,1962,735,1227,0,0,0,1.0,1,1.0,1,1.0,1,0.15844879704332285,35
975,0,1962,735,1227,0,0,0,1.0,1,1.0,1,1.0,1,0.13511365097781247,36
976,2,1964,736,1228,0,0,0,1.0,1,1.0,1,1.0,1,0.16591337558079808,38
977,0,1964,736,1228,0,0,0,1.0,1,1.0,1,1.0,1,0.16591337558079808,38
978,0,1964,736,1228,0,0,0,1.0,1,1.0,1,1.0,1,0.16591337558079808,38
979,1,1965,736,1229,0,0,0,1.0,1,1.0,1,1.0,1,0.14754790783306418,39
980,1,1966,737,1229,0,0,0,1.0,1,1.0,1,1.0,1,0.1676104949516431,39
981,2,1968,738,1230,0,0,0,1.0,1,1.0,1,1.0,1,0.18012453393973366,40
982,6,1974,741,1233,0,0,0,1.0,1,1.0,1,1.0,1,0.18313069025545126,40
983,1,1975,742,1233,0,0,0,1.0,1,1.0,1,1.0,1,0.15820241088425138,38
984,1,1976,742,1234,0,0,0,1.0,1,1.0,1,1.0,1,0.12787396733155068,39
985,3,1979,745,1234,0,0,0,1.0,1,1.0,1,1.0,1,0.2131188714133845,38
986,4,1983,747,1236,0,0,0,1.0,1,1.0,1,1.0,1,0.22310945632351167,38
987,5,1988,749,1239,0,0,0,1.0,1,1.0,1,1.0,1,0.1993672497949744,38
988,3,1991,749,1242,0,0,0,1.0,1,1.0,1,1.0,1,0.15301950290875774,38
989,4,1995,749,1246,0,0,0,1.0,1,1.0,1,1.0,1,0.15295296041465756,38
990,2,1997,749,1248,0,0,0,1.0,1,1.0,1,1.0,1,0.13381747915822598,38
991,2,1999,750,1249,0,0,0,1.0,1,1.0,1,1.0,1,0.11031049121215074,40
992,1,2000,751,1249,0,0,0,1.0,1,1.0,1,1.0,1,0.12198197124505487,39
993,0,2000,751,1249,0,0,0,1.0,1,1.0,1,1.0,1,0.11003404638171789,38
994,0,2000,751,1249,0,0,0,1.0,1,1.0,1,1.0,1,0.12435911284877643,39
995,0,2000,751,1249,0,0,0,1.0,1,1.0,1,1.0,1,0.12523193090414053,41
996,0,2000,751,1249,0,0,0,1.0,1,1.0,1,1.0,1,0.14432446823528078,40
997,2,2002,751,1251,0,0,0,1.0,1,1.0,1,1.0,1,0.12145736850384303,41
998,2,2004,751,1253,0,0,0,1.0,1,1.0,1,1.0,1,0.08991098736201922,40
999,1,2005,751,1254,0,0,0,1.0,1,1.0,1,1.0,1,0.13523680290344534,40
1000,1,2006,752,1254,0,0,0,1.0,1,1.0,1,1.0,1,0.13072586540572903,40
1001,0,2006,752,1254,0,0,0,1.0,1,1.0,1,1.0,1,0.14580078209844152,39
1002,0,2006,752,1254,0,0,0,1.0,1,1.0,1,1.0,1,0.14580078209844152,39
1003,0,2006,752,1254,0,0,0,1.0,1,1.0,1,1.0,1,0.14580078209844152,39
1004,0,2006,752,1254,0,0,0,1.0,1,1.0,1,1.0,1,0.14580078209844152,39
1005,1,2007,752,1255,0,0,0,1.0,1,1.0,1,1.0,1,0.12491414256351994,40
1006,3,2010,753,1257,0,0,0,1.0,1,1.0,1,1.0,1,0.12294860264894282,41
1007,1,2011,753,1258,0,0,0,1.0,1,1.0,1,1.0,1,0.1117591099789196,42
1008,1,2012,754,1258,0,0,0,1.0,1,1.0,1,1.0,1,0.12192684250679274,43
1009,0,2012,754,1258,0,0,0,1.0,1,1.0,1,1.0,1,0.12150236645795848,44
1010,0,2012,754,1258,0,0,0,1.0,1,1.0,1,1.0,1,0.12150236645795848,44
1011,1,2013,755,1258,0,0,0,1.0,1,1.0,1,1.0,1,0.15747869054714794,44
1012,6,2019,757,1262,0,0,0,1.0,1,1.0,1,1.0,1,0.14301964858551433,46
1013,1,2020,757,1263,0,0,0,1.0,1,1.0,1,1.0,1,0.12735951480174865,46
1014,3,2023,758,1265,0,0,0,1.0,1,1.0,1,1.0,1,0.15363017965361264,46
1015,0,2023,758,1265,0,0,0,1.0,1,1.0,1,1.0,1,0.15363017965361264,46
1016,1,2024,759,1265,0,0,0,1.0,1,1.0,1,1.0,1,0.17048749911975314,47
1017,2,2026,759,1267,0,0,0,1.0,1,1.0,1,1.0,1,0.1559455309896328,47
1018,3,2029,759,1270,0,0,0,1.0,1,1.0,1,1.0,1,0.13437755826698072,48
1019,4,2033,760,1273,0,0,0,1.0,1,1.0,1,1.0,1,0.11279083892728264,49
1020,2,2035,760,1275,0,0,0,1.0,1,1.0,1,1.0,1,0.10965542627282678,51
1021,0,2035,760,1275,0,0,0,1.0,1,1.0,1,1.0,1,0.10965542627282678,51
1022,0,2035,760,1275,0,0,0,1.0,1,1.0,1,1.0,1,0.11167234816762255,52
1023,1,2036,760,1276,0,0,0,1.0,1,1.0,1,1.0,1,0.10934427754153218,52
1024,1,2037,761,1276,0,0,0,1.0,1,1.0,1,1.0,1,0.13978466497349065,52
1025,1,2038,761,1277,0,0,0,1.0,1,1.0,1,1.0,1,0.14131293194531916,54
1026,2,2040,762,1278,0,0,0,1.0,1,1.0,1,1.0,1,0.13430322886242163,54
1027,2,2042,763,1279,0,0,0,1.0,1,1.0,1,1.0,1,0.11065411551904605,55
1028,3,2045,764,1281,0,0,0,1.0,1,1.0,1,1.0,1,0.10196766515109332,56
1029,0,2045,764,1281,0,0,0,1.0,1,1.0,1,1.0,1,0.10196766515109332,56
1030,2,2047,764,1283,0,0,0,1.0,1,1.0,1,1.0,1,0.09885829148079116,57
1031,0,2047,764,1283,0,0,0,1.0,1,1.0,1,1.0,1,0.08519065948939333,58
1032,1,2048,765,1283,0,0,0,1.0,1,1.0,1,1.0,1,0.09573722688833577,58
1033,3,2051,766,1285,0,0,0,1.0,1,1.0,1,1.0,1,0.0604594788180322,57
1034,1,2052,767,1285,0,0,0,1.0,1,1.0,1,1.0,1,0.08973520256951711,57
1035,3,2055,769,1286,0,0,0,1.0,1,1.0,1,1.0,1,0.11635502502492928,57
1036,4,2059,770,1289,0,0,0,1.0,1,1.0,1,1.0,1,0.09548857912504646,59
1037,2,2061,772,1289,0,0,0,1.0,1,1.0,1,1.0,1,0.10662948625297351,57
1038,8,2069,774,1295,0,0,0,1.0,1,1.0,1,1.0,1,0.10987647901131191,59
1039,6,2075,780,1295,0,0,0,1.0,1,1.0,1,1.0,1,0.13353121528391365,57
1040,4,2079,781,1298,0,0,0,1.0,1,1.0,1,1.0,1,0.15535691646632083,56
1041,0,2079,781,1298,0,0,0,1.0,1,1.0,1,1.0,1,0.14733901583235984,54
1042,2,2081,781,1300,0,0,0,1.0,1,1.0,1,1.0,1,0.09712189893955533,52
1043,1,2082,782,1300,0,0,0,1.0,1,1.0,1,1.0,1,0.11443902671963008,52
1044,1,2083,783,1300,0,0,0,1.0,1,1.0,1,1.0,1,0.10381218985519042,50
1045,6,2089,784,1305,0,0,0,1.0,1,1.0,1,1.0,1,0.09472211246163052,51
1046,3,2092,785,1307,0,0,0,1.0,1,1.0,1,1.0,1,0.10152858000959893,50
1047,1,2093,785,1308,0,0,0,1.0,1,1.0,1,1.0,1,0.08146386086117491,50
1048,1,2094,786,1308,0,0,0,1.0,1,1.0,1,1.0,1,0.08613859565494418,50
1049,1,2095,787,1308,0,0,0,1.0,1,1.0,1,1.0,1,0.11761696257297947,50
1050,0,2095,787,1308,0,0,0,1.0,1,1.0,1,1.0,1,0.11761696257297947,50
1051,1,2096,787,1309,0,0,0,1.0,1,1.0,1,1.0,1,0.08177456598227491,50
1052,2,2098,787,1311,0,0,0,1.0,1,1.0,1,1.0,1,0.090676694810839,51
1053,0,2098,787,1311,0,0,0,1.0,1,1.0,1,1.0,1,0.090676694810839,51
1054,1,2099,787,1312,0,0,0,1.0,1,1.0,1,1.0,1,0.07309133560804291,53
1055,2,2101,787,1314,0,0,0,1.0,1,1.0,1,1.0,1,0.03652500284856467,54
1056,0,2101,787,1314,0,0,0,1.0,1,1.0,1,1.0,1,0.07273230380475075,54
1057,3,2104,789,1315,0,0,0,1.0,1,1.0,1,1.0,1,0.10125220069493192,55
1058,1,2105,789,1316,0,0,0,1.0,1,1.0,1,1.0,1,0.09201736253350744,54
1059,3,2108,791,1317,0,0,0,1.0,1,1.0,1,1.0,1,0.16009103367986102,53
1060,3,2111,791,1320,0,0,0,1.0,1,1.0,1,1.0,1,0.11270126216024728,53
1061,2,2113,792,1321,0,0,0,1.0,1,1.0,1,1.0,1,0.13671682390348588,53
1062,5,2118,797,1321,0,0,0,1.0,1,1.0,1,1.0,1,0.1265105283185367,54
1063,5,2123,797,1326,0,0,0,1.0,1,1.0,1,1.0,1,0.09241769954863358,53
1064,6,2129,801,1328,0,0,0,1.0,1,1.0,1,1.0,1,0.13119612301396372,55
1065,0,2129,801,1328,0,0,0,1.0,1,1.0,1,1.0,1,0.1763591214132262,54
1066,4,2133,803,1330,0,0,0,1.0,1,1.0,1,1.0,1,0.15033967418874952,55
1067,2,2135,804,1331,0,0,0,1.0,1,1.0,1,1.0,1,0.17398623629222482,55
1068,2,2137,805,1332,0,0,0,1.0,1,1.0,1,1.0,1,0.17408670992345532,55
1069,6,2143,806,1337,0,0,0,1.0,1,1.0,1,1.0,1,0.1459370030234461,55
1070,1,2144,806,1338,0,0,0,1.0,1,1.0,1,1.0,1,0.15857177300231745,54
1071,1,2145,806,1339,0,0,0,1.0,1,1.0,1,1.0,1,0.1344927631707175,55
1072,2,2147,807,1340,0,0,0,1.0,1,1.0,1,1.0,1,0.12441959091373447,54
1073,2,2149,808,1341,0,0,0,1.0,1,1.0,1,1.0,1,0.10954652251562974,54
1074,2,2151,810,1341,0,0,0,1.0,1,1.0,1,1.0,1,0.12619362473895668,52
1075,5,2156,812,1344,0,0,0,1.0,1,1.0,1,1.0,1,0.12687449777232832,51
1076,2,2158,812,1346,0,0,0,1.0,1,1.0,1,1.0,1,0.14023130264620226,52
1077,2,2160,814,1346,0,0,0,1.0,1,1.0,1,1.0,1,0.10924307454443853,49
1078,4,2164,816,1348,0,0,0,1.0,1,1.0,1,1.0,1,0.13664528947130486,48
1079,3,2167,818,1349,0,0,0,1.0,1,1.0,1,1.0,1,0.12895425632154392,47
1080,1,2168,819,1349,0,0,0,1.0,1,1.0,1,1.0,1,0.1664632510225076,47
1081,3,2171,820,1351,0,0,0,1.0,1,1.0,1,1.0,1,0.14752098116130655,45
1082,0,2171,820,1351,0,0,0,1.0,1,1.0,1,1.0,1,0.18750257432246686,42
1083,2,2173,822,1351,0,0,0,1.0,1,1.0,1,1.0,1,0.24044913620256128,42
1084,2,2175,822,1353,0,0,0,1.0,1,1.0,1,1.0,1,0.210270177779956,40
1085,1,2176,822,1354,0,0,0,1.0,1,1.0,1,1.0,1,0.17802061484002832,43
1086,2,2178,822,1356,0,0,0,1.0,1,1.0,1,1.0,1,0.15098710528926254,41
1087,2,2180,822,1358,0,0,0,1.0,1,1.0,1,1.0,1,0.1498928578417745,41
1088,1,2181,822,1359,0,0,0,1.0,1,1.0,1,1.0,1,0.13507045136972845,41
1089,2,2183,824,1359,0,0,0,1.0,1,1.0,1,1.0,1,0.14023004767888136,42
1090,4,2187,824,1363,0,0,0,1.0,1,1.0,1,1.0,1,0.10352592790818019,43
1091,4,2191,826,1365,0,0,0,1.0,1,1.0,1,1.0,1,0.13147167069665067,43
1092,1,2192,826,1366,0,0,0,1.0,1,1.0,1,1.0,1,0.11758240825239176,43
1093,1,2193,827,1366,0,0,0,1.0,1,1.0,1,1.0,1,0.1269716595087747,43
1094,0,2193,827,1366,0,0,0,1.0,1,1.0,1,1.0,1,0.1269716595087747,43
1095,0,2193,827,1366,0,0,0,1.0,1,1.0,1,1.0,1,0.12186808250534019,44
1096,1,2194,828,1366,0,0,0,1.0,1,1.0,1,1.0,1,0.12760443327909937,44
1097,3,2197,830,1367,0,0,0,1.0,1,1.0,1,1.0,1,0.1726126908802279,45
1098,0,2197,830,1367,0,0,0,1.0,1,1.0,1,1.0,1,0.17705565164462064,46
1099,2,2199,831,1368,0,0,0,1.0,1,1.0,1,1.0,1,0.20694366243436307,48
1100,1,2200,831,1369,0,0,0,1.0,1,1.0,1,1.0,1,0.16715988698467846,49
1101,0,2200,831,1369,0,0,0,1.0,1,1.0,1,1.0,1,0.16715988698467846,49
1102,4,2204,834,1370,0,0,0,1.0,1,1.0,1,1.0,1,0.17693283408373828,50
1103,3,2207,835,1372,0,0,0,1.0,1,1.0,1,1.0,1,0.1442173178887386,48
1104,4,2211,839,1372,0,0,0,1.0,1,1.0,1,1.0,1,0.18579328401275447,50
1105,4,2215,841,1374,0,0,0,1.0,1,1.0,1,1.0,1,0.09463279561800646,48
1106,1,2216,841,1375,0,0,0,1.0,1,1.0,1,1.0,1,0.10544953200140533,48
1107,4,2220,842,1378,0,0,0,1.0,1,1.0,1,1.0,1,0.12738351884191146,47
1108,3,2223,843,1380,0,0,0,1.0,1,1.0,1,1.0,1,0.08309441987591305,47
1109,2,2225,845,1380,0,0,0,1.0,1,1.0,1,1.0,1,0.10792891193188398,46
1110,2,2227,846,1381,0,0,0,1.0,1,1.0,1,1.0,1,0.12543657435758762,43
1111,5,2232,848,1384,0,0,0,1.0,1,1.0,1,1.0,1,0.13385064743232614,44
1112,5,2237,851,1386,0,0,0,1.0,1,1.0,1,1.0,1,0.1609249935260873,43
1113,1,2238,852,1386,0,0,0,1.0,1,1.0,1,1.0,1,0.21068212657296026,39
1114,3,2241,852,1389,0,0,0,1.0,1,1.0,1,1.0,1,0.13968732454414784,39
1115,2,2243,853,1390,0,0,0,1.0,1,1.0,1,1.0,1,0.09910007907808713,37
1116,5,2248,855,1393,0,0,0,1.0,1,1.0,1,1.0,1,0.07937050259649461,37
1117,6,2254,858,1396,0,0,0,1.0,1,1.0,1,1.0,1,0.10421724541237899,36
1118,1,2255,859,1396,0,0,0,1.0,1,1.0,1,1.0,1,0.14008173363112753,36
1119,0,2255,859,1396,0,0,0,1.0,1,1.0,1,1.0,1,0.14008173363112753,36
1120,1,2256,859,1397,0,0,0,1.0,1,1.0,1,1.0,1,0.11148082235965634,36
1121,1,2257,860,1397,0,0,0,1.0,1,1.0,1,1.0,1,0.13787828218589346,36
1122,0,2257,860,1397,0,0,0,1.0,1,1.0,1,1.0,1,0.16589537020116588,37
1123,1,2258,861,1397,0,0,0,1.0,1,1.0,1,1.0,1,0.2244945204657739,37
1124,1,2259,861,1398,0,0,0,1.0,1,1.0,1,1.0,1,0.19171868576212406,37
1125,0,2259,861,1398,0,0,0,1.0,1,1.0,1,1.0,1,0.1981809976119941,38
1126,2,2261,862,1399,0,0,0,1.0,1,1.0,1,1.0,1,0.18082063487621428,38
1127,4,2265,862,1403,0,0,0,1.0,1,1.0,1,1.0,1,0.1492975227100027,39
1128,0,2265,862,1403,0,0,0,1.0,1,1.0,1,1.0,1,0.1492975227100027,39
1129,1,2266,862,1404,0,0,0,1.0,1,1.0,1,1.0,1,0.1344476563622081,39
1130,1,2267,862,1405,0,0,0,1.0,1,1.0,1,1.0,1,0.12396416807725363,39
1131,0,2267,862,1405,0,0,0,1.0,1,1.0,1,1.0,1,0.12396416807725363,39
1132,1,2268,863,1405,0,0,0,1.0,1,1.0,1,1.0,1,0.1461782532676897,39
1133,0,2268,863,1405,0,0,0,1.0,1,1.0,1,1.0,1,0.13664839983028598,42
1134,0,2268,863,1405,0,0,0,1.0,1,1.0,1,1.0,1,0.13664839983028598,42
1135,4,2272,864,1408,0,0,0,1.0,1,1.0,1,1.0,1,0.17823284471637169,44
1136,2,2274,865,1409,0,0,0,1.0,1,1.0,1,1.0,1,0.17205093814818262,46
1137,0,2274,865,1409,0,0,0,1.0,1,1.0,1,1.0,1,0.1877241889888174,45
1138,3,2277,866,1411,0,0,0,1.0,1,1.0,1,1.0,1,0.14984319601309795,46
1139,3,2280,867,1413,0,0,0,1.0,1,1.0,1,1.0,1,0.16891378939504104,47
1140,1,2281,867,1414,0,0,0,1.0,1,1.0,1,1.0,1,0.1705955529521709,46
1141,1,2282,867,1415,0,0,0,1.0,1,1.0,1,1.0,1,0.1805991397789,45
1142,3,2285,869,1416,0,0,0,1.0,1,1.0,1,1.0,1,0.18053113600108092,45
1143,1,2286,869,1417,0,0,0,1.0,1,1.0,1,1.0,1,0.17359331763951721,43
1144,6,2292,871,1421,0,0,0,1.0,1,1.0,1,1.0,1,0.07164325330591081,45
1145,2,2294,872,1422,0,0,0,1.0,1,1.0,1,1.0,1,0.09787420825242524,44
1146,1,2295,873,1422,0,0,0,1.0,1,1.0,1,1.0,1,0.0971391559420584,45
1147,2,2297,874,1423,0,0,0,1.0,1,1.0,1,1.0,1,0.10982452950312746,44
1148,1,2298,875,1423,0,0,0,1.0,1,1.0,1,1.0,1,0.12125308765118283,43
1149,3,2301,876,1425,0,0,0,1.0,1,1.0,1,1.0,1,0.16151916505698125,42
1150,8,2309,878,1431,0,0,0,1.0,1,1.0,1,1.0,1,0.1404919195715878,45
1151,1,2310,879,1431,0,0,0,1.0,1,1.0,1,1.0,1,0.2033887519286221,40
1152,5,2315,882,1433,0,0,0,1.0,1,1.0,1,1.0,1,0.20421245075828404,41
1153,9,2324,884,1440,0,0,0,1.0,1,1.0,1,1.0,1,0.15205566295784487,38
1154,4,2328,884,1444,0,0,0,1.0,1,1.0,1,1.0,1,0.1339587262592497,37
1155,4,2332,884,1448,0,0,0,1.0,1,1.0,1,1.0,1,0.139991996327197,38
1156,1,2333,885,1448,0,0,0,1.0,1,1.0,1,1.0,1,0.17921434948933732,38
1157,1,2334,885,1449,0,0,0,1.0,1,1.0,1,1.0,1,0.15276294289863726,37
1158,0,2334,885,1449,0,0,0,1.0,1,1.0,1,1.0,1,0.1824652426580474,36
1159,3,2337,885,1452,0,0,0,1.0,1,1.0,1,1.0,1,0.11597235363634618,35
1160,1,2338,885,1453,0,0,0,1.0,1,1.0,1,1.0,1,0.09901866403732933,35
1161,0,2338,885,1453,0,0,0,1.0,1,1.0,1,1.0,1,0.10726580466704334,36
1162,0,2338,885,1453,0,0,0,1.0,1,1.0,1,1.0,1,0.12121865855447198,37
1163,0,2338,885,1453,0,0,0,1.0,1,1.0,1,1.0,1,0.12121865855447198,37
1164,0,2338,885,1453,0,0,0,1.0,1,1.0,1,1.0,1,0.13069347527623335,38
1165,1,2339,886,1453,0,0,0,1.0,1,1.0,1,1.0,1,0.1371679008513391,38
1166,0,2339,886,1453,0,0,0,1.0,1,1.0,1,1.0,1,0.13431466957856347,40
1167,4,2343,888,1455,0,0,0,1.0,1,1.0,1,1.0,1,0.12549305938410837,40
1168,3,2346,888,1458,0,0,0,1.0,1,1.0,1,1.0,1,0.06866281063003912,40
1169,2,2348,889,1459,0,0,0,1.0,1,1.0,1,1.0,1,0.0852818247140118,41
1170,2,2350,890,1460,0,0,0,1.0,1,1.0,1,1.0,1,0.06618166962013576,41
1171,0,2350,890,1460,0,0,0,1.0,1,1.0,1,1.0,1,0.07799021107195651,43
1172,0,2350,890,1460,0,0,0,1.0,1,1.0,1,1.0,1,0.07799021107195651,43
1173,0,2350,890,1460,0,0,0,1.0,1,1.0,1,1.0,1,0.07799021107195651,43
1174,1,2351,891,1460,0,0,0,1.0,1,1.0,1,1.0,1,0.09805534395301391,43
1175,0,2351,891,1460,0,0,0,1.0,1,1.0,1,1.0,1,0.1123743775492524,44
1176,2,2353,892,1461,0,0,0,1.0,1,1.0,1,1.0,1,0.13100141366824133,45
1177,4,2357,894,1463,0,0,0,1.0,1,1.0,1,1.0,1,0.10950974110947273,45
1178,1,2358,894,1464,0,0,0,1.0,1,1.0,1,1.0,1,0.09864656246165697,45
1179,2,2360,895,1465,0,0,0,1.0,1,1.0,1,1.0,1,0.14216261785171222,46
1180,1,2361,895,1466,0,0,0,1.0,1,1.0,1,1.0,1,0.12136719193360077,47
1181,1,2362,895,1467,0,0,0,1.0,1,1.0,1,1.0,1,0.11375990704165302,48
1182,2,2364,897,1467,0,0,0,1.0,1,1.0,1,1.0,1,0.14169440158068217,48
1183,0,2364,897,1467,0,0,0,1.0,1,1.0,1,1.0,1,0.13318838619040285,46
1184,2,2366,899,1467,0,0,0,1.0,1,1.0,1,1.0,1,0.16281589217901118,47
1185,2,2368,900,1468,0,0,0,1.0,1,1.0,1,1.0,1,0.1857662166120409,44
1186,6,2374,900,1474,0,0,0,1.0,1,1.0,1,1.0,1,0.11407865799832033,47
1187,4,2378,901,1477,0,0,0,1.0,1,1.0,1,1.0,1,0.16962759168047684,49
1188,4,2382,902,1480,0,0,0,1.0,1,1.0,1,1.0,1,0.14877990098627178,50
1189,0,2382,902,1480,0,0,0,1.0,1,1.0,1,1.0,1,0.12216720275471825,48
1190,2,2384,904,1480,0,0,0,1.0,1,1.0,1,1.0,1,0.17033009749578815,48
1191,0,2384,904,1480,0,0,0,1.0,1,1.0,1,1.0,1,0.1787744449965041,46
1192,3,2387,905,1482,0,0,0,1.0,1,1.0,1,1.0,1,0.1695805146492225,46
1193,1,2388,905,1483,0,0,0,1.0,1,1.0,1,1.0,1,0.17281979023188496,45
1194,0,2388,905,1483,0,0,0,1.0,1,1.0,1,1.0,1,0.17281979023188496,45
1195,5,2393,906,1487,0,0,0,1.0,1,1.0,1,1.0,1,0.151778852317716,47
1196,1,2394,906,1488,0,0,0,1.0,1,1.0,1,1.0,1,0.14700938643311554,48
1197,0,2394,906,1488,0,0,0,1.0,1,1.0,1,1.0,1,0.131161212615891,49
1198,4,2398,907,1491,0,0,0,1.0,1,1.0,1,1.0,1,0.10973285675539293,49
1199,1,2399,907,1492,0,0,0,1.0,1,1.0,1,1.0,1,0.12629296363094086,50
1200,1,2400,908,1492,0,0,0,1.0,1,1.0,1,1.0,1,0.13724385772671643,50
1201,2,2402,908,1494,0,0,0,1.0,1,1.0,1,1.0,1,0.09342615132514434,50
1202,1,2403,909,1494,0,0,0,1.0,1,1.0,1,1.0,1,0.10123430777930867,51
1203,0,2403,909,1494,0,0,0,1.0,1,1.0,1,1.0,1,0.09836310011710017,52
1204,0,2403,909,1494,0,0,0,1.0,1,1.0,1,1.0,1,0.09836310011710017,52
1205,5,2408,910,1498,0,0,0,1.0,1,1.0,1,1.0,1,0.11042433086828055,53
1206,0,2408,910,1498,0,0,0,1.0,1,1.0,1,1.0,1,0.11042433086828055,53
1207,2,2410,910,1500,0,0,0,1.0,1,1.0,1,1.0,1,0.09977236618929122,55
1208,3,2413,911,1502,0,0,0,1.0,1,1.0,1,1.0,1,0.10602420492143527,56
1209,0,2413,911,1502,0,0,0,1.0,1,1.0,1,1.0,1,0.11677740043595117,55
1210,0,2413,911,1502,0,0,0,1.0,1,1.0,1,1.0,1,0.11677740043595117,55
1211,0,2413,911,1502,0,0,0,1.0,1,1.0,1,1.0,1,0.09804995271811387,57
1212,1,2414,912,1502,0,0,0,1.0,1,1.0,1,1.0,1,0.10756080401792917,57
1213,0,2414,912,1502,0,0,0,1.0,1,1.0,1,1.0,1,0.10756080401792917,57
1214,7,2421,916,1505,0,0,0,1.0,1,1.0,1,1.0,1,0.16806727868166466,57
1215,3,2424,916,1508,0,0,0,1.0,1,1.0,1,1.0,1,0.1318427232413017,59
1216,2,2426,916,1510,0,0,0,1.0,1,1.0,1,1.0,1,0.12405037642473701,61
1217,0,2426,916,1510,0,0,0,1.0,1,1.0,1,1.0,1,0.12405037642473701,61
1218,3,2429,917,1512,0,0,0,1.0,1,1.0,1,1.0,1,0.1391701020290882,61
1219,1,2430,918,1512,0,0,0,1.0,1,1.0,1,1.0,1,0.14179637136354845,61
1220,3,2433,920,1513,0,0,0,1.0,1,1.0,1,1.0,1,0.14439529407557034,60
1221,1,2434,920,1514,0,0,0,1.0,1,1.0,1,1.0,1,0.15398431467035312,61
1222,3,2437,920,1517,0,0,0,1.0,1,1.0,1,1.0,1,0.11365558488621202,61
1223,2,2439,921,1518,0,0,0,1.0,1,1.0,1,1.0,1,0.1314094395645382,59
1224,5,2444,922,1522,0,0,0,1.0,1,1.0,1,1.0,1,0.12427624634977491,60
1225,7,2451,923,1528,0,0,0,1.0,1,1.0,1,1.0,1,0.11505976845882766,60
1226,8,2459,925,1534,0,0,0,1.0,1,1.0,1,1.0,1,0.084202592473571,61
1227,3,2462,926,1536,0,0,0,1.0,1,1.0,1,1.0,1,0.09022773277351669,59
1228,4,2466,927,1539,0,0,0,1.0,1,1.0,1,1.0,1,0.05894614626754786,58
1229,3,2469,927,1542,0,0,0,1.0,1,1.0,1,1.0,1,0.04523841263466318,57
1230,0,2469,927,1542,0,0,0,1.0,1,1.0,1,1.0,1,0.07109699416110202,55
1231,2,2471,927,1544,0,0,0,1.0,1,1.0,1,1.0,1,0.07236272294672065,54
1232,3,2474,930,1544,0,0,0,1.0,1,1.0,1,1.0,1,0.11478013690150875,51
1233,2,2476,932,1544,0,0,0,1.0,1,1.0,1,1.0,1,0.14022080509290044,49
1234,8,2484,935,1549,0,0,0,1.0,1,1.0,1,1.0,1,0.14345902129108606,49
1235,1,2485,935,1550,0,0,0,1.0,1,1.0,1,1.0,1,0.15828540144292821,48
1236,2,2487,935,1552,0,0,0,1.0,1,1.0,1,1.0,1,0.16605463452353775,49
1237,9,2496,936,1560,0,0,0,1.0,1,1.0,1,1.0,1,0.15887108637283712,48
1238,0,2496,936,1560,0,0,0,1.0,1,1.0,1,1.0,1,0.1728359298575037,47
1239,2,2498,936,1562,0,0,0,1.0,1,1.0,1,1.0,1,0.14230095498728043,48
1240,4,2502,936,1566,0,0,0,1.0,1,1.0,1,1.0,1,0.11433517735945763,49
1241,2,2504,936,1568,0,0,0,1.0,1,1.0,1,1.0,1,0.11382059443972244,49
1242,1,2505,936,1569,0,0,0,1.0,1,1.0,1,1.0,1,0.12286777443700687,49
1243,2,2507,936,1571,0,0,0,1.0,1,1.0,1,1.0,1,0.10623938675226675,50
1244,1,2508,937,1571,0,0,0,1.0,1,1.0,1,1.0,1,0.1479999531733362,50
1245,5,2513,938,1575,0,0,0,1.0,1,1.0,1,1.0,1,0.13092135481447123,51
1246,5,2518,939,1579,0,0,0,1.0,1,1.0,1,1.0,1,0.14479619783934117,52
1247,0,2518,939,1579,0,0,0,1.0,1,1.0,1,1.0,1,0.14479619783934117,52
1248,2,2520,940,1580,0,0,0,1.0,1,1.0,1,1.0,1,0.17409830153112016,51
1249,3,2523,941,1582,0,0,0,1.0,1,1.0,1,1.0,1,0.14869368796119067,51
1250,1,2524,941,1583,0,0,0,1.0,1,1.0,1,1.0,1,0.1289279968161113,51
1251,3,2527,941,1586,0,0,0,1.0,1,1.0,1,1.0,1,0.10819788975361838,53
1252,3,2530,942,1588,0,0,0,1.0,1,1.0,1,1.0,1,0.08539456223821205,52
1253,0,2530,942,1588,0,0,0,1.0,1,1.0,1,1.0,1,0.08539456223821205,52
1254,0,2530,942,1588,0,0,0,1.0,1,1.0,1,1.0,1,0.09056469465985437,53
1255,1,2531,943,1588,0,0,0,1.0,1,1.0,1,1.0,1,0.10089325266855309,55
1256,0,2531,943,1588,0,0,0,1.0,1,1.0,1,1.0,1,0.10089325266855309,55
1257,2,2533,943,1590,0,0,0,1.0,1,1.0,1,1.0,1,0.10147342187035432,57
1258,1,2534,943,1591,0,0,0,1.0,1,1.0,1,1.0,1,0.09038396103414637,57
1259,1,2535,943,1592,0,0,0,1.0,1,1.0,1,1.0,1,0.09081477120106944,57
1260,0,2535,943,1592,0,0,0,1.0,1,1.0,1,1.0,1,0.08903331274315732,56
1261,0,2535,943,1592,0,0,0,1.0,1,1.0,1,1.0,1,0.0890055523380342,57
1262,0,2535,943,1592,0,0,0,1.0,1,1.0,1,1.0,1,0.10063970375491553,58
1263,4,2539,945,1594,0,0,0,1.0,1,1.0,1,1.0,1,0.09155593304709567,58
1264,1,2540,945,1595,0,0,0,1.0,1,1.0,1,1.0,1,0.10388726494541893,57
1265,7,2547,949,1598,0,0,0,1.0,1,1.0,1,1.0,1,0.10497567615590893,56
1266,2,2549,950,1599,0,0,0,1.0,1,1.0,1,1.0,1,0.10189812435244316,55
1267,6,2555,953,1602,0,0,0,1.0,1,1.0,1,1.0,1,0.10627491954503773,53
1268,5,2560,957,1603,0,0,0,1.0,1,1.0,1,1.0,1,0.17873531496269224,52
1269,3,2563,959,1604,0,0,0,1.0,1,1.0,1,1.0,1,0.17909737570093998,51
1270,2,2565,959,1606,0,0,0,1.0,1,1.0,1,1.0,1,0.12735337217844306,47
1271,0,2565,959,1606,0,0,0,1.0,1,1.0,1,1.0,1,0.1428377016457637,46
1272,1,2566,960,1606,0,0,0,1.0,1,1.0,1,1.0,1,0.13940061830761882,43
1273,5,2571,962,1609,0,0,0,1.0,1,1.0,1,1.0,1,0.12038219774110889,44
1274,1,2572,963,1609,0,0,0,1.0,1,1.0,1,1.0,1,0.12285543648885136,44
1275,2,2574,964,1610,0,0,0,1.0,1,1.0,1,1.0,1,0.10953024236883004,45
1276,1,2575,964,1611,0,0,0,1.0,1,1.0,1,1.0,1,0.06879941403601289,43
1277,2,2577,966,1611,0,0,0,1.0,1,1.0,1,1.0,1,0.1006772320118228,44
1278,3,2580,969,1611,0,0,0,1.0,1,1.0,1,1.0,1,0.14870275003080544,45
1279,4,2584,969,1615,0,0,0,1.0,1,1.0,1,1.0,1,0.10271328640121002,47
1280,2,2586,969,1617,0,0,0,1.0,1,1.0,1,1.0,1,0.0941602662320042,47
1281,3,2589,969,1620,0,0,0,1.0,1,1.0,1,1.0,1,0.07678500366927035,47
1282,0,2589,969,1620,0,0,0,1.0,1,1.0,1,1.0,1,0.07524027907610838,46
1283,1,2590,970,1620,0,0,0,1.0,1,1.0,1,1.0,1,0.08086431704950761,46
1284,0,2590,970,1620,0,0,0,1.0,1,1.0,1,1.0,1,0.08086431704950761,46
1285,2,2592,970,1622,0,0,0,1.0,1,1.0,1,1.0,1,0.07325677276582483,46
1286,1,2593,971,1622,0,0,0,1.0,1,1.0,1,1.0,1,0.12475342537902886,45
1287,2,2595,971,1624,0,0,0,1.0,1,1.0,1,1.0,1,0.1098294760219316,49
1288,0,2595,971,1624,0,0,0,1.0,1,1.0,1,1.0,1,0.1098294760219316,49
1289,1,2596,971,1625,0,0,0,1.0,1,1.0,1,1.0,1,0.09646925869790406,52
1290,0,2596,971,1625,0,0,0,1.0,1,1.0,1,1.0,1,0.09646925869790406,52
1291,0,2596,971,1625,0,0,0,1.0,1,1.0,1,1.0,1,0.09646925869790406,52
1292,1,2597,971,1626,0,0,0,1.0,1,1.0,1,1.0,1,0.07904597947231176,53
1293,0,2597,971,1626,0,0,0,1.0,1,1.0,1,1.0,1,0.07904597947231176,53
1294,0,2597,971,1626,0,0,0,1.0,1,1.0,1,1.0,1,0.07904597947231176,53
1295,3,2600,972,1628,0,0,0,1.0,1,1.0,1,1.0,1,0.0868834459269344,54
1296,1,2601,972,1629,0,0,0,1.0,1,1.0,1,1.0,1,0.07642188383157528,55
1297,1,2602,972,1630,0,0,0,1.0,1,1.0,1,1.0,1,0.06889850330196595,54
1298,1,2603,972,1631,0,0,0,1.0,1,1.0,1,1.0,1,0.07428216358491666,55
1299,0,2603,972,1631,0,0,0,1.0,1,1.0,1,1.0,1,0.0923097740333535,54
1300,2,2605,973,1632,0,0,0,1.0,1,1.0,1,1.0,1,0.08652911956758551,55
1301,5,2610,976,1634,0,0,0,1.0,1,1.0,1,1.0,1,0.12511395598944455,54
1302,4,2614,978,1636,0,0,0,1.0,1,1.0,1,1.0,1,0.14402563583119501,54
1303,8,2622,980,1642,0,0,0,1.0,1,1.0,1,1.0,1,0.16777259219781512,50
1304,6,2628,985,1643,0,0,0,1.0,1,1.0,1,1.0,1,0.13318261186589572,51
1305,1,2629,986,1643,0,0,0,1.0,1,1.0,1,1.0,1,0.1897844055046691,48
1306,8,2637,990,1647,0,0,0,1.0,1,1.0,1,1.0,1,0.19990583725434288,48
1307,2,2639,991,1648,0,0,0,1.0,1,1.0,1,1.0,1,0.15556412017331758,48
1308,0,2639,991,1648,0,0,0,1.0,1,1.0,1,1.0,1,0.17810798215426926,46
1309,5,2644,992,1652,0,0,0,1.0,1,1.0,1,1.0,1,0.15569305586277019,47
1310,1,2645,992,1653,0,0,0,1.0,1,1.0,1,1.0,1,0.17690030832199122,46
1311,4,2649,995,1654,0,0,0,1.0,1,1.0,1,1.0,1,0.19218094081233006,46
1312,5,2654,997,1657,0,0,0,1.0,1,1.0,1,1.0,1,0.17583036816314923,45
1313,4,2658,998,1660,0,0,0,1.0,1,1.0,1,1.0,1,0.17791918887835562,44
1314,0,2658,998,1660,0,0,0,1.0,1,1.0,1,1.0,1,0.18818330681526663,42
1315,4,2662,999,1663,0,0,0,1.0,1,1.0,1,1.0,1,0.1657101566517745,40
1316,4,2666,999,1667,0,0,0,1.0,1,1.0,1,1.0,1,0.1189380231394367,42
1317,1,2667,999,1668,0,0,0,1.0,1,1.0,1,1.0,1,0.09203936861114617,42
1318,0,2667,999,1668,0,0,0,1.0,1,1.0,1,1.0,1,0.09203936861114617,42
1319,1,2668,1000,1668,0,0,0,1.0,1,1.0,1,1.0,1,0.12806468869849588,42
1320,0,2668,1000,1668,0,0,0,1.0,1,1.0,1,1.0,1,0.12806468869849588,42
1321,0,2668,1000,1668,0,0,0,1.0,1,1.0,1,1.0,1,0.12591410801799127,45
1322,1,2669,1000,1669,0,0,0,1.0,1,1.0,1,1.0,1,0.11527353825491037,45
1323,1,2670,1000,1670,0,0,0,1.0,1,1.0,1,1.0,1,0.10868538948789126,46
1324,0,2670,1000,1670,0,0,0,1.0,1,1.0,1,1.0,1,0.1268907587099884,45
1325,2,2672,1001,1671,0,0,0,1.0,1,1.0,1,1.0,1,0.11699670135687809,46
1326,1,2673,1002,1671,0,0,0,1.0,1,1.0,1,1.0,1,0.17139985971755017,45
1327,4,2677,1002,1675,0,0,0,1.0,1,1.0,1,1.0,1,0.13487700116489823,46
1328,1,2678,1002,1676,0,0,0,1.0,1,1.0,1,1.0,1,0.12967761673421296,47
1329,1,2679,1003,1676,0,0,0,1.0,1,1.0,1,1.0,1,0.13230025450069727,47
1330,3,2682,1003,1679,0,0,0,1.0,1,1.0,1,1.0,1,0.12716449712677658,46
1331,0,2682,1003,1679,0,0,0,1.0,1,1.0,1,1.0,1,0.12716449712677658,46
1332,1,2683,1003,1680,0,0,0,1.0,1,1.0,1,1.0,1,0.14752235201369865,49
1333,1,2684,1003,1681,0,0,0,1.0,1,1.0,1,1.0,1,0.14266371214655615,50
1334,2,2686,1005,1681,0,0,0,1.0,1,1.0,1,1.0,1,0.15759210917371877,50
1335,2,2688,1005,1683,0,0,0,1.0,1,1.0,1,1.0,1,0.16170233480594093,52
1336,0,2688,1005,1683,0,0,0,1.0,1,1.0,1,1.0,1,0.14648087138727325,53
1337,4,2692,1006,1686,0,0,0,1.0,1,1.0,1,1.0,1,0.15347036505598172,54
1338,1,2693,1007,1686,0,0,0,1.0,1,1.0,1,1.0,1,0.17252776523225227,54
1339,4,2697,1008,1689,0,0,0,1.0,1,1.0,1,1.0,1,0.17514621225552432,54
1340,0,2697,1008,1689,0,0,0,1.0,1,1.0,1,1.0,1,0.1846136558240068,53
1341,0,2697,1008,1689,0,0,0,1.0,1,1.0,1,1.0,1,0.16833946290691554,53
1342,5,2702,1010,1692,0,0,0,1.0,1,1.0,1,1.0,1,0.12990684148313356,52
1343,0,2702,1010,1692,0,0,0,1.0,1,1.0,1,1.0,1,0.11810849574144405,50
1344,4,2706,1013,1693,0,0,0,1.0,1,1.0,1,1.0,1,0.16986237220478578,51
1345,4,2710,1013,1697,0,0,0,1.0,1,1.0,1,1.0,1,0.11695718308704305,50
1346,2,2712,1015,1697,0,0,0,1.0,1,1.0,1,1.0,1,0.13546480742669353,50
1347,0,2712,1015,1697,0,0,0,1.0,1,1.0,1,1.0,1,0.10818450964514054,48
1348,0,2712,1015,1697,0,0,0,1.0,1,1.0,1,1.0,1,0.1187356063600482,49
1349,0,2712,1015,1697,0,0,0,1.0,1,1.0,1,1.0,1,0.12819192396795692,48
1350,1,2713,1016,1697,0,0,0,1.0,1,1.0,1,1.0,1,0.12595469176440705,49
1351,0,2713,1016,1697,0,0,0,1.0,1,1.0,1,1.0,1,0.12119961619124173,48
1352,4,2717,1019,1698,0,0,0,1.0,1,1.0,1,1.0,1,0.11452023716258274,49
1353,2,2719,1019,1700,0,0,0,1.0,1,1.0,1,1.0,1,0.11165324435578032,49
1354,3,2722,1020,1702,0,0,0,1.0,1,1.0,1,1.0,1,0.08701887171422733,49
1355,0,2722,1020,1702,0,0,0,1.0,1,1.0,1,1.0,1,0.09030944693028814,50
1356,0,2722,1020,1702,0,0,0,1.0,1,1.0,1,1.0,1,0.09030944693028814,50
1357,3,2725,1022,1703,0,0,0,1.0,1,1.0,1,1.0,1,0.11027994799188946,50
1358,2,2727,1023,1704,0,0,0,1.0,1,1.0,1,1.0,1,0.14214271597389075,51
1359,3,2730,1024,1706,0,0,0,1.0,1,1.0,1,1.0,1,0.1651583178385567,53
1360,4,2734,1024,1710,0,0,0,1.0,1,1.0,1,1.0,1,0.12116121303004293,54
1361,0,2734,1024,1710,0,0,0,1.0,1,1.0,1,1.0,1,0.12116121303004293,54
1362,2,2736,1024,1712,0,0,0,1.0,1,1.0,1,1.0,1,0.11928564055251817,55
1363,1,2737,1024,1713,0,0,0,1.0,1,1.0,1,1.0,1,0.10348370844619914,55
1364,1,2738,1024,1714,0,0,0,1.0,1,1.0,1,1.0,1,0.12680471518831643,55
1365,4,2742,1026,1716,0,0,0,1.0,1,1.0,1,1.0,1,0.14461259711102997,56
1366,4,2746,1026,1720,0,0,0,1.0,1,1.0,1,1.0,1,0.10276725115389033,56
1367,0,2746,1026,1720,0,0,0,1.0,1,1.0,1,1.0,1,0.10276725115389033,56
1368,4,2750,1027,1723,0,0,0,1.0,1,1.0,1,1.0,1,0.10340170110014546,58
1369,1,2751,1027,1724,0,0,0,1.0,1,1.0,1,1.0,1,0.10281045069687941,59
1370,2,2753,1029,1724,0,0,0,1.0,1,1.0,1,1.0,1,0.10212237137938489,59
1371,1,2754,1029,1725,0,0,0,1.0,1,1.0,1,1.0,1,0.09518147668847543,59
1372,1,2755,1030,1725,0,0,0,1.0,1,1.0,1,1.0,1,0.10732960772565532,59
1373,3,2758,1030,1728,0,0,0,1.0,1,1.0,1,1.0,1,0.07400197858732585,59
1374,4,2762,1033,1729,0,0,0,1.0,1,1.0,1,1.0,1,0.11290134808977569,60
1375,6,2768,1034,1734,0,0,0,1.0,1,1.0,1,1.0,1,0.06932031557777568,61
1376,0,2768,1034,1734,0,0,0,1.0,1,1.0,1,1.0,1,0.09424954423644685,61
1377,3,2771,1037,1734,0,0,0,1.0,1,1.0,1,1.0,1,0.12368307445734608,61
1378,3,2774,1038,1736,0,0,0,1.0,1,1.0,1,1.0,1,0.12757842731479094,61
1379,2,2776,1038,1738,0,0,0,1.0,1,1.0,1,1.0,1,0.10931530931971739,60
1380,3,2779,1039,1740,0,0,0,1.0,1,1.0,1,1.0,1,0.11615921817223653,60
1381,0,2779,1039,1740,0,0,0,1.0,1,1.0,1,1.0,1,0.1099806744411377,58
1382,1,2780,1040,1740,0,0,0,1.0,1,1.0,1,1.0,1,0.1290687074253264,58
1383,5,2785,1043,1742,0,0,0,1.0,1,1.0,1,1.0,1,0.15406806906833811,57
1384,9,2794,1046,1748,0,0,0,1.0,1,1.0,1,1.0,1,0.12345420284478166,54
1385,3,2797,1047,1750,0,0,0,1.0,1,1.0,1,1.0,1,0.08803325862560692,52
1386,0,2797,1047,1750,0,0,0,1.0,1,1.0,1,1.0,1,0.09269508236232103,51
1387,4,2801,1048,1753,0,0,0,1.0,1,1.0,1,1.0,1,0.09290866670669048,51
1388,1,2802,1049,1753,0,0,0,1.0,1,1.0,1,1.0,1,0.09978369399001079,52
1389,0,2802,1049,1753,0,0,0,1.0,1,1.0,1,1.0,1,0.13104968197941277,50
1390,1,2803,1050,1753,0,0,0,1.0,1,1.0,1,1.0,1,0.1295111769100591,51
1391,0,2803,1050,1753,0,0,0,1.0,1,1.0,1,1.0,1,0.11916301321094991,50
1392,1,2804,1051,1753,0,0,0,1.0,1,1.0,1,1.0,1,0.09571895096408928,50
1393,0,2804,1051,1753,0,0,0,1.0,1,1.0,1,1.0,1,0.10554268338471796,49
1394,3,2807,1052,1755,0,0,0,1.0,1,1.0,1,1.0,1,0.13625405180504654,50
1395,1,2808,1052,1756,0,0,0,1.0,1,1.0,1,1.0,1,0.12267387220477025,51
1396,0,2808,1052,1756,0,0,0,1.0,1,1.0,1,1.0,1,0.13903094100878388,52
1397,2,2810,1054,1756,0,0,0,1.0,1,1.0,1,1.0,1,0.1477787953678755,52
1398,0,2810,1054,1756,0,0,0,1.0,1,1.0,1,1.0,1,0.13257356167153908,53
1399,4,2814,1056,1758,0,0,0,1.0,1,1.0,1,1.0,1,0.1586894042177354,54
1400,1,2815,1057,1758,0,0,0,1.0,1,1.0,1,1.0,1,0.17443232845831302,54
1401,1,2816,1058,1758,0,0,0,1.0,1,1.0,1,1.0,1,0.16144702734980834,54
1402,1,2817,1059,1758,0,0,0,1.0,1,1.0,1,1.0,1,0.1693968885005933,53
1403,0,2817,1059,1758,0,0,0,1.0,1,1.0,1,1.0,1,0.187105624109558,52
1404,1,2818,1059,1759,0,0,0,1.0,1,1.0,1,1.0,1,0.19011445643145455,53
1405,2,2820,1060,1760,0,0,0,1.0,1,1.0,1,1.0,1,0.22900168783404423,52
1406,2,2822,1060,1762,0,0,0,1.0,1,1.0,1,1.0,1,0.20292556517190455,53
1407,1,2823,1060,1763,0,0,0,1.0,1,1.0,1,1.0,1,0.20258953713298433,54
1408,1,2824,1060,1764,0,0,0,1.0,1,1.0,1,1.0,1,0.2032532509025955,53
1409,0,2824,1060,1764,0,0,0,1.0,1,1.0,1,1.0,1,0.20427900149210546,55
1410,0,2824,1060,1764,0,0,0,1.0,1,1.0,1,1.0,1,0.2156439994194706,54
1411,6,2830,1060,1770,0,0,0,1.0,1,1.0,1,1.0,1,0.18560846073372161,54
1412,0,2830,1060,1770,0,0,0,1.0,1,1.0,1,1.0,1,0.17511643547095013,53
1413,2,2832,1060,1772,0,0,0,1.0,1,1.0,1,1.0,1,0.14074846834561086,54
1414,3,2835,1060,1775,0,0,0,1.0,1,1.0,1,1.0,1,0.12807432339722652,55
1415,3,2838,1062,1776,0,0,0,1.0,1,1.0,1,1.0,1,0.13082548784601178,57
1416,3,2841,1063,1778,0,0,0,1.0,1,1.0,1,1.0,1,0.14812866679367498,59
1417,2,2843,1064,1779,0,0,0,1.0,1,1.0,1,1.0,1,0.14663408526013,58
1418,3,2846,1065,1781,0,0,0,1.0,1,1.0,1,1.0,1,0.11585420047362929,57
1419,1,2847,1066,1781,0,0,0,1.0,1,1.0,1,1.0,1,0.1400132825017979,56
1420,1,2848,1067,1781,0,0,0,1.0,1,1.0,1,1.0,1,0.18925788307139746,54
1421,3,2851,1068,1783,0,0,0,1.0,1,1.0,1,1.0,1,0.18016043657116204,55
1422,1,2852,1068,1784,0,0,0,1.0,1,1.0,1,1.0,1,0.1640922869959721,52
1423,6,2858,1070,1788,0,0,0,1.0,1,1.0,1,1.0,1,0.1319347819933115,52
1424,4,2862,1073,1789,0,0,0,1.0,1,1.0,1,1.0,1,0.13870336279300557,51
1425,1,2863,1073,1790,0,0,0,1.0,1,1.0,1,1.0,1,0.12997238543987435,50
1426,5,2868,1075,1793,0,0,0,1.0,1,1.0,1,1.0,1,0.11734468772361721,50
1427,0,2868,1075,1793,0,0,0,1.0,1,1.0,1,1.0,1,0.13705286792307317,48
1428,2,2870,1077,1793,0,0,0,1.0,1,1.0,1,1.0,1,0.18209613978625433,48
1429,1,2871,1077,1794,0,0,0,1.0,1,1.0,1,1.0,1,0.16826002751777983,48
1430,2,2873,1079,1794,0,0,0,1.0,1,1.0,1,1.0,1,0.17959198693450215,48
1431,1,2874,1079,1795,0,0,0,1.0,1,1.0,1,1.0,1,0.16352869762802424,48
1432,0,2874,1079,1795,0,0,0,1.0,1,1.0,1,1.0,1,0.1476324807478017,50
1433,2,2876,1080,1796,0,0,0,1.0,1,1.0,1,1.0,1,0.12463831498936363,51
1434,1,2877,1081,1796,0,0,0,1.0,1,1.0,1,1.0,1,0.11066058856934402,51
1435,7,2884,1083,1801,0,0,0,1.0,1,1.0,1,1.0,1,0.07902018298985684,50
1436,2,2886,1084,1802,0,0,0,1.0,1,1.0,1,1.0,1,0.10637057477143677,51
1437,0,2886,1084,1802,0,0,0,1.0,1,1.0,1,1.0,1,0.10637057477143677,51
1438,4,2890,1087,1803,0,0,0,1.0,1,1.0,1,1.0,1,0.1281069601103244,51
1439,4,2894,1090,1804,0,0,0,1.0,1,1.0,1,1.0,1,0.17578447710556913,50
1440,6,2900,1092,1808,0,0,0,1.0,1,1.0,1,1.0,1,0.1936627976570238,51
1441,2,2902,1092,1810,0,0,0,1.0,1,1.0,1,1.0,1,0.16003036957016392,51
1442,5,2907,1093,1814,0,0,0,1.0,1,1.0,1,1.0,1,0.14234605695637204,52
1443,3,2910,1093,1817,0,0,0,1.0,1,1.0,1,1.0,1,0.1252054800509816,53
1444,0,2910,1093,1817,0,0,0,1.0,1,1.0,1,1.0,1,0.122973398962102,54
1445,2,2912,1093,1819,0,0,0,1.0,1,1.0,1,1.0,1,0.09468877068674945,54
1446,0,2912,1093,1819,0,0,0,1.0,1,1.0,1,1.0,1,0.11540784185248786,54
1447,0,2912,1093,1819,0,0,0,1.0,1,1.0,1,1.0,1,0.10558748433878587,55
1448,0,2912,1093,1819,0,0,0,1.0,1,1.0,1,1.0,1,0.10558748433878587,55
1449,0,2912,1093,1819,0,0,0,1.0,1,1.0,1,1.0,1,0.10558748433878587,55
1450,3,2915,1093,1822,0,0,0,1.0,1,1.0,1,1.0,1,0.07294995102236296,57
1451,2,2917,1094,1823,0,0,0,1.0,1,1.0,1,1.0,1,0.06955047410080191,57
1452,0,2917,1094,1823,0,0,0,1.0,1,1.0,1,1.0,1,0.06955047410080191,57
1453,1,2918,1095,1823,0,0,0,1.0,1,1.0,1,1.0,1,0.09742786699973824,57
1454,3,2921,1097,1824,0,0,0,1.0,1,1.0,1,1.0,1,0.13371023821452901,58
1455,1,2922,1097,1825,0,0,0,1.0,1,1.0,1,1.0,1,0.11955195447929694,56
1456,3,2925,1098,1827,0,0,0,1.0,1,1.0,1,1.0,1,0.09332533755816946,55
1457,1,2926,1098,1828,0,0,0,1.0,1,1.0,1,1.0,1,0.10386108111381188,54
1458,2,2928,1100,1828,0,0,0,1.0,1,1.0,1,1.0,1,0.13801647407764994,53
1459,4,2932,1100,1832,0,0,0,1.0,1,1.0,1,1.0,1,0.09406895653505726,52
1460,0,2932,1100,1832,0,0,0,1.0,1,1.0,1,1.0,1,0.08663355983640936,51
1461,3,2935,1102,1833,0,0,0,1.0,1,1.0,1,1.0,1,0.10366434002665795,51
1462,3,2938,1103,1835,0,0,0,1.0,1,1.0,1,1.0,1,0.10880449537686862,51
1463,5,2943,1105,1838,0,0,0,1.0,1,1.0,1,1.0,1,0.14403929329928505,52
1464,5,2948,1108,1840,0,0,0,1.0,1,1.0,1,1.0,1,0.16437079392184623,52
1465,8,2956,1110,1846,0,0,0,1.0,1,1.0,1,1.0,1,0.13684799163619105,51
1466,4,2960,1113,1847,0,0,0,1.0,1,1.0,1,1.0,1,0.13988352703690257,50
1467,2,2962,1114,1848,0,0,0,1.0,1,1.0,1,1.0,1,0.15949004921030396,48
1468,4,2966,1116,1850,0,0,0,1.0,1,1.0,1,1.0,1,0.1322518814541103,48
1469,3,2969,1117,1852,0,0,0,1.0,1,1.0,1,1.0,1,0.1186019708632363,48
1470,1,2970,1118,1852,0,0,0,1.0,1,1.0,1,1.0,1,0.1366428052594394,48
1471,3,2973,1120,1853,0,0,0,1.0,1,1.0,1,1.0,1,0.13910803637235808,45
1472,1,2974,1120,1854,0,0,0,1.0,1,1.0,1,1.0,1,0.12669927772616546,45
1473,2,2976,1121,1855,0,0,0,1.0,1,1.0,1,1.0,1,0.12415077937010054,46
1474,3,2979,1121,1858,0,0,0,1.0,1,1.0,1,1.0,1,0.08809758311554518,46
1475,0,2979,1121,1858,0,0,0,1.0,1,1.0,1,1.0,1,0.08809758311554518,46
1476,2,2981,1122,1859,0,0,0,1.0,1,1.0,1,1.0,1,0.12017141145629512,47
1477,3,2984,1123,1861,0,0,0,1.0,1,1.0,1,1.0,1,0.07992678577938127,47
1478,0,2984,1123,1861,0,0,0,1.0,1,1.0,1,1.0,1,0.11830575341746877,47
1479,1,2985,1123,1862,0,0,0,1.0,1,1.0,1,1.0,1,0.11175785148640367,48
1480,1,2986,1124,1862,0,0,0,1.0,1,1.0,1,1.0,1,0.12928882220578175,47
1481,1,2987,1125,1862,0,0,0,1.0,1,1.0,1,1.0,1,0.13708331656218972,47
1482,2,2989,1126,1863,0,0,0,1.0,1,1.0,1,1.0,1,0.14463842671229724,46
1483,2,2991,1126,1865,0,0,0,1.0,1,1.0,1,1.0,1,0.12668855877005605,47
1484,0,2991,1126,1865,0,0,0,1.0,1,1.0,1,1.0,1,0.14527370087935793,47
1485,3,2994,1126,1868,0,0,0,1.0,1,1.0,1,1.0,1,0.15672925819412778,47
1486,1,2995,1126,1869,0,0,0,1.0,1,1.0,1,1.0,1,0.1472911458563478,49
1487,4,2999,1129,1870,0,0,0,1.0,1,1.0,1,1.0,1,0.1270801159471013,49
1488,1,3000,1130,1870,0,0,0,1.0,1,1.0,1,1.0,1,0.13899809711041908,51
1489,4,3004,1131,1873,0,0,0,1.0,1,1.0,1,1.0,1,0.12643057894819387,52
1490,0,3004,1131,1873,0,0,0,1.0,1,1.0,1,1.0,1,0.12643057894819387,52
1491,5,3009,1135,1874,0,0,0,1.0,1,1.0,1,1.0,1,0.16588698678777508,53
1492,6,3015,1138,1877,0,0,0,1.0,1,1.0,1,1.0,1,0.13293910906783613,53
1493,3,3018,1140,1878,0,0,0,1.0,1,1.0,1,1.0,1,0.08667433933132561,52
1494,1,3019,1141,1878,0,0,0,1.0,1,1.0,1,1.0,1,0.06838252239911666,50
1495,1,3020,1142,1878,0,0,0,1.0,1,1.0,1,1.0,1,0.08800026875813552,50
1496,4,3024,1143,1881,0,0,0,1.0,1,1.0,1,1.0,1,0.08210955947049796,52
1497,3,3027,1145,1882,0,0,0,1.0,1,1.0,1,1.0,1,0.14618530483247977,51
1498,2,3029,1146,1883,0,0,0,1.0,1,1.0,1,1.0,1,0.16468790667303188,50
1499,1,3030,1146,1884,0,0,0,1.0,1,1.0,1,1.0,1,0.10810043044974209,50
1500,1,3031,1147,1884,0,0,0,1.0,1,1.0,1,1.0,1,0.10590190288799003,49
1501,2,3033,1148,1885,0,0,0,1.0,1,1.0,1,1.0,1,0.10991187271411605,47
1502,2,3035,1150,1885,0,0,0,1.0,1,1.0,1,1.0,1,0.1539528116648044,47
1503,2,3037,1151,1886,0,0,0,1.0,1,1.0,1,1.0,1,0.11890064334862137,47
1504,4,3041,1153,1888,0,0,0,1.0,1,1.0,1,1.0,1,0.13359212998238829,48
1505,4,3045,1156,1889,0,0,0,1.0,1,1.0,1,1.0,1,0.11006085624243137,47
1506,1,3046,1157,1889,0,0,0,1.0,1,1.0,1,1.0,1,0.1076051041508004,47
1507,1,3047,1157,1890,0,0,0,1.0,1,1.0,1,1.0,1,0.10489745735472882,45
1508,2,3049,1158,1891,0,0,0,1.0,1,1.0,1,1.0,1,0.11513642941105136,45
1509,1,3050,1159,1891,0,0,0,1.0,1,1.0,1,1.0,1,0.10388343227559221,44
1510,4,3054,1162,1892,0,0,0,1.0,1,1.0,1,1.0,1,0.14166151926426498,42
1511,2,3056,1163,1893,0,0,0,1.0,1,1.0,1,1.0,1,0.1727296267764682,40
1512,5,3061,1167,1894,0,0,0,1.0,1,1.0,1,1.0,1,0.23785970329560524,39
1513,4,3065,1167,1898,0,0,0,1.0,1,1.0,1,1.0,1,0.1481910119805326,39
1514,0,3065,1167,1898,0,0,0,1.0,1,1.0,1,1.0,1,0.16796787529843193,38
1515,3,3068,1167,1901,0,0,0,1.0,1,1.0,1,1.0,1,0.13096228411756408,39
1516,0,3068,1167,1901,0,0,0,1.0,1,1.0,1,1.0,1,0.13096228411756408,39
1517,2,3070,1169,1901,0,0,0,1.0,1,1.0,1,1.0,1,0.1635578785219542,39
1518,2,3072,1171,1901,0,0,0,1.0,1,1.0,1,1.0,1,0.1681522965250325,39
1519,3,3075,1171,1904,0,0,0,1.0,1,1.0,1,1.0,1,0.08164849934188216,39
1520,3,3078,1174,1904,0,0,0,1.0,1,1.0,1,1.0,1,0.17455038132758982,39
1521,3,3081,1175,1906,0,0,0,1.0,1,1.0,1,1.0,1,0.19470973601204908,40
1522,4,3085,1176,1909,0,0,0,1.0,1,1.0,1,1.0,1,0.14412601467354438,40
1523,0,3085,1176,1909,0,0,0,1.0,1,1.0,1,1.0,1,0.1588774697470673,41
1524,1,3086,1176,1910,0,0,0,1.0,1,1.0,1,1.0,1,0.15001416712335341,42
1525,2,3088,1176,1912,0,0,0,1.0,1,1.0,1,1.0,1,0.10364468464879104,45
1526,1,3089,1176,1913,0,0,0,1.0,1,1.0,1,1.0,1,0.10729823762834986,46
1527,0,3089,1176,1913,0,0,0,1.0,1,1.0,1,1.0,1,0.10729823762834986,46
1528,0,3089,1176,1913,0,0,0,1.0,1,1.0,1,1.0,1,0.10889355572238753,47
1529,1,3090,1176,1914,0,0,0,1.0,1,1.0,1,1.0,1,0.07737367324330109,47
1530,0,3090,1176,1914,0,0,0,1.0,1,1.0,1,1.0,1,0.08746685292374398,48
1531,2,3092,1176,1916,0,0,0,1.0,1,1.0,1,1.0,1,0.07767845204976483,46
1532,1,3093,1177,1916,0,0,0,1.0,1,1.0,1,1.0,1,0.11696232205687523,47
1533,0,3093,1177,1916,0,0,0,1.0,1,1.0,1,1.0,1,0.10342226501430749,46
1534,2,3095,1178,1917,0,0,0,1.0,1,1.0,1,1.0,1,0.10201414876463158,47
1535,0,3095,1178,1917,0,0,0,1.0,1,1.0,1,1.0,1,0.10201414876463158,47
1536,1,3096,1178,1918,0,0,0,1.0,1,1.0,1,1.0,1,0.10802578489032436,48
1537,2,3098,1178,1920,0,0,0,1.0,1,1.0,1,1.0,1,0.08900478846994164,46
1538,0,3098,1178,1920,0,0,0,1.0,1,1.0,1,1.0,1,0.10920863638914963,47
1539,2,3100,1179,1921,0,0,0,1.0,1,1.0,1,1.0,1,0.11409544979525646,47
1540,2,3102,1180,1922,0,0,0,1.0,1,1.0,1,1.0,1,0.10740441295067227,47
1541,0,3102,1180,1922,0,0,0,1.0,1,1.0,1,1.0,1,0.10772559936096263,47
1542,6,3108,1185,1923,0,0,0,1.0,1,1.0,1,1.0,1,0.2020978909875471,50
1543,7,3115,1187,1928,0,0,0,1.0,1,1.0,1,1.0,1,0.13991802874808518,47
1544,4,3119,1190,1929,0,0,0,1.0,1,1.0,1,1.0,1,0.1604072208272137,48
1545,3,3122,1191,1931,0,0,0,1.0,1,1.0,1,1.0,1,0.07782092921107775,47
1546,3,3125,1192,1933,0,0,0,1.0,1,1.0,1,1.0,1,0.06205260145453384,47
1547,1,3126,1192,1934,0,0,0,1.0,1,1.0,1,1.0,1,0.10167097389200759,47
1548,2,3128,1194,1934,0,0,0,1.0,1,1.0,1,1.0,1,0.10687575538089715,47
1549,6,3134,1199,1935,0,0,0,1.0,1,1.0,1,1.0,1,0.11614153688180757,46
1550,3,3137,1201,1936,0,0,0,1.0,1,1.0,1,1.0,1,0.12678476672818345,44
1551,5,3142,1206,1936,0,0,0,1.0,1,1.0,1,1.0,1,0.15980354734741328,45
1552,4,3146,1207,1939,0,0,0,1.0,1,1.0,1,1.0,1,0.0877017932625825,43
1553,2,3148,1208,1940,0,0,0,1.0,1,1.0,1,1.0,1,0.1274696928536327,43
1554,1,3149,1208,1941,0,0,0,1.0,1,1.0,1,1.0,1,0.09053474293762301,41
1555,3,3152,1210,1942,0,0,0,1.0,1,1.0,1,1.0,1,0.11115454255373226,44
1556,1,3153,1211,1942,0,0,0,1.0,1,1.0,1,1.0,1,0.12693750003910934,45
1557,0,3153,1211,1942,0,0,0,1.0,1,1.0,1,1.0,1,0.12693750003910934,45
1558,2,3155,1211,1944,0,0,0,1.0,1,1.0,1,1.0,1,0.08762279422489865,46
1559,1,3156,1212,1944,0,0,0,1.0,1,1.0,1,1.0,1,0.12282890356155464,47
1560,3,3159,1214,1945,0,0,0,1.0,1,1.0,1,1.0,1,0.09229323778575897,46
1561,2,3161,1215,1946,0,0,0,1.0,1,1.0,1,1.0,1,0.08865339395163638,47
1562,0,3161,1215,1946,0,0,0,1.0,1,1.0,1,1.0,1,0.097930449227551,47
1563,0,3161,1215,1946,0,0,0,1.0,1,1.0,1,1.0,1,0.097930449227551,47
1564,0,3161,1215,1946,0,0,0,1.0,1,1.0,1,1.0,1,0.097930449227551,47
1565,1,3162,1215,1947,0,0,0,1.0,1,1.0,1,1.0,1,0.1183779979346144,48
1566,0,3162,1215,1947,0,0,0,1.0,1,1.0,1,1.0,1,0.1183779979346144,48
1567,3,3165,1215,1950,0,0,0,1.0,1,1.0,1,1.0,1,0.11536913935546478,48
1568,1,3166,1216,1950,0,0,0,1.0,1,1.0,1,1.0,1,0.14988802727713915,48
1569,2,3168,1217,1951,0,0,0,1.0,1,1.0,1,1.0,1,0.10786047517864063,45
1570,2,3170,1218,1952,0,0,0,1.0,1,1.0,1,1.0,1,0.08121810882603898,44
1571,4,3174,1221,1953,0,0,0,1.0,1,1.0,1,1.0,1,0.10817903272509184,42
1572,2,3176,1222,1954,0,0,0,1.0,1,1.0,1,1.0,1,0.13653415490638232,43
1573,3,3179,1223,1956,0,0,0,1.0,1,1.0,1,1.0,1,0.10937019052224654,43
1574,6,3185,1227,1958,0,0,0,1.0,1,1.0,1,1.0,1,0.15375422469683955,42
1575,3,3188,1228,1960,0,0,0,1.0,1,1.0,1,1.0,1,0.11465429004699605,43
1576,4,3192,1229,1963,0,0,0,1.0,1,1.0,1,1.0,1,0.10519756049456114,41
1577,2,3194,1231,1963,0,0,0,1.0,1,1.0,1,1.0,1,0.15321143156969794,40
1578,0,3194,1231,1963,0,0,0,1.0,1,1.0,1,1.0,1,0.16411279564188327,40
1579,2,3196,1231,1965,0,0,0,1.0,1,1.0,1,1.0,1,0.1182831105043715,40
1580,0,3196,1231,1965,0,0,0,1.0,1,1.0,1,1.0,1,0.1182831105043715,40
1581,0,3196,1231,1965,0,0,0,1.0,1,1.0,1,1.0,1,0.11847270450826736,40
1582,5,3201,1235,1966,0,0,0,1.0,1,1.0,1,1.0,1,0.19147338604886666,40
1583,1,3202,1235,1967,0,0,0,1.0,1,1.0,1,1.0,1,0.16496825539115065,38
1584,3,3205,1238,1967,0,0,0,1.0,1,1.0,1,1.0,1,0.22548449535169937,39
1585,6,3211,1240,1971,0,0,0,1.0,1,1.0,1,1.0,1,0.13336126497490297,38
1586,3,3214,1243,1971,0,0,0,1.0,1,1.0,1,1.0,1,0.18092763812728474,38
1587,1,3215,1244,1971,0,0,0,1.0,1,1.0,1,1.0,1,0.1549293162279544,37
1588,4,3219,1245,1974,0,0,0,1.0,1,1.0,1,1.0,1,0.08869103043558031,39
1589,4,3223,1248,1975,0,0,0,1.0,1,1.0,1,1.0,1,0.11074413307161013,37
1590,1,3224,1249,1975,0,0,0,1.0,1,1.0,1,1.0,1,0.1588949495723295,37
1591,8,3232,1252,1980,0,0,0,1.0,1,1.0,1,1.0,1,0.15860727487209153,36
1592,1,3233,1252,1981,0,0,0,1.0,1,1.0,1,1.0,1,0.1771641318254144,34
1593,0,3233,1252,1981,0,0,0,1.0,1,1.0,1,1.0,1,0.1911904223665461,33
1594,3,3236,1252,1984,0,0,0,1.0,1,1.0,1,1.0,1,0.12794103860337033,31
1595,2,3238,1253,1985,0,0,0,1.0,1,1.0,1,1.0,1,0.1794444890206931,34
1596,1,3239,1253,1986,0,0,0,1.0,1,1.0,1,1.0,1,0.13566379386096836,33
1597,0,3239,1253,1986,0,0,0,1.0,1,1.0,1,1.0,1,0.13566379386096836,33
1598,3,3242,1253,1989,0,0,0,1.0,1,1.0,1,1.0,1,0.096471343141252,33
1599,0,3242,1253,1989,0,0,0,1.0,1,1.0,1,1.0,1,0.096471343141252,33
1600,2,3244,1254,1990,0,0,0,1.0,1,1.0,1,1.0,1,0.098790515499909,34
1601,2,3246,1255,1991,0,0,0,1.0,1,1.0,1,1.0,1,0.12685127891209472,35
1602,0,3246,1255,1991,0,0,0,1.0,1,1.0,1,1.0,1,0.12091436477414892,36
1603,2,3248,1256,1992,0,0,0,1.0,1,1.0,1,1.0,1,0.16420589859169563,38
1604,3,3251,1256,1995,0,0,0,1.0,1,1.0,1,1.0,1,0.11713959473629638,38
1605,1,3252,1256,1996,0,0,0,1.0,1,1.0,1,1.0,1,0.07893992194424085,38
1606,4,3256,1259,1997,0,0,0,1.0,1,1.0,1,1.0,1,0.12648678604047023,39
1607,1,3257,1260,1997,0,0,0,1.0,1,1.0,1,1.0,1,0.12998070834493394,37
1608,2,3259,1261,1998,0,0,0,1.0,1,1.0,1,1.0,1,0.15263951727772496,36
1609,2,3261,1261,2000,0,0,0,1.0,1,1.0,1,1.0,1,0.1226815427343051,34
1610,1,3262,1262,2000,0,0,0,1.0,1,1.0,1,1.0,1,0.14054092249876968,34
1611,1,3263,1262,2001,0,0,0,1.0,1,1.0,1,1.0,1,0.13449062690469057,35
1612,0,3263,1262,2001,0,0,0,1.0,1,1.0,1,1.0,1,0.13397811208217697,33
1613,3,3266,1264,2002,0,0,0,1.0,1,1.0,1,1.0,1,0.20622312681780622,34
1614,2,3268,1265,2003,0,0,0,1.0,1,1.0,1,1.0,1,0.1785485886927139,35
1615,1,3269,1265,2004,0,0,0,1.0,1,1.0,1,1.0,1,0.15005765497592963,35
1616,2,3271,1266,2005,0,0,0,1.0,1,1.0,1,1.0,1,0.17503415396278726,37
1617,2,3273,1267,2006,0,0,0,1.0,1,1.0,1,1.0,1,0.17325810105180856,38
1618,2,3275,1267,2008,0,0,0,1.0,1,1.0,1,1.0,1,0.11964939611668324,38
1619,1,3276,1267,2009,0,0,0,1.0,1,1.0,1,1.0,1,0.13997734022940947,38
1620,2,3278,1268,2010,0,0,0,1.0,1,1.0,1,1.0,1,0.1454512057610076,39
1621,1,3279,1268,2011,0,0,0,1.0,1,1.0,1,1.0,1,0.16054502900686204,37
1622,4,3283,1271,2012,0,0,0,1.0,1,1.0,1,1.0,1,0.2363315630016387,37
1623,4,3287,1273,2014,0,0,0,1.0,1,1.0,1,1.0,1,0.2035920050110351,37
1624,4,3291,1275,2016,0,0,0,1.0,1,1.0,1,1.0,1,0.23350907020032205,37
1625,4,3295,1275,2020,0,0,0,1.0,1,1.0,1,1.0,1,0.18977322352471052,35
1626,1,3296,1275,2021,0,0,0,1.0,1,1.0,1,1.0,1,0.1604017691190418,35
1627,2,3298,1275,2023,0,0,0,1.0,1,1.0,1,1.0,1,0.13612193157579805,34
1628,1,3299,1276,2023,0,0,0,1.0,1,1.0,1,1.0,1,0.1686975343256093,35
1629,2,3301,1278,2023,0,0,0,1.0,1,1.0,1,1.0,1,0.2176653337640389,34
1630,2,3303,1278,2025,0,0,0,1.0,1,1.0,1,1.0,1,0.16311293653742392,32
1631,0,3303,1278,2025,0,0,0,1.0,1,1.0,1,1.0,1,0.18108045097667064,33
1632,1,3304,1279,2025,0,0,0,1.0,1,1.0,1,1.0,1,0.23011267840663618,32
1633,1,3305,1279,2026,0,0,0,1.0,1,1.0,1,1.0,1,0.20591486407810367,31
1634,0,3305,1279,2026,0,0,0,1.0,1,1.0,1,1.0,1,0.20591486407810367,31
1635,1,3306,1279,2027,0,0,0,1.0,1,1.0,1,1.0,1,0.20689251697259914,31
1636,0,3306,1279,2027,0,0,0,1.0,1,1.0,1,1.0,1,0.2037781534720988,33
1637,0,3306,1279,2027,0,0,0,1.0,1,1.0,1,1.0,1,0.2037781534720988,33
1638,4,3310,1279,2031,0,0,0,1.0,1,1.0,1,1.0,1,0.1621182823033572,36
1639,1,3311,1280,2031,0,0,0,1.0,1,1.0,1,1.0,1,0.1338312064945049,36
1640,1,3312,1281,2031,0,0,0,1.0,1,1.0,1,1.0,1,0.17358197005977583,36
1641,2,3314,1281,2033,0,0,0,1.0,1,1.0,1,1.0,1,0.15467575585299806,38
1642,0,3314,1281,2033,0,0,0,1.0,1,1.0,1,1.0,1,0.15423088548863018,37
1643,2,3316,1283,2033,0,0,0,1.0,1,1.0,1,1.0,1,0.1703937070881648,37
1644,1,3317,1284,2033,0,0,0,1.0,1,1.0,1,1.0,1,0.22660047748278586,38
1645,3,3320,1284,2036,0,0,0,1.0,1,1.0,1,1.0,1,0.15336448161558852,36
1646,2,3322,1286,2036,0,0,0,1.0,1,1.0,1,1.0,1,0.2171688589774587,37
1647,3,3325,1287,2038,0,0,0,1.0,1,1.0,1,1.0,1,0.24530010105578112,35
1648,2,3327,1287,2040,0,0,0,1.0,1,1.0,1,1.0,1,0.24657814331272607,38
1649,1,3328,1288,2040,0,0,0,1.0,1,1.0,1,1.0,1,0.23389356626207478,35
1650,0,3328,1288,2040,0,0,0,1.0,1,1.0,1,1.0,1,0.24618718021590746,34
1651,4,3332,1288,2044,0,0,0,1.0,1,1.0,1,1.0,1,0.23829823302450967,32
1652,4,3336,1288,2048,0,0,0,1.0,1,1.0,1,1.0,1,0.1862371013110494,33
1653,3,3339,1288,2051,0,0,0,1.0,1,1.0,1,1.0,1,0.15766308182092487,33
1654,1,3340,1288,2052,0,0,0,1.0,1,1.0,1,1.0,1,0.15932160213899077,34
1655,1,3341,1288,2053,0,0,0,1.0,1,1.0,1,1.0,1,0.12227893477211518,35
1656,0,3341,1288,2053,0,0,0,1.0,1,1.0,1,1.0,1,0.12227893477211518,35
1657,0,3341,1288,2053,0,0,0,1.0,1,1.0,1,1.0,1,0.13691188200053162,36
1658,1,3342,1289,2053,0,0,0,1.0,1,1.0,1,1.0,1,0.13157083701342323,36
1659,1,3343,1289,2054,0,0,0,1.0,1,1.0,1,1.0,1,0.10193489213902926,36
1660,4,3347,1292,2055,0,0,0,1.0,1,1.0,1,1.0,1,0.14843903888014412,38
1661,0,3347,1292,2055,0,0,0,1.0,1,1.0,1,1.0,1,0.14843903888014412,38
1662,3,3350,1295,2055,0,0,0,1.0,1,1.0,1,1.0,1,0.13180343513797915,39
1663,2,3352,1296,2056,0,0,0,1.0,1,1.0,1,1.0,1,0.15226102030613653,40
1664,1,3353,1297,2056,0,0,0,1.0,1,1.0,1,1.0,1,0.20165574146768092,39
1665,4,3357,1298,2059,0,0,0,1.0,1,1.0,1,1.0,1,0.15844080603619215,40
1666,3,3360,1299,2061,0,0,0,1.0,1,1.0,1,1.0,1,0.17847268499327906,40
1667,4,3364,1300,2064,0,0,0,1.0,1,1.0,1,1.0,1,0.15982432829567594,40
1668,2,3366,1302,2064,0,0,0,1.0,1,1.0,1,1.0,1,0.1499834743163834,41
1669,1,3367,1302,2065,0,0,0,1.0,1,1.0,1,1.0,1,0.09762096395681673,40
1670,1,3368,1303,2065,0,0,0,1.0,1,1.0,1,1.0,1,0.11939828047156811,40
1671,0,3368,1303,2065,0,0,0,1.0,1,1.0,1,1.0,1,0.11490313373028102,41
1672,2,3370,1304,2066,0,0,0,1.0,1,1.0,1,1.0,1,0.12754688782262188,40
1673,1,3371,1305,2066,0,0,0,1.0,1,1.0,1,1.0,1,0.16006629459195276,39
1674,1,3372,1306,2066,0,0,0,1.0,1,1.0,1,1.0,1,0.1747802920001896,40
1675,1,3373,1306,2067,0,0,0,1.0,1,1.0,1,1.0,1,0.13846237744072173,38
1676,0,3373,1306,2067,0,0,0,1.0,1,1.0,1,1.0,1,0.1444624138777155,39
1677,0,3373,1306,2067,0,0,0,1.0,1,1.0,1,1.0,1,0.14463249423313176,39
1678,1,3374,1306,2068,0,0,0,1.0,1,1.0,1,1.0,1,0.12330016106816041,39
1679,1,3375,1306,2069,0,0,0,1.0,1,1.0,1,1.0,1,0.10442938076621967,39
1680,5,3380,1309,2071,0,0,0,1.0,1,1.0,1,1.0,1,0.10388377835581906,41
1681,2,3382,1311,2071,0,0,0,1.0,1,1.0,1,1.0,1,0.16122543254511953,41
1682,2,3384,1311,2073,0,0,0,1.0,1,1.0,1,1.0,1,0.12228136555119867,43
1683,5,3389,1315,2074,0,0,0,1.0,1,1.0,1,1.0,1,0.14470317999246987,43
1684,2,3391,1316,2075,0,0,0,1.0,1,1.0,1,1.0,1,0.12266520516897675,42
1685,2,3393,1317,2076,0,0,0,1.0,1,1.0,1,1.0,1,0.1050771839242909,41
1686,3,3396,1319,2077,0,0,0,1.0,1,1.0,1,1.0,1,0.10112303815806056,41
1687,0,3396,1319,2077,0,0,0,1.0,1,1.0,1,1.0,1,0.08080745105182388,40
1688,2,3398,1321,2077,0,0,0,1.0,1,1.0,1,1.0,1,0.14524459115837682,39
1689,2,3400,1322,2078,0,0,0,1.0,1,1.0,1,1.0,1,0.17214172258736443,38
1690,3,3403,1323,2080,0,0,0,1.0,1,1.0,1,1.0,1,0.12495009287451836,38
1691,0,3403,1323,2080,0,0,0,1.0,1,1.0,1,1.0,1,0.17776954639533055,36
1692,0,3403,1323,2080,0,0,0,1.0,1,1.0,1,1.0,1,0.1967608486951742,36
1693,3,3406,1324,2082,0,0,0,1.0,1,1.0,1,1.0,1,0.1538260370520643,35
1694,1,3407,1325,2082,0,0,0,1.0,1,1.0,1,1.0,1,0.1855493557219363,33
1695,0,3407,1325,2082,0,0,0,1.0,1,1.0,1,1.0,1,0.19900466469783698,34
1696,3,3410,1326,2084,0,0,0,1.0,1,1.0,1,1.0,1,0.2079049865213395,35
1697,1,3411,1326,2085,0,0,0,1.0,1,1.0,1,1.0,1,0.20775573143790682,36
1698,2,3413,1328,2085,0,0,0,1.0,1,1.0,1,1.0,1,0.22667288675068023,38
1699,3,3416,1329,2087,0,0,0,1.0,1,1.0,1,1.0,1,0.1959402604197363,38
1700,1,3417,1329,2088,0,0,0,1.0,1,1.0,1,1.0,1,0.18750467258536693,39
1701,0,3417,1329,2088,0,0,0,1.0,1,1.0,1,1.0,1,0.19492322694355896,40
1702,4,3421,1331,2090,0,0,0,1.0,1,1.0,1,1.0,1,0.22887183062273211,41
1703,3,3424,1332,2092,0,0,0,1.0,1,1.0,1,1.0,1,0.2363273714482423,41
1704,5,3429,1334,2095,0,0,0,1.0,1,1.0,1,1.0,1,0.1655530912147678,41
1705,4,3433,1335,2098,0,0,0,1.0,1,1.0,1,1.0,1,0.0931541304792338,40
1706,4,3437,1336,2101,0,0,0,1.0,1,1.0,1,1.0,1,0.05579038368017547,40
1707,2,3439,1337,2102,0,0,0,1.0,1,1.0,1,1.0,1,0.14259698351729702,39
1708,3,3442,1338,2104,0,0,0,1.0,1,1.0,1,1.0,1,0.0845551694353677,39
1709,0,3442,1338,2104,0,0,0,1.0,1,1.0,1,1.0,1,0.10031304233904116,38
1710,4,3446,1340,2106,0,0,0,1.0,1,1.0,1,1.0,1,0.08266843442639314,39
1711,0,3446,1340,2106,0,0,0,1.0,1,1.0,1,1.0,1,0.09999891197957667,38
1712,1,3447,1341,2106,0,0,0,1.0,1,1.0,1,1.0,1,0.10935824200578549,38
1713,0,3447,1341,2106,0,0,0,1.0,1,1.0,1,1.0,1,0.12417035162893407,37
1714,3,3450,1343,2107,0,0,0,1.0,1,1.0,1,1.0,1,0.20365809005176172,38
1715,4,3454,1344,2110,0,0,0,1.0,1,1.0,1,1.0,1,0.14867793547351515,40
1716,0,3454,1344,2110,0,0,0,1.0,1,1.0,1,1.0,1,0.15460188820763318,39
1717,2,3456,1346,2110,0,0,0,1.0,1,1.0,1,1.0,1,0.14997990496830865,38
1718,0,3456,1346,2110,0,0,0,1.0,1,1.0,1,1.0,1,0.17548023509140093,38
1719,0,3456,1346,2110,0,0,0,1.0,1,1.0,1,1.0,1,0.17548023509140093,38
1720,3,3459,1347,2112,0,0,0,1.0,1,1.0,1,1.0,1,0.16618171646537308,41
1721,2,3461,1348,2113,0,0,0,1.0,1,1.0,1,1.0,1,0.13482091215722583,39
1722,2,3463,1350,2113,0,0,0,1.0,1,1.0,1,1.0,1,0.16756903734619585,40
1723,0,3463,1350,2113,0,0,0,1.0,1,1.0,1,1.0,1,0.13750820063733435,38
1724,0,3463,1350,2113,0,0,0,1.0,1,1.0,1,1.0,1,0.20134914363348627,37
1725,2,3465,1350,2115,0,0,0,1.0,1,1.0,1,1.0,1,0.20416940951808332,38
1726,1,3466,1350,2116,0,0,0,1.0,1,1.0,1,1.0,1,0.14727137126383844,37
1727,0,3466,1350,2116,0,0,0,1.0,1,1.0,1,1.0,1,0.14727137126383844,37
1728,0,3466,1350,2116,0,0,0,1.0,1,1.0,1,1.0,1,0.15915706350647574,35
1729,0,3466,1350,2116,0,0,0,1.0,1,1.0,1,1.0,1,0.1596149160015961,37
1730,4,3470,1351,2119,0,0,0,1.0,1,1.0,1,1.0,1,0.1656427339408436,37
1731,0,3470,1351,2119,0,0,0,1.0,1,1.0,1,1.0,1,0.1656427339408436,37
1732,5,3475,1351,2124,0,0,0,1.0,1,1.0,1,1.0,1,0.15325129334853704,37
1733,2,3477,1352,2125,0,0,0,1.0,1,1.0,1,1.0,1,0.16974983453313536,36
1734,1,3478,1352,2126,0,0,0,1.0,1,1.0,1,1.0,1,0.19032376219154193,35
1735,4,3482,1353,2129,0,0,0,1.0,1,1.0,1,1.0,1,0.17800410633893818,34
1736,0,3482,1353,2129,0,0,0,1.0,1,1.0,1,1.0,1,0.16883134510735026,35
1737,4,3486,1355,2131,0,0,0,1.0,1,1.0,1,1.0,1,0.16131077365353197,36
1738,2,3488,1355,2133,0,0,0,1.0,1,1.0,1,1.0,1,0.13931169991919357,37
1739,1,3489,1355,2134,0,0,0,1.0,1,1.0,1,1.0,1,0.12578999198611096,38
1740,0,3489,1355,2134,0,0,0,1.0,1,1.0,1,1.0,1,0.11979657107620235,37
1741,1,3490,1355,2135,0,0,0,1.0,1,1.0,1,1.0,1,0.10486947591615897,38
1742,4,3494,1357,2137,0,0,0,1.0,1,1.0,1,1.0,1,0.18719551519721536,39
1743,4,3498,1359,2139,0,0,0,1.0,1,1.0,1,1.0,1,0.1932723674396264,37
1744,4,3502,1360,2142,0,0,0,1.0,1,1.0,1,1.0,1,0.12254557945341568,38
1745,3,3505,1361,2144,0,0,0,1.0,1,1.0,1,1.0,1,0.18180553861382306,37
1746,0,3505,1361,2144,0,0,0,1.0,1,1.0,1,1.0,1,0.1630349113885821,38
1747,3,3508,1361,2147,0,0,0,1.0,1,1.0,1,1.0,1,0.12590103487923215,38
1748,2,3510,1362,2148,0,0,0,1.0,1,1.0,1,1.0,1,0.0881876743421781,38
1749,0,3510,1362,2148,0,0,0,1.0,1,1.0,1,1.0,1,0.11644646207252558,37
1750,3,3513,1362,2151,0,0,0,1.0,1,1.0,1,1.0,1,0.11937350208982218,39
1751,0,3513,1362,2151,0,0,0,1.0,1,1.0,1,1.0,1,0.14032562593826606,38
1752,0,3513,1362,2151,0,0,0,1.0,1,1.0,1,1.0,1,0.11840674764749717,39
1753,3,3516,1362,2154,0,0,0,1.0,1,1.0,1,1.0,1,0.06101080173722728,40
1754,2,3518,1363,2155,0,0,0,1.0,1,1.0,1,1.0,1,0.1184958349390778,41
1755,2,3520,1363,2157,0,0,0,1.0,1,1.0,1,1.0,1,0.1345830173453469,41
1756,2,3522,1364,2158,0,0,0,1.0,1,1.0,1,1.0,1,0.12720430256236948,42
1757,2,3524,1364,2160,0,0,0,1.0,1,1.0,1,1.0,1,0.09711363981006677,42
1758,4,3528,1367,2161,0,0,0,1.0,1,1.0,1,1.0,1,0.18206125222108532,42
1759,3,3531,1367,2164,0,0,0,1.0,1,1.0,1,1.0,1,0.1772182772662977,39
1760,4,3535,1369,2166,0,0,0,1.0,1,1.0,1,1.0,1,0.212710451935798,39
1761,4,3539,1370,2169,0,0,0,1.0,1,1.0,1,1.0,1,0.1477871457925838,38
1762,1,3540,1370,2170,0,0,0,1.0,1,1.0,1,1.0,1,0.1318082995127042,37
1763,3,3543,1371,2172,0,0,0,1.0,1,1.0,1,1.0,1,0.08962454577774197,37
1764,1,3544,1372,2172,0,0,0,1.0,1,1.0,1,1.0,1,0.15423955390718067,36
1765,3,3547,1374,2173,0,0,0,1.0,1,1.0,1,1.0,1,0.15698571742453762,37
1766,1,3548,1374,2174,0,0,0,1.0,1,1.0,1,1.0,1,0.10741553990726496,36
1767,0,3548,1374,2174,0,0,0,1.0,1,1.0,1,1.0,1,0.10741553990726496,36
1768,0,3548,1374,2174,0,0,0,1.0,1,1.0,1,1.0,1,0.10741553990726496,36
1769,1,3549,1374,2175,0,0,0,1.0,1,1.0,1,1.0,1,0.0959351329415828,38
1770,0,3549,1374,2175,0,0,0,1.0,1,1.0,1,1.0,1,0.0959351329415828,38
1771,0,3549,1374,2175,0,0,0,1.0,1,1.0,1,1.0,1,0.0959351329415828,38
1772,0,3549,1374,2175,0,0,0,1.0,1,1.0,1,1.0,1,0.1321490827332226,40
1773,1,3550,1375,2175,0,0,0,1.0,1,1.0,1,1.0,1,0.13101388628345653,40
1774,0,3550,1375,2175,0,0,0,1.0,1,1.0,1,1.0,1,0.13101388628345653,40
1775,3,3553,1376,2177,0,0,0,1.0,1,1.0,1,1.0,1,0.14211329054825142,41
1776,0,3553,1376,2177,0,0,0,1.0,1,1.0,1,1.0,1,0.1259114752779714,43
1777,1,3554,1377,2177,0,0,0,1.0,1,1.0,1,1.0,1,0.1102490027738142,44
1778,4,3558,1379,2179,0,0,0,1.0,1,1.0,1,1.0,1,0.11714894645634864,44
1779,1,3559,1380,2179,0,0,0,1.0,1,1.0,1,1.0,1,0.11633746161056309,44
1780,2,3561,1380,2181,0,0,0,1.0,1,1.0,1,1.0,1,0.08966398865688567,46
1781,1,3562,1380,2182,0,0,0,1.0,1,1.0,1,1.0,1,0.08482607371650883,46
1782,3,3565,1382,2183,0,0,0,1.0,1,1.0,1,1.0,1,0.12380146349340737,45
1783,4,3569,1385,2184,0,0,0,1.0,1,1.0,1,1.0,1,0.16922807909533347,44
1784,1,3570,1386,2184,0,0,0,1.0,1,1.0,1,1.0,1,0.18009274499403335,44
1785,2,3572,1388,2184,0,0,0,1.0,1,1.0,1,1.0,1,0.2258651507847201,42
1786,11,3583,1391,2192,0,0,0,1.0,1,1.0,1,1.0,1,0.1491224023553893,42
1787,4,3587,1392,2195,0,0,0,1.0,1,1.0,1,1.0,1,0.14161635276231838,41
1788,3,3590,1393,2197,0,0,0,1.0,1,1.0,1,1.0,1,0.1430810567404546,41
1789,2,3592,1393,2199,0,0,0,1.0,1,1.0,1,1.0,1,0.09291399493544461,41
1790,3,3595,1396,2199,0,0,0,1.0,1,1.0,1,1.0,1,0.19176512111230049,41
1791,1,3596,1396,2200,0,0,0,1.0,1,1.0,1,1.0,1,0.16099794692505862,41
1792,2,3598,1396,2202,0,0,0,1.0,1,1.0,1,1.0,1,0.11644013869615916,43
1793,5,3603,1398,2205,0,0,0,1.0,1,1.0,1,1.0,1,0.081775712360905,43
1794,0,3603,1398,2205,0,0,0,1.0,1,1.0,1,1.0,1,0.0947736964803478,41
1795,1,3604,1399,2205,0,0,0,1.0,1,1.0,1,1.0,1,0.12589424278481035,41
1796,2,3606,1400,2206,0,0,0,1.0,1,1.0,1,1.0,1,0.191760432900899,40
1797,1,3607,1401,2206,0,0,0,1.0,1,1.0,1,1.0,1,0.2277248840285969,38
1798,6,3613,1401,2212,0,0,0,1.0,1,1.0,1,1.0,1,0.11708439618292307,38
1799,4,3617,1404,2213,0,0,0,1.0,1,1.0,1,1.0,1,0.1895785349419725,37
1800,2,3619,1405,2214,0,0,0,1.0,1,1.0,1,1.0,1,0.1934183708539328,35
1801,4,3623,1406,2217,0,0,0,1.0,1,1.0,1,1.0,1,0.1896918489986045,34
1802,0,3623,1406,2217,0,0,0,1.0,1,1.0,1,1.0,1,0.20256555663638645,33
1803,0,3623,1406,2217,0,0,0,1.0,1,1.0,1,1.0,1,0.20256555663638645,33
1804,3,3626,1406,2220,0,0,0,1.0,1,1.0,1,1.0,1,0.1525361986002973,33
1805,1,3627,1406,2221,0,0,0,1.0,1,1.0,1,1.0,1,0.13003482365495217,35
1806,2,3629,1407,2222,0,0,0,1.0,1,1.0,1,1.0,1,0.15342926614154725,36
1807,3,3632,1407,2225,0,0,0,1.0,1,1.0,1,1.0,1,0.10763102867049648,35
1808,1,3633,1407,2226,0,0,0,1.0,1,1.0,1,1.0,1,0.10942916483988953,37
1809,2,3635,1407,2228,0,0,0,1.0,1,1.0,1,1.0,1,0.15609676204628686,35
1810,0,3635,1407,2228,0,0,0,1.0,1,1.0,1,1.0,1,0.1703215454172533,36
1811,1,3636,1408,2228,0,0,0,1.0,1,1.0,1,1.0,1,0.21563787380433744,34
1812,1,3637,1408,2229,0,0,0,1.0,1,1.0,1,1.0,1,0.19354608474449123,36
1813,2,3639,1409,2230,0,0,0,1.0,1,1.0,1,1.0,1,0.19102202319770417,35
1814,3,3642,1410,2232,0,0,0,1.0,1,1.0,1,1.0,1,0.23201488895611835,36
1815,1,3643,1411,2232,0,0,0,1.0,1,1.0,1,1.0,1,0.2721505557313481,35
1816,3,3646,1411,2235,0,0,0,1.0,1,1.0,1,1.0,1,0.22606846620148421,35
1817,2,3648,1412,2236,0,0,0,1.0,1,1.0,1,1.0,1,0.23825850219149894,35
1818,2,3650,1413,2237,0,0,0,1.0,1,1.0,1,1.0,1,0.21103625215983163,36
1819,4,3654,1414,2240,0,0,0,1.0,1,1.0,1,1.0,1,0.14347708114517724,37
1820,2,3656,1414,2242,0,0,0,1.0,1,1.0,1,1.0,1,0.14422211712362917,37
1821,0,3656,1414,2242,0,0,0,1.0,1,1.0,1,1.0,1,0.14502789947918787,38
1822,3,3659,1416,2243,0,0,0,1.0,1,1.0,1,1.0,1,0.16723350821872857,37
1823,2,3661,1417,2244,0,0,0,1.0,1,1.0,1,1.0,1,0.17489084799161067,36
1824,2,3663,1419,2244,0,0,0,1.0,1,1.0,1,1.0,1,0.23043890661411523,36
1825,6,3669,1421,2248,0,0,0,1.0,1,1.0,1,1.0,1,0.11490514395106374,34
1826,2,3671,1422,2249,0,0,0,1.0,1,1.0,1,1.0,1,0.14995690817971735,35
1827,2,3673,1424,2249,0,0,0,1.0,1,1.0,1,1.0,1,0.15885852813130458,34
1828,4,3677,1427,2250,0,0,0,1.0,1,1.0,1,1.0,1,0.1653293530461866,33
1829,0,3677,1427,2250,0,0,0,1.0,1,1.0,1,1.0,1,0.1343809821983667,31
1830,1,3678,1428,2250,0,0,0,1.0,1,1.0,1,1.0,1,0.11723515095451474,31
1831,2,3680,1429,2251,0,0,0,1.0,1,1.0,1,1.0,1,0.0956960215725823,30
1832,0,3680,1429,2251,0,0,0,1.0,1,1.0,1,1.0,1,0.11024069051991056,29
1833,2,3682,1431,2251,0,0,0,1.0,1,1.0,1,1.0,1,0.14666817217527106,28
1834,2,3684,1432,2252,0,0,0,1.0,1,1.0,1,1.0,1,0.15118579730540024,27
1835,4,3688,1435,2253,0,0,0,1.0,1,1.0,1,1.0,1,0.15464015636981798,26
1836,6,3694,1437,2257,0,0,0,1.0,1,1.0,1,1.0,1,0.16948892360874057,26
1837,2,3696,1438,2258,0,0,0,1.0,1,1.0,1,1.0,1,0.2695242219498872,25
1838,2,3698,1438,2260,0,0,0,1.0,1,1.0,1,1.0,1,0.15626309108964864,25
1839,0,3698,1438,2260,0,0,0,1.0,1,1.0,1,1.0,1,0.20302027904823763,24
1840,1,3699,1439,2260,0,0,0,1.0,1,1.0,1,1.0,1,0.2379151850625085,23
1841,0,3699,1439,2260,0,0,0,1.0,1,1.0,1,1.0,1,0.2497863688884751,22
1842,3,3702,1440,2262,0,0,0,1.0,1,1.0,1,1.0,1,0.2055226310993971,23
1843,0,3702,1440,2262,0,0,0,1.0,1,1.0,1,1.0,1,0.2055226310993971,23
1844,0,3702,1440,2262,0,0,0,1.0,1,1.0,1,1.0,1,0.2055226310993971,23
1845,2,3704,1442,2262,0,0,0,1.0,1,1.0,1,1.0,1,0.25834735012434284,23
1846,3,3707,1442,2265,0,0,0,1.0,1,1.0,1,1.0,1,0.13647631033579202,23
1847,0,3707,1442,2265,0,0,0,1.0,1,1.0,1,1.0,1,0.125609289013828,24
1848,0,3707,1442,2265,0,0,0,1.0,1,1.0,1,1.0,1,0.125609289013828,24
1849,0,3707,1442,2265,0,0,0,1.0,1,1.0,1,1.0,1,0.14387498177239155,25
1850,0,3707,1442,2265,0,0,0,1.0,1,1.0,1,1.0,1,0.14387498177239155,25
1851,0,3707,1442,2265,0,0,0,1.0,1,1.0,1,1.0,1,0.14387498177239155,25
1852,0,3707,1442,2265,0,0,0,1.0,1,1.0,1,1.0,1,0.14387498177239155,25
1853,0,3707,1442,2265,0,0,0,1.0,1,1.0,1,1.0,1,0.16270565135257067,25
1854,0,3707,1442,2265,0,0,0,1.0,1,1.0,1,1.0,1,0.16270565135257067,25
1855,0,3707,1442,2265,0,0,0,1.0,1,1.0,1,1.0,1,0.1895077605502882,26
1856,1,3708,1443,2265,0,0,0,1.0,1,1.0,1,1.0,1,0.2417138578139997,27
1857,3,3711,1444,2267,0,0,0,1.0,1,1.0,1,1.0,1,0.31149986622275594,28
1858,2,3713,1444,2269,0,0,0,1.0,1,1.0,1,1.0,1,0.2522692479862958,28
1859,4,3717,1447,2270,0,0,0,1.0,1,1.0,1,1.0,1,0.28234017856213944,28
1860,0,3717,1447,2270,0,0,0,1.0,1,1.0,1,1.0,1,0.28234017856213944,28
1861,1,3718,1447,2271,0,0,0,1.0,1,1.0,1,1.0,1,0.2655103351577384,28
1862,1,3719,1447,2272,0,0,0,1.0,1,1.0,1,1.0,1,0.2550450511723109,28
1863,0,3719,1447,2272,0,0,0,1.0,1,1.0,1,1.0,1,0.2670637349533801,29
1864,3,3722,1448,2274,0,0,0,1.0,1,1.0,1,1.0,1,0.2412113750819835,27
1865,1,3723,1449,2274,0,0,0,1.0,1,1.0,1,1.0,1,0.2628373271908551,26
1866,2,3725,1450,2275,0,0,0,1.0,1,1.0,1,1.0,1,0.27355017630687484,26
1867,1,3726,1450,2276,0,0,0,1.0,1,1.0,1,1.0,1,0.23365260691307305,26
1868,1,3727,1450,2277,0,0,0,1.0,1,1.0,1,1.0,1,0.2302783683188739,26
1869,0,3727,1450,2277,0,0,0,1.0,1,1.0,1,1.0,1,0.2302783683188739,26
1870,1,3728,1450,2278,0,0,0,1.0,1,1.0,1,1.0,1,0.22584314614172704,27
1871,0,3728,1450,2278,0,0,0,1.0,1,1.0,1,1.0,1,0.22584314614172704,27
1872,0,3728,1450,2278,0,0,0,1.0,1,1.0,1,1.0,1,0.2488307557782717,25
1873,0,3728,1450,2278,0,0,0,1.0,1,1.0,1,1.0,1,0.2488307557782717,25
1874,2,3730,1450,2280,0,0,0,1.0,1,1.0,1,1.0,1,0.2622993475400813,25
1875,1,3731,1450,2281,0,0,0,1.0,1,1.0,1,1.0,1,0.2427040341404528,25
1876,0,3731,1450,2281,0,0,0,1.0,1,1.0,1,1.0,1,0.2255965109382951,26
1877,1,3732,1450,2282,0,0,0,1.0,1,1.0,1,1.0,1,0.22599351960141711,27
1878,1,3733,1451,2282,0,0,0,1.0,1,1.0,1,1.0,1,0.24570268494974606,28
1879,2,3735,1451,2284,0,0,0,1.0,1,1.0,1,1.0,1,0.205358437692515,29
1880,1,3736,1451,2285,0,0,0,1.0,1,1.0,1,1.0,1,0.18916414641635249,29
1881,0,3736,1451,2285,0,0,0,1.0,1,1.0,1,1.0,1,0.18916414641635249,29
1882,0,3736,1451,2285,0,0,0,1.0,1,1.0,1,1.0,1,0.1921458511708847,28
1883,0,3736,1451,2285,0,0,0,1.0,1,1.0,1,1.0,1,0.1921458511708847,28
1884,1,3737,1452,2285,0,0,0,1.0,1,1.0,1,1.0,1,0.21561714531981538,28
1885,0,3737,1452,2285,0,0,0,1.0,1,1.0,1,1.0,1,0.21561714531981538,28
1886,0,3737,1452,2285,0,0,0,1.0,1,1.0,1,1.0,1,0.1996818521729176,29
1887,0,3737,1452,2285,0,0,0,1.0,1,1.0,1,1.0,1,0.1996818521729176,29
1888,2,3739,1452,2287,0,0,0,1.0,1,1.0,1,1.0,1,0.1745516339832298,31
1889,0,3739,1452,2287,0,0,0,1.0,1,1.0,1,1.0,1,0.1745516339832298,31
1890,0,3739,1452,2287,0,0,0,1.0,1,1.0,1,1.0,1,0.1745516339832298,31
1891,0,3739,1452,2287,0,0,0,1.0,1,1.0,1,1.0,1,0.19565269514441466,32
1892,0,3739,1452,2287,0,0,0,1.0,1,1.0,1,1.0,1,0.19565269514441466,32
1893,0,3739,1452,2287,0,0,0,1.0,1,1.0,1,1.0,1,0.19565269514441466,32
1894,0,3739,1452,2287,0,0,0,1.0,1,1.0,1,1.0,1,0.18149702491346562,33
1895,4,3743,1453,2290,0,0,0,1.0,1,1.0,1,1.0,1,0.13929811201071907,35
1896,0,3743,1453,2290,0,0,0,1.0,1,1.0,1,1.0,1,0.16337883757977337,34
1897,0,3743,1453,2290,0,0,0,1.0,1,1.0,1,1.0,1,0.16337883757977337,34
1898,0,3743,1453,2290,0,0,0,1.0,1,1.0,1,1.0,1,0.16337883757977337,34
1899,0,3743,1453,2290,0,0,0,1.0,1,1.0,1,1.0,1,0.16337883757977337,34
1900,1,3744,1453,2291,0,0,0,1.0,1,1.0,1,1.0,1,0.125460468865923,35
1901,0,3744,1453,2291,0,0,0,1.0,1,1.0,1,1.0,1,0.125460468865923,35
1902,1,3745,1454,2291,0,0,0,1.0,1,1.0,1,1.0,1,0.16363801696774952,35
1903,0,3745,1454,2291,0,0,0,1.0,1,1.0,1,1.0,1,0.16363801696774952,35
1904,0,3745,1454,2291,0,0,0,1.0,1,1.0,1,1.0,1,0.16363801696774952,35
1905,1,3746,1454,2292,0,0,0,1.0,1,1.0,1,1.0,1,0.14118051855238428,37
1906,0,3746,1454,2292,0,0,0,1.0,1,1.0,1,1.0,1,0.14118051855238428,37
1907,1,3747,1454,2293,0,0,0,1.0,1,1.0,1,1.0,1,0.12485069374934096,39
1908,0,3747,1454,2293,0,0,0,1.0,1,1.0,1,1.0,1,0.12485069374934096,39
1909,2,3749,1455,2294,0,0,0,1.0,1,1.0,1,1.0,1,0.16767910273147082,41
1910,0,3749,1455,2294,0,0,0,1.0,1,1.0,1,1.0,1,0.16767910273147082,41
1911,1,3750,1455,2295,0,0,0,1.0,1,1.0,1,1.0,1,0.20802945046165827,40
1912,3,3753,1456,2297,0,0,0,1.0,1,1.0,1,1.0,1,0.18718088991678353,39
1913,1,3754,1456,2298,0,0,0,1.0,1,1.0,1,1.0,1,0.18851897603658582,40
1914,2,3756,1458,2298,0,0,0,1.0,1,1.0,1,1.0,1,0.23130674178592875,41
1915,6,3762,1459,2303,0,0,0,1.0,1,1.0,1,1.0,1,0.19337005117470252,42
1916,2,3764,1460,2304,0,0,0,1.0,1,1.0,1,1.0,1,0.18500114030334064,42
1917,0,3764,1460,2304,0,0,0,1.0,1,1.0,1,1.0,1,0.19599377562221118,41
1918,6,3770,1462,2308,0,0,0,1.0,1,1.0,1,1.0,1,0.17263317505904108,38
1919,4,3774,1464,2310,0,0,0,1.0,1,1.0,1,1.0,1,0.24961275769515667,38
1920,1,3775,1464,2311,0,0,0,1.0,1,1.0,1,1.0,1,0.26128822327189866,38
1921,4,3779,1464,2315,0,0,0,1.0,1,1.0,1,1.0,1,0.19715356721650779,39
1922,2,3781,1464,2317,0,0,0,1.0,1,1.0,1,1.0,1,0.14987897920138668,40
1923,0,3781,1464,2317,0,0,0,1.0,1,1.0,1,1.0,1,0.14638963050828138,41
1924,2,3783,1466,2317,0,0,0,1.0,1,1.0,1,1.0,1,0.1772692430645323,41
1925,0,3783,1466,2317,0,0,0,1.0,1,1.0,1,1.0,1,0.16796201619182716,41
1926,0,3783,1466,2317,0,0,0,1.0,1,1.0,1,1.0,1,0.16796201619182716,41
1927,2,3785,1466,2319,0,0,0,1.0,1,1.0,1,1.0,1,0.13944062903145613,41
1928,2,3787,1468,2319,0,0,0,1.0,1,1.0,1,1.0,1,0.1727916318457136,42
1929,0,3787,1468,2319,0,0,0,1.0,1,1.0,1,1.0,1,0.163525633485172,41
1930,2,3789,1468,2321,0,0,0,1.0,1,1.0,1,1.0,1,0.13926833555187046,41
1931,0,3789,1468,2321,0,0,0,1.0,1,1.0,1,1.0,1,0.13926833555187046,41
1932,0,3789,1468,2321,0,0,0,1.0,1,1.0,1,1.0,1,0.13926833555187046,41
1933,2,3791,1469,2322,0,0,0,1.0,1,1.0,1,1.0,1,0.16078915311666483,43
1934,2,3793,1469,2324,0,0,0,1.0,1,1.0,1,1.0,1,0.16744319260605411,44
1935,0,3793,1469,2324,0,0,0,1.0,1,1.0,1,1.0,1,0.1362426495256832,45
1936,1,3794,1469,2325,0,0,0,1.0,1,1.0,1,1.0,1,0.12704505185947618,48
1937,2,3796,1471,2325,0,0,0,1.0,1,1.0,1,1.0,1,0.16375639235120615,48
1938,2,3798,1472,2326,0,0,0,1.0,1,1.0,1,1.0,1,0.13184825851723672,48
1939,2,3800,1472,2328,0,0,0,1.0,1,1.0,1,1.0,1,0.10745689399225693,48
1940,0,3800,1472,2328,0,0,0,1.0,1,1.0,1,1.0,1,0.10745689399225693,48
1941,0,3800,1472,2328,0,0,0,1.0,1,1.0,1,1.0,1,0.10745689399225693,48
1942,3,3803,1474,2329,0,0,0,1.0,1,1.0,1,1.0,1,0.1582492276833593,49
1943,0,3803,1474,2329,0,0,0,1.0,1,1.0,1,1.0,1,0.14590196117731413,48
1944,5,3808,1476,2332,0,0,0,1.0,1,1.0,1,1.0,1,0.17040823042836686,47
1945,3,3811,1478,2333,0,0,0,1.0,1,1.0,1,1.0,1,0.15365869788626918,46
1946,0,3811,1478,2333,0,0,0,1.0,1,1.0,1,1.0,1,0.1713286313160869,46
1947,7,3818,1481,2337,0,0,0,1.0,1,1.0,1,1.0,1,0.21417410382193802,45
1948,5,3823,1481,2342,0,0,0,1.0,1,1.0,1,1.0,1,0.18318209541166694,46
1949,3,3826,1483,2343,0,0,0,1.0,1,1.0,1,1.0,1,0.2097530840666507,42
1950,2,3828,1484,2344,0,0,0,1.0,1,1.0,1,1.0,1,0.20905743490101739,40
1951,2,3830,1485,2345,0,0,0,1.0,1,1.0,1,1.0,1,0.18812592260499586,39
1952,1,3831,1486,2345,0,0,0,1.0,1,1.0,1,1.0,1,0.24388137807747523,35
1953,3,3834,1488,2346,0,0,0,1.0,1,1.0,1,1.0,1,0.21212643975651227,36
1954,4,3838,1488,2350,0,0,0,1.0,1,1.0,1,1.0,1,0.13131787606119252,34
1955,1,3839,1489,2350,0,0,0,1.0,1,1.0,1,1.0,1,0.17729055377898167,35
1956,4,3843,1491,2352,0,0,0,1.0,1,1.0,1,1.0,1,0.2025883134490405,37
1957,2,3845,1491,2354,0,0,0,1.0,1,1.0,1,1.0,1,0.15713550117131758,37
1958,1,3846,1491,2355,0,0,0,1.0,1,1.0,1,1.0,1,0.17596426008193644,39
1959,1,3847,1491,2356,0,0,0,1.0,1,1.0,1,1.0,1,0.15512458450467087,41
1960,1,3848,1492,2356,0,0,0,1.0,1,1.0,1,1.0,1,0.17739708245186378,40
1961,2,3850,1493,2357,0,0,0,1.0,1,1.0,1,1.0,1,0.1540249000768485,41
1962,2,3852,1494,2358,0,0,0,1.0,1,1.0,1,1.0,1,0.20356163192896004,40
1963,3,3855,1495,2360,0,0,0,1.0,1,1.0,1,1.0,1,0.16630085620191204,41
1964,0,3855,1495,2360,0,0,0,1.0,1,1.0,1,1.0,1,0.19179558470721156,40
1965,2,3857,1496,2361,0,0,0,1.0,1,1.0,1,1.0,1,0.17913033720623614,41
1966,1,3858,1496,2362,0,0,0,1.0,1,1.0,1,1.0,1,0.16370921618733342,41
1967,2,3860,1497,2363,0,0,0,1.0,1,1.0,1,1.0,1,0.17812732847648485,42
1968,1,3861,1497,2364,0,0,0,1.0,1,1.0,1,1.0,1,0.20019946842137426,42
1969,3,3864,1498,2366,0,0,0,1.0,1,1.0,1,1.0,1,0.18850175005499195,43
1970,1,3865,1498,2367,0,0,0,1.0,1,1.0,1,1.0,1,0.18776593643944436,42
1971,1,3866,1499,2367,0,0,0,1.0,1,1.0,1,1.0,1,0.23671993232764968,42
1972,4,3870,1499,2371,0,0,0,1.0,1,1.0,1,1.0,1,0.16255331602870446,42
1973,2,3872,1499,2373,0,0,0,1.0,1,1.0,1,1.0,1,0.15795100480760713,43
1974,0,3872,1499,2373,0,0,0,1.0,1,1.0,1,1.0,1,0.17268334011602393,43
1975,2,3874,1499,2375,0,0,0,1.0,1,1.0,1,1.0,1,0.135423552998198,43
1976,0,3874,1499,2375,0,0,0,1.0,1,1.0,1,1.0,1,0.135423552998198,43
1977,3,3877,1499,2378,0,0,0,1.0,1,1.0,1,1.0,1,0.15016270030016213,48
1978,2,3879,1499,2380,0,0,0,1.0,1,1.0,1,1.0,1,0.13287065230139983,48
1979,1,3880,1500,2380,0,0,0,1.0,1,1.0,1,1.0,1,0.15318830661286373,49
1980,1,3881,1500,2381,0,0,0,1.0,1,1.0,1,1.0,1,0.14687791473694703,50
1981,3,3884,1502,2382,0,0,0,1.0,1,1.0,1,1.0,1,0.14497317613796715,50
1982,1,3885,1503,2382,0,0,0,1.0,1,1.0,1,1.0,1,0.15056385126880376,50
1983,1,3886,1504,2382,0,0,0,1.0,1,1.0,1,1.0,1,0.14281394967318217,49
1984,2,3888,1505,2383,0,0,0,1.0,1,1.0,1,1.0,1,0.13663118019856713,48
1985,2,3890,1507,2383,0,0,0,1.0,1,1.0,1,1.0,1,0.10689236554728143,46
1986,0,3890,1507,2383,0,0,0,1.0,1,1.0,1,1.0,1,0.10689236554728143,46
1987,3,3893,1509,2384,0,0,0,1.0,1,1.0,1,1.0,1,0.14460313565438823,42
1988,0,3893,1509,2384,0,0,0,1.0,1,1.0,1,1.0,1,0.16304331943315395,40
1989,2,3895,1511,2384,0,0,0,1.0,1,1.0,1,1.0,1,0.18230724686803731,38
1990,1,3896,1511,2385,0,0,0,1.0,1,1.0,1,1.0,1,0.1456688728959982,38
1991,4,3900,1514,2386,0,0,0,1.0,1,1.0,1,1.0,1,0.18286517920604392,38
1992,2,3902,1514,2388,0,0,0,1.0,1,1.0,1,1.0,1,0.16725491474705248,39
1993,5,3907,1516,2391,0,0,0,1.0,1,1.0,1,1.0,1,0.25414858373703814,38
1994,3,3910,1517,2393,0,0,0,1.0,1,1.0,1,1.0,1,0.19938004799258377,37
1995,2,3912,1518,2394,0,0,0,1.0,1,1.0,1,1.0,1,0.18589767384640646,37
1996,7,3919,1519,2400,0,0,0,1.0,1,1.0,1,1.0,1,0.1930016021760266,37
1997,1,3920,1519,2401,0,0,0,1.0,1,1.0,1,1.0,1,0.23091786393426944,35
1998,1,3921,1519,2402,0,0,0,1.0,1,1.0,1,1.0,1,0.22575945689054247,34
1999,3,3924,1521,2403,0,0,0,1.0,1,1.0,1,1.0,1,0.1864371414830415,35
2000,0,3924,1521,2403,0,0,0,1.0,1,1.0,1,1.0,1,0.20183256982786468,34
2001,2,3926,1521,2405,0,0,0,1.0,1,1.0,1,1.0,1,0.2220448234193166,35
2002,3,3929,1522,2407,0,0,0,1.0,1,1.0,1,1.0,1,0.22646859809863845,36
2003,0,3929,1522,2407,0,0,0,1.0,1,1.0,1,1.0,1,0.24040234080796236,37
2004,3,3932,1523,2409,0,0,0,1.0,1,1.0,1,1.0,1,0.18886844072529607,38
2005,3,3935,1523,2412,0,0,0,1.0,1,1.0,1,1.0,1,0.16391671998535523,38
2006,0,3935,1523,2412,0,0,0,1.0,1,1.0,1,1.0,1,0.16391671998535523,38
2007,3,3938,1524,2414,0,0,0,1.0,1,1.0,1,1.0,1,0.12957591677077146,40
2008,0,3938,1524,2414,0,0,0,1.0,1,1.0,1,1.0,1,0.12957591677077146,40
2009,2,3940,1526,2414,0,0,0,1.0,1,1.0,1,1.0,1,0.12100830035365374,41
2010,0,3940,1526,2414,0,0,0,1.0,1,1.0,1,1.0,1,0.12100830035365374,41
2011,1,3941,1526,2415,0,0,0,1.0,1,1.0,1,1.0,1,0.10727467588082072,41
2012,0,3941,1526,2415,0,0,0,1.0,1,1.0,1,1.0,1,0.10727467588082072,41
2013,0,3941,1526,2415,0,0,0,1.0,1,1.0,1,1.0,1,0.12939294494915504,43
2014,1,3942,1526,2416,0,0,0,1.0,1,1.0,1,1.0,1,0.13946325193604298,43
2015,2,3944,1528,2416,0,0,0,1.0,1,1.0,1,1.0,1,0.14706531989048688,43
2016,3,3947,1530,2417,0,0,0,1.0,1,1.0,1,1.0,1,0.18873847286779402,44
2017,3,3950,1530,2420,0,0,0,1.0,1,1.0,1,1.0,1,0.1461307041738118,45
2018,3,3953,1532,2421,0,0,0,1.0,1,1.0,1,1.0,1,0.15574753096167002,46
2019,2,3955,1532,2423,0,0,0,1.0,1,1.0,1,1.0,1,0.11461800121959635,47
2020,1,3956,1532,2424,0,0,0,1.0,1,1.0,1,1.0,1,0.09738251236768636,47
2021,1,3957,1533,2424,0,0,0,1.0,1,1.0,1,1.0,1,0.09506345248073744,47
2022,1,3958,1533,2425,0,0,0,1.0,1,1.0,1,1.0,1,0.08731231712842523,48
2023,1,3959,1534,2425,0,0,0,1.0,1,1.0,1,1.0,1,0.09168239568802751,48
2024,3,3962,1537,2425,0,0,0,1.0,1,1.0,1,1.0,1,0.1157780101832044,45
2025,2,3964,1539,2425,0,0,0,1.0,1,1.0,1,1.0,1,0.17750107686857242,42
2026,8,3972,1542,2430,0,0,0,1.0,1,1.0,1,1.0,1,0.12192186823272905,44
2027,0,3972,1542,2430,0,0,0,1.0,1,1.0,1,1.0,1,0.1325970634655935,40
2028,3,3975,1544,2431,0,0,0,1.0,1,1.0,1,1.0,1,0.1590785310653081,39
2029,0,3975,1544,2431,0,0,0,1.0,1,1.0,1,1.0,1,0.17837347808028145,37
2030,1,3976,1545,2431,0,0,0,1.0,1,1.0,1,1.0,1,0.2228476608371014,34
2031,1,3977,1545,2432,0,0,0,1.0,1,1.0,1,1.0,1,0.23204908537778465,35
2032,2,3979,1545,2434,0,0,0,1.0,1,1.0,1,1.0,1,0.22825377733668867,34
2033,6,3985,1548,2437,0,0,0,1.0,1,1.0,1,1.0,1,0.21067917844571338,36
2034,3,3988,1549,2439,0,0,0,1.0,1,1.0,1,1.0,1,0.2511740081202852,34
2035,5,3993,1550,2443,0,0,0,1.0,1,1.0,1,1.0,1,0.2122754552057163,35
2036,2,3995,1550,2445,0,0,0,1.0,1,1.0,1,1.0,1,0.17780432640147303,34
2037,0,3995,1550,2445,0,0,0,1.0,1,1.0,1,1.0,1,0.1613035317395968,35
2038,0,3995,1550,2445,0,0,0,1.0,1,1.0,1,1.0,1,0.17062230282623672,36
2039,0,3995,1550,2445,0,0,0,1.0,1,1.0,1,1.0,1,0.1461022518443183,38
2040,0,3995,1550,2445,0,0,0,1.0,1,1.0,1,1.0,1,0.1461022518443183,38
2041,0,3995,1550,2445,0,0,0,1.0,1,1.0,1,1.0,1,0.15516943378608933,39
2042,0,3995,1550,2445,0,0,0,1.0,1,1.0,1,1.0,1,0.15516943378608933,39
2043,0,3995,1550,2445,0,0,0,1.0,1,1.0,1,1.0,1,0.15516943378608933,39
2044,0,3995,1550,2445,0,0,0,1.0,1,1.0,1,1.0,1,0.15516943378608933,39
2045,3,3998,1551,2447,0,0,0,1.0,1,1.0,1,1.0,1,0.13484697759095293,41
2046,2,4000,1551,2449,0,0,0,1.0,1,1.0,1,1.0,1,0.12743434926416916,42
2047,2,4002,1551,2451,0,0,0,1.0,1,1.0,1,1.0,1,0.09385859143163906,42
2048,1,4003,1552,2451,0,0,0,1.0,1,1.0,1,1.0,1,0.12653960176100462,43
2049,2,4005,1553,2452,0,0,0,1.0,1,1.0,1,1.0,1,0.13929498584993003,44
2050,4,4009,1553,2456,0,0,0,1.0,1,1.0,1,1.0,1,0.059245870774251044,44
2051,3,4012,1554,2458,0,0,0,1.0,1,1.0,1,1.0,1,0.094058716498407,45
2052,0,4012,1554,2458,0,0,0,1.0,1,1.0,1,1.0,1,0.094058716498407,45
2053,1,4013,1554,2459,0,0,0,1.0,1,1.0,1,1.0,1,0.07374602504632782,45
2054,1,4014,1555,2459,0,0,0,1.0,1,1.0,1,1.0,1,0.10731261264732349,46
2055,2,4016,1555,2461,0,0,0,1.0,1,1.0,1,1.0,1,0.09598743652454665,46
2056,2,4018,1556,2462,0,0,0,1.0,1,1.0,1,1.0,1,0.10174615222666138,46
2057,6,4024,1559,2465,0,0,0,1.0,1,1.0,1,1.0,1,0.12317662344759944,47
2058,4,4028,1561,2467,0,0,0,1.0,1,1.0,1,1.0,1,0.10678613618546182,47
2059,3,4031,1562,2469,0,0,0,1.0,1,1.0,1,1.0,1,0.07796327541198438,48
2060,2,4033,1563,2470,0,0,0,1.0,1,1.0,1,1.0,1,0.10612833641340233,50
2061,0,4033,1563,2470,0,0,0,1.0,1,1.0,1,1.0,1,0.10463449113116463,51
2062,3,4036,1565,2471,0,0,0,1.0,1,1.0,1,1.0,1,0.15445460838498967,49
2063,1,4037,1566,2471,0,0,0,1.0,1,1.0,1,1.0,1,0.16203087546283065,48
2064,4,4041,1567,2474,0,0,0,1.0,1,1.0,1,1.0,1,0.12725844726434496,45
2065,3,4044,1569,2475,0,0,0,1.0,1,1.0,1,1.0,1,0.13582479089317517,44
2066,1,4045,1570,2475,0,0,0,1.0,1,1.0,1,1.0,1,0.19499551805234336,42
2067,1,4046,1571,2475,0,0,0,1.0,1,1.0,1,1.0,1,0.1851131619736436,41
2068,1,4047,1571,2476,0,0,0,1.0,1,1.0,1,1.0,1,0.18099748749850425,40
2069,0,4047,1571,2476,0,0,0,1.0,1,1.0,1,1.0,1,0.1886357156802494,40
2070,2,4049,1571,2478,0,0,0,1.0,1,1.0,1,1.0,1,0.1370889319148396,40
2071,4,4053,1574,2479,0,0,0,1.0,1,1.0,1,1.0,1,0.1446103126721426,40
2072,3,4056,1574,2482,0,0,0,1.0,1,1.0,1,1.0,1,0.0865149419403908,41
2073,4,4060,1575,2485,0,0,0,1.0,1,1.0,1,1.0,1,0.1131053099649507,41
2074,1,4061,1575,2486,0,0,0,1.0,1,1.0,1,1.0,1,0.09079703005888991,41
2075,0,4061,1575,2486,0,0,0,1.0,1,1.0,1,1.0,1,0.09079703005888991,41
2076,1,4062,1576,2486,0,0,0,1.0,1,1.0,1,1.0,1,0.11501391394414151,41
2077,1,4063,1577,2486,0,0,0,1.0,1,1.0,1,1.0,1,0.1000693149162817,40
2078,1,4064,1578,2486,0,0,0,1.0,1,1.0,1,1.0,1,0.11453045904994243,40
2079,0,4064,1578,2486,0,0,0,1.0,1,1.0,1,1.0,1,0.09742505119053466,39
2080,0,4064,1578,2486,0,0,0,1.0,1,1.0,1,1.0,1,0.0877126682949956,38
2081,0,4064,1578,2486,0,0,0,1.0,1,1.0,1,1.0,1,0.11076691329949838,40
2082,4,4068,1580,2488,0,0,0,1.0,1,1.0,1,1.0,1,0.15900808425956942,41
2083,5,4073,1581,2492,0,0,0,1.0,1,1.0,1,1.0,1,0.11025963601929391,40
2084,2,4075,1583,2492,0,0,0,1.0,1,1.0,1,1.0,1,0.07723742854845192,42
2085,1,4076,1584,2492,0,0,0,1.0,1,1.0,1,1.0,1,0.09170187967306757,42
2086,1,4077,1584,2493,0,0,0,1.0,1,1.0,1,1.0,1,0.08382884409368091,43
2087,1,4078,1585,2493,0,0,0,1.0,1,1.0,1,1.0,1,0.10947265092004912,45
2088,2,4080,1587,2493,0,0,0,1.0,1,1.0,1,1.0,1,0.16779988288716516,46
2089,4,4084,1587,2497,0,0,0,1.0,1,1.0,1,1.0,1,0.12010322319347087,47
2090,1,4085,1588,2497,0,0,0,1.0,1,1.0,1,1.0,1,0.16020514086458532,49
2091,0,4085,1588,2497,0,0,0,1.0,1,1.0,1,1.0,1,0.16020514086458532,49
2092,0,4085,1588,2497,0,0,0,1.0,1,1.0,1,1.0,1,0.16020514086458532,49
2093,1,4086,1589,2497,0,0,0,1.0,1,1.0,1,1.0,1,0.16499316522306692,49
2094,0,4086,1589,2497,0,0,0,1.0,1,1.0,1,1.0,1,0.16499316522306692,49
2095,2,4088,1590,2498,0,0,0,1.0,1,1.0,1,1.0,1,0.10281087947706931,49
2096,2,4090,1590,2500,0,0,0,1.0,1,1.0,1,1.0,1,0.10250508605785691,51
2097,1,4091,1590,2501,0,0,0,1.0,1,1.0,1,1.0,1,0.09503738846478414,51
2098,2,4093,1590,2503,0,0,0,1.0,1,1.0,1,1.0,1,0.07104495126855016,52
2099,1,4094,1591,2503,0,0,0,1.0,1,1.0,1,1.0,1,0.08811060346936118,51
2100,3,4097,1593,2504,0,0,0,1.0,1,1.0,1,1.0,1,0.11262171071161982,51
2101,5,4102,1593,2509,0,0,0,1.0,1,1.0,1,1.0,1,0.09478392666273436,48
2102,2,4104,1595,2509,0,0,0,1.0,1,1.0,1,1.0,1,0.14815377908639568,49
2103,8,4112,1598,2514,0,0,0,1.0,1,1.0,1,1.0,1,0.18969694811376794,48
2104,4,4116,1598,2518,0,0,0,1.0,1,1.0,1,1.0,1,0.15114336311898968,43
2105,6,4122,1601,2521,0,0,0,1.0,1,1.0,1,1.0,1,0.16354147112003747,42
2106,2,4124,1603,2521,0,0,0,1.0,1,1.0,1,1.0,1,0.18230307567041573,40
2107,1,4125,1604,2521,0,0,0,1.0,1,1.0,1,1.0,1,0.18004786474447101,39
2108,4,4129,1606,2523,0,0,0,1.0,1,1.0,1,1.0,1,0.1415050287464948,38
2109,0,4129,1606,2523,0,0,0,1.0,1,1.0,1,1.0,1,0.11918186895575852,37
2110,2,4131,1608,2523,0,0,0,1.0,1,1.0,1,1.0,1,0.1619712697674661,38
2111,1,4132,1609,2523,0,0,0,1.0,1,1.0,1,1.0,1,0.19891001750977566,37
2112,4,4136,1611,2525,0,0,0,1.0,1,1.0,1,1.0,1,0.17273279875017714,36
2113,0,4136,1611,2525,0,0,0,1.0,1,1.0,1,1.0,1,0.1748049893563938,36
2114,0,4136,1611,2525,0,0,0,1.0,1,1.0,1,1.0,1,0.1587215221238071,36
2115,0,4136,1611,2525,0,0,0,1.0,1,1.0,1,1.0,1,0.14768236572675533,35
2116,1,4137,1612,2525,0,0,0,1.0,1,1.0,1,1.0,1,0.2234083743797268,37
2117,2,4139,1612,2527,0,0,0,1.0,1,1.0,1,1.0,1,0.14841184652663622,38
2118,4,4143,1613,2530,0,0,0,1.0,1,1.0,1,1.0,1,0.14691862297999186,40
2119,1,4144,1613,2531,0,0,0,1.0,1,1.0,1,1.0,1,0.11672430535185957,40
2120,1,4145,1614,2531,0,0,0,1.0,1,1.0,1,1.0,1,0.15177926958320337,41
2121,1,4146,1614,2532,0,0,0,1.0,1,1.0,1,1.0,1,0.12165033272732309,41
2122,2,4148,1615,2533,0,0,0,1.0,1,1.0,1,1.0,1,0.13120361625660468,42
2123,0,4148,1615,2533,0,0,0,1.0,1,1.0,1,1.0,1,0.1321132361578178,43
2124,1,4149,1615,2534,0,0,0,1.0,1,1.0,1,1.0,1,0.10993749458410597,41
2125,1,4150,1616,2534,0,0,0,1.0,1,1.0,1,1.0,1,0.1476846013939815,41
2126,0,4150,1616,2534,0,0,0,1.0,1,1.0,1,1.0,1,0.12858053297506342,40
2127,1,4151,1616,2535,0,0,0,1.0,1,1.0,1,1.0,1,0.10467450518411359,40
2128,0,4151,1616,2535,0,0,0,1.0,1,1.0,1,1.0,1,0.12726622810619695,41
2129,0,4151,1616,2535,0,0,0,1.0,1,1.0,1,1.0,1,0.13337645153454705,42
2130,1,4152,1616,2536,0,0,0,1.0,1,1.0,1,1.0,1,0.1331497784097088,45
2131,2,4154,1616,2538,0,0,0,1.0,1,1.0,1,1.0,1,0.10868573490749717,45
2132,1,4155,1616,2539,0,0,0,1.0,1,1.0,1,1.0,1,0.10394898684230244,46
2133,3,4158,1617,2541,0,0,0,1.0,1,1.0,1,1.0,1,0.08786951895645129,46
2134,2,4160,1618,2542,0,0,0,1.0,1,1.0,1,1.0,1,0.0689156923973603,47
2135,1,4161,1619,2542,0,0,0,1.0,1,1.0,1,1.0,1,0.08108048369079195,47
2136,1,4162,1620,2542,0,0,0,1.0,1,1.0,1,1.0,1,0.10676530038780742,47
2137,4,4166,1622,2544,0,0,0,1.0,1,1.0,1,1.0,1,0.08181254981021455,49
2138,0,4166,1622,2544,0,0,0,1.0,1,1.0,1,1.0,1,0.08181254981021455,49
2139,1,4167,1623,2544,0,0,0,1.0,1,1.0,1,1.0,1,0.09705766864482011,47
2140,7,4174,1625,2549,0,0,0,1.0,1,1.0,1,1.0,1,0.09308239821646401,48
2141,2,4176,1626,2550,0,0,0,1.0,1,1.0,1,1.0,1,0.0773357921052991,47
2142,2,4178,1627,2551,0,0,0,1.0,1,1.0,1,1.0,1,0.11042347543647334,47
2143,1,4179,1628,2551,0,0,0,1.0,1,1.0,1,1.0,1,0.11759152348281499,48
2144,4,4183,1631,2552,0,0,0,1.0,1,1.0,1,1.0,1,0.13947076665229205,48
2145,4,4187,1632,2555,0,0,0,1.0,1,1.0,1,1.0,1,0.15124562171199765,46
2146,4,4191,1634,2557,0,0,0,1.0,1,1.0,1,1.0,1,0.11499897745489822,47
2147,5,4196,1637,2559,0,0,0,1.0,1,1.0,1,1.0,1,0.11889510569965155,48
2148,1,4197,1637,2560,0,0,0,1.0,1,1.0,1,1.0,1,0.11525203364584832,46
2149,3,4200,1640,2560,0,0,0,1.0,1,1.0,1,1.0,1,0.1069956233693909,46
2150,1,4201,1640,2561,0,0,0,1.0,1,1.0,1,1.0,1,0.09425986841539087,46
2151,3,4204,1643,2561,0,0,0,1.0,1,1.0,1,1.0,1,0.13237701941420205,44
2152,2,4206,1644,2562,0,0,0,1.0,1,1.0,1,1.0,1,0.15011380741743002,45
2153,1,4207,1645,2562,0,0,0,1.0,1,1.0,1,1.0,1,0.1719163210369762,48
2154,4,4211,1646,2565,0,0,0,1.0,1,1.0,1,1.0,1,0.17091524497237456,47
2155,7,4218,1647,2571,0,0,0,1.0,1,1.0,1,1.0,1,0.09147477055340639,48
2156,1,4219,1648,2571,0,0,0,1.0,1,1.0,1,1.0,1,0.11960065212911769,45
2157,0,4219,1648,2571,0,0,0,1.0,1,1.0,1,1.0,1,0.136303105873525,43
2158,2,4221,1648,2573,0,0,0,1.0,1,1.0,1,1.0,1,0.09829282615221435,43
2159,3,4224,1650,2574,0,0,0,1.0,1,1.0,1,1.0,1,0.15410578765734131,43
2160,0,4224,1650,2574,0,0,0,1.0,1,1.0,1,1.0,1,0.1545259639398191,41
2161,5,4229,1650,2579,0,0,0,1.0,1,1.0,1,1.0,1,0.1245993322853581,41
2162,3,4232,1650,2582,0,0,0,1.0,1,1.0,1,1.0,1,0.10383015676036093,42
2163,2,4234,1650,2584,0,0,0,1.0,1,1.0,1,1.0,1,0.11113267778699867,43
2164,3,4237,1652,2585,0,0,0,1.0,1,1.0,1,1.0,1,0.16791028891006907,44
2165,2,4239,1652,2587,0,0,0,1.0,1,1.0,1,1.0,1,0.1270114592861921,44
2166,2,4241,1652,2589,0,0,0,1.0,1,1.0,1,1.0,1,0.09227621795739417,46
2167,1,4242,1652,2590,0,0,0,1.0,1,1.0,1,1.0,1,0.07507626329878511,46
2168,0,4242,1652,2590,0,0,0,1.0,1,1.0,1,1.0,1,0.058538436904818074,45
2169,2,4244,1653,2591,0,0,0,1.0,1,1.0,1,1.0,1,0.0649262551759048,49
2170,0,4244,1653,2591,0,0,0,1.0,1,1.0,1,1.0,1,0.0649262551759048,49
2171,1,4245,1653,2592,0,0,0,1.0,1,1.0,1,1.0,1,0.07146380856275047,51
2172,2,4247,1654,2593,0,0,0,1.0,1,1.0,1,1.0,1,0.0681119306404326,52
2173,1,4248,1655,2593,0,0,0,1.0,1,1.0,1,1.0,1,0.10342719859437954,52
2174,2,4250,1656,2594,0,0,0,1.0,1,1.0,1,1.0,1,0.08463822973854347,52
2175,2,4252,1657,2595,0,0,0,1.0,1,1.0,1,1.0,1,0.12611890458235128,53
2176,1,4253,1657,2596,0,0,0,1.0,1,1.0,1,1.0,1,0.11659584156570357,54
2177,4,4257,1659,2598,0,0,0,1.0,1,1.0,1,1.0,1,0.13166821302231999,55
2178,4,4261,1661,2600,0,0,0,1.0,1,1.0,1,1.0,1,0.12325253109549647,54
2179,4,4265,1663,2602,0,0,0,1.0,1,1.0,1,1.0,1,0.1342900474846847,52
2180,2,4267,1663,2604,0,0,0,1.0,1,1.0,1,1.0,1,0.10800943160834094,51
2181,0,4267,1663,2604,0,0,0,1.0,1,1.0,1,1.0,1,0.13846720860990797,49
2182,8,4275,1664,2611,0,0,0,1.0,1,1.0,1,1.0,1,0.12864784503853824,49
2183,5,4280,1668,2612,0,0,0,1.0,1,1.0,1,1.0,1,0.16539681429894412,46
2184,4,4284,1670,2614,0,0,0,1.0,1,1.0,1,1.0,1,0.14259483900461611,45
2185,3,4287,1671,2616,0,0,0,1.0,1,1.0,1,1.0,1,0.08334956821553015,44
2186,8,4295,1676,2619,0,0,0,1.0,1,1.0,1,1.0,1,0.15874718023023449,42
2187,6,4301,1680,2621,0,0,0,1.0,1,1.0,1,1.0,1,0.22358374818300356,40
2188,11,4312,1683,2629,0,0,0,1.0,1,1.0,1,1.0,1,0.1492917181651316,38
2189,6,4318,1684,2634,0,0,0,1.0,1,1.0,1,1.0,1,0.13299205088971278,36
2190,4,4322,1686,2636,0,0,0,1.0,1,1.0,1,1.0,1,0.1822657801722858,34
2191,4,4326,1687,2639,0,0,0,1.0,1,1.0,1,1.0,1,0.09711143167914482,34
2192,2,4328,1687,2641,0,0,0,1.0,1,1.0,1,1.0,1,0.11384445705018546,33
2193,0,4328,1687,2641,0,0,0,1.0,1,1.0,1,1.0,1,0.1390244420771333,32
2194,1,4329,1687,2642,0,0,0,1.0,1,1.0,1,1.0,1,0.1103059435617938,32
2195,0,4329,1687,2642,0,0,0,1.0,1,1.0,1,1.0,1,0.13235848568338696,31
2196,1,4330,1688,2642,0,0,0,1.0,1,1.0,1,1.0,1,0.142734164726139,32
2197,2,4332,1688,2644,0,0,0,1.0,1,1.0,1,1.0,1,0.07163343176278654,31
2198,0,4332,1688,2644,0,0,0,1.0,1,1.0,1,1.0,1,0.07163343176278654,31
2199,2,4334,1689,2645,0,0,0,1.0,1,1.0,1,1.0,1,0.09879285801851574,32
2200,1,4335,1689,2646,0,0,0,1.0,1,1.0,1,1.0,1,0.1275422745284372,35
2201,3,4338,1690,2648,0,0,0,1.0,1,1.0,1,1.0,1,0.1311461701127725,36
2202,1,4339,1691,2648,0,0,0,1.0,1,1.0,1,1.0,1,0.1397579293832709,36
2203,2,4341,1691,2650,0,0,0,1.0,1,1.0,1,1.0,1,0.10115176389599065,37
2204,1,4342,1692,2650,0,0,0,1.0,1,1.0,1,1.0,1,0.15418826057577614,36
2205,0,4342,1692,2650,0,0,0,1.0,1,1.0,1,1.0,1,0.16137411381586766,37
2206,4,4346,1693,2653,0,0,0,1.0,1,1.0,1,1.0,1,0.13876895423111973,35
2207,2,4348,1694,2654,0,0,0,1.0,1,1.0,1,1.0,1,0.18393169491647543,37
2208,2,4350,1695,2655,0,0,0,1.0,1,1.0,1,1.0,1,0.1670405823915213,36
2209,0,4350,1695,2655,0,0,0,1.0,1,1.0,1,1.0,1,0.17110174065880257,35
2210,2,4352,1695,2657,0,0,0,1.0,1,1.0,1,1.0,1,0.18871543586648254,38
2211,1,4353,1695,2658,0,0,0,1.0,1,1.0,1,1.0,1,0.17335049852587944,37
2212,1,4354,1695,2659,0,0,0,1.0,1,1.0,1,1.0,1,0.15836624648318842,38
2213,0,4354,1695,2659,0,0,0,1.0,1,1.0,1,1.0,1,0.15836624648318842,38
2214,1,4355,1695,2660,0,0,0,1.0,1,1.0,1,1.0,1,0.14102028873211794,39
2215,1,4356,1696,2660,0,0,0,1.0,1,1.0,1,1.0,1,0.13925358004215385,39
2216,2,4358,1697,2661,0,0,0,1.0,1,1.0,1,1.0,1,0.14557390538836035,39
2217,0,4358,1697,2661,0,0,0,1.0,1,1.0,1,1.0,1,0.10312519448645234,38
2218,3,4361,1699,2662,0,0,0,1.0,1,1.0,1,1.0,1,0.07126634329992924,37
2219,2,4363,1701,2662,0,0,0,1.0,1,1.0,1,1.0,1,0.11448860879937173,36
2220,1,4364,1702,2662,0,0,0,1.0,1,1.0,1,1.0,1,0.1568320587979326,34
2221,3,4367,1703,2664,0,0,0,1.0,1,1.0,1,1.0,1,0.10875438476182536,35
2222,0,4367,1703,2664,0,0,0,1.0,1,1.0,1,1.0,1,0.1167100095790696,33
2223,2,4369,1704,2665,0,0,0,1.0,1,1.0,1,1.0,1,0.1115607909740711,34
2224,2,4371,1706,2665,0,0,0,1.0,1,1.0,1,1.0,1,0.15951005261835022,32
2225,2,4373,1708,2665,0,0,0,1.0,1,1.0,1,1.0,1,0.21941391062449683,33
2226,4,4377,1710,2667,0,0,0,1.0,1,1.0,1,1.0,1,0.2611442902321612,32
2227,7,4384,1711,2673,0,0,0,1.0,1,1.0,1,1.0,1,0.19739333245817484,31
2228,4,4388,1711,2677,0,0,0,1.0,1,1.0,1,1.0,1,0.22017755569039754,32
2229,3,4391,1711,2680,0,0,0,1.0,1,1.0,1,1.0,1,0.15845255249039725,32
2230,2,4393,1711,2682,0,0,0,1.0,1,1.0,1,1.0,1,0.15249019808623349,31
2231,0,4393,1711,2682,0,0,0,1.0,1,1.0,1,1.0,1,0.12923715567236566,32
2232,0,4393,1711,2682,0,0,0,1.0,1,1.0,1,1.0,1,0.1444774590015002,32
2233,2,4395,1711,2684,0,0,0,1.0,1,1.0,1,1.0,1,0.10691341772556678,31
2234,2,4397,1713,2684,0,0,0,1.0,1,1.0,1,1.0,1,0.2043613091916241,32
2235,2,4399,1714,2685,0,0,0,1.0,1,1.0,1,1.0,1,0.19078356886444695,31
2236,2,4401,1714,2687,0,0,0,1.0,1,1.0,1,1.0,1,0.14280588093766405,31
2237,3,4404,1716,2688,0,0,0,1.0,1,1.0,1,1.0,1,0.15902978750218652,31
2238,2,4406,1717,2689,0,0,0,1.0,1,1.0,1,1.0,1,0.18925848550237576,31
2239,2,4408,1717,2691,0,0,0,1.0,1,1.0,1,1.0,1,0.13285441133080747,31
2240,0,4408,1717,2691,0,0,0,1.0,1,1.0,1,1.0,1,0.1526083344018464,32
2241,2,4410,1718,2692,0,0,0,1.0,1,1.0,1,1.0,1,0.14911401189509893,32
2242,1,4411,1718,2693,0,0,0,1.0,1,1.0,1,1.0,1,0.10318420289149491,34
2243,3,4414,1720,2694,0,0,0,1.0,1,1.0,1,1.0,1,0.1467378247584359,34
2244,1,4415,1720,2695,0,0,0,1.0,1,1.0,1,1.0,1,0.1441195860364587,36
2245,3,4418,1721,2697,0,0,0,1.0,1,1.0,1,1.0,1,0.13583662420006867,36
2246,0,4418,1721,2697,0,0,0,1.0,1,1.0,1,1.0,1,0.13849376803333366,39
2247,1,4419,1721,2698,0,0,0,1.0,1,1.0,1,1.0,1,0.1452781794647489,40
2248,0,4419,1721,2698,0,0,0,1.0,1,1.0,1,1.0,1,0.1452781794647489,40
2249,0,4419,1721,2698,0,0,0,1.0,1,1.0,1,1.0,1,0.1379068197057875,41
2250,0,4419,1721,2698,0,0,0,1.0,1,1.0,1,1.0,1,0.1379068197057875,41
2251,0,4419,1721,2698,0,0,0,1.0,1,1.0,1,1.0,1,0.15873750749907037,42
2252,5,4424,1722,2702,0,0,0,1.0,1,1.0,1,1.0,1,0.1553590323594217,41
2253,0,4424,1722,2702,0,0,0,1.0,1,1.0,1,1.0,1,0.14062813436908336,40
2254,0,4424,1722,2702,0,0,0,1.0,1,1.0,1,1.0,1,0.16124531953454832,39
2255,2,4426,1722,2704,0,0,0,1.0,1,1.0,1,1.0,1,0.17972121769843633,39
2256,3,4429,1724,2705,0,0,0,1.0,1,1.0,1,1.0,1,0.22568149688177944,40
2257,4,4433,1725,2708,0,0,0,1.0,1,1.0,1,1.0,1,0.19840528374305694,40
2258,1,4434,1726,2708,0,0,0,1.0,1,1.0,1,1.0,1,0.20079649518205495,39
2259,2,4436,1728,2708,0,0,0,1.0,1,1.0,1,1.0,1,0.19561161282841635,41
2260,4,4440,1728,2712,0,0,0,1.0,1,1.0,1,1.0,1,0.09807379120991017,38
2261,1,4441,1729,2712,0,0,0,1.0,1,1.0,1,1.0,1,0.10978115756196351,38
2262,1,4442,1730,2712,0,0,0,1.0,1,1.0,1,1.0,1,0.19412936811158257,36
2263,5,4447,1734,2713,0,0,0,1.0,1,1.0,1,1.0,1,0.1873783921363847,35
2264,4,4451,1737,2714,0,0,0,1.0,1,1.0,1,1.0,1,0.20615696538782274,33
2265,1,4452,1738,2714,0,0,0,1.0,1,1.0,1,1.0,1,0.20589866187741374,33
2266,3,4455,1739,2716,0,0,0,1.0,1,1.0,1,1.0,1,0.14890888873828387,33
2267,5,4460,1743,2717,0,0,0,1.0,1,1.0,1,1.0,1,0.16690046144099402,33
2268,4,4464,1744,2720,0,0,0,1.0,1,1.0,1,1.0,1,0.10664472599318206,35
2269,1,4465,1745,2720,0,0,0,1.0,1,1.0,1,1.0,1,0.125471537122856,36
2270,1,4466,1746,2720,0,0,0,1.0,1,1.0,1,1.0,1,0.16510006753005424,34
2271,6,4472,1750,2722,0,0,0,1.0,1,1.0,1,1.0,1,0.15082239116082738,34
2272,6,4478,1752,2726,0,0,0,1.0,1,1.0,1,1.0,1,0.08130690396810546,33
2273,0,4478,1752,2726,0,0,0,1.0,1,1.0,1,1.0,1,0.09770815544207342,32
2274,0,4478,1752,2726,0,0,0,1.0,1,1.0,1,1.0,1,0.09770815544207342,32
2275,1,4479,1753,2726,0,0,0,1.0,1,1.0,1,1.0,1,0.1721498970476301,32
2276,2,4481,1754,2727,0,0,0,1.0,1,1.0,1,1.0,1,0.21179058183795663,31
2277,1,4482,1755,2727,0,0,0,1.0,1,1.0,1,1.0,1,0.22320699587105647,30
2278,2,4484,1755,2729,0,0,0,1.0,1,1.0,1,1.0,1,0.15024507552276337,33
2279,1,4485,1755,2730,0,0,0,1.0,1,1.0,1,1.0,1,0.1515676751513766,33
2280,1,4486,1755,2731,0,0,0,1.0,1,1.0,1,1.0,1,0.14258899448596704,35
2281,2,4488,1755,2733,0,0,0,1.0,1,1.0,1,1.0,1,0.12009983813002789,36
2282,0,4488,1755,2733,0,0,0,1.0,1,1.0,1,1.0,1,0.12009983813002789,36
2283,0,4488,1755,2733,0,0,0,1.0,1,1.0,1,1.0,1,0.12009983813002789,36
2284,1,4489,1756,2733,0,0,0,1.0,1,1.0,1,1.0,1,0.1340114301189359,36
2285,0,4489,1756,2733,0,0,0,1.0,1,1.0,1,1.0,1,0.12666945840130064,37
2286,1,4490,1757,2733,0,0,0,1.0,1,1.0,1,1.0,1,0.14933822615965195,38
2287,3,4493,1757,2736,0,0,0,1.0,1,1.0,1,1.0,1,0.09752893399845206,38
2288,2,4495,1759,2736,0,0,0,1.0,1,1.0,1,1.0,1,0.15089782658697443,40
2289,1,4496,1759,2737,0,0,0,1.0,1,1.0,1,1.0,1,0.14789612126769391,40
2290,3,4499,1759,2740,0,0,0,1.0,1,1.0,1,1.0,1,0.09526586426781,39
2291,0,4499,1759,2740,0,0,0,1.0,1,1.0,1,1.0,1,0.07204950766929218,37
2292,2,4501,1761,2740,0,0,0,1.0,1,1.0,1,1.0,1,0.09295940922343764,35
2293,1,4502,1762,2740,0,0,0,1.0,1,1.0,1,1.0,1,0.1276315924408122,35
2294,0,4502,1762,2740,0,0,0,1.0,1,1.0,1,1.0,1,0.10044728011712518,35
2295,0,4502,1762,2740,0,0,0,1.0,1,1.0,1,1.0,1,0.10695801830977959,36
2296,0,4502,1762,2740,0,0,0,1.0,1,1.0,1,1.0,1,0.10992643561079496,34
2297,1,4503,1762,2741,0,0,0,1.0,1,1.0,1,1.0,1,0.11771657915455984,35
2298,0,4503,1762,2741,0,0,0,1.0,1,1.0,1,1.0,1,0.1260946960857979,34
2299,2,4505,1764,2741,0,0,0,1.0,1,1.0,1,1.0,1,0.1681840269169426,35
2300,0,4505,1764,2741,0,0,0,1.0,1,1.0,1,1.0,1,0.1681840269169426,35
2301,0,4505,1764,2741,0,0,0,1.0,1,1.0,1,1.0,1,0.1681840269169426,35
2302,3,4508,1767,2741,0,0,0,1.0,1,1.0,1,1.0,1,0.2296039340652194,37
2303,0,4508,1767,2741,0,0,0,1.0,1,1.0,1,1.0,1,0.18214357385860502,35
2304,5,4513,1770,2743,0,0,0,1.0,1,1.0,1,1.0,1,0.2606852666751394,36
2305,2,4515,1770,2745,0,0,0,1.0,1,1.0,1,1.0,1,0.2039303083478266,34
2306,3,4518,1770,2748,0,0,0,1.0,1,1.0,1,1.0,1,0.15832471453762037,35
2307,1,4519,1770,2749,0,0,0,1.0,1,1.0,1,1.0,1,0.18213333260086523,35
2308,1,4520,1770,2750,0,0,0,1.0,1,1.0,1,1.0,1,0.13333299802478157,35
2309,0,4520,1770,2750,0,0,0,1.0,1,1.0,1,1.0,1,0.13350897822731167,34
2310,0,4520,1770,2750,0,0,0,1.0,1,1.0,1,1.0,1,0.1328288067042422,36
2311,1,4521,1770,2751,0,0,0,1.0,1,1.0,1,1.0,1,0.11620745505613746,38
2312,2,4523,1772,2751,0,0,0,1.0,1,1.0,1,1.0,1,0.1780427880973028,39
2313,1,4524,1772,2752,0,0,0,1.0,1,1.0,1,1.0,1,0.15029252999759143,39
2314,4,4528,1773,2755,0,0,0,1.0,1,1.0,1,1.0,1,0.10973002224832072,39
2315,3,4531,1775,2756,0,0,0,1.0,1,1.0,1,1.0,1,0.1523950014965956,40
2316,5,4536,1776,2760,0,0,0,1.0,1,1.0,1,1.0,1,0.15579146863329071,40
2317,2,4538,1776,2762,0,0,0,1.0,1,1.0,1,1.0,1,0.12033502871172282,41
2318,1,4539,1777,2762,0,0,0,1.0,1,1.0,1,1.0,1,0.12318259602719103,41
2319,0,4539,1777,2762,0,0,0,1.0,1,1.0,1,1.0,1,0.12318259602719103,41
2320,2,4541,1778,2763,0,0,0,1.0,1,1.0,1,1.0,1,0.14671449109673168,42
2321,1,4542,1778,2764,0,0,0,1.0,1,1.0,1,1.0,1,0.11597101737400241,43
2322,1,4543,1779,2764,0,0,0,1.0,1,1.0,1,1.0,1,0.14930328952482064,42
2323,2,4545,1779,2766,0,0,0,1.0,1,1.0,1,1.0,1,0.13506535023849517,43
2324,4,4549,1780,2769,0,0,0,1.0,1,1.0,1,1.0,1,0.10712384268610808,44
2325,3,4552,1781,2771,0,0,0,1.0,1,1.0,1,1.0,1,0.1175954865688678,44
2326,0,4552,1781,2771,0,0,0,1.0,1,1.0,1,1.0,1,0.11909410340090186,45
2327,0,4552,1781,2771,0,0,0,1.0,1,1.0,1,1.0,1,0.11909410340090186,45
2328,2,4554,1782,2772,0,0,0,1.0,1,1.0,1,1.0,1,0.14344319258195734,46
2329,0,4554,1782,2772,0,0,0,1.0,1,1.0,1,1.0,1,0.15490535628637858,45
2330,4,4558,1784,2774,0,0,0,1.0,1,1.0,1,1.0,1,0.12926482906402456,47
2331,2,4560,1785,2775,0,0,0,1.0,1,1.0,1,1.0,1,0.14979756579138448,48
2332,2,4562,1785,2777,0,0,0,1.0,1,1.0,1,1.0,1,0.1273609668521454,48
2333,3,4565,1785,2780,0,0,0,1.0,1,1.0,1,1.0,1,0.13212668149486895,49
2334,0,4565,1785,2780,0,0,0,1.0,1,1.0,1,1.0,1,0.13449415391506847,47
2335,3,4568,1786,2782,0,0,0,1.0,1,1.0,1,1.0,1,0.12713486180951075,46
2336,1,4569,1786,2783,0,0,0,1.0,1,1.0,1,1.0,1,0.14270022353803244,46
2337,2,4571,1786,2785,0,0,0,1.0,1,1.0,1,1.0,1,0.10954002388446325,45
2338,2,4573,1786,2787,0,0,0,1.0,1,1.0,1,1.0,1,0.11088817286797721,44
2339,2,4575,1787,2788,0,0,0,1.0,1,1.0,1,1.0,1,0.08870667924724526,45
2340,4,4579,1787,2792,0,0,0,1.0,1,1.0,1,1.0,1,0.08174343615867094,44
2341,1,4580,1787,2793,0,0,0,1.0,1,1.0,1,1.0,1,0.08128475161633376,45
2342,2,4582,1789,2793,0,0,0,1.0,1,1.0,1,1.0,1,0.08761819613549102,47
2343,2,4584,1790,2794,0,0,0,1.0,1,1.0,1,1.0,1,0.08747081863517087,46
2344,1,4585,1790,2795,0,0,0,1.0,1,1.0,1,1.0,1,0.08996010724819939,46
2345,0,4585,1790,2795,0,0,0,1.0,1,1.0,1,1.0,1,0.10486778692921823,45
2346,0,4585,1790,2795,0,0,0,1.0,1,1.0,1,1.0,1,0.0913154339223872,46
2347,0,4585,1790,2795,0,0,0,1.0,1,1.0,1,1.0,1,0.08940935060382936,47
2348,3,4588,1792,2796,0,0,0,1.0,1,1.0,1,1.0,1,0.10298325394331322,49
2349,1,4589,1793,2796,0,0,0,1.0,1,1.0,1,1.0,1,0.13972643499274226,49
2350,4,4593,1793,2800,0,0,0,1.0,1,1.0,1,1.0,1,0.11518468483030862,50
2351,1,4594,1794,2800,0,0,0,1.0,1,1.0,1,1.0,1,0.11463958771022034,50
2352,2,4596,1794,2802,0,0,0,1.0,1,1.0,1,1.0,1,0.10241618639363763,51
2353,1,4597,1794,2803,0,0,0,1.0,1,1.0,1,1.0,1,0.08952086289612311,51
2354,0,4597,1794,2803,0,0,0,1.0,1,1.0,1,1.0,1,0.08544496585663965,51
2355,1,4598,1795,2803,0,0,0,1.0,1,1.0,1,1.0,1,0.09772520227173519,50
2356,2,4600,1795,2805,0,0,0,1.0,1,1.0,1,1.0,1,0.06647414622384672,50
2357,1,4601,1796,2805,0,0,0,1.0,1,1.0,1,1.0,1,0.10190586136125085,49
2358,0,4601,1796,2805,0,0,0,1.0,1,1.0,1,1.0,1,0.11549936962502802,51
2359,1,4602,1796,2806,0,0,0,1.0,1,1.0,1,1.0,1,0.06980005474933582,51
2360,3,4605,1799,2806,0,0,0,1.0,1,1.0,1,1.0,1,0.10437630608323831,51
2361,1,4606,1800,2806,0,0,0,1.0,1,1.0,1,1.0,1,0.13564952076735176,52
2362,4,4610,1801,2809,0,0,0,1.0,1,1.0,1,1.0,1,0.12515645623740554,53
2363,3,4613,1803,2810,0,0,0,1.0,1,1.0,1,1.0,1,0.10080191171801497,54
2364,4,4617,1805,2812,0,0,0,1.0,1,1.0,1,1.0,1,0.12058568303158794,55
2365,4,4621,1807,2814,0,0,0,1.0,1,1.0,1,1.0,1,0.10934922749564689,53
2366,4,4625,1809,2816,0,0,0,1.0,1,1.0,1,1.0,1,0.1203984565684254,53
2367,4,4629,1812,2817,0,0,0,1.0,1,1.0,1,1.0,1,0.19918235320595487,51
2368,4,4633,1813,2820,0,0,0,1.0,1,1.0,1,1.0,1,0.1557611821022502,50
2369,2,4635,1815,2820,0,0,0,1.0,1,1.0,1,1.0,1,0.17859700799383293,47
2370,0,4635,1815,2820,0,0,0,1.0,1,1.0,1,1.0,1,0.18829410103791014,48
2371,3,4638,1816,2822,0,0,0,1.0,1,1.0,1,1.0,1,0.18305605739293718,49
2372,0,4638,1816,2822,0,0,0,1.0,1,1.0,1,1.0,1,0.19091102558527842,48
2373,0,4638,1816,2822,0,0,0,1.0,1,1.0,1,1.0,1,0.19705664815531496,49
2374,0,4638,1816,2822,0,0,0,1.0,1,1.0,1,1.0,1,0.1888191733518377,50
2375,2,4640,1817,2823,0,0,0,1.0,1,1.0,1,1.0,1,0.1924846255884877,50
2376,2,4642,1817,2825,0,0,0,1.0,1,1.0,1,1.0,1,0.16451932723594037,50
2377,0,4642,1817,2825,0,0,0,1.0,1,1.0,1,1.0,1,0.16677125974281548,49
2378,1,4643,1817,2826,0,0,0,1.0,1,1.0,1,1.0,1,0.15454167210294026,49
2379,2,4645,1819,2826,0,0,0,1.0,1,1.0,1,1.0,1,0.17452401720766172,50
2380,1,4646,1820,2826,0,0,0,1.0,1,1.0,1,1.0,1,0.19196272727145866,50
2381,3,4649,1821,2828,0,0,0,1.0,1,1.0,1,1.0,1,0.19126856842433082,51
2382,4,4653,1822,2831,0,0,0,1.0,1,1.0,1,1.0,1,0.18666665832316856,51
2383,5,4658,1823,2835,0,0,0,1.0,1,1.0,1,1.0,1,0.1612539450401352,52
2384,4,4662,1824,2838,0,0,0,1.0,1,1.0,1,1.0,1,0.12473127684788568,52
2385,1,4663,1825,2838,0,0,0,1.0,1,1.0,1,1.0,1,0.1617823643629465,51
2386,3,4666,1826,2840,0,0,0,1.0,1,1.0,1,1.0,1,0.14766166823048768,52
2387,2,4668,1827,2841,0,0,0,1.0,1,1.0,1,1.0,1,0.18233071041974597,49
2388,2,4670,1828,2842,0,0,0,1.0,1,1.0,1,1.0,1,0.17743992023979444,48
2389,5,4675,1831,2844,0,0,0,1.0,1,1.0,1,1.0,1,0.1761485311269213,48
2390,3,4678,1832,2846,0,0,0,1.0,1,1.0,1,1.0,1,0.16587688672441547,49
2391,7,4685,1836,2849,0,0,0,1.0,1,1.0,1,1.0,1,0.19673125925572651,48
2392,7,4692,1838,2854,0,0,0,1.0,1,1.0,1,1.0,1,0.15146932322246107,49
2393,3,4695,1839,2856,0,0,0,1.0,1,1.0,1,1.0,1,0.1552788033495048,50
2394,3,4698,1841,2857,0,0,0,1.0,1,1.0,1,1.0,1,0.1484192437490674,50
2395,1,4699,1841,2858,0,0,0,1.0,1,1.0,1,1.0,1,0.13388269496354155,49
2396,1,4700,1841,2859,0,0,0,1.0,1,1.0,1,1.0,1,0.1189434002118317,50
2397,1,4701,1842,2859,0,0,0,1.0,1,1.0,1,1.0,1,0.15512911094673346,51
2398,2,4703,1844,2859,0,0,0,1.0,1,1.0,1,1.0,1,0.17354047032454817,49
2399,1,4704,1844,2860,0,0,0,1.0,1,1.0,1,1.0,1,0.15786546907457516,50
2400,2,4706,1845,2861,0,0,0,1.0,1,1.0,1,1.0,1,0.17883996961922818,51
2401,2,4708,1845,2863,0,0,0,1.0,1,1.0,1,1.0,1,0.14804822580932153,50
2402,1,4709,1845,2864,0,0,0,1.0,1,1.0,1,1.0,1,0.13640938304221928,51
2403,0,4709,1845,2864,0,0,0,1.0,1,1.0,1,1.0,1,0.1400173599340832,52
2404,3,4712,1845,2867,0,0,0,1.0,1,1.0,1,1.0,1,0.09732683023571662,53
2405,0,4712,1845,2867,0,0,0,1.0,1,1.0,1,1.0,1,0.10986763964125812,52
2406,1,4713,1846,2867,0,0,0,1.0,1,1.0,1,1.0,1,0.11331057081961637,52
2407,2,4715,1846,2869,0,0,0,1.0,1,1.0,1,1.0,1,0.13596270458062987,51
2408,0,4715,1846,2869,0,0,0,1.0,1,1.0,1,1.0,1,0.15495783669255503,50
2409,3,4718,1846,2872,0,0,0,1.0,1,1.0,1,1.0,1,0.16576055630414743,50
2410,1,4719,1847,2872,0,0,0,1.0,1,1.0,1,1.0,1,0.1927966292375362,49
2411,1,4720,1847,2873,0,0,0,1.0,1,1.0,1,1.0,1,0.1844665417980706,48
2412,0,4720,1847,2873,0,0,0,1.0,1,1.0,1,1.0,1,0.20923202913108493,47
2413,2,4722,1847,2875,0,0,0,1.0,1,1.0,1,1.0,1,0.17526516153959726,47
2414,5,4727,1848,2879,0,0,0,1.0,1,1.0,1,1.0,1,0.2294410541534263,47
2415,2,4729,1848,2881,0,0,0,1.0,1,1.0,1,1.0,1,0.22516721323866276,46
2416,4,4733,1848,2885,0,0,0,1.0,1,1.0,1,1.0,1,0.1634274211825171,47
2417,2,4735,1849,2886,0,0,0,1.0,1,1.0,1,1.0,1,0.1696262457339283,46
2418,1,4736,1849,2887,0,0,0,1.0,1,1.0,1,1.0,1,0.16538850316670453,48
2419,0,4736,1849,2887,0,0,0,1.0,1,1.0,1,1.0,1,0.17657182375839173,47
2420,1,4737,1849,2888,0,0,0,1.0,1,1.0,1,1.0,1,0.15708226076713105,49
2421,1,4738,1849,2889,0,0,0,1.0,1,1.0,1,1.0,1,0.1392425355878384,50
2422,3,4741,1851,2890,0,0,0,1.0,1,1.0,1,1.0,1,0.1272845936468691,50
2423,0,4741,1851,2890,0,0,0,1.0,1,1.0,1,1.0,1,0.13821493499484722,51
2424,5,4746,1855,2891,0,0,0,1.0,1,1.0,1,1.0,1,0.12731859002970025,50
2425,1,4747,1855,2892,0,0,0,1.0,1,1.0,1,1.0,1,0.1288485128968561,48
2426,6,4753,1859,2894,0,0,0,1.0,1,1.0,1,1.0,1,0.14639637711422746,51
2427,1,4754,1860,2894,0,0,0,1.0,1,1.0,1,1.0,1,0.1657322314519411,50
2428,3,4757,1861,2896,0,0,0,1.0,1,1.0,1,1.0,1,0.13705089001512855,49
2429,4,4761,1863,2898,0,0,0,1.0,1,1.0,1,1.0,1,0.16075066657703618,49
2430,0,4761,1863,2898,0,0,0,1.0,1,1.0,1,1.0,1,0.19422937008087066,46
2431,4,4765,1864,2901,0,0,0,1.0,1,1.0,1,1.0,1,0.15686771582056688,45
2432,4,4769,1865,2904,0,0,0,1.0,1,1.0,1,1.0,1,0.2069178252480783,44
2433,2,4771,1866,2905,0,0,0,1.0,1,1.0,1,1.0,1,0.16543456708112206,45
2434,1,4772,1866,2906,0,0,0,1.0,1,1.0,1,1.0,1,0.15111560851460373,44
2435,0,4772,1866,2906,0,0,0,1.0,1,1.0,1,1.0,1,0.15111560851460373,44
2436,0,4772,1866,2906,0,0,0,1.0,1,1.0,1,1.0,1,0.15111560851460373,44
2437,2,4774,1868,2906,0,0,0,1.0,1,1.0,1,1.0,1,0.14304262922144875,45
2438,1,4775,1869,2906,0,0,0,1.0,1,1.0,1,1.0,1,0.16077428031976557,45
2439,2,4777,1869,2908,0,0,0,1.0,1,1.0,1,1.0,1,0.15818713748808355,46
2440,2,4779,1869,2910,0,0,0,1.0,1,1.0,1,1.0,1,0.10718603000745248,45
2441,0,4779,1869,2910,0,0,0,1.0,1,1.0,1,1.0,1,0.10718603000745248,45
2442,0,4779,1869,2910,0,0,0,1.0,1,1.0,1,1.0,1,0.10209937143841302,46
2443,2,4781,1869,2912,0,0,0,1.0,1,1.0,1,1.0,1,0.08559581948447105,45
2444,6,4787,1872,2915,0,0,0,1.0,1,1.0,1,1.0,1,0.16913178203316512,46
2445,2,4789,1873,2916,0,0,0,1.0,1,1.0,1,1.0,1,0.17364436736189168,44
2446,8,4797,1878,2919,0,0,0,1.0,1,1.0,1,1.0,1,0.13565338425889287,44
2447,3,4800,1878,2922,0,0,0,1.0,1,1.0,1,1.0,1,0.1390915623667029,42
2448,3,4803,1881,2922,0,0,0,1.0,1,1.0,1,1.0,1,0.16657291759321732,41
2449,3,4806,1882,2924,0,0,0,1.0,1,1.0,1,1.0,1,0.1519025282732911,40
2450,6,4812,1885,2927,0,0,0,1.0,1,1.0,1,1.0,1,0.20168334204958874,42
2451,2,4814,1885,2929,0,0,0,1.0,1,1.0,1,1.0,1,0.1510278572264981,43
2452,0,4814,1885,2929,0,0,0,1.0,1,1.0,1,1.0,1,0.1510278572264981,43
2453,1,4815,1885,2930,0,0,0,1.0,1,1.0,1,1.0,1,0.16335370227677204,45
2454,2,4817,1887,2930,0,0,0,1.0,1,1.0,1,1.0,1,0.21342562541717858,47
2455,1,4818,1887,2931,0,0,0,1.0,1,1.0,1,1.0,1,0.1967447510265057,48
2456,3,4821,1888,2933,0,0,0,1.0,1,1.0,1,1.0,1,0.2168684748991276,49
2457,1,4822,1889,2933,0,0,0,1.0,1,1.0,1,1.0,1,0.2549366111169869,48
2458,4,4826,1890,2936,0,0,0,1.0,1,1.0,1,1.0,1,0.22597887253464355,49
2459,2,4828,1890,2938,0,0,0,1.0,1,1.0,1,1.0,1,0.19944521705229235,49
2460,2,4830,1891,2939,0,0,0,1.0,1,1.0,1,1.0,1,0.19484615177741763,50
2461,4,4834,1891,2943,0,0,0,1.0,1,1.0,1,1.0,1,0.1639950431318445,50
2462,2,4836,1892,2944,0,0,0,1.0,1,1.0,1,1.0,1,0.17521602582231385,51
2463,4,4840,1894,2946,0,0,0,1.0,1,1.0,1,1.0,1,0.21641127177128844,51
2464,10,4850,1899,2951,0,0,0,1.0,1,1.0,1,1.0,1,0.2082679880760574,50
2465,5,4855,1899,2956,0,0,0,1.0,1,1.0,1,1.0,1,0.19982439752477454,49
2466,2,4857,1900,2957,0,0,0,1.0,1,1.0,1,1.0,1,0.1963679618157709,49
2467,2,4859,1900,2959,0,0,0,1.0,1,1.0,1,1.0,1,0.15421556056367092,48
2468,0,4859,1900,2959,0,0,0,1.0,1,1.0,1,1.0,1,0.1761042328171308,47
2469,3,4862,1901,2961,0,0,0,1.0,1,1.0,1,1.0,1,0.12319588518802604,46
2470,2,4864,1901,2963,0,0,0,1.0,1,1.0,1,1.0,1,0.12019309858663456,44
2471,2,4866,1902,2964,0,0,0,1.0,1,1.0,1,1.0,1,0.09669320805853451,44
2472,2,4868,1902,2966,0,0,0,1.0,1,1.0,1,1.0,1,0.09710871402906536,44
2473,2,4870,1903,2967,0,0,0,1.0,1,1.0,1,1.0,1,0.08372185576412587,43
2474,1,4871,1904,2967,0,0,0,1.0,1,1.0,1,1.0,1,0.1288976976260086,44
2475,2,4873,1905,2968,0,0,0,1.0,1,1.0,1,1.0,1,0.11346486087147505,46
2476,1,4874,1906,2968,0,0,0,1.0,1,1.0,1,1.0,1,0.11112993015794193,46
2477,2,4876,1906,2970,0,0,0,1.0,1,1.0,1,1.0,1,0.08620151652908449,46
2478,2,4878,1907,2971,0,0,0,1.0,1,1.0,1,1.0,1,0.05898073520484779,46
2479,0,4878,1907,2971,0,0,0,1.0,1,1.0,1,1.0,1,0.05898073520484779,46
2480,3,4881,1909,2972,0,0,0,1.0,1,1.0,1,1.0,1,0.10430401450939754,47
2481,4,4885,1911,2974,0,0,0,1.0,1,1.0,1,1.0,1,0.11955932082930752,47
2482,4,4889,1912,2977,0,0,0,1.0,1,1.0,1,1.0,1,0.11147272313621116,45
2483,1,4890,1912,2978,0,0,0,1.0,1,1.0,1,1.0,1,0.14359295783138623,45
2484,3,4893,1913,2980,0,0,0,1.0,1,1.0,1,1.0,1,0.1309081193581248,46
2485,1,4894,1913,2981,0,0,0,1.0,1,1.0,1,1.0,1,0.1438409656126021,44
2486,0,4894,1913,2981,0,0,0,1.0,1,1.0,1,1.0,1,0.1712987607548126,43
2487,1,4895,1914,2981,0,0,0,1.0,1,1.0,1,1.0,1,0.17875655291505962,44
2488,3,4898,1915,2983,0,0,0,1.0,1,1.0,1,1.0,1,0.13042666530363373,45
2489,4,4902,1916,2986,0,0,0,1.0,1,1.0,1,1.0,1,0.14549570704881265,44
2490,2,4904,1917,2987,0,0,0,1.0,1,1.0,1,1.0,1,0.15509688214710823,44
2491,3,4907,1917,2990,0,0,0,1.0,1,1.0,1,1.0,1,0.12713752902231396,44
2492,1,4908,1918,2990,0,0,0,1.0,1,1.0,1,1.0,1,0.15840743405024696,44
2493,0,4908,1918,2990,0,0,0,1.0,1,1.0,1,1.0,1,0.21119953683962606,42
2494,3,4911,1919,2992,0,0,0,1.0,1,1.0,1,1.0,1,0.21318364296235184,42
2495,3,4914,1920,2994,0,0,0,1.0,1,1.0,1,1.0,1,0.20996500065343116,42
2496,2,4916,1921,2995,0,0,0,1.0,1,1.0,1,1.0,1,0.21025146891462657,42
2497,2,4918,1921,2997,0,0,0,1.0,1,1.0,1,1.0,1,0.18649732800581342,44
2498,1,4919,1921,2998,0,0,0,1.0,1,1.0,1,1.0,1,0.17854889766274107,43
2499,1,4920,1921,2999,0,0,0,1.0,1,1.0,1,1.0,1,0.15892887193137212,43
2500,1,4921,1921,3000,0,0,0,1.0,1,1.0,1,1.0,1,0.14676828832188127,44
2501,1,4922,1921,3001,0,0,0,1.0,1,1.0,1,1.0,1,0.1462871668876663,46
2502,2,4924,1921,3003,0,0,0,1.0,1,1.0,1,1.0,1,0.13035127353747564,47
2503,3,4927,1923,3004,0,0,0,1.0,1,1.0,1,1.0,1,0.14961479908001069,47
2504,0,4927,1923,3004,0,0,0,1.0,1,1.0,1,1.0,1,0.14651283724466355,46
2505,5,4932,1928,3004,0,0,0,1.0,1,1.0,1,1.0,1,0.20807309969608778,46
2506,6,4938,1930,3008,0,0,0,1.0,1,1.0,1,1.0,1,0.14829666503368538,45
2507,4,4942,1931,3011,0,0,0,1.0,1,1.0,1,1.0,1,0.15496613539502754,45
2508,4,4946,1931,3015,0,0,0,1.0,1,1.0,1,1.0,1,0.14376542330127212,46
2509,3,4949,1931,3018,0,0,0,1.0,1,1.0,1,1.0,1,0.11340578267823798,45
2510,3,4952,1931,3021,0,0,0,1.0,1,1.0,1,1.0,1,0.12436022901727414,46
2511,1,4953,1932,3021,0,0,0,1.0,1,1.0,1,1.0,1,0.12478160371595456,47
2512,2,4955,1934,3021,0,0,0,1.0,1,1.0,1,1.0,1,0.16573182419862637,47
2513,4,4959,1935,3024,0,0,0,1.0,1,1.0,1,1.0,1,0.14303057299516236,48
2514,1,4960,1936,3024,0,0,0,1.0,1,1.0,1,1.0,1,0.1490276410415906,48
2515,5,4965,1936,3029,0,0,0,1.0,1,1.0,1,1.0,1,0.10800875928487427,49
2516,2,4967,1937,3030,0,0,0,1.0,1,1.0,1,1.0,1,0.11242220758472779,49
2517,3,4970,1939,3031,0,0,0,1.0,1,1.0,1,1.0,1,0.12216537101957596,49
2518,4,4974,1941,3033,0,0,0,1.0,1,1.0,1,1.0,1,0.10816853765925831,48
2519,0,4974,1941,3033,0,0,0,1.0,1,1.0,1,1.0,1,0.10423115794986759,48
2520,2,4976,1942,3034,0,0,0,1.0,1,1.0,1,1.0,1,0.13602499705753654,46
2521,4,4980,1944,3036,0,0,0,1.0,1,1.0,1,1.0,1,0.1854822380526186,47
2522,1,4981,1945,3036,0,0,0,1.0,1,1.0,1,1.0,1,0.22265203566592734,45
2523,2,4983,1947,3036,0,0,0,1.0,1,1.0,1,1.0,1,0.2751719534226438,44
2524,1,4984,1947,3037,0,0,0,1.0,1,1.0,1,1.0,1,0.2375192088598209,42
2525,6,4990,1948,3042,0,0,0,1.0,1,1.0,1,1.0,1,0.20400961484227687,42
2526,0,4990,1948,3042,0,0,0,1.0,1,1.0,1,1.0,1,0.20370814928236972,41
2527,1,4991,1949,3042,0,0,0,1.0,1,1.0,1,1.0,1,0.2134365824666077,41
2528,0,4991,1949,3042,0,0,0,1.0,1,1.0,1,1.0,1,0.23684567606443646,41
2529,4,4995,1950,3045,0,0,0,1.0,1,1.0,1,1.0,1,0.19572524614785058,42
2530,1,4996,1950,3046,0,0,0,1.0,1,1.0,1,1.0,1,0.17070596391633686,41
2531,1,4997,1950,3047,0,0,0,1.0,1,1.0,1,1.0,1,0.16679668036790174,41
2532,0,4997,1950,3047,0,0,0,1.0,1,1.0,1,1.0,1,0.19430977699365964,43
2533,0,4997,1950,3047,0,0,0,1.0,1,1.0,1,1.0,1,0.19430977699365964,43
2534,0,4997,1950,3047,0,0,0,1.0,1,1.0,1,1.0,1,0.19430977699365964,43
2535,1,4998,1950,3048,0,0,0,1.0,1,1.0,1,1.0,1,0.19728463069924418,44
2536,0,4998,1950,3048,0,0,0,1.0,1,1.0,1,1.0,1,0.19728463069924418,44
2537,1,4999,1950,3049,0,0,0,1.0,1,1.0,1,1.0,1,0.1984451426078321,45
2538,3,5002,1950,3052,0,0,0,1.0,1,1.0,1,1.0,1,0.19362026815323677,48
2539,2,5004,1952,3052,0,0,0,1.0,1,1.0,1,1.0,1,0.20313105159715406,48
2540,3,5007,1953,3054,0,0,0,1.0,1,1.0,1,1.0,1,0.20845507240778421,50
2541,4,5011,1954,3057,0,0,0,1.0,1,1.0,1,1.0,1,0.21019625048702043,52
2542,7,5018,1957,3061,0,0,0,1.0,1,1.0,1,1.0,1,0.219189975783424,52
2543,5,5023,1960,3063,0,0,0,1.0,1,1.0,1,1.0,1,0.2109400395091843,51
2544,6,5029,1964,3065,0,0,0,1.0,1,1.0,1,1.0,1,0.24373336871392953,51
2545,5,5034,1964,3070,0,0,0,1.0,1,1.0,1,1.0,1,0.1807072172163688,50
2546,2,5036,1965,3071,0,0,0,1.0,1,1.0,1,1.0,1,0.17844649799909174,50
2547,0,5036,1965,3071,0,0,0,1.0,1,1.0,1,1.0,1,0.19898149860775802,47
2548,1,5037,1965,3072,0,0,0,1.0,1,1.0,1,1.0,1,0.17734910935196152,46
2549,3,5040,1967,3073,0,0,0,1.0,1,1.0,1,1.0,1,0.16833799228815355,46
2550,2,5042,1969,3073,0,0,0,1.0,1,1.0,1,1.0,1,0.16326984780681414,44
2551,1,5043,1969,3074,0,0,0,1.0,1,1.0,1,1.0,1,0.14075637131133997,43
2552,0,5043,1969,3074,0,0,0,1.0,1,1.0,1,1.0,1,0.17226379816974188,43
2553,0,5043,1969,3074,0,0,0,1.0,1,1.0,1,1.0,1,0.17146490631786318,44
2554,2,5045,1970,3075,0,0,0,1.0,1,1.0,1,1.0,1,0.14839111591918092,45
2555,3,5048,1971,3077,0,0,0,1.0,1,1.0,1,1.0,1,0.13500115887511102,44
2556,1,5049,1971,3078,0,0,0,1.0,1,1.0,1,1.0,1,0.12516795067726447,44
2557,2,5051,1972,3079,0,0,0,1.0,1,1.0,1,1.0,1,0.15771530721272212,41
2558,0,5051,1972,3079,0,0,0,1.0,1,1.0,1,1.0,1,0.1681403440732497,40
2559,2,5053,1972,3081,0,0,0,1.0,1,1.0,1,1.0,1,0.16131147756342426,41
2560,1,5054,1972,3082,0,0,0,1.0,1,1.0,1,1.0,1,0.1437073937689982,41
2561,2,5056,1972,3084,0,0,0,1.0,1,1.0,1,1.0,1,0.1444344298224389,43
2562,2,5058,1973,3085,0,0,0,1.0,1,1.0,1,1.0,1,0.1552482663373292,44
2563,0,5058,1973,3085,0,0,0,1.0,1,1.0,1,1.0,1,0.1552482663373292,44
2564,2,5060,1975,3085,0,0,0,1.0,1,1.0,1,1.0,1,0.19568894695064923,44
2565,0,5060,1975,3085,0,0,0,1.0,1,1.0,1,1.0,1,0.19528762002925415,45
2566,5,5065,1978,3087,0,0,0,1.0,1,1.0,1,1.0,1,0.21348775748404103,46
2567,4,5069,1979,3090,0,0,0,1.0,1,1.0,1,1.0,1,0.2418918815960168,48
2568,5,5074,1979,3095,0,0,0,1.0,1,1.0,1,1.0,1,0.23005834330341213,48
2569,6,5080,1979,3101,0,0,0,1.0,1,1.0,1,1.0,1,0.18798120892893844,49
2570,1,5081,1979,3102,0,0,0,1.0,1,1.0,1,1.0,1,0.2005857077660457,48
2571,2,5083,1979,3104,0,0,0,1.0,1,1.0,1,1.0,1,0.2005857077660457,48
2572,2,5085,1979,3106,0,0,0,1.0,1,1.0,1,1.0,1,0.16383143963690996,49
2573,3,5088,1979,3109,0,0,0,1.0,1,1.0,1,1.0,1,0.14080451590624898,50
2574,4,5092,1981,3111,0,0,0,1.0,1,1.0,1,1.0,1,0.1394903815350514,49
2575,1,5093,1981,3112,0,0,0,1.0,1,1.0,1,1.0,1,0.12614115700279485,48
2576,0,5093,1981,3112,0,0,0,1.0,1,1.0,1,1.0,1,0.12614115700279485,48
2577,0,5093,1981,3112,0,0,0,1.0,1,1.0,1,1.0,1,0.1498356355290128,50
2578,0,5093,1981,3112,0,0,0,1.0,1,1.0,1,1.0,1,0.1498356355290128,50
2579,2,5095,1982,3113,0,0,0,1.0,1,1.0,1,1.0,1,0.1397372809205005,51
2580,2,5097,1983,3114,0,0,0,1.0,1,1.0,1,1.0,1,0.14920217976879221,52
2581,3,5100,1984,3116,0,0,0,1.0,1,1.0,1,1.0,1,0.14961685239450553,51
2582,3,5103,1985,3118,0,0,0,1.0,1,1.0,1,1.0,1,0.13570125023728097,51
2583,3,5106,1987,3119,0,0,0,1.0,1,1.0,1,1.0,1,0.13863314053793463,51
2584,6,5112,1989,3123,0,0,0,1.0,1,1.0,1,1.0,1,0.08843786490019008,51
2585,0,5112,1989,3123,0,0,0,1.0,1,1.0,1,1.0,1,0.07788736639420242,50
2586,3,5115,1992,3123,0,0,0,1.0,1,1.0,1,1.0,1,0.10748786895384387,50
2587,3,5118,1994,3124,0,0,0,1.0,1,1.0,1,1.0,1,0.07864300005642556,48
2588,1,5119,1994,3125,0,0,0,1.0,1,1.0,1,1.0,1,0.06872419523897232,50
2589,1,5120,1995,3125,0,0,0,1.0,1,1.0,1,1.0,1,0.03922866952847453,48
2590,2,5122,1996,3126,0,0,0,1.0,1,1.0,1,1.0,1,0.08643781568240635,47
2591,1,5123,1997,3126,0,0,0,1.0,1,1.0,1,1.0,1,0.08809794109132987,47
2592,1,5124,1998,3126,0,0,0,1.0,1,1.0,1,1.0,1,0.10840849435711129,47
2593,4,5128,1999,3129,0,0,0,1.0,1,1.0,1,1.0,1,0.1078825052672063,47
2594,6,5134,2002,3132,0,0,0,1.0,1,1.0,1,1.0,1,0.12539169481135506,49
2595,1,5135,2002,3133,0,0,0,1.0,1,1.0,1,1.0,1,0.11703339782791809,48
2596,6,5141,2004,3137,0,0,0,1.0,1,1.0,1,1.0,1,0.16188401505664685,47
2597,4,5145,2005,3140,0,0,0,1.0,1,1.0,1,1.0,1,0.170689447302556,48
2598,4,5149,2007,3142,0,0,0,1.0,1,1.0,1,1.0,1,0.140637697082087,48
2599,2,5151,2008,3143,0,0,0,1.0,1,1.0,1,1.0,1,0.11441098315612713,49
2600,1,5152,2008,3144,0,0,0,1.0,1,1.0,1,1.0,1,0.10533593745281015,52
2601,1,5153,2008,3145,0,0,0,1.0,1,1.0,1,1.0,1,0.1110544798819649,51
2602,0,5153,2008,3145,0,0,0,1.0,1,1.0,1,1.0,1,0.10859316477279686,52
2603,2,5155,2009,3146,0,0,0,1.0,1,1.0,1,1.0,1,0.1411596333182743,53
2604,1,5156,2009,3147,0,0,0,1.0,1,1.0,1,1.0,1,0.13538612596294144,53
2605,1,5157,2009,3148,0,0,0,1.0,1,1.0,1,1.0,1,0.15719571781234956,52
2606,0,5157,2009,3148,0,0,0,1.0,1,1.0,1,1.0,1,0.15719571781234956,52
2607,0,5157,2009,3148,0,0,0,1.0,1,1.0,1,1.0,1,0.16646781455800572,52
2608,2,5159,2009,3150,0,0,0,1.0,1,1.0,1,1.0,1,0.15093784984256942,52
2609,4,5163,2011,3152,0,0,0,1.0,1,1.0,1,1.0,1,0.13076729612677243,53
2610,1,5164,2011,3153,0,0,0,1.0,1,1.0,1,1.0,1,0.12678266614159386,54
2611,3,5167,2013,3154,0,0,0,1.0,1,1.0,1,1.0,1,0.11354856320268446,54
2612,2,5169,2014,3155,0,0,0,1.0,1,1.0,1,1.0,1,0.10112872306466268,56
2613,2,5171,2015,3156,0,0,0,1.0,1,1.0,1,1.0,1,0.1076274078984349,56
2614,4,5175,2016,3159,0,0,0,1.0,1,1.0,1,1.0,1,0.07381645796057172,56
2615,0,5175,2016,3159,0,0,0,1.0,1,1.0,1,1.0,1,0.06565425099979047,57
2616,1,5176,2016,3160,0,0,0,1.0,1,1.0,1,1.0,1,0.05937076298927879,57
2617,3,5179,2017,3162,0,0,0,1.0,1,1.0,1,1.0,1,0.05133938412875313,58
2618,2,5181,2018,3163,0,0,0,1.0,1,1.0,1,1.0,1,0.0792130282440736,58
2619,0,5181,2018,3163,0,0,0,1.0,1,1.0,1,1.0,1,0.07816530777108467,58
2620,2,5183,2018,3165,0,0,0,1.0,1,1.0,1,1.0,1,0.051281773434439196,60
2621,0,5183,2018,3165,0,0,0,1.0,1,1.0,1,1.0,1,0.06232874543472168,59
2622,2,5185,2020,3165,0,0,0,1.0,1,1.0,1,1.0,1,0.0758434278102005,60
2623,4,5189,2022,3167,0,0,0,1.0,1,1.0,1,1.0,1,0.0818068386278295,59
2624,2,5191,2024,3167,0,0,0,1.0,1,1.0,1,1.0,1,0.08964025434160007,58
2625,2,5193,2026,3167,0,0,0,1.0,1,1.0,1,1.0,1,0.09031330837575424,58
2626,6,5199,2028,3171,0,0,0,1.0,1,1.0,1,1.0,1,0.08290502576109726,57
2627,1,5200,2029,3171,0,0,0,1.0,1,1.0,1,1.0,1,0.07951791858690792,55
2628,3,5203,2032,3171,0,0,0,1.0,1,1.0,1,1.0,1,0.11906172758598395,55
2629,2,5205,2032,3173,0,0,0,1.0,1,1.0,1,1.0,1,0.08322787403694622,54
2630,2,5207,2033,3174,0,0,0,1.0,1,1.0,1,1.0,1,0.09404483990807283,55
2631,2,5209,2033,3176,0,0,0,1.0,1,1.0,1,1.0,1,0.09935007470612894,55
2632,2,5211,2035,3176,0,0,0,1.0,1,1.0,1,1.0,1,0.1437255696767424,55
2633,1,5212,2036,3176,0,0,0,1.0,1,1.0,1,1.0,1,0.11362147014071453,53
2634,2,5214,2037,3177,0,0,0,1.0,1,1.0,1,1.0,1,0.09318317831398287,52
2635,1,5215,2037,3178,0,0,0,1.0,1,1.0,1,1.0,1,0.1045511219734397,52
2636,5,5220,2040,3180,0,0,0,1.0,1,1.0,1,1.0,1,0.11883968554290743,51
2637,4,5224,2041,3183,0,0,0,1.0,1,1.0,1,1.0,1,0.08322552589683868,50
2638,3,5227,2042,3185,0,0,0,1.0,1,1.0,1,1.0,1,0.06836992773540988,48
2639,2,5229,2044,3185,0,0,0,1.0,1,1.0,1,1.0,1,0.11933236071732517,48
2640,5,5234,2049,3185,0,0,0,1.0,1,1.0,1,1.0,1,0.17974530454761972,46
2641,11,5245,2052,3193,0,0,0,1.0,1,1.0,1,1.0,1,0.10666871013374318,46
2642,9,5254,2056,3198,0,0,0,1.0,1,1.0,1,1.0,1,0.11534497331457699,47
2643,4,5258,2057,3201,0,0,0,1.0,1,1.0,1,1.0,1,0.10917212883587395,45
2644,3,5261,2057,3204,0,0,0,1.0,1,1.0,1,1.0,1,0.11923328900132864,44
2645,1,5262,2058,3204,0,0,0,1.0,1,1.0,1,1.0,1,0.11851353911271353,42
2646,2,5264,2059,3205,0,0,0,1.0,1,1.0,1,1.0,1,0.17094043657557204,43
2647,5,5269,2059,3210,0,0,0,1.0,1,1.0,1,1.0,1,0.07925634259094126,40
2648,1,5270,2060,3210,0,0,0,1.0,1,1.0,1,1.0,1,0.07643658047913687,41
2649,2,5272,2060,3212,0,0,0,1.0,1,1.0,1,1.0,1,0.07946607167193716,43
2650,0,5272,2060,3212,0,0,0,1.0,1,1.0,1,1.0,1,0.1107185674008464,43
2651,3,5275,2061,3214,0,0,0,1.0,1,1.0,1,1.0,1,0.09166559210613595,44
2652,1,5276,2061,3215,0,0,0,1.0,1,1.0,1,1.0,1,0.08613288757229563,44
2653,0,5276,2061,3215,0,0,0,1.0,1,1.0,1,1.0,1,0.08613288757229563,44
2654,3,5279,2062,3217,0,0,0,1.0,1,1.0,1,1.0,1,0.07208853431484268,45
2655,0,5279,2062,3217,0,0,0,1.0,1,1.0,1,1.0,1,0.07208853431484268,45
2656,1,5280,2063,3217,0,0,0,1.0,1,1.0,1,1.0,1,0.09014755330298263,45
2657,2,5282,2063,3219,0,0,0,1.0,1,1.0,1,1.0,1,0.07800553406331018,45
2658,2,5284,2064,3220,0,0,0,1.0,1,1.0,1,1.0,1,0.1090107384239298,47
2659,2,5286,2064,3222,0,0,0,1.0,1,1.0,1,1.0,1,0.06299599104876971,46
2660,0,5286,2064,3222,0,0,0,1.0,1,1.0,1,1.0,1,0.06299599104876971,46
2661,2,5288,2065,3223,0,0,0,1.0,1,1.0,1,1.0,1,0.11716147897579529,46
2662,5,5293,2067,3226,0,0,0,1.0,1,1.0,1,1.0,1,0.0892611716587235,47
2663,2,5295,2069,3226,0,0,0,1.0,1,1.0,1,1.0,1,0.10526009404565459,46
2664,3,5298,2071,3227,0,0,0,1.0,1,1.0,1,1.0,1,0.09766836916146879,45
2665,5,5303,2072,3231,0,0,0,1.0,1,1.0,1,1.0,1,0.10308479489646019,47
2666,8,5311,2076,3235,0,0,0,1.0,1,1.0,1,1.0,1,0.13354611761098725,47
2667,2,5313,2077,3236,0,0,0,1.0,1,1.0,1,1.0,1,0.12606478116138248,45
2668,4,5317,2079,3238,0,0,0,1.0,1,1.0,1,1.0,1,0.10277467708964355,45
2669,3,5320,2080,3240,0,0,0,1.0,1,1.0,1,1.0,1,0.13899851175537814,45
2670,1,5321,2081,3240,0,0,0,1.0,1,1.0,1,1.0,1,0.14421650041457815,45
2671,1,5322,2082,3240,0,0,0,1.0,1,1.0,1,1.0,1,0.14974587282273616,41
2672,1,5323,2083,3240,0,0,0,1.0,1,1.0,1,1.0,1,0.1592879019496196,40
2673,0,5323,2083,3240,0,0,0,1.0,1,1.0,1,1.0,1,0.15716474611525183,39
2674,2,5325,2084,3241,0,0,0,1.0,1,1.0,1,1.0,1,0.1796840764653281,37
2675,1,5326,2085,3241,0,0,0,1.0,1,1.0,1,1.0,1,0.18724402967454348,35
2676,3,5329,2086,3243,0,0,0,1.0,1,1.0,1,1.0,1,0.16537883552834817,34
2677,2,5331,2086,3245,0,0,0,1.0,1,1.0,1,1.0,1,0.14811405535788927,32
2678,2,5333,2086,3247,0,0,0,1.0,1,1.0,1,1.0,1,0.16418126406898584,33
2679,4,5337,2088,3249,0,0,0,1.0,1,1.0,1,1.0,1,0.18483243401358584,33
2680,5,5342,2092,3250,0,0,0,1.0,1,1.0,1,1.0,1,0.26780673403087013,33
2681,2,5344,2092,3252,0,0,0,1.0,1,1.0,1,1.0,1,0.13095456910106248,32
2682,1,5345,2092,3253,0,0,0,1.0,1,1.0,1,1.0,1,0.09819116031912034,32
2683,3,5348,2093,3255,0,0,0,1.0,1,1.0,1,1.0,1,0.15810184792576543,32
2684,0,5348,2093,3255,0,0,0,1.0,1,1.0,1,1.0,1,0.17756960851699405,31
2685,1,5349,2094,3255,0,0,0,1.0,1,1.0,1,1.0,1,0.2221715461165648,30
2686,5,5354,2095,3259,0,0,0,1.0,1,1.0,1,1.0,1,0.13878273236708902,29
2687,1,5355,2095,3260,0,0,0,1.0,1,1.0,1,1.0,1,0.12801903061157993,28
2688,0,5355,2095,3260,0,0,0,1.0,1,1.0,1,1.0,1,0.12801903061157993,28
2689,1,5356,2095,3261,0,0,0,1.0,1,1.0,1,1.0,1,0.17202505100105603,29
2690,1,5357,2095,3262,0,0,0,1.0,1,1.0,1,1.0,1,0.12869074950895715,29
2691,1,5358,2096,3262,0,0,0,1.0,1,1.0,1,1.0,1,0.15619509932813647,29
2692,4,5362,2096,3266,0,0,0,1.0,1,1.0,1,1.0,1,0.05973823872685068,31
2693,2,5364,2097,3267,0,0,0,1.0,1,1.0,1,1.0,1,0.09585743798531564,32
2694,0,5364,2097,3267,0,0,0,1.0,1,1.0,1,1.0,1,0.09585743798531564,32
2695,0,5364,2097,3267,0,0,0,1.0,1,1.0,1,1.0,1,0.07558650406362244,33
2696,0,5364,2097,3267,0,0,0,1.0,1,1.0,1,1.0,1,0.07558650406362244,33
2697,2,5366,2099,3267,0,0,0,1.0,1,1.0,1,1.0,1,0.13389799374748532,34
2698,3,5369,2100,3269,0,0,0,1.0,1,1.0,1,1.0,1,0.10871019467595634,34
2699,0,5369,2100,3269,0,0,0,1.0,1,1.0,1,1.0,1,0.09577754645394176,36
2700,4,5373,2101,3272,0,0,0,1.0,1,1.0,1,1.0,1,0.148905716573923,36
2701,1,5374,2101,3273,0,0,0,1.0,1,1.0,1,1.0,1,0.12596168994453125,36
2702,2,5376,2102,3274,0,0,0,1.0,1,1.0,1,1.0,1,0.16141096590630746,36
2703,3,5379,2103,3276,0,0,0,1.0,1,1.0,1,1.0,1,0.12329864320307789,38
2704,2,5381,2104,3277,0,0,0,1.0,1,1.0,1,1.0,1,0.15471020827067247,37
2705,2,5383,2105,3278,0,0,0,1.0,1,1.0,1,1.0,1,0.18081636215724248,36
2706,5,5388,2107,3281,0,0,0,1.0,1,1.0,1,1.0,1,0.22339909555645596,34
2707,3,5391,2108,3283,0,0,0,1.0,1,1.0,1,1.0,1,0.20166497741261497,36
2708,4,5395,2110,3285,0,0,0,1.0,1,1.0,1,1.0,1,0.20149658984917898,36
2709,0,5395,2110,3285,0,0,0,1.0,1,1.0,1,1.0,1,0.18720604042114586,33
2710,2,5397,2111,3286,0,0,0,1.0,1,1.0,1,1.0,1,0.14718910541803018,32
2711,1,5398,2112,3286,0,0,0,1.0,1,1.0,1,1.0,1,0.12044534109923392,29
2712,0,5398,2112,3286,0,0,0,1.0,1,1.0,1,1.0,1,0.15642399877575294,28
2713,3,5401,2112,3289,0,0,0,1.0,1,1.0,1,1.0,1,0.10299561152331416,28
2714,1,5402,2113,3289,0,0,0,1.0,1,1.0,1,1.0,1,0.20738808042782336,25
2715,1,5403,2114,3289,0,0,0,1.0,1,1.0,1,1.0,1,0.20902652335457267,24
2716,3,5406,2116,3290,0,0,0,1.0,1,1.0,1,1.0,1,0.33725537088435315,23
2717,3,5409,2117,3292,0,0,0,1.0,1,1.0,1,1.0,1,0.2703322115487927,24
2718,1,5410,2117,3293,0,0,0,1.0,1,1.0,1,1.0,1,0.2708893690297814,24
2719,4,5414,2118,3296,0,0,0,1.0,1,1.0,1,1.0,1,0.11781205890534713,25
2720,1,5415,2118,3297,0,0,0,1.0,1,1.0,1,1.0,1,0.10945277193275267,25
2721,2,5417,2120,3297,0,0,0,1.0,1,1.0,1,1.0,1,0.1296001381617553,26
2722,1,5418,2120,3298,0,0,0,1.0,1,1.0,1,1.0,1,0.08713921513000362,26
2723,0,5418,2120,3298,0,0,0,1.0,1,1.0,1,1.0,1,0.08713921513000362,26
2724,1,5419,2121,3298,0,0,0,1.0,1,1.0,1,1.0,1,0.12942018937854421,27
2725,1,5420,2122,3298,0,0,0,1.0,1,1.0,1,1.0,1,0.13182092244824148,27
2726,1,5421,2122,3299,0,0,0,1.0,1,1.0,1,1.0,1,0.155831113361871,28
2727,1,5422,2122,3300,0,0,0,1.0,1,1.0,1,1.0,1,0.12625984995117276,29
2728,1,5423,2122,3301,0,0,0,1.0,1,1.0,1,1.0,1,0.0767303565953839,28
2729,0,5423,2122,3301,0,0,0,1.0,1,1.0,1,1.0,1,0.0767303565953839,28
2730,0,5423,2122,3301,0,0,0,1.0,1,1.0,1,1.0,1,0.10653826250805391,29
2731,1,5424,2123,3301,0,0,0,1.0,1,1.0,1,1.0,1,0.17806472245809887,30
2732,3,5427,2124,3303,0,0,0,1.0,1,1.0,1,1.0,1,0.2038764027442941,29
2733,1,5428,2125,3303,0,0,0,1.0,1,1.0,1,1.0,1,0.24172530776061496,29
2734,2,5430,2125,3305,0,0,0,1.0,1,1.0,1,1.0,1,0.19351257053064283,29
2735,1,5431,2126,3305,0,0,0,1.0,1,1.0,1,1.0,1,0.16729863240765466,29
2736,2,5433,2126,3307,0,0,0,1.0,1,1.0,1,1.0,1,0.14229697431989927,30
2737,1,5434,2126,3308,0,0,0,1.0,1,1.0,1,1.0,1,0.11449706252080223,30
2738,1,5435,2127,3308,0,0,0,1.0,1,1.0,1,1.0,1,0.12742515492047207,29
2739,1,5436,2127,3309,0,0,0,1.0,1,1.0,1,1.0,1,0.1315119026260657,30
2740,1,5437,2128,3309,0,0,0,1.0,1,1.0,1,1.0,1,0.1720848038966869,29
2741,1,5438,2128,3310,0,0,0,1.0,1,1.0,1,1.0,1,0.1503744232016313,29
2742,1,5439,2129,3310,0,0,0,1.0,1,1.0,1,1.0,1,0.15993586209933722,29
2743,3,5442,2130,3312,0,0,0,1.0,1,1.0,1,1.0,1,0.21391916752032947,30
2744,4,5446,2132,3314,0,0,0,1.0,1,1.0,1,1.0,1,0.24338884987741055,28
2745,1,5447,2132,3315,0,0,0,1.0,1,1.0,1,1.0,1,0.141118875857418,27
2746,1,5448,2133,3315,0,0,0,1.0,1,1.0,1,1.0,1,0.1755764149519495,26
2747,1,5449,2134,3315,0,0,0,1.0,1,1.0,1,1.0,1,0.21375096631737947,22
2748,1,5450,2135,3315,0,0,0,1.0,1,1.0,1,1.0,1,0.2408976159483927,22
2749,3,5453,2135,3318,0,0,0,1.0,1,1.0,1,1.0,1,0.2126670422592969,20
2750,0,5453,2135,3318,0,0,0,1.0,1,1.0,1,1.0,1,0.27932846824233526,17
2751,0,5453,2135,3318,0,0,0,1.0,1,1.0,1,1.0,1,0.27932846824233526,17
2752,0,5453,2135,3318,0,0,0,1.0,1,1.0,1,1.0,1,0.25417758311202704,16
2753,0,5453,2135,3318,0,0,0,1.0,1,1.0,1,1.0,1,0.25417758311202704,16
2754,0,5453,2135,3318,0,0,0,1.0,1,1.0,1,1.0,1,0.25417758311202704,16
2755,1,5454,2136,3318,0,0,0,1.0,1,1.0,1,1.0,1,0.2658808740743164,16
2756,0,5454,2136,3318,0,0,0,1.0,1,1.0,1,1.0,1,0.2740971572815607,17
2757,1,5455,2137,3318,0,0,0,1.0,1,1.0,1,1.0,1,0.2360825002364488,18
2758,0,5455,2137,3318,0,0,0,1.0,1,1.0,1,1.0,1,0.2360825002364488,18
2759,0,5455,2137,3318,0,0,0,1.0,1,1.0,1,1.0,1,0.26523359102859734,19
2760,2,5457,2138,3319,0,0,0,1.0,1,1.0,1,1.0,1,0.26658005021874814,18
2761,1,5458,2138,3320,0,0,0,1.0,1,1.0,1,1.0,1,0.2005034096803429,18
2762,0,5458,2138,3320,0,0,0,1.0,1,1.0,1,1.0,1,0.2005034096803429,18
2763,1,5459,2138,3321,0,0,0,1.0,1,1.0,1,1.0,1,0.18037584054401729,18
2764,0,5459,2138,3321,0,0,0,1.0,1,1.0,1,1.0,1,0.18037584054401729,18
2765,0,5459,2138,3321,0,0,0,1.0,1,1.0,1,1.0,1,0.2452467625966835,18
2766,1,5460,2139,3321,0,0,0,1.0,1,1.0,1,1.0,1,0.2490877229517415,18
2767,0,5460,2139,3321,0,0,0,1.0,1,1.0,1,1.0,1,0.2819996425825916,17
2768,0,5460,2139,3321,0,0,0,1.0,1,1.0,1,1.0,1,0.2819996425825916,17
2769,1,5461,2140,3321,0,0,0,1.0,1,1.0,1,1.0,1,0.26937276878071253,17
2770,0,5461,2140,3321,0,0,0,1.0,1,1.0,1,1.0,1,0.26937276878071253,17
2771,0,5461,2140,3321,0,0,0,1.0,1,1.0,1,1.0,1,0.26937276878071253,17
2772,0,5461,2140,3321,0,0,0,1.0,1,1.0,1,1.0,1,0.26937276878071253,17
2773,1,5462,2141,3321,0,0,0,1.0,1,1.0,1,1.0,1,0.27153900326229097,17
2774,0,5462,2141,3321,0,0,0,1.0,1,1.0,1,1.0,1,0.23171162453684682,18
2775,1,5463,2142,3321,0,0,0,1.0,1,1.0,1,1.0,1,0.23960451085860265,20
2776,1,5464,2143,3321,0,0,0,1.0,1,1.0,1,1.0,1,0.2648678679957804,21
2777,1,5465,2144,3321,0,0,0,1.0,1,1.0,1,1.0,1,0.3013774927098591,21
2778,0,5465,2144,3321,0,0,0,1.0,1,1.0,1,1.0,1,0.3013774927098591,21
2779,3,5468,2145,3323,0,0,0,1.0,1,1.0,1,1.0,1,0.2650606792459537,22
2780,2,5470,2147,3323,0,0,0,1.0,1,1.0,1,1.0,1,0.31251244413584983,22
2781,3,5473,2148,3325,0,0,0,1.0,1,1.0,1,1.0,1,0.24724690102366786,22
2782,5,5478,2150,3328,0,0,0,1.0,1,1.0,1,1.0,1,0.22260100970882424,23
2783,1,5479,2151,3328,0,0,0,1.0,1,1.0,1,1.0,1,0.21251267099501311,22
2784,1,5480,2151,3329,0,0,0,1.0,1,1.0,1,1.0,1,0.1460961935352594,21
2785,0,5480,2151,3329,0,0,0,1.0,1,1.0,1,1.0,1,0.2197676796276542,19
2786,1,5481,2152,3329,0,0,0,1.0,1,1.0,1,1.0,1,0.20778611701895885,19
2787,1,5482,2152,3330,0,0,0,1.0,1,1.0,1,1.0,1,0.2702302493533738,20
2788,1,5483,2153,3330,0,0,0,1.0,1,1.0,1,1.0,1,0.2689852178836433,20
2789,0,5483,2153,3330,0,0,0,1.0,1,1.0,1,1.0,1,0.3102896538417494,19
2790,0,5483,2153,3330,0,0,0,1.0,1,1.0,1,1.0,1,0.300774932717929,20
2791,0,5483,2153,3330,0,0,0,1.0,1,1.0,1,1.0,1,0.300774932717929,20
2792,1,5484,2153,3331,0,0,0,1.0,1,1.0,1,1.0,1,0.25517080161467803,20
2793,0,5484,2153,3331,0,0,0,1.0,1,1.0,1,1.0,1,0.259274565127851,19
2794,1,5485,2153,3332,0,0,0,1.0,1,1.0,1,1.0,1,0.2564287387393036,20
2795,2,5487,2153,3334,0,0,0,1.0,1,1.0,1,1.0,1,0.22643676098710658,21
2796,0,5487,2153,3334,0,0,0,1.0,1,1.0,1,1.0,1,0.21939882392556087,22
2797,0,5487,2153,3334,0,0,0,1.0,1,1.0,1,1.0,1,0.22080838859856122,21
2798,1,5488,2154,3334,0,0,0,1.0,1,1.0,1,1.0,1,0.25239724824880583,21
2799,0,5488,2154,3334,0,0,0,1.0,1,1.0,1,1.0,1,0.2590377542094061,20
2800,2,5490,2154,3336,0,0,0,1.0,1,1.0,1,1.0,1,0.17820820213251345,20
2801,0,5490,2154,3336,0,0,0,1.0,1,1.0,1,1.0,1,0.17820820213251345,20
2802,1,5491,2154,3337,0,0,0,1.0,1,1.0,1,1.0,1,0.1337421887188391,20
2803,0,5491,2154,3337,0,0,0,1.0,1,1.0,1,1.0,1,0.1439844063054469,21
2804,0,5491,2154,3337,0,0,0,1.0,1,1.0,1,1.0,1,0.14869108707476944,22
2805,1,5492,2155,3337,0,0,0,1.0,1,1.0,1,1.0,1,0.14287672048962563,22
2806,1,5493,2156,3337,0,0,0,1.0,1,1.0,1,1.0,1,0.18144429137952414,23
2807,2,5495,2157,3338,0,0,0,1.0,1,1.0,1,1.0,1,0.2512996895424195,24
2808,3,5498,2159,3339,0,0,0,1.0,1,1.0,1,1.0,1,0.26227996041889895,24
2809,3,5501,2159,3342,0,0,0,1.0,1,1.0,1,1.0,1,0.12117858228739818,26
2810,2,5503,2159,3344,0,0,0,1.0,1,1.0,1,1.0,1,0.12893606420113063,26
2811,2,5505,2159,3346,0,0,0,1.0,1,1.0,1,1.0,1,0.16052869330950542,27
2812,1,5506,2159,3347,0,0,0,1.0,1,1.0,1,1.0,1,0.1242693467487901,27
2813,0,5506,2159,3347,0,0,0,1.0,1,1.0,1,1.0,1,0.13966238705227682,28
2814,1,5507,2159,3348,0,0,0,1.0,1,1.0,1,1.0,1,0.13315865873820068,29
2815,1,5508,2159,3349,0,0,0,1.0,1,1.0,1,1.0,1,0.1341056888187109,30
2816,0,5508,2159,3349,0,0,0,1.0,1,1.0,1,1.0,1,0.12553044247534684,31
2817,0,5508,2159,3349,0,0,0,1.0,1,1.0,1,1.0,1,0.12553044247534684,31
2818,1,5509,2159,3350,0,0,0,1.0,1,1.0,1,1.0,1,0.1048487828604904,32
2819,0,5509,2159,3350,0,0,0,1.0,1,1.0,1,1.0,1,0.1048487828604904,32
2820,1,5510,2160,3350,0,0,0,1.0,1,1.0,1,1.0,1,0.11358219872357259,33
2821,0,5510,2160,3350,0,0,0,1.0,1,1.0,1,1.0,1,0.13567381702167558,34
2822,1,5511,2161,3350,0,0,0,1.0,1,1.0,1,1.0,1,0.12031345440553236,35
2823,1,5512,2162,3350,0,0,0,1.0,1,1.0,1,1.0,1,0.19821157093891825,31
2824,5,5517,2164,3353,0,0,0,1.0,1,1.0,1,1.0,1,0.2678942931418507,33
2825,1,5518,2164,3354,0,0,0,1.0,1,1.0,1,1.0,1,0.19692296191843497,31
2826,1,5519,2164,3355,0,0,0,1.0,1,1.0,1,1.0,1,0.16978937837890265,31
2827,2,5521,2165,3356,0,0,0,1.0,1,1.0,1,1.0,1,0.15899084433143837,32
2828,5,5526,2168,3358,0,0,0,1.0,1,1.0,1,1.0,1,0.2188839904480538,33
2829,3,5529,2170,3359,0,0,0,1.0,1,1.0,1,1.0,1,0.23930305509925717,33
2830,6,5535,2171,3364,0,0,0,1.0,1,1.0,1,1.0,1,0.17383013659879856,32
2831,1,5536,2171,3365,0,0,0,1.0,1,1.0,1,1.0,1,0.191667979988794,31
2832,0,5536,2171,3365,0,0,0,1.0,1,1.0,1,1.0,1,0.17681031775400596,30
2833,0,5536,2171,3365,0,0,0,1.0,1,1.0,1,1.0,1,0.16809401006789473,29
2834,2,5538,2173,3365,0,0,0,1.0,1,1.0,1,1.0,1,0.28575243485971186,29
2835,2,5540,2175,3365,0,0,0,1.0,1,1.0,1,1.0,1,0.38318068743012695,27
2836,6,5546,2176,3370,0,0,0,1.0,1,1.0,1,1.0,1,0.20491942639503136,27
2837,0,5546,2176,3370,0,0,0,1.0,1,1.0,1,1.0,1,0.2136645852798198,28
2838,3,5549,2177,3372,0,0,0,1.0,1,1.0,1,1.0,1,0.19874425596304568,29
2839,1,5550,2177,3373,0,0,0,1.0,1,1.0,1,1.0,1,0.19621992636883195,29
2840,1,5551,2178,3373,0,0,0,1.0,1,1.0,1,1.0,1,0.2100792345390859,29
2841,2,5553,2178,3375,0,0,0,1.0,1,1.0,1,1.0,1,0.19125920126473042,31
2842,2,5555,2178,3377,0,0,0,1.0,1,1.0,1,1.0,1,0.1495581345050741,32
2843,0,5555,2178,3377,0,0,0,1.0,1,1.0,1,1.0,1,0.1495581345050741,32
2844,3,5558,2179,3379,0,0,0,1.0,1,1.0,1,1.0,1,0.13108109209635468,33
2845,2,5560,2180,3380,0,0,0,1.0,1,1.0,1,1.0,1,0.18056197375072047,34
2846,2,5562,2181,3381,0,0,0,1.0,1,1.0,1,1.0,1,0.17771760934332717,34
2847,0,5562,2181,3381,0,0,0,1.0,1,1.0,1,1.0,1,0.1608727106516413,35
2848,4,5566,2182,3384,0,0,0,1.0,1,1.0,1,1.0,1,0.17860382297424515,37
2849,4,5570,2183,3387,0,0,0,1.0,1,1.0,1,1.0,1,0.14431301058246612,37
2850,1,5571,2183,3388,0,0,0,1.0,1,1.0,1,1.0,1,0.12990054608102172,37
2851,3,5574,2184,3390,0,0,0,1.0,1,1.0,1,1.0,1,0.12400868665851157,38
2852,0,5574,2184,3390,0,0,0,1.0,1,1.0,1,1.0,1,0.1431617503873558,36
2853,1,5575,2184,3391,0,0,0,1.0,1,1.0,1,1.0,1,0.16585773981185276,36
2854,0,5575,2184,3391,0,0,0,1.0,1,1.0,1,1.0,1,0.18640221507061322,37
2855,1,5576,2184,3392,0,0,0,1.0,1,1.0,1,1.0,1,0.18767143206595582,37
2856,0,5576,2184,3392,0,0,0,1.0,1,1.0,1,1.0,1,0.18472908790506,38
2857,4,5580,2186,3394,0,0,0,1.0,1,1.0,1,1.0,1,0.16785751417045072,39
2858,1,5581,2186,3395,0,0,0,1.0,1,1.0,1,1.0,1,0.15695775338707213,39
2859,0,5581,2186,3395,0,0,0,1.0,1,1.0,1,1.0,1,0.15695775338707213,39
2860,3,5584,2187,3397,0,0,0,1.0,1,1.0,1,1.0,1,0.11000246326474343,40
2861,0,5584,2187,3397,0,0,0,1.0,1,1.0,1,1.0,1,0.087383577411746,38
2862,6,5590,2193,3397,0,0,0,1.0,1,1.0,1,1.0,1,0.18387531117122152,38
2863,4,5594,2195,3399,0,0,0,1.0,1,1.0,1,1.0,1,0.18230912332714086,37
2864,6,5600,2199,3401,0,0,0,1.0,1,1.0,1,1.0,1,0.18154258449083516,35
2865,3,5603,2201,3402,0,0,0,1.0,1,1.0,1,1.0,1,0.21861833691379703,33
2866,3,5606,2203,3403,0,0,0,1.0,1,1.0,1,1.0,1,0.15992793533343902,31
2867,2,5608,2203,3405,0,0,0,1.0,1,1.0,1,1.0,1,0.18575798900344984,30
2868,3,5611,2206,3405,0,0,0,1.0,1,1.0,1,1.0,1,0.23999864143230926,31
2869,2,5613,2207,3406,0,0,0,1.0,1,1.0,1,1.0,1,0.20533232085542708,30
2870,0,5613,2207,3406,0,0,0,1.0,1,1.0,1,1.0,1,0.24805672037117169,26
2871,3,5616,2208,3408,0,0,0,1.0,1,1.0,1,1.0,1,0.1884533176206047,27
2872,1,5617,2208,3409,0,0,0,1.0,1,1.0,1,1.0,1,0.20655852148402462,25
2873,1,5618,2208,3410,0,0,0,1.0,1,1.0,1,1.0,1,0.1920195671954389,24
2874,0,5618,2208,3410,0,0,0,1.0,1,1.0,1,1.0,1,0.17735484762047504,25
2875,0,5618,2208,3410,0,0,0,1.0,1,1.0,1,1.0,1,0.20304809217293487,26
2876,3,5621,2209,3412,0,0,0,1.0,1,1.0,1,1.0,1,0.22933745954732676,28
2877,0,5621,2209,3412,0,0,0,1.0,1,1.0,1,1.0,1,0.2294454463728899,29
2878,3,5624,2209,3415,0,0,0,1.0,1,1.0,1,1.0,1,0.13312568597733576,31
2879,1,5625,2209,3416,0,0,0,1.0,1,1.0,1,1.0,1,0.10799922317805526,31
2880,0,5625,2209,3416,0,0,0,1.0,1,1.0,1,1.0,1,0.1103100483774669,32
2881,0,5625,2209,3416,0,0,0,1.0,1,1.0,1,1.0,1,0.10803912689983958,31
2882,0,5625,2209,3416,0,0,0,1.0,1,1.0,1,1.0,1,0.10803912689983958,31
2883,0,5625,2209,3416,0,0,0,1.0,1,1.0,1,1.0,1,0.1418088542615865,32
2884,1,5626,2210,3416,0,0,0,1.0,1,1.0,1,1.0,1,0.1657221829284831,32
2885,4,5630,2211,3419,0,0,0,1.0,1,1.0,1,1.0,1,0.10930701284217206,33
2886,1,5631,2212,3419,0,0,0,1.0,1,1.0,1,1.0,1,0.1095405629619743,34
2887,2,5633,2212,3421,0,0,0,1.0,1,1.0,1,1.0,1,0.08831238895857714,34
2888,2,5635,2213,3422,0,0,0,1.0,1,1.0,1,1.0,1,0.09460809767700361,34
2889,3,5638,2215,3423,0,0,0,1.0,1,1.0,1,1.0,1,0.16606665396348846,37
2890,1,5639,2215,3424,0,0,0,1.0,1,1.0,1,1.0,1,0.14377682375681933,37
2891,1,5640,2216,3424,0,0,0,1.0,1,1.0,1,1.0,1,0.19335554032508648,37
2892,2,5642,2216,3426,0,0,0,1.0,1,1.0,1,1.0,1,0.16687913210287936,37
2893,2,5644,2217,3427,0,0,0,1.0,1,1.0,1,1.0,1,0.1784579033038881,38
2894,1,5645,2217,3428,0,0,0,1.0,1,1.0,1,1.0,1,0.16742683702943384,39
2895,5,5650,2218,3432,0,0,0,1.0,1,1.0,1,1.0,1,0.11007640174193144,40
2896,2,5652,2219,3433,0,0,0,1.0,1,1.0,1,1.0,1,0.10717771536017653,41
2897,0,5652,2219,3433,0,0,0,1.0,1,1.0,1,1.0,1,0.10717771536017653,41
2898,2,5654,2221,3433,0,0,0,1.0,1,1.0,1,1.0,1,0.14049570418033022,41
2899,0,5654,2221,3433,0,0,0,1.0,1,1.0,1,1.0,1,0.1430474761185274,39
2900,7,5661,2224,3437,0,0,0,1.0,1,1.0,1,1.0,1,0.20127843756114497,40
2901,0,5661,2224,3437,0,0,0,1.0,1,1.0,1,1.0,1,0.16876505092899868,40
2902,3,5664,2225,3439,0,0,0,1.0,1,1.0,1,1.0,1,0.14683840510579402,38
2903,2,5666,2226,3440,0,0,0,1.0,1,1.0,1,1.0,1,0.10637019432201944,36
2904,3,5669,2228,3441,0,0,0,1.0,1,1.0,1,1.0,1,0.12347175420411893,36
2905,0,5669,2228,3441,0,0,0,1.0,1,1.0,1,1.0,1,0.09803179203151154,35
2906,2,5671,2229,3442,0,0,0,1.0,1,1.0,1,1.0,1,0.09748993098135397,36
2907,2,5673,2230,3443,0,0,0,1.0,1,1.0,1,1.0,1,0.12067026423385763,37
2908,1,5674,2231,3443,0,0,0,1.0,1,1.0,1,1.0,1,0.14372087384765575,38
2909,1,5675,2232,3443,0,0,0,1.0,1,1.0,1,1.0,1,0.15870863147582717,37
2910,0,5675,2232,3443,0,0,0,1.0,1,1.0,1,1.0,1,0.1483288831749468,37
2911,0,5675,2232,3443,0,0,0,1.0,1,1.0,1,1.0,1,0.18803625609019473,36
2912,3,5678,2234,3444,0,0,0,1.0,1,1.0,1,1.0,1,0.18490430512469894,36
2913,1,5679,2235,3444,0,0,0,1.0,1,1.0,1,1.0,1,0.17108425001438637,36
2914,2,5681,2236,3445,0,0,0,1.0,1,1.0,1,1.0,1,0.19427322026435145,38
2915,0,5681,2236,3445,0,0,0,1.0,1,1.0,1,1.0,1,0.18569598401827783,37
2916,4,5685,2236,3449,0,0,0,1.0,1,1.0,1,1.0,1,0.1410065772073939,39
2917,5,5690,2237,3453,0,0,0,1.0,1,1.0,1,1.0,1,0.10367172902895377,40
2918,3,5693,2239,3454,0,0,0,1.0,1,1.0,1,1.0,1,0.14733309744226114,40
2919,0,5693,2239,3454,0,0,0,1.0,1,1.0,1,1.0,1,0.1666786568777839,42
2920,1,5694,2239,3455,0,0,0,1.0,1,1.0,1,1.0,1,0.15141927155270787,42
2921,1,5695,2239,3456,0,0,0,1.0,1,1.0,1,1.0,1,0.12048873455573272,42
2922,0,5695,2239,3456,0,0,0,1.0,1,1.0,1,1.0,1,0.10198873659661888,43
2923,0,5695,2239,3456,0,0,0,1.0,1,1.0,1,1.0,1,0.1256327907032054,45
2924,2,5697,2240,3457,0,0,0,1.0,1,1.0,1,1.0,1,0.11334768846136797,46
2925,2,5699,2240,3459,0,0,0,1.0,1,1.0,1,1.0,1,0.06552362068335549,46
2926,0,5699,2240,3459,0,0,0,1.0,1,1.0,1,1.0,1,0.06552362068335549,46
2927,1,5700,2241,3459,0,0,0,1.0,1,1.0,1,1.0,1,0.07417503446587143,48
2928,2,5702,2243,3459,0,0,0,1.0,1,1.0,1,1.0,1,0.1128928409867468,48
2929,1,5703,2243,3460,0,0,0,1.0,1,1.0,1,1.0,1,0.08986593835173465,48
2930,0,5703,2243,3460,0,0,0,1.0,1,1.0,1,1.0,1,0.1123623631887849,50
2931,1,5704,2244,3460,0,0,0,1.0,1,1.0,1,1.0,1,0.1436274480771917,51
2932,3,5707,2244,3463,0,0,0,1.0,1,1.0,1,1.0,1,0.13256969066055369,52
2933,0,5707,2244,3463,0,0,0,1.0,1,1.0,1,1.0,1,0.13922119654459345,53
2934,4,5711,2245,3466,0,0,0,1.0,1,1.0,1,1.0,1,0.1669952725447154,54
2935,2,5713,2245,3468,0,0,0,1.0,1,1.0,1,1.0,1,0.14150496077228966,53
2936,1,5714,2246,3468,0,0,0,1.0,1,1.0,1,1.0,1,0.14032490665408187,53
2937,0,5714,2246,3468,0,0,0,1.0,1,1.0,1,1.0,1,0.18216377507033701,51
2938,4,5718,2248,3470,0,0,0,1.0,1,1.0,1,1.0,1,0.20954013517489972,53
2939,0,5718,2248,3470,0,0,0,1.0,1,1.0,1,1.0,1,0.20561892595956355,52
2940,5,5723,2250,3473,0,0,0,1.0,1,1.0,1,1.0,1,0.20767803922731565,52
2941,4,5727,2250,3477,0,0,0,1.0,1,1.0,1,1.0,1,0.14494775703409227,50
2942,0,5727,2250,3477,0,0,0,1.0,1,1.0,1,1.0,1,0.1704976734592524,50
2943,2,5729,2251,3478,0,0,0,1.0,1,1.0,1,1.0,1,0.15119620868307163,49
2944,3,5732,2252,3480,0,0,0,1.0,1,1.0,1,1.0,1,0.1260911940655388,48
2945,1,5733,2253,3480,0,0,0,1.0,1,1.0,1,1.0,1,0.1373722016548952,48
2946,5,5738,2255,3483,0,0,0,1.0,1,1.0,1,1.0,1,0.10344356508450671,47
2947,1,5739,2255,3484,0,0,0,1.0,1,1.0,1,1.0,1,0.06543865116980617,47
2948,1,5740,2255,3485,0,0,0,1.0,1,1.0,1,1.0,1,0.06283108217879922,48
2949,0,5740,2255,3485,0,0,0,1.0,1,1.0,1,1.0,1,0.06283108217879922,48
2950,2,5742,2257,3485,0,0,0,1.0,1,1.0,1,1.0,1,0.05867546734517843,48
2951,2,5744,2258,3486,0,0,0,1.0,1,1.0,1,1.0,1,0.08390228006772052,50
2952,0,5744,2258,3486,0,0,0,1.0,1,1.0,1,1.0,1,0.08390228006772052,50
2953,2,5746,2258,3488,0,0,0,1.0,1,1.0,1,1.0,1,0.1009226536716235,51
2954,0,5746,2258,3488,0,0,0,1.0,1,1.0,1,1.0,1,0.1009226536716235,51
2955,0,5746,2258,3488,0,0,0,1.0,1,1.0,1,1.0,1,0.1009226536716235,51
2956,1,5747,2259,3488,0,0,0,1.0,1,1.0,1,1.0,1,0.13186659996444106,51
2957,2,5749,2259,3490,0,0,0,1.0,1,1.0,1,1.0,1,0.11902144747822993,52
2958,0,5749,2259,3490,0,0,0,1.0,1,1.0,1,1.0,1,0.11902144747822993,52
2959,2,5751,2260,3491,0,0,0,1.0,1,1.0,1,1.0,1,0.11321010693989382,53
2960,1,5752,2261,3491,0,0,0,1.0,1,1.0,1,1.0,1,0.11803388736834203,52
2961,3,5755,2261,3494,0,0,0,1.0,1,1.0,1,1.0,1,0.102459944653181,53
2962,2,5757,2261,3496,0,0,0,1.0,1,1.0,1,1.0,1,0.08625697715773822,54
2963,3,5760,2263,3497,0,0,0,1.0,1,1.0,1,1.0,1,0.11524045856883665,55
2964,2,5762,2263,3499,0,0,0,1.0,1,1.0,1,1.0,1,0.09856972998144248,55
2965,0,5762,2263,3499,0,0,0,1.0,1,1.0,1,1.0,1,0.11142720422203621,55
2966,0,5762,2263,3499,0,0,0,1.0,1,1.0,1,1.0,1,0.11142720422203621,55
2967,0,5762,2263,3499,0,0,0,1.0,1,1.0,1,1.0,1,0.14511166069839324,56
2968,0,5762,2263,3499,0,0,0,1.0,1,1.0,1,1.0,1,0.14511166069839324,56
2969,2,5764,2264,3500,0,0,0,1.0,1,1.0,1,1.0,1,0.15383941696346642,55
2970,3,5767,2264,3503,0,0,0,1.0,1,1.0,1,1.0,1,0.13595081956997057,57
2971,5,5772,2264,3508,0,0,0,1.0,1,1.0,1,1.0,1,0.10459045995518017,56
2972,0,5772,2264,3508,0,0,0,1.0,1,1.0,1,1.0,1,0.11462067046463538,57
2973,1,5773,2264,3509,0,0,0,1.0,1,1.0,1,1.0,1,0.11955780255907641,59
2974,1,5774,2265,3509,0,0,0,1.0,1,1.0,1,1.0,1,0.12641058869642488,60
2975,2,5776,2267,3509,0,0,0,1.0,1,1.0,1,1.0,1,0.14254091530893145,58
2976,3,5779,2269,3510,0,0,0,1.0,1,1.0,1,1.0,1,0.149686883918198,59
2977,7,5786,2270,3516,0,0,0,1.0,1,1.0,1,1.0,1,0.09589675574951179,59
2978,1,5787,2270,3517,0,0,0,1.0,1,1.0,1,1.0,1,0.11675224839592128,58
2979,2,5789,2272,3517,0,0,0,1.0,1,1.0,1,1.0,1,0.13640307765601922,57
2980,5,5794,2273,3521,0,0,0,1.0,1,1.0,1,1.0,1,0.10950451026410297,56
2981,1,5795,2273,3522,0,0,0,1.0,1,1.0,1,1.0,1,0.10066250559860011,56
2982,3,5798,2275,3523,0,0,0,1.0,1,1.0,1,1.0,1,0.1469418664296442,57
2983,8,5806,2279,3527,0,0,0,1.0,1,1.0,1,1.0,1,0.15437061848351263,57
2984,3,5809,2280,3529,0,0,0,1.0,1,1.0,1,1.0,1,0.14575101863875448,56
2985,1,5810,2280,3530,0,0,0,1.0,1,1.0,1,1.0,1,0.15852293485951774,55
2986,8,5818,2282,3536,0,0,0,1.0,1,1.0,1,1.0,1,0.08984404357498779,55
2987,2,5820,2283,3537,0,0,0,1.0,1,1.0,1,1.0,1,0.11787916136856418,51
2988,6,5826,2285,3541,0,0,0,1.0,1,1.0,1,1.0,1,0.10444386776602203,52
2989,3,5829,2285,3544,0,0,0,1.0,1,1.0,1,1.0,1,0.07726407204051092,50
2990,1,5830,2286,3544,0,0,0,1.0,1,1.0,1,1.0,1,0.10394039479278126,50
2991,0,5830,2286,3544,0,0,0,1.0,1,1.0,1,1.0,1,0.07252672943507504,50
2992,1,5831,2287,3544,0,0,0,1.0,1,1.0,1,1.0,1,0.08370900024275069,50
2993,0,5831,2287,3544,0,0,0,1.0,1,1.0,1,1.0,1,0.12373011334157999,51
2994,1,5832,2288,3544,0,0,0,1.0,1,1.0,1,1.0,1,0.1574725234199308,51
2995,3,5835,2288,3547,0,0,0,1.0,1,1.0,1,1.0,1,0.11924495399335919,51
2996,2,5837,2289,3548,0,0,0,1.0,1,1.0,1,1.0,1,0.12673346975218178,52
2997,3,5840,2289,3551,0,0,0,1.0,1,1.0,1,1.0,1,0.1150089692380671,52
2998,2,5842,2290,3552,0,0,0,1.0,1,1.0,1,1.0,1,0.1249217998916719,51
2999,1,5843,2290,3553,0,0,0,1.0,1,1.0,1,1.0,1,0.12162861310734574,51
3000,1,5844,2291,3553,0,0,0,1.0,1,1.0,1,1.0,1,0.12490108145053413,52
3001,1,5845,2291,3554,0,0,0,1.0,1,1.0,1,1.0,1,0.11640222045017426,52
3002,1,5846,2292,3554,0,0,0,1.0,1,1.0,1,1.0,1,0.1392329114821771,53
3003,2,5848,2292,3556,0,0,0,1.0,1,1.0,1,1.0,1,0.13180750618090858,54
3004,2,5850,2292,3558,0,0,0,1.0,1,1.0,1,1.0,1,0.13363592340701697,55
3005,1,5851,2292,3559,0,0,0,1.0,1,1.0,1,1.0,1,0.1336489698486079,56
3006,2,5853,2293,3560,0,0,0,1.0,1,1.0,1,1.0,1,0.14484350063946957,57
3007,0,5853,2293,3560,0,0,0,1.0,1,1.0,1,1.0,1,0.15402591913345962,58
3008,4,5857,2296,3561,0,0,0,1.0,1,1.0,1,1.0,1,0.1757836465902022,59
3009,0,5857,2296,3561,0,0,0,1.0,1,1.0,1,1.0,1,0.1757836465902022,59
3010,4,5861,2296,3565,0,0,0,1.0,1,1.0,1,1.0,1,0.09854683426458662,59
3011,0,5861,2296,3565,0,0,0,1.0,1,1.0,1,1.0,1,0.09854683426458662,59
3012,4,5865,2299,3566,0,0,0,1.0,1,1.0,1,1.0,1,0.1521295845471776,61
3013,5,5870,2300,3570,0,0,0,1.0,1,1.0,1,1.0,1,0.12467568421141138,59
3014,0,5870,2300,3570,0,0,0,1.0,1,1.0,1,1.0,1,0.13390099453650015,60
3015,2,5872,2301,3571,0,0,0,1.0,1,1.0,1,1.0,1,0.15743557372453942,58
3016,3,5875,2301,3574,0,0,0,1.0,1,1.0,1,1.0,1,0.131628142549308,57
3017,1,5876,2302,3574,0,0,0,1.0,1,1.0,1,1.0,1,0.13793346797412676,58
3018,0,5876,2302,3574,0,0,0,1.0,1,1.0,1,1.0,1,0.16691525886685243,55
3019,3,5879,2303,3576,0,0,0,1.0,1,1.0,1,1.0,1,0.15123894607526403,56
3020,3,5882,2304,3578,0,0,0,1.0,1,1.0,1,1.0,1,0.22588123646078545,55
3021,6,5888,2306,3582,0,0,0,1.0,1,1.0,1,1.0,1,0.19455651636525187,55
3022,7,5895,2308,3587,0,0,0,1.0,1,1.0,1,1.0,1,0.197774895796771,55
3023,2,5897,2309,3588,0,0,0,1.0,1,1.0,1,1.0,1,0.17746743973309118,54
3024,3,5900,2309,3591,0,0,0,1.0,1,1.0,1,1.0,1,0.18423782478703113,54
3025,6,5906,2311,3595,0,0,0,1.0,1,1.0,1,1.0,1,0.1195069265219812,54
3026,0,5906,2311,3595,0,0,0,1.0,1,1.0,1,1.0,1,0.10618346713098337,53
3027,6,5912,2313,3599,0,0,0,1.0,1,1.0,1,1.0,1,0.07409800904627008,53
3028,3,5915,2314,3601,0,0,0,1.0,1,1.0,1,1.0,1,0.06635300769762252,51
3029,0,5915,2314,3601,0,0,0,1.0,1,1.0,1,1.0,1,0.06222189235799721,51
3030,4,5919,2317,3602,0,0,0,1.0,1,1.0,1,1.0,1,0.0790246089803604,52
3031,2,5921,2318,3603,0,0,0,1.0,1,1.0,1,1.0,1,0.0812711119851247,51
3032,0,5921,2318,3603,0,0,0,1.0,1,1.0,1,1.0,1,0.06817439348530713,50
3033,1,5922,2319,3603,0,0,0,1.0,1,1.0,1,1.0,1,0.09335439081394174,52
3034,1,5923,2319,3604,0,0,0,1.0,1,1.0,1,1.0,1,0.06874517970560091,51
3035,0,5923,2319,3604,0,0,0,1.0,1,1.0,1,1.0,1,0.06943933287845049,51
3036,1,5924,2319,3605,0,0,0,1.0,1,1.0,1,1.0,1,0.0810551459529732,53
3037,0,5924,2319,3605,0,0,0,1.0,1,1.0,1,1.0,1,0.08227864881241555,52
3038,1,5925,2320,3605,0,0,0,1.0,1,1.0,1,1.0,1,0.08758742584561106,52
3039,3,5928,2322,3606,0,0,0,1.0,1,1.0,1,1.0,1,0.14708004323360177,54
3040,5,5933,2322,3611,0,0,0,1.0,1,1.0,1,1.0,1,0.10158012455902675,55
3041,2,5935,2322,3613,0,0,0,1.0,1,1.0,1,1.0,1,0.08135299459369226,56
3042,1,5936,2322,3614,0,0,0,1.0,1,1.0,1,1.0,1,0.07454736189523187,56
3043,1,5937,2322,3615,0,0,0,1.0,1,1.0,1,1.0,1,0.05367478282209211,57
3044,1,5938,2323,3615,0,0,0,1.0,1,1.0,1,1.0,1,0.07780063251137954,57
3045,0,5938,2323,3615,0,0,0,1.0,1,1.0,1,1.0,1,0.09016597599786907,56
3046,1,5939,2323,3616,0,0,0,1.0,1,1.0,1,1.0,1,0.08346645093915137,57
3047,0,5939,2323,3616,0,0,0,1.0,1,1.0,1,1.0,1,0.09937412913884407,56
3048,3,5942,2324,3618,0,0,0,1.0,1,1.0,1,1.0,1,0.13238869127886715,58
3049,8,5950,2325,3625,0,0,0,1.0,1,1.0,1,1.0,1,0.11066217430869091,59
3050,2,5952,2325,3627,0,0,0,1.0,1,1.0,1,1.0,1,0.07657654542269418,60
3051,1,5953,2326,3627,0,0,0,1.0,1,1.0,1,1.0,1,0.12807645934843914,59
3052,6,5959,2328,3631,0,0,0,1.0,1,1.0,1,1.0,1,0.08870341373691813,58
3053,1,5960,2329,3631,0,0,0,1.0,1,1.0,1,1.0,1,0.0848882676571569,57
3054,2,5962,2331,3631,0,0,0,1.0,1,1.0,1,1.0,1,0.12512859209525948,55
3055,1,5963,2331,3632,0,0,0,1.0,1,1.0,1,1.0,1,0.09656442228295196,54
3056,3,5966,2333,3633,0,0,0,1.0,1,1.0,1,1.0,1,0.12729064537172002,55
3057,2,5968,2334,3634,0,0,0,1.0,1,1.0,1,1.0,1,0.14497673729619207,54
3058,3,5971,2335,3636,0,0,0,1.0,1,1.0,1,1.0,1,0.19800439775044085,55
3059,0,5971,2335,3636,0,0,0,1.0,1,1.0,1,1.0,1,0.1924258916016183,56
3060,0,5971,2335,3636,0,0,0,1.0,1,1.0,1,1.0,1,0.1924258916016183,56
3061,1,5972,2336,3636,0,0,0,1.0,1,1.0,1,1.0,1,0.2003365893533398,56
3062,8,5980,2339,3641,0,0,0,1.0,1,1.0,1,1.0,1,0.1687713143922154,57
3063,2,5982,2339,3643,0,0,0,1.0,1,1.0,1,1.0,1,0.15746518211455346,55
3064,6,5988,2341,3647,0,0,0,1.0,1,1.0,1,1.0,1,0.1528546029347756,56
3065,0,5988,2341,3647,0,0,0,1.0,1,1.0,1,1.0,1,0.12820782130293848,55
3066,2,5990,2343,3647,0,0,0,1.0,1,1.0,1,1.0,1,0.1713673917268603,55
3067,4,5994,2344,3650,0,0,0,1.0,1,1.0,1,1.0,1,0.14908776311306424,54
3068,7,6001,2347,3654,0,0,0,1.0,1,1.0,1,1.0,1,0.12564950677833675,53
3069,4,6005,2351,3654,0,0,0,1.0,1,1.0,1,1.0,1,0.1572823701693886,51
3070,1,6006,2351,3655,0,0,0,1.0,1,1.0,1,1.0,1,0.1408055008532918,50
3071,2,6008,2352,3656,0,0,0,1.0,1,1.0,1,1.0,1,0.12428170491455746,51
3072,2,6010,2352,3658,0,0,0,1.0,1,1.0,1,1.0,1,0.10811707973679488,53
3073,0,6010,2352,3658,0,0,0,1.0,1,1.0,1,1.0,1,0.10958065186105923,51
3074,0,6010,2352,3658,0,0,0,1.0,1,1.0,1,1.0,1,0.1168336734465786,50
3075,1,6011,2352,3659,0,0,0,1.0,1,1.0,1,1.0,1,0.13471105492783908,52
3076,1,6012,2352,3660,0,0,0,1.0,1,1.0,1,1.0,1,0.1585966519856496,53
3077,0,6012,2352,3660,0,0,0,1.0,1,1.0,1,1.0,1,0.14606129600552895,52
3078,1,6013,2352,3661,0,0,0,1.0,1,1.0,1,1.0,1,0.17268915400852264,53
3079,5,6018,2353,3665,0,0,0,1.0,1,1.0,1,1.0,1,0.15584714589262344,53
3080,1,6019,2353,3666,0,0,0,1.0,1,1.0,1,1.0,1,0.14859348414502252,52
3081,3,6022,2354,3668,0,0,0,1.0,1,1.0,1,1.0,1,0.1317503017252803,54
3082,2,6024,2356,3668,0,0,0,1.0,1,1.0,1,1.0,1,0.16175433119017413,54
3083,1,6025,2356,3669,0,0,0,1.0,1,1.0,1,1.0,1,0.15743023999026107,54
3084,2,6027,2357,3670,0,0,0,1.0,1,1.0,1,1.0,1,0.1549250408296392,55
3085,3,6030,2359,3671,0,0,0,1.0,1,1.0,1,1.0,1,0.19128752253676812,55
3086,1,6031,2359,3672,0,0,0,1.0,1,1.0,1,1.0,1,0.16701248633603333,56
3087,0,6031,2359,3672,0,0,0,1.0,1,1.0,1,1.0,1,0.17689922894587853,57
3088,0,6031,2359,3672,0,0,0,1.0,1,1.0,1,1.0,1,0.18962590051327022,56
3089,0,6031,2359,3672,0,0,0,1.0,1,1.0,1,1.0,1,0.19503145508569933,55
3090,1,6032,2359,3673,0,0,0,1.0,1,1.0,1,1.0,1,0.20617058854164785,54
3091,1,6033,2359,3674,0,0,0,1.0,1,1.0,1,1.0,1,0.21258522491768858,53
3092,0,6033,2359,3674,0,0,0,1.0,1,1.0,1,1.0,1,0.1847178187008283,56
3093,1,6034,2360,3674,0,0,0,1.0,1,1.0,1,1.0,1,0.18941921119321958,56
3094,5,6039,2360,3679,0,0,0,1.0,1,1.0,1,1.0,1,0.17209690849361411,58
3095,3,6042,2360,3682,0,0,0,1.0,1,1.0,1,1.0,1,0.13191382811835306,59
3096,0,6042,2360,3682,0,0,0,1.0,1,1.0,1,1.0,1,0.13558604791496046,60
3097,1,6043,2360,3683,0,0,0,1.0,1,1.0,1,1.0,1,0.15241060519738273,60
3098,0,6043,2360,3683,0,0,0,1.0,1,1.0,1,1.0,1,0.17378608864727244,58
3099,1,6044,2361,3683,0,0,0,1.0,1,1.0,1,1.0,1,0.1917293592998651,57
3100,1,6045,2361,3684,0,0,0,1.0,1,1.0,1,1.0,1,0.18188777221590627,57
3101,4,6049,2364,3685,0,0,0,1.0,1,1.0,1,1.0,1,0.16794832113781355,58
3102,5,6054,2366,3688,0,0,0,1.0,1,1.0,1,1.0,1,0.18419692851505823,59
3103,2,6056,2367,3689,0,0,0,1.0,1,1.0,1,1.0,1,0.15336604979958554,58
3104,6,6062,2370,3692,0,0,0,1.0,1,1.0,1,1.0,1,0.15347483738153642,58
3105,4,6066,2372,3694,0,0,0,1.0,1,1.0,1,1.0,1,0.14177512695082536,56
3106,5,6071,2374,3697,0,0,0,1.0,1,1.0,1,1.0,1,0.11327207674641068,57
3107,3,6074,2377,3697,0,0,0,1.0,1,1.0,1,1.0,1,0.10782354076805675,55
3108,5,6079,2380,3699,0,0,0,1.0,1,1.0,1,1.0,1,0.13758418898862013,55
3109,6,6085,2382,3703,0,0,0,1.0,1,1.0,1,1.0,1,0.1336042865103156,54
3110,5,6090,2385,3705,0,0,0,1.0,1,1.0,1,1.0,1,0.14677469380963953,54
3111,3,6093,2386,3707,0,0,0,1.0,1,1.0,1,1.0,1,0.14813448518546776,54
3112,6,6099,2389,3710,0,0,0,1.0,1,1.0,1,1.0,1,0.13553871158972566,56
3113,6,6105,2391,3714,0,0,0,1.0,1,1.0,1,1.0,1,0.12946034633790315,55
3114,4,6109,2393,3716,0,0,0,1.0,1,1.0,1,1.0,1,0.1575476951670931,54
3115,3,6112,2393,3719,0,0,0,1.0,1,1.0,1,1.0,1,0.10943452341906842,56
3116,1,6113,2393,3720,0,0,0,1.0,1,1.0,1,1.0,1,0.10628958742867671,56
3117,3,6116,2393,3723,0,0,0,1.0,1,1.0,1,1.0,1,0.11528321057494853,58
3118,4,6120,2394,3726,0,0,0,1.0,1,1.0,1,1.0,1,0.08264367220018816,57
3119,2,6122,2394,3728,0,0,0,1.0,1,1.0,1,1.0,1,0.06338258323169901,57
3120,0,6122,2394,3728,0,0,0,1.0,1,1.0,1,1.0,1,0.06967719264949022,56
3121,0,6122,2394,3728,0,0,0,1.0,1,1.0,1,1.0,1,0.08260425320236305,57
3122,0,6122,2394,3728,0,0,0,1.0,1,1.0,1,1.0,1,0.08260425320236305,57
3123,0,6122,2394,3728,0,0,0,1.0,1,1.0,1,1.0,1,0.08260425320236305,57
3124,1,6123,2394,3729,0,0,0,1.0,1,1.0,1,1.0,1,0.0694217048030583,59
3125,4,6127,2395,3732,0,0,0,1.0,1,1.0,1,1.0,1,0.09500534681628625,61
3126,2,6129,2395,3734,0,0,0,1.0,1,1.0,1,1.0,1,0.09455298673854812,60
3127,4,6133,2395,3738,0,0,0,1.0,1,1.0,1,1.0,1,0.07164396674182887,58
3128,4,6137,2396,3741,0,0,0,1.0,1,1.0,1,1.0,1,0.07828731687044882,58
3129,0,6137,2396,3741,0,0,0,1.0,1,1.0,1,1.0,1,0.07495902555769304,56
3130,2,6139,2396,3743,0,0,0,1.0,1,1.0,1,1.0,1,0.09698916093558363,56
3131,4,6143,2397,3746,0,0,0,1.0,1,1.0,1,1.0,1,0.11263353014526221,55
3132,1,6144,2398,3746,0,0,0,1.0,1,1.0,1,1.0,1,0.15345987768119462,53
3133,3,6147,2398,3749,0,0,0,1.0,1,1.0,1,1.0,1,0.11173340081067619,52
3134,4,6151,2400,3751,0,0,0,1.0,1,1.0,1,1.0,1,0.11099660682548707,52
3135,1,6152,2400,3752,0,0,0,1.0,1,1.0,1,1.0,1,0.11381393014459219,53
3136,5,6157,2400,3757,0,0,0,1.0,1,1.0,1,1.0,1,0.06709523177800465,54
3137,2,6159,2401,3758,0,0,0,1.0,1,1.0,1,1.0,1,0.08343849222889073,55
3138,8,6167,2402,3765,0,0,0,1.0,1,1.0,1,1.0,1,0.08653269832155257,57
3139,3,6170,2404,3766,0,0,0,1.0,1,1.0,1,1.0,1,0.09768551259335975,56
3140,1,6171,2405,3766,0,0,0,1.0,1,1.0,1,1.0,1,0.10289297011150711,56
3141,3,6174,2406,3768,0,0,0,1.0,1,1.0,1,1.0,1,0.1101822276838948,56
3142,0,6174,2406,3768,0,0,0,1.0,1,1.0,1,1.0,1,0.1101822276838948,56
3143,1,6175,2407,3768,0,0,0,1.0,1,1.0,1,1.0,1,0.11052765030633667,56
3144,2,6177,2409,3768,0,0,0,1.0,1,1.0,1,1.0,1,0.09384568182216442,54
3145,3,6180,2410,3770,0,0,0,1.0,1,1.0,1,1.0,1,0.08118505407516786,55
3146,0,6180,2410,3770,0,0,0,1.0,1,1.0,1,1.0,1,0.08555699018593811,53
3147,2,6182,2410,3772,0,0,0,1.0,1,1.0,1,1.0,1,0.08422911367821978,54
3148,2,6184,2411,3773,0,0,0,1.0,1,1.0,1,1.0,1,0.07992046704217107,54
3149,1,6185,2412,3773,0,0,0,1.0,1,1.0,1,1.0,1,0.097131009604338,53
3150,0,6185,2412,3773,0,0,0,1.0,1,1.0,1,1.0,1,0.097131009604338,53
3151,2,6187,2412,3775,0,0,0,1.0,1,1.0,1,1.0,1,0.06786772411205041,53
3152,1,6188,2413,3775,0,0,0,1.0,1,1.0,1,1.0,1,0.08945297781779407,54
3153,0,6188,2413,3775,0,0,0,1.0,1,1.0,1,1.0,1,0.11325201403968166,53
3154,6,6194,2414,3780,0,0,0,1.0,1,1.0,1,1.0,1,0.09256856382170836,55
3155,1,6195,2414,3781,0,0,0,1.0,1,1.0,1,1.0,1,0.08008493055433359,56
3156,0,6195,2414,3781,0,0,0,1.0,1,1.0,1,1.0,1,0.10319809496694347,56
3157,1,6196,2414,3782,0,0,0,1.0,1,1.0,1,1.0,1,0.0797942109364668,56
3158,1,6197,2414,3783,0,0,0,1.0,1,1.0,1,1.0,1,0.07902931752509593,57
3159,0,6197,2414,3783,0,0,0,1.0,1,1.0,1,1.0,1,0.09594518197102779,56
3160,2,6199,2415,3784,0,0,0,1.0,1,1.0,1,1.0,1,0.11950247312859874,58
3161,2,6201,2416,3785,0,0,0,1.0,1,1.0,1,1.0,1,0.09297426439677388,59
3162,1,6202,2417,3785,0,0,0,1.0,1,1.0,1,1.0,1,0.1243369431410598,59
3163,9,6211,2420,3791,0,0,0,1.0,1,1.0,1,1.0,1,0.11669461335807861,59
3164,0,6211,2420,3791,0,0,0,1.0,1,1.0,1,1.0,1,0.12322687797711784,60
3165,0,6211,2420,3791,0,0,0,1.0,1,1.0,1,1.0,1,0.11296644568612944,58
3166,3,6214,2420,3794,0,0,0,1.0,1,1.0,1,1.0,1,0.07091655379545946,59
3167,4,6218,2423,3795,0,0,0,1.0,1,1.0,1,1.0,1,0.10364777548642455,57
3168,4,6222,2424,3798,0,0,0,1.0,1,1.0,1,1.0,1,0.10965447339624416,58
3169,5,6227,2426,3801,0,0,0,1.0,1,1.0,1,1.0,1,0.09601448487399367,57
3170,0,6227,2426,3801,0,0,0,1.0,1,1.0,1,1.0,1,0.1027627412126474,55
3171,3,6230,2428,3802,0,0,0,1.0,1,1.0,1,1.0,1,0.11703528723001486,56
3172,1,6231,2429,3802,0,0,0,1.0,1,1.0,1,1.0,1,0.14028195990475392,54
3173,3,6234,2430,3804,0,0,0,1.0,1,1.0,1,1.0,1,0.16187506590951828,53
3174,1,6235,2431,3804,0,0,0,1.0,1,1.0,1,1.0,1,0.13216904023370446,53
3175,4,6239,2431,3808,0,0,0,1.0,1,1.0,1,1.0,1,0.0986405032498315,52
3176,3,6242,2434,3808,0,0,0,1.0,1,1.0,1,1.0,1,0.13801903246283612,53
3177,2,6244,2436,3808,0,0,0,1.0,1,1.0,1,1.0,1,0.19680917746743823,52
3178,8,6252,2436,3816,0,0,0,1.0,1,1.0,1,1.0,1,0.08915343837039814,53
3179,1,6253,2436,3817,0,0,0,1.0,1,1.0,1,1.0,1,0.09567031953258821,54
3180,0,6253,2436,3817,0,0,0,1.0,1,1.0,1,1.0,1,0.1091504827988437,54
3181,4,6257,2436,3821,0,0,0,1.0,1,1.0,1,1.0,1,0.07463507731309849,55
3182,0,6257,2436,3821,0,0,0,1.0,1,1.0,1,1.0,1,0.086603590562446,54
3183,2,6259,2437,3822,0,0,0,1.0,1,1.0,1,1.0,1,0.11391712415400838,56
3184,4,6263,2440,3823,0,0,0,1.0,1,1.0,1,1.0,1,0.13695737136335917,54
3185,0,6263,2440,3823,0,0,0,1.0,1,1.0,1,1.0,1,0.12741950901070506,53
3186,4,6267,2441,3826,0,0,0,1.0,1,1.0,1,1.0,1,0.11963156945242966,52
3187,1,6268,2441,3827,0,0,0,1.0,1,1.0,1,1.0,1,0.09840599469942181,50
3188,1,6269,2442,3827,0,0,0,1.0,1,1.0,1,1.0,1,0.10705201800155874,50
3189,3,6272,2443,3829,0,0,0,1.0,1,1.0,1,1.0,1,0.14211713771575338,49
3190,5,6277,2444,3833,0,0,0,1.0,1,1.0,1,1.0,1,0.14015978883055755,50
3191,2,6279,2446,3833,0,0,0,1.0,1,1.0,1,1.0,1,0.1706639446437895,49
3192,0,6279,2446,3833,0,0,0,1.0,1,1.0,1,1.0,1,0.1706639446437895,49
3193,2,6281,2446,3835,0,0,0,1.0,1,1.0,1,1.0,1,0.13976354581000192,49
3194,5,6286,2449,3837,0,0,0,1.0,1,1.0,1,1.0,1,0.18150409565002298,50
3195,1,6287,2449,3838,0,0,0,1.0,1,1.0,1,1.0,1,0.16887575617008793,49
3196,2,6289,2450,3839,0,0,0,1.0,1,1.0,1,1.0,1,0.18280389662333685,49
3197,2,6291,2450,3841,0,0,0,1.0,1,1.0,1,1.0,1,0.1293291678969046,50
3198,2,6293,2450,3843,0,0,0,1.0,1,1.0,1,1.0,1,0.13040999630769698,50
3199,3,6296,2450,3846,0,0,0,1.0,1,1.0,1,1.0,1,0.0714747245613781,52
3200,0,6296,2450,3846,0,0,0,1.0,1,1.0,1,1.0,1,0.07095355785446683,53
3201,3,6299,2450,3849,0,0,0,1.0,1,1.0,1,1.0,1,0.05850074219316055,55
3202,0,6299,2450,3849,0,0,0,1.0,1,1.0,1,1.0,1,0.05850074219316055,55
3203,0,6299,2450,3849,0,0,0,1.0,1,1.0,1,1.0,1,0.05503941560264169,53
3204,0,6299,2450,3849,0,0,0,1.0,1,1.0,1,1.0,1,0.0807037800628079,53
3205,2,6301,2452,3849,0,0,0,1.0,1,1.0,1,1.0,1,0.10965951321719287,53
3206,1,6302,2452,3850,0,0,0,1.0,1,1.0,1,1.0,1,0.09179086787843399,52
3207,3,6305,2454,3851,0,0,0,1.0,1,1.0,1,1.0,1,0.1532581966006425,53
3208,2,6307,2454,3853,0,0,0,1.0,1,1.0,1,1.0,1,0.167401259486022,51
3209,2,6309,2454,3855,0,0,0,1.0,1,1.0,1,1.0,1,0.16563045153352698,52
3210,1,6310,2454,3856,0,0,0,1.0,1,1.0,1,1.0,1,0.11472444346145134,49
3211,4,6314,2456,3858,0,0,0,1.0,1,1.0,1,1.0,1,0.1611060066734836,48
3212,2,6316,2458,3858,0,0,0,1.0,1,1.0,1,1.0,1,0.17423731011734309,48
3213,0,6316,2458,3858,0,0,0,1.0,1,1.0,1,1.0,1,0.16985363918159396,49
3214,5,6321,2459,3862,0,0,0,1.0,1,1.0,1,1.0,1,0.11016985403036145,51
3215,0,6321,2459,3862,0,0,0,1.0,1,1.0,1,1.0,1,0.11016985403036145,51
3216,2,6323,2461,3862,0,0,0,1.0,1,1.0,1,1.0,1,0.108063574161817,51
3217,1,6324,2461,3863,0,0,0,1.0,1,1.0,1,1.0,1,0.09054292970276215,51
3218,0,6324,2461,3863,0,0,0,1.0,1,1.0,1,1.0,1,0.09054292970276215,51
3219,0,6324,2461,3863,0,0,0,1.0,1,1.0,1,1.0,1,0.10036614246037946,52
3220,0,6324,2461,3863,0,0,0,1.0,1,1.0,1,1.0,1,0.10036614246037946,52
3221,2,6326,2461,3865,0,0,0,1.0,1,1.0,1,1.0,1,0.08331008228709934,54
3222,0,6326,2461,3865,0,0,0,1.0,1,1.0,1,1.0,1,0.07585495194903286,54
3223,0,6326,2461,3865,0,0,0,1.0,1,1.0,1,1.0,1,0.09496518684805555,56
3224,1,6327,2462,3865,0,0,0,1.0,1,1.0,1,1.0,1,0.11504253192633938,57
3225,2,6329,2462,3867,0,0,0,1.0,1,1.0,1,1.0,1,0.11883159023227306,58
3226,0,6329,2462,3867,0,0,0,1.0,1,1.0,1,1.0,1,0.11883159023227306,58
3227,0,6329,2462,3867,0,0,0,1.0,1,1.0,1,1.0,1,0.11883159023227306,58
3228,0,6329,2462,3867,0,0,0,1.0,1,1.0,1,1.0,1,0.11883159023227306,58
3229,6,6335,2464,3871,0,0,0,1.0,1,1.0,1,1.0,1,0.1485883033690404,60
3230,0,6335,2464,3871,0,0,0,1.0,1,1.0,1,1.0,1,0.1423152735686688,61
3231,0,6335,2464,3871,0,0,0,1.0,1,1.0,1,1.0,1,0.1423152735686688,61
3232,1,6336,2464,3872,0,0,0,1.0,1,1.0,1,1.0,1,0.13221475255707088,61
3233,0,6336,2464,3872,0,0,0,1.0,1,1.0,1,1.0,1,0.13648206651289274,63
3234,1,6337,2465,3872,0,0,0,1.0,1,1.0,1,1.0,1,0.1788301315453881,64
3235,4,6341,2465,3876,0,0,0,1.0,1,1.0,1,1.0,1,0.1371754559237631,65
3236,1,6342,2465,3877,0,0,0,1.0,1,1.0,1,1.0,1,0.14252815610476838,66
3237,2,6344,2465,3879,0,0,0,1.0,1,1.0,1,1.0,1,0.1176770459088428,67
3238,0,6344,2465,3879,0,0,0,1.0,1,1.0,1,1.0,1,0.1176770459088428,67
3239,0,6344,2465,3879,0,0,0,1.0,1,1.0,1,1.0,1,0.13571808730644863,69
3240,0,6344,2465,3879,0,0,0,1.0,1,1.0,1,1.0,1,0.13571808730644863,69
3241,3,6347,2467,3880,0,0,0,1.0,1,1.0,1,1.0,1,0.1309643169626026,68
3242,1,6348,2468,3880,0,0,0,1.0,1,1.0,1,1.0,1,0.1437547913902422,67
3243,3,6351,2470,3881,0,0,0,1.0,1,1.0,1,1.0,1,0.13117556575956357,68
3244,4,6355,2470,3885,0,0,0,1.0,1,1.0,1,1.0,1,0.08887873661897527,68
3245,1,6356,2470,3886,0,0,0,1.0,1,1.0,1,1.0,1,0.08246155738142087,69
3246,3,6359,2470,3889,0,0,0,1.0,1,1.0,1,1.0,1,0.08558850122631871,68
3247,0,6359,2470,3889,0,0,0,1.0,1,1.0,1,1.0,1,0.08558850122631871,68
3248,1,6360,2471,3889,0,0,0,1.0,1,1.0,1,1.0,1,0.09498256325258,68
3249,2,6362,2471,3891,0,0,0,1.0,1,1.0,1,1.0,1,0.08884253340432471,69
3250,5,6367,2472,3895,0,0,0,1.0,1,1.0,1,1.0,1,0.060912947958354224,69
3251,2,6369,2473,3896,0,0,0,1.0,1,1.0,1,1.0,1,0.07222093414702052,68
3252,0,6369,2473,3896,0,0,0,1.0,1,1.0,1,1.0,1,0.06277651544376668,68
3253,0,6369,2473,3896,0,0,0,1.0,1,1.0,1,1.0,1,0.07410311967715942,69
3254,0,6369,2473,3896,0,0,0,1.0,1,1.0,1,1.0,1,0.07410311967715942,69
3255,2,6371,2473,3898,0,0,0,1.0,1,1.0,1,1.0,1,0.07837359537366029,70
3256,1,6372,2473,3899,0,0,0,1.0,1,1.0,1,1.0,1,0.06545188357758219,70
3257,0,6372,2473,3899,0,0,0,1.0,1,1.0,1,1.0,1,0.07558579824279323,71
3258,1,6373,2474,3899,0,0,0,1.0,1,1.0,1,1.0,1,0.0850089432986039,72
3259,4,6377,2476,3901,0,0,0,1.0,1,1.0,1,1.0,1,0.09554453073835881,71
3260,1,6378,2477,3901,0,0,0,1.0,1,1.0,1,1.0,1,0.10919924776805552,72
3261,3,6381,2477,3904,0,0,0,1.0,1,1.0,1,1.0,1,0.11216161279279863,74
3262,10,6391,2480,3911,0,0,0,1.0,1,1.0,1,1.0,1,0.08215019944150821,73
3263,3,6394,2482,3912,0,0,0,1.0,1,1.0,1,1.0,1,0.07779721395377588,73
3264,2,6396,2484,3912,0,0,0,1.0,1,1.0,1,1.0,1,0.11790391036394335,71
3265,1,6397,2484,3913,0,0,0,1.0,1,1.0,1,1.0,1,0.10757273249201627,70
3266,1,6398,2485,3913,0,0,0,1.0,1,1.0,1,1.0,1,0.12508388809636847,69
3267,1,6399,2486,3913,0,0,0,1.0,1,1.0,1,1.0,1,0.14664339580064992,69
3268,4,6403,2487,3916,0,0,0,1.0,1,1.0,1,1.0,1,0.15086658277772308,68
3269,3,6406,2488,3918,0,0,0,1.0,1,1.0,1,1.0,1,0.15144836813599033,68
3270,0,6406,2488,3918,0,0,0,1.0,1,1.0,1,1.0,1,0.16243532927588306,67
3271,2,6408,2488,3920,0,0,0,1.0,1,1.0,1,1.0,1,0.14454445808050215,66
3272,1,6409,2488,3921,0,0,0,1.0,1,1.0,1,1.0,1,0.12895522367050072,67
3273,2,6411,2488,3923,0,0,0,1.0,1,1.0,1,1.0,1,0.11945229267246837,66
3274,4,6415,2489,3926,0,0,0,1.0,1,1.0,1,1.0,1,0.10968966484684052,68
3275,0,6415,2489,3926,0,0,0,1.0,1,1.0,1,1.0,1,0.10968966484684052,68
3276,1,6416,2489,3927,0,0,0,1.0,1,1.0,1,1.0,1,0.10254959693994112,69
3277,4,6420,2490,3930,0,0,0,1.0,1,1.0,1,1.0,1,0.08938959267663366,68
3278,1,6421,2490,3931,0,0,0,1.0,1,1.0,1,1.0,1,0.093577609348798,69
3279,1,6422,2491,3931,0,0,0,1.0,1,1.0,1,1.0,1,0.09692919205500683,67
3280,4,6426,2493,3933,0,0,0,1.0,1,1.0,1,1.0,1,0.10754499369835763,66
3281,2,6428,2495,3933,0,0,0,1.0,1,1.0,1,1.0,1,0.1567212654548234,67
3282,2,6430,2495,3935,0,0,0,1.0,1,1.0,1,1.0,1,0.1634445562195158,66
3283,5,6435,2497,3938,0,0,0,1.0,1,1.0,1,1.0,1,0.18488880773879682,67
3284,2,6437,2497,3940,0,0,0,1.0,1,1.0,1,1.0,1,0.138200620023989,66
3285,1,6438,2497,3941,0,0,0,1.0,1,1.0,1,1.0,1,0.14094679805483226,66
3286,5,6443,2497,3946,0,0,0,1.0,1,1.0,1,1.0,1,0.10671824971519356,63
3287,3,6446,2499,3947,0,0,0,1.0,1,1.0,1,1.0,1,0.15553702880398235,61
3288,0,6446,2499,3947,0,0,0,1.0,1,1.0,1,1.0,1,0.16040931778573242,63
3289,5,6451,2500,3951,0,0,0,1.0,1,1.0,1,1.0,1,0.15898528320029043,62
3290,0,6451,2500,3951,0,0,0,1.0,1,1.0,1,1.0,1,0.15116514529221775,63
3291,4,6455,2502,3953,0,0,0,1.0,1,1.0,1,1.0,1,0.17024704619979672,62
3292,3,6458,2502,3956,0,0,0,1.0,1,1.0,1,1.0,1,0.1561924964816765,63
3293,0,6458,2502,3956,0,0,0,1.0,1,1.0,1,1.0,1,0.17991003055851335,65
3294,0,6458,2502,3956,0,0,0,1.0,1,1.0,1,1.0,1,0.17991003055851335,65
3295,3,6461,2503,3958,0,0,0,1.0,1,1.0,1,1.0,1,0.15109928314454577,65
3296,0,6461,2503,3958,0,0,0,1.0,1,1.0,1,1.0,1,0.15109928314454577,65
3297,1,6462,2503,3959,0,0,0,1.0,1,1.0,1,1.0,1,0.1369140322140508,66
3298,2,6464,2503,3961,0,0,0,1.0,1,1.0,1,1.0,1,0.12404556725633273,66
3299,0,6464,2503,3961,0,0,0,1.0,1,1.0,1,1.0,1,0.13174878076745772,67
3300,5,6469,2506,3963,0,0,0,1.0,1,1.0,1,1.0,1,0.18434542646876514,67
3301,6,6475,2508,3967,0,0,0,1.0,1,1.0,1,1.0,1,0.19685795941580725,68
3302,3,6478,2508,3970,0,0,0,1.0,1,1.0,1,1.0,1,0.19500856868726815,67
3303,3,6481,2509,3972,0,0,0,1.0,1,1.0,1,1.0,1,0.19976330227662123,67
3304,4,6485,2509,3976,0,0,0,1.0,1,1.0,1,1.0,1,0.16524052334006625,67
3305,4,6489,2509,3980,0,0,0,1.0,1,1.0,1,1.0,1,0.14686955898940499,69
3306,1,6490,2509,3981,0,0,0,1.0,1,1.0,1,1.0,1,0.13658577543684516,70
3307,0,6490,2509,3981,0,0,0,1.0,1,1.0,1,1.0,1,0.13658577543684516,70
3308,0,6490,2509,3981,0,0,0,1.0,1,1.0,1,1.0,1,0.13658577543684516,70
3309,4,6494,2509,3985,0,0,0,1.0,1,1.0,1,1.0,1,0.12459602252687173,72
3310,3,6497,2509,3988,0,0,0,1.0,1,1.0,1,1.0,1,0.11553325485050837,74
3311,0,6497,2509,3988,0,0,0,1.0,1,1.0,1,1.0,1,0.11553325485050837,74
3312,0,6497,2509,3988,0,0,0,1.0,1,1.0,1,1.0,1,0.11553325485050837,74
3313,2,6499,2509,3990,0,0,0,1.0,1,1.0,1,1.0,1,0.1105627406983565,75
3314,2,6501,2509,3992,0,0,0,1.0,1,1.0,1,1.0,1,0.11979304951879396,76
3315,2,6503,2510,3993,0,0,0,1.0,1,1.0,1,1.0,1,0.15353182840958876,75
3316,4,6507,2511,3996,0,0,0,1.0,1,1.0,1,1.0,1,0.1305055276507962,76
3317,1,6508,2511,3997,0,0,0,1.0,1,1.0,1,1.0,1,0.1297156544983341,73
3318,4,6512,2514,3998,0,0,0,1.0,1,1.0,1,1.0,1,0.1612075468658666,72
3319,5,6517,2515,4002,0,0,0,1.0,1,1.0,1,1.0,1,0.16133717496774044,71
3320,1,6518,2515,4003,0,0,0,1.0,1,1.0,1,1.0,1,0.15120118476949385,70
3321,2,6520,2516,4004,0,0,0,1.0,1,1.0,1,1.0,1,0.1618774211572916,69
3322,2,6522,2517,4005,0,0,0,1.0,1,1.0,1,1.0,1,0.1525555397778086,68
3323,0,6522,2517,4005,0,0,0,1.0,1,1.0,1,1.0,1,0.1593844977766421,69
3324,1,6523,2518,4005,0,0,0,1.0,1,1.0,1,1.0,1,0.16702735486990647,69
3325,3,6526,2518,4008,0,0,0,1.0,1,1.0,1,1.0,1,0.1574288696776832,70
3326,3,6529,2520,4009,0,0,0,1.0,1,1.0,1,1.0,1,0.17023814427343997,69
3327,2,6531,2521,4010,0,0,0,1.0,1,1.0,1,1.0,1,0.16100206684077012,70
3328,4,6535,2521,4014,0,0,0,1.0,1,1.0,1,1.0,1,0.13580236863960815,73
3329,1,6536,2522,4014,0,0,0,1.0,1,1.0,1,1.0,1,0.18103341245199892,72
3330,2,6538,2523,4015,0,0,0,1.0,1,1.0,1,1.0,1,0.18972192551058611,72
3331,3,6541,2524,4017,0,0,0,1.0,1,1.0,1,1.0,1,0.16738875081310028,72
3332,1,6542,2524,4018,0,0,0,1.0,1,1.0,1,1.0,1,0.16525176759945792,73
3333,0,6542,2524,4018,0,0,0,1.0,1,1.0,1,1.0,1,0.1673667931425328,72
3334,5,6547,2525,4022,0,0,0,1.0,1,1.0,1,1.0,1,0.15505581322614356,73
3335,4,6551,2526,4025,0,0,0,1.0,1,1.0,1,1.0,1,0.1555005297459225,74
3336,3,6554,2526,4028,0,0,0,1.0,1,1.0,1,1.0,1,0.14929832564908874,74
3337,2,6556,2526,4030,0,0,0,1.0,1,1.0,1,1.0,1,0.13446138801746618,74
3338,1,6557,2526,4031,0,0,0,1.0,1,1.0,1,1.0,1,0.1306596871665351,74
3339,1,6558,2527,4031,0,0,0,1.0,1,1.0,1,1.0,1,0.1515547813979786,75
3340,5,6563,2527,4036,0,0,0,1.0,1,1.0,1,1.0,1,0.1334279711450825,75
3341,0,6563,2527,4036,0,0,0,1.0,1,1.0,1,1.0,1,0.14306891396902793,76
3342,0,6563,2527,4036,0,0,0,1.0,1,1.0,1,1.0,1,0.16264517926896874,76
3343,3,6566,2528,4038,0,0,0,1.0,1,1.0,1,1.0,1,0.14451084961621763,75
3344,5,6571,2530,4041,0,0,0,1.0,1,1.0,1,1.0,1,0.14467325296806136,75
3345,1,6572,2531,4041,0,0,0,1.0,1,1.0,1,1.0,1,0.1689666159209798,72
3346,2,6574,2532,4042,0,0,0,1.0,1,1.0,1,1.0,1,0.16523930974908813,73
3347,1,6575,2533,4042,0,0,0,1.0,1,1.0,1,1.0,1,0.1519129360836253,73
3348,2,6577,2533,4044,0,0,0,1.0,1,1.0,1,1.0,1,0.14709867128781673,73
3349,3,6580,2533,4047,0,0,0,1.0,1,1.0,1,1.0,1,0.14056481658194742,74
3350,6,6586,2536,4050,0,0,0,1.0,1,1.0,1,1.0,1,0.17065607563835183,73
3351,1,6587,2537,4050,0,0,0,1.0,1,1.0,1,1.0,1,0.17810767600616062,72
3352,4,6591,2537,4054,0,0,0,1.0,1,1.0,1,1.0,1,0.15788579084508608,72
3353,2,6593,2539,4054,0,0,0,1.0,1,1.0,1,1.0,1,0.18496834551457647,72
3354,3,6596,2540,4056,0,0,0,1.0,1,1.0,1,1.0,1,0.1934595454815701,70
3355,5,6601,2540,4061,0,0,0,1.0,1,1.0,1,1.0,1,0.1503568406551864,69
3356,4,6605,2542,4063,0,0,0,1.0,1,1.0,1,1.0,1,0.1739733171414475,69
3357,1,6606,2542,4064,0,0,0,1.0,1,1.0,1,1.0,1,0.17694474838708554,68
3358,4,6610,2544,4066,0,0,0,1.0,1,1.0,1,1.0,1,0.19534258451997497,68
3359,2,6612,2544,4068,0,0,0,1.0,1,1.0,1,1.0,1,0.1890527532184668,66
3360,2,6614,2545,4069,0,0,0,1.0,1,1.0,1,1.0,1,0.20234885793018653,65
3361,3,6617,2545,4072,0,0,0,1.0,1,1.0,1,1.0,1,0.19814737273448468,64
3362,2,6619,2545,4074,0,0,0,1.0,1,1.0,1,1.0,1,0.18105283514815157,64
3363,0,6619,2545,4074,0,0,0,1.0,1,1.0,1,1.0,1,0.1720324409091627,65
3364,1,6620,2545,4075,0,0,0,1.0,1,1.0,1,1.0,1,0.16773722077680658,66
3365,1,6621,2545,4076,0,0,0,1.0,1,1.0,1,1.0,1,0.16592436365424268,68
3366,1,6622,2545,4077,0,0,0,1.0,1,1.0,1,1.0,1,0.1640762993827095,66
3367,3,6625,2545,4080,0,0,0,1.0,1,1.0,1,1.0,1,0.14109620045595792,68
3368,5,6630,2546,4084,0,0,0,1.0,1,1.0,1,1.0,1,0.11713664936604914,68
3369,3,6633,2546,4087,0,0,0,1.0,1,1.0,1,1.0,1,0.1267258772780711,69
3370,3,6636,2546,4090,0,0,0,1.0,1,1.0,1,1.0,1,0.09563271839858556,71
3371,1,6637,2546,4091,0,0,0,1.0,1,1.0,1,1.0,1,0.08850880708093158,71
3372,1,6638,2547,4091,0,0,0,1.0,1,1.0,1,1.0,1,0.09897297449686815,71
3373,1,6639,2547,4092,0,0,0,1.0,1,1.0,1,1.0,1,0.09268322077266959,72
3374,0,6639,2547,4092,0,0,0,1.0,1,1.0,1,1.0,1,0.08883139296294522,72
3375,2,6641,2548,4093,0,0,0,1.0,1,1.0,1,1.0,1,0.08712944433908587,73
3376,1,6642,2548,4094,0,0,0,1.0,1,1.0,1,1.0,1,0.07213140601670079,75
3377,1,6643,2549,4094,0,0,0,1.0,1,1.0,1,1.0,1,0.09801157735828896,77
3378,0,6643,2549,4094,0,0,0,1.0,1,1.0,1,1.0,1,0.09801157735828896,77
3379,3,6646,2551,4095,0,0,0,1.0,1,1.0,1,1.0,1,0.11686820082944241,77
3380,1,6647,2552,4095,0,0,0,1.0,1,1.0,1,1.0,1,0.12540103729667226,76
3381,1,6648,2553,4095,0,0,0,1.0,1,1.0,1,1.0,1,0.13315704813556622,76
3382,6,6654,2555,4099,0,0,0,1.0,1,1.0,1,1.0,1,0.10731310197471573,78
3383,1,6655,2555,4100,0,0,0,1.0,1,1.0,1,1.0,1,0.08142170084603918,77
3384,3,6658,2558,4100,0,0,0,1.0,1,1.0,1,1.0,1,0.11740708783714546,77
3385,3,6661,2560,4101,0,0,0,1.0,1,1.0,1,1.0,1,0.1031955440623538,75
3386,3,6664,2562,4102,0,0,0,1.0,1,1.0,1,1.0,1,0.12603252690041306,76
3387,2,6666,2562,4104,0,0,0,1.0,1,1.0,1,1.0,1,0.12334346775596741,75
3388,6,6672,2564,4108,0,0,0,1.0,1,1.0,1,1.0,1,0.12173245097433698,76
3389,0,6672,2564,4108,0,0,0,1.0,1,1.0,1,1.0,1,0.11882177470797498,77
3390,0,6672,2564,4108,0,0,0,1.0,1,1.0,1,1.0,1,0.10856440580264134,76
3391,2,6674,2565,4109,0,0,0,1.0,1,1.0,1,1.0,1,0.10706561012356805,77
3392,2,6676,2566,4110,0,0,0,1.0,1,1.0,1,1.0,1,0.11518797396948315,78
3393,0,6676,2566,4110,0,0,0,1.0,1,1.0,1,1.0,1,0.1071619934346692,76
3394,2,6678,2566,4112,0,0,0,1.0,1,1.0,1,1.0,1,0.10738998125765012,75
3395,2,6680,2566,4114,0,0,0,1.0,1,1.0,1,1.0,1,0.06386821729069697,73
3396,0,6680,2566,4114,0,0,0,1.0,1,1.0,1,1.0,1,0.06386821729069697,73
3397,0,6680,2566,4114,0,0,0,1.0,1,1.0,1,1.0,1,0.06489369880629012,74
3398,0,6680,2566,4114,0,0,0,1.0,1,1.0,1,1.0,1,0.06489369880629012,74
3399,2,6682,2568,4114,0,0,0,1.0,1,1.0,1,1.0,1,0.09439040779921562,75
3400,5,6687,2569,4118,0,0,0,1.0,1,1.0,1,1.0,1,0.0651730485065375,75
3401,2,6689,2569,4120,0,0,0,1.0,1,1.0,1,1.0,1,0.03657352482662079,77
3402,1,6690,2570,4120,0,0,0,1.0,1,1.0,1,1.0,1,0.05364079813667402,77
3403,3,6693,2571,4122,0,0,0,1.0,1,1.0,1,1.0,1,0.06174625199060854,78
3404,1,6694,2572,4122,0,0,0,1.0,1,1.0,1,1.0,1,0.09004548181735922,78
3405,1,6695,2572,4123,0,0,0,1.0,1,1.0,1,1.0,1,0.08726245397279171,78
3406,2,6697,2573,4124,0,0,0,1.0,1,1.0,1,1.0,1,0.08083167029634858,78
3407,2,6699,2574,4125,0,0,0,1.0,1,1.0,1,1.0,1,0.10219242553203277,78
3408,0,6699,2574,4125,0,0,0,1.0,1,1.0,1,1.0,1,0.10680859309737413,79
3409,3,6702,2574,4128,0,0,0,1.0,1,1.0,1,1.0,1,0.08222718248027353,81
3410,2,6704,2574,4130,0,0,0,1.0,1,1.0,1,1.0,1,0.07838981202698608,82
3411,3,6707,2576,4131,0,0,0,1.0,1,1.0,1,1.0,1,0.09661009280356855,84
3412,3,6710,2576,4134,0,0,0,1.0,1,1.0,1,1.0,1,0.08245156091405963,84
3413,0,6710,2576,4134,0,0,0,1.0,1,1.0,1,1.0,1,0.08245156091405963,84
3414,1,6711,2577,4134,0,0,0,1.0,1,1.0,1,1.0,1,0.08516918057887712,84
3415,3,6714,2578,4136,0,0,0,1.0,1,1.0,1,1.0,1,0.0790315945704317,85
3416,3,6717,2579,4138,0,0,0,1.0,1,1.0,1,1.0,1,0.06608663121307892,85
3417,1,6718,2580,4138,0,0,0,1.0,1,1.0,1,1.0,1,0.07512487026710854,86
3418,3,6721,2583,4138,0,0,0,1.0,1,1.0,1,1.0,1,0.12427720444125902,86
3419,6,6727,2585,4142,0,0,0,1.0,1,1.0,1,1.0,1,0.14788620679443956,87
3420,2,6729,2585,4144,0,0,0,1.0,1,1.0,1,1.0,1,0.14098189170679204,88
3421,3,6732,2585,4147,0,0,0,1.0,1,1.0,1,1.0,1,0.12627346804342449,89
3422,2,6734,2585,4149,0,0,0,1.0,1,1.0,1,1.0,1,0.12561080788146237,90
3423,0,6734,2585,4149,0,0,0,1.0,1,1.0,1,1.0,1,0.12565127267418813,90
3424,4,6738,2585,4153,0,0,0,1.0,1,1.0,1,1.0,1,0.10415116806766563,91
3425,2,6740,2586,4154,0,0,0,1.0,1,1.0,1,1.0,1,0.09375617769186244,90
3426,3,6743,2587,4156,0,0,0,1.0,1,1.0,1,1.0,1,0.07984653925137856,92
3427,2,6745,2587,4158,0,0,0,1.0,1,1.0,1,1.0,1,0.08564438775379389,92
3428,0,6745,2587,4158,0,0,0,1.0,1,1.0,1,1.0,1,0.09262569275546506,91
3429,0,6745,2587,4158,0,0,0,1.0,1,1.0,1,1.0,1,0.09262569275546506,91
3430,3,6748,2589,4159,0,0,0,1.0,1,1.0,1,1.0,1,0.11786895686404672,91
3431,0,6748,2589,4159,0,0,0,1.0,1,1.0,1,1.0,1,0.10749946946043219,90
3432,4,6752,2591,4161,0,0,0,1.0,1,1.0,1,1.0,1,0.12712305820992537,91
3433,7,6759,2591,4168,0,0,0,1.0,1,1.0,1,1.0,1,0.12471419032555363,90
3434,1,6760,2591,4169,0,0,0,1.0,1,1.0,1,1.0,1,0.12049435675622627,89
3435,0,6760,2591,4169,0,0,0,1.0,1,1.0,1,1.0,1,0.11626355478188527,88
3436,4,6764,2592,4172,0,0,0,1.0,1,1.0,1,1.0,1,0.11151362933101087,86
3437,3,6767,2594,4173,0,0,0,1.0,1,1.0,1,1.0,1,0.1254887275418985,86
3438,1,6768,2594,4174,0,0,0,1.0,1,1.0,1,1.0,1,0.11005673907377528,87
3439,5,6773,2595,4178,0,0,0,1.0,1,1.0,1,1.0,1,0.11085945208627732,86
3440,0,6773,2595,4178,0,0,0,1.0,1,1.0,1,1.0,1,0.12817190406046888,86
3441,0,6773,2595,4178,0,0,0,1.0,1,1.0,1,1.0,1,0.11922681899284379,85
3442,3,6776,2595,4181,0,0,0,1.0,1,1.0,1,1.0,1,0.09515409741400016,85
3443,1,6777,2595,4182,0,0,0,1.0,1,1.0,1,1.0,1,0.09806668784021715,85
3444,2,6779,2597,4182,0,0,0,1.0,1,1.0,1,1.0,1,0.10518908899048338,85
3445,4,6783,2598,4185,0,0,0,1.0,1,1.0,1,1.0,1,0.12174608358795874,84
3446,6,6789,2601,4188,0,0,0,1.0,1,1.0,1,1.0,1,0.1643262545455073,85
3447,3,6792,2602,4190,0,0,0,1.0,1,1.0,1,1.0,1,0.1505317016481905,85
3448,3,6795,2602,4193,0,0,0,1.0,1,1.0,1,1.0,1,0.14257288257200942,85
3449,2,6797,2603,4194,0,0,0,1.0,1,1.0,1,1.0,1,0.16398077409081319,84
3450,0,6797,2603,4194,0,0,0,1.0,1,1.0,1,1.0,1,0.16398077409081319,84
3451,4,6801,2603,4198,0,0,0,1.0,1,1.0,1,1.0,1,0.14598968264928364,85
3452,1,6802,2603,4199,0,0,0,1.0,1,1.0,1,1.0,1,0.1384710082743357,86
3453,2,6804,2604,4200,0,0,0,1.0,1,1.0,1,1.0,1,0.12568377908093623,85
3454,4,6808,2604,4204,0,0,0,1.0,1,1.0,1,1.0,1,0.10146674256610087,88
3455,0,6808,2604,4204,0,0,0,1.0,1,1.0,1,1.0,1,0.10146674256610087,88
3456,1,6809,2605,4204,0,0,0,1.0,1,1.0,1,1.0,1,0.1025431155725045,88
3457,1,6810,2605,4205,0,0,0,1.0,1,1.0,1,1.0,1,0.09806811233952839,89
3458,1,6811,2605,4206,0,0,0,1.0,1,1.0,1,1.0,1,0.10447071067294698,88
3459,0,6811,2605,4206,0,0,0,1.0,1,1.0,1,1.0,1,0.10447071067294698,88
3460,0,6811,2605,4206,0,0,0,1.0,1,1.0,1,1.0,1,0.09823272838153395,89
3461,0,6811,2605,4206,0,0,0,1.0,1,1.0,1,1.0,1,0.09823272838153395,89
3462,2,6813,2605,4208,0,0,0,1.0,1,1.0,1,1.0,1,0.09447539354157657,90
3463,1,6814,2605,4209,0,0,0,1.0,1,1.0,1,1.0,1,0.093805992519998,89
3464,0,6814,2605,4209,0,0,0,1.0,1,1.0,1,1.0,1,0.09885689119845929,88
3465,1,6815,2605,4210,0,0,0,1.0,1,1.0,1,1.0,1,0.11486270015962322,87
3466,4,6819,2605,4214,0,0,0,1.0,1,1.0,1,1.0,1,0.0890021481604795,87
3467,1,6820,2606,4214,0,0,0,1.0,1,1.0,1,1.0,1,0.10194054521784846,87
3468,4,6824,2608,4216,0,0,0,1.0,1,1.0,1,1.0,1,0.12269113418722927,88
3469,5,6829,2609,4220,0,0,0,1.0,1,1.0,1,1.0,1,0.12110699565149065,85
3470,5,6834,2610,4224,0,0,0,1.0,1,1.0,1,1.0,1,0.11311358508652206,86
3471,4,6838,2612,4226,0,0,0,1.0,1,1.0,1,1.0,1,0.13844945169385584,84
3472,5,6843,2613,4230,0,0,0,1.0,1,1.0,1,1.0,1,0.12150194466151831,83
3473,1,6844,2614,4230,0,0,0,1.0,1,1.0,1,1.0,1,0.14229164927323773,81
3474,2,6846,2614,4232,0,0,0,1.0,1,1.0,1,1.0,1,0.11653666622288243,80
3475,4,6850,2615,4235,0,0,0,1.0,1,1.0,1,1.0,1,0.13355468148552962,82
3476,2,6852,2616,4236,0,0,0,1.0,1,1.0,1,1.0,1,0.10880566490739614,81
3477,6,6858,2617,4241,0,0,0,1.0,1,1.0,1,1.0,1,0.12637535274464468,83
3478,3,6861,2618,4243,0,0,0,1.0,1,1.0,1,1.0,1,0.1275059088318783,83
3479,1,6862,2618,4244,0,0,0,1.0,1,1.0,1,1.0,1,0.12128721154849623,83
3480,1,6863,2619,4244,0,0,0,1.0,1,1.0,1,1.0,1,0.11793669306601459,83
3481,5,6868,2621,4247,0,0,0,1.0,1,1.0,1,1.0,1,0.1033594946115622,83
3482,4,6872,2624,4248,0,0,0,1.0,1,1.0,1,1.0,1,0.12853467275800015,83
3483,3,6875,2626,4249,0,0,0,1.0,1,1.0,1,1.0,1,0.13590809719311936,82
3484,4,6879,2627,4252,0,0,0,1.0,1,1.0,1,1.0,1,0.127972668651584,82
3485,1,6880,2628,4252,0,0,0,1.0,1,1.0,1,1.0,1,0.14866889564725896,83
3486,0,6880,2628,4252,0,0,0,1.0,1,1.0,1,1.0,1,0.14866889564725896,83
3487,3,6883,2628,4255,0,0,0,1.0,1,1.0,1,1.0,1,0.13207852713682008,84
3488,0,6883,2628,4255,0,0,0,1.0,1,1.0,1,1.0,1,0.14386948090068974,84
3489,2,6885,2628,4257,0,0,0,1.0,1,1.0,1,1.0,1,0.12080126534955554,84
3490,1,6886,2628,4258,0,0,0,1.0,1,1.0,1,1.0,1,0.11263356909316653,84
3491,2,6888,2628,4260,0,0,0,1.0,1,1.0,1,1.0,1,0.11837247474461897,86
3492,1,6889,2629,4260,0,0,0,1.0,1,1.0,1,1.0,1,0.11001194379536879,86
3493,2,6891,2629,4262,0,0,0,1.0,1,1.0,1,1.0,1,0.10050168662293557,86
3494,2,6893,2629,4264,0,0,0,1.0,1,1.0,1,1.0,1,0.09071113043485673,86
3495,0,6893,2629,4264,0,0,0,1.0,1,1.0,1,1.0,1,0.0893266199913779,87
3496,1,6894,2629,4265,0,0,0,1.0,1,1.0,1,1.0,1,0.08882478310436771,88
3497,2,6896,2630,4266,0,0,0,1.0,1,1.0,1,1.0,1,0.10956881515027028,89
3498,1,6897,2630,4267,0,0,0,1.0,1,1.0,1,1.0,1,0.12292683152282634,89
3499,6,6903,2630,4273,0,0,0,1.0,1,1.0,1,1.0,1,0.10835723133387878,91
3500,2,6905,2630,4275,0,0,0,1.0,1,1.0,1,1.0,1,0.10452690805367895,90
3501,0,6905,2630,4275,0,0,0,1.0,1,1.0,1,1.0,1,0.10452690805367895,90
3502,3,6908,2630,4278,0,0,0,1.0,1,1.0,1,1.0,1,0.08974589892220802,91
3503,2,6910,2630,4280,0,0,0,1.0,1,1.0,1,1.0,1,0.10369548279673647,91
3504,4,6914,2632,4282,0,0,0,1.0,1,1.0,1,1.0,1,0.13339317545795099,89
3505,5,6919,2633,4286,0,0,0,1.0,1,1.0,1,1.0,1,0.11371753347110115,87
3506,3,6922,2635,4287,0,0,0,1.0,1,1.0,1,1.0,1,0.12847003170918847,87
3507,4,6926,2637,4289,0,0,0,1.0,1,1.0,1,1.0,1,0.11511500138610507,84
3508,7,6933,2641,4292,0,0,0,1.0,1,1.0,1,1.0,1,0.15145766081227433,83
3509,4,6937,2642,4295,0,0,0,1.0,1,1.0,1,1.0,1,0.13431056028652213,80
3510,0,6937,2642,4295,0,0,0,1.0,1,1.0,1,1.0,1,0.14034225056538707,78
3511,3,6940,2643,4297,0,0,0,1.0,1,1.0,1,1.0,1,0.13871126581646062,77
3512,0,6940,2643,4297,0,0,0,1.0,1,1.0,1,1.0,1,0.15059450682570005,74
3513,3,6943,2643,4300,0,0,0,1.0,1,1.0,1,1.0,1,0.13205139749778066,76
3514,2,6945,2643,4302,0,0,0,1.0,1,1.0,1,1.0,1,0.12020172596867415,76
3515,4,6949,2645,4304,0,0,0,1.0,1,1.0,1,1.0,1,0.13180456742326913,75
3516,1,6950,2645,4305,0,0,0,1.0,1,1.0,1,1.0,1,0.11895913409550982,73
3517,2,6952,2647,4305,0,0,0,1.0,1,1.0,1,1.0,1,0.15526376166526148,74
3518,0,6952,2647,4305,0,0,0,1.0,1,1.0,1,1.0,1,0.17330629915687512,74
3519,0,6952,2647,4305,0,0,0,1.0,1,1.0,1,1.0,1,0.1859010949336317,73
3520,5,6957,2647,4310,0,0,0,1.0,1,1.0,1,1.0,1,0.12797412117667267,74
3521,4,6961,2647,4314,0,0,0,1.0,1,1.0,1,1.0,1,0.11647297727004455,75
3522,1,6962,2647,4315,0,0,0,1.0,1,1.0,1,1.0,1,0.11038877761127072,75
3523,3,6965,2647,4318,0,0,0,1.0,1,1.0,1,1.0,1,0.10075769962425155,75
3524,1,6966,2647,4319,0,0,0,1.0,1,1.0,1,1.0,1,0.07812614424380805,75
3525,0,6966,2647,4319,0,0,0,1.0,1,1.0,1,1.0,1,0.08690630629985939,75
3526,1,6967,2647,4320,0,0,0,1.0,1,1.0,1,1.0,1,0.07787508047009409,76
3527,2,6969,2649,4320,0,0,0,1.0,1,1.0,1,1.0,1,0.13115431011008552,77
3528,2,6971,2649,4322,0,0,0,1.0,1,1.0,1,1.0,1,0.13153022294505207,77
3529,4,6975,2650,4325,0,0,0,1.0,1,1.0,1,1.0,1,0.1294676309593676,78
3530,0,6975,2650,4325,0,0,0,1.0,1,1.0,1,1.0,1,0.1554482586604506,78
3531,2,6977,2651,4326,0,0,0,1.0,1,1.0,1,1.0,1,0.1536997567583359,79
3532,6,6983,2652,4331,0,0,0,1.0,1,1.0,1,1.0,1,0.14056748274638856,79
3533,2,6985,2654,4331,0,0,0,1.0,1,1.0,1,1.0,1,0.1772288650005246,79
3534,12,6997,2657,4340,0,0,0,1.0,1,1.0,1,1.0,1,0.18849028030281462,80
3535,6,7003,2657,4346,0,0,0,1.0,1,1.0,1,1.0,1,0.1572527402400985,81
3536,1,7004,2657,4347,0,0,0,1.0,1,1.0,1,1.0,1,0.1521692542925327,82
3537,0,7004,2657,4347,0,0,0,1.0,1,1.0,1,1.0,1,0.1521692542925327,82
3538,4,7008,2657,4351,0,0,0,1.0,1,1.0,1,1.0,1,0.12903901104699145,83
3539,0,7008,2657,4351,0,0,0,1.0,1,1.0,1,1.0,1,0.12903901104699145,83
3540,4,7012,2658,4354,0,0,0,1.0,1,1.0,1,1.0,1,0.12383194117843,85
3541,1,7013,2658,4355,0,0,0,1.0,1,1.0,1,1.0,1,0.1078357058138224,85
3542,3,7016,2658,4358,0,0,0,1.0,1,1.0,1,1.0,1,0.09729221793052148,88
3543,0,7016,2658,4358,0,0,0,1.0,1,1.0,1,1.0,1,0.09334976688496419,87
3544,3,7019,2658,4361,0,0,0,1.0,1,1.0,1,1.0,1,0.0784505552494499,87
3545,1,7020,2659,4361,0,0,0,1.0,1,1.0,1,1.0,1,0.08487981620802074,85
3546,1,7021,2660,4361,0,0,0,1.0,1,1.0,1,1.0,1,0.07713939372265317,83
3547,3,7024,2660,4364,0,0,0,1.0,1,1.0,1,1.0,1,0.05690310215101157,82
3548,1,7025,2661,4364,0,0,0,1.0,1,1.0,1,1.0,1,0.059688109278836735,82
3549,0,7025,2661,4364,0,0,0,1.0,1,1.0,1,1.0,1,0.05398401927216785,81
3550,0,7025,2661,4364,0,0,0,1.0,1,1.0,1,1.0,1,0.06885369170333755,79
3551,0,7025,2661,4364,0,0,0,1.0,1,1.0,1,1.0,1,0.0731485607670194,80
3552,1,7026,2662,4364,0,0,0,1.0,1,1.0,1,1.0,1,0.08751517852121517,78
3553,3,7029,2662,4367,0,0,0,1.0,1,1.0,1,1.0,1,0.07444155584635775,79
3554,1,7030,2663,4367,0,0,0,1.0,1,1.0,1,1.0,1,0.08955556533290622,77
3555,1,7031,2664,4367,0,0,0,1.0,1,1.0,1,1.0,1,0.10662479997080966,77
3556,3,7034,2664,4370,0,0,0,1.0,1,1.0,1,1.0,1,0.09787784353610747,76
3557,1,7035,2664,4371,0,0,0,1.0,1,1.0,1,1.0,1,0.08621074977559337,76
3558,1,7036,2665,4371,0,0,0,1.0,1,1.0,1,1.0,1,0.11173678849963645,76
3559,5,7041,2665,4376,0,0,0,1.0,1,1.0,1,1.0,1,0.0740974925943642,76
3560,3,7044,2666,4378,0,0,0,1.0,1,1.0,1,1.0,1,0.08044805804739293,78
3561,3,7047,2667,4380,0,0,0,1.0,1,1.0,1,1.0,1,0.09690382057820704,79
3562,3,7050,2668,4382,0,0,0,1.0,1,1.0,1,1.0,1,0.11081268883075153,79
3563,1,7051,2669,4382,0,0,0,1.0,1,1.0,1,1.0,1,0.11437364104701223,79
3564,7,7058,2671,4387,0,0,0,1.0,1,1.0,1,1.0,1,0.13025573760181214,80
3565,11,7069,2672,4397,0,0,0,1.0,1,1.0,1,1.0,1,0.12328542898016227,83
3566,4,7073,2673,4400,0,0,0,1.0,1,1.0,1,1.0,1,0.12262985566693108,84
3567,3,7076,2673,4403,0,0,0,1.0,1,1.0,1,1.0,1,0.1285397824969657,84
3568,4,7080,2674,4406,0,0,0,1.0,1,1.0,1,1.0,1,0.11036934810529773,84
3569,1,7081,2675,4406,0,0,0,1.0,1,1.0,1,1.0,1,0.11403660300684684,84
3570,5,7086,2677,4409,0,0,0,1.0,1,1.0,1,1.0,1,0.1120277115876917,87
3571,4,7090,2678,4412,0,0,0,1.0,1,1.0,1,1.0,1,0.09151022970060331,86
3572,5,7095,2680,4415,0,0,0,1.0,1,1.0,1,1.0,1,0.12172816618907062,87
3573,3,7098,2682,4416,0,0,0,1.0,1,1.0,1,1.0,1,0.14664742415260537,87
3574,5,7103,2684,4419,0,0,0,1.0,1,1.0,1,1.0,1,0.15625395409812276,88
3575,3,7106,2684,4422,0,0,0,1.0,1,1.0,1,1.0,1,0.13658944962278433,88
3576,2,7108,2685,4423,0,0,0,1.0,1,1.0,1,1.0,1,0.1228048322174465,90
3577,4,7112,2685,4427,0,0,0,1.0,1,1.0,1,1.0,1,0.10598562461169538,90
3578,2,7114,2685,4429,0,0,0,1.0,1,1.0,1,1.0,1,0.10379704834400867,91
3579,0,7114,2685,4429,0,0,0,1.0,1,1.0,1,1.0,1,0.10379704834400867,91
3580,4,7118,2685,4433,0,0,0,1.0,1,1.0,1,1.0,1,0.10507283480500235,91
3581,3,7121,2685,4436,0,0,0,1.0,1,1.0,1,1.0,1,0.09179030468908919,91
3582,5,7126,2686,4440,0,0,0,1.0,1,1.0,1,1.0,1,0.09797121614248269,92
3583,3,7129,2686,4443,0,0,0,1.0,1,1.0,1,1.0,1,0.08034661389318586,88
3584,3,7132,2689,4443,0,0,0,1.0,1,1.0,1,1.0,1,0.11086850885833045,87
3585,2,7134,2689,4445,0,0,0,1.0,1,1.0,1,1.0,1,0.08815815073733824,84
3586,3,7137,2690,4447,0,0,0,1.0,1,1.0,1,1.0,1,0.08096342942008382,83
3587,2,7139,2690,4449,0,0,0,1.0,1,1.0,1,1.0,1,0.08638388425430353,82
3588,5,7144,2692,4452,0,0,0,1.0,1,1.0,1,1.0,1,0.0961214099184002,81
3589,3,7147,2694,4453,0,0,0,1.0,1,1.0,1,1.0,1,0.11757508337968199,80
3590,4,7151,2695,4456,0,0,0,1.0,1,1.0,1,1.0,1,0.11799402103255349,78
3591,4,7155,2697,4458,0,0,0,1.0,1,1.0,1,1.0,1,0.09471310516335402,77
3592,6,7161,2698,4463,0,0,0,1.0,1,1.0,1,1.0,1,0.08413114764525992,75
3593,4,7165,2699,4466,0,0,0,1.0,1,1.0,1,1.0,1,0.08447287821604271,76
3594,1,7166,2700,4466,0,0,0,1.0,1,1.0,1,1.0,1,0.09778269609326132,74
3595,4,7170,2700,4470,0,0,0,1.0,1,1.0,1,1.0,1,0.07255775059727591,74
3596,0,7170,2700,4470,0,0,0,1.0,1,1.0,1,1.0,1,0.07745188009297944,73
3597,1,7171,2701,4470,0,0,0,1.0,1,1.0,1,1.0,1,0.08429554565977998,73
3598,2,7173,2703,4470,0,0,0,1.0,1,1.0,1,1.0,1,0.11726440630875898,73
3599,1,7174,2703,4471,0,0,0,1.0,1,1.0,1,1.0,1,0.1101087997284084,73
3600,0,7174,2703,4471,0,0,0,1.0,1,1.0,1,1.0,1,0.1021530397651705,74
3601,5,7179,2705,4474,0,0,0,1.0,1,1.0,1,1.0,1,0.09046042503408715,75
3602,1,7180,2705,4475,0,0,0,1.0,1,1.0,1,1.0,1,0.05966368022257142,76
3603,3,7183,2707,4476,0,0,0,1.0,1,1.0,1,1.0,1,0.07925496548280934,77
3604,4,7187,2710,4477,0,0,0,1.0,1,1.0,1,1.0,1,0.12233919004074609,78
3605,7,7194,2713,4481,0,0,0,1.0,1,1.0,1,1.0,1,0.1236348585264594,77
3606,3,7197,2714,4483,0,0,0,1.0,1,1.0,1,1.0,1,0.11353285219480369,79
3607,6,7203,2715,4488,0,0,0,1.0,1,1.0,1,1.0,1,0.06132005664423851,79
3608,0,7203,2715,4488,0,0,0,1.0,1,1.0,1,1.0,1,0.06132005664423851,79
3609,1,7204,2715,4489,0,0,0,1.0,1,1.0,1,1.0,1,0.0555133589500271,79
3610,3,7207,2718,4489,0,0,0,1.0,1,1.0,1,1.0,1,0.10073033940706091,80
3611,3,7210,2719,4491,0,0,0,1.0,1,1.0,1,1.0,1,0.0899843785417579,80
3612,2,7212,2720,4492,0,0,0,1.0,1,1.0,1,1.0,1,0.11943770539061768,79
3613,10,7222,2721,4501,0,0,0,1.0,1,1.0,1,1.0,1,0.0958732973253379,79
3614,2,7224,2723,4501,0,0,0,1.0,1,1.0,1,1.0,1,0.13661292596626343,78
3615,2,7226,2723,4503,0,0,0,1.0,1,1.0,1,1.0,1,0.09920486025670329,79
3616,3,7229,2724,4505,0,0,0,1.0,1,1.0,1,1.0,1,0.0846144874273818,79
3617,1,7230,2725,4505,0,0,0,1.0,1,1.0,1,1.0,1,0.07928924233641321,80
3618,3,7233,2725,4508,0,0,0,1.0,1,1.0,1,1.0,1,0.08912147439336843,82
3619,4,7237,2726,4511,0,0,0,1.0,1,1.0,1,1.0,1,0.07992306467576576,82
3620,3,7240,2728,4512,0,0,0,1.0,1,1.0,1,1.0,1,0.09229528811202355,81
3621,0,7240,2728,4512,0,0,0,1.0,1,1.0,1,1.0,1,0.09430300051722115,83
3622,1,7241,2728,4513,0,0,0,1.0,1,1.0,1,1.0,1,0.07659865748158262,81
3623,1,7242,2729,4513,0,0,0,1.0,1,1.0,1,1.0,1,0.08707387684031173,81
3624,1,7243,2730,4513,0,0,0,1.0,1,1.0,1,1.0,1,0.0979012979503775,79
3625,6,7249,2732,4517,0,0,0,1.0,1,1.0,1,1.0,1,0.08421779333333312,80
3626,1,7250,2732,4518,0,0,0,1.0,1,1.0,1,1.0,1,0.07820389502554435,78
3627,3,7253,2733,4520,0,0,0,1.0,1,1.0,1,1.0,1,0.10069616423945528,78
3628,4,7257,2733,4524,0,0,0,1.0,1,1.0,1,1.0,1,0.0787153476482906,77
3629,0,7257,2733,4524,0,0,0,1.0,1,1.0,1,1.0,1,0.08562103483394494,76
3630,0,7257,2733,4524,0,0,0,1.0,1,1.0,1,1.0,1,0.08002790631519942,77
3631,2,7259,2734,4525,0,0,0,1.0,1,1.0,1,1.0,1,0.06765221728408856,75
3632,3,7262,2737,4525,0,0,0,1.0,1,1.0,1,1.0,1,0.1389940787371023,74
3633,4,7266,2738,4528,0,0,0,1.0,1,1.0,1,1.0,1,0.12421700806872453,75
3634,4,7270,2738,4532,0,0,0,1.0,1,1.0,1,1.0,1,0.09166169581774854,74
3635,1,7271,2739,4532,0,0,0,1.0,1,1.0,1,1.0,1,0.10235378237296161,74
3636,3,7274,2740,4534,0,0,0,1.0,1,1.0,1,1.0,1,0.10237534601122279,74
3637,4,7278,2740,4538,0,0,0,1.0,1,1.0,1,1.0,1,0.0968050436925973,74
3638,3,7281,2740,4541,0,0,0,1.0,1,1.0,1,1.0,1,0.08567838106162617,75
3639,2,7283,2742,4541,0,0,0,1.0,1,1.0,1,1.0,1,0.08950003419299184,76
3640,4,7287,2742,4545,0,0,0,1.0,1,1.0,1,1.0,1,0.056320639317901565,76
3641,3,7290,2744,4546,0,0,0,1.0,1,1.0,1,1.0,1,0.08449776008250819,75
3642,3,7293,2746,4547,0,0,0,1.0,1,1.0,1,1.0,1,0.10808263520093819,75
3643,2,7295,2746,4549,0,0,0,1.0,1,1.0,1,1.0,1,0.0912664363471311,74
3644,0,7295,2746,4549,0,0,0,1.0,1,1.0,1,1.0,1,0.0912664363471311,74
3645,1,7296,2746,4550,0,0,0,1.0,1,1.0,1,1.0,1,0.08851881042065966,74
3646,2,7298,2746,4552,0,0,0,1.0,1,1.0,1,1.0,1,0.06830964225902962,75
3647,1,7299,2746,4553,0,0,0,1.0,1,1.0,1,1.0,1,0.06931865828882948,77
3648,2,7301,2746,4555,0,0,0,1.0,1,1.0,1,1.0,1,0.08694788147033493,78
3649,3,7304,2746,4558,0,0,0,1.0,1,1.0,1,1.0,1,0.08230711487765541,80
3650,5,7309,2747,4562,0,0,0,1.0,1,1.0,1,1.0,1,0.0808612473580698,81
3651,2,7311,2747,4564,0,0,0,1.0,1,1.0,1,1.0,1,0.09157886904134119,81
3652,3,7314,2747,4567,0,0,0,1.0,1,1.0,1,1.0,1,0.08424742379669534,83
3653,0,7314,2747,4567,0,0,0,1.0,1,1.0,1,1.0,1,0.08424742379669534,83
3654,0,7314,2747,4567,0,0,0,1.0,1,1.0,1,1.0,1,0.08424742379669534,83
3655,1,7315,2747,4568,0,0,0,1.0,1,1.0,1,1.0,1,0.07192874865655981,84
3656,1,7316,2748,4568,0,0,0,1.0,1,1.0,1,1.0,1,0.08560335464396632,85
3657,4,7320,2749,4571,0,0,0,1.0,1,1.0,1,1.0,1,0.08697852406326599,86
3658,2,7322,2750,4572,0,0,0,1.0,1,1.0,1,1.0,1,0.09513638188499798,87
3659,0,7322,2750,4572,0,0,0,1.0,1,1.0,1,1.0,1,0.08893793933979557,87
3660,0,7322,2750,4572,0,0,0,1.0,1,1.0,1,1.0,1,0.09494690748452524,86
3661,3,7325,2751,4574,0,0,0,1.0,1,1.0,1,1.0,1,0.09749074093958282,86
3662,1,7326,2752,4574,0,0,0,1.0,1,1.0,1,1.0,1,0.11515104235515573,83
3663,5,7331,2757,4574,0,0,0,1.0,1,1.0,1,1.0,1,0.1594351168038004,85
3664,6,7337,2759,4578,0,0,0,1.0,1,1.0,1,1.0,1,0.1276584327346874,82
3665,4,7341,2759,4582,0,0,0,1.0,1,1.0,1,1.0,1,0.09695830388808167,81
3666,3,7344,2760,4584,0,0,0,1.0,1,1.0,1,1.0,1,0.11128912953452846,79
3667,3,7347,2760,4587,0,0,0,1.0,1,1.0,1,1.0,1,0.08998540321131328,79
3668,1,7348,2761,4587,0,0,0,1.0,1,1.0,1,1.0,1,0.10967201681814134,77
3669,1,7349,2762,4587,0,0,0,1.0,1,1.0,1,1.0,1,0.106212474055303,75
3670,5,7354,2764,4590,0,0,0,1.0,1,1.0,1,1.0,1,0.10712906899997736,76
3671,1,7355,2764,4591,0,0,0,1.0,1,1.0,1,1.0,1,0.09408331304873059,74
3672,1,7356,2765,4591,0,0,0,1.0,1,1.0,1,1.0,1,0.09288263592051127,75
3673,5,7361,2767,4594,0,0,0,1.0,1,1.0,1,1.0,1,0.11116151729109121,75
3674,3,7364,2769,4595,0,0,0,1.0,1,1.0,1,1.0,1,0.11790994884585651,75
3675,0,7364,2769,4595,0,0,0,1.0,1,1.0,1,1.0,1,0.11872142586575717,75
3676,3,7367,2770,4597,0,0,0,1.0,1,1.0,1,1.0,1,0.11242549740046602,75
3677,0,7367,2770,4597,0,0,0,1.0,1,1.0,1,1.0,1,0.12163871297723071,75
3678,3,7370,2771,4599,0,0,0,1.0,1,1.0,1,1.0,1,0.11635648668496396,77
3679,2,7372,2772,4600,0,0,0,1.0,1,1.0,1,1.0,1,0.13704946953953026,78
3680,1,7373,2772,4601,0,0,0,1.0,1,1.0,1,1.0,1,0.1362498908089063,80
3681,0,7373,2772,4601,0,0,0,1.0,1,1.0,1,1.0,1,0.13795558882489803,81
3682,0,7373,2772,4601,0,0,0,1.0,1,1.0,1,1.0,1,0.13795558882489803,81
3683,2,7375,2773,4602,0,0,0,1.0,1,1.0,1,1.0,1,0.14486680604677776,81
3684,0,7375,2773,4602,0,0,0,1.0,1,1.0,1,1.0,1,0.14486680604677776,81
3685,0,7375,2773,4602,0,0,0,1.0,1,1.0,1,1.0,1,0.14486680604677776,81
3686,0,7375,2773,4602,0,0,0,1.0,1,1.0,1,1.0,1,0.14486680604677776,81
3687,1,7376,2773,4603,0,0,0,1.0,1,1.0,1,1.0,1,0.13060114706678483,82
3688,2,7378,2773,4605,0,0,0,1.0,1,1.0,1,1.0,1,0.12763451558583488,84
3689,0,7378,2773,4605,0,0,0,1.0,1,1.0,1,1.0,1,0.12763451558583488,84
3690,2,7380,2775,4605,0,0,0,1.0,1,1.0,1,1.0,1,0.14736711306192057,85
3691,2,7382,2775,4607,0,0,0,1.0,1,1.0,1,1.0,1,0.13047407938879194,86
3692,0,7382,2775,4607,0,0,0,1.0,1,1.0,1,1.0,1,0.12274126306594565,86
3693,1,7383,2775,4608,0,0,0,1.0,1,1.0,1,1.0,1,0.11924265668104266,86
3694,0,7383,2775,4608,0,0,0,1.0,1,1.0,1,1.0,1,0.11924265668104266,86
3695,1,7384,2776,4608,0,0,0,1.0,1,1.0,1,1.0,1,0.13592127432141926,86
3696,0,7384,2776,4608,0,0,0,1.0,1,1.0,1,1.0,1,0.12212880256457544,87
3697,0,7384,2776,4608,0,0,0,1.0,1,1.0,1,1.0,1,0.11999836194351478,85
3698,0,7384,2776,4608,0,0,0,1.0,1,1.0,1,1.0,1,0.11919665315323777,85
3699,1,7385,2777,4608,0,0,0,1.0,1,1.0,1,1.0,1,0.1163400522708554,85
3700,7,7392,2781,4611,0,0,0,1.0,1,1.0,1,1.0,1,0.13656024870129738,84
3701,4,7396,2782,4614,0,0,0,1.0,1,1.0,1,1.0,1,0.1566494680910557,85
3702,7,7403,2784,4619,0,0,0,1.0,1,1.0,1,1.0,1,0.14863536563388446,85
3703,1,7404,2784,4620,0,0,0,1.0,1,1.0,1,1.0,1,0.13931208804046927,85
3704,2,7406,2784,4622,0,0,0,1.0,1,1.0,1,1.0,1,0.12939735651729042,85
3705,0,7406,2784,4622,0,0,0,1.0,1,1.0,1,1.0,1,0.1231062843162061,86
3706,1,7407,2785,4622,0,0,0,1.0,1,1.0,1,1.0,1,0.12403124084906396,86
3707,2,7409,2787,4622,0,0,0,1.0,1,1.0,1,1.0,1,0.14279951009902692,85
3708,1,7410,2787,4623,0,0,0,1.0,1,1.0,1,1.0,1,0.13667084036626317,84
3709,1,7411,2787,4624,0,0,0,1.0,1,1.0,1,1.0,1,0.1374162427675587,85
3710,0,7411,2787,4624,0,0,0,1.0,1,1.0,1,1.0,1,0.1335718667208441,84
3711,1,7412,2787,4625,0,0,0,1.0,1,1.0,1,1.0,1,0.12753302243324224,85
3712,3,7415,2787,4628,0,0,0,1.0,1,1.0,1,1.0,1,0.10915556909006134,85
3713,0,7415,2787,4628,0,0,0,1.0,1,1.0,1,1.0,1,0.10915556909006134,85
3714,3,7418,2788,4630,0,0,0,1.0,1,1.0,1,1.0,1,0.1219716392290838,85
3715,2,7420,2789,4631,0,0,0,1.0,1,1.0,1,1.0,1,0.11748908720942382,85
3716,2,7422,2790,4632,0,0,0,1.0,1,1.0,1,1.0,1,0.11830069670131814,84
3717,0,7422,2790,4632,0,0,0,1.0,1,1.0,1,1.0,1,0.12232896691031861,86
3718,3,7425,2791,4634,0,0,0,1.0,1,1.0,1,1.0,1,0.13793437811117232,85
3719,4,7429,2793,4636,0,0,0,1.0,1,1.0,1,1.0,1,0.1323940114117727,84
3720,2,7431,2793,4638,0,0,0,1.0,1,1.0,1,1.0,1,0.13745067414484188,84
3721,7,7438,2796,4642,0,0,0,1.0,1,1.0,1,1.0,1,0.1285722570365182,85
3722,1,7439,2796,4643,0,0,0,1.0,1,1.0,1,1.0,1,0.12423990451490108,85
3723,1,7440,2796,4644,0,0,0,1.0,1,1.0,1,1.0,1,0.1312089564263717,85
3724,3,7443,2796,4647,0,0,0,1.0,1,1.0,1,1.0,1,0.11173953561274483,86
3725,1,7444,2797,4647,0,0,0,1.0,1,1.0,1,1.0,1,0.1186386572824219,86
3726,0,7444,2797,4647,0,0,0,1.0,1,1.0,1,1.0,1,0.1186386572824219,86
3727,1,7445,2797,4648,0,0,0,1.0,1,1.0,1,1.0,1,0.10662012154295322,86
3728,2,7447,2799,4648,0,0,0,1.0,1,1.0,1,1.0,1,0.13530844255918006,86
3729,2,7449,2800,4649,0,0,0,1.0,1,1.0,1,1.0,1,0.14778420454645422,86
3730,2,7451,2800,4651,0,0,0,1.0,1,1.0,1,1.0,1,0.14745988409578556,85
3731,1,7452,2800,4652,0,0,0,1.0,1,1.0,1,1.0,1,0.14780540981217818,86
3732,0,7452,2800,4652,0,0,0,1.0,1,1.0,1,1.0,1,0.14349451048804354,87
3733,1,7453,2801,4652,0,0,0,1.0,1,1.0,1,1.0,1,0.16847092932088645,87
3734,1,7454,2801,4653,0,0,0,1.0,1,1.0,1,1.0,1,0.1652358837714438,87
3735,4,7458,2802,4656,0,0,0,1.0,1,1.0,1,1.0,1,0.15354476323851862,86
3736,1,7459,2802,4657,0,0,0,1.0,1,1.0,1,1.0,1,0.137834065404638,87
3737,1,7460,2803,4657,0,0,0,1.0,1,1.0,1,1.0,1,0.1397768785284238,87
3738,4,7464,2804,4660,0,0,0,1.0,1,1.0,1,1.0,1,0.1355751166302513,87
3739,3,7467,2804,4663,0,0,0,1.0,1,1.0,1,1.0,1,0.11231910611352475,88
3740,3,7470,2805,4665,0,0,0,1.0,1,1.0,1,1.0,1,0.12752901256367705,87
3741,4,7474,2805,4669,0,0,0,1.0,1,1.0,1,1.0,1,0.1215973010560715,87
3742,4,7478,2806,4672,0,0,0,1.0,1,1.0,1,1.0,1,0.0923341018108605,86
3743,0,7478,2806,4672,0,0,0,1.0,1,1.0,1,1.0,1,0.10780206314682651,84
3744,2,7480,2807,4673,0,0,0,1.0,1,1.0,1,1.0,1,0.1256750830200132,83
3745,3,7483,2807,4676,0,0,0,1.0,1,1.0,1,1.0,1,0.10910486814384364,83
3746,2,7485,2808,4677,0,0,0,1.0,1,1.0,1,1.0,1,0.1356706275721923,83
3747,3,7488,2810,4678,0,0,0,1.0,1,1.0,1,1.0,1,0.13551218370975546,81
3748,5,7493,2810,4683,0,0,0,1.0,1,1.0,1,1.0,1,0.10354877966258158,81
3749,1,7494,2810,4684,0,0,0,1.0,1,1.0,1,1.0,1,0.11102493509935435,80
3750,0,7494,2810,4684,0,0,0,1.0,1,1.0,1,1.0,1,0.1214755599133636,79
3751,5,7499,2813,4686,0,0,0,1.0,1,1.0,1,1.0,1,0.1415764035138871,80
3752,2,7501,2814,4687,0,0,0,1.0,1,1.0,1,1.0,1,0.1499617992901556,80
3753,5,7506,2817,4689,0,0,0,1.0,1,1.0,1,1.0,1,0.156245037307837,81
3754,4,7510,2818,4692,0,0,0,1.0,1,1.0,1,1.0,1,0.1519872363987134,81
3755,5,7515,2819,4696,0,0,0,1.0,1,1.0,1,1.0,1,0.15215532676480845,80
3756,1,7516,2819,4697,0,0,0,1.0,1,1.0,1,1.0,1,0.15868649221907877,79
3757,2,7518,2819,4699,0,0,0,1.0,1,1.0,1,1.0,1,0.15882253579193326,80
3758,2,7520,2820,4700,0,0,0,1.0,1,1.0,1,1.0,1,0.1624376151948484,79
3759,2,7522,2822,4700,0,0,0,1.0,1,1.0,1,1.0,1,0.20214045483155907,79
3760,2,7524,2822,4702,0,0,0,1.0,1,1.0,1,1.0,1,0.18207917808796048,79
3761,0,7524,2822,4702,0,0,0,1.0,1,1.0,1,1.0,1,0.19944725019225176,78
3762,1,7525,2822,4703,0,0,0,1.0,1,1.0,1,1.0,1,0.19465737084053278,80
3763,1,7526,2822,4704,0,0,0,1.0,1,1.0,1,1.0,1,0.19160479958933693,80
3764,1,7527,2823,4704,0,0,0,1.0,1,1.0,1,1.0,1,0.20687601747721351,80
3765,3,7530,2823,4707,0,0,0,1.0,1,1.0,1,1.0,1,0.1996302618145324,81
3766,8,7538,2824,4714,0,0,0,1.0,1,1.0,1,1.0,1,0.1837733839685319,83
3767,1,7539,2825,4714,0,0,0,1.0,1,1.0,1,1.0,1,0.1776042305098178,83
3768,3,7542,2825,4717,0,0,0,1.0,1,1.0,1,1.0,1,0.17719077614730033,84
3769,5,7547,2825,4722,0,0,0,1.0,1,1.0,1,1.0,1,0.12521202867710157,86
3770,1,7548,2825,4723,0,0,0,1.0,1,1.0,1,1.0,1,0.11344081921522473,87
3771,1,7549,2826,4723,0,0,0,1.0,1,1.0,1,1.0,1,0.11666145951912694,87
3772,2,7551,2826,4725,0,0,0,1.0,1,1.0,1,1.0,1,0.1205820547625276,88
3773,0,7551,2826,4725,0,0,0,1.0,1,1.0,1,1.0,1,0.12956146729701407,85
3774,2,7553,2827,4726,0,0,0,1.0,1,1.0,1,1.0,1,0.12318083808163412,85
3775,2,7555,2828,4727,0,0,0,1.0,1,1.0,1,1.0,1,0.14377895778266248,83
3776,5,7560,2830,4730,0,0,0,1.0,1,1.0,1,1.0,1,0.1550992245806998,82
3777,1,7561,2830,4731,0,0,0,1.0,1,1.0,1,1.0,1,0.13779180029929686,81
3778,3,7564,2830,4734,0,0,0,1.0,1,1.0,1,1.0,1,0.12859492394982575,81
3779,2,7566,2832,4734,0,0,0,1.0,1,1.0,1,1.0,1,0.15127870158891743,80
3780,1,7567,2832,4735,0,0,0,1.0,1,1.0,1,1.0,1,0.1416921597691898,80
3781,1,7568,2832,4736,0,0,0,1.0,1,1.0,1,1.0,1,0.13957386204919947,80
3782,0,7568,2832,4736,0,0,0,1.0,1,1.0,1,1.0,1,0.13957386204919947,80
3783,0,7568,2832,4736,0,0,0,1.0,1,1.0,1,1.0,1,0.14072989683476686,80
3784,2,7570,2833,4737,0,0,0,1.0,1,1.0,1,1.0,1,0.14341014129369142,79
3785,3,7573,2834,4739,0,0,0,1.0,1,1.0,1,1.0,1,0.16960486021620425,77
3786,0,7573,2834,4739,0,0,0,1.0,1,1.0,1,1.0,1,0.15985475821922882,78
3787,3,7576,2835,4741,0,0,0,1.0,1,1.0,1,1.0,1,0.17470749521140802,77
3788,5,7581,2837,4744,0,0,0,1.0,1,1.0,1,1.0,1,0.1778965605583662,78
3789,3,7584,2839,4745,0,0,0,1.0,1,1.0,1,1.0,1,0.204546914582925,77
3790,6,7590,2840,4750,0,0,0,1.0,1,1.0,1,1.0,1,0.172379132563428,77
3791,1,7591,2841,4750,0,0,0,1.0,1,1.0,1,1.0,1,0.1799293000537641,77
3792,1,7592,2841,4751,0,0,0,1.0,1,1.0,1,1.0,1,0.1560435640262679,78
3793,1,7593,2841,4752,0,0,0,1.0,1,1.0,1,1.0,1,0.14147807969367118,80
3794,3,7596,2841,4755,0,0,0,1.0,1,1.0,1,1.0,1,0.13378980413397795,82
3795,2,7598,2841,4757,0,0,0,1.0,1,1.0,1,1.0,1,0.13404992914396494,83
3796,4,7602,2842,4760,0,0,0,1.0,1,1.0,1,1.0,1,0.10766200321146947,83
3797,4,7606,2842,4764,0,0,0,1.0,1,1.0,1,1.0,1,0.10836120766956897,82
3798,1,7607,2842,4765,0,0,0,1.0,1,1.0,1,1.0,1,0.11965925855718194,82
3799,2,7609,2842,4767,0,0,0,1.0,1,1.0,1,1.0,1,0.11863792761698744,83
3800,3,7612,2843,4769,0,0,0,1.0,1,1.0,1,1.0,1,0.12376857143157304,83
3801,0,7612,2843,4769,0,0,0,1.0,1,1.0,1,1.0,1,0.12376857143157304,83
3802,4,7616,2843,4773,0,0,0,1.0,1,1.0,1,1.0,1,0.1062776110054238,82
3803,0,7616,2843,4773,0,0,0,1.0,1,1.0,1,1.0,1,0.11315083660390625,84
3804,1,7617,2843,4774,0,0,0,1.0,1,1.0,1,1.0,1,0.09962151310197027,84
3805,3,7620,2844,4776,0,0,0,1.0,1,1.0,1,1.0,1,0.13257735970486131,86
3806,2,7622,2844,4778,0,0,0,1.0,1,1.0,1,1.0,1,0.12230621904481372,86
3807,1,7623,2845,4778,0,0,0,1.0,1,1.0,1,1.0,1,0.14168611541088919,86
3808,3,7626,2845,4781,0,0,0,1.0,1,1.0,1,1.0,1,0.12886959541111245,85
3809,3,7629,2846,4783,0,0,0,1.0,1,1.0,1,1.0,1,0.13231576299708944,85
3810,0,7629,2846,4783,0,0,0,1.0,1,1.0,1,1.0,1,0.13231576299708944,85
3811,4,7633,2847,4786,0,0,0,1.0,1,1.0,1,1.0,1,0.1285747332986805,84
3812,2,7635,2849,4786,0,0,0,1.0,1,1.0,1,1.0,1,0.14637855922128878,83
3813,3,7638,2849,4789,0,0,0,1.0,1,1.0,1,1.0,1,0.11280386316046534,82
3814,6,7644,2850,4794,0,0,0,1.0,1,1.0,1,1.0,1,0.1295303596648052,81
3815,3,7647,2850,4797,0,0,0,1.0,1,1.0,1,1.0,1,0.14555777444493218,82
3816,3,7650,2850,4800,0,0,0,1.0,1,1.0,1,1.0,1,0.11097063086307046,81
3817,2,7652,2851,4801,0,0,0,1.0,1,1.0,1,1.0,1,0.10330288039328311,81
3818,2,7654,2853,4801,0,0,0,1.0,1,1.0,1,1.0,1,0.15083015207166303,81
3819,6,7660,2855,4805,0,0,0,1.0,1,1.0,1,1.0,1,0.16634600756821158,82
3820,4,7664,2855,4809,0,0,0,1.0,1,1.0,1,1.0,1,0.1520092589001109,84
3821,1,7665,2855,4810,0,0,0,1.0,1,1.0,1,1.0,1,0.14887899020719128,84
3822,1,7666,2855,4811,0,0,0,1.0,1,1.0,1,1.0,1,0.1377695732309561,82
3823,8,7674,2858,4816,0,0,0,1.0,1,1.0,1,1.0,1,0.15478001757935467,81
3824,2,7676,2858,4818,0,0,0,1.0,1,1.0,1,1.0,1,0.16809260031109036,78
3825,1,7677,2858,4819,0,0,0,1.0,1,1.0,1,1.0,1,0.17791784901305185,76
3826,4,7681,2859,4822,0,0,0,1.0,1,1.0,1,1.0,1,0.17232760238228695,76
3827,1,7682,2859,4823,0,0,0,1.0,1,1.0,1,1.0,1,0.1728254973600093,75
3828,1,7683,2860,4823,0,0,0,1.0,1,1.0,1,1.0,1,0.1758343809377971,74
3829,6,7689,2861,4828,0,0,0,1.0,1,1.0,1,1.0,1,0.17097858266924554,74
3830,2,7691,2862,4829,0,0,0,1.0,1,1.0,1,1.0,1,0.14713686419985036,74
3831,3,7694,2864,4830,0,0,0,1.0,1,1.0,1,1.0,1,0.18510878125112532,74
3832,6,7700,2865,4835,0,0,0,1.0,1,1.0,1,1.0,1,0.158584137683452,73
3833,3,7703,2868,4835,0,0,0,1.0,1,1.0,1,1.0,1,0.1774682872681583,73
3834,5,7708,2869,4839,0,0,0,1.0,1,1.0,1,1.0,1,0.1760138074991901,74
3835,6,7714,2870,4844,0,0,0,1.0,1,1.0,1,1.0,1,0.15548524335920103,75
3836,2,7716,2870,4846,0,0,0,1.0,1,1.0,1,1.0,1,0.1392947209604796,75
3837,2,7718,2871,4847,0,0,0,1.0,1,1.0,1,1.0,1,0.1640012877964005,78
3838,6,7724,2872,4852,0,0,0,1.0,1,1.0,1,1.0,1,0.13502896300000977,78
3839,3,7727,2872,4855,0,0,0,1.0,1,1.0,1,1.0,1,0.11224094669226752,79
3840,2,7729,2873,4856,0,0,0,1.0,1,1.0,1,1.0,1,0.12217239597352457,82
3841,2,7731,2873,4858,0,0,0,1.0,1,1.0,1,1.0,1,0.10124611126043641,82
3842,0,7731,2873,4858,0,0,0,1.0,1,1.0,1,1.0,1,0.09966664356602224,82
3843,1,7732,2873,4859,0,0,0,1.0,1,1.0,1,1.0,1,0.08649633821794837,82
3844,0,7732,2873,4859,0,0,0,1.0,1,1.0,1,1.0,1,0.0853135063529504,83
3845,2,7734,2873,4861,0,0,0,1.0,1,1.0,1,1.0,1,0.0917083150201897,84
3846,2,7736,2873,4863,0,0,0,1.0,1,1.0,1,1.0,1,0.08828220098878543,85
3847,3,7739,2873,4866,0,0,0,1.0,1,1.0,1,1.0,1,0.08352731209848527,84
3848,1,7740,2874,4866,0,0,0,1.0,1,1.0,1,1.0,1,0.09953770014554578,84
3849,1,7741,2874,4867,0,0,0,1.0,1,1.0,1,1.0,1,0.09475266135573743,83
3850,1,7742,2874,4868,0,0,0,1.0,1,1.0,1,1.0,1,0.09644776492188256,80
3851,1,7743,2874,4869,0,0,0,1.0,1,1.0,1,1.0,1,0.08456880379273284,80
3852,1,7744,2874,4870,0,0,0,1.0,1,1.0,1,1.0,1,0.09873568912710712,79
3853,0,7744,2874,4870,0,0,0,1.0,1,1.0,1,1.0,1,0.09873568912710712,79
3854,2,7746,2876,4870,0,0,0,1.0,1,1.0,1,1.0,1,0.12960415283508347,78
3855,1,7747,2877,4870,0,0,0,1.0,1,1.0,1,1.0,1,0.14694543009160435,78
3856,5,7752,2878,4874,0,0,0,1.0,1,1.0,1,1.0,1,0.12541969016413085,80
3857,1,7753,2878,4875,0,0,0,1.0,1,1.0,1,1.0,1,0.12004300354156125,81
3858,1,7754,2879,4875,0,0,0,1.0,1,1.0,1,1.0,1,0.12229529376260768,81
3859,5,7759,2879,4880,0,0,0,1.0,1,1.0,1,1.0,1,0.11843944464396028,83
3860,6,7765,2880,4885,0,0,0,1.0,1,1.0,1,1.0,1,0.1332317377159004,82
3861,6,7771,2880,4891,0,0,0,1.0,1,1.0,1,1.0,1,0.13779409841146315,84
3862,3,7774,2881,4893,0,0,0,1.0,1,1.0,1,1.0,1,0.1340833296615958,85
3863,1,7775,2881,4894,0,0,0,1.0,1,1.0,1,1.0,1,0.11967653304399886,84
3864,1,7776,2882,4894,0,0,0,1.0,1,1.0,1,1.0,1,0.11557747779970493,83
3865,0,7776,2882,4894,0,0,0,1.0,1,1.0,1,1.0,1,0.11350201086004233,82
3866,0,7776,2882,4894,0,0,0,1.0,1,1.0,1,1.0,1,0.11382319505994465,81
3867,2,7778,2884,4894,0,0,0,1.0,1,1.0,1,1.0,1,0.11594088538596219,81
3868,6,7784,2885,4899,0,0,0,1.0,1,1.0,1,1.0,1,0.09883956883501399,81
3869,3,7787,2886,4901,0,0,0,1.0,1,1.0,1,1.0,1,0.10118269763054334,81
3870,2,7789,2886,4903,0,0,0,1.0,1,1.0,1,1.0,1,0.0904358209149462,80
3871,2,7791,2887,4904,0,0,0,1.0,1,1.0,1,1.0,1,0.08650785742974246,82
3872,2,7793,2888,4905,0,0,0,1.0,1,1.0,1,1.0,1,0.09757567336791126,81
3873,1,7794,2888,4906,0,0,0,1.0,1,1.0,1,1.0,1,0.0934627812919034,81
3874,2,7796,2889,4907,0,0,0,1.0,1,1.0,1,1.0,1,0.08775859623337412,78
3875,0,7796,2889,4907,0,0,0,1.0,1,1.0,1,1.0,1,0.09015240406953355,77
3876,3,7799,2889,4910,0,0,0,1.0,1,1.0,1,1.0,1,0.06986272072412376,78
3877,2,7801,2889,4912,0,0,0,1.0,1,1.0,1,1.0,1,0.09327898336899479,75
3878,2,7803,2891,4912,0,0,0,1.0,1,1.0,1,1.0,1,0.08995559302298602,75
3879,1,7804,2891,4913,0,0,0,1.0,1,1.0,1,1.0,1,0.10379369273565166,73
3880,1,7805,2891,4914,0,0,0,1.0,1,1.0,1,1.0,1,0.08192714477231805,74
3881,2,7807,2891,4916,0,0,0,1.0,1,1.0,1,1.0,1,0.07772487344992686,75
3882,4,7811,2891,4920,0,0,0,1.0,1,1.0,1,1.0,1,0.07413739525560406,76
3883,1,7812,2891,4921,0,0,0,1.0,1,1.0,1,1.0,1,0.06787288433321527,77
3884,5,7817,2893,4924,0,0,0,1.0,1,1.0,1,1.0,1,0.08339523149275432,78
3885,1,7818,2893,4925,0,0,0,1.0,1,1.0,1,1.0,1,0.07123441938618623,78
3886,4,7822,2895,4927,0,0,0,1.0,1,1.0,1,1.0,1,0.07894589020566424,79
3887,2,7824,2896,4928,0,0,0,1.0,1,1.0,1,1.0,1,0.09818912369060266,78
3888,6,7830,2898,4932,0,0,0,1.0,1,1.0,1,1.0,1,0.11057146314169926,80
3889,9,7839,2899,4940,0,0,0,1.0,1,1.0,1,1.0,1,0.07280043717794327,82
3890,4,7843,2900,4943,0,0,0,1.0,1,1.0,1,1.0,1,0.07772044491038894,82
3891,3,7846,2901,4945,0,0,0,1.0,1,1.0,1,1.0,1,0.0808881357424401,85
3892,10,7856,2904,4952,0,0,0,1.0,1,1.0,1,1.0,1,0.08219463847184323,87
3893,1,7857,2904,4953,0,0,0,1.0,1,1.0,1,1.0,1,0.07185292722753729,86
3894,0,7857,2904,4953,0,0,0,1.0,1,1.0,1,1.0,1,0.07815929190417381,87
3895,6,7863,2906,4957,0,0,0,1.0,1,1.0,1,1.0,1,0.05868279794790892,87
3896,0,7863,2906,4957,0,0,0,1.0,1,1.0,1,1.0,1,0.0633015056732598,85
3897,1,7864,2907,4957,0,0,0,1.0,1,1.0,1,1.0,1,0.06644077445265877,85
3898,3,7867,2908,4959,0,0,0,1.0,1,1.0,1,1.0,1,0.09161665984275252,86
3899,1,7868,2909,4959,0,0,0,1.0,1,1.0,1,1.0,1,0.09958611758352147,86
3900,1,7869,2909,4960,0,0,0,1.0,1,1.0,1,1.0,1,0.09429417218203151,86
3901,4,7873,2911,4962,0,0,0,1.0,1,1.0,1,1.0,1,0.0957577288591232,86
3902,3,7876,2912,4964,0,0,0,1.0,1,1.0,1,1.0,1,0.09347427119623333,87
3903,2,7878,2914,4964,0,0,0,1.0,1,1.0,1,1.0,1,0.11952067947271881,87
3904,6,7884,2916,4968,0,0,0,1.0,1,1.0,1,1.0,1,0.09782582868499051,85
3905,2,7886,2917,4969,0,0,0,1.0,1,1.0,1,1.0,1,0.07961474875212239,84
3906,1,7887,2917,4970,0,0,0,1.0,1,1.0,1,1.0,1,0.0708334575516091,86
3907,1,7888,2917,4971,0,0,0,1.0,1,1.0,1,1.0,1,0.06578034054393551,84
3908,1,7889,2918,4971,0,0,0,1.0,1,1.0,1,1.0,1,0.07243957272469066,83
3909,3,7892,2920,4972,0,0,0,1.0,1,1.0,1,1.0,1,0.08247439381883291,81
3910,6,7898,2923,4975,0,0,0,1.0,1,1.0,1,1.0,1,0.055382534819292825,82
3911,2,7900,2925,4975,0,0,0,1.0,1,1.0,1,1.0,1,0.06110368942489428,81
3912,2,7902,2926,4976,0,0,0,1.0,1,1.0,1,1.0,1,0.06814881721555041,80
3913,4,7906,2929,4977,0,0,0,1.0,1,1.0,1,1.0,1,0.11374889232500157,80
3914,5,7911,2930,4981,0,0,0,1.0,1,1.0,1,1.0,1,0.09394900155218527,81
3915,4,7915,2933,4982,0,0,0,1.0,1,1.0,1,1.0,1,0.11113073043108845,81
3916,5,7920,2934,4986,0,0,0,1.0,1,1.0,1,1.0,1,0.10551227446088324,81
3917,4,7924,2935,4989,0,0,0,1.0,1,1.0,1,1.0,1,0.09820695794929919,82
3918,4,7928,2936,4992,0,0,0,1.0,1,1.0,1,1.0,1,0.090476024232882,85
3919,4,7932,2938,4994,0,0,0,1.0,1,1.0,1,1.0,1,0.05881579322157077,85
3920,1,7933,2939,4994,0,0,0,1.0,1,1.0,1,1.0,1,0.06193199429400471,85
3921,2,7935,2940,4995,0,0,0,1.0,1,1.0,1,1.0,1,0.0678474578347009,88
3922,1,7936,2941,4995,0,0,0,1.0,1,1.0,1,1.0,1,0.07534597218360238,88
3923,1,7937,2941,4996,0,0,0,1.0,1,1.0,1,1.0,1,0.06506082588360514,89
3924,1,7938,2941,4997,0,0,0,1.0,1,1.0,1,1.0,1,0.06415855245755438,90
3925,1,7939,2942,4997,0,0,0,1.0,1,1.0,1,1.0,1,0.06997061520987227,88
3926,2,7941,2943,4998,0,0,0,1.0,1,1.0,1,1.0,1,0.0743476224543663,89
3927,0,7941,2943,4998,0,0,0,1.0,1,1.0,1,1.0,1,0.08285740792201039,89
3928,2,7943,2943,5000,0,0,0,1.0,1,1.0,1,1.0,1,0.08044246779646613,88
3929,1,7944,2944,5000,0,0,0,1.0,1,1.0,1,1.0,1,0.0999609988066442,88
3930,0,7944,2944,5000,0,0,0,1.0,1,1.0,1,1.0,1,0.10577926046033305,87
3931,8,7952,2946,5006,0,0,0,1.0,1,1.0,1,1.0,1,0.08126876098021156,86
3932,2,7954,2947,5007,0,0,0,1.0,1,1.0,1,1.0,1,0.08156725712820459,85
3933,0,7954,2947,5007,0,0,0,1.0,1,1.0,1,1.0,1,0.08802576722671668,84
3934,3,7957,2947,5010,0,0,0,1.0,1,1.0,1,1.0,1,0.08783932961206113,85
3935,3,7960,2949,5011,0,0,0,1.0,1,1.0,1,1.0,1,0.10768560540604857,84
3936,6,7966,2950,5016,0,0,0,1.0,1,1.0,1,1.0,1,0.10475384591010146,84
3937,5,7971,2951,5020,0,0,0,1.0,1,1.0,1,1.0,1,0.10436379415065324,82
3938,2,7973,2952,5021,0,0,0,1.0,1,1.0,1,1.0,1,0.0972476267705684,82
3939,0,7973,2952,5021,0,0,0,1.0,1,1.0,1,1.0,1,0.10004686773458292,84
3940,5,7978,2954,5024,0,0,0,1.0,1,1.0,1,1.0,1,0.08329066851734593,84
3941,2,7980,2954,5026,0,0,0,1.0,1,1.0,1,1.0,1,0.06324532199719263,85
3942,1,7981,2955,5026,0,0,0,1.0,1,1.0,1,1.0,1,0.0785529763366879,85
3943,3,7984,2955,5029,0,0,0,1.0,1,1.0,1,1.0,1,0.053672429526524304,84
3944,2,7986,2956,5030,0,0,0,1.0,1,1.0,1,1.0,1,0.07698113418362156,83
3945,1,7987,2957,5030,0,0,0,1.0,1,1.0,1,1.0,1,0.08385496874364438,83
3946,7,7994,2959,5035,0,0,0,1.0,1,1.0,1,1.0,1,0.08912628773428247,83
3947,0,7994,2959,5035,0,0,0,1.0,1,1.0,1,1.0,1,0.08912628773428247,83
3948,4,7998,2960,5038,0,0,0,1.0,1,1.0,1,1.0,1,0.10045522618528076,84
3949,5,8003,2960,5043,0,0,0,1.0,1,1.0,1,1.0,1,0.0893824763060742,84
3950,1,8004,2961,5043,0,0,0,1.0,1,1.0,1,1.0,1,0.10140103071826895,86
3951,2,8006,2961,5045,0,0,0,1.0,1,1.0,1,1.0,1,0.09652479413767391,87
3952,3,8009,2961,5048,0,0,0,1.0,1,1.0,1,1.0,1,0.07460758936023965,86
3953,2,8011,2962,5049,0,0,0,1.0,1,1.0,1,1.0,1,0.08554317929767158,86
3954,0,8011,2962,5049,0,0,0,1.0,1,1.0,1,1.0,1,0.07769226006799317,85
3955,4,8015,2962,5053,0,0,0,1.0,1,1.0,1,1.0,1,0.07323938190637709,85
3956,0,8015,2962,5053,0,0,0,1.0,1,1.0,1,1.0,1,0.07980717606133297,84
3957,0,8015,2962,5053,0,0,0,1.0,1,1.0,1,1.0,1,0.08783451428604286,85
3958,4,8019,2962,5057,0,0,0,1.0,1,1.0,1,1.0,1,0.06127109662562134,84
3959,1,8020,2963,5057,0,0,0,1.0,1,1.0,1,1.0,1,0.07252613226038153,83
3960,3,8023,2965,5058,0,0,0,1.0,1,1.0,1,1.0,1,0.10447431801268817,84
3961,3,8026,2966,5060,0,0,0,1.0,1,1.0,1,1.0,1,0.10570748198223831,83
3962,1,8027,2967,5060,0,0,0,1.0,1,1.0,1,1.0,1,0.10794926706881285,84
3963,0,8027,2967,5060,0,0,0,1.0,1,1.0,1,1.0,1,0.09934080095518633,81
3964,6,8033,2970,5063,0,0,0,1.0,1,1.0,1,1.0,1,0.11503878537073581,81
3965,3,8036,2970,5066,0,0,0,1.0,1,1.0,1,1.0,1,0.0977523875353554,81
3966,2,8038,2972,5066,0,0,0,1.0,1,1.0,1,1.0,1,0.10165031410104325,79
3967,5,8043,2973,5070,0,0,0,1.0,1,1.0,1,1.0,1,0.07906998980884113,81
3968,0,8043,2973,5070,0,0,0,1.0,1,1.0,1,1.0,1,0.09128306959919971,79
3969,3,8046,2976,5070,0,0,0,1.0,1,1.0,1,1.0,1,0.10528776851077447,79
3970,3,8049,2978,5071,0,0,0,1.0,1,1.0,1,1.0,1,0.11438454792100172,78
3971,0,8049,2978,5071,0,0,0,1.0,1,1.0,1,1.0,1,0.11535869339760775,77
3972,1,8050,2979,5071,0,0,0,1.0,1,1.0,1,1.0,1,0.12106712239109226,78
3973,2,8052,2979,5073,0,0,0,1.0,1,1.0,1,1.0,1,0.11374576735074218,77
3974,1,8053,2979,5074,0,0,0,1.0,1,1.0,1,1.0,1,0.10492451925398961,77
3975,3,8056,2981,5075,0,0,0,1.0,1,1.0,1,1.0,1,0.1242638233647993,76
3976,2,8058,2981,5077,0,0,0,1.0,1,1.0,1,1.0,1,0.11268557531525669,77
3977,0,8058,2981,5077,0,0,0,1.0,1,1.0,1,1.0,1,0.120720334665915,78
3978,3,8061,2982,5079,0,0,0,1.0,1,1.0,1,1.0,1,0.1403277635421656,79
3979,3,8064,2982,5082,0,0,0,1.0,1,1.0,1,1.0,1,0.12603501017740332,79
3980,2,8066,2983,5083,0,0,0,1.0,1,1.0,1,1.0,1,0.11956770688673742,79
3981,3,8069,2984,5085,0,0,0,1.0,1,1.0,1,1.0,1,0.13541727325209005,83
3982,4,8073,2984,5089,0,0,0,1.0,1,1.0,1,1.0,1,0.10498317602900978,83
3983,2,8075,2984,5091,0,0,0,1.0,1,1.0,1,1.0,1,0.11470774780788551,82
3984,3,8078,2984,5094,0,0,0,1.0,1,1.0,1,1.0,1,0.10729122584659158,83
3985,6,8084,2986,5098,0,0,0,1.0,1,1.0,1,1.0,1,0.10335010781372063,84
3986,5,8089,2988,5101,0,0,0,1.0,1,1.0,1,1.0,1,0.11714818462030817,83
3987,1,8090,2988,5102,0,0,0,1.0,1,1.0,1,1.0,1,0.11601940764069668,82
3988,5,8095,2989,5106,0,0,0,1.0,1,1.0,1,1.0,1,0.10604908952766806,83
3989,0,8095,2989,5106,0,0,0,1.0,1,1.0,1,1.0,1,0.11774298969365067,81
3990,1,8096,2989,5107,0,0,0,1.0,1,1.0,1,1.0,1,0.10618050645838151,81
3991,3,8099,2990,5109,0,0,0,1.0,1,1.0,1,1.0,1,0.11451719127570488,79
3992,0,8099,2990,5109,0,0,0,1.0,1,1.0,1,1.0,1,0.10717316823537688,81
3993,2,8101,2991,5110,0,0,0,1.0,1,1.0,1,1.0,1,0.10298134055868681,80
3994,1,8102,2992,5110,0,0,0,1.0,1,1.0,1,1.0,1,0.109851589141039,80
3995,1,8103,2993,5110,0,0,0,1.0,1,1.0,1,1.0,1,0.11384650857928663,81
3996,2,8105,2993,5112,0,0,0,1.0,1,1.0,1,1.0,1,0.12853541721286185,80
3997,2,8107,2994,5113,0,0,0,1.0,1,1.0,1,1.0,1,0.10699772741028482,81
3998,2,8109,2995,5114,0,0,0,1.0,1,1.0,1,1.0,1,0.0956678520979341,82
3999,3,8112,2995,5117,0,0,0,1.0,1,1.0,1,1.0,1,0.07902583024539214,82
4000,3,8115,2997,5118,0,0,0,1.0,1,1.0,1,1.0,1,0.08606700387035811,82
4001,1,8116,2998,5118,0,0,0,1.0,1,1.0,1,1.0,1,0.09404469301349663,81
4002,2,8118,3000,5118,0,0,0,1.0,1,1.0,1,1.0,1,0.09039676125756006,81
4003,4,8122,3003,5119,0,0,0,1.0,1,1.0,1,1.0,1,0.11812608949794014,81
4004,4,8126,3005,5121,0,0,0,1.0,1,1.0,1,1.0,1,0.1340163369947072,80
4005,2,8128,3007,5121,0,0,0,1.0,1,1.0,1,1.0,1,0.1610994174511556,78
4006,3,8131,3008,5123,0,0,0,1.0,1,1.0,1,1.0,1,0.1302509418789364,76
4007,3,8134,3010,5124,0,0,0,1.0,1,1.0,1,1.0,1,0.14024112574072006,75
4008,1,8135,3010,5125,0,0,0,1.0,1,1.0,1,1.0,1,0.12091294048984626,74
4009,6,8141,3011,5130,0,0,0,1.0,1,1.0,1,1.0,1,0.09259042544668916,75
4010,3,8144,3012,5132,0,0,0,1.0,1,1.0,1,1.0,1,0.09307018670824581,75
4011,0,8144,3012,5132,0,0,0,1.0,1,1.0,1,1.0,1,0.10174790250853565,74
4012,6,8150,3013,5137,0,0,0,1.0,1,1.0,1,1.0,1,0.09155480263565173,74
4013,1,8151,3014,5137,0,0,0,1.0,1,1.0,1,1.0,1,0.11934723763828861,74
4014,1,8152,3015,5137,0,0,0,1.0,1,1.0,1,1.0,1,0.13599353213700532,73
4015,2,8154,3015,5139,0,0,0,1.0,1,1.0,1,1.0,1,0.12437144123868873,74
4016,1,8155,3015,5140,0,0,0,1.0,1,1.0,1,1.0,1,0.1437825249583298,74
4017,5,8160,3017,5143,0,0,0,1.0,1,1.0,1,1.0,1,0.15906450452262752,78
4018,9,8169,3018,5151,0,0,0,1.0,1,1.0,1,1.0,1,0.10887572698464064,78
4019,1,8170,3019,5151,0,0,0,1.0,1,1.0,1,1.0,1,0.10728224466569908,78
4020,0,8170,3019,5151,0,0,0,1.0,1,1.0,1,1.0,1,0.10728224466569908,78
4021,1,8171,3019,5152,0,0,0,1.0,1,1.0,1,1.0,1,0.10186925160019707,78
4022,4,8175,3021,5154,0,0,0,1.0,1,1.0,1,1.0,1,0.09605485226899965,79
4023,0,8175,3021,5154,0,0,0,1.0,1,1.0,1,1.0,1,0.09104884361585593,78
4024,0,8175,3021,5154,0,0,0,1.0,1,1.0,1,1.0,1,0.09194447436884882,77
4025,3,8178,3023,5155,0,0,0,1.0,1,1.0,1,1.0,1,0.10823942313325682,76
4026,1,8179,3023,5156,0,0,0,1.0,1,1.0,1,1.0,1,0.09497465168665663,76
4027,5,8184,3026,5158,0,0,0,1.0,1,1.0,1,1.0,1,0.12840853683473907,75
4028,3,8187,3027,5160,0,0,0,1.0,1,1.0,1,1.0,1,0.12220814259479251,76
4029,2,8189,3027,5162,0,0,0,1.0,1,1.0,1,1.0,1,0.11422230306002935,75
4030,4,8193,3028,5165,0,0,0,1.0,1,1.0,1,1.0,1,0.09246882049986684,74
4031,1,8194,3028,5166,0,0,0,1.0,1,1.0,1,1.0,1,0.0847866461777557,73
4032,0,8194,3028,5166,0,0,0,1.0,1,1.0,1,1.0,1,0.10224142116242328,71
4033,1,8195,3028,5167,0,0,0,1.0,1,1.0,1,1.0,1,0.09410767963349999,73
4034,6,8201,3031,5170,0,0,0,1.0,1,1.0,1,1.0,1,0.057292655407384735,72
4035,1,8202,3032,5170,0,0,0,1.0,1,1.0,1,1.0,1,0.06818719050727261,71
4036,3,8205,3033,5172,0,0,0,1.0,1,1.0,1,1.0,1,0.05526651513205582,71
4037,2,8207,3035,5172,0,0,0,1.0,1,1.0,1,1.0,1,0.08765443427755301,70
4038,2,8209,3036,5173,0,0,0,1.0,1,1.0,1,1.0,1,0.1097447487333344,69
4039,4,8213,3037,5176,0,0,0,1.0,1,1.0,1,1.0,1,0.11799776852651078,68
4040,2,8215,3037,5178,0,0,0,1.0,1,1.0,1,1.0,1,0.12261314321403881,69
4041,2,8217,3038,5179,0,0,0,1.0,1,1.0,1,1.0,1,0.15630250475155202,67
4042,3,8220,3038,5182,0,0,0,1.0,1,1.0,1,1.0,1,0.16046571525384756,67
4043,4,8224,3039,5185,0,0,0,1.0,1,1.0,1,1.0,1,0.17192389718963105,66
4044,4,8228,3041,5187,0,0,0,1.0,1,1.0,1,1.0,1,0.18985305903559438,65
4045,3,8231,3041,5190,0,0,0,1.0,1,1.0,1,1.0,1,0.1638009341442721,66
4046,2,8233,3042,5191,0,0,0,1.0,1,1.0,1,1.0,1,0.1882081994283891,68
4047,0,8233,3042,5191,0,0,0,1.0,1,1.0,1,1.0,1,0.1882081994283891,68
4048,2,8235,3042,5193,0,0,0,1.0,1,1.0,1,1.0,1,0.173004193447644,69
4049,0,8235,3042,5193,0,0,0,1.0,1,1.0,1,1.0,1,0.173004193447644,69
4050,0,8235,3042,5193,0,0,0,1.0,1,1.0,1,1.0,1,0.17153916440546754,69
4051,1,8236,3042,5194,0,0,0,1.0,1,1.0,1,1.0,1,0.16387030471435152,69
4052,2,8238,3042,5196,0,0,0,1.0,1,1.0,1,1.0,1,0.1496034042214699,69
4053,0,8238,3042,5196,0,0,0,1.0,1,1.0,1,1.0,1,0.1496034042214699,69
4054,1,8239,3043,5196,0,0,0,1.0,1,1.0,1,1.0,1,0.1566774405455754,70
4055,2,8241,3043,5198,0,0,0,1.0,1,1.0,1,1.0,1,0.13802805524381803,70
4056,1,8242,3043,5199,0,0,0,1.0,1,1.0,1,1.0,1,0.12840955221803063,70
4057,2,8244,3043,5201,0,0,0,1.0,1,1.0,1,1.0,1,0.1233950366346205,71
4058,0,8244,3043,5201,0,0,0,1.0,1,1.0,1,1.0,1,0.1233950366346205,71
4059,2,8246,3044,5202,0,0,0,1.0,1,1.0,1,1.0,1,0.13606548619412895,72
4060,1,8247,3044,5203,0,0,0,1.0,1,1.0,1,1.0,1,0.13542533408089835,71
4061,4,8251,3045,5206,0,0,0,1.0,1,1.0,1,1.0,1,0.11785486523130688,72
4062,0,8251,3045,5206,0,0,0,1.0,1,1.0,1,1.0,1,0.11785486523130688,72
4063,2,8253,3045,5208,0,0,0,1.0,1,1.0,1,1.0,1,0.11663089109319652,72
4064,6,8259,3050,5209,0,0,0,1.0,1,1.0,1,1.0,1,0.11418830170118288,71
4065,2,8261,3051,5210,0,0,0,1.0,1,1.0,1,1.0,1,0.11434028265827952,70
4066,7,8268,3053,5215,0,0,0,1.0,1,1.0,1,1.0,1,0.10617212811428278,70
4067,5,8273,3054,5219,0,0,0,1.0,1,1.0,1,1.0,1,0.08112148679733933,68
4068,5,8278,3056,5222,0,0,0,1.0,1,1.0,1,1.0,1,0.13801080799635618,70
4069,6,8284,3056,5228,0,0,0,1.0,1,1.0,1,1.0,1,0.06268717473249934,68
4070,1,8285,3057,5228,0,0,0,1.0,1,1.0,1,1.0,1,0.08468731586806352,67
4071,5,8290,3058,5232,0,0,0,1.0,1,1.0,1,1.0,1,0.11107390874701036,68
4072,4,8294,3060,5234,0,0,0,1.0,1,1.0,1,1.0,1,0.10425872557366317,70
4073,5,8299,3064,5235,0,0,0,1.0,1,1.0,1,1.0,1,0.1267562714471857,70
4074,6,8305,3067,5238,0,0,0,1.0,1,1.0,1,1.0,1,0.12103992939272792,71
4075,6,8311,3069,5242,0,0,0,1.0,1,1.0,1,1.0,1,0.1161357232233111,72
4076,3,8314,3070,5244,0,0,0,1.0,1,1.0,1,1.0,1,0.1015948875263655,73
4077,5,8319,3072,5247,0,0,0,1.0,1,1.0,1,1.0,1,0.13107341186039356,72
4078,3,8322,3073,5249,0,0,0,1.0,1,1.0,1,1.0,1,0.1328915238175013,71
4079,0,8322,3073,5249,0,0,0,1.0,1,1.0,1,1.0,1,0.1399371018609589,69
4080,2,8324,3074,5250,0,0,0,1.0,1,1.0,1,1.0,1,0.14173034261169776,67
4081,4,8328,3074,5254,0,0,0,1.0,1,1.0,1,1.0,1,0.11063451803484746,66
4082,0,8328,3074,5254,0,0,0,1.0,1,1.0,1,1.0,1,0.12692281044003742,65
4083,3,8331,3075,5256,0,0,0,1.0,1,1.0,1,1.0,1,0.14162411665675453,64
4084,3,8334,3076,5258,0,0,0,1.0,1,1.0,1,1.0,1,0.13465914382488425,64
4085,3,8337,3077,5260,0,0,0,1.0,1,1.0,1,1.0,1,0.1282260365798618,65
4086,2,8339,3078,5261,0,0,0,1.0,1,1.0,1,1.0,1,0.13053696988162425,66
4087,1,8340,3078,5262,0,0,0,1.0,1,1.0,1,1.0,1,0.1269094579323623,66
4088,0,8340,3078,5262,0,0,0,1.0,1,1.0,1,1.0,1,0.1560253480116105,65
4089,0,8340,3078,5262,0,0,0,1.0,1,1.0,1,1.0,1,0.1560253480116105,65
4090,2,8342,3078,5264,0,0,0,1.0,1,1.0,1,1.0,1,0.14017593835714906,65
4091,0,8342,3078,5264,0,0,0,1.0,1,1.0,1,1.0,1,0.14017593835714906,65
4092,1,8343,3078,5265,0,0,0,1.0,1,1.0,1,1.0,1,0.1473094538976059,64
4093,3,8346,3078,5268,0,0,0,1.0,1,1.0,1,1.0,1,0.12020117628598986,66
4094,1,8347,3079,5268,0,0,0,1.0,1,1.0,1,1.0,1,0.15125543069237907,65
4095,3,8350,3081,5269,0,0,0,1.0,1,1.0,1,1.0,1,0.1492875561049799,65
4096,3,8353,3081,5272,0,0,0,1.0,1,1.0,1,1.0,1,0.12358220104051963,67
4097,2,8355,3082,5273,0,0,0,1.0,1,1.0,1,1.0,1,0.10945325429275886,67
4098,3,8358,3085,5273,0,0,0,1.0,1,1.0,1,1.0,1,0.123468529262405,68
4099,5,8363,3087,5276,0,0,0,1.0,1,1.0,1,1.0,1,0.10870385919287755,69
4100,4,8367,3088,5279,0,0,0,1.0,1,1.0,1,1.0,1,0.11988565271680553,70
4101,3,8370,3088,5282,0,0,0,1.0,1,1.0,1,1.0,1,0.12210886542633488,71
4102,1,8371,3088,5283,0,0,0,1.0,1,1.0,1,1.0,1,0.11314100233921875,71
4103,1,8372,3089,5283,0,0,0,1.0,1,1.0,1,1.0,1,0.1237350684827705,71
4104,2,8374,3091,5283,0,0,0,1.0,1,1.0,1,1.0,1,0.13504609239468024,69
4105,4,8378,3093,5285,0,0,0,1.0,1,1.0,1,1.0,1,0.15721161642369388,67
4106,3,8381,3094,5287,0,0,0,1.0,1,1.0,1,1.0,1,0.16861244837991038,68
4107,5,8386,3094,5292,0,0,0,1.0,1,1.0,1,1.0,1,0.12133957157976832,70
4108,0,8386,3094,5292,0,0,0,1.0,1,1.0,1,1.0,1,0.11936998742524431,70
4109,0,8386,3094,5292,0,0,0,1.0,1,1.0,1,1.0,1,0.12674085509731514,69
4110,0,8386,3094,5292,0,0,0,1.0,1,1.0,1,1.0,1,0.10418276284142372,71
4111,1,8387,3094,5293,0,0,0,1.0,1,1.0,1,1.0,1,0.10277458260767561,70
4112,1,8388,3094,5294,0,0,0,1.0,1,1.0,1,1.0,1,0.10290551603524971,72
4113,1,8389,3094,5295,0,0,0,1.0,1,1.0,1,1.0,1,0.09386578929344759,72
4114,6,8395,3096,5299,0,0,0,1.0,1,1.0,1,1.0,1,0.08879394691994828,72
4115,2,8397,3098,5299,0,0,0,1.0,1,1.0,1,1.0,1,0.09985791126857715,70
4116,0,8397,3098,5299,0,0,0,1.0,1,1.0,1,1.0,1,0.10013830500971913,67
4117,5,8402,3101,5301,0,0,0,1.0,1,1.0,1,1.0,1,0.11085261729373423,67
4118,2,8404,3101,5303,0,0,0,1.0,1,1.0,1,1.0,1,0.13451741878745607,66
4119,3,8407,3102,5305,0,0,0,1.0,1,1.0,1,1.0,1,0.16806650146133106,67
4120,7,8414,3104,5310,0,0,0,1.0,1,1.0,1,1.0,1,0.1854231018843943,64
4121,2,8416,3104,5312,0,0,0,1.0,1,1.0,1,1.0,1,0.18433760537668967,63
4122,5,8421,3105,5316,0,0,0,1.0,1,1.0,1,1.0,1,0.16328675303130336,63
4123,8,8429,3105,5324,0,0,0,1.0,1,1.0,1,1.0,1,0.14239517558870712,61
4124,1,8430,3106,5324,0,0,0,1.0,1,1.0,1,1.0,1,0.1468459541205814,62
4125,2,8432,3106,5326,0,0,0,1.0,1,1.0,1,1.0,1,0.1363247794230571,60
4126,2,8434,3106,5328,0,0,0,1.0,1,1.0,1,1.0,1,0.13421883349087269,59
4127,1,8435,3107,5328,0,0,0,1.0,1,1.0,1,1.0,1,0.15982011909886273,60
4128,1,8436,3107,5329,0,0,0,1.0,1,1.0,1,1.0,1,0.14620423578981587,60
4129,3,8439,3107,5332,0,0,0,1.0,1,1.0,1,1.0,1,0.14262832463540684,60
4130,3,8442,3110,5332,0,0,0,1.0,1,1.0,1,1.0,1,0.155293897567763,61
4131,1,8443,3110,5333,0,0,0,1.0,1,1.0,1,1.0,1,0.14303706189295384,60
4132,3,8446,3111,5335,0,0,0,1.0,1,1.0,1,1.0,1,0.15336844004790323,60
4133,1,8447,3112,5335,0,0,0,1.0,1,1.0,1,1.0,1,0.17167104813663997,62
4134,2,8449,3113,5336,0,0,0,1.0,1,1.0,1,1.0,1,0.17523043623679335,63
4135,4,8453,3114,5339,0,0,0,1.0,1,1.0,1,1.0,1,0.1360113155106216,65
4136,1,8454,3114,5340,0,0,0,1.0,1,1.0,1,1.0,1,0.1303583989096047,65
4137,1,8455,3115,5340,0,0,0,1.0,1,1.0,1,1.0,1,0.14858349671718674,66
4138,3,8458,3116,5342,0,0,0,1.0,1,1.0,1,1.0,1,0.13368084936291033,67
4139,3,8461,3118,5343,0,0,0,1.0,1,1.0,1,1.0,1,0.16394480919905174,67
4140,3,8464,3118,5346,0,0,0,1.0,1,1.0,1,1.0,1,0.11597905659564821,66
4141,1,8465,3118,5347,0,0,0,1.0,1,1.0,1,1.0,1,0.11056890533947633,67
4142,0,8465,3118,5347,0,0,0,1.0,1,1.0,1,1.0,1,0.11056890533947633,67
4143,2,8467,3118,5349,0,0,0,1.0,1,1.0,1,1.0,1,0.09199399987528242,66
4144,0,8467,3118,5349,0,0,0,1.0,1,1.0,1,1.0,1,0.10492376548577396,64
4145,2,8469,3120,5349,0,0,0,1.0,1,1.0,1,1.0,1,0.11876962806768714,63
4146,3,8472,3122,5350,0,0,0,1.0,1,1.0,1,1.0,1,0.13325131506328872,62
4147,6,8478,3123,5355,0,0,0,1.0,1,1.0,1,1.0,1,0.1101477457394437,60
4148,6,8484,3127,5357,0,0,0,1.0,1,1.0,1,1.0,1,0.11118349034084946,62
4149,2,8486,3127,5359,0,0,0,1.0,1,1.0,1,1.0,1,0.10423907273484544,61
4150,5,8491,3128,5363,0,0,0,1.0,1,1.0,1,1.0,1,0.0893817642233426,60
4151,1,8492,3129,5363,0,0,0,1.0,1,1.0,1,1.0,1,0.10433911530230205,60
4152,1,8493,3130,5363,0,0,0,1.0,1,1.0,1,1.0,1,0.13027769809781706,60
4153,2,8495,3131,5364,0,0,0,1.0,1,1.0,1,1.0,1,0.1442426917270904,58
4154,4,8499,3131,5368,0,0,0,1.0,1,1.0,1,1.0,1,0.12874380660281684,57
4155,1,8500,3132,5368,0,0,0,1.0,1,1.0,1,1.0,1,0.1363565072705246,57
4156,4,8504,3132,5372,0,0,0,1.0,1,1.0,1,1.0,1,0.10843489566128357,58
4157,0,8504,3132,5372,0,0,0,1.0,1,1.0,1,1.0,1,0.11865677583073145,57
4158,1,8505,3133,5372,0,0,0,1.0,1,1.0,1,1.0,1,0.15787207672699038,55
4159,5,8510,3134,5376,0,0,0,1.0,1,1.0,1,1.0,1,0.13707977431033722,57
4160,1,8511,3134,5377,0,0,0,1.0,1,1.0,1,1.0,1,0.13628799655193846,58
4161,0,8511,3134,5377,0,0,0,1.0,1,1.0,1,1.0,1,0.13628799655193846,58
4162,2,8513,3135,5378,0,0,0,1.0,1,1.0,1,1.0,1,0.15806659030578976,57
4163,0,8513,3135,5378,0,0,0,1.0,1,1.0,1,1.0,1,0.15282642509288588,58
4164,5,8518,3138,5380,0,0,0,1.0,1,1.0,1,1.0,1,0.20434102472654214,56
4165,6,8524,3139,5385,0,0,0,1.0,1,1.0,1,1.0,1,0.18205194939216948,58
4166,0,8524,3139,5385,0,0,0,1.0,1,1.0,1,1.0,1,0.17183048507231685,57
4167,2,8526,3140,5386,0,0,0,1.0,1,1.0,1,1.0,1,0.17032262171565055,57
4168,1,8527,3140,5387,0,0,0,1.0,1,1.0,1,1.0,1,0.16322331832579517,58
4169,1,8528,3140,5388,0,0,0,1.0,1,1.0,1,1.0,1,0.1503201207573952,58
4170,1,8529,3141,5388,0,0,0,1.0,1,1.0,1,1.0,1,0.17360287732709057,58
4171,0,8529,3141,5388,0,0,0,1.0,1,1.0,1,1.0,1,0.19073311685769004,57
4172,3,8532,3141,5391,0,0,0,1.0,1,1.0,1,1.0,1,0.1509380426351674,57
4173,2,8534,3143,5391,0,0,0,1.0,1,1.0,1,1.0,1,0.20321569128735192,56
4174,3,8537,3144,5393,0,0,0,1.0,1,1.0,1,1.0,1,0.21127494741459343,56
4175,2,8539,3144,5395,0,0,0,1.0,1,1.0,1,1.0,1,0.18404502993990737,55
4176,1,8540,3144,5396,0,0,0,1.0,1,1.0,1,1.0,1,0.1752109596755377,57
4177,6,8546,3144,5402,0,0,0,1.0,1,1.0,1,1.0,1,0.13415050798940487,58
4178,5,8551,3146,5405,0,0,0,1.0,1,1.0,1,1.0,1,0.11398100169277958,60
4179,4,8555,3146,5409,0,0,0,1.0,1,1.0,1,1.0,1,0.11642205410039365,61
4180,0,8555,3146,5409,0,0,0,1.0,1,1.0,1,1.0,1,0.12474228818786227,62
4181,0,8555,3146,5409,0,0,0,1.0,1,1.0,1,1.0,1,0.12273605733855933,63
4182,1,8556,3147,5409,0,0,0,1.0,1,1.0,1,1.0,1,0.12099920797389947,63
4183,5,8561,3148,5413,0,0,0,1.0,1,1.0,1,1.0,1,0.09359494289775865,63
4184,4,8565,3149,5416,0,0,0,1.0,1,1.0,1,1.0,1,0.08652786224938697,63
4185,1,8566,3149,5417,0,0,0,1.0,1,1.0,1,1.0,1,0.0769543564204713,61
4186,4,8570,3151,5419,0,0,0,1.0,1,1.0,1,1.0,1,0.09051284893321028,62
4187,1,8571,3151,5420,0,0,0,1.0,1,1.0,1,1.0,1,0.0995481196616415,60
4188,0,8571,3151,5420,0,0,0,1.0,1,1.0,1,1.0,1,0.11776165770855408,60
4189,4,8575,3152,5423,0,0,0,1.0,1,1.0,1,1.0,1,0.0775694189085875,60
4190,1,8576,3153,5423,0,0,0,1.0,1,1.0,1,1.0,1,0.09711511384504082,61
4191,0,8576,3153,5423,0,0,0,1.0,1,1.0,1,1.0,1,0.06966263940941003,59
4192,2,8578,3154,5424,0,0,0,1.0,1,1.0,1,1.0,1,0.0519935070569906,58
4193,2,8580,3156,5424,0,0,0,1.0,1,1.0,1,1.0,1,0.08769971230232924,57
4194,1,8581,3157,5424,0,0,0,1.0,1,1.0,1,1.0,1,0.08672046430959844,54
4195,1,8582,3158,5424,0,0,0,1.0,1,1.0,1,1.0,1,0.1005439388320782,55
4196,3,8585,3160,5425,0,0,0,1.0,1,1.0,1,1.0,1,0.15360378869367763,56
4197,0,8585,3160,5425,0,0,0,1.0,1,1.0,1,1.0,1,0.14527507150858687,55
4198,2,8587,3161,5426,0,0,0,1.0,1,1.0,1,1.0,1,0.19004368912533234,56
4199,2,8589,3162,5427,0,0,0,1.0,1,1.0,1,1.0,1,0.20416409422539558,55
4200,0,8589,3162,5427,0,0,0,1.0,1,1.0,1,1.0,1,0.20404963603359969,55
4201,1,8590,3162,5428,0,0,0,1.0,1,1.0,1,1.0,1,0.17295483090809713,56
4202,0,8590,3162,5428,0,0,0,1.0,1,1.0,1,1.0,1,0.17295483090809713,56
4203,3,8593,3162,5431,0,0,0,1.0,1,1.0,1,1.0,1,0.1544089124771857,57
4204,2,8595,3163,5432,0,0,0,1.0,1,1.0,1,1.0,1,0.12455669568339746,57
4205,0,8595,3163,5432,0,0,0,1.0,1,1.0,1,1.0,1,0.12343285191161635,58
4206,2,8597,3164,5433,0,0,0,1.0,1,1.0,1,1.0,1,0.1222830130257085,58
4207,3,8600,3166,5434,0,0,0,1.0,1,1.0,1,1.0,1,0.10897074123451835,58
4208,1,8601,3167,5434,0,0,0,1.0,1,1.0,1,1.0,1,0.13304636283831447,60
4209,3,8604,3170,5434,0,0,0,1.0,1,1.0,1,1.0,1,0.14532246247381422,61
4210,4,8608,3170,5438,0,0,0,1.0,1,1.0,1,1.0,1,0.10926973788391078,62
4211,3,8611,3171,5440,0,0,0,1.0,1,1.0,1,1.0,1,0.12064889870609585,63
4212,1,8612,3171,5441,0,0,0,1.0,1,1.0,1,1.0,1,0.12048541930271117,64
4213,4,8616,3171,5445,0,0,0,1.0,1,1.0,1,1.0,1,0.11488418675124311,65
4214,1,8617,3171,5446,0,0,0,1.0,1,1.0,1,1.0,1,0.10669745642608608,65
4215,0,8617,3171,5446,0,0,0,1.0,1,1.0,1,1.0,1,0.10669745642608608,65
4216,1,8618,3171,5447,0,0,0,1.0,1,1.0,1,1.0,1,0.10999621103804197,64
4217,3,8621,3172,5449,0,0,0,1.0,1,1.0,1,1.0,1,0.11635103561553643,65
4218,0,8621,3172,5449,0,0,0,1.0,1,1.0,1,1.0,1,0.11635103561553643,65
4219,2,8623,3173,5450,0,0,0,1.0,1,1.0,1,1.0,1,0.10718277575408038,65
4220,1,8624,3174,5450,0,0,0,1.0,1,1.0,1,1.0,1,0.1278611745354094,65
4221,2,8626,3175,5451,0,0,0,1.0,1,1.0,1,1.0,1,0.15679573421496187,67
4222,3,8629,3176,5453,0,0,0,1.0,1,1.0,1,1.0,1,0.14733587505169465,68
4223,3,8632,3177,5455,0,0,0,1.0,1,1.0,1,1.0,1,0.14472152459267654,68
4224,3,8635,3178,5457,0,0,0,1.0,1,1.0,1,1.0,1,0.13885389960663136,68
4225,0,8635,3178,5457,0,0,0,1.0,1,1.0,1,1.0,1,0.1332495617995273,66
4226,1,8636,3179,5457,0,0,0,1.0,1,1.0,1,1.0,1,0.1514468562958761,66
4227,1,8637,3180,5457,0,0,0,1.0,1,1.0,1,1.0,1,0.18121077192205917,66
4228,2,8639,3180,5459,0,0,0,1.0,1,1.0,1,1.0,1,0.16135905098358636,65
4229,2,8641,3181,5460,0,0,0,1.0,1,1.0,1,1.0,1,0.15707187741413267,65
4230,3,8644,3182,5462,0,0,0,1.0,1,1.0,1,1.0,1,0.15175673473060075,64
4231,0,8644,3182,5462,0,0,0,1.0,1,1.0,1,1.0,1,0.15489508021609522,64
4232,3,8647,3183,5464,0,0,0,1.0,1,1.0,1,1.0,1,0.12261441535043693,65
4233,0,8647,3183,5464,0,0,0,1.0,1,1.0,1,1.0,1,0.11208152675600318,64
4234,2,8649,3184,5465,0,0,0,1.0,1,1.0,1,1.0,1,0.10205347522829153,63
4235,1,8650,3185,5465,0,0,0,1.0,1,1.0,1,1.0,1,0.11578849577182725,63
4236,0,8650,3185,5465,0,0,0,1.0,1,1.0,1,1.0,1,0.11578849577182725,63
4237,4,8654,3186,5468,0,0,0,1.0,1,1.0,1,1.0,1,0.10267418629209044,65
4238,0,8654,3186,5468,0,0,0,1.0,1,1.0,1,1.0,1,0.10267418629209044,65
4239,0,8654,3186,5468,0,0,0,1.0,1,1.0,1,1.0,1,0.10267418629209044,65
4240,2,8656,3187,5469,0,0,0,1.0,1,1.0,1,1.0,1,0.06995311013795229,66
4241,0,8656,3187,5469,0,0,0,1.0,1,1.0,1,1.0,1,0.06995311013795229,66
4242,1,8657,3187,5470,0,0,0,1.0,1,1.0,1,1.0,1,0.0617582184375767,69
4243,1,8658,3187,5471,0,0,0,1.0,1,1.0,1,1.0,1,0.07106294646213418,71
4244,0,8658,3187,5471,0,0,0,1.0,1,1.0,1,1.0,1,0.07106294646213418,71
4245,1,8659,3187,5472,0,0,0,1.0,1,1.0,1,1.0,1,0.06482945331084619,73
4246,1,8660,3187,5473,0,0,0,1.0,1,1.0,1,1.0,1,0.05218208248098043,74
4247,0,8660,3187,5473,0,0,0,1.0,1,1.0,1,1.0,1,0.05218208248098043,74
4248,0,8660,3187,5473,0,0,0,1.0,1,1.0,1,1.0,1,0.05218208248098043,74
4249,0,8660,3187,5473,0,0,0,1.0,1,1.0,1,1.0,1,0.05218208248098043,74
4250,1,8661,3188,5473,0,0,0,1.0,1,1.0,1,1.0,1,0.06834919876480117,74
4251,1,8662,3188,5474,0,0,0,1.0,1,1.0,1,1.0,1,0.06598917807809694,75
4252,5,8667,3193,5474,0,0,0,1.0,1,1.0,1,1.0,1,0.15454113970850825,75
4253,4,8671,3193,5478,0,0,0,1.0,1,1.0,1,1.0,1,0.13210379182246468,76
4254,2,8673,3195,5478,0,0,0,1.0,1,1.0,1,1.0,1,0.1344990188906747,75
4255,5,8678,3196,5482,0,0,0,1.0,1,1.0,1,1.0,1,0.11597301497204617,76
4256,0,8678,3196,5482,0,0,0,1.0,1,1.0,1,1.0,1,0.11632639618677669,78
4257,3,8681,3198,5483,0,0,0,1.0,1,1.0,1,1.0,1,0.1385616787841606,78
4258,3,8684,3198,5486,0,0,0,1.0,1,1.0,1,1.0,1,0.11835847910110373,77
4259,3,8687,3199,5488,0,0,0,1.0,1,1.0,1,1.0,1,0.10605426983522898,78
4260,1,8688,3199,5489,0,0,0,1.0,1,1.0,1,1.0,1,0.11297675215013434,77
4261,1,8689,3200,5489,0,0,0,1.0,1,1.0,1,1.0,1,0.12296790899160513,76
4262,4,8693,3200,5493,0,0,0,1.0,1,1.0,1,1.0,1,0.11515670104875705,75
4263,2,8695,3200,5495,0,0,0,1.0,1,1.0,1,1.0,1,0.10462921364028406,74
4264,3,8698,3200,5498,0,0,0,1.0,1,1.0,1,1.0,1,0.12522257900286143,74
4265,3,8701,3202,5499,0,0,0,1.0,1,1.0,1,1.0,1,0.10008178978011248,73
4266,1,8702,3203,5499,0,0,0,1.0,1,1.0,1,1.0,1,0.11278752255290775,71
4267,5,8707,3206,5501,0,0,0,1.0,1,1.0,1,1.0,1,0.1152678702820708,69
4268,1,8708,3206,5502,0,0,0,1.0,1,1.0,1,1.0,1,0.12918296489552433,67
4269,3,8711,3209,5502,0,0,0,1.0,1,1.0,1,1.0,1,0.16292182320955456,64
4270,5,8716,3211,5505,0,0,0,1.0,1,1.0,1,1.0,1,0.12479624843274867,63
4271,2,8718,3211,5507,0,0,0,1.0,1,1.0,1,1.0,1,0.1264038508942487,63
4272,3,8721,3213,5508,0,0,0,1.0,1,1.0,1,1.0,1,0.17957796260156617,62
4273,4,8725,3214,5511,0,0,0,1.0,1,1.0,1,1.0,1,0.15748805740909017,62
4274,1,8726,3214,5512,0,0,0,1.0,1,1.0,1,1.0,1,0.1478944989374486,62
4275,2,8728,3214,5514,0,0,0,1.0,1,1.0,1,1.0,1,0.1398251114269842,61
4276,3,8731,3214,5517,0,0,0,1.0,1,1.0,1,1.0,1,0.11626899558238293,62
4277,2,8733,3214,5519,0,0,0,1.0,1,1.0,1,1.0,1,0.1172091603446132,63
4278,0,8733,3214,5519,0,0,0,1.0,1,1.0,1,1.0,1,0.10758198818841985,64
4279,1,8734,3214,5520,0,0,0,1.0,1,1.0,1,1.0,1,0.1159438185556077,65
4280,0,8734,3214,5520,0,0,0,1.0,1,1.0,1,1.0,1,0.1159438185556077,65
4281,1,8735,3215,5520,0,0,0,1.0,1,1.0,1,1.0,1,0.11977479149051383,65
4282,5,8740,3218,5522,0,0,0,1.0,1,1.0,1,1.0,1,0.15553158471228123,66
4283,4,8744,3220,5524,0,0,0,1.0,1,1.0,1,1.0,1,0.18982897428770593,66
4284,1,8745,3221,5524,0,0,0,1.0,1,1.0,1,1.0,1,0.21429526287029646,66
4285,4,8749,3221,5528,0,0,0,1.0,1,1.0,1,1.0,1,0.17889623161098972,67
4286,2,8751,3221,5530,0,0,0,1.0,1,1.0,1,1.0,1,0.1837904858111537,67
4287,2,8753,3221,5532,0,0,0,1.0,1,1.0,1,1.0,1,0.17775103027512826,67
4288,5,8758,3221,5537,0,0,0,1.0,1,1.0,1,1.0,1,0.12578780588565439,68
4289,0,8758,3221,5537,0,0,0,1.0,1,1.0,1,1.0,1,0.12651042102607318,68
4290,0,8758,3221,5537,0,0,0,1.0,1,1.0,1,1.0,1,0.14115447242701518,70
4291,3,8761,3222,5539,0,0,0,1.0,1,1.0,1,1.0,1,0.14044051594752746,71
4292,0,8761,3222,5539,0,0,0,1.0,1,1.0,1,1.0,1,0.14044051594752746,71
4293,1,8762,3222,5540,0,0,0,1.0,1,1.0,1,1.0,1,0.12976645754645122,71
4294,1,8763,3223,5540,0,0,0,1.0,1,1.0,1,1.0,1,0.13500330213648887,71
4295,2,8765,3224,5541,0,0,0,1.0,1,1.0,1,1.0,1,0.15193048471898224,72
4296,1,8766,3225,5541,0,0,0,1.0,1,1.0,1,1.0,1,0.16051818857478467,73
4297,3,8769,3225,5544,0,0,0,1.0,1,1.0,1,1.0,1,0.13892468425319462,73
4298,3,8772,3226,5546,0,0,0,1.0,1,1.0,1,1.0,1,0.14250725588144436,74
4299,0,8772,3226,5546,0,0,0,1.0,1,1.0,1,1.0,1,0.12704713902732737,75
4300,3,8775,3226,5549,0,0,0,1.0,1,1.0,1,1.0,1,0.10159348492519041,75
4301,0,8775,3226,5549,0,0,0,1.0,1,1.0,1,1.0,1,0.09637376849906437,76
4302,0,8775,3226,5549,0,0,0,1.0,1,1.0,1,1.0,1,0.09637376849906437,76
4303,2,8777,3226,5551,0,0,0,1.0,1,1.0,1,1.0,1,0.08988864512541837,75
4304,3,8780,3228,5552,0,0,0,1.0,1,1.0,1,1.0,1,0.10047172563004256,75
4305,1,8781,3229,5552,0,0,0,1.0,1,1.0,1,1.0,1,0.11804035637325519,73
4306,4,8785,3231,5554,0,0,0,1.0,1,1.0,1,1.0,1,0.1393509943021841,74
4307,5,8790,3232,5558,0,0,0,1.0,1,1.0,1,1.0,1,0.10905149119923488,73
4308,2,8792,3232,5560,0,0,0,1.0,1,1.0,1,1.0,1,0.12951539622095587,71
4309,3,8795,3233,5562,0,0,0,1.0,1,1.0,1,1.0,1,0.13107676399150925,70
4310,1,8796,3234,5562,0,0,0,1.0,1,1.0,1,1.0,1,0.12577624910706758,69
4311,3,8799,3235,5564,0,0,0,1.0,1,1.0,1,1.0,1,0.12122668462748368,69
4312,3,8802,3236,5566,0,0,0,1.0,1,1.0,1,1.0,1,0.14135432966978567,66
4313,2,8804,3238,5566,0,0,0,1.0,1,1.0,1,1.0,1,0.1582105456951315,64
4314,1,8805,3238,5567,0,0,0,1.0,1,1.0,1,1.0,1,0.19415880804546626,61
4315,6,8811,3241,5570,0,0,0,1.0,1,1.0,1,1.0,1,0.15359095870992523,61
4316,2,8813,3242,5571,0,0,0,1.0,1,1.0,1,1.0,1,0.09392724941643311,60
4317,0,8813,3242,5571,0,0,0,1.0,1,1.0,1,1.0,1,0.1038777597661431,62
4318,2,8815,3244,5571,0,0,0,1.0,1,1.0,1,1.0,1,0.14672681055434364,59
4319,0,8815,3244,5571,0,0,0,1.0,1,1.0,1,1.0,1,0.13719079527303027,60
4320,1,8816,3244,5572,0,0,0,1.0,1,1.0,1,1.0,1,0.12691357995039582,60
4321,2,8818,3245,5573,0,0,0,1.0,1,1.0,1,1.0,1,0.13277312304975245,61
4322,1,8819,3246,5573,0,0,0,1.0,1,1.0,1,1.0,1,0.14071427398858538,61
4323,1,8820,3247,5573,0,0,0,1.0,1,1.0,1,1.0,1,0.15239620680984148,61
4324,2,8822,3248,5574,0,0,0,1.0,1,1.0,1,1.0,1,0.16583852201287672,60
4325,2,8824,3249,5575,0,0,0,1.0,1,1.0,1,1.0,1,0.1762232516328339,60
4326,2,8826,3250,5576,0,0,0,1.0,1,1.0,1,1.0,1,0.1751687470064945,61
4327,2,8828,3250,5578,0,0,0,1.0,1,1.0,1,1.0,1,0.15125859154358334,62
4328,2,8830,3250,5580,0,0,0,1.0,1,1.0,1,1.0,1,0.13810258621362623,62
4329,6,8836,3251,5585,0,0,0,1.0,1,1.0,1,1.0,1,0.1265591064962895,65
4330,1,8837,3251,5586,0,0,0,1.0,1,1.0,1,1.0,1,0.12267423321656065,65
4331,0,8837,3251,5586,0,0,0,1.0,1,1.0,1,1.0,1,0.12267423321656065,65
4332,4,8841,3252,5589,0,0,0,1.0,1,1.0,1,1.0,1,0.13681954520057107,66
4333,2,8843,3252,5591,0,0,0,1.0,1,1.0,1,1.0,1,0.11540189506278443,66
4334,2,8845,3253,5592,0,0,0,1.0,1,1.0,1,1.0,1,0.12348140113640166,66
4335,0,8845,3253,5592,0,0,0,1.0,1,1.0,1,1.0,1,0.13493963688862343,65
4336,3,8848,3255,5593,0,0,0,1.0,1,1.0,1,1.0,1,0.13943259182091347,67
4337,6,8854,3255,5599,0,0,0,1.0,1,1.0,1,1.0,1,0.16709930264429093,69
4338,4,8858,3256,5602,0,0,0,1.0,1,1.0,1,1.0,1,0.16674889606659596,70
4339,5,8863,3256,5607,0,0,0,1.0,1,1.0,1,1.0,1,0.13384922039897829,70
4340,1,8864,3256,5608,0,0,0,1.0,1,1.0,1,1.0,1,0.14222587298683206,71
4341,4,8868,3258,5610,0,0,0,1.0,1,1.0,1,1.0,1,0.17009252033549807,70
4342,3,8871,3258,5613,0,0,0,1.0,1,1.0,1,1.0,1,0.15808943649592733,71
4343,4,8875,3261,5614,0,0,0,1.0,1,1.0,1,1.0,1,0.17071028125077617,67
4344,5,8880,3264,5616,0,0,0,1.0,1,1.0,1,1.0,1,0.1913459244172382,67
4345,10,8890,3268,5622,0,0,0,1.0,1,1.0,1,1.0,1,0.1518173149795239,64
4346,4,8894,3272,5622,0,0,0,1.0,1,1.0,1,1.0,1,0.17526133101358946,64
4347,6,8900,3276,5624,0,0,0,1.0,1,1.0,1,1.0,1,0.21528018684153294,62
4348,6,8906,3277,5629,0,0,0,1.0,1,1.0,1,1.0,1,0.18851802273168738,62
4349,4,8910,3278,5632,0,0,0,1.0,1,1.0,1,1.0,1,0.19985266568301685,61
4350,2,8912,3279,5633,0,0,0,1.0,1,1.0,1,1.0,1,0.21207663245864553,60
4351,2,8914,3280,5634,0,0,0,1.0,1,1.0,1,1.0,1,0.18962918299916956,60
4352,1,8915,3280,5635,0,0,0,1.0,1,1.0,1,1.0,1,0.21393540601346664,57
4353,1,8916,3280,5636,0,0,0,1.0,1,1.0,1,1.0,1,0.2202653582850782,55
4354,3,8919,3280,5639,0,0,0,1.0,1,1.0,1,1.0,1,0.16617960928343475,55
4355,3,8922,3281,5641,0,0,0,1.0,1,1.0,1,1.0,1,0.15312014006902794,53
4356,0,8922,3281,5641,0,0,0,1.0,1,1.0,1,1.0,1,0.12383438383422775,55
4357,3,8925,3283,5642,0,0,0,1.0,1,1.0,1,1.0,1,0.1343463317669129,55
4358,1,8926,3284,5642,0,0,0,1.0,1,1.0,1,1.0,1,0.14731478633929718,55
4359,1,8927,3284,5643,0,0,0,1.0,1,1.0,1,1.0,1,0.127735969806543,54
4360,2,8929,3284,5645,0,0,0,1.0,1,1.0,1,1.0,1,0.10113091194068238,55
4361,1,8930,3285,5645,0,0,0,1.0,1,1.0,1,1.0,1,0.11830020132555778,54
4362,0,8930,3285,5645,0,0,0,1.0,1,1.0,1,1.0,1,0.11909740223788635,55
4363,3,8933,3287,5646,0,0,0,1.0,1,1.0,1,1.0,1,0.14383751353497454,55
4364,2,8935,3288,5647,0,0,0,1.0,1,1.0,1,1.0,1,0.14244625073652634,55
4365,2,8937,3288,5649,0,0,0,1.0,1,1.0,1,1.0,1,0.14597282796247266,54
4366,4,8941,3289,5652,0,0,0,1.0,1,1.0,1,1.0,1,0.1324946635964166,54
4367,1,8942,3290,5652,0,0,0,1.0,1,1.0,1,1.0,1,0.1355788008257792,57
4368,1,8943,3290,5653,0,0,0,1.0,1,1.0,1,1.0,1,0.16745547702669536,57
4369,2,8945,3290,5655,0,0,0,1.0,1,1.0,1,1.0,1,0.1363150144894697,58
4370,1,8946,3290,5656,0,0,0,1.0,1,1.0,1,1.0,1,0.13643033527531598,59
4371,2,8948,3290,5658,0,0,0,1.0,1,1.0,1,1.0,1,0.1148065446262095,60
4372,3,8951,3291,5660,0,0,0,1.0,1,1.0,1,1.0,1,0.11709395156263532,60
4373,2,8953,3291,5662,0,0,0,1.0,1,1.0,1,1.0,1,0.09529673878119634,60
4374,0,8953,3291,5662,0,0,0,1.0,1,1.0,1,1.0,1,0.11059054755316751,59
4375,1,8954,3291,5663,0,0,0,1.0,1,1.0,1,1.0,1,0.11344725861949383,60
4376,0,8954,3291,5663,0,0,0,1.0,1,1.0,1,1.0,1,0.12844971441991798,60
4377,3,8957,3293,5664,0,0,0,1.0,1,1.0,1,1.0,1,0.16985097829512216,61
4378,2,8959,3294,5665,0,0,0,1.0,1,1.0,1,1.0,1,0.17731961787123868,64
4379,1,8960,3295,5665,0,0,0,1.0,1,1.0,1,1.0,1,0.19518031821464704,64
4380,3,8963,3296,5667,0,0,0,1.0,1,1.0,1,1.0,1,0.1891051677380682,65
4381,2,8965,3296,5669,0,0,0,1.0,1,1.0,1,1.0,1,0.18738057308183648,64
4382,3,8968,3297,5671,0,0,0,1.0,1,1.0,1,1.0,1,0.18929623996637898,64
4383,4,8972,3299,5673,0,0,0,1.0,1,1.0,1,1.0,1,0.20903527542477313,64
4384,9,8981,3302,5679,0,0,0,1.0,1,1.0,1,1.0,1,0.22766496422437937,60
4385,3,8984,3303,5681,0,0,0,1.0,1,1.0,1,1.0,1,0.21005144675360993,58
4386,2,8986,3305,5681,0,0,0,1.0,1,1.0,1,1.0,1,0.21565005228511155,58
4387,3,8989,3305,5684,0,0,0,1.0,1,1.0,1,1.0,1,0.16675884664716997,55
4388,2,8991,3307,5684,0,0,0,1.0,1,1.0,1,1.0,1,0.1559695490070974,56
4389,1,8992,3307,5685,0,0,0,1.0,1,1.0,1,1.0,1,0.13588259986889592,55
4390,3,8995,3308,5687,0,0,0,1.0,1,1.0,1,1.0,1,0.1380823643224612,55
4391,3,8998,3310,5688,0,0,0,1.0,1,1.0,1,1.0,1,0.1287758682725139,56
4392,2,9000,3310,5690,0,0,0,1.0,1,1.0,1,1.0,1,0.12170550463416209,56
4393,2,9002,3311,5691,0,0,0,1.0,1,1.0,1,1.0,1,0.14973425475888588,55
4394,1,9003,3312,5691,0,0,0,1.0,1,1.0,1,1.0,1,0.154165658215247,53
4395,1,9004,3313,5691,0,0,0,1.0,1,1.0,1,1.0,1,0.17049266080308895,53
4396,3,9007,3315,5692,0,0,0,1.0,1,1.0,1,1.0,1,0.16265671395641942,53
4397,1,9008,3316,5692,0,0,0,1.0,1,1.0,1,1.0,1,0.1997118887844105,50
4398,1,9009,3317,5692,0,0,0,1.0,1,1.0,1,1.0,1,0.23158515733451082,50
4399,0,9009,3317,5692,0,0,0,1.0,1,1.0,1,1.0,1,0.22556756662153135,52
4400,3,9012,3317,5695,0,0,0,1.0,1,1.0,1,1.0,1,0.1991911791598778,55
4401,1,9013,3317,5696,0,0,0,1.0,1,1.0,1,1.0,1,0.18682225925825854,56
4402,2,9015,3318,5697,0,0,0,1.0,1,1.0,1,1.0,1,0.19257018179289304,56
4403,2,9017,3320,5697,0,0,0,1.0,1,1.0,1,1.0,1,0.1929066358557625,57
4404,0,9017,3320,5697,0,0,0,1.0,1,1.0,1,1.0,1,0.1929066358557625,57
4405,3,9020,3320,5700,0,0,0,1.0,1,1.0,1,1.0,1,0.14232818003455455,58
4406,0,9020,3320,5700,0,0,0,1.0,1,1.0,1,1.0,1,0.14232818003455455,58
4407,0,9020,3320,5700,0,0,0,1.0,1,1.0,1,1.0,1,0.14232818003455455,58
4408,0,9020,3320,5700,0,0,0,1.0,1,1.0,1,1.0,1,0.14901194079948746,59
4409,0,9020,3320,5700,0,0,0,1.0,1,1.0,1,1.0,1,0.14901194079948746,59
4410,0,9020,3320,5700,0,0,0,1.0,1,1.0,1,1.0,1,0.14901194079948746,59
4411,2,9022,3320,5702,0,0,0,1.0,1,1.0,1,1.0,1,0.1269109424528065,62
4412,0,9022,3320,5702,0,0,0,1.0,1,1.0,1,1.0,1,0.12747359328314445,63
4413,1,9023,3321,5702,0,0,0,1.0,1,1.0,1,1.0,1,0.13308849740767809,63
4414,2,9025,3321,5704,0,0,0,1.0,1,1.0,1,1.0,1,0.11904323950677537,64
4415,3,9028,3322,5706,0,0,0,1.0,1,1.0,1,1.0,1,0.12335361256999545,64
4416,2,9030,3322,5708,0,0,0,1.0,1,1.0,1,1.0,1,0.10273249330688931,64
4417,0,9030,3322,5708,0,0,0,1.0,1,1.0,1,1.0,1,0.11193440934745195,65
4418,1,9031,3323,5708,0,0,0,1.0,1,1.0,1,1.0,1,0.12307963849904524,65
4419,3,9034,3323,5711,0,0,0,1.0,1,1.0,1,1.0,1,0.12693020381295853,62
4420,2,9036,3323,5713,0,0,0,1.0,1,1.0,1,1.0,1,0.10692278941516671,62
4421,2,9038,3323,5715,0,0,0,1.0,1,1.0,1,1.0,1,0.10488692754872687,65
4422,5,9043,3325,5718,0,0,0,1.0,1,1.0,1,1.0,1,0.11711261361706496,64
4423,2,9045,3326,5719,0,0,0,1.0,1,1.0,1,1.0,1,0.09677812539536984,63
4424,3,9048,3327,5721,0,0,0,1.0,1,1.0,1,1.0,1,0.08308446334988093,63
4425,3,9051,3328,5723,0,0,0,1.0,1,1.0,1,1.0,1,0.08713055358802486,63
4426,2,9053,3330,5723,0,0,0,1.0,1,1.0,1,1.0,1,0.08421902003456219,63
4427,0,9053,3330,5723,0,0,0,1.0,1,1.0,1,1.0,1,0.0787764252446272,62
4428,0,9053,3330,5723,0,0,0,1.0,1,1.0,1,1.0,1,0.07620743879333676,61
4429,4,9057,3334,5723,0,0,0,1.0,1,1.0,1,1.0,1,0.13607523839975172,62
4430,2,9059,3335,5724,0,0,0,1.0,1,1.0,1,1.0,1,0.12429981565982588,60
4431,2,9061,3336,5725,0,0,0,1.0,1,1.0,1,1.0,1,0.11682680073117493,59
4432,7,9068,3337,5731,0,0,0,1.0,1,1.0,1,1.0,1,0.08711915037509421,60
4433,6,9074,3340,5734,0,0,0,1.0,1,1.0,1,1.0,1,0.0899629042849894,61
4434,3,9077,3341,5736,0,0,0,1.0,1,1.0,1,1.0,1,0.09271296864397525,61
4435,3,9080,3342,5738,0,0,0,1.0,1,1.0,1,1.0,1,0.0815278248142938,61
4436,0,9080,3342,5738,0,0,0,1.0,1,1.0,1,1.0,1,0.0815278248142938,61
4437,4,9084,3344,5740,0,0,0,1.0,1,1.0,1,1.0,1,0.10285209496138409,61
4438,3,9087,3344,5743,0,0,0,1.0,1,1.0,1,1.0,1,0.05019680826830534,62
4439,0,9087,3344,5743,0,0,0,1.0,1,1.0,1,1.0,1,0.06552541960869905,63
4440,2,9089,3345,5744,0,0,0,1.0,1,1.0,1,1.0,1,0.06616083990738597,64
4441,2,9091,3346,5745,0,0,0,1.0,1,1.0,1,1.0,1,0.0632292770780955,64
4442,5,9096,3349,5747,0,0,0,1.0,1,1.0,1,1.0,1,0.12357583363710395,67
4443,2,9098,3351,5747,0,0,0,1.0,1,1.0,1,1.0,1,0.13416678582306377,68
4444,2,9100,3351,5749,0,0,0,1.0,1,1.0,1,1.0,1,0.12357086455560076,69
4445,4,9104,3352,5752,0,0,0,1.0,1,1.0,1,1.0,1,0.12514140887844016,71
4446,0,9104,3352,5752,0,0,0,1.0,1,1.0,1,1.0,1,0.12514140887844016,71
4447,5,9109,3352,5757,0,0,0,1.0,1,1.0,1,1.0,1,0.10203867809366003,72
4448,2,9111,3352,5759,0,0,0,1.0,1,1.0,1,1.0,1,0.11083109031897612,71
4449,3,9114,3353,5761,0,0,0,1.0,1,1.0,1,1.0,1,0.10884945632804993,70
4450,3,9117,3353,5764,0,0,0,1.0,1,1.0,1,1.0,1,0.10585119801491856,69
4451,1,9118,3353,5765,0,0,0,1.0,1,1.0,1,1.0,1,0.0903835912950459,69
4452,3,9121,3353,5768,0,0,0,1.0,1,1.0,1,1.0,1,0.08708126586408803,70
4453,1,9122,3353,5769,0,0,0,1.0,1,1.0,1,1.0,1,0.09625618034434144,70
4454,5,9127,3355,5772,0,0,0,1.0,1,1.0,1,1.0,1,0.106789805697879,71
4455,2,9129,3355,5774,0,0,0,1.0,1,1.0,1,1.0,1,0.09597738308899618,71
4456,4,9133,3358,5775,0,0,0,1.0,1,1.0,1,1.0,1,0.11221321416135753,71
4457,1,9134,3358,5776,0,0,0,1.0,1,1.0,1,1.0,1,0.09614825599168193,69
4458,3,9137,3360,5777,0,0,0,1.0,1,1.0,1,1.0,1,0.10561245550327952,70
4459,2,9139,3361,5778,0,0,0,1.0,1,1.0,1,1.0,1,0.09819418205864366,68
4460,2,9141,3363,5778,0,0,0,1.0,1,1.0,1,1.0,1,0.10882699914821335,68
4461,2,9143,3364,5779,0,0,0,1.0,1,1.0,1,1.0,1,0.0867776263407774,67
4462,3,9146,3366,5780,0,0,0,1.0,1,1.0,1,1.0,1,0.1063685114735676,66
4463,3,9149,3369,5780,0,0,0,1.0,1,1.0,1,1.0,1,0.14763305674450633,65
4464,4,9153,3372,5781,0,0,0,1.0,1,1.0,1,1.0,1,0.17405496982681343,62
4465,11,9164,3376,5788,0,0,0,1.0,1,1.0,1,1.0,1,0.14553268495330138,61
4466,2,9166,3377,5789,0,0,0,1.0,1,1.0,1,1.0,1,0.1566797942146755,60
4467,3,9169,3379,5790,0,0,0,1.0,1,1.0,1,1.0,1,0.14988631600943572,58
4468,4,9173,3380,5793,0,0,0,1.0,1,1.0,1,1.0,1,0.11923014032738934,57
4469,0,9173,3380,5793,0,0,0,1.0,1,1.0,1,1.0,1,0.12798411421006053,56
4470,3,9176,3382,5794,0,0,0,1.0,1,1.0,1,1.0,1,0.13633426922142444,55
4471,3,9179,3383,5796,0,0,0,1.0,1,1.0,1,1.0,1,0.1207737535925006,55
4472,2,9181,3385,5796,0,0,0,1.0,1,1.0,1,1.0,1,0.12873867868851324,55
4473,3,9184,3387,5797,0,0,0,1.0,1,1.0,1,1.0,1,0.15201244098406477,55
4474,4,9188,3388,5800,0,0,0,1.0,1,1.0,1,1.0,1,0.12766487003955213,55
4475,2,9190,3388,5802,0,0,0,1.0,1,1.0,1,1.0,1,0.0655502084354686,56
4476,1,9191,3389,5802,0,0,0,1.0,1,1.0,1,1.0,1,0.06391516414786134,56
4477,1,9192,3389,5803,0,0,0,1.0,1,1.0,1,1.0,1,0.06264590430896674,57
4478,0,9192,3389,5803,0,0,0,1.0,1,1.0,1,1.0,1,0.06550365641862145,55
4479,1,9193,3390,5803,0,0,0,1.0,1,1.0,1,1.0,1,0.07750785985150767,55
4480,1,9194,3391,5803,0,0,0,1.0,1,1.0,1,1.0,1,0.09843847967724763,54
4481,2,9196,3391,5805,0,0,0,1.0,1,1.0,1,1.0,1,0.12308548417104673,53
4482,1,9197,3392,5805,0,0,0,1.0,1,1.0,1,1.0,1,0.142767235540894,54
4483,4,9201,3392,5809,0,0,0,1.0,1,1.0,1,1.0,1,0.08807426515149068,55
4484,2,9203,3393,5810,0,0,0,1.0,1,1.0,1,1.0,1,0.11269948882193886,57
4485,4,9207,3395,5812,0,0,0,1.0,1,1.0,1,1.0,1,0.08628910494208927,60
4486,2,9209,3397,5812,0,0,0,1.0,1,1.0,1,1.0,1,0.08405668128855374,60
4487,1,9210,3397,5813,0,0,0,1.0,1,1.0,1,1.0,1,0.07379890799381587,60
4488,0,9210,3397,5813,0,0,0,1.0,1,1.0,1,1.0,1,0.07379890799381587,60
4489,1,9211,3398,5813,0,0,0,1.0,1,1.0,1,1.0,1,0.09106237482246472,60
4490,0,9211,3398,5813,0,0,0,1.0,1,1.0,1,1.0,1,0.09106237482246472,60
4491,1,9212,3399,5813,0,0,0,1.0,1,1.0,1,1.0,1,0.10506921580234924,61
4492,2,9214,3400,5814,0,0,0,1.0,1,1.0,1,1.0,1,0.08741498634916618,61
4493,2,9216,3402,5814,0,0,0,1.0,1,1.0,1,1.0,1,0.14112309136600665,60
4494,1,9217,3402,5815,0,0,0,1.0,1,1.0,1,1.0,1,0.13697517908336107,61
4495,5,9222,3402,5820,0,0,0,1.0,1,1.0,1,1.0,1,0.11076162692390407,59
4496,1,9223,3403,5820,0,0,0,1.0,1,1.0,1,1.0,1,0.14280467197911148,60
4497,0,9223,3403,5820,0,0,0,1.0,1,1.0,1,1.0,1,0.15068602321118696,59
4498,5,9228,3403,5825,0,0,0,1.0,1,1.0,1,1.0,1,0.10915924187620916,57
4499,2,9230,3405,5825,0,0,0,1.0,1,1.0,1,1.0,1,0.1336806431105318,58
4500,1,9231,3406,5825,0,0,0,1.0,1,1.0,1,1.0,1,0.151268895975098,56
4501,5,9236,3408,5828,0,0,0,1.0,1,1.0,1,1.0,1,0.13402264937430233,57
4502,5,9241,3410,5831,0,0,0,1.0,1,1.0,1,1.0,1,0.10265245206696184,56
4503,1,9242,3411,5831,0,0,0,1.0,1,1.0,1,1.0,1,0.1156486340162683,54
4504,0,9242,3411,5831,0,0,0,1.0,1,1.0,1,1.0,1,0.0916896792686317,54
4505,2,9244,3413,5831,0,0,0,1.0,1,1.0,1,1.0,1,0.12444753295912658,51
4506,1,9245,3414,5831,0,0,0,1.0,1,1.0,1,1.0,1,0.13885755554052367,49
4507,2,9247,3415,5832,0,0,0,1.0,1,1.0,1,1.0,1,0.1708976346203976,48
4508,2,9249,3415,5834,0,0,0,1.0,1,1.0,1,1.0,1,0.1794441228927394,48
4509,3,9252,3417,5835,0,0,0,1.0,1,1.0,1,1.0,1,0.18388847709252512,46
4510,6,9258,3417,5841,0,0,0,1.0,1,1.0,1,1.0,1,0.09774295520997069,44
4511,1,9259,3417,5842,0,0,0,1.0,1,1.0,1,1.0,1,0.12018114493183993,45
4512,1,9260,3418,5842,0,0,0,1.0,1,1.0,1,1.0,1,0.12321635003391423,46
4513,1,9261,3418,5843,0,0,0,1.0,1,1.0,1,1.0,1,0.11277276851524796,45
4514,1,9262,3419,5843,0,0,0,1.0,1,1.0,1,1.0,1,0.12273140006225393,46
4515,1,9263,3419,5844,0,0,0,1.0,1,1.0,1,1.0,1,0.12495291585063205,48
4516,1,9264,3419,5845,0,0,0,1.0,1,1.0,1,1.0,1,0.1332957833749827,49
4517,0,9264,3419,5845,0,0,0,1.0,1,1.0,1,1.0,1,0.13645768054494822,50
4518,1,9265,3420,5845,0,0,0,1.0,1,1.0,1,1.0,1,0.1402037115649073,50
4519,3,9268,3422,5846,0,0,0,1.0,1,1.0,1,1.0,1,0.15182691280321586,49
4520,0,9268,3422,5846,0,0,0,1.0,1,1.0,1,1.0,1,0.164377152761933,50
4521,1,9269,3422,5847,0,0,0,1.0,1,1.0,1,1.0,1,0.15807897276864488,50
4522,4,9273,3422,5851,0,0,0,1.0,1,1.0,1,1.0,1,0.13765600105030423,50
4523,2,9275,3423,5852,0,0,0,1.0,1,1.0,1,1.0,1,0.14436519884410165,51
4524,2,9277,3424,5853,0,0,0,1.0,1,1.0,1,1.0,1,0.1556264021892945,52
4525,4,9281,3425,5856,0,0,0,1.0,1,1.0,1,1.0,1,0.12978722180778576,53
4526,2,9283,3425,5858,0,0,0,1.0,1,1.0,1,1.0,1,0.07884295774300498,54
4527,1,9284,3425,5859,0,0,0,1.0,1,1.0,1,1.0,1,0.08920225408818853,55
4528,1,9285,3425,5860,0,0,0,1.0,1,1.0,1,1.0,1,0.06809630354518516,55
4529,0,9285,3425,5860,0,0,0,1.0,1,1.0,1,1.0,1,0.09468498998530733,55
4530,1,9286,3425,5861,0,0,0,1.0,1,1.0,1,1.0,1,0.07346366835279479,56
4531,5,9291,3429,5862,0,0,0,1.0,1,1.0,1,1.0,1,0.11821264081616106,56
4532,0,9291,3429,5862,0,0,0,1.0,1,1.0,1,1.0,1,0.14068379804142278,55
4533,1,9292,3430,5862,0,0,0,1.0,1,1.0,1,1.0,1,0.16075625742273442,54
4534,1,9293,3430,5863,0,0,0,1.0,1,1.0,1,1.0,1,0.14928470127881388,55
4535,3,9296,3431,5865,0,0,0,1.0,1,1.0,1,1.0,1,0.140159526717764,52
4536,4,9300,3433,5867,0,0,0,1.0,1,1.0,1,1.0,1,0.13853009021849055,53
4537,2,9302,3434,5868,0,0,0,1.0,1,1.0,1,1.0,1,0.14688786584342542,52
4538,1,9303,3435,5868,0,0,0,1.0,1,1.0,1,1.0,1,0.14494598088610613,52
4539,3,9306,3437,5869,0,0,0,1.0,1,1.0,1,1.0,1,0.15145655687645926,53
4540,6,9312,3438,5874,0,0,0,1.0,1,1.0,1,1.0,1,0.11731565589846608,54
4541,1,9313,3438,5875,0,0,0,1.0,1,1.0,1,1.0,1,0.13127083319759988,53
4542,4,9317,3441,5876,0,0,0,1.0,1,1.0,1,1.0,1,0.11405738864890456,53
4543,1,9318,3441,5877,0,0,0,1.0,1,1.0,1,1.0,1,0.1082601359061274,53
4544,1,9319,3442,5877,0,0,0,1.0,1,1.0,1,1.0,1,0.09459767939646056,52
4545,0,9319,3442,5877,0,0,0,1.0,1,1.0,1,1.0,1,0.11274212485756485,50
4546,2,9321,3442,5879,0,0,0,1.0,1,1.0,1,1.0,1,0.0823704127485129,49
4547,2,9323,3443,5880,0,0,0,1.0,1,1.0,1,1.0,1,0.08325024399913458,49
4548,0,9323,3443,5880,0,0,0,1.0,1,1.0,1,1.0,1,0.08325024399913458,49
4549,2,9325,3444,5881,0,0,0,1.0,1,1.0,1,1.0,1,0.06340857285134553,50
4550,1,9326,3445,5881,0,0,0,1.0,1,1.0,1,1.0,1,0.0905285398920162,49
4551,0,9326,3445,5881,0,0,0,1.0,1,1.0,1,1.0,1,0.0905285398920162,49
4552,1,9327,3446,5881,0,0,0,1.0,1,1.0,1,1.0,1,0.08490313888327945,49
4553,2,9329,3448,5881,0,0,0,1.0,1,1.0,1,1.0,1,0.16377066452560593,49
4554,2,9331,3450,5881,0,0,0,1.0,1,1.0,1,1.0,1,0.19119262313394045,49
4555,5,9336,3451,5885,0,0,0,1.0,1,1.0,1,1.0,1,0.13580034438337293,48
4556,1,9337,3452,5885,0,0,0,1.0,1,1.0,1,1.0,1,0.153722926890704,48
4557,3,9340,3453,5887,0,0,0,1.0,1,1.0,1,1.0,1,0.16035646064085066,49
4558,2,9342,3455,5887,0,0,0,1.0,1,1.0,1,1.0,1,0.15194112043938196,49
4559,1,9343,3456,5887,0,0,0,1.0,1,1.0,1,1.0,1,0.19533403372354202,50
4560,3,9346,3456,5890,0,0,0,1.0,1,1.0,1,1.0,1,0.18415947989021117,51
4561,2,9348,3456,5892,0,0,0,1.0,1,1.0,1,1.0,1,0.1389845259428096,52
4562,0,9348,3456,5892,0,0,0,1.0,1,1.0,1,1.0,1,0.13556420819295212,53
4563,1,9349,3457,5892,0,0,0,1.0,1,1.0,1,1.0,1,0.14281241348837148,52
4564,0,9349,3457,5892,0,0,0,1.0,1,1.0,1,1.0,1,0.13824169499942787,54
4565,2,9351,3458,5893,0,0,0,1.0,1,1.0,1,1.0,1,0.14003283242404377,55
4566,1,9352,3458,5894,0,0,0,1.0,1,1.0,1,1.0,1,0.12831110975392876,55
4567,3,9355,3460,5895,0,0,0,1.0,1,1.0,1,1.0,1,0.09992569759010256,56
4568,4,9359,3461,5898,0,0,0,1.0,1,1.0,1,1.0,1,0.11140730336447799,58
4569,1,9360,3461,5899,0,0,0,1.0,1,1.0,1,1.0,1,0.09686160922917754,59
4570,4,9364,3463,5901,0,0,0,1.0,1,1.0,1,1.0,1,0.09264610831677861,59
4571,0,9364,3463,5901,0,0,0,1.0,1,1.0,1,1.0,1,0.08493456217370068,57
4572,1,9365,3464,5901,0,0,0,1.0,1,1.0,1,1.0,1,0.09804223744705597,56
4573,2,9367,3465,5902,0,0,0,1.0,1,1.0,1,1.0,1,0.11036781171843221,56
4574,0,9367,3465,5902,0,0,0,1.0,1,1.0,1,1.0,1,0.13106793945853165,55
4575,0,9367,3465,5902,0,0,0,1.0,1,1.0,1,1.0,1,0.13106793945853165,55
4576,2,9369,3465,5904,0,0,0,1.0,1,1.0,1,1.0,1,0.12669844289477364,55
4577,0,9369,3465,5904,0,0,0,1.0,1,1.0,1,1.0,1,0.14005947760604773,54
4578,0,9369,3465,5904,0,0,0,1.0,1,1.0,1,1.0,1,0.1410700227613176,54
4579,3,9372,3466,5906,0,0,0,1.0,1,1.0,1,1.0,1,0.1351584394913852,54
4580,0,9372,3466,5906,0,0,0,1.0,1,1.0,1,1.0,1,0.12783628912473602,55
4581,2,9374,3468,5906,0,0,0,1.0,1,1.0,1,1.0,1,0.17165792025301096,56
4582,0,9374,3468,5906,0,0,0,1.0,1,1.0,1,1.0,1,0.17165792025301096,56
4583,1,9375,3469,5906,0,0,0,1.0,1,1.0,1,1.0,1,0.1731328823420924,57
4584,1,9376,3470,5906,0,0,0,1.0,1,1.0,1,1.0,1,0.19811584738519605,57
4585,3,9379,3470,5909,0,0,0,1.0,1,1.0,1,1.0,1,0.17112826523435307,57
4586,0,9379,3470,5909,0,0,0,1.0,1,1.0,1,1.0,1,0.17112826523435307,57
4587,0,9379,3470,5909,0,0,0,1.0,1,1.0,1,1.0,1,0.17112826523435307,57
4588,0,9379,3470,5909,0,0,0,1.0,1,1.0,1,1.0,1,0.1696913008507962,58
4589,0,9379,3470,5909,0,0,0,1.0,1,1.0,1,1.0,1,0.1786482584109252,59
4590,0,9379,3470,5909,0,0,0,1.0,1,1.0,1,1.0,1,0.18834548020611258,60
4591,0,9379,3470,5909,0,0,0,1.0,1,1.0,1,1.0,1,0.19183656013186537,61
4592,1,9380,3470,5910,0,0,0,1.0,1,1.0,1,1.0,1,0.1691538212855757,62
4593,3,9383,3470,5913,0,0,0,1.0,1,1.0,1,1.0,1,0.14111175035496526,64
4594,3,9386,3470,5916,0,0,0,1.0,1,1.0,1,1.0,1,0.11474185990363442,64
4595,0,9386,3470,5916,0,0,0,1.0,1,1.0,1,1.0,1,0.11538122713560373,63
4596,0,9386,3470,5916,0,0,0,1.0,1,1.0,1,1.0,1,0.11538122713560373,63
4597,3,9389,3471,5918,0,0,0,1.0,1,1.0,1,1.0,1,0.07729062918595758,63
4598,1,9390,3472,5918,0,0,0,1.0,1,1.0,1,1.0,1,0.07673364677039074,65
4599,2,9392,3473,5919,0,0,0,1.0,1,1.0,1,1.0,1,0.09530889774964219,66
4600,3,9395,3474,5921,0,0,0,1.0,1,1.0,1,1.0,1,0.09712986084064537,67
4601,0,9395,3474,5921,0,0,0,1.0,1,1.0,1,1.0,1,0.09712986084064537,67
4602,1,9396,3474,5922,0,0,0,1.0,1,1.0,1,1.0,1,0.09056404949066087,69
4603,2,9398,3475,5923,0,0,0,1.0,1,1.0,1,1.0,1,0.097208609073856,69
4604,1,9399,3476,5923,0,0,0,1.0,1,1.0,1,1.0,1,0.09831880356002873,69
4605,0,9399,3476,5923,0,0,0,1.0,1,1.0,1,1.0,1,0.0957528242851621,70
4606,0,9399,3476,5923,0,0,0,1.0,1,1.0,1,1.0,1,0.0957528242851621,70
4607,3,9402,3476,5926,0,0,0,1.0,1,1.0,1,1.0,1,0.07332630856067822,72
4608,0,9402,3476,5926,0,0,0,1.0,1,1.0,1,1.0,1,0.07976430267072639,73
4609,1,9403,3477,5926,0,0,0,1.0,1,1.0,1,1.0,1,0.09196009110591918,72
4610,2,9405,3478,5927,0,0,0,1.0,1,1.0,1,1.0,1,0.0918540498244877,72
4611,4,9409,3480,5929,0,0,0,1.0,1,1.0,1,1.0,1,0.11670985138970895,71
4612,4,9413,3482,5931,0,0,0,1.0,1,1.0,1,1.0,1,0.10358606266260235,70
4613,0,9413,3482,5931,0,0,0,1.0,1,1.0,1,1.0,1,0.10334461004531259,69
4614,0,9413,3482,5931,0,0,0,1.0,1,1.0,1,1.0,1,0.12175926542646398,68
4615,3,9416,3484,5932,0,0,0,1.0,1,1.0,1,1.0,1,0.115668497803877,68
4616,0,9416,3484,5932,0,0,0,1.0,1,1.0,1,1.0,1,0.16158121903987702,65
4617,1,9417,3485,5932,0,0,0,1.0,1,1.0,1,1.0,1,0.14265994457663123,66
4618,4,9421,3486,5935,0,0,0,1.0,1,1.0,1,1.0,1,0.13626711995824697,66
4619,1,9422,3486,5936,0,0,0,1.0,1,1.0,1,1.0,1,0.13042935900519415,65
4620,1,9423,3486,5937,0,0,0,1.0,1,1.0,1,1.0,1,0.11569410151162868,65
4621,8,9431,3492,5939,0,0,0,1.0,1,1.0,1,1.0,1,0.16868340344880509,67
4622,2,9433,3493,5940,0,0,0,1.0,1,1.0,1,1.0,1,0.16130549303979844,65
4623,1,9434,3493,5941,0,0,0,1.0,1,1.0,1,1.0,1,0.16682998466534496,66
4624,4,9438,3493,5945,0,0,0,1.0,1,1.0,1,1.0,1,0.13741489694161135,65
4625,1,9439,3493,5946,0,0,0,1.0,1,1.0,1,1.0,1,0.1349907700941231,64
4626,1,9440,3494,5946,0,0,0,1.0,1,1.0,1,1.0,1,0.12127720571354351,63
4627,5,9445,3494,5951,0,0,0,1.0,1,1.0,1,1.0,1,0.07605248098939975,65
4628,0,9445,3494,5951,0,0,0,1.0,1,1.0,1,1.0,1,0.07623417646724022,64
4629,1,9446,3495,5951,0,0,0,1.0,1,1.0,1,1.0,1,0.08637442700780822,64
4630,1,9447,3495,5952,0,0,0,1.0,1,1.0,1,1.0,1,0.07425326249097605,64
4631,6,9453,3498,5955,0,0,0,1.0,1,1.0,1,1.0,1,0.1260283096017917,66
4632,4,9457,3498,5959,0,0,0,1.0,1,1.0,1,1.0,1,0.13414721550673664,65
4633,3,9460,3498,5962,0,0,0,1.0,1,1.0,1,1.0,1,0.08293965028324043,66
4634,1,9461,3498,5963,0,0,0,1.0,1,1.0,1,1.0,1,0.07943072861634415,66
4635,0,9461,3498,5963,0,0,0,1.0,1,1.0,1,1.0,1,0.07760710688675197,66
4636,0,9461,3498,5963,0,0,0,1.0,1,1.0,1,1.0,1,0.07760710688675197,66
4637,1,9462,3498,5964,0,0,0,1.0,1,1.0,1,1.0,1,0.06682709167966973,68
4638,0,9462,3498,5964,0,0,0,1.0,1,1.0,1,1.0,1,0.06682709167966973,68
4639,1,9463,3499,5964,0,0,0,1.0,1,1.0,1,1.0,1,0.0794510742755393,69
4640,0,9463,3499,5964,0,0,0,1.0,1,1.0,1,1.0,1,0.0794510742755393,69
4641,2,9465,3499,5966,0,0,0,1.0,1,1.0,1,1.0,1,0.06349800330436609,70
4642,2,9467,3499,5968,0,0,0,1.0,1,1.0,1,1.0,1,0.049361450473957916,69
4643,1,9468,3500,5968,0,0,0,1.0,1,1.0,1,1.0,1,0.05330457153498882,70
4644,1,9469,3501,5968,0,0,0,1.0,1,1.0,1,1.0,1,0.07904382966978774,69
4645,1,9470,3501,5969,0,0,0,1.0,1,1.0,1,1.0,1,0.07719880674649612,70
4646,1,9471,3502,5969,0,0,0,1.0,1,1.0,1,1.0,1,0.11762641377578986,68
4647,3,9474,3505,5969,0,0,0,1.0,1,1.0,1,1.0,1,0.15279544843794188,68
4648,5,9479,3505,5974,0,0,0,1.0,1,1.0,1,1.0,1,0.14288980795547138,67
4649,7,9486,3508,5978,0,0,0,1.0,1,1.0,1,1.0,1,0.16312345637784073,67
4650,0,9486,3508,5978,0,0,0,1.0,1,1.0,1,1.0,1,0.14689877197549314,67
4651,11,9497,3511,5986,0,0,0,1.0,1,1.0,1,1.0,1,0.1286521212777962,68
4652,2,9499,3511,5988,0,0,0,1.0,1,1.0,1,1.0,1,0.14907880339167806,66
4653,2,9501,3512,5989,0,0,0,1.0,1,1.0,1,1.0,1,0.14552500606262342,64
4654,4,9505,3513,5992,0,0,0,1.0,1,1.0,1,1.0,1,0.143868668491296,65
4655,0,9505,3513,5992,0,0,0,1.0,1,1.0,1,1.0,1,0.14250987062328987,64
4656,1,9506,3514,5992,0,0,0,1.0,1,1.0,1,1.0,1,0.16044721484372088,65
4657,4,9510,3514,5996,0,0,0,1.0,1,1.0,1,1.0,1,0.13302738842364853,66
4658,5,9515,3517,5998,0,0,0,1.0,1,1.0,1,1.0,1,0.1999835457489244,65
4659,1,9516,3517,5999,0,0,0,1.0,1,1.0,1,1.0,1,0.19870960820211336,65
4660,6,9522,3520,6002,0,0,0,1.0,1,1.0,1,1.0,1,0.188701102494059,66
4661,3,9525,3520,6005,0,0,0,1.0,1,1.0,1,1.0,1,0.18259345998716425,66
4662,1,9526,3520,6006,0,0,0,1.0,1,1.0,1,1.0,1,0.17055484228829154,68
4663,2,9528,3520,6008,0,0,0,1.0,1,1.0,1,1.0,1,0.1577304043654674,67
4664,5,9533,3521,6012,0,0,0,1.0,1,1.0,1,1.0,1,0.12602923487920564,67
4665,1,9534,3522,6012,0,0,0,1.0,1,1.0,1,1.0,1,0.12156603556663027,67
4666,2,9536,3523,6013,0,0,0,1.0,1,1.0,1,1.0,1,0.12817489181739558,67
4667,1,9537,3524,6013,0,0,0,1.0,1,1.0,1,1.0,1,0.1324012139565387,66
4668,1,9538,3525,6013,0,0,0,1.0,1,1.0,1,1.0,1,0.14741012641301604,66
4669,5,9543,3527,6016,0,0,0,1.0,1,1.0,1,1.0,1,0.1487491828209821,66
4670,0,9543,3527,6016,0,0,0,1.0,1,1.0,1,1.0,1,0.1620344241555609,64
4671,0,9543,3527,6016,0,0,0,1.0,1,1.0,1,1.0,1,0.1620344241555609,64
4672,4,9547,3528,6019,0,0,0,1.0,1,1.0,1,1.0,1,0.17288059976441636,64
4673,2,9549,3528,6021,0,0,0,1.0,1,1.0,1,1.0,1,0.15164585657294144,65
4674,2,9551,3530,6021,0,0,0,1.0,1,1.0,1,1.0,1,0.16432053783117154,66
4675,6,9557,3530,6027,0,0,0,1.0,1,1.0,1,1.0,1,0.12644274538062195,65
4676,0,9557,3530,6027,0,0,0,1.0,1,1.0,1,1.0,1,0.1515682829603004,65
4677,0,9557,3530,6027,0,0,0,1.0,1,1.0,1,1.0,1,0.16571630023674475,65
4678,2,9559,3530,6029,0,0,0,1.0,1,1.0,1,1.0,1,0.17197847268296843,64
4679,2,9561,3530,6031,0,0,0,1.0,1,1.0,1,1.0,1,0.154767803774463,66
4680,2,9563,3530,6033,0,0,0,1.0,1,1.0,1,1.0,1,0.16120196115631036,67
4681,3,9566,3530,6036,0,0,0,1.0,1,1.0,1,1.0,1,0.12587868926078746,67
4682,4,9570,3533,6037,0,0,0,1.0,1,1.0,1,1.0,1,0.14337968965495274,67
4683,3,9573,3534,6039,0,0,0,1.0,1,1.0,1,1.0,1,0.13616460162634575,67
4684,4,9577,3536,6041,0,0,0,1.0,1,1.0,1,1.0,1,0.1371338519695791,66
4685,0,9577,3536,6041,0,0,0,1.0,1,1.0,1,1.0,1,0.13037448133393995,65
4686,1,9578,3537,6041,0,0,0,1.0,1,1.0,1,1.0,1,0.1768225148510671,65
4687,1,9579,3537,6042,0,0,0,1.0,1,1.0,1,1.0,1,0.15942712271155976,65
4688,3,9582,3539,6043,0,0,0,1.0,1,1.0,1,1.0,1,0.18544636122374267,64
4689,4,9586,3540,6046,0,0,0,1.0,1,1.0,1,1.0,1,0.1681710782482309,65
4690,0,9586,3540,6046,0,0,0,1.0,1,1.0,1,1.0,1,0.18207238058064318,63
4691,6,9592,3543,6049,0,0,0,1.0,1,1.0,1,1.0,1,0.18419216679748412,64
4692,0,9592,3543,6049,0,0,0,1.0,1,1.0,1,1.0,1,0.15372063847070527,63
4693,6,9598,3545,6053,0,0,0,1.0,1,1.0,1,1.0,1,0.1788664639207914,64
4694,1,9599,3545,6054,0,0,0,1.0,1,1.0,1,1.0,1,0.15162701881056195,63
4695,0,9599,3545,6054,0,0,0,1.0,1,1.0,1,1.0,1,0.15356032014946075,62
4696,2,9601,3545,6056,0,0,0,1.0,1,1.0,1,1.0,1,0.14287425623396272,61
4697,3,9604,3545,6059,0,0,0,1.0,1,1.0,1,1.0,1,0.12171763568102104,63
4698,1,9605,3545,6060,0,0,0,1.0,1,1.0,1,1.0,1,0.13017293122569484,63
4699,2,9607,3545,6062,0,0,0,1.0,1,1.0,1,1.0,1,0.1068578703987179,65
4700,0,9607,3545,6062,0,0,0,1.0,1,1.0,1,1.0,1,0.11405134599319722,64
4701,4,9611,3547,6064,0,0,0,1.0,1,1.0,1,1.0,1,0.1323116151669817,64
4702,3,9614,3547,6067,0,0,0,1.0,1,1.0,1,1.0,1,0.11959792643308606,66
4703,1,9615,3548,6067,0,0,0,1.0,1,1.0,1,1.0,1,0.11994135693186976,65
4704,0,9615,3548,6067,0,0,0,1.0,1,1.0,1,1.0,1,0.11024500258867485,64
4705,3,9618,3550,6068,0,0,0,1.0,1,1.0,1,1.0,1,0.1574590993028377,65
4706,6,9624,3555,6069,0,0,0,1.0,1,1.0,1,1.0,1,0.20015798080740055,65
4707,4,9628,3556,6072,0,0,0,1.0,1,1.0,1,1.0,1,0.2024168047483359,63
4708,5,9633,3557,6076,0,0,0,1.0,1,1.0,1,1.0,1,0.16360370674439093,62
4709,4,9637,3560,6077,0,0,0,1.0,1,1.0,1,1.0,1,0.18684616247296504,61
4710,0,9637,3560,6077,0,0,0,1.0,1,1.0,1,1.0,1,0.1813194862621036,60
4711,5,9642,3562,6080,0,0,0,1.0,1,1.0,1,1.0,1,0.17944153673080637,59
4712,3,9645,3563,6082,0,0,0,1.0,1,1.0,1,1.0,1,0.1603618084287949,58
4713,4,9649,3565,6084,0,0,0,1.0,1,1.0,1,1.0,1,0.16359435454511592,58
4714,5,9654,3565,6089,0,0,0,1.0,1,1.0,1,1.0,1,0.13901846964723202,57
4715,0,9654,3565,6089,0,0,0,1.0,1,1.0,1,1.0,1,0.15336037721644222,57
4716,4,9658,3566,6092,0,0,0,1.0,1,1.0,1,1.0,1,0.1548892887517745,55
4717,7,9665,3568,6097,0,0,0,1.0,1,1.0,1,1.0,1,0.11045727193841817,57
4718,1,9666,3568,6098,0,0,0,1.0,1,1.0,1,1.0,1,0.10089404145123704,56
4719,1,9667,3569,6098,0,0,0,1.0,1,1.0,1,1.0,1,0.1481118562972244,56
4720,5,9672,3569,6103,0,0,0,1.0,1,1.0,1,1.0,1,0.10847656152344849,57
4721,1,9673,3569,6104,0,0,0,1.0,1,1.0,1,1.0,1,0.08716582664790105,57
4722,1,9674,3570,6104,0,0,0,1.0,1,1.0,1,1.0,1,0.10101945705528742,57
4723,4,9678,3570,6108,0,0,0,1.0,1,1.0,1,1.0,1,0.09562528040948573,57
4724,0,9678,3570,6108,0,0,0,1.0,1,1.0,1,1.0,1,0.09800871560243074,57
4725,1,9679,3570,6109,0,0,0,1.0,1,1.0,1,1.0,1,0.11689792534964477,57
4726,3,9682,3571,6111,0,0,0,1.0,1,1.0,1,1.0,1,0.12585098824700564,57
4727,1,9683,3571,6112,0,0,0,1.0,1,1.0,1,1.0,1,0.1208213927944041,56
4728,0,9683,3571,6112,0,0,0,1.0,1,1.0,1,1.0,1,0.12968083248403034,57
4729,1,9684,3571,6113,0,0,0,1.0,1,1.0,1,1.0,1,0.14211972129107656,56
4730,2,9686,3573,6113,0,0,0,1.0,1,1.0,1,1.0,1,0.16418304515873147,54
4731,1,9687,3574,6113,0,0,0,1.0,1,1.0,1,1.0,1,0.16881756994091518,54
4732,6,9693,3576,6117,0,0,0,1.0,1,1.0,1,1.0,1,0.17436391196957035,54
4733,1,9694,3577,6117,0,0,0,1.0,1,1.0,1,1.0,1,0.18249120080310777,55
4734,3,9697,3579,6118,0,0,0,1.0,1,1.0,1,1.0,1,0.2386230457962976,56
4735,2,9699,3580,6119,0,0,0,1.0,1,1.0,1,1.0,1,0.23304875409771794,56
4736,4,9703,3581,6122,0,0,0,1.0,1,1.0,1,1.0,1,0.20325018746944146,58
4737,0,9703,3581,6122,0,0,0,1.0,1,1.0,1,1.0,1,0.19293844306750038,59
4738,3,9706,3584,6122,0,0,0,1.0,1,1.0,1,1.0,1,0.2446380007436437,60
4739,3,9709,3584,6125,0,0,0,1.0,1,1.0,1,1.0,1,0.23420476112246083,60
4740,1,9710,3584,6126,0,0,0,1.0,1,1.0,1,1.0,1,0.23336417177231478,60
4741,2,9712,3584,6128,0,0,0,1.0,1,1.0,1,1.0,1,0.22318493934193387,61
4742,2,9714,3585,6129,0,0,0,1.0,1,1.0,1,1.0,1,0.22199103257580527,61
4743,0,9714,3585,6129,0,0,0,1.0,1,1.0,1,1.0,1,0.21374437048324144,60
4744,4,9718,3586,6132,0,0,0,1.0,1,1.0,1,1.0,1,0.17795119331290765,60
4745,1,9719,3586,6133,0,0,0,1.0,1,1.0,1,1.0,1,0.16179235045534646,59
4746,4,9723,3588,6135,0,0,0,1.0,1,1.0,1,1.0,1,0.16136015745304225,59
4747,4,9727,3590,6137,0,0,0,1.0,1,1.0,1,1.0,1,0.13528324372924247,58
4748,5,9732,3592,6140,0,0,0,1.0,1,1.0,1,1.0,1,0.09261966517672685,58
4749,2,9734,3593,6141,0,0,0,1.0,1,1.0,1,1.0,1,0.09332210749879073,58
4750,2,9736,3594,6142,0,0,0,1.0,1,1.0,1,1.0,1,0.08717349652319374,56
4751,3,9739,3595,6144,0,0,0,1.0,1,1.0,1,1.0,1,0.08668858449658037,58
4752,1,9740,3596,6144,0,0,0,1.0,1,1.0,1,1.0,1,0.08926437094028429,55
4753,0,9740,3596,6144,0,0,0,1.0,1,1.0,1,1.0,1,0.08926437094028429,55
4754,0,9740,3596,6144,0,0,0,1.0,1,1.0,1,1.0,1,0.10382686955104822,54
4755,3,9743,3597,6146,0,0,0,1.0,1,1.0,1,1.0,1,0.09554022292110136,54
4756,4,9747,3598,6149,0,0,0,1.0,1,1.0,1,1.0,1,0.06378968537290594,54
4757,0,9747,3598,6149,0,0,0,1.0,1,1.0,1,1.0,1,0.0756118544069397,53
4758,0,9747,3598,6149,0,0,0,1.0,1,1.0,1,1.0,1,0.0756118544069397,53
4759,2,9749,3599,6150,0,0,0,1.0,1,1.0,1,1.0,1,0.09821830834774836,53
4760,2,9751,3600,6151,0,0,0,1.0,1,1.0,1,1.0,1,0.13136606194703077,53
4761,3,9754,3601,6153,0,0,0,1.0,1,1.0,1,1.0,1,0.12977451613085292,52
4762,8,9762,3603,6159,0,0,0,1.0,1,1.0,1,1.0,1,0.15484480197490025,54
4763,1,9763,3603,6160,0,0,0,1.0,1,1.0,1,1.0,1,0.14372677911654402,54
4764,2,9765,3604,6161,0,0,0,1.0,1,1.0,1,1.0,1,0.1493752032701059,55
4765,3,9768,3606,6162,0,0,0,1.0,1,1.0,1,1.0,1,0.1995255155445046,56
4766,3,9771,3607,6164,0,0,0,1.0,1,1.0,1,1.0,1,0.16263699206300397,58
4767,7,9778,3608,6170,0,0,0,1.0,1,1.0,1,1.0,1,0.11950115341371234,59
4768,2,9780,3609,6171,0,0,0,1.0,1,1.0,1,1.0,1,0.1152899764337655,60
4769,0,9780,3609,6171,0,0,0,1.0,1,1.0,1,1.0,1,0.1231392389836387,59
4770,0,9780,3609,6171,0,0,0,1.0,1,1.0,1,1.0,1,0.12790715351715343,60
4771,1,9781,3609,6172,0,0,0,1.0,1,1.0,1,1.0,1,0.14176366066636392,59
4772,1,9782,3609,6173,0,0,0,1.0,1,1.0,1,1.0,1,0.1342544623601891,59
4773,0,9782,3609,6173,0,0,0,1.0,1,1.0,1,1.0,1,0.12006444488739819,60
4774,1,9783,3610,6173,0,0,0,1.0,1,1.0,1,1.0,1,0.14269680279082053,60
4775,0,9783,3610,6173,0,0,0,1.0,1,1.0,1,1.0,1,0.14393621964665915,62
4776,0,9783,3610,6173,0,0,0,1.0,1,1.0,1,1.0,1,0.13533459478037754,63
4777,2,9785,3611,6174,0,0,0,1.0,1,1.0,1,1.0,1,0.12765469043090885,63
4778,0,9785,3611,6174,0,0,0,1.0,1,1.0,1,1.0,1,0.12765469043090885,63
4779,0,9785,3611,6174,0,0,0,1.0,1,1.0,1,1.0,1,0.12765469043090885,63
4780,3,9788,3612,6176,0,0,0,1.0,1,1.0,1,1.0,1,0.11948077925556055,65
4781,0,9788,3612,6176,0,0,0,1.0,1,1.0,1,1.0,1,0.13963970160965367,64
4782,3,9791,3612,6179,0,0,0,1.0,1,1.0,1,1.0,1,0.11038484943799888,65
4783,7,9798,3614,6184,0,0,0,1.0,1,1.0,1,1.0,1,0.10026436913063715,66
4784,5,9803,3616,6187,0,0,0,1.0,1,1.0,1,1.0,1,0.048269837889501406,64
4785,3,9806,3617,6189,0,0,0,1.0,1,1.0,1,1.0,1,0.06800222676171541,65
4786,2,9808,3619,6189,0,0,0,1.0,1,1.0,1,1.0,1,0.07818378582904661,66
4787,2,9810,3621,6189,0,0,0,1.0,1,1.0,1,1.0,1,0.08368653106710744,63
4788,5,9815,3624,6191,0,0,0,1.0,1,1.0,1,1.0,1,0.10200314498201168,63
4789,8,9823,3627,6196,0,0,0,1.0,1,1.0,1,1.0,1,0.04805729713789175,60
4790,3,9826,3627,6199,0,0,0,1.0,1,1.0,1,1.0,1,0.04201843311663159,61
4791,3,9829,3629,6200,0,0,0,1.0,1,1.0,1,1.0,1,0.08906607678143269,59
4792,3,9832,3631,6201,0,0,0,1.0,1,1.0,1,1.0,1,0.06967556457066974,59
4793,1,9833,3632,6201,0,0,0,1.0,1,1.0,1,1.0,1,0.09480523429870465,61
4794,3,9836,3634,6202,0,0,0,1.0,1,1.0,1,1.0,1,0.07548466051717978,60
4795,3,9839,3635,6204,0,0,0,1.0,1,1.0,1,1.0,1,0.04939740401578492,61
4796,2,9841,3637,6204,0,0,0,1.0,1,1.0,1,1.0,1,0.09338015447326697,60
4797,3,9844,3638,6206,0,0,0,1.0,1,1.0,1,1.0,1,0.09836609112029747,61
4798,8,9852,3639,6213,0,0,0,1.0,1,1.0,1,1.0,1,0.10447193071708065,61
4799,1,9853,3639,6214,0,0,0,1.0,1,1.0,1,1.0,1,0.13539022654481506,59
4800,1,9854,3639,6215,0,0,0,1.0,1,1.0,1,1.0,1,0.14432018106639471,57
4801,8,9862,3640,6222,0,0,0,1.0,1,1.0,1,1.0,1,0.10087214936977071,58
4802,5,9867,3640,6227,0,0,0,1.0,1,1.0,1,1.0,1,0.12513109134654377,56
4803,6,9873,3641,6232,0,0,0,1.0,1,1.0,1,1.0,1,0.10869471845539745,57
4804,1,9874,3641,6233,0,0,0,1.0,1,1.0,1,1.0,1,0.067681904340894,55
4805,4,9878,3644,6234,0,0,0,1.0,1,1.0,1,1.0,1,0.14158258393152107,56
4806,1,9879,3644,6235,0,0,0,1.0,1,1.0,1,1.0,1,0.09732957647377337,55
4807,0,9879,3644,6235,0,0,0,1.0,1,1.0,1,1.0,1,0.10734465152211095,53
4808,5,9884,3646,6238,0,0,0,1.0,1,1.0,1,1.0,1,0.10464261631873822,54
4809,2,9886,3646,6240,0,0,0,1.0,1,1.0,1,1.0,1,0.12233966389975415,53
4810,2,9888,3647,6241,0,0,0,1.0,1,1.0,1,1.0,1,0.09117475114854062,53
4811,3,9891,3648,6243,0,0,0,1.0,1,1.0,1,1.0,1,0.08262698563259911,54
4812,1,9892,3649,6243,0,0,0,1.0,1,1.0,1,1.0,1,0.07963860673776382,54
4813,3,9895,3650,6245,0,0,0,1.0,1,1.0,1,1.0,1,0.05879229644944282,55
4814,2,9897,3652,6245,0,0,0,1.0,1,1.0,1,1.0,1,0.0983705275575096,55
4815,2,9899,3652,6247,0,0,0,1.0,1,1.0,1,1.0,1,0.10874174365001096,56
4816,2,9901,3653,6248,0,0,0,1.0,1,1.0,1,1.0,1,0.1118699320510232,56
4817,6,9907,3655,6252,0,0,0,1.0,1,1.0,1,1.0,1,0.0932088703303663,58
4818,4,9911,3658,6253,0,0,0,1.0,1,1.0,1,1.0,1,0.11959554180164277,58
4819,4,9915,3659,6256,0,0,0,1.0,1,1.0,1,1.0,1,0.12049543658987992,58
4820,1,9916,3659,6257,0,0,0,1.0,1,1.0,1,1.0,1,0.10956643509007571,58
4821,2,9918,3659,6259,0,0,0,1.0,1,1.0,1,1.0,1,0.10218689232748736,58
4822,1,9919,3659,6260,0,0,0,1.0,1,1.0,1,1.0,1,0.09100103310205022,58
4823,2,9921,3660,6261,0,0,0,1.0,1,1.0,1,1.0,1,0.09233506679254051,57
4824,3,9924,3660,6264,0,0,0,1.0,1,1.0,1,1.0,1,0.07887290483227222,56
4825,1,9925,3660,6265,0,0,0,1.0,1,1.0,1,1.0,1,0.12369116708038246,57
4826,2,9927,3662,6265,0,0,0,1.0,1,1.0,1,1.0,1,0.12081562323751642,57
4827,3,9930,3662,6268,0,0,0,1.0,1,1.0,1,1.0,1,0.1414689735949008,56
4828,3,9933,3663,6270,0,0,0,1.0,1,1.0,1,1.0,1,0.10049854500996404,57
4829,0,9933,3663,6270,0,0,0,1.0,1,1.0,1,1.0,1,0.10881228008283382,56
4830,1,9934,3664,6270,0,0,0,1.0,1,1.0,1,1.0,1,0.10020025972421769,57
4831,4,9938,3666,6272,0,0,0,1.0,1,1.0,1,1.0,1,0.1306863713133905,57
4832,0,9938,3666,6272,0,0,0,1.0,1,1.0,1,1.0,1,0.134466347448785,55
4833,3,9941,3667,6274,0,0,0,1.0,1,1.0,1,1.0,1,0.1375626310091349,55
4834,4,9945,3667,6278,0,0,0,1.0,1,1.0,1,1.0,1,0.11056006794870352,55
4835,3,9948,3667,6281,0,0,0,1.0,1,1.0,1,1.0,1,0.09905311189292505,55
4836,2,9950,3667,6283,0,0,0,1.0,1,1.0,1,1.0,1,0.08990498557529795,55
4837,1,9951,3667,6284,0,0,0,1.0,1,1.0,1,1.0,1,0.08802282022030954,53
4838,2,9953,3667,6286,0,0,0,1.0,1,1.0,1,1.0,1,0.06710021339240174,54
4839,3,9956,3669,6287,0,0,0,1.0,1,1.0,1,1.0,1,0.10422168730301166,53
4840,5,9961,3670,6291,0,0,0,1.0,1,1.0,1,1.0,1,0.063898924053977,52
4841,4,9965,3673,6292,0,0,0,1.0,1,1.0,1,1.0,1,0.11571071789500115,51
4842,5,9970,3675,6295,0,0,0,1.0,1,1.0,1,1.0,1,0.16966213899211416,50
4843,5,9975,3676,6299,0,0,0,1.0,1,1.0,1,1.0,1,0.12628384488448058,51
4844,1,9976,3676,6300,0,0,0,1.0,1,1.0,1,1.0,1,0.09764075555958708,50
4845,3,9979,3678,6301,0,0,0,1.0,1,1.0,1,1.0,1,0.14076478632508302,49
4846,3,9982,3678,6304,0,0,0,1.0,1,1.0,1,1.0,1,0.10898652021420005,49
4847,0,9982,3678,6304,0,0,0,1.0,1,1.0,1,1.0,1,0.12734827294185486,48
4848,2,9984,3680,6304,0,0,0,1.0,1,1.0,1,1.0,1,0.13807133163135563,48
4849,1,9985,3681,6304,0,0,0,1.0,1,1.0,1,1.0,1,0.13575845958883304,48
4850,1,9986,3681,6305,0,0,0,1.0,1,1.0,1,1.0,1,0.12786837960734096,49
4851,3,9989,3681,6308,0,0,0,1.0,1,1.0,1,1.0,1,0.12673230571442737,49
4852,1,9990,3681,6309,0,0,0,1.0,1,1.0,1,1.0,1,0.14817391897041873,49
4853,0,9990,3681,6309,0,0,0,1.0,1,1.0,1,1.0,1,0.14424449078363413,50
4854,3,9993,3682,6311,0,0,0,1.0,1,1.0,1,1.0,1,0.13371741664960946,51
4855,1,9994,3682,6312,0,0,0,1.0,1,1.0,1,1.0,1,0.12705995864287514,51
4856,0,9994,3682,6312,0,0,0,1.0,1,1.0,1,1.0,1,0.13246422556817478,50
4857,1,9995,3682,6313,0,0,0,1.0,1,1.0,1,1.0,1,0.11408144423691476,51
4858,1,9996,3682,6314,0,0,0,1.0,1,1.0,1,1.0,1,0.10256435408704992,51
4859,0,9996,3682,6314,0,0,0,1.0,1,1.0,1,1.0,1,0.11275552398112904,52
4860,0,9996,3682,6314,0,0,0,1.0,1,1.0,1,1.0,1,0.11275552398112904,52
4861,1,9997,3682,6315,0,0,0,1.0,1,1.0,1,1.0,1,0.1148084822503383,53
4862,2,9999,3684,6315,0,0,0,1.0,1,1.0,1,1.0,1,0.14197242089880768,53
4863,0,9999,3684,6315,0,0,0,1.0,1,1.0,1,1.0,1,0.12948167267009808,51
4864,4,10003,3684,6319,0,0,0,1.0,1,1.0,1,1.0,1,0.07443544599419337,53
4865,1,10004,3684,6320,0,0,0,1.0,1,1.0,1,1.0,1,0.07722819155042343,52
4866,1,10005,3685,6320,0,0,0,1.0,1,1.0,1,1.0,1,0.0869108187446531,53
4867,3,10008,3686,6322,0,0,0,1.0,1,1.0,1,1.0,1,0.06333489549549895,51
4868,2,10010,3687,6323,0,0,0,1.0,1,1.0,1,1.0,1,0.09510741054775242,53
4869,2,10012,3687,6325,0,0,0,1.0,1,1.0,1,1.0,1,0.09440290046923022,53
4870,5,10017,3689,6328,0,0,0,1.0,1,1.0,1,1.0,1,0.09198148214643351,55
4871,2,10019,3690,6329,0,0,0,1.0,1,1.0,1,1.0,1,0.10612270228634792,55
4872,3,10022,3692,6330,0,0,0,1.0,1,1.0,1,1.0,1,0.13178364762477854,56
4873,5,10027,3693,6334,0,0,0,1.0,1,1.0,1,1.0,1,0.09309200555554217,56
4874,2,10029,3694,6335,0,0,0,1.0,1,1.0,1,1.0,1,0.10791502092287429,58
4875,1,10030,3694,6336,0,0,0,1.0,1,1.0,1,1.0,1,0.10477340762788748,56
4876,5,10035,3696,6339,0,0,0,1.0,1,1.0,1,1.0,1,0.10348874143097202,56
4877,2,10037,3697,6340,0,0,0,1.0,1,1.0,1,1.0,1,0.11563088456033009,54
4878,0,10037,3697,6340,0,0,0,1.0,1,1.0,1,1.0,1,0.11563088456033009,54
4879,5,10042,3700,6342,0,0,0,1.0,1,1.0,1,1.0,1,0.1253746615274428,54
4880,0,10042,3700,6342,0,0,0,1.0,1,1.0,1,1.0,1,0.15547217729385038,53
4881,1,10043,3700,6343,0,0,0,1.0,1,1.0,1,1.0,1,0.15838871410900762,54
4882,5,10048,3701,6347,0,0,0,1.0,1,1.0,1,1.0,1,0.11937711344944016,52
4883,1,10049,3701,6348,0,0,0,1.0,1,1.0,1,1.0,1,0.11283996526581362,54
4884,0,10049,3701,6348,0,0,0,1.0,1,1.0,1,1.0,1,0.13519513435633504,52
4885,2,10051,3702,6349,0,0,0,1.0,1,1.0,1,1.0,1,0.11101077832332966,51
4886,0,10051,3702,6349,0,0,0,1.0,1,1.0,1,1.0,1,0.11542894597817846,50
4887,0,10051,3702,6349,0,0,0,1.0,1,1.0,1,1.0,1,0.13025195604591525,49
4888,1,10052,3702,6350,0,0,0,1.0,1,1.0,1,1.0,1,0.1250863957943769,48
4889,1,10053,3702,6351,0,0,0,1.0,1,1.0,1,1.0,1,0.11577211264542182,48
4890,0,10053,3702,6351,0,0,0,1.0,1,1.0,1,1.0,1,0.11577211264542182,48
4891,1,10054,3703,6351,0,0,0,1.0,1,1.0,1,1.0,1,0.17095965368112812,49
4892,3,10057,3703,6354,0,0,0,1.0,1,1.0,1,1.0,1,0.1540929994305987,51
4893,0,10057,3703,6354,0,0,0,1.0,1,1.0,1,1.0,1,0.1555920669353046,51
4894,4,10061,3704,6357,0,0,0,1.0,1,1.0,1,1.0,1,0.12444251022914672,52
4895,0,10061,3704,6357,0,0,0,1.0,1,1.0,1,1.0,1,0.12444251022914672,52
4896,0,10061,3704,6357,0,0,0,1.0,1,1.0,1,1.0,1,0.11658940565860304,51
4897,1,10062,3704,6358,0,0,0,1.0,1,1.0,1,1.0,1,0.10518433192738248,52
4898,1,10063,3705,6358,0,0,0,1.0,1,1.0,1,1.0,1,0.0932017105041819,52
4899,1,10064,3705,6359,0,0,0,1.0,1,1.0,1,1.0,1,0.08440314929392162,53
4900,3,10067,3707,6360,0,0,0,1.0,1,1.0,1,1.0,1,0.06209948048206166,54
4901,2,10069,3709,6360,0,0,0,1.0,1,1.0,1,1.0,1,0.08337665295855377,54
4902,1,10070,3710,6360,0,0,0,1.0,1,1.0,1,1.0,1,0.09600168673229748,55
4903,5,10075,3712,6363,0,0,0,1.0,1,1.0,1,1.0,1,0.12070828410980125,56
4904,5,10080,3714,6366,0,0,0,1.0,1,1.0,1,1.0,1,0.14806271398398738,55
4905,1,10081,3714,6367,0,0,0,1.0,1,1.0,1,1.0,1,0.14299665884778806,54
4906,6,10087,3715,6372,0,0,0,1.0,1,1.0,1,1.0,1,0.10132409053566016,54
4907,2,10089,3715,6374,0,0,0,1.0,1,1.0,1,1.0,1,0.09774289640004111,54
4908,0,10089,3715,6374,0,0,0,1.0,1,1.0,1,1.0,1,0.09914954999098828,53
4909,2,10091,3717,6374,0,0,0,1.0,1,1.0,1,1.0,1,0.11532428695820447,54
4910,2,10093,3717,6376,0,0,0,1.0,1,1.0,1,1.0,1,0.09630781703105211,55
4911,2,10095,3718,6377,0,0,0,1.0,1,1.0,1,1.0,1,0.11235826911460692,57
4912,4,10099,3721,6378,0,0,0,1.0,1,1.0,1,1.0,1,0.1298594384672667,57
4913,0,10099,3721,6378,0,0,0,1.0,1,1.0,1,1.0,1,0.11366646106792226,56
4914,3,10102,3723,6379,0,0,0,1.0,1,1.0,1,1.0,1,0.12377996908306506,56
4915,2,10104,3724,6380,0,0,0,1.0,1,1.0,1,1.0,1,0.10507547609845595,56
4916,1,10105,3725,6380,0,0,0,1.0,1,1.0,1,1.0,1,0.13990276122485637,54
4917,1,10106,3725,6381,0,0,0,1.0,1,1.0,1,1.0,1,0.1705908528392478,53
4918,6,10112,3727,6385,0,0,0,1.0,1,1.0,1,1.0,1,0.13401359958384007,52
4919,1,10113,3728,6385,0,0,0,1.0,1,1.0,1,1.0,1,0.18171793427424285,49
4920,0,10113,3728,6385,0,0,0,1.0,1,1.0,1,1.0,1,0.18171793427424285,49
4921,5,10118,3729,6389,0,0,0,1.0,1,1.0,1,1.0,1,0.15616511800560554,50
4922,3,10121,3729,6392,0,0,0,1.0,1,1.0,1,1.0,1,0.1257358217182746,50
4923,2,10123,3729,6394,0,0,0,1.0,1,1.0,1,1.0,1,0.13463811566197845,52
4924,3,10126,3729,6397,0,0,0,1.0,1,1.0,1,1.0,1,0.11778723378861282,53
4925,1,10127,3729,6398,0,0,0,1.0,1,1.0,1,1.0,1,0.08049640998464334,54
4926,2,10129,3729,6400,0,0,0,1.0,1,1.0,1,1.0,1,0.08049640998464334,54
4927,1,10130,3730,6400,0,0,0,1.0,1,1.0,1,1.0,1,0.08854986064878186,54
4928,0,10130,3730,6400,0,0,0,1.0,1,1.0,1,1.0,1,0.08854986064878186,54
4929,0,10130,3730,6400,0,0,0,1.0,1,1.0,1,1.0,1,0.10229329721627112,55
4930,3,10133,3731,6402,0,0,0,1.0,1,1.0,1,1.0,1,0.11119054149285876,58
4931,0,10133,3731,6402,0,0,0,1.0,1,1.0,1,1.0,1,0.11119054149285876,58
4932,3,10136,3731,6405,0,0,0,1.0,1,1.0,1,1.0,1,0.11711298538038996,59
4933,2,10138,3731,6407,0,0,0,1.0,1,1.0,1,1.0,1,0.09175055043378261,59
4934,2,10140,3733,6407,0,0,0,1.0,1,1.0,1,1.0,1,0.11670015224108368,59
4935,3,10143,3734,6409,0,0,0,1.0,1,1.0,1,1.0,1,0.10880987419056543,59
4936,2,10145,3735,6410,0,0,0,1.0,1,1.0,1,1.0,1,0.1295629317815245,59
4937,1,10146,3735,6411,0,0,0,1.0,1,1.0,1,1.0,1,0.13356897623380853,61
4938,1,10147,3735,6412,0,0,0,1.0,1,1.0,1,1.0,1,0.12782810581917997,62
4939,1,10148,3735,6413,0,0,0,1.0,1,1.0,1,1.0,1,0.13209510992633233,63
4940,1,10149,3735,6414,0,0,0,1.0,1,1.0,1,1.0,1,0.1334940641290668,65
4941,0,10149,3735,6414,0,0,0,1.0,1,1.0,1,1.0,1,0.1334940641290668,65
4942,6,10155,3738,6417,0,0,0,1.0,1,1.0,1,1.0,1,0.14839849131444866,67
4943,2,10157,3738,6419,0,0,0,1.0,1,1.0,1,1.0,1,0.13893554634705021,66
4944,4,10161,3740,6421,0,0,0,1.0,1,1.0,1,1.0,1,0.15055220419431314,63
4945,4,10165,3741,6424,0,0,0,1.0,1,1.0,1,1.0,1,0.10637248128632737,61
4946,2,10167,3742,6425,0,0,0,1.0,1,1.0,1,1.0,1,0.11281340086985302,60
4947,1,10168,3742,6426,0,0,0,1.0,1,1.0,1,1.0,1,0.10072959810164764,58
4948,1,10169,3743,6426,0,0,0,1.0,1,1.0,1,1.0,1,0.1007496735051985,57
4949,1,10170,3743,6427,0,0,0,1.0,1,1.0,1,1.0,1,0.09417802239160321,56
4950,1,10171,3743,6428,0,0,0,1.0,1,1.0,1,1.0,1,0.10224665295618367,57
4951,5,10176,3745,6431,0,0,0,1.0,1,1.0,1,1.0,1,0.09538262267284509,55
4952,5,10181,3748,6433,0,0,0,1.0,1,1.0,1,1.0,1,0.1293543107841865,55
4953,5,10186,3749,6437,0,0,0,1.0,1,1.0,1,1.0,1,0.12938834543079544,54
4954,3,10189,3750,6439,0,0,0,1.0,1,1.0,1,1.0,1,0.10194584183862958,54
4955,1,10190,3750,6440,0,0,0,1.0,1,1.0,1,1.0,1,0.09875464612935825,52
4956,0,10190,3750,6440,0,0,0,1.0,1,1.0,1,1.0,1,0.09875464612935825,52
4957,4,10194,3751,6443,0,0,0,1.0,1,1.0,1,1.0,1,0.05963942052314103,53
4958,1,10195,3752,6443,0,0,0,1.0,1,1.0,1,1.0,1,0.06433314342609567,52
4959,1,10196,3753,6443,0,0,0,1.0,1,1.0,1,1.0,1,0.08967185597477166,51
4960,1,10197,3753,6444,0,0,0,1.0,1,1.0,1,1.0,1,0.08247146486249943,53
4961,1,10198,3754,6444,0,0,0,1.0,1,1.0,1,1.0,1,0.08384982765242797,53
4962,1,10199,3754,6445,0,0,0,1.0,1,1.0,1,1.0,1,0.07491652268490046,55
4963,2,10201,3755,6446,0,0,0,1.0,1,1.0,1,1.0,1,0.05970408831732443,54
4964,3,10204,3757,6447,0,0,0,1.0,1,1.0,1,1.0,1,0.043873532376834536,54
4965,1,10205,3758,6447,0,0,0,1.0,1,1.0,1,1.0,1,0.07166035654847713,54
4966,2,10207,3759,6448,0,0,0,1.0,1,1.0,1,1.0,1,0.0852272510082302,54
4967,5,10212,3761,6451,0,0,0,1.0,1,1.0,1,1.0,1,0.10215180281748171,55
4968,1,10213,3762,6451,0,0,0,1.0,1,1.0,1,1.0,1,0.09880438736659307,55
4969,4,10217,3763,6454,0,0,0,1.0,1,1.0,1,1.0,1,0.08846331577874174,57
4970,1,10218,3764,6454,0,0,0,1.0,1,1.0,1,1.0,1,0.10857578793230654,56
4971,4,10222,3766,6456,0,0,0,1.0,1,1.0,1,1.0,1,0.13265836380628568,57
4972,6,10228,3767,6461,0,0,0,1.0,1,1.0,1,1.0,1,0.11960762554030735,57
4973,2,10230,3768,6462,0,0,0,1.0,1,1.0,1,1.0,1,0.10598061886314106,60
4974,0,10230,3768,6462,0,0,0,1.0,1,1.0,1,1.0,1,0.12041582288048795,58
4975,1,10231,3768,6463,0,0,0,1.0,1,1.0,1,1.0,1,0.116673374052907,59
4976,3,10234,3770,6464,0,0,0,1.0,1,1.0,1,1.0,1,0.10308928443060145,59
4977,2,10236,3772,6464,0,0,0,1.0,1,1.0,1,1.0,1,0.11571501570861144,59
4978,3,10239,3773,6466,0,0,0,1.0,1,1.0,1,1.0,1,0.09465302270874114,59
4979,3,10242,3774,6468,0,0,0,1.0,1,1.0,1,1.0,1,0.10355554154969261,61
4980,2,10244,3774,6470,0,0,0,1.0,1,1.0,1,1.0,1,0.09164529525864668,62
4981,2,10246,3774,6472,0,0,0,1.0,1,1.0,1,1.0,1,0.05586485160947627,62
4982,2,10248,3775,6473,0,0,0,1.0,1,1.0,1,1.0,1,0.07141091369020829,63
4983,0,10248,3775,6473,0,0,0,1.0,1,1.0,1,1.0,1,0.07016474301310972,63
4984,4,10252,3777,6475,0,0,0,1.0,1,1.0,1,1.0,1,0.05562415405341975,61
4985,0,10252,3777,6475,0,0,0,1.0,1,1.0,1,1.0,1,0.06505757714848703,59
4986,3,10255,3778,6477,0,0,0,1.0,1,1.0,1,1.0,1,0.0857536808582579,62
4987,4,10259,3780,6479,0,0,0,1.0,1,1.0,1,1.0,1,0.06856127401262514,60
4988,1,10260,3781,6479,0,0,0,1.0,1,1.0,1,1.0,1,0.06909356331075557,59
4989,5,10265,3784,6481,0,0,0,1.0,1,1.0,1,1.0,1,0.09274297647821178,57
4990,3,10268,3784,6484,0,0,0,1.0,1,1.0,1,1.0,1,0.09199100353243891,55
4991,3,10271,3786,6485,0,0,0,1.0,1,1.0,1,1.0,1,0.0979621933618065,54
4992,1,10272,3786,6486,0,0,0,1.0,1,1.0,1,1.0,1,0.09534960289670129,52
4993,2,10274,3787,6487,0,0,0,1.0,1,1.0,1,1.0,1,0.08602147979336043,51
4994,2,10276,3789,6487,0,0,0,1.0,1,1.0,1,1.0,1,0.08105442464093526,49
4995,3,10279,3791,6488,0,0,0,1.0,1,1.0,1,1.0,1,0.10799105291054087,48
4996,6,10285,3797,6488,0,0,0,1.0,1,1.0,1,1.0,1,0.1354634077823384,48
4997,1,10286,3798,6488,0,0,0,1.0,1,1.0,1,1.0,1,0.13655350172756275,46
4998,4,10290,3799,6491,0,0,0,1.0,1,1.0,1,1.0,1,0.1449823913338275,48
4999,7,10297,3800,6497,0,0,0,1.0,1,1.0,1,1.0,1,0.1307299785967057,48
5000,1,10298,3800,6498,0,0,0,1.0,1,1.0,1,1.0,1,0.11501556072822977,47
5001,0,10298,3800,6498,0,0,0,1.0,1,1.0,1,1.0,1,0.14315604554212735,45
5002,6,10304,3801,6503,0,0,0,1.0,1,1.0,1,1.0,1,0.14961426253434515,46
5003,4,10308,3801,6507,0,0,0,1.0,1,1.0,1,1.0,1,0.17732231036001048,46
5004,4,10312,3802,6510,0,0,0,1.0,1,1.0,1,1.0,1,0.16818712368329328,46
5005,1,10313,3802,6511,0,0,0,1.0,1,1.0,1,1.0,1,0.18697543264475416,45
5006,0,10313,3802,6511,0,0,0,1.0,1,1.0,1,1.0,1,0.19685074839952155,45
5007,2,10315,3803,6512,0,0,0,1.0,1,1.0,1,1.0,1,0.17753232239485897,46
5008,2,10317,3803,6514,0,0,0,1.0,1,1.0,1,1.0,1,0.16163276374429725,49
5009,0,10317,3803,6514,0,0,0,1.0,1,1.0,1,1.0,1,0.15157411959434938,49
5010,1,10318,3803,6515,0,0,0,1.0,1,1.0,1,1.0,1,0.14704819939023253,50
5011,1,10319,3803,6516,0,0,0,1.0,1,1.0,1,1.0,1,0.14326891923681798,51
5012,0,10319,3803,6516,0,0,0,1.0,1,1.0,1,1.0,1,0.15353604931860249,52
5013,0,10319,3803,6516,0,0,0,1.0,1,1.0,1,1.0,1,0.15353604931860249,52
5014,0,10319,3803,6516,0,0,0,1.0,1,1.0,1,1.0,1,0.16317393844427727,53
5015,5,10324,3804,6520,0,0,0,1.0,1,1.0,1,1.0,1,0.14302641069726155,54
5016,4,10328,3805,6523,0,0,0,1.0,1,1.0,1,1.0,1,0.14339104997249405,55
5017,2,10330,3805,6525,0,0,0,1.0,1,1.0,1,1.0,1,0.11868598972810213,55
5018,1,10331,3805,6526,0,0,0,1.0,1,1.0,1,1.0,1,0.12519555686477504,56
5019,1,10332,3805,6527,0,0,0,1.0,1,1.0,1,1.0,1,0.11760560279445083,56
5020,3,10335,3805,6530,0,0,0,1.0,1,1.0,1,1.0,1,0.08412653015438655,55
5021,0,10335,3805,6530,0,0,0,1.0,1,1.0,1,1.0,1,0.09703806177605488,56
5022,2,10337,3807,6530,0,0,0,1.0,1,1.0,1,1.0,1,0.1061652717154937,56
5023,1,10338,3808,6530,0,0,0,1.0,1,1.0,1,1.0,1,0.08827289563813133,55
5024,3,10341,3811,6530,0,0,0,1.0,1,1.0,1,1.0,1,0.13686526481500833,55
5025,3,10344,3813,6531,0,0,0,1.0,1,1.0,1,1.0,1,0.11818207950174485,53
5026,4,10348,3816,6532,0,0,0,1.0,1,1.0,1,1.0,1,0.11596478754219716,52
5027,2,10350,3817,6533,0,0,0,1.0,1,1.0,1,1.0,1,0.1371168656326063,51
5028,5,10355,3820,6535,0,0,0,1.0,1,1.0,1,1.0,1,0.1683398172910213,51
5029,2,10357,3821,6536,0,0,0,1.0,1,1.0,1,1.0,1,0.16184232904294282,50
5030,1,10358,3822,6536,0,0,0,1.0,1,1.0,1,1.0,1,0.1196097103950476,49
5031,1,10359,3823,6536,0,0,0,1.0,1,1.0,1,1.0,1,0.12449187161688026,49
5032,2,10361,3825,6536,0,0,0,1.0,1,1.0,1,1.0,1,0.14951791581841337,48
5033,4,10365,3827,6538,0,0,0,1.0,1,1.0,1,1.0,1,0.1638641337641598,50
5034,0,10365,3827,6538,0,0,0,1.0,1,1.0,1,1.0,1,0.14636364211013578,49
5035,5,10370,3829,6541,0,0,0,1.0,1,1.0,1,1.0,1,0.14578807244230552,49
5036,1,10371,3830,6541,0,0,0,1.0,1,1.0,1,1.0,1,0.12907096197451978,47
5037,2,10373,3830,6543,0,0,0,1.0,1,1.0,1,1.0,1,0.11196899373424235,47
5038,0,10373,3830,6543,0,0,0,1.0,1,1.0,1,1.0,1,0.13135568607276527,47
5039,0,10373,3830,6543,0,0,0,1.0,1,1.0,1,1.0,1,0.1254747835316986,48
5040,0,10373,3830,6543,0,0,0,1.0,1,1.0,1,1.0,1,0.1254747835316986,48
5041,1,10374,3831,6543,0,0,0,1.0,1,1.0,1,1.0,1,0.11510187857047192,48
5042,0,10374,3831,6543,0,0,0,1.0,1,1.0,1,1.0,1,0.11262868856424053,50
5043,0,10374,3831,6543,0,0,0,1.0,1,1.0,1,1.0,1,0.11651305306619686,51
5044,1,10375,3831,6544,0,0,0,1.0,1,1.0,1,1.0,1,0.10318335214413844,51
5045,1,10376,3831,6545,0,0,0,1.0,1,1.0,1,1.0,1,0.09844893832961506,52
5046,4,10380,3832,6548,0,0,0,1.0,1,1.0,1,1.0,1,0.08516938640054694,51
5047,0,10380,3832,6548,0,0,0,1.0,1,1.0,1,1.0,1,0.08516938640054694,51
5048,1,10381,3833,6548,0,0,0,1.0,1,1.0,1,1.0,1,0.08943200830911512,52
5049,1,10382,3833,6549,0,0,0,1.0,1,1.0,1,1.0,1,0.1044712902592331,54
5050,1,10383,3833,6550,0,0,0,1.0,1,1.0,1,1.0,1,0.09656609655605526,56
5051,0,10383,3833,6550,0,0,0,1.0,1,1.0,1,1.0,1,0.11340308268402322,55
5052,0,10383,3833,6550,0,0,0,1.0,1,1.0,1,1.0,1,0.11340308268402322,55
5053,0,10383,3833,6550,0,0,0,1.0,1,1.0,1,1.0,1,0.11340308268402322,55
5054,1,10384,3834,6550,0,0,0,1.0,1,1.0,1,1.0,1,0.1281208241951754,55
5055,1,10385,3834,6551,0,0,0,1.0,1,1.0,1,1.0,1,0.1467214662448451,55
5056,5,10390,3835,6555,0,0,0,1.0,1,1.0,1,1.0,1,0.1379484953409344,56
5057,1,10391,3836,6555,0,0,0,1.0,1,1.0,1,1.0,1,0.13622980997227818,58
5058,3,10394,3837,6557,0,0,0,1.0,1,1.0,1,1.0,1,0.13162145471545159,59
5059,3,10397,3837,6560,0,0,0,1.0,1,1.0,1,1.0,1,0.09159505525926195,59
5060,1,10398,3837,6561,0,0,0,1.0,1,1.0,1,1.0,1,0.08231713390668051,59
5061,2,10400,3837,6563,0,0,0,1.0,1,1.0,1,1.0,1,0.09103107216145924,59
5062,2,10402,3839,6563,0,0,0,1.0,1,1.0,1,1.0,1,0.15062300596906356,59
5063,2,10404,3839,6565,0,0,0,1.0,1,1.0,1,1.0,1,0.12745932801723928,59
5064,5,10409,3844,6565,0,0,0,1.0,1,1.0,1,1.0,1,0.20256638298437504,57
5065,5,10414,3845,6569,0,0,0,1.0,1,1.0,1,1.0,1,0.14669955348185487,55
5066,5,10419,3847,6572,0,0,0,1.0,1,1.0,1,1.0,1,0.1692580529348218,55
5067,3,10422,3847,6575,0,0,0,1.0,1,1.0,1,1.0,1,0.14114446094739658,54
5068,1,10423,3847,6576,0,0,0,1.0,1,1.0,1,1.0,1,0.1210404794996331,54
5069,3,10426,3849,6577,0,0,0,1.0,1,1.0,1,1.0,1,0.13101341881614964,54
5070,1,10427,3850,6577,0,0,0,1.0,1,1.0,1,1.0,1,0.1279531135904837,52
5071,4,10431,3851,6580,0,0,0,1.0,1,1.0,1,1.0,1,0.09941159017805075,54
5072,0,10431,3851,6580,0,0,0,1.0,1,1.0,1,1.0,1,0.08921156297126791,52
5073,1,10432,3851,6581,0,0,0,1.0,1,1.0,1,1.0,1,0.09500842726284817,51
5074,1,10433,3852,6581,0,0,0,1.0,1,1.0,1,1.0,1,0.11232010174840955,52
5075,0,10433,3852,6581,0,0,0,1.0,1,1.0,1,1.0,1,0.11979647515821923,53
5076,0,10433,3852,6581,0,0,0,1.0,1,1.0,1,1.0,1,0.11979647515821923,53
5077,2,10435,3854,6581,0,0,0,1.0,1,1.0,1,1.0,1,0.1139015100196044,56
5078,2,10437,3854,6583,0,0,0,1.0,1,1.0,1,1.0,1,0.0758944769299205,55
5079,2,10439,3854,6585,0,0,0,1.0,1,1.0,1,1.0,1,0.08627700967408368,56
5080,2,10441,3854,6587,0,0,0,1.0,1,1.0,1,1.0,1,0.0726392066081573,57
5081,1,10442,3854,6588,0,0,0,1.0,1,1.0,1,1.0,1,0.06639345450544082,58
5082,0,10442,3854,6588,0,0,0,1.0,1,1.0,1,1.0,1,0.06639345450544082,58
5083,0,10442,3854,6588,0,0,0,1.0,1,1.0,1,1.0,1,0.07367239474353139,59
5084,1,10443,3855,6588,0,0,0,1.0,1,1.0,1,1.0,1,0.07642679353531726,59
5085,1,10444,3856,6588,0,0,0,1.0,1,1.0,1,1.0,1,0.09298071891333844,60
5086,2,10446,3856,6590,0,0,0,1.0,1,1.0,1,1.0,1,0.07168442155619616,61
5087,4,10450,3858,6592,0,0,0,1.0,1,1.0,1,1.0,1,0.0916114762519413,62
5088,2,10452,3859,6593,0,0,0,1.0,1,1.0,1,1.0,1,0.09875559108455215,64
5089,4,10456,3862,6594,0,0,0,1.0,1,1.0,1,1.0,1,0.11207989506086719,64
5090,3,10459,3863,6596,0,0,0,1.0,1,1.0,1,1.0,1,0.08588367127238974,64
5091,3,10462,3866,6596,0,0,0,1.0,1,1.0,1,1.0,1,0.10698624366464975,64
5092,2,10464,3868,6596,0,0,0,1.0,1,1.0,1,1.0,1,0.13437755836131762,64
5093,0,10464,3868,6596,0,0,0,1.0,1,1.0,1,1.0,1,0.13437755836131762,64
5094,2,10466,3869,6597,0,0,0,1.0,1,1.0,1,1.0,1,0.1325972898538381,65
5095,3,10469,3870,6599,0,0,0,1.0,1,1.0,1,1.0,1,0.0951416699338078,66
5096,0,10469,3870,6599,0,0,0,1.0,1,1.0,1,1.0,1,0.10435382537256051,66
5097,2,10471,3872,6599,0,0,0,1.0,1,1.0,1,1.0,1,0.10516326850927543,67
5098,1,10472,3872,6600,0,0,0,1.0,1,1.0,1,1.0,1,0.0909891714257321,67
5099,3,10475,3873,6602,0,0,0,1.0,1,1.0,1,1.0,1,0.08426100141391142,70
5100,1,10476,3873,6603,0,0,0,1.0,1,1.0,1,1.0,1,0.08205177625930468,71
5101,4,10480,3875,6605,0,0,0,1.0,1,1.0,1,1.0,1,0.08604236164820431,72
5102,6,10486,3879,6607,0,0,0,1.0,1,1.0,1,1.0,1,0.10509121354533782,72
5103,3,10489,3880,6609,0,0,0,1.0,1,1.0,1,1.0,1,0.08545610231628639,70
5104,4,10493,3882,6611,0,0,0,1.0,1,1.0,1,1.0,1,0.10854340939501059,67
5105,2,10495,3882,6613,0,0,0,1.0,1,1.0,1,1.0,1,0.09732458805081597,66
5106,2,10497,3884,6613,0,0,0,1.0,1,1.0,1,1.0,1,0.11537181060027248,64
5107,5,10502,3887,6615,0,0,0,1.0,1,1.0,1,1.0,1,0.10791731518010708,61
5108,2,10504,3888,6616,0,0,0,1.0,1,1.0,1,1.0,1,0.10002508659210144,57
5109,5,10509,3893,6616,0,0,0,1.0,1,1.0,1,1.0,1,0.15724559439937366,55
5110,9,10518,3895,6623,0,0,0,1.0,1,1.0,1,1.0,1,0.0951177894796736,53
5111,2,10520,3897,6623,0,0,0,1.0,1,1.0,1,1.0,1,0.12571631163789784,52
5112,3,10523,3900,6623,0,0,0,1.0,1,1.0,1,1.0,1,0.1493244463285516,52
5113,5,10528,3900,6628,0,0,0,1.0,1,1.0,1,1.0,1,0.07680588222816874,49
5114,4,10532,3904,6628,0,0,0,1.0,1,1.0,1,1.0,1,0.1265491707415434,49
5115,2,10534,3904,6630,0,0,0,1.0,1,1.0,1,1.0,1,0.11520339407354718,48
5116,1,10535,3904,6631,0,0,0,1.0,1,1.0,1,1.0,1,0.09863742366525566,47
5117,0,10535,3904,6631,0,0,0,1.0,1,1.0,1,1.0,1,0.10893849892245289,48
5118,0,10535,3904,6631,0,0,0,1.0,1,1.0,1,1.0,1,0.09847591359104176,49
5119,0,10535,3904,6631,0,0,0,1.0,1,1.0,1,1.0,1,0.09847591359104176,49
5120,1,10536,3905,6631,0,0,0,1.0,1,1.0,1,1.0,1,0.09762267013104438,48
5121,1,10537,3906,6631,0,0,0,1.0,1,1.0,1,1.0,1,0.13396144609600158,48
5122,3,10540,3907,6633,0,0,0,1.0,1,1.0,1,1.0,1,0.13703230930481572,46
5123,1,10541,3908,6633,0,0,0,1.0,1,1.0,1,1.0,1,0.14859875513396764,46
5124,2,10543,3908,6635,0,0,0,1.0,1,1.0,1,1.0,1,0.1339802743183639,47
5125,8,10551,3909,6642,0,0,0,1.0,1,1.0,1,1.0,1,0.11829646560609594,49
5126,1,10552,3909,6643,0,0,0,1.0,1,1.0,1,1.0,1,0.10904751063011763,49
5127,5,10557,3910,6647,0,0,0,1.0,1,1.0,1,1.0,1,0.1326553054937721,51
5128,5,10562,3911,6651,0,0,0,1.0,1,1.0,1,1.0,1,0.11186029008275129,53
5129,2,10564,3912,6652,0,0,0,1.0,1,1.0,1,1.0,1,0.13462555674037563,55
5130,0,10564,3912,6652,0,0,0,1.0,1,1.0,1,1.0,1,0.13462555674037563,55
5131,2,10566,3912,6654,0,0,0,1.0,1,1.0,1,1.0,1,0.10981765503465798,55
5132,0,10566,3912,6654,0,0,0,1.0,1,1.0,1,1.0,1,0.10981765503465798,55
5133,0,10566,3912,6654,0,0,0,1.0,1,1.0,1,1.0,1,0.1074096307998662,56
5134,2,10568,3912,6656,0,0,0,1.0,1,1.0,1,1.0,1,0.11733204730909386,56
5135,2,10570,3913,6657,0,0,0,1.0,1,1.0,1,1.0,1,0.11495707525511763,56
5136,0,10570,3913,6657,0,0,0,1.0,1,1.0,1,1.0,1,0.1282455482923989,55
5137,2,10572,3914,6658,0,0,0,1.0,1,1.0,1,1.0,1,0.14179766914474787,55
5138,2,10574,3914,6660,0,0,0,1.0,1,1.0,1,1.0,1,0.13729186851331693,54
5139,1,10575,3915,6660,0,0,0,1.0,1,1.0,1,1.0,1,0.13045775086848113,54
5140,4,10579,3916,6663,0,0,0,1.0,1,1.0,1,1.0,1,0.09194890218034657,54
5141,2,10581,3918,6663,0,0,0,1.0,1,1.0,1,1.0,1,0.1362440754600801,53
5142,6,10587,3921,6666,0,0,0,1.0,1,1.0,1,1.0,1,0.13925676987663288,55
5143,6,10593,3925,6668,0,0,0,1.0,1,1.0,1,1.0,1,0.10137969443080128,54
5144,4,10597,3926,6671,0,0,0,1.0,1,1.0,1,1.0,1,0.07247726824641847,50
5145,1,10598,3927,6671,0,0,0,1.0,1,1.0,1,1.0,1,0.1143684910579001,51
5146,1,10599,3928,6671,0,0,0,1.0,1,1.0,1,1.0,1,0.1137151483515561,48
5147,4,10603,3930,6673,0,0,0,1.0,1,1.0,1,1.0,1,0.09715051636924914,49
5148,0,10603,3930,6673,0,0,0,1.0,1,1.0,1,1.0,1,0.06912299098721555,47
5149,2,10605,3932,6673,0,0,0,1.0,1,1.0,1,1.0,1,0.15085272924448612,46
5150,8,10613,3936,6677,0,0,0,1.0,1,1.0,1,1.0,1,0.14867339844025948,46
5151,0,10613,3936,6677,0,0,0,1.0,1,1.0,1,1.0,1,0.12911676388078916,45
5152,3,10616,3939,6677,0,0,0,1.0,1,1.0,1,1.0,1,0.17519452019359252,45
5153,2,10618,3939,6679,0,0,0,1.0,1,1.0,1,1.0,1,0.17312709759944522,45
5154,1,10619,3940,6679,0,0,0,1.0,1,1.0,1,1.0,1,0.17552087244382214,45
5155,4,10623,3941,6682,0,0,0,1.0,1,1.0,1,1.0,1,0.15799020852093398,44
5156,4,10627,3943,6684,0,0,0,1.0,1,1.0,1,1.0,1,0.15941603582935665,44
5157,0,10627,3943,6684,0,0,0,1.0,1,1.0,1,1.0,1,0.1766454590487186,42
5158,2,10629,3943,6686,0,0,0,1.0,1,1.0,1,1.0,1,0.14373674151614746,43
5159,0,10629,3943,6686,0,0,0,1.0,1,1.0,1,1.0,1,0.1787622724329919,43
5160,0,10629,3943,6686,0,0,0,1.0,1,1.0,1,1.0,1,0.1787622724329919,43
5161,1,10630,3943,6687,0,0,0,1.0,1,1.0,1,1.0,1,0.16809717904175536,43
5162,1,10631,3943,6688,0,0,0,1.0,1,1.0,1,1.0,1,0.1469704072002639,44
5163,1,10632,3943,6689,0,0,0,1.0,1,1.0,1,1.0,1,0.14851371369957514,46
5164,4,10636,3944,6692,0,0,0,1.0,1,1.0,1,1.0,1,0.1142940484871034,46
5165,1,10637,3945,6692,0,0,0,1.0,1,1.0,1,1.0,1,0.13718568080874072,46
5166,3,10640,3946,6694,0,0,0,1.0,1,1.0,1,1.0,1,0.1497719405999302,47
5167,0,10640,3946,6694,0,0,0,1.0,1,1.0,1,1.0,1,0.1497719405999302,47
5168,6,10646,3948,6698,0,0,0,1.0,1,1.0,1,1.0,1,0.1375697905148149,47
5169,0,10646,3948,6698,0,0,0,1.0,1,1.0,1,1.0,1,0.1375697905148149,47
5170,4,10650,3949,6701,0,0,0,1.0,1,1.0,1,1.0,1,0.11502961807710847,48
5171,1,10651,3950,6701,0,0,0,1.0,1,1.0,1,1.0,1,0.13455364143763876,48
5172,0,10651,3950,6701,0,0,0,1.0,1,1.0,1,1.0,1,0.10691871463389682,49
5173,0,10651,3950,6701,0,0,0,1.0,1,1.0,1,1.0,1,0.11431643234859655,49
5174,1,10652,3950,6702,0,0,0,1.0,1,1.0,1,1.0,1,0.10546090985347222,52
5175,0,10652,3950,6702,0,0,0,1.0,1,1.0,1,1.0,1,0.10343333104365315,53
5176,1,10653,3950,6703,0,0,0,1.0,1,1.0,1,1.0,1,0.10393729086282201,54
5177,2,10655,3952,6703,0,0,0,1.0,1,1.0,1,1.0,1,0.12038651130688446,54
5178,4,10659,3954,6705,0,0,0,1.0,1,1.0,1,1.0,1,0.16108185018995586,55
5179,2,10661,3956,6705,0,0,0,1.0,1,1.0,1,1.0,1,0.17492711224470134,53
5180,4,10665,3958,6707,0,0,0,1.0,1,1.0,1,1.0,1,0.1507583535874787,52
5181,4,10669,3960,6709,0,0,0,1.0,1,1.0,1,1.0,1,0.13636638531355505,52
5182,2,10671,3960,6711,0,0,0,1.0,1,1.0,1,1.0,1,0.092321969219699,52
5183,3,10674,3962,6712,0,0,0,1.0,1,1.0,1,1.0,1,0.10720651735552768,52
5184,0,10674,3962,6712,0,0,0,1.0,1,1.0,1,1.0,1,0.10716762742168988,52
5185,3,10677,3963,6714,0,0,0,1.0,1,1.0,1,1.0,1,0.11786632013688922,50
5186,1,10678,3964,6714,0,0,0,1.0,1,1.0,1,1.0,1,0.1766930845801991,48
5187,1,10679,3965,6714,0,0,0,1.0,1,1.0,1,1.0,1,0.1763324679714075,46
5188,3,10682,3965,6717,0,0,0,1.0,1,1.0,1,1.0,1,0.12193307772468297,44
5189,1,10683,3965,6718,0,0,0,1.0,1,1.0,1,1.0,1,0.10621782503015226,44
5190,0,10683,3965,6718,0,0,0,1.0,1,1.0,1,1.0,1,0.1026693784397411,45
5191,0,10683,3965,6718,0,0,0,1.0,1,1.0,1,1.0,1,0.10307195987669818,45
5192,2,10685,3966,6719,0,0,0,1.0,1,1.0,1,1.0,1,0.10748020110623806,45
5193,0,10685,3966,6719,0,0,0,1.0,1,1.0,1,1.0,1,0.10748020110623806,45
5194,0,10685,3966,6719,0,0,0,1.0,1,1.0,1,1.0,1,0.11045380675438618,45
5195,3,10688,3967,6721,0,0,0,1.0,1,1.0,1,1.0,1,0.12202574131399029,46
5196,2,10690,3967,6723,0,0,0,1.0,1,1.0,1,1.0,1,0.12202574131399029,46
5197,3,10693,3968,6725,0,0,0,1.0,1,1.0,1,1.0,1,0.1257386714645166,46
5198,1,10694,3968,6726,0,0,0,1.0,1,1.0,1,1.0,1,0.09614203370764798,47
5199,1,10695,3969,6726,0,0,0,1.0,1,1.0,1,1.0,1,0.12653217210907652,49
5200,5,10700,3970,6730,0,0,0,1.0,1,1.0,1,1.0,1,0.09226971865256876,49
5201,2,10702,3972,6730,0,0,0,1.0,1,1.0,1,1.0,1,0.09037190938595893,50
5202,1,10703,3972,6731,0,0,0,1.0,1,1.0,1,1.0,1,0.09834965451881794,52
5203,0,10703,3972,6731,0,0,0,1.0,1,1.0,1,1.0,1,0.09834965451881794,52
5204,2,10705,3972,6733,0,0,0,1.0,1,1.0,1,1.0,1,0.10203352233292513,54
5205,1,10706,3972,6734,0,0,0,1.0,1,1.0,1,1.0,1,0.08280554067816898,54
5206,3,10709,3972,6737,0,0,0,1.0,1,1.0,1,1.0,1,0.05311890566916983,55
5207,0,10709,3972,6737,0,0,0,1.0,1,1.0,1,1.0,1,0.06985442933885631,54
5208,0,10709,3972,6737,0,0,0,1.0,1,1.0,1,1.0,1,0.06985442933885631,54
5209,2,10711,3973,6738,0,0,0,1.0,1,1.0,1,1.0,1,0.09164082611543034,54
5210,0,10711,3973,6738,0,0,0,1.0,1,1.0,1,1.0,1,0.09164082611543034,54
5211,0,10711,3973,6738,0,0,0,1.0,1,1.0,1,1.0,1,0.10583657245217234,56
5212,2,10713,3973,6740,0,0,0,1.0,1,1.0,1,1.0,1,0.08307434249403375,57
5213,3,10716,3976,6740,0,0,0,1.0,1,1.0,1,1.0,1,0.12800826624258493,57
5214,4,10720,3978,6742,0,0,0,1.0,1,1.0,1,1.0,1,0.17164359407918145,58
5215,4,10724,3978,6746,0,0,0,1.0,1,1.0,1,1.0,1,0.15583487019140457,57
5216,2,10726,3979,6747,0,0,0,1.0,1,1.0,1,1.0,1,0.1361079799811987,57
5217,0,10726,3979,6747,0,0,0,1.0,1,1.0,1,1.0,1,0.1026207723585627,56
5218,4,10730,3982,6748,0,0,0,1.0,1,1.0,1,1.0,1,0.11204426322732666,56
5219,1,10731,3982,6749,0,0,0,1.0,1,1.0,1,1.0,1,0.14143566309566508,54
5220,2,10733,3983,6750,0,0,0,1.0,1,1.0,1,1.0,1,0.14527194432076232,53
5221,3,10736,3983,6753,0,0,0,1.0,1,1.0,1,1.0,1,0.12072177824367841,52
5222,2,10738,3983,6755,0,0,0,1.0,1,1.0,1,1.0,1,0.13731916465464264,52
5223,2,10740,3984,6756,0,0,0,1.0,1,1.0,1,1.0,1,0.15492662881472838,52
5224,4,10744,3986,6758,0,0,0,1.0,1,1.0,1,1.0,1,0.13739113256569707,52
5225,1,10745,3986,6759,0,0,0,1.0,1,1.0,1,1.0,1,0.15302048452983755,50
5226,3,10748,3987,6761,0,0,0,1.0,1,1.0,1,1.0,1,0.13769003041095643,51
5227,7,10755,3988,6767,0,0,0,1.0,1,1.0,1,1.0,1,0.09923611630456966,49
5228,0,10755,3988,6767,0,0,0,1.0,1,1.0,1,1.0,1,0.1181891124001448,48
5229,1,10756,3988,6768,0,0,0,1.0,1,1.0,1,1.0,1,0.1406847088178467,49
5230,3,10759,3988,6771,0,0,0,1.0,1,1.0,1,1.0,1,0.08555463042547266,49
5231,1,10760,3989,6771,0,0,0,1.0,1,1.0,1,1.0,1,0.09353121560255485,49
5232,5,10765,3990,6775,0,0,0,1.0,1,1.0,1,1.0,1,0.0799582020337535,51
5233,2,10767,3991,6776,0,0,0,1.0,1,1.0,1,1.0,1,0.09796925947134566,51
5234,6,10773,3996,6777,0,0,0,1.0,1,1.0,1,1.0,1,0.1363811318353696,52
5235,2,10775,3996,6779,0,0,0,1.0,1,1.0,1,1.0,1,0.11316186696184727,52
5236,1,10776,3996,6780,0,0,0,1.0,1,1.0,1,1.0,1,0.08903053432083027,52
5237,1,10777,3996,6781,0,0,0,1.0,1,1.0,1,1.0,1,0.0888422777818818,53
5238,1,10778,3996,6782,0,0,0,1.0,1,1.0,1,1.0,1,0.08147388600312724,53
5239,0,10778,3996,6782,0,0,0,1.0,1,1.0,1,1.0,1,0.08147388600312724,53
5240,2,10780,3998,6782,0,0,0,1.0,1,1.0,1,1.0,1,0.13129371492909264,55
5241,2,10782,3998,6784,0,0,0,1.0,1,1.0,1,1.0,1,0.10822062968921525,56
5242,3,10785,3999,6786,0,0,0,1.0,1,1.0,1,1.0,1,0.08914760899249041,54
5243,1,10786,4000,6786,0,0,0,1.0,1,1.0,1,1.0,1,0.10947211351491998,55
5244,2,10788,4002,6786,0,0,0,1.0,1,1.0,1,1.0,1,0.14496881526914998,55
5245,4,10792,4003,6789,0,0,0,1.0,1,1.0,1,1.0,1,0.1054476483756762,55
5246,2,10794,4004,6790,0,0,0,1.0,1,1.0,1,1.0,1,0.14476927188357142,55
5247,1,10795,4005,6790,0,0,0,1.0,1,1.0,1,1.0,1,0.1582104678665213,54
5248,3,10798,4005,6793,0,0,0,1.0,1,1.0,1,1.0,1,0.117663374973231,53
5249,3,10801,4007,6794,0,0,0,1.0,1,1.0,1,1.0,1,0.14967313376309663,55
5250,0,10801,4007,6794,0,0,0,1.0,1,1.0,1,1.0,1,0.14967313376309663,55
5251,6,10807,4008,6799,0,0,0,1.0,1,1.0,1,1.0,1,0.11470741249998245,57
5252,2,10809,4009,6800,0,0,0,1.0,1,1.0,1,1.0,1,0.13484876285324066,58
5253,2,10811,4010,6801,0,0,0,1.0,1,1.0,1,1.0,1,0.1359585030458868,59
5254,3,10814,4010,6804,0,0,0,1.0,1,1.0,1,1.0,1,0.10234663004834609,59
5255,1,10815,4011,6804,0,0,0,1.0,1,1.0,1,1.0,1,0.1170567468066042,58
5256,1,10816,4012,6804,0,0,0,1.0,1,1.0,1,1.0,1,0.14124331245836963,59
5257,2,10818,4013,6805,0,0,0,1.0,1,1.0,1,1.0,1,0.12526529390958105,58
5258,1,10819,4014,6805,0,0,0,1.0,1,1.0,1,1.0,1,0.15897763535006026,56
5259,0,10819,4014,6805,0,0,0,1.0,1,1.0,1,1.0,1,0.17178662652848026,56
5260,4,10823,4016,6807,0,0,0,1.0,1,1.0,1,1.0,1,0.18478444710068478,55
5261,3,10826,4017,6809,0,0,0,1.0,1,1.0,1,1.0,1,0.1500689691035982,54
5262,1,10827,4018,6809,0,0,0,1.0,1,1.0,1,1.0,1,0.1740235703985373,54
5263,4,10831,4019,6812,0,0,0,1.0,1,1.0,1,1.0,1,0.1687924519151035,53
5264,3,10834,4020,6814,0,0,0,1.0,1,1.0,1,1.0,1,0.11426618436352734,51
5265,0,10834,4020,6814,0,0,0,1.0,1,1.0,1,1.0,1,0.10403700138217423,50
5266,5,10839,4022,6817,0,0,0,1.0,1,1.0,1,1.0,1,0.09668387001519638,49
5267,2,10841,4024,6817,0,0,0,1.0,1,1.0,1,1.0,1,0.14303279847419514,48
5268,2,10843,4025,6818,0,0,0,1.0,1,1.0,1,1.0,1,0.10531705989155603,47
5269,4,10847,4026,6821,0,0,0,1.0,1,1.0,1,1.0,1,0.11575310986892774,45
5270,1,10848,4026,6822,0,0,0,1.0,1,1.0,1,1.0,1,0.11449818203356844,47
5271,2,10850,4026,6824,0,0,0,1.0,1,1.0,1,1.0,1,0.11303632183484445,45
5272,3,10853,4029,6824,0,0,0,1.0,1,1.0,1,1.0,1,0.19719780495557965,46
5273,1,10854,4029,6825,0,0,0,1.0,1,1.0,1,1.0,1,0.17275802937630746,44
5274,3,10857,4030,6827,0,0,0,1.0,1,1.0,1,1.0,1,0.21543375304053533,44
5275,7,10864,4031,6833,0,0,0,1.0,1,1.0,1,1.0,1,0.09802978910395628,46
5276,0,10864,4031,6833,0,0,0,1.0,1,1.0,1,1.0,1,0.09802978910395628,46
5277,5,10869,4033,6836,0,0,0,1.0,1,1.0,1,1.0,1,0.1131438245958512,46
5278,3,10872,4034,6838,0,0,0,1.0,1,1.0,1,1.0,1,0.11761955136788106,46
5279,2,10874,4035,6839,0,0,0,1.0,1,1.0,1,1.0,1,0.13172577310032452,47
5280,2,10876,4036,6840,0,0,0,1.0,1,1.0,1,1.0,1,0.13695536872649092,47
5281,3,10879,4037,6842,0,0,0,1.0,1,1.0,1,1.0,1,0.17166888886432685,48
5282,0,10879,4037,6842,0,0,0,1.0,1,1.0,1,1.0,1,0.17166888886432685,48
5283,0,10879,4037,6842,0,0,0,1.0,1,1.0,1,1.0,1,0.18007336939587074,49
5284,1,10880,4037,6843,0,0,0,1.0,1,1.0,1,1.0,1,0.16419548644186946,49
5285,0,10880,4037,6843,0,0,0,1.0,1,1.0,1,1.0,1,0.14091109523199413,50
5286,0,10880,4037,6843,0,0,0,1.0,1,1.0,1,1.0,1,0.15566080939563773,51
5287,0,10880,4037,6843,0,0,0,1.0,1,1.0,1,1.0,1,0.15566080939563773,51
5288,1,10881,4037,6844,0,0,0,1.0,1,1.0,1,1.0,1,0.14028469596551063,51
5289,3,10884,4037,6847,0,0,0,1.0,1,1.0,1,1.0,1,0.11611416551376505,53
5290,2,10886,4037,6849,0,0,0,1.0,1,1.0,1,1.0,1,0.06755742610915819,53
5291,1,10887,4038,6849,0,0,0,1.0,1,1.0,1,1.0,1,0.0935833562266713,53
5292,2,10889,4040,6849,0,0,0,1.0,1,1.0,1,1.0,1,0.11277183910386876,53
5293,1,10890,4040,6850,0,0,0,1.0,1,1.0,1,1.0,1,0.1132481601474286,53
5294,2,10892,4041,6851,0,0,0,1.0,1,1.0,1,1.0,1,0.10553887837842321,54
5295,2,10894,4043,6851,0,0,0,1.0,1,1.0,1,1.0,1,0.11589844890892965,52
5296,3,10897,4044,6853,0,0,0,1.0,1,1.0,1,1.0,1,0.09962229783733104,49
5297,1,10898,4045,6853,0,0,0,1.0,1,1.0,1,1.0,1,0.14607020448157182,49
5298,1,10899,4045,6854,0,0,0,1.0,1,1.0,1,1.0,1,0.1501120372470996,49
5299,2,10901,4046,6855,0,0,0,1.0,1,1.0,1,1.0,1,0.12313923603876038,50
5300,0,10901,4046,6855,0,0,0,1.0,1,1.0,1,1.0,1,0.13276398368257494,48
5301,1,10902,4047,6855,0,0,0,1.0,1,1.0,1,1.0,1,0.16774049633075372,46
5302,2,10904,4048,6856,0,0,0,1.0,1,1.0,1,1.0,1,0.16430794283657266,47
5303,3,10907,4050,6857,0,0,0,1.0,1,1.0,1,1.0,1,0.16485650318543482,46
5304,1,10908,4051,6857,0,0,0,1.0,1,1.0,1,1.0,1,0.20108145998221175,45
5305,2,10910,4051,6859,0,0,0,1.0,1,1.0,1,1.0,1,0.17224454564505556,44
5306,4,10914,4055,6859,0,0,0,1.0,1,1.0,1,1.0,1,0.23821467053174547,42
5307,2,10916,4055,6861,0,0,0,1.0,1,1.0,1,1.0,1,0.20216939452473695,42
5308,3,10919,4056,6863,0,0,0,1.0,1,1.0,1,1.0,1,0.1721607399503049,43
5309,1,10920,4057,6863,0,0,0,1.0,1,1.0,1,1.0,1,0.184863537266614,41
5310,2,10922,4058,6864,0,0,0,1.0,1,1.0,1,1.0,1,0.2133698917252648,41
5311,2,10924,4059,6865,0,0,0,1.0,1,1.0,1,1.0,1,0.181355680434603,42
5312,1,10925,4059,6866,0,0,0,1.0,1,1.0,1,1.0,1,0.1794822122992983,43
5313,2,10927,4059,6868,0,0,0,1.0,1,1.0,1,1.0,1,0.14584205064571193,44
5314,1,10928,4059,6869,0,0,0,1.0,1,1.0,1,1.0,1,0.13437425175123763,44
5315,4,10932,4061,6871,0,0,0,1.0,1,1.0,1,1.0,1,0.15132358919647432,45
5316,1,10933,4061,6872,0,0,0,1.0,1,1.0,1,1.0,1,0.14782105798706946,46
5317,3,10936,4063,6873,0,0,0,1.0,1,1.0,1,1.0,1,0.14649923348337446,46
5318,1,10937,4064,6873,0,0,0,1.0,1,1.0,1,1.0,1,0.14395978053274247,46
5319,0,10937,4064,6873,0,0,0,1.0,1,1.0,1,1.0,1,0.15854203931638453,47
5320,6,10943,4065,6878,0,0,0,1.0,1,1.0,1,1.0,1,0.06371042049529983,48
5321,0,10943,4065,6878,0,0,0,1.0,1,1.0,1,1.0,1,0.07616381115747903,49
5322,0,10943,4065,6878,0,0,0,1.0,1,1.0,1,1.0,1,0.07616381115747903,49
5323,1,10944,4065,6879,0,0,0,1.0,1,1.0,1,1.0,1,0.09907526036914442,51
5324,0,10944,4065,6879,0,0,0,1.0,1,1.0,1,1.0,1,0.09819603280745058,53
5325,1,10945,4066,6879,0,0,0,1.0,1,1.0,1,1.0,1,0.11067410101805414,53
5326,1,10946,4067,6879,0,0,0,1.0,1,1.0,1,1.0,1,0.12890130820324355,53
5327,4,10950,4068,6882,0,0,0,1.0,1,1.0,1,1.0,1,0.11716980816044589,53
5328,1,10951,4068,6883,0,0,0,1.0,1,1.0,1,1.0,1,0.12168611063350711,54
5329,5,10956,4070,6886,0,0,0,1.0,1,1.0,1,1.0,1,0.1236943304470499,53
5330,2,10958,4072,6886,0,0,0,1.0,1,1.0,1,1.0,1,0.1832571085576257,52
5331,0,10958,4072,6886,0,0,0,1.0,1,1.0,1,1.0,1,0.19352628318287365,51
5332,3,10961,4072,6889,0,0,0,1.0,1,1.0,1,1.0,1,0.1472463693080956,52
5333,2,10963,4073,6890,0,0,0,1.0,1,1.0,1,1.0,1,0.17400434697202097,53
5334,4,10967,4074,6893,0,0,0,1.0,1,1.0,1,1.0,1,0.1613494136136159,54
5335,4,10971,4074,6897,0,0,0,1.0,1,1.0,1,1.0,1,0.09501029200863427,55
5336,1,10972,4074,6898,0,0,0,1.0,1,1.0,1,1.0,1,0.09197173655090471,54
5337,0,10972,4074,6898,0,0,0,1.0,1,1.0,1,1.0,1,0.10440015528718964,55
5338,1,10973,4075,6898,0,0,0,1.0,1,1.0,1,1.0,1,0.11808783941808661,55
5339,0,10973,4075,6898,0,0,0,1.0,1,1.0,1,1.0,1,0.11808783941808661,55
5340,0,10973,4075,6898,0,0,0,1.0,1,1.0,1,1.0,1,0.11808783941808661,55
5341,2,10975,4076,6899,0,0,0,1.0,1,1.0,1,1.0,1,0.1555580843080752,54
5342,0,10975,4076,6899,0,0,0,1.0,1,1.0,1,1.0,1,0.14807138005008172,55
5343,4,10979,4078,6901,0,0,0,1.0,1,1.0,1,1.0,1,0.14185581947270395,54
5344,4,10983,4081,6902,0,0,0,1.0,1,1.0,1,1.0,1,0.1595895259213578,55
5345,2,10985,4082,6903,0,0,0,1.0,1,1.0,1,1.0,1,0.12049570594650176,53
5346,4,10989,4084,6905,0,0,0,1.0,1,1.0,1,1.0,1,0.12409535929588618,53
5347,2,10991,4085,6906,0,0,0,1.0,1,1.0,1,1.0,1,0.13590229227685963,51
5348,6,10997,4087,6910,0,0,0,1.0,1,1.0,1,1.0,1,0.09415609073770327,53
5349,3,11000,4089,6911,0,0,0,1.0,1,1.0,1,1.0,1,0.0972184863114036,52
5350,3,11003,4090,6913,0,0,0,1.0,1,1.0,1,1.0,1,0.08434947191290101,50
5351,3,11006,4091,6915,0,0,0,1.0,1,1.0,1,1.0,1,0.09102315088429576,52
5352,1,11007,4092,6915,0,0,0,1.0,1,1.0,1,1.0,1,0.10300132352064577,49
5353,0,11007,4092,6915,0,0,0,1.0,1,1.0,1,1.0,1,0.10300132352064577,49
5354,1,11008,4092,6916,0,0,0,1.0,1,1.0,1,1.0,1,0.07897736872854924,49
5355,0,11008,4092,6916,0,0,0,1.0,1,1.0,1,1.0,1,0.10051514237781733,48
5356,5,11013,4094,6919,0,0,0,1.0,1,1.0,1,1.0,1,0.0998649853691985,49
5357,0,11013,4094,6919,0,0,0,1.0,1,1.0,1,1.0,1,0.12093979368263455,47
5358,1,11014,4095,6919,0,0,0,1.0,1,1.0,1,1.0,1,0.13049115900462932,48
5359,2,11016,4096,6920,0,0,0,1.0,1,1.0,1,1.0,1,0.10769565067681494,48
5360,0,11016,4096,6920,0,0,0,1.0,1,1.0,1,1.0,1,0.10769565067681494,48
5361,0,11016,4096,6920,0,0,0,1.0,1,1.0,1,1.0,1,0.10965166260653085,50
5362,1,11017,4096,6921,0,0,0,1.0,1,1.0,1,1.0,1,0.10171727641649748,50
5363,1,11018,4096,6922,0,0,0,1.0,1,1.0,1,1.0,1,0.08454217971653534,50
5364,1,11019,4097,6922,0,0,0,1.0,1,1.0,1,1.0,1,0.09629452189903555,51
5365,1,11020,4097,6923,0,0,0,1.0,1,1.0,1,1.0,1,0.11411257442323747,52
5366,0,11020,4097,6923,0,0,0,1.0,1,1.0,1,1.0,1,0.11411257442323747,52
5367,4,11024,4099,6925,0,0,0,1.0,1,1.0,1,1.0,1,0.13877334893557836,54
5368,4,11028,4100,6928,0,0,0,1.0,1,1.0,1,1.0,1,0.11115971534355593,55
5369,2,11030,4101,6929,0,0,0,1.0,1,1.0,1,1.0,1,0.09709967948501677,53
5370,2,11032,4102,6930,0,0,0,1.0,1,1.0,1,1.0,1,0.11888101478518573,54
5371,3,11035,4105,6930,0,0,0,1.0,1,1.0,1,1.0,1,0.16702743496144912,53
5372,4,11039,4108,6931,0,0,0,1.0,1,1.0,1,1.0,1,0.21502878031100414,53
5373,3,11042,4108,6934,0,0,0,1.0,1,1.0,1,1.0,1,0.19996546491182282,52
5374,7,11049,4110,6939,0,0,0,1.0,1,1.0,1,1.0,1,0.1521055788702349,51
5375,2,11051,4110,6941,0,0,0,1.0,1,1.0,1,1.0,1,0.11886819314621264,52
5376,5,11056,4113,6943,0,0,0,1.0,1,1.0,1,1.0,1,0.10793312804893959,51
5377,2,11058,4113,6945,0,0,0,1.0,1,1.0,1,1.0,1,0.08138183886750584,52
5378,1,11059,4114,6945,0,0,0,1.0,1,1.0,1,1.0,1,0.09802342666019381,50
5379,0,11059,4114,6945,0,0,0,1.0,1,1.0,1,1.0,1,0.09802342666019381,50
5380,2,11061,4114,6947,0,0,0,1.0,1,1.0,1,1.0,1,0.10769934445106367,52
5381,0,11061,4114,6947,0,0,0,1.0,1,1.0,1,1.0,1,0.10769934445106367,52
5382,1,11062,4114,6948,0,0,0,1.0,1,1.0,1,1.0,1,0.09668138866816854,52
5383,1,11063,4114,6949,0,0,0,1.0,1,1.0,1,1.0,1,0.06847365732611839,51
5384,0,11063,4114,6949,0,0,0,1.0,1,1.0,1,1.0,1,0.07974961000569238,52
5385,1,11064,4115,6949,0,0,0,1.0,1,1.0,1,1.0,1,0.12128053770676306,51
5386,5,11069,4116,6953,0,0,0,1.0,1,1.0,1,1.0,1,0.07159558234556372,52
5387,1,11070,4116,6954,0,0,0,1.0,1,1.0,1,1.0,1,0.08364361045780953,53
5388,1,11071,4116,6955,0,0,0,1.0,1,1.0,1,1.0,1,0.08547550021588739,54
5389,1,11072,4117,6955,0,0,0,1.0,1,1.0,1,1.0,1,0.06247367089223737,55
5390,2,11074,4118,6956,0,0,0,1.0,1,1.0,1,1.0,1,0.061103277225085954,56
5391,1,11075,4119,6956,0,0,0,1.0,1,1.0,1,1.0,1,0.07120769030677972,56
5392,3,11078,4122,6956,0,0,0,1.0,1,1.0,1,1.0,1,0.11036453763025329,56
5393,1,11079,4123,6956,0,0,0,1.0,1,1.0,1,1.0,1,0.13910158244012216,54
5394,1,11080,4124,6956,0,0,0,1.0,1,1.0,1,1.0,1,0.15295057589386685,53
5395,4,11084,4125,6959,0,0,0,1.0,1,1.0,1,1.0,1,0.13166072306063423,53
5396,4,11088,4125,6963,0,0,0,1.0,1,1.0,1,1.0,1,0.09649676639460643,54
5397,4,11092,4127,6965,0,0,0,1.0,1,1.0,1,1.0,1,0.12240644363566361,53
5398,4,11096,4127,6969,0,0,0,1.0,1,1.0,1,1.0,1,0.057427322418477145,53
5399,11,11107,4130,6977,0,0,0,1.0,1,1.0,1,1.0,1,0.09292103154112037,55
5400,2,11109,4130,6979,0,0,0,1.0,1,1.0,1,1.0,1,0.09430346478345356,55
5401,4,11113,4132,6981,0,0,0,1.0,1,1.0,1,1.0,1,0.10391808893219608,56
5402,0,11113,4132,6981,0,0,0,1.0,1,1.0,1,1.0,1,0.0,0
