,SuccessfulHandoverCount,TotalSuccessfulHandoverCount,TotalSuccessfulHandoverCountRange,TotalSuccessfulHandoverCountLoadBalancing,TotalSuccessfulHandoverCountOverload,FailedHandoverCount,TotalFailedHandoverCount,AvgQoS,MinQoS,AvgQoS_LoadBased,MinQoS_LoadBased,AvgQoS_RangeBased,MinQoS_RangeBased,GiniLoad,VehicleCount
0,0,0,0,0,0,0,0,1.0,1,1.0,1,1.0,1,0.0,0
1,22,22,0,22,0,0,0,1.0,1,1.0,1,1.0,1,0.2666439998729147,30
2,23,45,0,45,0,0,0,1.0,1,1.0,1,1.0,1,0.2713985427960271,32
3,23,68,0,68,0,0,0,1.0,1,1.0,1,1.0,1,0.2399327401436092,33
4,28,96,0,96,0,0,0,1.0,1,1.0,1,1.0,1,0.27141421236761243,34
5,16,112,0,112,0,0,0,1.0,1,1.0,1,1.0,1,0.14082477159239884,36
6,23,135,0,135,0,0,0,1.0,1,1.0,1,1.0,1,0.1823917172995195,38
7,28,163,0,163,0,0,0,1.0,1,1.0,1,1.0,1,0.2320387596672611,40
8,23,186,0,186,0,0,0,1.0,1,1.0,1,1.0,1,0.3122499946416135,40
9,22,208,0,208,0,0,0,1.0,1,1.0,1,1.0,1,0.24646047920943756,40
10,14,222,0,222,0,0,0,1.0,1,1.0,1,1.0,1,0.2639526445969088,41
11,20,242,0,242,0,0,0,1.0,1,1.0,1,1.0,1,0.22089031114009008,40
12,24,266,1,265,0,0,0,1.0,1,1.0,1,1.0,1,0.2636761698919463,39
13,21,287,1,286,0,0,0,1.0,1,1.0,1,1.0,1,0.27702553114988576,37
14,19,306,1,305,0,0,0,1.0,1,1.0,1,1.0,1,0.33368970171557516,35
15,18,324,1,323,0,0,0,1.0,1,1.0,1,1.0,1,0.17058223034103026,36
16,4,328,1,327,0,0,0,1.0,1,1.0,1,1.0,1,0.15745198430433252,34
17,0,328,1,327,0,0,0,1.0,1,1.0,1,1.0,1,0.18969171694498013,33
18,0,328,1,327,0,0,0,1.0,1,1.0,1,1.0,1,0.20474521739859042,34
19,1,329,2,327,0,0,0,1.0,1,1.0,1,1.0,1,0.22299786891493356,34
20,1,330,2,328,0,0,0,1.0,1,1.0,1,1.0,1,0.20970248871611366,34
21,4,334,2,332,0,0,0,1.0,1,1.0,1,1.0,1,0.16710334912323538,36
22,1,335,3,332,0,0,0,1.0,1,1.0,1,1.0,1,0.17868376265747576,35
23,3,338,4,334,0,0,0,1.0,1,1.0,1,1.0,1,0.18332025112219255,35
24,0,338,4,334,0,0,0,1.0,1,1.0,1,1.0,1,0.1440804233027039,35
25,5,343,9,334,0,0,0,1.0,1,1.0,1,1.0,1,0.2309943450437861,35
26,3,346,10,336,0,0,0,1.0,1,1.0,1,1.0,1,0.2162585184602933,36
27,1,347,10,337,0,0,0,1.0,1,1.0,1,1.0,1,0.1702770289367742,34
28,4,351,11,340,0,0,0,1.0,1,1.0,1,1.0,1,0.1855619367520435,35
29,3,354,12,342,0,0,0,1.0,1,1.0,1,1.0,1,0.17948248881346376,33
30,2,356,13,343,0,0,0,1.0,1,1.0,1,1.0,1,0.19375776828027713,33
31,4,360,15,345,0,0,0,1.0,1,1.0,1,1.0,1,0.20591871073613963,33
32,0,360,15,345,0,0,0,1.0,1,1.0,1,1.0,1,0.2303728618604846,32
33,0,360,15,345,0,0,0,1.0,1,1.0,1,1.0,1,0.24472892766616144,33
34,0,360,15,345,0,0,0,1.0,1,1.0,1,1.0,1,0.24472892766616144,33
35,0,360,15,345,0,0,0,1.0,1,1.0,1,1.0,1,0.23524053791689392,35
36,2,362,16,346,0,0,0,1.0,1,1.0,1,1.0,1,0.2736136981329881,36
37,3,365,17,348,0,0,0,1.0,1,1.0,1,1.0,1,0.22198095853236652,37
38,4,369,18,351,0,0,0,1.0,1,1.0,1,1.0,1,0.17670504179468863,36
39,4,373,18,355,0,0,0,1.0,1,1.0,1,1.0,1,0.16286404914920627,38
40,0,373,18,355,0,0,0,1.0,1,1.0,1,1.0,1,0.18146097569681446,40
41,0,373,18,355,0,0,0,1.0,1,1.0,1,1.0,1,0.18146097569681446,40
42,2,375,20,355,0,0,0,1.0,1,1.0,1,1.0,1,0.21043079832658623,40
43,6,381,21,360,0,0,0,1.0,1,1.0,1,1.0,1,0.19886740102995848,43
44,4,385,21,364,0,0,0,1.0,1,1.0,1,1.0,1,0.13983889366694408,43
45,1,386,22,364,0,0,0,1.0,1,1.0,1,1.0,1,0.12959242765586088,44
46,2,388,22,366,0,0,0,1.0,1,1.0,1,1.0,1,0.11074774648696924,44
47,0,388,22,366,0,0,0,1.0,1,1.0,1,1.0,1,0.11074774648696924,44
48,1,389,23,366,0,0,0,1.0,1,1.0,1,1.0,1,0.13958471005019998,44
49,0,389,23,366,0,0,0,1.0,1,1.0,1,1.0,1,0.12275511092875661,41
50,0,389,23,366,0,0,0,1.0,1,1.0,1,1.0,1,0.14942572217809183,40
51,0,389,23,366,0,0,0,1.0,1,1.0,1,1.0,1,0.17227852362643845,38
52,1,390,24,366,0,0,0,1.0,1,1.0,1,1.0,1,0.22103002616901643,37
53,0,390,24,366,0,0,0,1.0,1,1.0,1,1.0,1,0.24301954444939042,38
54,3,393,24,369,0,0,0,1.0,1,1.0,1,1.0,1,0.23870290927730145,38
55,1,394,24,370,0,0,0,1.0,1,1.0,1,1.0,1,0.24832513262077985,38
56,2,396,25,371,0,0,0,1.0,1,1.0,1,1.0,1,0.25071739924663133,38
57,1,397,26,371,0,0,0,1.0,1,1.0,1,1.0,1,0.23087271619959637,38
58,6,403,29,374,0,0,0,1.0,1,1.0,1,1.0,1,0.30951265143542456,38
59,5,408,30,378,0,0,0,1.0,1,1.0,1,1.0,1,0.29550652507526676,40
60,3,411,30,381,0,0,0,1.0,1,1.0,1,1.0,1,0.30333129368672457,40
61,5,416,30,386,0,0,0,1.0,1,1.0,1,1.0,1,0.20340451707606708,40
62,2,418,31,387,0,0,0,1.0,1,1.0,1,1.0,1,0.20258599179332795,42
63,1,419,31,388,0,0,0,1.0,1,1.0,1,1.0,1,0.18386395179381992,40
64,0,419,31,388,0,0,0,1.0,1,1.0,1,1.0,1,0.17503521094647048,41
65,0,419,31,388,0,0,0,1.0,1,1.0,1,1.0,1,0.17503521094647048,41
66,2,421,32,389,0,0,0,1.0,1,1.0,1,1.0,1,0.19259079527511425,41
67,0,421,32,389,0,0,0,1.0,1,1.0,1,1.0,1,0.19259079527511425,41
68,1,422,33,389,0,0,0,1.0,1,1.0,1,1.0,1,0.20812318978802805,41
69,7,429,35,394,0,0,0,1.0,1,1.0,1,1.0,1,0.15435850922984284,41
70,0,429,35,394,0,0,0,1.0,1,1.0,1,1.0,1,0.17198798094241743,42
71,5,434,37,397,0,0,0,1.0,1,1.0,1,1.0,1,0.1930910819410316,44
72,7,441,37,404,0,0,0,1.0,1,1.0,1,1.0,1,0.13601000238175193,44
73,1,442,37,405,0,0,0,1.0,1,1.0,1,1.0,1,0.1770539324744114,46
74,4,446,37,409,0,0,0,1.0,1,1.0,1,1.0,1,0.15980498566365456,44
75,2,448,38,410,0,0,0,1.0,1,1.0,1,1.0,1,0.15859949325083617,44
76,8,456,40,416,0,0,0,1.0,1,1.0,1,1.0,1,0.1752789606691408,45
77,2,458,40,418,0,0,0,1.0,1,1.0,1,1.0,1,0.1249832105473024,44
78,3,461,41,420,0,0,0,1.0,1,1.0,1,1.0,1,0.14433568490700058,44
79,2,463,42,421,0,0,0,1.0,1,1.0,1,1.0,1,0.21514380055338295,43
80,3,466,43,423,0,0,0,1.0,1,1.0,1,1.0,1,0.2065298494556704,43
81,5,471,45,426,0,0,0,1.0,1,1.0,1,1.0,1,0.28361330089518705,44
82,9,480,47,433,0,0,0,1.0,1,1.0,1,1.0,1,0.305247618711708,45
83,10,490,48,442,0,0,0,1.0,1,1.0,1,1.0,1,0.2983197208674237,45
84,6,496,48,448,0,0,0,1.0,1,1.0,1,1.0,1,0.2743894801575548,45
85,6,502,48,454,0,0,0,1.0,1,1.0,1,1.0,1,0.24837708386653334,45
86,5,507,48,459,0,0,0,1.0,1,1.0,1,1.0,1,0.25415317146691135,45
87,2,509,48,461,0,0,0,1.0,1,1.0,1,1.0,1,0.26539254882102054,44
88,3,512,48,464,0,0,0,1.0,1,1.0,1,1.0,1,0.25739158138400897,45
89,6,518,49,469,0,0,0,1.0,1,1.0,1,1.0,1,0.2630435993186849,46
90,3,521,49,472,0,0,0,1.0,1,1.0,1,1.0,1,0.30627673328245414,44
91,8,529,50,479,0,0,0,1.0,1,1.0,1,1.0,1,0.22090531370947522,45
92,1,530,50,480,0,0,0,1.0,1,1.0,1,1.0,1,0.22733074656146654,46
93,1,531,50,481,0,0,0,1.0,1,1.0,1,1.0,1,0.22811691061302938,46
94,2,533,50,483,0,0,0,1.0,1,1.0,1,1.0,1,0.22811691061302938,46
95,3,536,50,486,0,0,0,1.0,1,1.0,1,1.0,1,0.22014958066840984,46
96,5,541,51,490,0,0,0,1.0,1,1.0,1,1.0,1,0.23812750402015012,46
97,4,545,51,494,0,0,0,1.0,1,1.0,1,1.0,1,0.22366080117197817,47
98,4,549,51,498,0,0,0,1.0,1,1.0,1,1.0,1,0.18352829754715344,47
99,1,550,51,499,0,0,0,1.0,1,1.0,1,1.0,1,0.18735872655077934,46
100,2,552,52,500,0,0,0,1.0,1,1.0,1,1.0,1,0.18661405370861175,48
101,3,555,53,502,0,0,0,1.0,1,1.0,1,1.0,1,0.20169060948796236,49
102,5,560,53,507,0,0,0,1.0,1,1.0,1,1.0,1,0.1991624751065404,49
103,3,563,53,510,0,0,0,1.0,1,1.0,1,1.0,1,0.1706709724275612,48
104,5,568,55,513,0,0,0,1.0,1,1.0,1,1.0,1,0.20942836711774443,49
105,9,577,55,522,0,0,0,1.0,1,1.0,1,1.0,1,0.1635583824320275,48
106,6,583,56,527,0,0,0,1.0,1,1.0,1,1.0,1,0.10427636846606715,48
107,4,587,58,529,0,0,0,1.0,1,1.0,1,1.0,1,0.1172732901590495,47
108,2,589,59,530,0,0,0,1.0,1,1.0,1,1.0,1,0.12341101432803026,47
109,7,596,62,534,0,0,0,1.0,1,1.0,1,1.0,1,0.1691163715763765,47
110,2,598,63,535,0,0,0,1.0,1,1.0,1,1.0,1,0.19124118900170098,47
111,3,601,64,537,0,0,0,1.0,1,1.0,1,1.0,1,0.23742226127307517,46
112,6,607,65,542,0,0,0,1.0,1,1.0,1,1.0,1,0.18134259425276647,46
113,2,609,66,543,0,0,0,1.0,1,1.0,1,1.0,1,0.17036677901866826,45
114,1,610,66,544,0,0,0,1.0,1,1.0,1,1.0,1,0.14826509234870575,46
115,3,613,67,546,0,0,0,1.0,1,1.0,1,1.0,1,0.14747221928792908,47
116,3,616,68,548,0,0,0,1.0,1,1.0,1,1.0,1,0.1534876586948684,48
117,3,619,69,550,0,0,0,1.0,1,1.0,1,1.0,1,0.154372614457977,48
118,1,620,69,551,0,0,0,1.0,1,1.0,1,1.0,1,0.13082104976051562,49
119,1,621,69,552,0,0,0,1.0,1,1.0,1,1.0,1,0.14120149630427029,50
120,6,627,69,558,0,0,0,1.0,1,1.0,1,1.0,1,0.15461499712105647,51
121,4,631,69,562,0,0,0,1.0,1,1.0,1,1.0,1,0.11199634626629182,51
122,2,633,69,564,0,0,0,1.0,1,1.0,1,1.0,1,0.07488079962865761,51
123,1,634,70,564,0,0,0,1.0,1,1.0,1,1.0,1,0.10052194828992106,51
124,1,635,71,564,0,0,0,1.0,1,1.0,1,1.0,1,0.10230073658683576,51
125,0,635,71,564,0,0,0,1.0,1,1.0,1,1.0,1,0.14352377305472488,50
126,3,638,73,565,0,0,0,1.0,1,1.0,1,1.0,1,0.1605639073141464,52
127,2,640,73,567,0,0,0,1.0,1,1.0,1,1.0,1,0.1893996227651149,50
128,2,642,73,569,0,0,0,1.0,1,1.0,1,1.0,1,0.15480429312388405,50
129,3,645,73,572,0,0,0,1.0,1,1.0,1,1.0,1,0.16854024895379605,52
130,5,650,74,576,0,0,0,1.0,1,1.0,1,1.0,1,0.1875666455968417,52
131,1,651,74,577,0,0,0,1.0,1,1.0,1,1.0,1,0.19583929841171097,54
132,5,656,76,580,0,0,0,1.0,1,1.0,1,1.0,1,0.18438151430626148,54
133,2,658,76,582,0,0,0,1.0,1,1.0,1,1.0,1,0.16099671263272125,52
134,7,665,79,586,0,0,0,1.0,1,1.0,1,1.0,1,0.14310456505923083,52
135,5,670,83,587,0,0,0,1.0,1,1.0,1,1.0,1,0.1460824314127255,51
136,7,677,83,594,0,0,0,1.0,1,1.0,1,1.0,1,0.08763217041660594,51
137,1,678,84,594,0,0,0,1.0,1,1.0,1,1.0,1,0.09084471857164332,50
138,5,683,85,598,0,0,0,1.0,1,1.0,1,1.0,1,0.07620664672308185,52
139,3,686,87,599,0,0,0,1.0,1,1.0,1,1.0,1,0.11690392887267109,51
140,1,687,87,600,0,0,0,1.0,1,1.0,1,1.0,1,0.11031834917813933,51
141,1,688,88,600,0,0,0,1.0,1,1.0,1,1.0,1,0.13349552813179053,50
142,2,690,89,601,0,0,0,1.0,1,1.0,1,1.0,1,0.14621699591663576,51
143,0,690,89,601,0,0,0,1.0,1,1.0,1,1.0,1,0.17401726759268318,48
144,3,693,92,601,0,0,0,1.0,1,1.0,1,1.0,1,0.2072740350353574,49
145,6,699,94,605,0,0,0,1.0,1,1.0,1,1.0,1,0.20166951743229286,47
146,7,706,96,610,0,0,0,1.0,1,1.0,1,1.0,1,0.1871025954431763,49
147,1,707,96,611,0,0,0,1.0,1,1.0,1,1.0,1,0.1939153042440353,46
148,4,711,97,614,0,0,0,1.0,1,1.0,1,1.0,1,0.19872335526605245,47
149,3,714,99,615,0,0,0,1.0,1,1.0,1,1.0,1,0.21818600729434148,46
150,4,718,99,619,0,0,0,1.0,1,1.0,1,1.0,1,0.20958957126958938,47
151,5,723,102,621,0,0,0,1.0,1,1.0,1,1.0,1,0.19948695889977502,46
152,1,724,102,622,0,0,0,1.0,1,1.0,1,1.0,1,0.20744351056525134,45
153,2,726,102,624,0,0,0,1.0,1,1.0,1,1.0,1,0.172401773348908,46
154,2,728,102,626,0,0,0,1.0,1,1.0,1,1.0,1,0.150401223455224,44
155,4,732,104,628,0,0,0,1.0,1,1.0,1,1.0,1,0.13783585738181992,45
156,2,734,106,628,0,0,0,1.0,1,1.0,1,1.0,1,0.21580721922707335,43
157,1,735,106,629,0,0,0,1.0,1,1.0,1,1.0,1,0.20689430466430117,42
158,5,740,106,634,0,0,0,1.0,1,1.0,1,1.0,1,0.19761368397835105,43
159,3,743,108,635,0,0,0,1.0,1,1.0,1,1.0,1,0.17817045909788237,44
160,2,745,108,637,0,0,0,1.0,1,1.0,1,1.0,1,0.16059834079385676,44
161,2,747,109,638,0,0,0,1.0,1,1.0,1,1.0,1,0.1789455547633209,44
162,3,750,110,640,0,0,0,1.0,1,1.0,1,1.0,1,0.18662163829100767,44
163,4,754,112,642,0,0,0,1.0,1,1.0,1,1.0,1,0.16878112693419314,44
164,2,756,113,643,0,0,0,1.0,1,1.0,1,1.0,1,0.19574072246075874,44
165,2,758,114,644,0,0,0,1.0,1,1.0,1,1.0,1,0.15493441019279794,43
166,3,761,115,646,0,0,0,1.0,1,1.0,1,1.0,1,0.15713908324427878,43
167,0,761,115,646,0,0,0,1.0,1,1.0,1,1.0,1,0.15930009329784842,42
168,2,763,116,647,0,0,0,1.0,1,1.0,1,1.0,1,0.1703451330834829,40
169,4,767,118,649,0,0,0,1.0,1,1.0,1,1.0,1,0.15127300395302468,41
170,1,768,119,649,0,0,0,1.0,1,1.0,1,1.0,1,0.1487419826492254,39
171,0,768,119,649,0,0,0,1.0,1,1.0,1,1.0,1,0.1487419826492254,39
172,1,769,119,650,0,0,0,1.0,1,1.0,1,1.0,1,0.15564479844411286,38
173,2,771,119,652,0,0,0,1.0,1,1.0,1,1.0,1,0.13514642179542274,38
174,3,774,120,654,0,0,0,1.0,1,1.0,1,1.0,1,0.08655187434246865,37
175,1,775,121,654,0,0,0,1.0,1,1.0,1,1.0,1,0.12465323170058513,36
176,2,777,123,654,0,0,0,1.0,1,1.0,1,1.0,1,0.1466722373254082,36
177,3,780,124,656,0,0,0,1.0,1,1.0,1,1.0,1,0.13868705195899558,38
178,1,781,125,656,0,0,0,1.0,1,1.0,1,1.0,1,0.1484758053874345,39
179,2,783,125,658,0,0,0,1.0,1,1.0,1,1.0,1,0.14601623825329688,40
180,1,784,125,659,0,0,0,1.0,1,1.0,1,1.0,1,0.15443025518463216,40
181,1,785,125,660,0,0,0,1.0,1,1.0,1,1.0,1,0.16134845714844642,39
182,3,788,127,661,0,0,0,1.0,1,1.0,1,1.0,1,0.15156296331215638,40
183,2,790,128,662,0,0,0,1.0,1,1.0,1,1.0,1,0.20310548328770153,40
184,3,793,131,662,0,0,0,1.0,1,1.0,1,1.0,1,0.2832470230141757,38
185,6,799,132,667,0,0,0,1.0,1,1.0,1,1.0,1,0.20638679336308577,38
186,1,800,133,667,0,0,0,1.0,1,1.0,1,1.0,1,0.2142366266826401,37
187,3,803,134,669,0,0,0,1.0,1,1.0,1,1.0,1,0.16312214492410465,36
188,2,805,136,669,0,0,0,1.0,1,1.0,1,1.0,1,0.20513908289805827,36
189,5,810,137,673,0,0,0,1.0,1,1.0,1,1.0,1,0.22454540868067996,36
190,2,812,137,675,0,0,0,1.0,1,1.0,1,1.0,1,0.20124197932730273,36
191,2,814,138,676,0,0,0,1.0,1,1.0,1,1.0,1,0.1934130419149004,37
192,4,818,139,679,0,0,0,1.0,1,1.0,1,1.0,1,0.15303991085742746,37
193,0,818,139,679,0,0,0,1.0,1,1.0,1,1.0,1,0.14254286793565044,38
194,2,820,141,679,0,0,0,1.0,1,1.0,1,1.0,1,0.17148906847294418,39
195,2,822,142,680,0,0,0,1.0,1,1.0,1,1.0,1,0.18383350128001297,40
196,4,826,142,684,0,0,0,1.0,1,1.0,1,1.0,1,0.11181105629347195,40
197,1,827,142,685,0,0,0,1.0,1,1.0,1,1.0,1,0.1457035571956647,40
198,1,828,143,685,0,0,0,1.0,1,1.0,1,1.0,1,0.1674834627363414,40
199,4,832,144,688,0,0,0,1.0,1,1.0,1,1.0,1,0.12353912912750878,40
200,3,835,144,691,0,0,0,1.0,1,1.0,1,1.0,1,0.12103752062088047,40
201,2,837,146,691,0,0,0,1.0,1,1.0,1,1.0,1,0.06988076091165676,39
202,2,839,146,693,0,0,0,1.0,1,1.0,1,1.0,1,0.09758555627408254,40
203,4,843,148,695,0,0,0,1.0,1,1.0,1,1.0,1,0.1390586197578085,39
204,0,843,148,695,0,0,0,1.0,1,1.0,1,1.0,1,0.1274520063119381,38
205,0,843,148,695,0,0,0,1.0,1,1.0,1,1.0,1,0.13285028194675183,37
206,1,844,148,696,0,0,0,1.0,1,1.0,1,1.0,1,0.1549414386065509,36
207,1,845,149,696,0,0,0,1.0,1,1.0,1,1.0,1,0.17811970463762017,37
208,1,846,149,697,0,0,0,1.0,1,1.0,1,1.0,1,0.16884292345753563,36
209,2,848,151,697,0,0,0,1.0,1,1.0,1,1.0,1,0.20127303762859405,36
210,1,849,152,697,0,0,0,1.0,1,1.0,1,1.0,1,0.2386501529496503,36
211,4,853,153,700,0,0,0,1.0,1,1.0,1,1.0,1,0.23284097557282635,34
212,2,855,154,701,0,0,0,1.0,1,1.0,1,1.0,1,0.2372952380091492,34
213,2,857,154,703,0,0,0,1.0,1,1.0,1,1.0,1,0.2384221699960131,36
214,2,859,154,705,0,0,0,1.0,1,1.0,1,1.0,1,0.22106205848531738,35
215,2,861,154,707,0,0,0,1.0,1,1.0,1,1.0,1,0.18317442361156325,35
216,5,866,154,712,0,0,0,1.0,1,1.0,1,1.0,1,0.16281958432010107,37
217,1,867,154,713,0,0,0,1.0,1,1.0,1,1.0,1,0.1553454293512267,37
218,6,873,156,717,0,0,0,1.0,1,1.0,1,1.0,1,0.17575975170974534,37
219,6,879,157,722,0,0,0,1.0,1,1.0,1,1.0,1,0.2061670525273015,37
220,5,884,157,727,0,0,0,1.0,1,1.0,1,1.0,1,0.21391751910345944,38
221,3,887,157,730,0,0,0,1.0,1,1.0,1,1.0,1,0.2125693704350299,39
222,3,890,158,732,0,0,0,1.0,1,1.0,1,1.0,1,0.2030935790596135,39
223,3,893,159,734,0,0,0,1.0,1,1.0,1,1.0,1,0.16341700791018493,40
224,6,899,162,737,0,0,0,1.0,1,1.0,1,1.0,1,0.16322997371157816,40
225,2,901,162,739,0,0,0,1.0,1,1.0,1,1.0,1,0.16630621978950733,39
226,5,906,165,741,0,0,0,1.0,1,1.0,1,1.0,1,0.13887830069839302,39
227,1,907,165,742,0,0,0,1.0,1,1.0,1,1.0,1,0.1459396628299745,39
228,2,909,167,742,0,0,0,1.0,1,1.0,1,1.0,1,0.16421438452580486,38
229,4,913,168,745,0,0,0,1.0,1,1.0,1,1.0,1,0.1714248032704892,39
230,2,915,170,745,0,0,0,1.0,1,1.0,1,1.0,1,0.1700393841295115,38
231,2,917,172,745,0,0,0,1.0,1,1.0,1,1.0,1,0.1687777178514021,38
232,3,920,174,746,0,0,0,1.0,1,1.0,1,1.0,1,0.20567117854363995,37
233,2,922,175,747,0,0,0,1.0,1,1.0,1,1.0,1,0.19417183091948623,36
234,2,924,177,747,0,0,0,1.0,1,1.0,1,1.0,1,0.17385128853528178,34
235,1,925,178,747,0,0,0,1.0,1,1.0,1,1.0,1,0.20101011088016843,34
236,0,925,178,747,0,0,0,1.0,1,1.0,1,1.0,1,0.2551436753086523,33
237,0,925,178,747,0,0,0,1.0,1,1.0,1,1.0,1,0.26362205456505367,32
238,1,926,179,747,0,0,0,1.0,1,1.0,1,1.0,1,0.30198814795532675,32
239,1,927,180,747,0,0,0,1.0,1,1.0,1,1.0,1,0.2627341103299848,31
240,0,927,180,747,0,0,0,1.0,1,1.0,1,1.0,1,0.2701525487029292,28
241,6,933,183,750,0,0,0,1.0,1,1.0,1,1.0,1,0.2520813052060018,27
242,2,935,183,752,0,0,0,1.0,1,1.0,1,1.0,1,0.2300065354271673,29
243,1,936,183,753,0,0,0,1.0,1,1.0,1,1.0,1,0.24125484511026166,28
244,0,936,183,753,0,0,0,1.0,1,1.0,1,1.0,1,0.28053772383038283,28
245,1,937,184,753,0,0,0,1.0,1,1.0,1,1.0,1,0.2888808842482534,27
246,2,939,186,753,0,0,0,1.0,1,1.0,1,1.0,1,0.2662101202314203,25
247,1,940,186,754,0,0,0,1.0,1,1.0,1,1.0,1,0.261299695353403,26
248,0,940,186,754,0,0,0,1.0,1,1.0,1,1.0,1,0.2646824766917805,27
249,1,941,187,754,0,0,0,1.0,1,1.0,1,1.0,1,0.235731102605754,26
250,0,941,187,754,0,0,0,1.0,1,1.0,1,1.0,1,0.2568468079451483,27
251,3,944,189,755,0,0,0,1.0,1,1.0,1,1.0,1,0.35287842437408895,28
252,2,946,190,756,0,0,0,1.0,1,1.0,1,1.0,1,0.34112443494538847,28
253,3,949,191,758,0,0,0,1.0,1,1.0,1,1.0,1,0.32509070273034313,28
254,4,953,191,762,0,0,0,1.0,1,1.0,1,1.0,1,0.3461595230921138,29
255,4,957,191,766,0,0,0,1.0,1,1.0,1,1.0,1,0.30295228070564173,30
256,3,960,191,769,0,0,0,1.0,1,1.0,1,1.0,1,0.1874614644666152,30
257,3,963,192,771,0,0,0,1.0,1,1.0,1,1.0,1,0.19603853761173776,32
258,3,966,193,773,0,0,0,1.0,1,1.0,1,1.0,1,0.2022022484732133,32
259,0,966,193,773,0,0,0,1.0,1,1.0,1,1.0,1,0.2022022484732133,32
260,0,966,193,773,0,0,0,1.0,1,1.0,1,1.0,1,0.1507383707963698,34
261,0,966,193,773,0,0,0,1.0,1,1.0,1,1.0,1,0.1632209959480717,35
262,1,967,194,773,0,0,0,1.0,1,1.0,1,1.0,1,0.21671318691344638,36
263,0,967,194,773,0,0,0,1.0,1,1.0,1,1.0,1,0.19750995427401924,34
264,2,969,196,773,0,0,0,1.0,1,1.0,1,1.0,1,0.2615883678514038,34
265,2,971,196,775,0,0,0,1.0,1,1.0,1,1.0,1,0.2548204070602974,33
266,2,973,197,776,0,0,0,1.0,1,1.0,1,1.0,1,0.23423233099281104,34
267,0,973,197,776,0,0,0,1.0,1,1.0,1,1.0,1,0.24897696130332234,33
268,2,975,197,778,0,0,0,1.0,1,1.0,1,1.0,1,0.22089170498810673,34
269,0,975,197,778,0,0,0,1.0,1,1.0,1,1.0,1,0.22089170498810673,34
270,0,975,197,778,0,0,0,1.0,1,1.0,1,1.0,1,0.22869398620799036,36
271,2,977,197,780,0,0,0,1.0,1,1.0,1,1.0,1,0.18724902935866983,36
272,2,979,197,782,0,0,0,1.0,1,1.0,1,1.0,1,0.17333053215896146,38
273,0,979,197,782,0,0,0,1.0,1,1.0,1,1.0,1,0.17333053215896146,38
274,1,980,198,782,0,0,0,1.0,1,1.0,1,1.0,1,0.19544378038532592,38
275,1,981,198,783,0,0,0,1.0,1,1.0,1,1.0,1,0.1756064115006227,38
276,2,983,199,784,0,0,0,1.0,1,1.0,1,1.0,1,0.16743158844248673,39
277,1,984,200,784,0,0,0,1.0,1,1.0,1,1.0,1,0.20682810913453717,38
278,1,985,200,785,0,0,0,1.0,1,1.0,1,1.0,1,0.15451330814810993,38
279,1,986,200,786,0,0,0,1.0,1,1.0,1,1.0,1,0.11155767627807761,38
280,1,987,201,786,0,0,0,1.0,1,1.0,1,1.0,1,0.18010178606465244,38
281,0,987,201,786,0,0,0,1.0,1,1.0,1,1.0,1,0.16548098427687175,38
282,2,989,202,787,0,0,0,1.0,1,1.0,1,1.0,1,0.14398445169399315,38
283,2,991,203,788,0,0,0,1.0,1,1.0,1,1.0,1,0.19971952348144248,38
284,2,993,203,790,0,0,0,1.0,1,1.0,1,1.0,1,0.16366937540755194,39
285,2,995,203,792,0,0,0,1.0,1,1.0,1,1.0,1,0.16366937540755194,39
286,0,995,203,792,0,0,0,1.0,1,1.0,1,1.0,1,0.16366937540755194,39
287,2,997,204,793,0,0,0,1.0,1,1.0,1,1.0,1,0.18050505108552142,39
288,1,998,204,794,0,0,0,1.0,1,1.0,1,1.0,1,0.1387845471616179,39
289,1,999,205,794,0,0,0,1.0,1,1.0,1,1.0,1,0.18389310946146076,39
290,1,1000,205,795,0,0,0,1.0,1,1.0,1,1.0,1,0.18062282042789216,39
291,0,1000,205,795,0,0,0,1.0,1,1.0,1,1.0,1,0.18062282042789216,39
292,3,1003,206,797,0,0,0,1.0,1,1.0,1,1.0,1,0.1915592460653968,40
293,6,1009,208,801,0,0,0,1.0,1,1.0,1,1.0,1,0.24715340479928646,41
294,5,1014,209,805,0,0,0,1.0,1,1.0,1,1.0,1,0.19242050974980401,40
295,4,1018,211,807,0,0,0,1.0,1,1.0,1,1.0,1,0.18767248482653953,42
296,2,1020,213,807,0,0,0,1.0,1,1.0,1,1.0,1,0.2292302074872514,42
297,7,1027,215,812,0,0,0,1.0,1,1.0,1,1.0,1,0.18868323332503792,43
298,5,1032,215,817,0,0,0,1.0,1,1.0,1,1.0,1,0.1630558149058268,44
299,5,1037,216,821,0,0,0,1.0,1,1.0,1,1.0,1,0.16921840348871203,44
300,3,1040,216,824,0,0,0,1.0,1,1.0,1,1.0,1,0.17251939681864228,45
301,5,1045,218,827,0,0,0,1.0,1,1.0,1,1.0,1,0.10166393250043672,47
302,3,1048,220,828,0,0,0,1.0,1,1.0,1,1.0,1,0.12237694284601068,46
303,0,1048,220,828,0,0,0,1.0,1,1.0,1,1.0,1,0.10335270945161065,45
304,3,1051,223,828,0,0,0,1.0,1,1.0,1,1.0,1,0.1446026917568217,45
305,1,1052,223,829,0,0,0,1.0,1,1.0,1,1.0,1,0.1369681308434011,43
306,2,1054,223,831,0,0,0,1.0,1,1.0,1,1.0,1,0.14859001896773,44
307,4,1058,225,833,0,0,0,1.0,1,1.0,1,1.0,1,0.15416447143443165,42
308,2,1060,226,834,0,0,0,1.0,1,1.0,1,1.0,1,0.12868843937791263,41
309,2,1062,226,836,0,0,0,1.0,1,1.0,1,1.0,1,0.14104412012747966,42
310,2,1064,226,838,0,0,0,1.0,1,1.0,1,1.0,1,0.15748772550061574,41
311,2,1066,226,840,0,0,0,1.0,1,1.0,1,1.0,1,0.15748772550061574,41
312,5,1071,227,844,0,0,0,1.0,1,1.0,1,1.0,1,0.13850102272554152,44
313,0,1071,227,844,0,0,0,1.0,1,1.0,1,1.0,1,0.1601611798423907,43
314,1,1072,227,845,0,0,0,1.0,1,1.0,1,1.0,1,0.17104091112408576,43
315,3,1075,228,847,0,0,0,1.0,1,1.0,1,1.0,1,0.1751693224657299,43
316,4,1079,228,851,0,0,0,1.0,1,1.0,1,1.0,1,0.10227794891983356,43
317,0,1079,228,851,0,0,0,1.0,1,1.0,1,1.0,1,0.12083947933871812,44
318,2,1081,229,852,0,0,0,1.0,1,1.0,1,1.0,1,0.17067743065587357,45
319,3,1084,229,855,0,0,0,1.0,1,1.0,1,1.0,1,0.1237937478136419,46
320,3,1087,230,857,0,0,0,1.0,1,1.0,1,1.0,1,0.16473226915713948,45
321,0,1087,230,857,0,0,0,1.0,1,1.0,1,1.0,1,0.14831767696129936,44
322,0,1087,230,857,0,0,0,1.0,1,1.0,1,1.0,1,0.14243452715728236,42
323,2,1089,232,857,0,0,0,1.0,1,1.0,1,1.0,1,0.14948736755259265,42
324,1,1090,232,858,0,0,0,1.0,1,1.0,1,1.0,1,0.16541286756727347,43
325,4,1094,234,860,0,0,0,1.0,1,1.0,1,1.0,1,0.20851923953468707,43
326,1,1095,234,861,0,0,0,1.0,1,1.0,1,1.0,1,0.17699726001322313,43
327,3,1098,236,862,0,0,0,1.0,1,1.0,1,1.0,1,0.2100643683452623,44
328,2,1100,237,863,0,0,0,1.0,1,1.0,1,1.0,1,0.22635372907843937,44
329,2,1102,237,865,0,0,0,1.0,1,1.0,1,1.0,1,0.19079794927625032,45
330,1,1103,237,866,0,0,0,1.0,1,1.0,1,1.0,1,0.18027104703136806,46
331,5,1108,237,871,0,0,0,1.0,1,1.0,1,1.0,1,0.1178065987218765,46
332,0,1108,237,871,0,0,0,1.0,1,1.0,1,1.0,1,0.1059574015071372,47
333,0,1108,237,871,0,0,0,1.0,1,1.0,1,1.0,1,0.12062740086169114,48
334,0,1108,237,871,0,0,0,1.0,1,1.0,1,1.0,1,0.12062740086169114,48
335,1,1109,237,872,0,0,0,1.0,1,1.0,1,1.0,1,0.11021076443667212,49
336,2,1111,237,874,0,0,0,1.0,1,1.0,1,1.0,1,0.12300992082668209,50
337,3,1114,237,877,0,0,0,1.0,1,1.0,1,1.0,1,0.10250247464012964,51
338,0,1114,237,877,0,0,0,1.0,1,1.0,1,1.0,1,0.10250247464012964,51
339,0,1114,237,877,0,0,0,1.0,1,1.0,1,1.0,1,0.10250247464012964,51
340,1,1115,238,877,0,0,0,1.0,1,1.0,1,1.0,1,0.10171701043855552,51
341,1,1116,239,877,0,0,0,1.0,1,1.0,1,1.0,1,0.12403224465336561,51
342,1,1117,240,877,0,0,0,1.0,1,1.0,1,1.0,1,0.13680737853371241,51
343,1,1118,240,878,0,0,0,1.0,1,1.0,1,1.0,1,0.1615909738768949,51
344,0,1118,240,878,0,0,0,1.0,1,1.0,1,1.0,1,0.1775733083339871,50
345,0,1118,240,878,0,0,0,1.0,1,1.0,1,1.0,1,0.1775733083339871,50
346,5,1123,242,881,0,0,0,1.0,1,1.0,1,1.0,1,0.1628368690618899,50
347,1,1124,242,882,0,0,0,1.0,1,1.0,1,1.0,1,0.14281305249805704,51
348,5,1129,243,886,0,0,0,1.0,1,1.0,1,1.0,1,0.13647206379160687,52
349,5,1134,245,889,0,0,0,1.0,1,1.0,1,1.0,1,0.16023482430874889,54
350,5,1139,245,894,0,0,0,1.0,1,1.0,1,1.0,1,0.14837191020876947,54
351,4,1143,248,895,0,0,0,1.0,1,1.0,1,1.0,1,0.18191873444232814,54
352,2,1145,248,897,0,0,0,1.0,1,1.0,1,1.0,1,0.17774167313799857,56
353,2,1147,250,897,0,0,0,1.0,1,1.0,1,1.0,1,0.16486429563003188,54
354,1,1148,250,898,0,0,0,1.0,1,1.0,1,1.0,1,0.14149885868564838,53
355,1,1149,251,898,0,0,0,1.0,1,1.0,1,1.0,1,0.12278319998856202,54
356,1,1150,252,898,0,0,0,1.0,1,1.0,1,1.0,1,0.12025401393960088,54
357,4,1154,255,899,0,0,0,1.0,1,1.0,1,1.0,1,0.14755079275545924,53
358,2,1156,255,901,0,0,0,1.0,1,1.0,1,1.0,1,0.11241348173269201,49
359,0,1156,255,901,0,0,0,1.0,1,1.0,1,1.0,1,0.11471897881345755,48
360,0,1156,255,901,0,0,0,1.0,1,1.0,1,1.0,1,0.12296170541755438,47
361,3,1159,256,903,0,0,0,1.0,1,1.0,1,1.0,1,0.1042405385973065,46
362,0,1159,256,903,0,0,0,1.0,1,1.0,1,1.0,1,0.10383253927027895,46
363,2,1161,256,905,0,0,0,1.0,1,1.0,1,1.0,1,0.10122623287549495,47
364,4,1165,258,907,0,0,0,1.0,1,1.0,1,1.0,1,0.11171625348260791,47
365,1,1166,259,907,0,0,0,1.0,1,1.0,1,1.0,1,0.1315527034242882,47
366,7,1173,260,913,0,0,0,1.0,1,1.0,1,1.0,1,0.11773084314083228,50
367,7,1180,261,919,0,0,0,1.0,1,1.0,1,1.0,1,0.11700217407187562,50
368,4,1184,261,923,0,0,0,1.0,1,1.0,1,1.0,1,0.09824534063944523,51
369,4,1188,261,927,0,0,0,1.0,1,1.0,1,1.0,1,0.1176970757162944,51
370,2,1190,261,929,0,0,0,1.0,1,1.0,1,1.0,1,0.13890647949977536,51
371,2,1192,261,931,0,0,0,1.0,1,1.0,1,1.0,1,0.1422917226837493,52
372,1,1193,261,932,0,0,0,1.0,1,1.0,1,1.0,1,0.14950949750137257,53
373,4,1197,263,934,0,0,0,1.0,1,1.0,1,1.0,1,0.19093213823267527,53
374,5,1202,263,939,0,0,0,1.0,1,1.0,1,1.0,1,0.21451789754600614,53
375,7,1209,266,943,0,0,0,1.0,1,1.0,1,1.0,1,0.1487030559152306,53
376,5,1214,267,947,0,0,0,1.0,1,1.0,1,1.0,1,0.06938107928777801,53
377,2,1216,269,947,0,0,0,1.0,1,1.0,1,1.0,1,0.07196353377365088,53
378,1,1217,270,947,0,0,0,1.0,1,1.0,1,1.0,1,0.08011228088322409,53
379,1,1218,271,947,0,0,0,1.0,1,1.0,1,1.0,1,0.10325326456779525,54
380,2,1220,272,948,0,0,0,1.0,1,1.0,1,1.0,1,0.09839516742948956,54
381,1,1221,273,948,0,0,0,1.0,1,1.0,1,1.0,1,0.10312677457627933,54
382,2,1223,275,948,0,0,0,1.0,1,1.0,1,1.0,1,0.09080777585370312,55
383,1,1224,276,948,0,0,0,1.0,1,1.0,1,1.0,1,0.10653021115808083,55
384,2,1226,277,949,0,0,0,1.0,1,1.0,1,1.0,1,0.14201986670742242,54
385,1,1227,278,949,0,0,0,1.0,1,1.0,1,1.0,1,0.12573771903138908,52
386,2,1229,279,950,0,0,0,1.0,1,1.0,1,1.0,1,0.13513164036490524,52
387,3,1232,281,951,0,0,0,1.0,1,1.0,1,1.0,1,0.1249467925705473,50
388,5,1237,283,954,0,0,0,1.0,1,1.0,1,1.0,1,0.09949001734668622,52
389,1,1238,283,955,0,0,0,1.0,1,1.0,1,1.0,1,0.13402371449631523,51
390,1,1239,284,955,0,0,0,1.0,1,1.0,1,1.0,1,0.14527347040550886,50
391,9,1248,288,960,0,0,0,1.0,1,1.0,1,1.0,1,0.12380697860034023,49
392,6,1254,290,964,0,0,0,1.0,1,1.0,1,1.0,1,0.11102061675026725,47
393,10,1264,293,971,0,0,0,1.0,1,1.0,1,1.0,1,0.2153469000456429,47
394,5,1269,294,975,0,0,0,1.0,1,1.0,1,1.0,1,0.1697578904433322,48
395,4,1273,296,977,0,0,0,1.0,1,1.0,1,1.0,1,0.22988566503051203,46
396,5,1278,297,981,0,0,0,1.0,1,1.0,1,1.0,1,0.25129759399231777,43
397,1,1279,297,982,0,0,0,1.0,1,1.0,1,1.0,1,0.2745707219292466,42
398,6,1285,299,986,0,0,0,1.0,1,1.0,1,1.0,1,0.26436806516600714,40
399,2,1287,299,988,0,0,0,1.0,1,1.0,1,1.0,1,0.2839980517623554,39
400,3,1290,300,990,0,0,0,1.0,1,1.0,1,1.0,1,0.2253251458617205,38
401,5,1295,301,994,0,0,0,1.0,1,1.0,1,1.0,1,0.22176500493778983,37
402,2,1297,301,996,0,0,0,1.0,1,1.0,1,1.0,1,0.25219407653115905,36
403,4,1301,302,999,0,0,0,1.0,1,1.0,1,1.0,1,0.20827138753898977,38
404,6,1307,305,1002,0,0,0,1.0,1,1.0,1,1.0,1,0.24406618147824252,39
405,6,1313,305,1008,0,0,0,1.0,1,1.0,1,1.0,1,0.2621067837350448,40
406,5,1318,306,1012,0,0,0,1.0,1,1.0,1,1.0,1,0.17660270555290564,41
407,0,1318,306,1012,0,0,0,1.0,1,1.0,1,1.0,1,0.150566088509348,42
408,4,1322,306,1016,0,0,0,1.0,1,1.0,1,1.0,1,0.1306974577236757,43
409,2,1324,306,1018,0,0,0,1.0,1,1.0,1,1.0,1,0.12489889826417748,44
410,1,1325,306,1019,0,0,0,1.0,1,1.0,1,1.0,1,0.145318330955777,46
411,1,1326,306,1020,0,0,0,1.0,1,1.0,1,1.0,1,0.12112351718663382,46
412,2,1328,307,1021,0,0,0,1.0,1,1.0,1,1.0,1,0.15627364201880192,47
413,1,1329,307,1022,0,0,0,1.0,1,1.0,1,1.0,1,0.1514611112434908,47
414,2,1331,307,1024,0,0,0,1.0,1,1.0,1,1.0,1,0.1273677635645923,47
415,2,1333,307,1026,0,0,0,1.0,1,1.0,1,1.0,1,0.1262253665935987,48
416,0,1333,307,1026,0,0,0,1.0,1,1.0,1,1.0,1,0.12803208552399212,49
417,4,1337,307,1030,0,0,0,1.0,1,1.0,1,1.0,1,0.11739388668250932,49
418,4,1341,308,1033,0,0,0,1.0,1,1.0,1,1.0,1,0.1688431713795462,50
419,4,1345,308,1037,0,0,0,1.0,1,1.0,1,1.0,1,0.15002871048036484,50
420,3,1348,309,1039,0,0,0,1.0,1,1.0,1,1.0,1,0.16733235124932644,50
421,2,1350,309,1041,0,0,0,1.0,1,1.0,1,1.0,1,0.1104989665125914,50
422,0,1350,309,1041,0,0,0,1.0,1,1.0,1,1.0,1,0.12356274761515737,50
423,2,1352,311,1041,0,0,0,1.0,1,1.0,1,1.0,1,0.1505073394874296,51
424,2,1354,311,1043,0,0,0,1.0,1,1.0,1,1.0,1,0.1292389589144491,49
425,3,1357,312,1045,0,0,0,1.0,1,1.0,1,1.0,1,0.14404194066209366,48
426,1,1358,312,1046,0,0,0,1.0,1,1.0,1,1.0,1,0.15348353428605369,50
427,6,1364,314,1050,0,0,0,1.0,1,1.0,1,1.0,1,0.1616874223719446,48
428,6,1370,316,1054,0,0,0,1.0,1,1.0,1,1.0,1,0.20799602288254274,49
429,6,1376,317,1059,0,0,0,1.0,1,1.0,1,1.0,1,0.19535118054212006,45
430,4,1380,318,1062,0,0,0,1.0,1,1.0,1,1.0,1,0.20715071964505374,44
431,4,1384,318,1066,0,0,0,1.0,1,1.0,1,1.0,1,0.25752750451812334,42
432,4,1388,319,1069,0,0,0,1.0,1,1.0,1,1.0,1,0.25185026995747933,40
433,3,1391,320,1071,0,0,0,1.0,1,1.0,1,1.0,1,0.2479857045863667,39
434,5,1396,321,1075,0,0,0,1.0,1,1.0,1,1.0,1,0.2434706242767743,39
435,7,1403,325,1078,0,0,0,1.0,1,1.0,1,1.0,1,0.30963465125156614,38
436,8,1411,325,1086,0,0,0,1.0,1,1.0,1,1.0,1,0.15867176643398495,38
437,3,1414,325,1089,0,0,0,1.0,1,1.0,1,1.0,1,0.16578430731993254,39
438,6,1420,325,1095,0,0,0,1.0,1,1.0,1,1.0,1,0.15700589637366943,38
439,5,1425,325,1100,0,0,0,1.0,1,1.0,1,1.0,1,0.14180630799049834,39
440,2,1427,325,1102,0,0,0,1.0,1,1.0,1,1.0,1,0.13510260482026232,39
441,3,1430,326,1104,0,0,0,1.0,1,1.0,1,1.0,1,0.17944536273049008,41
442,4,1434,327,1107,0,0,0,1.0,1,1.0,1,1.0,1,0.13631906015798276,42
443,2,1436,327,1109,0,0,0,1.0,1,1.0,1,1.0,1,0.1268517117380514,42
444,4,1440,327,1113,0,0,0,1.0,1,1.0,1,1.0,1,0.13868037680102946,43
445,10,1450,328,1122,0,0,0,1.0,1,1.0,1,1.0,1,0.16352013234019086,44
446,4,1454,328,1126,0,0,0,1.0,1,1.0,1,1.0,1,0.09484306148517693,44
447,5,1459,328,1131,0,0,0,1.0,1,1.0,1,1.0,1,0.1352485566413062,47
448,6,1465,328,1137,0,0,0,1.0,1,1.0,1,1.0,1,0.11815900417942919,46
449,6,1471,328,1143,0,0,0,1.0,1,1.0,1,1.0,1,0.11815900417942919,46
450,7,1478,328,1150,0,0,0,1.0,1,1.0,1,1.0,1,0.14582402989618332,46
451,1,1479,328,1151,0,0,0,1.0,1,1.0,1,1.0,1,0.13267076011900497,47
452,1,1480,328,1152,0,0,0,1.0,1,1.0,1,1.0,1,0.1448423944478085,47
453,1,1481,329,1152,0,0,0,1.0,1,1.0,1,1.0,1,0.15375163318439042,47
454,1,1482,329,1153,0,0,0,1.0,1,1.0,1,1.0,1,0.1536958420632055,46
455,1,1483,329,1154,0,0,0,1.0,1,1.0,1,1.0,1,0.14110021387941626,47
456,1,1484,329,1155,0,0,0,1.0,1,1.0,1,1.0,1,0.12286062086922825,49
457,2,1486,330,1156,0,0,0,1.0,1,1.0,1,1.0,1,0.13082501990600504,50
458,2,1488,330,1158,0,0,0,1.0,1,1.0,1,1.0,1,0.09251442866783083,50
459,1,1489,330,1159,0,0,0,1.0,1,1.0,1,1.0,1,0.07510910505907925,52
460,4,1493,330,1163,0,0,0,1.0,1,1.0,1,1.0,1,0.053876754311647033,53
461,1,1494,330,1164,0,0,0,1.0,1,1.0,1,1.0,1,0.06214998572337423,54
462,0,1494,330,1164,0,0,0,1.0,1,1.0,1,1.0,1,0.06214998572337423,54
463,5,1499,332,1167,0,0,0,1.0,1,1.0,1,1.0,1,0.05212878788938557,55
464,2,1501,334,1167,0,0,0,1.0,1,1.0,1,1.0,1,0.0917178752183133,56
465,1,1502,335,1167,0,0,0,1.0,1,1.0,1,1.0,1,0.08141624225731801,54
466,2,1504,337,1167,0,0,0,1.0,1,1.0,1,1.0,1,0.1427050726145286,54
467,2,1506,338,1168,0,0,0,1.0,1,1.0,1,1.0,1,0.1628525456935142,51
468,7,1513,342,1171,0,0,0,1.0,1,1.0,1,1.0,1,0.13584759917382086,51
469,7,1520,345,1175,0,0,0,1.0,1,1.0,1,1.0,1,0.17556480199653166,48
470,2,1522,347,1175,0,0,0,1.0,1,1.0,1,1.0,1,0.20207370187877086,47
471,2,1524,349,1175,0,0,0,1.0,1,1.0,1,1.0,1,0.19959492907826634,44
472,4,1528,353,1175,0,0,0,1.0,1,1.0,1,1.0,1,0.18905113996169357,43
473,0,1528,353,1175,0,0,0,1.0,1,1.0,1,1.0,1,0.21663740905974788,41
474,1,1529,354,1175,0,0,0,1.0,1,1.0,1,1.0,1,0.2529718033047261,39
475,2,1531,356,1175,0,0,0,1.0,1,1.0,1,1.0,1,0.2792751885887588,40
476,3,1534,359,1175,0,0,0,1.0,1,1.0,1,1.0,1,0.289736807491424,38
477,1,1535,360,1175,0,0,0,1.0,1,1.0,1,1.0,1,0.3442960623335745,35
478,2,1537,361,1176,0,0,0,1.0,1,1.0,1,1.0,1,0.342558184153278,35
479,3,1540,362,1178,0,0,0,1.0,1,1.0,1,1.0,1,0.3438923179275619,32
480,0,1540,362,1178,0,0,0,1.0,1,1.0,1,1.0,1,0.37430845655584044,32
481,6,1546,362,1184,0,0,0,1.0,1,1.0,1,1.0,1,0.27837356021712073,33
482,5,1551,363,1188,0,0,0,1.0,1,1.0,1,1.0,1,0.2700906953874853,34
483,3,1554,363,1191,0,0,0,1.0,1,1.0,1,1.0,1,0.24564364564545715,32
484,5,1559,363,1196,0,0,0,1.0,1,1.0,1,1.0,1,0.20863453107104013,33
485,6,1565,363,1202,0,0,0,1.0,1,1.0,1,1.0,1,0.18561144673096858,34
486,4,1569,363,1206,0,0,0,1.0,1,1.0,1,1.0,1,0.19576696983709568,36
487,5,1574,363,1211,0,0,0,1.0,1,1.0,1,1.0,1,0.1944770346135435,36
488,3,1577,363,1214,0,0,0,1.0,1,1.0,1,1.0,1,0.1813934539917171,37
489,2,1579,364,1215,0,0,0,1.0,1,1.0,1,1.0,1,0.2027490737582102,38
490,3,1582,365,1217,0,0,0,1.0,1,1.0,1,1.0,1,0.18594185403449456,38
491,3,1585,365,1220,0,0,0,1.0,1,1.0,1,1.0,1,0.20541384496460416,37
492,4,1589,365,1224,0,0,0,1.0,1,1.0,1,1.0,1,0.20541384496460416,37
493,4,1593,365,1228,0,0,0,1.0,1,1.0,1,1.0,1,0.20541384496460416,37
494,10,1603,367,1236,0,0,0,1.0,1,1.0,1,1.0,1,0.18771080604658574,39
495,8,1611,367,1244,0,0,0,1.0,1,1.0,1,1.0,1,0.2129203353338002,40
496,5,1616,367,1249,0,0,0,1.0,1,1.0,1,1.0,1,0.1066448188704563,40
497,2,1618,367,1251,0,0,0,1.0,1,1.0,1,1.0,1,0.08426779440561634,43
498,1,1619,367,1252,0,0,0,1.0,1,1.0,1,1.0,1,0.0956039483624001,43
499,0,1619,367,1252,0,0,0,1.0,1,1.0,1,1.0,1,0.10074317386871197,44
500,1,1620,368,1252,0,0,0,1.0,1,1.0,1,1.0,1,0.09684677282795925,45
501,1,1621,368,1253,0,0,0,1.0,1,1.0,1,1.0,1,0.11809723321443807,45
502,0,1621,368,1253,0,0,0,1.0,1,1.0,1,1.0,1,0.11809723321443807,45
503,4,1625,371,1254,0,0,0,1.0,1,1.0,1,1.0,1,0.14263446199265245,46
504,4,1629,373,1256,0,0,0,1.0,1,1.0,1,1.0,1,0.18149845482301452,47
505,1,1630,373,1257,0,0,0,1.0,1,1.0,1,1.0,1,0.19354023366783227,42
506,4,1634,376,1258,0,0,0,1.0,1,1.0,1,1.0,1,0.20749548705661977,41
507,0,1634,376,1258,0,0,0,1.0,1,1.0,1,1.0,1,0.23622263169565666,38
508,1,1635,377,1258,0,0,0,1.0,1,1.0,1,1.0,1,0.26093935158651155,38
509,1,1636,378,1258,0,0,0,1.0,1,1.0,1,1.0,1,0.30623106031961017,37
510,5,1641,378,1263,0,0,0,1.0,1,1.0,1,1.0,1,0.26329766678045385,36
511,1,1642,378,1264,0,0,0,1.0,1,1.0,1,1.0,1,0.20500144159942213,34
512,0,1642,378,1264,0,0,0,1.0,1,1.0,1,1.0,1,0.2099591143204374,32
513,0,1642,378,1264,0,0,0,1.0,1,1.0,1,1.0,1,0.2099591143204374,32
514,1,1643,378,1265,0,0,0,1.0,1,1.0,1,1.0,1,0.15501224492692361,35
515,1,1644,378,1266,0,0,0,1.0,1,1.0,1,1.0,1,0.14622149784201818,35
516,4,1648,379,1269,0,0,0,1.0,1,1.0,1,1.0,1,0.15697739245887954,36
517,1,1649,379,1270,0,0,0,1.0,1,1.0,1,1.0,1,0.12437726429160115,36
518,5,1654,379,1275,0,0,0,1.0,1,1.0,1,1.0,1,0.15733269908710565,39
519,6,1660,380,1280,0,0,0,1.0,1,1.0,1,1.0,1,0.178767365461741,39
520,9,1669,382,1287,0,0,0,1.0,1,1.0,1,1.0,1,0.2939713549402216,39
521,5,1674,382,1292,0,0,0,1.0,1,1.0,1,1.0,1,0.21983753076456422,40
522,6,1680,382,1298,0,0,0,1.0,1,1.0,1,1.0,1,0.18673871560237557,40
523,9,1689,383,1306,0,0,0,1.0,1,1.0,1,1.0,1,0.15528914986060433,41
524,7,1696,383,1313,0,0,0,1.0,1,1.0,1,1.0,1,0.2123170449573177,41
525,8,1704,384,1320,0,0,0,1.0,1,1.0,1,1.0,1,0.18829670372620746,40
526,3,1707,384,1323,0,0,0,1.0,1,1.0,1,1.0,1,0.15362188303619548,40
527,3,1710,385,1325,0,0,0,1.0,1,1.0,1,1.0,1,0.17040912415199586,40
528,3,1713,386,1327,0,0,0,1.0,1,1.0,1,1.0,1,0.20528531651684753,40
529,2,1715,386,1329,0,0,0,1.0,1,1.0,1,1.0,1,0.21600196058181823,39
530,1,1716,386,1330,0,0,0,1.0,1,1.0,1,1.0,1,0.20429670528056304,39
531,5,1721,387,1334,0,0,0,1.0,1,1.0,1,1.0,1,0.21680577469204837,39
532,2,1723,387,1336,0,0,0,1.0,1,1.0,1,1.0,1,0.21324723148886057,40
533,5,1728,388,1340,0,0,0,1.0,1,1.0,1,1.0,1,0.22545577678479092,40
534,8,1736,388,1348,0,0,0,1.0,1,1.0,1,1.0,1,0.3028911236308781,42
535,4,1740,388,1352,0,0,0,1.0,1,1.0,1,1.0,1,0.25835398757803274,42
536,4,1744,388,1356,0,0,0,1.0,1,1.0,1,1.0,1,0.2646017270506043,43
537,3,1747,388,1359,0,0,0,1.0,1,1.0,1,1.0,1,0.24604219106286743,43
538,5,1752,388,1364,0,0,0,1.0,1,1.0,1,1.0,1,0.23924958245020664,44
539,4,1756,388,1368,0,0,0,1.0,1,1.0,1,1.0,1,0.23924958245020664,44
540,2,1758,388,1370,0,0,0,1.0,1,1.0,1,1.0,1,0.24380522767732077,44
541,5,1763,389,1374,0,0,0,1.0,1,1.0,1,1.0,1,0.15185078232449745,45
542,1,1764,389,1375,0,0,0,1.0,1,1.0,1,1.0,1,0.13424957450870884,46
543,4,1768,391,1377,0,0,0,1.0,1,1.0,1,1.0,1,0.15168639687478624,43
544,0,1768,391,1377,0,0,0,1.0,1,1.0,1,1.0,1,0.13452878155369588,42
545,3,1771,392,1379,0,0,0,1.0,1,1.0,1,1.0,1,0.136450825878857,43
546,3,1774,395,1379,0,0,0,1.0,1,1.0,1,1.0,1,0.1992030151902382,41
547,1,1775,395,1380,0,0,0,1.0,1,1.0,1,1.0,1,0.16184313255570545,40
548,3,1778,398,1380,0,0,0,1.0,1,1.0,1,1.0,1,0.26868233125613017,40
549,7,1785,400,1385,0,0,0,1.0,1,1.0,1,1.0,1,0.282740440141045,39
550,1,1786,400,1386,0,0,0,1.0,1,1.0,1,1.0,1,0.23698127813277717,38
551,2,1788,402,1386,0,0,0,1.0,1,1.0,1,1.0,1,0.25603624592142493,38
552,3,1791,403,1388,0,0,0,1.0,1,1.0,1,1.0,1,0.2246241007871471,39
553,2,1793,403,1390,0,0,0,1.0,1,1.0,1,1.0,1,0.22320935123829094,38
554,4,1797,404,1393,0,0,0,1.0,1,1.0,1,1.0,1,0.22043301932205592,39
555,1,1798,404,1394,0,0,0,1.0,1,1.0,1,1.0,1,0.19652404584706318,39
556,3,1801,404,1397,0,0,0,1.0,1,1.0,1,1.0,1,0.1424693379903589,40
557,0,1801,404,1397,0,0,0,1.0,1,1.0,1,1.0,1,0.13805536220846815,40
558,0,1801,404,1397,0,0,0,1.0,1,1.0,1,1.0,1,0.13805536220846815,40
559,2,1803,405,1398,0,0,0,1.0,1,1.0,1,1.0,1,0.14084011081165923,40
560,0,1803,405,1398,0,0,0,1.0,1,1.0,1,1.0,1,0.12647689069422874,41
561,3,1806,406,1400,0,0,0,1.0,1,1.0,1,1.0,1,0.15953853415251093,42
562,2,1808,407,1401,0,0,0,1.0,1,1.0,1,1.0,1,0.20626763477438786,42
563,3,1811,408,1403,0,0,0,1.0,1,1.0,1,1.0,1,0.23254084281045306,42
564,5,1816,408,1408,0,0,0,1.0,1,1.0,1,1.0,1,0.26234397773185014,43
565,5,1821,409,1412,0,0,0,1.0,1,1.0,1,1.0,1,0.2585017000330561,44
566,5,1826,409,1417,0,0,0,1.0,1,1.0,1,1.0,1,0.27111252757803617,45
567,10,1836,409,1427,0,0,0,1.0,1,1.0,1,1.0,1,0.23529077540286944,45
568,5,1841,409,1432,0,0,0,1.0,1,1.0,1,1.0,1,0.1967234191486709,46
569,7,1848,410,1438,0,0,0,1.0,1,1.0,1,1.0,1,0.19872005430174453,47
570,7,1855,411,1444,0,0,0,1.0,1,1.0,1,1.0,1,0.21504650469449035,48
571,4,1859,412,1447,0,0,0,1.0,1,1.0,1,1.0,1,0.18732339974425458,48
572,1,1860,412,1448,0,0,0,1.0,1,1.0,1,1.0,1,0.18302448543787586,47
573,5,1865,412,1453,0,0,0,1.0,1,1.0,1,1.0,1,0.13585836800568132,49
574,1,1866,412,1454,0,0,0,1.0,1,1.0,1,1.0,1,0.13642495241591665,49
575,5,1871,412,1459,0,0,0,1.0,1,1.0,1,1.0,1,0.1070115846319816,50
576,5,1876,412,1464,0,0,0,1.0,1,1.0,1,1.0,1,0.11018458385630693,51
577,2,1878,412,1466,0,0,0,1.0,1,1.0,1,1.0,1,0.11018458385630693,51
578,5,1883,413,1470,0,0,0,1.0,1,1.0,1,1.0,1,0.1353112781354928,51
579,4,1887,415,1472,0,0,0,1.0,1,1.0,1,1.0,1,0.16199097019748096,52
580,4,1891,415,1476,0,0,0,1.0,1,1.0,1,1.0,1,0.19152378753089458,52
581,6,1897,415,1482,0,0,0,1.0,1,1.0,1,1.0,1,0.15570243181308238,52
582,4,1901,416,1485,0,0,0,1.0,1,1.0,1,1.0,1,0.1595010565904471,53
583,2,1903,417,1486,0,0,0,1.0,1,1.0,1,1.0,1,0.12029308786487693,51
584,1,1904,418,1486,0,0,0,1.0,1,1.0,1,1.0,1,0.1597715185118882,51
585,4,1908,422,1486,0,0,0,1.0,1,1.0,1,1.0,1,0.15989994687774484,49
586,3,1911,423,1488,0,0,0,1.0,1,1.0,1,1.0,1,0.11751480217582982,49
587,4,1915,424,1491,0,0,0,1.0,1,1.0,1,1.0,1,0.06268422989591427,48
588,1,1916,425,1491,0,0,0,1.0,1,1.0,1,1.0,1,0.11923377854550254,46
589,3,1919,425,1494,0,0,0,1.0,1,1.0,1,1.0,1,0.08722899180689299,48
590,0,1919,425,1494,0,0,0,1.0,1,1.0,1,1.0,1,0.1045272733790342,47
591,3,1922,427,1495,0,0,0,1.0,1,1.0,1,1.0,1,0.13046009416793405,48
592,3,1925,428,1497,0,0,0,1.0,1,1.0,1,1.0,1,0.17041166566859722,47
593,3,1928,430,1498,0,0,0,1.0,1,1.0,1,1.0,1,0.19639299654529896,45
594,1,1929,430,1499,0,0,0,1.0,1,1.0,1,1.0,1,0.14212503752824987,44
595,2,1931,431,1500,0,0,0,1.0,1,1.0,1,1.0,1,0.12660474963662582,43
596,1,1932,432,1500,0,0,0,1.0,1,1.0,1,1.0,1,0.140009352426505,44
597,0,1932,432,1500,0,0,0,1.0,1,1.0,1,1.0,1,0.14239542914463946,43
598,2,1934,434,1500,0,0,0,1.0,1,1.0,1,1.0,1,0.17042081860408673,45
599,3,1937,437,1500,0,0,0,1.0,1,1.0,1,1.0,1,0.2068446539227827,44
600,4,1941,437,1504,0,0,0,1.0,1,1.0,1,1.0,1,0.1904391290955244,44
601,3,1944,438,1506,0,0,0,1.0,1,1.0,1,1.0,1,0.14055193853856468,45
602,2,1946,438,1508,0,0,0,1.0,1,1.0,1,1.0,1,0.1231279880535545,46
603,1,1947,438,1509,0,0,0,1.0,1,1.0,1,1.0,1,0.11168631003276282,46
604,2,1949,439,1510,0,0,0,1.0,1,1.0,1,1.0,1,0.10544817758065811,47
605,0,1949,439,1510,0,0,0,1.0,1,1.0,1,1.0,1,0.10544817758065811,47
606,0,1949,439,1510,0,0,0,1.0,1,1.0,1,1.0,1,0.1235978792696291,47
607,1,1950,439,1511,0,0,0,1.0,1,1.0,1,1.0,1,0.09559285717402537,48
608,0,1950,439,1511,0,0,0,1.0,1,1.0,1,1.0,1,0.10801746304307751,47
609,3,1953,440,1513,0,0,0,1.0,1,1.0,1,1.0,1,0.1040933734480581,48
610,2,1955,440,1515,0,0,0,1.0,1,1.0,1,1.0,1,0.09405496713505575,48
611,1,1956,441,1515,0,0,0,1.0,1,1.0,1,1.0,1,0.07524075438558375,49
612,2,1958,441,1517,0,0,0,1.0,1,1.0,1,1.0,1,0.086756892204426,50
613,1,1959,442,1517,0,0,0,1.0,1,1.0,1,1.0,1,0.06900918062393849,50
614,0,1959,442,1517,0,0,0,1.0,1,1.0,1,1.0,1,0.06900918062393849,50
615,1,1960,443,1517,0,0,0,1.0,1,1.0,1,1.0,1,0.08109822100805177,50
616,0,1960,443,1517,0,0,0,1.0,1,1.0,1,1.0,1,0.08109822100805177,50
617,2,1962,443,1519,0,0,0,1.0,1,1.0,1,1.0,1,0.06879855820849481,52
618,0,1962,443,1519,0,0,0,1.0,1,1.0,1,1.0,1,0.06879855820849481,52
619,0,1962,443,1519,0,0,0,1.0,1,1.0,1,1.0,1,0.08946161441769611,50
620,3,1965,445,1520,0,0,0,1.0,1,1.0,1,1.0,1,0.11228850671508128,50
621,1,1966,446,1520,0,0,0,1.0,1,1.0,1,1.0,1,0.12177823064011248,49
622,2,1968,446,1522,0,0,0,1.0,1,1.0,1,1.0,1,0.14893256107026645,49
623,3,1971,448,1523,0,0,0,1.0,1,1.0,1,1.0,1,0.19379984991622076,48
624,4,1975,449,1526,0,0,0,1.0,1,1.0,1,1.0,1,0.2386755694197184,46
625,2,1977,451,1526,0,0,0,1.0,1,1.0,1,1.0,1,0.24142548492243887,45
626,3,1980,453,1527,0,0,0,1.0,1,1.0,1,1.0,1,0.2716280617236622,44
627,6,1986,456,1530,0,0,0,1.0,1,1.0,1,1.0,1,0.3126627052184826,44
628,5,1991,459,1532,0,0,0,1.0,1,1.0,1,1.0,1,0.2958030698332613,44
629,0,1991,459,1532,0,0,0,1.0,1,1.0,1,1.0,1,0.28455455351638964,41
630,3,1994,461,1533,0,0,0,1.0,1,1.0,1,1.0,1,0.31533388608255003,40
631,7,2001,462,1539,0,0,0,1.0,1,1.0,1,1.0,1,0.20195200200124908,38
632,3,2004,463,1541,0,0,0,1.0,1,1.0,1,1.0,1,0.18240594587269676,38
633,1,2005,464,1541,0,0,0,1.0,1,1.0,1,1.0,1,0.2345447026942751,36
634,1,2006,464,1542,0,0,0,1.0,1,1.0,1,1.0,1,0.19940307823182074,35
635,2,2008,465,1543,0,0,0,1.0,1,1.0,1,1.0,1,0.1876708250379891,35
636,1,2009,466,1543,0,0,0,1.0,1,1.0,1,1.0,1,0.23538755437463849,36
637,2,2011,466,1545,0,0,0,1.0,1,1.0,1,1.0,1,0.2168300865661198,35
638,0,2011,466,1545,0,0,0,1.0,1,1.0,1,1.0,1,0.25548642278934,34
639,2,2013,467,1546,0,0,0,1.0,1,1.0,1,1.0,1,0.23446872475521438,36
640,2,2015,467,1548,0,0,0,1.0,1,1.0,1,1.0,1,0.26775087867458247,37
641,4,2019,467,1552,0,0,0,1.0,1,1.0,1,1.0,1,0.2736497298986301,37
642,5,2024,467,1557,0,0,0,1.0,1,1.0,1,1.0,1,0.2736753010946264,38
643,5,2029,467,1562,0,0,0,1.0,1,1.0,1,1.0,1,0.184058335483554,39
644,2,2031,467,1564,0,0,0,1.0,1,1.0,1,1.0,1,0.19588172629946776,39
645,3,2034,467,1567,0,0,0,1.0,1,1.0,1,1.0,1,0.17233522240692578,39
646,5,2039,469,1570,0,0,0,1.0,1,1.0,1,1.0,1,0.17103608266263295,40
647,4,2043,469,1574,0,0,0,1.0,1,1.0,1,1.0,1,0.1546997678194642,40
648,3,2046,470,1576,0,0,0,1.0,1,1.0,1,1.0,1,0.18733327205760555,40
649,4,2050,470,1580,0,0,0,1.0,1,1.0,1,1.0,1,0.18466971690747253,40
650,4,2054,471,1583,0,0,0,1.0,1,1.0,1,1.0,1,0.22487968964137917,41
651,5,2059,472,1587,0,0,0,1.0,1,1.0,1,1.0,1,0.19463151202179585,42
652,5,2064,472,1592,0,0,0,1.0,1,1.0,1,1.0,1,0.23260430386633807,41
653,2,2066,472,1594,0,0,0,1.0,1,1.0,1,1.0,1,0.24022152311550476,41
654,5,2071,472,1599,0,0,0,1.0,1,1.0,1,1.0,1,0.26087666364138107,42
655,3,2074,472,1602,0,0,0,1.0,1,1.0,1,1.0,1,0.2204786304876113,45
656,9,2083,475,1608,0,0,0,1.0,1,1.0,1,1.0,1,0.28093978814010084,45
657,5,2088,475,1613,0,0,0,1.0,1,1.0,1,1.0,1,0.24442317737245192,43
658,6,2094,477,1617,0,0,0,1.0,1,1.0,1,1.0,1,0.3020460956099526,43
659,14,2108,478,1630,0,0,0,1.0,1,1.0,1,1.0,1,0.30468458924691755,43
660,12,2120,480,1640,0,0,0,1.0,1,1.0,1,1.0,1,0.2906277880923608,43
661,6,2126,480,1646,0,0,0,1.0,1,1.0,1,1.0,1,0.16446874397794303,41
662,0,2126,480,1646,0,0,0,1.0,1,1.0,1,1.0,1,0.18891339880955718,40
663,0,2126,480,1646,0,0,0,1.0,1,1.0,1,1.0,1,0.17341205194392303,39
664,2,2128,480,1648,0,0,0,1.0,1,1.0,1,1.0,1,0.21201459463185834,36
665,0,2128,480,1648,0,0,0,1.0,1,1.0,1,1.0,1,0.1650032742479509,36
666,5,2133,481,1652,0,0,0,1.0,1,1.0,1,1.0,1,0.13292792137947276,36
667,3,2136,483,1653,0,0,0,1.0,1,1.0,1,1.0,1,0.1242794087424849,35
668,3,2139,485,1654,0,0,0,1.0,1,1.0,1,1.0,1,0.1837931128336887,34
669,5,2144,488,1656,0,0,0,1.0,1,1.0,1,1.0,1,0.14312334744048044,34
670,2,2146,489,1657,0,0,0,1.0,1,1.0,1,1.0,1,0.2414038184780578,32
671,2,2148,489,1659,0,0,0,1.0,1,1.0,1,1.0,1,0.2271725128135258,33
672,2,2150,489,1661,0,0,0,1.0,1,1.0,1,1.0,1,0.26900125505775435,32
673,1,2151,490,1661,0,0,0,1.0,1,1.0,1,1.0,1,0.2636510104142219,32
674,1,2152,490,1662,0,0,0,1.0,1,1.0,1,1.0,1,0.3147220869713684,32
675,2,2154,490,1664,0,0,0,1.0,1,1.0,1,1.0,1,0.278294617667459,34
676,9,2163,490,1673,0,0,0,1.0,1,1.0,1,1.0,1,0.1338824889483945,35
677,3,2166,490,1676,0,0,0,1.0,1,1.0,1,1.0,1,0.1281002370706117,35
678,4,2170,490,1680,0,0,0,1.0,1,1.0,1,1.0,1,0.12611683503170065,35
679,8,2178,491,1687,0,0,0,1.0,1,1.0,1,1.0,1,0.14197459147845595,36
680,3,2181,491,1690,0,0,0,1.0,1,1.0,1,1.0,1,0.18363492001361997,37
681,6,2187,491,1696,0,0,0,1.0,1,1.0,1,1.0,1,0.18363492001361997,37
682,5,2192,491,1701,0,0,0,1.0,1,1.0,1,1.0,1,0.15753774243619667,37
683,6,2198,492,1706,0,0,0,1.0,1,1.0,1,1.0,1,0.15036989109164411,38
684,8,2206,493,1713,0,0,0,1.0,1,1.0,1,1.0,1,0.16341561011516897,39
685,4,2210,493,1717,0,0,0,1.0,1,1.0,1,1.0,1,0.2019759032744429,38
686,9,2219,494,1725,0,0,0,1.0,1,1.0,1,1.0,1,0.2422643670669199,37
687,5,2224,495,1729,0,0,0,1.0,1,1.0,1,1.0,1,0.2945335845917708,38
688,8,2232,495,1737,0,0,0,1.0,1,1.0,1,1.0,1,0.335332054441602,37
689,8,2240,496,1744,0,0,0,1.0,1,1.0,1,1.0,1,0.31560973462971753,39
690,5,2245,496,1749,0,0,0,1.0,1,1.0,1,1.0,1,0.3150850545485091,38
691,6,2251,497,1754,0,0,0,1.0,1,1.0,1,1.0,1,0.1877116738993992,38
692,2,2253,498,1755,0,0,0,1.0,1,1.0,1,1.0,1,0.1795966988065341,38
693,2,2255,498,1757,0,0,0,1.0,1,1.0,1,1.0,1,0.16737825397378536,40
694,3,2258,499,1759,0,0,0,1.0,1,1.0,1,1.0,1,0.20141145996696447,42
695,5,2263,500,1763,0,0,0,1.0,1,1.0,1,1.0,1,0.143752972533481,40
696,5,2268,501,1767,0,0,0,1.0,1,1.0,1,1.0,1,0.2050034717063587,39
697,2,2270,501,1769,0,0,0,1.0,1,1.0,1,1.0,1,0.2037875762229304,39
698,4,2274,501,1773,0,0,0,1.0,1,1.0,1,1.0,1,0.23374358805588819,37
699,1,2275,501,1774,0,0,0,1.0,1,1.0,1,1.0,1,0.23773565303036223,37
700,1,2276,501,1775,0,0,0,1.0,1,1.0,1,1.0,1,0.20743683001842417,37
701,0,2276,501,1775,0,0,0,1.0,1,1.0,1,1.0,1,0.20743683001842417,37
702,2,2278,503,1775,0,0,0,1.0,1,1.0,1,1.0,1,0.2416390561195552,38
703,2,2280,504,1776,0,0,0,1.0,1,1.0,1,1.0,1,0.2504264307611592,36
704,8,2288,506,1782,0,0,0,1.0,1,1.0,1,1.0,1,0.18387355488810897,36
705,4,2292,507,1785,0,0,0,1.0,1,1.0,1,1.0,1,0.22139038791985893,36
706,10,2302,512,1790,0,0,0,1.0,1,1.0,1,1.0,1,0.12132296136684212,35
707,3,2305,513,1792,0,0,0,1.0,1,1.0,1,1.0,1,0.15992946702677727,36
708,4,2309,515,1794,0,0,0,1.0,1,1.0,1,1.0,1,0.22803901219899075,36
709,1,2310,515,1795,0,0,0,1.0,1,1.0,1,1.0,1,0.1781592837461693,34
710,1,2311,516,1795,0,0,0,1.0,1,1.0,1,1.0,1,0.1927693410936904,34
711,1,2312,516,1796,0,0,0,1.0,1,1.0,1,1.0,1,0.1570102633240677,34
712,0,2312,516,1796,0,0,0,1.0,1,1.0,1,1.0,1,0.1844376830323327,35
713,0,2312,516,1796,0,0,0,1.0,1,1.0,1,1.0,1,0.18265899209403996,34
714,2,2314,517,1797,0,0,0,1.0,1,1.0,1,1.0,1,0.16756528570688317,34
715,2,2316,518,1798,0,0,0,1.0,1,1.0,1,1.0,1,0.1740320386622305,35
716,0,2316,518,1798,0,0,0,1.0,1,1.0,1,1.0,1,0.19034343895507227,33
717,5,2321,521,1800,0,0,0,1.0,1,1.0,1,1.0,1,0.2632559151766081,33
718,2,2323,521,1802,0,0,0,1.0,1,1.0,1,1.0,1,0.275499893261844,32
719,2,2325,521,1804,0,0,0,1.0,1,1.0,1,1.0,1,0.275499893261844,32
720,3,2328,522,1806,0,0,0,1.0,1,1.0,1,1.0,1,0.27452556687587704,33
721,3,2331,522,1809,0,0,0,1.0,1,1.0,1,1.0,1,0.17851460554638734,33
722,4,2335,524,1811,0,0,0,1.0,1,1.0,1,1.0,1,0.2375876701737385,34
723,3,2338,524,1814,0,0,0,1.0,1,1.0,1,1.0,1,0.19259844151815217,34
724,2,2340,524,1816,0,0,0,1.0,1,1.0,1,1.0,1,0.17782860727517202,36
725,1,2341,524,1817,0,0,0,1.0,1,1.0,1,1.0,1,0.1598127864514791,36
726,0,2341,524,1817,0,0,0,1.0,1,1.0,1,1.0,1,0.1598127864514791,36
727,0,2341,524,1817,0,0,0,1.0,1,1.0,1,1.0,1,0.1598127864514791,36
728,0,2341,524,1817,0,0,0,1.0,1,1.0,1,1.0,1,0.17637878035440277,37
729,1,2342,524,1818,0,0,0,1.0,1,1.0,1,1.0,1,0.1805449818196025,37
730,0,2342,524,1818,0,0,0,1.0,1,1.0,1,1.0,1,0.17157589242832222,38
731,4,2346,525,1821,0,0,0,1.0,1,1.0,1,1.0,1,0.19888060712366912,39
732,2,2348,525,1823,0,0,0,1.0,1,1.0,1,1.0,1,0.15834771622986843,41
733,4,2352,527,1825,0,0,0,1.0,1,1.0,1,1.0,1,0.16206633394227304,39
734,1,2353,527,1826,0,0,0,1.0,1,1.0,1,1.0,1,0.11307777453944196,39
735,1,2354,527,1827,0,0,0,1.0,1,1.0,1,1.0,1,0.12605459934881696,39
736,2,2356,527,1829,0,0,0,1.0,1,1.0,1,1.0,1,0.0864575332982314,38
737,3,2359,529,1830,0,0,0,1.0,1,1.0,1,1.0,1,0.10353277008736875,39
738,1,2360,529,1831,0,0,0,1.0,1,1.0,1,1.0,1,0.12999726066421466,37
739,2,2362,530,1832,0,0,0,1.0,1,1.0,1,1.0,1,0.15716163071452324,37
740,0,2362,530,1832,0,0,0,1.0,1,1.0,1,1.0,1,0.17119277000517993,35
741,1,2363,530,1833,0,0,0,1.0,1,1.0,1,1.0,1,0.18570912393803718,33
742,3,2366,531,1835,0,0,0,1.0,1,1.0,1,1.0,1,0.2027050119653325,35
743,4,2370,534,1836,0,0,0,1.0,1,1.0,1,1.0,1,0.2633341705504181,35
744,5,2375,537,1838,0,0,0,1.0,1,1.0,1,1.0,1,0.2565509123065557,34
745,6,2381,540,1841,0,0,0,1.0,1,1.0,1,1.0,1,0.3155501814774299,34
746,7,2388,542,1846,0,0,0,1.0,1,1.0,1,1.0,1,0.33614408366321497,33
747,4,2392,542,1850,0,0,0,1.0,1,1.0,1,1.0,1,0.3185408067568887,32
748,3,2395,542,1853,0,0,0,1.0,1,1.0,1,1.0,1,0.30293099388652184,33
749,4,2399,542,1857,0,0,0,1.0,1,1.0,1,1.0,1,0.308878438601685,33
750,6,2405,542,1863,0,0,0,1.0,1,1.0,1,1.0,1,0.30840136190662926,34
751,10,2415,543,1872,0,0,0,1.0,1,1.0,1,1.0,1,0.10562418356281274,36
752,4,2419,544,1875,0,0,0,1.0,1,1.0,1,1.0,1,0.13807678279020388,35
753,3,2422,546,1876,0,0,0,1.0,1,1.0,1,1.0,1,0.1483437868460553,37
754,4,2426,547,1879,0,0,0,1.0,1,1.0,1,1.0,1,0.16558284346147917,37
755,3,2429,548,1881,0,0,0,1.0,1,1.0,1,1.0,1,0.2195173582916612,35
756,2,2431,549,1882,0,0,0,1.0,1,1.0,1,1.0,1,0.16948671859368605,36
757,0,2431,549,1882,0,0,0,1.0,1,1.0,1,1.0,1,0.18592834236959965,35
758,1,2432,549,1883,0,0,0,1.0,1,1.0,1,1.0,1,0.2050595041184272,36
759,4,2436,550,1886,0,0,0,1.0,1,1.0,1,1.0,1,0.21573066386280004,37
760,2,2438,550,1888,0,0,0,1.0,1,1.0,1,1.0,1,0.19193148083034106,36
761,0,2438,550,1888,0,0,0,1.0,1,1.0,1,1.0,1,0.19193148083034106,36
762,2,2440,550,1890,0,0,0,1.0,1,1.0,1,1.0,1,0.1941853056351116,37
763,1,2441,550,1891,0,0,0,1.0,1,1.0,1,1.0,1,0.1891395447071031,38
764,0,2441,550,1891,0,0,0,1.0,1,1.0,1,1.0,1,0.1891395447071031,38
765,1,2442,550,1892,0,0,0,1.0,1,1.0,1,1.0,1,0.19630906503586637,38
766,4,2446,550,1896,0,0,0,1.0,1,1.0,1,1.0,1,0.13043131046996628,40
767,2,2448,550,1898,0,0,0,1.0,1,1.0,1,1.0,1,0.14029750572735966,41
768,2,2450,551,1899,0,0,0,1.0,1,1.0,1,1.0,1,0.1416281923530516,41
769,3,2453,551,1902,0,0,0,1.0,1,1.0,1,1.0,1,0.12184124270822404,42
770,2,2455,551,1904,0,0,0,1.0,1,1.0,1,1.0,1,0.10852038287736926,41
771,5,2460,552,1908,0,0,0,1.0,1,1.0,1,1.0,1,0.1172289135019343,41
772,4,2464,553,1911,0,0,0,1.0,1,1.0,1,1.0,1,0.10410606295594134,41
773,8,2472,553,1919,0,0,0,1.0,1,1.0,1,1.0,1,0.13698491960272885,41
774,11,2483,554,1929,0,0,0,1.0,1,1.0,1,1.0,1,0.18135137332109152,42
775,6,2489,554,1935,0,0,0,1.0,1,1.0,1,1.0,1,0.1733988161321406,42
776,5,2494,554,1940,0,0,0,1.0,1,1.0,1,1.0,1,0.1852104098472504,42
777,4,2498,554,1944,0,0,0,1.0,1,1.0,1,1.0,1,0.15083336539279166,42
778,8,2506,555,1951,0,0,0,1.0,1,1.0,1,1.0,1,0.18261843041393686,44
779,5,2511,556,1955,0,0,0,1.0,1,1.0,1,1.0,1,0.18673064895666633,44
780,6,2517,557,1960,0,0,0,1.0,1,1.0,1,1.0,1,0.18366505941300795,44
781,3,2520,557,1963,0,0,0,1.0,1,1.0,1,1.0,1,0.15771557593060978,46
782,1,2521,558,1963,0,0,0,1.0,1,1.0,1,1.0,1,0.1612567159182272,45
783,3,2524,559,1965,0,0,0,1.0,1,1.0,1,1.0,1,0.15205974332294478,44
784,1,2525,560,1965,0,0,0,1.0,1,1.0,1,1.0,1,0.19641282502873283,44
785,2,2527,561,1966,0,0,0,1.0,1,1.0,1,1.0,1,0.15737240080108814,43
786,1,2528,562,1966,0,0,0,1.0,1,1.0,1,1.0,1,0.14532765498167585,43
787,0,2528,562,1966,0,0,0,1.0,1,1.0,1,1.0,1,0.14532765498167585,43
788,4,2532,563,1969,0,0,0,1.0,1,1.0,1,1.0,1,0.1885935641579262,45
789,1,2533,564,1969,0,0,0,1.0,1,1.0,1,1.0,1,0.1579467427119836,46
790,0,2533,564,1969,0,0,0,1.0,1,1.0,1,1.0,1,0.18726281230752612,45
791,1,2534,564,1970,0,0,0,1.0,1,1.0,1,1.0,1,0.18287276516080278,46
792,2,2536,564,1972,0,0,0,1.0,1,1.0,1,1.0,1,0.1710440551955683,46
793,2,2538,564,1974,0,0,0,1.0,1,1.0,1,1.0,1,0.16181312295293768,46
794,6,2544,565,1979,0,0,0,1.0,1,1.0,1,1.0,1,0.21737855060299835,47
795,5,2549,565,1984,0,0,0,1.0,1,1.0,1,1.0,1,0.16844753532783685,47
796,7,2556,566,1990,0,0,0,1.0,1,1.0,1,1.0,1,0.10575004740334498,46
797,2,2558,566,1992,0,0,0,1.0,1,1.0,1,1.0,1,0.1010111202388465,47
798,5,2563,569,1994,0,0,0,1.0,1,1.0,1,1.0,1,0.1352754917156995,48
799,1,2564,570,1994,0,0,0,1.0,1,1.0,1,1.0,1,0.11855784396033536,48
800,3,2567,571,1996,0,0,0,1.0,1,1.0,1,1.0,1,0.12409357531892137,48
801,1,2568,572,1996,0,0,0,1.0,1,1.0,1,1.0,1,0.1668404710211789,49
802,0,2568,572,1996,0,0,0,1.0,1,1.0,1,1.0,1,0.14876315191588263,50
803,0,2568,572,1996,0,0,0,1.0,1,1.0,1,1.0,1,0.1374926521816594,49
804,0,2568,572,1996,0,0,0,1.0,1,1.0,1,1.0,1,0.12295620325873546,50
805,0,2568,572,1996,0,0,0,1.0,1,1.0,1,1.0,1,0.12295620325873546,50
806,1,2569,573,1996,0,0,0,1.0,1,1.0,1,1.0,1,0.12739459789282853,50
807,5,2574,576,1998,0,0,0,1.0,1,1.0,1,1.0,1,0.16360001859590545,51
808,6,2580,577,2003,0,0,0,1.0,1,1.0,1,1.0,1,0.13688369292479255,51
809,3,2583,578,2005,0,0,0,1.0,1,1.0,1,1.0,1,0.1016497180366277,51
810,0,2583,578,2005,0,0,0,1.0,1,1.0,1,1.0,1,0.11431520175119504,52
811,0,2583,578,2005,0,0,0,1.0,1,1.0,1,1.0,1,0.0964317881625547,50
812,3,2586,579,2007,0,0,0,1.0,1,1.0,1,1.0,1,0.09330790976438205,48
813,2,2588,580,2008,0,0,0,1.0,1,1.0,1,1.0,1,0.0959130889580908,49
814,0,2588,580,2008,0,0,0,1.0,1,1.0,1,1.0,1,0.11684546424262905,48
815,4,2592,583,2009,0,0,0,1.0,1,1.0,1,1.0,1,0.14024330098330792,48
816,1,2593,584,2009,0,0,0,1.0,1,1.0,1,1.0,1,0.14751165143090883,46
817,0,2593,584,2009,0,0,0,1.0,1,1.0,1,1.0,1,0.18357611563394535,44
818,1,2594,584,2010,0,0,0,1.0,1,1.0,1,1.0,1,0.15267268654890284,46
819,0,2594,584,2010,0,0,0,1.0,1,1.0,1,1.0,1,0.18928579683233376,44
820,0,2594,584,2010,0,0,0,1.0,1,1.0,1,1.0,1,0.2052141404046162,44
821,1,2595,584,2011,0,0,0,1.0,1,1.0,1,1.0,1,0.17550646970704717,44
822,3,2598,586,2012,0,0,0,1.0,1,1.0,1,1.0,1,0.18602468208074216,44
823,1,2599,587,2012,0,0,0,1.0,1,1.0,1,1.0,1,0.17456000175440414,42
824,7,2606,594,2012,0,0,0,1.0,1,1.0,1,1.0,1,0.16635347194938535,42
825,2,2608,596,2012,0,0,0,1.0,1,1.0,1,1.0,1,0.19126694491732113,40
826,10,2618,602,2016,0,0,0,1.0,1,1.0,1,1.0,1,0.15302265141983468,41
827,2,2620,603,2017,0,0,0,1.0,1,1.0,1,1.0,1,0.14021602163949076,40
828,1,2621,604,2017,0,0,0,1.0,1,1.0,1,1.0,1,0.13646829557592277,40
829,3,2624,606,2018,0,0,0,1.0,1,1.0,1,1.0,1,0.16495153241677638,42
830,3,2627,609,2018,0,0,0,1.0,1,1.0,1,1.0,1,0.2228676563591174,42
831,5,2632,610,2022,0,0,0,1.0,1,1.0,1,1.0,1,0.190789759769229,43
832,3,2635,611,2024,0,0,0,1.0,1,1.0,1,1.0,1,0.20287964213030754,42
833,2,2637,611,2026,0,0,0,1.0,1,1.0,1,1.0,1,0.1773961547043282,41
834,1,2638,612,2026,0,0,0,1.0,1,1.0,1,1.0,1,0.2021702602636544,41
835,3,2641,612,2029,0,0,0,1.0,1,1.0,1,1.0,1,0.14328632737563476,41
836,0,2641,612,2029,0,0,0,1.0,1,1.0,1,1.0,1,0.15347258856814752,40
837,0,2641,612,2029,0,0,0,1.0,1,1.0,1,1.0,1,0.14576072556539768,41
838,0,2641,612,2029,0,0,0,1.0,1,1.0,1,1.0,1,0.14576072556539768,41
839,2,2643,614,2029,0,0,0,1.0,1,1.0,1,1.0,1,0.18466235802813472,41
840,2,2645,615,2030,0,0,0,1.0,1,1.0,1,1.0,1,0.22903865714847485,42
841,8,2653,615,2038,0,0,0,1.0,1,1.0,1,1.0,1,0.1376794452421509,42
842,7,2660,617,2043,0,0,0,1.0,1,1.0,1,1.0,1,0.16330884293870607,42
843,8,2668,620,2048,0,0,0,1.0,1,1.0,1,1.0,1,0.18045138620945578,42
844,8,2676,620,2056,0,0,0,1.0,1,1.0,1,1.0,1,0.1936011219155622,42
845,9,2685,621,2064,0,0,0,1.0,1,1.0,1,1.0,1,0.21643951945041834,44
846,10,2695,622,2073,0,0,0,1.0,1,1.0,1,1.0,1,0.2511177727741519,44
847,12,2707,622,2085,0,0,0,1.0,1,1.0,1,1.0,1,0.3186159083924047,42
848,13,2720,622,2098,0,0,0,1.0,1,1.0,1,1.0,1,0.31229846668961486,43
849,11,2731,622,2109,0,0,0,1.0,1,1.0,1,1.0,1,0.3003188050260377,43
850,10,2741,623,2118,0,0,0,1.0,1,1.0,1,1.0,1,0.2955680341169176,41
851,8,2749,624,2125,0,0,0,1.0,1,1.0,1,1.0,1,0.3356685999123728,40
852,12,2761,625,2136,0,0,0,1.0,1,1.0,1,1.0,1,0.33974892840106,40
853,12,2773,626,2147,0,0,0,1.0,1,1.0,1,1.0,1,0.31712540410272366,40
854,8,2781,626,2155,0,0,0,1.0,1,1.0,1,1.0,1,0.3303184788283831,40
855,8,2789,627,2162,0,0,0,1.0,1,1.0,1,1.0,1,0.30383038503764376,41
856,9,2798,628,2170,0,0,0,1.0,1,1.0,1,1.0,1,0.15260644840237422,41
857,1,2799,628,2171,0,0,0,1.0,1,1.0,1,1.0,1,0.17258827980616984,42
858,1,2800,628,2172,0,0,0,1.0,1,1.0,1,1.0,1,0.16284038959190136,43
859,1,2801,628,2173,0,0,0,1.0,1,1.0,1,1.0,1,0.17246180236472422,43
860,0,2801,628,2173,0,0,0,1.0,1,1.0,1,1.0,1,0.17393978333170612,44
861,3,2804,629,2175,0,0,0,1.0,1,1.0,1,1.0,1,0.1581785029148447,44
862,2,2806,629,2177,0,0,0,1.0,1,1.0,1,1.0,1,0.19946061651339825,44
863,6,2812,631,2181,0,0,0,1.0,1,1.0,1,1.0,1,0.1565303721533845,44
864,9,2821,633,2188,0,0,0,1.0,1,1.0,1,1.0,1,0.11154804400574025,44
865,7,2828,633,2195,0,0,0,1.0,1,1.0,1,1.0,1,0.13247886158951994,43
866,13,2841,636,2205,0,0,0,1.0,1,1.0,1,1.0,1,0.14271020800285547,45
867,6,2847,636,2211,0,0,0,1.0,1,1.0,1,1.0,1,0.19953320133808033,44
868,6,2853,638,2215,0,0,0,1.0,1,1.0,1,1.0,1,0.1368654768597865,45
869,5,2858,639,2219,0,0,0,1.0,1,1.0,1,1.0,1,0.21225877356922507,44
870,4,2862,640,2222,0,0,0,1.0,1,1.0,1,1.0,1,0.2072087790695365,44
871,8,2870,640,2230,0,0,0,1.0,1,1.0,1,1.0,1,0.09198879668507845,43
872,3,2873,640,2233,0,0,0,1.0,1,1.0,1,1.0,1,0.09050829749703199,43
873,4,2877,640,2237,0,0,0,1.0,1,1.0,1,1.0,1,0.10490083530660321,43
874,8,2885,642,2243,0,0,0,1.0,1,1.0,1,1.0,1,0.13201741340433748,46
875,3,2888,642,2246,0,0,0,1.0,1,1.0,1,1.0,1,0.13175223848677847,43
876,1,2889,643,2246,0,0,0,1.0,1,1.0,1,1.0,1,0.14195018036872797,44
877,0,2889,643,2246,0,0,0,1.0,1,1.0,1,1.0,1,0.18052591213133162,44
878,0,2889,643,2246,0,0,0,1.0,1,1.0,1,1.0,1,0.18052591213133162,44
879,1,2890,644,2246,0,0,0,1.0,1,1.0,1,1.0,1,0.1819323092164216,44
880,3,2893,646,2247,0,0,0,1.0,1,1.0,1,1.0,1,0.18951796553209443,44
881,0,2893,646,2247,0,0,0,1.0,1,1.0,1,1.0,1,0.19381798128575267,43
882,3,2896,648,2248,0,0,0,1.0,1,1.0,1,1.0,1,0.22438909329617607,45
883,5,2901,648,2253,0,0,0,1.0,1,1.0,1,1.0,1,0.19071485022630744,45
884,3,2904,648,2256,0,0,0,1.0,1,1.0,1,1.0,1,0.20227205425548775,45
885,3,2907,648,2259,0,0,0,1.0,1,1.0,1,1.0,1,0.18623608946276696,43
886,8,2915,650,2265,0,0,0,1.0,1,1.0,1,1.0,1,0.14596506468637074,43
887,1,2916,650,2266,0,0,0,1.0,1,1.0,1,1.0,1,0.11300722338760709,41
888,0,2916,650,2266,0,0,0,1.0,1,1.0,1,1.0,1,0.09254961738269017,40
889,0,2916,650,2266,0,0,0,1.0,1,1.0,1,1.0,1,0.09254961738269017,40
890,1,2917,651,2266,0,0,0,1.0,1,1.0,1,1.0,1,0.11888581533266797,38
891,5,2922,654,2268,0,0,0,1.0,1,1.0,1,1.0,1,0.18731718811365958,39
892,5,2927,657,2270,0,0,0,1.0,1,1.0,1,1.0,1,0.28162598715125275,39
893,5,2932,658,2274,0,0,0,1.0,1,1.0,1,1.0,1,0.24521676578430057,37
894,1,2933,658,2275,0,0,0,1.0,1,1.0,1,1.0,1,0.24674091823098,36
895,1,2934,658,2276,0,0,0,1.0,1,1.0,1,1.0,1,0.2568547416017091,37
896,0,2934,658,2276,0,0,0,1.0,1,1.0,1,1.0,1,0.25708420547046673,36
897,1,2935,659,2276,0,0,0,1.0,1,1.0,1,1.0,1,0.23664131071206407,36
898,0,2935,659,2276,0,0,0,1.0,1,1.0,1,1.0,1,0.24830306014817985,35
899,1,2936,660,2276,0,0,0,1.0,1,1.0,1,1.0,1,0.2511352210849153,35
900,4,2940,660,2280,0,0,0,1.0,1,1.0,1,1.0,1,0.28451323367830467,36
901,5,2945,661,2284,0,0,0,1.0,1,1.0,1,1.0,1,0.26850030193969865,36
902,5,2950,663,2287,0,0,0,1.0,1,1.0,1,1.0,1,0.28809708586380306,36
903,1,2951,663,2288,0,0,0,1.0,1,1.0,1,1.0,1,0.2349821655393974,35
904,3,2954,666,2288,0,0,0,1.0,1,1.0,1,1.0,1,0.2675789236375635,37
905,2,2956,666,2290,0,0,0,1.0,1,1.0,1,1.0,1,0.2305332229226524,36
906,2,2958,667,2291,0,0,0,1.0,1,1.0,1,1.0,1,0.22556804581669335,37
907,4,2962,668,2294,0,0,0,1.0,1,1.0,1,1.0,1,0.18044464779918187,37
908,4,2966,671,2295,0,0,0,1.0,1,1.0,1,1.0,1,0.25802819023059764,36
909,2,2968,672,2296,0,0,0,1.0,1,1.0,1,1.0,1,0.22146331358790391,36
910,3,2971,673,2298,0,0,0,1.0,1,1.0,1,1.0,1,0.17188560990143884,37
911,7,2978,675,2303,0,0,0,1.0,1,1.0,1,1.0,1,0.2193814094740779,36
912,5,2983,677,2306,0,0,0,1.0,1,1.0,1,1.0,1,0.22735208810103136,34
913,11,2994,679,2315,0,0,0,1.0,1,1.0,1,1.0,1,0.26329119784146815,34
914,7,3001,679,2322,0,0,0,1.0,1,1.0,1,1.0,1,0.31530828310248604,33
915,3,3004,679,2325,0,0,0,1.0,1,1.0,1,1.0,1,0.30823077602806753,33
916,6,3010,679,2331,0,0,0,1.0,1,1.0,1,1.0,1,0.2508741763846673,34
917,2,3012,680,2332,0,0,0,1.0,1,1.0,1,1.0,1,0.20419368623022324,34
918,1,3013,681,2332,0,0,0,1.0,1,1.0,1,1.0,1,0.16831254452888253,36
919,1,3014,681,2333,0,0,0,1.0,1,1.0,1,1.0,1,0.16045926939220836,36
920,4,3018,682,2336,0,0,0,1.0,1,1.0,1,1.0,1,0.1877656127876772,37
921,6,3024,683,2341,0,0,0,1.0,1,1.0,1,1.0,1,0.2192817729237641,37
922,5,3029,684,2345,0,0,0,1.0,1,1.0,1,1.0,1,0.1820476047495716,38
923,3,3032,685,2347,0,0,0,1.0,1,1.0,1,1.0,1,0.18267000069670183,36
924,3,3035,685,2350,0,0,0,1.0,1,1.0,1,1.0,1,0.12792521432032417,35
925,2,3037,686,2351,0,0,0,1.0,1,1.0,1,1.0,1,0.13689901557211068,35
926,8,3045,687,2358,0,0,0,1.0,1,1.0,1,1.0,1,0.1573637730305912,34
927,4,3049,687,2362,0,0,0,1.0,1,1.0,1,1.0,1,0.1989644063567105,32
928,5,3054,687,2367,0,0,0,1.0,1,1.0,1,1.0,1,0.1600583377875235,32
929,8,3062,688,2374,0,0,0,1.0,1,1.0,1,1.0,1,0.17771496460622177,31
930,5,3067,689,2378,0,0,0,1.0,1,1.0,1,1.0,1,0.2606766593651299,30
931,4,3071,691,2380,0,0,0,1.0,1,1.0,1,1.0,1,0.20459330333104644,29
932,1,3072,691,2381,0,0,0,1.0,1,1.0,1,1.0,1,0.1831990925058589,29
933,0,3072,691,2381,0,0,0,1.0,1,1.0,1,1.0,1,0.1831990925058589,29
934,1,3073,691,2382,0,0,0,1.0,1,1.0,1,1.0,1,0.16841051736078846,29
935,3,3076,691,2385,0,0,0,1.0,1,1.0,1,1.0,1,0.16505641247001812,31
936,1,3077,692,2385,0,0,0,1.0,1,1.0,1,1.0,1,0.13469281265605615,31
937,1,3078,693,2385,0,0,0,1.0,1,1.0,1,1.0,1,0.2036371478579035,34
938,0,3078,693,2385,0,0,0,1.0,1,1.0,1,1.0,1,0.213830798344735,33
939,4,3082,693,2389,0,0,0,1.0,1,1.0,1,1.0,1,0.17627860733324108,36
940,4,3086,693,2393,0,0,0,1.0,1,1.0,1,1.0,1,0.22080566809237867,36
941,3,3089,694,2395,0,0,0,1.0,1,1.0,1,1.0,1,0.2571716495196658,36
942,5,3094,695,2399,0,0,0,1.0,1,1.0,1,1.0,1,0.26974985499841403,36
943,5,3099,696,2403,0,0,0,1.0,1,1.0,1,1.0,1,0.22503773419244624,35
944,5,3104,697,2407,0,0,0,1.0,1,1.0,1,1.0,1,0.20760829022785457,35
945,4,3108,697,2411,0,0,0,1.0,1,1.0,1,1.0,1,0.18834159165453215,33
946,3,3111,699,2412,0,0,0,1.0,1,1.0,1,1.0,1,0.13845579027640778,36
947,1,3112,700,2412,0,0,0,1.0,1,1.0,1,1.0,1,0.15326765391597602,34
948,1,3113,701,2412,0,0,0,1.0,1,1.0,1,1.0,1,0.17374965859975838,33
949,2,3115,702,2413,0,0,0,1.0,1,1.0,1,1.0,1,0.22386942080468442,34
950,0,3115,702,2413,0,0,0,1.0,1,1.0,1,1.0,1,0.23145808926008035,33
951,0,3115,702,2413,0,0,0,1.0,1,1.0,1,1.0,1,0.23145808926008035,33
952,0,3115,702,2413,0,0,0,1.0,1,1.0,1,1.0,1,0.25142477596765417,32
953,0,3115,702,2413,0,0,0,1.0,1,1.0,1,1.0,1,0.25142477596765417,32
954,1,3116,703,2413,0,0,0,1.0,1,1.0,1,1.0,1,0.2763232748499791,31
955,4,3120,703,2417,0,0,0,1.0,1,1.0,1,1.0,1,0.29057921161541417,32
956,3,3123,704,2419,0,0,0,1.0,1,1.0,1,1.0,1,0.3324664861878907,32
957,8,3131,704,2427,0,0,0,1.0,1,1.0,1,1.0,1,0.32489588675108216,33
958,5,3136,704,2432,0,0,0,1.0,1,1.0,1,1.0,1,0.28983596160016095,35
959,4,3140,705,2435,0,0,0,1.0,1,1.0,1,1.0,1,0.3028856995747021,36
960,6,3146,705,2441,0,0,0,1.0,1,1.0,1,1.0,1,0.28684909439619344,38
961,6,3152,706,2446,0,0,0,1.0,1,1.0,1,1.0,1,0.26568257859899824,37
962,1,3153,706,2447,0,0,0,1.0,1,1.0,1,1.0,1,0.22316936807551965,35
963,1,3154,706,2448,0,0,0,1.0,1,1.0,1,1.0,1,0.17985820888653953,35
964,2,3156,706,2450,0,0,0,1.0,1,1.0,1,1.0,1,0.18100646696072067,34
965,5,3161,706,2455,0,0,0,1.0,1,1.0,1,1.0,1,0.15598902954575078,35
966,4,3165,706,2459,0,0,0,1.0,1,1.0,1,1.0,1,0.19755551902823765,34
967,3,3168,706,2462,0,0,0,1.0,1,1.0,1,1.0,1,0.2259797043684223,35
968,6,3174,706,2468,0,0,0,1.0,1,1.0,1,1.0,1,0.16990853811236895,36
969,1,3175,706,2469,0,0,0,1.0,1,1.0,1,1.0,1,0.1688324434788728,35
970,2,3177,706,2471,0,0,0,1.0,1,1.0,1,1.0,1,0.14604435076808006,34
971,3,3180,706,2474,0,0,0,1.0,1,1.0,1,1.0,1,0.15825920346997657,35
972,2,3182,706,2476,0,0,0,1.0,1,1.0,1,1.0,1,0.15825920346997657,35
973,1,3183,706,2477,0,0,0,1.0,1,1.0,1,1.0,1,0.1757021592947522,36
974,2,3185,706,2479,0,0,0,1.0,1,1.0,1,1.0,1,0.21232280643283216,35
975,2,3187,706,2481,0,0,0,1.0,1,1.0,1,1.0,1,0.18538218935353099,36
976,4,3191,706,2485,0,0,0,1.0,1,1.0,1,1.0,1,0.15391599675077308,38
977,1,3192,707,2485,0,0,0,1.0,1,1.0,1,1.0,1,0.1849517283933599,38
978,1,3193,707,2486,0,0,0,1.0,1,1.0,1,1.0,1,0.17900814812993984,38
979,0,3193,707,2486,0,0,0,1.0,1,1.0,1,1.0,1,0.18206155032075963,39
980,1,3194,708,2486,0,0,0,1.0,1,1.0,1,1.0,1,0.20161323444021592,39
981,3,3197,708,2489,0,0,0,1.0,1,1.0,1,1.0,1,0.20469959967721682,40
982,5,3202,711,2491,0,0,0,1.0,1,1.0,1,1.0,1,0.2477293328612738,40
983,1,3203,711,2492,0,0,0,1.0,1,1.0,1,1.0,1,0.22639165905845485,38
984,3,3206,712,2494,0,0,0,1.0,1,1.0,1,1.0,1,0.21047967888839603,39
985,6,3212,714,2498,0,0,0,1.0,1,1.0,1,1.0,1,0.23666319093812474,38
986,2,3214,715,2499,0,0,0,1.0,1,1.0,1,1.0,1,0.25156380429918396,38
987,3,3217,716,2501,0,0,0,1.0,1,1.0,1,1.0,1,0.2796285268769077,38
988,3,3220,717,2503,0,0,0,1.0,1,1.0,1,1.0,1,0.2986877433986515,38
989,4,3224,717,2507,0,0,0,1.0,1,1.0,1,1.0,1,0.2835408418604713,38
990,3,3227,718,2509,0,0,0,1.0,1,1.0,1,1.0,1,0.2799871364768985,38
991,8,3235,718,2517,0,0,0,1.0,1,1.0,1,1.0,1,0.18449227616404323,40
992,3,3238,718,2520,0,0,0,1.0,1,1.0,1,1.0,1,0.1332053410076931,39
993,4,3242,719,2523,0,0,0,1.0,1,1.0,1,1.0,1,0.19416076608152924,38
994,2,3244,719,2525,0,0,0,1.0,1,1.0,1,1.0,1,0.20290144941003496,39
995,5,3249,719,2530,0,0,0,1.0,1,1.0,1,1.0,1,0.1940086498442035,41
996,1,3250,719,2531,0,0,0,1.0,1,1.0,1,1.0,1,0.2127702557397,40
997,6,3256,719,2537,0,0,0,1.0,1,1.0,1,1.0,1,0.17140316866763053,41
998,2,3258,719,2539,0,0,0,1.0,1,1.0,1,1.0,1,0.17597320948573197,40
999,2,3260,719,2541,0,0,0,1.0,1,1.0,1,1.0,1,0.17580388362007343,40
1000,1,3261,719,2542,0,0,0,1.0,1,1.0,1,1.0,1,0.17930866443285634,40
1001,4,3265,719,2546,0,0,0,1.0,1,1.0,1,1.0,1,0.19916975142548293,39
1002,3,3268,719,2549,0,0,0,1.0,1,1.0,1,1.0,1,0.1912915606304163,39
1003,1,3269,719,2550,0,0,0,1.0,1,1.0,1,1.0,1,0.19916975142548293,39
1004,2,3271,719,2552,0,0,0,1.0,1,1.0,1,1.0,1,0.1872757869552089,39
1005,2,3273,719,2554,0,0,0,1.0,1,1.0,1,1.0,1,0.19756528398354647,40
1006,4,3277,719,2558,0,0,0,1.0,1,1.0,1,1.0,1,0.15783408548275746,41
1007,5,3282,719,2563,0,0,0,1.0,1,1.0,1,1.0,1,0.13597870078468777,42
1008,1,3283,719,2564,0,0,0,1.0,1,1.0,1,1.0,1,0.14442440348574934,43
1009,0,3283,719,2564,0,0,0,1.0,1,1.0,1,1.0,1,0.14462759663345984,44
1010,4,3287,720,2567,0,0,0,1.0,1,1.0,1,1.0,1,0.17432326651687863,44
1011,2,3289,720,2569,0,0,0,1.0,1,1.0,1,1.0,1,0.16694736384181375,44
1012,4,3293,722,2571,0,0,0,1.0,1,1.0,1,1.0,1,0.20443052516603377,46
1013,8,3301,722,2579,0,0,0,1.0,1,1.0,1,1.0,1,0.20051576214657782,46
1014,5,3306,723,2583,0,0,0,1.0,1,1.0,1,1.0,1,0.23356202918907787,46
1015,2,3308,723,2585,0,0,0,1.0,1,1.0,1,1.0,1,0.22443991680249742,46
1016,3,3311,724,2587,0,0,0,1.0,1,1.0,1,1.0,1,0.23357169907970365,47
1017,4,3315,724,2591,0,0,0,1.0,1,1.0,1,1.0,1,0.2184567066370715,47
1018,3,3318,724,2594,0,0,0,1.0,1,1.0,1,1.0,1,0.1549875662818403,48
1019,1,3319,724,2595,0,0,0,1.0,1,1.0,1,1.0,1,0.15879657992085786,49
1020,4,3323,724,2599,0,0,0,1.0,1,1.0,1,1.0,1,0.13005258479227624,51
1021,1,3324,724,2600,0,0,0,1.0,1,1.0,1,1.0,1,0.11978820513847836,51
1022,1,3325,725,2600,0,0,0,1.0,1,1.0,1,1.0,1,0.12286162888955832,52
1023,2,3327,725,2602,0,0,0,1.0,1,1.0,1,1.0,1,0.11875285878212836,52
1024,0,3327,725,2602,0,0,0,1.0,1,1.0,1,1.0,1,0.11875285878212836,52
1025,1,3328,725,2603,0,0,0,1.0,1,1.0,1,1.0,1,0.12885631186580748,54
1026,1,3329,725,2604,0,0,0,1.0,1,1.0,1,1.0,1,0.10366342955113306,54
1027,2,3331,726,2605,0,0,0,1.0,1,1.0,1,1.0,1,0.09051476148377882,55
1028,1,3332,726,2606,0,0,0,1.0,1,1.0,1,1.0,1,0.09957304767570992,56
1029,0,3332,726,2606,0,0,0,1.0,1,1.0,1,1.0,1,0.09957304767570992,56
1030,5,3337,727,2610,0,0,0,1.0,1,1.0,1,1.0,1,0.11693775412124448,57
1031,3,3340,727,2613,0,0,0,1.0,1,1.0,1,1.0,1,0.11491391674406948,58
1032,3,3343,727,2616,0,0,0,1.0,1,1.0,1,1.0,1,0.11919853241669005,58
1033,7,3350,728,2622,0,0,0,1.0,1,1.0,1,1.0,1,0.10612020452232214,57
1034,4,3354,730,2624,0,0,0,1.0,1,1.0,1,1.0,1,0.1586726781321658,57
1035,4,3358,731,2627,0,0,0,1.0,1,1.0,1,1.0,1,0.15815167647027395,57
1036,4,3362,732,2630,0,0,0,1.0,1,1.0,1,1.0,1,0.1172771282632643,59
1037,7,3369,735,2634,0,0,0,1.0,1,1.0,1,1.0,1,0.1277255254990582,57
1038,6,3375,738,2637,0,0,0,1.0,1,1.0,1,1.0,1,0.16099267992453603,59
1039,2,3377,740,2637,0,0,0,1.0,1,1.0,1,1.0,1,0.16806556713393483,57
1040,2,3379,741,2638,0,0,0,1.0,1,1.0,1,1.0,1,0.22536783362437626,56
1041,4,3383,742,2641,0,0,0,1.0,1,1.0,1,1.0,1,0.22960408719107453,54
1042,1,3384,743,2641,0,0,0,1.0,1,1.0,1,1.0,1,0.17554997004387227,52
1043,2,3386,744,2642,0,0,0,1.0,1,1.0,1,1.0,1,0.16235322455588505,52
1044,2,3388,745,2643,0,0,0,1.0,1,1.0,1,1.0,1,0.0987596209525281,50
1045,0,3388,745,2643,0,0,0,1.0,1,1.0,1,1.0,1,0.1104209364917957,51
1046,0,3388,745,2643,0,0,0,1.0,1,1.0,1,1.0,1,0.10463885428752394,50
1047,1,3389,745,2644,0,0,0,1.0,1,1.0,1,1.0,1,0.10186303189601627,50
1048,3,3392,746,2646,0,0,0,1.0,1,1.0,1,1.0,1,0.13059775968618226,50
1049,4,3396,749,2647,0,0,0,1.0,1,1.0,1,1.0,1,0.1327828139988253,50
1050,3,3399,750,2649,0,0,0,1.0,1,1.0,1,1.0,1,0.1353241746880054,50
1051,3,3402,751,2651,0,0,0,1.0,1,1.0,1,1.0,1,0.10789571177581715,50
1052,2,3404,751,2653,0,0,0,1.0,1,1.0,1,1.0,1,0.09566435192997236,51
1053,0,3404,751,2653,0,0,0,1.0,1,1.0,1,1.0,1,0.09566435192997236,51
1054,0,3404,751,2653,0,0,0,1.0,1,1.0,1,1.0,1,0.1045999233020971,53
1055,0,3404,751,2653,0,0,0,1.0,1,1.0,1,1.0,1,0.11315558604003062,54
1056,2,3406,751,2655,0,0,0,1.0,1,1.0,1,1.0,1,0.12084448362913519,54
1057,4,3410,753,2657,0,0,0,1.0,1,1.0,1,1.0,1,0.15036560540844832,55
1058,3,3413,753,2660,0,0,0,1.0,1,1.0,1,1.0,1,0.16915963490956273,54
1059,4,3417,755,2662,0,0,0,1.0,1,1.0,1,1.0,1,0.20947071896042285,53
1060,4,3421,756,2665,0,0,0,1.0,1,1.0,1,1.0,1,0.1940882422798296,53
1061,4,3425,758,2667,0,0,0,1.0,1,1.0,1,1.0,1,0.18312181291273846,53
1062,6,3431,762,2669,0,0,0,1.0,1,1.0,1,1.0,1,0.22603428385553273,54
1063,6,3437,762,2675,0,0,0,1.0,1,1.0,1,1.0,1,0.21611309576363646,53
1064,6,3443,764,2679,0,0,0,1.0,1,1.0,1,1.0,1,0.20753926085196167,55
1065,3,3446,764,2682,0,0,0,1.0,1,1.0,1,1.0,1,0.24808219061456036,54
1066,12,3458,765,2693,0,0,0,1.0,1,1.0,1,1.0,1,0.1710261012397035,55
1067,5,3463,766,2697,0,0,0,1.0,1,1.0,1,1.0,1,0.13945995806480946,55
1068,2,3465,766,2699,0,0,0,1.0,1,1.0,1,1.0,1,0.13361795523059977,55
1069,1,3466,767,2699,0,0,0,1.0,1,1.0,1,1.0,1,0.1461282535362077,55
1070,1,3467,767,2700,0,0,0,1.0,1,1.0,1,1.0,1,0.1600130190500372,54
1071,5,3472,768,2704,0,0,0,1.0,1,1.0,1,1.0,1,0.13584382076859614,55
1072,2,3474,769,2705,0,0,0,1.0,1,1.0,1,1.0,1,0.10860693524162411,54
1073,3,3477,771,2706,0,0,0,1.0,1,1.0,1,1.0,1,0.09430169106034253,54
1074,2,3479,773,2706,0,0,0,1.0,1,1.0,1,1.0,1,0.11195019826238913,52
1075,1,3480,774,2706,0,0,0,1.0,1,1.0,1,1.0,1,0.14826801988670246,51
1076,4,3484,776,2708,0,0,0,1.0,1,1.0,1,1.0,1,0.19012343379198562,52
1077,5,3489,779,2710,0,0,0,1.0,1,1.0,1,1.0,1,0.13635152763167852,49
1078,2,3491,780,2711,0,0,0,1.0,1,1.0,1,1.0,1,0.15883055848714026,48
1079,2,3493,782,2711,0,0,0,1.0,1,1.0,1,1.0,1,0.21224781017128205,47
1080,1,3494,783,2711,0,0,0,1.0,1,1.0,1,1.0,1,0.16277323675836067,47
1081,4,3498,784,2714,0,0,0,1.0,1,1.0,1,1.0,1,0.17857780983543067,45
1082,1,3499,785,2714,0,0,0,1.0,1,1.0,1,1.0,1,0.24228269798437696,42
1083,0,3499,785,2714,0,0,0,1.0,1,1.0,1,1.0,1,0.24228269798437696,42
1084,3,3502,785,2717,0,0,0,1.0,1,1.0,1,1.0,1,0.21254382005723205,40
1085,2,3504,785,2719,0,0,0,1.0,1,1.0,1,1.0,1,0.15298687668581573,43
1086,2,3506,785,2721,0,0,0,1.0,1,1.0,1,1.0,1,0.17669435361163402,41
1087,2,3508,785,2723,0,0,0,1.0,1,1.0,1,1.0,1,0.20479579266382605,41
1088,1,3509,785,2724,0,0,0,1.0,1,1.0,1,1.0,1,0.21164857374660445,41
1089,3,3512,787,2725,0,0,0,1.0,1,1.0,1,1.0,1,0.18638707693476508,42
1090,0,3512,787,2725,0,0,0,1.0,1,1.0,1,1.0,1,0.2000176847172718,43
1091,2,3514,788,2726,0,0,0,1.0,1,1.0,1,1.0,1,0.2499845041778037,43
1092,3,3517,789,2728,0,0,0,1.0,1,1.0,1,1.0,1,0.21148501259622907,43
1093,2,3519,791,2728,0,0,0,1.0,1,1.0,1,1.0,1,0.25718927322031,43
1094,5,3524,793,2731,0,0,0,1.0,1,1.0,1,1.0,1,0.27314340216764205,43
1095,7,3531,793,2738,0,0,0,1.0,1,1.0,1,1.0,1,0.2656260362142809,44
1096,5,3536,793,2743,0,0,0,1.0,1,1.0,1,1.0,1,0.16078667764636365,44
1097,5,3541,795,2746,0,0,0,1.0,1,1.0,1,1.0,1,0.18707166515044776,45
1098,0,3541,795,2746,0,0,0,1.0,1,1.0,1,1.0,1,0.18471771869910492,46
1099,2,3543,796,2747,0,0,0,1.0,1,1.0,1,1.0,1,0.18287423252847124,48
1100,2,3545,796,2749,0,0,0,1.0,1,1.0,1,1.0,1,0.16488782685656792,49
1101,1,3546,797,2749,0,0,0,1.0,1,1.0,1,1.0,1,0.168460552930717,49
1102,2,3548,799,2749,0,0,0,1.0,1,1.0,1,1.0,1,0.159843244806548,50
1103,4,3552,800,2752,0,0,0,1.0,1,1.0,1,1.0,1,0.10526130199735886,48
1104,5,3557,803,2754,0,0,0,1.0,1,1.0,1,1.0,1,0.12587553492688633,50
1105,5,3562,805,2757,0,0,0,1.0,1,1.0,1,1.0,1,0.12692791885160304,48
1106,2,3564,806,2758,0,0,0,1.0,1,1.0,1,1.0,1,0.12218173153429575,48
1107,1,3565,807,2758,0,0,0,1.0,1,1.0,1,1.0,1,0.10031375984520716,47
1108,3,3568,809,2759,0,0,0,1.0,1,1.0,1,1.0,1,0.08846035280932874,47
1109,3,3571,811,2760,0,0,0,1.0,1,1.0,1,1.0,1,0.1263364357253009,46
1110,3,3574,812,2762,0,0,0,1.0,1,1.0,1,1.0,1,0.1734102249203795,43
1111,7,3581,814,2767,0,0,0,1.0,1,1.0,1,1.0,1,0.11321503539739135,44
1112,4,3585,815,2770,0,0,0,1.0,1,1.0,1,1.0,1,0.10773517866450978,43
1113,1,3586,815,2771,0,0,0,1.0,1,1.0,1,1.0,1,0.15183967667031711,39
1114,0,3586,815,2771,0,0,0,1.0,1,1.0,1,1.0,1,0.15183967667031711,39
1115,1,3587,816,2771,0,0,0,1.0,1,1.0,1,1.0,1,0.174237963248082,37
1116,2,3589,818,2771,0,0,0,1.0,1,1.0,1,1.0,1,0.12487301744064729,37
1117,1,3590,819,2771,0,0,0,1.0,1,1.0,1,1.0,1,0.2179997134199643,36
1118,0,3590,819,2771,0,0,0,1.0,1,1.0,1,1.0,1,0.19983653184727893,36
1119,2,3592,819,2773,0,0,0,1.0,1,1.0,1,1.0,1,0.19983653184727893,36
1120,1,3593,819,2774,0,0,0,1.0,1,1.0,1,1.0,1,0.17534204701249392,36
1121,1,3594,820,2774,0,0,0,1.0,1,1.0,1,1.0,1,0.18810449843475405,36
1122,0,3594,820,2774,0,0,0,1.0,1,1.0,1,1.0,1,0.13976545127386833,37
1123,3,3597,822,2775,0,0,0,1.0,1,1.0,1,1.0,1,0.22886850592637256,37
1124,0,3597,822,2775,0,0,0,1.0,1,1.0,1,1.0,1,0.22886850592637256,37
1125,2,3599,823,2776,0,0,0,1.0,1,1.0,1,1.0,1,0.27764809861347645,38
1126,7,3606,824,2782,0,0,0,1.0,1,1.0,1,1.0,1,0.18782192098583986,38
1127,5,3611,824,2787,0,0,0,1.0,1,1.0,1,1.0,1,0.1278204376031301,39
1128,0,3611,824,2787,0,0,0,1.0,1,1.0,1,1.0,1,0.1278204376031301,39
1129,1,3612,824,2788,0,0,0,1.0,1,1.0,1,1.0,1,0.12868891013665015,39
1130,3,3615,825,2790,0,0,0,1.0,1,1.0,1,1.0,1,0.1610155526391026,39
1131,0,3615,825,2790,0,0,0,1.0,1,1.0,1,1.0,1,0.1610155526391026,39
1132,0,3615,825,2790,0,0,0,1.0,1,1.0,1,1.0,1,0.1610155526391026,39
1133,0,3615,825,2790,0,0,0,1.0,1,1.0,1,1.0,1,0.13810892281615822,42
1134,0,3615,825,2790,0,0,0,1.0,1,1.0,1,1.0,1,0.13810892281615822,42
1135,4,3619,826,2793,0,0,0,1.0,1,1.0,1,1.0,1,0.17276020760617472,44
1136,6,3625,827,2798,0,0,0,1.0,1,1.0,1,1.0,1,0.18627756766326906,46
1137,2,3627,827,2800,0,0,0,1.0,1,1.0,1,1.0,1,0.2106794518535136,45
1138,5,3632,828,2804,0,0,0,1.0,1,1.0,1,1.0,1,0.2160535406702889,46
1139,4,3636,829,2807,0,0,0,1.0,1,1.0,1,1.0,1,0.20803815372177956,47
1140,3,3639,830,2809,0,0,0,1.0,1,1.0,1,1.0,1,0.2285034869646278,46
1141,7,3646,830,2816,0,0,0,1.0,1,1.0,1,1.0,1,0.1874396256590391,45
1142,1,3647,830,2817,0,0,0,1.0,1,1.0,1,1.0,1,0.17193839730751945,45
1143,3,3650,832,2818,0,0,0,1.0,1,1.0,1,1.0,1,0.15474117873003593,43
1144,2,3652,833,2819,0,0,0,1.0,1,1.0,1,1.0,1,0.09581592357473911,45
1145,2,3654,834,2820,0,0,0,1.0,1,1.0,1,1.0,1,0.11763476829739639,44
1146,2,3656,834,2822,0,0,0,1.0,1,1.0,1,1.0,1,0.18177984997544488,45
1147,6,3662,837,2825,0,0,0,1.0,1,1.0,1,1.0,1,0.21965856657982322,44
1148,5,3667,840,2827,0,0,0,1.0,1,1.0,1,1.0,1,0.18814587969849825,43
1149,3,3670,840,2830,0,0,0,1.0,1,1.0,1,1.0,1,0.2379527603757358,42
1150,3,3673,842,2831,0,0,0,1.0,1,1.0,1,1.0,1,0.22718508698974818,45
1151,1,3674,843,2831,0,0,0,1.0,1,1.0,1,1.0,1,0.2915305532262849,40
1152,5,3679,845,2834,0,0,0,1.0,1,1.0,1,1.0,1,0.26471014307469876,41
1153,5,3684,849,2835,0,0,0,1.0,1,1.0,1,1.0,1,0.32037902253086814,38
1154,5,3689,852,2837,0,0,0,1.0,1,1.0,1,1.0,1,0.324375262144999,37
1155,3,3692,853,2839,0,0,0,1.0,1,1.0,1,1.0,1,0.32097980410349103,38
1156,13,3705,854,2851,0,0,0,1.0,1,1.0,1,1.0,1,0.16402184317248503,38
1157,1,3706,854,2852,0,0,0,1.0,1,1.0,1,1.0,1,0.17712454217204082,37
1158,3,3709,855,2854,0,0,0,1.0,1,1.0,1,1.0,1,0.14148420907557377,36
1159,0,3709,855,2854,0,0,0,1.0,1,1.0,1,1.0,1,0.17350022181839844,35
1160,0,3709,855,2854,0,0,0,1.0,1,1.0,1,1.0,1,0.17350022181839844,35
1161,0,3709,855,2854,0,0,0,1.0,1,1.0,1,1.0,1,0.18095690882234755,36
1162,1,3710,855,2855,0,0,0,1.0,1,1.0,1,1.0,1,0.1804642100760799,37
1163,2,3712,855,2857,0,0,0,1.0,1,1.0,1,1.0,1,0.1804642100760799,37
1164,2,3714,855,2859,0,0,0,1.0,1,1.0,1,1.0,1,0.15618117624829111,38
1165,7,3721,856,2865,0,0,0,1.0,1,1.0,1,1.0,1,0.18874222599777887,38
1166,7,3728,856,2872,0,0,0,1.0,1,1.0,1,1.0,1,0.20162673960261787,40
1167,10,3738,857,2881,0,0,0,1.0,1,1.0,1,1.0,1,0.23811774157395899,40
1168,8,3746,857,2889,0,0,0,1.0,1,1.0,1,1.0,1,0.19587029881611573,40
1169,10,3756,857,2899,0,0,0,1.0,1,1.0,1,1.0,1,0.2772498265829285,41
1170,6,3762,857,2905,0,0,0,1.0,1,1.0,1,1.0,1,0.26642783009254195,41
1171,8,3770,857,2913,0,0,0,1.0,1,1.0,1,1.0,1,0.13254496757633139,43
1172,1,3771,857,2914,0,0,0,1.0,1,1.0,1,1.0,1,0.15563130366015596,43
1173,0,3771,857,2914,0,0,0,1.0,1,1.0,1,1.0,1,0.15563130366015596,43
1174,0,3771,857,2914,0,0,0,1.0,1,1.0,1,1.0,1,0.15563130366015596,43
1175,2,3773,857,2916,0,0,0,1.0,1,1.0,1,1.0,1,0.15685823898264442,44
1176,1,3774,857,2917,0,0,0,1.0,1,1.0,1,1.0,1,0.17085396658157095,45
1177,2,3776,857,2919,0,0,0,1.0,1,1.0,1,1.0,1,0.17085396658157095,45
1178,2,3778,857,2921,0,0,0,1.0,1,1.0,1,1.0,1,0.15139035442419324,45
1179,2,3780,857,2923,0,0,0,1.0,1,1.0,1,1.0,1,0.16711768672118113,46
1180,2,3782,857,2925,0,0,0,1.0,1,1.0,1,1.0,1,0.19263164607651076,47
1181,5,3787,857,2930,0,0,0,1.0,1,1.0,1,1.0,1,0.17616949238721225,48
1182,4,3791,858,2933,0,0,0,1.0,1,1.0,1,1.0,1,0.18685792403547352,48
1183,2,3793,858,2935,0,0,0,1.0,1,1.0,1,1.0,1,0.18402166894976654,46
1184,4,3797,860,2937,0,0,0,1.0,1,1.0,1,1.0,1,0.16557771035015378,47
1185,7,3804,861,2943,0,0,0,1.0,1,1.0,1,1.0,1,0.15578202259566143,44
1186,2,3806,861,2945,0,0,0,1.0,1,1.0,1,1.0,1,0.13164618603492767,47
1187,5,3811,862,2949,0,0,0,1.0,1,1.0,1,1.0,1,0.13509958974340225,49
1188,0,3811,862,2949,0,0,0,1.0,1,1.0,1,1.0,1,0.13053462410955977,50
1189,0,3811,862,2949,0,0,0,1.0,1,1.0,1,1.0,1,0.12820933278924249,48
1190,4,3815,865,2950,0,0,0,1.0,1,1.0,1,1.0,1,0.15919161580535512,48
1191,1,3816,865,2951,0,0,0,1.0,1,1.0,1,1.0,1,0.1645553380584882,46
1192,3,3819,866,2953,0,0,0,1.0,1,1.0,1,1.0,1,0.18196052875640084,46
1193,4,3823,866,2957,0,0,0,1.0,1,1.0,1,1.0,1,0.19705843406885765,45
1194,1,3824,866,2958,0,0,0,1.0,1,1.0,1,1.0,1,0.19791062815706614,45
1195,3,3827,867,2960,0,0,0,1.0,1,1.0,1,1.0,1,0.19191180373799685,47
1196,4,3831,868,2963,0,0,0,1.0,1,1.0,1,1.0,1,0.17710790369512835,48
1197,5,3836,868,2968,0,0,0,1.0,1,1.0,1,1.0,1,0.16588295054018357,49
1198,5,3841,869,2972,0,0,0,1.0,1,1.0,1,1.0,1,0.1615155539629715,49
1199,9,3850,869,2981,0,0,0,1.0,1,1.0,1,1.0,1,0.17497897897075906,50
1200,4,3854,869,2985,0,0,0,1.0,1,1.0,1,1.0,1,0.17497897897075906,50
1201,5,3859,869,2990,0,0,0,1.0,1,1.0,1,1.0,1,0.12211946766687055,50
1202,1,3860,869,2991,0,0,0,1.0,1,1.0,1,1.0,1,0.11360462959207823,51
1203,0,3860,869,2991,0,0,0,1.0,1,1.0,1,1.0,1,0.12200714874682855,52
1204,0,3860,869,2991,0,0,0,1.0,1,1.0,1,1.0,1,0.12200714874682855,52
1205,2,3862,870,2992,0,0,0,1.0,1,1.0,1,1.0,1,0.11284734263916496,53
1206,1,3863,870,2993,0,0,0,1.0,1,1.0,1,1.0,1,0.11486521407028011,53
1207,2,3865,870,2995,0,0,0,1.0,1,1.0,1,1.0,1,0.11089701311659433,55
1208,1,3866,871,2995,0,0,0,1.0,1,1.0,1,1.0,1,0.12694512823489343,56
1209,0,3866,871,2995,0,0,0,1.0,1,1.0,1,1.0,1,0.1365899403992689,55
1210,1,3867,871,2996,0,0,0,1.0,1,1.0,1,1.0,1,0.11581192798971739,55
1211,0,3867,871,2996,0,0,0,1.0,1,1.0,1,1.0,1,0.10333189814162716,57
1212,0,3867,871,2996,0,0,0,1.0,1,1.0,1,1.0,1,0.10333189814162716,57
1213,0,3867,871,2996,0,0,0,1.0,1,1.0,1,1.0,1,0.10333189814162716,57
1214,11,3878,875,3003,0,0,0,1.0,1,1.0,1,1.0,1,0.1744265962496522,57
1215,8,3886,875,3011,0,0,0,1.0,1,1.0,1,1.0,1,0.18137532647786533,59
1216,8,3894,875,3019,0,0,0,1.0,1,1.0,1,1.0,1,0.1003309479491196,61
1217,1,3895,876,3019,0,0,0,1.0,1,1.0,1,1.0,1,0.11496844122373039,61
1218,0,3895,876,3019,0,0,0,1.0,1,1.0,1,1.0,1,0.14102349908293296,61
1219,2,3897,877,3020,0,0,0,1.0,1,1.0,1,1.0,1,0.13277506052793733,61
1220,0,3897,877,3020,0,0,0,1.0,1,1.0,1,1.0,1,0.14157416903038558,60
1221,1,3898,878,3020,0,0,0,1.0,1,1.0,1,1.0,1,0.15396524776815237,61
1222,4,3902,879,3023,0,0,0,1.0,1,1.0,1,1.0,1,0.13212959815767433,61
1223,2,3904,881,3023,0,0,0,1.0,1,1.0,1,1.0,1,0.1316626908075012,59
1224,4,3908,885,3023,0,0,0,1.0,1,1.0,1,1.0,1,0.13136589504738744,60
1225,5,3913,888,3025,0,0,0,1.0,1,1.0,1,1.0,1,0.15932399770235728,60
1226,2,3915,889,3026,0,0,0,1.0,1,1.0,1,1.0,1,0.17579697733010025,61
1227,2,3917,890,3027,0,0,0,1.0,1,1.0,1,1.0,1,0.17726472482004446,59
1228,2,3919,891,3028,0,0,0,1.0,1,1.0,1,1.0,1,0.18268586238491777,58
1229,2,3921,892,3029,0,0,0,1.0,1,1.0,1,1.0,1,0.17609803694415535,57
1230,2,3923,894,3029,0,0,0,1.0,1,1.0,1,1.0,1,0.16962840641788166,55
1231,10,3933,897,3036,0,0,0,1.0,1,1.0,1,1.0,1,0.06804051533713176,54
1232,4,3937,900,3037,0,0,0,1.0,1,1.0,1,1.0,1,0.07971354331815154,51
1233,2,3939,902,3037,0,0,0,1.0,1,1.0,1,1.0,1,0.11445315964264545,49
1234,2,3941,904,3037,0,0,0,1.0,1,1.0,1,1.0,1,0.15959703381067183,49
1235,1,3942,904,3038,0,0,0,1.0,1,1.0,1,1.0,1,0.19458325852560276,48
1236,1,3943,904,3039,0,0,0,1.0,1,1.0,1,1.0,1,0.19897861680128082,49
1237,4,3947,905,3042,0,0,0,1.0,1,1.0,1,1.0,1,0.18697833059272753,48
1238,1,3948,905,3043,0,0,0,1.0,1,1.0,1,1.0,1,0.181530157312832,47
1239,0,3948,905,3043,0,0,0,1.0,1,1.0,1,1.0,1,0.16308186829162163,48
1240,2,3950,905,3045,0,0,0,1.0,1,1.0,1,1.0,1,0.18319311778554495,49
1241,2,3952,906,3046,0,0,0,1.0,1,1.0,1,1.0,1,0.18261380609952646,49
1242,0,3952,906,3046,0,0,0,1.0,1,1.0,1,1.0,1,0.17924310134311508,49
1243,0,3952,906,3046,0,0,0,1.0,1,1.0,1,1.0,1,0.17370826143281493,50
1244,1,3953,907,3046,0,0,0,1.0,1,1.0,1,1.0,1,0.2035800558850979,50
1245,5,3958,907,3051,0,0,0,1.0,1,1.0,1,1.0,1,0.17338597174963288,51
1246,6,3964,907,3057,0,0,0,1.0,1,1.0,1,1.0,1,0.13160747786622118,52
1247,0,3964,907,3057,0,0,0,1.0,1,1.0,1,1.0,1,0.13160747786622118,52
1248,1,3965,908,3057,0,0,0,1.0,1,1.0,1,1.0,1,0.1479352578970541,51
1249,1,3966,909,3057,0,0,0,1.0,1,1.0,1,1.0,1,0.13408881454156515,51
1250,2,3968,911,3057,0,0,0,1.0,1,1.0,1,1.0,1,0.15900139908903313,51
1251,2,3970,912,3058,0,0,0,1.0,1,1.0,1,1.0,1,0.1730596243112086,53
1252,4,3974,915,3059,0,0,0,1.0,1,1.0,1,1.0,1,0.18441811590611326,52
1253,1,3975,915,3060,0,0,0,1.0,1,1.0,1,1.0,1,0.1828270477034992,52
1254,1,3976,915,3061,0,0,0,1.0,1,1.0,1,1.0,1,0.17306374939406363,53
1255,3,3979,916,3063,0,0,0,1.0,1,1.0,1,1.0,1,0.13980536621013243,55
1256,1,3980,916,3064,0,0,0,1.0,1,1.0,1,1.0,1,0.1313656374470169,55
1257,2,3982,916,3066,0,0,0,1.0,1,1.0,1,1.0,1,0.15105138805217483,57
1258,1,3983,916,3067,0,0,0,1.0,1,1.0,1,1.0,1,0.14007111653697343,57
1259,4,3987,916,3071,0,0,0,1.0,1,1.0,1,1.0,1,0.13415717039353858,57
1260,2,3989,916,3073,0,0,0,1.0,1,1.0,1,1.0,1,0.12204127603649428,56
1261,4,3993,916,3077,0,0,0,1.0,1,1.0,1,1.0,1,0.07767202824117345,57
1262,0,3993,916,3077,0,0,0,1.0,1,1.0,1,1.0,1,0.07830589078180927,58
1263,3,3996,918,3078,0,0,0,1.0,1,1.0,1,1.0,1,0.0938090850068083,58
1264,2,3998,918,3080,0,0,0,1.0,1,1.0,1,1.0,1,0.08613807331343004,57
1265,4,4002,920,3082,0,0,0,1.0,1,1.0,1,1.0,1,0.12261336920519353,56
1266,3,4005,923,3082,0,0,0,1.0,1,1.0,1,1.0,1,0.17607789452718908,55
1267,3,4008,925,3083,0,0,0,1.0,1,1.0,1,1.0,1,0.19868815022293432,53
1268,6,4014,931,3083,0,0,0,1.0,1,1.0,1,1.0,1,0.20062686533927537,52
1269,3,4017,933,3084,0,0,0,1.0,1,1.0,1,1.0,1,0.20202643747301943,51
1270,2,4019,933,3086,0,0,0,1.0,1,1.0,1,1.0,1,0.17704431395032869,47
1271,4,4023,936,3087,0,0,0,1.0,1,1.0,1,1.0,1,0.20283146284691844,46
1272,1,4024,937,3087,0,0,0,1.0,1,1.0,1,1.0,1,0.21762505711446292,43
1273,1,4025,937,3088,0,0,0,1.0,1,1.0,1,1.0,1,0.2204041642650096,44
1274,3,4028,938,3090,0,0,0,1.0,1,1.0,1,1.0,1,0.23312971535914676,44
1275,3,4031,939,3092,0,0,0,1.0,1,1.0,1,1.0,1,0.23861640736467324,45
1276,10,4041,940,3101,0,0,0,1.0,1,1.0,1,1.0,1,0.21193953388181994,43
1277,7,4048,942,3106,0,0,0,1.0,1,1.0,1,1.0,1,0.12224077768734673,44
1278,6,4054,942,3112,0,0,0,1.0,1,1.0,1,1.0,1,0.10696445501037942,45
1279,1,4055,942,3113,0,0,0,1.0,1,1.0,1,1.0,1,0.13275065590678392,47
1280,1,4056,942,3114,0,0,0,1.0,1,1.0,1,1.0,1,0.11891550182870035,47
1281,5,4061,943,3118,0,0,0,1.0,1,1.0,1,1.0,1,0.128593833906451,47
1282,3,4064,944,3120,0,0,0,1.0,1,1.0,1,1.0,1,0.14053637803414243,46
1283,3,4067,945,3122,0,0,0,1.0,1,1.0,1,1.0,1,0.13245832594655338,46
1284,4,4071,945,3126,0,0,0,1.0,1,1.0,1,1.0,1,0.13028518778024376,46
1285,3,4074,945,3129,0,0,0,1.0,1,1.0,1,1.0,1,0.16205024885264033,46
1286,4,4078,945,3133,0,0,0,1.0,1,1.0,1,1.0,1,0.1887814826147577,45
1287,7,4085,945,3140,0,0,0,1.0,1,1.0,1,1.0,1,0.22152696169663802,49
1288,9,4094,945,3149,0,0,0,1.0,1,1.0,1,1.0,1,0.2168915706154982,49
1289,4,4098,945,3153,0,0,0,1.0,1,1.0,1,1.0,1,0.20035879844519897,52
1290,8,4106,945,3161,0,0,0,1.0,1,1.0,1,1.0,1,0.18437238173060624,52
1291,5,4111,945,3166,0,0,0,1.0,1,1.0,1,1.0,1,0.1120996566140118,52
1292,2,4113,945,3168,0,0,0,1.0,1,1.0,1,1.0,1,0.12331590940140089,53
1293,2,4115,945,3170,0,0,0,1.0,1,1.0,1,1.0,1,0.10959829742769588,53
1294,2,4117,945,3172,0,0,0,1.0,1,1.0,1,1.0,1,0.09922386015709275,53
1295,1,4118,945,3173,0,0,0,1.0,1,1.0,1,1.0,1,0.10479242731008494,54
1296,2,4120,945,3175,0,0,0,1.0,1,1.0,1,1.0,1,0.08985730025696882,55
1297,0,4120,945,3175,0,0,0,1.0,1,1.0,1,1.0,1,0.10956788066452672,54
1298,1,4121,945,3176,0,0,0,1.0,1,1.0,1,1.0,1,0.1140259185651058,55
1299,1,4122,945,3177,0,0,0,1.0,1,1.0,1,1.0,1,0.11022838414850326,54
1300,1,4123,945,3178,0,0,0,1.0,1,1.0,1,1.0,1,0.11564624420531744,55
1301,2,4125,946,3179,0,0,0,1.0,1,1.0,1,1.0,1,0.12333836713220821,54
1302,3,4128,947,3181,0,0,0,1.0,1,1.0,1,1.0,1,0.12070080708005815,54
1303,2,4130,949,3181,0,0,0,1.0,1,1.0,1,1.0,1,0.1881005885058352,50
1304,5,4135,951,3184,0,0,0,1.0,1,1.0,1,1.0,1,0.1502088784026814,51
1305,3,4138,954,3184,0,0,0,1.0,1,1.0,1,1.0,1,0.19798470885745145,48
1306,10,4148,958,3190,0,0,0,1.0,1,1.0,1,1.0,1,0.20032784683295563,48
1307,4,4152,959,3193,0,0,0,1.0,1,1.0,1,1.0,1,0.14879314421123285,48
1308,2,4154,961,3193,0,0,0,1.0,1,1.0,1,1.0,1,0.17431588877880955,46
1309,2,4156,962,3194,0,0,0,1.0,1,1.0,1,1.0,1,0.17438335980939387,47
1310,0,4156,962,3194,0,0,0,1.0,1,1.0,1,1.0,1,0.15150683627517766,46
1311,2,4158,964,3194,0,0,0,1.0,1,1.0,1,1.0,1,0.18831398406151267,46
1312,3,4161,966,3195,0,0,0,1.0,1,1.0,1,1.0,1,0.1731331544364944,45
1313,0,4161,966,3195,0,0,0,1.0,1,1.0,1,1.0,1,0.19283312418503612,44
1314,1,4162,967,3195,0,0,0,1.0,1,1.0,1,1.0,1,0.18659358063511858,42
1315,1,4163,968,3195,0,0,0,1.0,1,1.0,1,1.0,1,0.20245325791540805,40
1316,1,4164,968,3196,0,0,0,1.0,1,1.0,1,1.0,1,0.17301615404027887,42
1317,2,4166,969,3197,0,0,0,1.0,1,1.0,1,1.0,1,0.23645707895606805,42
1318,3,4169,969,3200,0,0,0,1.0,1,1.0,1,1.0,1,0.20386266316028465,42
1319,3,4172,970,3202,0,0,0,1.0,1,1.0,1,1.0,1,0.24130668207623235,42
1320,3,4175,971,3204,0,0,0,1.0,1,1.0,1,1.0,1,0.21385112210018267,42
1321,5,4180,971,3209,0,0,0,1.0,1,1.0,1,1.0,1,0.10178169529898153,45
1322,3,4183,971,3212,0,0,0,1.0,1,1.0,1,1.0,1,0.11329671455380251,45
1323,4,4187,972,3215,0,0,0,1.0,1,1.0,1,1.0,1,0.12312899714975152,46
1324,1,4188,972,3216,0,0,0,1.0,1,1.0,1,1.0,1,0.13586936266638708,45
1325,1,4189,973,3216,0,0,0,1.0,1,1.0,1,1.0,1,0.15610203245206097,46
1326,3,4192,974,3218,0,0,0,1.0,1,1.0,1,1.0,1,0.1929885852103899,45
1327,2,4194,974,3220,0,0,0,1.0,1,1.0,1,1.0,1,0.22092992891651947,46
1328,3,4197,974,3223,0,0,0,1.0,1,1.0,1,1.0,1,0.20456838752469256,47
1329,2,4199,975,3224,0,0,0,1.0,1,1.0,1,1.0,1,0.15061727555119273,47
1330,2,4201,975,3226,0,0,0,1.0,1,1.0,1,1.0,1,0.13576566136715107,46
1331,2,4203,975,3228,0,0,0,1.0,1,1.0,1,1.0,1,0.17655879039591174,46
1332,5,4208,975,3233,0,0,0,1.0,1,1.0,1,1.0,1,0.1899187815874472,49
1333,7,4215,975,3240,0,0,0,1.0,1,1.0,1,1.0,1,0.19233009683184815,50
1334,8,4223,975,3248,0,0,0,1.0,1,1.0,1,1.0,1,0.1936050545406366,50
1335,3,4226,975,3251,0,0,0,1.0,1,1.0,1,1.0,1,0.1967930126689209,52
1336,4,4230,975,3255,0,0,0,1.0,1,1.0,1,1.0,1,0.123935392634432,53
1337,0,4230,975,3255,0,0,0,1.0,1,1.0,1,1.0,1,0.13745548998467033,54
1338,0,4230,975,3255,0,0,0,1.0,1,1.0,1,1.0,1,0.13745548998467033,54
1339,1,4231,976,3255,0,0,0,1.0,1,1.0,1,1.0,1,0.15948270668468098,54
1340,1,4232,976,3256,0,0,0,1.0,1,1.0,1,1.0,1,0.13204118335179482,53
1341,0,4232,976,3256,0,0,0,1.0,1,1.0,1,1.0,1,0.11705832567698726,53
1342,2,4234,978,3256,0,0,0,1.0,1,1.0,1,1.0,1,0.12909567512824655,52
1343,0,4234,978,3256,0,0,0,1.0,1,1.0,1,1.0,1,0.13001601437081906,50
1344,3,4237,981,3256,0,0,0,1.0,1,1.0,1,1.0,1,0.18820901258055392,51
1345,2,4239,981,3258,0,0,0,1.0,1,1.0,1,1.0,1,0.14083612871333887,50
1346,2,4241,981,3260,0,0,0,1.0,1,1.0,1,1.0,1,0.14102605574446808,50
1347,0,4241,981,3260,0,0,0,1.0,1,1.0,1,1.0,1,0.15801862885909648,48
1348,1,4242,981,3261,0,0,0,1.0,1,1.0,1,1.0,1,0.15492191956131432,49
1349,0,4242,981,3261,0,0,0,1.0,1,1.0,1,1.0,1,0.17371960160548275,48
1350,1,4243,982,3261,0,0,0,1.0,1,1.0,1,1.0,1,0.1638521563557224,49
1351,3,4246,982,3264,0,0,0,1.0,1,1.0,1,1.0,1,0.11442426252013328,48
1352,3,4249,984,3265,0,0,0,1.0,1,1.0,1,1.0,1,0.08774780254155284,49
1353,1,4250,984,3266,0,0,0,1.0,1,1.0,1,1.0,1,0.09425823273122719,49
1354,1,4251,985,3266,0,0,0,1.0,1,1.0,1,1.0,1,0.12235095819862084,49
1355,3,4254,986,3268,0,0,0,1.0,1,1.0,1,1.0,1,0.11571901238590315,50
1356,4,4258,987,3271,0,0,0,1.0,1,1.0,1,1.0,1,0.11602030288876776,50
1357,6,4264,989,3275,0,0,0,1.0,1,1.0,1,1.0,1,0.12323078893789138,50
1358,4,4268,990,3278,0,0,0,1.0,1,1.0,1,1.0,1,0.16013166316038815,51
1359,6,4274,991,3283,0,0,0,1.0,1,1.0,1,1.0,1,0.18866089628630459,53
1360,3,4277,991,3286,0,0,0,1.0,1,1.0,1,1.0,1,0.18081625319749386,54
1361,3,4280,991,3289,0,0,0,1.0,1,1.0,1,1.0,1,0.17923451380494118,54
1362,4,4284,992,3292,0,0,0,1.0,1,1.0,1,1.0,1,0.15469857072147977,55
1363,1,4285,992,3293,0,0,0,1.0,1,1.0,1,1.0,1,0.15888115365276126,55
1364,2,4287,992,3295,0,0,0,1.0,1,1.0,1,1.0,1,0.18149194024991744,55
1365,7,4294,994,3300,0,0,0,1.0,1,1.0,1,1.0,1,0.17576710008874913,56
1366,6,4300,994,3306,0,0,0,1.0,1,1.0,1,1.0,1,0.11729745738074458,56
1367,2,4302,994,3308,0,0,0,1.0,1,1.0,1,1.0,1,0.09888795506827876,56
1368,2,4304,994,3310,0,0,0,1.0,1,1.0,1,1.0,1,0.10782220909685357,58
1369,1,4305,994,3311,0,0,0,1.0,1,1.0,1,1.0,1,0.11417791862016842,59
1370,0,4305,994,3311,0,0,0,1.0,1,1.0,1,1.0,1,0.11417791862016842,59
1371,2,4307,994,3313,0,0,0,1.0,1,1.0,1,1.0,1,0.11271265443143914,59
1372,2,4309,995,3314,0,0,0,1.0,1,1.0,1,1.0,1,0.11085131841814316,59
1373,2,4311,995,3316,0,0,0,1.0,1,1.0,1,1.0,1,0.10131700514781922,59
1374,5,4316,998,3318,0,0,0,1.0,1,1.0,1,1.0,1,0.11557522417820866,60
1375,2,4318,998,3320,0,0,0,1.0,1,1.0,1,1.0,1,0.09970293474610073,61
1376,3,4321,998,3323,0,0,0,1.0,1,1.0,1,1.0,1,0.11034706697575535,61
1377,1,4322,998,3324,0,0,0,1.0,1,1.0,1,1.0,1,0.10267509970099342,61
1378,7,4329,1000,3329,0,0,0,1.0,1,1.0,1,1.0,1,0.14278064231264087,61
1379,5,4334,1001,3333,0,0,0,1.0,1,1.0,1,1.0,1,0.1811660741662289,60
1380,6,4340,1002,3338,0,0,0,1.0,1,1.0,1,1.0,1,0.19458976214582283,60
1381,11,4351,1004,3347,0,0,0,1.0,1,1.0,1,1.0,1,0.11159723809405707,58
1382,3,4354,1005,3349,0,0,0,1.0,1,1.0,1,1.0,1,0.15190555598219027,58
1383,1,4355,1005,3350,0,0,0,1.0,1,1.0,1,1.0,1,0.10844541460277103,57
1384,0,4355,1005,3350,0,0,0,1.0,1,1.0,1,1.0,1,0.13419969235474596,54
1385,0,4355,1005,3350,0,0,0,1.0,1,1.0,1,1.0,1,0.15456097033055435,52
1386,2,4357,1007,3350,0,0,0,1.0,1,1.0,1,1.0,1,0.19910788296017726,51
1387,1,4358,1008,3350,0,0,0,1.0,1,1.0,1,1.0,1,0.19784808621378785,51
1388,6,4364,1012,3352,0,0,0,1.0,1,1.0,1,1.0,1,0.17420241332537081,52
1389,0,4364,1012,3352,0,0,0,1.0,1,1.0,1,1.0,1,0.2233417988791828,50
1390,4,4368,1014,3354,0,0,0,1.0,1,1.0,1,1.0,1,0.18129667174497494,51
1391,2,4370,1014,3356,0,0,0,1.0,1,1.0,1,1.0,1,0.20283475004965226,50
1392,3,4373,1015,3358,0,0,0,1.0,1,1.0,1,1.0,1,0.1996969467687997,50
1393,1,4374,1015,3359,0,0,0,1.0,1,1.0,1,1.0,1,0.2144989835776023,49
1394,5,4379,1017,3362,0,0,0,1.0,1,1.0,1,1.0,1,0.2056185402025879,50
1395,1,4380,1017,3363,0,0,0,1.0,1,1.0,1,1.0,1,0.23286250862576843,51
1396,9,4389,1017,3372,0,0,0,1.0,1,1.0,1,1.0,1,0.16096762319198335,52
1397,3,4392,1017,3375,0,0,0,1.0,1,1.0,1,1.0,1,0.14949317224542719,52
1398,2,4394,1017,3377,0,0,0,1.0,1,1.0,1,1.0,1,0.13256164824847577,53
1399,8,4402,1020,3382,0,0,0,1.0,1,1.0,1,1.0,1,0.19162604039826153,54
1400,7,4409,1021,3388,0,0,0,1.0,1,1.0,1,1.0,1,0.15164945891446316,54
1401,6,4415,1023,3392,0,0,0,1.0,1,1.0,1,1.0,1,0.15078994868424783,54
1402,6,4421,1024,3397,0,0,0,1.0,1,1.0,1,1.0,1,0.14933931634591086,53
1403,4,4425,1025,3400,0,0,0,1.0,1,1.0,1,1.0,1,0.18289196801743168,52
1404,4,4429,1025,3404,0,0,0,1.0,1,1.0,1,1.0,1,0.19155202453554437,53
1405,3,4432,1026,3406,0,0,0,1.0,1,1.0,1,1.0,1,0.24713209962350374,52
1406,4,4436,1026,3410,0,0,0,1.0,1,1.0,1,1.0,1,0.20464090297152565,53
1407,3,4439,1027,3412,0,0,0,1.0,1,1.0,1,1.0,1,0.24491107207422388,54
1408,5,4444,1028,3416,0,0,0,1.0,1,1.0,1,1.0,1,0.2659077495826284,53
1409,7,4451,1028,3423,0,0,0,1.0,1,1.0,1,1.0,1,0.26000956827486055,55
1410,6,4457,1028,3429,0,0,0,1.0,1,1.0,1,1.0,1,0.2797274364586557,54
1411,10,4467,1028,3439,0,0,0,1.0,1,1.0,1,1.0,1,0.1974636252201267,54
1412,0,4467,1028,3439,0,0,0,1.0,1,1.0,1,1.0,1,0.18723016103804546,53
1413,0,4467,1028,3439,0,0,0,1.0,1,1.0,1,1.0,1,0.18102846182436685,54
1414,1,4468,1028,3440,0,0,0,1.0,1,1.0,1,1.0,1,0.18434433788998308,55
1415,5,4473,1029,3444,0,0,0,1.0,1,1.0,1,1.0,1,0.15161956594030085,57
1416,8,4481,1030,3451,0,0,0,1.0,1,1.0,1,1.0,1,0.16673028242366972,59
1417,6,4487,1031,3456,0,0,0,1.0,1,1.0,1,1.0,1,0.18560372926189572,58
1418,2,4489,1031,3458,0,0,0,1.0,1,1.0,1,1.0,1,0.1736871425698824,57
1419,5,4494,1033,3461,0,0,0,1.0,1,1.0,1,1.0,1,0.19969522909386303,56
1420,7,4501,1033,3468,0,0,0,1.0,1,1.0,1,1.0,1,0.23305921674477753,54
1421,9,4510,1034,3476,0,0,0,1.0,1,1.0,1,1.0,1,0.21183758739115296,55
1422,5,4515,1034,3481,0,0,0,1.0,1,1.0,1,1.0,1,0.16637072073637696,52
1423,8,4523,1036,3487,0,0,0,1.0,1,1.0,1,1.0,1,0.15659342741022622,52
1424,10,4533,1039,3494,0,0,0,1.0,1,1.0,1,1.0,1,0.10907296891126665,51
1425,4,4537,1039,3498,0,0,0,1.0,1,1.0,1,1.0,1,0.15597794771830187,50
1426,6,4543,1041,3502,0,0,0,1.0,1,1.0,1,1.0,1,0.11280101468647286,50
1427,1,4544,1041,3503,0,0,0,1.0,1,1.0,1,1.0,1,0.12271697584171286,48
1428,2,4546,1043,3503,0,0,0,1.0,1,1.0,1,1.0,1,0.17085792811393713,48
1429,4,4550,1043,3507,0,0,0,1.0,1,1.0,1,1.0,1,0.16824888360196644,48
1430,1,4551,1043,3508,0,0,0,1.0,1,1.0,1,1.0,1,0.16523948066864028,48
1431,0,4551,1043,3508,0,0,0,1.0,1,1.0,1,1.0,1,0.16523948066864028,48
1432,0,4551,1043,3508,0,0,0,1.0,1,1.0,1,1.0,1,0.13389685409975366,50
1433,1,4552,1044,3508,0,0,0,1.0,1,1.0,1,1.0,1,0.1103907153845462,51
1434,3,4555,1047,3508,0,0,0,1.0,1,1.0,1,1.0,1,0.14674405931781956,51
1435,3,4558,1049,3509,0,0,0,1.0,1,1.0,1,1.0,1,0.13564187670474906,50
1436,3,4561,1051,3510,0,0,0,1.0,1,1.0,1,1.0,1,0.149163637310633,51
1437,1,4562,1051,3511,0,0,0,1.0,1,1.0,1,1.0,1,0.1399981851725064,51
1438,2,4564,1053,3511,0,0,0,1.0,1,1.0,1,1.0,1,0.17564244106433577,51
1439,3,4567,1056,3511,0,0,0,1.0,1,1.0,1,1.0,1,0.23341681836418612,50
1440,6,4573,1058,3515,0,0,0,1.0,1,1.0,1,1.0,1,0.26899126928062206,51
1441,11,4584,1058,3526,0,0,0,1.0,1,1.0,1,1.0,1,0.13281028038293255,51
1442,7,4591,1060,3531,0,0,0,1.0,1,1.0,1,1.0,1,0.179447314640735,52
1443,9,4600,1060,3540,0,0,0,1.0,1,1.0,1,1.0,1,0.18751723760210906,53
1444,5,4605,1060,3545,0,0,0,1.0,1,1.0,1,1.0,1,0.19216930822621,54
1445,4,4609,1060,3549,0,0,0,1.0,1,1.0,1,1.0,1,0.1660709150094999,54
1446,8,4617,1060,3557,0,0,0,1.0,1,1.0,1,1.0,1,0.18404666774333145,54
1447,7,4624,1060,3564,0,0,0,1.0,1,1.0,1,1.0,1,0.18067621819760624,55
1448,5,4629,1060,3569,0,0,0,1.0,1,1.0,1,1.0,1,0.1775352913273865,55
1449,5,4634,1060,3574,0,0,0,1.0,1,1.0,1,1.0,1,0.1725260945355649,55
1450,9,4643,1060,3583,0,0,0,1.0,1,1.0,1,1.0,1,0.1507650132764127,57
1451,8,4651,1060,3591,0,0,0,1.0,1,1.0,1,1.0,1,0.14565421126893718,57
1452,4,4655,1060,3595,0,0,0,1.0,1,1.0,1,1.0,1,0.11297337283492201,57
1453,9,4664,1061,3603,0,0,0,1.0,1,1.0,1,1.0,1,0.1207631671255786,57
1454,10,4674,1063,3611,0,0,0,1.0,1,1.0,1,1.0,1,0.15746136562305674,58
1455,6,4680,1063,3617,0,0,0,1.0,1,1.0,1,1.0,1,0.095423846246721,56
1456,4,4684,1064,3620,0,0,0,1.0,1,1.0,1,1.0,1,0.08727262783508187,55
1457,0,4684,1064,3620,0,0,0,1.0,1,1.0,1,1.0,1,0.11143319706537311,54
1458,1,4685,1065,3620,0,0,0,1.0,1,1.0,1,1.0,1,0.12082938891235605,53
1459,1,4686,1065,3621,0,0,0,1.0,1,1.0,1,1.0,1,0.10296482318411142,52
1460,1,4687,1066,3621,0,0,0,1.0,1,1.0,1,1.0,1,0.133644464643499,51
1461,2,4689,1068,3621,0,0,0,1.0,1,1.0,1,1.0,1,0.1402047661645096,51
1462,3,4692,1071,3621,0,0,0,1.0,1,1.0,1,1.0,1,0.10151130229121431,51
1463,3,4695,1074,3621,0,0,0,1.0,1,1.0,1,1.0,1,0.15302746765011208,52
1464,2,4697,1076,3621,0,0,0,1.0,1,1.0,1,1.0,1,0.16622018242987963,52
1465,3,4700,1078,3622,0,0,0,1.0,1,1.0,1,1.0,1,0.1773512687341557,51
1466,5,4705,1082,3623,0,0,0,1.0,1,1.0,1,1.0,1,0.19299282748148844,50
1467,5,4710,1084,3626,0,0,0,1.0,1,1.0,1,1.0,1,0.191666069242282,48
1468,4,4714,1086,3628,0,0,0,1.0,1,1.0,1,1.0,1,0.14808246444621667,48
1469,1,4715,1087,3628,0,0,0,1.0,1,1.0,1,1.0,1,0.17146671814901496,48
1470,2,4717,1088,3629,0,0,0,1.0,1,1.0,1,1.0,1,0.1687556782927616,48
1471,8,4725,1090,3635,0,0,0,1.0,1,1.0,1,1.0,1,0.1113880167742337,45
1472,4,4729,1090,3639,0,0,0,1.0,1,1.0,1,1.0,1,0.0808798699986507,45
1473,3,4732,1092,3640,0,0,0,1.0,1,1.0,1,1.0,1,0.07895076598040145,46
1474,4,4736,1092,3644,0,0,0,1.0,1,1.0,1,1.0,1,0.06255751087223785,46
1475,0,4736,1092,3644,0,0,0,1.0,1,1.0,1,1.0,1,0.06255751087223785,46
1476,1,4737,1092,3645,0,0,0,1.0,1,1.0,1,1.0,1,0.08873661170073925,47
1477,0,4737,1092,3645,0,0,0,1.0,1,1.0,1,1.0,1,0.08873661170073925,47
1478,0,4737,1092,3645,0,0,0,1.0,1,1.0,1,1.0,1,0.1277459203109729,47
1479,0,4737,1092,3645,0,0,0,1.0,1,1.0,1,1.0,1,0.12412049802790752,48
1480,1,4738,1093,3645,0,0,0,1.0,1,1.0,1,1.0,1,0.13274970760329313,47
1481,1,4739,1094,3645,0,0,0,1.0,1,1.0,1,1.0,1,0.13358646079652234,47
1482,1,4740,1095,3645,0,0,0,1.0,1,1.0,1,1.0,1,0.17072257200852836,46
1483,6,4746,1096,3650,0,0,0,1.0,1,1.0,1,1.0,1,0.17206645026581396,47
1484,6,4752,1096,3656,0,0,0,1.0,1,1.0,1,1.0,1,0.14633284641434888,47
1485,2,4754,1096,3658,0,0,0,1.0,1,1.0,1,1.0,1,0.21323856306632274,47
1486,5,4759,1096,3663,0,0,0,1.0,1,1.0,1,1.0,1,0.13285707381554718,49
1487,5,4764,1100,3664,0,0,0,1.0,1,1.0,1,1.0,1,0.08647035645627929,49
1488,1,4765,1101,3664,0,0,0,1.0,1,1.0,1,1.0,1,0.10829868204307486,51
1489,2,4767,1102,3665,0,0,0,1.0,1,1.0,1,1.0,1,0.11589107731493879,52
1490,1,4768,1102,3666,0,0,0,1.0,1,1.0,1,1.0,1,0.11419469491117563,52
1491,4,4772,1104,3668,0,0,0,1.0,1,1.0,1,1.0,1,0.14428007203988466,53
1492,8,4780,1107,3673,0,0,0,1.0,1,1.0,1,1.0,1,0.08887349900394192,53
1493,4,4784,1109,3675,0,0,0,1.0,1,1.0,1,1.0,1,0.11449176092232131,52
1494,1,4785,1110,3675,0,0,0,1.0,1,1.0,1,1.0,1,0.1256670669532702,50
1495,2,4787,1111,3676,0,0,0,1.0,1,1.0,1,1.0,1,0.1568341784784087,50
1496,4,4791,1112,3679,0,0,0,1.0,1,1.0,1,1.0,1,0.1666741247056367,52
1497,3,4794,1114,3680,0,0,0,1.0,1,1.0,1,1.0,1,0.1895888312072256,51
1498,4,4798,1115,3683,0,0,0,1.0,1,1.0,1,1.0,1,0.13245355598954534,50
1499,2,4800,1115,3685,0,0,0,1.0,1,1.0,1,1.0,1,0.13687662174935836,50
1500,0,4800,1115,3685,0,0,0,1.0,1,1.0,1,1.0,1,0.14815344541290731,49
1501,2,4802,1115,3687,0,0,0,1.0,1,1.0,1,1.0,1,0.11908320625122959,47
1502,2,4804,1117,3687,0,0,0,1.0,1,1.0,1,1.0,1,0.14399470495453337,47
1503,0,4804,1117,3687,0,0,0,1.0,1,1.0,1,1.0,1,0.1303744515303129,47
1504,3,4807,1120,3687,0,0,0,1.0,1,1.0,1,1.0,1,0.19727117058920887,48
1505,5,4812,1122,3690,0,0,0,1.0,1,1.0,1,1.0,1,0.13732270227841875,47
1506,3,4815,1125,3690,0,0,0,1.0,1,1.0,1,1.0,1,0.14604791008281567,47
1507,2,4817,1125,3692,0,0,0,1.0,1,1.0,1,1.0,1,0.13111429249936585,45
1508,2,4819,1126,3693,0,0,0,1.0,1,1.0,1,1.0,1,0.1416304019030033,45
1509,4,4823,1128,3695,0,0,0,1.0,1,1.0,1,1.0,1,0.14038022665438454,44
1510,2,4825,1130,3695,0,0,0,1.0,1,1.0,1,1.0,1,0.1456591020797537,42
1511,1,4826,1131,3695,0,0,0,1.0,1,1.0,1,1.0,1,0.18582307429663159,40
1512,3,4829,1134,3695,0,0,0,1.0,1,1.0,1,1.0,1,0.2737722524885598,39
1513,2,4831,1134,3697,0,0,0,1.0,1,1.0,1,1.0,1,0.23790135913357588,39
1514,0,4831,1134,3697,0,0,0,1.0,1,1.0,1,1.0,1,0.26032422898529645,38
1515,2,4833,1135,3698,0,0,0,1.0,1,1.0,1,1.0,1,0.22807589867091474,39
1516,2,4835,1135,3700,0,0,0,1.0,1,1.0,1,1.0,1,0.19891458127306444,39
1517,4,4839,1136,3703,0,0,0,1.0,1,1.0,1,1.0,1,0.1806168497965245,39
1518,2,4841,1136,3705,0,0,0,1.0,1,1.0,1,1.0,1,0.1519173159514172,39
1519,2,4843,1136,3707,0,0,0,1.0,1,1.0,1,1.0,1,0.1519173159514172,39
1520,8,4851,1139,3712,0,0,0,1.0,1,1.0,1,1.0,1,0.21563969133419228,39
1521,8,4859,1140,3719,0,0,0,1.0,1,1.0,1,1.0,1,0.22685714367479,40
1522,6,4865,1141,3724,0,0,0,1.0,1,1.0,1,1.0,1,0.24572274767495564,40
1523,7,4872,1141,3731,0,0,0,1.0,1,1.0,1,1.0,1,0.23849182157440998,41
1524,3,4875,1141,3734,0,0,0,1.0,1,1.0,1,1.0,1,0.2571667147022995,42
1525,11,4886,1143,3743,0,0,0,1.0,1,1.0,1,1.0,1,0.23374651888466963,45
1526,9,4895,1143,3752,0,0,0,1.0,1,1.0,1,1.0,1,0.23991909173763143,46
1527,5,4900,1143,3757,0,0,0,1.0,1,1.0,1,1.0,1,0.2349289869096547,46
1528,9,4909,1143,3766,0,0,0,1.0,1,1.0,1,1.0,1,0.23039885976925475,47
1529,6,4915,1143,3772,0,0,0,1.0,1,1.0,1,1.0,1,0.21543390811655125,47
1530,5,4920,1143,3777,0,0,0,1.0,1,1.0,1,1.0,1,0.20611628093427178,48
1531,4,4924,1143,3781,0,0,0,1.0,1,1.0,1,1.0,1,0.15757441647462944,46
1532,3,4927,1144,3783,0,0,0,1.0,1,1.0,1,1.0,1,0.13024916407722884,47
1533,0,4927,1144,3783,0,0,0,1.0,1,1.0,1,1.0,1,0.13829771681853667,46
1534,2,4929,1144,3785,0,0,0,1.0,1,1.0,1,1.0,1,0.13063655176034528,47
1535,2,4931,1144,3787,0,0,0,1.0,1,1.0,1,1.0,1,0.13063655176034528,47
1536,1,4932,1144,3788,0,0,0,1.0,1,1.0,1,1.0,1,0.13902242956374336,48
1537,1,4933,1144,3789,0,0,0,1.0,1,1.0,1,1.0,1,0.1484346605703399,46
1538,4,4937,1144,3793,0,0,0,1.0,1,1.0,1,1.0,1,0.1615244129481445,47
1539,2,4939,1144,3795,0,0,0,1.0,1,1.0,1,1.0,1,0.15517054051526993,47
1540,3,4942,1145,3797,0,0,0,1.0,1,1.0,1,1.0,1,0.18372997832859106,47
1541,4,4946,1145,3801,0,0,0,1.0,1,1.0,1,1.0,1,0.18259438462427133,47
1542,8,4954,1148,3806,0,0,0,1.0,1,1.0,1,1.0,1,0.18641245427191874,50
1543,7,4961,1150,3811,0,0,0,1.0,1,1.0,1,1.0,1,0.1988756022765261,47
1544,8,4969,1153,3816,0,0,0,1.0,1,1.0,1,1.0,1,0.17890708081811718,48
1545,7,4976,1154,3822,0,0,0,1.0,1,1.0,1,1.0,1,0.13940510954033541,47
1546,7,4983,1156,3827,0,0,0,1.0,1,1.0,1,1.0,1,0.13409315262593968,47
1547,6,4989,1157,3832,0,0,0,1.0,1,1.0,1,1.0,1,0.11942273099717661,47
1548,3,4992,1158,3834,0,0,0,1.0,1,1.0,1,1.0,1,0.13736935283891324,47
1549,7,4999,1162,3837,0,0,0,1.0,1,1.0,1,1.0,1,0.18799902878587285,46
1550,7,5006,1163,3843,0,0,0,1.0,1,1.0,1,1.0,1,0.19585018597083365,44
1551,6,5012,1167,3845,0,0,0,1.0,1,1.0,1,1.0,1,0.18457469802859064,45
1552,7,5019,1169,3850,0,0,0,1.0,1,1.0,1,1.0,1,0.2536413051019478,43
1553,6,5025,1171,3854,0,0,0,1.0,1,1.0,1,1.0,1,0.23961190443542413,43
1554,3,5028,1171,3857,0,0,0,1.0,1,1.0,1,1.0,1,0.2409505136160439,41
1555,5,5033,1172,3861,0,0,0,1.0,1,1.0,1,1.0,1,0.22035992500088625,44
1556,2,5035,1172,3863,0,0,0,1.0,1,1.0,1,1.0,1,0.20158312129514205,45
1557,3,5038,1172,3866,0,0,0,1.0,1,1.0,1,1.0,1,0.20992128834624238,45
1558,3,5041,1172,3869,0,0,0,1.0,1,1.0,1,1.0,1,0.1887750947197418,46
1559,1,5042,1173,3869,0,0,0,1.0,1,1.0,1,1.0,1,0.1863983538815416,47
1560,1,5043,1173,3870,0,0,0,1.0,1,1.0,1,1.0,1,0.22100912751227314,46
1561,10,5053,1173,3880,0,0,0,1.0,1,1.0,1,1.0,1,0.08321907797146391,47
1562,6,5059,1173,3886,0,0,0,1.0,1,1.0,1,1.0,1,0.09484813070432546,47
1563,3,5062,1174,3888,0,0,0,1.0,1,1.0,1,1.0,1,0.13685580947508708,47
1564,2,5064,1174,3890,0,0,0,1.0,1,1.0,1,1.0,1,0.09816470416934044,47
1565,4,5068,1174,3894,0,0,0,1.0,1,1.0,1,1.0,1,0.16764587994318095,48
1566,6,5074,1175,3899,0,0,0,1.0,1,1.0,1,1.0,1,0.14008277513596126,48
1567,4,5078,1175,3903,0,0,0,1.0,1,1.0,1,1.0,1,0.117455140229356,48
1568,8,5086,1177,3909,0,0,0,1.0,1,1.0,1,1.0,1,0.16575815309773495,48
1569,3,5089,1177,3912,0,0,0,1.0,1,1.0,1,1.0,1,0.19088780175588768,45
1570,4,5093,1177,3916,0,0,0,1.0,1,1.0,1,1.0,1,0.195441393916458,44
1571,6,5099,1180,3919,0,0,0,1.0,1,1.0,1,1.0,1,0.22209738313964553,42
1572,4,5103,1180,3923,0,0,0,1.0,1,1.0,1,1.0,1,0.25166554920673656,43
1573,3,5106,1180,3926,0,0,0,1.0,1,1.0,1,1.0,1,0.24119269968001103,43
1574,3,5109,1181,3928,0,0,0,1.0,1,1.0,1,1.0,1,0.22246578670024533,42
1575,4,5113,1181,3932,0,0,0,1.0,1,1.0,1,1.0,1,0.2506534669948169,43
1576,8,5121,1184,3937,0,0,0,1.0,1,1.0,1,1.0,1,0.13942317698487094,41
1577,3,5124,1185,3939,0,0,0,1.0,1,1.0,1,1.0,1,0.14795832387681107,40
1578,1,5125,1185,3940,0,0,0,1.0,1,1.0,1,1.0,1,0.13403218948349188,40
1579,1,5126,1185,3941,0,0,0,1.0,1,1.0,1,1.0,1,0.12037482785793964,40
1580,1,5127,1186,3941,0,0,0,1.0,1,1.0,1,1.0,1,0.12511695973665599,40
1581,1,5128,1187,3941,0,0,0,1.0,1,1.0,1,1.0,1,0.1563269744316725,40
1582,6,5134,1190,3944,0,0,0,1.0,1,1.0,1,1.0,1,0.16620299664959573,40
1583,0,5134,1190,3944,0,0,0,1.0,1,1.0,1,1.0,1,0.18847338055011045,38
1584,4,5138,1192,3946,0,0,0,1.0,1,1.0,1,1.0,1,0.155140120093211,39
1585,3,5141,1194,3947,0,0,0,1.0,1,1.0,1,1.0,1,0.20048535216171526,38
1586,4,5145,1197,3948,0,0,0,1.0,1,1.0,1,1.0,1,0.19226898358366867,38
1587,4,5149,1200,3949,0,0,0,1.0,1,1.0,1,1.0,1,0.21473000575214954,37
1588,6,5155,1202,3953,0,0,0,1.0,1,1.0,1,1.0,1,0.17369650407062254,39
1589,5,5160,1205,3955,0,0,0,1.0,1,1.0,1,1.0,1,0.2209671162365259,37
1590,7,5167,1207,3960,0,0,0,1.0,1,1.0,1,1.0,1,0.21087933323600513,37
1591,6,5173,1209,3964,0,0,0,1.0,1,1.0,1,1.0,1,0.13460934658387172,36
1592,1,5174,1209,3965,0,0,0,1.0,1,1.0,1,1.0,1,0.14969459501106305,34
1593,2,5176,1211,3965,0,0,0,1.0,1,1.0,1,1.0,1,0.2311258901498893,33
1594,0,5176,1211,3965,0,0,0,1.0,1,1.0,1,1.0,1,0.21142639098485952,31
1595,3,5179,1212,3967,0,0,0,1.0,1,1.0,1,1.0,1,0.22200387861325183,34
1596,1,5180,1212,3968,0,0,0,1.0,1,1.0,1,1.0,1,0.18614846851600023,33
1597,0,5180,1212,3968,0,0,0,1.0,1,1.0,1,1.0,1,0.18614846851600023,33
1598,1,5181,1212,3969,0,0,0,1.0,1,1.0,1,1.0,1,0.20548849638736272,33
1599,2,5183,1214,3969,0,0,0,1.0,1,1.0,1,1.0,1,0.21445996007950396,33
1600,1,5184,1214,3970,0,0,0,1.0,1,1.0,1,1.0,1,0.2210586689975668,34
1601,0,5184,1214,3970,0,0,0,1.0,1,1.0,1,1.0,1,0.24195468835347628,35
1602,2,5186,1214,3972,0,0,0,1.0,1,1.0,1,1.0,1,0.24709625888465622,36
1603,5,5191,1215,3976,0,0,0,1.0,1,1.0,1,1.0,1,0.21999075104607516,38
1604,4,5195,1215,3980,0,0,0,1.0,1,1.0,1,1.0,1,0.2169313455367923,38
1605,0,5195,1215,3980,0,0,0,1.0,1,1.0,1,1.0,1,0.2169313455367923,38
1606,8,5203,1217,3986,0,0,0,1.0,1,1.0,1,1.0,1,0.1812700162714879,39
1607,2,5205,1218,3987,0,0,0,1.0,1,1.0,1,1.0,1,0.18462882502841801,37
1608,2,5207,1218,3989,0,0,0,1.0,1,1.0,1,1.0,1,0.20581511864888427,36
1609,4,5211,1218,3993,0,0,0,1.0,1,1.0,1,1.0,1,0.20242017352295616,34
1610,3,5214,1219,3995,0,0,0,1.0,1,1.0,1,1.0,1,0.23291362368525653,34
1611,2,5216,1219,3997,0,0,0,1.0,1,1.0,1,1.0,1,0.20297814609388423,35
1612,1,5217,1219,3998,0,0,0,1.0,1,1.0,1,1.0,1,0.20268924888301595,33
1613,3,5220,1220,4000,0,0,0,1.0,1,1.0,1,1.0,1,0.22539035260047574,34
1614,4,5224,1220,4004,0,0,0,1.0,1,1.0,1,1.0,1,0.15228322369152675,35
1615,3,5227,1220,4007,0,0,0,1.0,1,1.0,1,1.0,1,0.15655698074436777,35
1616,3,5230,1220,4010,0,0,0,1.0,1,1.0,1,1.0,1,0.1629034564727071,37
1617,4,5234,1222,4012,0,0,0,1.0,1,1.0,1,1.0,1,0.19746229934561796,38
1618,0,5234,1222,4012,0,0,0,1.0,1,1.0,1,1.0,1,0.19746229934561796,38
1619,0,5234,1222,4012,0,0,0,1.0,1,1.0,1,1.0,1,0.19841549811155254,38
1620,2,5236,1223,4013,0,0,0,1.0,1,1.0,1,1.0,1,0.20527348699216622,39
1621,4,5240,1224,4016,0,0,0,1.0,1,1.0,1,1.0,1,0.18995469416927924,37
1622,1,5241,1224,4017,0,0,0,1.0,1,1.0,1,1.0,1,0.20129855825387297,37
1623,4,5245,1227,4018,0,0,0,1.0,1,1.0,1,1.0,1,0.22114636457842696,37
1624,2,5247,1229,4018,0,0,0,1.0,1,1.0,1,1.0,1,0.23666875805908258,37
1625,1,5248,1229,4019,0,0,0,1.0,1,1.0,1,1.0,1,0.22058494308656074,35
1626,4,5252,1231,4021,0,0,0,1.0,1,1.0,1,1.0,1,0.259769216491322,35
1627,0,5252,1231,4021,0,0,0,1.0,1,1.0,1,1.0,1,0.24744108839683887,34
1628,3,5255,1232,4023,0,0,0,1.0,1,1.0,1,1.0,1,0.22040845645818896,35
1629,4,5259,1235,4024,0,0,0,1.0,1,1.0,1,1.0,1,0.2507836430402044,34
1630,3,5262,1235,4027,0,0,0,1.0,1,1.0,1,1.0,1,0.22611266566992125,32
1631,2,5264,1236,4028,0,0,0,1.0,1,1.0,1,1.0,1,0.24849689904015881,33
1632,2,5266,1237,4029,0,0,0,1.0,1,1.0,1,1.0,1,0.27277583532363153,32
1633,2,5268,1238,4030,0,0,0,1.0,1,1.0,1,1.0,1,0.2706876681238906,31
1634,2,5270,1239,4031,0,0,0,1.0,1,1.0,1,1.0,1,0.2552300050361306,31
1635,0,5270,1239,4031,0,0,0,1.0,1,1.0,1,1.0,1,0.26150399744000724,31
1636,4,5274,1240,4034,0,0,0,1.0,1,1.0,1,1.0,1,0.21191907166954743,33
1637,0,5274,1240,4034,0,0,0,1.0,1,1.0,1,1.0,1,0.21191907166954743,33
1638,0,5274,1240,4034,0,0,0,1.0,1,1.0,1,1.0,1,0.18578738609655565,36
1639,1,5275,1240,4035,0,0,0,1.0,1,1.0,1,1.0,1,0.15548469490890438,36
1640,2,5277,1240,4037,0,0,0,1.0,1,1.0,1,1.0,1,0.15564279874198614,36
1641,1,5278,1240,4038,0,0,0,1.0,1,1.0,1,1.0,1,0.15891758885646737,38
1642,3,5281,1242,4039,0,0,0,1.0,1,1.0,1,1.0,1,0.1681589996657091,37
1643,0,5281,1242,4039,0,0,0,1.0,1,1.0,1,1.0,1,0.1681589996657091,37
1644,2,5283,1243,4040,0,0,0,1.0,1,1.0,1,1.0,1,0.16014659944982299,38
1645,0,5283,1243,4040,0,0,0,1.0,1,1.0,1,1.0,1,0.118996849749694,36
1646,0,5283,1243,4040,0,0,0,1.0,1,1.0,1,1.0,1,0.13162994310938603,37
1647,2,5285,1245,4040,0,0,0,1.0,1,1.0,1,1.0,1,0.17800588335154513,35
1648,2,5287,1246,4041,0,0,0,1.0,1,1.0,1,1.0,1,0.21991586065897645,38
1649,1,5288,1247,4041,0,0,0,1.0,1,1.0,1,1.0,1,0.2227152345139422,35
1650,0,5288,1247,4041,0,0,0,1.0,1,1.0,1,1.0,1,0.24861582804712828,34
1651,1,5289,1247,4042,0,0,0,1.0,1,1.0,1,1.0,1,0.2019719408211563,32
1652,0,5289,1247,4042,0,0,0,1.0,1,1.0,1,1.0,1,0.2223869914961705,33
1653,1,5290,1247,4043,0,0,0,1.0,1,1.0,1,1.0,1,0.19579281047954902,33
1654,1,5291,1247,4044,0,0,0,1.0,1,1.0,1,1.0,1,0.200043216844169,34
1655,5,5296,1249,4047,0,0,0,1.0,1,1.0,1,1.0,1,0.1891476666419386,35
1656,5,5301,1249,4052,0,0,0,1.0,1,1.0,1,1.0,1,0.18015954086577188,35
1657,3,5304,1250,4054,0,0,0,1.0,1,1.0,1,1.0,1,0.15350933221792748,36
1658,1,5305,1251,4054,0,0,0,1.0,1,1.0,1,1.0,1,0.1759699582814115,36
1659,3,5308,1251,4057,0,0,0,1.0,1,1.0,1,1.0,1,0.16406020116670497,36
1660,4,5312,1254,4058,0,0,0,1.0,1,1.0,1,1.0,1,0.25977206702030925,38
1661,4,5316,1254,4062,0,0,0,1.0,1,1.0,1,1.0,1,0.2400475758158463,38
1662,6,5322,1257,4065,0,0,0,1.0,1,1.0,1,1.0,1,0.14131092958101643,39
1663,7,5329,1258,4071,0,0,0,1.0,1,1.0,1,1.0,1,0.14983068305913577,40
1664,9,5338,1260,4078,0,0,0,1.0,1,1.0,1,1.0,1,0.28018979851924025,39
1665,6,5344,1261,4083,0,0,0,1.0,1,1.0,1,1.0,1,0.24212711851401944,40
1666,6,5350,1262,4088,0,0,0,1.0,1,1.0,1,1.0,1,0.15690003776764255,40
1667,2,5352,1262,4090,0,0,0,1.0,1,1.0,1,1.0,1,0.13711555665891564,40
1668,7,5359,1262,4097,0,0,0,1.0,1,1.0,1,1.0,1,0.13979298028805603,41
1669,6,5365,1262,4103,0,0,0,1.0,1,1.0,1,1.0,1,0.10961477873446668,40
1670,1,5366,1262,4104,0,0,0,1.0,1,1.0,1,1.0,1,0.1113018928076544,40
1671,6,5372,1263,4109,0,0,0,1.0,1,1.0,1,1.0,1,0.11746757977143134,41
1672,3,5375,1264,4111,0,0,0,1.0,1,1.0,1,1.0,1,0.13295128459648484,40
1673,2,5377,1265,4112,0,0,0,1.0,1,1.0,1,1.0,1,0.16266385051348844,39
1674,0,5377,1265,4112,0,0,0,1.0,1,1.0,1,1.0,1,0.1813694834388834,40
1675,0,5377,1265,4112,0,0,0,1.0,1,1.0,1,1.0,1,0.22660498617109892,38
1676,2,5379,1266,4113,0,0,0,1.0,1,1.0,1,1.0,1,0.22092807672364934,39
1677,1,5380,1266,4114,0,0,0,1.0,1,1.0,1,1.0,1,0.2175538674377262,39
1678,1,5381,1266,4115,0,0,0,1.0,1,1.0,1,1.0,1,0.21885462822200027,39
1679,2,5383,1267,4116,0,0,0,1.0,1,1.0,1,1.0,1,0.250655958686195,39
1680,4,5387,1267,4120,0,0,0,1.0,1,1.0,1,1.0,1,0.15564106562787752,41
1681,4,5391,1269,4122,0,0,0,1.0,1,1.0,1,1.0,1,0.16119633064354422,41
1682,5,5396,1270,4126,0,0,0,1.0,1,1.0,1,1.0,1,0.1579761784321354,43
1683,3,5399,1271,4128,0,0,0,1.0,1,1.0,1,1.0,1,0.13442806580250524,43
1684,1,5400,1272,4128,0,0,0,1.0,1,1.0,1,1.0,1,0.1128296358585144,42
1685,1,5401,1273,4128,0,0,0,1.0,1,1.0,1,1.0,1,0.1278300112016077,41
1686,2,5403,1275,4128,0,0,0,1.0,1,1.0,1,1.0,1,0.18314320915189147,41
1687,1,5404,1276,4128,0,0,0,1.0,1,1.0,1,1.0,1,0.1786460120177465,40
1688,2,5406,1277,4129,0,0,0,1.0,1,1.0,1,1.0,1,0.17980044679167165,39
1689,0,5406,1277,4129,0,0,0,1.0,1,1.0,1,1.0,1,0.21287027037320316,38
1690,0,5406,1277,4129,0,0,0,1.0,1,1.0,1,1.0,1,0.2056203137061388,38
1691,2,5408,1279,4129,0,0,0,1.0,1,1.0,1,1.0,1,0.30847283590980157,36
1692,4,5412,1280,4132,0,0,0,1.0,1,1.0,1,1.0,1,0.2912333826949177,36
1693,1,5413,1281,4132,0,0,0,1.0,1,1.0,1,1.0,1,0.2961642886053368,35
1694,1,5414,1282,4132,0,0,0,1.0,1,1.0,1,1.0,1,0.32577325860465706,33
1695,0,5414,1282,4132,0,0,0,1.0,1,1.0,1,1.0,1,0.30570376695899076,34
1696,8,5422,1283,4139,0,0,0,1.0,1,1.0,1,1.0,1,0.2428954965319301,35
1697,3,5425,1283,4142,0,0,0,1.0,1,1.0,1,1.0,1,0.23951517936235492,36
1698,4,5429,1284,4145,0,0,0,1.0,1,1.0,1,1.0,1,0.2241252379023392,38
1699,2,5431,1285,4146,0,0,0,1.0,1,1.0,1,1.0,1,0.2555062033852069,38
1700,3,5434,1285,4149,0,0,0,1.0,1,1.0,1,1.0,1,0.22027283103023934,39
1701,4,5438,1285,4153,0,0,0,1.0,1,1.0,1,1.0,1,0.2355172174318864,40
1702,4,5442,1286,4156,0,0,0,1.0,1,1.0,1,1.0,1,0.21134015392394503,41
1703,2,5444,1287,4157,0,0,0,1.0,1,1.0,1,1.0,1,0.25185964807286393,41
1704,2,5446,1287,4159,0,0,0,1.0,1,1.0,1,1.0,1,0.18091370858656308,41
1705,3,5449,1288,4161,0,0,0,1.0,1,1.0,1,1.0,1,0.12575788813808972,40
1706,3,5452,1290,4162,0,0,0,1.0,1,1.0,1,1.0,1,0.19576976034113933,40
1707,5,5457,1291,4166,0,0,0,1.0,1,1.0,1,1.0,1,0.17071290555002067,39
1708,8,5465,1293,4172,0,0,0,1.0,1,1.0,1,1.0,1,0.1969172303225765,39
1709,4,5469,1293,4176,0,0,0,1.0,1,1.0,1,1.0,1,0.21048189141012832,38
1710,8,5477,1295,4182,0,0,0,1.0,1,1.0,1,1.0,1,0.23495927532572597,39
1711,4,5481,1296,4185,0,0,0,1.0,1,1.0,1,1.0,1,0.1706377166573469,38
1712,2,5483,1296,4187,0,0,0,1.0,1,1.0,1,1.0,1,0.1706377166573469,38
1713,0,5483,1296,4187,0,0,0,1.0,1,1.0,1,1.0,1,0.18957251703154765,37
1714,0,5483,1296,4187,0,0,0,1.0,1,1.0,1,1.0,1,0.19837180987739014,38
1715,1,5484,1296,4188,0,0,0,1.0,1,1.0,1,1.0,1,0.1830982656139913,40
1716,1,5485,1297,4188,0,0,0,1.0,1,1.0,1,1.0,1,0.22238461586173328,39
1717,1,5486,1298,4188,0,0,0,1.0,1,1.0,1,1.0,1,0.21891916844113307,38
1718,1,5487,1298,4189,0,0,0,1.0,1,1.0,1,1.0,1,0.2245896544845176,38
1719,1,5488,1298,4190,0,0,0,1.0,1,1.0,1,1.0,1,0.20919293574034242,38
1720,1,5489,1298,4191,0,0,0,1.0,1,1.0,1,1.0,1,0.19348910778544978,41
1721,0,5489,1298,4191,0,0,0,1.0,1,1.0,1,1.0,1,0.1640933980962155,39
1722,0,5489,1298,4191,0,0,0,1.0,1,1.0,1,1.0,1,0.15382598464986538,40
1723,1,5490,1299,4191,0,0,0,1.0,1,1.0,1,1.0,1,0.14519374905076307,38
1724,1,5491,1300,4191,0,0,0,1.0,1,1.0,1,1.0,1,0.17513951454402435,37
1725,2,5493,1300,4193,0,0,0,1.0,1,1.0,1,1.0,1,0.16993775760522853,38
1726,2,5495,1300,4195,0,0,0,1.0,1,1.0,1,1.0,1,0.16724297417580464,37
1727,2,5497,1300,4197,0,0,0,1.0,1,1.0,1,1.0,1,0.12568013754959306,37
1728,0,5497,1300,4197,0,0,0,1.0,1,1.0,1,1.0,1,0.12558111709704212,35
1729,0,5497,1300,4197,0,0,0,1.0,1,1.0,1,1.0,1,0.13677675963513602,37
1730,1,5498,1301,4197,0,0,0,1.0,1,1.0,1,1.0,1,0.20144165585575358,37
1731,4,5502,1302,4200,0,0,0,1.0,1,1.0,1,1.0,1,0.1411267241376239,37
1732,1,5503,1302,4201,0,0,0,1.0,1,1.0,1,1.0,1,0.18132489406407537,37
1733,3,5506,1304,4202,0,0,0,1.0,1,1.0,1,1.0,1,0.20203268145739528,36
1734,1,5507,1304,4203,0,0,0,1.0,1,1.0,1,1.0,1,0.2286642692492126,35
1735,5,5512,1306,4206,0,0,0,1.0,1,1.0,1,1.0,1,0.25775433228255823,34
1736,3,5515,1306,4209,0,0,0,1.0,1,1.0,1,1.0,1,0.2444173372965612,35
1737,5,5520,1308,4212,0,0,0,1.0,1,1.0,1,1.0,1,0.2733094357467486,36
1738,7,5527,1308,4219,0,0,0,1.0,1,1.0,1,1.0,1,0.26438612248821475,37
1739,4,5531,1309,4222,0,0,0,1.0,1,1.0,1,1.0,1,0.19927044618332546,38
1740,5,5536,1309,4227,0,0,0,1.0,1,1.0,1,1.0,1,0.22185822893165477,37
1741,4,5540,1309,4231,0,0,0,1.0,1,1.0,1,1.0,1,0.11123548883370449,38
1742,5,5545,1312,4233,0,0,0,1.0,1,1.0,1,1.0,1,0.17494294875451794,39
1743,2,5547,1312,4235,0,0,0,1.0,1,1.0,1,1.0,1,0.1337084399199355,37
1744,2,5549,1314,4235,0,0,0,1.0,1,1.0,1,1.0,1,0.16463404733545775,38
1745,0,5549,1314,4235,0,0,0,1.0,1,1.0,1,1.0,1,0.19888168644149357,37
1746,2,5551,1316,4235,0,0,0,1.0,1,1.0,1,1.0,1,0.22413305997464655,38
1747,3,5554,1316,4238,0,0,0,1.0,1,1.0,1,1.0,1,0.2068014993981695,38
1748,1,5555,1316,4239,0,0,0,1.0,1,1.0,1,1.0,1,0.1950162383903054,38
1749,0,5555,1316,4239,0,0,0,1.0,1,1.0,1,1.0,1,0.20783672685643917,37
1750,3,5558,1316,4242,0,0,0,1.0,1,1.0,1,1.0,1,0.20512984637079867,39
1751,2,5560,1316,4244,0,0,0,1.0,1,1.0,1,1.0,1,0.2086946000076266,38
1752,2,5562,1316,4246,0,0,0,1.0,1,1.0,1,1.0,1,0.2080958397286627,39
1753,5,5567,1316,4251,0,0,0,1.0,1,1.0,1,1.0,1,0.2098148681314221,40
1754,1,5568,1317,4251,0,0,0,1.0,1,1.0,1,1.0,1,0.21889440510675715,41
1755,1,5569,1317,4252,0,0,0,1.0,1,1.0,1,1.0,1,0.17777862721043533,41
1756,2,5571,1318,4253,0,0,0,1.0,1,1.0,1,1.0,1,0.1514895813726744,42
1757,5,5576,1318,4258,0,0,0,1.0,1,1.0,1,1.0,1,0.10278280321843634,42
1758,3,5579,1320,4259,0,0,0,1.0,1,1.0,1,1.0,1,0.14706803056154114,42
1759,2,5581,1320,4261,0,0,0,1.0,1,1.0,1,1.0,1,0.14122604622085827,39
1760,5,5586,1322,4264,0,0,0,1.0,1,1.0,1,1.0,1,0.24073859926108174,39
1761,2,5588,1323,4265,0,0,0,1.0,1,1.0,1,1.0,1,0.25944987962777966,38
1762,3,5591,1324,4267,0,0,0,1.0,1,1.0,1,1.0,1,0.17565216657865998,37
1763,1,5592,1324,4268,0,0,0,1.0,1,1.0,1,1.0,1,0.16333053837073497,37
1764,2,5594,1326,4268,0,0,0,1.0,1,1.0,1,1.0,1,0.18700172620121103,36
1765,4,5598,1328,4270,0,0,0,1.0,1,1.0,1,1.0,1,0.19805255750641118,37
1766,3,5601,1328,4273,0,0,0,1.0,1,1.0,1,1.0,1,0.2650314374202643,36
1767,4,5605,1328,4277,0,0,0,1.0,1,1.0,1,1.0,1,0.24209350415590125,36
1768,2,5607,1328,4279,0,0,0,1.0,1,1.0,1,1.0,1,0.23287079831059135,36
1769,2,5609,1329,4280,0,0,0,1.0,1,1.0,1,1.0,1,0.24518919209890935,38
1770,5,5614,1330,4284,0,0,0,1.0,1,1.0,1,1.0,1,0.25095037701822936,38
1771,4,5618,1330,4288,0,0,0,1.0,1,1.0,1,1.0,1,0.14955154920505187,38
1772,1,5619,1330,4289,0,0,0,1.0,1,1.0,1,1.0,1,0.14404963805368032,40
1773,1,5620,1331,4289,0,0,0,1.0,1,1.0,1,1.0,1,0.1856403118024459,40
1774,1,5621,1331,4290,0,0,0,1.0,1,1.0,1,1.0,1,0.1586933505391874,40
1775,1,5622,1331,4291,0,0,0,1.0,1,1.0,1,1.0,1,0.15547315957865265,41
1776,1,5623,1331,4292,0,0,0,1.0,1,1.0,1,1.0,1,0.11281584096274702,43
1777,0,5623,1331,4292,0,0,0,1.0,1,1.0,1,1.0,1,0.12431922524766645,44
1778,5,5628,1334,4294,0,0,0,1.0,1,1.0,1,1.0,1,0.13639738343183394,44
1779,2,5630,1334,4296,0,0,0,1.0,1,1.0,1,1.0,1,0.1299877610780863,44
1780,3,5633,1334,4299,0,0,0,1.0,1,1.0,1,1.0,1,0.11910814545539247,46
1781,2,5635,1335,4300,0,0,0,1.0,1,1.0,1,1.0,1,0.13507261928125003,46
1782,3,5638,1337,4301,0,0,0,1.0,1,1.0,1,1.0,1,0.1713000375882583,45
1783,0,5638,1337,4301,0,0,0,1.0,1,1.0,1,1.0,1,0.16705034798238455,44
1784,3,5641,1339,4302,0,0,0,1.0,1,1.0,1,1.0,1,0.14755622093409645,44
1785,4,5645,1341,4304,0,0,0,1.0,1,1.0,1,1.0,1,0.16949103242168465,42
1786,3,5648,1343,4305,0,0,0,1.0,1,1.0,1,1.0,1,0.1370638103844891,42
1787,0,5648,1343,4305,0,0,0,1.0,1,1.0,1,1.0,1,0.19888410451835412,41
1788,2,5650,1343,4307,0,0,0,1.0,1,1.0,1,1.0,1,0.20255621392275214,41
1789,2,5652,1344,4308,0,0,0,1.0,1,1.0,1,1.0,1,0.13682499677000076,41
1790,3,5655,1346,4309,0,0,0,1.0,1,1.0,1,1.0,1,0.12142248423428938,41
1791,2,5657,1348,4309,0,0,0,1.0,1,1.0,1,1.0,1,0.1330884419597403,41
1792,3,5660,1349,4311,0,0,0,1.0,1,1.0,1,1.0,1,0.1284395935291523,43
1793,6,5666,1352,4314,0,0,0,1.0,1,1.0,1,1.0,1,0.1801998811439495,43
1794,2,5668,1354,4314,0,0,0,1.0,1,1.0,1,1.0,1,0.20871818611130719,41
1795,2,5670,1356,4314,0,0,0,1.0,1,1.0,1,1.0,1,0.25847376285244744,41
1796,2,5672,1357,4315,0,0,0,1.0,1,1.0,1,1.0,1,0.3078597560012234,40
1797,1,5673,1357,4316,0,0,0,1.0,1,1.0,1,1.0,1,0.28326908676671125,38
1798,1,5674,1357,4317,0,0,0,1.0,1,1.0,1,1.0,1,0.27042593568797624,38
1799,2,5676,1359,4317,0,0,0,1.0,1,1.0,1,1.0,1,0.2822437887053068,37
1800,1,5677,1360,4317,0,0,0,1.0,1,1.0,1,1.0,1,0.3102184818589812,35
1801,7,5684,1361,4323,0,0,0,1.0,1,1.0,1,1.0,1,0.13565408528609646,34
1802,1,5685,1361,4324,0,0,0,1.0,1,1.0,1,1.0,1,0.12382151906733427,33
1803,2,5687,1362,4325,0,0,0,1.0,1,1.0,1,1.0,1,0.12748484606574675,33
1804,1,5688,1363,4325,0,0,0,1.0,1,1.0,1,1.0,1,0.1750433288236331,33
1805,3,5691,1363,4328,0,0,0,1.0,1,1.0,1,1.0,1,0.1583033777793957,35
1806,4,5695,1363,4332,0,0,0,1.0,1,1.0,1,1.0,1,0.14077226539585108,36
1807,0,5695,1363,4332,0,0,0,1.0,1,1.0,1,1.0,1,0.12116541943962643,35
1808,1,5696,1363,4333,0,0,0,1.0,1,1.0,1,1.0,1,0.12946285962347176,37
1809,3,5699,1363,4336,0,0,0,1.0,1,1.0,1,1.0,1,0.13247939229295191,35
1810,4,5703,1364,4339,0,0,0,1.0,1,1.0,1,1.0,1,0.17329729045191214,36
1811,4,5707,1365,4342,0,0,0,1.0,1,1.0,1,1.0,1,0.271827527561166,34
1812,3,5710,1365,4345,0,0,0,1.0,1,1.0,1,1.0,1,0.27364254671388605,36
1813,5,5715,1365,4350,0,0,0,1.0,1,1.0,1,1.0,1,0.2876079092849026,35
1814,4,5719,1366,4353,0,0,0,1.0,1,1.0,1,1.0,1,0.2977204406686871,36
1815,2,5721,1367,4354,0,0,0,1.0,1,1.0,1,1.0,1,0.2918344208336156,35
1816,6,5727,1367,4360,0,0,0,1.0,1,1.0,1,1.0,1,0.1963749368854642,35
1817,3,5730,1367,4363,0,0,0,1.0,1,1.0,1,1.0,1,0.17147882549082066,35
1818,2,5732,1367,4365,0,0,0,1.0,1,1.0,1,1.0,1,0.12606430367345628,36
1819,3,5735,1370,4365,0,0,0,1.0,1,1.0,1,1.0,1,0.11188822496303223,37
1820,0,5735,1370,4365,0,0,0,1.0,1,1.0,1,1.0,1,0.11188822496303223,37
1821,2,5737,1371,4366,0,0,0,1.0,1,1.0,1,1.0,1,0.11455808497217787,38
1822,4,5741,1374,4367,0,0,0,1.0,1,1.0,1,1.0,1,0.1251784283364855,37
1823,2,5743,1376,4367,0,0,0,1.0,1,1.0,1,1.0,1,0.17727948290787413,36
1824,4,5747,1379,4368,0,0,0,1.0,1,1.0,1,1.0,1,0.22791299289292763,36
1825,2,5749,1380,4369,0,0,0,1.0,1,1.0,1,1.0,1,0.20003745531262146,34
1826,2,5751,1381,4370,0,0,0,1.0,1,1.0,1,1.0,1,0.17751058835557568,35
1827,2,5753,1383,4370,0,0,0,1.0,1,1.0,1,1.0,1,0.1869661871981823,34
1828,4,5757,1385,4372,0,0,0,1.0,1,1.0,1,1.0,1,0.16280357515516122,33
1829,1,5758,1386,4372,0,0,0,1.0,1,1.0,1,1.0,1,0.1940085474674169,31
1830,5,5763,1388,4375,0,0,0,1.0,1,1.0,1,1.0,1,0.22273676551328678,31
1831,6,5769,1389,4380,0,0,0,1.0,1,1.0,1,1.0,1,0.1542997742655511,30
1832,1,5770,1389,4381,0,0,0,1.0,1,1.0,1,1.0,1,0.16908372960965312,29
1833,1,5771,1390,4381,0,0,0,1.0,1,1.0,1,1.0,1,0.20093882920771836,28
1834,0,5771,1390,4381,0,0,0,1.0,1,1.0,1,1.0,1,0.23298110220614132,27
1835,4,5775,1393,4382,0,0,0,1.0,1,1.0,1,1.0,1,0.21540994457854307,26
1836,0,5775,1393,4382,0,0,0,1.0,1,1.0,1,1.0,1,0.268034720630848,26
1837,3,5778,1394,4384,0,0,0,1.0,1,1.0,1,1.0,1,0.30107726481958724,25
1838,2,5780,1395,4385,0,0,0,1.0,1,1.0,1,1.0,1,0.27264786801409713,25
1839,0,5780,1395,4385,0,0,0,1.0,1,1.0,1,1.0,1,0.32152555656456977,24
1840,0,5780,1395,4385,0,0,0,1.0,1,1.0,1,1.0,1,0.3618210263945926,23
1841,4,5784,1395,4389,0,0,0,1.0,1,1.0,1,1.0,1,0.35875907497488196,22
1842,4,5788,1396,4392,0,0,0,1.0,1,1.0,1,1.0,1,0.3230131551152551,23
1843,2,5790,1396,4394,0,0,0,1.0,1,1.0,1,1.0,1,0.3230131551152551,23
1844,2,5792,1396,4396,0,0,0,1.0,1,1.0,1,1.0,1,0.3271653231321023,23
1845,3,5795,1397,4398,0,0,0,1.0,1,1.0,1,1.0,1,0.3460313792608087,23
1846,7,5802,1398,4404,0,0,0,1.0,1,1.0,1,1.0,1,0.2602719333506502,23
1847,2,5804,1398,4406,0,0,0,1.0,1,1.0,1,1.0,1,0.1565308975581145,24
1848,1,5805,1398,4407,0,0,0,1.0,1,1.0,1,1.0,1,0.21723728254790714,24
1849,0,5805,1398,4407,0,0,0,1.0,1,1.0,1,1.0,1,0.2356415052881771,25
1850,1,5806,1398,4408,0,0,0,1.0,1,1.0,1,1.0,1,0.1821239074570396,25
1851,2,5808,1398,4410,0,0,0,1.0,1,1.0,1,1.0,1,0.1821239074570396,25
1852,1,5809,1398,4411,0,0,0,1.0,1,1.0,1,1.0,1,0.2356415052881771,25
1853,3,5812,1398,4414,0,0,0,1.0,1,1.0,1,1.0,1,0.19034878350600995,25
1854,3,5815,1399,4416,0,0,0,1.0,1,1.0,1,1.0,1,0.28563453397456334,25
1855,1,5816,1399,4417,0,0,0,1.0,1,1.0,1,1.0,1,0.2656314699644847,26
1856,5,5821,1399,4422,0,0,0,1.0,1,1.0,1,1.0,1,0.22822266295431962,27
1857,3,5824,1399,4425,0,0,0,1.0,1,1.0,1,1.0,1,0.24616742199358835,28
1858,10,5834,1400,4434,0,0,0,1.0,1,1.0,1,1.0,1,0.3213583637979729,28
1859,7,5841,1401,4440,0,0,0,1.0,1,1.0,1,1.0,1,0.3653756640523838,28
1860,4,5845,1401,4444,0,0,0,1.0,1,1.0,1,1.0,1,0.3653756640523838,28
1861,5,5850,1401,4449,0,0,0,1.0,1,1.0,1,1.0,1,0.30452374499608914,28
1862,2,5852,1401,4451,0,0,0,1.0,1,1.0,1,1.0,1,0.30452374499608914,28
1863,3,5855,1402,4453,0,0,0,1.0,1,1.0,1,1.0,1,0.3482223804564048,29
1864,3,5858,1402,4456,0,0,0,1.0,1,1.0,1,1.0,1,0.2993024814272944,27
1865,3,5861,1403,4458,0,0,0,1.0,1,1.0,1,1.0,1,0.2523641791162872,26
1866,3,5864,1404,4460,0,0,0,1.0,1,1.0,1,1.0,1,0.2559242600719468,26
1867,1,5865,1404,4461,0,0,0,1.0,1,1.0,1,1.0,1,0.25027192833819484,26
1868,2,5867,1404,4463,0,0,0,1.0,1,1.0,1,1.0,1,0.25027192833819484,26
1869,2,5869,1404,4465,0,0,0,1.0,1,1.0,1,1.0,1,0.18621944254025452,26
1870,1,5870,1404,4466,0,0,0,1.0,1,1.0,1,1.0,1,0.2068264806940296,27
1871,2,5872,1404,4468,0,0,0,1.0,1,1.0,1,1.0,1,0.2068264806940296,27
1872,1,5873,1404,4469,0,0,0,1.0,1,1.0,1,1.0,1,0.2584057173952958,25
1873,1,5874,1404,4470,0,0,0,1.0,1,1.0,1,1.0,1,0.25745442843326477,25
1874,3,5877,1405,4472,0,0,0,1.0,1,1.0,1,1.0,1,0.32499650680444087,25
1875,2,5879,1405,4474,0,0,0,1.0,1,1.0,1,1.0,1,0.32499650680444087,25
1876,3,5882,1405,4477,0,0,0,1.0,1,1.0,1,1.0,1,0.2533940374297722,26
1877,0,5882,1405,4477,0,0,0,1.0,1,1.0,1,1.0,1,0.22239133400072522,27
1878,0,5882,1405,4477,0,0,0,1.0,1,1.0,1,1.0,1,0.23296643681538856,28
1879,0,5882,1405,4477,0,0,0,1.0,1,1.0,1,1.0,1,0.22730734358516216,29
1880,3,5885,1405,4480,0,0,0,1.0,1,1.0,1,1.0,1,0.21039300525006013,29
1881,0,5885,1405,4480,0,0,0,1.0,1,1.0,1,1.0,1,0.21039300525006013,29
1882,0,5885,1405,4480,0,0,0,1.0,1,1.0,1,1.0,1,0.25102940782344924,28
1883,0,5885,1405,4480,0,0,0,1.0,1,1.0,1,1.0,1,0.25102940782344924,28
1884,0,5885,1405,4480,0,0,0,1.0,1,1.0,1,1.0,1,0.25102940782344924,28
1885,0,5885,1405,4480,0,0,0,1.0,1,1.0,1,1.0,1,0.25102940782344924,28
1886,0,5885,1405,4480,0,0,0,1.0,1,1.0,1,1.0,1,0.23036780050428782,29
1887,0,5885,1405,4480,0,0,0,1.0,1,1.0,1,1.0,1,0.23036780050428782,29
1888,3,5888,1405,4483,0,0,0,1.0,1,1.0,1,1.0,1,0.21203938519614,31
1889,1,5889,1405,4484,0,0,0,1.0,1,1.0,1,1.0,1,0.2299718223636713,31
1890,1,5890,1406,4484,0,0,0,1.0,1,1.0,1,1.0,1,0.24698452293972598,31
1891,1,5891,1406,4485,0,0,0,1.0,1,1.0,1,1.0,1,0.24405801852760473,32
1892,0,5891,1406,4485,0,0,0,1.0,1,1.0,1,1.0,1,0.24405801852760473,32
1893,1,5892,1406,4486,0,0,0,1.0,1,1.0,1,1.0,1,0.20902705587042494,32
1894,1,5893,1406,4487,0,0,0,1.0,1,1.0,1,1.0,1,0.18908776172738886,33
1895,1,5894,1406,4488,0,0,0,1.0,1,1.0,1,1.0,1,0.19732923464721014,35
1896,0,5894,1406,4488,0,0,0,1.0,1,1.0,1,1.0,1,0.2071553743791375,34
1897,0,5894,1406,4488,0,0,0,1.0,1,1.0,1,1.0,1,0.2071553743791375,34
1898,0,5894,1406,4488,0,0,0,1.0,1,1.0,1,1.0,1,0.2071553743791375,34
1899,0,5894,1406,4488,0,0,0,1.0,1,1.0,1,1.0,1,0.2071553743791375,34
1900,0,5894,1406,4488,0,0,0,1.0,1,1.0,1,1.0,1,0.2289167665528586,35
1901,0,5894,1406,4488,0,0,0,1.0,1,1.0,1,1.0,1,0.2289167665528586,35
1902,3,5897,1407,4490,0,0,0,1.0,1,1.0,1,1.0,1,0.2612832797771459,35
1903,1,5898,1407,4491,0,0,0,1.0,1,1.0,1,1.0,1,0.24145203261969808,35
1904,0,5898,1407,4491,0,0,0,1.0,1,1.0,1,1.0,1,0.24145203261969808,35
1905,1,5899,1407,4492,0,0,0,1.0,1,1.0,1,1.0,1,0.20732963006047953,37
1906,2,5901,1407,4494,0,0,0,1.0,1,1.0,1,1.0,1,0.17562420186173708,37
1907,2,5903,1407,4496,0,0,0,1.0,1,1.0,1,1.0,1,0.1649566099918957,39
1908,0,5903,1407,4496,0,0,0,1.0,1,1.0,1,1.0,1,0.1649566099918957,39
1909,3,5906,1408,4498,0,0,0,1.0,1,1.0,1,1.0,1,0.20263913161412914,41
1910,2,5908,1408,4500,0,0,0,1.0,1,1.0,1,1.0,1,0.16010341284364388,41
1911,0,5908,1408,4500,0,0,0,1.0,1,1.0,1,1.0,1,0.1843461623313822,40
1912,3,5911,1409,4502,0,0,0,1.0,1,1.0,1,1.0,1,0.1816996449633194,39
1913,1,5912,1409,4503,0,0,0,1.0,1,1.0,1,1.0,1,0.1811602382459488,40
1914,2,5914,1410,4504,0,0,0,1.0,1,1.0,1,1.0,1,0.20119418874933062,41
1915,5,5919,1411,4508,0,0,0,1.0,1,1.0,1,1.0,1,0.2422469247801217,42
1916,8,5927,1413,4514,0,0,0,1.0,1,1.0,1,1.0,1,0.24937326610001015,42
1917,5,5932,1414,4518,0,0,0,1.0,1,1.0,1,1.0,1,0.258320015659257,41
1918,3,5935,1415,4520,0,0,0,1.0,1,1.0,1,1.0,1,0.2141876865810283,38
1919,0,5935,1415,4520,0,0,0,1.0,1,1.0,1,1.0,1,0.25558673436604173,38
1920,1,5936,1415,4521,0,0,0,1.0,1,1.0,1,1.0,1,0.28459680587288066,38
1921,4,5940,1415,4525,0,0,0,1.0,1,1.0,1,1.0,1,0.19391482482269162,39
1922,4,5944,1416,4528,0,0,0,1.0,1,1.0,1,1.0,1,0.16591150506036179,40
1923,2,5946,1416,4530,0,0,0,1.0,1,1.0,1,1.0,1,0.14211860669093673,41
1924,5,5951,1418,4533,0,0,0,1.0,1,1.0,1,1.0,1,0.222363894560559,41
1925,4,5955,1418,4537,0,0,0,1.0,1,1.0,1,1.0,1,0.18951354112744578,41
1926,2,5957,1418,4539,0,0,0,1.0,1,1.0,1,1.0,1,0.1906545099277237,41
1927,3,5960,1418,4542,0,0,0,1.0,1,1.0,1,1.0,1,0.2045553397025818,41
1928,5,5965,1419,4546,0,0,0,1.0,1,1.0,1,1.0,1,0.19726481067022442,42
1929,2,5967,1419,4548,0,0,0,1.0,1,1.0,1,1.0,1,0.18831285607173712,41
1930,4,5971,1419,4552,0,0,0,1.0,1,1.0,1,1.0,1,0.18831285607173712,41
1931,4,5975,1419,4556,0,0,0,1.0,1,1.0,1,1.0,1,0.18831285607173712,41
1932,4,5979,1419,4560,0,0,0,1.0,1,1.0,1,1.0,1,0.18831285607173712,41
1933,4,5983,1420,4563,0,0,0,1.0,1,1.0,1,1.0,1,0.24069845868088893,43
1934,6,5989,1420,4569,0,0,0,1.0,1,1.0,1,1.0,1,0.2531282993138008,44
1935,4,5993,1420,4573,0,0,0,1.0,1,1.0,1,1.0,1,0.1964640516054462,45
1936,6,5999,1420,4579,0,0,0,1.0,1,1.0,1,1.0,1,0.1184781418505697,48
1937,1,6000,1421,4579,0,0,0,1.0,1,1.0,1,1.0,1,0.15546970488409637,48
1938,3,6003,1422,4581,0,0,0,1.0,1,1.0,1,1.0,1,0.14032712166389902,48
1939,3,6006,1422,4584,0,0,0,1.0,1,1.0,1,1.0,1,0.12337602858519664,48
1940,0,6006,1422,4584,0,0,0,1.0,1,1.0,1,1.0,1,0.12337602858519664,48
1941,0,6006,1422,4584,0,0,0,1.0,1,1.0,1,1.0,1,0.12337602858519664,48
1942,4,6010,1423,4587,0,0,0,1.0,1,1.0,1,1.0,1,0.20160486003548855,49
1943,2,6012,1423,4589,0,0,0,1.0,1,1.0,1,1.0,1,0.19166894474907195,48
1944,6,6018,1427,4591,0,0,0,1.0,1,1.0,1,1.0,1,0.24926816297454762,47
1945,6,6024,1429,4595,0,0,0,1.0,1,1.0,1,1.0,1,0.22703626728003007,46
1946,2,6026,1430,4596,0,0,0,1.0,1,1.0,1,1.0,1,0.2237178794916789,46
1947,5,6031,1433,4598,0,0,0,1.0,1,1.0,1,1.0,1,0.28674551157839273,45
1948,1,6032,1433,4599,0,0,0,1.0,1,1.0,1,1.0,1,0.2792939574049001,46
1949,3,6035,1436,4599,0,0,0,1.0,1,1.0,1,1.0,1,0.33910456262761385,42
1950,2,6037,1436,4601,0,0,0,1.0,1,1.0,1,1.0,1,0.2825737366980586,40
1951,6,6043,1438,4605,0,0,0,1.0,1,1.0,1,1.0,1,0.2209231059870025,39
1952,1,6044,1439,4605,0,0,0,1.0,1,1.0,1,1.0,1,0.22461366306466826,35
1953,2,6046,1441,4605,0,0,0,1.0,1,1.0,1,1.0,1,0.17890977946006822,36
1954,2,6048,1442,4606,0,0,0,1.0,1,1.0,1,1.0,1,0.19099330574711443,34
1955,1,6049,1443,4606,0,0,0,1.0,1,1.0,1,1.0,1,0.20683489256689763,35
1956,4,6053,1445,4608,0,0,0,1.0,1,1.0,1,1.0,1,0.22064175772127334,37
1957,0,6053,1445,4608,0,0,0,1.0,1,1.0,1,1.0,1,0.22064175772127334,37
1958,1,6054,1445,4609,0,0,0,1.0,1,1.0,1,1.0,1,0.20844428190105274,39
1959,1,6055,1446,4609,0,0,0,1.0,1,1.0,1,1.0,1,0.23510024671569807,41
1960,2,6057,1447,4610,0,0,0,1.0,1,1.0,1,1.0,1,0.25021624804838627,40
1961,5,6062,1448,4614,0,0,0,1.0,1,1.0,1,1.0,1,0.22057519869623024,41
1962,2,6064,1449,4615,0,0,0,1.0,1,1.0,1,1.0,1,0.21593953012646327,40
1963,1,6065,1449,4616,0,0,0,1.0,1,1.0,1,1.0,1,0.22027932808018946,41
1964,0,6065,1449,4616,0,0,0,1.0,1,1.0,1,1.0,1,0.23208888612451617,40
1965,2,6067,1449,4618,0,0,0,1.0,1,1.0,1,1.0,1,0.18684749138174386,41
1966,3,6070,1449,4621,0,0,0,1.0,1,1.0,1,1.0,1,0.1424611216867169,41
1967,3,6073,1450,4623,0,0,0,1.0,1,1.0,1,1.0,1,0.12806100928172456,42
1968,1,6074,1450,4624,0,0,0,1.0,1,1.0,1,1.0,1,0.1494977620144058,42
1969,4,6078,1451,4627,0,0,0,1.0,1,1.0,1,1.0,1,0.14838750376397694,43
1970,0,6078,1451,4627,0,0,0,1.0,1,1.0,1,1.0,1,0.17430802494553932,42
1971,1,6079,1451,4628,0,0,0,1.0,1,1.0,1,1.0,1,0.17744588642601603,42
1972,1,6080,1451,4629,0,0,0,1.0,1,1.0,1,1.0,1,0.1801690029065236,42
1973,2,6082,1451,4631,0,0,0,1.0,1,1.0,1,1.0,1,0.1662124919059776,43
1974,3,6085,1452,4633,0,0,0,1.0,1,1.0,1,1.0,1,0.1968155089667059,43
1975,1,6086,1452,4634,0,0,0,1.0,1,1.0,1,1.0,1,0.20665284239428444,43
1976,1,6087,1452,4635,0,0,0,1.0,1,1.0,1,1.0,1,0.1961901199401945,43
1977,7,6094,1452,4642,0,0,0,1.0,1,1.0,1,1.0,1,0.20449689836504484,48
1978,3,6097,1453,4644,0,0,0,1.0,1,1.0,1,1.0,1,0.21542638930148988,48
1979,4,6101,1454,4647,0,0,0,1.0,1,1.0,1,1.0,1,0.21804927676063807,49
1980,2,6103,1454,4649,0,0,0,1.0,1,1.0,1,1.0,1,0.2219924322898726,50
1981,6,6109,1454,4655,0,0,0,1.0,1,1.0,1,1.0,1,0.14174566572807823,50
1982,0,6109,1454,4655,0,0,0,1.0,1,1.0,1,1.0,1,0.14174566572807823,50
1983,1,6110,1455,4655,0,0,0,1.0,1,1.0,1,1.0,1,0.13222646208559863,49
1984,1,6111,1456,4655,0,0,0,1.0,1,1.0,1,1.0,1,0.15630515004058448,48
1985,0,6111,1456,4655,0,0,0,1.0,1,1.0,1,1.0,1,0.15047418860888664,46
1986,0,6111,1456,4655,0,0,0,1.0,1,1.0,1,1.0,1,0.15047418860888664,46
1987,3,6114,1459,4655,0,0,0,1.0,1,1.0,1,1.0,1,0.13899104963276476,42
1988,1,6115,1459,4656,0,0,0,1.0,1,1.0,1,1.0,1,0.15008169623291134,40
1989,4,6119,1463,4656,0,0,0,1.0,1,1.0,1,1.0,1,0.16266094436703263,38
1990,1,6120,1463,4657,0,0,0,1.0,1,1.0,1,1.0,1,0.14924756929953273,38
1991,0,6120,1463,4657,0,0,0,1.0,1,1.0,1,1.0,1,0.14924756929953273,38
1992,3,6123,1464,4659,0,0,0,1.0,1,1.0,1,1.0,1,0.13975181067316908,39
1993,4,6127,1467,4660,0,0,0,1.0,1,1.0,1,1.0,1,0.23219040032736263,38
1994,2,6129,1469,4660,0,0,0,1.0,1,1.0,1,1.0,1,0.2479479024233774,37
1995,3,6132,1471,4661,0,0,0,1.0,1,1.0,1,1.0,1,0.28622601591383123,37
1996,5,6137,1471,4666,0,0,0,1.0,1,1.0,1,1.0,1,0.2001960647984276,37
1997,3,6140,1473,4667,0,0,0,1.0,1,1.0,1,1.0,1,0.22278996558392533,35
1998,4,6144,1474,4670,0,0,0,1.0,1,1.0,1,1.0,1,0.2535710977346847,34
1999,2,6146,1475,4671,0,0,0,1.0,1,1.0,1,1.0,1,0.24449515927610013,35
2000,6,6152,1475,4677,0,0,0,1.0,1,1.0,1,1.0,1,0.23625530427178965,34
2001,6,6158,1475,4683,0,0,0,1.0,1,1.0,1,1.0,1,0.21152905839543654,35
2002,5,6163,1476,4687,0,0,0,1.0,1,1.0,1,1.0,1,0.26788657082806416,36
2003,5,6168,1476,4692,0,0,0,1.0,1,1.0,1,1.0,1,0.26822259325822595,37
2004,9,6177,1478,4699,0,0,0,1.0,1,1.0,1,1.0,1,0.2613270224534606,38
2005,6,6183,1478,4705,0,0,0,1.0,1,1.0,1,1.0,1,0.22164549701561176,38
2006,3,6186,1478,4708,0,0,0,1.0,1,1.0,1,1.0,1,0.23670668059937816,38
2007,1,6187,1478,4709,0,0,0,1.0,1,1.0,1,1.0,1,0.22625505938465135,40
2008,4,6191,1478,4713,0,0,0,1.0,1,1.0,1,1.0,1,0.23367744776367502,40
2009,3,6194,1478,4716,0,0,0,1.0,1,1.0,1,1.0,1,0.2636407114321207,41
2010,4,6198,1478,4720,0,0,0,1.0,1,1.0,1,1.0,1,0.2636407114321207,41
2011,6,6204,1478,4726,0,0,0,1.0,1,1.0,1,1.0,1,0.18036894083304944,41
2012,0,6204,1478,4726,0,0,0,1.0,1,1.0,1,1.0,1,0.18036894083304944,41
2013,1,6205,1478,4727,0,0,0,1.0,1,1.0,1,1.0,1,0.1725916817730501,43
2014,3,6208,1478,4730,0,0,0,1.0,1,1.0,1,1.0,1,0.15536670260077007,43
2015,1,6209,1479,4730,0,0,0,1.0,1,1.0,1,1.0,1,0.1588790067185885,43
2016,3,6212,1479,4733,0,0,0,1.0,1,1.0,1,1.0,1,0.12675463304728363,44
2017,4,6216,1479,4737,0,0,0,1.0,1,1.0,1,1.0,1,0.12359902270650294,45
2018,3,6219,1479,4740,0,0,0,1.0,1,1.0,1,1.0,1,0.11417088751669222,46
2019,2,6221,1479,4742,0,0,0,1.0,1,1.0,1,1.0,1,0.1222567517765933,47
2020,1,6222,1479,4743,0,0,0,1.0,1,1.0,1,1.0,1,0.11769856931800056,47
2021,2,6224,1480,4744,0,0,0,1.0,1,1.0,1,1.0,1,0.10791245613351887,47
2022,4,6228,1480,4748,0,0,0,1.0,1,1.0,1,1.0,1,0.0926047985568282,48
2023,2,6230,1482,4748,0,0,0,1.0,1,1.0,1,1.0,1,0.1080310111708353,48
2024,4,6234,1484,4750,0,0,0,1.0,1,1.0,1,1.0,1,0.11122422534329332,45
2025,2,6236,1485,4751,0,0,0,1.0,1,1.0,1,1.0,1,0.18884534474980894,42
2026,7,6243,1490,4753,0,0,0,1.0,1,1.0,1,1.0,1,0.19715868429597644,44
2027,3,6246,1491,4755,0,0,0,1.0,1,1.0,1,1.0,1,0.2535143494525104,40
2028,5,6251,1492,4759,0,0,0,1.0,1,1.0,1,1.0,1,0.19929603031792922,39
2029,2,6253,1493,4760,0,0,0,1.0,1,1.0,1,1.0,1,0.1935849056363727,37
2030,0,6253,1493,4760,0,0,0,1.0,1,1.0,1,1.0,1,0.18760986637932575,34
2031,3,6256,1495,4761,0,0,0,1.0,1,1.0,1,1.0,1,0.14932973113770598,35
2032,2,6258,1496,4762,0,0,0,1.0,1,1.0,1,1.0,1,0.2847614413010228,34
2033,7,6265,1500,4765,0,0,0,1.0,1,1.0,1,1.0,1,0.2714238570250254,36
2034,2,6267,1500,4767,0,0,0,1.0,1,1.0,1,1.0,1,0.3027814034796885,34
2035,2,6269,1501,4768,0,0,0,1.0,1,1.0,1,1.0,1,0.2706266171029155,35
2036,2,6271,1502,4769,0,0,0,1.0,1,1.0,1,1.0,1,0.3164979686713031,34
2037,2,6273,1502,4771,0,0,0,1.0,1,1.0,1,1.0,1,0.2972871175963814,35
2038,2,6275,1502,4773,0,0,0,1.0,1,1.0,1,1.0,1,0.2674013823703387,36
2039,2,6277,1503,4774,0,0,0,1.0,1,1.0,1,1.0,1,0.21504453448588418,38
2040,2,6279,1503,4776,0,0,0,1.0,1,1.0,1,1.0,1,0.21504453448588418,38
2041,4,6283,1503,4780,0,0,0,1.0,1,1.0,1,1.0,1,0.1562478024064049,39
2042,1,6284,1503,4781,0,0,0,1.0,1,1.0,1,1.0,1,0.14842360927377074,39
2043,1,6285,1503,4782,0,0,0,1.0,1,1.0,1,1.0,1,0.1524115818085061,39
2044,1,6286,1503,4783,0,0,0,1.0,1,1.0,1,1.0,1,0.1517907447785755,39
2045,4,6290,1505,4785,0,0,0,1.0,1,1.0,1,1.0,1,0.11944513097236693,41
2046,1,6291,1505,4786,0,0,0,1.0,1,1.0,1,1.0,1,0.12852877197222365,42
2047,2,6293,1505,4788,0,0,0,1.0,1,1.0,1,1.0,1,0.11452107042716526,42
2048,3,6296,1505,4791,0,0,0,1.0,1,1.0,1,1.0,1,0.11498784361597515,43
2049,3,6299,1506,4793,0,0,0,1.0,1,1.0,1,1.0,1,0.12873138294471284,44
2050,1,6300,1506,4794,0,0,0,1.0,1,1.0,1,1.0,1,0.14196836239633753,44
2051,4,6304,1506,4798,0,0,0,1.0,1,1.0,1,1.0,1,0.1199416087680125,45
2052,2,6306,1506,4800,0,0,0,1.0,1,1.0,1,1.0,1,0.16604441919689492,45
2053,4,6310,1506,4804,0,0,0,1.0,1,1.0,1,1.0,1,0.16032026669006913,45
2054,8,6318,1506,4812,0,0,0,1.0,1,1.0,1,1.0,1,0.11904228402244817,46
2055,2,6320,1506,4814,0,0,0,1.0,1,1.0,1,1.0,1,0.11973169280282352,46
2056,6,6326,1508,4818,0,0,0,1.0,1,1.0,1,1.0,1,0.12851579675603705,46
2057,4,6330,1509,4821,0,0,0,1.0,1,1.0,1,1.0,1,0.1321214476829062,47
2058,3,6333,1511,4822,0,0,0,1.0,1,1.0,1,1.0,1,0.1610800233187211,47
2059,1,6334,1511,4823,0,0,0,1.0,1,1.0,1,1.0,1,0.17143739187491358,48
2060,4,6338,1512,4826,0,0,0,1.0,1,1.0,1,1.0,1,0.1844246924567178,50
2061,7,6345,1512,4833,0,0,0,1.0,1,1.0,1,1.0,1,0.13737166989450414,51
2062,1,6346,1512,4834,0,0,0,1.0,1,1.0,1,1.0,1,0.10969399070911716,49
2063,2,6348,1513,4835,0,0,0,1.0,1,1.0,1,1.0,1,0.09288393840853491,48
2064,2,6350,1514,4836,0,0,0,1.0,1,1.0,1,1.0,1,0.11925476037277731,45
2065,0,6350,1514,4836,0,0,0,1.0,1,1.0,1,1.0,1,0.12220402013067103,44
2066,1,6351,1514,4837,0,0,0,1.0,1,1.0,1,1.0,1,0.18021273154729062,42
2067,0,6351,1514,4837,0,0,0,1.0,1,1.0,1,1.0,1,0.20375868172722178,41
2068,2,6353,1516,4837,0,0,0,1.0,1,1.0,1,1.0,1,0.1711103372489514,40
2069,1,6354,1517,4837,0,0,0,1.0,1,1.0,1,1.0,1,0.1701969623332648,40
2070,1,6355,1518,4837,0,0,0,1.0,1,1.0,1,1.0,1,0.17022720469701666,40
2071,4,6359,1520,4839,0,0,0,1.0,1,1.0,1,1.0,1,0.144314902388416,40
2072,1,6360,1520,4840,0,0,0,1.0,1,1.0,1,1.0,1,0.12958864025803704,41
2073,2,6362,1522,4840,0,0,0,1.0,1,1.0,1,1.0,1,0.13209036145355682,41
2074,0,6362,1522,4840,0,0,0,1.0,1,1.0,1,1.0,1,0.13246916788341667,41
2075,0,6362,1522,4840,0,0,0,1.0,1,1.0,1,1.0,1,0.13246916788341667,41
2076,3,6365,1523,4842,0,0,0,1.0,1,1.0,1,1.0,1,0.13976400015748602,41
2077,1,6366,1523,4843,0,0,0,1.0,1,1.0,1,1.0,1,0.099271820746374,40
2078,2,6368,1525,4843,0,0,0,1.0,1,1.0,1,1.0,1,0.1208960472112922,40
2079,0,6368,1525,4843,0,0,0,1.0,1,1.0,1,1.0,1,0.12160701915912811,39
2080,2,6370,1526,4844,0,0,0,1.0,1,1.0,1,1.0,1,0.11128938147239115,38
2081,1,6371,1527,4844,0,0,0,1.0,1,1.0,1,1.0,1,0.1338407816257006,40
2082,4,6375,1529,4846,0,0,0,1.0,1,1.0,1,1.0,1,0.206324669668407,41
2083,1,6376,1529,4847,0,0,0,1.0,1,1.0,1,1.0,1,0.2162756929838978,40
2084,5,6381,1531,4850,0,0,0,1.0,1,1.0,1,1.0,1,0.263325890692182,42
2085,5,6386,1532,4854,0,0,0,1.0,1,1.0,1,1.0,1,0.2883013051285168,42
2086,9,6395,1533,4862,0,0,0,1.0,1,1.0,1,1.0,1,0.10294207706994889,43
2087,3,6398,1534,4864,0,0,0,1.0,1,1.0,1,1.0,1,0.13904999801627493,45
2088,3,6401,1535,4866,0,0,0,1.0,1,1.0,1,1.0,1,0.14195028992083555,46
2089,5,6406,1535,4871,0,0,0,1.0,1,1.0,1,1.0,1,0.11608998701091953,47
2090,5,6411,1536,4875,0,0,0,1.0,1,1.0,1,1.0,1,0.1935582068351813,49
2091,6,6417,1536,4881,0,0,0,1.0,1,1.0,1,1.0,1,0.16724329824300704,49
2092,9,6426,1536,4890,0,0,0,1.0,1,1.0,1,1.0,1,0.15811186410576897,49
2093,5,6431,1537,4894,0,0,0,1.0,1,1.0,1,1.0,1,0.1696504564219085,49
2094,4,6435,1537,4898,0,0,0,1.0,1,1.0,1,1.0,1,0.15324092192517821,49
2095,3,6438,1537,4901,0,0,0,1.0,1,1.0,1,1.0,1,0.1711776621470869,49
2096,7,6445,1537,4908,0,0,0,1.0,1,1.0,1,1.0,1,0.14887532937411016,51
2097,4,6449,1537,4912,0,0,0,1.0,1,1.0,1,1.0,1,0.14887532937411016,51
2098,5,6454,1537,4917,0,0,0,1.0,1,1.0,1,1.0,1,0.13484597706843363,52
2099,4,6458,1537,4921,0,0,0,1.0,1,1.0,1,1.0,1,0.15624846942945267,51
2100,7,6465,1537,4928,0,0,0,1.0,1,1.0,1,1.0,1,0.14176228248645642,51
2101,3,6468,1537,4931,0,0,0,1.0,1,1.0,1,1.0,1,0.13763353908000037,48
2102,3,6471,1539,4932,0,0,0,1.0,1,1.0,1,1.0,1,0.14475845139743188,49
2103,5,6476,1541,4935,0,0,0,1.0,1,1.0,1,1.0,1,0.16429340274372053,48
2104,1,6477,1542,4935,0,0,0,1.0,1,1.0,1,1.0,1,0.20735604248680528,43
2105,1,6478,1543,4935,0,0,0,1.0,1,1.0,1,1.0,1,0.2203333328539232,42
2106,3,6481,1545,4936,0,0,0,1.0,1,1.0,1,1.0,1,0.2319422877311998,40
2107,2,6483,1546,4937,0,0,0,1.0,1,1.0,1,1.0,1,0.2346242368792829,39
2108,5,6488,1549,4939,0,0,0,1.0,1,1.0,1,1.0,1,0.23149822364418382,38
2109,3,6491,1550,4941,0,0,0,1.0,1,1.0,1,1.0,1,0.2471859062589104,37
2110,3,6494,1552,4942,0,0,0,1.0,1,1.0,1,1.0,1,0.29472232996232967,38
2111,2,6496,1553,4943,0,0,0,1.0,1,1.0,1,1.0,1,0.3072620767786838,37
2112,2,6498,1554,4944,0,0,0,1.0,1,1.0,1,1.0,1,0.2982547254962582,36
2113,3,6501,1555,4946,0,0,0,1.0,1,1.0,1,1.0,1,0.29998700482075763,36
2114,2,6503,1555,4948,0,0,0,1.0,1,1.0,1,1.0,1,0.2836823666419146,36
2115,1,6504,1555,4949,0,0,0,1.0,1,1.0,1,1.0,1,0.2885023076285269,35
2116,7,6511,1556,4955,0,0,0,1.0,1,1.0,1,1.0,1,0.17296081772062832,37
2117,2,6513,1556,4957,0,0,0,1.0,1,1.0,1,1.0,1,0.12454589137160507,38
2118,1,6514,1556,4958,0,0,0,1.0,1,1.0,1,1.0,1,0.15403094657936645,40
2119,1,6515,1556,4959,0,0,0,1.0,1,1.0,1,1.0,1,0.14608581454064987,40
2120,0,6515,1556,4959,0,0,0,1.0,1,1.0,1,1.0,1,0.15483152375815468,41
2121,0,6515,1556,4959,0,0,0,1.0,1,1.0,1,1.0,1,0.15483152375815468,41
2122,1,6516,1556,4960,0,0,0,1.0,1,1.0,1,1.0,1,0.1496288442401918,42
2123,1,6517,1556,4961,0,0,0,1.0,1,1.0,1,1.0,1,0.14322576277572382,43
2124,1,6518,1556,4962,0,0,0,1.0,1,1.0,1,1.0,1,0.15931492905740152,41
2125,2,6520,1556,4964,0,0,0,1.0,1,1.0,1,1.0,1,0.15931492905740152,41
2126,1,6521,1556,4965,0,0,0,1.0,1,1.0,1,1.0,1,0.19526279175011513,40
2127,1,6522,1556,4966,0,0,0,1.0,1,1.0,1,1.0,1,0.18633172800988226,40
2128,2,6524,1556,4968,0,0,0,1.0,1,1.0,1,1.0,1,0.21237589394929773,41
2129,1,6525,1556,4969,0,0,0,1.0,1,1.0,1,1.0,1,0.18291412552042144,42
2130,3,6528,1556,4972,0,0,0,1.0,1,1.0,1,1.0,1,0.22659100995243336,45
2131,5,6533,1556,4977,0,0,0,1.0,1,1.0,1,1.0,1,0.17537328758724458,45
2132,1,6534,1556,4978,0,0,0,1.0,1,1.0,1,1.0,1,0.15325698267156565,46
2133,4,6538,1558,4980,0,0,0,1.0,1,1.0,1,1.0,1,0.15337618956348872,46
2134,4,6542,1558,4984,0,0,0,1.0,1,1.0,1,1.0,1,0.1238429103194238,47
2135,5,6547,1558,4989,0,0,0,1.0,1,1.0,1,1.0,1,0.08788957123458026,47
2136,2,6549,1558,4991,0,0,0,1.0,1,1.0,1,1.0,1,0.08011733039759603,47
2137,5,6554,1561,4993,0,0,0,1.0,1,1.0,1,1.0,1,0.08420157665161193,49
2138,4,6558,1562,4996,0,0,0,1.0,1,1.0,1,1.0,1,0.12872776715640769,49
2139,5,6563,1563,5000,0,0,0,1.0,1,1.0,1,1.0,1,0.15915572250974477,47
2140,4,6567,1565,5002,0,0,0,1.0,1,1.0,1,1.0,1,0.18745275798280464,48
2141,3,6570,1566,5004,0,0,0,1.0,1,1.0,1,1.0,1,0.1585126134996526,47
2142,0,6570,1566,5004,0,0,0,1.0,1,1.0,1,1.0,1,0.1585126134996526,47
2143,4,6574,1566,5008,0,0,0,1.0,1,1.0,1,1.0,1,0.1477782532557214,48
2144,7,6581,1569,5012,0,0,0,1.0,1,1.0,1,1.0,1,0.18653371772603464,48
2145,10,6591,1571,5020,0,0,0,1.0,1,1.0,1,1.0,1,0.16630045156325457,46
2146,4,6595,1571,5024,0,0,0,1.0,1,1.0,1,1.0,1,0.09680835524966044,47
2147,2,6597,1573,5024,0,0,0,1.0,1,1.0,1,1.0,1,0.13302904348983405,48
2148,0,6597,1573,5024,0,0,0,1.0,1,1.0,1,1.0,1,0.10713736286509822,46
2149,2,6599,1575,5024,0,0,0,1.0,1,1.0,1,1.0,1,0.07748817345892278,46
2150,4,6603,1576,5027,0,0,0,1.0,1,1.0,1,1.0,1,0.10722457075913248,46
2151,2,6605,1577,5028,0,0,0,1.0,1,1.0,1,1.0,1,0.14763824969074507,44
2152,5,6610,1578,5032,0,0,0,1.0,1,1.0,1,1.0,1,0.19350405499441178,45
2153,4,6614,1579,5035,0,0,0,1.0,1,1.0,1,1.0,1,0.18333109622331953,48
2154,9,6623,1581,5042,0,0,0,1.0,1,1.0,1,1.0,1,0.21339828665388452,47
2155,5,6628,1581,5047,0,0,0,1.0,1,1.0,1,1.0,1,0.23748693226747827,48
2156,4,6632,1582,5050,0,0,0,1.0,1,1.0,1,1.0,1,0.216042481041843,45
2157,3,6635,1582,5053,0,0,0,1.0,1,1.0,1,1.0,1,0.2177518974416263,43
2158,3,6638,1582,5056,0,0,0,1.0,1,1.0,1,1.0,1,0.20363035600901458,43
2159,5,6643,1583,5060,0,0,0,1.0,1,1.0,1,1.0,1,0.21867411274034637,43
2160,1,6644,1583,5061,0,0,0,1.0,1,1.0,1,1.0,1,0.19092578876031488,41
2161,6,6650,1584,5066,0,0,0,1.0,1,1.0,1,1.0,1,0.09024009065736513,41
2162,1,6651,1585,5066,0,0,0,1.0,1,1.0,1,1.0,1,0.0929883282287675,42
2163,4,6655,1587,5068,0,0,0,1.0,1,1.0,1,1.0,1,0.10674631097519062,43
2164,1,6656,1588,5068,0,0,0,1.0,1,1.0,1,1.0,1,0.12500090132876435,44
2165,0,6656,1588,5068,0,0,0,1.0,1,1.0,1,1.0,1,0.12500090132876435,44
2166,3,6659,1588,5071,0,0,0,1.0,1,1.0,1,1.0,1,0.12131958018700748,46
2167,0,6659,1588,5071,0,0,0,1.0,1,1.0,1,1.0,1,0.12131958018700748,46
2168,0,6659,1588,5071,0,0,0,1.0,1,1.0,1,1.0,1,0.12148260820042867,45
2169,4,6663,1588,5075,0,0,0,1.0,1,1.0,1,1.0,1,0.11035873820182796,49
2170,1,6664,1588,5076,0,0,0,1.0,1,1.0,1,1.0,1,0.09043508405540245,49
2171,1,6665,1588,5077,0,0,0,1.0,1,1.0,1,1.0,1,0.08202542514837871,51
2172,4,6669,1588,5081,0,0,0,1.0,1,1.0,1,1.0,1,0.12442134194167624,52
2173,3,6672,1589,5083,0,0,0,1.0,1,1.0,1,1.0,1,0.1377038533028991,52
2174,7,6679,1591,5088,0,0,0,1.0,1,1.0,1,1.0,1,0.156751888344318,52
2175,7,6686,1591,5095,0,0,0,1.0,1,1.0,1,1.0,1,0.15141004468230848,53
2176,3,6689,1591,5098,0,0,0,1.0,1,1.0,1,1.0,1,0.07048878811097509,54
2177,4,6693,1593,5100,0,0,0,1.0,1,1.0,1,1.0,1,0.08551025377879037,55
2178,0,6693,1593,5100,0,0,0,1.0,1,1.0,1,1.0,1,0.07247279470665809,54
2179,2,6695,1595,5100,0,0,0,1.0,1,1.0,1,1.0,1,0.10851093292530421,52
2180,0,6695,1595,5100,0,0,0,1.0,1,1.0,1,1.0,1,0.11128767259766698,51
2181,1,6696,1595,5101,0,0,0,1.0,1,1.0,1,1.0,1,0.1149310367988812,49
2182,4,6700,1598,5102,0,0,0,1.0,1,1.0,1,1.0,1,0.1561843245095798,49
2183,4,6704,1600,5104,0,0,0,1.0,1,1.0,1,1.0,1,0.15065145994256068,46
2184,5,6709,1602,5107,0,0,0,1.0,1,1.0,1,1.0,1,0.1323025375911358,45
2185,4,6713,1606,5107,0,0,0,1.0,1,1.0,1,1.0,1,0.18095541419865926,44
2186,1,6714,1607,5107,0,0,0,1.0,1,1.0,1,1.0,1,0.2436085990345519,42
2187,3,6717,1609,5108,0,0,0,1.0,1,1.0,1,1.0,1,0.2137651726747185,40
2188,6,6723,1614,5109,0,0,0,1.0,1,1.0,1,1.0,1,0.1774571201548938,38
2189,2,6725,1615,5110,0,0,0,1.0,1,1.0,1,1.0,1,0.2185741218176993,36
2190,1,6726,1616,5110,0,0,0,1.0,1,1.0,1,1.0,1,0.27390341765679976,34
2191,6,6732,1617,5115,0,0,0,1.0,1,1.0,1,1.0,1,0.12958103094898926,34
2192,1,6733,1618,5115,0,0,0,1.0,1,1.0,1,1.0,1,0.18138798700719883,33
2193,1,6734,1618,5116,0,0,0,1.0,1,1.0,1,1.0,1,0.14665394719158667,32
2194,0,6734,1618,5116,0,0,0,1.0,1,1.0,1,1.0,1,0.14665394719158667,32
2195,0,6734,1618,5116,0,0,0,1.0,1,1.0,1,1.0,1,0.16950871477956977,31
2196,5,6739,1620,5119,0,0,0,1.0,1,1.0,1,1.0,1,0.1822487421385194,32
2197,1,6740,1620,5120,0,0,0,1.0,1,1.0,1,1.0,1,0.20299340076081795,31
2198,0,6740,1620,5120,0,0,0,1.0,1,1.0,1,1.0,1,0.20299340076081795,31
2199,1,6741,1621,5120,0,0,0,1.0,1,1.0,1,1.0,1,0.21689717144497483,32
2200,3,6744,1621,5123,0,0,0,1.0,1,1.0,1,1.0,1,0.20566532765795426,35
2201,2,6746,1621,5125,0,0,0,1.0,1,1.0,1,1.0,1,0.18982858820111978,36
2202,4,6750,1623,5127,0,0,0,1.0,1,1.0,1,1.0,1,0.20258637870971474,36
2203,5,6755,1623,5132,0,0,0,1.0,1,1.0,1,1.0,1,0.20589628294678133,37
2204,7,6762,1624,5138,0,0,0,1.0,1,1.0,1,1.0,1,0.19314763629715673,36
2205,4,6766,1626,5140,0,0,0,1.0,1,1.0,1,1.0,1,0.14108864109277933,37
2206,4,6770,1628,5142,0,0,0,1.0,1,1.0,1,1.0,1,0.15076080184723098,35
2207,1,6771,1628,5143,0,0,0,1.0,1,1.0,1,1.0,1,0.14454862930405973,37
2208,1,6772,1628,5144,0,0,0,1.0,1,1.0,1,1.0,1,0.1405466325126662,36
2209,0,6772,1628,5144,0,0,0,1.0,1,1.0,1,1.0,1,0.16141851548493077,35
2210,2,6774,1628,5146,0,0,0,1.0,1,1.0,1,1.0,1,0.18164000392234964,38
2211,2,6776,1628,5148,0,0,0,1.0,1,1.0,1,1.0,1,0.14420735901680098,37
2212,2,6778,1628,5150,0,0,0,1.0,1,1.0,1,1.0,1,0.15703663957254968,38
2213,2,6780,1629,5151,0,0,0,1.0,1,1.0,1,1.0,1,0.1580765347141277,38
2214,3,6783,1629,5154,0,0,0,1.0,1,1.0,1,1.0,1,0.1373750641151245,39
2215,2,6785,1630,5155,0,0,0,1.0,1,1.0,1,1.0,1,0.11355327499306668,39
2216,4,6789,1632,5157,0,0,0,1.0,1,1.0,1,1.0,1,0.1433298314163221,39
2217,2,6791,1634,5157,0,0,0,1.0,1,1.0,1,1.0,1,0.14336858996729174,38
2218,3,6794,1636,5158,0,0,0,1.0,1,1.0,1,1.0,1,0.1311719527721343,37
2219,3,6797,1636,5161,0,0,0,1.0,1,1.0,1,1.0,1,0.1678962344535895,36
2220,2,6799,1636,5163,0,0,0,1.0,1,1.0,1,1.0,1,0.17130807198056114,34
2221,6,6805,1637,5168,0,0,0,1.0,1,1.0,1,1.0,1,0.11002615184739271,35
2222,1,6806,1638,5168,0,0,0,1.0,1,1.0,1,1.0,1,0.12775134144893505,33
2223,2,6808,1639,5169,0,0,0,1.0,1,1.0,1,1.0,1,0.1612812876747918,34
2224,1,6809,1640,5169,0,0,0,1.0,1,1.0,1,1.0,1,0.2004746674941868,32
2225,2,6811,1642,5169,0,0,0,1.0,1,1.0,1,1.0,1,0.25615020200019684,33
2226,2,6813,1644,5169,0,0,0,1.0,1,1.0,1,1.0,1,0.23298966490080006,32
2227,2,6815,1645,5170,0,0,0,1.0,1,1.0,1,1.0,1,0.21735915913212425,31
2228,1,6816,1645,5171,0,0,0,1.0,1,1.0,1,1.0,1,0.22080734292322451,32
2229,1,6817,1645,5172,0,0,0,1.0,1,1.0,1,1.0,1,0.18566073858252438,32
2230,0,6817,1645,5172,0,0,0,1.0,1,1.0,1,1.0,1,0.21572486672685753,31
2231,0,6817,1645,5172,0,0,0,1.0,1,1.0,1,1.0,1,0.19105983719882694,32
2232,2,6819,1646,5173,0,0,0,1.0,1,1.0,1,1.0,1,0.19623119162172198,32
2233,0,6819,1646,5173,0,0,0,1.0,1,1.0,1,1.0,1,0.21261814864498974,31
2234,2,6821,1648,5173,0,0,0,1.0,1,1.0,1,1.0,1,0.2575382851974705,32
2235,4,6825,1649,5176,0,0,0,1.0,1,1.0,1,1.0,1,0.19518556752803642,31
2236,1,6826,1649,5177,0,0,0,1.0,1,1.0,1,1.0,1,0.1832474013481303,31
2237,3,6829,1652,5177,0,0,0,1.0,1,1.0,1,1.0,1,0.2657730087223397,31
2238,3,6832,1653,5179,0,0,0,1.0,1,1.0,1,1.0,1,0.23229426070897566,31
2239,2,6834,1653,5181,0,0,0,1.0,1,1.0,1,1.0,1,0.17538989302717997,31
2240,0,6834,1653,5181,0,0,0,1.0,1,1.0,1,1.0,1,0.19525653363048334,32
2241,1,6835,1654,5181,0,0,0,1.0,1,1.0,1,1.0,1,0.17339553926861884,32
2242,2,6837,1655,5182,0,0,0,1.0,1,1.0,1,1.0,1,0.15911567307147065,34
2243,3,6840,1658,5182,0,0,0,1.0,1,1.0,1,1.0,1,0.2561543933415094,34
2244,3,6843,1658,5185,0,0,0,1.0,1,1.0,1,1.0,1,0.22022865429540248,36
2245,2,6845,1658,5187,0,0,0,1.0,1,1.0,1,1.0,1,0.22022865429540248,36
2246,3,6848,1658,5190,0,0,0,1.0,1,1.0,1,1.0,1,0.22184832246963207,39
2247,4,6852,1658,5194,0,0,0,1.0,1,1.0,1,1.0,1,0.20328138241931212,40
2248,3,6855,1658,5197,0,0,0,1.0,1,1.0,1,1.0,1,0.17624267659586965,40
2249,4,6859,1658,5201,0,0,0,1.0,1,1.0,1,1.0,1,0.19279700467062116,41
2250,5,6864,1658,5206,0,0,0,1.0,1,1.0,1,1.0,1,0.1768073177697463,41
2251,3,6867,1658,5209,0,0,0,1.0,1,1.0,1,1.0,1,0.13412010784121908,42
2252,1,6868,1658,5210,0,0,0,1.0,1,1.0,1,1.0,1,0.13526956662088738,41
2253,1,6869,1658,5211,0,0,0,1.0,1,1.0,1,1.0,1,0.14173289946469844,40
2254,1,6870,1659,5211,0,0,0,1.0,1,1.0,1,1.0,1,0.18081272430204315,39
2255,1,6871,1659,5212,0,0,0,1.0,1,1.0,1,1.0,1,0.15727285644221822,39
2256,2,6873,1661,5212,0,0,0,1.0,1,1.0,1,1.0,1,0.19664091739404363,40
2257,3,6876,1662,5214,0,0,0,1.0,1,1.0,1,1.0,1,0.15493608163415423,40
2258,1,6877,1663,5214,0,0,0,1.0,1,1.0,1,1.0,1,0.1285170050652236,39
2259,1,6878,1664,5214,0,0,0,1.0,1,1.0,1,1.0,1,0.14219505727667522,41
2260,2,6880,1665,5215,0,0,0,1.0,1,1.0,1,1.0,1,0.1492851981042589,38
2261,2,6882,1667,5215,0,0,0,1.0,1,1.0,1,1.0,1,0.17600810713682993,38
2262,0,6882,1667,5215,0,0,0,1.0,1,1.0,1,1.0,1,0.18734742973596014,36
2263,2,6884,1669,5215,0,0,0,1.0,1,1.0,1,1.0,1,0.21456725949763003,35
2264,2,6886,1671,5215,0,0,0,1.0,1,1.0,1,1.0,1,0.2632686558488477,33
2265,2,6888,1671,5217,0,0,0,1.0,1,1.0,1,1.0,1,0.13064997495584915,33
2266,2,6890,1673,5217,0,0,0,1.0,1,1.0,1,1.0,1,0.17254370150041973,33
2267,3,6893,1676,5217,0,0,0,1.0,1,1.0,1,1.0,1,0.23001359609735095,33
2268,7,6900,1680,5220,0,0,0,1.0,1,1.0,1,1.0,1,0.1959306283702527,35
2269,5,6905,1684,5221,0,0,0,1.0,1,1.0,1,1.0,1,0.26252334669890737,36
2270,1,6906,1685,5221,0,0,0,1.0,1,1.0,1,1.0,1,0.25656125060707674,34
2271,6,6912,1687,5225,0,0,0,1.0,1,1.0,1,1.0,1,0.27824529207016346,34
2272,2,6914,1687,5227,0,0,0,1.0,1,1.0,1,1.0,1,0.2633372232342989,33
2273,2,6916,1687,5229,0,0,0,1.0,1,1.0,1,1.0,1,0.25496047533784777,32
2274,1,6917,1687,5230,0,0,0,1.0,1,1.0,1,1.0,1,0.24879213168672287,32
2275,8,6925,1688,5237,0,0,0,1.0,1,1.0,1,1.0,1,0.2569016865263371,32
2276,3,6928,1688,5240,0,0,0,1.0,1,1.0,1,1.0,1,0.2776677121314434,31
2277,3,6931,1688,5243,0,0,0,1.0,1,1.0,1,1.0,1,0.29954896430729777,30
2278,4,6935,1688,5247,0,0,0,1.0,1,1.0,1,1.0,1,0.2775939965677565,33
2279,4,6939,1688,5251,0,0,0,1.0,1,1.0,1,1.0,1,0.2775939965677565,33
2280,3,6942,1689,5253,0,0,0,1.0,1,1.0,1,1.0,1,0.29940727376064213,35
2281,7,6949,1689,5260,0,0,0,1.0,1,1.0,1,1.0,1,0.1458885430266156,36
2282,0,6949,1689,5260,0,0,0,1.0,1,1.0,1,1.0,1,0.1458885430266156,36
2283,1,6950,1690,5260,0,0,0,1.0,1,1.0,1,1.0,1,0.1641983709300359,36
2284,1,6951,1690,5261,0,0,0,1.0,1,1.0,1,1.0,1,0.1794680648020173,36
2285,1,6952,1690,5262,0,0,0,1.0,1,1.0,1,1.0,1,0.17778291797243298,37
2286,2,6954,1691,5263,0,0,0,1.0,1,1.0,1,1.0,1,0.15105327394792048,38
2287,1,6955,1691,5264,0,0,0,1.0,1,1.0,1,1.0,1,0.146572983753512,38
2288,6,6961,1693,5268,0,0,0,1.0,1,1.0,1,1.0,1,0.17942924455286685,40
2289,5,6966,1694,5272,0,0,0,1.0,1,1.0,1,1.0,1,0.20074631613214908,40
2290,2,6968,1694,5274,0,0,0,1.0,1,1.0,1,1.0,1,0.2146850385509121,39
2291,2,6970,1694,5276,0,0,0,1.0,1,1.0,1,1.0,1,0.18284679713757845,37
2292,2,6972,1694,5278,0,0,0,1.0,1,1.0,1,1.0,1,0.20903406595973828,35
2293,2,6974,1694,5280,0,0,0,1.0,1,1.0,1,1.0,1,0.20850487712945898,35
2294,7,6981,1695,5286,0,0,0,1.0,1,1.0,1,1.0,1,0.26605127209705426,35
2295,3,6984,1695,5289,0,0,0,1.0,1,1.0,1,1.0,1,0.28924792236690494,36
2296,4,6988,1695,5293,0,0,0,1.0,1,1.0,1,1.0,1,0.24604961602151007,34
2297,3,6991,1695,5296,0,0,0,1.0,1,1.0,1,1.0,1,0.2140210511080191,35
2298,1,6992,1696,5296,0,0,0,1.0,1,1.0,1,1.0,1,0.22656166299959563,34
2299,2,6994,1697,5297,0,0,0,1.0,1,1.0,1,1.0,1,0.22362897032785695,35
2300,0,6994,1697,5297,0,0,0,1.0,1,1.0,1,1.0,1,0.22362897032785695,35
2301,0,6994,1697,5297,0,0,0,1.0,1,1.0,1,1.0,1,0.22362897032785695,35
2302,5,6999,1699,5300,0,0,0,1.0,1,1.0,1,1.0,1,0.2515516375966925,37
2303,0,6999,1699,5300,0,0,0,1.0,1,1.0,1,1.0,1,0.20884346336491183,35
2304,4,7003,1701,5302,0,0,0,1.0,1,1.0,1,1.0,1,0.27824132043290695,36
2305,2,7005,1701,5304,0,0,0,1.0,1,1.0,1,1.0,1,0.28432139326665545,34
2306,5,7010,1702,5308,0,0,0,1.0,1,1.0,1,1.0,1,0.29390872310689287,35
2307,5,7015,1702,5313,0,0,0,1.0,1,1.0,1,1.0,1,0.29546190723262516,35
2308,4,7019,1703,5316,0,0,0,1.0,1,1.0,1,1.0,1,0.2899460794971823,35
2309,5,7024,1703,5321,0,0,0,1.0,1,1.0,1,1.0,1,0.30154502028073005,34
2310,8,7032,1703,5329,0,0,0,1.0,1,1.0,1,1.0,1,0.2514895817999402,36
2311,7,7039,1703,5336,0,0,0,1.0,1,1.0,1,1.0,1,0.12104723000879666,38
2312,2,7041,1703,5338,0,0,0,1.0,1,1.0,1,1.0,1,0.1352642700222399,39
2313,6,7047,1703,5344,0,0,0,1.0,1,1.0,1,1.0,1,0.09291678431856042,39
2314,5,7052,1703,5349,0,0,0,1.0,1,1.0,1,1.0,1,0.1645777165360015,39
2315,5,7057,1705,5352,0,0,0,1.0,1,1.0,1,1.0,1,0.19496986859699747,40
2316,2,7059,1705,5354,0,0,0,1.0,1,1.0,1,1.0,1,0.19549463596035804,40
2317,6,7065,1706,5359,0,0,0,1.0,1,1.0,1,1.0,1,0.22767767362886876,41
2318,7,7072,1706,5366,0,0,0,1.0,1,1.0,1,1.0,1,0.2406779096003038,41
2319,6,7078,1706,5372,0,0,0,1.0,1,1.0,1,1.0,1,0.2508857953294336,41
2320,11,7089,1707,5382,0,0,0,1.0,1,1.0,1,1.0,1,0.25678868827220697,42
2321,8,7097,1707,5390,0,0,0,1.0,1,1.0,1,1.0,1,0.22002173472347794,43
2322,7,7104,1707,5397,0,0,0,1.0,1,1.0,1,1.0,1,0.207859125973451,42
2323,7,7111,1708,5403,0,0,0,1.0,1,1.0,1,1.0,1,0.262040942454,43
2324,12,7123,1708,5415,0,0,0,1.0,1,1.0,1,1.0,1,0.26305211846203974,44
2325,11,7134,1709,5425,0,0,0,1.0,1,1.0,1,1.0,1,0.262751847905938,44
2326,7,7141,1709,5432,0,0,0,1.0,1,1.0,1,1.0,1,0.17822557850499324,45
2327,4,7145,1709,5436,0,0,0,1.0,1,1.0,1,1.0,1,0.1922531506147264,45
2328,3,7148,1709,5439,0,0,0,1.0,1,1.0,1,1.0,1,0.18766542067807448,46
2329,2,7150,1709,5441,0,0,0,1.0,1,1.0,1,1.0,1,0.1596820248811711,45
2330,2,7152,1709,5443,0,0,0,1.0,1,1.0,1,1.0,1,0.14435386390708055,47
2331,4,7156,1709,5447,0,0,0,1.0,1,1.0,1,1.0,1,0.16316344466342828,48
2332,2,7158,1709,5449,0,0,0,1.0,1,1.0,1,1.0,1,0.1853279269376007,48
2333,4,7162,1710,5452,0,0,0,1.0,1,1.0,1,1.0,1,0.20164074258269812,49
2334,5,7167,1711,5456,0,0,0,1.0,1,1.0,1,1.0,1,0.21770985487306285,47
2335,6,7173,1712,5461,0,0,0,1.0,1,1.0,1,1.0,1,0.22395410853506137,46
2336,2,7175,1712,5463,0,0,0,1.0,1,1.0,1,1.0,1,0.20811724033746554,46
2337,4,7179,1712,5467,0,0,0,1.0,1,1.0,1,1.0,1,0.17544466908817144,45
2338,2,7181,1712,5469,0,0,0,1.0,1,1.0,1,1.0,1,0.165416071558645,44
2339,5,7186,1712,5474,0,0,0,1.0,1,1.0,1,1.0,1,0.19013176953896735,45
2340,2,7188,1712,5476,0,0,0,1.0,1,1.0,1,1.0,1,0.2053212484845391,44
2341,6,7194,1712,5482,0,0,0,1.0,1,1.0,1,1.0,1,0.09963606732163158,45
2342,4,7198,1712,5486,0,0,0,1.0,1,1.0,1,1.0,1,0.10284142289796282,47
2343,3,7201,1713,5488,0,0,0,1.0,1,1.0,1,1.0,1,0.10594973454318227,46
2344,1,7202,1713,5489,0,0,0,1.0,1,1.0,1,1.0,1,0.10229098270168384,46
2345,1,7203,1713,5490,0,0,0,1.0,1,1.0,1,1.0,1,0.10365529051662498,45
2346,0,7203,1713,5490,0,0,0,1.0,1,1.0,1,1.0,1,0.10867480327844178,46
2347,0,7203,1713,5490,0,0,0,1.0,1,1.0,1,1.0,1,0.11103540374663487,47
2348,4,7207,1714,5493,0,0,0,1.0,1,1.0,1,1.0,1,0.1837928170174219,49
2349,4,7211,1714,5497,0,0,0,1.0,1,1.0,1,1.0,1,0.15086133165983018,49
2350,5,7216,1715,5501,0,0,0,1.0,1,1.0,1,1.0,1,0.1183997580895495,50
2351,8,7224,1716,5508,0,0,0,1.0,1,1.0,1,1.0,1,0.15813758658320126,50
2352,11,7235,1716,5519,0,0,0,1.0,1,1.0,1,1.0,1,0.13140444838661236,51
2353,6,7241,1716,5525,0,0,0,1.0,1,1.0,1,1.0,1,0.2075544897478688,51
2354,8,7249,1716,5533,0,0,0,1.0,1,1.0,1,1.0,1,0.207209475754256,51
2355,7,7256,1718,5538,0,0,0,1.0,1,1.0,1,1.0,1,0.19394521662741068,50
2356,7,7263,1718,5545,0,0,0,1.0,1,1.0,1,1.0,1,0.10130938474331871,50
2357,1,7264,1718,5546,0,0,0,1.0,1,1.0,1,1.0,1,0.11020593839740357,49
2358,3,7267,1718,5549,0,0,0,1.0,1,1.0,1,1.0,1,0.09896189678667612,51
2359,9,7276,1718,5558,0,0,0,1.0,1,1.0,1,1.0,1,0.08835457818131562,51
2360,3,7279,1718,5561,0,0,0,1.0,1,1.0,1,1.0,1,0.11486336715588766,51
2361,4,7283,1719,5564,0,0,0,1.0,1,1.0,1,1.0,1,0.12520462035958718,52
2362,3,7286,1719,5567,0,0,0,1.0,1,1.0,1,1.0,1,0.14841193609311631,53
2363,4,7290,1719,5571,0,0,0,1.0,1,1.0,1,1.0,1,0.1380215481734173,54
2364,3,7293,1719,5574,0,0,0,1.0,1,1.0,1,1.0,1,0.13280977431972965,55
2365,5,7298,1721,5577,0,0,0,1.0,1,1.0,1,1.0,1,0.14076234388718303,53
2366,7,7305,1723,5582,0,0,0,1.0,1,1.0,1,1.0,1,0.1283453067159176,53
2367,4,7309,1726,5583,0,0,0,1.0,1,1.0,1,1.0,1,0.16252700225107475,51
2368,2,7311,1728,5583,0,0,0,1.0,1,1.0,1,1.0,1,0.19360323251845749,50
2369,3,7314,1730,5584,0,0,0,1.0,1,1.0,1,1.0,1,0.23720883167777995,47
2370,1,7315,1730,5585,0,0,0,1.0,1,1.0,1,1.0,1,0.2565395612410176,48
2371,15,7330,1732,5598,0,0,0,1.0,1,1.0,1,1.0,1,0.18851273503598187,49
2372,5,7335,1732,5603,0,0,0,1.0,1,1.0,1,1.0,1,0.1946301262876873,48
2373,4,7339,1732,5607,0,0,0,1.0,1,1.0,1,1.0,1,0.1622226388306751,49
2374,4,7343,1732,5611,0,0,0,1.0,1,1.0,1,1.0,1,0.161982999250264,50
2375,8,7351,1733,5618,0,0,0,1.0,1,1.0,1,1.0,1,0.17749145112623643,50
2376,4,7355,1733,5622,0,0,0,1.0,1,1.0,1,1.0,1,0.21186283495305125,50
2377,5,7360,1733,5627,0,0,0,1.0,1,1.0,1,1.0,1,0.20153522161561913,49
2378,6,7366,1733,5633,0,0,0,1.0,1,1.0,1,1.0,1,0.2172269355337229,49
2379,7,7373,1734,5639,0,0,0,1.0,1,1.0,1,1.0,1,0.22338455568094853,50
2380,6,7379,1735,5644,0,0,0,1.0,1,1.0,1,1.0,1,0.2355967450385605,50
2381,7,7386,1736,5650,0,0,0,1.0,1,1.0,1,1.0,1,0.24519318283456454,51
2382,8,7394,1738,5656,0,0,0,1.0,1,1.0,1,1.0,1,0.28895677390730934,51
2383,7,7401,1739,5662,0,0,0,1.0,1,1.0,1,1.0,1,0.25479932843858094,52
2384,5,7406,1741,5665,0,0,0,1.0,1,1.0,1,1.0,1,0.2322194232261264,52
2385,10,7416,1742,5674,0,0,0,1.0,1,1.0,1,1.0,1,0.2797376988423536,51
2386,11,7427,1743,5684,0,0,0,1.0,1,1.0,1,1.0,1,0.15271104066180313,52
2387,3,7430,1743,5687,0,0,0,1.0,1,1.0,1,1.0,1,0.1812544101620666,49
2388,3,7433,1743,5690,0,0,0,1.0,1,1.0,1,1.0,1,0.15278383816160007,48
2389,7,7440,1747,5693,0,0,0,1.0,1,1.0,1,1.0,1,0.18249839732254383,48
2390,3,7443,1748,5695,0,0,0,1.0,1,1.0,1,1.0,1,0.16215853849235984,49
2391,7,7450,1749,5701,0,0,0,1.0,1,1.0,1,1.0,1,0.17723529285984502,48
2392,5,7455,1749,5706,0,0,0,1.0,1,1.0,1,1.0,1,0.19826025546066672,49
2393,5,7460,1750,5710,0,0,0,1.0,1,1.0,1,1.0,1,0.17197959906140953,50
2394,4,7464,1752,5712,0,0,0,1.0,1,1.0,1,1.0,1,0.16337757952179607,50
2395,2,7466,1752,5714,0,0,0,1.0,1,1.0,1,1.0,1,0.1742004615920453,49
2396,6,7472,1753,5719,0,0,0,1.0,1,1.0,1,1.0,1,0.18957055838088743,50
2397,9,7481,1755,5726,0,0,0,1.0,1,1.0,1,1.0,1,0.20699620570651614,51
2398,2,7483,1755,5728,0,0,0,1.0,1,1.0,1,1.0,1,0.21859039037742098,49
2399,4,7487,1755,5732,0,0,0,1.0,1,1.0,1,1.0,1,0.21338182459970015,50
2400,4,7491,1755,5736,0,0,0,1.0,1,1.0,1,1.0,1,0.22178996612667945,51
2401,7,7498,1756,5742,0,0,0,1.0,1,1.0,1,1.0,1,0.15691552847795018,50
2402,1,7499,1756,5743,0,0,0,1.0,1,1.0,1,1.0,1,0.14126750108984729,51
2403,1,7500,1756,5744,0,0,0,1.0,1,1.0,1,1.0,1,0.14035177690184403,52
2404,2,7502,1756,5746,0,0,0,1.0,1,1.0,1,1.0,1,0.1311366484705316,53
2405,1,7503,1756,5747,0,0,0,1.0,1,1.0,1,1.0,1,0.13204067055624977,52
2406,3,7506,1758,5748,0,0,0,1.0,1,1.0,1,1.0,1,0.14383332909362617,52
2407,3,7509,1759,5750,0,0,0,1.0,1,1.0,1,1.0,1,0.1693872103835893,51
2408,0,7509,1759,5750,0,0,0,1.0,1,1.0,1,1.0,1,0.180597575921389,50
2409,2,7511,1759,5752,0,0,0,1.0,1,1.0,1,1.0,1,0.16659267853161489,50
2410,1,7512,1760,5752,0,0,0,1.0,1,1.0,1,1.0,1,0.17469156520173482,49
2411,0,7512,1760,5752,0,0,0,1.0,1,1.0,1,1.0,1,0.18894778225430817,48
2412,1,7513,1761,5752,0,0,0,1.0,1,1.0,1,1.0,1,0.19456716749478914,47
2413,0,7513,1761,5752,0,0,0,1.0,1,1.0,1,1.0,1,0.18667005242890505,47
2414,2,7515,1762,5753,0,0,0,1.0,1,1.0,1,1.0,1,0.22328384502623128,47
2415,4,7519,1762,5757,0,0,0,1.0,1,1.0,1,1.0,1,0.22321570019191586,46
2416,5,7524,1763,5761,0,0,0,1.0,1,1.0,1,1.0,1,0.17336669982565642,47
2417,3,7527,1764,5763,0,0,0,1.0,1,1.0,1,1.0,1,0.1724982540610022,46
2418,1,7528,1765,5763,0,0,0,1.0,1,1.0,1,1.0,1,0.214153165845216,48
2419,1,7529,1765,5764,0,0,0,1.0,1,1.0,1,1.0,1,0.2009363536317529,47
2420,1,7530,1765,5765,0,0,0,1.0,1,1.0,1,1.0,1,0.16693908718795536,49
2421,1,7531,1765,5766,0,0,0,1.0,1,1.0,1,1.0,1,0.1521514243881757,50
2422,4,7535,1766,5769,0,0,0,1.0,1,1.0,1,1.0,1,0.1506836809229785,50
2423,2,7537,1766,5771,0,0,0,1.0,1,1.0,1,1.0,1,0.16178623484660842,51
2424,6,7543,1770,5773,0,0,0,1.0,1,1.0,1,1.0,1,0.1871975290442878,50
2425,0,7543,1770,5773,0,0,0,1.0,1,1.0,1,1.0,1,0.18810693676529874,48
2426,1,7544,1771,5773,0,0,0,1.0,1,1.0,1,1.0,1,0.1767801589499066,51
2427,1,7545,1771,5774,0,0,0,1.0,1,1.0,1,1.0,1,0.18309236004824314,50
2428,4,7549,1772,5777,0,0,0,1.0,1,1.0,1,1.0,1,0.19026288828693178,49
2429,6,7555,1775,5780,0,0,0,1.0,1,1.0,1,1.0,1,0.2613366065475711,49
2430,3,7558,1776,5782,0,0,0,1.0,1,1.0,1,1.0,1,0.30228908261275517,46
2431,9,7567,1777,5790,0,0,0,1.0,1,1.0,1,1.0,1,0.21422891812130135,45
2432,2,7569,1777,5792,0,0,0,1.0,1,1.0,1,1.0,1,0.2727026103759988,44
2433,6,7575,1778,5797,0,0,0,1.0,1,1.0,1,1.0,1,0.15555697997754828,45
2434,2,7577,1778,5799,0,0,0,1.0,1,1.0,1,1.0,1,0.1687019718937769,44
2435,3,7580,1778,5802,0,0,0,1.0,1,1.0,1,1.0,1,0.1184317428480664,44
2436,1,7581,1778,5803,0,0,0,1.0,1,1.0,1,1.0,1,0.115574080334197,44
2437,5,7586,1780,5806,0,0,0,1.0,1,1.0,1,1.0,1,0.13668830398861032,45
2438,4,7590,1782,5808,0,0,0,1.0,1,1.0,1,1.0,1,0.2288660652260596,45
2439,8,7598,1782,5816,0,0,0,1.0,1,1.0,1,1.0,1,0.23513200611018265,46
2440,8,7606,1782,5824,0,0,0,1.0,1,1.0,1,1.0,1,0.2672742977720245,45
2441,14,7620,1783,5837,0,0,0,1.0,1,1.0,1,1.0,1,0.2901048668011191,45
2442,12,7632,1783,5849,0,0,0,1.0,1,1.0,1,1.0,1,0.27159369446883075,46
2443,9,7641,1783,5858,0,0,0,1.0,1,1.0,1,1.0,1,0.21789541871091894,45
2444,10,7651,1784,5867,0,0,0,1.0,1,1.0,1,1.0,1,0.24792749192685806,46
2445,13,7664,1784,5880,0,0,0,1.0,1,1.0,1,1.0,1,0.20621267369777393,44
2446,8,7672,1786,5886,0,0,0,1.0,1,1.0,1,1.0,1,0.13462196232050036,44
2447,0,7672,1786,5886,0,0,0,1.0,1,1.0,1,1.0,1,0.12920798742234915,42
2448,3,7675,1788,5887,0,0,0,1.0,1,1.0,1,1.0,1,0.18672161267907292,41
2449,1,7676,1789,5887,0,0,0,1.0,1,1.0,1,1.0,1,0.2204098922485759,40
2450,2,7678,1791,5887,0,0,0,1.0,1,1.0,1,1.0,1,0.19710827705013967,42
2451,0,7678,1791,5887,0,0,0,1.0,1,1.0,1,1.0,1,0.20180051322809534,43
2452,2,7680,1793,5887,0,0,0,1.0,1,1.0,1,1.0,1,0.24858033377277797,43
2453,3,7683,1793,5890,0,0,0,1.0,1,1.0,1,1.0,1,0.22535068164674874,45
2454,2,7685,1794,5891,0,0,0,1.0,1,1.0,1,1.0,1,0.225042295084034,47
2455,2,7687,1794,5893,0,0,0,1.0,1,1.0,1,1.0,1,0.19608742324502357,48
2456,0,7687,1794,5893,0,0,0,1.0,1,1.0,1,1.0,1,0.20609733489396323,49
2457,3,7690,1795,5895,0,0,0,1.0,1,1.0,1,1.0,1,0.20948168376395293,48
2458,3,7693,1795,5898,0,0,0,1.0,1,1.0,1,1.0,1,0.21411915403171866,49
2459,1,7694,1795,5899,0,0,0,1.0,1,1.0,1,1.0,1,0.2012847075664871,49
2460,3,7697,1796,5901,0,0,0,1.0,1,1.0,1,1.0,1,0.20593898402140623,50
2461,2,7699,1796,5903,0,0,0,1.0,1,1.0,1,1.0,1,0.18345372212510472,50
2462,8,7707,1798,5909,0,0,0,1.0,1,1.0,1,1.0,1,0.14744356176186713,51
2463,6,7713,1800,5913,0,0,0,1.0,1,1.0,1,1.0,1,0.19123711772460023,51
2464,2,7715,1801,5914,0,0,0,1.0,1,1.0,1,1.0,1,0.17609586804931138,50
2465,1,7716,1802,5914,0,0,0,1.0,1,1.0,1,1.0,1,0.19384408929681773,49
2466,1,7717,1803,5914,0,0,0,1.0,1,1.0,1,1.0,1,0.17700034251840951,49
2467,2,7719,1804,5915,0,0,0,1.0,1,1.0,1,1.0,1,0.21565685072376978,48
2468,4,7723,1807,5916,0,0,0,1.0,1,1.0,1,1.0,1,0.1966572584618688,47
2469,1,7724,1808,5916,0,0,0,1.0,1,1.0,1,1.0,1,0.19670427666221735,46
2470,1,7725,1809,5916,0,0,0,1.0,1,1.0,1,1.0,1,0.19483348630428088,44
2471,0,7725,1809,5916,0,0,0,1.0,1,1.0,1,1.0,1,0.21838862690553007,44
2472,3,7728,1810,5918,0,0,0,1.0,1,1.0,1,1.0,1,0.23180883724898005,44
2473,3,7731,1811,5920,0,0,0,1.0,1,1.0,1,1.0,1,0.2345180099600202,43
2474,7,7738,1815,5923,0,0,0,1.0,1,1.0,1,1.0,1,0.2461290889542397,44
2475,5,7743,1815,5928,0,0,0,1.0,1,1.0,1,1.0,1,0.25702607492245866,46
2476,9,7752,1815,5937,0,0,0,1.0,1,1.0,1,1.0,1,0.12040598422282807,46
2477,1,7753,1815,5938,0,0,0,1.0,1,1.0,1,1.0,1,0.10568367301476606,46
2478,0,7753,1815,5938,0,0,0,1.0,1,1.0,1,1.0,1,0.10568367301476606,46
2479,1,7754,1816,5938,0,0,0,1.0,1,1.0,1,1.0,1,0.13286470639393105,46
2480,1,7755,1817,5938,0,0,0,1.0,1,1.0,1,1.0,1,0.1016362621250347,47
2481,2,7757,1818,5939,0,0,0,1.0,1,1.0,1,1.0,1,0.14036685551838923,47
2482,3,7760,1818,5942,0,0,0,1.0,1,1.0,1,1.0,1,0.15177597252017203,45
2483,2,7762,1818,5944,0,0,0,1.0,1,1.0,1,1.0,1,0.16367994184978749,45
2484,1,7763,1819,5944,0,0,0,1.0,1,1.0,1,1.0,1,0.16080112202567992,46
2485,1,7764,1819,5945,0,0,0,1.0,1,1.0,1,1.0,1,0.1720815522071561,44
2486,0,7764,1819,5945,0,0,0,1.0,1,1.0,1,1.0,1,0.19886281998217983,43
2487,3,7767,1821,5946,0,0,0,1.0,1,1.0,1,1.0,1,0.15921669168989638,44
2488,3,7770,1823,5947,0,0,0,1.0,1,1.0,1,1.0,1,0.15709979918559652,45
2489,5,7775,1825,5950,0,0,0,1.0,1,1.0,1,1.0,1,0.20855713240926704,44
2490,2,7777,1826,5951,0,0,0,1.0,1,1.0,1,1.0,1,0.24216362947262227,44
2491,5,7782,1826,5956,0,0,0,1.0,1,1.0,1,1.0,1,0.17622606517369704,44
2492,4,7786,1827,5959,0,0,0,1.0,1,1.0,1,1.0,1,0.1487292964509826,44
2493,0,7786,1827,5959,0,0,0,1.0,1,1.0,1,1.0,1,0.17537528297816518,42
2494,0,7786,1827,5959,0,0,0,1.0,1,1.0,1,1.0,1,0.17537528297816518,42
2495,0,7786,1827,5959,0,0,0,1.0,1,1.0,1,1.0,1,0.17486123952530222,42
2496,2,7788,1828,5960,0,0,0,1.0,1,1.0,1,1.0,1,0.1638426912287585,42
2497,1,7789,1828,5961,0,0,0,1.0,1,1.0,1,1.0,1,0.13909820583584076,44
2498,0,7789,1828,5961,0,0,0,1.0,1,1.0,1,1.0,1,0.16570156011187864,43
2499,1,7790,1828,5962,0,0,0,1.0,1,1.0,1,1.0,1,0.1850346755357937,43
2500,4,7794,1828,5966,0,0,0,1.0,1,1.0,1,1.0,1,0.17417514916466623,44
2501,3,7797,1828,5969,0,0,0,1.0,1,1.0,1,1.0,1,0.18722776583268289,46
2502,4,7801,1830,5971,0,0,0,1.0,1,1.0,1,1.0,1,0.17556821420729585,47
2503,4,7805,1830,5975,0,0,0,1.0,1,1.0,1,1.0,1,0.1632746088270954,47
2504,3,7808,1832,5976,0,0,0,1.0,1,1.0,1,1.0,1,0.2128773677149096,46
2505,5,7813,1835,5978,0,0,0,1.0,1,1.0,1,1.0,1,0.1700983851959439,46
2506,6,7819,1837,5982,0,0,0,1.0,1,1.0,1,1.0,1,0.1720761332239362,45
2507,1,7820,1837,5983,0,0,0,1.0,1,1.0,1,1.0,1,0.18849214649132257,45
2508,3,7823,1838,5985,0,0,0,1.0,1,1.0,1,1.0,1,0.17333432072299543,46
2509,3,7826,1840,5986,0,0,0,1.0,1,1.0,1,1.0,1,0.19356821010312225,45
2510,8,7834,1841,5993,0,0,0,1.0,1,1.0,1,1.0,1,0.2081224767035062,46
2511,5,7839,1841,5998,0,0,0,1.0,1,1.0,1,1.0,1,0.18085831861414528,47
2512,2,7841,1841,6000,0,0,0,1.0,1,1.0,1,1.0,1,0.15354725267301003,47
2513,2,7843,1841,6002,0,0,0,1.0,1,1.0,1,1.0,1,0.1406761327759276,48
2514,1,7844,1841,6003,0,0,0,1.0,1,1.0,1,1.0,1,0.13773136397943606,48
2515,4,7848,1841,6007,0,0,0,1.0,1,1.0,1,1.0,1,0.14339492285636504,49
2516,6,7854,1843,6011,0,0,0,1.0,1,1.0,1,1.0,1,0.14605299699526073,49
2517,5,7859,1845,6014,0,0,0,1.0,1,1.0,1,1.0,1,0.1579499528595912,49
2518,4,7863,1846,6017,0,0,0,1.0,1,1.0,1,1.0,1,0.18091727492844978,48
2519,3,7866,1847,6019,0,0,0,1.0,1,1.0,1,1.0,1,0.1891717369765999,48
2520,2,7868,1847,6021,0,0,0,1.0,1,1.0,1,1.0,1,0.18394822940200686,46
2521,7,7875,1850,6025,0,0,0,1.0,1,1.0,1,1.0,1,0.12122648117817109,47
2522,0,7875,1850,6025,0,0,0,1.0,1,1.0,1,1.0,1,0.12495224311404869,45
2523,0,7875,1850,6025,0,0,0,1.0,1,1.0,1,1.0,1,0.13697139041743692,44
2524,0,7875,1850,6025,0,0,0,1.0,1,1.0,1,1.0,1,0.16051566298886513,42
2525,1,7876,1850,6026,0,0,0,1.0,1,1.0,1,1.0,1,0.18739055853057204,42
2526,1,7877,1850,6027,0,0,0,1.0,1,1.0,1,1.0,1,0.181020359294636,41
2527,0,7877,1850,6027,0,0,0,1.0,1,1.0,1,1.0,1,0.181020359294636,41
2528,1,7878,1850,6028,0,0,0,1.0,1,1.0,1,1.0,1,0.12794817031691028,41
2529,1,7879,1851,6028,0,0,0,1.0,1,1.0,1,1.0,1,0.14936381586213587,42
2530,0,7879,1851,6028,0,0,0,1.0,1,1.0,1,1.0,1,0.16114493216367476,41
2531,0,7879,1851,6028,0,0,0,1.0,1,1.0,1,1.0,1,0.16114493216367476,41
2532,2,7881,1851,6030,0,0,0,1.0,1,1.0,1,1.0,1,0.16352245666162496,43
2533,3,7884,1851,6033,0,0,0,1.0,1,1.0,1,1.0,1,0.1791380113710343,43
2534,1,7885,1851,6034,0,0,0,1.0,1,1.0,1,1.0,1,0.17730751472281242,43
2535,0,7885,1851,6034,0,0,0,1.0,1,1.0,1,1.0,1,0.195329951884849,44
2536,2,7887,1851,6036,0,0,0,1.0,1,1.0,1,1.0,1,0.1453343411377247,44
2537,2,7889,1853,6036,0,0,0,1.0,1,1.0,1,1.0,1,0.22783097878801603,45
2538,4,7893,1853,6040,0,0,0,1.0,1,1.0,1,1.0,1,0.18608424482543484,48
2539,3,7896,1854,6042,0,0,0,1.0,1,1.0,1,1.0,1,0.17486555562225065,48
2540,2,7898,1855,6043,0,0,0,1.0,1,1.0,1,1.0,1,0.19287876086897027,50
2541,5,7903,1856,6047,0,0,0,1.0,1,1.0,1,1.0,1,0.18832941820420576,52
2542,7,7910,1858,6052,0,0,0,1.0,1,1.0,1,1.0,1,0.18055981777206162,52
2543,4,7914,1860,6054,0,0,0,1.0,1,1.0,1,1.0,1,0.20378926250862686,51
2544,6,7920,1863,6057,0,0,0,1.0,1,1.0,1,1.0,1,0.1909491647549443,51
2545,4,7924,1863,6061,0,0,0,1.0,1,1.0,1,1.0,1,0.17790606303645162,50
2546,3,7927,1865,6062,0,0,0,1.0,1,1.0,1,1.0,1,0.16650745116220406,50
2547,3,7930,1867,6063,0,0,0,1.0,1,1.0,1,1.0,1,0.1847714055720348,47
2548,4,7934,1867,6067,0,0,0,1.0,1,1.0,1,1.0,1,0.20211374946875257,46
2549,7,7941,1871,6070,0,0,0,1.0,1,1.0,1,1.0,1,0.18247091636076285,46
2550,5,7946,1873,6073,0,0,0,1.0,1,1.0,1,1.0,1,0.18598512799812017,44
2551,5,7951,1874,6077,0,0,0,1.0,1,1.0,1,1.0,1,0.09757051573043012,43
2552,0,7951,1874,6077,0,0,0,1.0,1,1.0,1,1.0,1,0.11658089541254452,43
2553,1,7952,1875,6077,0,0,0,1.0,1,1.0,1,1.0,1,0.14417684572722414,44
2554,0,7952,1875,6077,0,0,0,1.0,1,1.0,1,1.0,1,0.13991767322712215,45
2555,2,7954,1875,6079,0,0,0,1.0,1,1.0,1,1.0,1,0.14474748783676103,44
2556,3,7957,1876,6081,0,0,0,1.0,1,1.0,1,1.0,1,0.16840025455078814,44
2557,2,7959,1877,6082,0,0,0,1.0,1,1.0,1,1.0,1,0.18658603305550805,41
2558,0,7959,1877,6082,0,0,0,1.0,1,1.0,1,1.0,1,0.18890606831351503,40
2559,0,7959,1877,6082,0,0,0,1.0,1,1.0,1,1.0,1,0.2036268786972085,41
2560,0,7959,1877,6082,0,0,0,1.0,1,1.0,1,1.0,1,0.2036268786972085,41
2561,2,7961,1877,6084,0,0,0,1.0,1,1.0,1,1.0,1,0.19254605083297965,43
2562,5,7966,1878,6088,0,0,0,1.0,1,1.0,1,1.0,1,0.23289591111905644,44
2563,6,7972,1878,6094,0,0,0,1.0,1,1.0,1,1.0,1,0.23289591111905644,44
2564,5,7977,1879,6098,0,0,0,1.0,1,1.0,1,1.0,1,0.25261779231036424,44
2565,5,7982,1881,6101,0,0,0,1.0,1,1.0,1,1.0,1,0.2578189742498784,45
2566,7,7989,1882,6107,0,0,0,1.0,1,1.0,1,1.0,1,0.2136571903661201,46
2567,4,7993,1884,6109,0,0,0,1.0,1,1.0,1,1.0,1,0.21492391445295791,48
2568,2,7995,1884,6111,0,0,0,1.0,1,1.0,1,1.0,1,0.20405657739885164,48
2569,3,7998,1884,6114,0,0,0,1.0,1,1.0,1,1.0,1,0.2220814111595854,49
2570,5,8003,1884,6119,0,0,0,1.0,1,1.0,1,1.0,1,0.1907806406719371,48
2571,5,8008,1884,6124,0,0,0,1.0,1,1.0,1,1.0,1,0.20148541504634204,48
2572,2,8010,1884,6126,0,0,0,1.0,1,1.0,1,1.0,1,0.1644453377370332,49
2573,1,8011,1884,6127,0,0,0,1.0,1,1.0,1,1.0,1,0.13857367945518675,50
2574,3,8014,1885,6129,0,0,0,1.0,1,1.0,1,1.0,1,0.15315110489196682,49
2575,1,8015,1885,6130,0,0,0,1.0,1,1.0,1,1.0,1,0.15273066849792336,48
2576,3,8018,1886,6132,0,0,0,1.0,1,1.0,1,1.0,1,0.16280297327600568,48
2577,3,8021,1886,6135,0,0,0,1.0,1,1.0,1,1.0,1,0.17411545988454621,50
2578,2,8023,1887,6136,0,0,0,1.0,1,1.0,1,1.0,1,0.16996292637566696,50
2579,5,8028,1887,6141,0,0,0,1.0,1,1.0,1,1.0,1,0.10462472254829215,51
2580,5,8033,1888,6145,0,0,0,1.0,1,1.0,1,1.0,1,0.13633749827438515,52
2581,4,8037,1888,6149,0,0,0,1.0,1,1.0,1,1.0,1,0.10787882328903703,51
2582,1,8038,1889,6149,0,0,0,1.0,1,1.0,1,1.0,1,0.11678193028130891,51
2583,4,8042,1891,6151,0,0,0,1.0,1,1.0,1,1.0,1,0.13395751445811413,51
2584,2,8044,1892,6152,0,0,0,1.0,1,1.0,1,1.0,1,0.11516655951760535,51
2585,1,8045,1892,6153,0,0,0,1.0,1,1.0,1,1.0,1,0.10987062877512187,50
2586,4,8049,1895,6154,0,0,0,1.0,1,1.0,1,1.0,1,0.12248089574337408,50
2587,4,8053,1896,6157,0,0,0,1.0,1,1.0,1,1.0,1,0.06624370780744927,48
2588,2,8055,1897,6158,0,0,0,1.0,1,1.0,1,1.0,1,0.10749623955506105,50
2589,4,8059,1898,6161,0,0,0,1.0,1,1.0,1,1.0,1,0.08138265738449038,48
2590,0,8059,1898,6161,0,0,0,1.0,1,1.0,1,1.0,1,0.07953965157177742,47
2591,1,8060,1899,6161,0,0,0,1.0,1,1.0,1,1.0,1,0.09768165885491971,47
2592,2,8062,1901,6161,0,0,0,1.0,1,1.0,1,1.0,1,0.1368951574055045,47
2593,1,8063,1901,6162,0,0,0,1.0,1,1.0,1,1.0,1,0.12492549898241737,47
2594,8,8071,1904,6167,0,0,0,1.0,1,1.0,1,1.0,1,0.19429673915709703,49
2595,4,8075,1906,6169,0,0,0,1.0,1,1.0,1,1.0,1,0.17404446707280835,48
2596,7,8082,1907,6175,0,0,0,1.0,1,1.0,1,1.0,1,0.08891580669960983,47
2597,1,8083,1907,6176,0,0,0,1.0,1,1.0,1,1.0,1,0.08494713714852749,48
2598,1,8084,1908,6176,0,0,0,1.0,1,1.0,1,1.0,1,0.06285596840917762,48
2599,1,8085,1908,6177,0,0,0,1.0,1,1.0,1,1.0,1,0.0728765516169079,49
2600,4,8089,1910,6179,0,0,0,1.0,1,1.0,1,1.0,1,0.08246318496895459,52
2601,3,8092,1912,6180,0,0,0,1.0,1,1.0,1,1.0,1,0.1441789650823993,51
2602,1,8093,1912,6181,0,0,0,1.0,1,1.0,1,1.0,1,0.1331950297820277,52
2603,3,8096,1912,6184,0,0,0,1.0,1,1.0,1,1.0,1,0.1462205888723005,53
2604,2,8098,1912,6186,0,0,0,1.0,1,1.0,1,1.0,1,0.15264266310201124,53
2605,2,8100,1912,6188,0,0,0,1.0,1,1.0,1,1.0,1,0.17005721569609,52
2606,4,8104,1912,6192,0,0,0,1.0,1,1.0,1,1.0,1,0.15958292889315276,52
2607,1,8105,1912,6193,0,0,0,1.0,1,1.0,1,1.0,1,0.16908607595798067,52
2608,2,8107,1912,6195,0,0,0,1.0,1,1.0,1,1.0,1,0.16908607595798067,52
2609,1,8108,1912,6196,0,0,0,1.0,1,1.0,1,1.0,1,0.14590382857592146,53
2610,5,8113,1913,6200,0,0,0,1.0,1,1.0,1,1.0,1,0.17012599014598867,54
2611,6,8119,1914,6205,0,0,0,1.0,1,1.0,1,1.0,1,0.1196159650930971,54
2612,5,8124,1915,6209,0,0,0,1.0,1,1.0,1,1.0,1,0.08577460785153915,56
2613,3,8127,1917,6210,0,0,0,1.0,1,1.0,1,1.0,1,0.07420361671717601,56
2614,5,8132,1918,6214,0,0,0,1.0,1,1.0,1,1.0,1,0.08734940584420878,56
2615,1,8133,1918,6215,0,0,0,1.0,1,1.0,1,1.0,1,0.08240243433994339,57
2616,5,8138,1918,6220,0,0,0,1.0,1,1.0,1,1.0,1,0.07655502041853476,57
2617,5,8143,1919,6224,0,0,0,1.0,1,1.0,1,1.0,1,0.10286054076614322,58
2618,3,8146,1919,6227,0,0,0,1.0,1,1.0,1,1.0,1,0.09689243678086978,58
2619,2,8148,1919,6229,0,0,0,1.0,1,1.0,1,1.0,1,0.11790702387006953,58
2620,8,8156,1920,6236,0,0,0,1.0,1,1.0,1,1.0,1,0.10738231650127042,60
2621,3,8159,1920,6239,0,0,0,1.0,1,1.0,1,1.0,1,0.12290662328543205,59
2622,8,8167,1922,6245,0,0,0,1.0,1,1.0,1,1.0,1,0.15563756928085137,60
2623,8,8175,1924,6251,0,0,0,1.0,1,1.0,1,1.0,1,0.15345444570592962,59
2624,10,8185,1927,6258,0,0,0,1.0,1,1.0,1,1.0,1,0.18206491405810005,58
2625,10,8195,1930,6265,0,0,0,1.0,1,1.0,1,1.0,1,0.18811623833100644,58
2626,7,8202,1932,6270,0,0,0,1.0,1,1.0,1,1.0,1,0.11714534966966332,57
2627,1,8203,1932,6271,0,0,0,1.0,1,1.0,1,1.0,1,0.12394890749491252,55
2628,1,8204,1933,6271,0,0,0,1.0,1,1.0,1,1.0,1,0.11491713640305896,55
2629,1,8205,1933,6272,0,0,0,1.0,1,1.0,1,1.0,1,0.12908319496120949,54
2630,4,8209,1934,6275,0,0,0,1.0,1,1.0,1,1.0,1,0.12230539313726387,55
2631,0,8209,1934,6275,0,0,0,1.0,1,1.0,1,1.0,1,0.15000680720834636,55
2632,1,8210,1934,6276,0,0,0,1.0,1,1.0,1,1.0,1,0.15715478067964134,55
2633,1,8211,1935,6276,0,0,0,1.0,1,1.0,1,1.0,1,0.12935778292767633,53
2634,4,8215,1937,6278,0,0,0,1.0,1,1.0,1,1.0,1,0.17742981862328086,52
2635,4,8219,1937,6282,0,0,0,1.0,1,1.0,1,1.0,1,0.1983606394054161,52
2636,6,8225,1939,6286,0,0,0,1.0,1,1.0,1,1.0,1,0.2717157678872196,51
2637,4,8229,1939,6290,0,0,0,1.0,1,1.0,1,1.0,1,0.24874292489465044,50
2638,7,8236,1940,6296,0,0,0,1.0,1,1.0,1,1.0,1,0.21854601218163364,48
2639,6,8242,1941,6301,0,0,0,1.0,1,1.0,1,1.0,1,0.22306936965572424,48
2640,8,8250,1944,6306,0,0,0,1.0,1,1.0,1,1.0,1,0.2538303309652198,46
2641,12,8262,1947,6315,0,0,0,1.0,1,1.0,1,1.0,1,0.20305150306225847,46
2642,7,8269,1949,6320,0,0,0,1.0,1,1.0,1,1.0,1,0.19414099776669924,47
2643,4,8273,1949,6324,0,0,0,1.0,1,1.0,1,1.0,1,0.14439571738445034,45
2644,5,8278,1951,6327,0,0,0,1.0,1,1.0,1,1.0,1,0.24070721035652667,44
2645,7,8285,1952,6333,0,0,0,1.0,1,1.0,1,1.0,1,0.2140858411528158,42
2646,2,8287,1952,6335,0,0,0,1.0,1,1.0,1,1.0,1,0.20169344957708363,43
2647,3,8290,1953,6337,0,0,0,1.0,1,1.0,1,1.0,1,0.2276472867555697,40
2648,4,8294,1954,6340,0,0,0,1.0,1,1.0,1,1.0,1,0.20243092105335386,41
2649,3,8297,1954,6343,0,0,0,1.0,1,1.0,1,1.0,1,0.20840091224973065,43
2650,4,8301,1954,6347,0,0,0,1.0,1,1.0,1,1.0,1,0.13695898750058552,43
2651,4,8305,1955,6350,0,0,0,1.0,1,1.0,1,1.0,1,0.12209821194655947,44
2652,4,8309,1955,6354,0,0,0,1.0,1,1.0,1,1.0,1,0.12209821194655947,44
2653,2,8311,1955,6356,0,0,0,1.0,1,1.0,1,1.0,1,0.15839655156014246,44
2654,4,8315,1956,6359,0,0,0,1.0,1,1.0,1,1.0,1,0.14864895992507582,45
2655,6,8321,1957,6364,0,0,0,1.0,1,1.0,1,1.0,1,0.19444802294168997,45
2656,7,8328,1957,6371,0,0,0,1.0,1,1.0,1,1.0,1,0.10733921425803271,45
2657,3,8331,1957,6374,0,0,0,1.0,1,1.0,1,1.0,1,0.10257710501357407,45
2658,2,8333,1958,6375,0,0,0,1.0,1,1.0,1,1.0,1,0.11530515161755585,47
2659,4,8337,1959,6378,0,0,0,1.0,1,1.0,1,1.0,1,0.1560508657317637,46
2660,3,8340,1959,6381,0,0,0,1.0,1,1.0,1,1.0,1,0.14009104253431073,46
2661,2,8342,1959,6383,0,0,0,1.0,1,1.0,1,1.0,1,0.15882357155636126,46
2662,5,8347,1961,6386,0,0,0,1.0,1,1.0,1,1.0,1,0.1552750260119917,47
2663,9,8356,1962,6394,0,0,0,1.0,1,1.0,1,1.0,1,0.14237548795604688,46
2664,4,8360,1964,6396,0,0,0,1.0,1,1.0,1,1.0,1,0.1804180764201114,45
2665,9,8369,1966,6403,0,0,0,1.0,1,1.0,1,1.0,1,0.21134030454148064,47
2666,13,8382,1970,6412,0,0,0,1.0,1,1.0,1,1.0,1,0.22704734601321383,47
2667,6,8388,1970,6418,0,0,0,1.0,1,1.0,1,1.0,1,0.25740983362686864,45
2668,8,8396,1971,6425,0,0,0,1.0,1,1.0,1,1.0,1,0.24767779919052174,45
2669,10,8406,1972,6434,0,0,0,1.0,1,1.0,1,1.0,1,0.2945414583731426,45
2670,9,8415,1975,6440,0,0,0,1.0,1,1.0,1,1.0,1,0.21563343836858642,45
2671,6,8421,1976,6445,0,0,0,1.0,1,1.0,1,1.0,1,0.1617886952343928,41
2672,1,8422,1977,6445,0,0,0,1.0,1,1.0,1,1.0,1,0.18422520338231868,40
2673,3,8425,1977,6448,0,0,0,1.0,1,1.0,1,1.0,1,0.1674922008408681,39
2674,3,8428,1978,6450,0,0,0,1.0,1,1.0,1,1.0,1,0.13741716234262188,37
2675,1,8429,1979,6450,0,0,0,1.0,1,1.0,1,1.0,1,0.15885696964150237,35
2676,0,8429,1979,6450,0,0,0,1.0,1,1.0,1,1.0,1,0.20104201585546574,34
2677,2,8431,1981,6450,0,0,0,1.0,1,1.0,1,1.0,1,0.20936943613199083,32
2678,5,8436,1984,6452,0,0,0,1.0,1,1.0,1,1.0,1,0.23104813448159056,33
2679,5,8441,1986,6455,0,0,0,1.0,1,1.0,1,1.0,1,0.3152256385294124,33
2680,6,8447,1989,6458,0,0,0,1.0,1,1.0,1,1.0,1,0.31983925887984055,33
2681,0,8447,1989,6458,0,0,0,1.0,1,1.0,1,1.0,1,0.2574973963653935,32
2682,1,8448,1990,6458,0,0,0,1.0,1,1.0,1,1.0,1,0.22722421340749913,32
2683,1,8449,1991,6458,0,0,0,1.0,1,1.0,1,1.0,1,0.17536252076344003,32
2684,1,8450,1991,6459,0,0,0,1.0,1,1.0,1,1.0,1,0.1387925195157509,31
2685,1,8451,1992,6459,0,0,0,1.0,1,1.0,1,1.0,1,0.10520178831645818,30
2686,1,8452,1993,6459,0,0,0,1.0,1,1.0,1,1.0,1,0.15997323257625878,29
2687,0,8452,1993,6459,0,0,0,1.0,1,1.0,1,1.0,1,0.1708953099467913,28
2688,0,8452,1993,6459,0,0,0,1.0,1,1.0,1,1.0,1,0.1708953099467913,28
2689,1,8453,1993,6460,0,0,0,1.0,1,1.0,1,1.0,1,0.20236144176862908,29
2690,4,8457,1995,6462,0,0,0,1.0,1,1.0,1,1.0,1,0.1927077800001446,29
2691,3,8460,1996,6464,0,0,0,1.0,1,1.0,1,1.0,1,0.22988298181471015,29
2692,2,8462,1996,6466,0,0,0,1.0,1,1.0,1,1.0,1,0.21032724276437342,31
2693,2,8464,1997,6467,0,0,0,1.0,1,1.0,1,1.0,1,0.20969869595548646,32
2694,1,8465,1997,6468,0,0,0,1.0,1,1.0,1,1.0,1,0.20871869647742106,32
2695,0,8465,1997,6468,0,0,0,1.0,1,1.0,1,1.0,1,0.21401800757916795,33
2696,0,8465,1997,6468,0,0,0,1.0,1,1.0,1,1.0,1,0.21401800757916795,33
2697,3,8468,1998,6470,0,0,0,1.0,1,1.0,1,1.0,1,0.2779008800992597,34
2698,3,8471,1999,6472,0,0,0,1.0,1,1.0,1,1.0,1,0.21973666560225372,34
2699,2,8473,1999,6474,0,0,0,1.0,1,1.0,1,1.0,1,0.20813107913416481,36
2700,3,8476,2000,6476,0,0,0,1.0,1,1.0,1,1.0,1,0.2443330401883579,36
2701,3,8479,2000,6479,0,0,0,1.0,1,1.0,1,1.0,1,0.14397614244414872,36
2702,0,8479,2000,6479,0,0,0,1.0,1,1.0,1,1.0,1,0.14397614244414872,36
2703,4,8483,2001,6482,0,0,0,1.0,1,1.0,1,1.0,1,0.1520825269070771,38
2704,1,8484,2002,6482,0,0,0,1.0,1,1.0,1,1.0,1,0.17511398137703943,37
2705,3,8487,2004,6483,0,0,0,1.0,1,1.0,1,1.0,1,0.1454345372168828,36
2706,1,8488,2005,6483,0,0,0,1.0,1,1.0,1,1.0,1,0.19470607573734827,34
2707,4,8492,2006,6486,0,0,0,1.0,1,1.0,1,1.0,1,0.1796067038099953,36
2708,1,8493,2007,6486,0,0,0,1.0,1,1.0,1,1.0,1,0.17747286690410644,36
2709,2,8495,2007,6488,0,0,0,1.0,1,1.0,1,1.0,1,0.19545000569938742,33
2710,5,8500,2010,6490,0,0,0,1.0,1,1.0,1,1.0,1,0.1643784861317897,32
2711,2,8502,2012,6490,0,0,0,1.0,1,1.0,1,1.0,1,0.13730127010816337,29
2712,0,8502,2012,6490,0,0,0,1.0,1,1.0,1,1.0,1,0.16997995881124636,28
2713,1,8503,2012,6491,0,0,0,1.0,1,1.0,1,1.0,1,0.16391161185349398,28
2714,0,8503,2012,6491,0,0,0,1.0,1,1.0,1,1.0,1,0.14302616676028843,25
2715,2,8505,2014,6491,0,0,0,1.0,1,1.0,1,1.0,1,0.16035239538484425,24
2716,3,8508,2016,6492,0,0,0,1.0,1,1.0,1,1.0,1,0.23572573635009608,23
2717,1,8509,2017,6492,0,0,0,1.0,1,1.0,1,1.0,1,0.19096497814716445,24
2718,1,8510,2017,6493,0,0,0,1.0,1,1.0,1,1.0,1,0.14710607887820454,24
2719,3,8513,2019,6494,0,0,0,1.0,1,1.0,1,1.0,1,0.21193348897248526,25
2720,0,8513,2019,6494,0,0,0,1.0,1,1.0,1,1.0,1,0.21193348897248526,25
2721,2,8515,2021,6494,0,0,0,1.0,1,1.0,1,1.0,1,0.2492799941239881,26
2722,3,8518,2022,6496,0,0,0,1.0,1,1.0,1,1.0,1,0.3000307213903914,26
2723,2,8520,2023,6497,0,0,0,1.0,1,1.0,1,1.0,1,0.23156210873433636,26
2724,1,8521,2024,6497,0,0,0,1.0,1,1.0,1,1.0,1,0.21163162808732694,27
2725,0,8521,2024,6497,0,0,0,1.0,1,1.0,1,1.0,1,0.21163162808732694,27
2726,1,8522,2024,6498,0,0,0,1.0,1,1.0,1,1.0,1,0.18420773766848703,28
2727,0,8522,2024,6498,0,0,0,1.0,1,1.0,1,1.0,1,0.18708993527952023,29
2728,0,8522,2024,6498,0,0,0,1.0,1,1.0,1,1.0,1,0.16876890842163025,28
2729,0,8522,2024,6498,0,0,0,1.0,1,1.0,1,1.0,1,0.16876890842163025,28
2730,1,8523,2025,6498,0,0,0,1.0,1,1.0,1,1.0,1,0.1887456785129286,29
2731,3,8526,2025,6501,0,0,0,1.0,1,1.0,1,1.0,1,0.12667144286691664,30
2732,0,8526,2025,6501,0,0,0,1.0,1,1.0,1,1.0,1,0.15231114283008618,29
2733,1,8527,2026,6501,0,0,0,1.0,1,1.0,1,1.0,1,0.18494003181811117,29
2734,0,8527,2026,6501,0,0,0,1.0,1,1.0,1,1.0,1,0.18494003181811117,29
2735,2,8529,2028,6501,0,0,0,1.0,1,1.0,1,1.0,1,0.2809602568761881,29
2736,4,8533,2028,6505,0,0,0,1.0,1,1.0,1,1.0,1,0.2704065652351987,30
2737,4,8537,2029,6508,0,0,0,1.0,1,1.0,1,1.0,1,0.18273092905234342,30
2738,1,8538,2030,6508,0,0,0,1.0,1,1.0,1,1.0,1,0.19763051387501826,29
2739,1,8539,2030,6509,0,0,0,1.0,1,1.0,1,1.0,1,0.19631948396064042,30
2740,0,8539,2030,6509,0,0,0,1.0,1,1.0,1,1.0,1,0.22272056748107197,29
2741,1,8540,2031,6509,0,0,0,1.0,1,1.0,1,1.0,1,0.23530032381654403,29
2742,1,8541,2032,6509,0,0,0,1.0,1,1.0,1,1.0,1,0.2267836669182921,29
2743,4,8545,2033,6512,0,0,0,1.0,1,1.0,1,1.0,1,0.22820355517294458,30
2744,2,8547,2035,6512,0,0,0,1.0,1,1.0,1,1.0,1,0.3005757470692008,28
2745,3,8550,2035,6515,0,0,0,1.0,1,1.0,1,1.0,1,0.2881446869551348,27
2746,8,8558,2037,6521,0,0,0,1.0,1,1.0,1,1.0,1,0.27216899224577334,26
2747,1,8559,2038,6521,0,0,0,1.0,1,1.0,1,1.0,1,0.2993021694710866,22
2748,0,8559,2038,6521,0,0,0,1.0,1,1.0,1,1.0,1,0.2917591538723423,22
2749,0,8559,2038,6521,0,0,0,1.0,1,1.0,1,1.0,1,0.38817857484284896,20
2750,0,8559,2038,6521,0,0,0,1.0,1,1.0,1,1.0,1,0.3804498563378424,17
2751,0,8559,2038,6521,0,0,0,1.0,1,1.0,1,1.0,1,0.3804498563378424,17
2752,1,8560,2039,6521,0,0,0,1.0,1,1.0,1,1.0,1,0.36976110301510284,16
2753,0,8560,2039,6521,0,0,0,1.0,1,1.0,1,1.0,1,0.36976110301510284,16
2754,0,8560,2039,6521,0,0,0,1.0,1,1.0,1,1.0,1,0.36976110301510284,16
2755,0,8560,2039,6521,0,0,0,1.0,1,1.0,1,1.0,1,0.36976110301510284,16
2756,1,8561,2039,6522,0,0,0,1.0,1,1.0,1,1.0,1,0.3163714581768872,17
2757,1,8562,2039,6523,0,0,0,1.0,1,1.0,1,1.0,1,0.3711399347294802,18
2758,0,8562,2039,6523,0,0,0,1.0,1,1.0,1,1.0,1,0.3711399347294802,18
2759,2,8564,2040,6524,0,0,0,1.0,1,1.0,1,1.0,1,0.2956234981862269,19
2760,0,8564,2040,6524,0,0,0,1.0,1,1.0,1,1.0,1,0.3614742608861478,18
2761,1,8565,2040,6525,0,0,0,1.0,1,1.0,1,1.0,1,0.31439873316619876,18
2762,0,8565,2040,6525,0,0,0,1.0,1,1.0,1,1.0,1,0.31439873316619876,18
2763,0,8565,2040,6525,0,0,0,1.0,1,1.0,1,1.0,1,0.31439873316619876,18
2764,1,8566,2040,6526,0,0,0,1.0,1,1.0,1,1.0,1,0.23238371301860422,18
2765,0,8566,2040,6526,0,0,0,1.0,1,1.0,1,1.0,1,0.2449540887059761,18
2766,0,8566,2040,6526,0,0,0,1.0,1,1.0,1,1.0,1,0.2449540887059761,18
2767,0,8566,2040,6526,0,0,0,1.0,1,1.0,1,1.0,1,0.284151636693124,17
2768,0,8566,2040,6526,0,0,0,1.0,1,1.0,1,1.0,1,0.284151636693124,17
2769,1,8567,2041,6526,0,0,0,1.0,1,1.0,1,1.0,1,0.2454906368100797,17
2770,0,8567,2041,6526,0,0,0,1.0,1,1.0,1,1.0,1,0.2454906368100797,17
2771,0,8567,2041,6526,0,0,0,1.0,1,1.0,1,1.0,1,0.2454906368100797,17
2772,0,8567,2041,6526,0,0,0,1.0,1,1.0,1,1.0,1,0.2454906368100797,17
2773,0,8567,2041,6526,0,0,0,1.0,1,1.0,1,1.0,1,0.2454906368100797,17
2774,0,8567,2041,6526,0,0,0,1.0,1,1.0,1,1.0,1,0.20595916497154076,18
2775,2,8569,2043,6526,0,0,0,1.0,1,1.0,1,1.0,1,0.2607626574584123,20
2776,0,8569,2043,6526,0,0,0,1.0,1,1.0,1,1.0,1,0.2530338044439026,21
2777,0,8569,2043,6526,0,0,0,1.0,1,1.0,1,1.0,1,0.2530338044439026,21
2778,5,8574,2046,6528,0,0,0,1.0,1,1.0,1,1.0,1,0.37192242506584805,21
2779,3,8577,2047,6530,0,0,0,1.0,1,1.0,1,1.0,1,0.3312822410018865,22
2780,3,8580,2048,6532,0,0,0,1.0,1,1.0,1,1.0,1,0.3436402861788182,22
2781,4,8584,2049,6535,0,0,0,1.0,1,1.0,1,1.0,1,0.2912269685953921,22
2782,0,8584,2049,6535,0,0,0,1.0,1,1.0,1,1.0,1,0.23644460777038123,23
2783,0,8584,2049,6535,0,0,0,1.0,1,1.0,1,1.0,1,0.20704313219356474,22
2784,2,8586,2050,6536,0,0,0,1.0,1,1.0,1,1.0,1,0.1970640475505694,21
2785,0,8586,2050,6536,0,0,0,1.0,1,1.0,1,1.0,1,0.16296417324669105,19
2786,0,8586,2050,6536,0,0,0,1.0,1,1.0,1,1.0,1,0.16296417324669105,19
2787,1,8587,2050,6537,0,0,0,1.0,1,1.0,1,1.0,1,0.16869136468219306,20
2788,1,8588,2051,6537,0,0,0,1.0,1,1.0,1,1.0,1,0.17134778540112744,20
2789,0,8588,2051,6537,0,0,0,1.0,1,1.0,1,1.0,1,0.19421454761409696,19
2790,0,8588,2051,6537,0,0,0,1.0,1,1.0,1,1.0,1,0.1908831571176168,20
2791,0,8588,2051,6537,0,0,0,1.0,1,1.0,1,1.0,1,0.1908831571176168,20
2792,0,8588,2051,6537,0,0,0,1.0,1,1.0,1,1.0,1,0.1908831571176168,20
2793,0,8588,2051,6537,0,0,0,1.0,1,1.0,1,1.0,1,0.20498405421829302,19
2794,0,8588,2051,6537,0,0,0,1.0,1,1.0,1,1.0,1,0.23074625932547738,20
2795,0,8588,2051,6537,0,0,0,1.0,1,1.0,1,1.0,1,0.22881454748656566,21
2796,0,8588,2051,6537,0,0,0,1.0,1,1.0,1,1.0,1,0.2094750451513537,22
2797,0,8588,2051,6537,0,0,0,1.0,1,1.0,1,1.0,1,0.21834179000574577,21
2798,1,8589,2052,6537,0,0,0,1.0,1,1.0,1,1.0,1,0.2759686070330867,21
2799,0,8589,2052,6537,0,0,0,1.0,1,1.0,1,1.0,1,0.25645939950258667,20
2800,0,8589,2052,6537,0,0,0,1.0,1,1.0,1,1.0,1,0.25645939950258667,20
2801,0,8589,2052,6537,0,0,0,1.0,1,1.0,1,1.0,1,0.25645939950258667,20
2802,1,8590,2052,6538,0,0,0,1.0,1,1.0,1,1.0,1,0.2053132656121226,20
2803,1,8591,2052,6539,0,0,0,1.0,1,1.0,1,1.0,1,0.1971312571706205,21
2804,1,8592,2052,6540,0,0,0,1.0,1,1.0,1,1.0,1,0.21774921062231956,22
2805,2,8594,2053,6541,0,0,0,1.0,1,1.0,1,1.0,1,0.2205038507647492,22
2806,4,8598,2055,6543,0,0,0,1.0,1,1.0,1,1.0,1,0.18971503954333843,23
2807,1,8599,2056,6543,0,0,0,1.0,1,1.0,1,1.0,1,0.23976039427859833,24
2808,3,8602,2058,6544,0,0,0,1.0,1,1.0,1,1.0,1,0.29544507735594305,24
2809,3,8605,2058,6547,0,0,0,1.0,1,1.0,1,1.0,1,0.26534140348495916,26
2810,1,8606,2058,6548,0,0,0,1.0,1,1.0,1,1.0,1,0.17639626533977726,26
2811,0,8606,2058,6548,0,0,0,1.0,1,1.0,1,1.0,1,0.1875465533612254,27
2812,1,8607,2058,6549,0,0,0,1.0,1,1.0,1,1.0,1,0.170990382462989,27
2813,0,8607,2058,6549,0,0,0,1.0,1,1.0,1,1.0,1,0.15750860591097976,28
2814,2,8609,2058,6551,0,0,0,1.0,1,1.0,1,1.0,1,0.18711513930150606,29
2815,1,8610,2058,6552,0,0,0,1.0,1,1.0,1,1.0,1,0.1833390705347202,30
2816,3,8613,2059,6554,0,0,0,1.0,1,1.0,1,1.0,1,0.14185659323565342,31
2817,1,8614,2059,6555,0,0,0,1.0,1,1.0,1,1.0,1,0.15018179496896503,31
2818,4,8618,2060,6558,0,0,0,1.0,1,1.0,1,1.0,1,0.13082043489307751,32
2819,2,8620,2060,6560,0,0,0,1.0,1,1.0,1,1.0,1,0.13082043489307751,32
2820,2,8622,2060,6562,0,0,0,1.0,1,1.0,1,1.0,1,0.14352434889312868,33
2821,2,8624,2061,6563,0,0,0,1.0,1,1.0,1,1.0,1,0.14284295466176775,34
2822,0,8624,2061,6563,0,0,0,1.0,1,1.0,1,1.0,1,0.11091695920596098,35
2823,1,8625,2062,6563,0,0,0,1.0,1,1.0,1,1.0,1,0.16010225438303985,31
2824,2,8627,2064,6563,0,0,0,1.0,1,1.0,1,1.0,1,0.2812062131419717,33
2825,1,8628,2064,6564,0,0,0,1.0,1,1.0,1,1.0,1,0.2416618253472438,31
2826,0,8628,2064,6564,0,0,0,1.0,1,1.0,1,1.0,1,0.2416618253472438,31
2827,3,8631,2067,6564,0,0,0,1.0,1,1.0,1,1.0,1,0.25877585955781024,32
2828,3,8634,2068,6566,0,0,0,1.0,1,1.0,1,1.0,1,0.27702032162525314,33
2829,0,8634,2068,6566,0,0,0,1.0,1,1.0,1,1.0,1,0.27702032162525314,33
2830,8,8642,2070,6572,0,0,0,1.0,1,1.0,1,1.0,1,0.29546299150228444,32
2831,1,8643,2070,6573,0,0,0,1.0,1,1.0,1,1.0,1,0.24324060113017498,31
2832,0,8643,2070,6573,0,0,0,1.0,1,1.0,1,1.0,1,0.27045360517026257,30
2833,1,8644,2071,6573,0,0,0,1.0,1,1.0,1,1.0,1,0.3354602330474809,29
2834,5,8649,2074,6575,0,0,0,1.0,1,1.0,1,1.0,1,0.34231388513935035,29
2835,2,8651,2075,6576,0,0,0,1.0,1,1.0,1,1.0,1,0.33543654413407553,27
2836,6,8657,2075,6582,0,0,0,1.0,1,1.0,1,1.0,1,0.15965218232638415,27
2837,2,8659,2075,6584,0,0,0,1.0,1,1.0,1,1.0,1,0.16685768353104738,28
2838,1,8660,2076,6584,0,0,0,1.0,1,1.0,1,1.0,1,0.19382022239247249,29
2839,0,8660,2076,6584,0,0,0,1.0,1,1.0,1,1.0,1,0.22351207200465742,29
2840,1,8661,2076,6585,0,0,0,1.0,1,1.0,1,1.0,1,0.17126891663104718,29
2841,0,8661,2076,6585,0,0,0,1.0,1,1.0,1,1.0,1,0.2044879385518343,31
2842,3,8664,2077,6587,0,0,0,1.0,1,1.0,1,1.0,1,0.26797174703831345,32
2843,6,8670,2077,6593,0,0,0,1.0,1,1.0,1,1.0,1,0.27215661678093805,32
2844,6,8676,2078,6598,0,0,0,1.0,1,1.0,1,1.0,1,0.18255588763102243,33
2845,8,8684,2079,6605,0,0,0,1.0,1,1.0,1,1.0,1,0.20815585899464262,34
2846,5,8689,2080,6609,0,0,0,1.0,1,1.0,1,1.0,1,0.23563192826173326,34
2847,6,8695,2081,6614,0,0,0,1.0,1,1.0,1,1.0,1,0.2123865460864633,35
2848,9,8704,2082,6622,0,0,0,1.0,1,1.0,1,1.0,1,0.2130038579149383,37
2849,7,8711,2083,6628,0,0,0,1.0,1,1.0,1,1.0,1,0.25257639127475556,37
2850,6,8717,2083,6634,0,0,0,1.0,1,1.0,1,1.0,1,0.2026024779366218,37
2851,1,8718,2083,6635,0,0,0,1.0,1,1.0,1,1.0,1,0.18478768779560067,38
2852,2,8720,2084,6636,0,0,0,1.0,1,1.0,1,1.0,1,0.15578533130127104,36
2853,0,8720,2084,6636,0,0,0,1.0,1,1.0,1,1.0,1,0.19951735429529785,36
2854,1,8721,2084,6637,0,0,0,1.0,1,1.0,1,1.0,1,0.2042684392280607,37
2855,4,8725,2084,6641,0,0,0,1.0,1,1.0,1,1.0,1,0.1652125307744627,37
2856,0,8725,2084,6641,0,0,0,1.0,1,1.0,1,1.0,1,0.14908731522881535,38
2857,1,8726,2085,6641,0,0,0,1.0,1,1.0,1,1.0,1,0.21529702395939027,39
2858,1,8727,2085,6642,0,0,0,1.0,1,1.0,1,1.0,1,0.24503602677958175,39
2859,3,8730,2085,6645,0,0,0,1.0,1,1.0,1,1.0,1,0.18766037553234588,39
2860,3,8733,2085,6648,0,0,0,1.0,1,1.0,1,1.0,1,0.19491301442002812,40
2861,0,8733,2085,6648,0,0,0,1.0,1,1.0,1,1.0,1,0.19929245626117212,38
2862,6,8739,2088,6651,0,0,0,1.0,1,1.0,1,1.0,1,0.21236766400684481,38
2863,4,8743,2089,6654,0,0,0,1.0,1,1.0,1,1.0,1,0.20053372385911997,37
2864,4,8747,2092,6655,0,0,0,1.0,1,1.0,1,1.0,1,0.2819643467790968,35
2865,3,8750,2092,6658,0,0,0,1.0,1,1.0,1,1.0,1,0.3034214313629387,33
2866,6,8756,2095,6661,0,0,0,1.0,1,1.0,1,1.0,1,0.20082177893865005,31
2867,2,8758,2096,6662,0,0,0,1.0,1,1.0,1,1.0,1,0.22414046639385254,30
2868,3,8761,2097,6664,0,0,0,1.0,1,1.0,1,1.0,1,0.2005542990418069,31
2869,4,8765,2100,6665,0,0,0,1.0,1,1.0,1,1.0,1,0.28103192445322667,30
2870,1,8766,2100,6666,0,0,0,1.0,1,1.0,1,1.0,1,0.30504079858194927,26
2871,3,8769,2101,6668,0,0,0,1.0,1,1.0,1,1.0,1,0.2702027056681389,27
2872,0,8769,2101,6668,0,0,0,1.0,1,1.0,1,1.0,1,0.2708148491025146,25
2873,0,8769,2101,6668,0,0,0,1.0,1,1.0,1,1.0,1,0.28037847074941247,24
2874,1,8770,2101,6669,0,0,0,1.0,1,1.0,1,1.0,1,0.24330134432260705,25
2875,0,8770,2101,6669,0,0,0,1.0,1,1.0,1,1.0,1,0.26811295168836036,26
2876,5,8775,2102,6673,0,0,0,1.0,1,1.0,1,1.0,1,0.2715429551495337,28
2877,0,8775,2102,6673,0,0,0,1.0,1,1.0,1,1.0,1,0.2618139873897217,29
2878,1,8776,2103,6673,0,0,0,1.0,1,1.0,1,1.0,1,0.20647746244007462,31
2879,0,8776,2103,6673,0,0,0,1.0,1,1.0,1,1.0,1,0.20647746244007462,31
2880,0,8776,2103,6673,0,0,0,1.0,1,1.0,1,1.0,1,0.17937806432625672,32
2881,1,8777,2103,6674,0,0,0,1.0,1,1.0,1,1.0,1,0.1671468367409031,31
2882,1,8778,2103,6675,0,0,0,1.0,1,1.0,1,1.0,1,0.14603518137313823,31
2883,0,8778,2103,6675,0,0,0,1.0,1,1.0,1,1.0,1,0.16029869828782262,32
2884,0,8778,2103,6675,0,0,0,1.0,1,1.0,1,1.0,1,0.16029869828782262,32
2885,2,8780,2104,6676,0,0,0,1.0,1,1.0,1,1.0,1,0.15602243832931742,33
2886,3,8783,2105,6678,0,0,0,1.0,1,1.0,1,1.0,1,0.13797910868519309,34
2887,0,8783,2105,6678,0,0,0,1.0,1,1.0,1,1.0,1,0.14622150437276193,34
2888,1,8784,2106,6678,0,0,0,1.0,1,1.0,1,1.0,1,0.1584265988299706,34
2889,2,8786,2107,6679,0,0,0,1.0,1,1.0,1,1.0,1,0.17271199527657352,37
2890,1,8787,2107,6680,0,0,0,1.0,1,1.0,1,1.0,1,0.17233395701227858,37
2891,2,8789,2108,6681,0,0,0,1.0,1,1.0,1,1.0,1,0.20384546942463969,37
2892,0,8789,2108,6681,0,0,0,1.0,1,1.0,1,1.0,1,0.20384546942463969,37
2893,4,8793,2109,6684,0,0,0,1.0,1,1.0,1,1.0,1,0.20981177843834237,38
2894,3,8796,2109,6687,0,0,0,1.0,1,1.0,1,1.0,1,0.15194660867546197,39
2895,3,8799,2110,6689,0,0,0,1.0,1,1.0,1,1.0,1,0.14765922850321994,40
2896,3,8802,2111,6691,0,0,0,1.0,1,1.0,1,1.0,1,0.14350091036448775,41
2897,6,8808,2112,6696,0,0,0,1.0,1,1.0,1,1.0,1,0.12419445171422867,41
2898,4,8812,2114,6698,0,0,0,1.0,1,1.0,1,1.0,1,0.1840175209748098,41
2899,1,8813,2115,6698,0,0,0,1.0,1,1.0,1,1.0,1,0.22138328342250244,39
2900,4,8817,2118,6699,0,0,0,1.0,1,1.0,1,1.0,1,0.3239984604616263,40
2901,2,8819,2118,6701,0,0,0,1.0,1,1.0,1,1.0,1,0.2545924422993171,40
2902,3,8822,2120,6702,0,0,0,1.0,1,1.0,1,1.0,1,0.2908484811914073,38
2903,4,8826,2121,6705,0,0,0,1.0,1,1.0,1,1.0,1,0.2143144980657858,36
2904,3,8829,2122,6707,0,0,0,1.0,1,1.0,1,1.0,1,0.17966744252063585,36
2905,1,8830,2122,6708,0,0,0,1.0,1,1.0,1,1.0,1,0.1239187491224985,35
2906,0,8830,2122,6708,0,0,0,1.0,1,1.0,1,1.0,1,0.14075292961235245,36
2907,1,8831,2123,6708,0,0,0,1.0,1,1.0,1,1.0,1,0.18349664290546894,37
2908,4,8835,2123,6712,0,0,0,1.0,1,1.0,1,1.0,1,0.18404490439594093,38
2909,1,8836,2124,6712,0,0,0,1.0,1,1.0,1,1.0,1,0.20691934786488045,37
2910,1,8837,2124,6713,0,0,0,1.0,1,1.0,1,1.0,1,0.17934721489633104,37
2911,0,8837,2124,6713,0,0,0,1.0,1,1.0,1,1.0,1,0.2228279460751913,36
2912,3,8840,2126,6714,0,0,0,1.0,1,1.0,1,1.0,1,0.25739250660577945,36
2913,3,8843,2127,6716,0,0,0,1.0,1,1.0,1,1.0,1,0.19718550537150867,36
2914,1,8844,2128,6716,0,0,0,1.0,1,1.0,1,1.0,1,0.2132313362812497,38
2915,1,8845,2128,6717,0,0,0,1.0,1,1.0,1,1.0,1,0.18199737929635346,37
2916,2,8847,2128,6719,0,0,0,1.0,1,1.0,1,1.0,1,0.18152186819433128,39
2917,3,8850,2129,6721,0,0,0,1.0,1,1.0,1,1.0,1,0.2043842739747214,40
2918,2,8852,2130,6722,0,0,0,1.0,1,1.0,1,1.0,1,0.21520802374512643,40
2919,5,8857,2131,6726,0,0,0,1.0,1,1.0,1,1.0,1,0.17132341487670213,42
2920,2,8859,2131,6728,0,0,0,1.0,1,1.0,1,1.0,1,0.1643161800142882,42
2921,0,8859,2131,6728,0,0,0,1.0,1,1.0,1,1.0,1,0.1643161800142882,42
2922,3,8862,2131,6731,0,0,0,1.0,1,1.0,1,1.0,1,0.17213121367724174,43
2923,1,8863,2131,6732,0,0,0,1.0,1,1.0,1,1.0,1,0.18249128871025083,45
2924,3,8866,2132,6734,0,0,0,1.0,1,1.0,1,1.0,1,0.16759501648031258,46
2925,4,8870,2132,6738,0,0,0,1.0,1,1.0,1,1.0,1,0.1651911713344217,46
2926,7,8877,2132,6745,0,0,0,1.0,1,1.0,1,1.0,1,0.15794015807996972,46
2927,6,8883,2133,6750,0,0,0,1.0,1,1.0,1,1.0,1,0.1400282165441114,48
2928,11,8894,2134,6760,0,0,0,1.0,1,1.0,1,1.0,1,0.15008276240789928,48
2929,11,8905,2134,6771,0,0,0,1.0,1,1.0,1,1.0,1,0.18357773921266354,48
2930,9,8914,2134,6780,0,0,0,1.0,1,1.0,1,1.0,1,0.20479670407926606,50
2931,8,8922,2135,6787,0,0,0,1.0,1,1.0,1,1.0,1,0.16560116243332776,51
2932,10,8932,2135,6797,0,0,0,1.0,1,1.0,1,1.0,1,0.15890378519378692,52
2933,11,8943,2135,6808,0,0,0,1.0,1,1.0,1,1.0,1,0.17652057216198608,53
2934,12,8955,2136,6819,0,0,0,1.0,1,1.0,1,1.0,1,0.19898540277188978,54
2935,11,8966,2136,6830,0,0,0,1.0,1,1.0,1,1.0,1,0.16077946018278888,53
2936,12,8978,2136,6842,0,0,0,1.0,1,1.0,1,1.0,1,0.16077946018278888,53
2937,6,8984,2136,6848,0,0,0,1.0,1,1.0,1,1.0,1,0.22031251329660753,51
2938,11,8995,2137,6858,0,0,0,1.0,1,1.0,1,1.0,1,0.2471585119469475,53
2939,12,9007,2137,6870,0,0,0,1.0,1,1.0,1,1.0,1,0.261036450473289,52
2940,10,9017,2138,6879,0,0,0,1.0,1,1.0,1,1.0,1,0.2135491163925732,52
2941,4,9021,2138,6883,0,0,0,1.0,1,1.0,1,1.0,1,0.14730204883665962,50
2942,2,9023,2139,6884,0,0,0,1.0,1,1.0,1,1.0,1,0.17141155906209737,50
2943,2,9025,2140,6885,0,0,0,1.0,1,1.0,1,1.0,1,0.16655901373559268,49
2944,3,9028,2141,6887,0,0,0,1.0,1,1.0,1,1.0,1,0.14644835928990946,48
2945,3,9031,2142,6889,0,0,0,1.0,1,1.0,1,1.0,1,0.14277332776496712,48
2946,5,9036,2143,6893,0,0,0,1.0,1,1.0,1,1.0,1,0.10484344302932064,47
2947,2,9038,2143,6895,0,0,0,1.0,1,1.0,1,1.0,1,0.08868648699515574,47
2948,1,9039,2143,6896,0,0,0,1.0,1,1.0,1,1.0,1,0.11079881855127226,48
2949,3,9042,2143,6899,0,0,0,1.0,1,1.0,1,1.0,1,0.1048735381737924,48
2950,2,9044,2143,6901,0,0,0,1.0,1,1.0,1,1.0,1,0.1048735381737924,48
2951,3,9047,2144,6903,0,0,0,1.0,1,1.0,1,1.0,1,0.15735036315090703,50
2952,3,9050,2144,6906,0,0,0,1.0,1,1.0,1,1.0,1,0.1456300837371138,50
2953,5,9055,2144,6911,0,0,0,1.0,1,1.0,1,1.0,1,0.18537200830776845,51
2954,5,9060,2144,6916,0,0,0,1.0,1,1.0,1,1.0,1,0.19825869596551016,51
2955,3,9063,2144,6919,0,0,0,1.0,1,1.0,1,1.0,1,0.17524626602716176,51
2956,6,9069,2145,6924,0,0,0,1.0,1,1.0,1,1.0,1,0.1395603407455806,51
2957,1,9070,2145,6925,0,0,0,1.0,1,1.0,1,1.0,1,0.1419313522582356,52
2958,1,9071,2145,6926,0,0,0,1.0,1,1.0,1,1.0,1,0.1239619636065115,52
2959,2,9073,2146,6927,0,0,0,1.0,1,1.0,1,1.0,1,0.12005918478774584,53
2960,0,9073,2146,6927,0,0,0,1.0,1,1.0,1,1.0,1,0.10811503232049581,52
2961,2,9075,2146,6929,0,0,0,1.0,1,1.0,1,1.0,1,0.08766258205153034,53
2962,1,9076,2146,6930,0,0,0,1.0,1,1.0,1,1.0,1,0.08859142107298591,54
2963,3,9079,2147,6932,0,0,0,1.0,1,1.0,1,1.0,1,0.12968083969405284,55
2964,3,9082,2147,6935,0,0,0,1.0,1,1.0,1,1.0,1,0.14987067173046625,55
2965,2,9084,2147,6937,0,0,0,1.0,1,1.0,1,1.0,1,0.14807739613262186,55
2966,3,9087,2147,6940,0,0,0,1.0,1,1.0,1,1.0,1,0.14475420676227838,55
2967,2,9089,2147,6942,0,0,0,1.0,1,1.0,1,1.0,1,0.163313692238332,56
2968,3,9092,2147,6945,0,0,0,1.0,1,1.0,1,1.0,1,0.1592872676407526,56
2969,8,9100,2148,6952,0,0,0,1.0,1,1.0,1,1.0,1,0.1622826474347433,55
2970,6,9106,2149,6957,0,0,0,1.0,1,1.0,1,1.0,1,0.1779890361709992,57
2971,5,9111,2150,6961,0,0,0,1.0,1,1.0,1,1.0,1,0.14233207346471233,56
2972,1,9112,2151,6961,0,0,0,1.0,1,1.0,1,1.0,1,0.14727543066570412,57
2973,1,9113,2151,6962,0,0,0,1.0,1,1.0,1,1.0,1,0.13606872144350188,59
2974,0,9113,2151,6962,0,0,0,1.0,1,1.0,1,1.0,1,0.1340643048122631,60
2975,4,9117,2153,6964,0,0,0,1.0,1,1.0,1,1.0,1,0.16456635347990003,58
2976,2,9119,2154,6965,0,0,0,1.0,1,1.0,1,1.0,1,0.14076815553057043,59
2977,3,9122,2155,6967,0,0,0,1.0,1,1.0,1,1.0,1,0.15442200365037784,59
2978,3,9125,2156,6969,0,0,0,1.0,1,1.0,1,1.0,1,0.21405757470778855,58
2979,6,9131,2158,6973,0,0,0,1.0,1,1.0,1,1.0,1,0.215167999075892,57
2980,6,9137,2158,6979,0,0,0,1.0,1,1.0,1,1.0,1,0.19092862282281142,56
2981,2,9139,2159,6980,0,0,0,1.0,1,1.0,1,1.0,1,0.20792353996619015,56
2982,6,9145,2162,6983,0,0,0,1.0,1,1.0,1,1.0,1,0.1766190228052061,57
2983,7,9152,2164,6988,0,0,0,1.0,1,1.0,1,1.0,1,0.15982311601410765,57
2984,3,9155,2165,6990,0,0,0,1.0,1,1.0,1,1.0,1,0.15556940372755124,56
2985,8,9163,2166,6997,0,0,0,1.0,1,1.0,1,1.0,1,0.17553532173863082,55
2986,14,9177,2170,7007,0,0,0,1.0,1,1.0,1,1.0,1,0.043386732058730074,55
2987,1,9178,2170,7008,0,0,0,1.0,1,1.0,1,1.0,1,0.08872221133441918,51
2988,2,9180,2171,7009,0,0,0,1.0,1,1.0,1,1.0,1,0.07188270077418084,52
2989,1,9181,2171,7010,0,0,0,1.0,1,1.0,1,1.0,1,0.12162580434803008,50
2990,6,9187,2172,7015,0,0,0,1.0,1,1.0,1,1.0,1,0.1487090462958722,50
2991,2,9189,2172,7017,0,0,0,1.0,1,1.0,1,1.0,1,0.11073871535170556,50
2992,3,9192,2173,7019,0,0,0,1.0,1,1.0,1,1.0,1,0.11858626889663436,50
2993,2,9194,2173,7021,0,0,0,1.0,1,1.0,1,1.0,1,0.16419491321606966,51
2994,4,9198,2174,7024,0,0,0,1.0,1,1.0,1,1.0,1,0.17870423622369902,51
2995,4,9202,2175,7027,0,0,0,1.0,1,1.0,1,1.0,1,0.19634897259167028,51
2996,5,9207,2176,7031,0,0,0,1.0,1,1.0,1,1.0,1,0.19779680689495152,52
2997,4,9211,2176,7035,0,0,0,1.0,1,1.0,1,1.0,1,0.21843214816488957,52
2998,8,9219,2178,7041,0,0,0,1.0,1,1.0,1,1.0,1,0.2499618665791612,51
2999,7,9226,2178,7048,0,0,0,1.0,1,1.0,1,1.0,1,0.2548248902207401,51
3000,5,9231,2180,7051,0,0,0,1.0,1,1.0,1,1.0,1,0.2046329547929871,52
3001,8,9239,2180,7059,0,0,0,1.0,1,1.0,1,1.0,1,0.14201104780415416,52
3002,1,9240,2180,7060,0,0,0,1.0,1,1.0,1,1.0,1,0.1310499122468913,53
3003,0,9240,2180,7060,0,0,0,1.0,1,1.0,1,1.0,1,0.1174758282497215,54
3004,2,9242,2181,7061,0,0,0,1.0,1,1.0,1,1.0,1,0.13951959212392184,55
3005,1,9243,2181,7062,0,0,0,1.0,1,1.0,1,1.0,1,0.13564186874642364,56
3006,7,9250,2182,7068,0,0,0,1.0,1,1.0,1,1.0,1,0.10859236658367025,57
3007,3,9253,2182,7071,0,0,0,1.0,1,1.0,1,1.0,1,0.10153111365546458,58
3008,7,9260,2183,7077,0,0,0,1.0,1,1.0,1,1.0,1,0.12405467166999365,59
3009,3,9263,2183,7080,0,0,0,1.0,1,1.0,1,1.0,1,0.1062547268452854,59
3010,4,9267,2184,7083,0,0,0,1.0,1,1.0,1,1.0,1,0.11525175210247379,59
3011,5,9272,2185,7087,0,0,0,1.0,1,1.0,1,1.0,1,0.14721347960251097,59
3012,7,9279,2185,7094,0,0,0,1.0,1,1.0,1,1.0,1,0.1230549040124445,61
3013,7,9286,2186,7100,0,0,0,1.0,1,1.0,1,1.0,1,0.1493422579251087,59
3014,13,9299,2187,7112,0,0,0,1.0,1,1.0,1,1.0,1,0.16955594904381915,60
3015,9,9308,2187,7121,0,0,0,1.0,1,1.0,1,1.0,1,0.18076759532857342,58
3016,10,9318,2189,7129,0,0,0,1.0,1,1.0,1,1.0,1,0.14661870148448453,57
3017,3,9321,2191,7130,0,0,0,1.0,1,1.0,1,1.0,1,0.1455162886962654,58
3018,3,9324,2191,7133,0,0,0,1.0,1,1.0,1,1.0,1,0.16641000581168341,55
3019,4,9328,2192,7136,0,0,0,1.0,1,1.0,1,1.0,1,0.17000634005864212,56
3020,6,9334,2193,7141,0,0,0,1.0,1,1.0,1,1.0,1,0.23362339156793366,55
3021,13,9347,2194,7153,0,0,0,1.0,1,1.0,1,1.0,1,0.2182731560387962,55
3022,11,9358,2195,7163,0,0,0,1.0,1,1.0,1,1.0,1,0.21498000687536975,55
3023,5,9363,2196,7167,0,0,0,1.0,1,1.0,1,1.0,1,0.19506150844123668,54
3024,9,9372,2197,7175,0,0,0,1.0,1,1.0,1,1.0,1,0.17754595594284853,54
3025,8,9380,2198,7182,0,0,0,1.0,1,1.0,1,1.0,1,0.16869367811827493,54
3026,5,9385,2198,7187,0,0,0,1.0,1,1.0,1,1.0,1,0.1727197794823878,53
3027,10,9395,2201,7194,0,0,0,1.0,1,1.0,1,1.0,1,0.157107260151302,53
3028,5,9400,2202,7198,0,0,0,1.0,1,1.0,1,1.0,1,0.1830484652205728,51
3029,6,9406,2203,7203,0,0,0,1.0,1,1.0,1,1.0,1,0.22988997925506646,51
3030,6,9412,2205,7207,0,0,0,1.0,1,1.0,1,1.0,1,0.21221284894514983,52
3031,6,9418,2206,7212,0,0,0,1.0,1,1.0,1,1.0,1,0.14609523724009513,51
3032,1,9419,2206,7213,0,0,0,1.0,1,1.0,1,1.0,1,0.1015303610379801,50
3033,2,9421,2207,7214,0,0,0,1.0,1,1.0,1,1.0,1,0.10797669301660219,52
3034,3,9424,2208,7216,0,0,0,1.0,1,1.0,1,1.0,1,0.09019443432083189,51
3035,2,9426,2208,7218,0,0,0,1.0,1,1.0,1,1.0,1,0.09112984051555727,51
3036,1,9427,2208,7219,0,0,0,1.0,1,1.0,1,1.0,1,0.08669791089219703,53
3037,0,9427,2208,7219,0,0,0,1.0,1,1.0,1,1.0,1,0.10017595745294716,52
3038,0,9427,2208,7219,0,0,0,1.0,1,1.0,1,1.0,1,0.10017595745294716,52
3039,3,9430,2208,7222,0,0,0,1.0,1,1.0,1,1.0,1,0.08272341844265059,54
3040,2,9432,2208,7224,0,0,0,1.0,1,1.0,1,1.0,1,0.10277236457496551,55
3041,2,9434,2208,7226,0,0,0,1.0,1,1.0,1,1.0,1,0.10920582366096693,56
3042,3,9437,2210,7227,0,0,0,1.0,1,1.0,1,1.0,1,0.16144490170513273,56
3043,8,9445,2211,7234,0,0,0,1.0,1,1.0,1,1.0,1,0.16979182935453496,57
3044,12,9457,2214,7243,0,0,0,1.0,1,1.0,1,1.0,1,0.1800648599185884,57
3045,8,9465,2214,7251,0,0,0,1.0,1,1.0,1,1.0,1,0.19388374472021397,56
3046,10,9475,2216,7259,0,0,0,1.0,1,1.0,1,1.0,1,0.07570185421377451,57
3047,0,9475,2216,7259,0,0,0,1.0,1,1.0,1,1.0,1,0.08879735960082683,56
3048,2,9477,2216,7261,0,0,0,1.0,1,1.0,1,1.0,1,0.09827662924141031,58
3049,3,9480,2217,7263,0,0,0,1.0,1,1.0,1,1.0,1,0.1318558388617773,59
3050,3,9483,2217,7266,0,0,0,1.0,1,1.0,1,1.0,1,0.0775180205755927,60
3051,2,9485,2217,7268,0,0,0,1.0,1,1.0,1,1.0,1,0.08550936968074448,59
3052,1,9486,2218,7268,0,0,0,1.0,1,1.0,1,1.0,1,0.0688627418889885,58
3053,2,9488,2219,7269,0,0,0,1.0,1,1.0,1,1.0,1,0.11084619273420968,57
3054,3,9491,2221,7270,0,0,0,1.0,1,1.0,1,1.0,1,0.13769011191562341,55
3055,1,9492,2221,7271,0,0,0,1.0,1,1.0,1,1.0,1,0.12074391417502063,54
3056,6,9498,2223,7275,0,0,0,1.0,1,1.0,1,1.0,1,0.16043427066352522,55
3057,4,9502,2224,7278,0,0,0,1.0,1,1.0,1,1.0,1,0.19131741199851818,54
3058,6,9508,2225,7283,0,0,0,1.0,1,1.0,1,1.0,1,0.23567004421302012,55
3059,4,9512,2225,7287,0,0,0,1.0,1,1.0,1,1.0,1,0.24407524886319545,56
3060,7,9519,2225,7294,0,0,0,1.0,1,1.0,1,1.0,1,0.23937138071106626,56
3061,5,9524,2225,7299,0,0,0,1.0,1,1.0,1,1.0,1,0.18565739281557878,56
3062,3,9527,2228,7299,0,0,0,1.0,1,1.0,1,1.0,1,0.23258541380584496,57
3063,0,9527,2228,7299,0,0,0,1.0,1,1.0,1,1.0,1,0.2043469125371984,55
3064,1,9528,2229,7299,0,0,0,1.0,1,1.0,1,1.0,1,0.23587281674808394,56
3065,2,9530,2230,7300,0,0,0,1.0,1,1.0,1,1.0,1,0.2002113372392548,55
3066,4,9534,2231,7303,0,0,0,1.0,1,1.0,1,1.0,1,0.19698907156885231,55
3067,2,9536,2232,7304,0,0,0,1.0,1,1.0,1,1.0,1,0.19964428225910227,54
3068,4,9540,2235,7305,0,0,0,1.0,1,1.0,1,1.0,1,0.23979998266710492,53
3069,5,9545,2238,7307,0,0,0,1.0,1,1.0,1,1.0,1,0.22139612242382498,51
3070,2,9547,2238,7309,0,0,0,1.0,1,1.0,1,1.0,1,0.18571085270833698,50
3071,3,9550,2239,7311,0,0,0,1.0,1,1.0,1,1.0,1,0.1634186112458648,51
3072,5,9555,2241,7314,0,0,0,1.0,1,1.0,1,1.0,1,0.17484489227354674,53
3073,3,9558,2241,7317,0,0,0,1.0,1,1.0,1,1.0,1,0.17977046831736282,51
3074,2,9560,2242,7318,0,0,0,1.0,1,1.0,1,1.0,1,0.14811390181954848,50
3075,3,9563,2243,7320,0,0,0,1.0,1,1.0,1,1.0,1,0.17231646771896675,52
3076,7,9570,2245,7325,0,0,0,1.0,1,1.0,1,1.0,1,0.13111177486365766,53
3077,2,9572,2245,7327,0,0,0,1.0,1,1.0,1,1.0,1,0.12475495430448857,52
3078,2,9574,2245,7329,0,0,0,1.0,1,1.0,1,1.0,1,0.1557038213230008,53
3079,2,9576,2246,7330,0,0,0,1.0,1,1.0,1,1.0,1,0.14402052404293442,53
3080,3,9579,2247,7332,0,0,0,1.0,1,1.0,1,1.0,1,0.19730475272657874,52
3081,8,9587,2248,7339,0,0,0,1.0,1,1.0,1,1.0,1,0.17837946818663505,54
3082,7,9594,2251,7343,0,0,0,1.0,1,1.0,1,1.0,1,0.2245599136793956,54
3083,9,9603,2251,7352,0,0,0,1.0,1,1.0,1,1.0,1,0.21621556312661724,54
3084,8,9611,2252,7359,0,0,0,1.0,1,1.0,1,1.0,1,0.19800967321077587,55
3085,6,9617,2253,7364,0,0,0,1.0,1,1.0,1,1.0,1,0.2548686089337429,55
3086,7,9624,2253,7371,0,0,0,1.0,1,1.0,1,1.0,1,0.250897120962743,56
3087,13,9637,2253,7384,0,0,0,1.0,1,1.0,1,1.0,1,0.26228984357837576,57
3088,9,9646,2253,7393,0,0,0,1.0,1,1.0,1,1.0,1,0.2259105954701334,56
3089,10,9656,2253,7403,0,0,0,1.0,1,1.0,1,1.0,1,0.23628366637378279,55
3090,7,9663,2253,7410,0,0,0,1.0,1,1.0,1,1.0,1,0.24308584534669853,54
3091,5,9668,2253,7415,0,0,0,1.0,1,1.0,1,1.0,1,0.19846282685340447,53
3092,6,9674,2253,7421,0,0,0,1.0,1,1.0,1,1.0,1,0.14325230366505837,56
3093,1,9675,2254,7421,0,0,0,1.0,1,1.0,1,1.0,1,0.14795592553546605,56
3094,2,9677,2254,7423,0,0,0,1.0,1,1.0,1,1.0,1,0.14713540222156132,58
3095,6,9683,2254,7429,0,0,0,1.0,1,1.0,1,1.0,1,0.11490729283411165,59
3096,5,9688,2254,7434,0,0,0,1.0,1,1.0,1,1.0,1,0.12862518604795928,60
3097,2,9690,2254,7436,0,0,0,1.0,1,1.0,1,1.0,1,0.12525408329372376,60
3098,0,9690,2254,7436,0,0,0,1.0,1,1.0,1,1.0,1,0.14863154943116633,58
3099,0,9690,2254,7436,0,0,0,1.0,1,1.0,1,1.0,1,0.16077313353353137,57
3100,0,9690,2254,7436,0,0,0,1.0,1,1.0,1,1.0,1,0.16077313353353137,57
3101,1,9691,2254,7437,0,0,0,1.0,1,1.0,1,1.0,1,0.15519554818110456,58
3102,5,9696,2256,7440,0,0,0,1.0,1,1.0,1,1.0,1,0.1679455711655487,59
3103,3,9699,2256,7443,0,0,0,1.0,1,1.0,1,1.0,1,0.1499047683274709,58
3104,6,9705,2260,7445,0,0,0,1.0,1,1.0,1,1.0,1,0.17412254944962396,58
3105,2,9707,2261,7446,0,0,0,1.0,1,1.0,1,1.0,1,0.1690266765094876,56
3106,6,9713,2263,7450,0,0,0,1.0,1,1.0,1,1.0,1,0.11458452846549948,57
3107,4,9717,2264,7453,0,0,0,1.0,1,1.0,1,1.0,1,0.09176548111684125,55
3108,2,9719,2266,7453,0,0,0,1.0,1,1.0,1,1.0,1,0.12325155009411959,55
3109,2,9721,2268,7453,0,0,0,1.0,1,1.0,1,1.0,1,0.13363023185564785,54
3110,3,9724,2270,7454,0,0,0,1.0,1,1.0,1,1.0,1,0.1414695346739501,54
3111,4,9728,2271,7457,0,0,0,1.0,1,1.0,1,1.0,1,0.11375163500650101,54
3112,9,9737,2276,7461,0,0,0,1.0,1,1.0,1,1.0,1,0.11123300525090644,56
3113,5,9742,2278,7464,0,0,0,1.0,1,1.0,1,1.0,1,0.1293046516564997,55
3114,3,9745,2279,7466,0,0,0,1.0,1,1.0,1,1.0,1,0.11598338318408372,54
3115,5,9750,2280,7470,0,0,0,1.0,1,1.0,1,1.0,1,0.10438832141511585,56
3116,4,9754,2282,7472,0,0,0,1.0,1,1.0,1,1.0,1,0.11586369253217843,56
3117,2,9756,2282,7474,0,0,0,1.0,1,1.0,1,1.0,1,0.162768325417506,58
3118,2,9758,2283,7475,0,0,0,1.0,1,1.0,1,1.0,1,0.15684339415561424,57
3119,3,9761,2283,7478,0,0,0,1.0,1,1.0,1,1.0,1,0.1339969430193465,57
3120,1,9762,2283,7479,0,0,0,1.0,1,1.0,1,1.0,1,0.1575805771570909,56
3121,7,9769,2285,7484,0,0,0,1.0,1,1.0,1,1.0,1,0.0894313002635389,57
3122,2,9771,2285,7486,0,0,0,1.0,1,1.0,1,1.0,1,0.10083710374435854,57
3123,1,9772,2285,7487,0,0,0,1.0,1,1.0,1,1.0,1,0.08047748345662033,57
3124,0,9772,2285,7487,0,0,0,1.0,1,1.0,1,1.0,1,0.05513769128525207,59
3125,7,9779,2287,7492,0,0,0,1.0,1,1.0,1,1.0,1,0.11953339400567885,61
3126,2,9781,2287,7494,0,0,0,1.0,1,1.0,1,1.0,1,0.07604682040839349,60
3127,0,9781,2287,7494,0,0,0,1.0,1,1.0,1,1.0,1,0.06539316490584719,58
3128,3,9784,2287,7497,0,0,0,1.0,1,1.0,1,1.0,1,0.09042287719927307,58
3129,2,9786,2288,7498,0,0,0,1.0,1,1.0,1,1.0,1,0.14028773352863938,56
3130,2,9788,2288,7500,0,0,0,1.0,1,1.0,1,1.0,1,0.1486191277990037,56
3131,5,9793,2290,7503,0,0,0,1.0,1,1.0,1,1.0,1,0.16268516567096603,55
3132,3,9796,2291,7505,0,0,0,1.0,1,1.0,1,1.0,1,0.18056521895393593,53
3133,2,9798,2292,7506,0,0,0,1.0,1,1.0,1,1.0,1,0.1541496463836949,52
3134,4,9802,2292,7510,0,0,0,1.0,1,1.0,1,1.0,1,0.20345860958402603,52
3135,3,9805,2294,7511,0,0,0,1.0,1,1.0,1,1.0,1,0.15871523455688025,53
3136,11,9816,2298,7518,0,0,0,1.0,1,1.0,1,1.0,1,0.10617870716347881,54
3137,5,9821,2301,7520,0,0,0,1.0,1,1.0,1,1.0,1,0.12573264137385934,55
3138,7,9828,2302,7526,0,0,0,1.0,1,1.0,1,1.0,1,0.1356692553978136,57
3139,7,9835,2303,7532,0,0,0,1.0,1,1.0,1,1.0,1,0.12338401799411078,56
3140,1,9836,2303,7533,0,0,0,1.0,1,1.0,1,1.0,1,0.10796207628678818,56
3141,4,9840,2305,7535,0,0,0,1.0,1,1.0,1,1.0,1,0.14218780191566013,56
3142,3,9843,2306,7537,0,0,0,1.0,1,1.0,1,1.0,1,0.166864972633463,56
3143,5,9848,2307,7541,0,0,0,1.0,1,1.0,1,1.0,1,0.19273986215985786,56
3144,2,9850,2308,7542,0,0,0,1.0,1,1.0,1,1.0,1,0.192932703986735,54
3145,6,9856,2310,7546,0,0,0,1.0,1,1.0,1,1.0,1,0.20271544434568126,55
3146,7,9863,2310,7553,0,0,0,1.0,1,1.0,1,1.0,1,0.21310692518824806,53
3147,6,9869,2310,7559,0,0,0,1.0,1,1.0,1,1.0,1,0.2285721519940021,54
3148,5,9874,2311,7563,0,0,0,1.0,1,1.0,1,1.0,1,0.2206898714896259,54
3149,10,9884,2312,7572,0,0,0,1.0,1,1.0,1,1.0,1,0.21061849508827557,53
3150,4,9888,2312,7576,0,0,0,1.0,1,1.0,1,1.0,1,0.21960613992739908,53
3151,9,9897,2313,7584,0,0,0,1.0,1,1.0,1,1.0,1,0.11821569661785437,53
3152,9,9906,2315,7591,0,0,0,1.0,1,1.0,1,1.0,1,0.1338600778467794,54
3153,3,9909,2315,7594,0,0,0,1.0,1,1.0,1,1.0,1,0.1310591152381037,53
3154,6,9915,2316,7599,0,0,0,1.0,1,1.0,1,1.0,1,0.11247429081938443,55
3155,7,9922,2316,7606,0,0,0,1.0,1,1.0,1,1.0,1,0.1507470268723261,56
3156,8,9930,2316,7614,0,0,0,1.0,1,1.0,1,1.0,1,0.14827198207393197,56
3157,8,9938,2316,7622,0,0,0,1.0,1,1.0,1,1.0,1,0.11493895185864413,56
3158,9,9947,2316,7631,0,0,0,1.0,1,1.0,1,1.0,1,0.12162347995269154,57
3159,7,9954,2317,7637,0,0,0,1.0,1,1.0,1,1.0,1,0.14913530029109823,56
3160,5,9959,2317,7642,0,0,0,1.0,1,1.0,1,1.0,1,0.16194364334201378,58
3161,6,9965,2317,7648,0,0,0,1.0,1,1.0,1,1.0,1,0.11916708754310758,59
3162,4,9969,2317,7652,0,0,0,1.0,1,1.0,1,1.0,1,0.11916708754310758,59
3163,5,9974,2319,7655,0,0,0,1.0,1,1.0,1,1.0,1,0.13462858336226755,59
3164,5,9979,2319,7660,0,0,0,1.0,1,1.0,1,1.0,1,0.13783152500487914,60
3165,7,9986,2321,7665,0,0,0,1.0,1,1.0,1,1.0,1,0.16505650114185832,58
3166,7,9993,2321,7672,0,0,0,1.0,1,1.0,1,1.0,1,0.06841567199371106,59
3167,3,9996,2322,7674,0,0,0,1.0,1,1.0,1,1.0,1,0.0832375740548728,57
3168,3,9999,2322,7677,0,0,0,1.0,1,1.0,1,1.0,1,0.09980871102619268,58
3169,5,10004,2325,7679,0,0,0,1.0,1,1.0,1,1.0,1,0.1336103455900488,57
3170,4,10008,2325,7683,0,0,0,1.0,1,1.0,1,1.0,1,0.14209468358031135,55
3171,5,10013,2328,7685,0,0,0,1.0,1,1.0,1,1.0,1,0.15452939262016435,56
3172,1,10014,2328,7686,0,0,0,1.0,1,1.0,1,1.0,1,0.17016711987126573,54
3173,1,10015,2328,7687,0,0,0,1.0,1,1.0,1,1.0,1,0.15585414622425395,53
3174,4,10019,2329,7690,0,0,0,1.0,1,1.0,1,1.0,1,0.16862836630699082,53
3175,2,10021,2329,7692,0,0,0,1.0,1,1.0,1,1.0,1,0.14599899806074976,52
3176,5,10026,2332,7694,0,0,0,1.0,1,1.0,1,1.0,1,0.14622301359122528,53
3177,2,10028,2333,7695,0,0,0,1.0,1,1.0,1,1.0,1,0.16814974068995,52
3178,1,10029,2333,7696,0,0,0,1.0,1,1.0,1,1.0,1,0.17580603032559036,53
3179,2,10031,2335,7696,0,0,0,1.0,1,1.0,1,1.0,1,0.13755786355211225,54
3180,3,10034,2335,7699,0,0,0,1.0,1,1.0,1,1.0,1,0.1867815497227977,54
3181,5,10039,2335,7704,0,0,0,1.0,1,1.0,1,1.0,1,0.11051706432894073,55
3182,2,10041,2336,7705,0,0,0,1.0,1,1.0,1,1.0,1,0.1600294327550868,54
3183,4,10045,2337,7708,0,0,0,1.0,1,1.0,1,1.0,1,0.1499095750308509,56
3184,4,10049,2339,7710,0,0,0,1.0,1,1.0,1,1.0,1,0.13105415500047055,54
3185,0,10049,2339,7710,0,0,0,1.0,1,1.0,1,1.0,1,0.13226758761313614,53
3186,1,10050,2340,7710,0,0,0,1.0,1,1.0,1,1.0,1,0.15827301810867692,52
3187,3,10053,2342,7711,0,0,0,1.0,1,1.0,1,1.0,1,0.1727525408285785,50
3188,2,10055,2344,7711,0,0,0,1.0,1,1.0,1,1.0,1,0.17753466825778108,50
3189,5,10060,2347,7713,0,0,0,1.0,1,1.0,1,1.0,1,0.19981023615761573,49
3190,4,10064,2348,7716,0,0,0,1.0,1,1.0,1,1.0,1,0.20358821841109487,50
3191,6,10070,2349,7721,0,0,0,1.0,1,1.0,1,1.0,1,0.24063644881599397,49
3192,5,10075,2349,7726,0,0,0,1.0,1,1.0,1,1.0,1,0.22315464138601243,49
3193,3,10078,2349,7729,0,0,0,1.0,1,1.0,1,1.0,1,0.21734489023999612,49
3194,5,10083,2350,7733,0,0,0,1.0,1,1.0,1,1.0,1,0.2302358005203273,50
3195,5,10088,2350,7738,0,0,0,1.0,1,1.0,1,1.0,1,0.24399849391600123,49
3196,4,10092,2350,7742,0,0,0,1.0,1,1.0,1,1.0,1,0.18567245177968672,49
3197,1,10093,2350,7743,0,0,0,1.0,1,1.0,1,1.0,1,0.16092773827187157,50
3198,1,10094,2350,7744,0,0,0,1.0,1,1.0,1,1.0,1,0.12938968485350646,50
3199,5,10099,2352,7747,0,0,0,1.0,1,1.0,1,1.0,1,0.17889658680109513,52
3200,4,10103,2353,7750,0,0,0,1.0,1,1.0,1,1.0,1,0.14595806908022227,53
3201,4,10107,2353,7754,0,0,0,1.0,1,1.0,1,1.0,1,0.13117889001522487,55
3202,12,10119,2353,7766,0,0,0,1.0,1,1.0,1,1.0,1,0.141257912432502,55
3203,8,10127,2353,7774,0,0,0,1.0,1,1.0,1,1.0,1,0.14116945244634066,53
3204,12,10139,2354,7785,0,0,0,1.0,1,1.0,1,1.0,1,0.13572741991047566,53
3205,6,10145,2354,7791,0,0,0,1.0,1,1.0,1,1.0,1,0.14423207277068187,53
3206,11,10156,2354,7802,0,0,0,1.0,1,1.0,1,1.0,1,0.14414452447456927,52
3207,12,10168,2356,7812,0,0,0,1.0,1,1.0,1,1.0,1,0.15851488607451114,53
3208,5,10173,2356,7817,0,0,0,1.0,1,1.0,1,1.0,1,0.20323494025122485,51
3209,7,10180,2357,7823,0,0,0,1.0,1,1.0,1,1.0,1,0.21682662819091764,52
3210,8,10188,2357,7831,0,0,0,1.0,1,1.0,1,1.0,1,0.22342842611542857,49
3211,8,10196,2359,7837,0,0,0,1.0,1,1.0,1,1.0,1,0.19182942236861666,48
3212,1,10197,2359,7838,0,0,0,1.0,1,1.0,1,1.0,1,0.1769092351331515,48
3213,1,10198,2359,7839,0,0,0,1.0,1,1.0,1,1.0,1,0.15371791710630142,49
3214,1,10199,2360,7839,0,0,0,1.0,1,1.0,1,1.0,1,0.13189752432678478,51
3215,3,10202,2360,7842,0,0,0,1.0,1,1.0,1,1.0,1,0.11896885834095298,51
3216,1,10203,2361,7842,0,0,0,1.0,1,1.0,1,1.0,1,0.11943676692961816,51
3217,2,10205,2362,7843,0,0,0,1.0,1,1.0,1,1.0,1,0.12550053855735213,51
3218,0,10205,2362,7843,0,0,0,1.0,1,1.0,1,1.0,1,0.12550053855735213,51
3219,3,10208,2363,7845,0,0,0,1.0,1,1.0,1,1.0,1,0.09891255668626737,52
3220,2,10210,2363,7847,0,0,0,1.0,1,1.0,1,1.0,1,0.1156567190466799,52
3221,2,10212,2363,7849,0,0,0,1.0,1,1.0,1,1.0,1,0.10667458049900175,54
3222,1,10213,2363,7850,0,0,0,1.0,1,1.0,1,1.0,1,0.09376831856587885,54
3223,2,10215,2363,7852,0,0,0,1.0,1,1.0,1,1.0,1,0.09598372429210955,56
3224,4,10219,2364,7855,0,0,0,1.0,1,1.0,1,1.0,1,0.11267592574028755,57
3225,4,10223,2364,7859,0,0,0,1.0,1,1.0,1,1.0,1,0.11566190735581414,58
3226,3,10226,2364,7862,0,0,0,1.0,1,1.0,1,1.0,1,0.09143879872583954,58
3227,0,10226,2364,7862,0,0,0,1.0,1,1.0,1,1.0,1,0.09143879872583954,58
3228,0,10226,2364,7862,0,0,0,1.0,1,1.0,1,1.0,1,0.09143879872583954,58
3229,2,10228,2365,7863,0,0,0,1.0,1,1.0,1,1.0,1,0.13440188679432225,60
3230,1,10229,2365,7864,0,0,0,1.0,1,1.0,1,1.0,1,0.12660878386180832,61
3231,0,10229,2365,7864,0,0,0,1.0,1,1.0,1,1.0,1,0.12660878386180832,61
3232,0,10229,2365,7864,0,0,0,1.0,1,1.0,1,1.0,1,0.12660878386180832,61
3233,5,10234,2365,7869,0,0,0,1.0,1,1.0,1,1.0,1,0.12306804756191579,63
3234,6,10240,2366,7874,0,0,0,1.0,1,1.0,1,1.0,1,0.1587581540131771,64
3235,5,10245,2366,7879,0,0,0,1.0,1,1.0,1,1.0,1,0.13982018788438372,65
3236,2,10247,2366,7881,0,0,0,1.0,1,1.0,1,1.0,1,0.14793809143887127,66
3237,4,10251,2366,7885,0,0,0,1.0,1,1.0,1,1.0,1,0.15111918100430521,67
3238,2,10253,2366,7887,0,0,0,1.0,1,1.0,1,1.0,1,0.13904744302703717,67
3239,5,10258,2366,7892,0,0,0,1.0,1,1.0,1,1.0,1,0.14700307537990434,69
3240,8,10266,2366,7900,0,0,0,1.0,1,1.0,1,1.0,1,0.1349454302755875,69
3241,7,10273,2367,7906,0,0,0,1.0,1,1.0,1,1.0,1,0.08575311344418862,68
3242,1,10274,2368,7906,0,0,0,1.0,1,1.0,1,1.0,1,0.10505129914258429,67
3243,4,10278,2370,7908,0,0,0,1.0,1,1.0,1,1.0,1,0.08929902911237071,68
3244,1,10279,2370,7909,0,0,0,1.0,1,1.0,1,1.0,1,0.0717978799122017,68
3245,2,10281,2370,7911,0,0,0,1.0,1,1.0,1,1.0,1,0.08704896537582657,69
3246,3,10284,2371,7913,0,0,0,1.0,1,1.0,1,1.0,1,0.07352998301093258,68
3247,3,10287,2371,7916,0,0,0,1.0,1,1.0,1,1.0,1,0.08313640065840645,68
3248,2,10289,2373,7916,0,0,0,1.0,1,1.0,1,1.0,1,0.07630058231523565,68
3249,0,10289,2373,7916,0,0,0,1.0,1,1.0,1,1.0,1,0.08464262119791173,69
3250,0,10289,2373,7916,0,0,0,1.0,1,1.0,1,1.0,1,0.08464262119791173,69
3251,2,10291,2374,7917,0,0,0,1.0,1,1.0,1,1.0,1,0.08887927137556358,68
3252,3,10294,2374,7920,0,0,0,1.0,1,1.0,1,1.0,1,0.09739106023133867,68
3253,2,10296,2374,7922,0,0,0,1.0,1,1.0,1,1.0,1,0.09538700624978591,69
3254,1,10297,2374,7923,0,0,0,1.0,1,1.0,1,1.0,1,0.09773149038051886,69
3255,3,10300,2374,7926,0,0,0,1.0,1,1.0,1,1.0,1,0.09478822358861333,70
3256,5,10305,2375,7930,0,0,0,1.0,1,1.0,1,1.0,1,0.07102776551588308,70
3257,2,10307,2375,7932,0,0,0,1.0,1,1.0,1,1.0,1,0.08028845020654445,71
3258,1,10308,2376,7932,0,0,0,1.0,1,1.0,1,1.0,1,0.07518829329067449,72
3259,2,10310,2378,7932,0,0,0,1.0,1,1.0,1,1.0,1,0.10771667040941106,71
3260,7,10317,2382,7935,0,0,0,1.0,1,1.0,1,1.0,1,0.12647293381024471,72
3261,9,10326,2383,7943,0,0,0,1.0,1,1.0,1,1.0,1,0.1372531112311107,74
3262,4,10330,2384,7946,0,0,0,1.0,1,1.0,1,1.0,1,0.13761016452486816,73
3263,8,10338,2385,7953,0,0,0,1.0,1,1.0,1,1.0,1,0.14916763298009758,73
3264,5,10343,2385,7958,0,0,0,1.0,1,1.0,1,1.0,1,0.16208805406240498,71
3265,2,10345,2386,7959,0,0,0,1.0,1,1.0,1,1.0,1,0.17905524948238816,70
3266,7,10352,2389,7963,0,0,0,1.0,1,1.0,1,1.0,1,0.17275221023658568,69
3267,6,10358,2390,7968,0,0,0,1.0,1,1.0,1,1.0,1,0.17079733497294589,69
3268,6,10364,2393,7971,0,0,0,1.0,1,1.0,1,1.0,1,0.18825401878314005,68
3269,8,10372,2394,7978,0,0,0,1.0,1,1.0,1,1.0,1,0.21609082345087396,68
3270,4,10376,2394,7982,0,0,0,1.0,1,1.0,1,1.0,1,0.22666949666671804,67
3271,4,10380,2394,7986,0,0,0,1.0,1,1.0,1,1.0,1,0.17672709087939775,66
3272,2,10382,2395,7987,0,0,0,1.0,1,1.0,1,1.0,1,0.15324706800001903,67
3273,4,10386,2395,7991,0,0,0,1.0,1,1.0,1,1.0,1,0.14715425163818474,66
3274,1,10387,2396,7991,0,0,0,1.0,1,1.0,1,1.0,1,0.15321059584127875,68
3275,3,10390,2396,7994,0,0,0,1.0,1,1.0,1,1.0,1,0.15011164527918722,68
3276,4,10394,2397,7997,0,0,0,1.0,1,1.0,1,1.0,1,0.12725779562971867,69
3277,8,10402,2398,8004,0,0,0,1.0,1,1.0,1,1.0,1,0.13320980127978646,68
3278,7,10409,2398,8011,0,0,0,1.0,1,1.0,1,1.0,1,0.12216312458134597,69
3279,5,10414,2399,8015,0,0,0,1.0,1,1.0,1,1.0,1,0.13748257196925706,67
3280,6,10420,2400,8020,0,0,0,1.0,1,1.0,1,1.0,1,0.15428197249602638,66
3281,7,10427,2402,8025,0,0,0,1.0,1,1.0,1,1.0,1,0.1591998592291574,67
3282,1,10428,2402,8026,0,0,0,1.0,1,1.0,1,1.0,1,0.1382870606353412,66
3283,4,10432,2404,8028,0,0,0,1.0,1,1.0,1,1.0,1,0.19756689753334533,67
3284,3,10435,2404,8031,0,0,0,1.0,1,1.0,1,1.0,1,0.16646645517772918,66
3285,1,10436,2405,8031,0,0,0,1.0,1,1.0,1,1.0,1,0.18163152510583716,66
3286,5,10441,2405,8036,0,0,0,1.0,1,1.0,1,1.0,1,0.13546481898519216,63
3287,1,10442,2405,8037,0,0,0,1.0,1,1.0,1,1.0,1,0.14621865408604073,61
3288,3,10445,2405,8040,0,0,0,1.0,1,1.0,1,1.0,1,0.14782836076499897,63
3289,1,10446,2405,8041,0,0,0,1.0,1,1.0,1,1.0,1,0.15604283346827832,62
3290,1,10447,2405,8042,0,0,0,1.0,1,1.0,1,1.0,1,0.13522085455181065,63
3291,5,10452,2408,8044,0,0,0,1.0,1,1.0,1,1.0,1,0.19041537916124637,62
3292,2,10454,2409,8045,0,0,0,1.0,1,1.0,1,1.0,1,0.1936403343273365,63
3293,3,10457,2409,8048,0,0,0,1.0,1,1.0,1,1.0,1,0.18066296877224286,65
3294,1,10458,2409,8049,0,0,0,1.0,1,1.0,1,1.0,1,0.17303305040489197,65
3295,0,10458,2409,8049,0,0,0,1.0,1,1.0,1,1.0,1,0.17303305040489197,65
3296,2,10460,2410,8050,0,0,0,1.0,1,1.0,1,1.0,1,0.1801499848117147,65
3297,1,10461,2410,8051,0,0,0,1.0,1,1.0,1,1.0,1,0.1687892762939903,66
3298,1,10462,2411,8051,0,0,0,1.0,1,1.0,1,1.0,1,0.16549576311789052,66
3299,1,10463,2411,8052,0,0,0,1.0,1,1.0,1,1.0,1,0.1640591138712092,67
3300,1,10464,2412,8052,0,0,0,1.0,1,1.0,1,1.0,1,0.17923942953182503,67
3301,4,10468,2413,8055,0,0,0,1.0,1,1.0,1,1.0,1,0.1730581991221342,68
3302,1,10469,2413,8056,0,0,0,1.0,1,1.0,1,1.0,1,0.17239008862872615,67
3303,3,10472,2415,8057,0,0,0,1.0,1,1.0,1,1.0,1,0.1606472414888982,67
3304,1,10473,2416,8057,0,0,0,1.0,1,1.0,1,1.0,1,0.1492122178419854,67
3305,3,10476,2416,8060,0,0,0,1.0,1,1.0,1,1.0,1,0.14995883745371139,69
3306,1,10477,2417,8060,0,0,0,1.0,1,1.0,1,1.0,1,0.15363317356968498,70
3307,0,10477,2417,8060,0,0,0,1.0,1,1.0,1,1.0,1,0.15363317356968498,70
3308,2,10479,2417,8062,0,0,0,1.0,1,1.0,1,1.0,1,0.15369615598356395,70
3309,2,10481,2417,8064,0,0,0,1.0,1,1.0,1,1.0,1,0.16735604740656343,72
3310,5,10486,2417,8069,0,0,0,1.0,1,1.0,1,1.0,1,0.16757199209113105,74
3311,3,10489,2417,8072,0,0,0,1.0,1,1.0,1,1.0,1,0.17529728952023557,74
3312,2,10491,2417,8074,0,0,0,1.0,1,1.0,1,1.0,1,0.16503702300633333,74
3313,5,10496,2417,8079,0,0,0,1.0,1,1.0,1,1.0,1,0.1653800146287975,75
3314,5,10501,2417,8084,0,0,0,1.0,1,1.0,1,1.0,1,0.17791011991863745,76
3315,4,10505,2418,8087,0,0,0,1.0,1,1.0,1,1.0,1,0.20138850321126606,75
3316,11,10516,2420,8096,0,0,0,1.0,1,1.0,1,1.0,1,0.14674344118741028,76
3317,3,10519,2421,8098,0,0,0,1.0,1,1.0,1,1.0,1,0.1531415641585451,73
3318,2,10521,2423,8098,0,0,0,1.0,1,1.0,1,1.0,1,0.18180781204290702,72
3319,3,10524,2423,8101,0,0,0,1.0,1,1.0,1,1.0,1,0.17168901835332148,71
3320,0,10524,2423,8101,0,0,0,1.0,1,1.0,1,1.0,1,0.1759674126091198,70
3321,2,10526,2425,8101,0,0,0,1.0,1,1.0,1,1.0,1,0.20439827936738517,69
3322,3,10529,2427,8102,0,0,0,1.0,1,1.0,1,1.0,1,0.19920283777454373,68
3323,1,10530,2428,8102,0,0,0,1.0,1,1.0,1,1.0,1,0.21757609431449643,69
3324,3,10533,2430,8103,0,0,0,1.0,1,1.0,1,1.0,1,0.20566316441616941,69
3325,1,10534,2430,8104,0,0,0,1.0,1,1.0,1,1.0,1,0.20372043241762167,70
3326,4,10538,2434,8104,0,0,0,1.0,1,1.0,1,1.0,1,0.2314765201869169,69
3327,5,10543,2435,8108,0,0,0,1.0,1,1.0,1,1.0,1,0.19974377226636034,70
3328,5,10548,2435,8113,0,0,0,1.0,1,1.0,1,1.0,1,0.1961073076619005,73
3329,7,10555,2436,8119,0,0,0,1.0,1,1.0,1,1.0,1,0.22982204486681387,72
3330,6,10561,2437,8124,0,0,0,1.0,1,1.0,1,1.0,1,0.23511600219357492,72
3331,11,10572,2439,8133,0,0,0,1.0,1,1.0,1,1.0,1,0.16773588410218446,72
3332,2,10574,2439,8135,0,0,0,1.0,1,1.0,1,1.0,1,0.15355380181209607,73
3333,3,10577,2439,8138,0,0,0,1.0,1,1.0,1,1.0,1,0.1512832794622983,72
3334,4,10581,2439,8142,0,0,0,1.0,1,1.0,1,1.0,1,0.13094420750783303,73
3335,4,10585,2440,8145,0,0,0,1.0,1,1.0,1,1.0,1,0.15982073048453216,74
3336,1,10586,2440,8146,0,0,0,1.0,1,1.0,1,1.0,1,0.16540193542370016,74
3337,3,10589,2440,8149,0,0,0,1.0,1,1.0,1,1.0,1,0.15771954563946033,74
3338,1,10590,2440,8150,0,0,0,1.0,1,1.0,1,1.0,1,0.15244202880100474,74
3339,2,10592,2441,8151,0,0,0,1.0,1,1.0,1,1.0,1,0.15569206378053324,75
3340,1,10593,2441,8152,0,0,0,1.0,1,1.0,1,1.0,1,0.17455443401250925,75
3341,2,10595,2441,8154,0,0,0,1.0,1,1.0,1,1.0,1,0.16664599284337922,76
3342,3,10598,2442,8156,0,0,0,1.0,1,1.0,1,1.0,1,0.1961477025901048,76
3343,3,10601,2443,8158,0,0,0,1.0,1,1.0,1,1.0,1,0.17460186200436478,75
3344,5,10606,2443,8163,0,0,0,1.0,1,1.0,1,1.0,1,0.17641306776674076,75
3345,5,10611,2444,8167,0,0,0,1.0,1,1.0,1,1.0,1,0.1993702687067843,72
3346,9,10620,2446,8174,0,0,0,1.0,1,1.0,1,1.0,1,0.15143495365976167,73
3347,1,10621,2447,8174,0,0,0,1.0,1,1.0,1,1.0,1,0.13645734755902986,73
3348,2,10623,2447,8176,0,0,0,1.0,1,1.0,1,1.0,1,0.1401166619366092,73
3349,1,10624,2448,8176,0,0,0,1.0,1,1.0,1,1.0,1,0.14956373115762814,74
3350,4,10628,2450,8178,0,0,0,1.0,1,1.0,1,1.0,1,0.17701131180115692,73
3351,3,10631,2450,8181,0,0,0,1.0,1,1.0,1,1.0,1,0.18087130923936515,72
3352,2,10633,2451,8182,0,0,0,1.0,1,1.0,1,1.0,1,0.1886254599470276,72
3353,3,10636,2452,8184,0,0,0,1.0,1,1.0,1,1.0,1,0.2076200186555306,72
3354,3,10639,2452,8187,0,0,0,1.0,1,1.0,1,1.0,1,0.22753209815880945,70
3355,7,10646,2453,8193,0,0,0,1.0,1,1.0,1,1.0,1,0.24939316305969889,69
3356,6,10652,2456,8196,0,0,0,1.0,1,1.0,1,1.0,1,0.22356191665922626,69
3357,4,10656,2457,8199,0,0,0,1.0,1,1.0,1,1.0,1,0.22250103519485473,68
3358,3,10659,2458,8201,0,0,0,1.0,1,1.0,1,1.0,1,0.23880032001510265,68
3359,5,10664,2459,8205,0,0,0,1.0,1,1.0,1,1.0,1,0.22278338055042304,66
3360,5,10669,2462,8207,0,0,0,1.0,1,1.0,1,1.0,1,0.24781874983366484,65
3361,6,10675,2462,8213,0,0,0,1.0,1,1.0,1,1.0,1,0.20153133770936738,64
3362,0,10675,2462,8213,0,0,0,1.0,1,1.0,1,1.0,1,0.20153133770936738,64
3363,0,10675,2462,8213,0,0,0,1.0,1,1.0,1,1.0,1,0.1954203194534882,65
3364,0,10675,2462,8213,0,0,0,1.0,1,1.0,1,1.0,1,0.20088126928366232,66
3365,1,10676,2462,8214,0,0,0,1.0,1,1.0,1,1.0,1,0.20147677504989514,68
3366,0,10676,2462,8214,0,0,0,1.0,1,1.0,1,1.0,1,0.21312591794921465,66
3367,4,10680,2462,8218,0,0,0,1.0,1,1.0,1,1.0,1,0.18877949312732692,68
3368,6,10686,2464,8222,0,0,0,1.0,1,1.0,1,1.0,1,0.16985848039355955,68
3369,4,10690,2464,8226,0,0,0,1.0,1,1.0,1,1.0,1,0.1549430043289076,69
3370,3,10693,2464,8229,0,0,0,1.0,1,1.0,1,1.0,1,0.1475925224099871,71
3371,4,10697,2464,8233,0,0,0,1.0,1,1.0,1,1.0,1,0.14803702338887795,71
3372,7,10704,2465,8239,0,0,0,1.0,1,1.0,1,1.0,1,0.13528359854473423,71
3373,5,10709,2465,8244,0,0,0,1.0,1,1.0,1,1.0,1,0.13470278685014778,72
3374,6,10715,2465,8250,0,0,0,1.0,1,1.0,1,1.0,1,0.1578773159382278,72
3375,8,10723,2465,8258,0,0,0,1.0,1,1.0,1,1.0,1,0.14596820854919898,73
3376,6,10729,2465,8264,0,0,0,1.0,1,1.0,1,1.0,1,0.10162947122783494,75
3377,2,10731,2465,8266,0,0,0,1.0,1,1.0,1,1.0,1,0.10364129427244523,77
3378,3,10734,2465,8269,0,0,0,1.0,1,1.0,1,1.0,1,0.09893194554396001,77
3379,4,10738,2468,8270,0,0,0,1.0,1,1.0,1,1.0,1,0.13526954503368643,77
3380,7,10745,2468,8277,0,0,0,1.0,1,1.0,1,1.0,1,0.10832536222021942,76
3381,6,10751,2471,8280,0,0,0,1.0,1,1.0,1,1.0,1,0.12318791945032505,76
3382,2,10753,2471,8282,0,0,0,1.0,1,1.0,1,1.0,1,0.128297194455091,78
3383,1,10754,2471,8283,0,0,0,1.0,1,1.0,1,1.0,1,0.12889935742723005,77
3384,9,10763,2475,8288,0,0,0,1.0,1,1.0,1,1.0,1,0.15506678402746735,77
3385,4,10767,2476,8291,0,0,0,1.0,1,1.0,1,1.0,1,0.15661948750286525,75
3386,8,10775,2478,8297,0,0,0,1.0,1,1.0,1,1.0,1,0.16599470210473286,76
3387,3,10778,2478,8300,0,0,0,1.0,1,1.0,1,1.0,1,0.17701499530704948,75
3388,4,10782,2478,8304,0,0,0,1.0,1,1.0,1,1.0,1,0.1825027445079271,76
3389,6,10788,2478,8310,0,0,0,1.0,1,1.0,1,1.0,1,0.17508732398542623,77
3390,2,10790,2478,8312,0,0,0,1.0,1,1.0,1,1.0,1,0.16996761337350502,76
3391,6,10796,2479,8317,0,0,0,1.0,1,1.0,1,1.0,1,0.10836911644657671,77
3392,2,10798,2479,8319,0,0,0,1.0,1,1.0,1,1.0,1,0.10308576945148415,78
3393,1,10799,2479,8320,0,0,0,1.0,1,1.0,1,1.0,1,0.10866712609347258,76
3394,1,10800,2480,8320,0,0,0,1.0,1,1.0,1,1.0,1,0.14162938845319634,75
3395,1,10801,2480,8321,0,0,0,1.0,1,1.0,1,1.0,1,0.12066744914627119,73
3396,2,10803,2480,8323,0,0,0,1.0,1,1.0,1,1.0,1,0.11165122074467282,73
3397,0,10803,2480,8323,0,0,0,1.0,1,1.0,1,1.0,1,0.10151392001623849,74
3398,1,10804,2480,8324,0,0,0,1.0,1,1.0,1,1.0,1,0.09653555036108233,74
3399,2,10806,2481,8325,0,0,0,1.0,1,1.0,1,1.0,1,0.10434312312837395,75
3400,5,10811,2482,8329,0,0,0,1.0,1,1.0,1,1.0,1,0.12450040422639401,75
3401,4,10815,2483,8332,0,0,0,1.0,1,1.0,1,1.0,1,0.10349279457948729,77
3402,3,10818,2484,8334,0,0,0,1.0,1,1.0,1,1.0,1,0.1380613210812738,77
3403,8,10826,2485,8341,0,0,0,1.0,1,1.0,1,1.0,1,0.13563928750759816,78
3404,3,10829,2486,8343,0,0,0,1.0,1,1.0,1,1.0,1,0.12434178619726813,78
3405,3,10832,2487,8345,0,0,0,1.0,1,1.0,1,1.0,1,0.13899632184347743,78
3406,5,10837,2488,8349,0,0,0,1.0,1,1.0,1,1.0,1,0.11307107148328921,78
3407,0,10837,2488,8349,0,0,0,1.0,1,1.0,1,1.0,1,0.10969254846237836,78
3408,2,10839,2489,8350,0,0,0,1.0,1,1.0,1,1.0,1,0.11280220435601299,79
3409,4,10843,2489,8354,0,0,0,1.0,1,1.0,1,1.0,1,0.0833673791411799,81
3410,1,10844,2489,8355,0,0,0,1.0,1,1.0,1,1.0,1,0.08028776066858602,82
3411,6,10850,2491,8359,0,0,0,1.0,1,1.0,1,1.0,1,0.07733189518075785,84
3412,3,10853,2491,8362,0,0,0,1.0,1,1.0,1,1.0,1,0.09760072806997355,84
3413,3,10856,2491,8365,0,0,0,1.0,1,1.0,1,1.0,1,0.09504721355013719,84
3414,3,10859,2491,8368,0,0,0,1.0,1,1.0,1,1.0,1,0.08923700125445044,84
3415,3,10862,2491,8371,0,0,0,1.0,1,1.0,1,1.0,1,0.1018708489398429,85
3416,3,10865,2491,8374,0,0,0,1.0,1,1.0,1,1.0,1,0.09007231208900375,85
3417,4,10869,2492,8377,0,0,0,1.0,1,1.0,1,1.0,1,0.08286565975303276,86
3418,5,10874,2493,8381,0,0,0,1.0,1,1.0,1,1.0,1,0.10684033206881581,86
3419,7,10881,2494,8387,0,0,0,1.0,1,1.0,1,1.0,1,0.0933665130896232,87
3420,8,10889,2494,8395,0,0,0,1.0,1,1.0,1,1.0,1,0.10204898513105776,88
3421,5,10894,2496,8398,0,0,0,1.0,1,1.0,1,1.0,1,0.07218937348422318,89
3422,2,10896,2496,8400,0,0,0,1.0,1,1.0,1,1.0,1,0.07008700991583629,90
3423,0,10896,2496,8400,0,0,0,1.0,1,1.0,1,1.0,1,0.07010775919401165,90
3424,1,10897,2496,8401,0,0,0,1.0,1,1.0,1,1.0,1,0.05643921589749914,91
3425,1,10898,2496,8402,0,0,0,1.0,1,1.0,1,1.0,1,0.05602705674275926,90
3426,4,10902,2498,8404,0,0,0,1.0,1,1.0,1,1.0,1,0.06472179354751588,92
3427,1,10903,2498,8405,0,0,0,1.0,1,1.0,1,1.0,1,0.07816164843833474,92
3428,2,10905,2498,8407,0,0,0,1.0,1,1.0,1,1.0,1,0.07920792848612333,91
3429,0,10905,2498,8407,0,0,0,1.0,1,1.0,1,1.0,1,0.07920792848612333,91
3430,10,10915,2502,8413,0,0,0,1.0,1,1.0,1,1.0,1,0.12563668829349198,91
3431,3,10918,2502,8416,0,0,0,1.0,1,1.0,1,1.0,1,0.1276053294431946,90
3432,7,10925,2506,8419,0,0,0,1.0,1,1.0,1,1.0,1,0.19026398620793936,91
3433,10,10935,2507,8428,0,0,0,1.0,1,1.0,1,1.0,1,0.18544401254224901,90
3434,10,10945,2508,8437,0,0,0,1.0,1,1.0,1,1.0,1,0.20053754921142686,89
3435,8,10953,2509,8444,0,0,0,1.0,1,1.0,1,1.0,1,0.20554852582700875,88
3436,9,10962,2509,8453,0,0,0,1.0,1,1.0,1,1.0,1,0.13727576831548668,86
3437,2,10964,2510,8454,0,0,0,1.0,1,1.0,1,1.0,1,0.16301865961538087,86
3438,5,10969,2510,8459,0,0,0,1.0,1,1.0,1,1.0,1,0.1574688833816902,87
3439,3,10972,2510,8462,0,0,0,1.0,1,1.0,1,1.0,1,0.13195419416289086,86
3440,1,10973,2510,8463,0,0,0,1.0,1,1.0,1,1.0,1,0.12850357105995963,86
3441,3,10976,2511,8465,0,0,0,1.0,1,1.0,1,1.0,1,0.11567842410320836,85
3442,3,10979,2513,8466,0,0,0,1.0,1,1.0,1,1.0,1,0.16613264045735793,85
3443,3,10982,2513,8469,0,0,0,1.0,1,1.0,1,1.0,1,0.15454410407951172,85
3444,1,10983,2513,8470,0,0,0,1.0,1,1.0,1,1.0,1,0.16158063474149126,85
3445,3,10986,2514,8472,0,0,0,1.0,1,1.0,1,1.0,1,0.16856223129148593,84
3446,3,10989,2514,8475,0,0,0,1.0,1,1.0,1,1.0,1,0.17817091179647973,85
3447,6,10995,2515,8480,0,0,0,1.0,1,1.0,1,1.0,1,0.18178948674380566,85
3448,7,11002,2517,8485,0,0,0,1.0,1,1.0,1,1.0,1,0.18716723488005207,85
3449,7,11009,2518,8491,0,0,0,1.0,1,1.0,1,1.0,1,0.21142605050131447,84
3450,5,11014,2519,8495,0,0,0,1.0,1,1.0,1,1.0,1,0.19792469006013919,84
3451,11,11025,2521,8504,0,0,0,1.0,1,1.0,1,1.0,1,0.16308343405735187,85
3452,1,11026,2522,8504,0,0,0,1.0,1,1.0,1,1.0,1,0.1580220554476683,86
3453,1,11027,2522,8505,0,0,0,1.0,1,1.0,1,1.0,1,0.15179220960654252,85
3454,4,11031,2522,8509,0,0,0,1.0,1,1.0,1,1.0,1,0.13089757473835176,88
3455,4,11035,2522,8513,0,0,0,1.0,1,1.0,1,1.0,1,0.1301386993719993,88
3456,2,11037,2522,8515,0,0,0,1.0,1,1.0,1,1.0,1,0.1301386993719993,88
3457,6,11043,2523,8520,0,0,0,1.0,1,1.0,1,1.0,1,0.123396350321977,89
3458,3,11046,2523,8523,0,0,0,1.0,1,1.0,1,1.0,1,0.1307106213168879,88
3459,2,11048,2523,8525,0,0,0,1.0,1,1.0,1,1.0,1,0.13069569111560228,88
3460,2,11050,2523,8527,0,0,0,1.0,1,1.0,1,1.0,1,0.12395154127769666,89
3461,2,11052,2524,8528,0,0,0,1.0,1,1.0,1,1.0,1,0.13744214253553008,89
3462,4,11056,2524,8532,0,0,0,1.0,1,1.0,1,1.0,1,0.15231352037376822,90
3463,2,11058,2524,8534,0,0,0,1.0,1,1.0,1,1.0,1,0.14065500517809804,89
3464,4,11062,2526,8536,0,0,0,1.0,1,1.0,1,1.0,1,0.1447145596634863,88
3465,1,11063,2526,8537,0,0,0,1.0,1,1.0,1,1.0,1,0.16072005202989398,87
3466,9,11072,2526,8546,0,0,0,1.0,1,1.0,1,1.0,1,0.11101203071574144,87
3467,3,11075,2527,8548,0,0,0,1.0,1,1.0,1,1.0,1,0.1130907121687452,87
3468,3,11078,2529,8549,0,0,0,1.0,1,1.0,1,1.0,1,0.15041432427875548,88
3469,2,11080,2530,8550,0,0,0,1.0,1,1.0,1,1.0,1,0.15920841605147215,85
3470,2,11082,2530,8552,0,0,0,1.0,1,1.0,1,1.0,1,0.16191482484344208,86
3471,2,11084,2530,8554,0,0,0,1.0,1,1.0,1,1.0,1,0.15928835088975132,84
3472,3,11087,2530,8557,0,0,0,1.0,1,1.0,1,1.0,1,0.15360740278679064,83
3473,5,11092,2531,8561,0,0,0,1.0,1,1.0,1,1.0,1,0.1737969619352344,81
3474,5,11097,2531,8566,0,0,0,1.0,1,1.0,1,1.0,1,0.13710548015573829,80
3475,5,11102,2531,8571,0,0,0,1.0,1,1.0,1,1.0,1,0.15864317908513065,82
3476,3,11105,2531,8574,0,0,0,1.0,1,1.0,1,1.0,1,0.13691752048163297,81
3477,3,11108,2533,8575,0,0,0,1.0,1,1.0,1,1.0,1,0.1628827418340582,83
3478,3,11111,2535,8576,0,0,0,1.0,1,1.0,1,1.0,1,0.17285382151372702,83
3479,4,11115,2535,8580,0,0,0,1.0,1,1.0,1,1.0,1,0.15651052579664407,83
3480,0,11115,2535,8580,0,0,0,1.0,1,1.0,1,1.0,1,0.15651052579664407,83
3481,7,11122,2538,8584,0,0,0,1.0,1,1.0,1,1.0,1,0.1321835320051748,83
3482,5,11127,2541,8586,0,0,0,1.0,1,1.0,1,1.0,1,0.15129604423983195,83
3483,10,11137,2544,8593,0,0,0,1.0,1,1.0,1,1.0,1,0.14536671140397317,82
3484,5,11142,2546,8596,0,0,0,1.0,1,1.0,1,1.0,1,0.17737217464218458,82
3485,4,11146,2547,8599,0,0,0,1.0,1,1.0,1,1.0,1,0.1957881554913339,83
3486,3,11149,2547,8602,0,0,0,1.0,1,1.0,1,1.0,1,0.19672614789012643,83
3487,6,11155,2547,8608,0,0,0,1.0,1,1.0,1,1.0,1,0.18605673720659752,84
3488,3,11158,2547,8611,0,0,0,1.0,1,1.0,1,1.0,1,0.18932919293093542,84
3489,3,11161,2547,8614,0,0,0,1.0,1,1.0,1,1.0,1,0.1868774695927679,84
3490,3,11164,2547,8617,0,0,0,1.0,1,1.0,1,1.0,1,0.16458960907836273,84
3491,3,11167,2547,8620,0,0,0,1.0,1,1.0,1,1.0,1,0.16858896655568636,86
3492,4,11171,2548,8623,0,0,0,1.0,1,1.0,1,1.0,1,0.16754089010251474,86
3493,6,11177,2548,8629,0,0,0,1.0,1,1.0,1,1.0,1,0.17124761442659522,86
3494,6,11183,2548,8635,0,0,0,1.0,1,1.0,1,1.0,1,0.1500375016352001,86
3495,8,11191,2548,8643,0,0,0,1.0,1,1.0,1,1.0,1,0.14607588171108707,87
3496,12,11203,2548,8655,0,0,0,1.0,1,1.0,1,1.0,1,0.09931272324278025,88
3497,4,11207,2549,8658,0,0,0,1.0,1,1.0,1,1.0,1,0.08588682244083412,89
3498,5,11212,2549,8663,0,0,0,1.0,1,1.0,1,1.0,1,0.10163005601257051,89
3499,5,11217,2549,8668,0,0,0,1.0,1,1.0,1,1.0,1,0.11512153643124119,91
3500,6,11223,2549,8674,0,0,0,1.0,1,1.0,1,1.0,1,0.12133765122214649,90
3501,7,11230,2550,8680,0,0,0,1.0,1,1.0,1,1.0,1,0.12747632664427527,90
3502,7,11237,2550,8687,0,0,0,1.0,1,1.0,1,1.0,1,0.13891882271824707,91
3503,6,11243,2551,8692,0,0,0,1.0,1,1.0,1,1.0,1,0.11198235196664941,91
3504,6,11249,2554,8695,0,0,0,1.0,1,1.0,1,1.0,1,0.1548504171338252,89
3505,10,11259,2555,8704,0,0,0,1.0,1,1.0,1,1.0,1,0.15214448353864274,87
3506,5,11264,2557,8707,0,0,0,1.0,1,1.0,1,1.0,1,0.1592213773929619,87
3507,6,11270,2559,8711,0,0,0,1.0,1,1.0,1,1.0,1,0.1622003502995083,84
3508,6,11276,2561,8715,0,0,0,1.0,1,1.0,1,1.0,1,0.204334422049184,83
3509,8,11284,2563,8721,0,0,0,1.0,1,1.0,1,1.0,1,0.18459001955318724,80
3510,2,11286,2564,8722,0,0,0,1.0,1,1.0,1,1.0,1,0.19322198333656526,78
3511,9,11295,2568,8727,0,0,0,1.0,1,1.0,1,1.0,1,0.14069872148673793,77
3512,2,11297,2569,8728,0,0,0,1.0,1,1.0,1,1.0,1,0.1227879975671567,74
3513,4,11301,2570,8731,0,0,0,1.0,1,1.0,1,1.0,1,0.14070918825088266,76
3514,4,11305,2572,8733,0,0,0,1.0,1,1.0,1,1.0,1,0.13507662644197613,76
3515,3,11308,2572,8736,0,0,0,1.0,1,1.0,1,1.0,1,0.12412918387053956,75
3516,0,11308,2572,8736,0,0,0,1.0,1,1.0,1,1.0,1,0.12957644987650074,73
3517,5,11313,2574,8739,0,0,0,1.0,1,1.0,1,1.0,1,0.14087133312537642,74
3518,1,11314,2574,8740,0,0,0,1.0,1,1.0,1,1.0,1,0.15678530376508656,74
3519,1,11315,2574,8741,0,0,0,1.0,1,1.0,1,1.0,1,0.166584500724478,73
3520,4,11319,2574,8745,0,0,0,1.0,1,1.0,1,1.0,1,0.14515247513753068,74
3521,4,11323,2574,8749,0,0,0,1.0,1,1.0,1,1.0,1,0.15048266627366735,75
3522,5,11328,2574,8754,0,0,0,1.0,1,1.0,1,1.0,1,0.14719235316970286,75
3523,4,11332,2574,8758,0,0,0,1.0,1,1.0,1,1.0,1,0.14719235316970286,75
3524,5,11337,2574,8763,0,0,0,1.0,1,1.0,1,1.0,1,0.13820794165601155,75
3525,5,11342,2574,8768,0,0,0,1.0,1,1.0,1,1.0,1,0.12002811298282033,75
3526,3,11345,2575,8770,0,0,0,1.0,1,1.0,1,1.0,1,0.08667373338231603,76
3527,6,11351,2577,8774,0,0,0,1.0,1,1.0,1,1.0,1,0.10618300805970404,77
3528,6,11357,2578,8779,0,0,0,1.0,1,1.0,1,1.0,1,0.1197328584717323,77
3529,4,11361,2579,8782,0,0,0,1.0,1,1.0,1,1.0,1,0.12226756975045673,78
3530,2,11363,2579,8784,0,0,0,1.0,1,1.0,1,1.0,1,0.147264758784784,78
3531,6,11369,2579,8790,0,0,0,1.0,1,1.0,1,1.0,1,0.15735668665915178,79
3532,4,11373,2579,8794,0,0,0,1.0,1,1.0,1,1.0,1,0.16169382637287427,79
3533,9,11382,2582,8800,0,0,0,1.0,1,1.0,1,1.0,1,0.2164862627843242,79
3534,9,11391,2584,8807,0,0,0,1.0,1,1.0,1,1.0,1,0.2291125597893912,80
3535,20,11411,2585,8826,0,0,0,1.0,1,1.0,1,1.0,1,0.25735484168478884,81
3536,16,11427,2585,8842,0,0,0,1.0,1,1.0,1,1.0,1,0.23217342787709275,82
3537,15,11442,2585,8857,0,0,0,1.0,1,1.0,1,1.0,1,0.24467979868003317,82
3538,16,11458,2585,8873,0,0,0,1.0,1,1.0,1,1.0,1,0.25198314365885427,83
3539,15,11473,2585,8888,0,0,0,1.0,1,1.0,1,1.0,1,0.24949508360859216,83
3540,13,11486,2585,8901,0,0,0,1.0,1,1.0,1,1.0,1,0.23750166869068282,85
3541,16,11502,2585,8917,0,0,0,1.0,1,1.0,1,1.0,1,0.14251917354755,85
3542,8,11510,2585,8925,0,0,0,1.0,1,1.0,1,1.0,1,0.14611102016441588,88
3543,4,11514,2586,8928,0,0,0,1.0,1,1.0,1,1.0,1,0.10141736592847186,87
3544,9,11523,2587,8936,0,0,0,1.0,1,1.0,1,1.0,1,0.08321679606051831,87
3545,7,11530,2588,8942,0,0,0,1.0,1,1.0,1,1.0,1,0.07390716821719413,85
3546,8,11538,2588,8950,0,0,0,1.0,1,1.0,1,1.0,1,0.08392982293381744,83
3547,4,11542,2588,8954,0,0,0,1.0,1,1.0,1,1.0,1,0.13432711238708803,82
3548,6,11548,2589,8959,0,0,0,1.0,1,1.0,1,1.0,1,0.15946109254444998,82
3549,8,11556,2589,8967,0,0,0,1.0,1,1.0,1,1.0,1,0.16830211144190801,81
3550,5,11561,2590,8971,0,0,0,1.0,1,1.0,1,1.0,1,0.09119087568944402,79
3551,8,11569,2590,8979,0,0,0,1.0,1,1.0,1,1.0,1,0.0946317800071866,80
3552,9,11578,2591,8987,0,0,0,1.0,1,1.0,1,1.0,1,0.11018513138373981,78
3553,8,11586,2591,8995,0,0,0,1.0,1,1.0,1,1.0,1,0.11692778599615884,79
3554,3,11589,2591,8998,0,0,0,1.0,1,1.0,1,1.0,1,0.16578885035372068,77
3555,8,11597,2592,9005,0,0,0,1.0,1,1.0,1,1.0,1,0.13738249585769494,77
3556,12,11609,2592,9017,0,0,0,1.0,1,1.0,1,1.0,1,0.10306990736786581,76
3557,6,11615,2592,9023,0,0,0,1.0,1,1.0,1,1.0,1,0.07037621198890504,76
3558,4,11619,2593,9026,0,0,0,1.0,1,1.0,1,1.0,1,0.08817270593520907,76
3559,2,11621,2593,9028,0,0,0,1.0,1,1.0,1,1.0,1,0.10740615338455067,76
3560,8,11629,2594,9035,0,0,0,1.0,1,1.0,1,1.0,1,0.12434971382313624,78
3561,11,11640,2594,9046,0,0,0,1.0,1,1.0,1,1.0,1,0.1371067181008508,79
3562,14,11654,2595,9059,0,0,0,1.0,1,1.0,1,1.0,1,0.13790865304418728,79
3563,15,11669,2596,9073,0,0,0,1.0,1,1.0,1,1.0,1,0.16503684878106098,79
3564,11,11680,2596,9084,0,0,0,1.0,1,1.0,1,1.0,1,0.15639958176978408,80
3565,12,11692,2596,9096,0,0,0,1.0,1,1.0,1,1.0,1,0.16288976100581123,83
3566,23,11715,2598,9117,0,0,0,1.0,1,1.0,1,1.0,1,0.20910314906586983,84
3567,15,11730,2598,9132,0,0,0,1.0,1,1.0,1,1.0,1,0.1570851566627831,84
3568,20,11750,2599,9151,0,0,0,1.0,1,1.0,1,1.0,1,0.19379909252028685,84
3569,15,11765,2599,9166,0,0,0,1.0,1,1.0,1,1.0,1,0.18675896533925107,84
3570,19,11784,2601,9183,0,0,0,1.0,1,1.0,1,1.0,1,0.18417541718477093,87
3571,15,11799,2602,9197,0,0,0,1.0,1,1.0,1,1.0,1,0.06712735069264135,86
3572,9,11808,2603,9205,0,0,0,1.0,1,1.0,1,1.0,1,0.0712902112879217,87
3573,6,11814,2605,9209,0,0,0,1.0,1,1.0,1,1.0,1,0.0937649309551967,87
3574,5,11819,2607,9212,0,0,0,1.0,1,1.0,1,1.0,1,0.1110697837554439,88
3575,6,11825,2607,9218,0,0,0,1.0,1,1.0,1,1.0,1,0.11032872617881417,88
3576,3,11828,2607,9221,0,0,0,1.0,1,1.0,1,1.0,1,0.08481780779234842,90
3577,5,11833,2607,9226,0,0,0,1.0,1,1.0,1,1.0,1,0.08764124966086782,90
3578,7,11840,2607,9233,0,0,0,1.0,1,1.0,1,1.0,1,0.09483543197823215,91
3579,5,11845,2607,9238,0,0,0,1.0,1,1.0,1,1.0,1,0.09284515890132894,91
3580,6,11851,2607,9244,0,0,0,1.0,1,1.0,1,1.0,1,0.10980736886765463,91
3581,9,11860,2609,9251,0,0,0,1.0,1,1.0,1,1.0,1,0.09844877914986243,91
3582,9,11869,2610,9259,0,0,0,1.0,1,1.0,1,1.0,1,0.111891663510999,92
3583,6,11875,2611,9264,0,0,0,1.0,1,1.0,1,1.0,1,0.1334863648468094,88
3584,9,11884,2613,9271,0,0,0,1.0,1,1.0,1,1.0,1,0.13052192993600717,87
3585,11,11895,2615,9280,0,0,0,1.0,1,1.0,1,1.0,1,0.1499495046966047,84
3586,12,11907,2618,9289,0,0,0,1.0,1,1.0,1,1.0,1,0.09704045255249005,83
3587,0,11907,2618,9289,0,0,0,1.0,1,1.0,1,1.0,1,0.10170815923233431,82
3588,5,11912,2620,9292,0,0,0,1.0,1,1.0,1,1.0,1,0.08159639900147271,81
3589,6,11918,2623,9295,0,0,0,1.0,1,1.0,1,1.0,1,0.1084841417730036,80
3590,6,11924,2624,9300,0,0,0,1.0,1,1.0,1,1.0,1,0.12306794156188212,78
3591,2,11926,2624,9302,0,0,0,1.0,1,1.0,1,1.0,1,0.13027786679800202,77
3592,2,11928,2625,9303,0,0,0,1.0,1,1.0,1,1.0,1,0.13621402650480136,75
3593,3,11931,2625,9306,0,0,0,1.0,1,1.0,1,1.0,1,0.13454826936650283,76
3594,3,11934,2626,9308,0,0,0,1.0,1,1.0,1,1.0,1,0.1686045305696974,74
3595,9,11943,2628,9315,0,0,0,1.0,1,1.0,1,1.0,1,0.16364146767722546,74
3596,6,11949,2629,9320,0,0,0,1.0,1,1.0,1,1.0,1,0.16804162619447602,73
3597,5,11954,2631,9323,0,0,0,1.0,1,1.0,1,1.0,1,0.16775163094304985,73
3598,6,11960,2632,9328,0,0,0,1.0,1,1.0,1,1.0,1,0.15403054136962904,73
3599,2,11962,2632,9330,0,0,0,1.0,1,1.0,1,1.0,1,0.15435053804637333,73
3600,2,11964,2632,9332,0,0,0,1.0,1,1.0,1,1.0,1,0.15261190878418301,74
3601,14,11978,2635,9343,0,0,0,1.0,1,1.0,1,1.0,1,0.09222363410241262,75
3602,4,11982,2635,9347,0,0,0,1.0,1,1.0,1,1.0,1,0.09763894721524019,76
3603,4,11986,2637,9349,0,0,0,1.0,1,1.0,1,1.0,1,0.11245474009648815,77
3604,8,11994,2638,9356,0,0,0,1.0,1,1.0,1,1.0,1,0.1381404139949136,78
3605,5,11999,2639,9360,0,0,0,1.0,1,1.0,1,1.0,1,0.16517399454518647,77
3606,9,12008,2639,9369,0,0,0,1.0,1,1.0,1,1.0,1,0.14736295387496087,79
3607,6,12014,2639,9375,0,0,0,1.0,1,1.0,1,1.0,1,0.12826352242199007,79
3608,7,12021,2640,9381,0,0,0,1.0,1,1.0,1,1.0,1,0.14203755824916892,79
3609,6,12027,2640,9387,0,0,0,1.0,1,1.0,1,1.0,1,0.11852774696347494,79
3610,11,12038,2643,9395,0,0,0,1.0,1,1.0,1,1.0,1,0.10547293148983392,80
3611,5,12043,2644,9399,0,0,0,1.0,1,1.0,1,1.0,1,0.11017788004263951,80
3612,9,12052,2645,9407,0,0,0,1.0,1,1.0,1,1.0,1,0.10803695221245864,79
3613,5,12057,2645,9412,0,0,0,1.0,1,1.0,1,1.0,1,0.09880801158220584,79
3614,6,12063,2647,9416,0,0,0,1.0,1,1.0,1,1.0,1,0.13458979360000178,78
3615,5,12068,2647,9421,0,0,0,1.0,1,1.0,1,1.0,1,0.1364935446804014,79
3616,7,12075,2648,9427,0,0,0,1.0,1,1.0,1,1.0,1,0.08321360633029767,79
3617,1,12076,2649,9427,0,0,0,1.0,1,1.0,1,1.0,1,0.07760400251051065,80
3618,5,12081,2649,9432,0,0,0,1.0,1,1.0,1,1.0,1,0.08711645737379639,82
3619,0,12081,2649,9432,0,0,0,1.0,1,1.0,1,1.0,1,0.1066253031692897,82
3620,1,12082,2650,9432,0,0,0,1.0,1,1.0,1,1.0,1,0.11491112067974077,81
3621,6,12088,2652,9436,0,0,0,1.0,1,1.0,1,1.0,1,0.09500782684789838,83
3622,0,12088,2652,9436,0,0,0,1.0,1,1.0,1,1.0,1,0.09814853120347455,81
3623,4,12092,2656,9436,0,0,0,1.0,1,1.0,1,1.0,1,0.13513241673091697,81
3624,1,12093,2657,9436,0,0,0,1.0,1,1.0,1,1.0,1,0.12355815718734182,79
3625,3,12096,2658,9438,0,0,0,1.0,1,1.0,1,1.0,1,0.15202072400265865,80
3626,0,12096,2658,9438,0,0,0,1.0,1,1.0,1,1.0,1,0.14593246928171763,78
3627,2,12098,2658,9440,0,0,0,1.0,1,1.0,1,1.0,1,0.16823532731687058,78
3628,6,12104,2658,9446,0,0,0,1.0,1,1.0,1,1.0,1,0.15406685342492615,77
3629,3,12107,2658,9449,0,0,0,1.0,1,1.0,1,1.0,1,0.13574119528725911,76
3630,4,12111,2660,9451,0,0,0,1.0,1,1.0,1,1.0,1,0.13776040638517562,77
3631,4,12115,2661,9454,0,0,0,1.0,1,1.0,1,1.0,1,0.09691532268016376,75
3632,4,12119,2663,9456,0,0,0,1.0,1,1.0,1,1.0,1,0.14462364067255262,74
3633,3,12122,2664,9458,0,0,0,1.0,1,1.0,1,1.0,1,0.12186775066177927,75
3634,2,12124,2665,9459,0,0,0,1.0,1,1.0,1,1.0,1,0.14702997538622986,74
3635,5,12129,2666,9463,0,0,0,1.0,1,1.0,1,1.0,1,0.14775932980801687,74
3636,5,12134,2667,9467,0,0,0,1.0,1,1.0,1,1.0,1,0.16095810039972383,74
3637,4,12138,2667,9471,0,0,0,1.0,1,1.0,1,1.0,1,0.1749650640162763,74
3638,8,12146,2667,9479,0,0,0,1.0,1,1.0,1,1.0,1,0.16554363881972242,75
3639,7,12153,2670,9483,0,0,0,1.0,1,1.0,1,1.0,1,0.1730703982209273,76
3640,2,12155,2670,9485,0,0,0,1.0,1,1.0,1,1.0,1,0.16807471016110215,76
3641,8,12163,2672,9491,0,0,0,1.0,1,1.0,1,1.0,1,0.20858447834445187,75
3642,8,12171,2674,9497,0,0,0,1.0,1,1.0,1,1.0,1,0.23402415751143954,75
3643,7,12178,2674,9504,0,0,0,1.0,1,1.0,1,1.0,1,0.2257682577732135,74
3644,6,12184,2675,9509,0,0,0,1.0,1,1.0,1,1.0,1,0.2309231675063448,74
3645,12,12196,2676,9520,0,0,0,1.0,1,1.0,1,1.0,1,0.22674428191809254,74
3646,12,12208,2676,9532,0,0,0,1.0,1,1.0,1,1.0,1,0.09856475984706163,75
3647,4,12212,2676,9536,0,0,0,1.0,1,1.0,1,1.0,1,0.09801789585920823,77
3648,1,12213,2676,9537,0,0,0,1.0,1,1.0,1,1.0,1,0.10352730432650209,78
3649,0,12213,2676,9537,0,0,0,1.0,1,1.0,1,1.0,1,0.09719843249647697,80
3650,2,12215,2677,9538,0,0,0,1.0,1,1.0,1,1.0,1,0.11896097927412694,81
3651,2,12217,2677,9540,0,0,0,1.0,1,1.0,1,1.0,1,0.11769467341314242,81
3652,9,12226,2678,9548,0,0,0,1.0,1,1.0,1,1.0,1,0.13616045140585567,83
3653,4,12230,2678,9552,0,0,0,1.0,1,1.0,1,1.0,1,0.13043970649152403,83
3654,5,12235,2678,9557,0,0,0,1.0,1,1.0,1,1.0,1,0.13285792099536572,83
3655,5,12240,2678,9562,0,0,0,1.0,1,1.0,1,1.0,1,0.12908171162650506,84
3656,7,12247,2678,9569,0,0,0,1.0,1,1.0,1,1.0,1,0.1261351940868066,85
3657,8,12255,2679,9576,0,0,0,1.0,1,1.0,1,1.0,1,0.1563971538553419,86
3658,12,12267,2679,9588,0,0,0,1.0,1,1.0,1,1.0,1,0.1598532182618084,87
3659,13,12280,2680,9600,0,0,0,1.0,1,1.0,1,1.0,1,0.18423699202730578,87
3660,11,12291,2680,9611,0,0,0,1.0,1,1.0,1,1.0,1,0.17068741965992254,86
3661,10,12301,2681,9620,0,0,0,1.0,1,1.0,1,1.0,1,0.11791715170862296,86
3662,1,12302,2681,9621,0,0,0,1.0,1,1.0,1,1.0,1,0.10872261918210294,83
3663,3,12305,2683,9622,0,0,0,1.0,1,1.0,1,1.0,1,0.13082932005999165,85
3664,2,12307,2684,9623,0,0,0,1.0,1,1.0,1,1.0,1,0.10133154492596717,82
3665,2,12309,2684,9625,0,0,0,1.0,1,1.0,1,1.0,1,0.10109498015611547,81
3666,5,12314,2687,9627,0,0,0,1.0,1,1.0,1,1.0,1,0.1474775333332962,79
3667,4,12318,2687,9631,0,0,0,1.0,1,1.0,1,1.0,1,0.14393370719445217,79
3668,3,12321,2688,9633,0,0,0,1.0,1,1.0,1,1.0,1,0.1382585011487086,77
3669,3,12324,2689,9635,0,0,0,1.0,1,1.0,1,1.0,1,0.14456642151483454,75
3670,3,12327,2692,9635,0,0,0,1.0,1,1.0,1,1.0,1,0.16065150523412747,76
3671,1,12328,2693,9635,0,0,0,1.0,1,1.0,1,1.0,1,0.13223230507681966,74
3672,3,12331,2694,9637,0,0,0,1.0,1,1.0,1,1.0,1,0.13374113445644156,75
3673,3,12334,2695,9639,0,0,0,1.0,1,1.0,1,1.0,1,0.1519997385675556,75
3674,6,12340,2697,9643,0,0,0,1.0,1,1.0,1,1.0,1,0.1553102300238448,75
3675,1,12341,2697,9644,0,0,0,1.0,1,1.0,1,1.0,1,0.16234411417027253,75
3676,6,12347,2698,9649,0,0,0,1.0,1,1.0,1,1.0,1,0.11666033750592777,75
3677,2,12349,2698,9651,0,0,0,1.0,1,1.0,1,1.0,1,0.10627313432778,75
3678,0,12349,2698,9651,0,0,0,1.0,1,1.0,1,1.0,1,0.11530511952753093,77
3679,2,12351,2699,9652,0,0,0,1.0,1,1.0,1,1.0,1,0.12466576692705468,78
3680,1,12352,2699,9653,0,0,0,1.0,1,1.0,1,1.0,1,0.11681989860445108,80
3681,4,12356,2699,9657,0,0,0,1.0,1,1.0,1,1.0,1,0.12246739153799292,81
3682,2,12358,2699,9659,0,0,0,1.0,1,1.0,1,1.0,1,0.12004676136658404,81
3683,3,12361,2700,9661,0,0,0,1.0,1,1.0,1,1.0,1,0.13513464811411244,81
3684,4,12365,2700,9665,0,0,0,1.0,1,1.0,1,1.0,1,0.13513464811411244,81
3685,2,12367,2700,9667,0,0,0,1.0,1,1.0,1,1.0,1,0.13150370285699908,81
3686,4,12371,2700,9671,0,0,0,1.0,1,1.0,1,1.0,1,0.13150370285699908,81
3687,3,12374,2700,9674,0,0,0,1.0,1,1.0,1,1.0,1,0.13372943496489467,82
3688,5,12379,2700,9679,0,0,0,1.0,1,1.0,1,1.0,1,0.14038521824249364,84
3689,4,12383,2700,9683,0,0,0,1.0,1,1.0,1,1.0,1,0.14038521824249364,84
3690,4,12387,2701,9686,0,0,0,1.0,1,1.0,1,1.0,1,0.14930356153392116,85
3691,3,12390,2701,9689,0,0,0,1.0,1,1.0,1,1.0,1,0.12222587312240497,86
3692,3,12393,2702,9691,0,0,0,1.0,1,1.0,1,1.0,1,0.11467430464878445,86
3693,2,12395,2702,9693,0,0,0,1.0,1,1.0,1,1.0,1,0.1101850688177455,86
3694,1,12396,2702,9694,0,0,0,1.0,1,1.0,1,1.0,1,0.11386358563842428,86
3695,1,12397,2703,9694,0,0,0,1.0,1,1.0,1,1.0,1,0.12423774758630589,86
3696,3,12400,2704,9696,0,0,0,1.0,1,1.0,1,1.0,1,0.10975095773782725,87
3697,2,12402,2705,9697,0,0,0,1.0,1,1.0,1,1.0,1,0.12217108105591863,85
3698,0,12402,2705,9697,0,0,0,1.0,1,1.0,1,1.0,1,0.12104472689390741,85
3699,2,12404,2706,9698,0,0,0,1.0,1,1.0,1,1.0,1,0.10708361295208713,85
3700,6,12410,2709,9701,0,0,0,1.0,1,1.0,1,1.0,1,0.12060436246594657,84
3701,1,12411,2710,9701,0,0,0,1.0,1,1.0,1,1.0,1,0.14091688252771423,85
3702,4,12415,2712,9703,0,0,0,1.0,1,1.0,1,1.0,1,0.14460379552552735,85
3703,0,12415,2712,9703,0,0,0,1.0,1,1.0,1,1.0,1,0.14460379552552735,85
3704,2,12417,2713,9704,0,0,0,1.0,1,1.0,1,1.0,1,0.13108870473397438,85
3705,0,12417,2713,9704,0,0,0,1.0,1,1.0,1,1.0,1,0.12324529276871951,86
3706,3,12420,2715,9705,0,0,0,1.0,1,1.0,1,1.0,1,0.1292610040166354,86
3707,2,12422,2717,9705,0,0,0,1.0,1,1.0,1,1.0,1,0.14980261879402865,85
3708,1,12423,2717,9706,0,0,0,1.0,1,1.0,1,1.0,1,0.14944905204879066,84
3709,1,12424,2717,9707,0,0,0,1.0,1,1.0,1,1.0,1,0.14722668588776205,85
3710,0,12424,2717,9707,0,0,0,1.0,1,1.0,1,1.0,1,0.13653149218301994,84
3711,1,12425,2717,9708,0,0,0,1.0,1,1.0,1,1.0,1,0.14128365961468467,85
3712,2,12427,2717,9710,0,0,0,1.0,1,1.0,1,1.0,1,0.1284518187960936,85
3713,0,12427,2717,9710,0,0,0,1.0,1,1.0,1,1.0,1,0.1284518187960936,85
3714,4,12431,2718,9713,0,0,0,1.0,1,1.0,1,1.0,1,0.137882523306542,85
3715,1,12432,2719,9713,0,0,0,1.0,1,1.0,1,1.0,1,0.13594885806655416,85
3716,1,12433,2719,9714,0,0,0,1.0,1,1.0,1,1.0,1,0.1363946730809529,84
3717,3,12436,2719,9717,0,0,0,1.0,1,1.0,1,1.0,1,0.11200116078752087,86
3718,0,12436,2719,9717,0,0,0,1.0,1,1.0,1,1.0,1,0.12248508930185754,85
3719,3,12439,2721,9718,0,0,0,1.0,1,1.0,1,1.0,1,0.13080077099839543,84
3720,3,12442,2721,9721,0,0,0,1.0,1,1.0,1,1.0,1,0.14216040480550393,84
3721,8,12450,2725,9725,0,0,0,1.0,1,1.0,1,1.0,1,0.14443522932002062,85
3722,1,12451,2725,9726,0,0,0,1.0,1,1.0,1,1.0,1,0.1387206099672697,85
3723,3,12454,2725,9729,0,0,0,1.0,1,1.0,1,1.0,1,0.1429073443677158,85
3724,0,12454,2725,9729,0,0,0,1.0,1,1.0,1,1.0,1,0.13625786941463233,86
3725,0,12454,2725,9729,0,0,0,1.0,1,1.0,1,1.0,1,0.13625786941463233,86
3726,2,12456,2726,9730,0,0,0,1.0,1,1.0,1,1.0,1,0.13711777782052142,86
3727,0,12456,2726,9730,0,0,0,1.0,1,1.0,1,1.0,1,0.13711777782052142,86
3728,1,12457,2727,9730,0,0,0,1.0,1,1.0,1,1.0,1,0.14929070895889374,86
3729,1,12458,2728,9730,0,0,0,1.0,1,1.0,1,1.0,1,0.15131662796907425,86
3730,1,12459,2729,9730,0,0,0,1.0,1,1.0,1,1.0,1,0.16277321748445775,85
3731,0,12459,2729,9730,0,0,0,1.0,1,1.0,1,1.0,1,0.17208054843185858,86
3732,1,12460,2730,9730,0,0,0,1.0,1,1.0,1,1.0,1,0.17940468927901107,87
3733,3,12463,2730,9733,0,0,0,1.0,1,1.0,1,1.0,1,0.17148340349876617,87
3734,2,12465,2730,9735,0,0,0,1.0,1,1.0,1,1.0,1,0.17148340349876617,87
3735,5,12470,2732,9738,0,0,0,1.0,1,1.0,1,1.0,1,0.16831889248146553,86
3736,6,12476,2732,9744,0,0,0,1.0,1,1.0,1,1.0,1,0.1336516929538531,87
3737,2,12478,2733,9745,0,0,0,1.0,1,1.0,1,1.0,1,0.13621493704594614,87
3738,1,12479,2734,9745,0,0,0,1.0,1,1.0,1,1.0,1,0.13649089005417211,87
3739,3,12482,2734,9748,0,0,0,1.0,1,1.0,1,1.0,1,0.126839432388339,88
3740,5,12487,2737,9750,0,0,0,1.0,1,1.0,1,1.0,1,0.13377178285719718,87
3741,3,12490,2737,9753,0,0,0,1.0,1,1.0,1,1.0,1,0.14043147233305736,87
3742,4,12494,2739,9755,0,0,0,1.0,1,1.0,1,1.0,1,0.12979008039039086,86
3743,0,12494,2739,9755,0,0,0,1.0,1,1.0,1,1.0,1,0.14131525117050125,84
3744,1,12495,2740,9755,0,0,0,1.0,1,1.0,1,1.0,1,0.17077175082860796,83
3745,2,12497,2741,9756,0,0,0,1.0,1,1.0,1,1.0,1,0.16641313800525895,83
3746,2,12499,2742,9757,0,0,0,1.0,1,1.0,1,1.0,1,0.1798571457077869,83
3747,2,12501,2743,9758,0,0,0,1.0,1,1.0,1,1.0,1,0.1815033206247793,81
3748,1,12502,2743,9759,0,0,0,1.0,1,1.0,1,1.0,1,0.1778569157296821,81
3749,0,12502,2743,9759,0,0,0,1.0,1,1.0,1,1.0,1,0.18059051455475533,80
3750,0,12502,2743,9759,0,0,0,1.0,1,1.0,1,1.0,1,0.18390229988709333,79
3751,13,12515,2746,9769,0,0,0,1.0,1,1.0,1,1.0,1,0.20305441518705855,80
3752,15,12530,2747,9783,0,0,0,1.0,1,1.0,1,1.0,1,0.20115828660001758,80
3753,15,12545,2749,9796,0,0,0,1.0,1,1.0,1,1.0,1,0.18336113739289323,81
3754,10,12555,2750,9805,0,0,0,1.0,1,1.0,1,1.0,1,0.1985604788981857,81
3755,10,12565,2751,9814,0,0,0,1.0,1,1.0,1,1.0,1,0.22158496236372477,80
3756,6,12571,2751,9820,0,0,0,1.0,1,1.0,1,1.0,1,0.22771764651541476,79
3757,5,12576,2751,9825,0,0,0,1.0,1,1.0,1,1.0,1,0.22404070601956236,80
3758,5,12581,2751,9830,0,0,0,1.0,1,1.0,1,1.0,1,0.2406047054906176,79
3759,7,12588,2752,9836,0,0,0,1.0,1,1.0,1,1.0,1,0.23460112078842743,79
3760,9,12597,2752,9845,0,0,0,1.0,1,1.0,1,1.0,1,0.23220023645434165,79
3761,11,12608,2752,9856,0,0,0,1.0,1,1.0,1,1.0,1,0.2455429117277419,78
3762,9,12617,2753,9864,0,0,0,1.0,1,1.0,1,1.0,1,0.24719123041121507,80
3763,11,12628,2753,9875,0,0,0,1.0,1,1.0,1,1.0,1,0.24856163592697678,80
3764,10,12638,2755,9883,0,0,0,1.0,1,1.0,1,1.0,1,0.26589901143712,80
3765,14,12652,2756,9896,0,0,0,1.0,1,1.0,1,1.0,1,0.2738034648603571,81
3766,15,12667,2758,9909,0,0,0,1.0,1,1.0,1,1.0,1,0.2109610268087885,83
3767,3,12670,2758,9912,0,0,0,1.0,1,1.0,1,1.0,1,0.1946022782636406,83
3768,6,12676,2759,9917,0,0,0,1.0,1,1.0,1,1.0,1,0.18115408924370696,84
3769,11,12687,2759,9928,0,0,0,1.0,1,1.0,1,1.0,1,0.15691806781592468,86
3770,8,12695,2759,9936,0,0,0,1.0,1,1.0,1,1.0,1,0.13750178490902742,87
3771,8,12703,2761,9942,0,0,0,1.0,1,1.0,1,1.0,1,0.132373888581901,87
3772,5,12708,2761,9947,0,0,0,1.0,1,1.0,1,1.0,1,0.1324847049909748,88
3773,3,12711,2761,9950,0,0,0,1.0,1,1.0,1,1.0,1,0.1572419424038749,85
3774,3,12714,2761,9953,0,0,0,1.0,1,1.0,1,1.0,1,0.15588447846535392,85
3775,5,12719,2761,9958,0,0,0,1.0,1,1.0,1,1.0,1,0.18320637916192242,83
3776,8,12727,2763,9964,0,0,0,1.0,1,1.0,1,1.0,1,0.2074554269478949,82
3777,6,12733,2763,9970,0,0,0,1.0,1,1.0,1,1.0,1,0.1870441119242933,81
3778,6,12739,2763,9976,0,0,0,1.0,1,1.0,1,1.0,1,0.17456647421019705,81
3779,3,12742,2765,9977,0,0,0,1.0,1,1.0,1,1.0,1,0.2157176834728991,80
3780,2,12744,2765,9979,0,0,0,1.0,1,1.0,1,1.0,1,0.20218239344990416,80
3781,8,12752,2765,9987,0,0,0,1.0,1,1.0,1,1.0,1,0.1766415992469688,80
3782,1,12753,2765,9988,0,0,0,1.0,1,1.0,1,1.0,1,0.17124179487614524,80
3783,1,12754,2765,9989,0,0,0,1.0,1,1.0,1,1.0,1,0.1586091795270704,80
3784,2,12756,2767,9989,0,0,0,1.0,1,1.0,1,1.0,1,0.17382836196329077,79
3785,3,12759,2768,9991,0,0,0,1.0,1,1.0,1,1.0,1,0.19985485160054586,77
3786,5,12764,2769,9995,0,0,0,1.0,1,1.0,1,1.0,1,0.1713719976012709,78
3787,5,12769,2772,9997,0,0,0,1.0,1,1.0,1,1.0,1,0.217429035666656,77
3788,4,12773,2772,10001,0,0,0,1.0,1,1.0,1,1.0,1,0.2168611739757405,78
3789,7,12780,2773,10007,0,0,0,1.0,1,1.0,1,1.0,1,0.23391100869929587,77
3790,12,12792,2774,10018,0,0,0,1.0,1,1.0,1,1.0,1,0.24206722995328372,77
3791,8,12800,2775,10025,0,0,0,1.0,1,1.0,1,1.0,1,0.23621368657299532,77
3792,5,12805,2775,10030,0,0,0,1.0,1,1.0,1,1.0,1,0.22945982347845598,78
3793,7,12812,2776,10036,0,0,0,1.0,1,1.0,1,1.0,1,0.2267503574727786,80
3794,11,12823,2777,10046,0,0,0,1.0,1,1.0,1,1.0,1,0.20339425724289906,82
3795,8,12831,2777,10054,0,0,0,1.0,1,1.0,1,1.0,1,0.19691561947535194,83
3796,9,12840,2777,10063,0,0,0,1.0,1,1.0,1,1.0,1,0.16276219597305255,83
3797,3,12843,2777,10066,0,0,0,1.0,1,1.0,1,1.0,1,0.14125790273242336,82
3798,2,12845,2777,10068,0,0,0,1.0,1,1.0,1,1.0,1,0.14576668418828967,82
3799,2,12847,2777,10070,0,0,0,1.0,1,1.0,1,1.0,1,0.13156941235575825,83
3800,2,12849,2777,10072,0,0,0,1.0,1,1.0,1,1.0,1,0.14495131713619386,83
3801,0,12849,2777,10072,0,0,0,1.0,1,1.0,1,1.0,1,0.14495131713619386,83
3802,0,12849,2777,10072,0,0,0,1.0,1,1.0,1,1.0,1,0.160931195334397,82
3803,1,12850,2777,10073,0,0,0,1.0,1,1.0,1,1.0,1,0.15136981352206633,84
3804,2,12852,2778,10074,0,0,0,1.0,1,1.0,1,1.0,1,0.1545940997389421,84
3805,3,12855,2779,10076,0,0,0,1.0,1,1.0,1,1.0,1,0.1671616924776938,86
3806,1,12856,2779,10077,0,0,0,1.0,1,1.0,1,1.0,1,0.17201669353246354,86
3807,0,12856,2779,10077,0,0,0,1.0,1,1.0,1,1.0,1,0.17201669353246354,86
3808,0,12856,2779,10077,0,0,0,1.0,1,1.0,1,1.0,1,0.1735132260664383,85
3809,0,12856,2779,10077,0,0,0,1.0,1,1.0,1,1.0,1,0.1735132260664383,85
3810,1,12857,2779,10078,0,0,0,1.0,1,1.0,1,1.0,1,0.168823061987745,85
3811,5,12862,2781,10081,0,0,0,1.0,1,1.0,1,1.0,1,0.14223531429288272,84
3812,1,12863,2782,10081,0,0,0,1.0,1,1.0,1,1.0,1,0.14782388208115502,83
3813,2,12865,2782,10083,0,0,0,1.0,1,1.0,1,1.0,1,0.1144315421669706,82
3814,3,12868,2783,10085,0,0,0,1.0,1,1.0,1,1.0,1,0.11596229196528343,81
3815,3,12871,2783,10088,0,0,0,1.0,1,1.0,1,1.0,1,0.10532954188730423,82
3816,6,12877,2783,10094,0,0,0,1.0,1,1.0,1,1.0,1,0.06750344863180364,81
3817,4,12881,2784,10097,0,0,0,1.0,1,1.0,1,1.0,1,0.08737487353557925,81
3818,1,12882,2785,10097,0,0,0,1.0,1,1.0,1,1.0,1,0.11195754207367549,81
3819,3,12885,2787,10098,0,0,0,1.0,1,1.0,1,1.0,1,0.14563551967056634,82
3820,7,12892,2787,10105,0,0,0,1.0,1,1.0,1,1.0,1,0.1260015412923247,84
3821,4,12896,2789,10107,0,0,0,1.0,1,1.0,1,1.0,1,0.16502349614725081,84
3822,1,12897,2789,10108,0,0,0,1.0,1,1.0,1,1.0,1,0.1418433844244651,82
3823,1,12898,2790,10108,0,0,0,1.0,1,1.0,1,1.0,1,0.14849414806259478,81
3824,0,12898,2790,10108,0,0,0,1.0,1,1.0,1,1.0,1,0.17164966213223767,78
3825,1,12899,2790,10109,0,0,0,1.0,1,1.0,1,1.0,1,0.18649224285366978,76
3826,6,12905,2791,10114,0,0,0,1.0,1,1.0,1,1.0,1,0.17464668943704797,76
3827,1,12906,2791,10115,0,0,0,1.0,1,1.0,1,1.0,1,0.16709246773331787,75
3828,0,12906,2791,10115,0,0,0,1.0,1,1.0,1,1.0,1,0.17732356263524882,74
3829,0,12906,2791,10115,0,0,0,1.0,1,1.0,1,1.0,1,0.1972984768118834,74
3830,2,12908,2793,10115,0,0,0,1.0,1,1.0,1,1.0,1,0.18952552260710315,74
3831,5,12913,2795,10118,0,0,0,1.0,1,1.0,1,1.0,1,0.18876598536547293,74
3832,1,12914,2795,10119,0,0,0,1.0,1,1.0,1,1.0,1,0.20008718136506604,73
3833,2,12916,2797,10119,0,0,0,1.0,1,1.0,1,1.0,1,0.207459046423589,73
3834,3,12919,2798,10121,0,0,0,1.0,1,1.0,1,1.0,1,0.19581713958740704,74
3835,9,12928,2799,10129,0,0,0,1.0,1,1.0,1,1.0,1,0.20062869266006586,75
3836,5,12933,2799,10134,0,0,0,1.0,1,1.0,1,1.0,1,0.20506202100811555,75
3837,11,12944,2800,10144,0,0,0,1.0,1,1.0,1,1.0,1,0.2275020250837911,78
3838,12,12956,2802,10154,0,0,0,1.0,1,1.0,1,1.0,1,0.21797371246205202,78
3839,10,12966,2802,10164,0,0,0,1.0,1,1.0,1,1.0,1,0.19412523162798218,79
3840,14,12980,2803,10177,0,0,0,1.0,1,1.0,1,1.0,1,0.23063128443638142,82
3841,15,12995,2803,10192,0,0,0,1.0,1,1.0,1,1.0,1,0.13824163536636325,82
3842,3,12998,2803,10195,0,0,0,1.0,1,1.0,1,1.0,1,0.14004512466159688,82
3843,5,13003,2803,10200,0,0,0,1.0,1,1.0,1,1.0,1,0.1319534523986729,82
3844,3,13006,2804,10202,0,0,0,1.0,1,1.0,1,1.0,1,0.12390785494201668,83
3845,4,13010,2804,10206,0,0,0,1.0,1,1.0,1,1.0,1,0.1347377967961295,84
3846,7,13017,2804,10213,0,0,0,1.0,1,1.0,1,1.0,1,0.12240030045071125,85
3847,5,13022,2804,10218,0,0,0,1.0,1,1.0,1,1.0,1,0.12072666489672608,84
3848,6,13028,2805,10223,0,0,0,1.0,1,1.0,1,1.0,1,0.12868104869238384,84
3849,4,13032,2805,10227,0,0,0,1.0,1,1.0,1,1.0,1,0.12077769194604691,83
3850,1,13033,2805,10228,0,0,0,1.0,1,1.0,1,1.0,1,0.1279638030977558,80
3851,1,13034,2805,10229,0,0,0,1.0,1,1.0,1,1.0,1,0.13087140467137282,80
3852,2,13036,2806,10230,0,0,0,1.0,1,1.0,1,1.0,1,0.16748829766374818,79
3853,4,13040,2807,10233,0,0,0,1.0,1,1.0,1,1.0,1,0.15516353294740934,79
3854,5,13045,2810,10235,0,0,0,1.0,1,1.0,1,1.0,1,0.17950457774410752,78
3855,2,13047,2811,10236,0,0,0,1.0,1,1.0,1,1.0,1,0.19786882740483025,78
3856,9,13056,2812,10244,0,0,0,1.0,1,1.0,1,1.0,1,0.15583192132365772,80
3857,1,13057,2812,10245,0,0,0,1.0,1,1.0,1,1.0,1,0.1405975592952119,81
3858,6,13063,2814,10249,0,0,0,1.0,1,1.0,1,1.0,1,0.15516789957490043,81
3859,2,13065,2814,10251,0,0,0,1.0,1,1.0,1,1.0,1,0.15123476447950174,83
3860,2,13067,2815,10252,0,0,0,1.0,1,1.0,1,1.0,1,0.167377047134594,82
3861,5,13072,2815,10257,0,0,0,1.0,1,1.0,1,1.0,1,0.17370207732553988,84
3862,8,13080,2817,10263,0,0,0,1.0,1,1.0,1,1.0,1,0.17850084827021315,85
3863,4,13084,2817,10267,0,0,0,1.0,1,1.0,1,1.0,1,0.16876235053358657,84
3864,6,13090,2818,10272,0,0,0,1.0,1,1.0,1,1.0,1,0.16584191880991683,83
3865,3,13093,2819,10274,0,0,0,1.0,1,1.0,1,1.0,1,0.15907711187833112,82
3866,2,13095,2819,10276,0,0,0,1.0,1,1.0,1,1.0,1,0.16063070030712734,81
3867,6,13101,2823,10278,0,0,0,1.0,1,1.0,1,1.0,1,0.1498444677324429,81
3868,8,13109,2824,10285,0,0,0,1.0,1,1.0,1,1.0,1,0.18519508982713062,81
3869,10,13119,2828,10291,0,0,0,1.0,1,1.0,1,1.0,1,0.15952086991847492,81
3870,4,13123,2828,10295,0,0,0,1.0,1,1.0,1,1.0,1,0.16058117359899302,80
3871,8,13131,2831,10300,0,0,0,1.0,1,1.0,1,1.0,1,0.1277474468684501,82
3872,3,13134,2833,10301,0,0,0,1.0,1,1.0,1,1.0,1,0.13183360097731076,81
3873,1,13135,2834,10301,0,0,0,1.0,1,1.0,1,1.0,1,0.1353309603817484,81
3874,2,13137,2836,10301,0,0,0,1.0,1,1.0,1,1.0,1,0.14101586888088793,78
3875,2,13139,2836,10303,0,0,0,1.0,1,1.0,1,1.0,1,0.1461977991685798,77
3876,5,13144,2837,10307,0,0,0,1.0,1,1.0,1,1.0,1,0.11707582643446723,78
3877,2,13146,2838,10308,0,0,0,1.0,1,1.0,1,1.0,1,0.13435943971692293,75
3878,3,13149,2839,10310,0,0,0,1.0,1,1.0,1,1.0,1,0.10636311763112415,75
3879,0,13149,2839,10310,0,0,0,1.0,1,1.0,1,1.0,1,0.13318184321304716,73
3880,0,13149,2839,10310,0,0,0,1.0,1,1.0,1,1.0,1,0.11944297486799894,74
3881,1,13150,2839,10311,0,0,0,1.0,1,1.0,1,1.0,1,0.11899490077412055,75
3882,3,13153,2839,10314,0,0,0,1.0,1,1.0,1,1.0,1,0.09648390276003249,76
3883,1,13154,2839,10315,0,0,0,1.0,1,1.0,1,1.0,1,0.0894983174967152,77
3884,8,13162,2843,10319,0,0,0,1.0,1,1.0,1,1.0,1,0.11190514534899659,78
3885,3,13165,2843,10322,0,0,0,1.0,1,1.0,1,1.0,1,0.11519746937605778,78
3886,11,13176,2844,10332,0,0,0,1.0,1,1.0,1,1.0,1,0.07467345441289615,79
3887,5,13181,2846,10335,0,0,0,1.0,1,1.0,1,1.0,1,0.10642346251375517,78
3888,7,13188,2848,10340,0,0,0,1.0,1,1.0,1,1.0,1,0.1488327812985992,80
3889,6,13194,2848,10346,0,0,0,1.0,1,1.0,1,1.0,1,0.11191122718913497,82
3890,1,13195,2848,10347,0,0,0,1.0,1,1.0,1,1.0,1,0.10487028643180257,82
3891,8,13203,2849,10354,0,0,0,1.0,1,1.0,1,1.0,1,0.10712169853220294,85
3892,13,13216,2851,10365,0,0,0,1.0,1,1.0,1,1.0,1,0.098225396381537,87
3893,8,13224,2851,10373,0,0,0,1.0,1,1.0,1,1.0,1,0.08846853125332042,86
3894,7,13231,2851,10380,0,0,0,1.0,1,1.0,1,1.0,1,0.09615531344661292,87
3895,8,13239,2853,10386,0,0,0,1.0,1,1.0,1,1.0,1,0.11355280256349308,87
3896,6,13245,2853,10392,0,0,0,1.0,1,1.0,1,1.0,1,0.12963431859902208,85
3897,9,13254,2854,10400,0,0,0,1.0,1,1.0,1,1.0,1,0.12056561997169768,85
3898,10,13264,2855,10409,0,0,0,1.0,1,1.0,1,1.0,1,0.1329398140367747,86
3899,5,13269,2855,10414,0,0,0,1.0,1,1.0,1,1.0,1,0.13625469296167134,86
3900,8,13277,2855,10422,0,0,0,1.0,1,1.0,1,1.0,1,0.13215135027460725,86
3901,5,13282,2856,10426,0,0,0,1.0,1,1.0,1,1.0,1,0.11800818229523531,86
3902,5,13287,2858,10429,0,0,0,1.0,1,1.0,1,1.0,1,0.10612987349426443,87
3903,5,13292,2859,10433,0,0,0,1.0,1,1.0,1,1.0,1,0.08979549925955742,87
3904,1,13293,2860,10433,0,0,0,1.0,1,1.0,1,1.0,1,0.09867530915026196,85
3905,1,13294,2860,10434,0,0,0,1.0,1,1.0,1,1.0,1,0.10026196129689152,84
3906,4,13298,2861,10437,0,0,0,1.0,1,1.0,1,1.0,1,0.09553196654999811,86
3907,4,13302,2863,10439,0,0,0,1.0,1,1.0,1,1.0,1,0.10686309848019655,84
3908,1,13303,2864,10439,0,0,0,1.0,1,1.0,1,1.0,1,0.11010899587435284,83
3909,3,13306,2865,10441,0,0,0,1.0,1,1.0,1,1.0,1,0.12414267753072505,81
3910,4,13310,2867,10443,0,0,0,1.0,1,1.0,1,1.0,1,0.14988834097952058,82
3911,10,13320,2870,10450,0,0,0,1.0,1,1.0,1,1.0,1,0.15763522346257058,81
3912,4,13324,2870,10454,0,0,0,1.0,1,1.0,1,1.0,1,0.16831413317056854,80
3913,8,13332,2872,10460,0,0,0,1.0,1,1.0,1,1.0,1,0.18301171345572484,80
3914,7,13339,2873,10466,0,0,0,1.0,1,1.0,1,1.0,1,0.21919359689856613,81
3915,13,13352,2875,10477,0,0,0,1.0,1,1.0,1,1.0,1,0.2260938497001269,81
3916,22,13374,2878,10496,0,0,0,1.0,1,1.0,1,1.0,1,0.1214926209273529,81
3917,2,13376,2879,10497,0,0,0,1.0,1,1.0,1,1.0,1,0.0914471662185777,82
3918,7,13383,2879,10504,0,0,0,1.0,1,1.0,1,1.0,1,0.0994899419166974,85
3919,5,13388,2880,10508,0,0,0,1.0,1,1.0,1,1.0,1,0.13322664407421356,85
3920,6,13394,2881,10513,0,0,0,1.0,1,1.0,1,1.0,1,0.1102302097348038,85
3921,18,13412,2883,10529,0,0,0,1.0,1,1.0,1,1.0,1,0.12118430900031653,88
3922,10,13422,2883,10539,0,0,0,1.0,1,1.0,1,1.0,1,0.11011768240663766,88
3923,10,13432,2883,10549,0,0,0,1.0,1,1.0,1,1.0,1,0.10079574283053422,89
3924,9,13441,2883,10558,0,0,0,1.0,1,1.0,1,1.0,1,0.12311920912368013,90
3925,9,13450,2883,10567,0,0,0,1.0,1,1.0,1,1.0,1,0.1041787996190301,88
3926,11,13461,2883,10578,0,0,0,1.0,1,1.0,1,1.0,1,0.11336150320787522,89
3927,10,13471,2884,10587,0,0,0,1.0,1,1.0,1,1.0,1,0.1480614145952073,89
3928,11,13482,2884,10598,0,0,0,1.0,1,1.0,1,1.0,1,0.1385072119814015,88
3929,17,13499,2884,10615,0,0,0,1.0,1,1.0,1,1.0,1,0.13547147738748488,88
3930,14,13513,2885,10628,0,0,0,1.0,1,1.0,1,1.0,1,0.13502018779978353,87
3931,15,13528,2887,10641,0,0,0,1.0,1,1.0,1,1.0,1,0.16437867679194118,86
3932,12,13540,2888,10652,0,0,0,1.0,1,1.0,1,1.0,1,0.14285534825112384,85
3933,9,13549,2888,10661,0,0,0,1.0,1,1.0,1,1.0,1,0.0981530366957246,84
3934,15,13564,2888,10676,0,0,0,1.0,1,1.0,1,1.0,1,0.11149159001557807,85
3935,7,13571,2889,10682,0,0,0,1.0,1,1.0,1,1.0,1,0.1603918959802431,84
3936,9,13580,2889,10691,0,0,0,1.0,1,1.0,1,1.0,1,0.16194574335626596,84
3937,7,13587,2889,10698,0,0,0,1.0,1,1.0,1,1.0,1,0.11799897578394469,82
3938,9,13596,2890,10706,0,0,0,1.0,1,1.0,1,1.0,1,0.16112514747636308,82
3939,14,13610,2890,10720,0,0,0,1.0,1,1.0,1,1.0,1,0.1514625386891099,84
3940,9,13619,2890,10729,0,0,0,1.0,1,1.0,1,1.0,1,0.1519976247245997,84
3941,12,13631,2890,10741,0,0,0,1.0,1,1.0,1,1.0,1,0.15721443949828012,85
3942,12,13643,2892,10751,0,0,0,1.0,1,1.0,1,1.0,1,0.0816410969639182,85
3943,12,13655,2892,10763,0,0,0,1.0,1,1.0,1,1.0,1,0.1457011969635526,84
3944,14,13669,2895,10774,0,0,0,1.0,1,1.0,1,1.0,1,0.11781505600773115,83
3945,12,13681,2895,10786,0,0,0,1.0,1,1.0,1,1.0,1,0.16609739675890745,83
3946,10,13691,2896,10795,0,0,0,1.0,1,1.0,1,1.0,1,0.1167899063570074,83
3947,5,13696,2896,10800,0,0,0,1.0,1,1.0,1,1.0,1,0.108495494654113,83
3948,6,13702,2897,10805,0,0,0,1.0,1,1.0,1,1.0,1,0.11676184454288469,84
3949,5,13707,2897,10810,0,0,0,1.0,1,1.0,1,1.0,1,0.14321330542547014,84
3950,4,13711,2898,10813,0,0,0,1.0,1,1.0,1,1.0,1,0.14634159531566585,86
3951,5,13716,2898,10818,0,0,0,1.0,1,1.0,1,1.0,1,0.14889119415415003,87
3952,6,13722,2898,10824,0,0,0,1.0,1,1.0,1,1.0,1,0.15863788200493792,86
3953,5,13727,2899,10828,0,0,0,1.0,1,1.0,1,1.0,1,0.15193549873052709,86
3954,5,13732,2899,10833,0,0,0,1.0,1,1.0,1,1.0,1,0.1473830239280355,85
3955,6,13738,2900,10838,0,0,0,1.0,1,1.0,1,1.0,1,0.15296710912894637,85
3956,7,13745,2900,10845,0,0,0,1.0,1,1.0,1,1.0,1,0.1667167191632069,84
3957,11,13756,2900,10856,0,0,0,1.0,1,1.0,1,1.0,1,0.14515570278149637,85
3958,5,13761,2900,10861,0,0,0,1.0,1,1.0,1,1.0,1,0.1560274917450284,84
3959,8,13769,2900,10869,0,0,0,1.0,1,1.0,1,1.0,1,0.16786061137108133,83
3960,8,13777,2900,10877,0,0,0,1.0,1,1.0,1,1.0,1,0.1759105870522659,84
3961,11,13788,2901,10887,0,0,0,1.0,1,1.0,1,1.0,1,0.12790732787089237,83
3962,5,13793,2901,10892,0,0,0,1.0,1,1.0,1,1.0,1,0.10071039042744524,84
3963,2,13795,2901,10894,0,0,0,1.0,1,1.0,1,1.0,1,0.1098142884232638,81
3964,4,13799,2902,10897,0,0,0,1.0,1,1.0,1,1.0,1,0.10188894918392465,81
3965,3,13802,2902,10900,0,0,0,1.0,1,1.0,1,1.0,1,0.11506221020163038,81
3966,5,13807,2905,10902,0,0,0,1.0,1,1.0,1,1.0,1,0.10564736439315074,79
3967,5,13812,2907,10905,0,0,0,1.0,1,1.0,1,1.0,1,0.10409594509834413,81
3968,3,13815,2908,10907,0,0,0,1.0,1,1.0,1,1.0,1,0.08943807862874863,79
3969,8,13823,2912,10911,0,0,0,1.0,1,1.0,1,1.0,1,0.12304964354354836,79
3970,6,13829,2913,10916,0,0,0,1.0,1,1.0,1,1.0,1,0.1237525240042279,78
3971,5,13834,2913,10921,0,0,0,1.0,1,1.0,1,1.0,1,0.1419317227660161,77
3972,6,13840,2914,10926,0,0,0,1.0,1,1.0,1,1.0,1,0.1512604803161746,78
3973,5,13845,2915,10930,0,0,0,1.0,1,1.0,1,1.0,1,0.16277750204181718,77
3974,4,13849,2915,10934,0,0,0,1.0,1,1.0,1,1.0,1,0.16281676085030605,77
3975,5,13854,2917,10937,0,0,0,1.0,1,1.0,1,1.0,1,0.2103432312921969,76
3976,9,13863,2917,10946,0,0,0,1.0,1,1.0,1,1.0,1,0.13243564320739423,77
3977,2,13865,2917,10948,0,0,0,1.0,1,1.0,1,1.0,1,0.12346548688965983,78
3978,3,13868,2918,10950,0,0,0,1.0,1,1.0,1,1.0,1,0.14949649368015072,79
3979,3,13871,2918,10953,0,0,0,1.0,1,1.0,1,1.0,1,0.15096061807735806,79
3980,4,13875,2918,10957,0,0,0,1.0,1,1.0,1,1.0,1,0.14236572350941903,79
3981,4,13879,2919,10960,0,0,0,1.0,1,1.0,1,1.0,1,0.16631143678835084,83
3982,3,13882,2919,10963,0,0,0,1.0,1,1.0,1,1.0,1,0.1548970752053597,83
3983,5,13887,2920,10967,0,0,0,1.0,1,1.0,1,1.0,1,0.16235261383578148,82
3984,7,13894,2920,10974,0,0,0,1.0,1,1.0,1,1.0,1,0.14218442351514352,83
3985,5,13899,2921,10978,0,0,0,1.0,1,1.0,1,1.0,1,0.14209329005338958,84
3986,9,13908,2923,10985,0,0,0,1.0,1,1.0,1,1.0,1,0.1430144813404661,83
3987,8,13916,2926,10990,0,0,0,1.0,1,1.0,1,1.0,1,0.14006664537746177,82
3988,6,13922,2928,10994,0,0,0,1.0,1,1.0,1,1.0,1,0.14407906256000777,83
3989,5,13927,2928,10999,0,0,0,1.0,1,1.0,1,1.0,1,0.14752473113714396,81
3990,7,13934,2928,11006,0,0,0,1.0,1,1.0,1,1.0,1,0.14683234159671865,81
3991,5,13939,2928,11011,0,0,0,1.0,1,1.0,1,1.0,1,0.12863754859749643,79
3992,2,13941,2928,11013,0,0,0,1.0,1,1.0,1,1.0,1,0.11190570125870221,81
3993,1,13942,2929,11013,0,0,0,1.0,1,1.0,1,1.0,1,0.11150971232054865,80
3994,1,13943,2929,11014,0,0,0,1.0,1,1.0,1,1.0,1,0.10592177560472793,80
3995,1,13944,2930,11014,0,0,0,1.0,1,1.0,1,1.0,1,0.09969185229774566,81
3996,2,13946,2930,11016,0,0,0,1.0,1,1.0,1,1.0,1,0.10539942308749153,80
3997,2,13948,2931,11017,0,0,0,1.0,1,1.0,1,1.0,1,0.11417914786351499,81
3998,0,13948,2931,11017,0,0,0,1.0,1,1.0,1,1.0,1,0.10211263301861638,82
3999,1,13949,2931,11018,0,0,0,1.0,1,1.0,1,1.0,1,0.10743643818307759,82
4000,3,13952,2933,11019,0,0,0,1.0,1,1.0,1,1.0,1,0.11097996675669058,82
4001,1,13953,2934,11019,0,0,0,1.0,1,1.0,1,1.0,1,0.10900470902155467,81
4002,3,13956,2936,11020,0,0,0,1.0,1,1.0,1,1.0,1,0.11759557458658515,81
4003,8,13964,2939,11025,0,0,0,1.0,1,1.0,1,1.0,1,0.1191758546168949,81
4004,4,13968,2941,11027,0,0,0,1.0,1,1.0,1,1.0,1,0.13364870759682312,80
4005,2,13970,2943,11027,0,0,0,1.0,1,1.0,1,1.0,1,0.14881106769614283,78
4006,3,13973,2943,11030,0,0,0,1.0,1,1.0,1,1.0,1,0.11613859582981577,76
4007,3,13976,2945,11031,0,0,0,1.0,1,1.0,1,1.0,1,0.13514151647091435,75
4008,1,13977,2945,11032,0,0,0,1.0,1,1.0,1,1.0,1,0.12345702129296268,74
4009,5,13982,2947,11035,0,0,0,1.0,1,1.0,1,1.0,1,0.15380105135690456,75
4010,1,13983,2947,11036,0,0,0,1.0,1,1.0,1,1.0,1,0.14959361859198333,75
4011,2,13985,2949,11036,0,0,0,1.0,1,1.0,1,1.0,1,0.14634158775901815,74
4012,2,13987,2950,11037,0,0,0,1.0,1,1.0,1,1.0,1,0.14945639892679977,74
4013,1,13988,2951,11037,0,0,0,1.0,1,1.0,1,1.0,1,0.1494355030905524,74
4014,0,13988,2951,11037,0,0,0,1.0,1,1.0,1,1.0,1,0.16068713905053528,73
4015,3,13991,2951,11040,0,0,0,1.0,1,1.0,1,1.0,1,0.16461699028695873,74
4016,0,13991,2951,11040,0,0,0,1.0,1,1.0,1,1.0,1,0.17648913059037885,74
4017,9,14000,2953,11047,0,0,0,1.0,1,1.0,1,1.0,1,0.16524501204650557,78
4018,4,14004,2953,11051,0,0,0,1.0,1,1.0,1,1.0,1,0.1595759272047709,78
4019,2,14006,2953,11053,0,0,0,1.0,1,1.0,1,1.0,1,0.1559611549564286,78
4020,0,14006,2953,11053,0,0,0,1.0,1,1.0,1,1.0,1,0.1559611549564286,78
4021,5,14011,2954,11057,0,0,0,1.0,1,1.0,1,1.0,1,0.1264855288012478,78
4022,1,14012,2955,11057,0,0,0,1.0,1,1.0,1,1.0,1,0.13518626495739292,79
4023,1,14013,2956,11057,0,0,0,1.0,1,1.0,1,1.0,1,0.13359644504976645,78
4024,2,14015,2958,11057,0,0,0,1.0,1,1.0,1,1.0,1,0.15430008123146816,77
4025,1,14016,2959,11057,0,0,0,1.0,1,1.0,1,1.0,1,0.15205234575412643,76
4026,6,14022,2962,11060,0,0,0,1.0,1,1.0,1,1.0,1,0.12483800083794427,76
4027,6,14028,2967,11061,0,0,0,1.0,1,1.0,1,1.0,1,0.1473879022528624,75
4028,4,14032,2969,11063,0,0,0,1.0,1,1.0,1,1.0,1,0.1412505704611717,76
4029,2,14034,2969,11065,0,0,0,1.0,1,1.0,1,1.0,1,0.13665523395237328,75
4030,1,14035,2970,11065,0,0,0,1.0,1,1.0,1,1.0,1,0.12704697737835227,74
4031,4,14039,2973,11066,0,0,0,1.0,1,1.0,1,1.0,1,0.14342528421661685,73
4032,1,14040,2973,11067,0,0,0,1.0,1,1.0,1,1.0,1,0.14596528276434428,71
4033,3,14043,2974,11069,0,0,0,1.0,1,1.0,1,1.0,1,0.1444070016604796,73
4034,3,14046,2977,11069,0,0,0,1.0,1,1.0,1,1.0,1,0.15999119337825246,72
4035,1,14047,2978,11069,0,0,0,1.0,1,1.0,1,1.0,1,0.15381001101397232,71
4036,8,14055,2979,11076,0,0,0,1.0,1,1.0,1,1.0,1,0.08951015038414302,71
4037,4,14059,2981,11078,0,0,0,1.0,1,1.0,1,1.0,1,0.11701678082970156,70
4038,1,14060,2981,11079,0,0,0,1.0,1,1.0,1,1.0,1,0.12450023815106576,69
4039,3,14063,2982,11081,0,0,0,1.0,1,1.0,1,1.0,1,0.14916576109990928,68
4040,5,14068,2983,11085,0,0,0,1.0,1,1.0,1,1.0,1,0.20979040294147538,69
4041,7,14075,2984,11091,0,0,0,1.0,1,1.0,1,1.0,1,0.22998170384720043,67
4042,4,14079,2984,11095,0,0,0,1.0,1,1.0,1,1.0,1,0.2514142237768522,67
4043,8,14087,2985,11102,0,0,0,1.0,1,1.0,1,1.0,1,0.2574482831891289,66
4044,8,14095,2985,11110,0,0,0,1.0,1,1.0,1,1.0,1,0.2641558812268855,65
4045,7,14102,2985,11117,0,0,0,1.0,1,1.0,1,1.0,1,0.24082650779368395,66
4046,6,14108,2985,11123,0,0,0,1.0,1,1.0,1,1.0,1,0.25547185868519845,68
4047,6,14114,2985,11129,0,0,0,1.0,1,1.0,1,1.0,1,0.2471680436380403,68
4048,7,14121,2985,11136,0,0,0,1.0,1,1.0,1,1.0,1,0.23386387935450698,69
4049,8,14129,2985,11144,0,0,0,1.0,1,1.0,1,1.0,1,0.23365909544959057,69
4050,9,14138,2985,11153,0,0,0,1.0,1,1.0,1,1.0,1,0.26287942533394437,69
4051,10,14148,2985,11163,0,0,0,1.0,1,1.0,1,1.0,1,0.16490793369060033,69
4052,4,14152,2985,11167,0,0,0,1.0,1,1.0,1,1.0,1,0.1403264958871595,69
4053,1,14153,2985,11168,0,0,0,1.0,1,1.0,1,1.0,1,0.1480827620434715,69
4054,3,14156,2986,11170,0,0,0,1.0,1,1.0,1,1.0,1,0.14780110189203638,70
4055,2,14158,2986,11172,0,0,0,1.0,1,1.0,1,1.0,1,0.11873921192828793,70
4056,1,14159,2986,11173,0,0,0,1.0,1,1.0,1,1.0,1,0.12063878156165202,70
4057,2,14161,2986,11175,0,0,0,1.0,1,1.0,1,1.0,1,0.11182822753429121,71
4058,1,14162,2986,11176,0,0,0,1.0,1,1.0,1,1.0,1,0.1123028689958537,71
4059,4,14166,2987,11179,0,0,0,1.0,1,1.0,1,1.0,1,0.11389514538885069,72
4060,5,14171,2987,11184,0,0,0,1.0,1,1.0,1,1.0,1,0.12021098672049896,71
4061,6,14177,2987,11190,0,0,0,1.0,1,1.0,1,1.0,1,0.12269169781666886,72
4062,4,14181,2987,11194,0,0,0,1.0,1,1.0,1,1.0,1,0.12493661040526398,72
4063,8,14189,2987,11202,0,0,0,1.0,1,1.0,1,1.0,1,0.10521198220458015,72
4064,7,14196,2988,11208,0,0,0,1.0,1,1.0,1,1.0,1,0.10710364977537391,71
4065,7,14203,2990,11213,0,0,0,1.0,1,1.0,1,1.0,1,0.13080964667696449,70
4066,9,14212,2991,11221,0,0,0,1.0,1,1.0,1,1.0,1,0.0947531797615289,70
4067,2,14214,2992,11222,0,0,0,1.0,1,1.0,1,1.0,1,0.07093562654907554,68
4068,5,14219,2993,11226,0,0,0,1.0,1,1.0,1,1.0,1,0.11617247715839463,70
4069,4,14223,2993,11230,0,0,0,1.0,1,1.0,1,1.0,1,0.10597879104367028,68
4070,7,14230,2994,11236,0,0,0,1.0,1,1.0,1,1.0,1,0.1407839862842408,67
4071,5,14235,2994,11241,0,0,0,1.0,1,1.0,1,1.0,1,0.17111993570451256,68
4072,10,14245,2996,11249,0,0,0,1.0,1,1.0,1,1.0,1,0.18349459583386563,70
4073,6,14251,2997,11254,0,0,0,1.0,1,1.0,1,1.0,1,0.21308087910629686,70
4074,12,14263,3002,11261,0,0,0,1.0,1,1.0,1,1.0,1,0.21402460302275933,71
4075,19,14282,3004,11278,0,0,0,1.0,1,1.0,1,1.0,1,0.16227684505308052,72
4076,10,14292,3006,11286,0,0,0,1.0,1,1.0,1,1.0,1,0.1847713933653564,73
4077,9,14301,3008,11293,0,0,0,1.0,1,1.0,1,1.0,1,0.2166279594272693,72
4078,16,14317,3011,11306,0,0,0,1.0,1,1.0,1,1.0,1,0.2565734846684392,71
4079,13,14330,3011,11319,0,0,0,1.0,1,1.0,1,1.0,1,0.2518084278022164,69
4080,7,14337,3011,11326,0,0,0,1.0,1,1.0,1,1.0,1,0.24298879296243828,67
4081,16,14353,3011,11342,0,0,0,1.0,1,1.0,1,1.0,1,0.1864215914793755,66
4082,4,14357,3011,11346,0,0,0,1.0,1,1.0,1,1.0,1,0.16671107379003694,65
4083,8,14365,3013,11352,0,0,0,1.0,1,1.0,1,1.0,1,0.20144653934736528,64
4084,7,14372,3013,11359,0,0,0,1.0,1,1.0,1,1.0,1,0.16369941977616734,64
4085,5,14377,3014,11363,0,0,0,1.0,1,1.0,1,1.0,1,0.16464025973413698,65
4086,4,14381,3015,11366,0,0,0,1.0,1,1.0,1,1.0,1,0.16789673568461788,66
4087,7,14388,3017,11371,0,0,0,1.0,1,1.0,1,1.0,1,0.1619350266630105,66
4088,3,14391,3017,11374,0,0,0,1.0,1,1.0,1,1.0,1,0.21074096760692995,65
4089,2,14393,3017,11376,0,0,0,1.0,1,1.0,1,1.0,1,0.20168547225023178,65
4090,6,14399,3017,11382,0,0,0,1.0,1,1.0,1,1.0,1,0.21734168514596872,65
4091,6,14405,3017,11388,0,0,0,1.0,1,1.0,1,1.0,1,0.21734168514596872,65
4092,4,14409,3017,11392,0,0,0,1.0,1,1.0,1,1.0,1,0.2215061608930503,64
4093,4,14413,3017,11396,0,0,0,1.0,1,1.0,1,1.0,1,0.18745251237899788,66
4094,5,14418,3018,11400,0,0,0,1.0,1,1.0,1,1.0,1,0.17654045115855202,65
4095,6,14424,3019,11405,0,0,0,1.0,1,1.0,1,1.0,1,0.18114630574769436,65
4096,7,14431,3020,11411,0,0,0,1.0,1,1.0,1,1.0,1,0.12452889517368329,67
4097,0,14431,3020,11411,0,0,0,1.0,1,1.0,1,1.0,1,0.12452889517368329,67
4098,1,14432,3021,11411,0,0,0,1.0,1,1.0,1,1.0,1,0.1249945265385312,68
4099,0,14432,3021,11411,0,0,0,1.0,1,1.0,1,1.0,1,0.13363359376043804,69
4100,1,14433,3022,11411,0,0,0,1.0,1,1.0,1,1.0,1,0.1379079577146877,70
4101,4,14437,3023,11414,0,0,0,1.0,1,1.0,1,1.0,1,0.14230681590041805,71
4102,2,14439,3025,11414,0,0,0,1.0,1,1.0,1,1.0,1,0.12624527657918233,71
4103,1,14440,3026,11414,0,0,0,1.0,1,1.0,1,1.0,1,0.14297416384906417,71
4104,5,14445,3029,11416,0,0,0,1.0,1,1.0,1,1.0,1,0.16945353067136554,69
4105,3,14448,3030,11418,0,0,0,1.0,1,1.0,1,1.0,1,0.17340107193615953,67
4106,3,14451,3030,11421,0,0,0,1.0,1,1.0,1,1.0,1,0.16620945021459213,68
4107,4,14455,3030,11425,0,0,0,1.0,1,1.0,1,1.0,1,0.13520231844066294,70
4108,3,14458,3030,11428,0,0,0,1.0,1,1.0,1,1.0,1,0.14066390185984542,70
4109,2,14460,3030,11430,0,0,0,1.0,1,1.0,1,1.0,1,0.1317422792838839,69
4110,3,14463,3030,11433,0,0,0,1.0,1,1.0,1,1.0,1,0.12839106579214563,71
4111,4,14467,3030,11437,0,0,0,1.0,1,1.0,1,1.0,1,0.10118104763803239,70
4112,1,14468,3030,11438,0,0,0,1.0,1,1.0,1,1.0,1,0.09154939813775986,72
4113,1,14469,3031,11438,0,0,0,1.0,1,1.0,1,1.0,1,0.08512663083042053,72
4114,8,14477,3035,11442,0,0,0,1.0,1,1.0,1,1.0,1,0.09766880779685069,72
4115,2,14479,3036,11443,0,0,0,1.0,1,1.0,1,1.0,1,0.08727109741535011,70
4116,2,14481,3037,11444,0,0,0,1.0,1,1.0,1,1.0,1,0.08705850752366319,67
4117,5,14486,3040,11446,0,0,0,1.0,1,1.0,1,1.0,1,0.12873436969452196,67
4118,0,14486,3040,11446,0,0,0,1.0,1,1.0,1,1.0,1,0.1401814742343785,66
4119,2,14488,3041,11447,0,0,0,1.0,1,1.0,1,1.0,1,0.16021572323190278,67
4120,1,14489,3042,11447,0,0,0,1.0,1,1.0,1,1.0,1,0.18744349721019712,64
4121,3,14492,3043,11449,0,0,0,1.0,1,1.0,1,1.0,1,0.19546975736235847,63
4122,5,14497,3048,11449,0,0,0,1.0,1,1.0,1,1.0,1,0.16766665193034533,63
4123,5,14502,3050,11452,0,0,0,1.0,1,1.0,1,1.0,1,0.16591357010038055,61
4124,2,14504,3052,11452,0,0,0,1.0,1,1.0,1,1.0,1,0.15896063442974048,62
4125,0,14504,3052,11452,0,0,0,1.0,1,1.0,1,1.0,1,0.1687726792245215,60
4126,5,14509,3054,11455,0,0,0,1.0,1,1.0,1,1.0,1,0.14194484343721803,59
4127,3,14512,3055,11457,0,0,0,1.0,1,1.0,1,1.0,1,0.14091709315936585,60
4128,3,14515,3057,11458,0,0,0,1.0,1,1.0,1,1.0,1,0.1595600160736075,60
4129,0,14515,3057,11458,0,0,0,1.0,1,1.0,1,1.0,1,0.17670224330582848,60
4130,4,14519,3060,11459,0,0,0,1.0,1,1.0,1,1.0,1,0.19909219950589538,61
4131,2,14521,3061,11460,0,0,0,1.0,1,1.0,1,1.0,1,0.224307103032167,60
4132,5,14526,3063,11463,0,0,0,1.0,1,1.0,1,1.0,1,0.23379945775983868,60
4133,7,14533,3064,11469,0,0,0,1.0,1,1.0,1,1.0,1,0.23562361815957938,62
4134,4,14537,3066,11471,0,0,0,1.0,1,1.0,1,1.0,1,0.20364599465546576,63
4135,5,14542,3067,11475,0,0,0,1.0,1,1.0,1,1.0,1,0.1667679520187298,65
4136,1,14543,3067,11476,0,0,0,1.0,1,1.0,1,1.0,1,0.16380498018295409,65
4137,3,14546,3067,11479,0,0,0,1.0,1,1.0,1,1.0,1,0.16199590140367678,66
4138,3,14549,3067,11482,0,0,0,1.0,1,1.0,1,1.0,1,0.16245781361556003,67
4139,9,14558,3069,11489,0,0,0,1.0,1,1.0,1,1.0,1,0.18543964246142433,67
4140,6,14564,3069,11495,0,0,0,1.0,1,1.0,1,1.0,1,0.17005110484815467,66
4141,5,14569,3069,11500,0,0,0,1.0,1,1.0,1,1.0,1,0.12804168952657835,67
4142,1,14570,3069,11501,0,0,0,1.0,1,1.0,1,1.0,1,0.1229181026043038,67
4143,3,14573,3071,11502,0,0,0,1.0,1,1.0,1,1.0,1,0.12205575995954808,66
4144,2,14575,3072,11503,0,0,0,1.0,1,1.0,1,1.0,1,0.143114457782151,64
4145,1,14576,3073,11503,0,0,0,1.0,1,1.0,1,1.0,1,0.14639586804036253,63
4146,5,14581,3077,11504,0,0,0,1.0,1,1.0,1,1.0,1,0.17061702113774943,62
4147,2,14583,3078,11505,0,0,0,1.0,1,1.0,1,1.0,1,0.1654667989277733,60
4148,5,14588,3080,11508,0,0,0,1.0,1,1.0,1,1.0,1,0.16998045808263887,62
4149,3,14591,3081,11510,0,0,0,1.0,1,1.0,1,1.0,1,0.16590414893844319,61
4150,1,14592,3082,11510,0,0,0,1.0,1,1.0,1,1.0,1,0.18624579986998774,60
4151,0,14592,3082,11510,0,0,0,1.0,1,1.0,1,1.0,1,0.1938540094353285,60
4152,1,14593,3083,11510,0,0,0,1.0,1,1.0,1,1.0,1,0.2221173818125601,60
4153,2,14595,3085,11510,0,0,0,1.0,1,1.0,1,1.0,1,0.21841450851364672,58
4154,1,14596,3086,11510,0,0,0,1.0,1,1.0,1,1.0,1,0.2097150357408151,57
4155,1,14597,3087,11510,0,0,0,1.0,1,1.0,1,1.0,1,0.19581822733890203,57
4156,13,14610,3089,11521,0,0,0,1.0,1,1.0,1,1.0,1,0.15586377299735465,58
4157,1,14611,3089,11522,0,0,0,1.0,1,1.0,1,1.0,1,0.15233751222541794,57
4158,2,14613,3090,11523,0,0,0,1.0,1,1.0,1,1.0,1,0.2125165645991637,55
4159,2,14615,3091,11524,0,0,0,1.0,1,1.0,1,1.0,1,0.2246161711184183,57
4160,2,14617,3091,11526,0,0,0,1.0,1,1.0,1,1.0,1,0.20306994843285153,58
4161,2,14619,3091,11528,0,0,0,1.0,1,1.0,1,1.0,1,0.18322673707784184,58
4162,4,14623,3092,11531,0,0,0,1.0,1,1.0,1,1.0,1,0.18458540276212498,57
4163,3,14626,3092,11534,0,0,0,1.0,1,1.0,1,1.0,1,0.1853775365563364,58
4164,6,14632,3094,11538,0,0,0,1.0,1,1.0,1,1.0,1,0.1913570212597902,56
4165,8,14640,3095,11545,0,0,0,1.0,1,1.0,1,1.0,1,0.1764103014449345,58
4166,4,14644,3095,11549,0,0,0,1.0,1,1.0,1,1.0,1,0.19910433758685162,57
4167,8,14652,3097,11555,0,0,0,1.0,1,1.0,1,1.0,1,0.2070279144609858,57
4168,11,14663,3097,11566,0,0,0,1.0,1,1.0,1,1.0,1,0.19549648207375814,58
4169,7,14670,3098,11572,0,0,0,1.0,1,1.0,1,1.0,1,0.2312386711584041,58
4170,7,14677,3098,11579,0,0,0,1.0,1,1.0,1,1.0,1,0.23000861619793952,58
4171,6,14683,3098,11585,0,0,0,1.0,1,1.0,1,1.0,1,0.19763790796882355,57
4172,3,14686,3098,11588,0,0,0,1.0,1,1.0,1,1.0,1,0.14918680598686906,57
4173,2,14688,3100,11588,0,0,0,1.0,1,1.0,1,1.0,1,0.17634947041949145,56
4174,1,14689,3101,11588,0,0,0,1.0,1,1.0,1,1.0,1,0.20590791184499815,56
4175,4,14693,3101,11592,0,0,0,1.0,1,1.0,1,1.0,1,0.16110956668548135,55
4176,4,14697,3101,11596,0,0,0,1.0,1,1.0,1,1.0,1,0.181571201656355,57
4177,4,14701,3101,11600,0,0,0,1.0,1,1.0,1,1.0,1,0.1649575321618363,58
4178,5,14706,3101,11605,0,0,0,1.0,1,1.0,1,1.0,1,0.15056691479339415,60
4179,3,14709,3101,11608,0,0,0,1.0,1,1.0,1,1.0,1,0.1460914295209951,61
4180,2,14711,3101,11610,0,0,0,1.0,1,1.0,1,1.0,1,0.15645143271750195,62
4181,7,14718,3101,11617,0,0,0,1.0,1,1.0,1,1.0,1,0.14636945940439763,63
4182,8,14726,3101,11625,0,0,0,1.0,1,1.0,1,1.0,1,0.15788046812369189,63
4183,7,14733,3101,11632,0,0,0,1.0,1,1.0,1,1.0,1,0.12295539038921206,63
4184,9,14742,3102,11640,0,0,0,1.0,1,1.0,1,1.0,1,0.11756927552772493,63
4185,8,14750,3102,11648,0,0,0,1.0,1,1.0,1,1.0,1,0.1902185589081692,61
4186,9,14759,3102,11657,0,0,0,1.0,1,1.0,1,1.0,1,0.06325990115948349,62
4187,5,14764,3104,11660,0,0,0,1.0,1,1.0,1,1.0,1,0.056038801723450764,60
4188,1,14765,3104,11661,0,0,0,1.0,1,1.0,1,1.0,1,0.07579368492867491,60
4189,1,14766,3105,11661,0,0,0,1.0,1,1.0,1,1.0,1,0.07383682458828535,60
4190,1,14767,3106,11661,0,0,0,1.0,1,1.0,1,1.0,1,0.10409746318984588,61
4191,0,14767,3106,11661,0,0,0,1.0,1,1.0,1,1.0,1,0.09059253502911851,59
4192,4,14771,3108,11663,0,0,0,1.0,1,1.0,1,1.0,1,0.12485626994951754,58
4193,2,14773,3110,11663,0,0,0,1.0,1,1.0,1,1.0,1,0.14258252953986084,57
4194,3,14776,3112,11664,0,0,0,1.0,1,1.0,1,1.0,1,0.1476063439525647,54
4195,0,14776,3112,11664,0,0,0,1.0,1,1.0,1,1.0,1,0.15787369402881654,55
4196,2,14778,3112,11666,0,0,0,1.0,1,1.0,1,1.0,1,0.1627690081039774,56
4197,2,14780,3112,11668,0,0,0,1.0,1,1.0,1,1.0,1,0.15640256353546939,55
4198,5,14785,3113,11672,0,0,0,1.0,1,1.0,1,1.0,1,0.18410901538720745,56
4199,7,14792,3115,11677,0,0,0,1.0,1,1.0,1,1.0,1,0.20829091790036114,55
4200,6,14798,3115,11683,0,0,0,1.0,1,1.0,1,1.0,1,0.22570253435105578,55
4201,6,14804,3115,11689,0,0,0,1.0,1,1.0,1,1.0,1,0.1536531375687629,56
4202,0,14804,3115,11689,0,0,0,1.0,1,1.0,1,1.0,1,0.1536531375687629,56
4203,1,14805,3115,11690,0,0,0,1.0,1,1.0,1,1.0,1,0.1558915150773818,57
4204,1,14806,3116,11690,0,0,0,1.0,1,1.0,1,1.0,1,0.15747091207216268,57
4205,1,14807,3116,11691,0,0,0,1.0,1,1.0,1,1.0,1,0.14658816721422888,58
4206,4,14811,3117,11694,0,0,0,1.0,1,1.0,1,1.0,1,0.1501902112271168,58
4207,6,14817,3119,11698,0,0,0,1.0,1,1.0,1,1.0,1,0.1542695025180636,58
4208,3,14820,3120,11700,0,0,0,1.0,1,1.0,1,1.0,1,0.1682470949308428,60
4209,5,14825,3123,11702,0,0,0,1.0,1,1.0,1,1.0,1,0.17688029101924527,61
4210,5,14830,3123,11707,0,0,0,1.0,1,1.0,1,1.0,1,0.15298310018171,62
4211,7,14837,3124,11713,0,0,0,1.0,1,1.0,1,1.0,1,0.1567687007656518,63
4212,6,14843,3124,11719,0,0,0,1.0,1,1.0,1,1.0,1,0.13810030115364907,64
4213,5,14848,3124,11724,0,0,0,1.0,1,1.0,1,1.0,1,0.128867486305429,65
4214,3,14851,3124,11727,0,0,0,1.0,1,1.0,1,1.0,1,0.14486824608591364,65
4215,2,14853,3124,11729,0,0,0,1.0,1,1.0,1,1.0,1,0.12584634679055434,65
4216,2,14855,3124,11731,0,0,0,1.0,1,1.0,1,1.0,1,0.12125518064064647,64
4217,3,14858,3125,11733,0,0,0,1.0,1,1.0,1,1.0,1,0.12356698701067335,65
4218,0,14858,3125,11733,0,0,0,1.0,1,1.0,1,1.0,1,0.12356698701067335,65
4219,1,14859,3126,11733,0,0,0,1.0,1,1.0,1,1.0,1,0.14650722007755804,65
4220,3,14862,3127,11735,0,0,0,1.0,1,1.0,1,1.0,1,0.1371993590817828,65
4221,1,14863,3128,11735,0,0,0,1.0,1,1.0,1,1.0,1,0.1804365465606617,67
4222,5,14868,3130,11738,0,0,0,1.0,1,1.0,1,1.0,1,0.1859773548781025,68
4223,3,14871,3130,11741,0,0,0,1.0,1,1.0,1,1.0,1,0.17978056833839035,68
4224,3,14874,3131,11743,0,0,0,1.0,1,1.0,1,1.0,1,0.18510213288329047,68
4225,1,14875,3132,11743,0,0,0,1.0,1,1.0,1,1.0,1,0.1755639466232636,66
4226,0,14875,3132,11743,0,0,0,1.0,1,1.0,1,1.0,1,0.17528236857010612,66
4227,1,14876,3133,11743,0,0,0,1.0,1,1.0,1,1.0,1,0.19187192115155066,66
4228,0,14876,3133,11743,0,0,0,1.0,1,1.0,1,1.0,1,0.18704215497797438,65
4229,1,14877,3134,11743,0,0,0,1.0,1,1.0,1,1.0,1,0.19131583548532122,65
4230,2,14879,3135,11744,0,0,0,1.0,1,1.0,1,1.0,1,0.19973006505618293,64
4231,8,14887,3136,11751,0,0,0,1.0,1,1.0,1,1.0,1,0.13480711456568953,64
4232,1,14888,3136,11752,0,0,0,1.0,1,1.0,1,1.0,1,0.11888049977995481,65
4233,0,14888,3136,11752,0,0,0,1.0,1,1.0,1,1.0,1,0.1251165570201915,64
4234,0,14888,3136,11752,0,0,0,1.0,1,1.0,1,1.0,1,0.12005736530779594,63
4235,3,14891,3138,11753,0,0,0,1.0,1,1.0,1,1.0,1,0.13779475817920037,63
4236,2,14893,3138,11755,0,0,0,1.0,1,1.0,1,1.0,1,0.13475215058852538,63
4237,7,14900,3139,11761,0,0,0,1.0,1,1.0,1,1.0,1,0.17823621035747914,65
4238,4,14904,3139,11765,0,0,0,1.0,1,1.0,1,1.0,1,0.19204351171156922,65
4239,5,14909,3139,11770,0,0,0,1.0,1,1.0,1,1.0,1,0.17557606357274452,65
4240,6,14915,3139,11776,0,0,0,1.0,1,1.0,1,1.0,1,0.15528513647338477,66
4241,2,14917,3139,11778,0,0,0,1.0,1,1.0,1,1.0,1,0.15458271517732908,66
4242,5,14922,3140,11782,0,0,0,1.0,1,1.0,1,1.0,1,0.1371309527628473,69
4243,5,14927,3140,11787,0,0,0,1.0,1,1.0,1,1.0,1,0.13460298356696496,71
4244,6,14933,3140,11793,0,0,0,1.0,1,1.0,1,1.0,1,0.13952094927707123,71
4245,3,14936,3140,11796,0,0,0,1.0,1,1.0,1,1.0,1,0.13622780023384556,73
4246,7,14943,3140,11803,0,0,0,1.0,1,1.0,1,1.0,1,0.0734364010542135,74
4247,2,14945,3140,11805,0,0,0,1.0,1,1.0,1,1.0,1,0.0734364010542135,74
4248,0,14945,3140,11805,0,0,0,1.0,1,1.0,1,1.0,1,0.0734364010542135,74
4249,0,14945,3140,11805,0,0,0,1.0,1,1.0,1,1.0,1,0.0734364010542135,74
4250,0,14945,3140,11805,0,0,0,1.0,1,1.0,1,1.0,1,0.0734364010542135,74
4251,2,14947,3140,11807,0,0,0,1.0,1,1.0,1,1.0,1,0.06960505148484952,75
4252,2,14949,3142,11807,0,0,0,1.0,1,1.0,1,1.0,1,0.10566950321480233,75
4253,3,14952,3142,11810,0,0,0,1.0,1,1.0,1,1.0,1,0.1042415175730519,76
4254,2,14954,3144,11810,0,0,0,1.0,1,1.0,1,1.0,1,0.10095425097528385,75
4255,2,14956,3146,11810,0,0,0,1.0,1,1.0,1,1.0,1,0.1219093248136004,76
4256,2,14958,3147,11811,0,0,0,1.0,1,1.0,1,1.0,1,0.1310518637586963,78
4257,7,14965,3149,11816,0,0,0,1.0,1,1.0,1,1.0,1,0.13177003876111243,78
4258,4,14969,3149,11820,0,0,0,1.0,1,1.0,1,1.0,1,0.13220816309671726,77
4259,5,14974,3150,11824,0,0,0,1.0,1,1.0,1,1.0,1,0.1557278703915089,78
4260,4,14978,3150,11828,0,0,0,1.0,1,1.0,1,1.0,1,0.13642100991658201,77
4261,8,14986,3151,11835,0,0,0,1.0,1,1.0,1,1.0,1,0.1002908946589127,76
4262,1,14987,3151,11836,0,0,0,1.0,1,1.0,1,1.0,1,0.12233203492310037,75
4263,2,14989,3152,11837,0,0,0,1.0,1,1.0,1,1.0,1,0.11458674504859619,74
4264,3,14992,3152,11840,0,0,0,1.0,1,1.0,1,1.0,1,0.1611762878612275,74
4265,9,15001,3154,11847,0,0,0,1.0,1,1.0,1,1.0,1,0.15829076962287533,73
4266,6,15007,3155,11852,0,0,0,1.0,1,1.0,1,1.0,1,0.17921520814939587,71
4267,5,15012,3158,11854,0,0,0,1.0,1,1.0,1,1.0,1,0.22232875160807333,69
4268,5,15017,3160,11857,0,0,0,1.0,1,1.0,1,1.0,1,0.26069621902215656,67
4269,4,15021,3161,11860,0,0,0,1.0,1,1.0,1,1.0,1,0.2745288186372979,64
4270,2,15023,3161,11862,0,0,0,1.0,1,1.0,1,1.0,1,0.25363405511813897,63
4271,7,15030,3162,11868,0,0,0,1.0,1,1.0,1,1.0,1,0.250172004646995,63
4272,3,15033,3163,11870,0,0,0,1.0,1,1.0,1,1.0,1,0.258383884550882,62
4273,6,15039,3164,11875,0,0,0,1.0,1,1.0,1,1.0,1,0.27373609411953376,62
4274,8,15047,3164,11883,0,0,0,1.0,1,1.0,1,1.0,1,0.25660976499405097,62
4275,5,15052,3165,11887,0,0,0,1.0,1,1.0,1,1.0,1,0.2469923434278236,61
4276,14,15066,3165,11901,0,0,0,1.0,1,1.0,1,1.0,1,0.11440600634705904,62
4277,3,15069,3165,11904,0,0,0,1.0,1,1.0,1,1.0,1,0.10730224082744147,63
4278,2,15071,3165,11906,0,0,0,1.0,1,1.0,1,1.0,1,0.116471463464728,64
4279,6,15077,3165,11912,0,0,0,1.0,1,1.0,1,1.0,1,0.0860508198292793,65
4280,7,15084,3165,11919,0,0,0,1.0,1,1.0,1,1.0,1,0.10521611739668886,65
4281,7,15091,3165,11926,0,0,0,1.0,1,1.0,1,1.0,1,0.08077382113959115,65
4282,12,15103,3168,11935,0,0,0,1.0,1,1.0,1,1.0,1,0.16004271541022821,66
4283,12,15115,3170,11945,0,0,0,1.0,1,1.0,1,1.0,1,0.19950742946865238,66
4284,15,15130,3172,11958,0,0,0,1.0,1,1.0,1,1.0,1,0.20126048782204553,66
4285,10,15140,3172,11968,0,0,0,1.0,1,1.0,1,1.0,1,0.2268966168780551,67
4286,14,15154,3172,11982,0,0,0,1.0,1,1.0,1,1.0,1,0.23723458000414055,67
4287,8,15162,3172,11990,0,0,0,1.0,1,1.0,1,1.0,1,0.2472297932309669,67
4288,14,15176,3173,12003,0,0,0,1.0,1,1.0,1,1.0,1,0.22197336927097405,68
4289,9,15185,3173,12012,0,0,0,1.0,1,1.0,1,1.0,1,0.22761958754968306,68
4290,16,15201,3174,12027,0,0,0,1.0,1,1.0,1,1.0,1,0.23994711936431623,70
4291,9,15210,3174,12036,0,0,0,1.0,1,1.0,1,1.0,1,0.17190128006631744,71
4292,1,15211,3174,12037,0,0,0,1.0,1,1.0,1,1.0,1,0.16373797325777623,71
4293,1,15212,3174,12038,0,0,0,1.0,1,1.0,1,1.0,1,0.1573429754652064,71
4294,0,15212,3174,12038,0,0,0,1.0,1,1.0,1,1.0,1,0.1573429754652064,71
4295,4,15216,3174,12042,0,0,0,1.0,1,1.0,1,1.0,1,0.1372003856222856,72
4296,5,15221,3176,12045,0,0,0,1.0,1,1.0,1,1.0,1,0.14047129395036,73
4297,2,15223,3176,12047,0,0,0,1.0,1,1.0,1,1.0,1,0.14596981124771982,73
4298,6,15229,3177,12052,0,0,0,1.0,1,1.0,1,1.0,1,0.1511793847966594,74
4299,4,15233,3177,12056,0,0,0,1.0,1,1.0,1,1.0,1,0.1436294384170368,75
4300,10,15243,3178,12065,0,0,0,1.0,1,1.0,1,1.0,1,0.14640752223553288,75
4301,4,15247,3178,12069,0,0,0,1.0,1,1.0,1,1.0,1,0.13837785123972643,76
4302,3,15250,3179,12071,0,0,0,1.0,1,1.0,1,1.0,1,0.12229844474633635,76
4303,5,15255,3179,12076,0,0,0,1.0,1,1.0,1,1.0,1,0.12021018058680971,75
4304,6,15261,3180,12081,0,0,0,1.0,1,1.0,1,1.0,1,0.14406877452916744,75
4305,4,15265,3180,12085,0,0,0,1.0,1,1.0,1,1.0,1,0.14467599024436156,73
4306,5,15270,3181,12089,0,0,0,1.0,1,1.0,1,1.0,1,0.11265998389332989,74
4307,3,15273,3183,12090,0,0,0,1.0,1,1.0,1,1.0,1,0.1361087385280226,73
4308,0,15273,3183,12090,0,0,0,1.0,1,1.0,1,1.0,1,0.15344921449153529,71
4309,0,15273,3183,12090,0,0,0,1.0,1,1.0,1,1.0,1,0.16913161953914996,70
4310,1,15274,3184,12090,0,0,0,1.0,1,1.0,1,1.0,1,0.1776160341285315,69
4311,3,15277,3185,12092,0,0,0,1.0,1,1.0,1,1.0,1,0.1663695055522626,69
4312,1,15278,3186,12092,0,0,0,1.0,1,1.0,1,1.0,1,0.16565324379335103,66
4313,3,15281,3187,12094,0,0,0,1.0,1,1.0,1,1.0,1,0.15766497543199506,64
4314,0,15281,3187,12094,0,0,0,1.0,1,1.0,1,1.0,1,0.17660275106053339,61
4315,8,15289,3193,12096,0,0,0,1.0,1,1.0,1,1.0,1,0.16735189386838334,61
4316,1,15290,3194,12096,0,0,0,1.0,1,1.0,1,1.0,1,0.16631915063305305,60
4317,2,15292,3195,12097,0,0,0,1.0,1,1.0,1,1.0,1,0.1697172531821567,62
4318,4,15296,3197,12099,0,0,0,1.0,1,1.0,1,1.0,1,0.1815182444574723,59
4319,3,15299,3200,12099,0,0,0,1.0,1,1.0,1,1.0,1,0.2365185729667994,60
4320,0,15299,3200,12099,0,0,0,1.0,1,1.0,1,1.0,1,0.2365185729667994,60
4321,10,15309,3201,12108,0,0,0,1.0,1,1.0,1,1.0,1,0.15304535031685415,61
4322,4,15313,3201,12112,0,0,0,1.0,1,1.0,1,1.0,1,0.14342498007338517,61
4323,6,15319,3202,12117,0,0,0,1.0,1,1.0,1,1.0,1,0.16406114590758641,61
4324,4,15323,3203,12120,0,0,0,1.0,1,1.0,1,1.0,1,0.1997440828828641,60
4325,4,15327,3203,12124,0,0,0,1.0,1,1.0,1,1.0,1,0.1778767355939315,60
4326,9,15336,3205,12131,0,0,0,1.0,1,1.0,1,1.0,1,0.20423620400335948,61
4327,5,15341,3205,12136,0,0,0,1.0,1,1.0,1,1.0,1,0.17425140932290442,62
4328,4,15345,3205,12140,0,0,0,1.0,1,1.0,1,1.0,1,0.18067600411663104,62
4329,13,15358,3206,12152,0,0,0,1.0,1,1.0,1,1.0,1,0.14863952088805035,65
4330,7,15365,3206,12159,0,0,0,1.0,1,1.0,1,1.0,1,0.168882713068814,65
4331,9,15374,3206,12168,0,0,0,1.0,1,1.0,1,1.0,1,0.14797973724536462,65
4332,8,15382,3206,12176,0,0,0,1.0,1,1.0,1,1.0,1,0.12739800892770314,66
4333,5,15387,3206,12181,0,0,0,1.0,1,1.0,1,1.0,1,0.1550558619707033,66
4334,8,15395,3208,12187,0,0,0,1.0,1,1.0,1,1.0,1,0.152108556885577,66
4335,5,15400,3208,12192,0,0,0,1.0,1,1.0,1,1.0,1,0.19746112074079777,65
4336,11,15411,3210,12201,0,0,0,1.0,1,1.0,1,1.0,1,0.1369895898523322,67
4337,5,15416,3211,12205,0,0,0,1.0,1,1.0,1,1.0,1,0.17038412155116409,69
4338,5,15421,3211,12210,0,0,0,1.0,1,1.0,1,1.0,1,0.18549264906477259,70
4339,6,15427,3211,12216,0,0,0,1.0,1,1.0,1,1.0,1,0.16816726491389447,70
4340,3,15430,3211,12219,0,0,0,1.0,1,1.0,1,1.0,1,0.18090890969779616,71
4341,5,15435,3213,12222,0,0,0,1.0,1,1.0,1,1.0,1,0.18638804986150084,70
4342,9,15444,3213,12231,0,0,0,1.0,1,1.0,1,1.0,1,0.17873829207934686,71
4343,7,15451,3214,12237,0,0,0,1.0,1,1.0,1,1.0,1,0.18517042243448908,67
4344,7,15458,3217,12241,0,0,0,1.0,1,1.0,1,1.0,1,0.18952428157185486,67
4345,4,15462,3217,12245,0,0,0,1.0,1,1.0,1,1.0,1,0.18113735447164778,64
4346,12,15474,3221,12253,0,0,0,1.0,1,1.0,1,1.0,1,0.23027682270409824,64
4347,5,15479,3222,12257,0,0,0,1.0,1,1.0,1,1.0,1,0.28158008391365863,62
4348,7,15486,3224,12262,0,0,0,1.0,1,1.0,1,1.0,1,0.3110625685414788,62
4349,8,15494,3225,12269,0,0,0,1.0,1,1.0,1,1.0,1,0.3458034223251264,61
4350,12,15506,3226,12280,0,0,0,1.0,1,1.0,1,1.0,1,0.34160607995698844,60
4351,17,15523,3226,12297,0,0,0,1.0,1,1.0,1,1.0,1,0.22235601273578545,60
4352,5,15528,3226,12302,0,0,0,1.0,1,1.0,1,1.0,1,0.20645278847869936,57
4353,5,15533,3228,12305,0,0,0,1.0,1,1.0,1,1.0,1,0.23944353050478373,55
4354,4,15537,3229,12308,0,0,0,1.0,1,1.0,1,1.0,1,0.21404486262383296,55
4355,2,15539,3229,12310,0,0,0,1.0,1,1.0,1,1.0,1,0.2471592771560433,53
4356,2,15541,3229,12312,0,0,0,1.0,1,1.0,1,1.0,1,0.1962110424578748,55
4357,4,15545,3230,12315,0,0,0,1.0,1,1.0,1,1.0,1,0.1790131125976541,55
4358,8,15553,3230,12323,0,0,0,1.0,1,1.0,1,1.0,1,0.16931733784034356,55
4359,3,15556,3230,12326,0,0,0,1.0,1,1.0,1,1.0,1,0.22602618158453316,54
4360,6,15562,3230,12332,0,0,0,1.0,1,1.0,1,1.0,1,0.1893308437361432,55
4361,5,15567,3231,12336,0,0,0,1.0,1,1.0,1,1.0,1,0.2270376862854392,54
4362,5,15572,3231,12341,0,0,0,1.0,1,1.0,1,1.0,1,0.18643233938072104,55
4363,1,15573,3231,12342,0,0,0,1.0,1,1.0,1,1.0,1,0.16114525716663353,55
4364,1,15574,3231,12343,0,0,0,1.0,1,1.0,1,1.0,1,0.18327837968831495,55
4365,2,15576,3231,12345,0,0,0,1.0,1,1.0,1,1.0,1,0.1932913856749246,54
4366,7,15583,3231,12352,0,0,0,1.0,1,1.0,1,1.0,1,0.12049127823494934,54
4367,3,15586,3231,12355,0,0,0,1.0,1,1.0,1,1.0,1,0.11380936142875846,57
4368,2,15588,3231,12357,0,0,0,1.0,1,1.0,1,1.0,1,0.11446917633356954,57
4369,2,15590,3231,12359,0,0,0,1.0,1,1.0,1,1.0,1,0.11650227952461714,58
4370,2,15592,3232,12360,0,0,0,1.0,1,1.0,1,1.0,1,0.1352192900407086,59
4371,2,15594,3232,12362,0,0,0,1.0,1,1.0,1,1.0,1,0.11489618285611133,60
4372,0,15594,3232,12362,0,0,0,1.0,1,1.0,1,1.0,1,0.11489618285611133,60
4373,0,15594,3232,12362,0,0,0,1.0,1,1.0,1,1.0,1,0.11489618285611133,60
4374,2,15596,3233,12363,0,0,0,1.0,1,1.0,1,1.0,1,0.1535475881086304,59
4375,2,15598,3233,12365,0,0,0,1.0,1,1.0,1,1.0,1,0.15795653394837175,60
4376,2,15600,3233,12367,0,0,0,1.0,1,1.0,1,1.0,1,0.16164814503165875,60
4377,4,15604,3235,12369,0,0,0,1.0,1,1.0,1,1.0,1,0.2136070776913852,61
4378,4,15608,3235,12373,0,0,0,1.0,1,1.0,1,1.0,1,0.18782781372615992,64
4379,4,15612,3236,12376,0,0,0,1.0,1,1.0,1,1.0,1,0.1924275999184264,64
4380,9,15621,3238,12383,0,0,0,1.0,1,1.0,1,1.0,1,0.20177259029888367,65
4381,4,15625,3238,12387,0,0,0,1.0,1,1.0,1,1.0,1,0.16449571790664988,64
4382,2,15627,3239,12388,0,0,0,1.0,1,1.0,1,1.0,1,0.19720418668261674,64
4383,1,15628,3240,12388,0,0,0,1.0,1,1.0,1,1.0,1,0.21478636180600436,64
4384,3,15631,3241,12390,0,0,0,1.0,1,1.0,1,1.0,1,0.2600802651054942,60
4385,2,15633,3242,12391,0,0,0,1.0,1,1.0,1,1.0,1,0.2556593037775894,58
4386,2,15635,3243,12392,0,0,0,1.0,1,1.0,1,1.0,1,0.25464048954681223,58
4387,3,15638,3243,12395,0,0,0,1.0,1,1.0,1,1.0,1,0.23758718548932845,55
4388,5,15643,3246,12397,0,0,0,1.0,1,1.0,1,1.0,1,0.18290202550388338,56
4389,1,15644,3246,12398,0,0,0,1.0,1,1.0,1,1.0,1,0.17602641100597452,55
4390,1,15645,3247,12398,0,0,0,1.0,1,1.0,1,1.0,1,0.19173112137667955,55
4391,2,15647,3248,12399,0,0,0,1.0,1,1.0,1,1.0,1,0.188248452780232,56
4392,0,15647,3248,12399,0,0,0,1.0,1,1.0,1,1.0,1,0.18863911149363063,56
4393,1,15648,3249,12399,0,0,0,1.0,1,1.0,1,1.0,1,0.22270542787598305,55
4394,1,15649,3250,12399,0,0,0,1.0,1,1.0,1,1.0,1,0.22524998891447573,53
4395,1,15650,3251,12399,0,0,0,1.0,1,1.0,1,1.0,1,0.24209207746897327,53
4396,6,15656,3254,12402,0,0,0,1.0,1,1.0,1,1.0,1,0.17749210309901578,53
4397,3,15659,3255,12404,0,0,0,1.0,1,1.0,1,1.0,1,0.20251627264711786,50
4398,5,15664,3256,12408,0,0,0,1.0,1,1.0,1,1.0,1,0.24568538786987515,50
4399,0,15664,3256,12408,0,0,0,1.0,1,1.0,1,1.0,1,0.23687887303850033,52
4400,6,15670,3256,12414,0,0,0,1.0,1,1.0,1,1.0,1,0.2313196010026834,55
4401,3,15673,3256,12417,0,0,0,1.0,1,1.0,1,1.0,1,0.20128661699280012,56
4402,2,15675,3256,12419,0,0,0,1.0,1,1.0,1,1.0,1,0.17783619946883683,56
4403,4,15679,3257,12422,0,0,0,1.0,1,1.0,1,1.0,1,0.15435694500465083,57
4404,2,15681,3258,12423,0,0,0,1.0,1,1.0,1,1.0,1,0.15690044306603748,57
4405,0,15681,3258,12423,0,0,0,1.0,1,1.0,1,1.0,1,0.1549687550481016,58
4406,0,15681,3258,12423,0,0,0,1.0,1,1.0,1,1.0,1,0.1549687550481016,58
4407,0,15681,3258,12423,0,0,0,1.0,1,1.0,1,1.0,1,0.1549687550481016,58
4408,1,15682,3258,12424,0,0,0,1.0,1,1.0,1,1.0,1,0.16328768139335192,59
4409,0,15682,3258,12424,0,0,0,1.0,1,1.0,1,1.0,1,0.16328768139335192,59
4410,0,15682,3258,12424,0,0,0,1.0,1,1.0,1,1.0,1,0.16328768139335192,59
4411,4,15686,3258,12428,0,0,0,1.0,1,1.0,1,1.0,1,0.10533165222743507,62
4412,0,15686,3258,12428,0,0,0,1.0,1,1.0,1,1.0,1,0.10949364173377608,63
4413,2,15688,3259,12429,0,0,0,1.0,1,1.0,1,1.0,1,0.09452896106257948,63
4414,3,15691,3259,12432,0,0,0,1.0,1,1.0,1,1.0,1,0.08092535983059296,64
4415,2,15693,3260,12433,0,0,0,1.0,1,1.0,1,1.0,1,0.09761298888919656,64
4416,0,15693,3260,12433,0,0,0,1.0,1,1.0,1,1.0,1,0.09761298888919656,64
4417,1,15694,3260,12434,0,0,0,1.0,1,1.0,1,1.0,1,0.10073542710380794,65
4418,1,15695,3261,12434,0,0,0,1.0,1,1.0,1,1.0,1,0.11452186161402916,65
4419,0,15695,3261,12434,0,0,0,1.0,1,1.0,1,1.0,1,0.16265406125647,62
4420,0,15695,3261,12434,0,0,0,1.0,1,1.0,1,1.0,1,0.1719971365289908,62
4421,1,15696,3261,12435,0,0,0,1.0,1,1.0,1,1.0,1,0.1742793358910942,65
4422,3,15699,3262,12437,0,0,0,1.0,1,1.0,1,1.0,1,0.17985794277484568,64
4423,4,15703,3263,12440,0,0,0,1.0,1,1.0,1,1.0,1,0.15812897953693666,63
4424,3,15706,3264,12442,0,0,0,1.0,1,1.0,1,1.0,1,0.1533528615509811,63
4425,2,15708,3265,12443,0,0,0,1.0,1,1.0,1,1.0,1,0.1587783987532671,63
4426,6,15714,3266,12448,0,0,0,1.0,1,1.0,1,1.0,1,0.08806427634317018,63
4427,0,15714,3266,12448,0,0,0,1.0,1,1.0,1,1.0,1,0.08610068382896516,62
4428,1,15715,3266,12449,0,0,0,1.0,1,1.0,1,1.0,1,0.08058655798902975,61
4429,5,15720,3270,12450,0,0,0,1.0,1,1.0,1,1.0,1,0.11276818699754877,62
4430,2,15722,3271,12451,0,0,0,1.0,1,1.0,1,1.0,1,0.1335887713363792,60
4431,1,15723,3271,12452,0,0,0,1.0,1,1.0,1,1.0,1,0.11672880397047639,59
4432,1,15724,3272,12452,0,0,0,1.0,1,1.0,1,1.0,1,0.11072756000984066,60
4433,6,15730,3275,12455,0,0,0,1.0,1,1.0,1,1.0,1,0.16771137935499508,61
4434,5,15735,3276,12459,0,0,0,1.0,1,1.0,1,1.0,1,0.16560579849348178,61
4435,6,15741,3277,12464,0,0,0,1.0,1,1.0,1,1.0,1,0.14981733323081275,61
4436,0,15741,3277,12464,0,0,0,1.0,1,1.0,1,1.0,1,0.14981733323081275,61
4437,3,15744,3280,12464,0,0,0,1.0,1,1.0,1,1.0,1,0.17854461818637726,61
4438,2,15746,3281,12465,0,0,0,1.0,1,1.0,1,1.0,1,0.15850925688288542,62
4439,3,15749,3282,12467,0,0,0,1.0,1,1.0,1,1.0,1,0.16353579953383432,63
4440,2,15751,3282,12469,0,0,0,1.0,1,1.0,1,1.0,1,0.12174200256940446,64
4441,6,15757,3283,12474,0,0,0,1.0,1,1.0,1,1.0,1,0.08375249188359304,64
4442,4,15761,3284,12477,0,0,0,1.0,1,1.0,1,1.0,1,0.11632616072449412,67
4443,2,15763,3285,12478,0,0,0,1.0,1,1.0,1,1.0,1,0.15549268253990386,68
4444,3,15766,3285,12481,0,0,0,1.0,1,1.0,1,1.0,1,0.14236485665113738,69
4445,5,15771,3285,12486,0,0,0,1.0,1,1.0,1,1.0,1,0.12352454033419653,71
4446,5,15776,3286,12490,0,0,0,1.0,1,1.0,1,1.0,1,0.1190265596923171,71
4447,3,15779,3286,12493,0,0,0,1.0,1,1.0,1,1.0,1,0.14764486189654627,72
4448,3,15782,3286,12496,0,0,0,1.0,1,1.0,1,1.0,1,0.14740812432674247,71
4449,3,15785,3287,12498,0,0,0,1.0,1,1.0,1,1.0,1,0.15110258212093725,70
4450,2,15787,3288,12499,0,0,0,1.0,1,1.0,1,1.0,1,0.14427025466168586,69
4451,2,15789,3288,12501,0,0,0,1.0,1,1.0,1,1.0,1,0.14374746420791754,69
4452,7,15796,3288,12508,0,0,0,1.0,1,1.0,1,1.0,1,0.16573084270111454,70
4453,3,15799,3288,12511,0,0,0,1.0,1,1.0,1,1.0,1,0.14650477093046088,70
4454,3,15802,3289,12513,0,0,0,1.0,1,1.0,1,1.0,1,0.19332897602183668,71
4455,7,15809,3289,12520,0,0,0,1.0,1,1.0,1,1.0,1,0.19153989529492244,71
4456,13,15822,3292,12530,0,0,0,1.0,1,1.0,1,1.0,1,0.1348291541785897,71
4457,3,15825,3292,12533,0,0,0,1.0,1,1.0,1,1.0,1,0.12094889426113564,69
4458,6,15831,3293,12538,0,0,0,1.0,1,1.0,1,1.0,1,0.1297280974933044,70
4459,5,15836,3294,12542,0,0,0,1.0,1,1.0,1,1.0,1,0.12089341447723569,68
4460,2,15838,3295,12543,0,0,0,1.0,1,1.0,1,1.0,1,0.1401509902124067,68
4461,3,15841,3295,12546,0,0,0,1.0,1,1.0,1,1.0,1,0.13714182679587927,67
4462,7,15848,3300,12548,0,0,0,1.0,1,1.0,1,1.0,1,0.1869529413474447,66
4463,6,15854,3300,12554,0,0,0,1.0,1,1.0,1,1.0,1,0.19084652976314856,65
4464,3,15857,3301,12556,0,0,0,1.0,1,1.0,1,1.0,1,0.2094923476682319,62
4465,2,15859,3303,12556,0,0,0,1.0,1,1.0,1,1.0,1,0.18174231420252515,61
4466,2,15861,3304,12557,0,0,0,1.0,1,1.0,1,1.0,1,0.18608457709454365,60
4467,7,15868,3308,12560,0,0,0,1.0,1,1.0,1,1.0,1,0.21830849840608582,58
4468,3,15871,3309,12562,0,0,0,1.0,1,1.0,1,1.0,1,0.21992641532329202,57
4469,5,15876,3314,12562,0,0,0,1.0,1,1.0,1,1.0,1,0.2741880959147658,56
4470,6,15882,3316,12566,0,0,0,1.0,1,1.0,1,1.0,1,0.25362287057095767,55
4471,13,15895,3318,12577,0,0,0,1.0,1,1.0,1,1.0,1,0.16185097785477556,55
4472,7,15902,3320,12582,0,0,0,1.0,1,1.0,1,1.0,1,0.162201518244339,55
4473,7,15909,3322,12587,0,0,0,1.0,1,1.0,1,1.0,1,0.18005778678629036,55
4474,3,15912,3322,12590,0,0,0,1.0,1,1.0,1,1.0,1,0.20558878044851073,55
4475,12,15924,3324,12600,0,0,0,1.0,1,1.0,1,1.0,1,0.18448444677659157,56
4476,9,15933,3325,12608,0,0,0,1.0,1,1.0,1,1.0,1,0.19422322818835858,56
4477,5,15938,3325,12613,0,0,0,1.0,1,1.0,1,1.0,1,0.1701281786282274,57
4478,3,15941,3325,12616,0,0,0,1.0,1,1.0,1,1.0,1,0.19987596219044226,55
4479,7,15948,3326,12622,0,0,0,1.0,1,1.0,1,1.0,1,0.20006578421613366,55
4480,5,15953,3327,12626,0,0,0,1.0,1,1.0,1,1.0,1,0.19884665255890355,54
4481,3,15956,3327,12629,0,0,0,1.0,1,1.0,1,1.0,1,0.22751209346729503,53
4482,7,15963,3330,12633,0,0,0,1.0,1,1.0,1,1.0,1,0.21223501601147396,54
4483,6,15969,3330,12639,0,0,0,1.0,1,1.0,1,1.0,1,0.22663393899989095,55
4484,7,15976,3332,12644,0,0,0,1.0,1,1.0,1,1.0,1,0.2207047802740074,57
4485,11,15987,3333,12654,0,0,0,1.0,1,1.0,1,1.0,1,0.23044729290215396,60
4486,10,15997,3334,12663,0,0,0,1.0,1,1.0,1,1.0,1,0.1367121942594738,60
4487,0,15997,3334,12663,0,0,0,1.0,1,1.0,1,1.0,1,0.1367121942594738,60
4488,0,15997,3334,12663,0,0,0,1.0,1,1.0,1,1.0,1,0.1367121942594738,60
4489,1,15998,3335,12663,0,0,0,1.0,1,1.0,1,1.0,1,0.13858735908840455,60
4490,2,16000,3336,12664,0,0,0,1.0,1,1.0,1,1.0,1,0.13919602308384424,60
4491,1,16001,3337,12664,0,0,0,1.0,1,1.0,1,1.0,1,0.14488471272650733,61
4492,0,16001,3337,12664,0,0,0,1.0,1,1.0,1,1.0,1,0.14488471272650733,61
4493,0,16001,3337,12664,0,0,0,1.0,1,1.0,1,1.0,1,0.1682362697370632,60
4494,4,16005,3338,12667,0,0,0,1.0,1,1.0,1,1.0,1,0.1291700684512234,61
4495,1,16006,3339,12667,0,0,0,1.0,1,1.0,1,1.0,1,0.12351539860203788,59
4496,0,16006,3339,12667,0,0,0,1.0,1,1.0,1,1.0,1,0.13616013754038467,60
4497,0,16006,3339,12667,0,0,0,1.0,1,1.0,1,1.0,1,0.13593951221030282,59
4498,0,16006,3339,12667,0,0,0,1.0,1,1.0,1,1.0,1,0.1339033357405962,57
4499,5,16011,3341,12670,0,0,0,1.0,1,1.0,1,1.0,1,0.13279837504729658,58
4500,2,16013,3342,12671,0,0,0,1.0,1,1.0,1,1.0,1,0.1370583024675189,56
4501,9,16022,3342,12680,0,0,0,1.0,1,1.0,1,1.0,1,0.1042152518393035,57
4502,7,16029,3345,12684,0,0,0,1.0,1,1.0,1,1.0,1,0.17474534714778045,56
4503,7,16036,3346,12690,0,0,0,1.0,1,1.0,1,1.0,1,0.2146298577625884,54
4504,9,16045,3349,12696,0,0,0,1.0,1,1.0,1,1.0,1,0.24796463297164661,54
4505,5,16050,3350,12700,0,0,0,1.0,1,1.0,1,1.0,1,0.21629990556888412,51
4506,7,16057,3351,12706,0,0,0,1.0,1,1.0,1,1.0,1,0.21146929889102165,49
4507,7,16064,3353,12711,0,0,0,1.0,1,1.0,1,1.0,1,0.2974141079339314,48
4508,5,16069,3353,12716,0,0,0,1.0,1,1.0,1,1.0,1,0.2336141816267403,48
4509,5,16074,3356,12718,0,0,0,1.0,1,1.0,1,1.0,1,0.24206082924043443,46
4510,3,16077,3356,12721,0,0,0,1.0,1,1.0,1,1.0,1,0.2716005897053149,44
4511,2,16079,3356,12723,0,0,0,1.0,1,1.0,1,1.0,1,0.2993088885179814,45
4512,7,16086,3357,12729,0,0,0,1.0,1,1.0,1,1.0,1,0.256653863771387,46
4513,4,16090,3357,12733,0,0,0,1.0,1,1.0,1,1.0,1,0.26961811709246153,45
4514,3,16093,3358,12735,0,0,0,1.0,1,1.0,1,1.0,1,0.24965927975588217,46
4515,2,16095,3358,12737,0,0,0,1.0,1,1.0,1,1.0,1,0.2603361119392761,48
4516,9,16104,3358,12746,0,0,0,1.0,1,1.0,1,1.0,1,0.11296476915789753,49
4517,2,16106,3358,12748,0,0,0,1.0,1,1.0,1,1.0,1,0.09755137953924514,50
4518,2,16108,3358,12750,0,0,0,1.0,1,1.0,1,1.0,1,0.09755137953924514,50
4519,3,16111,3359,12752,0,0,0,1.0,1,1.0,1,1.0,1,0.1269359801308889,49
4520,2,16113,3360,12753,0,0,0,1.0,1,1.0,1,1.0,1,0.14705892681099347,50
4521,5,16118,3360,12758,0,0,0,1.0,1,1.0,1,1.0,1,0.12240807439699614,50
4522,2,16120,3360,12760,0,0,0,1.0,1,1.0,1,1.0,1,0.12240807439699614,50
4523,4,16124,3361,12763,0,0,0,1.0,1,1.0,1,1.0,1,0.1255058400196218,51
4524,8,16132,3362,12770,0,0,0,1.0,1,1.0,1,1.0,1,0.09447019341643445,52
4525,4,16136,3362,12774,0,0,0,1.0,1,1.0,1,1.0,1,0.11226606289596754,53
4526,8,16144,3362,12782,0,0,0,1.0,1,1.0,1,1.0,1,0.11915805504036683,54
4527,14,16158,3362,12796,0,0,0,1.0,1,1.0,1,1.0,1,0.13533066516453648,55
4528,8,16166,3362,12804,0,0,0,1.0,1,1.0,1,1.0,1,0.12165886285522481,55
4529,7,16173,3362,12811,0,0,0,1.0,1,1.0,1,1.0,1,0.13748587270825732,55
4530,6,16179,3362,12817,0,0,0,1.0,1,1.0,1,1.0,1,0.13523740323660444,56
4531,8,16187,3365,12822,0,0,0,1.0,1,1.0,1,1.0,1,0.15553921483652683,56
4532,3,16190,3365,12825,0,0,0,1.0,1,1.0,1,1.0,1,0.11497953363404684,55
4533,2,16192,3366,12826,0,0,0,1.0,1,1.0,1,1.0,1,0.13065865742005714,54
4534,4,16196,3367,12829,0,0,0,1.0,1,1.0,1,1.0,1,0.11990775115239942,55
4535,2,16198,3367,12831,0,0,0,1.0,1,1.0,1,1.0,1,0.1490584024397976,52
4536,4,16202,3370,12832,0,0,0,1.0,1,1.0,1,1.0,1,0.16977559427364788,53
4537,1,16203,3370,12833,0,0,0,1.0,1,1.0,1,1.0,1,0.14238929606597875,52
4538,2,16205,3371,12834,0,0,0,1.0,1,1.0,1,1.0,1,0.18475724373274835,52
4539,6,16211,3373,12838,0,0,0,1.0,1,1.0,1,1.0,1,0.24948526769879517,53
4540,3,16214,3374,12840,0,0,0,1.0,1,1.0,1,1.0,1,0.2588166644858089,54
4541,4,16218,3374,12844,0,0,0,1.0,1,1.0,1,1.0,1,0.23073581719797276,53
4542,8,16226,3378,12848,0,0,0,1.0,1,1.0,1,1.0,1,0.2137547776976448,53
4543,6,16232,3379,12853,0,0,0,1.0,1,1.0,1,1.0,1,0.23606338852947428,53
4544,6,16238,3382,12856,0,0,0,1.0,1,1.0,1,1.0,1,0.2724449669927884,52
4545,6,16244,3382,12862,0,0,0,1.0,1,1.0,1,1.0,1,0.2377210535904527,50
4546,11,16255,3385,12870,0,0,0,1.0,1,1.0,1,1.0,1,0.17741639969195083,49
4547,1,16256,3385,12871,0,0,0,1.0,1,1.0,1,1.0,1,0.1636401444490986,49
4548,4,16260,3385,12875,0,0,0,1.0,1,1.0,1,1.0,1,0.16783061547694497,49
4549,4,16264,3386,12878,0,0,0,1.0,1,1.0,1,1.0,1,0.14709218602110163,50
4550,2,16266,3386,12880,0,0,0,1.0,1,1.0,1,1.0,1,0.15167058651264667,49
4551,3,16269,3387,12882,0,0,0,1.0,1,1.0,1,1.0,1,0.15148807133911293,49
4552,2,16271,3387,12884,0,0,0,1.0,1,1.0,1,1.0,1,0.15148807133911293,49
4553,1,16272,3387,12885,0,0,0,1.0,1,1.0,1,1.0,1,0.1834755542758615,49
4554,4,16276,3389,12887,0,0,0,1.0,1,1.0,1,1.0,1,0.18637967702785058,49
4555,2,16278,3390,12888,0,0,0,1.0,1,1.0,1,1.0,1,0.15493682822543225,48
4556,0,16278,3390,12888,0,0,0,1.0,1,1.0,1,1.0,1,0.15493682822543225,48
4557,0,16278,3390,12888,0,0,0,1.0,1,1.0,1,1.0,1,0.15148748564544742,49
4558,5,16283,3392,12891,0,0,0,1.0,1,1.0,1,1.0,1,0.18300450044592528,49
4559,4,16287,3393,12894,0,0,0,1.0,1,1.0,1,1.0,1,0.19188445972152082,50
4560,2,16289,3394,12895,0,0,0,1.0,1,1.0,1,1.0,1,0.19011929892632845,51
4561,5,16294,3394,12900,0,0,0,1.0,1,1.0,1,1.0,1,0.13805410773014132,52
4562,4,16298,3397,12901,0,0,0,1.0,1,1.0,1,1.0,1,0.184624330036765,53
4563,0,16298,3397,12901,0,0,0,1.0,1,1.0,1,1.0,1,0.17242701530531956,52
4564,4,16302,3397,12905,0,0,0,1.0,1,1.0,1,1.0,1,0.12503867305293417,54
4565,0,16302,3397,12905,0,0,0,1.0,1,1.0,1,1.0,1,0.1373112642434731,55
4566,1,16303,3397,12906,0,0,0,1.0,1,1.0,1,1.0,1,0.13942869496805763,55
4567,0,16303,3397,12906,0,0,0,1.0,1,1.0,1,1.0,1,0.13194355250846712,56
4568,5,16308,3399,12909,0,0,0,1.0,1,1.0,1,1.0,1,0.12119404483859013,58
4569,9,16317,3401,12916,0,0,0,1.0,1,1.0,1,1.0,1,0.12167032125603212,59
4570,5,16322,3402,12920,0,0,0,1.0,1,1.0,1,1.0,1,0.10255013366693752,59
4571,5,16327,3402,12925,0,0,0,1.0,1,1.0,1,1.0,1,0.11847194060242515,57
4572,5,16332,3404,12928,0,0,0,1.0,1,1.0,1,1.0,1,0.1262909204858413,56
4573,3,16335,3405,12930,0,0,0,1.0,1,1.0,1,1.0,1,0.1400552709559973,56
4574,3,16338,3405,12933,0,0,0,1.0,1,1.0,1,1.0,1,0.18560792934900083,55
4575,2,16340,3405,12935,0,0,0,1.0,1,1.0,1,1.0,1,0.1790729165411113,55
4576,4,16344,3405,12939,0,0,0,1.0,1,1.0,1,1.0,1,0.1313232199436218,55
4577,0,16344,3405,12939,0,0,0,1.0,1,1.0,1,1.0,1,0.13597445425399318,54
4578,1,16345,3406,12939,0,0,0,1.0,1,1.0,1,1.0,1,0.15350049080702144,54
4579,1,16346,3406,12940,0,0,0,1.0,1,1.0,1,1.0,1,0.1288055754767976,54
4580,1,16347,3406,12941,0,0,0,1.0,1,1.0,1,1.0,1,0.12256211195127985,55
4581,2,16349,3408,12941,0,0,0,1.0,1,1.0,1,1.0,1,0.1658744052257472,56
4582,0,16349,3408,12941,0,0,0,1.0,1,1.0,1,1.0,1,0.1658744052257472,56
4583,0,16349,3408,12941,0,0,0,1.0,1,1.0,1,1.0,1,0.17084459695484075,57
4584,2,16351,3410,12941,0,0,0,1.0,1,1.0,1,1.0,1,0.21933571377949096,57
4585,3,16354,3410,12944,0,0,0,1.0,1,1.0,1,1.0,1,0.19991228170656655,57
4586,2,16356,3410,12946,0,0,0,1.0,1,1.0,1,1.0,1,0.1995598719130797,57
4587,1,16357,3410,12947,0,0,0,1.0,1,1.0,1,1.0,1,0.19961725762465984,57
4588,1,16358,3410,12948,0,0,0,1.0,1,1.0,1,1.0,1,0.20222941553481974,58
4589,1,16359,3410,12949,0,0,0,1.0,1,1.0,1,1.0,1,0.19839825946048392,59
4590,2,16361,3410,12951,0,0,0,1.0,1,1.0,1,1.0,1,0.20864053719622305,60
4591,2,16363,3410,12953,0,0,0,1.0,1,1.0,1,1.0,1,0.18924999443210094,61
4592,2,16365,3410,12955,0,0,0,1.0,1,1.0,1,1.0,1,0.17049809673220975,62
4593,3,16368,3411,12957,0,0,0,1.0,1,1.0,1,1.0,1,0.1780097372901311,64
4594,2,16370,3411,12959,0,0,0,1.0,1,1.0,1,1.0,1,0.15919178163026157,64
4595,3,16373,3412,12961,0,0,0,1.0,1,1.0,1,1.0,1,0.1616641876197069,63
4596,4,16377,3412,12965,0,0,0,1.0,1,1.0,1,1.0,1,0.16047860033540154,63
4597,4,16381,3412,12969,0,0,0,1.0,1,1.0,1,1.0,1,0.16046860344920436,63
4598,4,16385,3413,12972,0,0,0,1.0,1,1.0,1,1.0,1,0.15648933971314816,65
4599,4,16389,3414,12975,0,0,0,1.0,1,1.0,1,1.0,1,0.16860924680245182,66
4600,2,16391,3415,12976,0,0,0,1.0,1,1.0,1,1.0,1,0.1924364952486766,67
4601,2,16393,3415,12978,0,0,0,1.0,1,1.0,1,1.0,1,0.17476727184671248,67
4602,1,16394,3415,12979,0,0,0,1.0,1,1.0,1,1.0,1,0.1634812168067546,69
4603,2,16396,3415,12981,0,0,0,1.0,1,1.0,1,1.0,1,0.1634812168067546,69
4604,2,16398,3415,12983,0,0,0,1.0,1,1.0,1,1.0,1,0.1634812168067546,69
4605,2,16400,3415,12985,0,0,0,1.0,1,1.0,1,1.0,1,0.14933746071161513,70
4606,5,16405,3415,12990,0,0,0,1.0,1,1.0,1,1.0,1,0.11000435228603518,70
4607,4,16409,3416,12993,0,0,0,1.0,1,1.0,1,1.0,1,0.0952816873135298,72
4608,1,16410,3416,12994,0,0,0,1.0,1,1.0,1,1.0,1,0.09497043900327118,73
4609,1,16411,3417,12994,0,0,0,1.0,1,1.0,1,1.0,1,0.10659963429412474,72
4610,1,16412,3418,12994,0,0,0,1.0,1,1.0,1,1.0,1,0.12182307277131284,72
4611,4,16416,3419,12997,0,0,0,1.0,1,1.0,1,1.0,1,0.14309649770224914,71
4612,2,16418,3420,12998,0,0,0,1.0,1,1.0,1,1.0,1,0.16516142046531843,70
4613,0,16418,3420,12998,0,0,0,1.0,1,1.0,1,1.0,1,0.15312885980961827,69
4614,1,16419,3421,12998,0,0,0,1.0,1,1.0,1,1.0,1,0.1389030365048303,68
4615,2,16421,3423,12998,0,0,0,1.0,1,1.0,1,1.0,1,0.12259479226826248,68
4616,0,16421,3423,12998,0,0,0,1.0,1,1.0,1,1.0,1,0.1421519995717597,65
4617,3,16424,3425,12999,0,0,0,1.0,1,1.0,1,1.0,1,0.14095150714792734,66
4618,2,16426,3426,13000,0,0,0,1.0,1,1.0,1,1.0,1,0.16124618149409026,66
4619,1,16427,3427,13000,0,0,0,1.0,1,1.0,1,1.0,1,0.1707200198349538,65
4620,1,16428,3427,13001,0,0,0,1.0,1,1.0,1,1.0,1,0.16379537511469272,65
4621,7,16435,3430,13005,0,0,0,1.0,1,1.0,1,1.0,1,0.15778681067176345,67
4622,4,16439,3431,13008,0,0,0,1.0,1,1.0,1,1.0,1,0.1486016656223441,65
4623,3,16442,3433,13009,0,0,0,1.0,1,1.0,1,1.0,1,0.17338763274985197,66
4624,6,16448,3436,13012,0,0,0,1.0,1,1.0,1,1.0,1,0.1736092235527828,65
4625,3,16451,3436,13015,0,0,0,1.0,1,1.0,1,1.0,1,0.15489861791913345,64
4626,3,16454,3438,13016,0,0,0,1.0,1,1.0,1,1.0,1,0.1667946250546593,63
4627,4,16458,3439,13019,0,0,0,1.0,1,1.0,1,1.0,1,0.16919537021160452,65
4628,2,16460,3439,13021,0,0,0,1.0,1,1.0,1,1.0,1,0.18227007591218428,64
4629,4,16464,3441,13023,0,0,0,1.0,1,1.0,1,1.0,1,0.17680646583931653,64
4630,2,16466,3442,13024,0,0,0,1.0,1,1.0,1,1.0,1,0.14932116263061043,64
4631,7,16473,3445,13028,0,0,0,1.0,1,1.0,1,1.0,1,0.20991005080959088,66
4632,4,16477,3445,13032,0,0,0,1.0,1,1.0,1,1.0,1,0.21547189783642468,65
4633,5,16482,3445,13037,0,0,0,1.0,1,1.0,1,1.0,1,0.1962180839756725,66
4634,2,16484,3445,13039,0,0,0,1.0,1,1.0,1,1.0,1,0.22344511704608308,66
4635,4,16488,3445,13043,0,0,0,1.0,1,1.0,1,1.0,1,0.2262093001918344,66
4636,8,16496,3445,13051,0,0,0,1.0,1,1.0,1,1.0,1,0.136414730831544,66
4637,0,16496,3445,13051,0,0,0,1.0,1,1.0,1,1.0,1,0.1271119536735232,68
4638,0,16496,3445,13051,0,0,0,1.0,1,1.0,1,1.0,1,0.1271119536735232,68
4639,4,16500,3446,13054,0,0,0,1.0,1,1.0,1,1.0,1,0.11409066562569738,69
4640,0,16500,3446,13054,0,0,0,1.0,1,1.0,1,1.0,1,0.11409066562569738,69
4641,6,16506,3447,13059,0,0,0,1.0,1,1.0,1,1.0,1,0.07892081560164473,70
4642,0,16506,3447,13059,0,0,0,1.0,1,1.0,1,1.0,1,0.0844776432748825,69
4643,1,16507,3448,13059,0,0,0,1.0,1,1.0,1,1.0,1,0.08319452606840695,70
4644,2,16509,3448,13061,0,0,0,1.0,1,1.0,1,1.0,1,0.09589128511169645,69
4645,3,16512,3448,13064,0,0,0,1.0,1,1.0,1,1.0,1,0.0910904307413096,70
4646,4,16516,3449,13067,0,0,0,1.0,1,1.0,1,1.0,1,0.11902070955319193,68
4647,3,16519,3451,13068,0,0,0,1.0,1,1.0,1,1.0,1,0.1443484890659569,68
4648,3,16522,3451,13071,0,0,0,1.0,1,1.0,1,1.0,1,0.15218337967606566,67
4649,6,16528,3453,13075,0,0,0,1.0,1,1.0,1,1.0,1,0.13433099042672225,67
4650,6,16534,3453,13081,0,0,0,1.0,1,1.0,1,1.0,1,0.10700039953080862,67
4651,4,16538,3454,13084,0,0,0,1.0,1,1.0,1,1.0,1,0.10322099212632965,68
4652,4,16542,3455,13087,0,0,0,1.0,1,1.0,1,1.0,1,0.12930997351153772,66
4653,6,16548,3456,13092,0,0,0,1.0,1,1.0,1,1.0,1,0.13516356946161534,64
4654,4,16552,3458,13094,0,0,0,1.0,1,1.0,1,1.0,1,0.23678096700032034,65
4655,4,16556,3458,13098,0,0,0,1.0,1,1.0,1,1.0,1,0.19323062256918383,64
4656,6,16562,3459,13103,0,0,0,1.0,1,1.0,1,1.0,1,0.19939768846264894,65
4657,2,16564,3460,13104,0,0,0,1.0,1,1.0,1,1.0,1,0.17609136852946913,66
4658,3,16567,3462,13105,0,0,0,1.0,1,1.0,1,1.0,1,0.21287640376527092,65
4659,2,16569,3462,13107,0,0,0,1.0,1,1.0,1,1.0,1,0.20527839648939472,65
4660,2,16571,3463,13108,0,0,0,1.0,1,1.0,1,1.0,1,0.2246032106075255,66
4661,3,16574,3463,13111,0,0,0,1.0,1,1.0,1,1.0,1,0.23331612336114332,66
4662,4,16578,3463,13115,0,0,0,1.0,1,1.0,1,1.0,1,0.2155299725305295,68
4663,3,16581,3464,13117,0,0,0,1.0,1,1.0,1,1.0,1,0.2155834979350287,67
4664,6,16587,3465,13122,0,0,0,1.0,1,1.0,1,1.0,1,0.21559829595304583,67
4665,4,16591,3465,13126,0,0,0,1.0,1,1.0,1,1.0,1,0.20862472251851627,67
4666,7,16598,3465,13133,0,0,0,1.0,1,1.0,1,1.0,1,0.12884679495405646,67
4667,4,16602,3466,13136,0,0,0,1.0,1,1.0,1,1.0,1,0.13249416821549873,66
4668,2,16604,3468,13136,0,0,0,1.0,1,1.0,1,1.0,1,0.1394327491433205,66
4669,2,16606,3470,13136,0,0,0,1.0,1,1.0,1,1.0,1,0.15724125342034725,66
4670,0,16606,3470,13136,0,0,0,1.0,1,1.0,1,1.0,1,0.1724624151564521,64
4671,1,16607,3471,13136,0,0,0,1.0,1,1.0,1,1.0,1,0.17690463682831556,64
4672,3,16610,3472,13138,0,0,0,1.0,1,1.0,1,1.0,1,0.1952006331716439,64
4673,3,16613,3472,13141,0,0,0,1.0,1,1.0,1,1.0,1,0.16511641185992063,65
4674,4,16617,3474,13143,0,0,0,1.0,1,1.0,1,1.0,1,0.17843016963462843,66
4675,4,16621,3474,13147,0,0,0,1.0,1,1.0,1,1.0,1,0.1987407247927969,65
4676,6,16627,3474,13153,0,0,0,1.0,1,1.0,1,1.0,1,0.2076057382578157,65
4677,7,16634,3475,13159,0,0,0,1.0,1,1.0,1,1.0,1,0.2230852474746878,65
4678,3,16637,3475,13162,0,0,0,1.0,1,1.0,1,1.0,1,0.24738291267000143,64
4679,8,16645,3476,13169,0,0,0,1.0,1,1.0,1,1.0,1,0.2269728739190846,66
4680,6,16651,3477,13174,0,0,0,1.0,1,1.0,1,1.0,1,0.22464806434585238,67
4681,9,16660,3478,13182,0,0,0,1.0,1,1.0,1,1.0,1,0.1558794400074636,67
4682,5,16665,3482,13183,0,0,0,1.0,1,1.0,1,1.0,1,0.19263007879549673,67
4683,5,16670,3484,13186,0,0,0,1.0,1,1.0,1,1.0,1,0.15844511902585082,67
4684,3,16673,3485,13188,0,0,0,1.0,1,1.0,1,1.0,1,0.1546135064147555,66
4685,5,16678,3485,13193,0,0,0,1.0,1,1.0,1,1.0,1,0.14504042092183167,65
4686,2,16680,3485,13195,0,0,0,1.0,1,1.0,1,1.0,1,0.15527357868238245,65
4687,9,16689,3486,13203,0,0,0,1.0,1,1.0,1,1.0,1,0.15243168006053426,65
4688,8,16697,3490,13207,0,0,0,1.0,1,1.0,1,1.0,1,0.1767656920040111,64
4689,11,16708,3493,13215,0,0,0,1.0,1,1.0,1,1.0,1,0.23628951610105964,65
4690,9,16717,3493,13224,0,0,0,1.0,1,1.0,1,1.0,1,0.23140755782005437,63
4691,10,16727,3493,13234,0,0,0,1.0,1,1.0,1,1.0,1,0.21256855225370525,64
4692,6,16733,3493,13240,0,0,0,1.0,1,1.0,1,1.0,1,0.20425147729255103,63
4693,7,16740,3496,13244,0,0,0,1.0,1,1.0,1,1.0,1,0.1977039754844025,64
4694,8,16748,3496,13252,0,0,0,1.0,1,1.0,1,1.0,1,0.20135273601403528,63
4695,8,16756,3496,13260,0,0,0,1.0,1,1.0,1,1.0,1,0.20466847201004992,62
4696,6,16762,3496,13266,0,0,0,1.0,1,1.0,1,1.0,1,0.15589350009338113,61
4697,1,16763,3496,13267,0,0,0,1.0,1,1.0,1,1.0,1,0.13856923425804557,63
4698,3,16766,3496,13270,0,0,0,1.0,1,1.0,1,1.0,1,0.13453093866154156,63
4699,5,16771,3496,13275,0,0,0,1.0,1,1.0,1,1.0,1,0.12317343023564717,65
4700,3,16774,3496,13278,0,0,0,1.0,1,1.0,1,1.0,1,0.13526600342207235,64
4701,1,16775,3496,13279,0,0,0,1.0,1,1.0,1,1.0,1,0.14275459306545507,64
4702,5,16780,3496,13284,0,0,0,1.0,1,1.0,1,1.0,1,0.15151576125999314,66
4703,1,16781,3496,13285,0,0,0,1.0,1,1.0,1,1.0,1,0.14621169085502883,65
4704,4,16785,3498,13287,0,0,0,1.0,1,1.0,1,1.0,1,0.1506300326422526,64
4705,6,16791,3500,13291,0,0,0,1.0,1,1.0,1,1.0,1,0.20071070475944222,65
4706,7,16798,3504,13294,0,0,0,1.0,1,1.0,1,1.0,1,0.22125890971511297,65
4707,3,16801,3504,13297,0,0,0,1.0,1,1.0,1,1.0,1,0.19691674198954162,63
4708,6,16807,3506,13301,0,0,0,1.0,1,1.0,1,1.0,1,0.21818643942270383,62
4709,5,16812,3508,13304,0,0,0,1.0,1,1.0,1,1.0,1,0.2522455152817409,61
4710,3,16815,3508,13307,0,0,0,1.0,1,1.0,1,1.0,1,0.24652404729759472,60
4711,9,16824,3510,13314,0,0,0,1.0,1,1.0,1,1.0,1,0.1556259657884611,59
4712,2,16826,3510,13316,0,0,0,1.0,1,1.0,1,1.0,1,0.1420180322838343,58
4713,5,16831,3512,13319,0,0,0,1.0,1,1.0,1,1.0,1,0.11695835762000971,58
4714,0,16831,3512,13319,0,0,0,1.0,1,1.0,1,1.0,1,0.1169405338500313,57
4715,3,16834,3512,13322,0,0,0,1.0,1,1.0,1,1.0,1,0.10498556440626824,57
4716,3,16837,3513,13324,0,0,0,1.0,1,1.0,1,1.0,1,0.10176951309948631,55
4717,4,16841,3515,13326,0,0,0,1.0,1,1.0,1,1.0,1,0.13896392594272486,57
4718,2,16843,3515,13328,0,0,0,1.0,1,1.0,1,1.0,1,0.13086671406987915,56
4719,7,16850,3516,13334,0,0,0,1.0,1,1.0,1,1.0,1,0.11586878133204905,56
4720,6,16856,3516,13340,0,0,0,1.0,1,1.0,1,1.0,1,0.12141009877594719,57
4721,5,16861,3516,13345,0,0,0,1.0,1,1.0,1,1.0,1,0.08591231830212348,57
4722,4,16865,3516,13349,0,0,0,1.0,1,1.0,1,1.0,1,0.11268712733408234,57
4723,5,16870,3517,13353,0,0,0,1.0,1,1.0,1,1.0,1,0.11911610803520478,57
4724,3,16873,3517,13356,0,0,0,1.0,1,1.0,1,1.0,1,0.10452624518726604,57
4725,4,16877,3518,13359,0,0,0,1.0,1,1.0,1,1.0,1,0.14552868365289567,57
4726,2,16879,3519,13360,0,0,0,1.0,1,1.0,1,1.0,1,0.15488261155320654,57
4727,2,16881,3519,13362,0,0,0,1.0,1,1.0,1,1.0,1,0.14969327711739433,56
4728,0,16881,3519,13362,0,0,0,1.0,1,1.0,1,1.0,1,0.15579560376007187,57
4729,3,16884,3519,13365,0,0,0,1.0,1,1.0,1,1.0,1,0.1454930010997379,56
4730,2,16886,3520,13366,0,0,0,1.0,1,1.0,1,1.0,1,0.16528446253316045,54
4731,3,16889,3520,13369,0,0,0,1.0,1,1.0,1,1.0,1,0.1653859292294535,54
4732,3,16892,3523,13369,0,0,0,1.0,1,1.0,1,1.0,1,0.24049908974653866,54
4733,6,16898,3524,13374,0,0,0,1.0,1,1.0,1,1.0,1,0.20950264335406246,55
4734,7,16905,3526,13379,0,0,0,1.0,1,1.0,1,1.0,1,0.2778451975598592,56
4735,9,16914,3527,13387,0,0,0,1.0,1,1.0,1,1.0,1,0.28785449027790794,56
4736,6,16920,3529,13391,0,0,0,1.0,1,1.0,1,1.0,1,0.3137946159832702,58
4737,5,16925,3529,13396,0,0,0,1.0,1,1.0,1,1.0,1,0.31274363833783586,59
4738,11,16936,3530,13406,0,0,0,1.0,1,1.0,1,1.0,1,0.32509062656115956,60
4739,13,16949,3530,13419,0,0,0,1.0,1,1.0,1,1.0,1,0.33320471255513523,60
4740,9,16958,3530,13428,0,0,0,1.0,1,1.0,1,1.0,1,0.30857501643972646,60
4741,11,16969,3530,13439,0,0,0,1.0,1,1.0,1,1.0,1,0.19714175012102414,61
4742,2,16971,3531,13440,0,0,0,1.0,1,1.0,1,1.0,1,0.19415757633040626,61
4743,2,16973,3531,13442,0,0,0,1.0,1,1.0,1,1.0,1,0.18294343051602338,60
4744,4,16977,3533,13444,0,0,0,1.0,1,1.0,1,1.0,1,0.18220929876876255,60
4745,3,16980,3533,13447,0,0,0,1.0,1,1.0,1,1.0,1,0.16038733368427868,59
4746,4,16984,3534,13450,0,0,0,1.0,1,1.0,1,1.0,1,0.1409325059995741,59
4747,5,16989,3535,13454,0,0,0,1.0,1,1.0,1,1.0,1,0.13483258617761712,58
4748,7,16996,3537,13459,0,0,0,1.0,1,1.0,1,1.0,1,0.0999088520979346,58
4749,6,17002,3537,13465,0,0,0,1.0,1,1.0,1,1.0,1,0.1173936193026849,58
4750,10,17012,3538,13474,0,0,0,1.0,1,1.0,1,1.0,1,0.1462334443336153,56
4751,15,17027,3541,13486,0,0,0,1.0,1,1.0,1,1.0,1,0.10833806828389311,58
4752,5,17032,3542,13490,0,0,0,1.0,1,1.0,1,1.0,1,0.09954023448426845,55
4753,8,17040,3542,13498,0,0,0,1.0,1,1.0,1,1.0,1,0.09954023448426845,55
4754,4,17044,3542,13502,0,0,0,1.0,1,1.0,1,1.0,1,0.16016821799858189,54
4755,9,17053,3542,13511,0,0,0,1.0,1,1.0,1,1.0,1,0.12817718270727102,54
4756,8,17061,3544,13517,0,0,0,1.0,1,1.0,1,1.0,1,0.12751046322687537,54
4757,4,17065,3544,13521,0,0,0,1.0,1,1.0,1,1.0,1,0.07014800181855163,53
4758,5,17070,3544,13526,0,0,0,1.0,1,1.0,1,1.0,1,0.09380671685471258,53
4759,2,17072,3544,13528,0,0,0,1.0,1,1.0,1,1.0,1,0.07833462017610092,53
4760,3,17075,3545,13530,0,0,0,1.0,1,1.0,1,1.0,1,0.07476761303810349,53
4761,13,17088,3549,13539,0,0,0,1.0,1,1.0,1,1.0,1,0.13079355648625612,52
4762,10,17098,3550,13548,0,0,0,1.0,1,1.0,1,1.0,1,0.17632928683677823,54
4763,8,17106,3550,13556,0,0,0,1.0,1,1.0,1,1.0,1,0.15460904432196623,54
4764,7,17113,3551,13562,0,0,0,1.0,1,1.0,1,1.0,1,0.14897703745287033,55
4765,10,17123,3552,13571,0,0,0,1.0,1,1.0,1,1.0,1,0.22250831545077035,56
4766,7,17130,3552,13578,0,0,0,1.0,1,1.0,1,1.0,1,0.17098904909810242,58
4767,16,17146,3552,13594,0,0,0,1.0,1,1.0,1,1.0,1,0.17726919778147157,59
4768,16,17162,3553,13609,0,0,0,1.0,1,1.0,1,1.0,1,0.17601622059384234,60
4769,14,17176,3553,13623,0,0,0,1.0,1,1.0,1,1.0,1,0.17126064254610918,59
4770,12,17188,3553,13635,0,0,0,1.0,1,1.0,1,1.0,1,0.19561279066844614,60
4771,10,17198,3553,13645,0,0,0,1.0,1,1.0,1,1.0,1,0.1400294457588818,59
4772,3,17201,3553,13648,0,0,0,1.0,1,1.0,1,1.0,1,0.1325967172094569,59
4773,4,17205,3553,13652,0,0,0,1.0,1,1.0,1,1.0,1,0.14481064423356158,60
4774,4,17209,3555,13654,0,0,0,1.0,1,1.0,1,1.0,1,0.1544570564404243,60
4775,3,17212,3555,13657,0,0,0,1.0,1,1.0,1,1.0,1,0.138506866012162,62
4776,5,17217,3555,13662,0,0,0,1.0,1,1.0,1,1.0,1,0.09903310505024705,63
4777,3,17220,3555,13665,0,0,0,1.0,1,1.0,1,1.0,1,0.11551479099040377,63
4778,5,17225,3555,13670,0,0,0,1.0,1,1.0,1,1.0,1,0.10424872049026938,63
4779,2,17227,3555,13672,0,0,0,1.0,1,1.0,1,1.0,1,0.10410788551130452,63
4780,6,17233,3555,13678,0,0,0,1.0,1,1.0,1,1.0,1,0.12013244930666336,65
4781,5,17238,3555,13683,0,0,0,1.0,1,1.0,1,1.0,1,0.1264213479866442,64
4782,8,17246,3555,13691,0,0,0,1.0,1,1.0,1,1.0,1,0.13907246369093723,65
4783,9,17255,3557,13698,0,0,0,1.0,1,1.0,1,1.0,1,0.09437596437007648,66
4784,12,17267,3559,13708,0,0,0,1.0,1,1.0,1,1.0,1,0.14543901234301523,64
4785,8,17275,3561,13714,0,0,0,1.0,1,1.0,1,1.0,1,0.18834293079170028,65
4786,10,17285,3564,13721,0,0,0,1.0,1,1.0,1,1.0,1,0.14540388163790977,66
4787,4,17289,3564,13725,0,0,0,1.0,1,1.0,1,1.0,1,0.08906181153727517,63
4788,7,17296,3567,13729,0,0,0,1.0,1,1.0,1,1.0,1,0.11493861718277376,63
4789,5,17301,3569,13732,0,0,0,1.0,1,1.0,1,1.0,1,0.0704720610505821,60
4790,1,17302,3570,13732,0,0,0,1.0,1,1.0,1,1.0,1,0.09726954425186195,61
4791,4,17306,3574,13732,0,0,0,1.0,1,1.0,1,1.0,1,0.10810351680438357,59
4792,4,17310,3575,13735,0,0,0,1.0,1,1.0,1,1.0,1,0.0878825222127663,59
4793,1,17311,3575,13736,0,0,0,1.0,1,1.0,1,1.0,1,0.10228801255019046,61
4794,1,17312,3576,13736,0,0,0,1.0,1,1.0,1,1.0,1,0.12532275768094936,60
4795,0,17312,3576,13736,0,0,0,1.0,1,1.0,1,1.0,1,0.13094412352731982,61
4796,2,17314,3578,13736,0,0,0,1.0,1,1.0,1,1.0,1,0.1335297228866503,60
4797,5,17319,3580,13739,0,0,0,1.0,1,1.0,1,1.0,1,0.1304042946855289,61
4798,3,17322,3582,13740,0,0,0,1.0,1,1.0,1,1.0,1,0.17646622263509584,61
4799,3,17325,3582,13743,0,0,0,1.0,1,1.0,1,1.0,1,0.14352044363891378,59
4800,2,17327,3583,13744,0,0,0,1.0,1,1.0,1,1.0,1,0.15867207855874618,57
4801,7,17334,3583,13751,0,0,0,1.0,1,1.0,1,1.0,1,0.05296164778175625,58
4802,2,17336,3583,13753,0,0,0,1.0,1,1.0,1,1.0,1,0.04588668769787853,56
4803,3,17339,3584,13755,0,0,0,1.0,1,1.0,1,1.0,1,0.09595636989135471,57
4804,2,17341,3584,13757,0,0,0,1.0,1,1.0,1,1.0,1,0.06716479698985288,55
4805,3,17344,3585,13759,0,0,0,1.0,1,1.0,1,1.0,1,0.1440977406567152,56
4806,5,17349,3585,13764,0,0,0,1.0,1,1.0,1,1.0,1,0.1139737591017601,55
4807,4,17353,3585,13768,0,0,0,1.0,1,1.0,1,1.0,1,0.1524086574214763,53
4808,8,17361,3587,13774,0,0,0,1.0,1,1.0,1,1.0,1,0.2016626844512208,54
4809,3,17364,3587,13777,0,0,0,1.0,1,1.0,1,1.0,1,0.1743131035872054,53
4810,8,17372,3589,13783,0,0,0,1.0,1,1.0,1,1.0,1,0.17520602826700837,53
4811,9,17381,3590,13791,0,0,0,1.0,1,1.0,1,1.0,1,0.15942113191058904,54
4812,7,17388,3591,13797,0,0,0,1.0,1,1.0,1,1.0,1,0.17496022775249873,54
4813,8,17396,3592,13804,0,0,0,1.0,1,1.0,1,1.0,1,0.18140383384149292,55
4814,4,17400,3593,13807,0,0,0,1.0,1,1.0,1,1.0,1,0.25416380375360825,55
4815,11,17411,3593,13818,0,0,0,1.0,1,1.0,1,1.0,1,0.23011149654084723,56
4816,13,17424,3596,13828,0,0,0,1.0,1,1.0,1,1.0,1,0.10496179985532762,56
4817,8,17432,3598,13834,0,0,0,1.0,1,1.0,1,1.0,1,0.09028288561180628,58
4818,6,17438,3600,13838,0,0,0,1.0,1,1.0,1,1.0,1,0.10318457210177535,58
4819,2,17440,3600,13840,0,0,0,1.0,1,1.0,1,1.0,1,0.056842758546039686,58
4820,3,17443,3601,13842,0,0,0,1.0,1,1.0,1,1.0,1,0.09699197387890321,58
4821,5,17448,3601,13847,0,0,0,1.0,1,1.0,1,1.0,1,0.1112900713915765,58
4822,2,17450,3601,13849,0,0,0,1.0,1,1.0,1,1.0,1,0.1112900713915765,58
4823,2,17452,3602,13850,0,0,0,1.0,1,1.0,1,1.0,1,0.11502401778387597,57
4824,5,17457,3604,13853,0,0,0,1.0,1,1.0,1,1.0,1,0.1338897831101491,56
4825,6,17463,3604,13859,0,0,0,1.0,1,1.0,1,1.0,1,0.12458361646805585,57
4826,4,17467,3605,13862,0,0,0,1.0,1,1.0,1,1.0,1,0.13285288051447305,57
4827,0,17467,3605,13862,0,0,0,1.0,1,1.0,1,1.0,1,0.15845969154630213,56
4828,2,17469,3607,13862,0,0,0,1.0,1,1.0,1,1.0,1,0.1444186930494475,57
4829,1,17470,3607,13863,0,0,0,1.0,1,1.0,1,1.0,1,0.15961320443212143,56
4830,3,17473,3607,13866,0,0,0,1.0,1,1.0,1,1.0,1,0.1502054424239314,57
4831,8,17481,3609,13872,0,0,0,1.0,1,1.0,1,1.0,1,0.1317423842223732,57
4832,2,17483,3609,13874,0,0,0,1.0,1,1.0,1,1.0,1,0.15025013544443586,55
4833,6,17489,3612,13877,0,0,0,1.0,1,1.0,1,1.0,1,0.13229776473908494,55
4834,0,17489,3612,13877,0,0,0,1.0,1,1.0,1,1.0,1,0.15005874085609894,55
4835,1,17490,3613,13877,0,0,0,1.0,1,1.0,1,1.0,1,0.1540549916585155,55
4836,0,17490,3613,13877,0,0,0,1.0,1,1.0,1,1.0,1,0.1540549916585155,55
4837,1,17491,3614,13877,0,0,0,1.0,1,1.0,1,1.0,1,0.15815217622597907,53
4838,2,17493,3614,13879,0,0,0,1.0,1,1.0,1,1.0,1,0.15553149035628144,54
4839,8,17501,3618,13883,0,0,0,1.0,1,1.0,1,1.0,1,0.1585929964452731,53
4840,2,17503,3619,13884,0,0,0,1.0,1,1.0,1,1.0,1,0.16249602548361294,52
4841,2,17505,3621,13884,0,0,0,1.0,1,1.0,1,1.0,1,0.15265139386870144,51
4842,5,17510,3623,13887,0,0,0,1.0,1,1.0,1,1.0,1,0.17889270838093474,50
4843,5,17515,3624,13891,0,0,0,1.0,1,1.0,1,1.0,1,0.21857272386121304,51
4844,3,17518,3625,13893,0,0,0,1.0,1,1.0,1,1.0,1,0.1943407752146807,50
4845,7,17525,3627,13898,0,0,0,1.0,1,1.0,1,1.0,1,0.17122882500847159,49
4846,8,17533,3627,13906,0,0,0,1.0,1,1.0,1,1.0,1,0.11983473140351085,49
4847,4,17537,3628,13909,0,0,0,1.0,1,1.0,1,1.0,1,0.1168224428169023,48
4848,1,17538,3628,13910,0,0,0,1.0,1,1.0,1,1.0,1,0.1202980093951074,48
4849,2,17540,3628,13912,0,0,0,1.0,1,1.0,1,1.0,1,0.11064797542008925,48
4850,2,17542,3628,13914,0,0,0,1.0,1,1.0,1,1.0,1,0.11851551688394438,49
4851,2,17544,3628,13916,0,0,0,1.0,1,1.0,1,1.0,1,0.13839841852162305,49
4852,1,17545,3628,13917,0,0,0,1.0,1,1.0,1,1.0,1,0.1539097995996665,49
4853,2,17547,3629,13918,0,0,0,1.0,1,1.0,1,1.0,1,0.18189768716229404,50
4854,4,17551,3631,13920,0,0,0,1.0,1,1.0,1,1.0,1,0.17096165938443134,51
4855,2,17553,3631,13922,0,0,0,1.0,1,1.0,1,1.0,1,0.17096165938443134,51
4856,2,17555,3631,13924,0,0,0,1.0,1,1.0,1,1.0,1,0.16854633704071623,50
4857,2,17557,3631,13926,0,0,0,1.0,1,1.0,1,1.0,1,0.17192233812011107,51
4858,1,17558,3631,13927,0,0,0,1.0,1,1.0,1,1.0,1,0.1657537146487953,51
4859,5,17563,3631,13932,0,0,0,1.0,1,1.0,1,1.0,1,0.1392129491352164,52
4860,0,17563,3631,13932,0,0,0,1.0,1,1.0,1,1.0,1,0.1392129491352164,52
4861,3,17566,3631,13935,0,0,0,1.0,1,1.0,1,1.0,1,0.10242024619959227,53
4862,3,17569,3632,13937,0,0,0,1.0,1,1.0,1,1.0,1,0.09705111507131356,53
4863,0,17569,3632,13937,0,0,0,1.0,1,1.0,1,1.0,1,0.09288781014616172,51
4864,0,17569,3632,13937,0,0,0,1.0,1,1.0,1,1.0,1,0.09753629603654765,53
4865,0,17569,3632,13937,0,0,0,1.0,1,1.0,1,1.0,1,0.10342541065733178,52
4866,2,17571,3633,13938,0,0,0,1.0,1,1.0,1,1.0,1,0.09194537176626835,53
4867,2,17573,3634,13939,0,0,0,1.0,1,1.0,1,1.0,1,0.10011380361929512,51
4868,2,17575,3635,13940,0,0,0,1.0,1,1.0,1,1.0,1,0.10246341601408304,53
4869,0,17575,3635,13940,0,0,0,1.0,1,1.0,1,1.0,1,0.10246341601408304,53
4870,3,17578,3637,13941,0,0,0,1.0,1,1.0,1,1.0,1,0.12027943446181236,55
4871,6,17584,3638,13946,0,0,0,1.0,1,1.0,1,1.0,1,0.1181321539139781,55
4872,9,17593,3639,13954,0,0,0,1.0,1,1.0,1,1.0,1,0.1588455797881247,56
4873,4,17597,3640,13957,0,0,0,1.0,1,1.0,1,1.0,1,0.1608943270009798,56
4874,2,17599,3640,13959,0,0,0,1.0,1,1.0,1,1.0,1,0.15932284085786355,58
4875,2,17601,3641,13960,0,0,0,1.0,1,1.0,1,1.0,1,0.1993435027638796,56
4876,11,17612,3643,13969,0,0,0,1.0,1,1.0,1,1.0,1,0.14119908334364265,56
4877,3,17615,3643,13972,0,0,0,1.0,1,1.0,1,1.0,1,0.13154437180387688,54
4878,1,17616,3643,13973,0,0,0,1.0,1,1.0,1,1.0,1,0.1499395973527211,54
4879,8,17624,3645,13979,0,0,0,1.0,1,1.0,1,1.0,1,0.11194485431500703,54
4880,5,17629,3645,13984,0,0,0,1.0,1,1.0,1,1.0,1,0.1684099315447521,53
4881,6,17635,3647,13988,0,0,0,1.0,1,1.0,1,1.0,1,0.14841244948916157,54
4882,8,17643,3648,13995,0,0,0,1.0,1,1.0,1,1.0,1,0.21284667462809742,52
4883,7,17650,3649,14001,0,0,0,1.0,1,1.0,1,1.0,1,0.3026805131597437,54
4884,11,17661,3649,14012,0,0,0,1.0,1,1.0,1,1.0,1,0.29170827721627374,52
4885,7,17668,3650,14018,0,0,0,1.0,1,1.0,1,1.0,1,0.2397123554708398,51
4886,5,17673,3650,14023,0,0,0,1.0,1,1.0,1,1.0,1,0.2734543735229778,50
4887,6,17679,3650,14029,0,0,0,1.0,1,1.0,1,1.0,1,0.2657828695867354,49
4888,5,17684,3650,14034,0,0,0,1.0,1,1.0,1,1.0,1,0.25200737330808437,48
4889,6,17690,3650,14040,0,0,0,1.0,1,1.0,1,1.0,1,0.25200737330808437,48
4890,5,17695,3650,14045,0,0,0,1.0,1,1.0,1,1.0,1,0.28187640639019873,48
4891,9,17704,3651,14053,0,0,0,1.0,1,1.0,1,1.0,1,0.1562309038864904,49
4892,2,17706,3651,14055,0,0,0,1.0,1,1.0,1,1.0,1,0.129140098661917,51
4893,2,17708,3651,14057,0,0,0,1.0,1,1.0,1,1.0,1,0.11917534017667941,51
4894,0,17708,3651,14057,0,0,0,1.0,1,1.0,1,1.0,1,0.13114688820265302,52
4895,0,17708,3651,14057,0,0,0,1.0,1,1.0,1,1.0,1,0.13114688820265302,52
4896,2,17710,3651,14059,0,0,0,1.0,1,1.0,1,1.0,1,0.1349309827667289,51
4897,4,17714,3651,14063,0,0,0,1.0,1,1.0,1,1.0,1,0.1437492056889425,52
4898,5,17719,3651,14068,0,0,0,1.0,1,1.0,1,1.0,1,0.14434151205873313,52
4899,6,17725,3651,14074,0,0,0,1.0,1,1.0,1,1.0,1,0.1433478698218127,53
4900,9,17734,3651,14083,0,0,0,1.0,1,1.0,1,1.0,1,0.1661093016535815,54
4901,7,17741,3653,14088,0,0,0,1.0,1,1.0,1,1.0,1,0.16832572248065053,54
4902,4,17745,3653,14092,0,0,0,1.0,1,1.0,1,1.0,1,0.17295276632593215,55
4903,7,17752,3654,14098,0,0,0,1.0,1,1.0,1,1.0,1,0.15820652760070178,56
4904,8,17760,3654,14106,0,0,0,1.0,1,1.0,1,1.0,1,0.19241341400109765,55
4905,6,17766,3655,14111,0,0,0,1.0,1,1.0,1,1.0,1,0.148094345659137,54
4906,3,17769,3656,14113,0,0,0,1.0,1,1.0,1,1.0,1,0.13302699839555648,54
4907,0,17769,3656,14113,0,0,0,1.0,1,1.0,1,1.0,1,0.13293388817239157,54
4908,0,17769,3656,14113,0,0,0,1.0,1,1.0,1,1.0,1,0.13131673959025772,53
4909,2,17771,3657,14114,0,0,0,1.0,1,1.0,1,1.0,1,0.1495230195049708,54
4910,3,17774,3657,14117,0,0,0,1.0,1,1.0,1,1.0,1,0.1472562417335208,55
4911,4,17778,3658,14120,0,0,0,1.0,1,1.0,1,1.0,1,0.17509916415269328,57
4912,5,17783,3659,14124,0,0,0,1.0,1,1.0,1,1.0,1,0.1937524697867377,57
4913,3,17786,3659,14127,0,0,0,1.0,1,1.0,1,1.0,1,0.15097784474463743,56
4914,2,17788,3661,14127,0,0,0,1.0,1,1.0,1,1.0,1,0.16484728605980983,56
4915,6,17794,3662,14132,0,0,0,1.0,1,1.0,1,1.0,1,0.1557835797929083,56
4916,4,17798,3662,14136,0,0,0,1.0,1,1.0,1,1.0,1,0.15010768411689393,54
4917,4,17802,3663,14139,0,0,0,1.0,1,1.0,1,1.0,1,0.15347509580608906,53
4918,3,17805,3663,14142,0,0,0,1.0,1,1.0,1,1.0,1,0.15939499286329478,52
4919,0,17805,3663,14142,0,0,0,1.0,1,1.0,1,1.0,1,0.17390901399510378,49
4920,2,17807,3663,14144,0,0,0,1.0,1,1.0,1,1.0,1,0.17390901399510378,49
4921,7,17814,3664,14150,0,0,0,1.0,1,1.0,1,1.0,1,0.10159636059450552,50
4922,2,17816,3664,14152,0,0,0,1.0,1,1.0,1,1.0,1,0.11477002521004086,50
4923,2,17818,3664,14154,0,0,0,1.0,1,1.0,1,1.0,1,0.09264578094500553,52
4924,2,17820,3665,14155,0,0,0,1.0,1,1.0,1,1.0,1,0.11281131999181805,53
4925,2,17822,3665,14157,0,0,0,1.0,1,1.0,1,1.0,1,0.09134438058762066,54
4926,2,17824,3665,14159,0,0,0,1.0,1,1.0,1,1.0,1,0.09134438058762066,54
4927,2,17826,3666,14160,0,0,0,1.0,1,1.0,1,1.0,1,0.09942255623456554,54
4928,1,17827,3666,14161,0,0,0,1.0,1,1.0,1,1.0,1,0.10722197187246663,54
4929,1,17828,3666,14162,0,0,0,1.0,1,1.0,1,1.0,1,0.08877651986544166,55
4930,4,17832,3667,14165,0,0,0,1.0,1,1.0,1,1.0,1,0.12817712749737312,58
4931,5,17837,3668,14169,0,0,0,1.0,1,1.0,1,1.0,1,0.14795081005692262,58
4932,10,17847,3669,14178,0,0,0,1.0,1,1.0,1,1.0,1,0.17999534219585356,59
4933,9,17856,3670,14186,0,0,0,1.0,1,1.0,1,1.0,1,0.18135929856045632,59
4934,10,17866,3670,14196,0,0,0,1.0,1,1.0,1,1.0,1,0.20832028956205836,59
4935,13,17879,3670,14209,0,0,0,1.0,1,1.0,1,1.0,1,0.17390801181874888,59
4936,4,17883,3670,14213,0,0,0,1.0,1,1.0,1,1.0,1,0.1368758858717676,59
4937,1,17884,3670,14214,0,0,0,1.0,1,1.0,1,1.0,1,0.14244731826553575,61
4938,2,17886,3670,14216,0,0,0,1.0,1,1.0,1,1.0,1,0.1506586569529457,62
4939,6,17892,3672,14220,0,0,0,1.0,1,1.0,1,1.0,1,0.11947753170627579,63
4940,3,17895,3672,14223,0,0,0,1.0,1,1.0,1,1.0,1,0.13832516362407343,65
4941,5,17900,3673,14227,0,0,0,1.0,1,1.0,1,1.0,1,0.15009889389704226,65
4942,7,17907,3675,14232,0,0,0,1.0,1,1.0,1,1.0,1,0.15455555972285137,67
4943,6,17913,3676,14237,0,0,0,1.0,1,1.0,1,1.0,1,0.16505095101919237,66
4944,5,17918,3678,14240,0,0,0,1.0,1,1.0,1,1.0,1,0.19850524803522204,63
4945,5,17923,3678,14245,0,0,0,1.0,1,1.0,1,1.0,1,0.17552093949644373,61
4946,4,17927,3679,14248,0,0,0,1.0,1,1.0,1,1.0,1,0.17590208294214296,60
4947,2,17929,3679,14250,0,0,0,1.0,1,1.0,1,1.0,1,0.1661782259794349,58
4948,7,17936,3681,14255,0,0,0,1.0,1,1.0,1,1.0,1,0.17821777924523405,57
4949,5,17941,3684,14257,0,0,0,1.0,1,1.0,1,1.0,1,0.18942884953240777,56
4950,5,17946,3685,14261,0,0,0,1.0,1,1.0,1,1.0,1,0.21212722830078234,57
4951,9,17955,3686,14269,0,0,0,1.0,1,1.0,1,1.0,1,0.06447256911470718,55
4952,4,17959,3688,14271,0,0,0,1.0,1,1.0,1,1.0,1,0.09586638702264462,55
4953,1,17960,3689,14271,0,0,0,1.0,1,1.0,1,1.0,1,0.09717794250393116,54
4954,1,17961,3690,14271,0,0,0,1.0,1,1.0,1,1.0,1,0.11732107028844725,54
4955,3,17964,3690,14274,0,0,0,1.0,1,1.0,1,1.0,1,0.1271363315112503,52
4956,0,17964,3690,14274,0,0,0,1.0,1,1.0,1,1.0,1,0.1271363315112503,52
4957,1,17965,3691,14274,0,0,0,1.0,1,1.0,1,1.0,1,0.11757490742086651,53
4958,2,17967,3692,14275,0,0,0,1.0,1,1.0,1,1.0,1,0.13588285443727283,52
4959,1,17968,3693,14275,0,0,0,1.0,1,1.0,1,1.0,1,0.14943059315510468,51
4960,0,17968,3693,14275,0,0,0,1.0,1,1.0,1,1.0,1,0.14085889886100214,53
4961,0,17968,3693,14275,0,0,0,1.0,1,1.0,1,1.0,1,0.14085889886100214,53
4962,1,17969,3693,14276,0,0,0,1.0,1,1.0,1,1.0,1,0.14830924134429468,55
4963,2,17971,3693,14278,0,0,0,1.0,1,1.0,1,1.0,1,0.13385674260857547,54
4964,3,17974,3694,14280,0,0,0,1.0,1,1.0,1,1.0,1,0.1577168290568904,54
4965,6,17980,3696,14284,0,0,0,1.0,1,1.0,1,1.0,1,0.17366998523391655,54
4966,12,17992,3698,14294,0,0,0,1.0,1,1.0,1,1.0,1,0.08716852725635768,54
4967,9,18001,3701,14300,0,0,0,1.0,1,1.0,1,1.0,1,0.1089539816893056,55
4968,5,18006,3701,14305,0,0,0,1.0,1,1.0,1,1.0,1,0.10083342621461867,55
4969,6,18012,3702,14310,0,0,0,1.0,1,1.0,1,1.0,1,0.16253199803214244,57
4970,4,18016,3702,14314,0,0,0,1.0,1,1.0,1,1.0,1,0.1707351990464929,56
4971,6,18022,3702,14320,0,0,0,1.0,1,1.0,1,1.0,1,0.16946669184108118,57
4972,3,18025,3702,14323,0,0,0,1.0,1,1.0,1,1.0,1,0.17978896597272245,57
4973,10,18035,3702,14333,0,0,0,1.0,1,1.0,1,1.0,1,0.1673333997776128,60
4974,5,18040,3702,14338,0,0,0,1.0,1,1.0,1,1.0,1,0.19486451387124185,58
4975,10,18050,3703,14347,0,0,0,1.0,1,1.0,1,1.0,1,0.1827179640892636,59
4976,5,18055,3703,14352,0,0,0,1.0,1,1.0,1,1.0,1,0.1695707919480431,59
4977,8,18063,3704,14359,0,0,0,1.0,1,1.0,1,1.0,1,0.18402992156698936,59
4978,6,18069,3704,14365,0,0,0,1.0,1,1.0,1,1.0,1,0.16255438987022108,59
4979,7,18076,3704,14372,0,0,0,1.0,1,1.0,1,1.0,1,0.16560787612587385,61
4980,13,18089,3704,14385,0,0,0,1.0,1,1.0,1,1.0,1,0.2204269036272875,62
4981,9,18098,3704,14394,0,0,0,1.0,1,1.0,1,1.0,1,0.10547790290954358,62
4982,2,18100,3704,14396,0,0,0,1.0,1,1.0,1,1.0,1,0.11428052325633384,63
4983,3,18103,3704,14399,0,0,0,1.0,1,1.0,1,1.0,1,0.11858652255145562,63
4984,5,18108,3706,14402,0,0,0,1.0,1,1.0,1,1.0,1,0.07894163235122789,61
4985,0,18108,3706,14402,0,0,0,1.0,1,1.0,1,1.0,1,0.08837292719747906,59
4986,5,18113,3708,14405,0,0,0,1.0,1,1.0,1,1.0,1,0.08566538721073168,62
4987,2,18115,3709,14406,0,0,0,1.0,1,1.0,1,1.0,1,0.08720539830525689,60
4988,2,18117,3710,14407,0,0,0,1.0,1,1.0,1,1.0,1,0.10191222376227403,59
4989,2,18119,3711,14408,0,0,0,1.0,1,1.0,1,1.0,1,0.07585996951703813,57
4990,0,18119,3711,14408,0,0,0,1.0,1,1.0,1,1.0,1,0.13161857508213792,55
4991,4,18123,3714,14409,0,0,0,1.0,1,1.0,1,1.0,1,0.147456451989619,54
4992,3,18126,3714,14412,0,0,0,1.0,1,1.0,1,1.0,1,0.15164733880600173,52
4993,2,18128,3715,14413,0,0,0,1.0,1,1.0,1,1.0,1,0.1676249184013423,51
4994,4,18132,3716,14416,0,0,0,1.0,1,1.0,1,1.0,1,0.18654188908755776,49
4995,3,18135,3717,14418,0,0,0,1.0,1,1.0,1,1.0,1,0.2160843061604311,48
4996,6,18141,3719,14422,0,0,0,1.0,1,1.0,1,1.0,1,0.15729813441408244,48
4997,3,18144,3721,14423,0,0,0,1.0,1,1.0,1,1.0,1,0.14456511170971847,46
4998,5,18149,3722,14427,0,0,0,1.0,1,1.0,1,1.0,1,0.11141180818981719,48
4999,5,18154,3725,14429,0,0,0,1.0,1,1.0,1,1.0,1,0.16806113805891768,48
5000,3,18157,3726,14431,0,0,0,1.0,1,1.0,1,1.0,1,0.14757564843204082,47
5001,2,18159,3726,14433,0,0,0,1.0,1,1.0,1,1.0,1,0.1489422710373264,45
5002,4,18163,3728,14435,0,0,0,1.0,1,1.0,1,1.0,1,0.14482751709507624,46
5003,4,18167,3728,14439,0,0,0,1.0,1,1.0,1,1.0,1,0.17667191609365088,46
5004,3,18170,3729,14441,0,0,0,1.0,1,1.0,1,1.0,1,0.16969758695358636,46
5005,2,18172,3729,14443,0,0,0,1.0,1,1.0,1,1.0,1,0.19455255421916096,45
5006,1,18173,3729,14444,0,0,0,1.0,1,1.0,1,1.0,1,0.2106787020120029,45
5007,2,18175,3729,14446,0,0,0,1.0,1,1.0,1,1.0,1,0.23158875576026774,46
5008,3,18178,3729,14449,0,0,0,1.0,1,1.0,1,1.0,1,0.2142144950583453,49
5009,3,18181,3729,14452,0,0,0,1.0,1,1.0,1,1.0,1,0.2348032619239989,49
5010,9,18190,3729,14461,0,0,0,1.0,1,1.0,1,1.0,1,0.26090905014480287,50
5011,5,18195,3729,14466,0,0,0,1.0,1,1.0,1,1.0,1,0.19687211360924736,51
5012,3,18198,3729,14469,0,0,0,1.0,1,1.0,1,1.0,1,0.18013024163335148,52
5013,2,18200,3729,14471,0,0,0,1.0,1,1.0,1,1.0,1,0.16123882781386256,52
5014,0,18200,3729,14471,0,0,0,1.0,1,1.0,1,1.0,1,0.16173085257338923,53
5015,3,18203,3730,14473,0,0,0,1.0,1,1.0,1,1.0,1,0.1931593188664409,54
5016,4,18207,3730,14477,0,0,0,1.0,1,1.0,1,1.0,1,0.1524529651344921,55
5017,2,18209,3730,14479,0,0,0,1.0,1,1.0,1,1.0,1,0.15437366109396655,55
5018,2,18211,3730,14481,0,0,0,1.0,1,1.0,1,1.0,1,0.16649640317891182,56
5019,5,18216,3730,14486,0,0,0,1.0,1,1.0,1,1.0,1,0.1446920186653505,56
5020,3,18219,3730,14489,0,0,0,1.0,1,1.0,1,1.0,1,0.14055096447694365,55
5021,1,18220,3730,14490,0,0,0,1.0,1,1.0,1,1.0,1,0.12466597730754304,56
5022,3,18223,3732,14491,0,0,0,1.0,1,1.0,1,1.0,1,0.15267592993013157,56
5023,2,18225,3732,14493,0,0,0,1.0,1,1.0,1,1.0,1,0.1388312131757642,55
5024,7,18232,3736,14496,0,0,0,1.0,1,1.0,1,1.0,1,0.13141543931471575,55
5025,2,18234,3738,14496,0,0,0,1.0,1,1.0,1,1.0,1,0.19477059307441044,53
5026,6,18240,3739,14501,0,0,0,1.0,1,1.0,1,1.0,1,0.1219431520676635,52
5027,5,18245,3741,14504,0,0,0,1.0,1,1.0,1,1.0,1,0.12903189298569326,51
5028,5,18250,3744,14506,0,0,0,1.0,1,1.0,1,1.0,1,0.18673213419596724,51
5029,4,18254,3746,14508,0,0,0,1.0,1,1.0,1,1.0,1,0.19387936973738,50
5030,2,18256,3747,14509,0,0,0,1.0,1,1.0,1,1.0,1,0.15863250857410074,49
5031,2,18258,3748,14510,0,0,0,1.0,1,1.0,1,1.0,1,0.14635624320730345,49
5032,0,18258,3748,14510,0,0,0,1.0,1,1.0,1,1.0,1,0.14258386691486544,48
5033,3,18261,3749,14512,0,0,0,1.0,1,1.0,1,1.0,1,0.15525607172370293,50
5034,4,18265,3751,14514,0,0,0,1.0,1,1.0,1,1.0,1,0.1835419065248698,49
5035,6,18271,3752,14519,0,0,0,1.0,1,1.0,1,1.0,1,0.17296725949285088,49
5036,3,18274,3753,14521,0,0,0,1.0,1,1.0,1,1.0,1,0.16077001763322274,47
5037,2,18276,3754,14522,0,0,0,1.0,1,1.0,1,1.0,1,0.17173420876428266,47
5038,2,18278,3754,14524,0,0,0,1.0,1,1.0,1,1.0,1,0.15674148147421463,47
5039,3,18281,3754,14527,0,0,0,1.0,1,1.0,1,1.0,1,0.1492911882743429,48
5040,1,18282,3754,14528,0,0,0,1.0,1,1.0,1,1.0,1,0.14586856458012173,48
5041,1,18283,3754,14529,0,0,0,1.0,1,1.0,1,1.0,1,0.13059434949814733,48
5042,1,18284,3754,14530,0,0,0,1.0,1,1.0,1,1.0,1,0.11148848403328689,50
5043,0,18284,3754,14530,0,0,0,1.0,1,1.0,1,1.0,1,0.11811651856147638,51
5044,0,18284,3754,14530,0,0,0,1.0,1,1.0,1,1.0,1,0.11811651856147638,51
5045,0,18284,3754,14530,0,0,0,1.0,1,1.0,1,1.0,1,0.12860279164889346,52
5046,3,18287,3755,14532,0,0,0,1.0,1,1.0,1,1.0,1,0.1267698135387002,51
5047,1,18288,3755,14533,0,0,0,1.0,1,1.0,1,1.0,1,0.10942195049404033,51
5048,1,18289,3755,14534,0,0,0,1.0,1,1.0,1,1.0,1,0.09382920702069794,52
5049,2,18291,3756,14535,0,0,0,1.0,1,1.0,1,1.0,1,0.10609800470808094,54
5050,5,18296,3756,14540,0,0,0,1.0,1,1.0,1,1.0,1,0.0837384620354822,56
5051,0,18296,3756,14540,0,0,0,1.0,1,1.0,1,1.0,1,0.09755456296931146,55
5052,0,18296,3756,14540,0,0,0,1.0,1,1.0,1,1.0,1,0.09755456296931146,55
5053,1,18297,3757,14540,0,0,0,1.0,1,1.0,1,1.0,1,0.11952150338422382,55
5054,1,18298,3758,14540,0,0,0,1.0,1,1.0,1,1.0,1,0.13859635431488251,55
5055,1,18299,3758,14541,0,0,0,1.0,1,1.0,1,1.0,1,0.16975708211721025,55
5056,6,18305,3758,14547,0,0,0,1.0,1,1.0,1,1.0,1,0.1152680060999051,56
5057,3,18308,3758,14550,0,0,0,1.0,1,1.0,1,1.0,1,0.0742700283888607,58
5058,3,18311,3758,14553,0,0,0,1.0,1,1.0,1,1.0,1,0.05965616077085885,59
5059,3,18314,3758,14556,0,0,0,1.0,1,1.0,1,1.0,1,0.0928364365840928,59
5060,1,18315,3758,14557,0,0,0,1.0,1,1.0,1,1.0,1,0.067874393281272,59
5061,3,18318,3758,14560,0,0,0,1.0,1,1.0,1,1.0,1,0.08322270162857447,59
5062,8,18326,3760,14566,0,0,0,1.0,1,1.0,1,1.0,1,0.10619916887665008,59
5063,5,18331,3761,14570,0,0,0,1.0,1,1.0,1,1.0,1,0.13072440624123366,59
5064,8,18339,3764,14575,0,0,0,1.0,1,1.0,1,1.0,1,0.1597892793880804,57
5065,4,18343,3765,14578,0,0,0,1.0,1,1.0,1,1.0,1,0.15835858879348821,55
5066,3,18346,3767,14579,0,0,0,1.0,1,1.0,1,1.0,1,0.18591945130722107,55
5067,6,18352,3770,14582,0,0,0,1.0,1,1.0,1,1.0,1,0.2180749824299594,54
5068,1,18353,3770,14583,0,0,0,1.0,1,1.0,1,1.0,1,0.20194784602262766,54
5069,3,18356,3772,14584,0,0,0,1.0,1,1.0,1,1.0,1,0.21809301957036198,54
5070,2,18358,3773,14585,0,0,0,1.0,1,1.0,1,1.0,1,0.20917019917617014,52
5071,6,18364,3774,14590,0,0,0,1.0,1,1.0,1,1.0,1,0.14416964095110033,54
5072,3,18367,3774,14593,0,0,0,1.0,1,1.0,1,1.0,1,0.12366035370631101,52
5073,2,18369,3774,14595,0,0,0,1.0,1,1.0,1,1.0,1,0.1373627427061709,51
5074,6,18375,3775,14600,0,0,0,1.0,1,1.0,1,1.0,1,0.17227260442927914,52
5075,6,18381,3775,14606,0,0,0,1.0,1,1.0,1,1.0,1,0.1379515311539819,53
5076,3,18384,3775,14609,0,0,0,1.0,1,1.0,1,1.0,1,0.13385034556718647,53
5077,2,18386,3775,14611,0,0,0,1.0,1,1.0,1,1.0,1,0.13663659290889282,56
5078,3,18389,3775,14614,0,0,0,1.0,1,1.0,1,1.0,1,0.14222078690644196,55
5079,3,18392,3775,14617,0,0,0,1.0,1,1.0,1,1.0,1,0.1399081328636672,56
5080,6,18398,3775,14623,0,0,0,1.0,1,1.0,1,1.0,1,0.1491736891763054,57
5081,5,18403,3775,14628,0,0,0,1.0,1,1.0,1,1.0,1,0.13516067749658575,58
5082,6,18409,3775,14634,0,0,0,1.0,1,1.0,1,1.0,1,0.14835256613218975,58
5083,4,18413,3775,14638,0,0,0,1.0,1,1.0,1,1.0,1,0.1417713013923423,59
5084,7,18420,3775,14645,0,0,0,1.0,1,1.0,1,1.0,1,0.13110597818013345,59
5085,5,18425,3776,14649,0,0,0,1.0,1,1.0,1,1.0,1,0.1541167452658705,60
5086,8,18433,3776,14657,0,0,0,1.0,1,1.0,1,1.0,1,0.03833208366103719,61
5087,4,18437,3777,14660,0,0,0,1.0,1,1.0,1,1.0,1,0.04994525570495931,62
5088,3,18440,3777,14663,0,0,0,1.0,1,1.0,1,1.0,1,0.05738137290322614,64
5089,1,18441,3778,14663,0,0,0,1.0,1,1.0,1,1.0,1,0.07139768563574696,64
5090,1,18442,3778,14664,0,0,0,1.0,1,1.0,1,1.0,1,0.06539494661406574,64
5091,2,18444,3780,14664,0,0,0,1.0,1,1.0,1,1.0,1,0.08807465456555998,64
5092,2,18446,3782,14664,0,0,0,1.0,1,1.0,1,1.0,1,0.11892638883588048,64
5093,6,18452,3782,14670,0,0,0,1.0,1,1.0,1,1.0,1,0.1212463330795162,64
5094,12,18464,3785,14679,0,0,0,1.0,1,1.0,1,1.0,1,0.15375012764201262,65
5095,12,18476,3786,14690,0,0,0,1.0,1,1.0,1,1.0,1,0.157645161872768,66
5096,11,18487,3787,14700,0,0,0,1.0,1,1.0,1,1.0,1,0.19522326972786883,66
5097,11,18498,3789,14709,0,0,0,1.0,1,1.0,1,1.0,1,0.1921922001607624,67
5098,8,18506,3789,14717,0,0,0,1.0,1,1.0,1,1.0,1,0.18161646072295196,67
5099,8,18514,3789,14725,0,0,0,1.0,1,1.0,1,1.0,1,0.18862940027963826,70
5100,10,18524,3791,14733,0,0,0,1.0,1,1.0,1,1.0,1,0.16286843607277102,71
5101,9,18533,3791,14742,0,0,0,1.0,1,1.0,1,1.0,1,0.12253594781795392,72
5102,5,18538,3792,14746,0,0,0,1.0,1,1.0,1,1.0,1,0.09452930598701226,72
5103,2,18540,3792,14748,0,0,0,1.0,1,1.0,1,1.0,1,0.07651020046165508,70
5104,4,18544,3794,14750,0,0,0,1.0,1,1.0,1,1.0,1,0.06935302523925992,67
5105,4,18548,3796,14752,0,0,0,1.0,1,1.0,1,1.0,1,0.07196078477765869,66
5106,2,18550,3798,14752,0,0,0,1.0,1,1.0,1,1.0,1,0.09479998163439812,64
5107,1,18551,3799,14752,0,0,0,1.0,1,1.0,1,1.0,1,0.10363031956379525,61
5108,2,18553,3801,14752,0,0,0,1.0,1,1.0,1,1.0,1,0.1084615272665038,57
5109,5,18558,3804,14754,0,0,0,1.0,1,1.0,1,1.0,1,0.11234166152212303,55
5110,1,18559,3805,14754,0,0,0,1.0,1,1.0,1,1.0,1,0.1263822446668774,53
5111,3,18562,3808,14754,0,0,0,1.0,1,1.0,1,1.0,1,0.1917634185945826,52
5112,3,18565,3811,14754,0,0,0,1.0,1,1.0,1,1.0,1,0.1823550371865492,52
5113,3,18568,3813,14755,0,0,0,1.0,1,1.0,1,1.0,1,0.23732559712837123,49
5114,3,18571,3816,14755,0,0,0,1.0,1,1.0,1,1.0,1,0.2747636839926856,49
5115,3,18574,3816,14758,0,0,0,1.0,1,1.0,1,1.0,1,0.21585600580014452,48
5116,11,18585,3817,14768,0,0,0,1.0,1,1.0,1,1.0,1,0.1605192646988677,47
5117,1,18586,3817,14769,0,0,0,1.0,1,1.0,1,1.0,1,0.15060552191489104,48
5118,5,18591,3817,14774,0,0,0,1.0,1,1.0,1,1.0,1,0.17580588818841827,49
5119,8,18599,3819,14780,0,0,0,1.0,1,1.0,1,1.0,1,0.1920345632205807,49
5120,6,18605,3820,14785,0,0,0,1.0,1,1.0,1,1.0,1,0.189692392738232,48
5121,4,18609,3821,14788,0,0,0,1.0,1,1.0,1,1.0,1,0.18458272323759609,48
5122,2,18611,3821,14790,0,0,0,1.0,1,1.0,1,1.0,1,0.19396535523881095,46
5123,3,18614,3821,14793,0,0,0,1.0,1,1.0,1,1.0,1,0.20730900465226743,46
5124,4,18618,3821,14797,0,0,0,1.0,1,1.0,1,1.0,1,0.1881381093134095,47
5125,7,18625,3821,14804,0,0,0,1.0,1,1.0,1,1.0,1,0.1808924395140175,49
5126,4,18629,3821,14808,0,0,0,1.0,1,1.0,1,1.0,1,0.1808924395140175,49
5127,7,18636,3822,14814,0,0,0,1.0,1,1.0,1,1.0,1,0.19103508720093074,51
5128,7,18643,3824,14819,0,0,0,1.0,1,1.0,1,1.0,1,0.2153755248955342,53
5129,14,18657,3826,14831,0,0,0,1.0,1,1.0,1,1.0,1,0.2235617467739323,55
5130,9,18666,3827,14839,0,0,0,1.0,1,1.0,1,1.0,1,0.23150873749026404,55
5131,12,18678,3827,14851,0,0,0,1.0,1,1.0,1,1.0,1,0.08579353428243341,55
5132,1,18679,3827,14852,0,0,0,1.0,1,1.0,1,1.0,1,0.08818573972392961,55
5133,0,18679,3827,14852,0,0,0,1.0,1,1.0,1,1.0,1,0.09086218438411811,56
5134,1,18680,3827,14853,0,0,0,1.0,1,1.0,1,1.0,1,0.11635920801780603,56
5135,1,18681,3828,14853,0,0,0,1.0,1,1.0,1,1.0,1,0.11498883593970384,56
5136,1,18682,3828,14854,0,0,0,1.0,1,1.0,1,1.0,1,0.1553949381080398,55
5137,4,18686,3829,14857,0,0,0,1.0,1,1.0,1,1.0,1,0.14626136841941892,55
5138,3,18689,3829,14860,0,0,0,1.0,1,1.0,1,1.0,1,0.14108538543294197,54
5139,1,18690,3829,14861,0,0,0,1.0,1,1.0,1,1.0,1,0.14265826433622195,54
5140,5,18695,3830,14865,0,0,0,1.0,1,1.0,1,1.0,1,0.1349635288306664,54
5141,3,18698,3832,14866,0,0,0,1.0,1,1.0,1,1.0,1,0.17600000302153204,53
5142,11,18709,3835,14874,0,0,0,1.0,1,1.0,1,1.0,1,0.20514092195213904,55
5143,6,18715,3838,14877,0,0,0,1.0,1,1.0,1,1.0,1,0.18011764343900205,54
5144,5,18720,3840,14880,0,0,0,1.0,1,1.0,1,1.0,1,0.187770923478981,50
5145,4,18724,3840,14884,0,0,0,1.0,1,1.0,1,1.0,1,0.20766403920114407,51
5146,6,18730,3842,14888,0,0,0,1.0,1,1.0,1,1.0,1,0.11564345870979566,48
5147,4,18734,3843,14891,0,0,0,1.0,1,1.0,1,1.0,1,0.10829248997571574,49
5148,2,18736,3845,14891,0,0,0,1.0,1,1.0,1,1.0,1,0.10826430996438487,47
5149,5,18741,3847,14894,0,0,0,1.0,1,1.0,1,1.0,1,0.17045349962263984,46
5150,7,18748,3851,14897,0,0,0,1.0,1,1.0,1,1.0,1,0.2167414538750516,46
5151,4,18752,3851,14901,0,0,0,1.0,1,1.0,1,1.0,1,0.16937911777089906,45
5152,3,18755,3852,14903,0,0,0,1.0,1,1.0,1,1.0,1,0.1893567201736651,45
5153,4,18759,3852,14907,0,0,0,1.0,1,1.0,1,1.0,1,0.17068265582090777,45
5154,5,18764,3853,14911,0,0,0,1.0,1,1.0,1,1.0,1,0.19815922198213043,45
5155,0,18764,3853,14911,0,0,0,1.0,1,1.0,1,1.0,1,0.19878573294037677,44
5156,1,18765,3854,14911,0,0,0,1.0,1,1.0,1,1.0,1,0.21487842796120962,44
5157,0,18765,3854,14911,0,0,0,1.0,1,1.0,1,1.0,1,0.22530016867370495,42
5158,1,18766,3855,14911,0,0,0,1.0,1,1.0,1,1.0,1,0.24105029062417452,43
5159,3,18769,3855,14914,0,0,0,1.0,1,1.0,1,1.0,1,0.26389673724721413,43
5160,1,18770,3855,14915,0,0,0,1.0,1,1.0,1,1.0,1,0.25264964402649437,43
5161,5,18775,3855,14920,0,0,0,1.0,1,1.0,1,1.0,1,0.1680822767639276,43
5162,1,18776,3855,14921,0,0,0,1.0,1,1.0,1,1.0,1,0.1476586306123116,44
5163,3,18779,3855,14924,0,0,0,1.0,1,1.0,1,1.0,1,0.14004811886099797,46
5164,0,18779,3855,14924,0,0,0,1.0,1,1.0,1,1.0,1,0.14004811886099797,46
5165,1,18780,3855,14925,0,0,0,1.0,1,1.0,1,1.0,1,0.13523773873507242,46
5166,8,18788,3857,14931,0,0,0,1.0,1,1.0,1,1.0,1,0.1462933784006628,47
5167,3,18791,3858,14933,0,0,0,1.0,1,1.0,1,1.0,1,0.1559662678895122,47
5168,3,18794,3858,14936,0,0,0,1.0,1,1.0,1,1.0,1,0.13415049654385305,47
5169,3,18797,3858,14939,0,0,0,1.0,1,1.0,1,1.0,1,0.1922971656950849,47
5170,4,18801,3858,14943,0,0,0,1.0,1,1.0,1,1.0,1,0.18351110205150437,48
5171,5,18806,3859,14947,0,0,0,1.0,1,1.0,1,1.0,1,0.20542952614356738,48
5172,3,18809,3859,14950,0,0,0,1.0,1,1.0,1,1.0,1,0.20633458798286333,49
5173,6,18815,3859,14956,0,0,0,1.0,1,1.0,1,1.0,1,0.15326385394909864,49
5174,4,18819,3859,14960,0,0,0,1.0,1,1.0,1,1.0,1,0.23047111358505004,52
5175,7,18826,3859,14967,0,0,0,1.0,1,1.0,1,1.0,1,0.15111143695084092,53
5176,7,18833,3859,14974,0,0,0,1.0,1,1.0,1,1.0,1,0.08744668376448987,54
5177,8,18841,3862,14979,0,0,0,1.0,1,1.0,1,1.0,1,0.15694929154984982,54
5178,9,18850,3863,14987,0,0,0,1.0,1,1.0,1,1.0,1,0.19802686424589017,55
5179,10,18860,3864,14996,0,0,0,1.0,1,1.0,1,1.0,1,0.22718487687949784,53
5180,9,18869,3865,15004,0,0,0,1.0,1,1.0,1,1.0,1,0.238872780075275,52
5181,4,18873,3866,15007,0,0,0,1.0,1,1.0,1,1.0,1,0.2283230120322278,52
5182,6,18879,3867,15012,0,0,0,1.0,1,1.0,1,1.0,1,0.2041216004488262,52
5183,8,18887,3870,15017,0,0,0,1.0,1,1.0,1,1.0,1,0.22198899729979252,52
5184,4,18891,3870,15021,0,0,0,1.0,1,1.0,1,1.0,1,0.22878367625193466,52
5185,8,18899,3873,15026,0,0,0,1.0,1,1.0,1,1.0,1,0.24686632560318508,50
5186,3,18902,3873,15029,0,0,0,1.0,1,1.0,1,1.0,1,0.24671840484115493,48
5187,1,18903,3873,15030,0,0,0,1.0,1,1.0,1,1.0,1,0.23532779047165647,46
5188,0,18903,3873,15030,0,0,0,1.0,1,1.0,1,1.0,1,0.2665453938958048,44
5189,0,18903,3873,15030,0,0,0,1.0,1,1.0,1,1.0,1,0.2640869758920848,44
5190,7,18910,3874,15036,0,0,0,1.0,1,1.0,1,1.0,1,0.27363707108053287,45
5191,9,18919,3874,15045,0,0,0,1.0,1,1.0,1,1.0,1,0.17015547471532552,45
5192,4,18923,3874,15049,0,0,0,1.0,1,1.0,1,1.0,1,0.10624112493571457,45
5193,4,18927,3874,15053,0,0,0,1.0,1,1.0,1,1.0,1,0.16325069060063768,45
5194,2,18929,3874,15055,0,0,0,1.0,1,1.0,1,1.0,1,0.1724451465971564,45
5195,3,18932,3874,15058,0,0,0,1.0,1,1.0,1,1.0,1,0.17960770026442816,46
5196,2,18934,3874,15060,0,0,0,1.0,1,1.0,1,1.0,1,0.19042409622273393,46
5197,3,18937,3875,15062,0,0,0,1.0,1,1.0,1,1.0,1,0.17911238911706268,46
5198,7,18944,3875,15069,0,0,0,1.0,1,1.0,1,1.0,1,0.1920269463767627,47
5199,9,18953,3876,15077,0,0,0,1.0,1,1.0,1,1.0,1,0.2019685335634256,49
5200,9,18962,3877,15085,0,0,0,1.0,1,1.0,1,1.0,1,0.2318706734216346,49
5201,6,18968,3877,15091,0,0,0,1.0,1,1.0,1,1.0,1,0.22699867566554469,50
5202,12,18980,3877,15103,0,0,0,1.0,1,1.0,1,1.0,1,0.22676196102710974,52
5203,13,18993,3878,15115,0,0,0,1.0,1,1.0,1,1.0,1,0.22277042967675875,52
5204,12,19005,3878,15127,0,0,0,1.0,1,1.0,1,1.0,1,0.22185260385704306,54
5205,10,19015,3878,15137,0,0,0,1.0,1,1.0,1,1.0,1,0.18756880782153962,54
5206,6,19021,3878,15143,0,0,0,1.0,1,1.0,1,1.0,1,0.11309744595602936,55
5207,0,19021,3878,15143,0,0,0,1.0,1,1.0,1,1.0,1,0.10392364665894491,54
5208,0,19021,3878,15143,0,0,0,1.0,1,1.0,1,1.0,1,0.10392364665894491,54
5209,1,19022,3878,15144,0,0,0,1.0,1,1.0,1,1.0,1,0.09735672674205605,54
5210,3,19025,3878,15147,0,0,0,1.0,1,1.0,1,1.0,1,0.10537198141672222,54
5211,2,19027,3878,15149,0,0,0,1.0,1,1.0,1,1.0,1,0.1043205920024538,56
5212,4,19031,3878,15153,0,0,0,1.0,1,1.0,1,1.0,1,0.0952337681179395,57
5213,3,19034,3879,15155,0,0,0,1.0,1,1.0,1,1.0,1,0.11398248857462163,57
5214,6,19040,3881,15159,0,0,0,1.0,1,1.0,1,1.0,1,0.15132440653544643,58
5215,4,19044,3881,15163,0,0,0,1.0,1,1.0,1,1.0,1,0.14335025120345632,57
5216,7,19051,3883,15168,0,0,0,1.0,1,1.0,1,1.0,1,0.1654188108270677,57
5217,3,19054,3884,15170,0,0,0,1.0,1,1.0,1,1.0,1,0.14713971565564923,56
5218,7,19061,3887,15174,0,0,0,1.0,1,1.0,1,1.0,1,0.16477215693435546,56
5219,2,19063,3887,15176,0,0,0,1.0,1,1.0,1,1.0,1,0.16507224729088563,54
5220,5,19068,3887,15181,0,0,0,1.0,1,1.0,1,1.0,1,0.18933075153357953,53
5221,3,19071,3887,15184,0,0,0,1.0,1,1.0,1,1.0,1,0.13734928436784108,52
5222,1,19072,3888,15184,0,0,0,1.0,1,1.0,1,1.0,1,0.13574792704353383,52
5223,3,19075,3890,15185,0,0,0,1.0,1,1.0,1,1.0,1,0.1201367636150771,52
5224,3,19078,3893,15185,0,0,0,1.0,1,1.0,1,1.0,1,0.1397525586908376,52
5225,0,19078,3893,15185,0,0,0,1.0,1,1.0,1,1.0,1,0.15307342074532515,50
5226,3,19081,3896,15185,0,0,0,1.0,1,1.0,1,1.0,1,0.1735511638285377,51
5227,3,19084,3899,15185,0,0,0,1.0,1,1.0,1,1.0,1,0.22711637144169636,49
5228,1,19085,3899,15186,0,0,0,1.0,1,1.0,1,1.0,1,0.2501818562545251,48
5229,1,19086,3900,15186,0,0,0,1.0,1,1.0,1,1.0,1,0.2136002997996022,49
5230,2,19088,3901,15187,0,0,0,1.0,1,1.0,1,1.0,1,0.2515196664082277,49
5231,3,19091,3902,15189,0,0,0,1.0,1,1.0,1,1.0,1,0.2171872141419471,49
5232,5,19096,3904,15192,0,0,0,1.0,1,1.0,1,1.0,1,0.1736771080476133,51
5233,1,19097,3904,15193,0,0,0,1.0,1,1.0,1,1.0,1,0.1948562183794306,51
5234,5,19102,3906,15196,0,0,0,1.0,1,1.0,1,1.0,1,0.16511410035202795,52
5235,0,19102,3906,15196,0,0,0,1.0,1,1.0,1,1.0,1,0.1695363184209518,52
5236,6,19108,3907,15201,0,0,0,1.0,1,1.0,1,1.0,1,0.10173762939285,52
5237,4,19112,3907,15205,0,0,0,1.0,1,1.0,1,1.0,1,0.12467995213074072,53
5238,2,19114,3907,15207,0,0,0,1.0,1,1.0,1,1.0,1,0.10415286874549462,53
5239,1,19115,3907,15208,0,0,0,1.0,1,1.0,1,1.0,1,0.12061648258383986,53
5240,2,19117,3908,15209,0,0,0,1.0,1,1.0,1,1.0,1,0.12264003427962665,55
5241,1,19118,3908,15210,0,0,0,1.0,1,1.0,1,1.0,1,0.11785503862573733,56
5242,2,19120,3908,15212,0,0,0,1.0,1,1.0,1,1.0,1,0.10899087700373337,54
5243,7,19127,3909,15218,0,0,0,1.0,1,1.0,1,1.0,1,0.13665220407378295,55
5244,9,19136,3911,15225,0,0,0,1.0,1,1.0,1,1.0,1,0.1929640021213862,55
5245,10,19146,3912,15234,0,0,0,1.0,1,1.0,1,1.0,1,0.2039850684785916,55
5246,12,19158,3914,15244,0,0,0,1.0,1,1.0,1,1.0,1,0.2239559649918528,55
5247,9,19167,3916,15251,0,0,0,1.0,1,1.0,1,1.0,1,0.24292613355499657,54
5248,6,19173,3918,15255,0,0,0,1.0,1,1.0,1,1.0,1,0.1894650172185651,53
5249,13,19186,3921,15265,0,0,0,1.0,1,1.0,1,1.0,1,0.22517477757559798,55
5250,8,19194,3921,15273,0,0,0,1.0,1,1.0,1,1.0,1,0.2225537510358859,55
5251,11,19205,3921,15284,0,0,0,1.0,1,1.0,1,1.0,1,0.14250167503308958,57
5252,6,19211,3922,15289,0,0,0,1.0,1,1.0,1,1.0,1,0.1436373735985154,58
5253,6,19217,3923,15294,0,0,0,1.0,1,1.0,1,1.0,1,0.1352936310413669,59
5254,7,19224,3923,15301,0,0,0,1.0,1,1.0,1,1.0,1,0.1288111094214546,59
5255,7,19231,3923,15308,0,0,0,1.0,1,1.0,1,1.0,1,0.1781049281504642,58
5256,6,19237,3925,15312,0,0,0,1.0,1,1.0,1,1.0,1,0.1623444647542759,59
5257,4,19241,3926,15315,0,0,0,1.0,1,1.0,1,1.0,1,0.16794068734999962,58
5258,2,19243,3926,15317,0,0,0,1.0,1,1.0,1,1.0,1,0.17518735158461726,56
5259,2,19245,3926,15319,0,0,0,1.0,1,1.0,1,1.0,1,0.1840479544909001,56
5260,2,19247,3926,15321,0,0,0,1.0,1,1.0,1,1.0,1,0.19125390517187288,55
5261,5,19252,3927,15325,0,0,0,1.0,1,1.0,1,1.0,1,0.1618248335726357,54
5262,2,19254,3928,15326,0,0,0,1.0,1,1.0,1,1.0,1,0.16473855796434647,54
5263,4,19258,3930,15328,0,0,0,1.0,1,1.0,1,1.0,1,0.16049844644058195,53
5264,3,19261,3931,15330,0,0,0,1.0,1,1.0,1,1.0,1,0.14596297237944436,51
5265,3,19264,3931,15333,0,0,0,1.0,1,1.0,1,1.0,1,0.09647099648390357,50
5266,4,19268,3934,15334,0,0,0,1.0,1,1.0,1,1.0,1,0.1268559970331009,49
5267,2,19270,3936,15334,0,0,0,1.0,1,1.0,1,1.0,1,0.16049681828450127,48
5268,2,19272,3937,15335,0,0,0,1.0,1,1.0,1,1.0,1,0.1475658648626391,47
5269,0,19272,3937,15335,0,0,0,1.0,1,1.0,1,1.0,1,0.15364140353475786,45
5270,2,19274,3937,15337,0,0,0,1.0,1,1.0,1,1.0,1,0.13642870458448514,47
5271,1,19275,3938,15337,0,0,0,1.0,1,1.0,1,1.0,1,0.1397924826112668,45
5272,6,19281,3942,15339,0,0,0,1.0,1,1.0,1,1.0,1,0.2199046064352263,46
5273,2,19283,3942,15341,0,0,0,1.0,1,1.0,1,1.0,1,0.2697658698396992,44
5274,5,19288,3942,15346,0,0,0,1.0,1,1.0,1,1.0,1,0.2911164751126982,44
5275,5,19293,3944,15349,0,0,0,1.0,1,1.0,1,1.0,1,0.3068757751888403,46
5276,8,19301,3946,15355,0,0,0,1.0,1,1.0,1,1.0,1,0.2661247545609091,46
5277,3,19304,3948,15356,0,0,0,1.0,1,1.0,1,1.0,1,0.26026027818413705,46
5278,3,19307,3949,15358,0,0,0,1.0,1,1.0,1,1.0,1,0.26405214218325007,46
5279,6,19313,3950,15363,0,0,0,1.0,1,1.0,1,1.0,1,0.2803227662508647,47
5280,6,19319,3951,15368,0,0,0,1.0,1,1.0,1,1.0,1,0.2418538402538627,47
5281,7,19326,3951,15375,0,0,0,1.0,1,1.0,1,1.0,1,0.14283934321264144,48
5282,1,19327,3952,15375,0,0,0,1.0,1,1.0,1,1.0,1,0.17425100497754883,48
5283,1,19328,3953,15375,0,0,0,1.0,1,1.0,1,1.0,1,0.19333742818230604,49
5284,2,19330,3953,15377,0,0,0,1.0,1,1.0,1,1.0,1,0.17240431539447262,49
5285,4,19334,3953,15381,0,0,0,1.0,1,1.0,1,1.0,1,0.16351077485650142,50
5286,3,19337,3953,15384,0,0,0,1.0,1,1.0,1,1.0,1,0.157648587687076,51
5287,2,19339,3953,15386,0,0,0,1.0,1,1.0,1,1.0,1,0.157648587687076,51
5288,4,19343,3953,15390,0,0,0,1.0,1,1.0,1,1.0,1,0.1396115519430096,51
5289,2,19345,3953,15392,0,0,0,1.0,1,1.0,1,1.0,1,0.1604687300648957,53
5290,5,19350,3953,15397,0,0,0,1.0,1,1.0,1,1.0,1,0.14137738811863423,53
5291,4,19354,3953,15401,0,0,0,1.0,1,1.0,1,1.0,1,0.14137738811863423,53
5292,4,19358,3954,15404,0,0,0,1.0,1,1.0,1,1.0,1,0.14849072508280464,53
5293,6,19364,3955,15409,0,0,0,1.0,1,1.0,1,1.0,1,0.12225231347604089,53
5294,3,19367,3955,15412,0,0,0,1.0,1,1.0,1,1.0,1,0.15818742322815446,54
5295,3,19370,3955,15415,0,0,0,1.0,1,1.0,1,1.0,1,0.1152980685668461,52
5296,2,19372,3955,15417,0,0,0,1.0,1,1.0,1,1.0,1,0.07040222867025843,49
5297,3,19375,3957,15418,0,0,0,1.0,1,1.0,1,1.0,1,0.15792177292983833,49
5298,2,19377,3957,15420,0,0,0,1.0,1,1.0,1,1.0,1,0.12251805485808341,49
5299,1,19378,3958,15420,0,0,0,1.0,1,1.0,1,1.0,1,0.13009523347664861,50
5300,0,19378,3958,15420,0,0,0,1.0,1,1.0,1,1.0,1,0.13583808502228925,48
5301,1,19379,3959,15420,0,0,0,1.0,1,1.0,1,1.0,1,0.16077711389184668,46
5302,2,19381,3960,15421,0,0,0,1.0,1,1.0,1,1.0,1,0.15697453325841249,47
5303,2,19383,3962,15421,0,0,0,1.0,1,1.0,1,1.0,1,0.1535470547231265,46
5304,1,19384,3963,15421,0,0,0,1.0,1,1.0,1,1.0,1,0.17516468795665235,45
5305,0,19384,3963,15421,0,0,0,1.0,1,1.0,1,1.0,1,0.1645774050030761,44
5306,4,19388,3966,15422,0,0,0,1.0,1,1.0,1,1.0,1,0.2390449947452151,42
5307,5,19393,3968,15425,0,0,0,1.0,1,1.0,1,1.0,1,0.23770830070437166,42
5308,6,19399,3970,15429,0,0,0,1.0,1,1.0,1,1.0,1,0.2113225470381213,43
5309,2,19401,3971,15430,0,0,0,1.0,1,1.0,1,1.0,1,0.20691912722008987,41
5310,1,19402,3972,15430,0,0,0,1.0,1,1.0,1,1.0,1,0.24730838315263606,41
5311,4,19406,3973,15433,0,0,0,1.0,1,1.0,1,1.0,1,0.20118898362487228,42
5312,2,19408,3973,15435,0,0,0,1.0,1,1.0,1,1.0,1,0.17564035117976046,43
5313,4,19412,3973,15439,0,0,0,1.0,1,1.0,1,1.0,1,0.1461589673136125,44
5314,2,19414,3973,15441,0,0,0,1.0,1,1.0,1,1.0,1,0.15818890846633182,44
5315,2,19416,3975,15441,0,0,0,1.0,1,1.0,1,1.0,1,0.16530594976491875,45
5316,5,19421,3975,15446,0,0,0,1.0,1,1.0,1,1.0,1,0.10025182761386421,46
5317,4,19425,3975,15450,0,0,0,1.0,1,1.0,1,1.0,1,0.12710824192038717,46
5318,2,19427,3975,15452,0,0,0,1.0,1,1.0,1,1.0,1,0.1009101356699534,46
5319,8,19435,3976,15459,0,0,0,1.0,1,1.0,1,1.0,1,0.16317618971854086,47
5320,5,19440,3976,15464,0,0,0,1.0,1,1.0,1,1.0,1,0.1420346230754313,48
5321,7,19447,3977,15470,0,0,0,1.0,1,1.0,1,1.0,1,0.19597447265219037,49
5322,4,19451,3977,15474,0,0,0,1.0,1,1.0,1,1.0,1,0.19811520649625888,49
5323,9,19460,3977,15483,0,0,0,1.0,1,1.0,1,1.0,1,0.21199598746687234,51
5324,3,19463,3977,15486,0,0,0,1.0,1,1.0,1,1.0,1,0.20493857725253725,53
5325,7,19470,3978,15492,0,0,0,1.0,1,1.0,1,1.0,1,0.21387448518892527,53
5326,7,19477,3978,15499,0,0,0,1.0,1,1.0,1,1.0,1,0.1686839501103673,53
5327,4,19481,3978,15503,0,0,0,1.0,1,1.0,1,1.0,1,0.161327313055795,53
5328,3,19484,3979,15505,0,0,0,1.0,1,1.0,1,1.0,1,0.11863641202735158,54
5329,2,19486,3980,15506,0,0,0,1.0,1,1.0,1,1.0,1,0.16255666330359891,53
5330,2,19488,3982,15506,0,0,0,1.0,1,1.0,1,1.0,1,0.2037472038137434,52
5331,2,19490,3982,15508,0,0,0,1.0,1,1.0,1,1.0,1,0.18166785815180073,51
5332,1,19491,3982,15509,0,0,0,1.0,1,1.0,1,1.0,1,0.17727438124525366,52
5333,3,19494,3983,15511,0,0,0,1.0,1,1.0,1,1.0,1,0.21951382558314017,53
5334,5,19499,3984,15515,0,0,0,1.0,1,1.0,1,1.0,1,0.17453340687650698,54
5335,5,19504,3984,15520,0,0,0,1.0,1,1.0,1,1.0,1,0.12298531857824746,55
5336,3,19507,3984,15523,0,0,0,1.0,1,1.0,1,1.0,1,0.1487716200140654,54
5337,2,19509,3984,15525,0,0,0,1.0,1,1.0,1,1.0,1,0.15492926431327017,55
5338,2,19511,3984,15527,0,0,0,1.0,1,1.0,1,1.0,1,0.15492926431327017,55
5339,1,19512,3984,15528,0,0,0,1.0,1,1.0,1,1.0,1,0.15186103613012403,55
5340,1,19513,3984,15529,0,0,0,1.0,1,1.0,1,1.0,1,0.15492926431327017,55
5341,4,19517,3984,15533,0,0,0,1.0,1,1.0,1,1.0,1,0.14518243337839218,54
5342,3,19520,3987,15533,0,0,0,1.0,1,1.0,1,1.0,1,0.18709896932061656,55
5343,4,19524,3988,15536,0,0,0,1.0,1,1.0,1,1.0,1,0.15226717354705377,54
5344,2,19526,3990,15536,0,0,0,1.0,1,1.0,1,1.0,1,0.1842432614552423,55
5345,3,19529,3991,15538,0,0,0,1.0,1,1.0,1,1.0,1,0.1383461231708504,53
5346,3,19532,3993,15539,0,0,0,1.0,1,1.0,1,1.0,1,0.1482627845830259,53
5347,2,19534,3994,15540,0,0,0,1.0,1,1.0,1,1.0,1,0.151450701665854,51
5348,1,19535,3994,15541,0,0,0,1.0,1,1.0,1,1.0,1,0.1201410153971921,53
5349,2,19537,3995,15542,0,0,0,1.0,1,1.0,1,1.0,1,0.0995350567900798,52
5350,1,19538,3996,15542,0,0,0,1.0,1,1.0,1,1.0,1,0.13166822265322148,50
5351,2,19540,3998,15542,0,0,0,1.0,1,1.0,1,1.0,1,0.17308629314821158,52
5352,3,19543,4000,15543,0,0,0,1.0,1,1.0,1,1.0,1,0.15079038151966057,49
5353,1,19544,4000,15544,0,0,0,1.0,1,1.0,1,1.0,1,0.14940038973282074,49
5354,1,19545,4000,15545,0,0,0,1.0,1,1.0,1,1.0,1,0.12364400022207579,49
5355,3,19548,4000,15548,0,0,0,1.0,1,1.0,1,1.0,1,0.1480018470073292,48
5356,3,19551,4002,15549,0,0,0,1.0,1,1.0,1,1.0,1,0.1342536642475136,49
5357,4,19555,4002,15553,0,0,0,1.0,1,1.0,1,1.0,1,0.08308914143751125,47
5358,1,19556,4003,15553,0,0,0,1.0,1,1.0,1,1.0,1,0.09481322244334935,48
5359,0,19556,4003,15553,0,0,0,1.0,1,1.0,1,1.0,1,0.09481322244334935,48
5360,1,19557,4004,15553,0,0,0,1.0,1,1.0,1,1.0,1,0.07729375437872851,48
5361,3,19560,4005,15555,0,0,0,1.0,1,1.0,1,1.0,1,0.1231552397647827,50
5362,1,19561,4005,15556,0,0,0,1.0,1,1.0,1,1.0,1,0.10779523780123308,50
5363,1,19562,4005,15557,0,0,0,1.0,1,1.0,1,1.0,1,0.12529322207866836,50
5364,3,19565,4007,15558,0,0,0,1.0,1,1.0,1,1.0,1,0.16815057895193725,51
5365,9,19574,4008,15566,0,0,0,1.0,1,1.0,1,1.0,1,0.20194773853834064,52
5366,6,19580,4008,15572,0,0,0,1.0,1,1.0,1,1.0,1,0.20116405913403382,52
5367,9,19589,4009,15580,0,0,0,1.0,1,1.0,1,1.0,1,0.21381089667298428,54
5368,12,19601,4009,15592,0,0,0,1.0,1,1.0,1,1.0,1,0.22727749005962594,55
5369,6,19607,4011,15596,0,0,0,1.0,1,1.0,1,1.0,1,0.20285553963222913,53
5370,8,19615,4012,15603,0,0,0,1.0,1,1.0,1,1.0,1,0.24333667801933248,54
5371,7,19622,4013,15609,0,0,0,1.0,1,1.0,1,1.0,1,0.18136588101656223,53
5372,4,19626,4014,15612,0,0,0,1.0,1,1.0,1,1.0,1,0.14845795641447254,53
5373,2,19628,4014,15614,0,0,0,1.0,1,1.0,1,1.0,1,0.15753131818565494,52
5374,5,19633,4017,15616,0,0,0,1.0,1,1.0,1,1.0,1,0.16413177241851531,51
5375,2,19635,4017,15618,0,0,0,1.0,1,1.0,1,1.0,1,0.1346249121891027,52
5376,8,19643,4019,15624,0,0,0,1.0,1,1.0,1,1.0,1,0.20392205573566813,51
5377,5,19648,4020,15628,0,0,0,1.0,1,1.0,1,1.0,1,0.20742939425412082,52
5378,3,19651,4020,15631,0,0,0,1.0,1,1.0,1,1.0,1,0.2368289291060737,50
5379,5,19656,4020,15636,0,0,0,1.0,1,1.0,1,1.0,1,0.22774397139511962,50
5380,7,19663,4020,15643,0,0,0,1.0,1,1.0,1,1.0,1,0.22664933837651935,52
5381,5,19668,4020,15648,0,0,0,1.0,1,1.0,1,1.0,1,0.20343870953373103,52
5382,6,19674,4020,15654,0,0,0,1.0,1,1.0,1,1.0,1,0.19568217370561397,52
5383,5,19679,4020,15659,0,0,0,1.0,1,1.0,1,1.0,1,0.19784171317331736,51
5384,5,19684,4020,15664,0,0,0,1.0,1,1.0,1,1.0,1,0.17253515175603126,52
5385,5,19689,4021,15668,0,0,0,1.0,1,1.0,1,1.0,1,0.19755640706243902,51
5386,11,19700,4022,15678,0,0,0,1.0,1,1.0,1,1.0,1,0.1556124033128238,52
5387,11,19711,4022,15689,0,0,0,1.0,1,1.0,1,1.0,1,0.13670111124541276,53
5388,4,19715,4022,15693,0,0,0,1.0,1,1.0,1,1.0,1,0.10572341776734522,54
5389,9,19724,4023,15701,0,0,0,1.0,1,1.0,1,1.0,1,0.1308398482463443,55
5390,10,19734,4026,15708,0,0,0,1.0,1,1.0,1,1.0,1,0.2334403006744801,56
5391,5,19739,4026,15713,0,0,0,1.0,1,1.0,1,1.0,1,0.2012769442459753,56
5392,7,19746,4026,15720,0,0,0,1.0,1,1.0,1,1.0,1,0.16761531561609572,56
5393,9,19755,4026,15729,0,0,0,1.0,1,1.0,1,1.0,1,0.19864051303971036,54
5394,4,19759,4026,15733,0,0,0,1.0,1,1.0,1,1.0,1,0.17918902089785538,53
5395,4,19763,4027,15736,0,0,0,1.0,1,1.0,1,1.0,1,0.1561074651249587,53
5396,7,19770,4028,15742,0,0,0,1.0,1,1.0,1,1.0,1,0.19130681148136486,54
5397,6,19776,4028,15748,0,0,0,1.0,1,1.0,1,1.0,1,0.1850952927731364,53
5398,5,19781,4028,15753,0,0,0,1.0,1,1.0,1,1.0,1,0.14788358824686665,53
5399,14,19795,4030,15765,0,0,0,1.0,1,1.0,1,1.0,1,0.17771507665311612,55
5400,11,19806,4031,15775,0,0,0,1.0,1,1.0,1,1.0,1,0.21842224493246232,55
5401,14,19820,4032,15788,0,0,0,1.0,1,1.0,1,1.0,1,0.060208548377129724,56
5402,0,19820,4032,15788,0,0,0,1.0,1,1.0,1,1.0,1,0.0,0
