,SuccessfulHandoverCount,TotalSuccessfulHandoverCount,TotalSuccessfulHandoverCountRange,TotalSuccessfulHandoverCountLoadBalancing,TotalSuccessfulHandoverCountOverload,FailedHandoverCount,TotalFailedHandoverCount,AvgQoS,MinQoS,AvgQoS_LoadBased,MinQoS_LoadBased,AvgQoS_RangeBased,MinQoS_RangeBased,GiniLoad,VehicleCount
0,0,0,0,0,0,0,0,1.0,1,1.0,1,1.0,1,0.0,0
1,21,21,0,21,0,0,0,1.0,1,1.0,1,1.0,1,0.21657892356170347,26
2,17,38,0,38,0,0,0,1.0,1,1.0,1,1.0,1,0.18791845812517585,27
3,17,55,0,55,0,0,0,1.0,1,1.0,1,1.0,1,0.25024752654601423,28
4,13,68,0,68,0,0,0,1.0,1,1.0,1,1.0,1,0.2282232856460528,29
5,15,83,0,83,0,0,0,1.0,1,1.0,1,1.0,1,0.2692221329804045,29
6,17,100,0,100,0,0,0,1.0,1,1.0,1,1.0,1,0.2270842961719373,32
7,20,120,0,120,0,0,0,1.0,1,1.0,1,1.0,1,0.19626399996620253,33
8,20,140,0,140,0,0,0,1.0,1,1.0,1,1.0,1,0.2154769459355529,35
9,18,158,0,158,0,0,0,1.0,1,1.0,1,1.0,1,0.23368197703721189,35
10,18,176,0,176,0,0,0,1.0,1,1.0,1,1.0,1,0.18769854624512006,35
11,18,194,0,194,0,0,0,1.0,1,1.0,1,1.0,1,0.16795527971039256,35
12,12,206,0,206,0,0,0,1.0,1,1.0,1,1.0,1,0.23891424869164352,34
13,9,215,0,215,0,0,0,1.0,1,1.0,1,1.0,1,0.20249354877288966,32
14,13,228,1,227,0,0,0,1.0,1,1.0,1,1.0,1,0.31933391429386404,31
15,12,240,1,239,0,0,0,1.0,1,1.0,1,1.0,1,0.2297172262240594,30
16,2,242,1,241,0,0,0,1.0,1,1.0,1,1.0,1,0.18205578186532134,30
17,0,242,1,241,0,0,0,1.0,1,1.0,1,1.0,1,0.15355120171655093,29
18,1,243,2,241,0,0,0,1.0,1,1.0,1,1.0,1,0.20145073285841267,29
19,2,245,2,243,0,0,0,1.0,1,1.0,1,1.0,1,0.1341816302086954,28
20,0,245,2,243,0,0,0,1.0,1,1.0,1,1.0,1,0.1764819095114374,28
21,0,245,2,243,0,0,0,1.0,1,1.0,1,1.0,1,0.1764819095114374,28
22,4,249,5,244,0,0,0,1.0,1,1.0,1,1.0,1,0.2254452969109009,28
23,2,251,6,245,0,0,0,1.0,1,1.0,1,1.0,1,0.2973455649331132,27
24,2,253,8,245,0,0,0,1.0,1,1.0,1,1.0,1,0.30996385865859094,28
25,3,256,10,246,0,0,0,1.0,1,1.0,1,1.0,1,0.24350739524358656,28
26,2,258,12,246,0,0,0,1.0,1,1.0,1,1.0,1,0.261867260756578,30
27,1,259,12,247,0,0,0,1.0,1,1.0,1,1.0,1,0.276206906123463,30
28,6,265,14,251,0,0,0,1.0,1,1.0,1,1.0,1,0.24408828071813035,31
29,1,266,14,252,0,0,0,1.0,1,1.0,1,1.0,1,0.25107552733633354,30
30,3,269,15,254,0,0,0,1.0,1,1.0,1,1.0,1,0.2608021873274776,30
31,5,274,16,258,0,0,0,1.0,1,1.0,1,1.0,1,0.13369100320517813,31
32,0,274,16,258,0,0,0,1.0,1,1.0,1,1.0,1,0.15925490511399598,31
33,3,277,18,259,0,0,0,1.0,1,1.0,1,1.0,1,0.1832855136907315,31
34,2,279,19,260,0,0,0,1.0,1,1.0,1,1.0,1,0.18550076701934196,29
35,4,283,20,263,0,0,0,1.0,1,1.0,1,1.0,1,0.20534795827535363,30
36,0,283,20,263,0,0,0,1.0,1,1.0,1,1.0,1,0.21871647889224824,30
37,1,284,20,264,0,0,0,1.0,1,1.0,1,1.0,1,0.2081810787637195,31
38,0,284,20,264,0,0,0,1.0,1,1.0,1,1.0,1,0.20602304345856917,32
39,3,287,20,267,0,0,0,1.0,1,1.0,1,1.0,1,0.20183667284313742,36
40,3,290,20,270,0,0,0,1.0,1,1.0,1,1.0,1,0.19941294298043535,37
41,4,294,20,274,0,0,0,1.0,1,1.0,1,1.0,1,0.15506900042927954,37
42,3,297,20,277,0,0,0,1.0,1,1.0,1,1.0,1,0.1696906101244346,38
43,4,301,20,281,0,0,0,1.0,1,1.0,1,1.0,1,0.2145283815313664,40
44,2,303,20,283,0,0,0,1.0,1,1.0,1,1.0,1,0.16369736512672683,39
45,6,309,21,288,0,0,0,1.0,1,1.0,1,1.0,1,0.20470039295424822,40
46,1,310,21,289,0,0,0,1.0,1,1.0,1,1.0,1,0.16917655628479547,39
47,0,310,21,289,0,0,0,1.0,1,1.0,1,1.0,1,0.16917655628479547,39
48,0,310,21,289,0,0,0,1.0,1,1.0,1,1.0,1,0.16917655628479547,39
49,4,314,23,291,0,0,0,1.0,1,1.0,1,1.0,1,0.19951690538863354,37
50,2,316,24,292,0,0,0,1.0,1,1.0,1,1.0,1,0.17079072397444603,35
51,0,316,24,292,0,0,0,1.0,1,1.0,1,1.0,1,0.17466627558629502,34
52,0,316,24,292,0,0,0,1.0,1,1.0,1,1.0,1,0.20277461983418568,34
53,1,317,24,293,0,0,0,1.0,1,1.0,1,1.0,1,0.18207780969087953,35
54,1,318,24,294,0,0,0,1.0,1,1.0,1,1.0,1,0.21033890273147895,36
55,4,322,25,297,0,0,0,1.0,1,1.0,1,1.0,1,0.17433383978643197,36
56,4,326,27,299,0,0,0,1.0,1,1.0,1,1.0,1,0.20894617102858526,36
57,2,328,27,301,0,0,0,1.0,1,1.0,1,1.0,1,0.20313885677077656,37
58,5,333,29,304,0,0,0,1.0,1,1.0,1,1.0,1,0.20746344479691917,38
59,3,336,29,307,0,0,0,1.0,1,1.0,1,1.0,1,0.20291129116183748,37
60,0,336,29,307,0,0,0,1.0,1,1.0,1,1.0,1,0.1911636939994758,38
61,3,339,29,310,0,0,0,1.0,1,1.0,1,1.0,1,0.17168532297731023,37
62,1,340,30,310,0,0,0,1.0,1,1.0,1,1.0,1,0.17188086220495388,39
63,2,342,31,311,0,0,0,1.0,1,1.0,1,1.0,1,0.17186155573637527,39
64,2,344,33,311,0,0,0,1.0,1,1.0,1,1.0,1,0.2275507224769915,38
65,2,346,35,311,0,0,0,1.0,1,1.0,1,1.0,1,0.23279009521596428,39
66,3,349,37,312,0,0,0,1.0,1,1.0,1,1.0,1,0.26894495344961256,39
67,4,353,37,316,0,0,0,1.0,1,1.0,1,1.0,1,0.20088565006719775,36
68,3,356,38,318,0,0,0,1.0,1,1.0,1,1.0,1,0.2414080030492185,36
69,2,358,38,320,0,0,0,1.0,1,1.0,1,1.0,1,0.2132964466769914,37
70,3,361,38,323,0,0,0,1.0,1,1.0,1,1.0,1,0.2059983661496064,36
71,2,363,38,325,0,0,0,1.0,1,1.0,1,1.0,1,0.19716059862015414,38
72,3,366,38,328,0,0,0,1.0,1,1.0,1,1.0,1,0.20274359493331734,38
73,3,369,38,331,0,0,0,1.0,1,1.0,1,1.0,1,0.18545815525959727,37
74,3,372,39,333,0,0,0,1.0,1,1.0,1,1.0,1,0.2337438502532408,38
75,3,375,39,336,0,0,0,1.0,1,1.0,1,1.0,1,0.21866683728095987,38
76,6,381,40,341,0,0,0,1.0,1,1.0,1,1.0,1,0.21231910153914213,39
77,3,384,40,344,0,0,0,1.0,1,1.0,1,1.0,1,0.1561471170046236,40
78,4,388,40,348,0,0,0,1.0,1,1.0,1,1.0,1,0.16822872878531167,41
79,4,392,40,352,0,0,0,1.0,1,1.0,1,1.0,1,0.16822872878531167,41
80,3,395,40,355,0,0,0,1.0,1,1.0,1,1.0,1,0.16327184959754307,41
81,3,398,41,357,0,0,0,1.0,1,1.0,1,1.0,1,0.25397669925427124,41
82,8,406,41,365,0,0,0,1.0,1,1.0,1,1.0,1,0.18011760782262623,44
83,7,413,41,372,0,0,0,1.0,1,1.0,1,1.0,1,0.17297820998314284,44
84,4,417,41,376,0,0,0,1.0,1,1.0,1,1.0,1,0.1666983635484429,45
85,2,419,41,378,0,0,0,1.0,1,1.0,1,1.0,1,0.17445245529709,45
86,4,423,41,382,0,0,0,1.0,1,1.0,1,1.0,1,0.11107647560999895,45
87,0,423,41,382,0,0,0,1.0,1,1.0,1,1.0,1,0.12228843655611718,44
88,1,424,41,383,0,0,0,1.0,1,1.0,1,1.0,1,0.1438769466880798,44
89,2,426,42,384,0,0,0,1.0,1,1.0,1,1.0,1,0.12932426806787492,43
90,1,427,42,385,0,0,0,1.0,1,1.0,1,1.0,1,0.18408107294856452,44
91,3,430,44,386,0,0,0,1.0,1,1.0,1,1.0,1,0.21882831555057378,44
92,0,430,44,386,0,0,0,1.0,1,1.0,1,1.0,1,0.20618814436578647,43
93,3,433,44,389,0,0,0,1.0,1,1.0,1,1.0,1,0.18535510334552552,44
94,1,434,45,389,0,0,0,1.0,1,1.0,1,1.0,1,0.20338390752424254,44
95,3,437,45,392,0,0,0,1.0,1,1.0,1,1.0,1,0.15100456961661562,43
96,0,437,45,392,0,0,0,1.0,1,1.0,1,1.0,1,0.1524095302121189,44
97,0,437,45,392,0,0,0,1.0,1,1.0,1,1.0,1,0.1524095302121189,44
98,0,437,45,392,0,0,0,1.0,1,1.0,1,1.0,1,0.17380158538472087,43
99,0,437,45,392,0,0,0,1.0,1,1.0,1,1.0,1,0.17380158538472087,43
100,0,437,45,392,0,0,0,1.0,1,1.0,1,1.0,1,0.1681425515906102,47
101,0,437,45,392,0,0,0,1.0,1,1.0,1,1.0,1,0.1681425515906102,47
102,3,440,47,393,0,0,0,1.0,1,1.0,1,1.0,1,0.16190800411156256,47
103,3,443,49,394,0,0,0,1.0,1,1.0,1,1.0,1,0.15340509390578067,46
104,2,445,51,394,0,0,0,1.0,1,1.0,1,1.0,1,0.15188381329308911,45
105,3,448,53,395,0,0,0,1.0,1,1.0,1,1.0,1,0.14813758785539566,44
106,5,453,56,397,0,0,0,1.0,1,1.0,1,1.0,1,0.16245455144389068,45
107,2,455,57,398,0,0,0,1.0,1,1.0,1,1.0,1,0.16302427475424663,44
108,5,460,59,401,0,0,0,1.0,1,1.0,1,1.0,1,0.13068801716517203,46
109,2,462,60,402,0,0,0,1.0,1,1.0,1,1.0,1,0.13835947456133157,46
110,4,466,62,404,0,0,0,1.0,1,1.0,1,1.0,1,0.13976733072008216,46
111,3,469,63,406,0,0,0,1.0,1,1.0,1,1.0,1,0.14757824195075442,46
112,3,472,63,409,0,0,0,1.0,1,1.0,1,1.0,1,0.11115683893696221,46
113,1,473,64,409,0,0,0,1.0,1,1.0,1,1.0,1,0.11899822877382259,46
114,1,474,64,410,0,0,0,1.0,1,1.0,1,1.0,1,0.10896173643562727,46
115,0,474,64,410,0,0,0,1.0,1,1.0,1,1.0,1,0.08025139526224241,47
116,5,479,66,413,0,0,0,1.0,1,1.0,1,1.0,1,0.11899832020374675,47
117,3,482,67,415,0,0,0,1.0,1,1.0,1,1.0,1,0.09472081457501248,45
118,2,484,67,417,0,0,0,1.0,1,1.0,1,1.0,1,0.07703357231465748,46
119,1,485,67,418,0,0,0,1.0,1,1.0,1,1.0,1,0.09649527887773746,46
120,0,485,67,418,0,0,0,1.0,1,1.0,1,1.0,1,0.10565077167794559,47
121,1,486,67,419,0,0,0,1.0,1,1.0,1,1.0,1,0.09019249763655235,46
122,1,487,68,419,0,0,0,1.0,1,1.0,1,1.0,1,0.10854293064610822,46
123,0,487,68,419,0,0,0,1.0,1,1.0,1,1.0,1,0.1263014795189838,45
124,0,487,68,419,0,0,0,1.0,1,1.0,1,1.0,1,0.12506149784736478,46
125,1,488,69,419,0,0,0,1.0,1,1.0,1,1.0,1,0.1537658228089228,44
126,1,489,70,419,0,0,0,1.0,1,1.0,1,1.0,1,0.15160938081326986,45
127,0,489,70,419,0,0,0,1.0,1,1.0,1,1.0,1,0.14726635753797773,45
128,1,490,70,420,0,0,0,1.0,1,1.0,1,1.0,1,0.13064003568844249,46
129,3,493,72,421,0,0,0,1.0,1,1.0,1,1.0,1,0.13032999832145165,48
130,4,497,73,424,0,0,0,1.0,1,1.0,1,1.0,1,0.11132094941657898,48
131,2,499,73,426,0,0,0,1.0,1,1.0,1,1.0,1,0.10311989143492838,49
132,4,503,75,428,0,0,0,1.0,1,1.0,1,1.0,1,0.1672821114864277,51
133,2,505,77,428,0,0,0,1.0,1,1.0,1,1.0,1,0.16258358218803068,49
134,5,510,80,430,0,0,0,1.0,1,1.0,1,1.0,1,0.18341932363482016,49
135,4,514,81,433,0,0,0,1.0,1,1.0,1,1.0,1,0.19469053232865194,49
136,16,530,87,443,0,0,0,1.0,1,1.0,1,1.0,1,0.2317018897571281,48
137,10,540,87,453,0,0,0,1.0,1,1.0,1,1.0,1,0.22944988436757907,47
138,7,547,87,460,0,0,0,1.0,1,1.0,1,1.0,1,0.20137664637951375,48
139,10,557,88,469,0,0,0,1.0,1,1.0,1,1.0,1,0.24740114311901618,48
140,9,566,89,477,0,0,0,1.0,1,1.0,1,1.0,1,0.2432501466018189,49
141,7,573,90,483,0,0,0,1.0,1,1.0,1,1.0,1,0.19884373885797224,49
142,7,580,91,489,0,0,0,1.0,1,1.0,1,1.0,1,0.2764019579074071,49
143,8,588,92,496,0,0,0,1.0,1,1.0,1,1.0,1,0.25690060052837416,47
144,8,596,94,502,0,0,0,1.0,1,1.0,1,1.0,1,0.25903631118478093,46
145,7,603,95,508,0,0,0,1.0,1,1.0,1,1.0,1,0.2708571129778828,44
146,8,611,96,515,0,0,0,1.0,1,1.0,1,1.0,1,0.255000376497446,44
147,7,618,97,521,0,0,0,1.0,1,1.0,1,1.0,1,0.27866359700425464,43
148,8,626,98,528,0,0,0,1.0,1,1.0,1,1.0,1,0.28365474606650093,43
149,8,634,100,534,0,0,0,1.0,1,1.0,1,1.0,1,0.2819663965853869,43
150,8,642,101,541,0,0,0,1.0,1,1.0,1,1.0,1,0.3169463823599181,42
151,11,653,102,551,0,0,0,1.0,1,1.0,1,1.0,1,0.1622101618254116,42
152,3,656,102,554,0,0,0,1.0,1,1.0,1,1.0,1,0.14846787868037667,42
153,2,658,102,556,0,0,0,1.0,1,1.0,1,1.0,1,0.15787700077811267,42
154,2,660,103,557,0,0,0,1.0,1,1.0,1,1.0,1,0.19853420255660842,43
155,3,663,103,560,0,0,0,1.0,1,1.0,1,1.0,1,0.15867130169911267,43
156,3,666,104,562,0,0,0,1.0,1,1.0,1,1.0,1,0.16663869404847506,42
157,5,671,104,567,0,0,0,1.0,1,1.0,1,1.0,1,0.19006247324687853,41
158,4,675,105,570,0,0,0,1.0,1,1.0,1,1.0,1,0.22496986342614414,42
159,2,677,105,572,0,0,0,1.0,1,1.0,1,1.0,1,0.18334625442649086,43
160,11,688,107,581,0,0,0,1.0,1,1.0,1,1.0,1,0.28378846425858323,44
161,9,697,108,589,0,0,0,1.0,1,1.0,1,1.0,1,0.2832839114150906,44
162,10,707,111,596,0,0,0,1.0,1,1.0,1,1.0,1,0.35603728838748205,45
163,8,715,112,603,0,0,0,1.0,1,1.0,1,1.0,1,0.2999665470552988,43
164,7,722,113,609,0,0,0,1.0,1,1.0,1,1.0,1,0.27149118188303467,42
165,9,731,114,617,0,0,0,1.0,1,1.0,1,1.0,1,0.2238273799405657,42
166,9,740,114,626,0,0,0,1.0,1,1.0,1,1.0,1,0.12679825492197064,42
167,3,743,115,628,0,0,0,1.0,1,1.0,1,1.0,1,0.1323158068860122,41
168,0,743,115,628,0,0,0,1.0,1,1.0,1,1.0,1,0.120800898888819,40
169,0,743,115,628,0,0,0,1.0,1,1.0,1,1.0,1,0.1276709656501275,40
170,2,745,115,630,0,0,0,1.0,1,1.0,1,1.0,1,0.16955144852748424,38
171,1,746,115,631,0,0,0,1.0,1,1.0,1,1.0,1,0.13986557907347114,37
172,3,749,118,631,0,0,0,1.0,1,1.0,1,1.0,1,0.14883721029032718,35
173,4,753,120,633,0,0,0,1.0,1,1.0,1,1.0,1,0.20479797803226685,36
174,2,755,121,634,0,0,0,1.0,1,1.0,1,1.0,1,0.17036952183757598,34
175,0,755,121,634,0,0,0,1.0,1,1.0,1,1.0,1,0.21923831361638818,33
176,0,755,121,634,0,0,0,1.0,1,1.0,1,1.0,1,0.23511751877708184,34
177,2,757,122,635,0,0,0,1.0,1,1.0,1,1.0,1,0.23234021895186363,36
178,1,758,122,636,0,0,0,1.0,1,1.0,1,1.0,1,0.2187318015221412,37
179,1,759,123,636,0,0,0,1.0,1,1.0,1,1.0,1,0.2534836682210095,37
180,0,759,123,636,0,0,0,1.0,1,1.0,1,1.0,1,0.25915108504710227,36
181,3,762,123,639,0,0,0,1.0,1,1.0,1,1.0,1,0.14352335944569033,36
182,2,764,123,641,0,0,0,1.0,1,1.0,1,1.0,1,0.10341972594646709,38
183,1,765,124,641,0,0,0,1.0,1,1.0,1,1.0,1,0.11109453815906734,37
184,2,767,126,641,0,0,0,1.0,1,1.0,1,1.0,1,0.14167957573851545,36
185,3,770,127,643,0,0,0,1.0,1,1.0,1,1.0,1,0.15761838879649195,35
186,2,772,129,643,0,0,0,1.0,1,1.0,1,1.0,1,0.21503528106605627,34
187,2,774,130,644,0,0,0,1.0,1,1.0,1,1.0,1,0.18794006976104713,33
188,1,775,130,645,0,0,0,1.0,1,1.0,1,1.0,1,0.22454802364274454,33
189,6,781,134,647,0,0,0,1.0,1,1.0,1,1.0,1,0.27755908792024403,33
190,1,782,134,648,0,0,0,1.0,1,1.0,1,1.0,1,0.269962094732361,32
191,1,783,135,648,0,0,0,1.0,1,1.0,1,1.0,1,0.283015097105832,34
192,5,788,136,652,0,0,0,1.0,1,1.0,1,1.0,1,0.303321436861192,34
193,3,791,136,655,0,0,0,1.0,1,1.0,1,1.0,1,0.27050698967156517,35
194,3,794,137,657,0,0,0,1.0,1,1.0,1,1.0,1,0.25280046108493903,37
195,1,795,137,658,0,0,0,1.0,1,1.0,1,1.0,1,0.2337136801822079,36
196,3,798,137,661,0,0,0,1.0,1,1.0,1,1.0,1,0.17949336287347886,36
197,0,798,137,661,0,0,0,1.0,1,1.0,1,1.0,1,0.18098296026758554,37
198,0,798,137,661,0,0,0,1.0,1,1.0,1,1.0,1,0.18098296026758554,37
199,0,798,137,661,0,0,0,1.0,1,1.0,1,1.0,1,0.18098296026758554,37
200,1,799,138,661,0,0,0,1.0,1,1.0,1,1.0,1,0.21241387931708558,37
201,3,802,139,663,0,0,0,1.0,1,1.0,1,1.0,1,0.18278918490422255,36
202,1,803,140,663,0,0,0,1.0,1,1.0,1,1.0,1,0.1939016780393751,36
203,1,804,141,663,0,0,0,1.0,1,1.0,1,1.0,1,0.188154326389317,35
204,2,806,143,663,0,0,0,1.0,1,1.0,1,1.0,1,0.20691126474969584,35
205,3,809,144,665,0,0,0,1.0,1,1.0,1,1.0,1,0.22350432236780088,35
206,5,814,146,668,0,0,0,1.0,1,1.0,1,1.0,1,0.2503232042230646,34
207,2,816,146,670,0,0,0,1.0,1,1.0,1,1.0,1,0.26580325306496727,34
208,6,822,147,675,0,0,0,1.0,1,1.0,1,1.0,1,0.28767367286957635,33
209,2,824,147,677,0,0,0,1.0,1,1.0,1,1.0,1,0.30575445432011567,33
210,6,830,149,681,0,0,0,1.0,1,1.0,1,1.0,1,0.35410782904121246,34
211,8,838,150,688,0,0,0,1.0,1,1.0,1,1.0,1,0.24175445039498314,33
212,3,841,150,691,0,0,0,1.0,1,1.0,1,1.0,1,0.17880329351533805,33
213,1,842,150,692,0,0,0,1.0,1,1.0,1,1.0,1,0.19316225612335422,35
214,3,845,150,695,0,0,0,1.0,1,1.0,1,1.0,1,0.16094696702341796,34
215,3,848,150,698,0,0,0,1.0,1,1.0,1,1.0,1,0.12137436834276501,35
216,5,853,150,703,0,0,0,1.0,1,1.0,1,1.0,1,0.12518880849683478,36
217,3,856,151,705,0,0,0,1.0,1,1.0,1,1.0,1,0.1433533365808575,36
218,4,860,153,707,0,0,0,1.0,1,1.0,1,1.0,1,0.19709372122694535,36
219,6,866,154,712,0,0,0,1.0,1,1.0,1,1.0,1,0.1571106778485991,37
220,7,873,155,718,0,0,0,1.0,1,1.0,1,1.0,1,0.23303791669868987,38
221,5,878,156,722,0,0,0,1.0,1,1.0,1,1.0,1,0.2212428615505961,37
222,1,879,157,722,0,0,0,1.0,1,1.0,1,1.0,1,0.20178686687690742,38
223,2,881,158,723,0,0,0,1.0,1,1.0,1,1.0,1,0.20419048299162504,38
224,3,884,160,724,0,0,0,1.0,1,1.0,1,1.0,1,0.18380914157355668,38
225,1,885,161,724,0,0,0,1.0,1,1.0,1,1.0,1,0.2349842874715079,36
226,7,892,163,729,0,0,0,1.0,1,1.0,1,1.0,1,0.14905621628110702,37
227,3,895,165,730,0,0,0,1.0,1,1.0,1,1.0,1,0.18141951682799679,35
228,4,899,167,732,0,0,0,1.0,1,1.0,1,1.0,1,0.15149050698494448,35
229,4,903,169,734,0,0,0,1.0,1,1.0,1,1.0,1,0.15754048288992825,35
230,3,906,171,735,0,0,0,1.0,1,1.0,1,1.0,1,0.22046504270145872,35
231,3,909,172,737,0,0,0,1.0,1,1.0,1,1.0,1,0.16241694395691927,35
232,1,910,173,737,0,0,0,1.0,1,1.0,1,1.0,1,0.14065189520427843,36
233,0,910,173,737,0,0,0,1.0,1,1.0,1,1.0,1,0.14065189520427843,36
234,0,910,173,737,0,0,0,1.0,1,1.0,1,1.0,1,0.1269878390346195,34
235,2,912,175,737,0,0,0,1.0,1,1.0,1,1.0,1,0.14771587077877124,33
236,0,912,175,737,0,0,0,1.0,1,1.0,1,1.0,1,0.1573260474118374,31
237,1,913,176,737,0,0,0,1.0,1,1.0,1,1.0,1,0.1676683699198541,32
238,1,914,177,737,0,0,0,1.0,1,1.0,1,1.0,1,0.20519265197581654,31
239,1,915,178,737,0,0,0,1.0,1,1.0,1,1.0,1,0.2529892935385729,30
240,1,916,179,737,0,0,0,1.0,1,1.0,1,1.0,1,0.2948975756835389,27
241,8,924,182,742,0,0,0,1.0,1,1.0,1,1.0,1,0.21448056968255583,27
242,2,926,182,744,0,0,0,1.0,1,1.0,1,1.0,1,0.16276246417411222,28
243,2,928,183,745,0,0,0,1.0,1,1.0,1,1.0,1,0.1472598328019105,28
244,2,930,184,746,0,0,0,1.0,1,1.0,1,1.0,1,0.1704393523711249,27
245,0,930,184,746,0,0,0,1.0,1,1.0,1,1.0,1,0.1704393523711249,27
246,3,933,186,747,0,0,0,1.0,1,1.0,1,1.0,1,0.20957312157041372,25
247,0,933,186,747,0,0,0,1.0,1,1.0,1,1.0,1,0.19527016198304614,24
248,0,933,186,747,0,0,0,1.0,1,1.0,1,1.0,1,0.19768101961229395,24
249,1,934,187,747,0,0,0,1.0,1,1.0,1,1.0,1,0.23934290280332635,25
250,0,934,187,747,0,0,0,1.0,1,1.0,1,1.0,1,0.23081771774259358,27
251,0,934,187,747,0,0,0,1.0,1,1.0,1,1.0,1,0.23081771774259358,27
252,1,935,187,748,0,0,0,1.0,1,1.0,1,1.0,1,0.20220028088885394,27
253,1,936,187,749,0,0,0,1.0,1,1.0,1,1.0,1,0.18609536073512412,29
254,0,936,187,749,0,0,0,1.0,1,1.0,1,1.0,1,0.1593150597693659,30
255,3,939,188,751,0,0,0,1.0,1,1.0,1,1.0,1,0.16472984709181246,31
256,2,941,189,752,0,0,0,1.0,1,1.0,1,1.0,1,0.13470603003129433,31
257,1,942,190,752,0,0,0,1.0,1,1.0,1,1.0,1,0.16448193646417697,33
258,1,943,191,752,0,0,0,1.0,1,1.0,1,1.0,1,0.18290495178047267,33
259,2,945,192,753,0,0,0,1.0,1,1.0,1,1.0,1,0.17360063840183054,33
260,5,950,194,756,0,0,0,1.0,1,1.0,1,1.0,1,0.2334807338521378,35
261,7,957,195,762,0,0,0,1.0,1,1.0,1,1.0,1,0.21248297722244225,35
262,3,960,196,764,0,0,0,1.0,1,1.0,1,1.0,1,0.24871342855336678,35
263,5,965,197,768,0,0,0,1.0,1,1.0,1,1.0,1,0.23762106458618015,34
264,4,969,199,770,0,0,0,1.0,1,1.0,1,1.0,1,0.2456135050524798,32
265,0,969,199,770,0,0,0,1.0,1,1.0,1,1.0,1,0.19282553500375252,30
266,0,969,199,770,0,0,0,1.0,1,1.0,1,1.0,1,0.17252514382170633,31
267,1,970,200,770,0,0,0,1.0,1,1.0,1,1.0,1,0.1740425769386129,30
268,1,971,200,771,0,0,0,1.0,1,1.0,1,1.0,1,0.19713361360379644,31
269,1,972,201,771,0,0,0,1.0,1,1.0,1,1.0,1,0.21238784355149243,31
270,2,974,202,772,0,0,0,1.0,1,1.0,1,1.0,1,0.2475458231780649,32
271,3,977,203,774,0,0,0,1.0,1,1.0,1,1.0,1,0.24555653948512812,31
272,1,978,204,774,0,0,0,1.0,1,1.0,1,1.0,1,0.33623602240235234,32
273,2,980,204,776,0,0,0,1.0,1,1.0,1,1.0,1,0.3061794158290449,32
274,1,981,204,777,0,0,0,1.0,1,1.0,1,1.0,1,0.2956646163754854,32
275,0,981,204,777,0,0,0,1.0,1,1.0,1,1.0,1,0.2698887436117368,33
276,3,984,205,779,0,0,0,1.0,1,1.0,1,1.0,1,0.2477668078211871,34
277,2,986,205,781,0,0,0,1.0,1,1.0,1,1.0,1,0.23281696065422566,32
278,0,986,205,781,0,0,0,1.0,1,1.0,1,1.0,1,0.2542598026405548,31
279,2,988,205,783,0,0,0,1.0,1,1.0,1,1.0,1,0.19014999500350058,31
280,1,989,205,784,0,0,0,1.0,1,1.0,1,1.0,1,0.1834135936030702,30
281,2,991,207,784,0,0,0,1.0,1,1.0,1,1.0,1,0.22631925733340402,31
282,3,994,207,787,0,0,0,1.0,1,1.0,1,1.0,1,0.21299017798750927,30
283,7,1001,209,792,0,0,0,1.0,1,1.0,1,1.0,1,0.18564208989739978,31
284,3,1004,209,795,0,0,0,1.0,1,1.0,1,1.0,1,0.2143163714741627,31
285,7,1011,211,800,0,0,0,1.0,1,1.0,1,1.0,1,0.27532707276756657,31
286,4,1015,211,804,0,0,0,1.0,1,1.0,1,1.0,1,0.1544306133541003,31
287,5,1020,213,807,0,0,0,1.0,1,1.0,1,1.0,1,0.1270765766495724,33
288,1,1021,213,808,0,0,0,1.0,1,1.0,1,1.0,1,0.13702877972507604,32
289,1,1022,214,808,0,0,0,1.0,1,1.0,1,1.0,1,0.15293174558290992,32
290,0,1022,214,808,0,0,0,1.0,1,1.0,1,1.0,1,0.1748194167999105,31
291,0,1022,214,808,0,0,0,1.0,1,1.0,1,1.0,1,0.16886929805101786,30
292,1,1023,215,808,0,0,0,1.0,1,1.0,1,1.0,1,0.19130425570097911,32
293,1,1024,215,809,0,0,0,1.0,1,1.0,1,1.0,1,0.18527681631299364,32
294,0,1024,215,809,0,0,0,1.0,1,1.0,1,1.0,1,0.18527681631299364,32
295,1,1025,215,810,0,0,0,1.0,1,1.0,1,1.0,1,0.15848330626877508,34
296,2,1027,216,811,0,0,0,1.0,1,1.0,1,1.0,1,0.15453430100737378,34
297,1,1028,216,812,0,0,0,1.0,1,1.0,1,1.0,1,0.12890922854571427,34
298,1,1029,216,813,0,0,0,1.0,1,1.0,1,1.0,1,0.12639126672440576,35
299,0,1029,216,813,0,0,0,1.0,1,1.0,1,1.0,1,0.10478047340336899,35
300,0,1029,216,813,0,0,0,1.0,1,1.0,1,1.0,1,0.10478047340336899,35
301,2,1031,217,814,0,0,0,1.0,1,1.0,1,1.0,1,0.12581513625600693,38
302,1,1032,218,814,0,0,0,1.0,1,1.0,1,1.0,1,0.13283950449703394,38
303,2,1034,220,814,0,0,0,1.0,1,1.0,1,1.0,1,0.15448477889042092,37
304,4,1038,222,816,0,0,0,1.0,1,1.0,1,1.0,1,0.20298161630331382,37
305,6,1044,223,821,0,0,0,1.0,1,1.0,1,1.0,1,0.20107769972620634,36
306,5,1049,226,823,0,0,0,1.0,1,1.0,1,1.0,1,0.28842549879107704,36
307,1,1050,226,824,0,0,0,1.0,1,1.0,1,1.0,1,0.292930279024061,35
308,5,1055,227,828,0,0,0,1.0,1,1.0,1,1.0,1,0.2798205875870906,37
309,5,1060,227,833,0,0,0,1.0,1,1.0,1,1.0,1,0.2653659611634966,37
310,3,1063,227,836,0,0,0,1.0,1,1.0,1,1.0,1,0.2992369715019857,37
311,4,1067,227,840,0,0,0,1.0,1,1.0,1,1.0,1,0.24712093756244616,39
312,5,1072,227,845,0,0,0,1.0,1,1.0,1,1.0,1,0.22388383259198988,40
313,2,1074,227,847,0,0,0,1.0,1,1.0,1,1.0,1,0.220701348550454,39
314,4,1078,227,851,0,0,0,1.0,1,1.0,1,1.0,1,0.2085347683384031,40
315,2,1080,229,851,0,0,0,1.0,1,1.0,1,1.0,1,0.2343437125172804,39
316,7,1087,229,858,0,0,0,1.0,1,1.0,1,1.0,1,0.1062538518765691,39
317,2,1089,229,860,0,0,0,1.0,1,1.0,1,1.0,1,0.1119513157814712,40
318,4,1093,229,864,0,0,0,1.0,1,1.0,1,1.0,1,0.12383651331429665,41
319,3,1096,229,867,0,0,0,1.0,1,1.0,1,1.0,1,0.16046708873014384,41
320,0,1096,229,867,0,0,0,1.0,1,1.0,1,1.0,1,0.18291275758006972,41
321,0,1096,229,867,0,0,0,1.0,1,1.0,1,1.0,1,0.18291275758006972,41
322,4,1100,232,868,0,0,0,1.0,1,1.0,1,1.0,1,0.207661266621779,41
323,4,1104,232,872,0,0,0,1.0,1,1.0,1,1.0,1,0.20066601828930714,41
324,8,1112,234,878,0,0,0,1.0,1,1.0,1,1.0,1,0.2462378919892735,42
325,7,1119,234,885,0,0,0,1.0,1,1.0,1,1.0,1,0.2423290092022137,42
326,5,1124,235,889,0,0,0,1.0,1,1.0,1,1.0,1,0.25204732284067666,42
327,9,1133,236,897,0,0,0,1.0,1,1.0,1,1.0,1,0.25895365032364603,42
328,7,1140,236,904,0,0,0,1.0,1,1.0,1,1.0,1,0.22179215669150643,43
329,6,1146,236,910,0,0,0,1.0,1,1.0,1,1.0,1,0.25648567089988783,43
330,8,1154,236,918,0,0,0,1.0,1,1.0,1,1.0,1,0.2484814240322149,45
331,10,1164,237,927,0,0,0,1.0,1,1.0,1,1.0,1,0.08684862002342188,45
332,5,1169,238,931,0,0,0,1.0,1,1.0,1,1.0,1,0.13413589101120496,45
333,4,1173,239,934,0,0,0,1.0,1,1.0,1,1.0,1,0.11657263496225426,46
334,3,1176,239,937,0,0,0,1.0,1,1.0,1,1.0,1,0.10339927273664792,48
335,1,1177,239,938,0,0,0,1.0,1,1.0,1,1.0,1,0.09895229936111086,48
336,2,1179,239,940,0,0,0,1.0,1,1.0,1,1.0,1,0.09895229936111086,48
337,2,1181,239,942,0,0,0,1.0,1,1.0,1,1.0,1,0.12059159555509284,49
338,2,1183,240,943,0,0,0,1.0,1,1.0,1,1.0,1,0.12425855913604761,50
339,1,1184,240,944,0,0,0,1.0,1,1.0,1,1.0,1,0.10389865919566768,50
340,0,1184,240,944,0,0,0,1.0,1,1.0,1,1.0,1,0.10389865919566768,50
341,1,1185,240,945,0,0,0,1.0,1,1.0,1,1.0,1,0.11383284881551277,51
342,1,1186,241,945,0,0,0,1.0,1,1.0,1,1.0,1,0.1269068094663025,51
343,4,1190,241,949,0,0,0,1.0,1,1.0,1,1.0,1,0.08715546474516014,51
344,4,1194,242,952,0,0,0,1.0,1,1.0,1,1.0,1,0.11012965482345148,50
345,3,1197,242,955,0,0,0,1.0,1,1.0,1,1.0,1,0.099507131676018,51
346,3,1200,242,958,0,0,0,1.0,1,1.0,1,1.0,1,0.07600932489498392,51
347,1,1201,243,958,0,0,0,1.0,1,1.0,1,1.0,1,0.06494947919726457,51
348,2,1203,245,958,0,0,0,1.0,1,1.0,1,1.0,1,0.09274348906434234,53
349,4,1207,247,960,0,0,0,1.0,1,1.0,1,1.0,1,0.09525115235665405,55
350,1,1208,248,960,0,0,0,1.0,1,1.0,1,1.0,1,0.11069087507429258,54
351,7,1215,252,963,0,0,0,1.0,1,1.0,1,1.0,1,0.13347204463289458,54
352,3,1218,254,964,0,0,0,1.0,1,1.0,1,1.0,1,0.17634285553249596,53
353,1,1219,254,965,0,0,0,1.0,1,1.0,1,1.0,1,0.1425072079196041,53
354,1,1220,254,966,0,0,0,1.0,1,1.0,1,1.0,1,0.15987733525723968,50
355,0,1220,254,966,0,0,0,1.0,1,1.0,1,1.0,1,0.17439835502426007,51
356,1,1221,255,966,0,0,0,1.0,1,1.0,1,1.0,1,0.16044779393176922,51
357,1,1222,256,966,0,0,0,1.0,1,1.0,1,1.0,1,0.1606026512485589,50
358,1,1223,257,966,0,0,0,1.0,1,1.0,1,1.0,1,0.18037503310819647,48
359,1,1224,258,966,0,0,0,1.0,1,1.0,1,1.0,1,0.1689272942915337,47
360,0,1224,258,966,0,0,0,1.0,1,1.0,1,1.0,1,0.20594246789901915,45
361,5,1229,260,969,0,0,0,1.0,1,1.0,1,1.0,1,0.18618312541145188,44
362,3,1232,260,972,0,0,0,1.0,1,1.0,1,1.0,1,0.15598723866288416,44
363,2,1234,262,972,0,0,0,1.0,1,1.0,1,1.0,1,0.1570145964018819,44
364,1,1235,263,972,0,0,0,1.0,1,1.0,1,1.0,1,0.16799593455636763,43
365,3,1238,265,973,0,0,0,1.0,1,1.0,1,1.0,1,0.1890975269075414,43
366,1,1239,265,974,0,0,0,1.0,1,1.0,1,1.0,1,0.1772321917645638,45
367,2,1241,266,975,0,0,0,1.0,1,1.0,1,1.0,1,0.2011810513774576,44
368,3,1244,268,976,0,0,0,1.0,1,1.0,1,1.0,1,0.16462619842207393,46
369,3,1247,269,978,0,0,0,1.0,1,1.0,1,1.0,1,0.18090900617282998,45
370,1,1248,269,979,0,0,0,1.0,1,1.0,1,1.0,1,0.18581322680690737,46
371,2,1250,269,981,0,0,0,1.0,1,1.0,1,1.0,1,0.1625344185391776,47
372,0,1250,269,981,0,0,0,1.0,1,1.0,1,1.0,1,0.17414122798590972,48
373,1,1251,269,982,0,0,0,1.0,1,1.0,1,1.0,1,0.14982998208915269,48
374,3,1254,269,985,0,0,0,1.0,1,1.0,1,1.0,1,0.17576311275396556,49
375,1,1255,269,986,0,0,0,1.0,1,1.0,1,1.0,1,0.1633146253109083,49
376,4,1259,273,986,0,0,0,1.0,1,1.0,1,1.0,1,0.13797359824094224,49
377,3,1262,276,986,0,0,0,1.0,1,1.0,1,1.0,1,0.16832536008100885,49
378,1,1263,277,986,0,0,0,1.0,1,1.0,1,1.0,1,0.18565697551025723,49
379,1,1264,277,987,0,0,0,1.0,1,1.0,1,1.0,1,0.19652847803117915,50
380,5,1269,279,990,0,0,0,1.0,1,1.0,1,1.0,1,0.2145032363082238,50
381,2,1271,279,992,0,0,0,1.0,1,1.0,1,1.0,1,0.19748545443286997,51
382,1,1272,279,993,0,0,0,1.0,1,1.0,1,1.0,1,0.21729767893776272,50
383,5,1277,281,996,0,0,0,1.0,1,1.0,1,1.0,1,0.17955740120744795,51
384,3,1280,284,996,0,0,0,1.0,1,1.0,1,1.0,1,0.17391166345661652,50
385,2,1282,286,996,0,0,0,1.0,1,1.0,1,1.0,1,0.18116232333258236,50
386,4,1286,288,998,0,0,0,1.0,1,1.0,1,1.0,1,0.19340953704786218,48
387,1,1287,288,999,0,0,0,1.0,1,1.0,1,1.0,1,0.18412410080878958,47
388,2,1289,288,1001,0,0,0,1.0,1,1.0,1,1.0,1,0.200504823122725,48
389,2,1291,288,1003,0,0,0,1.0,1,1.0,1,1.0,1,0.19436788495520396,47
390,4,1295,290,1005,0,0,0,1.0,1,1.0,1,1.0,1,0.1744681877460977,49
391,7,1302,292,1010,0,0,0,1.0,1,1.0,1,1.0,1,0.08499855202637562,46
392,3,1305,293,1012,0,0,0,1.0,1,1.0,1,1.0,1,0.12221903793467098,46
393,3,1308,296,1012,0,0,0,1.0,1,1.0,1,1.0,1,0.15697214428472328,44
394,4,1312,297,1015,0,0,0,1.0,1,1.0,1,1.0,1,0.16648334512773055,43
395,2,1314,297,1017,0,0,0,1.0,1,1.0,1,1.0,1,0.21324956982715887,42
396,2,1316,299,1017,0,0,0,1.0,1,1.0,1,1.0,1,0.2370592299610626,39
397,2,1318,300,1018,0,0,0,1.0,1,1.0,1,1.0,1,0.2856722200845911,39
398,3,1321,300,1021,0,0,0,1.0,1,1.0,1,1.0,1,0.26627752086721207,36
399,0,1321,300,1021,0,0,0,1.0,1,1.0,1,1.0,1,0.26627752086721207,36
400,2,1323,302,1021,0,0,0,1.0,1,1.0,1,1.0,1,0.28066727263116625,34
401,2,1325,303,1022,0,0,0,1.0,1,1.0,1,1.0,1,0.2789946395623648,33
402,0,1325,303,1022,0,0,0,1.0,1,1.0,1,1.0,1,0.26158060212953094,34
403,0,1325,303,1022,0,0,0,1.0,1,1.0,1,1.0,1,0.262583055154876,36
404,3,1328,305,1023,0,0,0,1.0,1,1.0,1,1.0,1,0.2588822553836342,36
405,3,1331,308,1023,0,0,0,1.0,1,1.0,1,1.0,1,0.32943016325711794,37
406,7,1338,308,1030,0,0,0,1.0,1,1.0,1,1.0,1,0.1876983603780168,37
407,3,1341,309,1032,0,0,0,1.0,1,1.0,1,1.0,1,0.1759107151351483,39
408,2,1343,310,1033,0,0,0,1.0,1,1.0,1,1.0,1,0.1532182951143601,40
409,5,1348,312,1036,0,0,0,1.0,1,1.0,1,1.0,1,0.18319691583361414,41
410,3,1351,313,1038,0,0,0,1.0,1,1.0,1,1.0,1,0.19723474517843106,42
411,1,1352,313,1039,0,0,0,1.0,1,1.0,1,1.0,1,0.2036005488324411,43
412,2,1354,315,1039,0,0,0,1.0,1,1.0,1,1.0,1,0.24333998138741858,44
413,0,1354,315,1039,0,0,0,1.0,1,1.0,1,1.0,1,0.24333998138741858,44
414,1,1355,315,1040,0,0,0,1.0,1,1.0,1,1.0,1,0.21535885236950622,45
415,2,1357,315,1042,0,0,0,1.0,1,1.0,1,1.0,1,0.20688185288249714,45
416,4,1361,315,1046,0,0,0,1.0,1,1.0,1,1.0,1,0.23947130057024943,46
417,4,1365,316,1049,0,0,0,1.0,1,1.0,1,1.0,1,0.2024354547071285,46
418,3,1368,316,1052,0,0,0,1.0,1,1.0,1,1.0,1,0.18271343006593058,47
419,2,1370,316,1054,0,0,0,1.0,1,1.0,1,1.0,1,0.19930771809484255,47
420,2,1372,316,1056,0,0,0,1.0,1,1.0,1,1.0,1,0.19930771809484255,47
421,2,1374,316,1058,0,0,0,1.0,1,1.0,1,1.0,1,0.16937760126765605,47
422,2,1376,317,1059,0,0,0,1.0,1,1.0,1,1.0,1,0.16995782046962274,49
423,1,1377,317,1060,0,0,0,1.0,1,1.0,1,1.0,1,0.14883711366830774,47
424,2,1379,317,1062,0,0,0,1.0,1,1.0,1,1.0,1,0.11507492972906659,45
425,1,1380,317,1063,0,0,0,1.0,1,1.0,1,1.0,1,0.1370048447645746,46
426,3,1383,318,1065,0,0,0,1.0,1,1.0,1,1.0,1,0.14355939241757273,46
427,1,1384,319,1065,0,0,0,1.0,1,1.0,1,1.0,1,0.13929646802889226,45
428,1,1385,319,1066,0,0,0,1.0,1,1.0,1,1.0,1,0.13827406008288534,45
429,8,1393,323,1070,0,0,0,1.0,1,1.0,1,1.0,1,0.1659196507265833,42
430,0,1393,323,1070,0,0,0,1.0,1,1.0,1,1.0,1,0.18939771940607925,40
431,1,1394,324,1070,0,0,0,1.0,1,1.0,1,1.0,1,0.21724524177488297,39
432,1,1395,325,1070,0,0,0,1.0,1,1.0,1,1.0,1,0.26752468620497827,37
433,3,1398,328,1070,0,0,0,1.0,1,1.0,1,1.0,1,0.2792553293403,35
434,0,1398,328,1070,0,0,0,1.0,1,1.0,1,1.0,1,0.3260698052734883,33
435,1,1399,328,1071,0,0,0,1.0,1,1.0,1,1.0,1,0.3116314406772988,33
436,9,1408,328,1080,0,0,0,1.0,1,1.0,1,1.0,1,0.14257260496210208,33
437,3,1411,329,1082,0,0,0,1.0,1,1.0,1,1.0,1,0.15480402974087246,33
438,3,1414,329,1085,0,0,0,1.0,1,1.0,1,1.0,1,0.1160617357564461,32
439,4,1418,330,1088,0,0,0,1.0,1,1.0,1,1.0,1,0.1716036668602765,34
440,4,1422,331,1091,0,0,0,1.0,1,1.0,1,1.0,1,0.2163510350567402,34
441,3,1425,332,1093,0,0,0,1.0,1,1.0,1,1.0,1,0.2589712398919587,35
442,8,1433,333,1100,0,0,0,1.0,1,1.0,1,1.0,1,0.2385950762913603,37
443,10,1443,337,1106,0,0,0,1.0,1,1.0,1,1.0,1,0.23744759589186623,37
444,6,1449,338,1111,0,0,0,1.0,1,1.0,1,1.0,1,0.22887908795852624,38
445,8,1457,340,1117,0,0,0,1.0,1,1.0,1,1.0,1,0.28005456593538586,39
446,9,1466,340,1126,0,0,0,1.0,1,1.0,1,1.0,1,0.33891040365345065,39
447,12,1478,340,1138,0,0,0,1.0,1,1.0,1,1.0,1,0.2578575061817676,41
448,10,1488,340,1148,0,0,0,1.0,1,1.0,1,1.0,1,0.245905897878587,41
449,10,1498,341,1157,0,0,0,1.0,1,1.0,1,1.0,1,0.3206487553734068,40
450,7,1505,341,1164,0,0,0,1.0,1,1.0,1,1.0,1,0.2690131694736287,40
451,3,1508,341,1167,0,0,0,1.0,1,1.0,1,1.0,1,0.2478561506741133,41
452,2,1510,341,1169,0,0,0,1.0,1,1.0,1,1.0,1,0.21093034079371584,41
453,2,1512,341,1171,0,0,0,1.0,1,1.0,1,1.0,1,0.2261779833682682,40
454,3,1515,341,1174,0,0,0,1.0,1,1.0,1,1.0,1,0.16566699495393908,41
455,4,1519,341,1178,0,0,0,1.0,1,1.0,1,1.0,1,0.1160364325899259,41
456,6,1525,341,1184,0,0,0,1.0,1,1.0,1,1.0,1,0.1744980088154782,43
457,8,1533,342,1191,0,0,0,1.0,1,1.0,1,1.0,1,0.13887159166634586,43
458,4,1537,342,1195,0,0,0,1.0,1,1.0,1,1.0,1,0.16293596840759209,43
459,3,1540,342,1198,0,0,0,1.0,1,1.0,1,1.0,1,0.13549654375258488,44
460,5,1545,342,1203,0,0,0,1.0,1,1.0,1,1.0,1,0.16105483997860304,47
461,4,1549,342,1207,0,0,0,1.0,1,1.0,1,1.0,1,0.17159542194004831,48
462,5,1554,345,1209,0,0,0,1.0,1,1.0,1,1.0,1,0.21025556873787743,49
463,6,1560,345,1215,0,0,0,1.0,1,1.0,1,1.0,1,0.17776547763131775,47
464,6,1566,347,1219,0,0,0,1.0,1,1.0,1,1.0,1,0.21510909368921965,48
465,6,1572,349,1223,0,0,0,1.0,1,1.0,1,1.0,1,0.21599184290699686,47
466,10,1582,349,1233,0,0,0,1.0,1,1.0,1,1.0,1,0.12876648376838876,46
467,7,1589,350,1239,0,0,0,1.0,1,1.0,1,1.0,1,0.15728550000866495,44
468,4,1593,350,1243,0,0,0,1.0,1,1.0,1,1.0,1,0.17157231224582972,41
469,2,1595,350,1245,0,0,0,1.0,1,1.0,1,1.0,1,0.13411549205933643,40
470,3,1598,352,1246,0,0,0,1.0,1,1.0,1,1.0,1,0.10605137483121196,39
471,3,1601,353,1248,0,0,0,1.0,1,1.0,1,1.0,1,0.11739629330929179,38
472,4,1605,355,1250,0,0,0,1.0,1,1.0,1,1.0,1,0.23326183773611905,36
473,5,1610,358,1252,0,0,0,1.0,1,1.0,1,1.0,1,0.20971904595454896,36
474,1,1611,359,1252,0,0,0,1.0,1,1.0,1,1.0,1,0.2676393170722947,34
475,3,1614,362,1252,0,0,0,1.0,1,1.0,1,1.0,1,0.29520827590335047,34
476,0,1614,362,1252,0,0,0,1.0,1,1.0,1,1.0,1,0.32819277143539516,32
477,3,1617,363,1254,0,0,0,1.0,1,1.0,1,1.0,1,0.30456778869586276,32
478,1,1618,363,1255,0,0,0,1.0,1,1.0,1,1.0,1,0.27929565943288925,30
479,2,1620,364,1256,0,0,0,1.0,1,1.0,1,1.0,1,0.27468370906154116,31
480,1,1621,364,1257,0,0,0,1.0,1,1.0,1,1.0,1,0.35706084673970434,27
481,7,1628,365,1263,0,0,0,1.0,1,1.0,1,1.0,1,0.19870429624899055,28
482,0,1628,365,1263,0,0,0,1.0,1,1.0,1,1.0,1,0.16908188396679347,28
483,4,1632,366,1266,0,0,0,1.0,1,1.0,1,1.0,1,0.18359810059773693,29
484,2,1634,367,1267,0,0,0,1.0,1,1.0,1,1.0,1,0.17073849654892093,29
485,3,1637,368,1269,0,0,0,1.0,1,1.0,1,1.0,1,0.12194918765223191,29
486,1,1638,368,1270,0,0,0,1.0,1,1.0,1,1.0,1,0.12447880751042506,31
487,4,1642,368,1274,0,0,0,1.0,1,1.0,1,1.0,1,0.12684552737389412,33
488,2,1644,368,1276,0,0,0,1.0,1,1.0,1,1.0,1,0.10034564319390929,34
489,1,1645,369,1276,0,0,0,1.0,1,1.0,1,1.0,1,0.18826826208806322,34
490,0,1645,369,1276,0,0,0,1.0,1,1.0,1,1.0,1,0.18826826208806322,34
491,0,1645,369,1276,0,0,0,1.0,1,1.0,1,1.0,1,0.18826826208806322,34
492,0,1645,369,1276,0,0,0,1.0,1,1.0,1,1.0,1,0.18826826208806322,34
493,5,1650,370,1280,0,0,0,1.0,1,1.0,1,1.0,1,0.19403759584517064,34
494,5,1655,371,1284,0,0,0,1.0,1,1.0,1,1.0,1,0.17913849477922344,36
495,3,1658,372,1286,0,0,0,1.0,1,1.0,1,1.0,1,0.20486004709449435,36
496,5,1663,372,1291,0,0,0,1.0,1,1.0,1,1.0,1,0.10325051719112699,37
497,2,1665,372,1293,0,0,0,1.0,1,1.0,1,1.0,1,0.13091402262477145,39
498,2,1667,372,1295,0,0,0,1.0,1,1.0,1,1.0,1,0.1263820414699301,40
499,2,1669,373,1296,0,0,0,1.0,1,1.0,1,1.0,1,0.1817133264642594,40
500,7,1676,373,1303,0,0,0,1.0,1,1.0,1,1.0,1,0.1501747926110729,42
501,2,1678,373,1305,0,0,0,1.0,1,1.0,1,1.0,1,0.1501747926110729,42
502,5,1683,375,1308,0,0,0,1.0,1,1.0,1,1.0,1,0.1435081156914497,42
503,1,1684,376,1308,0,0,0,1.0,1,1.0,1,1.0,1,0.18811736046131078,41
504,3,1687,379,1308,0,0,0,1.0,1,1.0,1,1.0,1,0.24042148459514476,42
505,3,1690,380,1310,0,0,0,1.0,1,1.0,1,1.0,1,0.22754155910490714,38
506,2,1692,381,1311,0,0,0,1.0,1,1.0,1,1.0,1,0.18457116650323285,37
507,5,1697,382,1315,0,0,0,1.0,1,1.0,1,1.0,1,0.1992137562655005,35
508,2,1699,383,1316,0,0,0,1.0,1,1.0,1,1.0,1,0.20329221951513748,35
509,0,1699,383,1316,0,0,0,1.0,1,1.0,1,1.0,1,0.21875729643693706,34
510,2,1701,385,1316,0,0,0,1.0,1,1.0,1,1.0,1,0.2701011456288621,34
511,1,1702,385,1317,0,0,0,1.0,1,1.0,1,1.0,1,0.22084765743180138,32
512,0,1702,385,1317,0,0,0,1.0,1,1.0,1,1.0,1,0.21757565924714364,30
513,0,1702,385,1317,0,0,0,1.0,1,1.0,1,1.0,1,0.20817923115605147,31
514,0,1702,385,1317,0,0,0,1.0,1,1.0,1,1.0,1,0.20817923115605147,31
515,4,1706,387,1319,0,0,0,1.0,1,1.0,1,1.0,1,0.17896873873906188,32
516,1,1707,387,1320,0,0,0,1.0,1,1.0,1,1.0,1,0.1540888116763662,31
517,2,1709,388,1321,0,0,0,1.0,1,1.0,1,1.0,1,0.17633550306175982,32
518,1,1710,388,1322,0,0,0,1.0,1,1.0,1,1.0,1,0.15149998613821006,31
519,3,1713,390,1323,0,0,0,1.0,1,1.0,1,1.0,1,0.14490898563732707,31
520,0,1713,390,1323,0,0,0,1.0,1,1.0,1,1.0,1,0.17346096642802053,33
521,1,1714,391,1323,0,0,0,1.0,1,1.0,1,1.0,1,0.18363795997546586,34
522,3,1717,393,1324,0,0,0,1.0,1,1.0,1,1.0,1,0.15509641546691774,34
523,0,1717,393,1324,0,0,0,1.0,1,1.0,1,1.0,1,0.16030454797533045,33
524,5,1722,396,1326,0,0,0,1.0,1,1.0,1,1.0,1,0.1841772734046627,34
525,2,1724,396,1328,0,0,0,1.0,1,1.0,1,1.0,1,0.17592429990299635,32
526,2,1726,396,1330,0,0,0,1.0,1,1.0,1,1.0,1,0.1410443798024266,32
527,0,1726,396,1330,0,0,0,1.0,1,1.0,1,1.0,1,0.1406050181098951,31
528,4,1730,399,1331,0,0,0,1.0,1,1.0,1,1.0,1,0.22270424860859825,31
529,0,1730,399,1331,0,0,0,1.0,1,1.0,1,1.0,1,0.24054384214154614,30
530,2,1732,400,1332,0,0,0,1.0,1,1.0,1,1.0,1,0.22234218173223874,30
531,0,1732,400,1332,0,0,0,1.0,1,1.0,1,1.0,1,0.2478861523524895,32
532,4,1736,403,1333,0,0,0,1.0,1,1.0,1,1.0,1,0.26102244882166137,32
533,4,1740,405,1335,0,0,0,1.0,1,1.0,1,1.0,1,0.2744650955871127,34
534,2,1742,406,1336,0,0,0,1.0,1,1.0,1,1.0,1,0.27772188068108405,34
535,3,1745,406,1339,0,0,0,1.0,1,1.0,1,1.0,1,0.28507255620498,37
536,2,1747,406,1341,0,0,0,1.0,1,1.0,1,1.0,1,0.2866928388667845,37
537,4,1751,408,1343,0,0,0,1.0,1,1.0,1,1.0,1,0.3046315546757196,37
538,6,1757,408,1349,0,0,0,1.0,1,1.0,1,1.0,1,0.27569307933841164,38
539,3,1760,408,1352,0,0,0,1.0,1,1.0,1,1.0,1,0.24487127330826494,38
540,1,1761,408,1353,0,0,0,1.0,1,1.0,1,1.0,1,0.23399656855732218,38
541,0,1761,408,1353,0,0,0,1.0,1,1.0,1,1.0,1,0.22076655787742833,39
542,6,1767,410,1357,0,0,0,1.0,1,1.0,1,1.0,1,0.19184125530995688,40
543,1,1768,411,1357,0,0,0,1.0,1,1.0,1,1.0,1,0.22424659322608978,37
544,2,1770,412,1358,0,0,0,1.0,1,1.0,1,1.0,1,0.23786549366151635,35
545,1,1771,413,1358,0,0,0,1.0,1,1.0,1,1.0,1,0.17290156032746384,35
546,4,1775,415,1360,0,0,0,1.0,1,1.0,1,1.0,1,0.1619153646687526,35
547,2,1777,416,1361,0,0,0,1.0,1,1.0,1,1.0,1,0.1508940963048,34
548,5,1782,419,1363,0,0,0,1.0,1,1.0,1,1.0,1,0.18709311964807987,34
549,2,1784,421,1363,0,0,0,1.0,1,1.0,1,1.0,1,0.2280741154159541,31
550,0,1784,421,1363,0,0,0,1.0,1,1.0,1,1.0,1,0.21580207130593515,30
551,3,1787,424,1363,0,0,0,1.0,1,1.0,1,1.0,1,0.2710338565534831,31
552,1,1788,424,1364,0,0,0,1.0,1,1.0,1,1.0,1,0.1853568016343158,29
553,3,1791,425,1366,0,0,0,1.0,1,1.0,1,1.0,1,0.22019316883801168,30
554,2,1793,425,1368,0,0,0,1.0,1,1.0,1,1.0,1,0.17747887396763093,30
555,2,1795,425,1370,0,0,0,1.0,1,1.0,1,1.0,1,0.17997996177858236,30
556,2,1797,425,1372,0,0,0,1.0,1,1.0,1,1.0,1,0.08562279274103507,31
557,0,1797,425,1372,0,0,0,1.0,1,1.0,1,1.0,1,0.13008117626343138,31
558,1,1798,425,1373,0,0,0,1.0,1,1.0,1,1.0,1,0.11481495938480965,31
559,0,1798,425,1373,0,0,0,1.0,1,1.0,1,1.0,1,0.11481495938480965,31
560,0,1798,425,1373,0,0,0,1.0,1,1.0,1,1.0,1,0.09632880526257677,32
561,3,1801,427,1374,0,0,0,1.0,1,1.0,1,1.0,1,0.14224803681576711,33
562,0,1801,427,1374,0,0,0,1.0,1,1.0,1,1.0,1,0.14224803681576711,33
563,3,1804,429,1375,0,0,0,1.0,1,1.0,1,1.0,1,0.1409352383121717,33
564,4,1808,431,1377,0,0,0,1.0,1,1.0,1,1.0,1,0.1685627914369428,34
565,4,1812,432,1380,0,0,0,1.0,1,1.0,1,1.0,1,0.1580409052173299,35
566,3,1815,433,1382,0,0,0,1.0,1,1.0,1,1.0,1,0.15707139355279076,36
567,8,1823,436,1387,0,0,0,1.0,1,1.0,1,1.0,1,0.24618922334214138,37
568,5,1828,436,1392,0,0,0,1.0,1,1.0,1,1.0,1,0.2745701839383972,36
569,4,1832,436,1396,0,0,0,1.0,1,1.0,1,1.0,1,0.2299126954038232,37
570,3,1835,436,1399,0,0,0,1.0,1,1.0,1,1.0,1,0.22238743229713162,38
571,6,1841,436,1405,0,0,0,1.0,1,1.0,1,1.0,1,0.14890709676966626,38
572,0,1841,436,1405,0,0,0,1.0,1,1.0,1,1.0,1,0.1513550043269125,39
573,0,1841,436,1405,0,0,0,1.0,1,1.0,1,1.0,1,0.1513550043269125,39
574,0,1841,436,1405,0,0,0,1.0,1,1.0,1,1.0,1,0.14983817367250996,41
575,1,1842,436,1406,0,0,0,1.0,1,1.0,1,1.0,1,0.1308590895612356,41
576,3,1845,436,1409,0,0,0,1.0,1,1.0,1,1.0,1,0.1183734467180436,42
577,0,1845,436,1409,0,0,0,1.0,1,1.0,1,1.0,1,0.1183734467180436,42
578,1,1846,437,1409,0,0,0,1.0,1,1.0,1,1.0,1,0.16958014308040387,41
579,3,1849,438,1411,0,0,0,1.0,1,1.0,1,1.0,1,0.1873238399155519,42
580,5,1854,438,1416,0,0,0,1.0,1,1.0,1,1.0,1,0.20051247161813956,43
581,5,1859,440,1419,0,0,0,1.0,1,1.0,1,1.0,1,0.18206863077682392,42
582,6,1865,441,1424,0,0,0,1.0,1,1.0,1,1.0,1,0.17486981884178834,41
583,6,1871,443,1428,0,0,0,1.0,1,1.0,1,1.0,1,0.15770557555936998,40
584,1,1872,443,1429,0,0,0,1.0,1,1.0,1,1.0,1,0.16465764675651792,38
585,5,1877,445,1432,0,0,0,1.0,1,1.0,1,1.0,1,0.21006977878533475,38
586,6,1883,446,1437,0,0,0,1.0,1,1.0,1,1.0,1,0.12444469728402709,37
587,5,1888,447,1441,0,0,0,1.0,1,1.0,1,1.0,1,0.1280115246873083,35
588,5,1893,448,1445,0,0,0,1.0,1,1.0,1,1.0,1,0.14262444527899468,35
589,1,1894,448,1446,0,0,0,1.0,1,1.0,1,1.0,1,0.1078350526600189,34
590,4,1898,449,1449,0,0,0,1.0,1,1.0,1,1.0,1,0.16262011981587324,36
591,2,1900,450,1450,0,0,0,1.0,1,1.0,1,1.0,1,0.15102309793865526,35
592,1,1901,451,1450,0,0,0,1.0,1,1.0,1,1.0,1,0.1694535016854607,37
593,3,1904,451,1453,0,0,0,1.0,1,1.0,1,1.0,1,0.13728775523972306,36
594,2,1906,452,1454,0,0,0,1.0,1,1.0,1,1.0,1,0.1824646918908304,35
595,0,1906,452,1454,0,0,0,1.0,1,1.0,1,1.0,1,0.18386169694019958,34
596,1,1907,452,1455,0,0,0,1.0,1,1.0,1,1.0,1,0.20630144741712245,34
597,5,1912,454,1458,0,0,0,1.0,1,1.0,1,1.0,1,0.24185847432704163,33
598,2,1914,454,1460,0,0,0,1.0,1,1.0,1,1.0,1,0.29495828725332063,33
599,3,1917,454,1463,0,0,0,1.0,1,1.0,1,1.0,1,0.2587337653938234,33
600,4,1921,457,1464,0,0,0,1.0,1,1.0,1,1.0,1,0.36993630075376127,33
601,6,1927,458,1469,0,0,0,1.0,1,1.0,1,1.0,1,0.2959239822933409,34
602,1,1928,458,1470,0,0,0,1.0,1,1.0,1,1.0,1,0.3097328680623139,35
603,5,1933,458,1475,0,0,0,1.0,1,1.0,1,1.0,1,0.22464283744745442,35
604,1,1934,458,1476,0,0,0,1.0,1,1.0,1,1.0,1,0.2293760199578457,35
605,3,1937,458,1479,0,0,0,1.0,1,1.0,1,1.0,1,0.2110610361892096,35
606,1,1938,458,1480,0,0,0,1.0,1,1.0,1,1.0,1,0.18619184850869466,35
607,1,1939,459,1480,0,0,0,1.0,1,1.0,1,1.0,1,0.2049514939031292,35
608,3,1942,459,1483,0,0,0,1.0,1,1.0,1,1.0,1,0.18341455283836683,36
609,1,1943,459,1484,0,0,0,1.0,1,1.0,1,1.0,1,0.14497154004994234,37
610,3,1946,459,1487,0,0,0,1.0,1,1.0,1,1.0,1,0.14282895978940544,37
611,3,1949,459,1490,0,0,0,1.0,1,1.0,1,1.0,1,0.18116801192492438,39
612,5,1954,460,1494,0,0,0,1.0,1,1.0,1,1.0,1,0.13625158666120796,39
613,2,1956,460,1496,0,0,0,1.0,1,1.0,1,1.0,1,0.13625158666120796,39
614,7,1963,461,1502,0,0,0,1.0,1,1.0,1,1.0,1,0.13420686335022144,39
615,7,1970,462,1508,0,0,0,1.0,1,1.0,1,1.0,1,0.16288489563453304,39
616,4,1974,463,1511,0,0,0,1.0,1,1.0,1,1.0,1,0.11320591264550742,38
617,0,1974,463,1511,0,0,0,1.0,1,1.0,1,1.0,1,0.12765700228729765,39
618,2,1976,463,1513,0,0,0,1.0,1,1.0,1,1.0,1,0.11285811375563311,40
619,1,1977,464,1513,0,0,0,1.0,1,1.0,1,1.0,1,0.09621211454512377,39
620,1,1978,464,1514,0,0,0,1.0,1,1.0,1,1.0,1,0.08759426622764752,38
621,1,1979,465,1514,0,0,0,1.0,1,1.0,1,1.0,1,0.1270723006015715,38
622,2,1981,466,1515,0,0,0,1.0,1,1.0,1,1.0,1,0.22210772241507226,38
623,4,1985,469,1516,0,0,0,1.0,1,1.0,1,1.0,1,0.16983469226688303,37
624,3,1988,471,1517,0,0,0,1.0,1,1.0,1,1.0,1,0.15494082243847393,33
625,0,1988,471,1517,0,0,0,1.0,1,1.0,1,1.0,1,0.1383339600786865,32
626,1,1989,472,1517,0,0,0,1.0,1,1.0,1,1.0,1,0.15787640591737487,31
627,4,1993,474,1519,0,0,0,1.0,1,1.0,1,1.0,1,0.28566856135052354,30
628,4,1997,478,1519,0,0,0,1.0,1,1.0,1,1.0,1,0.32908271864910665,32
629,5,2002,481,1521,0,0,0,1.0,1,1.0,1,1.0,1,0.37084626727143105,29
630,4,2006,483,1523,0,0,0,1.0,1,1.0,1,1.0,1,0.41239498078827797,29
631,5,2011,484,1527,0,0,0,1.0,1,1.0,1,1.0,1,0.2860253918386681,25
632,0,2011,484,1527,0,0,0,1.0,1,1.0,1,1.0,1,0.2967478658076533,24
633,2,2013,484,1529,0,0,0,1.0,1,1.0,1,1.0,1,0.2037565954637689,23
634,1,2014,484,1530,0,0,0,1.0,1,1.0,1,1.0,1,0.20603793076571353,23
635,2,2016,485,1531,0,0,0,1.0,1,1.0,1,1.0,1,0.19366894642887672,22
636,1,2017,485,1532,0,0,0,1.0,1,1.0,1,1.0,1,0.2100876804027006,22
637,2,2019,486,1533,0,0,0,1.0,1,1.0,1,1.0,1,0.21381014537306908,23
638,2,2021,486,1535,0,0,0,1.0,1,1.0,1,1.0,1,0.215534764835683,23
639,2,2023,486,1537,0,0,0,1.0,1,1.0,1,1.0,1,0.2093753089875555,24
640,3,2026,487,1539,0,0,0,1.0,1,1.0,1,1.0,1,0.2433271828667651,24
641,1,2027,487,1540,0,0,0,1.0,1,1.0,1,1.0,1,0.22383752886125438,25
642,0,2027,487,1540,0,0,0,1.0,1,1.0,1,1.0,1,0.17651336746423799,26
643,1,2028,487,1541,0,0,0,1.0,1,1.0,1,1.0,1,0.18994059867934598,28
644,1,2029,488,1541,0,0,0,1.0,1,1.0,1,1.0,1,0.18051210381544647,28
645,1,2030,489,1541,0,0,0,1.0,1,1.0,1,1.0,1,0.19313757300844478,28
646,1,2031,489,1542,0,0,0,1.0,1,1.0,1,1.0,1,0.15241808735911333,29
647,2,2033,491,1542,0,0,0,1.0,1,1.0,1,1.0,1,0.21551201440554985,30
648,1,2034,491,1543,0,0,0,1.0,1,1.0,1,1.0,1,0.19826952191600736,30
649,1,2035,492,1543,0,0,0,1.0,1,1.0,1,1.0,1,0.22826669287456314,31
650,1,2036,493,1543,0,0,0,1.0,1,1.0,1,1.0,1,0.21844953495179764,31
651,3,2039,493,1546,0,0,0,1.0,1,1.0,1,1.0,1,0.14544420927016624,32
652,0,2039,493,1546,0,0,0,1.0,1,1.0,1,1.0,1,0.14544420927016624,32
653,1,2040,493,1547,0,0,0,1.0,1,1.0,1,1.0,1,0.13572487073160353,33
654,3,2043,494,1549,0,0,0,1.0,1,1.0,1,1.0,1,0.17766982197685452,33
655,7,2050,497,1553,0,0,0,1.0,1,1.0,1,1.0,1,0.15691618327709178,36
656,3,2053,498,1555,0,0,0,1.0,1,1.0,1,1.0,1,0.17641389997659238,36
657,3,2056,499,1557,0,0,0,1.0,1,1.0,1,1.0,1,0.16801694362163647,35
658,3,2059,501,1558,0,0,0,1.0,1,1.0,1,1.0,1,0.26291663455825764,33
659,3,2062,501,1561,0,0,0,1.0,1,1.0,1,1.0,1,0.2473332416707033,35
660,4,2066,502,1564,0,0,0,1.0,1,1.0,1,1.0,1,0.3161006608996593,34
661,6,2072,502,1570,0,0,0,1.0,1,1.0,1,1.0,1,0.20604569370362041,33
662,2,2074,503,1571,0,0,0,1.0,1,1.0,1,1.0,1,0.20999432739757973,31
663,2,2076,504,1572,0,0,0,1.0,1,1.0,1,1.0,1,0.22690775400429944,29
664,1,2077,505,1572,0,0,0,1.0,1,1.0,1,1.0,1,0.2738075602642074,27
665,4,2081,505,1576,0,0,0,1.0,1,1.0,1,1.0,1,0.21170619263502327,27
666,2,2083,506,1577,0,0,0,1.0,1,1.0,1,1.0,1,0.19368258174476058,28
667,2,2085,507,1578,0,0,0,1.0,1,1.0,1,1.0,1,0.2204597018163222,26
668,3,2088,510,1578,0,0,0,1.0,1,1.0,1,1.0,1,0.1644478942367293,26
669,2,2090,512,1578,0,0,0,1.0,1,1.0,1,1.0,1,0.13432382290025005,25
670,0,2090,512,1578,0,0,0,1.0,1,1.0,1,1.0,1,0.1368703835594326,24
671,0,2090,512,1578,0,0,0,1.0,1,1.0,1,1.0,1,0.1368703835594326,24
672,2,2092,513,1579,0,0,0,1.0,1,1.0,1,1.0,1,0.2274938502781417,25
673,1,2093,513,1580,0,0,0,1.0,1,1.0,1,1.0,1,0.18092688268238513,25
674,1,2094,514,1580,0,0,0,1.0,1,1.0,1,1.0,1,0.18363209571448766,25
675,4,2098,516,1582,0,0,0,1.0,1,1.0,1,1.0,1,0.21786993244167233,26
676,4,2102,517,1585,0,0,0,1.0,1,1.0,1,1.0,1,0.1524482189101128,27
677,2,2104,517,1587,0,0,0,1.0,1,1.0,1,1.0,1,0.15222534367529592,28
678,2,2106,518,1588,0,0,0,1.0,1,1.0,1,1.0,1,0.12453165056282246,28
679,3,2109,519,1590,0,0,0,1.0,1,1.0,1,1.0,1,0.1474837128944716,30
680,2,2111,519,1592,0,0,0,1.0,1,1.0,1,1.0,1,0.13048202494650848,29
681,1,2112,519,1593,0,0,0,1.0,1,1.0,1,1.0,1,0.15108891103184552,29
682,2,2114,519,1595,0,0,0,1.0,1,1.0,1,1.0,1,0.15957243190553141,30
683,1,2115,519,1596,0,0,0,1.0,1,1.0,1,1.0,1,0.13238254049776457,30
684,2,2117,519,1598,0,0,0,1.0,1,1.0,1,1.0,1,0.16278130189922857,31
685,2,2119,519,1600,0,0,0,1.0,1,1.0,1,1.0,1,0.18801309591201246,30
686,6,2125,522,1603,0,0,0,1.0,1,1.0,1,1.0,1,0.20480008582221937,30
687,4,2129,523,1606,0,0,0,1.0,1,1.0,1,1.0,1,0.23817416460752577,30
688,3,2132,523,1609,0,0,0,1.0,1,1.0,1,1.0,1,0.2699881540910227,31
689,5,2137,524,1613,0,0,0,1.0,1,1.0,1,1.0,1,0.33131791064704547,32
690,7,2144,524,1620,0,0,0,1.0,1,1.0,1,1.0,1,0.2647812907832469,32
691,6,2150,525,1625,0,0,0,1.0,1,1.0,1,1.0,1,0.1646865158867608,32
692,1,2151,526,1625,0,0,0,1.0,1,1.0,1,1.0,1,0.21965199351377934,32
693,1,2152,527,1625,0,0,0,1.0,1,1.0,1,1.0,1,0.2024743339610681,34
694,4,2156,528,1628,0,0,0,1.0,1,1.0,1,1.0,1,0.150362544813658,36
695,3,2159,530,1629,0,0,0,1.0,1,1.0,1,1.0,1,0.19323612570714815,34
696,2,2161,531,1630,0,0,0,1.0,1,1.0,1,1.0,1,0.12936998724935264,33
697,0,2161,531,1630,0,0,0,1.0,1,1.0,1,1.0,1,0.1302126807290768,33
698,1,2162,531,1631,0,0,0,1.0,1,1.0,1,1.0,1,0.11431055434380036,34
699,1,2163,532,1631,0,0,0,1.0,1,1.0,1,1.0,1,0.10389801676656518,33
700,1,2164,533,1631,0,0,0,1.0,1,1.0,1,1.0,1,0.12678309383653125,32
701,1,2165,533,1632,0,0,0,1.0,1,1.0,1,1.0,1,0.13296782925247613,33
702,1,2166,534,1632,0,0,0,1.0,1,1.0,1,1.0,1,0.2137097913981875,34
703,7,2173,536,1637,0,0,0,1.0,1,1.0,1,1.0,1,0.14654450562589175,32
704,0,2173,536,1637,0,0,0,1.0,1,1.0,1,1.0,1,0.1649968356765587,31
705,2,2175,538,1637,0,0,0,1.0,1,1.0,1,1.0,1,0.13812208134253742,33
706,3,2178,539,1639,0,0,0,1.0,1,1.0,1,1.0,1,0.09698359422105292,33
707,1,2179,540,1639,0,0,0,1.0,1,1.0,1,1.0,1,0.1694816475578189,31
708,2,2181,542,1639,0,0,0,1.0,1,1.0,1,1.0,1,0.20142193722067311,31
709,2,2183,543,1640,0,0,0,1.0,1,1.0,1,1.0,1,0.2379725813754758,30
710,1,2184,543,1641,0,0,0,1.0,1,1.0,1,1.0,1,0.23918708625859214,30
711,0,2184,543,1641,0,0,0,1.0,1,1.0,1,1.0,1,0.22470235244730535,30
712,1,2185,543,1642,0,0,0,1.0,1,1.0,1,1.0,1,0.2102599859276448,30
713,0,2185,543,1642,0,0,0,1.0,1,1.0,1,1.0,1,0.23345371513045302,31
714,0,2185,543,1642,0,0,0,1.0,1,1.0,1,1.0,1,0.24880628564358725,31
715,0,2185,543,1642,0,0,0,1.0,1,1.0,1,1.0,1,0.2465550579696821,30
716,0,2185,543,1642,0,0,0,1.0,1,1.0,1,1.0,1,0.21902565832792295,31
717,1,2186,543,1643,0,0,0,1.0,1,1.0,1,1.0,1,0.22421499176885482,32
718,0,2186,543,1643,0,0,0,1.0,1,1.0,1,1.0,1,0.22421499176885482,32
719,0,2186,543,1643,0,0,0,1.0,1,1.0,1,1.0,1,0.22421499176885482,32
720,0,2186,543,1643,0,0,0,1.0,1,1.0,1,1.0,1,0.20599418726808227,34
721,2,2188,544,1644,0,0,0,1.0,1,1.0,1,1.0,1,0.22912296957266357,34
722,3,2191,545,1646,0,0,0,1.0,1,1.0,1,1.0,1,0.2506659593325604,34
723,1,2192,545,1647,0,0,0,1.0,1,1.0,1,1.0,1,0.2498596236112125,35
724,1,2193,546,1647,0,0,0,1.0,1,1.0,1,1.0,1,0.2781459506641675,36
725,2,2195,546,1649,0,0,0,1.0,1,1.0,1,1.0,1,0.24722513511776423,37
726,1,2196,546,1650,0,0,0,1.0,1,1.0,1,1.0,1,0.2342850347560167,37
727,0,2196,546,1650,0,0,0,1.0,1,1.0,1,1.0,1,0.24540896565982095,38
728,0,2196,546,1650,0,0,0,1.0,1,1.0,1,1.0,1,0.2363565312617711,39
729,0,2196,546,1650,0,0,0,1.0,1,1.0,1,1.0,1,0.2363565312617711,39
730,1,2197,547,1650,0,0,0,1.0,1,1.0,1,1.0,1,0.23816839273408802,40
731,2,2199,548,1651,0,0,0,1.0,1,1.0,1,1.0,1,0.18939949915356905,40
732,1,2200,548,1652,0,0,0,1.0,1,1.0,1,1.0,1,0.2077023739942871,41
733,1,2201,548,1653,0,0,0,1.0,1,1.0,1,1.0,1,0.13969898021469343,41
734,1,2202,549,1653,0,0,0,1.0,1,1.0,1,1.0,1,0.15529076251863,42
735,2,2204,550,1654,0,0,0,1.0,1,1.0,1,1.0,1,0.1309147396411294,42
736,1,2205,550,1655,0,0,0,1.0,1,1.0,1,1.0,1,0.14674684531646207,41
737,5,2210,553,1657,0,0,0,1.0,1,1.0,1,1.0,1,0.20570467299545017,41
738,1,2211,553,1658,0,0,0,1.0,1,1.0,1,1.0,1,0.16498050452191623,39
739,0,2211,553,1658,0,0,0,1.0,1,1.0,1,1.0,1,0.16498050452191623,39
740,3,2214,555,1659,0,0,0,1.0,1,1.0,1,1.0,1,0.1892019799764817,39
741,1,2215,555,1660,0,0,0,1.0,1,1.0,1,1.0,1,0.19366148359019028,38
742,2,2217,557,1660,0,0,0,1.0,1,1.0,1,1.0,1,0.17051974794560656,39
743,6,2223,561,1662,0,0,0,1.0,1,1.0,1,1.0,1,0.1952716915327569,39
744,2,2225,562,1663,0,0,0,1.0,1,1.0,1,1.0,1,0.17699190992000358,39
745,2,2227,564,1663,0,0,0,1.0,1,1.0,1,1.0,1,0.20480458877749005,39
746,7,2234,567,1667,0,0,0,1.0,1,1.0,1,1.0,1,0.23722319227838418,40
747,3,2237,568,1669,0,0,0,1.0,1,1.0,1,1.0,1,0.2191025921098275,41
748,6,2243,570,1673,0,0,0,1.0,1,1.0,1,1.0,1,0.20343993808547645,41
749,5,2248,571,1677,0,0,0,1.0,1,1.0,1,1.0,1,0.19600272603692423,41
750,6,2254,573,1681,0,0,0,1.0,1,1.0,1,1.0,1,0.23233197563135785,39
751,8,2262,573,1689,0,0,0,1.0,1,1.0,1,1.0,1,0.13441777605271824,41
752,5,2267,574,1693,0,0,0,1.0,1,1.0,1,1.0,1,0.1773606052445789,41
753,3,2270,574,1696,0,0,0,1.0,1,1.0,1,1.0,1,0.1651834399680722,41
754,3,2273,575,1698,0,0,0,1.0,1,1.0,1,1.0,1,0.1876966010256607,41
755,3,2276,576,1700,0,0,0,1.0,1,1.0,1,1.0,1,0.21270786961481833,41
756,4,2280,576,1704,0,0,0,1.0,1,1.0,1,1.0,1,0.21387291120106589,41
757,4,2284,576,1708,0,0,0,1.0,1,1.0,1,1.0,1,0.2299571356556778,39
758,4,2288,576,1712,0,0,0,1.0,1,1.0,1,1.0,1,0.23003438810274462,39
759,1,2289,576,1713,0,0,0,1.0,1,1.0,1,1.0,1,0.19709458212066702,39
760,2,2291,576,1715,0,0,0,1.0,1,1.0,1,1.0,1,0.2133878713526588,40
761,2,2293,576,1717,0,0,0,1.0,1,1.0,1,1.0,1,0.22495005634492057,41
762,4,2297,576,1721,0,0,0,1.0,1,1.0,1,1.0,1,0.19893064420340453,42
763,5,2302,576,1726,0,0,0,1.0,1,1.0,1,1.0,1,0.21623264408558063,43
764,5,2307,576,1731,0,0,0,1.0,1,1.0,1,1.0,1,0.2160019559328707,43
765,5,2312,576,1736,0,0,0,1.0,1,1.0,1,1.0,1,0.16986286062239503,45
766,3,2315,576,1739,0,0,0,1.0,1,1.0,1,1.0,1,0.11962722365502841,45
767,0,2315,576,1739,0,0,0,1.0,1,1.0,1,1.0,1,0.11854459573489809,46
768,0,2315,576,1739,0,0,0,1.0,1,1.0,1,1.0,1,0.12393527886217288,45
769,2,2317,576,1741,0,0,0,1.0,1,1.0,1,1.0,1,0.11001822601778496,46
770,5,2322,577,1745,0,0,0,1.0,1,1.0,1,1.0,1,0.09669678013093416,47
771,4,2326,578,1748,0,0,0,1.0,1,1.0,1,1.0,1,0.1369898795625783,47
772,3,2329,579,1750,0,0,0,1.0,1,1.0,1,1.0,1,0.13693141846343532,46
773,2,2331,580,1751,0,0,0,1.0,1,1.0,1,1.0,1,0.13749162148281,45
774,2,2333,580,1753,0,0,0,1.0,1,1.0,1,1.0,1,0.12094183889093933,45
775,4,2337,583,1754,0,0,0,1.0,1,1.0,1,1.0,1,0.15603764598296974,45
776,1,2338,583,1755,0,0,0,1.0,1,1.0,1,1.0,1,0.14954903180890033,43
777,2,2340,583,1757,0,0,0,1.0,1,1.0,1,1.0,1,0.16443849672200378,44
778,6,2346,584,1762,0,0,0,1.0,1,1.0,1,1.0,1,0.16309283527238788,45
779,4,2350,584,1766,0,0,0,1.0,1,1.0,1,1.0,1,0.16309283527238788,45
780,6,2356,586,1770,0,0,0,1.0,1,1.0,1,1.0,1,0.18698638328900172,45
781,4,2360,586,1774,0,0,0,1.0,1,1.0,1,1.0,1,0.14382749553778137,46
782,2,2362,587,1775,0,0,0,1.0,1,1.0,1,1.0,1,0.21515296285094102,47
783,3,2365,588,1777,0,0,0,1.0,1,1.0,1,1.0,1,0.14730408079438656,46
784,1,2366,588,1778,0,0,0,1.0,1,1.0,1,1.0,1,0.13777584639164223,45
785,0,2366,588,1778,0,0,0,1.0,1,1.0,1,1.0,1,0.14751587025792132,43
786,1,2367,588,1779,0,0,0,1.0,1,1.0,1,1.0,1,0.13860433323692894,43
787,2,2369,589,1780,0,0,0,1.0,1,1.0,1,1.0,1,0.16610970680528875,43
788,4,2373,590,1783,0,0,0,1.0,1,1.0,1,1.0,1,0.14754552979966495,44
789,2,2375,590,1785,0,0,0,1.0,1,1.0,1,1.0,1,0.12338145213264967,46
790,2,2377,592,1785,0,0,0,1.0,1,1.0,1,1.0,1,0.1465858781607338,46
791,0,2377,592,1785,0,0,0,1.0,1,1.0,1,1.0,1,0.17264477341589352,46
792,0,2377,592,1785,0,0,0,1.0,1,1.0,1,1.0,1,0.17793270848857948,47
793,3,2380,592,1788,0,0,0,1.0,1,1.0,1,1.0,1,0.15945795721267136,48
794,2,2382,592,1790,0,0,0,1.0,1,1.0,1,1.0,1,0.16447740766575575,48
795,3,2385,593,1792,0,0,0,1.0,1,1.0,1,1.0,1,0.1606524297059682,47
796,4,2389,594,1795,0,0,0,1.0,1,1.0,1,1.0,1,0.13225298172514574,45
797,4,2393,594,1799,0,0,0,1.0,1,1.0,1,1.0,1,0.14309802533073704,47
798,1,2394,594,1800,0,0,0,1.0,1,1.0,1,1.0,1,0.1626175006608911,48
799,4,2398,595,1803,0,0,0,1.0,1,1.0,1,1.0,1,0.16844895103598426,48
800,5,2403,597,1806,0,0,0,1.0,1,1.0,1,1.0,1,0.19496131217494847,48
801,3,2406,598,1808,0,0,0,1.0,1,1.0,1,1.0,1,0.1714001918022642,49
802,7,2413,600,1813,0,0,0,1.0,1,1.0,1,1.0,1,0.2050172593528389,50
803,2,2415,600,1815,0,0,0,1.0,1,1.0,1,1.0,1,0.2066905213560946,50
804,1,2416,600,1816,0,0,0,1.0,1,1.0,1,1.0,1,0.20412536635268702,50
805,2,2418,601,1817,0,0,0,1.0,1,1.0,1,1.0,1,0.22465660838482895,50
806,2,2420,601,1819,0,0,0,1.0,1,1.0,1,1.0,1,0.2041949822865146,51
807,4,2424,603,1821,0,0,0,1.0,1,1.0,1,1.0,1,0.2106448337994029,51
808,1,2425,603,1822,0,0,0,1.0,1,1.0,1,1.0,1,0.2057490255037707,53
809,1,2426,603,1823,0,0,0,1.0,1,1.0,1,1.0,1,0.15226367511598,51
810,0,2426,603,1823,0,0,0,1.0,1,1.0,1,1.0,1,0.1651247699345975,52
811,4,2430,603,1827,0,0,0,1.0,1,1.0,1,1.0,1,0.10589151031604911,50
812,1,2431,603,1828,0,0,0,1.0,1,1.0,1,1.0,1,0.08973239739429567,51
813,3,2434,604,1830,0,0,0,1.0,1,1.0,1,1.0,1,0.1088737849226133,51
814,3,2437,606,1831,0,0,0,1.0,1,1.0,1,1.0,1,0.16680781544557224,52
815,1,2438,607,1831,0,0,0,1.0,1,1.0,1,1.0,1,0.22207097095466802,50
816,0,2438,607,1831,0,0,0,1.0,1,1.0,1,1.0,1,0.22207097095466802,50
817,0,2438,607,1831,0,0,0,1.0,1,1.0,1,1.0,1,0.23821755640628275,49
818,4,2442,608,1834,0,0,0,1.0,1,1.0,1,1.0,1,0.24087634876251457,49
819,2,2444,608,1836,0,0,0,1.0,1,1.0,1,1.0,1,0.23803866227633771,50
820,1,2445,609,1836,0,0,0,1.0,1,1.0,1,1.0,1,0.25377844625827356,49
821,0,2445,609,1836,0,0,0,1.0,1,1.0,1,1.0,1,0.2524317969498159,49
822,3,2448,610,1838,0,0,0,1.0,1,1.0,1,1.0,1,0.23904568739384496,49
823,3,2451,612,1839,0,0,0,1.0,1,1.0,1,1.0,1,0.27044895565520405,47
824,7,2458,616,1842,0,0,0,1.0,1,1.0,1,1.0,1,0.2482027924162043,45
825,0,2458,616,1842,0,0,0,1.0,1,1.0,1,1.0,1,0.240993653104495,43
826,7,2465,618,1847,0,0,0,1.0,1,1.0,1,1.0,1,0.19888180554852541,44
827,4,2469,618,1851,0,0,0,1.0,1,1.0,1,1.0,1,0.12254747822164466,43
828,5,2474,620,1854,0,0,0,1.0,1,1.0,1,1.0,1,0.14164446139728157,43
829,3,2477,622,1855,0,0,0,1.0,1,1.0,1,1.0,1,0.10750017136802306,45
830,4,2481,623,1858,0,0,0,1.0,1,1.0,1,1.0,1,0.11704352159810298,46
831,2,2483,624,1859,0,0,0,1.0,1,1.0,1,1.0,1,0.10846052810954865,48
832,2,2485,625,1860,0,0,0,1.0,1,1.0,1,1.0,1,0.08812055585509491,47
833,3,2488,626,1862,0,0,0,1.0,1,1.0,1,1.0,1,0.10224172947625648,47
834,4,2492,626,1866,0,0,0,1.0,1,1.0,1,1.0,1,0.13576488605010342,46
835,2,2494,626,1868,0,0,0,1.0,1,1.0,1,1.0,1,0.12259218032203376,45
836,3,2497,627,1870,0,0,0,1.0,1,1.0,1,1.0,1,0.13086921717961256,46
837,3,2500,627,1873,0,0,0,1.0,1,1.0,1,1.0,1,0.11712444763842615,46
838,4,2504,628,1876,0,0,0,1.0,1,1.0,1,1.0,1,0.13802261951347622,45
839,4,2508,630,1878,0,0,0,1.0,1,1.0,1,1.0,1,0.18232181839108622,46
840,5,2513,630,1883,0,0,0,1.0,1,1.0,1,1.0,1,0.16814298317560822,46
841,4,2517,630,1887,0,0,0,1.0,1,1.0,1,1.0,1,0.10577534580560832,46
842,4,2521,631,1890,0,0,0,1.0,1,1.0,1,1.0,1,0.07719963146994441,46
843,1,2522,631,1891,0,0,0,1.0,1,1.0,1,1.0,1,0.05561973011527354,46
844,3,2525,633,1892,0,0,0,1.0,1,1.0,1,1.0,1,0.11221517824984673,47
845,6,2531,634,1897,0,0,0,1.0,1,1.0,1,1.0,1,0.1266817842095245,48
846,4,2535,635,1900,0,0,0,1.0,1,1.0,1,1.0,1,0.15370530044239722,47
847,5,2540,635,1905,0,0,0,1.0,1,1.0,1,1.0,1,0.10288270626533451,48
848,3,2543,635,1908,0,0,0,1.0,1,1.0,1,1.0,1,0.15126977845872913,48
849,6,2549,635,1914,0,0,0,1.0,1,1.0,1,1.0,1,0.18658317307517308,48
850,6,2555,635,1920,0,0,0,1.0,1,1.0,1,1.0,1,0.19011811690924432,46
851,3,2558,635,1923,0,0,0,1.0,1,1.0,1,1.0,1,0.20097372808839822,45
852,5,2563,636,1927,0,0,0,1.0,1,1.0,1,1.0,1,0.18402347763678578,44
853,5,2568,637,1931,0,0,0,1.0,1,1.0,1,1.0,1,0.17195174817758002,44
854,4,2572,639,1933,0,0,0,1.0,1,1.0,1,1.0,1,0.20517104756560642,45
855,4,2576,639,1937,0,0,0,1.0,1,1.0,1,1.0,1,0.20188083074749158,46
856,8,2584,641,1943,0,0,0,1.0,1,1.0,1,1.0,1,0.1507875368341718,46
857,3,2587,641,1946,0,0,0,1.0,1,1.0,1,1.0,1,0.12606703538663463,47
858,1,2588,641,1947,0,0,0,1.0,1,1.0,1,1.0,1,0.12807060537691717,48
859,2,2590,641,1949,0,0,0,1.0,1,1.0,1,1.0,1,0.12807060537691717,48
860,1,2591,641,1950,0,0,0,1.0,1,1.0,1,1.0,1,0.13978721625285148,49
861,2,2593,642,1951,0,0,0,1.0,1,1.0,1,1.0,1,0.14757467088261528,49
862,4,2597,644,1953,0,0,0,1.0,1,1.0,1,1.0,1,0.14565089467280234,49
863,5,2602,646,1956,0,0,0,1.0,1,1.0,1,1.0,1,0.20367511043980757,48
864,7,2609,648,1961,0,0,0,1.0,1,1.0,1,1.0,1,0.1812060445495382,49
865,5,2614,649,1965,0,0,0,1.0,1,1.0,1,1.0,1,0.21568507442276422,48
866,4,2618,650,1968,0,0,0,1.0,1,1.0,1,1.0,1,0.1792235325260334,50
867,3,2621,651,1970,0,0,0,1.0,1,1.0,1,1.0,1,0.1738654103324574,50
868,4,2625,652,1973,0,0,0,1.0,1,1.0,1,1.0,1,0.17728175975627064,51
869,5,2630,652,1978,0,0,0,1.0,1,1.0,1,1.0,1,0.18184567063399282,49
870,5,2635,654,1981,0,0,0,1.0,1,1.0,1,1.0,1,0.2109795795144672,49
871,11,2646,654,1992,0,0,0,1.0,1,1.0,1,1.0,1,0.089732313875707,49
872,5,2651,655,1996,0,0,0,1.0,1,1.0,1,1.0,1,0.07475604097363475,48
873,5,2656,656,2000,0,0,0,1.0,1,1.0,1,1.0,1,0.171522939459608,49
874,5,2661,656,2005,0,0,0,1.0,1,1.0,1,1.0,1,0.13681157175822753,49
875,10,2671,658,2013,0,0,0,1.0,1,1.0,1,1.0,1,0.133592142055707,50
876,6,2677,659,2018,0,0,0,1.0,1,1.0,1,1.0,1,0.18871296848599284,50
877,9,2686,662,2024,0,0,0,1.0,1,1.0,1,1.0,1,0.18747898277966435,50
878,5,2691,663,2028,0,0,0,1.0,1,1.0,1,1.0,1,0.17361583584936882,49
879,7,2698,664,2034,0,0,0,1.0,1,1.0,1,1.0,1,0.19044691240931114,49
880,5,2703,664,2039,0,0,0,1.0,1,1.0,1,1.0,1,0.18798568360881293,48
881,6,2709,664,2045,0,0,0,1.0,1,1.0,1,1.0,1,0.19914456575301648,49
882,2,2711,664,2047,0,0,0,1.0,1,1.0,1,1.0,1,0.20007064241980216,48
883,7,2718,664,2054,0,0,0,1.0,1,1.0,1,1.0,1,0.2191781293231269,50
884,8,2726,664,2062,0,0,0,1.0,1,1.0,1,1.0,1,0.24998740138150935,50
885,13,2739,665,2074,0,0,0,1.0,1,1.0,1,1.0,1,0.2655350700162198,49
886,11,2750,666,2084,0,0,0,1.0,1,1.0,1,1.0,1,0.1258328917021518,49
887,1,2751,666,2085,0,0,0,1.0,1,1.0,1,1.0,1,0.12929603269210685,49
888,0,2751,666,2085,0,0,0,1.0,1,1.0,1,1.0,1,0.14758612725143863,47
889,1,2752,667,2085,0,0,0,1.0,1,1.0,1,1.0,1,0.1747635669285489,46
890,0,2752,667,2085,0,0,0,1.0,1,1.0,1,1.0,1,0.14799115214163427,44
891,1,2753,668,2085,0,0,0,1.0,1,1.0,1,1.0,1,0.19202202208271868,45
892,8,2761,669,2092,0,0,0,1.0,1,1.0,1,1.0,1,0.19694603241291206,45
893,0,2761,669,2092,0,0,0,1.0,1,1.0,1,1.0,1,0.19694603241291206,45
894,0,2761,669,2092,0,0,0,1.0,1,1.0,1,1.0,1,0.21510140270556724,44
895,2,2763,669,2094,0,0,0,1.0,1,1.0,1,1.0,1,0.22306577459142987,45
896,1,2764,670,2094,0,0,0,1.0,1,1.0,1,1.0,1,0.2431982883046804,44
897,1,2765,670,2095,0,0,0,1.0,1,1.0,1,1.0,1,0.1998017542524489,44
898,0,2765,670,2095,0,0,0,1.0,1,1.0,1,1.0,1,0.20278507340739665,45
899,0,2765,670,2095,0,0,0,1.0,1,1.0,1,1.0,1,0.19887896879236786,44
900,3,2768,670,2098,0,0,0,1.0,1,1.0,1,1.0,1,0.19541976017086315,46
901,2,2770,670,2100,0,0,0,1.0,1,1.0,1,1.0,1,0.16335528288081064,45
902,4,2774,673,2101,0,0,0,1.0,1,1.0,1,1.0,1,0.17855475510530053,45
903,1,2775,673,2102,0,0,0,1.0,1,1.0,1,1.0,1,0.17835347404634228,44
904,2,2777,673,2104,0,0,0,1.0,1,1.0,1,1.0,1,0.1641966168448419,45
905,1,2778,673,2105,0,0,0,1.0,1,1.0,1,1.0,1,0.18244024978615572,45
906,1,2779,674,2105,0,0,0,1.0,1,1.0,1,1.0,1,0.20963518723876703,45
907,4,2783,675,2108,0,0,0,1.0,1,1.0,1,1.0,1,0.17473997270566013,46
908,0,2783,675,2108,0,0,0,1.0,1,1.0,1,1.0,1,0.16672505138309954,46
909,5,2788,679,2109,0,0,0,1.0,1,1.0,1,1.0,1,0.15537320717029435,46
910,2,2790,679,2111,0,0,0,1.0,1,1.0,1,1.0,1,0.17936577980234505,44
911,3,2793,680,2113,0,0,0,1.0,1,1.0,1,1.0,1,0.1840851957280948,45
912,1,2794,680,2114,0,0,0,1.0,1,1.0,1,1.0,1,0.18798633791773742,44
913,2,2796,680,2116,0,0,0,1.0,1,1.0,1,1.0,1,0.20589191396701695,45
914,3,2799,680,2119,0,0,0,1.0,1,1.0,1,1.0,1,0.21593656773461706,45
915,5,2804,681,2123,0,0,0,1.0,1,1.0,1,1.0,1,0.20856397003658092,45
916,6,2810,681,2129,0,0,0,1.0,1,1.0,1,1.0,1,0.10009906152398589,45
917,4,2814,681,2133,0,0,0,1.0,1,1.0,1,1.0,1,0.09360688235707916,46
918,3,2817,681,2136,0,0,0,1.0,1,1.0,1,1.0,1,0.0833089111379269,47
919,2,2819,681,2138,0,0,0,1.0,1,1.0,1,1.0,1,0.0833089111379269,47
920,1,2820,681,2139,0,0,0,1.0,1,1.0,1,1.0,1,0.08808262124174736,47
921,5,2825,683,2142,0,0,0,1.0,1,1.0,1,1.0,1,0.17580853578116484,49
922,5,2830,683,2147,0,0,0,1.0,1,1.0,1,1.0,1,0.12941879485994395,49
923,5,2835,684,2151,0,0,0,1.0,1,1.0,1,1.0,1,0.13210578314262544,47
924,3,2838,684,2154,0,0,0,1.0,1,1.0,1,1.0,1,0.10639275719010996,47
925,6,2844,686,2158,0,0,0,1.0,1,1.0,1,1.0,1,0.17111908560771535,47
926,12,2856,689,2167,0,0,0,1.0,1,1.0,1,1.0,1,0.22097659373839065,46
927,9,2865,690,2175,0,0,0,1.0,1,1.0,1,1.0,1,0.21522759289423787,45
928,5,2870,691,2179,0,0,0,1.0,1,1.0,1,1.0,1,0.22792205781330532,43
929,4,2874,691,2183,0,0,0,1.0,1,1.0,1,1.0,1,0.22128519386275752,42
930,9,2883,692,2191,0,0,0,1.0,1,1.0,1,1.0,1,0.23285199247153085,41
931,4,2887,693,2194,0,0,0,1.0,1,1.0,1,1.0,1,0.20665297862353582,40
932,1,2888,693,2195,0,0,0,1.0,1,1.0,1,1.0,1,0.1945073284952937,40
933,2,2890,695,2195,0,0,0,1.0,1,1.0,1,1.0,1,0.2536589276380534,39
934,6,2896,696,2200,0,0,0,1.0,1,1.0,1,1.0,1,0.22293386287713432,39
935,5,2901,698,2203,0,0,0,1.0,1,1.0,1,1.0,1,0.21779151638632113,41
936,4,2905,698,2207,0,0,0,1.0,1,1.0,1,1.0,1,0.19039993948632375,42
937,5,2910,698,2212,0,0,0,1.0,1,1.0,1,1.0,1,0.17717679507064685,43
938,7,2917,698,2219,0,0,0,1.0,1,1.0,1,1.0,1,0.20249705708883747,44
939,9,2926,698,2228,0,0,0,1.0,1,1.0,1,1.0,1,0.27705830678820553,46
940,8,2934,698,2236,0,0,0,1.0,1,1.0,1,1.0,1,0.27287030435003357,46
941,7,2941,698,2243,0,0,0,1.0,1,1.0,1,1.0,1,0.20716115951368064,46
942,6,2947,699,2248,0,0,0,1.0,1,1.0,1,1.0,1,0.26900902420707756,46
943,6,2953,700,2253,0,0,0,1.0,1,1.0,1,1.0,1,0.24516584684798567,45
944,6,2959,702,2257,0,0,0,1.0,1,1.0,1,1.0,1,0.2628087600926357,45
945,7,2966,703,2263,0,0,0,1.0,1,1.0,1,1.0,1,0.18172071355043282,44
946,8,2974,705,2269,0,0,0,1.0,1,1.0,1,1.0,1,0.10493697782432983,46
947,0,2974,705,2269,0,0,0,1.0,1,1.0,1,1.0,1,0.13425806408913932,44
948,0,2974,705,2269,0,0,0,1.0,1,1.0,1,1.0,1,0.13425806408913932,44
949,6,2980,707,2273,0,0,0,1.0,1,1.0,1,1.0,1,0.20298079078868705,44
950,1,2981,708,2273,0,0,0,1.0,1,1.0,1,1.0,1,0.26473835755353053,43
951,4,2985,708,2277,0,0,0,1.0,1,1.0,1,1.0,1,0.2587589868302312,42
952,2,2987,709,2278,0,0,0,1.0,1,1.0,1,1.0,1,0.2624862787633523,42
953,0,2987,709,2278,0,0,0,1.0,1,1.0,1,1.0,1,0.2503465802350243,41
954,1,2988,710,2278,0,0,0,1.0,1,1.0,1,1.0,1,0.24303920158918804,40
955,1,2989,710,2279,0,0,0,1.0,1,1.0,1,1.0,1,0.19646834727494714,42
956,3,2992,712,2280,0,0,0,1.0,1,1.0,1,1.0,1,0.17765367513584804,43
957,1,2993,712,2281,0,0,0,1.0,1,1.0,1,1.0,1,0.18258120944995038,42
958,2,2995,712,2283,0,0,0,1.0,1,1.0,1,1.0,1,0.20630983899408878,43
959,1,2996,712,2284,0,0,0,1.0,1,1.0,1,1.0,1,0.17860059476001774,45
960,3,2999,713,2286,0,0,0,1.0,1,1.0,1,1.0,1,0.1973466596675492,47
961,2,3001,713,2288,0,0,0,1.0,1,1.0,1,1.0,1,0.14542801884640852,45
962,1,3002,713,2289,0,0,0,1.0,1,1.0,1,1.0,1,0.13875353109787436,45
963,2,3004,714,2290,0,0,0,1.0,1,1.0,1,1.0,1,0.17334321211929116,44
964,0,3004,714,2290,0,0,0,1.0,1,1.0,1,1.0,1,0.161186192566921,44
965,1,3005,714,2291,0,0,0,1.0,1,1.0,1,1.0,1,0.16444603637692942,45
966,2,3007,715,2292,0,0,0,1.0,1,1.0,1,1.0,1,0.16805342070280962,43
967,1,3008,716,2292,0,0,0,1.0,1,1.0,1,1.0,1,0.16258778809400196,43
968,1,3009,717,2292,0,0,0,1.0,1,1.0,1,1.0,1,0.18744829666412988,43
969,3,3012,718,2294,0,0,0,1.0,1,1.0,1,1.0,1,0.20353614803642472,42
970,2,3014,718,2296,0,0,0,1.0,1,1.0,1,1.0,1,0.194902082675366,42
971,2,3016,718,2298,0,0,0,1.0,1,1.0,1,1.0,1,0.194902082675366,42
972,3,3019,719,2300,0,0,0,1.0,1,1.0,1,1.0,1,0.15859729531722497,42
973,1,3020,719,2301,0,0,0,1.0,1,1.0,1,1.0,1,0.15151887002337389,43
974,5,3025,720,2305,0,0,0,1.0,1,1.0,1,1.0,1,0.14579335939010565,43
975,4,3029,720,2309,0,0,0,1.0,1,1.0,1,1.0,1,0.1458107378218985,43
976,4,3033,721,2312,0,0,0,1.0,1,1.0,1,1.0,1,0.11934234308124007,45
977,0,3033,721,2312,0,0,0,1.0,1,1.0,1,1.0,1,0.13704204331462277,44
978,1,3034,721,2313,0,0,0,1.0,1,1.0,1,1.0,1,0.10172063340452597,44
979,0,3034,721,2313,0,0,0,1.0,1,1.0,1,1.0,1,0.11729236718602752,45
980,1,3035,722,2313,0,0,0,1.0,1,1.0,1,1.0,1,0.14501039669991814,45
981,0,3035,722,2313,0,0,0,1.0,1,1.0,1,1.0,1,0.14501039669991814,45
982,3,3038,724,2314,0,0,0,1.0,1,1.0,1,1.0,1,0.2083906096521227,46
983,3,3041,725,2316,0,0,0,1.0,1,1.0,1,1.0,1,0.1920912243349135,45
984,1,3042,726,2316,0,0,0,1.0,1,1.0,1,1.0,1,0.1883485825261144,45
985,6,3048,730,2318,0,0,0,1.0,1,1.0,1,1.0,1,0.2276124035775528,45
986,1,3049,731,2318,0,0,0,1.0,1,1.0,1,1.0,1,0.23597598911671158,44
987,4,3053,732,2321,0,0,0,1.0,1,1.0,1,1.0,1,0.24267914441369906,45
988,4,3057,734,2323,0,0,0,1.0,1,1.0,1,1.0,1,0.24813687036969365,44
989,2,3059,735,2324,0,0,0,1.0,1,1.0,1,1.0,1,0.23844229012894375,43
990,3,3062,737,2325,0,0,0,1.0,1,1.0,1,1.0,1,0.24581655402455216,42
991,3,3065,737,2328,0,0,0,1.0,1,1.0,1,1.0,1,0.1662901315431032,42
992,1,3066,737,2329,0,0,0,1.0,1,1.0,1,1.0,1,0.14294709457518542,43
993,2,3068,739,2329,0,0,0,1.0,1,1.0,1,1.0,1,0.19801061000379894,43
994,2,3070,739,2331,0,0,0,1.0,1,1.0,1,1.0,1,0.1548323090120554,43
995,0,3070,739,2331,0,0,0,1.0,1,1.0,1,1.0,1,0.1546204659781324,43
996,1,3071,739,2332,0,0,0,1.0,1,1.0,1,1.0,1,0.14525892384988257,44
997,1,3072,740,2332,0,0,0,1.0,1,1.0,1,1.0,1,0.17700806030270028,44
998,2,3074,740,2334,0,0,0,1.0,1,1.0,1,1.0,1,0.16916974017235295,45
999,0,3074,740,2334,0,0,0,1.0,1,1.0,1,1.0,1,0.16473853639205166,42
1000,0,3074,740,2334,0,0,0,1.0,1,1.0,1,1.0,1,0.1792708695256668,43
1001,0,3074,740,2334,0,0,0,1.0,1,1.0,1,1.0,1,0.18307528270907095,42
1002,1,3075,740,2335,0,0,0,1.0,1,1.0,1,1.0,1,0.1622808366173507,43
1003,0,3075,740,2335,0,0,0,1.0,1,1.0,1,1.0,1,0.1622808366173507,43
1004,1,3076,740,2336,0,0,0,1.0,1,1.0,1,1.0,1,0.16785385901622832,43
1005,0,3076,740,2336,0,0,0,1.0,1,1.0,1,1.0,1,0.16384037504925802,44
1006,1,3077,740,2337,0,0,0,1.0,1,1.0,1,1.0,1,0.15005149595791542,46
1007,3,3080,740,2340,0,0,0,1.0,1,1.0,1,1.0,1,0.10794116590821777,46
1008,1,3081,740,2341,0,0,0,1.0,1,1.0,1,1.0,1,0.11374247917277758,47
1009,3,3084,740,2344,0,0,0,1.0,1,1.0,1,1.0,1,0.12475132292379906,48
1010,0,3084,740,2344,0,0,0,1.0,1,1.0,1,1.0,1,0.12475132292379906,48
1011,1,3085,740,2345,0,0,0,1.0,1,1.0,1,1.0,1,0.11313342503369525,48
1012,6,3091,742,2349,0,0,0,1.0,1,1.0,1,1.0,1,0.15162199316544223,49
1013,4,3095,744,2351,0,0,0,1.0,1,1.0,1,1.0,1,0.1839622944545678,50
1014,4,3099,744,2355,0,0,0,1.0,1,1.0,1,1.0,1,0.18063137509642693,50
1015,5,3104,744,2360,0,0,0,1.0,1,1.0,1,1.0,1,0.16279501514437245,51
1016,7,3111,744,2367,0,0,0,1.0,1,1.0,1,1.0,1,0.16571310524813,51
1017,8,3119,744,2375,0,0,0,1.0,1,1.0,1,1.0,1,0.17133843789905348,52
1018,5,3124,746,2378,0,0,0,1.0,1,1.0,1,1.0,1,0.18435444832161602,52
1019,8,3132,748,2384,0,0,0,1.0,1,1.0,1,1.0,1,0.19256413947190468,52
1020,7,3139,748,2391,0,0,0,1.0,1,1.0,1,1.0,1,0.13255043009741788,53
1021,6,3145,748,2397,0,0,0,1.0,1,1.0,1,1.0,1,0.08737587334394865,53
1022,1,3146,748,2398,0,0,0,1.0,1,1.0,1,1.0,1,0.09738669439555231,54
1023,3,3149,749,2400,0,0,0,1.0,1,1.0,1,1.0,1,0.08318403649706463,55
1024,4,3153,751,2402,0,0,0,1.0,1,1.0,1,1.0,1,0.11582631411343984,55
1025,1,3154,751,2403,0,0,0,1.0,1,1.0,1,1.0,1,0.11064274553738306,56
1026,3,3157,752,2405,0,0,0,1.0,1,1.0,1,1.0,1,0.14553663165590985,57
1027,1,3158,752,2406,0,0,0,1.0,1,1.0,1,1.0,1,0.15041007769026646,58
1028,4,3162,752,2410,0,0,0,1.0,1,1.0,1,1.0,1,0.1395445089488126,58
1029,5,3167,752,2415,0,0,0,1.0,1,1.0,1,1.0,1,0.12449178552627313,59
1030,5,3172,752,2420,0,0,0,1.0,1,1.0,1,1.0,1,0.16278266300045713,60
1031,4,3176,752,2424,0,0,0,1.0,1,1.0,1,1.0,1,0.16278266300045713,60
1032,1,3177,752,2425,0,0,0,1.0,1,1.0,1,1.0,1,0.1507951950505599,61
1033,4,3181,754,2427,0,0,0,1.0,1,1.0,1,1.0,1,0.14322043652257016,60
1034,3,3184,755,2429,0,0,0,1.0,1,1.0,1,1.0,1,0.15829335384182694,60
1035,2,3186,756,2430,0,0,0,1.0,1,1.0,1,1.0,1,0.1444804217349989,59
1036,5,3191,759,2432,0,0,0,1.0,1,1.0,1,1.0,1,0.12462845647474462,60
1037,4,3195,762,2433,0,0,0,1.0,1,1.0,1,1.0,1,0.12581598108913808,59
1038,7,3202,765,2437,0,0,0,1.0,1,1.0,1,1.0,1,0.12935404473413828,60
1039,5,3207,767,2440,0,0,0,1.0,1,1.0,1,1.0,1,0.12053327800334221,60
1040,0,3207,767,2440,0,0,0,1.0,1,1.0,1,1.0,1,0.14670838416175686,58
1041,1,3208,768,2440,0,0,0,1.0,1,1.0,1,1.0,1,0.1433280113242752,56
1042,1,3209,768,2441,0,0,0,1.0,1,1.0,1,1.0,1,0.12921203687534324,55
1043,1,3210,768,2442,0,0,0,1.0,1,1.0,1,1.0,1,0.1220260889610019,55
1044,0,3210,768,2442,0,0,0,1.0,1,1.0,1,1.0,1,0.109776169835696,52
1045,0,3210,768,2442,0,0,0,1.0,1,1.0,1,1.0,1,0.11412309632414508,52
1046,2,3212,769,2443,0,0,0,1.0,1,1.0,1,1.0,1,0.14921594890034182,53
1047,1,3213,769,2444,0,0,0,1.0,1,1.0,1,1.0,1,0.14437109486671765,54
1048,3,3216,771,2445,0,0,0,1.0,1,1.0,1,1.0,1,0.15575703930384777,56
1049,3,3219,772,2447,0,0,0,1.0,1,1.0,1,1.0,1,0.15873468238506963,55
1050,1,3220,772,2448,0,0,0,1.0,1,1.0,1,1.0,1,0.1697854176581893,56
1051,9,3229,772,2457,0,0,0,1.0,1,1.0,1,1.0,1,0.1225636706333768,55
1052,5,3234,772,2462,0,0,0,1.0,1,1.0,1,1.0,1,0.08672965531417086,56
1053,10,3244,774,2470,0,0,0,1.0,1,1.0,1,1.0,1,0.0820222093165958,56
1054,7,3251,775,2476,0,0,0,1.0,1,1.0,1,1.0,1,0.08924680822315616,57
1055,4,3255,775,2480,0,0,0,1.0,1,1.0,1,1.0,1,0.08935239107907884,58
1056,6,3261,775,2486,0,0,0,1.0,1,1.0,1,1.0,1,0.09632126406119074,59
1057,8,3269,775,2494,0,0,0,1.0,1,1.0,1,1.0,1,0.10570201156881402,60
1058,4,3273,776,2497,0,0,0,1.0,1,1.0,1,1.0,1,0.16066709934867535,60
1059,7,3280,776,2504,0,0,0,1.0,1,1.0,1,1.0,1,0.14622097226030384,60
1060,8,3288,777,2511,0,0,0,1.0,1,1.0,1,1.0,1,0.1497061984792754,60
1061,7,3295,779,2516,0,0,0,1.0,1,1.0,1,1.0,1,0.22526320309520326,59
1062,15,3310,781,2529,0,0,0,1.0,1,1.0,1,1.0,1,0.2610996842418669,59
1063,15,3325,784,2541,0,0,0,1.0,1,1.0,1,1.0,1,0.3286847531359134,58
1064,15,3340,785,2555,0,0,0,1.0,1,1.0,1,1.0,1,0.3088166475244367,58
1065,10,3350,786,2564,0,0,0,1.0,1,1.0,1,1.0,1,0.29555048102527354,60
1066,17,3367,788,2579,0,0,0,1.0,1,1.0,1,1.0,1,0.13379392073677818,58
1067,3,3370,789,2581,0,0,0,1.0,1,1.0,1,1.0,1,0.14973061873368898,59
1068,3,3373,789,2584,0,0,0,1.0,1,1.0,1,1.0,1,0.14165225882755164,59
1069,1,3374,789,2585,0,0,0,1.0,1,1.0,1,1.0,1,0.16541271608431443,58
1070,7,3381,790,2591,0,0,0,1.0,1,1.0,1,1.0,1,0.15180500673270755,58
1071,5,3386,791,2595,0,0,0,1.0,1,1.0,1,1.0,1,0.17067689877533637,57
1072,7,3393,791,2602,0,0,0,1.0,1,1.0,1,1.0,1,0.17371410005355473,56
1073,4,3397,791,2606,0,0,0,1.0,1,1.0,1,1.0,1,0.1892899244294821,54
1074,3,3400,792,2608,0,0,0,1.0,1,1.0,1,1.0,1,0.19589648916052058,54
1075,4,3404,792,2612,0,0,0,1.0,1,1.0,1,1.0,1,0.19258602222276397,51
1076,9,3413,794,2619,0,0,0,1.0,1,1.0,1,1.0,1,0.22976458366701552,51
1077,7,3420,794,2626,0,0,0,1.0,1,1.0,1,1.0,1,0.2377960363529202,51
1078,7,3427,795,2632,0,0,0,1.0,1,1.0,1,1.0,1,0.2422045749597613,52
1079,6,3433,796,2637,0,0,0,1.0,1,1.0,1,1.0,1,0.26210731020618416,51
1080,7,3440,797,2643,0,0,0,1.0,1,1.0,1,1.0,1,0.24195363065855918,51
1081,9,3449,797,2652,0,0,0,1.0,1,1.0,1,1.0,1,0.18506784340000204,48
1082,1,3450,798,2652,0,0,0,1.0,1,1.0,1,1.0,1,0.23427995435139443,47
1083,6,3456,800,2656,0,0,0,1.0,1,1.0,1,1.0,1,0.2662289277684289,46
1084,2,3458,800,2658,0,0,0,1.0,1,1.0,1,1.0,1,0.240968230041553,45
1085,6,3464,800,2664,0,0,0,1.0,1,1.0,1,1.0,1,0.22420453979885688,46
1086,4,3468,800,2668,0,0,0,1.0,1,1.0,1,1.0,1,0.20514335518445415,45
1087,2,3470,800,2670,0,0,0,1.0,1,1.0,1,1.0,1,0.22139871260464386,44
1088,4,3474,800,2674,0,0,0,1.0,1,1.0,1,1.0,1,0.25219459796704563,45
1089,3,3477,801,2676,0,0,0,1.0,1,1.0,1,1.0,1,0.2210810577523658,46
1090,4,3481,801,2680,0,0,0,1.0,1,1.0,1,1.0,1,0.205773880647047,47
1091,4,3485,803,2682,0,0,0,1.0,1,1.0,1,1.0,1,0.22228292706854383,47
1092,2,3487,803,2684,0,0,0,1.0,1,1.0,1,1.0,1,0.2116808477433718,48
1093,4,3491,804,2687,0,0,0,1.0,1,1.0,1,1.0,1,0.20230578895491266,48
1094,5,3496,805,2691,0,0,0,1.0,1,1.0,1,1.0,1,0.2200482754133914,48
1095,3,3499,805,2694,0,0,0,1.0,1,1.0,1,1.0,1,0.2167375173648381,49
1096,7,3506,806,2700,0,0,0,1.0,1,1.0,1,1.0,1,0.12813249586209835,49
1097,1,3507,807,2700,0,0,0,1.0,1,1.0,1,1.0,1,0.13914724146892893,50
1098,1,3508,807,2701,0,0,0,1.0,1,1.0,1,1.0,1,0.14453072517468757,51
1099,0,3508,807,2701,0,0,0,1.0,1,1.0,1,1.0,1,0.1405546761019112,54
1100,0,3508,807,2701,0,0,0,1.0,1,1.0,1,1.0,1,0.1405546761019112,54
1101,2,3510,807,2703,0,0,0,1.0,1,1.0,1,1.0,1,0.14044497746499182,54
1102,0,3510,807,2703,0,0,0,1.0,1,1.0,1,1.0,1,0.13330623646505554,54
1103,4,3514,809,2705,0,0,0,1.0,1,1.0,1,1.0,1,0.1400148661053104,53
1104,4,3518,812,2706,0,0,0,1.0,1,1.0,1,1.0,1,0.1616087334482044,53
1105,7,3525,814,2711,0,0,0,1.0,1,1.0,1,1.0,1,0.16160150878540452,52
1106,7,3532,816,2716,0,0,0,1.0,1,1.0,1,1.0,1,0.16365817678388433,52
1107,5,3537,817,2720,0,0,0,1.0,1,1.0,1,1.0,1,0.16428225587941778,52
1108,3,3540,819,2721,0,0,0,1.0,1,1.0,1,1.0,1,0.1911830935255587,51
1109,1,3541,820,2721,0,0,0,1.0,1,1.0,1,1.0,1,0.21421164948987567,49
1110,1,3542,821,2721,0,0,0,1.0,1,1.0,1,1.0,1,0.24061720465000258,48
1111,10,3552,823,2729,0,0,0,1.0,1,1.0,1,1.0,1,0.24383909423444206,47
1112,6,3558,824,2734,0,0,0,1.0,1,1.0,1,1.0,1,0.21609334946307762,46
1113,4,3562,826,2736,0,0,0,1.0,1,1.0,1,1.0,1,0.2327949309505975,43
1114,3,3565,827,2738,0,0,0,1.0,1,1.0,1,1.0,1,0.25358764916250764,41
1115,6,3571,828,2743,0,0,0,1.0,1,1.0,1,1.0,1,0.22716945782888903,40
1116,6,3577,829,2748,0,0,0,1.0,1,1.0,1,1.0,1,0.21016599088718774,39
1117,4,3581,830,2751,0,0,0,1.0,1,1.0,1,1.0,1,0.26622056525108423,40
1118,5,3586,830,2756,0,0,0,1.0,1,1.0,1,1.0,1,0.20846601213521593,40
1119,9,3595,831,2764,0,0,0,1.0,1,1.0,1,1.0,1,0.2951210495853246,40
1120,9,3604,833,2771,0,0,0,1.0,1,1.0,1,1.0,1,0.2916244584943365,40
1121,10,3614,834,2780,0,0,0,1.0,1,1.0,1,1.0,1,0.31341865255791795,40
1122,10,3624,835,2789,0,0,0,1.0,1,1.0,1,1.0,1,0.31848262202876876,41
1123,7,3631,835,2796,0,0,0,1.0,1,1.0,1,1.0,1,0.35439013765142174,41
1124,7,3638,835,2803,0,0,0,1.0,1,1.0,1,1.0,1,0.36351268073812004,41
1125,9,3647,837,2810,0,0,0,1.0,1,1.0,1,1.0,1,0.4080603602377936,41
1126,9,3656,837,2819,0,0,0,1.0,1,1.0,1,1.0,1,0.2234508005960926,41
1127,3,3659,837,2822,0,0,0,1.0,1,1.0,1,1.0,1,0.18428878686445593,41
1128,6,3665,837,2828,0,0,0,1.0,1,1.0,1,1.0,1,0.17042322118454886,42
1129,4,3669,837,2832,0,0,0,1.0,1,1.0,1,1.0,1,0.1680068603275147,42
1130,5,3674,837,2837,0,0,0,1.0,1,1.0,1,1.0,1,0.16158792307674572,42
1131,1,3675,837,2838,0,0,0,1.0,1,1.0,1,1.0,1,0.16787688614215068,42
1132,6,3681,837,2844,0,0,0,1.0,1,1.0,1,1.0,1,0.11504962887017041,43
1133,4,3685,837,2848,0,0,0,1.0,1,1.0,1,1.0,1,0.11578958927876766,45
1134,2,3687,837,2850,0,0,0,1.0,1,1.0,1,1.0,1,0.12466727863201083,46
1135,2,3689,837,2852,0,0,0,1.0,1,1.0,1,1.0,1,0.11904047807470801,45
1136,1,3690,837,2853,0,0,0,1.0,1,1.0,1,1.0,1,0.1347031045980944,48
1137,4,3694,837,2857,0,0,0,1.0,1,1.0,1,1.0,1,0.14998290175892948,49
1138,3,3697,837,2860,0,0,0,1.0,1,1.0,1,1.0,1,0.15551012503595643,49
1139,2,3699,837,2862,0,0,0,1.0,1,1.0,1,1.0,1,0.16093887275057345,49
1140,1,3700,837,2863,0,0,0,1.0,1,1.0,1,1.0,1,0.15355336917423165,49
1141,2,3702,837,2865,0,0,0,1.0,1,1.0,1,1.0,1,0.15767199003098772,48
1142,7,3709,840,2869,0,0,0,1.0,1,1.0,1,1.0,1,0.13485069549410372,48
1143,1,3710,841,2869,0,0,0,1.0,1,1.0,1,1.0,1,0.17726069381542542,48
1144,4,3714,843,2871,0,0,0,1.0,1,1.0,1,1.0,1,0.1398425479082348,48
1145,1,3715,844,2871,0,0,0,1.0,1,1.0,1,1.0,1,0.17686466393332367,48
1146,2,3717,845,2872,0,0,0,1.0,1,1.0,1,1.0,1,0.14891774344389946,48
1147,1,3718,845,2873,0,0,0,1.0,1,1.0,1,1.0,1,0.16909435072392748,46
1148,2,3720,847,2873,0,0,0,1.0,1,1.0,1,1.0,1,0.13003187403785518,46
1149,2,3722,848,2874,0,0,0,1.0,1,1.0,1,1.0,1,0.24294575437561292,45
1150,5,3727,851,2876,0,0,0,1.0,1,1.0,1,1.0,1,0.24233337045775424,46
1151,3,3730,853,2877,0,0,0,1.0,1,1.0,1,1.0,1,0.26728495404465225,44
1152,3,3733,854,2879,0,0,0,1.0,1,1.0,1,1.0,1,0.25767858288052936,44
1153,6,3739,856,2883,0,0,0,1.0,1,1.0,1,1.0,1,0.2519821224161755,43
1154,3,3742,858,2884,0,0,0,1.0,1,1.0,1,1.0,1,0.22582971034609425,43
1155,3,3745,859,2886,0,0,0,1.0,1,1.0,1,1.0,1,0.2634997301075054,43
1156,4,3749,859,2890,0,0,0,1.0,1,1.0,1,1.0,1,0.18993985715254752,42
1157,0,3749,859,2890,0,0,0,1.0,1,1.0,1,1.0,1,0.19164127108468756,42
1158,0,3749,859,2890,0,0,0,1.0,1,1.0,1,1.0,1,0.18038888769493963,41
1159,0,3749,859,2890,0,0,0,1.0,1,1.0,1,1.0,1,0.18213100551025932,41
1160,1,3750,859,2891,0,0,0,1.0,1,1.0,1,1.0,1,0.18911428169372388,41
1161,2,3752,859,2893,0,0,0,1.0,1,1.0,1,1.0,1,0.17759748430480785,42
1162,5,3757,859,2898,0,0,0,1.0,1,1.0,1,1.0,1,0.1381371742506043,43
1163,2,3759,859,2900,0,0,0,1.0,1,1.0,1,1.0,1,0.12958516714644028,43
1164,2,3761,859,2902,0,0,0,1.0,1,1.0,1,1.0,1,0.11940933356052315,44
1165,0,3761,859,2902,0,0,0,1.0,1,1.0,1,1.0,1,0.11940933356052315,44
1166,4,3765,860,2905,0,0,0,1.0,1,1.0,1,1.0,1,0.13942931914657866,46
1167,5,3770,861,2909,0,0,0,1.0,1,1.0,1,1.0,1,0.12633086445743388,46
1168,9,3779,861,2918,0,0,0,1.0,1,1.0,1,1.0,1,0.09710902391477386,47
1169,5,3784,861,2923,0,0,0,1.0,1,1.0,1,1.0,1,0.13307699128290953,46
1170,7,3791,862,2929,0,0,0,1.0,1,1.0,1,1.0,1,0.13964299857001786,48
1171,5,3796,863,2933,0,0,0,1.0,1,1.0,1,1.0,1,0.08321352961034413,49
1172,2,3798,863,2935,0,0,0,1.0,1,1.0,1,1.0,1,0.08321352961034413,49
1173,2,3800,863,2937,0,0,0,1.0,1,1.0,1,1.0,1,0.08321352961034413,49
1174,2,3802,864,2938,0,0,0,1.0,1,1.0,1,1.0,1,0.09636770188875064,49
1175,3,3805,864,2941,0,0,0,1.0,1,1.0,1,1.0,1,0.08793325560645851,50
1176,0,3805,864,2941,0,0,0,1.0,1,1.0,1,1.0,1,0.10879296799487498,52
1177,3,3808,865,2943,0,0,0,1.0,1,1.0,1,1.0,1,0.1324395101151181,52
1178,1,3809,865,2944,0,0,0,1.0,1,1.0,1,1.0,1,0.12528226421055558,52
1179,0,3809,865,2944,0,0,0,1.0,1,1.0,1,1.0,1,0.11259006669848337,53
1180,1,3810,865,2945,0,0,0,1.0,1,1.0,1,1.0,1,0.10640091193173598,54
1181,3,3813,865,2948,0,0,0,1.0,1,1.0,1,1.0,1,0.11741833430885906,55
1182,5,3818,867,2951,0,0,0,1.0,1,1.0,1,1.0,1,0.15293590692931905,55
1183,9,3827,868,2959,0,0,0,1.0,1,1.0,1,1.0,1,0.15115282291474152,53
1184,7,3834,870,2964,0,0,0,1.0,1,1.0,1,1.0,1,0.1559992918753064,54
1185,4,3838,870,2968,0,0,0,1.0,1,1.0,1,1.0,1,0.16555355428396853,53
1186,6,3844,871,2973,0,0,0,1.0,1,1.0,1,1.0,1,0.14955889272878292,54
1187,1,3845,872,2973,0,0,0,1.0,1,1.0,1,1.0,1,0.18426290086514496,55
1188,0,3845,872,2973,0,0,0,1.0,1,1.0,1,1.0,1,0.18426290086514496,55
1189,2,3847,872,2975,0,0,0,1.0,1,1.0,1,1.0,1,0.15216357341297082,54
1190,1,3848,872,2976,0,0,0,1.0,1,1.0,1,1.0,1,0.14180311684359873,55
1191,3,3851,872,2979,0,0,0,1.0,1,1.0,1,1.0,1,0.142182186430934,54
1192,9,3860,875,2985,0,0,0,1.0,1,1.0,1,1.0,1,0.19349845249200695,52
1193,7,3867,875,2992,0,0,0,1.0,1,1.0,1,1.0,1,0.16517714157622748,53
1194,5,3872,876,2996,0,0,0,1.0,1,1.0,1,1.0,1,0.18285170086447697,53
1195,7,3879,877,3002,0,0,0,1.0,1,1.0,1,1.0,1,0.14737579550046298,54
1196,5,3884,877,3007,0,0,0,1.0,1,1.0,1,1.0,1,0.13243294896418153,56
1197,5,3889,879,3010,0,0,0,1.0,1,1.0,1,1.0,1,0.12688085540778593,56
1198,5,3894,880,3014,0,0,0,1.0,1,1.0,1,1.0,1,0.14766493257696747,58
1199,6,3900,881,3019,0,0,0,1.0,1,1.0,1,1.0,1,0.14765150231320257,58
1200,3,3903,881,3022,0,0,0,1.0,1,1.0,1,1.0,1,0.15108889556153896,58
1201,8,3911,883,3028,0,0,0,1.0,1,1.0,1,1.0,1,0.10087816172349673,58
1202,4,3915,884,3031,0,0,0,1.0,1,1.0,1,1.0,1,0.11080274240220449,60
1203,3,3918,884,3034,0,0,0,1.0,1,1.0,1,1.0,1,0.12092375496079096,58
1204,2,3920,885,3035,0,0,0,1.0,1,1.0,1,1.0,1,0.13014724874727587,59
1205,3,3923,886,3037,0,0,0,1.0,1,1.0,1,1.0,1,0.15131757123214273,59
1206,5,3928,886,3042,0,0,0,1.0,1,1.0,1,1.0,1,0.14250917296721258,58
1207,3,3931,886,3045,0,0,0,1.0,1,1.0,1,1.0,1,0.177537117905711,60
1208,3,3934,886,3048,0,0,0,1.0,1,1.0,1,1.0,1,0.1422005463624983,60
1209,4,3938,886,3052,0,0,0,1.0,1,1.0,1,1.0,1,0.13075736330166648,61
1210,1,3939,886,3053,0,0,0,1.0,1,1.0,1,1.0,1,0.14227789665883392,61
1211,2,3941,886,3055,0,0,0,1.0,1,1.0,1,1.0,1,0.09729132802977664,63
1212,2,3943,886,3057,0,0,0,1.0,1,1.0,1,1.0,1,0.09729132802977664,63
1213,3,3946,887,3059,0,0,0,1.0,1,1.0,1,1.0,1,0.10893788501041621,63
1214,6,3952,888,3064,0,0,0,1.0,1,1.0,1,1.0,1,0.1494497848474472,62
1215,9,3961,888,3073,0,0,0,1.0,1,1.0,1,1.0,1,0.16041603042814814,63
1216,8,3969,888,3081,0,0,0,1.0,1,1.0,1,1.0,1,0.08721026815735289,64
1217,2,3971,888,3083,0,0,0,1.0,1,1.0,1,1.0,1,0.094208624132407,65
1218,3,3974,889,3085,0,0,0,1.0,1,1.0,1,1.0,1,0.11140369962101818,64
1219,0,3974,889,3085,0,0,0,1.0,1,1.0,1,1.0,1,0.11916053164278223,65
1220,0,3974,889,3085,0,0,0,1.0,1,1.0,1,1.0,1,0.1285505127142972,64
1221,2,3976,890,3086,0,0,0,1.0,1,1.0,1,1.0,1,0.14387433876986824,65
1222,3,3979,891,3088,0,0,0,1.0,1,1.0,1,1.0,1,0.1427975045472204,66
1223,2,3981,892,3089,0,0,0,1.0,1,1.0,1,1.0,1,0.12599478519654586,64
1224,5,3986,893,3093,0,0,0,1.0,1,1.0,1,1.0,1,0.11011239231920415,66
1225,3,3989,895,3094,0,0,0,1.0,1,1.0,1,1.0,1,0.1297738492507846,66
1226,4,3993,897,3096,0,0,0,1.0,1,1.0,1,1.0,1,0.11551213637492791,68
1227,2,3995,898,3097,0,0,0,1.0,1,1.0,1,1.0,1,0.09616504641339937,64
1228,1,3996,898,3098,0,0,0,1.0,1,1.0,1,1.0,1,0.11276540858115716,62
1229,2,3998,899,3099,0,0,0,1.0,1,1.0,1,1.0,1,0.10619424990084474,61
1230,1,3999,900,3099,0,0,0,1.0,1,1.0,1,1.0,1,0.12993705394938085,58
1231,3,4002,901,3101,0,0,0,1.0,1,1.0,1,1.0,1,0.08972201133201521,57
1232,1,4003,902,3101,0,0,0,1.0,1,1.0,1,1.0,1,0.15087106351205903,53
1233,1,4004,903,3101,0,0,0,1.0,1,1.0,1,1.0,1,0.15726700130346166,53
1234,0,4004,903,3101,0,0,0,1.0,1,1.0,1,1.0,1,0.135589822291922,54
1235,2,4006,903,3103,0,0,0,1.0,1,1.0,1,1.0,1,0.15005704704493603,55
1236,5,4011,904,3107,0,0,0,1.0,1,1.0,1,1.0,1,0.18234073041696605,55
1237,4,4015,905,3110,0,0,0,1.0,1,1.0,1,1.0,1,0.17855408458076133,55
1238,3,4018,907,3111,0,0,0,1.0,1,1.0,1,1.0,1,0.16823964969231314,54
1239,2,4020,907,3113,0,0,0,1.0,1,1.0,1,1.0,1,0.13999965632103709,55
1240,1,4021,907,3114,0,0,0,1.0,1,1.0,1,1.0,1,0.13287372220988436,55
1241,2,4023,908,3115,0,0,0,1.0,1,1.0,1,1.0,1,0.09037840636083048,54
1242,0,4023,908,3115,0,0,0,1.0,1,1.0,1,1.0,1,0.09966633050620956,54
1243,1,4024,909,3115,0,0,0,1.0,1,1.0,1,1.0,1,0.1430156299891737,55
1244,0,4024,909,3115,0,0,0,1.0,1,1.0,1,1.0,1,0.15835982078234928,55
1245,2,4026,910,3116,0,0,0,1.0,1,1.0,1,1.0,1,0.15757684183361195,55
1246,6,4032,911,3121,0,0,0,1.0,1,1.0,1,1.0,1,0.13617948684505712,55
1247,3,4035,913,3122,0,0,0,1.0,1,1.0,1,1.0,1,0.14414888159375236,57
1248,3,4038,913,3125,0,0,0,1.0,1,1.0,1,1.0,1,0.14926635664804738,56
1249,2,4040,915,3125,0,0,0,1.0,1,1.0,1,1.0,1,0.21159982911829425,56
1250,8,4048,918,3130,0,0,0,1.0,1,1.0,1,1.0,1,0.18059766274689137,56
1251,1,4049,918,3131,0,0,0,1.0,1,1.0,1,1.0,1,0.1680123536016159,58
1252,4,4053,921,3132,0,0,0,1.0,1,1.0,1,1.0,1,0.20719832545923392,58
1253,2,4055,922,3133,0,0,0,1.0,1,1.0,1,1.0,1,0.20115023056604373,58
1254,0,4055,922,3133,0,0,0,1.0,1,1.0,1,1.0,1,0.17114515564928612,60
1255,3,4058,923,3135,0,0,0,1.0,1,1.0,1,1.0,1,0.18302160778504445,61
1256,4,4062,923,3139,0,0,0,1.0,1,1.0,1,1.0,1,0.15245931368531535,61
1257,3,4065,923,3142,0,0,0,1.0,1,1.0,1,1.0,1,0.139293421744385,62
1258,5,4070,924,3146,0,0,0,1.0,1,1.0,1,1.0,1,0.13435766941814878,63
1259,2,4072,924,3148,0,0,0,1.0,1,1.0,1,1.0,1,0.13435766941814878,63
1260,1,4073,924,3149,0,0,0,1.0,1,1.0,1,1.0,1,0.14390396991834592,63
1261,3,4076,924,3152,0,0,0,1.0,1,1.0,1,1.0,1,0.11814638566269588,63
1262,2,4078,924,3154,0,0,0,1.0,1,1.0,1,1.0,1,0.09900535815815474,64
1263,1,4079,925,3154,0,0,0,1.0,1,1.0,1,1.0,1,0.10876725915445835,63
1264,2,4081,927,3154,0,0,0,1.0,1,1.0,1,1.0,1,0.09052568072206285,63
1265,4,4085,931,3154,0,0,0,1.0,1,1.0,1,1.0,1,0.16294905394591558,60
1266,6,4091,935,3156,0,0,0,1.0,1,1.0,1,1.0,1,0.18547993293697726,61
1267,2,4093,937,3156,0,0,0,1.0,1,1.0,1,1.0,1,0.15160239728093058,58
1268,3,4096,939,3157,0,0,0,1.0,1,1.0,1,1.0,1,0.18741962119621478,54
1269,0,4096,939,3157,0,0,0,1.0,1,1.0,1,1.0,1,0.16484038017408828,54
1270,2,4098,940,3158,0,0,0,1.0,1,1.0,1,1.0,1,0.1710868188581825,51
1271,1,4099,941,3158,0,0,0,1.0,1,1.0,1,1.0,1,0.1642023906592801,50
1272,2,4101,943,3158,0,0,0,1.0,1,1.0,1,1.0,1,0.2530684752286303,47
1273,1,4102,944,3158,0,0,0,1.0,1,1.0,1,1.0,1,0.24822497019294898,47
1274,2,4104,945,3159,0,0,0,1.0,1,1.0,1,1.0,1,0.281742267898564,49
1275,4,4108,946,3162,0,0,0,1.0,1,1.0,1,1.0,1,0.271518475443026,48
1276,9,4117,946,3171,0,0,0,1.0,1,1.0,1,1.0,1,0.16570660385409391,49
1277,6,4123,949,3174,0,0,0,1.0,1,1.0,1,1.0,1,0.15127342061129057,50
1278,7,4130,949,3181,0,0,0,1.0,1,1.0,1,1.0,1,0.07834868917172999,51
1279,4,4134,950,3184,0,0,0,1.0,1,1.0,1,1.0,1,0.10973451383570935,51
1280,2,4136,950,3186,0,0,0,1.0,1,1.0,1,1.0,1,0.11791651931641062,52
1281,2,4138,950,3188,0,0,0,1.0,1,1.0,1,1.0,1,0.09101114975067515,52
1282,4,4142,952,3190,0,0,0,1.0,1,1.0,1,1.0,1,0.14748422346673432,52
1283,3,4145,952,3193,0,0,0,1.0,1,1.0,1,1.0,1,0.14681747697024716,52
1284,6,4151,953,3198,0,0,0,1.0,1,1.0,1,1.0,1,0.182026411591235,52
1285,3,4154,953,3201,0,0,0,1.0,1,1.0,1,1.0,1,0.20175917613632288,51
1286,5,4159,953,3206,0,0,0,1.0,1,1.0,1,1.0,1,0.20049111987086568,52
1287,5,4164,953,3211,0,0,0,1.0,1,1.0,1,1.0,1,0.19234404522221835,54
1288,9,4173,953,3220,0,0,0,1.0,1,1.0,1,1.0,1,0.1672072485862348,55
1289,8,4181,953,3228,0,0,0,1.0,1,1.0,1,1.0,1,0.15756210499257692,56
1290,10,4191,955,3236,0,0,0,1.0,1,1.0,1,1.0,1,0.11772356763528943,57
1291,3,4194,955,3239,0,0,0,1.0,1,1.0,1,1.0,1,0.09873298683991868,58
1292,1,4195,956,3239,0,0,0,1.0,1,1.0,1,1.0,1,0.09833756793099302,59
1293,3,4198,956,3242,0,0,0,1.0,1,1.0,1,1.0,1,0.10627551256941511,59
1294,5,4203,957,3246,0,0,0,1.0,1,1.0,1,1.0,1,0.10505754431266663,59
1295,5,4208,958,3250,0,0,0,1.0,1,1.0,1,1.0,1,0.08210480138696147,59
1296,0,4208,958,3250,0,0,0,1.0,1,1.0,1,1.0,1,0.10451578620136959,59
1297,4,4212,959,3253,0,0,0,1.0,1,1.0,1,1.0,1,0.10201508970530683,61
1298,1,4213,959,3254,0,0,0,1.0,1,1.0,1,1.0,1,0.11187395174539883,61
1299,2,4215,959,3256,0,0,0,1.0,1,1.0,1,1.0,1,0.1318419684991883,60
1300,4,4219,960,3259,0,0,0,1.0,1,1.0,1,1.0,1,0.1154953002639836,59
1301,4,4223,961,3262,0,0,0,1.0,1,1.0,1,1.0,1,0.13118089633914884,59
1302,6,4229,965,3264,0,0,0,1.0,1,1.0,1,1.0,1,0.11394639254652403,59
1303,7,4236,969,3267,0,0,0,1.0,1,1.0,1,1.0,1,0.2051107961272873,55
1304,7,4243,974,3269,0,0,0,1.0,1,1.0,1,1.0,1,0.21727911130064742,56
1305,7,4250,976,3274,0,0,0,1.0,1,1.0,1,1.0,1,0.20024003349828015,54
1306,5,4255,977,3278,0,0,0,1.0,1,1.0,1,1.0,1,0.14144022424473993,53
1307,6,4261,979,3282,0,0,0,1.0,1,1.0,1,1.0,1,0.148495197569901,52
1308,3,4264,982,3282,0,0,0,1.0,1,1.0,1,1.0,1,0.14951418761236565,52
1309,6,4270,985,3285,0,0,0,1.0,1,1.0,1,1.0,1,0.1386057702943133,54
1310,3,4273,987,3286,0,0,0,1.0,1,1.0,1,1.0,1,0.1579463667583423,52
1311,1,4274,988,3286,0,0,0,1.0,1,1.0,1,1.0,1,0.16629621403981976,51
1312,1,4275,989,3286,0,0,0,1.0,1,1.0,1,1.0,1,0.19650547521504327,49
1313,1,4276,989,3287,0,0,0,1.0,1,1.0,1,1.0,1,0.22635858688659705,47
1314,0,4276,989,3287,0,0,0,1.0,1,1.0,1,1.0,1,0.2534715690343518,46
1315,1,4277,989,3288,0,0,0,1.0,1,1.0,1,1.0,1,0.2427297519059435,45
1316,4,4281,992,3289,0,0,0,1.0,1,1.0,1,1.0,1,0.16744395807794482,46
1317,0,4281,992,3289,0,0,0,1.0,1,1.0,1,1.0,1,0.18711038572403477,45
1318,2,4283,994,3289,0,0,0,1.0,1,1.0,1,1.0,1,0.18296658095171917,46
1319,2,4285,994,3291,0,0,0,1.0,1,1.0,1,1.0,1,0.18417570003053468,46
1320,0,4285,994,3291,0,0,0,1.0,1,1.0,1,1.0,1,0.18417570003053468,46
1321,6,4291,995,3296,0,0,0,1.0,1,1.0,1,1.0,1,0.09027931712167556,48
1322,1,4292,996,3296,0,0,0,1.0,1,1.0,1,1.0,1,0.09580609543293259,49
1323,0,4292,996,3296,0,0,0,1.0,1,1.0,1,1.0,1,0.10070045973041054,49
1324,2,4294,996,3298,0,0,0,1.0,1,1.0,1,1.0,1,0.09986315234234194,50
1325,2,4296,996,3300,0,0,0,1.0,1,1.0,1,1.0,1,0.10894161493437218,49
1326,3,4299,997,3302,0,0,0,1.0,1,1.0,1,1.0,1,0.16384575950356228,50
1327,7,4306,998,3308,0,0,0,1.0,1,1.0,1,1.0,1,0.17016452127901638,50
1328,2,4308,998,3310,0,0,0,1.0,1,1.0,1,1.0,1,0.15949886641123265,49
1329,6,4314,998,3316,0,0,0,1.0,1,1.0,1,1.0,1,0.1787852834326072,50
1330,5,4319,998,3321,0,0,0,1.0,1,1.0,1,1.0,1,0.15683227906580122,50
1331,3,4322,999,3323,0,0,0,1.0,1,1.0,1,1.0,1,0.16191296597210994,50
1332,3,4325,999,3326,0,0,0,1.0,1,1.0,1,1.0,1,0.1825094698982696,51
1333,6,4331,1000,3331,0,0,0,1.0,1,1.0,1,1.0,1,0.2081083198793399,52
1334,7,4338,1000,3338,0,0,0,1.0,1,1.0,1,1.0,1,0.20792116077651882,54
1335,8,4346,1000,3346,0,0,0,1.0,1,1.0,1,1.0,1,0.24817326037980234,54
1336,8,4354,1000,3354,0,0,0,1.0,1,1.0,1,1.0,1,0.11402288677287206,56
1337,6,4360,1002,3358,0,0,0,1.0,1,1.0,1,1.0,1,0.1436292908356764,57
1338,5,4365,1003,3362,0,0,0,1.0,1,1.0,1,1.0,1,0.13915707063971572,57
1339,4,4369,1005,3364,0,0,0,1.0,1,1.0,1,1.0,1,0.1724514237288374,58
1340,4,4373,1005,3368,0,0,0,1.0,1,1.0,1,1.0,1,0.17519823744648408,59
1341,2,4375,1005,3370,0,0,0,1.0,1,1.0,1,1.0,1,0.1732617443011961,57
1342,9,4384,1007,3377,0,0,0,1.0,1,1.0,1,1.0,1,0.13354914741855184,57
1343,2,4386,1007,3379,0,0,0,1.0,1,1.0,1,1.0,1,0.11967691521551024,55
1344,5,4391,1009,3382,0,0,0,1.0,1,1.0,1,1.0,1,0.1236746844875272,54
1345,0,4391,1009,3382,0,0,0,1.0,1,1.0,1,1.0,1,0.12921598915938254,53
1346,1,4392,1010,3382,0,0,0,1.0,1,1.0,1,1.0,1,0.14369799325173127,53
1347,0,4392,1010,3382,0,0,0,1.0,1,1.0,1,1.0,1,0.15126083977094712,51
1348,2,4394,1012,3382,0,0,0,1.0,1,1.0,1,1.0,1,0.1643066033297758,52
1349,0,4394,1012,3382,0,0,0,1.0,1,1.0,1,1.0,1,0.1731500553878326,50
1350,3,4397,1014,3383,0,0,0,1.0,1,1.0,1,1.0,1,0.20057994778741617,51
1351,7,4404,1015,3389,0,0,0,1.0,1,1.0,1,1.0,1,0.11988144218105938,50
1352,0,4404,1015,3389,0,0,0,1.0,1,1.0,1,1.0,1,0.11589113535853661,50
1353,0,4404,1015,3389,0,0,0,1.0,1,1.0,1,1.0,1,0.11589113535853661,50
1354,2,4406,1015,3391,0,0,0,1.0,1,1.0,1,1.0,1,0.12680057051439425,51
1355,1,4407,1016,3391,0,0,0,1.0,1,1.0,1,1.0,1,0.12642457348086825,53
1356,2,4409,1018,3391,0,0,0,1.0,1,1.0,1,1.0,1,0.14418833820651888,52
1357,4,4413,1018,3395,0,0,0,1.0,1,1.0,1,1.0,1,0.1345668532283703,52
1358,5,4418,1019,3399,0,0,0,1.0,1,1.0,1,1.0,1,0.173338405816637,53
1359,2,4420,1019,3401,0,0,0,1.0,1,1.0,1,1.0,1,0.15843394446458625,54
1360,6,4426,1020,3406,0,0,0,1.0,1,1.0,1,1.0,1,0.1679795509177462,55
1361,5,4431,1021,3410,0,0,0,1.0,1,1.0,1,1.0,1,0.20000874024477047,55
1362,4,4435,1021,3414,0,0,0,1.0,1,1.0,1,1.0,1,0.16824253941166886,56
1363,6,4441,1021,3420,0,0,0,1.0,1,1.0,1,1.0,1,0.15353925288390483,56
1364,2,4443,1021,3422,0,0,0,1.0,1,1.0,1,1.0,1,0.1443695005546141,55
1365,4,4447,1022,3425,0,0,0,1.0,1,1.0,1,1.0,1,0.16685058052636256,56
1366,8,4455,1023,3432,0,0,0,1.0,1,1.0,1,1.0,1,0.11740071557088286,57
1367,2,4457,1023,3434,0,0,0,1.0,1,1.0,1,1.0,1,0.10103101413062973,57
1368,1,4458,1023,3435,0,0,0,1.0,1,1.0,1,1.0,1,0.1125864529387333,58
1369,4,4462,1024,3438,0,0,0,1.0,1,1.0,1,1.0,1,0.10566025711140145,59
1370,4,4466,1025,3441,0,0,0,1.0,1,1.0,1,1.0,1,0.12709300580356275,60
1371,5,4471,1025,3446,0,0,0,1.0,1,1.0,1,1.0,1,0.11181966112594159,59
1372,4,4475,1027,3448,0,0,0,1.0,1,1.0,1,1.0,1,0.12477911557182259,59
1373,3,4478,1028,3450,0,0,0,1.0,1,1.0,1,1.0,1,0.13622172732385882,59
1374,4,4482,1028,3454,0,0,0,1.0,1,1.0,1,1.0,1,0.1342438003272977,59
1375,7,4489,1028,3461,0,0,0,1.0,1,1.0,1,1.0,1,0.116548820630448,62
1376,9,4498,1030,3468,0,0,0,1.0,1,1.0,1,1.0,1,0.16390138973082993,61
1377,8,4506,1031,3475,0,0,0,1.0,1,1.0,1,1.0,1,0.15729332626495254,63
1378,3,4509,1031,3478,0,0,0,1.0,1,1.0,1,1.0,1,0.18450613068920504,62
1379,11,4520,1033,3487,0,0,0,1.0,1,1.0,1,1.0,1,0.2687085051982225,61
1380,7,4527,1033,3494,0,0,0,1.0,1,1.0,1,1.0,1,0.25878179461946926,60
1381,10,4537,1034,3503,0,0,0,1.0,1,1.0,1,1.0,1,0.13905950745697881,58
1382,5,4542,1034,3508,0,0,0,1.0,1,1.0,1,1.0,1,0.1041101011061841,56
1383,6,4548,1035,3513,0,0,0,1.0,1,1.0,1,1.0,1,0.14633248948513344,57
1384,7,4555,1035,3520,0,0,0,1.0,1,1.0,1,1.0,1,0.14544920052481944,55
1385,3,4558,1035,3523,0,0,0,1.0,1,1.0,1,1.0,1,0.20182396898308483,55
1386,3,4561,1036,3525,0,0,0,1.0,1,1.0,1,1.0,1,0.15001793921975387,54
1387,6,4567,1036,3531,0,0,0,1.0,1,1.0,1,1.0,1,0.17565293143629426,53
1388,5,4572,1038,3534,0,0,0,1.0,1,1.0,1,1.0,1,0.18302469422697157,52
1389,2,4574,1039,3535,0,0,0,1.0,1,1.0,1,1.0,1,0.1989016203695806,52
1390,3,4577,1039,3538,0,0,0,1.0,1,1.0,1,1.0,1,0.20196237849900248,51
1391,4,4581,1039,3542,0,0,0,1.0,1,1.0,1,1.0,1,0.18186167036629966,52
1392,4,4585,1039,3546,0,0,0,1.0,1,1.0,1,1.0,1,0.18130992703141002,51
1393,3,4588,1040,3548,0,0,0,1.0,1,1.0,1,1.0,1,0.1769215706381062,51
1394,1,4589,1040,3549,0,0,0,1.0,1,1.0,1,1.0,1,0.18672336895338898,52
1395,0,4589,1040,3549,0,0,0,1.0,1,1.0,1,1.0,1,0.18672336895338898,52
1396,5,4594,1040,3554,0,0,0,1.0,1,1.0,1,1.0,1,0.09801326094427197,53
1397,5,4599,1040,3559,0,0,0,1.0,1,1.0,1,1.0,1,0.11285647336277368,56
1398,3,4602,1041,3561,0,0,0,1.0,1,1.0,1,1.0,1,0.10942123041876252,56
1399,5,4607,1043,3564,0,0,0,1.0,1,1.0,1,1.0,1,0.13199253212673365,57
1400,2,4609,1043,3566,0,0,0,1.0,1,1.0,1,1.0,1,0.1274432130117736,57
1401,2,4611,1043,3568,0,0,0,1.0,1,1.0,1,1.0,1,0.11824051831610743,57
1402,5,4616,1045,3571,0,0,0,1.0,1,1.0,1,1.0,1,0.13583529357685686,57
1403,4,4620,1045,3575,0,0,0,1.0,1,1.0,1,1.0,1,0.14763629574415327,56
1404,2,4622,1045,3577,0,0,0,1.0,1,1.0,1,1.0,1,0.15322806748646045,58
1405,8,4630,1046,3584,0,0,0,1.0,1,1.0,1,1.0,1,0.20370789321842497,58
1406,7,4637,1046,3591,0,0,0,1.0,1,1.0,1,1.0,1,0.2022204329982448,58
1407,7,4644,1046,3598,0,0,0,1.0,1,1.0,1,1.0,1,0.21672617961948523,57
1408,6,4650,1046,3604,0,0,0,1.0,1,1.0,1,1.0,1,0.2390998091496784,58
1409,8,4658,1046,3612,0,0,0,1.0,1,1.0,1,1.0,1,0.23022077227939797,57
1410,10,4668,1046,3622,0,0,0,1.0,1,1.0,1,1.0,1,0.23022077227939797,57
1411,12,4680,1047,3633,0,0,0,1.0,1,1.0,1,1.0,1,0.1731660200255188,56
1412,1,4681,1047,3634,0,0,0,1.0,1,1.0,1,1.0,1,0.16277077857901492,55
1413,1,4682,1047,3635,0,0,0,1.0,1,1.0,1,1.0,1,0.14724682875595205,57
1414,0,4682,1047,3635,0,0,0,1.0,1,1.0,1,1.0,1,0.14724682875595205,57
1415,6,4688,1049,3639,0,0,0,1.0,1,1.0,1,1.0,1,0.14030097860650806,60
1416,3,4691,1049,3642,0,0,0,1.0,1,1.0,1,1.0,1,0.15316485919725262,61
1417,4,4695,1049,3646,0,0,0,1.0,1,1.0,1,1.0,1,0.1481945789471384,59
1418,4,4699,1049,3650,0,0,0,1.0,1,1.0,1,1.0,1,0.16613778621538441,60
1419,7,4706,1050,3656,0,0,0,1.0,1,1.0,1,1.0,1,0.17814934791436504,59
1420,6,4712,1050,3662,0,0,0,1.0,1,1.0,1,1.0,1,0.13322523650215568,58
1421,6,4718,1051,3667,0,0,0,1.0,1,1.0,1,1.0,1,0.14746488763336965,57
1422,6,4724,1052,3672,0,0,0,1.0,1,1.0,1,1.0,1,0.14247125147016246,57
1423,7,4731,1054,3677,0,0,0,1.0,1,1.0,1,1.0,1,0.09677244653283372,56
1424,1,4732,1055,3677,0,0,0,1.0,1,1.0,1,1.0,1,0.09927010899007212,57
1425,3,4735,1056,3679,0,0,0,1.0,1,1.0,1,1.0,1,0.10415675423366844,54
1426,3,4738,1057,3681,0,0,0,1.0,1,1.0,1,1.0,1,0.09216696332850334,54
1427,6,4744,1059,3685,0,0,0,1.0,1,1.0,1,1.0,1,0.1187359609597263,53
1428,0,4744,1059,3685,0,0,0,1.0,1,1.0,1,1.0,1,0.12552834321582287,52
1429,2,4746,1060,3686,0,0,0,1.0,1,1.0,1,1.0,1,0.1050790812501767,52
1430,4,4750,1062,3688,0,0,0,1.0,1,1.0,1,1.0,1,0.15615931748301273,51
1431,3,4753,1062,3691,0,0,0,1.0,1,1.0,1,1.0,1,0.1429386511254874,51
1432,3,4756,1064,3692,0,0,0,1.0,1,1.0,1,1.0,1,0.14818318784468598,52
1433,1,4757,1065,3692,0,0,0,1.0,1,1.0,1,1.0,1,0.16529690198876765,52
1434,0,4757,1065,3692,0,0,0,1.0,1,1.0,1,1.0,1,0.17567228307413876,52
1435,2,4759,1067,3692,0,0,0,1.0,1,1.0,1,1.0,1,0.1924150640556676,50
1436,1,4760,1068,3692,0,0,0,1.0,1,1.0,1,1.0,1,0.20733827784715433,50
1437,3,4763,1070,3693,0,0,0,1.0,1,1.0,1,1.0,1,0.2394746108083061,49
1438,3,4766,1071,3695,0,0,0,1.0,1,1.0,1,1.0,1,0.20310450291663565,49
1439,4,4770,1072,3698,0,0,0,1.0,1,1.0,1,1.0,1,0.21119278784992856,50
1440,5,4775,1076,3699,0,0,0,1.0,1,1.0,1,1.0,1,0.2207019927568147,50
1441,5,4780,1076,3704,0,0,0,1.0,1,1.0,1,1.0,1,0.1625285923156859,51
1442,0,4780,1076,3704,0,0,0,1.0,1,1.0,1,1.0,1,0.18616454980777566,50
1443,3,4783,1076,3707,0,0,0,1.0,1,1.0,1,1.0,1,0.17566185213916222,51
1444,3,4786,1076,3710,0,0,0,1.0,1,1.0,1,1.0,1,0.15140010540115634,51
1445,3,4789,1077,3712,0,0,0,1.0,1,1.0,1,1.0,1,0.169185733531806,51
1446,4,4793,1079,3714,0,0,0,1.0,1,1.0,1,1.0,1,0.1884309101937981,51
1447,4,4797,1079,3718,0,0,0,1.0,1,1.0,1,1.0,1,0.16602415335977344,51
1448,3,4800,1079,3721,0,0,0,1.0,1,1.0,1,1.0,1,0.16989451895709287,51
1449,3,4803,1079,3724,0,0,0,1.0,1,1.0,1,1.0,1,0.1722429989576115,51
1450,6,4809,1079,3730,0,0,0,1.0,1,1.0,1,1.0,1,0.13485898722991746,52
1451,2,4811,1079,3732,0,0,0,1.0,1,1.0,1,1.0,1,0.13876109727447972,54
1452,4,4815,1079,3736,0,0,0,1.0,1,1.0,1,1.0,1,0.15398283499840737,56
1453,5,4820,1079,3741,0,0,0,1.0,1,1.0,1,1.0,1,0.14728392717781208,56
1454,13,4833,1082,3751,0,0,0,1.0,1,1.0,1,1.0,1,0.15670095290749103,58
1455,7,4840,1083,3757,0,0,0,1.0,1,1.0,1,1.0,1,0.16788337445283802,55
1456,3,4843,1084,3759,0,0,0,1.0,1,1.0,1,1.0,1,0.1810568506909216,56
1457,2,4845,1085,3760,0,0,0,1.0,1,1.0,1,1.0,1,0.21374824761479233,54
1458,1,4846,1085,3761,0,0,0,1.0,1,1.0,1,1.0,1,0.18160551996692856,52
1459,1,4847,1085,3762,0,0,0,1.0,1,1.0,1,1.0,1,0.1782153037215059,52
1460,0,4847,1085,3762,0,0,0,1.0,1,1.0,1,1.0,1,0.17224623118386118,50
1461,1,4848,1085,3763,0,0,0,1.0,1,1.0,1,1.0,1,0.15478032530286162,53
1462,6,4854,1090,3764,0,0,0,1.0,1,1.0,1,1.0,1,0.15492777524865858,51
1463,2,4856,1091,3765,0,0,0,1.0,1,1.0,1,1.0,1,0.17040820462304046,51
1464,3,4859,1093,3766,0,0,0,1.0,1,1.0,1,1.0,1,0.17203096467581916,51
1465,1,4860,1094,3766,0,0,0,1.0,1,1.0,1,1.0,1,0.18245729912120295,49
1466,3,4863,1096,3767,0,0,0,1.0,1,1.0,1,1.0,1,0.19192099351575398,49
1467,2,4865,1098,3767,0,0,0,1.0,1,1.0,1,1.0,1,0.23057270535945978,47
1468,1,4866,1099,3767,0,0,0,1.0,1,1.0,1,1.0,1,0.23233368788508568,48
1469,0,4866,1099,3767,0,0,0,1.0,1,1.0,1,1.0,1,0.24558921372540904,47
1470,3,4869,1100,3769,0,0,0,1.0,1,1.0,1,1.0,1,0.2324125371905858,49
1471,10,4879,1100,3779,0,0,0,1.0,1,1.0,1,1.0,1,0.19897689146391193,48
1472,5,4884,1100,3784,0,0,0,1.0,1,1.0,1,1.0,1,0.17400535913249673,48
1473,6,4890,1100,3790,0,0,0,1.0,1,1.0,1,1.0,1,0.17764276422119518,49
1474,6,4896,1100,3796,0,0,0,1.0,1,1.0,1,1.0,1,0.17764276422119518,49
1475,8,4904,1100,3804,0,0,0,1.0,1,1.0,1,1.0,1,0.17297946332810202,49
1476,6,4910,1101,3809,0,0,0,1.0,1,1.0,1,1.0,1,0.16857465688544462,51
1477,5,4915,1101,3814,0,0,0,1.0,1,1.0,1,1.0,1,0.17675476693236714,51
1478,7,4922,1101,3821,0,0,0,1.0,1,1.0,1,1.0,1,0.1370001244734589,52
1479,3,4925,1101,3824,0,0,0,1.0,1,1.0,1,1.0,1,0.13576833420248846,53
1480,5,4930,1102,3828,0,0,0,1.0,1,1.0,1,1.0,1,0.15901012722028426,53
1481,5,4935,1102,3833,0,0,0,1.0,1,1.0,1,1.0,1,0.1449869801614454,53
1482,3,4938,1103,3835,0,0,0,1.0,1,1.0,1,1.0,1,0.1477157954114005,52
1483,5,4943,1103,3840,0,0,0,1.0,1,1.0,1,1.0,1,0.12680900190880434,52
1484,7,4950,1104,3846,0,0,0,1.0,1,1.0,1,1.0,1,0.1755846655528071,53
1485,9,4959,1104,3855,0,0,0,1.0,1,1.0,1,1.0,1,0.14905739068934548,53
1486,6,4965,1104,3861,0,0,0,1.0,1,1.0,1,1.0,1,0.08468709204894342,54
1487,1,4966,1104,3862,0,0,0,1.0,1,1.0,1,1.0,1,0.07322439758879527,55
1488,0,4966,1104,3862,0,0,0,1.0,1,1.0,1,1.0,1,0.08124689200722918,57
1489,1,4967,1105,3862,0,0,0,1.0,1,1.0,1,1.0,1,0.11098407157802853,58
1490,4,4971,1106,3865,0,0,0,1.0,1,1.0,1,1.0,1,0.10026873715451642,58
1491,4,4975,1108,3867,0,0,0,1.0,1,1.0,1,1.0,1,0.1404355864104854,59
1492,5,4980,1109,3871,0,0,0,1.0,1,1.0,1,1.0,1,0.15415461998992336,59
1493,4,4984,1111,3873,0,0,0,1.0,1,1.0,1,1.0,1,0.19301972871905113,58
1494,5,4989,1112,3877,0,0,0,1.0,1,1.0,1,1.0,1,0.20097089835308174,58
1495,10,4999,1113,3886,0,0,0,1.0,1,1.0,1,1.0,1,0.24675590973748804,57
1496,7,5006,1113,3893,0,0,0,1.0,1,1.0,1,1.0,1,0.2486338244262107,59
1497,8,5014,1114,3900,0,0,0,1.0,1,1.0,1,1.0,1,0.26719287729606744,58
1498,9,5023,1115,3908,0,0,0,1.0,1,1.0,1,1.0,1,0.26269834679920606,58
1499,4,5027,1115,3912,0,0,0,1.0,1,1.0,1,1.0,1,0.23045916369940225,56
1500,4,5031,1115,3916,0,0,0,1.0,1,1.0,1,1.0,1,0.23323154762584838,57
1501,6,5037,1116,3921,0,0,0,1.0,1,1.0,1,1.0,1,0.15094529384493516,55
1502,3,5040,1117,3923,0,0,0,1.0,1,1.0,1,1.0,1,0.11144413845513883,55
1503,1,5041,1117,3924,0,0,0,1.0,1,1.0,1,1.0,1,0.09551323337358346,54
1504,2,5043,1118,3925,0,0,0,1.0,1,1.0,1,1.0,1,0.09421785432733888,55
1505,1,5044,1118,3926,0,0,0,1.0,1,1.0,1,1.0,1,0.10093265633136594,53
1506,4,5048,1119,3929,0,0,0,1.0,1,1.0,1,1.0,1,0.1335790792873423,55
1507,4,5052,1119,3933,0,0,0,1.0,1,1.0,1,1.0,1,0.16411624741159658,53
1508,5,5057,1121,3936,0,0,0,1.0,1,1.0,1,1.0,1,0.11461330047295194,53
1509,6,5063,1122,3941,0,0,0,1.0,1,1.0,1,1.0,1,0.14273070978806354,52
1510,6,5069,1124,3945,0,0,0,1.0,1,1.0,1,1.0,1,0.1894428369143318,50
1511,4,5073,1125,3948,0,0,0,1.0,1,1.0,1,1.0,1,0.18143707355739966,49
1512,4,5077,1126,3951,0,0,0,1.0,1,1.0,1,1.0,1,0.20932688785918765,48
1513,6,5083,1126,3957,0,0,0,1.0,1,1.0,1,1.0,1,0.259515416075727,47
1514,4,5087,1126,3961,0,0,0,1.0,1,1.0,1,1.0,1,0.2492423263721953,48
1515,6,5093,1127,3966,0,0,0,1.0,1,1.0,1,1.0,1,0.2667451937909622,48
1516,9,5102,1127,3975,0,0,0,1.0,1,1.0,1,1.0,1,0.21220115484312882,47
1517,6,5108,1127,3981,0,0,0,1.0,1,1.0,1,1.0,1,0.1576581361578137,48
1518,3,5111,1127,3984,0,0,0,1.0,1,1.0,1,1.0,1,0.15171041322154627,48
1519,4,5115,1127,3988,0,0,0,1.0,1,1.0,1,1.0,1,0.1914487702904927,47
1520,10,5125,1128,3997,0,0,0,1.0,1,1.0,1,1.0,1,0.19533838013928376,48
1521,6,5131,1128,4003,0,0,0,1.0,1,1.0,1,1.0,1,0.15928937451413364,49
1522,3,5134,1128,4006,0,0,0,1.0,1,1.0,1,1.0,1,0.15676610082156578,48
1523,4,5138,1129,4009,0,0,0,1.0,1,1.0,1,1.0,1,0.1994780922179615,49
1524,6,5144,1131,4013,0,0,0,1.0,1,1.0,1,1.0,1,0.2036219140083764,49
1525,10,5154,1132,4022,0,0,0,1.0,1,1.0,1,1.0,1,0.18476967457024332,51
1526,7,5161,1132,4029,0,0,0,1.0,1,1.0,1,1.0,1,0.20235282705136928,52
1527,10,5171,1133,4038,0,0,0,1.0,1,1.0,1,1.0,1,0.20252452829410356,54
1528,15,5186,1135,4051,0,0,0,1.0,1,1.0,1,1.0,1,0.208596538720591,54
1529,8,5194,1135,4059,0,0,0,1.0,1,1.0,1,1.0,1,0.22000271836524837,54
1530,10,5204,1136,4068,0,0,0,1.0,1,1.0,1,1.0,1,0.21800536563993397,54
1531,7,5211,1136,4075,0,0,0,1.0,1,1.0,1,1.0,1,0.08287682545523002,54
1532,1,5212,1136,4076,0,0,0,1.0,1,1.0,1,1.0,1,0.06967108066356635,54
1533,3,5215,1136,4079,0,0,0,1.0,1,1.0,1,1.0,1,0.073682886637157,54
1534,5,5220,1136,4084,0,0,0,1.0,1,1.0,1,1.0,1,0.07645928830991848,54
1535,3,5223,1136,4087,0,0,0,1.0,1,1.0,1,1.0,1,0.06996404447757097,54
1536,5,5228,1136,4092,0,0,0,1.0,1,1.0,1,1.0,1,0.063541903921995,55
1537,2,5230,1136,4094,0,0,0,1.0,1,1.0,1,1.0,1,0.07898615508062216,53
1538,5,5235,1136,4099,0,0,0,1.0,1,1.0,1,1.0,1,0.10274351135544868,54
1539,3,5238,1136,4102,0,0,0,1.0,1,1.0,1,1.0,1,0.11080843300872374,54
1540,7,5245,1137,4108,0,0,0,1.0,1,1.0,1,1.0,1,0.1018310669135662,54
1541,5,5250,1137,4113,0,0,0,1.0,1,1.0,1,1.0,1,0.10134962772387834,54
1542,6,5256,1139,4117,0,0,0,1.0,1,1.0,1,1.0,1,0.10622389278928467,57
1543,5,5261,1140,4121,0,0,0,1.0,1,1.0,1,1.0,1,0.1215227939208195,55
1544,6,5267,1143,4124,0,0,0,1.0,1,1.0,1,1.0,1,0.16792907049773792,54
1545,5,5272,1143,4129,0,0,0,1.0,1,1.0,1,1.0,1,0.1466353957478237,54
1546,3,5275,1143,4132,0,0,0,1.0,1,1.0,1,1.0,1,0.10619064082918644,53
1547,5,5280,1147,4133,0,0,0,1.0,1,1.0,1,1.0,1,0.14591649920884048,53
1548,1,5281,1148,4133,0,0,0,1.0,1,1.0,1,1.0,1,0.15320551751045158,54
1549,1,5282,1148,4134,0,0,0,1.0,1,1.0,1,1.0,1,0.16873745799979312,52
1550,4,5286,1151,4135,0,0,0,1.0,1,1.0,1,1.0,1,0.17603637917815537,52
1551,5,5291,1153,4138,0,0,0,1.0,1,1.0,1,1.0,1,0.19428065280058104,52
1552,7,5298,1156,4142,0,0,0,1.0,1,1.0,1,1.0,1,0.2140521124718754,51
1553,6,5304,1158,4146,0,0,0,1.0,1,1.0,1,1.0,1,0.2288073208363439,51
1554,5,5309,1160,4149,0,0,0,1.0,1,1.0,1,1.0,1,0.2140693440549173,51
1555,3,5312,1161,4151,0,0,0,1.0,1,1.0,1,1.0,1,0.19489109518038478,50
1556,3,5315,1162,4153,0,0,0,1.0,1,1.0,1,1.0,1,0.23334998563583048,51
1557,4,5319,1164,4155,0,0,0,1.0,1,1.0,1,1.0,1,0.2513305642852865,51
1558,4,5323,1165,4158,0,0,0,1.0,1,1.0,1,1.0,1,0.2711682023247883,52
1559,8,5331,1168,4163,0,0,0,1.0,1,1.0,1,1.0,1,0.23639090302493437,53
1560,3,5334,1169,4165,0,0,0,1.0,1,1.0,1,1.0,1,0.24951915100410124,51
1561,11,5345,1169,4176,0,0,0,1.0,1,1.0,1,1.0,1,0.12266156211251224,51
1562,6,5351,1169,4182,0,0,0,1.0,1,1.0,1,1.0,1,0.14202625512723627,52
1563,3,5354,1169,4185,0,0,0,1.0,1,1.0,1,1.0,1,0.12085502155901823,52
1564,0,5354,1169,4185,0,0,0,1.0,1,1.0,1,1.0,1,0.1356257204345088,51
1565,6,5360,1170,4190,0,0,0,1.0,1,1.0,1,1.0,1,0.13477135206765734,53
1566,5,5365,1170,4195,0,0,0,1.0,1,1.0,1,1.0,1,0.14362057822864618,53
1567,6,5371,1170,4201,0,0,0,1.0,1,1.0,1,1.0,1,0.16644572608569141,52
1568,5,5376,1171,4205,0,0,0,1.0,1,1.0,1,1.0,1,0.1789398835872454,52
1569,6,5382,1172,4210,0,0,0,1.0,1,1.0,1,1.0,1,0.2352928084077086,49
1570,2,5384,1172,4212,0,0,0,1.0,1,1.0,1,1.0,1,0.21018015910776763,48
1571,5,5389,1174,4215,0,0,0,1.0,1,1.0,1,1.0,1,0.23046596864216576,46
1572,4,5393,1176,4217,0,0,0,1.0,1,1.0,1,1.0,1,0.27589280565438185,47
1573,6,5399,1176,4223,0,0,0,1.0,1,1.0,1,1.0,1,0.22281548396654854,48
1574,7,5406,1178,4228,0,0,0,1.0,1,1.0,1,1.0,1,0.19983514197898478,46
1575,5,5411,1179,4232,0,0,0,1.0,1,1.0,1,1.0,1,0.18433289757043037,47
1576,5,5416,1181,4235,0,0,0,1.0,1,1.0,1,1.0,1,0.09584468618929441,46
1577,1,5417,1182,4235,0,0,0,1.0,1,1.0,1,1.0,1,0.12979899645997608,45
1578,5,5422,1185,4237,0,0,0,1.0,1,1.0,1,1.0,1,0.14590603063028448,44
1579,2,5424,1186,4238,0,0,0,1.0,1,1.0,1,1.0,1,0.1816716462324427,43
1580,0,5424,1186,4238,0,0,0,1.0,1,1.0,1,1.0,1,0.1816716462324427,43
1581,0,5424,1186,4238,0,0,0,1.0,1,1.0,1,1.0,1,0.2029087649242463,42
1582,3,5427,1186,4241,0,0,0,1.0,1,1.0,1,1.0,1,0.19789886696938697,42
1583,5,5432,1189,4243,0,0,0,1.0,1,1.0,1,1.0,1,0.18904550203064518,43
1584,4,5436,1191,4245,0,0,0,1.0,1,1.0,1,1.0,1,0.15567251085997214,41
1585,6,5442,1194,4248,0,0,0,1.0,1,1.0,1,1.0,1,0.1863492946619862,43
1586,4,5446,1195,4251,0,0,0,1.0,1,1.0,1,1.0,1,0.22880529790778364,42
1587,5,5451,1196,4255,0,0,0,1.0,1,1.0,1,1.0,1,0.2553687583517466,42
1588,12,5463,1201,4262,0,0,0,1.0,1,1.0,1,1.0,1,0.30243111761595054,42
1589,6,5469,1201,4268,0,0,0,1.0,1,1.0,1,1.0,1,0.2394804315417946,42
1590,6,5475,1202,4273,0,0,0,1.0,1,1.0,1,1.0,1,0.2808028539251743,41
1591,7,5482,1203,4279,0,0,0,1.0,1,1.0,1,1.0,1,0.19001460419681307,40
1592,3,5485,1203,4282,0,0,0,1.0,1,1.0,1,1.0,1,0.1763237668693192,39
1593,7,5492,1205,4287,0,0,0,1.0,1,1.0,1,1.0,1,0.19682615922911403,39
1594,4,5496,1205,4291,0,0,0,1.0,1,1.0,1,1.0,1,0.1750583498601315,39
1595,3,5499,1205,4294,0,0,0,1.0,1,1.0,1,1.0,1,0.1680172474073173,42
1596,2,5501,1205,4296,0,0,0,1.0,1,1.0,1,1.0,1,0.19920492928059794,41
1597,2,5503,1205,4298,0,0,0,1.0,1,1.0,1,1.0,1,0.18719504377625928,41
1598,3,5506,1206,4300,0,0,0,1.0,1,1.0,1,1.0,1,0.22175356957432268,39
1599,2,5508,1206,4302,0,0,0,1.0,1,1.0,1,1.0,1,0.18231888547281863,39
1600,5,5513,1209,4304,0,0,0,1.0,1,1.0,1,1.0,1,0.18760592383471777,40
1601,7,5520,1210,4310,0,0,0,1.0,1,1.0,1,1.0,1,0.22616514218196082,41
1602,4,5524,1210,4314,0,0,0,1.0,1,1.0,1,1.0,1,0.21710419121109614,41
1603,9,5533,1211,4322,0,0,0,1.0,1,1.0,1,1.0,1,0.2689190772047391,43
1604,10,5543,1211,4332,0,0,0,1.0,1,1.0,1,1.0,1,0.23741559735982232,43
1605,5,5548,1212,4336,0,0,0,1.0,1,1.0,1,1.0,1,0.24377912217135494,44
1606,12,5560,1214,4346,0,0,0,1.0,1,1.0,1,1.0,1,0.1382231925711306,44
1607,1,5561,1214,4347,0,0,0,1.0,1,1.0,1,1.0,1,0.15793425416570753,42
1608,1,5562,1215,4347,0,0,0,1.0,1,1.0,1,1.0,1,0.16833554826090202,41
1609,2,5564,1215,4349,0,0,0,1.0,1,1.0,1,1.0,1,0.20277986469385376,39
1610,0,5564,1215,4349,0,0,0,1.0,1,1.0,1,1.0,1,0.20535877312068965,39
1611,1,5565,1215,4350,0,0,0,1.0,1,1.0,1,1.0,1,0.15833650532661891,40
1612,0,5565,1215,4350,0,0,0,1.0,1,1.0,1,1.0,1,0.1608461393910627,39
1613,0,5565,1215,4350,0,0,0,1.0,1,1.0,1,1.0,1,0.1440833267969505,41
1614,3,5568,1215,4353,0,0,0,1.0,1,1.0,1,1.0,1,0.10282681514437257,41
1615,3,5571,1215,4356,0,0,0,1.0,1,1.0,1,1.0,1,0.12504290221794248,41
1616,0,5571,1215,4356,0,0,0,1.0,1,1.0,1,1.0,1,0.11603695020925127,43
1617,0,5571,1215,4356,0,0,0,1.0,1,1.0,1,1.0,1,0.11908780089421037,44
1618,2,5573,1215,4358,0,0,0,1.0,1,1.0,1,1.0,1,0.1201762243853982,44
1619,2,5575,1216,4359,0,0,0,1.0,1,1.0,1,1.0,1,0.13901002859385134,44
1620,3,5578,1217,4361,0,0,0,1.0,1,1.0,1,1.0,1,0.2068134185077396,45
1621,4,5582,1217,4365,0,0,0,1.0,1,1.0,1,1.0,1,0.1201716790489427,44
1622,2,5584,1219,4365,0,0,0,1.0,1,1.0,1,1.0,1,0.15331996156155167,44
1623,3,5587,1219,4368,0,0,0,1.0,1,1.0,1,1.0,1,0.10726428590034429,43
1624,2,5589,1220,4369,0,0,0,1.0,1,1.0,1,1.0,1,0.11841688574990003,43
1625,3,5592,1221,4371,0,0,0,1.0,1,1.0,1,1.0,1,0.12090940400371145,43
1626,5,5597,1222,4375,0,0,0,1.0,1,1.0,1,1.0,1,0.18105114277422163,42
1627,1,5598,1223,4375,0,0,0,1.0,1,1.0,1,1.0,1,0.1818537249474692,42
1628,1,5599,1224,4375,0,0,0,1.0,1,1.0,1,1.0,1,0.20543315141992688,42
1629,1,5600,1224,4376,0,0,0,1.0,1,1.0,1,1.0,1,0.20044373460313483,41
1630,3,5603,1227,4376,0,0,0,1.0,1,1.0,1,1.0,1,0.24556696848545873,41
1631,3,5606,1229,4377,0,0,0,1.0,1,1.0,1,1.0,1,0.25192020670414506,40
1632,0,5606,1229,4377,0,0,0,1.0,1,1.0,1,1.0,1,0.2578306505033673,39
1633,0,5606,1229,4377,0,0,0,1.0,1,1.0,1,1.0,1,0.2578306505033673,39
1634,0,5606,1229,4377,0,0,0,1.0,1,1.0,1,1.0,1,0.2578306505033673,39
1635,2,5608,1230,4378,0,0,0,1.0,1,1.0,1,1.0,1,0.21219920335653417,40
1636,9,5617,1230,4387,0,0,0,1.0,1,1.0,1,1.0,1,0.1364859748965072,41
1637,2,5619,1230,4389,0,0,0,1.0,1,1.0,1,1.0,1,0.13881810625524912,41
1638,3,5622,1232,4390,0,0,0,1.0,1,1.0,1,1.0,1,0.13613985996815217,42
1639,7,5629,1232,4397,0,0,0,1.0,1,1.0,1,1.0,1,0.12006814238735719,43
1640,4,5633,1232,4401,0,0,0,1.0,1,1.0,1,1.0,1,0.1498939766436544,43
1641,8,5641,1232,4409,0,0,0,1.0,1,1.0,1,1.0,1,0.14498423273614094,44
1642,12,5653,1233,4420,0,0,0,1.0,1,1.0,1,1.0,1,0.19788555427299484,45
1643,6,5659,1234,4425,0,0,0,1.0,1,1.0,1,1.0,1,0.12097236674901315,44
1644,9,5668,1236,4432,0,0,0,1.0,1,1.0,1,1.0,1,0.09870802359983061,45
1645,5,5673,1236,4437,0,0,0,1.0,1,1.0,1,1.0,1,0.14429362863933345,44
1646,7,5680,1237,4443,0,0,0,1.0,1,1.0,1,1.0,1,0.1729155503047769,43
1647,9,5689,1238,4451,0,0,0,1.0,1,1.0,1,1.0,1,0.1981681916746753,43
1648,9,5698,1238,4460,0,0,0,1.0,1,1.0,1,1.0,1,0.20924447648811478,42
1649,6,5704,1238,4466,0,0,0,1.0,1,1.0,1,1.0,1,0.2166880349668409,41
1650,5,5709,1238,4471,0,0,0,1.0,1,1.0,1,1.0,1,0.2485794983637495,41
1651,5,5714,1239,4475,0,0,0,1.0,1,1.0,1,1.0,1,0.17726377708004754,40
1652,0,5714,1239,4475,0,0,0,1.0,1,1.0,1,1.0,1,0.16730860754818452,39
1653,2,5716,1239,4477,0,0,0,1.0,1,1.0,1,1.0,1,0.19675109954555212,39
1654,1,5717,1239,4478,0,0,0,1.0,1,1.0,1,1.0,1,0.1666451152281402,39
1655,4,5721,1241,4480,0,0,0,1.0,1,1.0,1,1.0,1,0.19631958076700237,40
1656,2,5723,1241,4482,0,0,0,1.0,1,1.0,1,1.0,1,0.19627501917557114,40
1657,2,5725,1242,4483,0,0,0,1.0,1,1.0,1,1.0,1,0.22172140123294234,40
1658,2,5727,1242,4485,0,0,0,1.0,1,1.0,1,1.0,1,0.20393733510792894,40
1659,2,5729,1242,4487,0,0,0,1.0,1,1.0,1,1.0,1,0.18709516745467103,40
1660,1,5730,1243,4487,0,0,0,1.0,1,1.0,1,1.0,1,0.1980783480150142,41
1661,2,5732,1244,4488,0,0,0,1.0,1,1.0,1,1.0,1,0.2248757065736757,42
1662,3,5735,1245,4490,0,0,0,1.0,1,1.0,1,1.0,1,0.1655382575003114,44
1663,3,5738,1246,4492,0,0,0,1.0,1,1.0,1,1.0,1,0.16514464587666888,43
1664,9,5747,1251,4496,0,0,0,1.0,1,1.0,1,1.0,1,0.181837282441767,42
1665,2,5749,1251,4498,0,0,0,1.0,1,1.0,1,1.0,1,0.10914431386248477,42
1666,4,5753,1254,4499,0,0,0,1.0,1,1.0,1,1.0,1,0.16586422630742895,43
1667,1,5754,1255,4499,0,0,0,1.0,1,1.0,1,1.0,1,0.16273307804703993,40
1668,1,5755,1256,4499,0,0,0,1.0,1,1.0,1,1.0,1,0.1410597225964885,40
1669,2,5757,1258,4499,0,0,0,1.0,1,1.0,1,1.0,1,0.17339948818538797,40
1670,1,5758,1259,4499,0,0,0,1.0,1,1.0,1,1.0,1,0.18020105620150667,39
1671,0,5758,1259,4499,0,0,0,1.0,1,1.0,1,1.0,1,0.16100881840479206,39
1672,2,5760,1261,4499,0,0,0,1.0,1,1.0,1,1.0,1,0.17122769294949827,38
1673,2,5762,1262,4500,0,0,0,1.0,1,1.0,1,1.0,1,0.1386106265272293,38
1674,0,5762,1262,4500,0,0,0,1.0,1,1.0,1,1.0,1,0.13965571299479235,38
1675,6,5768,1264,4504,0,0,0,1.0,1,1.0,1,1.0,1,0.15255097618211763,39
1676,3,5771,1265,4506,0,0,0,1.0,1,1.0,1,1.0,1,0.1809736300892723,39
1677,7,5778,1266,4512,0,0,0,1.0,1,1.0,1,1.0,1,0.19751577085024816,40
1678,4,5782,1266,4516,0,0,0,1.0,1,1.0,1,1.0,1,0.1634248690521524,39
1679,1,5783,1267,4516,0,0,0,1.0,1,1.0,1,1.0,1,0.21860853197982125,39
1680,1,5784,1267,4517,0,0,0,1.0,1,1.0,1,1.0,1,0.23513034618761663,40
1681,4,5788,1267,4521,0,0,0,1.0,1,1.0,1,1.0,1,0.18892643439052978,41
1682,2,5790,1267,4523,0,0,0,1.0,1,1.0,1,1.0,1,0.1494610150900632,40
1683,1,5791,1267,4524,0,0,0,1.0,1,1.0,1,1.0,1,0.1464578557548003,43
1684,1,5792,1268,4524,0,0,0,1.0,1,1.0,1,1.0,1,0.18137845598840768,42
1685,2,5794,1269,4525,0,0,0,1.0,1,1.0,1,1.0,1,0.14329777561759952,41
1686,2,5796,1271,4525,0,0,0,1.0,1,1.0,1,1.0,1,0.1767497573172031,39
1687,8,5804,1274,4530,0,0,0,1.0,1,1.0,1,1.0,1,0.2074346037901543,41
1688,3,5807,1276,4531,0,0,0,1.0,1,1.0,1,1.0,1,0.2554646249394628,39
1689,5,5812,1278,4534,0,0,0,1.0,1,1.0,1,1.0,1,0.28076235715046205,37
1690,1,5813,1278,4535,0,0,0,1.0,1,1.0,1,1.0,1,0.23120626641573885,36
1691,5,5818,1281,4537,0,0,0,1.0,1,1.0,1,1.0,1,0.24289799697506625,36
1692,0,5818,1281,4537,0,0,0,1.0,1,1.0,1,1.0,1,0.23303972917171858,34
1693,0,5818,1281,4537,0,0,0,1.0,1,1.0,1,1.0,1,0.20133660281644045,33
1694,1,5819,1282,4537,0,0,0,1.0,1,1.0,1,1.0,1,0.26302926566657,32
1695,0,5819,1282,4537,0,0,0,1.0,1,1.0,1,1.0,1,0.2593128983366033,32
1696,5,5824,1283,4541,0,0,0,1.0,1,1.0,1,1.0,1,0.22302410133645173,34
1697,2,5826,1284,4542,0,0,0,1.0,1,1.0,1,1.0,1,0.21655355634643808,34
1698,3,5829,1285,4544,0,0,0,1.0,1,1.0,1,1.0,1,0.22076403540414655,36
1699,4,5833,1286,4547,0,0,0,1.0,1,1.0,1,1.0,1,0.2306346569549189,36
1700,3,5836,1286,4550,0,0,0,1.0,1,1.0,1,1.0,1,0.21872987313471806,37
1701,0,5836,1286,4550,0,0,0,1.0,1,1.0,1,1.0,1,0.249970354051058,39
1702,5,5841,1287,4554,0,0,0,1.0,1,1.0,1,1.0,1,0.19425642343478544,39
1703,2,5843,1287,4556,0,0,0,1.0,1,1.0,1,1.0,1,0.19471776703827887,38
1704,3,5846,1289,4557,0,0,0,1.0,1,1.0,1,1.0,1,0.17046982742993283,38
1705,2,5848,1291,4557,0,0,0,1.0,1,1.0,1,1.0,1,0.16651012466075224,37
1706,2,5850,1292,4558,0,0,0,1.0,1,1.0,1,1.0,1,0.1655201011677386,37
1707,7,5857,1294,4563,0,0,0,1.0,1,1.0,1,1.0,1,0.11578345525141434,36
1708,2,5859,1294,4565,0,0,0,1.0,1,1.0,1,1.0,1,0.11691628313141127,34
1709,5,5864,1295,4569,0,0,0,1.0,1,1.0,1,1.0,1,0.11526541505519125,34
1710,6,5870,1295,4575,0,0,0,1.0,1,1.0,1,1.0,1,0.21472189586878684,33
1711,5,5875,1298,4577,0,0,0,1.0,1,1.0,1,1.0,1,0.21305429515998808,32
1712,1,5876,1299,4577,0,0,0,1.0,1,1.0,1,1.0,1,0.24976468385351502,31
1713,1,5877,1299,4578,0,0,0,1.0,1,1.0,1,1.0,1,0.2545772524754926,32
1714,1,5878,1299,4579,0,0,0,1.0,1,1.0,1,1.0,1,0.24116939969501422,32
1715,1,5879,1299,4580,0,0,0,1.0,1,1.0,1,1.0,1,0.2308060208730719,32
1716,2,5881,1299,4582,0,0,0,1.0,1,1.0,1,1.0,1,0.23784654629778174,34
1717,0,5881,1299,4582,0,0,0,1.0,1,1.0,1,1.0,1,0.23784654629778174,34
1718,3,5884,1299,4585,0,0,0,1.0,1,1.0,1,1.0,1,0.25143807045135624,34
1719,2,5886,1299,4587,0,0,0,1.0,1,1.0,1,1.0,1,0.25143807045135624,34
1720,3,5889,1300,4589,0,0,0,1.0,1,1.0,1,1.0,1,0.2578639214595062,34
1721,1,5890,1300,4590,0,0,0,1.0,1,1.0,1,1.0,1,0.22904717568347632,35
1722,1,5891,1300,4591,0,0,0,1.0,1,1.0,1,1.0,1,0.23750858670135788,35
1723,1,5892,1300,4592,0,0,0,1.0,1,1.0,1,1.0,1,0.24188486100722326,34
1724,2,5894,1301,4593,0,0,0,1.0,1,1.0,1,1.0,1,0.21483514365573442,33
1725,3,5897,1302,4595,0,0,0,1.0,1,1.0,1,1.0,1,0.23397663630138527,35
1726,3,5900,1302,4598,0,0,0,1.0,1,1.0,1,1.0,1,0.1517092680192103,34
1727,2,5902,1303,4599,0,0,0,1.0,1,1.0,1,1.0,1,0.1607486116446458,34
1728,2,5904,1303,4601,0,0,0,1.0,1,1.0,1,1.0,1,0.11872186316865371,35
1729,0,5904,1303,4601,0,0,0,1.0,1,1.0,1,1.0,1,0.13540815202487586,35
1730,1,5905,1304,4601,0,0,0,1.0,1,1.0,1,1.0,1,0.16246863124150135,35
1731,1,5906,1305,4601,0,0,0,1.0,1,1.0,1,1.0,1,0.19082026477320288,35
1732,1,5907,1305,4602,0,0,0,1.0,1,1.0,1,1.0,1,0.1636728229233681,35
1733,2,5909,1305,4604,0,0,0,1.0,1,1.0,1,1.0,1,0.19515604057206826,33
1734,4,5913,1308,4605,0,0,0,1.0,1,1.0,1,1.0,1,0.23756509804489548,34
1735,1,5914,1308,4606,0,0,0,1.0,1,1.0,1,1.0,1,0.2075908509923952,33
1736,3,5917,1310,4607,0,0,0,1.0,1,1.0,1,1.0,1,0.24007960032684378,33
1737,3,5920,1310,4610,0,0,0,1.0,1,1.0,1,1.0,1,0.22704972126077347,35
1738,6,5926,1312,4614,0,0,0,1.0,1,1.0,1,1.0,1,0.20508155703732675,36
1739,5,5931,1313,4618,0,0,0,1.0,1,1.0,1,1.0,1,0.2513557821485261,36
1740,3,5934,1313,4621,0,0,0,1.0,1,1.0,1,1.0,1,0.21856155728270585,37
1741,4,5938,1313,4625,0,0,0,1.0,1,1.0,1,1.0,1,0.1270525819966863,36
1742,1,5939,1314,4625,0,0,0,1.0,1,1.0,1,1.0,1,0.13033401990629526,36
1743,4,5943,1315,4628,0,0,0,1.0,1,1.0,1,1.0,1,0.1312060416953706,37
1744,1,5944,1315,4629,0,0,0,1.0,1,1.0,1,1.0,1,0.13228119605600663,37
1745,9,5953,1319,4634,0,0,0,1.0,1,1.0,1,1.0,1,0.276420195026359,38
1746,5,5958,1320,4638,0,0,0,1.0,1,1.0,1,1.0,1,0.24772443694159743,38
1747,1,5959,1320,4639,0,0,0,1.0,1,1.0,1,1.0,1,0.25665425108277606,37
1748,2,5961,1320,4641,0,0,0,1.0,1,1.0,1,1.0,1,0.25566210447042315,38
1749,3,5964,1321,4643,0,0,0,1.0,1,1.0,1,1.0,1,0.2681747822085412,38
1750,6,5970,1321,4649,0,0,0,1.0,1,1.0,1,1.0,1,0.23256237569688476,39
1751,5,5975,1321,4654,0,0,0,1.0,1,1.0,1,1.0,1,0.22134030974206223,41
1752,3,5978,1322,4656,0,0,0,1.0,1,1.0,1,1.0,1,0.2112681106564454,41
1753,2,5980,1323,4657,0,0,0,1.0,1,1.0,1,1.0,1,0.23114467376354036,41
1754,4,5984,1324,4660,0,0,0,1.0,1,1.0,1,1.0,1,0.20271568441473845,40
1755,3,5987,1325,4662,0,0,0,1.0,1,1.0,1,1.0,1,0.17675544621837183,41
1756,6,5993,1325,4668,0,0,0,1.0,1,1.0,1,1.0,1,0.12284648756721735,41
1757,1,5994,1325,4669,0,0,0,1.0,1,1.0,1,1.0,1,0.14128573490523225,40
1758,3,5997,1326,4671,0,0,0,1.0,1,1.0,1,1.0,1,0.1668228940254602,41
1759,2,5999,1326,4673,0,0,0,1.0,1,1.0,1,1.0,1,0.19110327635978103,38
1760,2,6001,1326,4675,0,0,0,1.0,1,1.0,1,1.0,1,0.17430579970297458,38
1761,7,6008,1328,4680,0,0,0,1.0,1,1.0,1,1.0,1,0.23979414275445082,37
1762,3,6011,1328,4683,0,0,0,1.0,1,1.0,1,1.0,1,0.18922839543099407,37
1763,6,6017,1331,4686,0,0,0,1.0,1,1.0,1,1.0,1,0.24333764702789315,37
1764,2,6019,1331,4688,0,0,0,1.0,1,1.0,1,1.0,1,0.23593506964181502,36
1765,5,6024,1332,4692,0,0,0,1.0,1,1.0,1,1.0,1,0.22848807532666351,36
1766,5,6029,1333,4696,0,0,0,1.0,1,1.0,1,1.0,1,0.240773218787724,37
1767,5,6034,1335,4699,0,0,0,1.0,1,1.0,1,1.0,1,0.2366237652910174,37
1768,3,6037,1336,4701,0,0,0,1.0,1,1.0,1,1.0,1,0.23888337637689785,37
1769,2,6039,1337,4702,0,0,0,1.0,1,1.0,1,1.0,1,0.2038854904317369,38
1770,7,6046,1339,4707,0,0,0,1.0,1,1.0,1,1.0,1,0.2565179901072568,39
1771,3,6049,1339,4710,0,0,0,1.0,1,1.0,1,1.0,1,0.1976912110439439,39
1772,1,6050,1339,4711,0,0,0,1.0,1,1.0,1,1.0,1,0.18826801973028898,39
1773,1,6051,1340,4711,0,0,0,1.0,1,1.0,1,1.0,1,0.1894051576553506,41
1774,1,6052,1340,4712,0,0,0,1.0,1,1.0,1,1.0,1,0.1891142220793724,41
1775,0,6052,1340,4712,0,0,0,1.0,1,1.0,1,1.0,1,0.18504615732688845,42
1776,2,6054,1340,4714,0,0,0,1.0,1,1.0,1,1.0,1,0.16385378852412538,43
1777,0,6054,1340,4714,0,0,0,1.0,1,1.0,1,1.0,1,0.16385378852412538,43
1778,2,6056,1340,4716,0,0,0,1.0,1,1.0,1,1.0,1,0.14275041688076429,44
1779,3,6059,1340,4719,0,0,0,1.0,1,1.0,1,1.0,1,0.12906453464991938,46
1780,0,6059,1340,4719,0,0,0,1.0,1,1.0,1,1.0,1,0.12906453464991938,46
1781,0,6059,1340,4719,0,0,0,1.0,1,1.0,1,1.0,1,0.12906453464991938,46
1782,1,6060,1341,4719,0,0,0,1.0,1,1.0,1,1.0,1,0.1815120709575997,46
1783,1,6061,1342,4719,0,0,0,1.0,1,1.0,1,1.0,1,0.17349259020879473,44
1784,4,6065,1343,4722,0,0,0,1.0,1,1.0,1,1.0,1,0.1689380717655922,45
1785,2,6067,1343,4724,0,0,0,1.0,1,1.0,1,1.0,1,0.15282947054192295,42
1786,9,6076,1347,4729,0,0,0,1.0,1,1.0,1,1.0,1,0.16660546652513317,43
1787,1,6077,1347,4730,0,0,0,1.0,1,1.0,1,1.0,1,0.14132938750149449,41
1788,3,6080,1348,4732,0,0,0,1.0,1,1.0,1,1.0,1,0.19535842209151735,41
1789,5,6085,1350,4735,0,0,0,1.0,1,1.0,1,1.0,1,0.2240532402107231,41
1790,3,6088,1351,4737,0,0,0,1.0,1,1.0,1,1.0,1,0.2263232978250637,41
1791,7,6095,1355,4740,0,0,0,1.0,1,1.0,1,1.0,1,0.22822456337990416,40
1792,5,6100,1356,4744,0,0,0,1.0,1,1.0,1,1.0,1,0.19978665188735553,40
1793,3,6103,1357,4746,0,0,0,1.0,1,1.0,1,1.0,1,0.24191991390765236,41
1794,4,6107,1359,4748,0,0,0,1.0,1,1.0,1,1.0,1,0.2064909934982257,41
1795,3,6110,1362,4748,0,0,0,1.0,1,1.0,1,1.0,1,0.26355198823748766,40
1796,6,6116,1363,4753,0,0,0,1.0,1,1.0,1,1.0,1,0.2436838799177931,40
1797,5,6121,1365,4756,0,0,0,1.0,1,1.0,1,1.0,1,0.29146070836807103,37
1798,4,6125,1366,4759,0,0,0,1.0,1,1.0,1,1.0,1,0.28825768442900856,37
1799,9,6134,1368,4766,0,0,0,1.0,1,1.0,1,1.0,1,0.3259716290850494,36
1800,3,6137,1368,4769,0,0,0,1.0,1,1.0,1,1.0,1,0.2930973501839093,36
1801,4,6141,1368,4773,0,0,0,1.0,1,1.0,1,1.0,1,0.18761290894733823,34
1802,1,6142,1368,4774,0,0,0,1.0,1,1.0,1,1.0,1,0.18493710107828698,33
1803,4,6146,1368,4778,0,0,0,1.0,1,1.0,1,1.0,1,0.13487247028592841,33
1804,4,6150,1369,4781,0,0,0,1.0,1,1.0,1,1.0,1,0.1595689156306541,33
1805,2,6152,1369,4783,0,0,0,1.0,1,1.0,1,1.0,1,0.1518349004862723,35
1806,2,6154,1369,4785,0,0,0,1.0,1,1.0,1,1.0,1,0.1518349004862723,35
1807,4,6158,1369,4789,0,0,0,1.0,1,1.0,1,1.0,1,0.09183193342052917,35
1808,6,6164,1369,4795,0,0,0,1.0,1,1.0,1,1.0,1,0.12061746396227867,36
1809,1,6165,1369,4796,0,0,0,1.0,1,1.0,1,1.0,1,0.14679068253246053,36
1810,1,6166,1369,4797,0,0,0,1.0,1,1.0,1,1.0,1,0.14261524984788315,35
1811,2,6168,1369,4799,0,0,0,1.0,1,1.0,1,1.0,1,0.19837764228394,36
1812,4,6172,1369,4803,0,0,0,1.0,1,1.0,1,1.0,1,0.19267212272451878,36
1813,4,6176,1370,4806,0,0,0,1.0,1,1.0,1,1.0,1,0.218594629357328,36
1814,4,6180,1371,4809,0,0,0,1.0,1,1.0,1,1.0,1,0.2712142104322192,34
1815,8,6188,1371,4817,0,0,0,1.0,1,1.0,1,1.0,1,0.2565410937439529,35
1816,5,6193,1371,4822,0,0,0,1.0,1,1.0,1,1.0,1,0.21320825980879946,34
1817,3,6196,1372,4824,0,0,0,1.0,1,1.0,1,1.0,1,0.15523111127508865,34
1818,0,6196,1372,4824,0,0,0,1.0,1,1.0,1,1.0,1,0.15523111127508865,34
1819,4,6200,1373,4827,0,0,0,1.0,1,1.0,1,1.0,1,0.12295774233192044,35
1820,3,6203,1373,4830,0,0,0,1.0,1,1.0,1,1.0,1,0.13550239974876468,36
1821,2,6205,1373,4832,0,0,0,1.0,1,1.0,1,1.0,1,0.13550239974876468,36
1822,2,6207,1375,4832,0,0,0,1.0,1,1.0,1,1.0,1,0.1976482590910685,37
1823,6,6213,1377,4836,0,0,0,1.0,1,1.0,1,1.0,1,0.21283766267467014,38
1824,1,6214,1378,4836,0,0,0,1.0,1,1.0,1,1.0,1,0.23732529570792615,37
1825,4,6218,1380,4838,0,0,0,1.0,1,1.0,1,1.0,1,0.236841223587309,36
1826,1,6219,1381,4838,0,0,0,1.0,1,1.0,1,1.0,1,0.24387738904473044,35
1827,1,6220,1382,4838,0,0,0,1.0,1,1.0,1,1.0,1,0.2490316498903629,35
1828,3,6223,1383,4840,0,0,0,1.0,1,1.0,1,1.0,1,0.2625910053453162,33
1829,1,6224,1383,4841,0,0,0,1.0,1,1.0,1,1.0,1,0.27631332080261467,32
1830,3,6227,1384,4843,0,0,0,1.0,1,1.0,1,1.0,1,0.3185804982089424,32
1831,3,6230,1384,4846,0,0,0,1.0,1,1.0,1,1.0,1,0.3046081870182643,30
1832,1,6231,1384,4847,0,0,0,1.0,1,1.0,1,1.0,1,0.29017084946074306,30
1833,2,6233,1384,4849,0,0,0,1.0,1,1.0,1,1.0,1,0.24651318904719557,29
1834,1,6234,1385,4849,0,0,0,1.0,1,1.0,1,1.0,1,0.26687764678749326,28
1835,0,6234,1385,4849,0,0,0,1.0,1,1.0,1,1.0,1,0.2550943200620033,28
1836,2,6236,1385,4851,0,0,0,1.0,1,1.0,1,1.0,1,0.2300444230228096,29
1837,0,6236,1385,4851,0,0,0,1.0,1,1.0,1,1.0,1,0.221705372073156,28
1838,0,6236,1385,4851,0,0,0,1.0,1,1.0,1,1.0,1,0.20603934684004688,28
1839,1,6237,1386,4851,0,0,0,1.0,1,1.0,1,1.0,1,0.31707562563066044,27
1840,2,6239,1386,4853,0,0,0,1.0,1,1.0,1,1.0,1,0.2720107661041475,26
1841,0,6239,1386,4853,0,0,0,1.0,1,1.0,1,1.0,1,0.25343506238598207,25
1842,4,6243,1387,4856,0,0,0,1.0,1,1.0,1,1.0,1,0.19536948741754728,26
1843,2,6245,1387,4858,0,0,0,1.0,1,1.0,1,1.0,1,0.19536948741754728,26
1844,5,6250,1387,4863,0,0,0,1.0,1,1.0,1,1.0,1,0.2429019928570715,26
1845,3,6253,1388,4865,0,0,0,1.0,1,1.0,1,1.0,1,0.22429256602467137,26
1846,3,6256,1388,4868,0,0,0,1.0,1,1.0,1,1.0,1,0.12605618042787003,26
1847,0,6256,1388,4868,0,0,0,1.0,1,1.0,1,1.0,1,0.12605618042787003,26
1848,1,6257,1389,4868,0,0,0,1.0,1,1.0,1,1.0,1,0.19130157470600823,27
1849,0,6257,1389,4868,0,0,0,1.0,1,1.0,1,1.0,1,0.19130157470600823,27
1850,3,6260,1390,4870,0,0,0,1.0,1,1.0,1,1.0,1,0.16592499594995286,28
1851,0,6260,1390,4870,0,0,0,1.0,1,1.0,1,1.0,1,0.16592499594995286,28
1852,0,6260,1390,4870,0,0,0,1.0,1,1.0,1,1.0,1,0.16592499594995286,28
1853,0,6260,1390,4870,0,0,0,1.0,1,1.0,1,1.0,1,0.1905235183635008,27
1854,1,6261,1390,4871,0,0,0,1.0,1,1.0,1,1.0,1,0.21149930021699961,28
1855,1,6262,1390,4872,0,0,0,1.0,1,1.0,1,1.0,1,0.20615508101753893,28
1856,5,6267,1391,4876,0,0,0,1.0,1,1.0,1,1.0,1,0.22106224506709113,30
1857,3,6270,1392,4878,0,0,0,1.0,1,1.0,1,1.0,1,0.25946747827484595,31
1858,4,6274,1393,4881,0,0,0,1.0,1,1.0,1,1.0,1,0.2702669600827486,31
1859,3,6277,1393,4884,0,0,0,1.0,1,1.0,1,1.0,1,0.24495462274327207,31
1860,2,6279,1393,4886,0,0,0,1.0,1,1.0,1,1.0,1,0.24495462274327207,31
1861,1,6280,1393,4887,0,0,0,1.0,1,1.0,1,1.0,1,0.22588450234392551,31
1862,1,6281,1394,4887,0,0,0,1.0,1,1.0,1,1.0,1,0.21526333484867627,31
1863,2,6283,1395,4888,0,0,0,1.0,1,1.0,1,1.0,1,0.22744153513296222,31
1864,2,6285,1397,4888,0,0,0,1.0,1,1.0,1,1.0,1,0.2527274451590105,30
1865,0,6285,1397,4888,0,0,0,1.0,1,1.0,1,1.0,1,0.24895951971654354,27
1866,4,6289,1400,4889,0,0,0,1.0,1,1.0,1,1.0,1,0.3191438065893145,28
1867,1,6290,1401,4889,0,0,0,1.0,1,1.0,1,1.0,1,0.3177383112571545,26
1868,0,6290,1401,4889,0,0,0,1.0,1,1.0,1,1.0,1,0.3177383112571545,26
1869,0,6290,1401,4889,0,0,0,1.0,1,1.0,1,1.0,1,0.31934518862533495,25
1870,2,6292,1402,4890,0,0,0,1.0,1,1.0,1,1.0,1,0.2996957948612828,25
1871,0,6292,1402,4890,0,0,0,1.0,1,1.0,1,1.0,1,0.3216894823065885,26
1872,0,6292,1402,4890,0,0,0,1.0,1,1.0,1,1.0,1,0.307261965370723,25
1873,0,6292,1402,4890,0,0,0,1.0,1,1.0,1,1.0,1,0.34570082786031203,23
1874,1,6293,1403,4890,0,0,0,1.0,1,1.0,1,1.0,1,0.27636063898152274,23
1875,1,6294,1404,4890,0,0,0,1.0,1,1.0,1,1.0,1,0.3866104907360282,21
1876,6,6300,1405,4895,0,0,0,1.0,1,1.0,1,1.0,1,0.2813830048683586,24
1877,4,6304,1406,4898,0,0,0,1.0,1,1.0,1,1.0,1,0.2824244348386257,24
1878,4,6308,1407,4901,0,0,0,1.0,1,1.0,1,1.0,1,0.230164030179478,26
1879,2,6310,1407,4903,0,0,0,1.0,1,1.0,1,1.0,1,0.230164030179478,26
1880,2,6312,1407,4905,0,0,0,1.0,1,1.0,1,1.0,1,0.18934042110408678,26
1881,4,6316,1407,4909,0,0,0,1.0,1,1.0,1,1.0,1,0.2071856879080835,26
1882,2,6318,1407,4911,0,0,0,1.0,1,1.0,1,1.0,1,0.2307144276871669,25
1883,3,6321,1407,4914,0,0,0,1.0,1,1.0,1,1.0,1,0.22852186991578133,25
1884,5,6326,1407,4919,0,0,0,1.0,1,1.0,1,1.0,1,0.22360891083088139,25
1885,3,6329,1407,4922,0,0,0,1.0,1,1.0,1,1.0,1,0.22580146860226694,25
1886,3,6332,1407,4925,0,0,0,1.0,1,1.0,1,1.0,1,0.19897903720186114,26
1887,3,6335,1407,4928,0,0,0,1.0,1,1.0,1,1.0,1,0.20105807656812383,26
1888,6,6341,1408,4933,0,0,0,1.0,1,1.0,1,1.0,1,0.2358199374870013,27
1889,3,6344,1408,4936,0,0,0,1.0,1,1.0,1,1.0,1,0.24489582272220536,28
1890,2,6346,1408,4938,0,0,0,1.0,1,1.0,1,1.0,1,0.2620932153532764,28
1891,3,6349,1408,4941,0,0,0,1.0,1,1.0,1,1.0,1,0.2171937269444607,29
1892,0,6349,1408,4941,0,0,0,1.0,1,1.0,1,1.0,1,0.2171937269444607,29
1893,0,6349,1408,4941,0,0,0,1.0,1,1.0,1,1.0,1,0.2171937269444607,29
1894,0,6349,1408,4941,0,0,0,1.0,1,1.0,1,1.0,1,0.2171937269444607,29
1895,2,6351,1408,4943,0,0,0,1.0,1,1.0,1,1.0,1,0.25844884838860016,31
1896,1,6352,1408,4944,0,0,0,1.0,1,1.0,1,1.0,1,0.24317540010803054,31
1897,0,6352,1408,4944,0,0,0,1.0,1,1.0,1,1.0,1,0.24317540010803054,31
1898,0,6352,1408,4944,0,0,0,1.0,1,1.0,1,1.0,1,0.24317540010803054,31
1899,0,6352,1408,4944,0,0,0,1.0,1,1.0,1,1.0,1,0.22575455477325126,32
1900,0,6352,1408,4944,0,0,0,1.0,1,1.0,1,1.0,1,0.22575455477325126,32
1901,0,6352,1408,4944,0,0,0,1.0,1,1.0,1,1.0,1,0.22575455477325126,32
1902,1,6353,1408,4945,0,0,0,1.0,1,1.0,1,1.0,1,0.22222992681457715,32
1903,0,6353,1408,4945,0,0,0,1.0,1,1.0,1,1.0,1,0.22222992681457715,32
1904,2,6355,1408,4947,0,0,0,1.0,1,1.0,1,1.0,1,0.23404105086804278,34
1905,4,6359,1409,4950,0,0,0,1.0,1,1.0,1,1.0,1,0.2421032220416839,34
1906,4,6363,1409,4954,0,0,0,1.0,1,1.0,1,1.0,1,0.167258587142317,35
1907,0,6363,1409,4954,0,0,0,1.0,1,1.0,1,1.0,1,0.17965419421668657,36
1908,1,6364,1409,4955,0,0,0,1.0,1,1.0,1,1.0,1,0.1642388063187454,36
1909,3,6367,1410,4957,0,0,0,1.0,1,1.0,1,1.0,1,0.1763412922316974,37
1910,3,6370,1411,4959,0,0,0,1.0,1,1.0,1,1.0,1,0.19025199120649514,38
1911,2,6372,1411,4961,0,0,0,1.0,1,1.0,1,1.0,1,0.11851773465296936,37
1912,1,6373,1412,4961,0,0,0,1.0,1,1.0,1,1.0,1,0.12636896658260657,37
1913,0,6373,1412,4961,0,0,0,1.0,1,1.0,1,1.0,1,0.13799818346439827,36
1914,0,6373,1412,4961,0,0,0,1.0,1,1.0,1,1.0,1,0.14309089617079412,37
1915,2,6375,1413,4962,0,0,0,1.0,1,1.0,1,1.0,1,0.14788051236448832,37
1916,0,6375,1413,4962,0,0,0,1.0,1,1.0,1,1.0,1,0.12521566416457033,39
1917,3,6378,1415,4963,0,0,0,1.0,1,1.0,1,1.0,1,0.17987007976188016,38
1918,1,6379,1415,4964,0,0,0,1.0,1,1.0,1,1.0,1,0.1725521526846633,38
1919,1,6380,1416,4964,0,0,0,1.0,1,1.0,1,1.0,1,0.2405339460377858,38
1920,1,6381,1416,4965,0,0,0,1.0,1,1.0,1,1.0,1,0.23802575234398113,39
1921,2,6383,1416,4967,0,0,0,1.0,1,1.0,1,1.0,1,0.1812211040745744,38
1922,3,6386,1418,4968,0,0,0,1.0,1,1.0,1,1.0,1,0.17405828134957801,39
1923,2,6388,1420,4968,0,0,0,1.0,1,1.0,1,1.0,1,0.23638231899417908,40
1924,2,6390,1420,4970,0,0,0,1.0,1,1.0,1,1.0,1,0.21953537914350987,40
1925,3,6393,1420,4973,0,0,0,1.0,1,1.0,1,1.0,1,0.22431499559303755,40
1926,0,6393,1420,4973,0,0,0,1.0,1,1.0,1,1.0,1,0.22431499559303755,40
1927,0,6393,1420,4973,0,0,0,1.0,1,1.0,1,1.0,1,0.1999563055382694,41
1928,2,6395,1421,4974,0,0,0,1.0,1,1.0,1,1.0,1,0.21204998701516886,41
1929,1,6396,1421,4975,0,0,0,1.0,1,1.0,1,1.0,1,0.15516723277975755,40
1930,1,6397,1422,4975,0,0,0,1.0,1,1.0,1,1.0,1,0.1885320596154846,40
1931,0,6397,1422,4975,0,0,0,1.0,1,1.0,1,1.0,1,0.1885320596154846,40
1932,0,6397,1422,4975,0,0,0,1.0,1,1.0,1,1.0,1,0.1885320596154846,40
1933,1,6398,1422,4976,0,0,0,1.0,1,1.0,1,1.0,1,0.17130880840292786,42
1934,3,6401,1422,4979,0,0,0,1.0,1,1.0,1,1.0,1,0.18134577898046195,44
1935,1,6402,1422,4980,0,0,0,1.0,1,1.0,1,1.0,1,0.17143460338523736,44
1936,6,6408,1423,4985,0,0,0,1.0,1,1.0,1,1.0,1,0.12115912205404802,46
1937,2,6410,1424,4986,0,0,0,1.0,1,1.0,1,1.0,1,0.11719610202248176,47
1938,3,6413,1424,4989,0,0,0,1.0,1,1.0,1,1.0,1,0.1282860882390543,47
1939,2,6415,1424,4991,0,0,0,1.0,1,1.0,1,1.0,1,0.1163704319345407,47
1940,2,6417,1424,4993,0,0,0,1.0,1,1.0,1,1.0,1,0.12395741395109271,47
1941,7,6424,1426,4998,0,0,0,1.0,1,1.0,1,1.0,1,0.11004334152889059,47
1942,5,6429,1427,5002,0,0,0,1.0,1,1.0,1,1.0,1,0.12528504444465755,49
1943,1,6430,1428,5002,0,0,0,1.0,1,1.0,1,1.0,1,0.09785323427349797,47
1944,1,6431,1429,5002,0,0,0,1.0,1,1.0,1,1.0,1,0.12862534127899708,47
1945,3,6434,1431,5003,0,0,0,1.0,1,1.0,1,1.0,1,0.14542835122808892,45
1946,5,6439,1432,5007,0,0,0,1.0,1,1.0,1,1.0,1,0.15542767931619555,45
1947,10,6449,1435,5014,0,0,0,1.0,1,1.0,1,1.0,1,0.17303803613733082,45
1948,2,6451,1435,5016,0,0,0,1.0,1,1.0,1,1.0,1,0.18656385633073624,45
1949,4,6455,1437,5018,0,0,0,1.0,1,1.0,1,1.0,1,0.19996171242401597,42
1950,6,6461,1440,5021,0,0,0,1.0,1,1.0,1,1.0,1,0.21863351714618223,42
1951,6,6467,1441,5026,0,0,0,1.0,1,1.0,1,1.0,1,0.21240943840303503,38
1952,3,6470,1442,5028,0,0,0,1.0,1,1.0,1,1.0,1,0.12560230943339962,36
1953,2,6472,1443,5029,0,0,0,1.0,1,1.0,1,1.0,1,0.1848205917581841,35
1954,1,6473,1443,5030,0,0,0,1.0,1,1.0,1,1.0,1,0.20145531173840944,32
1955,1,6474,1444,5030,0,0,0,1.0,1,1.0,1,1.0,1,0.21669840441164595,33
1956,1,6475,1445,5030,0,0,0,1.0,1,1.0,1,1.0,1,0.2746045228806208,31
1957,1,6476,1446,5030,0,0,0,1.0,1,1.0,1,1.0,1,0.29232188925632874,33
1958,7,6483,1448,5035,0,0,0,1.0,1,1.0,1,1.0,1,0.2806921485995176,34
1959,0,6483,1448,5035,0,0,0,1.0,1,1.0,1,1.0,1,0.28345990114409714,35
1960,2,6485,1449,5036,0,0,0,1.0,1,1.0,1,1.0,1,0.33871024179317133,36
1961,4,6489,1450,5039,0,0,0,1.0,1,1.0,1,1.0,1,0.24263152608343355,36
1962,0,6489,1450,5039,0,0,0,1.0,1,1.0,1,1.0,1,0.2266806806152696,35
1963,3,6492,1451,5041,0,0,0,1.0,1,1.0,1,1.0,1,0.2523210433601035,36
1964,4,6496,1453,5043,0,0,0,1.0,1,1.0,1,1.0,1,0.1844599196199771,35
1965,1,6497,1454,5043,0,0,0,1.0,1,1.0,1,1.0,1,0.14742653860337349,36
1966,1,6498,1455,5043,0,0,0,1.0,1,1.0,1,1.0,1,0.1953504855772882,36
1967,2,6500,1456,5044,0,0,0,1.0,1,1.0,1,1.0,1,0.1993038319335961,36
1968,1,6501,1456,5045,0,0,0,1.0,1,1.0,1,1.0,1,0.17784686331852495,37
1969,0,6501,1456,5045,0,0,0,1.0,1,1.0,1,1.0,1,0.17784686331852495,37
1970,1,6502,1457,5045,0,0,0,1.0,1,1.0,1,1.0,1,0.1877463459533629,38
1971,0,6502,1457,5045,0,0,0,1.0,1,1.0,1,1.0,1,0.2069064483606187,37
1972,1,6503,1458,5045,0,0,0,1.0,1,1.0,1,1.0,1,0.20665301427522814,37
1973,6,6509,1461,5048,0,0,0,1.0,1,1.0,1,1.0,1,0.24242939989803444,37
1974,5,6514,1461,5053,0,0,0,1.0,1,1.0,1,1.0,1,0.24937160956734317,38
1975,4,6518,1461,5057,0,0,0,1.0,1,1.0,1,1.0,1,0.25002640046743263,37
1976,3,6521,1462,5059,0,0,0,1.0,1,1.0,1,1.0,1,0.23624989337066069,39
1977,7,6528,1462,5066,0,0,0,1.0,1,1.0,1,1.0,1,0.18809974457484036,42
1978,3,6531,1463,5068,0,0,0,1.0,1,1.0,1,1.0,1,0.2147403319225132,42
1979,3,6534,1463,5071,0,0,0,1.0,1,1.0,1,1.0,1,0.1822881918793493,42
1980,4,6538,1463,5075,0,0,0,1.0,1,1.0,1,1.0,1,0.18776594732437193,43
1981,5,6543,1463,5080,0,0,0,1.0,1,1.0,1,1.0,1,0.09337192753451914,44
1982,0,6543,1463,5080,0,0,0,1.0,1,1.0,1,1.0,1,0.09337192753451914,44
1983,0,6543,1463,5080,0,0,0,1.0,1,1.0,1,1.0,1,0.09337192753451914,44
1984,1,6544,1464,5080,0,0,0,1.0,1,1.0,1,1.0,1,0.1268696455434822,42
1985,0,6544,1464,5080,0,0,0,1.0,1,1.0,1,1.0,1,0.14224304206079616,41
1986,1,6545,1465,5080,0,0,0,1.0,1,1.0,1,1.0,1,0.14782504144175848,40
1987,2,6547,1467,5080,0,0,0,1.0,1,1.0,1,1.0,1,0.13770531562493257,37
1988,5,6552,1471,5081,0,0,0,1.0,1,1.0,1,1.0,1,0.2801716179447731,35
1989,3,6555,1473,5082,0,0,0,1.0,1,1.0,1,1.0,1,0.3413969966042915,32
1990,0,6555,1473,5082,0,0,0,1.0,1,1.0,1,1.0,1,0.315967874215861,31
1991,1,6556,1474,5082,0,0,0,1.0,1,1.0,1,1.0,1,0.3123351701350336,32
1992,2,6558,1475,5083,0,0,0,1.0,1,1.0,1,1.0,1,0.3038747718740001,32
1993,1,6559,1476,5083,0,0,0,1.0,1,1.0,1,1.0,1,0.3177745979633665,32
1994,1,6560,1477,5083,0,0,0,1.0,1,1.0,1,1.0,1,0.3351814992012717,31
1995,2,6562,1478,5084,0,0,0,1.0,1,1.0,1,1.0,1,0.3672541285485747,32
1996,7,6569,1478,5091,0,0,0,1.0,1,1.0,1,1.0,1,0.16959262544595843,32
1997,0,6569,1478,5091,0,0,0,1.0,1,1.0,1,1.0,1,0.19657100315612186,31
1998,0,6569,1478,5091,0,0,0,1.0,1,1.0,1,1.0,1,0.1946084867472515,32
1999,0,6569,1478,5091,0,0,0,1.0,1,1.0,1,1.0,1,0.19948608452261157,31
2000,0,6569,1478,5091,0,0,0,1.0,1,1.0,1,1.0,1,0.1730852090818475,30
2001,1,6570,1478,5092,0,0,0,1.0,1,1.0,1,1.0,1,0.1690105516510922,29
2002,2,6572,1478,5094,0,0,0,1.0,1,1.0,1,1.0,1,0.16845940509979676,31
2003,3,6575,1480,5095,0,0,0,1.0,1,1.0,1,1.0,1,0.1608070202429449,33
2004,6,6581,1481,5100,0,0,0,1.0,1,1.0,1,1.0,1,0.21298641493057463,34
2005,6,6587,1481,5106,0,0,0,1.0,1,1.0,1,1.0,1,0.23413963447161185,35
2006,5,6592,1482,5110,0,0,0,1.0,1,1.0,1,1.0,1,0.21457538638214807,36
2007,7,6599,1482,5117,0,0,0,1.0,1,1.0,1,1.0,1,0.1954273575218722,36
2008,7,6606,1483,5123,0,0,0,1.0,1,1.0,1,1.0,1,0.24322314842722584,36
2009,7,6613,1483,5130,0,0,0,1.0,1,1.0,1,1.0,1,0.21058081665330725,37
2010,8,6621,1484,5137,0,0,0,1.0,1,1.0,1,1.0,1,0.20133283474763664,37
2011,2,6623,1484,5139,0,0,0,1.0,1,1.0,1,1.0,1,0.15213406997967382,37
2012,1,6624,1484,5140,0,0,0,1.0,1,1.0,1,1.0,1,0.10442949722269866,37
2013,1,6625,1484,5141,0,0,0,1.0,1,1.0,1,1.0,1,0.11602550792735815,39
2014,2,6627,1484,5143,0,0,0,1.0,1,1.0,1,1.0,1,0.09017438577081227,39
2015,2,6629,1484,5145,0,0,0,1.0,1,1.0,1,1.0,1,0.1196656168865225,39
2016,2,6631,1484,5147,0,0,0,1.0,1,1.0,1,1.0,1,0.08304725033514644,41
2017,2,6633,1484,5149,0,0,0,1.0,1,1.0,1,1.0,1,0.08102498963767074,41
2018,4,6637,1485,5152,0,0,0,1.0,1,1.0,1,1.0,1,0.11341493261713385,42
2019,2,6639,1485,5154,0,0,0,1.0,1,1.0,1,1.0,1,0.0950822990975541,43
2020,3,6642,1487,5155,0,0,0,1.0,1,1.0,1,1.0,1,0.16640569908003502,43
2021,4,6646,1487,5159,0,0,0,1.0,1,1.0,1,1.0,1,0.11665977393076893,43
2022,3,6649,1487,5162,0,0,0,1.0,1,1.0,1,1.0,1,0.17903405877916914,44
2023,6,6655,1489,5166,0,0,0,1.0,1,1.0,1,1.0,1,0.2182648780278018,42
2024,3,6658,1490,5168,0,0,0,1.0,1,1.0,1,1.0,1,0.2058242294805094,41
2025,4,6662,1492,5170,0,0,0,1.0,1,1.0,1,1.0,1,0.21398069236284686,39
2026,5,6667,1493,5174,0,0,0,1.0,1,1.0,1,1.0,1,0.18684306094695102,39
2027,4,6671,1494,5177,0,0,0,1.0,1,1.0,1,1.0,1,0.20737042428903776,38
2028,2,6673,1494,5179,0,0,0,1.0,1,1.0,1,1.0,1,0.18851204636023774,37
2029,1,6674,1494,5180,0,0,0,1.0,1,1.0,1,1.0,1,0.13506985827531973,35
2030,1,6675,1495,5180,0,0,0,1.0,1,1.0,1,1.0,1,0.2234771165379322,32
2031,2,6677,1496,5181,0,0,0,1.0,1,1.0,1,1.0,1,0.27112354224636126,34
2032,3,6680,1496,5184,0,0,0,1.0,1,1.0,1,1.0,1,0.276383587079121,35
2033,7,6687,1499,5188,0,0,0,1.0,1,1.0,1,1.0,1,0.30104166204797006,35
2034,2,6689,1499,5190,0,0,0,1.0,1,1.0,1,1.0,1,0.31628341178636654,35
2035,5,6694,1501,5193,0,0,0,1.0,1,1.0,1,1.0,1,0.26052935615928996,36
2036,4,6698,1501,5197,0,0,0,1.0,1,1.0,1,1.0,1,0.22677786162105854,35
2037,5,6703,1503,5200,0,0,0,1.0,1,1.0,1,1.0,1,0.2869833876848523,36
2038,2,6705,1504,5201,0,0,0,1.0,1,1.0,1,1.0,1,0.23849408853046017,38
2039,4,6709,1504,5205,0,0,0,1.0,1,1.0,1,1.0,1,0.24717874793259578,38
2040,3,6712,1504,5208,0,0,0,1.0,1,1.0,1,1.0,1,0.2589611780329708,37
2041,5,6717,1505,5212,0,0,0,1.0,1,1.0,1,1.0,1,0.22758772570855948,38
2042,2,6719,1505,5214,0,0,0,1.0,1,1.0,1,1.0,1,0.22758772570855948,38
2043,3,6722,1506,5216,0,0,0,1.0,1,1.0,1,1.0,1,0.2106956580017232,38
2044,3,6725,1506,5219,0,0,0,1.0,1,1.0,1,1.0,1,0.17632895242361402,39
2045,3,6728,1507,5221,0,0,0,1.0,1,1.0,1,1.0,1,0.18321986666997023,40
2046,5,6733,1507,5226,0,0,0,1.0,1,1.0,1,1.0,1,0.13243844770527732,41
2047,2,6735,1507,5228,0,0,0,1.0,1,1.0,1,1.0,1,0.13243844770527732,41
2048,5,6740,1507,5233,0,0,0,1.0,1,1.0,1,1.0,1,0.11374366217268889,43
2049,2,6742,1508,5234,0,0,0,1.0,1,1.0,1,1.0,1,0.1385236791521468,43
2050,1,6743,1508,5235,0,0,0,1.0,1,1.0,1,1.0,1,0.1084023034815687,43
2051,1,6744,1508,5236,0,0,0,1.0,1,1.0,1,1.0,1,0.1427954171581884,43
2052,3,6747,1508,5239,0,0,0,1.0,1,1.0,1,1.0,1,0.16436551973755434,44
2053,5,6752,1509,5243,0,0,0,1.0,1,1.0,1,1.0,1,0.2044689575404899,43
2054,8,6760,1509,5251,0,0,0,1.0,1,1.0,1,1.0,1,0.21239950751365136,44
2055,7,6767,1509,5258,0,0,0,1.0,1,1.0,1,1.0,1,0.25909073042693254,43
2056,11,6778,1511,5267,0,0,0,1.0,1,1.0,1,1.0,1,0.1180484778266102,44
2057,3,6781,1511,5270,0,0,0,1.0,1,1.0,1,1.0,1,0.1136183650189807,44
2058,1,6782,1511,5271,0,0,0,1.0,1,1.0,1,1.0,1,0.10726809423974847,44
2059,1,6783,1511,5272,0,0,0,1.0,1,1.0,1,1.0,1,0.1325011547840997,45
2060,4,6787,1512,5275,0,0,0,1.0,1,1.0,1,1.0,1,0.12556869908099055,46
2061,5,6792,1513,5279,0,0,0,1.0,1,1.0,1,1.0,1,0.11050107851044172,48
2062,5,6797,1515,5282,0,0,0,1.0,1,1.0,1,1.0,1,0.10300700689096465,48
2063,2,6799,1515,5284,0,0,0,1.0,1,1.0,1,1.0,1,0.11683814015153884,45
2064,2,6801,1516,5285,0,0,0,1.0,1,1.0,1,1.0,1,0.09723037453776807,44
2065,1,6802,1517,5285,0,0,0,1.0,1,1.0,1,1.0,1,0.1454483749673897,42
2066,5,6807,1522,5285,0,0,0,1.0,1,1.0,1,1.0,1,0.13775613243563478,42
2067,2,6809,1523,5286,0,0,0,1.0,1,1.0,1,1.0,1,0.16565801820993956,38
2068,0,6809,1523,5286,0,0,0,1.0,1,1.0,1,1.0,1,0.18974288138109985,37
2069,1,6810,1524,5286,0,0,0,1.0,1,1.0,1,1.0,1,0.2035563697375234,35
2070,2,6812,1526,5286,0,0,0,1.0,1,1.0,1,1.0,1,0.18337716771283546,35
2071,3,6815,1527,5288,0,0,0,1.0,1,1.0,1,1.0,1,0.17789745907079818,34
2072,4,6819,1528,5291,0,0,0,1.0,1,1.0,1,1.0,1,0.1593839512834565,35
2073,2,6821,1528,5293,0,0,0,1.0,1,1.0,1,1.0,1,0.16081912594130324,37
2074,4,6825,1528,5297,0,0,0,1.0,1,1.0,1,1.0,1,0.08141840962681116,36
2075,3,6828,1528,5300,0,0,0,1.0,1,1.0,1,1.0,1,0.09454327322508935,38
2076,0,6828,1528,5300,0,0,0,1.0,1,1.0,1,1.0,1,0.07484755890775975,37
2077,1,6829,1528,5301,0,0,0,1.0,1,1.0,1,1.0,1,0.07130129060469029,37
2078,3,6832,1529,5303,0,0,0,1.0,1,1.0,1,1.0,1,0.1128287498021138,37
2079,4,6836,1530,5306,0,0,0,1.0,1,1.0,1,1.0,1,0.12234232044395438,37
2080,1,6837,1531,5306,0,0,0,1.0,1,1.0,1,1.0,1,0.08972056515421788,36
2081,3,6840,1534,5306,0,0,0,1.0,1,1.0,1,1.0,1,0.17814178446999912,37
2082,8,6848,1536,5312,0,0,0,1.0,1,1.0,1,1.0,1,0.21062380099609526,38
2083,4,6852,1537,5315,0,0,0,1.0,1,1.0,1,1.0,1,0.22562070915849278,39
2084,7,6859,1538,5321,0,0,0,1.0,1,1.0,1,1.0,1,0.2734892185087536,41
2085,6,6865,1538,5327,0,0,0,1.0,1,1.0,1,1.0,1,0.2734892185087536,41
2086,8,6873,1538,5335,0,0,0,1.0,1,1.0,1,1.0,1,0.1359193670668104,44
2087,5,6878,1538,5340,0,0,0,1.0,1,1.0,1,1.0,1,0.1668101877578376,44
2088,2,6880,1538,5342,0,0,0,1.0,1,1.0,1,1.0,1,0.1307661909314653,45
2089,3,6883,1538,5345,0,0,0,1.0,1,1.0,1,1.0,1,0.13756371883055396,46
2090,3,6886,1538,5348,0,0,0,1.0,1,1.0,1,1.0,1,0.14988572396086638,47
2091,6,6892,1540,5352,0,0,0,1.0,1,1.0,1,1.0,1,0.12923096152671915,48
2092,1,6893,1541,5352,0,0,0,1.0,1,1.0,1,1.0,1,0.11433143326796186,48
2093,1,6894,1542,5352,0,0,0,1.0,1,1.0,1,1.0,1,0.13254216955352188,48
2094,1,6895,1542,5353,0,0,0,1.0,1,1.0,1,1.0,1,0.10440354917378798,47
2095,3,6898,1542,5356,0,0,0,1.0,1,1.0,1,1.0,1,0.12146572024679178,49
2096,8,6906,1543,5363,0,0,0,1.0,1,1.0,1,1.0,1,0.13821616547652696,50
2097,4,6910,1543,5367,0,0,0,1.0,1,1.0,1,1.0,1,0.13990092895281864,50
2098,7,6917,1544,5373,0,0,0,1.0,1,1.0,1,1.0,1,0.13221527936832955,51
2099,1,6918,1544,5374,0,0,0,1.0,1,1.0,1,1.0,1,0.1121521878437986,50
2100,3,6921,1546,5375,0,0,0,1.0,1,1.0,1,1.0,1,0.1283928071741155,49
2101,4,6925,1546,5379,0,0,0,1.0,1,1.0,1,1.0,1,0.10575075635703916,48
2102,3,6928,1548,5380,0,0,0,1.0,1,1.0,1,1.0,1,0.17328538147262645,49
2103,1,6929,1548,5381,0,0,0,1.0,1,1.0,1,1.0,1,0.1606337262533159,44
2104,3,6932,1550,5382,0,0,0,1.0,1,1.0,1,1.0,1,0.17857228367516534,42
2105,3,6935,1551,5384,0,0,0,1.0,1,1.0,1,1.0,1,0.22099077161051056,40
2106,1,6936,1552,5384,0,0,0,1.0,1,1.0,1,1.0,1,0.23030237756317073,39
2107,1,6937,1553,5384,0,0,0,1.0,1,1.0,1,1.0,1,0.2147331672366099,37
2108,1,6938,1554,5384,0,0,0,1.0,1,1.0,1,1.0,1,0.20421820584853018,37
2109,3,6941,1556,5385,0,0,0,1.0,1,1.0,1,1.0,1,0.2226243994530224,36
2110,0,6941,1556,5385,0,0,0,1.0,1,1.0,1,1.0,1,0.23602937801923107,35
2111,1,6942,1557,5385,0,0,0,1.0,1,1.0,1,1.0,1,0.1959909567427231,35
2112,1,6943,1558,5385,0,0,0,1.0,1,1.0,1,1.0,1,0.2009079934088916,35
2113,1,6944,1559,5385,0,0,0,1.0,1,1.0,1,1.0,1,0.21849567961584318,35
2114,3,6947,1560,5387,0,0,0,1.0,1,1.0,1,1.0,1,0.23257972570300434,36
2115,2,6949,1560,5389,0,0,0,1.0,1,1.0,1,1.0,1,0.21640589886851255,37
2116,5,6954,1562,5392,0,0,0,1.0,1,1.0,1,1.0,1,0.15830344277176503,39
2117,3,6957,1562,5395,0,0,0,1.0,1,1.0,1,1.0,1,0.11118167012543921,39
2118,2,6959,1563,5396,0,0,0,1.0,1,1.0,1,1.0,1,0.15914190991029734,41
2119,4,6963,1564,5399,0,0,0,1.0,1,1.0,1,1.0,1,0.15701534462948435,42
2120,5,6968,1564,5404,0,0,0,1.0,1,1.0,1,1.0,1,0.12975756806278513,42
2121,3,6971,1565,5406,0,0,0,1.0,1,1.0,1,1.0,1,0.16258526078528893,42
2122,3,6974,1565,5409,0,0,0,1.0,1,1.0,1,1.0,1,0.1378919265813676,43
2123,4,6978,1565,5413,0,0,0,1.0,1,1.0,1,1.0,1,0.1251886954978747,42
2124,3,6981,1565,5416,0,0,0,1.0,1,1.0,1,1.0,1,0.13907383007209437,42
2125,1,6982,1565,5417,0,0,0,1.0,1,1.0,1,1.0,1,0.1494268760899921,41
2126,3,6985,1565,5420,0,0,0,1.0,1,1.0,1,1.0,1,0.1724501961973472,41
2127,4,6989,1565,5424,0,0,0,1.0,1,1.0,1,1.0,1,0.1724501961973472,41
2128,3,6992,1565,5427,0,0,0,1.0,1,1.0,1,1.0,1,0.1585236081834979,42
2129,4,6996,1565,5431,0,0,0,1.0,1,1.0,1,1.0,1,0.17465086119055817,43
2130,5,7001,1565,5436,0,0,0,1.0,1,1.0,1,1.0,1,0.17256176501155188,45
2131,7,7008,1566,5442,0,0,0,1.0,1,1.0,1,1.0,1,0.13166569960645536,44
2132,2,7010,1566,5444,0,0,0,1.0,1,1.0,1,1.0,1,0.13836748985636824,44
2133,6,7016,1567,5449,0,0,0,1.0,1,1.0,1,1.0,1,0.15063924563257683,45
2134,1,7017,1567,5450,0,0,0,1.0,1,1.0,1,1.0,1,0.1599265476866334,45
2135,3,7020,1567,5453,0,0,0,1.0,1,1.0,1,1.0,1,0.1225444844403368,46
2136,3,7023,1568,5455,0,0,0,1.0,1,1.0,1,1.0,1,0.12846291595422066,47
2137,3,7026,1570,5456,0,0,0,1.0,1,1.0,1,1.0,1,0.1345808629098651,47
2138,1,7027,1570,5457,0,0,0,1.0,1,1.0,1,1.0,1,0.1694141661242038,45
2139,5,7032,1572,5460,0,0,0,1.0,1,1.0,1,1.0,1,0.16540477758737296,45
2140,3,7035,1573,5462,0,0,0,1.0,1,1.0,1,1.0,1,0.1840468075618743,44
2141,3,7038,1573,5465,0,0,0,1.0,1,1.0,1,1.0,1,0.17494651702039443,45
2142,4,7042,1576,5466,0,0,0,1.0,1,1.0,1,1.0,1,0.12335751898612114,46
2143,2,7044,1578,5466,0,0,0,1.0,1,1.0,1,1.0,1,0.16002641701129042,46
2144,8,7052,1581,5471,0,0,0,1.0,1,1.0,1,1.0,1,0.1719877568988214,48
2145,4,7056,1582,5474,0,0,0,1.0,1,1.0,1,1.0,1,0.1451903018643163,46
2146,5,7061,1583,5478,0,0,0,1.0,1,1.0,1,1.0,1,0.06986336050983749,45
2147,3,7064,1585,5479,0,0,0,1.0,1,1.0,1,1.0,1,0.10688389527589227,44
2148,2,7066,1586,5480,0,0,0,1.0,1,1.0,1,1.0,1,0.159562302644055,44
2149,6,7072,1589,5483,0,0,0,1.0,1,1.0,1,1.0,1,0.17614199107480522,42
2150,3,7075,1591,5484,0,0,0,1.0,1,1.0,1,1.0,1,0.17214899195994376,40
2151,0,7075,1591,5484,0,0,0,1.0,1,1.0,1,1.0,1,0.16512824411075644,39
2152,1,7076,1592,5484,0,0,0,1.0,1,1.0,1,1.0,1,0.22041516122894667,40
2153,7,7083,1594,5489,0,0,0,1.0,1,1.0,1,1.0,1,0.22972538659891442,42
2154,3,7086,1595,5491,0,0,0,1.0,1,1.0,1,1.0,1,0.2392884546671889,42
2155,1,7087,1596,5491,0,0,0,1.0,1,1.0,1,1.0,1,0.23478319474577058,41
2156,2,7089,1596,5493,0,0,0,1.0,1,1.0,1,1.0,1,0.19871912458043106,40
2157,2,7091,1597,5494,0,0,0,1.0,1,1.0,1,1.0,1,0.22519109370954882,40
2158,1,7092,1598,5494,0,0,0,1.0,1,1.0,1,1.0,1,0.22762271669813322,38
2159,0,7092,1598,5494,0,0,0,1.0,1,1.0,1,1.0,1,0.22840428563756765,38
2160,2,7094,1598,5496,0,0,0,1.0,1,1.0,1,1.0,1,0.22840428563756765,38
2161,7,7101,1599,5502,0,0,0,1.0,1,1.0,1,1.0,1,0.11970168148658364,38
2162,4,7105,1602,5503,0,0,0,1.0,1,1.0,1,1.0,1,0.14064400623947113,38
2163,2,7107,1602,5505,0,0,0,1.0,1,1.0,1,1.0,1,0.16447941438562713,40
2164,2,7109,1604,5505,0,0,0,1.0,1,1.0,1,1.0,1,0.16026629224707037,41
2165,2,7111,1605,5506,0,0,0,1.0,1,1.0,1,1.0,1,0.1750703133221261,42
2166,0,7111,1605,5506,0,0,0,1.0,1,1.0,1,1.0,1,0.1750703133221261,42
2167,1,7112,1605,5507,0,0,0,1.0,1,1.0,1,1.0,1,0.13147216097690706,43
2168,2,7114,1605,5509,0,0,0,1.0,1,1.0,1,1.0,1,0.14880768217004295,43
2169,2,7116,1605,5511,0,0,0,1.0,1,1.0,1,1.0,1,0.16486034461796908,45
2170,2,7118,1606,5512,0,0,0,1.0,1,1.0,1,1.0,1,0.1331230990393188,46
2171,5,7123,1606,5517,0,0,0,1.0,1,1.0,1,1.0,1,0.1336128749892826,48
2172,5,7128,1606,5522,0,0,0,1.0,1,1.0,1,1.0,1,0.1685581231192258,49
2173,3,7131,1606,5525,0,0,0,1.0,1,1.0,1,1.0,1,0.15845656386564136,49
2174,6,7137,1609,5528,0,0,0,1.0,1,1.0,1,1.0,1,0.1549752389803178,49
2175,4,7141,1609,5532,0,0,0,1.0,1,1.0,1,1.0,1,0.13475941175317743,49
2176,2,7143,1609,5534,0,0,0,1.0,1,1.0,1,1.0,1,0.12793503464077136,51
2177,4,7147,1611,5536,0,0,0,1.0,1,1.0,1,1.0,1,0.11116178672700353,51
2178,5,7152,1612,5540,0,0,0,1.0,1,1.0,1,1.0,1,0.10848146682799975,50
2179,4,7156,1613,5543,0,0,0,1.0,1,1.0,1,1.0,1,0.10932557257205404,49
2180,0,7156,1613,5543,0,0,0,1.0,1,1.0,1,1.0,1,0.11784116587246485,47
2181,1,7157,1614,5543,0,0,0,1.0,1,1.0,1,1.0,1,0.12353938543237228,47
2182,2,7159,1615,5544,0,0,0,1.0,1,1.0,1,1.0,1,0.1546095969693227,45
2183,4,7163,1618,5545,0,0,0,1.0,1,1.0,1,1.0,1,0.19479906596901567,44
2184,4,7167,1620,5547,0,0,0,1.0,1,1.0,1,1.0,1,0.2271981014873932,43
2185,5,7172,1623,5549,0,0,0,1.0,1,1.0,1,1.0,1,0.21145331342862217,40
2186,1,7173,1624,5549,0,0,0,1.0,1,1.0,1,1.0,1,0.24733388138491527,38
2187,0,7173,1624,5549,0,0,0,1.0,1,1.0,1,1.0,1,0.24026186727304927,35
2188,1,7174,1625,5549,0,0,0,1.0,1,1.0,1,1.0,1,0.3039435087681145,34
2189,1,7175,1626,5549,0,0,0,1.0,1,1.0,1,1.0,1,0.3257188150362246,31
2190,3,7178,1629,5549,0,0,0,1.0,1,1.0,1,1.0,1,0.3320151557000792,29
2191,8,7186,1630,5556,0,0,0,1.0,1,1.0,1,1.0,1,0.1992282775821827,28
2192,2,7188,1631,5557,0,0,0,1.0,1,1.0,1,1.0,1,0.19824880572436535,29
2193,0,7188,1631,5557,0,0,0,1.0,1,1.0,1,1.0,1,0.237098929022342,28
2194,0,7188,1631,5557,0,0,0,1.0,1,1.0,1,1.0,1,0.24896046447495265,27
2195,2,7190,1633,5557,0,0,0,1.0,1,1.0,1,1.0,1,0.2946795974207284,27
2196,2,7192,1634,5558,0,0,0,1.0,1,1.0,1,1.0,1,0.38008724221176354,27
2197,0,7192,1634,5558,0,0,0,1.0,1,1.0,1,1.0,1,0.38008724221176354,27
2198,0,7192,1634,5558,0,0,0,1.0,1,1.0,1,1.0,1,0.35190021947284045,28
2199,5,7197,1634,5563,0,0,0,1.0,1,1.0,1,1.0,1,0.3274887009935588,29
2200,3,7200,1634,5566,0,0,0,1.0,1,1.0,1,1.0,1,0.3078105558241125,31
2201,3,7203,1635,5568,0,0,0,1.0,1,1.0,1,1.0,1,0.31341024824317715,32
2202,2,7205,1635,5570,0,0,0,1.0,1,1.0,1,1.0,1,0.30234780422620744,31
2203,5,7210,1635,5575,0,0,0,1.0,1,1.0,1,1.0,1,0.2653385453708769,32
2204,1,7211,1635,5576,0,0,0,1.0,1,1.0,1,1.0,1,0.26569832935779236,32
2205,2,7213,1636,5577,0,0,0,1.0,1,1.0,1,1.0,1,0.22878494401254873,33
2206,6,7219,1637,5582,0,0,0,1.0,1,1.0,1,1.0,1,0.17291860653025737,32
2207,2,7221,1637,5584,0,0,0,1.0,1,1.0,1,1.0,1,0.17927702625322647,33
2208,3,7224,1638,5586,0,0,0,1.0,1,1.0,1,1.0,1,0.2108287089620171,35
2209,5,7229,1639,5590,0,0,0,1.0,1,1.0,1,1.0,1,0.22188192612273028,36
2210,1,7230,1639,5591,0,0,0,1.0,1,1.0,1,1.0,1,0.24980864706636802,35
2211,1,7231,1639,5592,0,0,0,1.0,1,1.0,1,1.0,1,0.24228418267504603,36
2212,8,7239,1639,5600,0,0,0,1.0,1,1.0,1,1.0,1,0.2536702749804537,37
2213,4,7243,1640,5603,0,0,0,1.0,1,1.0,1,1.0,1,0.22780753301616993,37
2214,0,7243,1640,5603,0,0,0,1.0,1,1.0,1,1.0,1,0.21301254565751812,39
2215,2,7245,1641,5604,0,0,0,1.0,1,1.0,1,1.0,1,0.2552402436994819,36
2216,2,7247,1643,5604,0,0,0,1.0,1,1.0,1,1.0,1,0.3154256658967286,37
2217,5,7252,1646,5606,0,0,0,1.0,1,1.0,1,1.0,1,0.28492623853034715,35
2218,9,7261,1649,5612,0,0,0,1.0,1,1.0,1,1.0,1,0.3246047193630475,35
2219,4,7265,1649,5616,0,0,0,1.0,1,1.0,1,1.0,1,0.31250345858219686,33
2220,3,7268,1649,5619,0,0,0,1.0,1,1.0,1,1.0,1,0.3181544238068304,31
2221,7,7275,1650,5625,0,0,0,1.0,1,1.0,1,1.0,1,0.16030518899901572,31
2222,4,7279,1652,5627,0,0,0,1.0,1,1.0,1,1.0,1,0.19866752154130715,30
2223,1,7280,1653,5627,0,0,0,1.0,1,1.0,1,1.0,1,0.2073181163500158,28
2224,5,7285,1655,5630,0,0,0,1.0,1,1.0,1,1.0,1,0.25448325673999656,29
2225,6,7291,1657,5634,0,0,0,1.0,1,1.0,1,1.0,1,0.2508249820656041,28
2226,4,7295,1657,5638,0,0,0,1.0,1,1.0,1,1.0,1,0.24057953494416867,30
2227,4,7299,1658,5641,0,0,0,1.0,1,1.0,1,1.0,1,0.2951424012762989,28
2228,3,7302,1659,5643,0,0,0,1.0,1,1.0,1,1.0,1,0.28685802134181543,29
2229,3,7305,1660,5645,0,0,0,1.0,1,1.0,1,1.0,1,0.3237091447058485,28
2230,2,7307,1660,5647,0,0,0,1.0,1,1.0,1,1.0,1,0.3233950778591278,28
2231,2,7309,1660,5649,0,0,0,1.0,1,1.0,1,1.0,1,0.2712722446490605,27
2232,1,7310,1660,5650,0,0,0,1.0,1,1.0,1,1.0,1,0.2669706229715083,27
2233,0,7310,1660,5650,0,0,0,1.0,1,1.0,1,1.0,1,0.26373467294694886,28
2234,5,7315,1664,5651,0,0,0,1.0,1,1.0,1,1.0,1,0.18237985276100824,26
2235,3,7318,1665,5653,0,0,0,1.0,1,1.0,1,1.0,1,0.1970590008439836,26
2236,3,7321,1666,5655,0,0,0,1.0,1,1.0,1,1.0,1,0.12720713368191275,26
2237,2,7323,1668,5655,0,0,0,1.0,1,1.0,1,1.0,1,0.14709100844833783,26
2238,4,7327,1671,5656,0,0,0,1.0,1,1.0,1,1.0,1,0.214964031025464,27
2239,3,7330,1672,5658,0,0,0,1.0,1,1.0,1,1.0,1,0.2207232469844143,28
2240,3,7333,1674,5659,0,0,0,1.0,1,1.0,1,1.0,1,0.2000538785123677,30
2241,0,7333,1674,5659,0,0,0,1.0,1,1.0,1,1.0,1,0.2474301858024864,29
2242,1,7334,1674,5660,0,0,0,1.0,1,1.0,1,1.0,1,0.25083276722782283,29
2243,2,7336,1676,5660,0,0,0,1.0,1,1.0,1,1.0,1,0.2682904791471281,29
2244,1,7337,1676,5661,0,0,0,1.0,1,1.0,1,1.0,1,0.2344574160766146,29
2245,6,7343,1677,5666,0,0,0,1.0,1,1.0,1,1.0,1,0.2787302933403677,30
2246,2,7345,1677,5668,0,0,0,1.0,1,1.0,1,1.0,1,0.2595367433664919,33
2247,7,7352,1677,5675,0,0,0,1.0,1,1.0,1,1.0,1,0.2691920142349948,34
2248,7,7359,1677,5682,0,0,0,1.0,1,1.0,1,1.0,1,0.3001485406064274,34
2249,5,7364,1677,5687,0,0,0,1.0,1,1.0,1,1.0,1,0.26177301819754134,35
2250,4,7368,1677,5691,0,0,0,1.0,1,1.0,1,1.0,1,0.2858264539239406,35
2251,6,7374,1678,5696,0,0,0,1.0,1,1.0,1,1.0,1,0.18729375402363152,36
2252,3,7377,1679,5698,0,0,0,1.0,1,1.0,1,1.0,1,0.18295765206619757,37
2253,2,7379,1680,5699,0,0,0,1.0,1,1.0,1,1.0,1,0.16049270181400935,35
2254,0,7379,1680,5699,0,0,0,1.0,1,1.0,1,1.0,1,0.18373458164885534,33
2255,2,7381,1680,5701,0,0,0,1.0,1,1.0,1,1.0,1,0.13914192970215714,35
2256,1,7382,1680,5702,0,0,0,1.0,1,1.0,1,1.0,1,0.17057579269045703,34
2257,1,7383,1681,5702,0,0,0,1.0,1,1.0,1,1.0,1,0.12605890080200574,36
2258,0,7383,1681,5702,0,0,0,1.0,1,1.0,1,1.0,1,0.15836697801874003,35
2259,1,7384,1682,5702,0,0,0,1.0,1,1.0,1,1.0,1,0.1662932852365888,35
2260,4,7388,1682,5706,0,0,0,1.0,1,1.0,1,1.0,1,0.16523591486969086,33
2261,3,7391,1683,5708,0,0,0,1.0,1,1.0,1,1.0,1,0.16187082727892455,33
2262,3,7394,1684,5710,0,0,0,1.0,1,1.0,1,1.0,1,0.24026543845744358,32
2263,2,7396,1686,5710,0,0,0,1.0,1,1.0,1,1.0,1,0.2717278212289293,31
2264,2,7398,1688,5710,0,0,0,1.0,1,1.0,1,1.0,1,0.33665767089669185,30
2265,3,7401,1688,5713,0,0,0,1.0,1,1.0,1,1.0,1,0.23055366410606729,29
2266,2,7403,1688,5715,0,0,0,1.0,1,1.0,1,1.0,1,0.1612133056220957,30
2267,2,7405,1690,5715,0,0,0,1.0,1,1.0,1,1.0,1,0.21003354394048,29
2268,5,7410,1693,5717,0,0,0,1.0,1,1.0,1,1.0,1,0.23031454835119405,30
2269,4,7414,1696,5718,0,0,0,1.0,1,1.0,1,1.0,1,0.2871422409609885,31
2270,4,7418,1696,5722,0,0,0,1.0,1,1.0,1,1.0,1,0.23701583620983216,31
2271,2,7420,1697,5723,0,0,0,1.0,1,1.0,1,1.0,1,0.22788219673133903,31
2272,5,7425,1699,5726,0,0,0,1.0,1,1.0,1,1.0,1,0.25981994123026836,31
2273,0,7425,1699,5726,0,0,0,1.0,1,1.0,1,1.0,1,0.2663771985718376,30
2274,0,7425,1699,5726,0,0,0,1.0,1,1.0,1,1.0,1,0.2628881064674889,31
2275,1,7426,1699,5727,0,0,0,1.0,1,1.0,1,1.0,1,0.23731916096508837,32
2276,1,7427,1700,5727,0,0,0,1.0,1,1.0,1,1.0,1,0.25861558620270736,31
2277,1,7428,1700,5728,0,0,0,1.0,1,1.0,1,1.0,1,0.24626759482098212,31
2278,1,7429,1701,5728,0,0,0,1.0,1,1.0,1,1.0,1,0.26755795090678536,32
2279,0,7429,1701,5728,0,0,0,1.0,1,1.0,1,1.0,1,0.27321752726080223,32
2280,2,7431,1701,5730,0,0,0,1.0,1,1.0,1,1.0,1,0.2709132720388653,33
2281,8,7439,1701,5738,0,0,0,1.0,1,1.0,1,1.0,1,0.11260091023436783,34
2282,1,7440,1701,5739,0,0,0,1.0,1,1.0,1,1.0,1,0.12557572739872985,34
2283,0,7440,1701,5739,0,0,0,1.0,1,1.0,1,1.0,1,0.12557572739872985,34
2284,2,7442,1701,5741,0,0,0,1.0,1,1.0,1,1.0,1,0.13634464719811953,34
2285,2,7444,1701,5743,0,0,0,1.0,1,1.0,1,1.0,1,0.14194883746376094,35
2286,0,7444,1701,5743,0,0,0,1.0,1,1.0,1,1.0,1,0.1574429692340583,34
2287,1,7445,1702,5743,0,0,0,1.0,1,1.0,1,1.0,1,0.1508553172633411,35
2288,1,7446,1702,5744,0,0,0,1.0,1,1.0,1,1.0,1,0.22135531431802027,35
2289,4,7450,1703,5747,0,0,0,1.0,1,1.0,1,1.0,1,0.24460135680408276,37
2290,5,7455,1704,5751,0,0,0,1.0,1,1.0,1,1.0,1,0.27018008069483074,37
2291,3,7458,1705,5753,0,0,0,1.0,1,1.0,1,1.0,1,0.28266630206180293,35
2292,4,7462,1705,5757,0,0,0,1.0,1,1.0,1,1.0,1,0.28968373561948135,35
2293,2,7464,1705,5759,0,0,0,1.0,1,1.0,1,1.0,1,0.2628729140568066,34
2294,5,7469,1705,5764,0,0,0,1.0,1,1.0,1,1.0,1,0.3027401451776698,33
2295,6,7475,1705,5770,0,0,0,1.0,1,1.0,1,1.0,1,0.278278862369453,34
2296,3,7478,1705,5773,0,0,0,1.0,1,1.0,1,1.0,1,0.21216745412847715,33
2297,4,7482,1706,5776,0,0,0,1.0,1,1.0,1,1.0,1,0.1800672117294312,32
2298,1,7483,1706,5777,0,0,0,1.0,1,1.0,1,1.0,1,0.19215440184558447,32
2299,0,7483,1706,5777,0,0,0,1.0,1,1.0,1,1.0,1,0.19580464531064606,33
2300,2,7485,1706,5779,0,0,0,1.0,1,1.0,1,1.0,1,0.1644703986520248,33
2301,0,7485,1706,5779,0,0,0,1.0,1,1.0,1,1.0,1,0.1644703986520248,33
2302,5,7490,1708,5782,0,0,0,1.0,1,1.0,1,1.0,1,0.1986315923706531,34
2303,6,7496,1711,5785,0,0,0,1.0,1,1.0,1,1.0,1,0.18252231775197328,34
2304,5,7501,1713,5788,0,0,0,1.0,1,1.0,1,1.0,1,0.14866909686162297,33
2305,3,7504,1714,5790,0,0,0,1.0,1,1.0,1,1.0,1,0.15856013932197674,33
2306,4,7508,1715,5793,0,0,0,1.0,1,1.0,1,1.0,1,0.20485561748440256,33
2307,3,7511,1716,5795,0,0,0,1.0,1,1.0,1,1.0,1,0.19178510387255585,35
2308,3,7514,1717,5797,0,0,0,1.0,1,1.0,1,1.0,1,0.20916190753375005,34
2309,4,7518,1719,5799,0,0,0,1.0,1,1.0,1,1.0,1,0.2147657233942742,34
2310,3,7521,1719,5802,0,0,0,1.0,1,1.0,1,1.0,1,0.1867392695550064,34
2311,4,7525,1720,5805,0,0,0,1.0,1,1.0,1,1.0,1,0.10032345799020055,35
2312,1,7526,1721,5805,0,0,0,1.0,1,1.0,1,1.0,1,0.11005616848932856,34
2313,4,7530,1722,5808,0,0,0,1.0,1,1.0,1,1.0,1,0.12361168775953585,35
2314,1,7531,1722,5809,0,0,0,1.0,1,1.0,1,1.0,1,0.09619606827158711,35
2315,0,7531,1722,5809,0,0,0,1.0,1,1.0,1,1.0,1,0.10550975018580734,34
2316,4,7535,1724,5811,0,0,0,1.0,1,1.0,1,1.0,1,0.16887664152784773,35
2317,1,7536,1724,5812,0,0,0,1.0,1,1.0,1,1.0,1,0.1869044681647943,32
2318,3,7539,1725,5814,0,0,0,1.0,1,1.0,1,1.0,1,0.2195428789221809,32
2319,2,7541,1726,5815,0,0,0,1.0,1,1.0,1,1.0,1,0.2816006689459701,32
2320,4,7545,1726,5819,0,0,0,1.0,1,1.0,1,1.0,1,0.29924754841219087,32
2321,5,7550,1726,5824,0,0,0,1.0,1,1.0,1,1.0,1,0.2838656885129307,33
2322,4,7554,1726,5828,0,0,0,1.0,1,1.0,1,1.0,1,0.2838656885129307,33
2323,4,7558,1727,5831,0,0,0,1.0,1,1.0,1,1.0,1,0.32789599834398464,33
2324,4,7562,1727,5835,0,0,0,1.0,1,1.0,1,1.0,1,0.2842870025216953,34
2325,5,7567,1727,5840,0,0,0,1.0,1,1.0,1,1.0,1,0.3148369190327377,35
2326,11,7578,1728,5850,0,0,0,1.0,1,1.0,1,1.0,1,0.12719330599643616,35
2327,2,7580,1728,5852,0,0,0,1.0,1,1.0,1,1.0,1,0.134910809408497,36
2328,3,7583,1728,5855,0,0,0,1.0,1,1.0,1,1.0,1,0.1325209596173788,37
2329,3,7586,1728,5858,0,0,0,1.0,1,1.0,1,1.0,1,0.17096590864121175,37
2330,3,7589,1728,5861,0,0,0,1.0,1,1.0,1,1.0,1,0.19235693364726347,38
2331,3,7592,1728,5864,0,0,0,1.0,1,1.0,1,1.0,1,0.19317355822977578,40
2332,6,7598,1728,5870,0,0,0,1.0,1,1.0,1,1.0,1,0.19356401686507899,40
2333,3,7601,1728,5873,0,0,0,1.0,1,1.0,1,1.0,1,0.16157593840336784,41
2334,2,7603,1728,5875,0,0,0,1.0,1,1.0,1,1.0,1,0.15573927416469302,41
2335,4,7607,1728,5879,0,0,0,1.0,1,1.0,1,1.0,1,0.15573927416469302,41
2336,8,7615,1728,5887,0,0,0,1.0,1,1.0,1,1.0,1,0.15383672284222674,41
2337,6,7621,1728,5893,0,0,0,1.0,1,1.0,1,1.0,1,0.14723246776080634,42
2338,6,7627,1728,5899,0,0,0,1.0,1,1.0,1,1.0,1,0.1643729288261486,43
2339,6,7633,1728,5905,0,0,0,1.0,1,1.0,1,1.0,1,0.17028322576777308,43
2340,7,7640,1728,5912,0,0,0,1.0,1,1.0,1,1.0,1,0.1475192147411118,45
2341,7,7647,1728,5919,0,0,0,1.0,1,1.0,1,1.0,1,0.09143810696154281,45
2342,7,7654,1728,5926,0,0,0,1.0,1,1.0,1,1.0,1,0.14654159252681145,46
2343,6,7660,1729,5931,0,0,0,1.0,1,1.0,1,1.0,1,0.13850861796707492,45
2344,7,7667,1731,5936,0,0,0,1.0,1,1.0,1,1.0,1,0.10977253939176558,44
2345,8,7675,1731,5944,0,0,0,1.0,1,1.0,1,1.0,1,0.16625937019706086,44
2346,11,7686,1732,5954,0,0,0,1.0,1,1.0,1,1.0,1,0.19737951578648408,44
2347,9,7695,1733,5962,0,0,0,1.0,1,1.0,1,1.0,1,0.12023928294266316,44
2348,10,7705,1733,5972,0,0,0,1.0,1,1.0,1,1.0,1,0.12688916647649795,45
2349,12,7717,1733,5984,0,0,0,1.0,1,1.0,1,1.0,1,0.13120480023937123,46
2350,9,7726,1733,5993,0,0,0,1.0,1,1.0,1,1.0,1,0.23160760742337416,47
2351,9,7735,1733,6002,0,0,0,1.0,1,1.0,1,1.0,1,0.19827179183802446,47
2352,10,7745,1733,6012,0,0,0,1.0,1,1.0,1,1.0,1,0.19736614385658394,47
2353,7,7752,1733,6019,0,0,0,1.0,1,1.0,1,1.0,1,0.2154841909053474,46
2354,6,7758,1734,6024,0,0,0,1.0,1,1.0,1,1.0,1,0.1534009776858793,47
2355,9,7767,1734,6033,0,0,0,1.0,1,1.0,1,1.0,1,0.18889770002399933,47
2356,5,7772,1735,6037,0,0,0,1.0,1,1.0,1,1.0,1,0.13483610579900937,47
2357,2,7774,1735,6039,0,0,0,1.0,1,1.0,1,1.0,1,0.11380052907476726,47
2358,4,7778,1736,6042,0,0,0,1.0,1,1.0,1,1.0,1,0.15694520913750032,48
2359,3,7781,1736,6045,0,0,0,1.0,1,1.0,1,1.0,1,0.14164016759123707,49
2360,1,7782,1736,6046,0,0,0,1.0,1,1.0,1,1.0,1,0.14416578446457196,49
2361,4,7786,1736,6050,0,0,0,1.0,1,1.0,1,1.0,1,0.12499817233862075,50
2362,2,7788,1736,6052,0,0,0,1.0,1,1.0,1,1.0,1,0.1610968691761259,51
2363,4,7792,1736,6056,0,0,0,1.0,1,1.0,1,1.0,1,0.1610968691761259,51
2364,6,7798,1736,6062,0,0,0,1.0,1,1.0,1,1.0,1,0.12754585813720482,52
2365,9,7807,1739,6068,0,0,0,1.0,1,1.0,1,1.0,1,0.12899507792826198,53
2366,11,7818,1741,6077,0,0,0,1.0,1,1.0,1,1.0,1,0.17061434597236871,54
2367,8,7826,1742,6084,0,0,0,1.0,1,1.0,1,1.0,1,0.17231339951759808,52
2368,4,7830,1743,6087,0,0,0,1.0,1,1.0,1,1.0,1,0.1371906281043594,51
2369,4,7834,1743,6091,0,0,0,1.0,1,1.0,1,1.0,1,0.21331086266857932,51
2370,7,7841,1747,6094,0,0,0,1.0,1,1.0,1,1.0,1,0.18892940163619165,52
2371,18,7859,1750,6109,0,0,0,1.0,1,1.0,1,1.0,1,0.16589372900559662,52
2372,8,7867,1751,6116,0,0,0,1.0,1,1.0,1,1.0,1,0.18225138518095266,49
2373,9,7876,1752,6124,0,0,0,1.0,1,1.0,1,1.0,1,0.21819675543742567,47
2374,8,7884,1752,6132,0,0,0,1.0,1,1.0,1,1.0,1,0.22024085553668604,45
2375,6,7890,1752,6138,0,0,0,1.0,1,1.0,1,1.0,1,0.1959559562266282,45
2376,4,7894,1752,6142,0,0,0,1.0,1,1.0,1,1.0,1,0.2384190525486679,43
2377,7,7901,1752,6149,0,0,0,1.0,1,1.0,1,1.0,1,0.1832593483034882,44
2378,5,7906,1752,6154,0,0,0,1.0,1,1.0,1,1.0,1,0.21200895347858661,43
2379,2,7908,1752,6156,0,0,0,1.0,1,1.0,1,1.0,1,0.17632275369579284,43
2380,4,7912,1752,6160,0,0,0,1.0,1,1.0,1,1.0,1,0.21200895347858661,43
2381,6,7918,1755,6163,0,0,0,1.0,1,1.0,1,1.0,1,0.2596097692182055,44
2382,6,7924,1756,6168,0,0,0,1.0,1,1.0,1,1.0,1,0.24213898789110502,44
2383,6,7930,1757,6173,0,0,0,1.0,1,1.0,1,1.0,1,0.2596742817069399,45
2384,7,7937,1758,6179,0,0,0,1.0,1,1.0,1,1.0,1,0.190351847342185,45
2385,3,7940,1758,6182,0,0,0,1.0,1,1.0,1,1.0,1,0.21695238712620085,45
2386,10,7950,1760,6190,0,0,0,1.0,1,1.0,1,1.0,1,0.13402665952807347,46
2387,3,7953,1761,6192,0,0,0,1.0,1,1.0,1,1.0,1,0.12387080744798695,44
2388,1,7954,1761,6193,0,0,0,1.0,1,1.0,1,1.0,1,0.11817901758964318,44
2389,2,7956,1761,6195,0,0,0,1.0,1,1.0,1,1.0,1,0.16397551580432124,43
2390,9,7965,1765,6200,0,0,0,1.0,1,1.0,1,1.0,1,0.10108017116949806,44
2391,2,7967,1766,6201,0,0,0,1.0,1,1.0,1,1.0,1,0.109408498702356,43
2392,3,7970,1767,6203,0,0,0,1.0,1,1.0,1,1.0,1,0.16487529454608174,44
2393,2,7972,1768,6204,0,0,0,1.0,1,1.0,1,1.0,1,0.12620788284137324,45
2394,0,7972,1768,6204,0,0,0,1.0,1,1.0,1,1.0,1,0.15109563203844076,44
2395,1,7973,1768,6205,0,0,0,1.0,1,1.0,1,1.0,1,0.13113002323004333,44
2396,2,7975,1770,6205,0,0,0,1.0,1,1.0,1,1.0,1,0.14769152610943737,45
2397,1,7976,1770,6206,0,0,0,1.0,1,1.0,1,1.0,1,0.14687673101262474,44
2398,2,7978,1771,6207,0,0,0,1.0,1,1.0,1,1.0,1,0.21065570697321429,44
2399,0,7978,1771,6207,0,0,0,1.0,1,1.0,1,1.0,1,0.2171777606818865,45
2400,2,7980,1771,6209,0,0,0,1.0,1,1.0,1,1.0,1,0.2171777606818865,45
2401,4,7984,1771,6213,0,0,0,1.0,1,1.0,1,1.0,1,0.16699387161892598,46
2402,2,7986,1771,6215,0,0,0,1.0,1,1.0,1,1.0,1,0.13595636913321857,47
2403,5,7991,1772,6219,0,0,0,1.0,1,1.0,1,1.0,1,0.11411097780630368,48
2404,4,7995,1773,6222,0,0,0,1.0,1,1.0,1,1.0,1,0.14348925858810088,47
2405,3,7998,1773,6225,0,0,0,1.0,1,1.0,1,1.0,1,0.14524740990469415,45
2406,5,8003,1774,6229,0,0,0,1.0,1,1.0,1,1.0,1,0.1290291458183888,45
2407,3,8006,1774,6232,0,0,0,1.0,1,1.0,1,1.0,1,0.17932692179123128,42
2408,6,8012,1774,6238,0,0,0,1.0,1,1.0,1,1.0,1,0.19434823385224081,41
2409,3,8015,1774,6241,0,0,0,1.0,1,1.0,1,1.0,1,0.2315369604582607,41
2410,7,8022,1774,6248,0,0,0,1.0,1,1.0,1,1.0,1,0.25051276545303475,40
2411,7,8029,1778,6251,0,0,0,1.0,1,1.0,1,1.0,1,0.28241447099179284,40
2412,5,8034,1780,6254,0,0,0,1.0,1,1.0,1,1.0,1,0.31762913781868873,38
2413,11,8045,1784,6261,0,0,0,1.0,1,1.0,1,1.0,1,0.33108497495964045,38
2414,5,8050,1785,6265,0,0,0,1.0,1,1.0,1,1.0,1,0.3331241967053587,36
2415,4,8054,1785,6269,0,0,0,1.0,1,1.0,1,1.0,1,0.3485772343115335,36
2416,7,8061,1787,6274,0,0,0,1.0,1,1.0,1,1.0,1,0.2629217690479874,35
2417,1,8062,1787,6275,0,0,0,1.0,1,1.0,1,1.0,1,0.3140810905415299,33
2418,3,8065,1787,6278,0,0,0,1.0,1,1.0,1,1.0,1,0.2872626674579523,33
2419,2,8067,1788,6279,0,0,0,1.0,1,1.0,1,1.0,1,0.30408659210887756,33
2420,4,8071,1788,6283,0,0,0,1.0,1,1.0,1,1.0,1,0.23478306438079938,34
2421,3,8074,1788,6286,0,0,0,1.0,1,1.0,1,1.0,1,0.22257403197816594,34
2422,12,8086,1790,6296,0,0,0,1.0,1,1.0,1,1.0,1,0.23174330022794548,35
2423,7,8093,1791,6302,0,0,0,1.0,1,1.0,1,1.0,1,0.25187533648099836,36
2424,6,8099,1793,6306,0,0,0,1.0,1,1.0,1,1.0,1,0.22878089255412168,35
2425,4,8103,1794,6309,0,0,0,1.0,1,1.0,1,1.0,1,0.20423960905608643,33
2426,8,8111,1795,6316,0,0,0,1.0,1,1.0,1,1.0,1,0.20553151020364022,34
2427,5,8116,1796,6320,0,0,0,1.0,1,1.0,1,1.0,1,0.21366488948023832,34
2428,6,8122,1797,6325,0,0,0,1.0,1,1.0,1,1.0,1,0.2216812950695819,34
2429,4,8126,1797,6329,0,0,0,1.0,1,1.0,1,1.0,1,0.21077806592052623,34
2430,3,8129,1797,6332,0,0,0,1.0,1,1.0,1,1.0,1,0.21959585019981095,33
2431,3,8132,1798,6334,0,0,0,1.0,1,1.0,1,1.0,1,0.15764927068542275,33
2432,1,8133,1798,6335,0,0,0,1.0,1,1.0,1,1.0,1,0.1705949949857795,33
2433,1,8134,1799,6335,0,0,0,1.0,1,1.0,1,1.0,1,0.15458925374030658,34
2434,1,8135,1800,6335,0,0,0,1.0,1,1.0,1,1.0,1,0.1292038315302233,34
2435,0,8135,1800,6335,0,0,0,1.0,1,1.0,1,1.0,1,0.1292038315302233,34
2436,0,8135,1800,6335,0,0,0,1.0,1,1.0,1,1.0,1,0.12319054599042918,33
2437,2,8137,1801,6336,0,0,0,1.0,1,1.0,1,1.0,1,0.16026141796854013,33
2438,2,8139,1802,6337,0,0,0,1.0,1,1.0,1,1.0,1,0.19722647204427363,34
2439,4,8143,1802,6341,0,0,0,1.0,1,1.0,1,1.0,1,0.1584696604251005,35
2440,1,8144,1802,6342,0,0,0,1.0,1,1.0,1,1.0,1,0.14591504438265893,35
2441,2,8146,1804,6342,0,0,0,1.0,1,1.0,1,1.0,1,0.1878103516133667,35
2442,3,8149,1804,6345,0,0,0,1.0,1,1.0,1,1.0,1,0.16213980575342063,35
2443,3,8152,1804,6348,0,0,0,1.0,1,1.0,1,1.0,1,0.1344720451486815,35
2444,3,8155,1805,6350,0,0,0,1.0,1,1.0,1,1.0,1,0.16254456693630126,34
2445,3,8158,1806,6352,0,0,0,1.0,1,1.0,1,1.0,1,0.2448363764741552,33
2446,5,8163,1807,6356,0,0,0,1.0,1,1.0,1,1.0,1,0.2666818543672731,30
2447,0,8163,1807,6356,0,0,0,1.0,1,1.0,1,1.0,1,0.24374459294372533,29
2448,1,8164,1808,6356,0,0,0,1.0,1,1.0,1,1.0,1,0.3035952525356713,27
2449,1,8165,1808,6357,0,0,0,1.0,1,1.0,1,1.0,1,0.26598716647729853,26
2450,4,8169,1810,6359,0,0,0,1.0,1,1.0,1,1.0,1,0.22397594736635845,28
2451,3,8172,1810,6362,0,0,0,1.0,1,1.0,1,1.0,1,0.19600442447306896,28
2452,0,8172,1810,6362,0,0,0,1.0,1,1.0,1,1.0,1,0.22203890215243868,29
2453,1,8173,1811,6362,0,0,0,1.0,1,1.0,1,1.0,1,0.1914637701437116,30
2454,0,8173,1811,6362,0,0,0,1.0,1,1.0,1,1.0,1,0.20619929440100498,32
2455,2,8175,1813,6362,0,0,0,1.0,1,1.0,1,1.0,1,0.2102859071838137,33
2456,3,8178,1814,6364,0,0,0,1.0,1,1.0,1,1.0,1,0.1988199115150447,34
2457,1,8179,1815,6364,0,0,0,1.0,1,1.0,1,1.0,1,0.18238097263055883,34
2458,4,8183,1815,6368,0,0,0,1.0,1,1.0,1,1.0,1,0.16951958446118318,36
2459,1,8184,1815,6369,0,0,0,1.0,1,1.0,1,1.0,1,0.19310409065638895,36
2460,3,8187,1817,6370,0,0,0,1.0,1,1.0,1,1.0,1,0.2521757010687019,37
2461,6,8193,1818,6375,0,0,0,1.0,1,1.0,1,1.0,1,0.12469634069888395,37
2462,2,8195,1820,6375,0,0,0,1.0,1,1.0,1,1.0,1,0.1904059800912593,38
2463,1,8196,1820,6376,0,0,0,1.0,1,1.0,1,1.0,1,0.130795858860268,38
2464,0,8196,1820,6376,0,0,0,1.0,1,1.0,1,1.0,1,0.11756909576993706,37
2465,1,8197,1821,6376,0,0,0,1.0,1,1.0,1,1.0,1,0.10242718673171301,36
2466,5,8202,1825,6377,0,0,0,1.0,1,1.0,1,1.0,1,0.24013653229826784,36
2467,2,8204,1826,6378,0,0,0,1.0,1,1.0,1,1.0,1,0.1972744942983062,34
2468,2,8206,1827,6379,0,0,0,1.0,1,1.0,1,1.0,1,0.21273384289321823,33
2469,2,8208,1828,6380,0,0,0,1.0,1,1.0,1,1.0,1,0.20520657709973264,32
2470,5,8213,1830,6383,0,0,0,1.0,1,1.0,1,1.0,1,0.2545736473771256,33
2471,3,8216,1830,6386,0,0,0,1.0,1,1.0,1,1.0,1,0.24870780137080561,31
2472,3,8219,1831,6388,0,0,0,1.0,1,1.0,1,1.0,1,0.28112351048423473,32
2473,2,8221,1832,6389,0,0,0,1.0,1,1.0,1,1.0,1,0.2509307974987646,31
2474,4,8225,1833,6392,0,0,0,1.0,1,1.0,1,1.0,1,0.3050576726291353,33
2475,2,8227,1834,6393,0,0,0,1.0,1,1.0,1,1.0,1,0.26661970050765926,33
2476,5,8232,1835,6397,0,0,0,1.0,1,1.0,1,1.0,1,0.12110475572700036,33
2477,5,8237,1836,6401,0,0,0,1.0,1,1.0,1,1.0,1,0.14378253474962077,33
2478,2,8239,1837,6402,0,0,0,1.0,1,1.0,1,1.0,1,0.1444192687683111,33
2479,8,8247,1839,6408,0,0,0,1.0,1,1.0,1,1.0,1,0.20272936868548153,33
2480,7,8254,1840,6414,0,0,0,1.0,1,1.0,1,1.0,1,0.23779330916042507,34
2481,4,8258,1840,6418,0,0,0,1.0,1,1.0,1,1.0,1,0.3168796251389359,33
2482,5,8263,1840,6423,0,0,0,1.0,1,1.0,1,1.0,1,0.34024624592502284,34
2483,3,8266,1840,6426,0,0,0,1.0,1,1.0,1,1.0,1,0.29842936600789827,33
2484,5,8271,1840,6431,0,0,0,1.0,1,1.0,1,1.0,1,0.30458469676819633,32
2485,3,8274,1841,6433,0,0,0,1.0,1,1.0,1,1.0,1,0.3484573664407384,31
2486,4,8278,1843,6435,0,0,0,1.0,1,1.0,1,1.0,1,0.2658626301611544,29
2487,3,8281,1844,6437,0,0,0,1.0,1,1.0,1,1.0,1,0.27484894476821053,29
2488,4,8285,1845,6440,0,0,0,1.0,1,1.0,1,1.0,1,0.31831355805605244,30
2489,3,8288,1845,6443,0,0,0,1.0,1,1.0,1,1.0,1,0.2958338878756118,29
2490,3,8291,1846,6445,0,0,0,1.0,1,1.0,1,1.0,1,0.32605046041151664,30
2491,4,8295,1846,6449,0,0,0,1.0,1,1.0,1,1.0,1,0.20755319673535286,30
2492,1,8296,1846,6450,0,0,0,1.0,1,1.0,1,1.0,1,0.22952392385658155,29
2493,1,8297,1846,6451,0,0,0,1.0,1,1.0,1,1.0,1,0.22367863356120413,29
2494,2,8299,1846,6453,0,0,0,1.0,1,1.0,1,1.0,1,0.2550544893315805,28
2495,1,8300,1846,6454,0,0,0,1.0,1,1.0,1,1.0,1,0.2504787492635508,29
2496,1,8301,1846,6455,0,0,0,1.0,1,1.0,1,1.0,1,0.24721023450386914,28
2497,3,8304,1846,6458,0,0,0,1.0,1,1.0,1,1.0,1,0.24386271248097655,28
2498,2,8306,1846,6460,0,0,0,1.0,1,1.0,1,1.0,1,0.20794889518430668,29
2499,4,8310,1846,6464,0,0,0,1.0,1,1.0,1,1.0,1,0.26627738181732136,30
2500,5,8315,1846,6469,0,0,0,1.0,1,1.0,1,1.0,1,0.24809234504654484,29
2501,4,8319,1848,6471,0,0,0,1.0,1,1.0,1,1.0,1,0.20207323028360347,33
2502,8,8327,1850,6477,0,0,0,1.0,1,1.0,1,1.0,1,0.2643946333911105,33
2503,7,8334,1851,6483,0,0,0,1.0,1,1.0,1,1.0,1,0.2238183306518594,31
2504,6,8340,1854,6486,0,0,0,1.0,1,1.0,1,1.0,1,0.2697387351105991,31
2505,3,8343,1855,6488,0,0,0,1.0,1,1.0,1,1.0,1,0.25364530356592196,32
2506,5,8348,1857,6491,0,0,0,1.0,1,1.0,1,1.0,1,0.22321494861035543,31
2507,3,8351,1859,6492,0,0,0,1.0,1,1.0,1,1.0,1,0.1909071865225887,29
2508,6,8357,1862,6495,0,0,0,1.0,1,1.0,1,1.0,1,0.18196875221990397,31
2509,2,8359,1863,6496,0,0,0,1.0,1,1.0,1,1.0,1,0.16310212133546817,30
2510,4,8363,1863,6500,0,0,0,1.0,1,1.0,1,1.0,1,0.15695335437821994,31
2511,3,8366,1864,6502,0,0,0,1.0,1,1.0,1,1.0,1,0.13735176473601046,32
2512,2,8368,1864,6504,0,0,0,1.0,1,1.0,1,1.0,1,0.13735176473601046,32
2513,6,8374,1865,6509,0,0,0,1.0,1,1.0,1,1.0,1,0.11116506133562476,34
2514,1,8375,1865,6510,0,0,0,1.0,1,1.0,1,1.0,1,0.13956657698420405,35
2515,5,8380,1866,6514,0,0,0,1.0,1,1.0,1,1.0,1,0.15247990460684424,35
2516,8,8388,1867,6521,0,0,0,1.0,1,1.0,1,1.0,1,0.19564035223112647,34
2517,5,8393,1868,6525,0,0,0,1.0,1,1.0,1,1.0,1,0.20196515699068576,34
2518,4,8397,1870,6527,0,0,0,1.0,1,1.0,1,1.0,1,0.2427668851856517,33
2519,6,8403,1870,6533,0,0,0,1.0,1,1.0,1,1.0,1,0.19044593196472254,32
2520,6,8409,1872,6537,0,0,0,1.0,1,1.0,1,1.0,1,0.22571781134110944,31
2521,2,8411,1872,6539,0,0,0,1.0,1,1.0,1,1.0,1,0.13960639476458175,31
2522,0,8411,1872,6539,0,0,0,1.0,1,1.0,1,1.0,1,0.13698814342333307,30
2523,0,8411,1872,6539,0,0,0,1.0,1,1.0,1,1.0,1,0.14275950580877803,30
2524,0,8411,1872,6539,0,0,0,1.0,1,1.0,1,1.0,1,0.1907155903359408,29
2525,2,8413,1873,6540,0,0,0,1.0,1,1.0,1,1.0,1,0.2043961279868172,29
2526,0,8413,1873,6540,0,0,0,1.0,1,1.0,1,1.0,1,0.20266197200602976,27
2527,0,8413,1873,6540,0,0,0,1.0,1,1.0,1,1.0,1,0.22906699213934012,28
2528,0,8413,1873,6540,0,0,0,1.0,1,1.0,1,1.0,1,0.22906699213934012,28
2529,0,8413,1873,6540,0,0,0,1.0,1,1.0,1,1.0,1,0.22906699213934012,28
2530,0,8413,1873,6540,0,0,0,1.0,1,1.0,1,1.0,1,0.23785577997495078,29
2531,2,8415,1873,6542,0,0,0,1.0,1,1.0,1,1.0,1,0.17937882438299585,30
2532,1,8416,1873,6543,0,0,0,1.0,1,1.0,1,1.0,1,0.1707937052161238,31
2533,0,8416,1873,6543,0,0,0,1.0,1,1.0,1,1.0,1,0.1707937052161238,31
2534,0,8416,1873,6543,0,0,0,1.0,1,1.0,1,1.0,1,0.1707937052161238,31
2535,1,8417,1874,6543,0,0,0,1.0,1,1.0,1,1.0,1,0.24078587762766,31
2536,2,8419,1874,6545,0,0,0,1.0,1,1.0,1,1.0,1,0.22604111351388043,32
2537,2,8421,1875,6546,0,0,0,1.0,1,1.0,1,1.0,1,0.16371017047446257,33
2538,1,8422,1875,6547,0,0,0,1.0,1,1.0,1,1.0,1,0.1882238806488873,35
2539,2,8424,1876,6548,0,0,0,1.0,1,1.0,1,1.0,1,0.19180981784367634,37
2540,3,8427,1878,6549,0,0,0,1.0,1,1.0,1,1.0,1,0.21705616575993758,38
2541,6,8433,1879,6554,0,0,0,1.0,1,1.0,1,1.0,1,0.20941128157135838,39
2542,11,8444,1880,6564,0,0,0,1.0,1,1.0,1,1.0,1,0.17722453003066896,38
2543,6,8450,1883,6567,0,0,0,1.0,1,1.0,1,1.0,1,0.18628890843432572,41
2544,4,8454,1883,6571,0,0,0,1.0,1,1.0,1,1.0,1,0.12650142669393472,39
2545,5,8459,1884,6575,0,0,0,1.0,1,1.0,1,1.0,1,0.11848045729744787,40
2546,2,8461,1885,6576,0,0,0,1.0,1,1.0,1,1.0,1,0.16409538718490474,38
2547,5,8466,1887,6579,0,0,0,1.0,1,1.0,1,1.0,1,0.15195657639896737,38
2548,0,8466,1887,6579,0,0,0,1.0,1,1.0,1,1.0,1,0.19924172737165574,35
2549,3,8469,1889,6580,0,0,0,1.0,1,1.0,1,1.0,1,0.2366484202442542,35
2550,1,8470,1890,6580,0,0,0,1.0,1,1.0,1,1.0,1,0.25846690252963517,33
2551,5,8475,1891,6584,0,0,0,1.0,1,1.0,1,1.0,1,0.1658574749980706,31
2552,0,8475,1891,6584,0,0,0,1.0,1,1.0,1,1.0,1,0.14749551853388956,30
2553,0,8475,1891,6584,0,0,0,1.0,1,1.0,1,1.0,1,0.14749551853388956,30
2554,0,8475,1891,6584,0,0,0,1.0,1,1.0,1,1.0,1,0.14964477387573327,32
2555,1,8476,1891,6585,0,0,0,1.0,1,1.0,1,1.0,1,0.14809455100295582,32
2556,1,8477,1892,6585,0,0,0,1.0,1,1.0,1,1.0,1,0.16020548900318418,32
2557,1,8478,1893,6585,0,0,0,1.0,1,1.0,1,1.0,1,0.20281096817745062,30
2558,1,8479,1894,6585,0,0,0,1.0,1,1.0,1,1.0,1,0.20256270978115357,31
2559,0,8479,1894,6585,0,0,0,1.0,1,1.0,1,1.0,1,0.22935874995558048,30
2560,0,8479,1894,6585,0,0,0,1.0,1,1.0,1,1.0,1,0.22935874995558048,30
2561,0,8479,1894,6585,0,0,0,1.0,1,1.0,1,1.0,1,0.22935874995558048,30
2562,3,8482,1894,6588,0,0,0,1.0,1,1.0,1,1.0,1,0.1680772388922694,33
2563,3,8485,1894,6591,0,0,0,1.0,1,1.0,1,1.0,1,0.15623733640917037,33
2564,2,8487,1894,6593,0,0,0,1.0,1,1.0,1,1.0,1,0.16041400672371958,33
2565,1,8488,1894,6594,0,0,0,1.0,1,1.0,1,1.0,1,0.15997284887869798,33
2566,1,8489,1894,6595,0,0,0,1.0,1,1.0,1,1.0,1,0.13443617121402524,35
2567,1,8490,1895,6595,0,0,0,1.0,1,1.0,1,1.0,1,0.14493247716831562,36
2568,1,8491,1896,6595,0,0,0,1.0,1,1.0,1,1.0,1,0.22265543689018638,37
2569,4,8495,1896,6599,0,0,0,1.0,1,1.0,1,1.0,1,0.11834427647402224,37
2570,0,8495,1896,6599,0,0,0,1.0,1,1.0,1,1.0,1,0.14981360155115772,37
2571,0,8495,1896,6599,0,0,0,1.0,1,1.0,1,1.0,1,0.14981360155115772,37
2572,0,8495,1896,6599,0,0,0,1.0,1,1.0,1,1.0,1,0.12755926696784212,39
2573,1,8496,1896,6600,0,0,0,1.0,1,1.0,1,1.0,1,0.09792401380277639,39
2574,1,8497,1896,6601,0,0,0,1.0,1,1.0,1,1.0,1,0.14053157560038537,38
2575,2,8499,1897,6602,0,0,0,1.0,1,1.0,1,1.0,1,0.1259620227425212,38
2576,1,8500,1897,6603,0,0,0,1.0,1,1.0,1,1.0,1,0.14673384848947116,37
2577,3,8503,1898,6605,0,0,0,1.0,1,1.0,1,1.0,1,0.2294446747670602,39
2578,3,8506,1898,6608,0,0,0,1.0,1,1.0,1,1.0,1,0.21682502552574037,40
2579,2,8508,1898,6610,0,0,0,1.0,1,1.0,1,1.0,1,0.20855290008504887,41
2580,4,8512,1898,6614,0,0,0,1.0,1,1.0,1,1.0,1,0.17410943504703905,42
2581,4,8516,1898,6618,0,0,0,1.0,1,1.0,1,1.0,1,0.11605050432421526,43
2582,1,8517,1899,6618,0,0,0,1.0,1,1.0,1,1.0,1,0.12751339201212666,43
2583,3,8520,1900,6620,0,0,0,1.0,1,1.0,1,1.0,1,0.13076462223664573,43
2584,2,8522,1900,6622,0,0,0,1.0,1,1.0,1,1.0,1,0.13245613094572253,43
2585,5,8527,1900,6627,0,0,0,1.0,1,1.0,1,1.0,1,0.10007310644340173,44
2586,3,8530,1901,6629,0,0,0,1.0,1,1.0,1,1.0,1,0.11374998894433017,43
2587,8,8538,1905,6633,0,0,0,1.0,1,1.0,1,1.0,1,0.18510973030291428,44
2588,6,8544,1905,6639,0,0,0,1.0,1,1.0,1,1.0,1,0.17979537590232528,44
2589,5,8549,1907,6642,0,0,0,1.0,1,1.0,1,1.0,1,0.1649323729190104,44
2590,0,8549,1907,6642,0,0,0,1.0,1,1.0,1,1.0,1,0.1649323729190104,44
2591,0,8549,1907,6642,0,0,0,1.0,1,1.0,1,1.0,1,0.1649323729190104,44
2592,0,8549,1907,6642,0,0,0,1.0,1,1.0,1,1.0,1,0.1649323729190104,44
2593,0,8549,1907,6642,0,0,0,1.0,1,1.0,1,1.0,1,0.14867101377253444,43
2594,8,8557,1909,6648,0,0,0,1.0,1,1.0,1,1.0,1,0.14924625811627887,48
2595,4,8561,1909,6652,0,0,0,1.0,1,1.0,1,1.0,1,0.13894633523208413,45
2596,2,8563,1910,6653,0,0,0,1.0,1,1.0,1,1.0,1,0.09933590283122042,46
2597,0,8563,1910,6653,0,0,0,1.0,1,1.0,1,1.0,1,0.11062491068641797,45
2598,1,8564,1911,6653,0,0,0,1.0,1,1.0,1,1.0,1,0.09529731781968315,45
2599,5,8569,1915,6654,0,0,0,1.0,1,1.0,1,1.0,1,0.09318170795203286,45
2600,5,8574,1917,6657,0,0,0,1.0,1,1.0,1,1.0,1,0.1590082301170956,48
2601,1,8575,1917,6658,0,0,0,1.0,1,1.0,1,1.0,1,0.1453488385439814,47
2602,3,8578,1917,6661,0,0,0,1.0,1,1.0,1,1.0,1,0.15338669491377996,48
2603,1,8579,1917,6662,0,0,0,1.0,1,1.0,1,1.0,1,0.16047573056289544,48
2604,1,8580,1917,6663,0,0,0,1.0,1,1.0,1,1.0,1,0.16648138752869995,47
2605,2,8582,1919,6663,0,0,0,1.0,1,1.0,1,1.0,1,0.18949659540504327,47
2606,2,8584,1919,6665,0,0,0,1.0,1,1.0,1,1.0,1,0.17260172599014867,46
2607,3,8587,1919,6668,0,0,0,1.0,1,1.0,1,1.0,1,0.19888634972613636,45
2608,4,8591,1920,6671,0,0,0,1.0,1,1.0,1,1.0,1,0.1703006460196879,45
2609,2,8593,1921,6672,0,0,0,1.0,1,1.0,1,1.0,1,0.16665275700911086,44
2610,4,8597,1923,6674,0,0,0,1.0,1,1.0,1,1.0,1,0.2168433158180805,45
2611,4,8601,1923,6678,0,0,0,1.0,1,1.0,1,1.0,1,0.13191975088024946,46
2612,3,8604,1923,6681,0,0,0,1.0,1,1.0,1,1.0,1,0.11584033619283651,47
2613,4,8608,1924,6684,0,0,0,1.0,1,1.0,1,1.0,1,0.14073428913216268,48
2614,4,8612,1927,6685,0,0,0,1.0,1,1.0,1,1.0,1,0.19988995373756555,48
2615,2,8614,1929,6685,0,0,0,1.0,1,1.0,1,1.0,1,0.2079337114436656,49
2616,5,8619,1929,6690,0,0,0,1.0,1,1.0,1,1.0,1,0.15223084341168786,49
2617,3,8622,1929,6693,0,0,0,1.0,1,1.0,1,1.0,1,0.1623203381072608,48
2618,1,8623,1930,6693,0,0,0,1.0,1,1.0,1,1.0,1,0.13501774143731615,47
2619,3,8626,1930,6696,0,0,0,1.0,1,1.0,1,1.0,1,0.12441342173650616,50
2620,1,8627,1931,6696,0,0,0,1.0,1,1.0,1,1.0,1,0.15592376255824447,51
2621,0,8627,1931,6696,0,0,0,1.0,1,1.0,1,1.0,1,0.14777422706603885,52
2622,2,8629,1932,6697,0,0,0,1.0,1,1.0,1,1.0,1,0.14534915001925958,52
2623,3,8632,1933,6699,0,0,0,1.0,1,1.0,1,1.0,1,0.14337594010701607,53
2624,4,8636,1936,6700,0,0,0,1.0,1,1.0,1,1.0,1,0.16564439433649922,51
2625,3,8639,1937,6702,0,0,0,1.0,1,1.0,1,1.0,1,0.16189859164577985,50
2626,5,8644,1939,6705,0,0,0,1.0,1,1.0,1,1.0,1,0.1275494751612541,49
2627,2,8646,1940,6706,0,0,0,1.0,1,1.0,1,1.0,1,0.11741995414771945,48
2628,5,8651,1942,6709,0,0,0,1.0,1,1.0,1,1.0,1,0.10942247639523178,48
2629,0,8651,1942,6709,0,0,0,1.0,1,1.0,1,1.0,1,0.12476648300190678,47
2630,1,8652,1942,6710,0,0,0,1.0,1,1.0,1,1.0,1,0.1438823571214096,47
2631,1,8653,1943,6710,0,0,0,1.0,1,1.0,1,1.0,1,0.1378128645805361,47
2632,1,8654,1944,6710,0,0,0,1.0,1,1.0,1,1.0,1,0.13269084048243543,47
2633,1,8655,1945,6710,0,0,0,1.0,1,1.0,1,1.0,1,0.13651961163121257,44
2634,1,8656,1946,6710,0,0,0,1.0,1,1.0,1,1.0,1,0.14236900021321,44
2635,3,8659,1948,6711,0,0,0,1.0,1,1.0,1,1.0,1,0.19092038914466186,45
2636,2,8661,1949,6712,0,0,0,1.0,1,1.0,1,1.0,1,0.16851260840568086,40
2637,2,8663,1951,6712,0,0,0,1.0,1,1.0,1,1.0,1,0.18783998659293039,41
2638,5,8668,1953,6715,0,0,0,1.0,1,1.0,1,1.0,1,0.2712424549943135,38
2639,4,8672,1953,6719,0,0,0,1.0,1,1.0,1,1.0,1,0.2642739306901954,39
2640,7,8679,1955,6724,0,0,0,1.0,1,1.0,1,1.0,1,0.2892760493480419,38
2641,8,8687,1957,6730,0,0,0,1.0,1,1.0,1,1.0,1,0.20185188905928939,37
2642,4,8691,1959,6732,0,0,0,1.0,1,1.0,1,1.0,1,0.19593678610166085,38
2643,2,8693,1959,6734,0,0,0,1.0,1,1.0,1,1.0,1,0.1784913026467802,37
2644,4,8697,1960,6737,0,0,0,1.0,1,1.0,1,1.0,1,0.14786547423861002,36
2645,2,8699,1960,6739,0,0,0,1.0,1,1.0,1,1.0,1,0.13658655558515603,35
2646,0,8699,1960,6739,0,0,0,1.0,1,1.0,1,1.0,1,0.13629659463749758,35
2647,0,8699,1960,6739,0,0,0,1.0,1,1.0,1,1.0,1,0.1412374798384197,35
2648,2,8701,1960,6741,0,0,0,1.0,1,1.0,1,1.0,1,0.1237841483476589,36
2649,2,8703,1960,6743,0,0,0,1.0,1,1.0,1,1.0,1,0.09333970569537191,37
2650,2,8705,1961,6744,0,0,0,1.0,1,1.0,1,1.0,1,0.13444608946027556,39
2651,0,8705,1961,6744,0,0,0,1.0,1,1.0,1,1.0,1,0.13444608946027556,39
2652,0,8705,1961,6744,0,0,0,1.0,1,1.0,1,1.0,1,0.13444608946027556,39
2653,0,8705,1961,6744,0,0,0,1.0,1,1.0,1,1.0,1,0.13444608946027556,39
2654,1,8706,1962,6744,0,0,0,1.0,1,1.0,1,1.0,1,0.12343325991026007,40
2655,2,8708,1962,6746,0,0,0,1.0,1,1.0,1,1.0,1,0.12461319052249496,40
2656,6,8714,1963,6751,0,0,0,1.0,1,1.0,1,1.0,1,0.129601701985286,39
2657,4,8718,1963,6755,0,0,0,1.0,1,1.0,1,1.0,1,0.12445488623131504,40
2658,2,8720,1963,6757,0,0,0,1.0,1,1.0,1,1.0,1,0.13770483829995972,41
2659,4,8724,1965,6759,0,0,0,1.0,1,1.0,1,1.0,1,0.17815807378081971,41
2660,4,8728,1966,6762,0,0,0,1.0,1,1.0,1,1.0,1,0.22343574076102385,40
2661,8,8736,1967,6769,0,0,0,1.0,1,1.0,1,1.0,1,0.21584202436949876,40
2662,7,8743,1969,6774,0,0,0,1.0,1,1.0,1,1.0,1,0.23721103277373498,42
2663,6,8749,1971,6778,0,0,0,1.0,1,1.0,1,1.0,1,0.23417379278272898,41
2664,5,8754,1973,6781,0,0,0,1.0,1,1.0,1,1.0,1,0.26149363032998285,42
2665,6,8760,1974,6786,0,0,0,1.0,1,1.0,1,1.0,1,0.25009245862110424,43
2666,6,8766,1975,6791,0,0,0,1.0,1,1.0,1,1.0,1,0.2141968398719119,44
2667,4,8770,1976,6794,0,0,0,1.0,1,1.0,1,1.0,1,0.2305846153614249,42
2668,8,8778,1977,6801,0,0,0,1.0,1,1.0,1,1.0,1,0.270798647607042,41
2669,9,8787,1978,6809,0,0,0,1.0,1,1.0,1,1.0,1,0.20645104001537443,42
2670,5,8792,1979,6813,0,0,0,1.0,1,1.0,1,1.0,1,0.22451293896443267,40
2671,5,8797,1981,6816,0,0,0,1.0,1,1.0,1,1.0,1,0.19547420688673176,39
2672,2,8799,1983,6816,0,0,0,1.0,1,1.0,1,1.0,1,0.29022717803625825,36
2673,6,8805,1984,6821,0,0,0,1.0,1,1.0,1,1.0,1,0.23397827570665905,35
2674,3,8808,1985,6823,0,0,0,1.0,1,1.0,1,1.0,1,0.240863787449582,33
2675,1,8809,1985,6824,0,0,0,1.0,1,1.0,1,1.0,1,0.20200799546755863,34
2676,0,8809,1985,6824,0,0,0,1.0,1,1.0,1,1.0,1,0.1992184354872873,32
2677,3,8812,1987,6825,0,0,0,1.0,1,1.0,1,1.0,1,0.21796346034570405,33
2678,4,8816,1988,6828,0,0,0,1.0,1,1.0,1,1.0,1,0.21934638278493565,33
2679,5,8821,1988,6833,0,0,0,1.0,1,1.0,1,1.0,1,0.17241102002109795,32
2680,3,8824,1988,6836,0,0,0,1.0,1,1.0,1,1.0,1,0.19463764181143098,32
2681,1,8825,1988,6837,0,0,0,1.0,1,1.0,1,1.0,1,0.19663825343169217,32
2682,1,8826,1989,6837,0,0,0,1.0,1,1.0,1,1.0,1,0.21013404540252176,33
2683,0,8826,1989,6837,0,0,0,1.0,1,1.0,1,1.0,1,0.2463863282234044,32
2684,1,8827,1989,6838,0,0,0,1.0,1,1.0,1,1.0,1,0.26704982570751606,31
2685,2,8829,1989,6840,0,0,0,1.0,1,1.0,1,1.0,1,0.27339561003004653,31
2686,3,8832,1989,6843,0,0,0,1.0,1,1.0,1,1.0,1,0.21996704714403106,30
2687,2,8834,1990,6844,0,0,0,1.0,1,1.0,1,1.0,1,0.2217799075455447,30
2688,1,8835,1991,6844,0,0,0,1.0,1,1.0,1,1.0,1,0.24787583246902878,30
2689,3,8838,1992,6846,0,0,0,1.0,1,1.0,1,1.0,1,0.22256911647861155,31
2690,2,8840,1994,6846,0,0,0,1.0,1,1.0,1,1.0,1,0.19698414635810843,31
2691,3,8843,1995,6848,0,0,0,1.0,1,1.0,1,1.0,1,0.17676208294054682,32
2692,3,8846,1996,6850,0,0,0,1.0,1,1.0,1,1.0,1,0.2250919619515236,32
2693,3,8849,1998,6851,0,0,0,1.0,1,1.0,1,1.0,1,0.2218219132684776,33
2694,2,8851,1998,6853,0,0,0,1.0,1,1.0,1,1.0,1,0.22789311399482948,34
2695,2,8853,1998,6855,0,0,0,1.0,1,1.0,1,1.0,1,0.16393670657965048,35
2696,4,8857,1998,6859,0,0,0,1.0,1,1.0,1,1.0,1,0.16393670657965048,35
2697,2,8859,1999,6860,0,0,0,1.0,1,1.0,1,1.0,1,0.17901395407954307,35
2698,0,8859,1999,6860,0,0,0,1.0,1,1.0,1,1.0,1,0.161697872835109,36
2699,0,8859,1999,6860,0,0,0,1.0,1,1.0,1,1.0,1,0.17901369245800364,36
2700,3,8862,2000,6862,0,0,0,1.0,1,1.0,1,1.0,1,0.14913824065607634,37
2701,0,8862,2000,6862,0,0,0,1.0,1,1.0,1,1.0,1,0.14913824065607634,37
2702,4,8866,2002,6864,0,0,0,1.0,1,1.0,1,1.0,1,0.17601236646110854,37
2703,1,8867,2003,6864,0,0,0,1.0,1,1.0,1,1.0,1,0.17935559116742744,38
2704,1,8868,2004,6864,0,0,0,1.0,1,1.0,1,1.0,1,0.21108248701118554,37
2705,1,8869,2005,6864,0,0,0,1.0,1,1.0,1,1.0,1,0.21494627450818435,36
2706,2,8871,2007,6864,0,0,0,1.0,1,1.0,1,1.0,1,0.280229559551866,36
2707,4,8875,2008,6867,0,0,0,1.0,1,1.0,1,1.0,1,0.2918386209591795,35
2708,4,8879,2011,6868,0,0,0,1.0,1,1.0,1,1.0,1,0.2770891202363051,36
2709,2,8881,2012,6869,0,0,0,1.0,1,1.0,1,1.0,1,0.30093834810801945,32
2710,3,8884,2014,6870,0,0,0,1.0,1,1.0,1,1.0,1,0.33753210351865354,29
2711,3,8887,2015,6872,0,0,0,1.0,1,1.0,1,1.0,1,0.301663799918135,29
2712,0,8887,2015,6872,0,0,0,1.0,1,1.0,1,1.0,1,0.36480307596062733,28
2713,0,8887,2015,6872,0,0,0,1.0,1,1.0,1,1.0,1,0.3449291967720597,28
2714,2,8889,2017,6872,0,0,0,1.0,1,1.0,1,1.0,1,0.36762640316983264,26
2715,1,8890,2018,6872,0,0,0,1.0,1,1.0,1,1.0,1,0.39314257718655654,24
2716,7,8897,2018,6879,0,0,0,1.0,1,1.0,1,1.0,1,0.2222833617306318,24
2717,3,8900,2018,6882,0,0,0,1.0,1,1.0,1,1.0,1,0.24488433006505375,25
2718,5,8905,2019,6886,0,0,0,1.0,1,1.0,1,1.0,1,0.324820019871937,25
2719,7,8912,2022,6890,0,0,0,1.0,1,1.0,1,1.0,1,0.38791241801176496,25
2720,3,8915,2022,6893,0,0,0,1.0,1,1.0,1,1.0,1,0.3574099307528126,25
2721,4,8919,2024,6895,0,0,0,1.0,1,1.0,1,1.0,1,0.3342962661416631,25
2722,3,8922,2025,6897,0,0,0,1.0,1,1.0,1,1.0,1,0.33390873875053956,26
2723,5,8927,2026,6901,0,0,0,1.0,1,1.0,1,1.0,1,0.34341630883714663,26
2724,3,8930,2027,6903,0,0,0,1.0,1,1.0,1,1.0,1,0.286371508926552,27
2725,1,8931,2027,6904,0,0,0,1.0,1,1.0,1,1.0,1,0.252261125401808,28
2726,0,8931,2027,6904,0,0,0,1.0,1,1.0,1,1.0,1,0.252261125401808,28
2727,2,8933,2027,6906,0,0,0,1.0,1,1.0,1,1.0,1,0.23092926193178223,29
2728,2,8935,2028,6907,0,0,0,1.0,1,1.0,1,1.0,1,0.31416279856709606,29
2729,4,8939,2029,6910,0,0,0,1.0,1,1.0,1,1.0,1,0.3193167739550055,29
2730,4,8943,2029,6914,0,0,0,1.0,1,1.0,1,1.0,1,0.2720993473032568,29
2731,3,8946,2029,6917,0,0,0,1.0,1,1.0,1,1.0,1,0.21817896438280507,30
2732,3,8949,2029,6920,0,0,0,1.0,1,1.0,1,1.0,1,0.20284408271507043,29
2733,1,8950,2029,6921,0,0,0,1.0,1,1.0,1,1.0,1,0.17114953930389615,29
2734,0,8950,2029,6921,0,0,0,1.0,1,1.0,1,1.0,1,0.17114953930389615,29
2735,0,8950,2029,6921,0,0,0,1.0,1,1.0,1,1.0,1,0.17114953930389615,29
2736,1,8951,2030,6921,0,0,0,1.0,1,1.0,1,1.0,1,0.18548396848883125,30
2737,2,8953,2030,6923,0,0,0,1.0,1,1.0,1,1.0,1,0.17150902374532884,30
2738,2,8955,2031,6924,0,0,0,1.0,1,1.0,1,1.0,1,0.21565043063435468,30
2739,2,8957,2032,6925,0,0,0,1.0,1,1.0,1,1.0,1,0.24465761951603093,29
2740,0,8957,2032,6925,0,0,0,1.0,1,1.0,1,1.0,1,0.24465761951603093,29
2741,1,8958,2032,6926,0,0,0,1.0,1,1.0,1,1.0,1,0.25171205377645917,28
2742,3,8961,2033,6928,0,0,0,1.0,1,1.0,1,1.0,1,0.25029640853967383,28
2743,2,8963,2034,6929,0,0,0,1.0,1,1.0,1,1.0,1,0.24257370208287107,29
2744,2,8965,2035,6930,0,0,0,1.0,1,1.0,1,1.0,1,0.1980868475582635,27
2745,1,8966,2036,6930,0,0,0,1.0,1,1.0,1,1.0,1,0.18070865532982147,25
2746,5,8971,2038,6933,0,0,0,1.0,1,1.0,1,1.0,1,0.2099688174567827,25
2747,2,8973,2038,6935,0,0,0,1.0,1,1.0,1,1.0,1,0.14277323254885274,23
2748,1,8974,2038,6936,0,0,0,1.0,1,1.0,1,1.0,1,0.09766287440125632,22
2749,0,8974,2038,6936,0,0,0,1.0,1,1.0,1,1.0,1,0.24494173939330288,19
2750,2,8976,2040,6936,0,0,0,1.0,1,1.0,1,1.0,1,0.21310085563438447,18
2751,0,8976,2040,6936,0,0,0,1.0,1,1.0,1,1.0,1,0.2859627908425139,16
2752,0,8976,2040,6936,0,0,0,1.0,1,1.0,1,1.0,1,0.3307186795814685,15
2753,0,8976,2040,6936,0,0,0,1.0,1,1.0,1,1.0,1,0.3307186795814685,15
2754,0,8976,2040,6936,0,0,0,1.0,1,1.0,1,1.0,1,0.3307186795814685,15
2755,0,8976,2040,6936,0,0,0,1.0,1,1.0,1,1.0,1,0.3307186795814685,15
2756,0,8976,2040,6936,0,0,0,1.0,1,1.0,1,1.0,1,0.33410213124961224,16
2757,0,8976,2040,6936,0,0,0,1.0,1,1.0,1,1.0,1,0.271055782139017,17
2758,0,8976,2040,6936,0,0,0,1.0,1,1.0,1,1.0,1,0.271055782139017,17
2759,0,8976,2040,6936,0,0,0,1.0,1,1.0,1,1.0,1,0.2371087433400702,18
2760,0,8976,2040,6936,0,0,0,1.0,1,1.0,1,1.0,1,0.2371087433400702,18
2761,0,8976,2040,6936,0,0,0,1.0,1,1.0,1,1.0,1,0.2371087433400702,18
2762,0,8976,2040,6936,0,0,0,1.0,1,1.0,1,1.0,1,0.2371087433400702,18
2763,0,8976,2040,6936,0,0,0,1.0,1,1.0,1,1.0,1,0.2665261092372236,17
2764,2,8978,2042,6936,0,0,0,1.0,1,1.0,1,1.0,1,0.3470118745136673,17
2765,1,8979,2042,6937,0,0,0,1.0,1,1.0,1,1.0,1,0.2943681319535727,18
2766,0,8979,2042,6937,0,0,0,1.0,1,1.0,1,1.0,1,0.2943681319535727,18
2767,0,8979,2042,6937,0,0,0,1.0,1,1.0,1,1.0,1,0.2943681319535727,18
2768,1,8980,2042,6938,0,0,0,1.0,1,1.0,1,1.0,1,0.23628073295435395,18
2769,3,8983,2044,6939,0,0,0,1.0,1,1.0,1,1.0,1,0.20899644741631143,18
2770,0,8983,2044,6939,0,0,0,1.0,1,1.0,1,1.0,1,0.20899644741631143,18
2771,0,8983,2044,6939,0,0,0,1.0,1,1.0,1,1.0,1,0.20899644741631143,18
2772,0,8983,2044,6939,0,0,0,1.0,1,1.0,1,1.0,1,0.20899644741631143,18
2773,0,8983,2044,6939,0,0,0,1.0,1,1.0,1,1.0,1,0.20899644741631143,18
2774,2,8985,2045,6940,0,0,0,1.0,1,1.0,1,1.0,1,0.22653160147120782,20
2775,0,8985,2045,6940,0,0,0,1.0,1,1.0,1,1.0,1,0.2322028036223368,21
2776,1,8986,2045,6941,0,0,0,1.0,1,1.0,1,1.0,1,0.20840265138229272,21
2777,0,8986,2045,6941,0,0,0,1.0,1,1.0,1,1.0,1,0.19698719013460061,22
2778,3,8989,2046,6943,0,0,0,1.0,1,1.0,1,1.0,1,0.19062792535886947,24
2779,2,8991,2048,6943,0,0,0,1.0,1,1.0,1,1.0,1,0.2388238383857615,24
2780,1,8992,2048,6944,0,0,0,1.0,1,1.0,1,1.0,1,0.18049407719094057,24
2781,0,8992,2048,6944,0,0,0,1.0,1,1.0,1,1.0,1,0.18049407719094057,24
2782,0,8992,2048,6944,0,0,0,1.0,1,1.0,1,1.0,1,0.18049407719094057,24
2783,0,8992,2048,6944,0,0,0,1.0,1,1.0,1,1.0,1,0.18049407719094057,24
2784,3,8995,2048,6947,0,0,0,1.0,1,1.0,1,1.0,1,0.15728760494032026,24
2785,1,8996,2049,6947,0,0,0,1.0,1,1.0,1,1.0,1,0.1559994759875932,22
2786,1,8997,2050,6947,0,0,0,1.0,1,1.0,1,1.0,1,0.20424209485391376,22
2787,0,8997,2050,6947,0,0,0,1.0,1,1.0,1,1.0,1,0.2037444985066902,21
2788,0,8997,2050,6947,0,0,0,1.0,1,1.0,1,1.0,1,0.2061958370022533,20
2789,1,8998,2051,6947,0,0,0,1.0,1,1.0,1,1.0,1,0.21856563058775408,20
2790,0,8998,2051,6947,0,0,0,1.0,1,1.0,1,1.0,1,0.24119894518881166,21
2791,1,8999,2052,6947,0,0,0,1.0,1,1.0,1,1.0,1,0.2904582548575473,21
2792,0,8999,2052,6947,0,0,0,1.0,1,1.0,1,1.0,1,0.2904582548575473,21
2793,0,8999,2052,6947,0,0,0,1.0,1,1.0,1,1.0,1,0.33789962483212704,18
2794,0,8999,2052,6947,0,0,0,1.0,1,1.0,1,1.0,1,0.33789962483212704,18
2795,0,8999,2052,6947,0,0,0,1.0,1,1.0,1,1.0,1,0.32640860923118165,20
2796,1,9000,2053,6947,0,0,0,1.0,1,1.0,1,1.0,1,0.3181954910689387,21
2797,3,9003,2053,6950,0,0,0,1.0,1,1.0,1,1.0,1,0.20908442061994995,21
2798,0,9003,2053,6950,0,0,0,1.0,1,1.0,1,1.0,1,0.20908442061994995,21
2799,1,9004,2053,6951,0,0,0,1.0,1,1.0,1,1.0,1,0.1797915247958806,22
2800,0,9004,2053,6951,0,0,0,1.0,1,1.0,1,1.0,1,0.1797915247958806,22
2801,2,9006,2055,6951,0,0,0,1.0,1,1.0,1,1.0,1,0.2056133196068628,22
2802,0,9006,2055,6951,0,0,0,1.0,1,1.0,1,1.0,1,0.2056133196068628,22
2803,0,9006,2055,6951,0,0,0,1.0,1,1.0,1,1.0,1,0.2056133196068628,22
2804,0,9006,2055,6951,0,0,0,1.0,1,1.0,1,1.0,1,0.224479782222541,23
2805,0,9006,2055,6951,0,0,0,1.0,1,1.0,1,1.0,1,0.224479782222541,23
2806,0,9006,2055,6951,0,0,0,1.0,1,1.0,1,1.0,1,0.224479782222541,23
2807,1,9007,2055,6952,0,0,0,1.0,1,1.0,1,1.0,1,0.17633402113843868,24
2808,0,9007,2055,6952,0,0,0,1.0,1,1.0,1,1.0,1,0.17633402113843868,24
2809,1,9008,2056,6952,0,0,0,1.0,1,1.0,1,1.0,1,0.20814946309227783,25
2810,0,9008,2056,6952,0,0,0,1.0,1,1.0,1,1.0,1,0.19800996479374558,24
2811,1,9009,2056,6953,0,0,0,1.0,1,1.0,1,1.0,1,0.2112052390182536,26
2812,1,9010,2057,6953,0,0,0,1.0,1,1.0,1,1.0,1,0.249607291233923,26
2813,1,9011,2058,6953,0,0,0,1.0,1,1.0,1,1.0,1,0.22946892390241486,27
2814,5,9016,2060,6956,0,0,0,1.0,1,1.0,1,1.0,1,0.203622332529897,29
2815,2,9018,2060,6958,0,0,0,1.0,1,1.0,1,1.0,1,0.203622332529897,29
2816,3,9021,2060,6961,0,0,0,1.0,1,1.0,1,1.0,1,0.21876864098735396,29
2817,4,9025,2061,6964,0,0,0,1.0,1,1.0,1,1.0,1,0.26823668805310596,29
2818,5,9030,2061,6969,0,0,0,1.0,1,1.0,1,1.0,1,0.32085208070425336,29
2819,5,9035,2061,6974,0,0,0,1.0,1,1.0,1,1.0,1,0.329617102019679,30
2820,4,9039,2062,6977,0,0,0,1.0,1,1.0,1,1.0,1,0.31695631109616956,30
2821,7,9046,2062,6984,0,0,0,1.0,1,1.0,1,1.0,1,0.1797823060509934,31
2822,4,9050,2063,6987,0,0,0,1.0,1,1.0,1,1.0,1,0.19038388206840134,30
2823,1,9051,2063,6988,0,0,0,1.0,1,1.0,1,1.0,1,0.21941073011478845,27
2824,2,9053,2063,6990,0,0,0,1.0,1,1.0,1,1.0,1,0.19371092785101587,28
2825,3,9056,2065,6991,0,0,0,1.0,1,1.0,1,1.0,1,0.17535940436778358,28
2826,1,9057,2066,6991,0,0,0,1.0,1,1.0,1,1.0,1,0.24033477722720442,27
2827,3,9060,2067,6993,0,0,0,1.0,1,1.0,1,1.0,1,0.21332212126387545,28
2828,4,9064,2067,6997,0,0,0,1.0,1,1.0,1,1.0,1,0.22878929510719495,28
2829,1,9065,2068,6997,0,0,0,1.0,1,1.0,1,1.0,1,0.2454087484133139,27
2830,1,9066,2068,6998,0,0,0,1.0,1,1.0,1,1.0,1,0.23222886920244026,27
2831,0,9066,2068,6998,0,0,0,1.0,1,1.0,1,1.0,1,0.23222886920244026,27
2832,4,9070,2068,7002,0,0,0,1.0,1,1.0,1,1.0,1,0.22387738909853291,27
2833,4,9074,2068,7006,0,0,0,1.0,1,1.0,1,1.0,1,0.19912434131172466,26
2834,1,9075,2069,7006,0,0,0,1.0,1,1.0,1,1.0,1,0.19630620712707625,26
2835,0,9075,2069,7006,0,0,0,1.0,1,1.0,1,1.0,1,0.23004126224064544,25
2836,3,9078,2069,7009,0,0,0,1.0,1,1.0,1,1.0,1,0.1676033741530873,27
2837,0,9078,2069,7009,0,0,0,1.0,1,1.0,1,1.0,1,0.17329451688818215,27
2838,3,9081,2069,7012,0,0,0,1.0,1,1.0,1,1.0,1,0.15223994858624762,27
2839,0,9081,2069,7012,0,0,0,1.0,1,1.0,1,1.0,1,0.18804264321595546,29
2840,2,9083,2070,7013,0,0,0,1.0,1,1.0,1,1.0,1,0.1957636508665118,29
2841,1,9084,2070,7014,0,0,0,1.0,1,1.0,1,1.0,1,0.17624957007637854,31
2842,0,9084,2070,7014,0,0,0,1.0,1,1.0,1,1.0,1,0.17624957007637854,31
2843,4,9088,2070,7018,0,0,0,1.0,1,1.0,1,1.0,1,0.17941061148036008,32
2844,4,9092,2072,7020,0,0,0,1.0,1,1.0,1,1.0,1,0.2027943536015804,33
2845,9,9101,2072,7029,0,0,0,1.0,1,1.0,1,1.0,1,0.21118658853258152,32
2846,5,9106,2073,7033,0,0,0,1.0,1,1.0,1,1.0,1,0.2566514450078305,33
2847,4,9110,2074,7036,0,0,0,1.0,1,1.0,1,1.0,1,0.31907702927963816,32
2848,3,9113,2074,7039,0,0,0,1.0,1,1.0,1,1.0,1,0.33880515712601966,33
2849,9,9122,2074,7048,0,0,0,1.0,1,1.0,1,1.0,1,0.3059940690481867,34
2850,8,9130,2074,7056,0,0,0,1.0,1,1.0,1,1.0,1,0.3059940690481867,34
2851,8,9138,2074,7064,0,0,0,1.0,1,1.0,1,1.0,1,0.08279876242576448,34
2852,3,9141,2075,7066,0,0,0,1.0,1,1.0,1,1.0,1,0.06079405769735205,35
2853,3,9144,2076,7068,0,0,0,1.0,1,1.0,1,1.0,1,0.07048111958756226,36
2854,0,9144,2076,7068,0,0,0,1.0,1,1.0,1,1.0,1,0.09830106312050815,37
2855,0,9144,2076,7068,0,0,0,1.0,1,1.0,1,1.0,1,0.10876064728078291,38
2856,0,9144,2076,7068,0,0,0,1.0,1,1.0,1,1.0,1,0.10876064728078291,38
2857,4,9148,2077,7071,0,0,0,1.0,1,1.0,1,1.0,1,0.16138389969680045,39
2858,4,9152,2079,7073,0,0,0,1.0,1,1.0,1,1.0,1,0.18433966122108536,40
2859,7,9159,2080,7079,0,0,0,1.0,1,1.0,1,1.0,1,0.1432863571413369,40
2860,4,9163,2080,7083,0,0,0,1.0,1,1.0,1,1.0,1,0.17381411675726297,40
2861,2,9165,2080,7085,0,0,0,1.0,1,1.0,1,1.0,1,0.1687127879323265,38
2862,5,9170,2081,7089,0,0,0,1.0,1,1.0,1,1.0,1,0.18519610022086075,38
2863,6,9176,2083,7093,0,0,0,1.0,1,1.0,1,1.0,1,0.2528554421783292,38
2864,6,9182,2086,7096,0,0,0,1.0,1,1.0,1,1.0,1,0.3150987269988436,36
2865,13,9195,2091,7104,0,0,0,1.0,1,1.0,1,1.0,1,0.3211907717395046,34
2866,8,9203,2092,7111,0,0,0,1.0,1,1.0,1,1.0,1,0.1922975151694869,31
2867,0,9203,2092,7111,0,0,0,1.0,1,1.0,1,1.0,1,0.19160929994010167,30
2868,2,9205,2094,7111,0,0,0,1.0,1,1.0,1,1.0,1,0.2567688510337281,27
2869,2,9207,2095,7112,0,0,0,1.0,1,1.0,1,1.0,1,0.3116525958031868,27
2870,4,9211,2096,7115,0,0,0,1.0,1,1.0,1,1.0,1,0.27580940084807865,25
2871,1,9212,2097,7115,0,0,0,1.0,1,1.0,1,1.0,1,0.3073560651955287,25
2872,2,9214,2098,7116,0,0,0,1.0,1,1.0,1,1.0,1,0.2861181974422235,23
2873,1,9215,2099,7116,0,0,0,1.0,1,1.0,1,1.0,1,0.3515211054519011,24
2874,3,9218,2100,7118,0,0,0,1.0,1,1.0,1,1.0,1,0.3443681364074578,24
2875,0,9218,2100,7118,0,0,0,1.0,1,1.0,1,1.0,1,0.39605378445950506,23
2876,0,9218,2100,7118,0,0,0,1.0,1,1.0,1,1.0,1,0.3720511454496086,24
2877,2,9220,2100,7120,0,0,0,1.0,1,1.0,1,1.0,1,0.3286181367382758,24
2878,3,9223,2101,7122,0,0,0,1.0,1,1.0,1,1.0,1,0.31518160012643387,24
2879,3,9226,2102,7124,0,0,0,1.0,1,1.0,1,1.0,1,0.3681831358843498,25
2880,3,9229,2102,7127,0,0,0,1.0,1,1.0,1,1.0,1,0.4317401023863381,26
2881,5,9234,2102,7132,0,0,0,1.0,1,1.0,1,1.0,1,0.3032590076884614,26
2882,1,9235,2102,7133,0,0,0,1.0,1,1.0,1,1.0,1,0.2789309536808479,27
2883,1,9236,2102,7134,0,0,0,1.0,1,1.0,1,1.0,1,0.2736889057303262,28
2884,2,9238,2102,7136,0,0,0,1.0,1,1.0,1,1.0,1,0.27231596433921945,29
2885,2,9240,2102,7138,0,0,0,1.0,1,1.0,1,1.0,1,0.2395119503687164,31
2886,5,9245,2103,7142,0,0,0,1.0,1,1.0,1,1.0,1,0.2655816578648621,31
2887,8,9253,2103,7150,0,0,0,1.0,1,1.0,1,1.0,1,0.2878799937816283,33
2888,7,9260,2103,7157,0,0,0,1.0,1,1.0,1,1.0,1,0.2399603626693029,34
2889,7,9267,2103,7164,0,0,0,1.0,1,1.0,1,1.0,1,0.22561232961297328,35
2890,4,9271,2103,7168,0,0,0,1.0,1,1.0,1,1.0,1,0.23951609752707714,35
2891,5,9276,2104,7172,0,0,0,1.0,1,1.0,1,1.0,1,0.2707097506029013,35
2892,6,9282,2106,7176,0,0,0,1.0,1,1.0,1,1.0,1,0.2879767441010228,35
2893,7,9289,2106,7183,0,0,0,1.0,1,1.0,1,1.0,1,0.25339209849955585,37
2894,8,9297,2106,7191,0,0,0,1.0,1,1.0,1,1.0,1,0.29323149985114094,37
2895,8,9305,2106,7199,0,0,0,1.0,1,1.0,1,1.0,1,0.29042364839189183,37
2896,6,9311,2106,7205,0,0,0,1.0,1,1.0,1,1.0,1,0.20746237448954724,38
2897,0,9311,2106,7205,0,0,0,1.0,1,1.0,1,1.0,1,0.23461367751415163,37
2898,1,9312,2107,7205,0,0,0,1.0,1,1.0,1,1.0,1,0.26751865567731614,38
2899,1,9313,2108,7205,0,0,0,1.0,1,1.0,1,1.0,1,0.23170534915180244,37
2900,2,9315,2109,7206,0,0,0,1.0,1,1.0,1,1.0,1,0.22017922770248283,36
2901,1,9316,2109,7207,0,0,0,1.0,1,1.0,1,1.0,1,0.18703180854924042,37
2902,1,9317,2110,7207,0,0,0,1.0,1,1.0,1,1.0,1,0.19085691696344742,35
2903,1,9318,2111,7207,0,0,0,1.0,1,1.0,1,1.0,1,0.2229807462145423,35
2904,0,9318,2111,7207,0,0,0,1.0,1,1.0,1,1.0,1,0.20940304453019848,33
2905,1,9319,2111,7208,0,0,0,1.0,1,1.0,1,1.0,1,0.18581314029510806,34
2906,2,9321,2113,7208,0,0,0,1.0,1,1.0,1,1.0,1,0.20813951944762332,34
2907,0,9321,2113,7208,0,0,0,1.0,1,1.0,1,1.0,1,0.20464035532605718,35
2908,2,9323,2113,7210,0,0,0,1.0,1,1.0,1,1.0,1,0.19646098363213008,36
2909,2,9325,2113,7212,0,0,0,1.0,1,1.0,1,1.0,1,0.19732997493358312,38
2910,0,9325,2113,7212,0,0,0,1.0,1,1.0,1,1.0,1,0.19732997493358312,38
2911,1,9326,2114,7212,0,0,0,1.0,1,1.0,1,1.0,1,0.21775218031024826,37
2912,1,9327,2114,7213,0,0,0,1.0,1,1.0,1,1.0,1,0.20205638663602613,37
2913,0,9327,2114,7213,0,0,0,1.0,1,1.0,1,1.0,1,0.2073702227538063,38
2914,1,9328,2114,7214,0,0,0,1.0,1,1.0,1,1.0,1,0.17931283855719043,38
2915,3,9331,2114,7217,0,0,0,1.0,1,1.0,1,1.0,1,0.12777907453865914,39
2916,0,9331,2114,7217,0,0,0,1.0,1,1.0,1,1.0,1,0.13734574050076495,40
2917,2,9333,2115,7218,0,0,0,1.0,1,1.0,1,1.0,1,0.15327341326760827,41
2918,3,9336,2116,7220,0,0,0,1.0,1,1.0,1,1.0,1,0.19155397056061962,41
2919,2,9338,2116,7222,0,0,0,1.0,1,1.0,1,1.0,1,0.19155397056061962,41
2920,1,9339,2116,7223,0,0,0,1.0,1,1.0,1,1.0,1,0.20563521416499178,43
2921,1,9340,2116,7224,0,0,0,1.0,1,1.0,1,1.0,1,0.2209966945258757,42
2922,4,9344,2117,7227,0,0,0,1.0,1,1.0,1,1.0,1,0.19916389197177672,43
2923,1,9345,2117,7228,0,0,0,1.0,1,1.0,1,1.0,1,0.19958191128924072,44
2924,0,9345,2117,7228,0,0,0,1.0,1,1.0,1,1.0,1,0.17904019563194534,45
2925,4,9349,2117,7232,0,0,0,1.0,1,1.0,1,1.0,1,0.21551885333221185,45
2926,5,9354,2117,7237,0,0,0,1.0,1,1.0,1,1.0,1,0.10302320011712275,47
2927,1,9355,2118,7237,0,0,0,1.0,1,1.0,1,1.0,1,0.1285074446778334,47
2928,4,9359,2119,7240,0,0,0,1.0,1,1.0,1,1.0,1,0.1405805219596303,48
2929,6,9365,2120,7245,0,0,0,1.0,1,1.0,1,1.0,1,0.17715777569661628,48
2930,7,9372,2120,7252,0,0,0,1.0,1,1.0,1,1.0,1,0.13792102904403025,50
2931,3,9375,2120,7255,0,0,0,1.0,1,1.0,1,1.0,1,0.1520366396193158,51
2932,2,9377,2120,7257,0,0,0,1.0,1,1.0,1,1.0,1,0.1520366396193158,51
2933,4,9381,2121,7260,0,0,0,1.0,1,1.0,1,1.0,1,0.199629778584938,52
2934,5,9386,2122,7264,0,0,0,1.0,1,1.0,1,1.0,1,0.17643153481406207,52
2935,3,9389,2122,7267,0,0,0,1.0,1,1.0,1,1.0,1,0.19901403497508982,51
2936,2,9391,2122,7269,0,0,0,1.0,1,1.0,1,1.0,1,0.16350693010176082,49
2937,2,9393,2122,7271,0,0,0,1.0,1,1.0,1,1.0,1,0.17350555556459532,50
2938,3,9396,2123,7273,0,0,0,1.0,1,1.0,1,1.0,1,0.20018265691334608,50
2939,4,9400,2123,7277,0,0,0,1.0,1,1.0,1,1.0,1,0.18320189645767376,51
2940,8,9408,2124,7284,0,0,0,1.0,1,1.0,1,1.0,1,0.17110103849339348,52
2941,6,9414,2125,7289,0,0,0,1.0,1,1.0,1,1.0,1,0.12846679728847726,53
2942,2,9416,2127,7289,0,0,0,1.0,1,1.0,1,1.0,1,0.13746742942459106,52
2943,0,9416,2127,7289,0,0,0,1.0,1,1.0,1,1.0,1,0.12800589027205544,51
2944,4,9420,2129,7291,0,0,0,1.0,1,1.0,1,1.0,1,0.10788791627656379,52
2945,1,9421,2130,7291,0,0,0,1.0,1,1.0,1,1.0,1,0.10143781388444795,50
2946,3,9424,2131,7293,0,0,0,1.0,1,1.0,1,1.0,1,0.11711471522703992,51
2947,3,9427,2133,7294,0,0,0,1.0,1,1.0,1,1.0,1,0.11495711682690031,50
2948,4,9431,2135,7296,0,0,0,1.0,1,1.0,1,1.0,1,0.11856773047876049,50
2949,0,9431,2135,7296,0,0,0,1.0,1,1.0,1,1.0,1,0.11062943986562075,49
2950,0,9431,2135,7296,0,0,0,1.0,1,1.0,1,1.0,1,0.1323330078886374,48
2951,3,9434,2136,7298,0,0,0,1.0,1,1.0,1,1.0,1,0.1427739763695358,48
2952,1,9435,2136,7299,0,0,0,1.0,1,1.0,1,1.0,1,0.16239506198922835,46
2953,0,9435,2136,7299,0,0,0,1.0,1,1.0,1,1.0,1,0.16239506198922835,46
2954,1,9436,2136,7300,0,0,0,1.0,1,1.0,1,1.0,1,0.1493201859958363,48
2955,1,9437,2136,7301,0,0,0,1.0,1,1.0,1,1.0,1,0.12492218674423905,48
2956,2,9439,2137,7302,0,0,0,1.0,1,1.0,1,1.0,1,0.09380110890772606,47
2957,5,9444,2139,7305,0,0,0,1.0,1,1.0,1,1.0,1,0.09900559968426717,48
2958,0,9444,2139,7305,0,0,0,1.0,1,1.0,1,1.0,1,0.0981285914759605,49
2959,3,9447,2140,7307,0,0,0,1.0,1,1.0,1,1.0,1,0.12337708072492656,49
2960,2,9449,2140,7309,0,0,0,1.0,1,1.0,1,1.0,1,0.11576114847868955,49
2961,4,9453,2143,7310,0,0,0,1.0,1,1.0,1,1.0,1,0.17709748739528516,51
2962,3,9456,2143,7313,0,0,0,1.0,1,1.0,1,1.0,1,0.1588063851201401,51
2963,3,9459,2143,7316,0,0,0,1.0,1,1.0,1,1.0,1,0.15536983612861982,51
2964,2,9461,2143,7318,0,0,0,1.0,1,1.0,1,1.0,1,0.1566976692114378,52
2965,0,9461,2143,7318,0,0,0,1.0,1,1.0,1,1.0,1,0.16011168747410495,53
2966,3,9464,2144,7320,0,0,0,1.0,1,1.0,1,1.0,1,0.16690480190245713,53
2967,3,9467,2145,7322,0,0,0,1.0,1,1.0,1,1.0,1,0.204756132529,53
2968,2,9469,2145,7324,0,0,0,1.0,1,1.0,1,1.0,1,0.20245094658202967,54
2969,3,9472,2146,7326,0,0,0,1.0,1,1.0,1,1.0,1,0.22360258875089153,55
2970,2,9474,2146,7328,0,0,0,1.0,1,1.0,1,1.0,1,0.1988759861243542,55
2971,8,9482,2146,7336,0,0,0,1.0,1,1.0,1,1.0,1,0.12148526766988679,55
2972,1,9483,2146,7337,0,0,0,1.0,1,1.0,1,1.0,1,0.11111077248532722,55
2973,2,9485,2146,7339,0,0,0,1.0,1,1.0,1,1.0,1,0.120697540385618,55
2974,2,9487,2147,7340,0,0,0,1.0,1,1.0,1,1.0,1,0.11167640156154589,56
2975,2,9489,2147,7342,0,0,0,1.0,1,1.0,1,1.0,1,0.12447716618227805,55
2976,3,9492,2147,7345,0,0,0,1.0,1,1.0,1,1.0,1,0.10721596583370913,57
2977,3,9495,2148,7347,0,0,0,1.0,1,1.0,1,1.0,1,0.14057992130849759,59
2978,3,9498,2149,7349,0,0,0,1.0,1,1.0,1,1.0,1,0.09080067551756722,59
2979,9,9507,2149,7358,0,0,0,1.0,1,1.0,1,1.0,1,0.11754153804012943,59
2980,3,9510,2150,7360,0,0,0,1.0,1,1.0,1,1.0,1,0.09283859740840897,59
2981,5,9515,2150,7365,0,0,0,1.0,1,1.0,1,1.0,1,0.14179486112808293,59
2982,7,9522,2152,7370,0,0,0,1.0,1,1.0,1,1.0,1,0.1464891830471781,61
2983,9,9531,2155,7376,0,0,0,1.0,1,1.0,1,1.0,1,0.15207211942661666,61
2984,11,9542,2158,7384,0,0,0,1.0,1,1.0,1,1.0,1,0.19497136812094795,61
2985,7,9549,2161,7388,0,0,0,1.0,1,1.0,1,1.0,1,0.1995391229334597,57
2986,9,9558,2163,7395,0,0,0,1.0,1,1.0,1,1.0,1,0.1419007756821092,58
2987,4,9562,2164,7398,0,0,0,1.0,1,1.0,1,1.0,1,0.125070185346345,56
2988,4,9566,2164,7402,0,0,0,1.0,1,1.0,1,1.0,1,0.11787167702141138,55
2989,10,9576,2168,7408,0,0,0,1.0,1,1.0,1,1.0,1,0.1268462027801504,53
2990,2,9578,2170,7408,0,0,0,1.0,1,1.0,1,1.0,1,0.13950356568252317,52
2991,4,9582,2171,7411,0,0,0,1.0,1,1.0,1,1.0,1,0.08894170317768355,54
2992,1,9583,2172,7411,0,0,0,1.0,1,1.0,1,1.0,1,0.10941046889613024,55
2993,3,9586,2175,7411,0,0,0,1.0,1,1.0,1,1.0,1,0.09729061135561974,53
2994,5,9591,2177,7414,0,0,0,1.0,1,1.0,1,1.0,1,0.0877113585394343,53
2995,0,9591,2177,7414,0,0,0,1.0,1,1.0,1,1.0,1,0.11594837651981843,51
2996,1,9592,2178,7414,0,0,0,1.0,1,1.0,1,1.0,1,0.13006215755725462,52
2997,3,9595,2180,7415,0,0,0,1.0,1,1.0,1,1.0,1,0.146680935315317,50
2998,2,9597,2181,7416,0,0,0,1.0,1,1.0,1,1.0,1,0.12262623711838767,51
2999,0,9597,2181,7416,0,0,0,1.0,1,1.0,1,1.0,1,0.14104753905351317,48
3000,1,9598,2181,7417,0,0,0,1.0,1,1.0,1,1.0,1,0.13487658586458467,48
3001,1,9599,2181,7418,0,0,0,1.0,1,1.0,1,1.0,1,0.09550588066656392,49
3002,2,9601,2182,7419,0,0,0,1.0,1,1.0,1,1.0,1,0.09774077412977837,50
3003,0,9601,2182,7419,0,0,0,1.0,1,1.0,1,1.0,1,0.09774077412977837,50
3004,1,9602,2183,7419,0,0,0,1.0,1,1.0,1,1.0,1,0.09293089315989063,51
3005,0,9602,2183,7419,0,0,0,1.0,1,1.0,1,1.0,1,0.10230794652237879,50
3006,2,9604,2183,7421,0,0,0,1.0,1,1.0,1,1.0,1,0.09038714742303097,51
3007,0,9604,2183,7421,0,0,0,1.0,1,1.0,1,1.0,1,0.10457976539610331,51
3008,4,9608,2184,7424,0,0,0,1.0,1,1.0,1,1.0,1,0.11698045668397422,53
3009,3,9611,2184,7427,0,0,0,1.0,1,1.0,1,1.0,1,0.13580311640987422,52
3010,6,9617,2186,7431,0,0,0,1.0,1,1.0,1,1.0,1,0.16383163128973072,52
3011,2,9619,2186,7433,0,0,0,1.0,1,1.0,1,1.0,1,0.16620824805457618,51
3012,8,9627,2189,7438,0,0,0,1.0,1,1.0,1,1.0,1,0.17293762525102382,54
3013,4,9631,2190,7441,0,0,0,1.0,1,1.0,1,1.0,1,0.18612857747076608,52
3014,5,9636,2191,7445,0,0,0,1.0,1,1.0,1,1.0,1,0.2407995544426775,51
3015,8,9644,2194,7450,0,0,0,1.0,1,1.0,1,1.0,1,0.2469597401433722,50
3016,12,9656,2197,7459,0,0,0,1.0,1,1.0,1,1.0,1,0.12843291001366458,50
3017,3,9659,2198,7461,0,0,0,1.0,1,1.0,1,1.0,1,0.17474193659710485,48
3018,6,9665,2199,7466,0,0,0,1.0,1,1.0,1,1.0,1,0.1538922596046915,48
3019,1,9666,2200,7466,0,0,0,1.0,1,1.0,1,1.0,1,0.14649402149793272,47
3020,2,9668,2202,7466,0,0,0,1.0,1,1.0,1,1.0,1,0.138080257220096,47
3021,1,9669,2203,7466,0,0,0,1.0,1,1.0,1,1.0,1,0.17535032156450495,46
3022,2,9671,2205,7466,0,0,0,1.0,1,1.0,1,1.0,1,0.13664561896950844,45
3023,1,9672,2206,7466,0,0,0,1.0,1,1.0,1,1.0,1,0.12989981887871305,41
3024,7,9679,2210,7469,0,0,0,1.0,1,1.0,1,1.0,1,0.13524178413950277,43
3025,2,9681,2211,7470,0,0,0,1.0,1,1.0,1,1.0,1,0.1801770223624434,39
3026,5,9686,2213,7473,0,0,0,1.0,1,1.0,1,1.0,1,0.1846876001349346,38
3027,1,9687,2214,7473,0,0,0,1.0,1,1.0,1,1.0,1,0.19053179283438046,38
3028,1,9688,2214,7474,0,0,0,1.0,1,1.0,1,1.0,1,0.2081338488373022,38
3029,1,9689,2215,7474,0,0,0,1.0,1,1.0,1,1.0,1,0.24334128648842004,37
3030,1,9690,2215,7475,0,0,0,1.0,1,1.0,1,1.0,1,0.21991207736386725,38
3031,7,9697,2216,7481,0,0,0,1.0,1,1.0,1,1.0,1,0.13360899139241367,39
3032,3,9700,2217,7483,0,0,0,1.0,1,1.0,1,1.0,1,0.19187638302953366,39
3033,4,9704,2217,7487,0,0,0,1.0,1,1.0,1,1.0,1,0.20631337257871427,39
3034,3,9707,2217,7490,0,0,0,1.0,1,1.0,1,1.0,1,0.16410338127322047,38
3035,4,9711,2218,7493,0,0,0,1.0,1,1.0,1,1.0,1,0.19100667773068924,39
3036,3,9714,2218,7496,0,0,0,1.0,1,1.0,1,1.0,1,0.20220388989004917,39
3037,3,9717,2218,7499,0,0,0,1.0,1,1.0,1,1.0,1,0.16643671382499,39
3038,3,9720,2219,7501,0,0,0,1.0,1,1.0,1,1.0,1,0.1523907379377466,40
3039,4,9724,2220,7504,0,0,0,1.0,1,1.0,1,1.0,1,0.12162144295632238,41
3040,6,9730,2222,7508,0,0,0,1.0,1,1.0,1,1.0,1,0.12221882902447449,42
3041,6,9736,2223,7513,0,0,0,1.0,1,1.0,1,1.0,1,0.1692451129914727,43
3042,15,9751,2225,7526,0,0,0,1.0,1,1.0,1,1.0,1,0.24136193929054187,45
3043,12,9763,2227,7536,0,0,0,1.0,1,1.0,1,1.0,1,0.31974688041090815,45
3044,11,9774,2228,7546,0,0,0,1.0,1,1.0,1,1.0,1,0.25925509410618325,45
3045,10,9784,2229,7555,0,0,0,1.0,1,1.0,1,1.0,1,0.30015391232016964,45
3046,14,9798,2229,7569,0,0,0,1.0,1,1.0,1,1.0,1,0.10591050830566313,46
3047,9,9807,2229,7578,0,0,0,1.0,1,1.0,1,1.0,1,0.13116897269212094,46
3048,6,9813,2229,7584,0,0,0,1.0,1,1.0,1,1.0,1,0.14355492988140836,49
3049,9,9822,2229,7593,0,0,0,1.0,1,1.0,1,1.0,1,0.17279202183455314,50
3050,7,9829,2229,7600,0,0,0,1.0,1,1.0,1,1.0,1,0.1556256740168895,50
3051,10,9839,2230,7609,0,0,0,1.0,1,1.0,1,1.0,1,0.2765890770536798,50
3052,13,9852,2231,7621,0,0,0,1.0,1,1.0,1,1.0,1,0.21499869635364538,50
3053,8,9860,2232,7628,0,0,0,1.0,1,1.0,1,1.0,1,0.2554120226739914,49
3054,7,9867,2232,7635,0,0,0,1.0,1,1.0,1,1.0,1,0.2705362950388826,47
3055,10,9877,2232,7645,0,0,0,1.0,1,1.0,1,1.0,1,0.25529308260032973,48
3056,9,9886,2232,7654,0,0,0,1.0,1,1.0,1,1.0,1,0.24753382068240226,47
3057,8,9894,2232,7662,0,0,0,1.0,1,1.0,1,1.0,1,0.25416358787753374,48
3058,9,9903,2233,7670,0,0,0,1.0,1,1.0,1,1.0,1,0.2528978526936252,46
3059,5,9908,2234,7674,0,0,0,1.0,1,1.0,1,1.0,1,0.3321290137459449,44
3060,6,9914,2234,7680,0,0,0,1.0,1,1.0,1,1.0,1,0.33264164573444777,44
3061,6,9920,2234,7686,0,0,0,1.0,1,1.0,1,1.0,1,0.1917239255529132,42
3062,6,9926,2236,7690,0,0,0,1.0,1,1.0,1,1.0,1,0.17166025450316957,42
3063,5,9931,2238,7693,0,0,0,1.0,1,1.0,1,1.0,1,0.17167901238332736,41
3064,6,9937,2240,7697,0,0,0,1.0,1,1.0,1,1.0,1,0.18843642815476744,42
3065,5,9942,2240,7702,0,0,0,1.0,1,1.0,1,1.0,1,0.15473407852590726,40
3066,9,9951,2242,7709,0,0,0,1.0,1,1.0,1,1.0,1,0.1918725211544078,42
3067,5,9956,2244,7712,0,0,0,1.0,1,1.0,1,1.0,1,0.16052812745828618,40
3068,3,9959,2244,7715,0,0,0,1.0,1,1.0,1,1.0,1,0.15767631910485078,39
3069,0,9959,2244,7715,0,0,0,1.0,1,1.0,1,1.0,1,0.19581986373798924,38
3070,1,9960,2245,7715,0,0,0,1.0,1,1.0,1,1.0,1,0.19091181073496485,39
3071,1,9961,2245,7716,0,0,0,1.0,1,1.0,1,1.0,1,0.22770026264769694,39
3072,6,9967,2247,7720,0,0,0,1.0,1,1.0,1,1.0,1,0.23571922494058797,40
3073,5,9972,2247,7725,0,0,0,1.0,1,1.0,1,1.0,1,0.27817333972820707,38
3074,5,9977,2248,7729,0,0,0,1.0,1,1.0,1,1.0,1,0.25792960060522213,38
3075,11,9988,2250,7738,0,0,0,1.0,1,1.0,1,1.0,1,0.3174708463337273,41
3076,13,10001,2251,7750,0,0,0,1.0,1,1.0,1,1.0,1,0.11903567598078499,42
3077,6,10007,2253,7754,0,0,0,1.0,1,1.0,1,1.0,1,0.1439435487036414,42
3078,4,10011,2253,7758,0,0,0,1.0,1,1.0,1,1.0,1,0.1439435487036414,42
3079,3,10014,2253,7761,0,0,0,1.0,1,1.0,1,1.0,1,0.21517721387185523,42
3080,4,10018,2253,7765,0,0,0,1.0,1,1.0,1,1.0,1,0.1296917992216649,43
3081,4,10022,2253,7769,0,0,0,1.0,1,1.0,1,1.0,1,0.14103501758974274,44
3082,5,10027,2254,7773,0,0,0,1.0,1,1.0,1,1.0,1,0.15290394975670685,45
3083,4,10031,2254,7777,0,0,0,1.0,1,1.0,1,1.0,1,0.15290394975670685,45
3084,9,10040,2256,7784,0,0,0,1.0,1,1.0,1,1.0,1,0.19677153105148357,45
3085,9,10049,2256,7793,0,0,0,1.0,1,1.0,1,1.0,1,0.17707071198728036,46
3086,7,10056,2256,7800,0,0,0,1.0,1,1.0,1,1.0,1,0.19346240574584264,46
3087,5,10061,2256,7805,0,0,0,1.0,1,1.0,1,1.0,1,0.23123250314903182,47
3088,7,10068,2257,7811,0,0,0,1.0,1,1.0,1,1.0,1,0.19671510200854908,48
3089,8,10076,2257,7819,0,0,0,1.0,1,1.0,1,1.0,1,0.18645848917414923,46
3090,4,10080,2257,7823,0,0,0,1.0,1,1.0,1,1.0,1,0.2295302726856695,46
3091,6,10086,2257,7829,0,0,0,1.0,1,1.0,1,1.0,1,0.1590854411237196,46
3092,7,10093,2259,7834,0,0,0,1.0,1,1.0,1,1.0,1,0.15665298575017542,47
3093,3,10096,2260,7836,0,0,0,1.0,1,1.0,1,1.0,1,0.1683150082035331,47
3094,4,10100,2260,7840,0,0,0,1.0,1,1.0,1,1.0,1,0.13262792207177143,45
3095,0,10100,2260,7840,0,0,0,1.0,1,1.0,1,1.0,1,0.14749872660408983,46
3096,1,10101,2260,7841,0,0,0,1.0,1,1.0,1,1.0,1,0.1395178685048538,46
3097,3,10104,2261,7843,0,0,0,1.0,1,1.0,1,1.0,1,0.09514974506316216,47
3098,1,10105,2261,7844,0,0,0,1.0,1,1.0,1,1.0,1,0.11650789953051771,47
3099,0,10105,2261,7844,0,0,0,1.0,1,1.0,1,1.0,1,0.11650789953051771,47
3100,0,10105,2261,7844,0,0,0,1.0,1,1.0,1,1.0,1,0.11650789953051771,47
3101,0,10105,2261,7844,0,0,0,1.0,1,1.0,1,1.0,1,0.10004558231378748,48
3102,3,10108,2263,7845,0,0,0,1.0,1,1.0,1,1.0,1,0.11366703549236644,48
3103,4,10112,2264,7848,0,0,0,1.0,1,1.0,1,1.0,1,0.09731835104627237,49
3104,2,10114,2265,7849,0,0,0,1.0,1,1.0,1,1.0,1,0.10412312013027249,48
3105,2,10116,2266,7850,0,0,0,1.0,1,1.0,1,1.0,1,0.11671871293058925,45
3106,3,10119,2267,7852,0,0,0,1.0,1,1.0,1,1.0,1,0.08900296921944983,46
3107,0,10119,2267,7852,0,0,0,1.0,1,1.0,1,1.0,1,0.11701968660079687,44
3108,0,10119,2267,7852,0,0,0,1.0,1,1.0,1,1.0,1,0.10192272343611078,45
3109,1,10120,2267,7853,0,0,0,1.0,1,1.0,1,1.0,1,0.10111437875796765,44
3110,2,10122,2268,7854,0,0,0,1.0,1,1.0,1,1.0,1,0.11934089550661672,46
3111,1,10123,2269,7854,0,0,0,1.0,1,1.0,1,1.0,1,0.13179342330685523,46
3112,2,10125,2270,7855,0,0,0,1.0,1,1.0,1,1.0,1,0.13015083571163824,47
3113,1,10126,2271,7855,0,0,0,1.0,1,1.0,1,1.0,1,0.11641715950436805,48
3114,1,10127,2271,7856,0,0,0,1.0,1,1.0,1,1.0,1,0.11772950784755432,48
3115,0,10127,2271,7856,0,0,0,1.0,1,1.0,1,1.0,1,0.13870385239483535,49
3116,0,10127,2271,7856,0,0,0,1.0,1,1.0,1,1.0,1,0.16480441610093002,48
3117,3,10130,2272,7858,0,0,0,1.0,1,1.0,1,1.0,1,0.16996159955233472,49
3118,2,10132,2272,7860,0,0,0,1.0,1,1.0,1,1.0,1,0.1668304813981222,50
3119,1,10133,2272,7861,0,0,0,1.0,1,1.0,1,1.0,1,0.13768293492493056,50
3120,3,10136,2273,7863,0,0,0,1.0,1,1.0,1,1.0,1,0.16039375553285276,50
3121,3,10139,2273,7866,0,0,0,1.0,1,1.0,1,1.0,1,0.1265663285632687,50
3122,1,10140,2273,7867,0,0,0,1.0,1,1.0,1,1.0,1,0.12287322902763194,50
3123,1,10141,2274,7867,0,0,0,1.0,1,1.0,1,1.0,1,0.11444799699929446,51
3124,1,10142,2275,7867,0,0,0,1.0,1,1.0,1,1.0,1,0.14637567250859027,51
3125,2,10144,2276,7868,0,0,0,1.0,1,1.0,1,1.0,1,0.1248156871937016,51
3126,1,10145,2277,7868,0,0,0,1.0,1,1.0,1,1.0,1,0.1290501176794368,54
3127,3,10148,2279,7869,0,0,0,1.0,1,1.0,1,1.0,1,0.13686065113388385,53
3128,2,10150,2280,7870,0,0,0,1.0,1,1.0,1,1.0,1,0.1503227974593996,52
3129,1,10151,2281,7870,0,0,0,1.0,1,1.0,1,1.0,1,0.1493884547064904,51
3130,0,10151,2281,7870,0,0,0,1.0,1,1.0,1,1.0,1,0.15709844001761103,50
3131,1,10152,2282,7870,0,0,0,1.0,1,1.0,1,1.0,1,0.1581102498361318,50
3132,2,10154,2284,7870,0,0,0,1.0,1,1.0,1,1.0,1,0.20795488855252556,49
3133,2,10156,2286,7870,0,0,0,1.0,1,1.0,1,1.0,1,0.21748504040766936,49
3134,0,10156,2286,7870,0,0,0,1.0,1,1.0,1,1.0,1,0.23368470384591156,46
3135,1,10157,2287,7870,0,0,0,1.0,1,1.0,1,1.0,1,0.23011873762504842,47
3136,8,10165,2288,7877,0,0,0,1.0,1,1.0,1,1.0,1,0.11445086167475484,46
3137,4,10169,2291,7878,0,0,0,1.0,1,1.0,1,1.0,1,0.1377320356096625,49
3138,1,10170,2291,7879,0,0,0,1.0,1,1.0,1,1.0,1,0.12498107322763279,49
3139,1,10171,2292,7879,0,0,0,1.0,1,1.0,1,1.0,1,0.1518659088577449,50
3140,5,10176,2293,7883,0,0,0,1.0,1,1.0,1,1.0,1,0.14792628786923206,51
3141,1,10177,2294,7883,0,0,0,1.0,1,1.0,1,1.0,1,0.17832206050615226,50
3142,2,10179,2294,7885,0,0,0,1.0,1,1.0,1,1.0,1,0.18017348431752306,50
3143,3,10182,2295,7887,0,0,0,1.0,1,1.0,1,1.0,1,0.20209061838573453,49
3144,6,10188,2296,7892,0,0,0,1.0,1,1.0,1,1.0,1,0.22400848769233922,49
3145,3,10191,2296,7895,0,0,0,1.0,1,1.0,1,1.0,1,0.19251041953259315,48
3146,7,10198,2298,7900,0,0,0,1.0,1,1.0,1,1.0,1,0.19140862880978066,49
3147,3,10201,2298,7903,0,0,0,1.0,1,1.0,1,1.0,1,0.17388754994112549,48
3148,6,10207,2299,7908,0,0,0,1.0,1,1.0,1,1.0,1,0.17364860187131642,48
3149,2,10209,2299,7910,0,0,0,1.0,1,1.0,1,1.0,1,0.17490109857654954,47
3150,2,10211,2299,7912,0,0,0,1.0,1,1.0,1,1.0,1,0.17490109857654954,47
3151,5,10216,2300,7916,0,0,0,1.0,1,1.0,1,1.0,1,0.14382613983947892,48
3152,1,10217,2300,7917,0,0,0,1.0,1,1.0,1,1.0,1,0.13378729926211114,47
3153,3,10220,2301,7919,0,0,0,1.0,1,1.0,1,1.0,1,0.11434929185779058,47
3154,2,10222,2302,7920,0,0,0,1.0,1,1.0,1,1.0,1,0.13269610303346904,48
3155,2,10224,2303,7921,0,0,0,1.0,1,1.0,1,1.0,1,0.1479822260482646,48
3156,2,10226,2303,7923,0,0,0,1.0,1,1.0,1,1.0,1,0.0852356087366388,48
3157,0,10226,2303,7923,0,0,0,1.0,1,1.0,1,1.0,1,0.11682291443374639,48
3158,1,10227,2304,7923,0,0,0,1.0,1,1.0,1,1.0,1,0.1386034288163592,48
3159,1,10228,2304,7924,0,0,0,1.0,1,1.0,1,1.0,1,0.13862145392771835,49
3160,2,10230,2304,7926,0,0,0,1.0,1,1.0,1,1.0,1,0.1520980692501722,51
3161,1,10231,2304,7927,0,0,0,1.0,1,1.0,1,1.0,1,0.1403703421160506,52
3162,1,10232,2305,7927,0,0,0,1.0,1,1.0,1,1.0,1,0.1515189011882428,51
3163,2,10234,2306,7928,0,0,0,1.0,1,1.0,1,1.0,1,0.16290802885509395,51
3164,2,10236,2307,7929,0,0,0,1.0,1,1.0,1,1.0,1,0.19304738631632526,52
3165,7,10243,2309,7934,0,0,0,1.0,1,1.0,1,1.0,1,0.19012499852458242,50
3166,7,10250,2309,7941,0,0,0,1.0,1,1.0,1,1.0,1,0.09957422751433899,50
3167,4,10254,2312,7942,0,0,0,1.0,1,1.0,1,1.0,1,0.16072108649295616,49
3168,3,10257,2313,7944,0,0,0,1.0,1,1.0,1,1.0,1,0.1301827769798103,47
3169,3,10260,2316,7944,0,0,0,1.0,1,1.0,1,1.0,1,0.15689163974571535,48
3170,2,10262,2316,7946,0,0,0,1.0,1,1.0,1,1.0,1,0.17295781061090176,47
3171,2,10264,2316,7948,0,0,0,1.0,1,1.0,1,1.0,1,0.18645691250807161,47
3172,3,10267,2317,7950,0,0,0,1.0,1,1.0,1,1.0,1,0.22427625753762814,46
3173,4,10271,2317,7954,0,0,0,1.0,1,1.0,1,1.0,1,0.15217406640895906,45
3174,1,10272,2318,7954,0,0,0,1.0,1,1.0,1,1.0,1,0.18376634106773057,43
3175,1,10273,2319,7954,0,0,0,1.0,1,1.0,1,1.0,1,0.15638419675967366,43
3176,1,10274,2320,7954,0,0,0,1.0,1,1.0,1,1.0,1,0.14326718952563278,44
3177,2,10276,2321,7955,0,0,0,1.0,1,1.0,1,1.0,1,0.14532848849375987,44
3178,0,10276,2321,7955,0,0,0,1.0,1,1.0,1,1.0,1,0.14202618005362794,47
3179,6,10282,2325,7957,0,0,0,1.0,1,1.0,1,1.0,1,0.11801827788327472,48
3180,3,10285,2326,7959,0,0,0,1.0,1,1.0,1,1.0,1,0.16025816922852365,48
3181,4,10289,2326,7963,0,0,0,1.0,1,1.0,1,1.0,1,0.0860868527229061,48
3182,1,10290,2327,7963,0,0,0,1.0,1,1.0,1,1.0,1,0.09562290315016442,51
3183,2,10292,2328,7964,0,0,0,1.0,1,1.0,1,1.0,1,0.10795274739219915,50
3184,6,10298,2330,7968,0,0,0,1.0,1,1.0,1,1.0,1,0.11876401646396499,50
3185,2,10300,2330,7970,0,0,0,1.0,1,1.0,1,1.0,1,0.14173683586366032,48
3186,3,10303,2331,7972,0,0,0,1.0,1,1.0,1,1.0,1,0.15436172771737838,48
3187,8,10311,2331,7980,0,0,0,1.0,1,1.0,1,1.0,1,0.17856798587331624,48
3188,4,10315,2332,7983,0,0,0,1.0,1,1.0,1,1.0,1,0.21675868385684935,48
3189,9,10324,2332,7992,0,0,0,1.0,1,1.0,1,1.0,1,0.21350632310067072,49
3190,4,10328,2332,7996,0,0,0,1.0,1,1.0,1,1.0,1,0.1999691760571563,51
3191,6,10334,2332,8002,0,0,0,1.0,1,1.0,1,1.0,1,0.19623693100722134,52
3192,5,10339,2332,8007,0,0,0,1.0,1,1.0,1,1.0,1,0.17599272595459287,52
3193,4,10343,2332,8011,0,0,0,1.0,1,1.0,1,1.0,1,0.17153617221156287,52
3194,5,10348,2332,8016,0,0,0,1.0,1,1.0,1,1.0,1,0.16641960322606336,54
3195,4,10352,2332,8020,0,0,0,1.0,1,1.0,1,1.0,1,0.13828672403360115,54
3196,5,10357,2335,8022,0,0,0,1.0,1,1.0,1,1.0,1,0.12767810398480836,54
3197,1,10358,2335,8023,0,0,0,1.0,1,1.0,1,1.0,1,0.1329629797290787,54
3198,3,10361,2336,8025,0,0,0,1.0,1,1.0,1,1.0,1,0.14078628162294904,54
3199,5,10366,2336,8030,0,0,0,1.0,1,1.0,1,1.0,1,0.1496200194087383,56
3200,4,10370,2338,8032,0,0,0,1.0,1,1.0,1,1.0,1,0.21348165673317077,56
3201,4,10374,2338,8036,0,0,0,1.0,1,1.0,1,1.0,1,0.17891100912987823,56
3202,3,10377,2338,8039,0,0,0,1.0,1,1.0,1,1.0,1,0.18084070811124484,57
3203,2,10379,2338,8041,0,0,0,1.0,1,1.0,1,1.0,1,0.18293295530347387,56
3204,8,10387,2341,8046,0,0,0,1.0,1,1.0,1,1.0,1,0.21318911798237572,55
3205,2,10389,2341,8048,0,0,0,1.0,1,1.0,1,1.0,1,0.1918577683010413,54
3206,8,10397,2344,8053,0,0,0,1.0,1,1.0,1,1.0,1,0.22654392988524577,56
3207,4,10401,2345,8056,0,0,0,1.0,1,1.0,1,1.0,1,0.23541562707330158,54
3208,6,10407,2346,8061,0,0,0,1.0,1,1.0,1,1.0,1,0.27720088893266875,53
3209,6,10413,2346,8067,0,0,0,1.0,1,1.0,1,1.0,1,0.260111188064825,54
3210,4,10417,2347,8070,0,0,0,1.0,1,1.0,1,1.0,1,0.2689586474725406,53
3211,8,10425,2348,8077,0,0,0,1.0,1,1.0,1,1.0,1,0.1778915964423665,53
3212,2,10427,2348,8079,0,0,0,1.0,1,1.0,1,1.0,1,0.18402382617444998,54
3213,2,10429,2348,8081,0,0,0,1.0,1,1.0,1,1.0,1,0.16848362936177572,54
3214,2,10431,2348,8083,0,0,0,1.0,1,1.0,1,1.0,1,0.16560609225855114,55
3215,2,10433,2348,8085,0,0,0,1.0,1,1.0,1,1.0,1,0.16560609225855114,55
3216,0,10433,2348,8085,0,0,0,1.0,1,1.0,1,1.0,1,0.16560609225855114,55
3217,4,10437,2351,8086,0,0,0,1.0,1,1.0,1,1.0,1,0.21021735037596959,54
3218,2,10439,2351,8088,0,0,0,1.0,1,1.0,1,1.0,1,0.16173811764637613,54
3219,3,10442,2351,8091,0,0,0,1.0,1,1.0,1,1.0,1,0.18537941063774693,55
3220,1,10443,2351,8092,0,0,0,1.0,1,1.0,1,1.0,1,0.15868011963985312,56
3221,2,10445,2352,8093,0,0,0,1.0,1,1.0,1,1.0,1,0.17082739886342446,57
3222,4,10449,2353,8096,0,0,0,1.0,1,1.0,1,1.0,1,0.1638626420994065,57
3223,5,10454,2354,8100,0,0,0,1.0,1,1.0,1,1.0,1,0.18322560460963414,56
3224,9,10463,2357,8106,0,0,0,1.0,1,1.0,1,1.0,1,0.15765142063896584,58
3225,4,10467,2358,8109,0,0,0,1.0,1,1.0,1,1.0,1,0.14959892940178232,55
3226,6,10473,2360,8113,0,0,0,1.0,1,1.0,1,1.0,1,0.12741380525016888,54
3227,0,10473,2360,8113,0,0,0,1.0,1,1.0,1,1.0,1,0.09413961392395571,53
3228,5,10478,2362,8116,0,0,0,1.0,1,1.0,1,1.0,1,0.11174822809547488,52
3229,4,10482,2365,8117,0,0,0,1.0,1,1.0,1,1.0,1,0.15114651846860205,52
3230,2,10484,2366,8118,0,0,0,1.0,1,1.0,1,1.0,1,0.18717359180725035,50
3231,5,10489,2369,8120,0,0,0,1.0,1,1.0,1,1.0,1,0.2049976353876194,50
3232,2,10491,2371,8120,0,0,0,1.0,1,1.0,1,1.0,1,0.2215487652166873,50
3233,2,10493,2372,8121,0,0,0,1.0,1,1.0,1,1.0,1,0.18402619388318142,50
3234,3,10496,2374,8122,0,0,0,1.0,1,1.0,1,1.0,1,0.2014208346721577,49
3235,6,10502,2376,8126,0,0,0,1.0,1,1.0,1,1.0,1,0.26908618234787546,49
3236,4,10506,2376,8130,0,0,0,1.0,1,1.0,1,1.0,1,0.24515501119749092,51
3237,5,10511,2377,8134,0,0,0,1.0,1,1.0,1,1.0,1,0.23028343224211192,53
3238,5,10516,2377,8139,0,0,0,1.0,1,1.0,1,1.0,1,0.25351403731190525,53
3239,5,10521,2377,8144,0,0,0,1.0,1,1.0,1,1.0,1,0.256677987843271,53
3240,3,10524,2377,8147,0,0,0,1.0,1,1.0,1,1.0,1,0.24616451103766385,53
3241,8,10532,2377,8155,0,0,0,1.0,1,1.0,1,1.0,1,0.18854533443025084,53
3242,1,10533,2377,8156,0,0,0,1.0,1,1.0,1,1.0,1,0.18436258757221835,53
3243,1,10534,2377,8157,0,0,0,1.0,1,1.0,1,1.0,1,0.15936585105877704,56
3244,3,10537,2377,8160,0,0,0,1.0,1,1.0,1,1.0,1,0.16118845298831147,57
3245,8,10545,2377,8168,0,0,0,1.0,1,1.0,1,1.0,1,0.1403273246431818,59
3246,4,10549,2377,8172,0,0,0,1.0,1,1.0,1,1.0,1,0.140430472880528,59
3247,7,10556,2378,8178,0,0,0,1.0,1,1.0,1,1.0,1,0.12278277247607348,59
3248,9,10565,2379,8186,0,0,0,1.0,1,1.0,1,1.0,1,0.1321264625357206,59
3249,4,10569,2379,8190,0,0,0,1.0,1,1.0,1,1.0,1,0.1595704992982442,58
3250,7,10576,2379,8197,0,0,0,1.0,1,1.0,1,1.0,1,0.10594067155130896,58
3251,4,10580,2379,8201,0,0,0,1.0,1,1.0,1,1.0,1,0.15736926820161967,57
3252,8,10588,2379,8209,0,0,0,1.0,1,1.0,1,1.0,1,0.16331807539575874,57
3253,4,10592,2379,8213,0,0,0,1.0,1,1.0,1,1.0,1,0.1706595797636008,56
3254,4,10596,2380,8216,0,0,0,1.0,1,1.0,1,1.0,1,0.16013765631570523,57
3255,6,10602,2381,8221,0,0,0,1.0,1,1.0,1,1.0,1,0.1842105540456647,57
3256,5,10607,2381,8226,0,0,0,1.0,1,1.0,1,1.0,1,0.12226461546524688,57
3257,0,10607,2381,8226,0,0,0,1.0,1,1.0,1,1.0,1,0.12226461546524688,57
3258,4,10611,2381,8230,0,0,0,1.0,1,1.0,1,1.0,1,0.1404999902390363,58
3259,4,10615,2382,8233,0,0,0,1.0,1,1.0,1,1.0,1,0.10525453301824347,59
3260,1,10616,2382,8234,0,0,0,1.0,1,1.0,1,1.0,1,0.1374514428841411,60
3261,5,10621,2384,8237,0,0,0,1.0,1,1.0,1,1.0,1,0.14518501419839297,60
3262,4,10625,2387,8238,0,0,0,1.0,1,1.0,1,1.0,1,0.17141422562239034,61
3263,4,10629,2390,8239,0,0,0,1.0,1,1.0,1,1.0,1,0.16551717574413818,62
3264,6,10635,2395,8240,0,0,0,1.0,1,1.0,1,1.0,1,0.17093766769986354,60
3265,2,10637,2396,8241,0,0,0,1.0,1,1.0,1,1.0,1,0.18460659107478328,58
3266,8,10645,2402,8243,0,0,0,1.0,1,1.0,1,1.0,1,0.2097446291635145,59
3267,6,10651,2404,8247,0,0,0,1.0,1,1.0,1,1.0,1,0.20856508963326412,60
3268,7,10658,2408,8250,0,0,0,1.0,1,1.0,1,1.0,1,0.24747259974167846,58
3269,3,10661,2409,8252,0,0,0,1.0,1,1.0,1,1.0,1,0.20387693250552683,57
3270,2,10663,2410,8253,0,0,0,1.0,1,1.0,1,1.0,1,0.17704116216956575,56
3271,7,10670,2411,8259,0,0,0,1.0,1,1.0,1,1.0,1,0.09048182291980343,55
3272,0,10670,2411,8259,0,0,0,1.0,1,1.0,1,1.0,1,0.09005149721543265,55
3273,4,10674,2413,8261,0,0,0,1.0,1,1.0,1,1.0,1,0.1427011561959981,55
3274,1,10675,2414,8261,0,0,0,1.0,1,1.0,1,1.0,1,0.158159626964156,55
3275,2,10677,2415,8262,0,0,0,1.0,1,1.0,1,1.0,1,0.15924020057653754,55
3276,2,10679,2415,8264,0,0,0,1.0,1,1.0,1,1.0,1,0.1595738982031819,55
3277,6,10685,2416,8269,0,0,0,1.0,1,1.0,1,1.0,1,0.17835730153031149,57
3278,4,10689,2417,8272,0,0,0,1.0,1,1.0,1,1.0,1,0.1300887331904914,56
3279,2,10691,2417,8274,0,0,0,1.0,1,1.0,1,1.0,1,0.10294346539625703,54
3280,2,10693,2418,8275,0,0,0,1.0,1,1.0,1,1.0,1,0.11581560742975837,53
3281,0,10693,2418,8275,0,0,0,1.0,1,1.0,1,1.0,1,0.11369369545987285,52
3282,0,10693,2418,8275,0,0,0,1.0,1,1.0,1,1.0,1,0.12353531514107509,50
3283,5,10698,2420,8278,0,0,0,1.0,1,1.0,1,1.0,1,0.11095285849759558,50
3284,0,10698,2420,8278,0,0,0,1.0,1,1.0,1,1.0,1,0.12918098006366133,47
3285,2,10700,2420,8280,0,0,0,1.0,1,1.0,1,1.0,1,0.13382235361389483,48
3286,7,10707,2423,8284,0,0,0,1.0,1,1.0,1,1.0,1,0.09123338328338465,46
3287,5,10712,2425,8287,0,0,0,1.0,1,1.0,1,1.0,1,0.05926376145222655,46
3288,6,10718,2428,8290,0,0,0,1.0,1,1.0,1,1.0,1,0.09510349214421733,46
3289,5,10723,2429,8294,0,0,0,1.0,1,1.0,1,1.0,1,0.15654570691519626,48
3290,4,10727,2430,8297,0,0,0,1.0,1,1.0,1,1.0,1,0.1438526287831398,48
3291,6,10733,2431,8302,0,0,0,1.0,1,1.0,1,1.0,1,0.189057315307161,50
3292,8,10741,2432,8309,0,0,0,1.0,1,1.0,1,1.0,1,0.18586218704305277,50
3293,8,10749,2433,8316,0,0,0,1.0,1,1.0,1,1.0,1,0.20582824068602476,51
3294,6,10755,2433,8322,0,0,0,1.0,1,1.0,1,1.0,1,0.18796472805859626,50
3295,3,10758,2433,8325,0,0,0,1.0,1,1.0,1,1.0,1,0.1914086902067134,50
3296,5,10763,2435,8328,0,0,0,1.0,1,1.0,1,1.0,1,0.2202601129307975,50
3297,3,10766,2435,8331,0,0,0,1.0,1,1.0,1,1.0,1,0.20470721516807242,51
3298,6,10772,2435,8337,0,0,0,1.0,1,1.0,1,1.0,1,0.2132046342815553,52
3299,4,10776,2435,8341,0,0,0,1.0,1,1.0,1,1.0,1,0.2176283721602932,53
3300,3,10779,2435,8344,0,0,0,1.0,1,1.0,1,1.0,1,0.19630758967930084,53
3301,10,10789,2436,8353,0,0,0,1.0,1,1.0,1,1.0,1,0.07235934829122699,53
3302,5,10794,2437,8357,0,0,0,1.0,1,1.0,1,1.0,1,0.06588321165921542,53
3303,4,10798,2438,8360,0,0,0,1.0,1,1.0,1,1.0,1,0.06160691148963281,52
3304,8,10806,2442,8364,0,0,0,1.0,1,1.0,1,1.0,1,0.10539718184362383,52
3305,3,10809,2444,8365,0,0,0,1.0,1,1.0,1,1.0,1,0.15520423134909223,51
3306,7,10816,2446,8370,0,0,0,1.0,1,1.0,1,1.0,1,0.1048542585143038,51
3307,5,10821,2446,8375,0,0,0,1.0,1,1.0,1,1.0,1,0.10531314609678474,48
3308,7,10828,2448,8380,0,0,0,1.0,1,1.0,1,1.0,1,0.11008431993240746,48
3309,5,10833,2448,8385,0,0,0,1.0,1,1.0,1,1.0,1,0.17210289621734798,48
3310,3,10836,2448,8388,0,0,0,1.0,1,1.0,1,1.0,1,0.218880417059397,47
3311,4,10840,2449,8391,0,0,0,1.0,1,1.0,1,1.0,1,0.21912895179191982,49
3312,6,10846,2449,8397,0,0,0,1.0,1,1.0,1,1.0,1,0.23668821096280612,48
3313,7,10853,2452,8401,0,0,0,1.0,1,1.0,1,1.0,1,0.23462024043645516,49
3314,4,10857,2452,8405,0,0,0,1.0,1,1.0,1,1.0,1,0.2557545592344952,47
3315,8,10865,2454,8411,0,0,0,1.0,1,1.0,1,1.0,1,0.28892530059869703,47
3316,6,10871,2454,8417,0,0,0,1.0,1,1.0,1,1.0,1,0.1978727673413372,47
3317,3,10874,2455,8419,0,0,0,1.0,1,1.0,1,1.0,1,0.1494479076944734,46
3318,2,10876,2456,8420,0,0,0,1.0,1,1.0,1,1.0,1,0.14028258703118213,45
3319,3,10879,2456,8423,0,0,0,1.0,1,1.0,1,1.0,1,0.1325325390093156,44
3320,1,10880,2456,8424,0,0,0,1.0,1,1.0,1,1.0,1,0.17141944166910347,43
3321,2,10882,2457,8425,0,0,0,1.0,1,1.0,1,1.0,1,0.14339189623632342,43
3322,0,10882,2457,8425,0,0,0,1.0,1,1.0,1,1.0,1,0.1715334499388983,40
3323,0,10882,2457,8425,0,0,0,1.0,1,1.0,1,1.0,1,0.2035232129810575,40
3324,6,10888,2460,8428,0,0,0,1.0,1,1.0,1,1.0,1,0.20645891120128254,40
3325,3,10891,2462,8429,0,0,0,1.0,1,1.0,1,1.0,1,0.25277968397872214,40
3326,4,10895,2462,8433,0,0,0,1.0,1,1.0,1,1.0,1,0.22438518554848955,41
3327,2,10897,2463,8434,0,0,0,1.0,1,1.0,1,1.0,1,0.23269274615143834,39
3328,7,10904,2467,8437,0,0,0,1.0,1,1.0,1,1.0,1,0.3094717226954127,41
3329,3,10907,2468,8439,0,0,0,1.0,1,1.0,1,1.0,1,0.2564993207260096,39
3330,3,10910,2470,8440,0,0,0,1.0,1,1.0,1,1.0,1,0.29241879866084175,40
3331,6,10916,2470,8446,0,0,0,1.0,1,1.0,1,1.0,1,0.15195997637616085,38
3332,1,10917,2470,8447,0,0,0,1.0,1,1.0,1,1.0,1,0.20945784359042544,38
3333,1,10918,2470,8448,0,0,0,1.0,1,1.0,1,1.0,1,0.18397668313025348,38
3334,3,10921,2470,8451,0,0,0,1.0,1,1.0,1,1.0,1,0.16637586133214716,40
3335,2,10923,2470,8453,0,0,0,1.0,1,1.0,1,1.0,1,0.15041732632286456,40
3336,0,10923,2470,8453,0,0,0,1.0,1,1.0,1,1.0,1,0.18466303552691815,39
3337,2,10925,2470,8455,0,0,0,1.0,1,1.0,1,1.0,1,0.1596244177435107,40
3338,1,10926,2471,8455,0,0,0,1.0,1,1.0,1,1.0,1,0.20266592312574574,41
3339,2,10928,2472,8456,0,0,0,1.0,1,1.0,1,1.0,1,0.15270339719916376,42
3340,4,10932,2474,8458,0,0,0,1.0,1,1.0,1,1.0,1,0.19559606063600535,43
3341,6,10938,2474,8464,0,0,0,1.0,1,1.0,1,1.0,1,0.19018021036500302,43
3342,8,10946,2475,8471,0,0,0,1.0,1,1.0,1,1.0,1,0.2625588514734321,44
3343,8,10954,2477,8477,0,0,0,1.0,1,1.0,1,1.0,1,0.22627914825010947,44
3344,12,10966,2479,8487,0,0,0,1.0,1,1.0,1,1.0,1,0.25392237632604236,44
3345,7,10973,2479,8494,0,0,0,1.0,1,1.0,1,1.0,1,0.2488366004814919,43
3346,1,10974,2479,8495,0,0,0,1.0,1,1.0,1,1.0,1,0.2671506607911723,42
3347,0,10974,2479,8495,0,0,0,1.0,1,1.0,1,1.0,1,0.23547753467561355,44
3348,1,10975,2479,8496,0,0,0,1.0,1,1.0,1,1.0,1,0.23232145028949913,45
3349,1,10976,2480,8496,0,0,0,1.0,1,1.0,1,1.0,1,0.2317272017617506,45
3350,2,10978,2480,8498,0,0,0,1.0,1,1.0,1,1.0,1,0.2052609416962527,46
3351,1,10979,2480,8499,0,0,0,1.0,1,1.0,1,1.0,1,0.1794382319874185,47
3352,3,10982,2481,8501,0,0,0,1.0,1,1.0,1,1.0,1,0.19169140235590112,47
3353,5,10987,2482,8505,0,0,0,1.0,1,1.0,1,1.0,1,0.1917655780136605,48
3354,4,10991,2483,8508,0,0,0,1.0,1,1.0,1,1.0,1,0.18655693152125982,48
3355,2,10993,2484,8509,0,0,0,1.0,1,1.0,1,1.0,1,0.15965395675776392,48
3356,2,10995,2484,8511,0,0,0,1.0,1,1.0,1,1.0,1,0.13352566352295153,48
3357,1,10996,2484,8512,0,0,0,1.0,1,1.0,1,1.0,1,0.1561345632701506,47
3358,2,10998,2485,8513,0,0,0,1.0,1,1.0,1,1.0,1,0.11016204647991926,46
3359,3,11001,2486,8515,0,0,0,1.0,1,1.0,1,1.0,1,0.09840483158369653,45
3360,3,11004,2488,8516,0,0,0,1.0,1,1.0,1,1.0,1,0.1475551765512702,44
3361,2,11006,2489,8517,0,0,0,1.0,1,1.0,1,1.0,1,0.12962355905483752,43
3362,4,11010,2490,8520,0,0,0,1.0,1,1.0,1,1.0,1,0.1974001391798558,42
3363,5,11015,2491,8524,0,0,0,1.0,1,1.0,1,1.0,1,0.24924259008026423,41
3364,1,11016,2491,8525,0,0,0,1.0,1,1.0,1,1.0,1,0.2922679358533897,41
3365,0,11016,2491,8525,0,0,0,1.0,1,1.0,1,1.0,1,0.2931744527855694,41
3366,2,11018,2491,8527,0,0,0,1.0,1,1.0,1,1.0,1,0.2521421992312818,40
3367,2,11020,2492,8528,0,0,0,1.0,1,1.0,1,1.0,1,0.2118126404812164,39
3368,0,11020,2492,8528,0,0,0,1.0,1,1.0,1,1.0,1,0.2118126404812164,39
3369,0,11020,2492,8528,0,0,0,1.0,1,1.0,1,1.0,1,0.2003921784951103,40
3370,2,11022,2494,8528,0,0,0,1.0,1,1.0,1,1.0,1,0.21023382246494995,41
3371,1,11023,2495,8528,0,0,0,1.0,1,1.0,1,1.0,1,0.21875753140558518,41
3372,2,11025,2497,8528,0,0,0,1.0,1,1.0,1,1.0,1,0.21279755718159213,40
3373,3,11028,2498,8530,0,0,0,1.0,1,1.0,1,1.0,1,0.23622264934189854,41
3374,1,11029,2498,8531,0,0,0,1.0,1,1.0,1,1.0,1,0.24374085296912257,42
3375,5,11034,2498,8536,0,0,0,1.0,1,1.0,1,1.0,1,0.1947677820528902,44
3376,7,11041,2499,8542,0,0,0,1.0,1,1.0,1,1.0,1,0.11634905469858138,46
3377,2,11043,2499,8544,0,0,0,1.0,1,1.0,1,1.0,1,0.1112229319188872,47
3378,3,11046,2500,8546,0,0,0,1.0,1,1.0,1,1.0,1,0.12024691369819564,48
3379,2,11048,2500,8548,0,0,0,1.0,1,1.0,1,1.0,1,0.12024691369819564,48
3380,3,11051,2502,8549,0,0,0,1.0,1,1.0,1,1.0,1,0.17759159080467013,48
3381,3,11054,2502,8552,0,0,0,1.0,1,1.0,1,1.0,1,0.16597751256364743,48
3382,4,11058,2503,8555,0,0,0,1.0,1,1.0,1,1.0,1,0.1631321521503188,49
3383,0,11058,2503,8555,0,0,0,1.0,1,1.0,1,1.0,1,0.14803336077920382,47
3384,10,11068,2506,8562,0,0,0,1.0,1,1.0,1,1.0,1,0.20394711489802073,48
3385,0,11068,2506,8562,0,0,0,1.0,1,1.0,1,1.0,1,0.16887573781704693,47
3386,9,11077,2508,8569,0,0,0,1.0,1,1.0,1,1.0,1,0.1829782370601956,49
3387,2,11079,2508,8571,0,0,0,1.0,1,1.0,1,1.0,1,0.17009606966917026,48
3388,3,11082,2508,8574,0,0,0,1.0,1,1.0,1,1.0,1,0.171354164264928,48
3389,2,11084,2508,8576,0,0,0,1.0,1,1.0,1,1.0,1,0.1873547418425923,50
3390,2,11086,2509,8577,0,0,0,1.0,1,1.0,1,1.0,1,0.18204713223332192,51
3391,4,11090,2509,8581,0,0,0,1.0,1,1.0,1,1.0,1,0.1194669940959421,51
3392,1,11091,2509,8582,0,0,0,1.0,1,1.0,1,1.0,1,0.11216312924300845,52
3393,2,11093,2509,8584,0,0,0,1.0,1,1.0,1,1.0,1,0.10500227013375511,52
3394,0,11093,2509,8584,0,0,0,1.0,1,1.0,1,1.0,1,0.10500227013375511,52
3395,0,11093,2509,8584,0,0,0,1.0,1,1.0,1,1.0,1,0.11385783737888021,50
3396,0,11093,2509,8584,0,0,0,1.0,1,1.0,1,1.0,1,0.11880321669826868,49
3397,0,11093,2509,8584,0,0,0,1.0,1,1.0,1,1.0,1,0.12486177910304923,49
3398,0,11093,2509,8584,0,0,0,1.0,1,1.0,1,1.0,1,0.1399821745867101,48
3399,3,11096,2510,8586,0,0,0,1.0,1,1.0,1,1.0,1,0.14951625555118767,49
3400,2,11098,2511,8587,0,0,0,1.0,1,1.0,1,1.0,1,0.1518297256324246,50
3401,3,11101,2511,8590,0,0,0,1.0,1,1.0,1,1.0,1,0.1446052812026046,51
3402,4,11105,2512,8593,0,0,0,1.0,1,1.0,1,1.0,1,0.18428268327921854,51
3403,3,11108,2512,8596,0,0,0,1.0,1,1.0,1,1.0,1,0.16702108497612014,51
3404,1,11109,2512,8597,0,0,0,1.0,1,1.0,1,1.0,1,0.15492365119766266,51
3405,0,11109,2512,8597,0,0,0,1.0,1,1.0,1,1.0,1,0.15492365119766266,51
3406,2,11111,2512,8599,0,0,0,1.0,1,1.0,1,1.0,1,0.10268613740878692,51
3407,1,11112,2512,8600,0,0,0,1.0,1,1.0,1,1.0,1,0.08192266131279456,52
3408,1,11113,2512,8601,0,0,0,1.0,1,1.0,1,1.0,1,0.1020431758014236,53
3409,1,11114,2513,8601,0,0,0,1.0,1,1.0,1,1.0,1,0.098390901177884,54
3410,3,11117,2515,8602,0,0,0,1.0,1,1.0,1,1.0,1,0.12359497502088711,54
3411,3,11120,2515,8605,0,0,0,1.0,1,1.0,1,1.0,1,0.1157336391664512,54
3412,4,11124,2516,8608,0,0,0,1.0,1,1.0,1,1.0,1,0.1503275034045246,55
3413,3,11127,2516,8611,0,0,0,1.0,1,1.0,1,1.0,1,0.15827511604962907,55
3414,3,11130,2516,8614,0,0,0,1.0,1,1.0,1,1.0,1,0.18211769384841872,55
3415,7,11137,2519,8618,0,0,0,1.0,1,1.0,1,1.0,1,0.20435440104009198,56
3416,5,11142,2519,8623,0,0,0,1.0,1,1.0,1,1.0,1,0.18688662317596516,55
3417,8,11150,2519,8631,0,0,0,1.0,1,1.0,1,1.0,1,0.18408753255204546,56
3418,6,11156,2520,8636,0,0,0,1.0,1,1.0,1,1.0,1,0.2324509249002702,55
3419,10,11166,2521,8645,0,0,0,1.0,1,1.0,1,1.0,1,0.2491287382694818,56
3420,5,11171,2521,8650,0,0,0,1.0,1,1.0,1,1.0,1,0.27499010783966843,55
3421,11,11182,2522,8660,0,0,0,1.0,1,1.0,1,1.0,1,0.18837274625023206,57
3422,2,11184,2523,8661,0,0,0,1.0,1,1.0,1,1.0,1,0.20017914228969497,56
3423,2,11186,2524,8662,0,0,0,1.0,1,1.0,1,1.0,1,0.18628797692491575,56
3424,1,11187,2524,8663,0,0,0,1.0,1,1.0,1,1.0,1,0.1904923358175658,56
3425,2,11189,2524,8665,0,0,0,1.0,1,1.0,1,1.0,1,0.19081091303476555,56
3426,4,11193,2525,8668,0,0,0,1.0,1,1.0,1,1.0,1,0.1971474503064386,55
3427,6,11199,2526,8673,0,0,0,1.0,1,1.0,1,1.0,1,0.1940733777998112,55
3428,6,11205,2528,8677,0,0,0,1.0,1,1.0,1,1.0,1,0.2099417645487995,55
3429,3,11208,2528,8680,0,0,0,1.0,1,1.0,1,1.0,1,0.21838200890016182,54
3430,2,11210,2529,8681,0,0,0,1.0,1,1.0,1,1.0,1,0.20657278204945442,56
3431,0,11210,2529,8681,0,0,0,1.0,1,1.0,1,1.0,1,0.20775420301210606,54
3432,1,11211,2529,8682,0,0,0,1.0,1,1.0,1,1.0,1,0.2251908198293542,56
3433,5,11216,2531,8685,0,0,0,1.0,1,1.0,1,1.0,1,0.24704954051761802,53
3434,4,11220,2531,8689,0,0,0,1.0,1,1.0,1,1.0,1,0.2328298126135111,51
3435,4,11224,2531,8693,0,0,0,1.0,1,1.0,1,1.0,1,0.21939656132389176,51
3436,9,11233,2532,8701,0,0,0,1.0,1,1.0,1,1.0,1,0.10527796006043028,51
3437,8,11241,2533,8708,0,0,0,1.0,1,1.0,1,1.0,1,0.13189071229079521,53
3438,4,11245,2533,8712,0,0,0,1.0,1,1.0,1,1.0,1,0.06472703486217897,52
3439,8,11253,2534,8719,0,0,0,1.0,1,1.0,1,1.0,1,0.15737627745626526,54
3440,6,11259,2535,8724,0,0,0,1.0,1,1.0,1,1.0,1,0.09545322437868443,52
3441,6,11265,2535,8730,0,0,0,1.0,1,1.0,1,1.0,1,0.10669174995005097,53
3442,7,11272,2536,8736,0,0,0,1.0,1,1.0,1,1.0,1,0.142593451549877,53
3443,8,11280,2537,8743,0,0,0,1.0,1,1.0,1,1.0,1,0.15877649746106473,53
3444,7,11287,2538,8749,0,0,0,1.0,1,1.0,1,1.0,1,0.17736434143135588,52
3445,7,11294,2538,8756,0,0,0,1.0,1,1.0,1,1.0,1,0.1838544120131586,53
3446,17,11311,2541,8770,0,0,0,1.0,1,1.0,1,1.0,1,0.2093481237517227,53
3447,12,11323,2542,8781,0,0,0,1.0,1,1.0,1,1.0,1,0.2354812625728555,53
3448,12,11335,2544,8791,0,0,0,1.0,1,1.0,1,1.0,1,0.30953682116051595,52
3449,11,11346,2547,8799,0,0,0,1.0,1,1.0,1,1.0,1,0.24200666194742504,52
3450,9,11355,2547,8808,0,0,0,1.0,1,1.0,1,1.0,1,0.25337298248489865,52
3451,9,11364,2549,8815,0,0,0,1.0,1,1.0,1,1.0,1,0.11367162342563543,54
3452,0,11364,2549,8815,0,0,0,1.0,1,1.0,1,1.0,1,0.11367162342563543,54
3453,1,11365,2550,8815,0,0,0,1.0,1,1.0,1,1.0,1,0.11044658282636269,54
3454,1,11366,2550,8816,0,0,0,1.0,1,1.0,1,1.0,1,0.10678274717483796,57
3455,1,11367,2550,8817,0,0,0,1.0,1,1.0,1,1.0,1,0.08516875308509457,57
3456,2,11369,2551,8818,0,0,0,1.0,1,1.0,1,1.0,1,0.1392852165082644,58
3457,2,11371,2551,8820,0,0,0,1.0,1,1.0,1,1.0,1,0.16018449166252785,57
3458,2,11373,2551,8822,0,0,0,1.0,1,1.0,1,1.0,1,0.14822899894831423,57
3459,2,11375,2551,8824,0,0,0,1.0,1,1.0,1,1.0,1,0.14822899894831423,57
3460,1,11376,2551,8825,0,0,0,1.0,1,1.0,1,1.0,1,0.1680945286938364,58
3461,5,11381,2551,8830,0,0,0,1.0,1,1.0,1,1.0,1,0.13739917534122734,59
3462,2,11383,2551,8832,0,0,0,1.0,1,1.0,1,1.0,1,0.13739917534122734,59
3463,1,11384,2551,8833,0,0,0,1.0,1,1.0,1,1.0,1,0.13924108117591616,59
3464,6,11390,2553,8837,0,0,0,1.0,1,1.0,1,1.0,1,0.13415949677979122,59
3465,6,11396,2554,8842,0,0,0,1.0,1,1.0,1,1.0,1,0.1383706642842079,57
3466,7,11403,2556,8847,0,0,0,1.0,1,1.0,1,1.0,1,0.08745243933703829,57
3467,3,11406,2557,8849,0,0,0,1.0,1,1.0,1,1.0,1,0.0807403634821979,57
3468,1,11407,2558,8849,0,0,0,1.0,1,1.0,1,1.0,1,0.1037564905131549,57
3469,4,11411,2562,8849,0,0,0,1.0,1,1.0,1,1.0,1,0.13239945238388587,53
3470,4,11415,2564,8851,0,0,0,1.0,1,1.0,1,1.0,1,0.09294112709892145,50
3471,1,11416,2565,8851,0,0,0,1.0,1,1.0,1,1.0,1,0.09194453973078791,49
3472,2,11418,2567,8851,0,0,0,1.0,1,1.0,1,1.0,1,0.10165460879849862,47
3473,3,11421,2570,8851,0,0,0,1.0,1,1.0,1,1.0,1,0.1438244608701705,45
3474,2,11423,2571,8852,0,0,0,1.0,1,1.0,1,1.0,1,0.12437786285303071,42
3475,2,11425,2573,8852,0,0,0,1.0,1,1.0,1,1.0,1,0.185085963003194,43
3476,2,11427,2575,8852,0,0,0,1.0,1,1.0,1,1.0,1,0.20861405005141245,41
3477,4,11431,2578,8853,0,0,0,1.0,1,1.0,1,1.0,1,0.15305835233511084,42
3478,2,11433,2580,8853,0,0,0,1.0,1,1.0,1,1.0,1,0.17739706245468265,40
3479,2,11435,2582,8853,0,0,0,1.0,1,1.0,1,1.0,1,0.20576488005765936,40
3480,0,11435,2582,8853,0,0,0,1.0,1,1.0,1,1.0,1,0.20032632819991536,40
3481,5,11440,2582,8858,0,0,0,1.0,1,1.0,1,1.0,1,0.13815780152934892,40
3482,1,11441,2582,8859,0,0,0,1.0,1,1.0,1,1.0,1,0.1260589479486527,40
3483,0,11441,2582,8859,0,0,0,1.0,1,1.0,1,1.0,1,0.125709003784237,39
3484,0,11441,2582,8859,0,0,0,1.0,1,1.0,1,1.0,1,0.125709003784237,39
3485,4,11445,2583,8862,0,0,0,1.0,1,1.0,1,1.0,1,0.11255917888870144,40
3486,2,11447,2583,8864,0,0,0,1.0,1,1.0,1,1.0,1,0.11334731873434081,41
3487,1,11448,2583,8865,0,0,0,1.0,1,1.0,1,1.0,1,0.16483645558273377,41
3488,2,11450,2584,8866,0,0,0,1.0,1,1.0,1,1.0,1,0.1454823720704307,42
3489,2,11452,2584,8868,0,0,0,1.0,1,1.0,1,1.0,1,0.12944027286739065,44
3490,1,11453,2584,8869,0,0,0,1.0,1,1.0,1,1.0,1,0.13708880742200705,44
3491,4,11457,2584,8873,0,0,0,1.0,1,1.0,1,1.0,1,0.13684138912890484,45
3492,3,11460,2585,8875,0,0,0,1.0,1,1.0,1,1.0,1,0.15992580511484264,45
3493,2,11462,2586,8876,0,0,0,1.0,1,1.0,1,1.0,1,0.1377410695411903,45
3494,4,11466,2586,8880,0,0,0,1.0,1,1.0,1,1.0,1,0.1377410695411903,45
3495,4,11470,2588,8882,0,0,0,1.0,1,1.0,1,1.0,1,0.16167994385339876,45
3496,5,11475,2588,8887,0,0,0,1.0,1,1.0,1,1.0,1,0.11249953587796377,46
3497,3,11478,2588,8890,0,0,0,1.0,1,1.0,1,1.0,1,0.10826645725963287,47
3498,5,11483,2589,8894,0,0,0,1.0,1,1.0,1,1.0,1,0.1250906882473369,48
3499,1,11484,2589,8895,0,0,0,1.0,1,1.0,1,1.0,1,0.13609303512687726,47
3500,2,11486,2589,8897,0,0,0,1.0,1,1.0,1,1.0,1,0.15303857136380092,50
3501,8,11494,2590,8904,0,0,0,1.0,1,1.0,1,1.0,1,0.17499761305586178,50
3502,5,11499,2590,8909,0,0,0,1.0,1,1.0,1,1.0,1,0.19790679641891581,50
3503,4,11503,2592,8911,0,0,0,1.0,1,1.0,1,1.0,1,0.23358463860858247,50
3504,9,11512,2595,8917,0,0,0,1.0,1,1.0,1,1.0,1,0.26830419296217706,47
3505,10,11522,2596,8926,0,0,0,1.0,1,1.0,1,1.0,1,0.2858326912295995,48
3506,12,11534,2598,8936,0,0,0,1.0,1,1.0,1,1.0,1,0.34017359966844724,49
3507,7,11541,2598,8943,0,0,0,1.0,1,1.0,1,1.0,1,0.3496471677198784,46
3508,13,11554,2599,8955,0,0,0,1.0,1,1.0,1,1.0,1,0.33166057374667435,47
3509,5,11559,2599,8960,0,0,0,1.0,1,1.0,1,1.0,1,0.3382555626026391,44
3510,2,11561,2599,8962,0,0,0,1.0,1,1.0,1,1.0,1,0.3277512905265788,45
3511,5,11566,2600,8966,0,0,0,1.0,1,1.0,1,1.0,1,0.23245722358934057,44
3512,0,11566,2600,8966,0,0,0,1.0,1,1.0,1,1.0,1,0.24037548376823598,42
3513,2,11568,2600,8968,0,0,0,1.0,1,1.0,1,1.0,1,0.20668027545963952,42
3514,0,11568,2600,8968,0,0,0,1.0,1,1.0,1,1.0,1,0.2218297376278495,42
3515,5,11573,2601,8972,0,0,0,1.0,1,1.0,1,1.0,1,0.1877681574840565,42
3516,3,11576,2601,8975,0,0,0,1.0,1,1.0,1,1.0,1,0.21631946115850156,41
3517,4,11580,2601,8979,0,0,0,1.0,1,1.0,1,1.0,1,0.17669423718031216,44
3518,1,11581,2601,8980,0,0,0,1.0,1,1.0,1,1.0,1,0.1928618091390469,43
3519,2,11583,2601,8982,0,0,0,1.0,1,1.0,1,1.0,1,0.18577787820375685,44
3520,5,11588,2601,8987,0,0,0,1.0,1,1.0,1,1.0,1,0.17397782513120857,45
3521,4,11592,2601,8991,0,0,0,1.0,1,1.0,1,1.0,1,0.16517880251389913,45
3522,5,11597,2601,8996,0,0,0,1.0,1,1.0,1,1.0,1,0.1691164031602411,46
3523,6,11603,2601,9002,0,0,0,1.0,1,1.0,1,1.0,1,0.16758404541067165,46
3524,6,11609,2601,9008,0,0,0,1.0,1,1.0,1,1.0,1,0.12831556654594767,47
3525,7,11616,2601,9015,0,0,0,1.0,1,1.0,1,1.0,1,0.16485277370532553,48
3526,4,11620,2601,9019,0,0,0,1.0,1,1.0,1,1.0,1,0.12415814406267475,49
3527,4,11624,2603,9021,0,0,0,1.0,1,1.0,1,1.0,1,0.17429835063364701,49
3528,3,11627,2603,9024,0,0,0,1.0,1,1.0,1,1.0,1,0.17040195153548338,51
3529,3,11630,2603,9027,0,0,0,1.0,1,1.0,1,1.0,1,0.1404263182141508,51
3530,3,11633,2603,9030,0,0,0,1.0,1,1.0,1,1.0,1,0.15683438332475175,52
3531,3,11636,2603,9033,0,0,0,1.0,1,1.0,1,1.0,1,0.11744441547187343,52
3532,0,11636,2603,9033,0,0,0,1.0,1,1.0,1,1.0,1,0.11744441547187343,52
3533,0,11636,2603,9033,0,0,0,1.0,1,1.0,1,1.0,1,0.11744441547187343,52
3534,0,11636,2603,9033,0,0,0,1.0,1,1.0,1,1.0,1,0.11744441547187343,52
3535,1,11637,2604,9033,0,0,0,1.0,1,1.0,1,1.0,1,0.11748262678263172,52
3536,5,11642,2605,9037,0,0,0,1.0,1,1.0,1,1.0,1,0.14200447843149644,54
3537,2,11644,2605,9039,0,0,0,1.0,1,1.0,1,1.0,1,0.12528506085427638,55
3538,0,11644,2605,9039,0,0,0,1.0,1,1.0,1,1.0,1,0.12528506085427638,55
3539,3,11647,2605,9042,0,0,0,1.0,1,1.0,1,1.0,1,0.1323618035707759,58
3540,5,11652,2606,9046,0,0,0,1.0,1,1.0,1,1.0,1,0.12254172543782156,59
3541,4,11656,2606,9050,0,0,0,1.0,1,1.0,1,1.0,1,0.08052392566703992,59
3542,1,11657,2607,9050,0,0,0,1.0,1,1.0,1,1.0,1,0.09260244238626174,61
3543,4,11661,2609,9052,0,0,0,1.0,1,1.0,1,1.0,1,0.09486263090252531,62
3544,2,11663,2611,9052,0,0,0,1.0,1,1.0,1,1.0,1,0.08689847430679254,59
3545,1,11664,2612,9052,0,0,0,1.0,1,1.0,1,1.0,1,0.11946728594118057,59
3546,5,11669,2614,9055,0,0,0,1.0,1,1.0,1,1.0,1,0.08342770380340486,57
3547,1,11670,2615,9055,0,0,0,1.0,1,1.0,1,1.0,1,0.0735988474490082,53
3548,2,11672,2616,9056,0,0,0,1.0,1,1.0,1,1.0,1,0.07394265362792594,53
3549,0,11672,2616,9056,0,0,0,1.0,1,1.0,1,1.0,1,0.07168415751467312,52
3550,2,11674,2617,9057,0,0,0,1.0,1,1.0,1,1.0,1,0.09220641193091009,51
3551,1,11675,2618,9057,0,0,0,1.0,1,1.0,1,1.0,1,0.114908875666153,51
3552,2,11677,2619,9058,0,0,0,1.0,1,1.0,1,1.0,1,0.12696350747698498,51
3553,0,11677,2619,9058,0,0,0,1.0,1,1.0,1,1.0,1,0.1486611499923303,49
3554,0,11677,2619,9058,0,0,0,1.0,1,1.0,1,1.0,1,0.1486611499923303,49
3555,0,11677,2619,9058,0,0,0,1.0,1,1.0,1,1.0,1,0.15212913710071102,51
3556,4,11681,2619,9062,0,0,0,1.0,1,1.0,1,1.0,1,0.08104699836801021,51
3557,1,11682,2620,9062,0,0,0,1.0,1,1.0,1,1.0,1,0.09744120110463106,52
3558,4,11686,2622,9064,0,0,0,1.0,1,1.0,1,1.0,1,0.0950023519775626,52
3559,2,11688,2623,9065,0,0,0,1.0,1,1.0,1,1.0,1,0.10595095346127176,52
3560,0,11688,2623,9065,0,0,0,1.0,1,1.0,1,1.0,1,0.0904396748219578,53
3561,2,11690,2623,9067,0,0,0,1.0,1,1.0,1,1.0,1,0.08652399766961483,54
3562,2,11692,2625,9067,0,0,0,1.0,1,1.0,1,1.0,1,0.11011761860493317,54
3563,3,11695,2626,9069,0,0,0,1.0,1,1.0,1,1.0,1,0.14761628312170297,55
3564,2,11697,2626,9071,0,0,0,1.0,1,1.0,1,1.0,1,0.12315039736928068,57
3565,1,11698,2626,9072,0,0,0,1.0,1,1.0,1,1.0,1,0.13905554087223818,56
3566,0,11698,2626,9072,0,0,0,1.0,1,1.0,1,1.0,1,0.14990194592155942,57
3567,0,11698,2626,9072,0,0,0,1.0,1,1.0,1,1.0,1,0.14990194592155942,57
3568,1,11699,2627,9072,0,0,0,1.0,1,1.0,1,1.0,1,0.1703115428567051,57
3569,4,11703,2627,9076,0,0,0,1.0,1,1.0,1,1.0,1,0.17993354275364384,57
3570,7,11710,2628,9082,0,0,0,1.0,1,1.0,1,1.0,1,0.1964879471715905,59
3571,4,11714,2628,9086,0,0,0,1.0,1,1.0,1,1.0,1,0.1523456320846979,60
3572,2,11716,2628,9088,0,0,0,1.0,1,1.0,1,1.0,1,0.13036677214967982,61
3573,1,11717,2628,9089,0,0,0,1.0,1,1.0,1,1.0,1,0.1332275558986401,62
3574,0,11717,2628,9089,0,0,0,1.0,1,1.0,1,1.0,1,0.13207234479820731,63
3575,4,11721,2630,9091,0,0,0,1.0,1,1.0,1,1.0,1,0.1556124995808413,63
3576,4,11725,2631,9094,0,0,0,1.0,1,1.0,1,1.0,1,0.1516346914151008,63
3577,1,11726,2631,9095,0,0,0,1.0,1,1.0,1,1.0,1,0.16228175530005193,64
3578,1,11727,2632,9095,0,0,0,1.0,1,1.0,1,1.0,1,0.16579873123609712,64
3579,0,11727,2632,9095,0,0,0,1.0,1,1.0,1,1.0,1,0.16579873123609712,64
3580,1,11728,2632,9096,0,0,0,1.0,1,1.0,1,1.0,1,0.16730951572346692,65
3581,2,11730,2632,9098,0,0,0,1.0,1,1.0,1,1.0,1,0.1651731797110108,68
3582,4,11734,2635,9099,0,0,0,1.0,1,1.0,1,1.0,1,0.1722260498291613,68
3583,4,11738,2637,9101,0,0,0,1.0,1,1.0,1,1.0,1,0.18320042097498468,65
3584,7,11745,2641,9104,0,0,0,1.0,1,1.0,1,1.0,1,0.2115079343165261,64
3585,3,11748,2642,9106,0,0,0,1.0,1,1.0,1,1.0,1,0.1669766124956509,64
3586,9,11757,2645,9112,0,0,0,1.0,1,1.0,1,1.0,1,0.10722590856473828,65
3587,0,11757,2645,9112,0,0,0,1.0,1,1.0,1,1.0,1,0.07401761034989372,64
3588,2,11759,2647,9112,0,0,0,1.0,1,1.0,1,1.0,1,0.07937970847548045,62
3589,3,11762,2650,9112,0,0,0,1.0,1,1.0,1,1.0,1,0.10764411488644647,63
3590,0,11762,2650,9112,0,0,0,1.0,1,1.0,1,1.0,1,0.10812673773198374,63
3591,4,11766,2653,9113,0,0,0,1.0,1,1.0,1,1.0,1,0.11878936340637149,62
3592,1,11767,2654,9113,0,0,0,1.0,1,1.0,1,1.0,1,0.11939025391709766,59
3593,2,11769,2655,9114,0,0,0,1.0,1,1.0,1,1.0,1,0.08965767239081168,58
3594,0,11769,2655,9114,0,0,0,1.0,1,1.0,1,1.0,1,0.1084450706454311,57
3595,1,11770,2656,9114,0,0,0,1.0,1,1.0,1,1.0,1,0.11393155497717192,59
3596,2,11772,2658,9114,0,0,0,1.0,1,1.0,1,1.0,1,0.08878449468875214,57
3597,3,11775,2660,9115,0,0,0,1.0,1,1.0,1,1.0,1,0.09836085418436814,57
3598,3,11778,2662,9116,0,0,0,1.0,1,1.0,1,1.0,1,0.09942928014264331,57
3599,3,11781,2665,9116,0,0,0,1.0,1,1.0,1,1.0,1,0.09483799429371365,58
3600,0,11781,2665,9116,0,0,0,1.0,1,1.0,1,1.0,1,0.0934625045745977,58
3601,5,11786,2667,9119,0,0,0,1.0,1,1.0,1,1.0,1,0.0545924340330065,58
3602,2,11788,2668,9120,0,0,0,1.0,1,1.0,1,1.0,1,0.07561205313235496,60
3603,2,11790,2670,9120,0,0,0,1.0,1,1.0,1,1.0,1,0.1086977812256962,60
3604,6,11796,2670,9126,0,0,0,1.0,1,1.0,1,1.0,1,0.0928353512346101,60
3605,0,11796,2670,9126,0,0,0,1.0,1,1.0,1,1.0,1,0.1015712806428085,61
3606,5,11801,2672,9129,0,0,0,1.0,1,1.0,1,1.0,1,0.12282067680554094,63
3607,7,11808,2673,9135,0,0,0,1.0,1,1.0,1,1.0,1,0.13476608297341305,63
3608,2,11810,2673,9137,0,0,0,1.0,1,1.0,1,1.0,1,0.11153929547977473,64
3609,4,11814,2675,9139,0,0,0,1.0,1,1.0,1,1.0,1,0.11830381997176788,66
3610,3,11817,2675,9142,0,0,0,1.0,1,1.0,1,1.0,1,0.11842078473835711,67
3611,3,11820,2676,9144,0,0,0,1.0,1,1.0,1,1.0,1,0.13507548102271205,67
3612,4,11824,2677,9147,0,0,0,1.0,1,1.0,1,1.0,1,0.1725152600328129,66
3613,3,11827,2678,9149,0,0,0,1.0,1,1.0,1,1.0,1,0.1735513386749162,66
3614,3,11830,2679,9151,0,0,0,1.0,1,1.0,1,1.0,1,0.1709088281968133,65
3615,1,11831,2679,9152,0,0,0,1.0,1,1.0,1,1.0,1,0.15847978213434238,65
3616,6,11837,2680,9157,0,0,0,1.0,1,1.0,1,1.0,1,0.12083038059521431,65
3617,1,11838,2680,9158,0,0,0,1.0,1,1.0,1,1.0,1,0.12837009653255532,66
3618,1,11839,2681,9158,0,0,0,1.0,1,1.0,1,1.0,1,0.10285668618400325,66
3619,1,11840,2682,9158,0,0,0,1.0,1,1.0,1,1.0,1,0.13520132118027509,65
3620,3,11843,2683,9160,0,0,0,1.0,1,1.0,1,1.0,1,0.1375743241007968,66
3621,5,11848,2684,9164,0,0,0,1.0,1,1.0,1,1.0,1,0.1217998555642811,65
3622,1,11849,2684,9165,0,0,0,1.0,1,1.0,1,1.0,1,0.12537338823257027,65
3623,2,11851,2685,9166,0,0,0,1.0,1,1.0,1,1.0,1,0.14642745410005226,62
3624,6,11857,2689,9168,0,0,0,1.0,1,1.0,1,1.0,1,0.1481047470695876,62
3625,8,11865,2691,9174,0,0,0,1.0,1,1.0,1,1.0,1,0.172095532119743,61
3626,4,11869,2692,9177,0,0,0,1.0,1,1.0,1,1.0,1,0.19653170082122798,58
3627,3,11872,2693,9179,0,0,0,1.0,1,1.0,1,1.0,1,0.1966465034952935,58
3628,2,11874,2694,9180,0,0,0,1.0,1,1.0,1,1.0,1,0.24234447178652835,57
3629,3,11877,2695,9182,0,0,0,1.0,1,1.0,1,1.0,1,0.25655384521154057,57
3630,5,11882,2696,9186,0,0,0,1.0,1,1.0,1,1.0,1,0.2878674006673048,56
3631,20,11902,2700,9202,0,0,0,1.0,1,1.0,1,1.0,1,0.12765175559291733,54
3632,7,11909,2700,9209,0,0,0,1.0,1,1.0,1,1.0,1,0.09951612532794293,52
3633,9,11918,2703,9215,0,0,0,1.0,1,1.0,1,1.0,1,0.13393509425993072,52
3634,7,11925,2705,9220,0,0,0,1.0,1,1.0,1,1.0,1,0.2227778559460315,49
3635,4,11929,2705,9224,0,0,0,1.0,1,1.0,1,1.0,1,0.2332206934574597,47
3636,5,11934,2706,9228,0,0,0,1.0,1,1.0,1,1.0,1,0.23127459815552856,48
3637,6,11940,2706,9234,0,0,0,1.0,1,1.0,1,1.0,1,0.2655062163325141,49
3638,5,11945,2706,9239,0,0,0,1.0,1,1.0,1,1.0,1,0.23994191850240407,50
3639,13,11958,2707,9251,0,0,0,1.0,1,1.0,1,1.0,1,0.2021470244582458,52
3640,7,11965,2709,9256,0,0,0,1.0,1,1.0,1,1.0,1,0.28259921183346987,52
3641,10,11975,2710,9265,0,0,0,1.0,1,1.0,1,1.0,1,0.2506602476879492,52
3642,14,11989,2710,9279,0,0,0,1.0,1,1.0,1,1.0,1,0.22419390789640758,52
3643,10,11999,2710,9289,0,0,0,1.0,1,1.0,1,1.0,1,0.2608007222591527,52
3644,11,12010,2710,9300,0,0,0,1.0,1,1.0,1,1.0,1,0.22684162140990893,52
3645,8,12018,2710,9308,0,0,0,1.0,1,1.0,1,1.0,1,0.2791030002769505,53
3646,10,12028,2710,9318,0,0,0,1.0,1,1.0,1,1.0,1,0.175682751186954,53
3647,6,12034,2711,9323,0,0,0,1.0,1,1.0,1,1.0,1,0.14598058681292553,55
3648,2,12036,2711,9325,0,0,0,1.0,1,1.0,1,1.0,1,0.1359639909531722,57
3649,4,12040,2711,9329,0,0,0,1.0,1,1.0,1,1.0,1,0.1359639909531722,57
3650,5,12045,2711,9334,0,0,0,1.0,1,1.0,1,1.0,1,0.13411575584294097,59
3651,7,12052,2711,9341,0,0,0,1.0,1,1.0,1,1.0,1,0.1480677001864339,59
3652,8,12060,2711,9349,0,0,0,1.0,1,1.0,1,1.0,1,0.1480677001864339,59
3653,8,12068,2711,9357,0,0,0,1.0,1,1.0,1,1.0,1,0.1480677001864339,59
3654,4,12072,2711,9361,0,0,0,1.0,1,1.0,1,1.0,1,0.14594919988769295,59
3655,8,12080,2711,9369,0,0,0,1.0,1,1.0,1,1.0,1,0.11163302558606097,62
3656,9,12089,2711,9378,0,0,0,1.0,1,1.0,1,1.0,1,0.13689098012215153,62
3657,5,12094,2711,9383,0,0,0,1.0,1,1.0,1,1.0,1,0.12870011177500812,63
3658,6,12100,2712,9388,0,0,0,1.0,1,1.0,1,1.0,1,0.1465308450883664,63
3659,8,12108,2712,9396,0,0,0,1.0,1,1.0,1,1.0,1,0.15320680225202424,62
3660,8,12116,2714,9402,0,0,0,1.0,1,1.0,1,1.0,1,0.18122011788507086,62
3661,7,12123,2715,9408,0,0,0,1.0,1,1.0,1,1.0,1,0.10112948762100867,61
3662,3,12126,2717,9409,0,0,0,1.0,1,1.0,1,1.0,1,0.11188459594973678,60
3663,4,12130,2718,9412,0,0,0,1.0,1,1.0,1,1.0,1,0.0936486734139558,61
3664,1,12131,2718,9413,0,0,0,1.0,1,1.0,1,1.0,1,0.10153608563136343,58
3665,1,12132,2718,9414,0,0,0,1.0,1,1.0,1,1.0,1,0.11391979307997563,58
3666,2,12134,2719,9415,0,0,0,1.0,1,1.0,1,1.0,1,0.10377480631584036,58
3667,1,12135,2720,9415,0,0,0,1.0,1,1.0,1,1.0,1,0.13562269344056113,58
3668,2,12137,2720,9417,0,0,0,1.0,1,1.0,1,1.0,1,0.1347292468603497,58
3669,2,12139,2721,9418,0,0,0,1.0,1,1.0,1,1.0,1,0.13271306156913357,57
3670,2,12141,2722,9419,0,0,0,1.0,1,1.0,1,1.0,1,0.1351072803669029,56
3671,2,12143,2723,9420,0,0,0,1.0,1,1.0,1,1.0,1,0.14228671143605842,57
3672,1,12144,2724,9420,0,0,0,1.0,1,1.0,1,1.0,1,0.16095433755369082,57
3673,0,12144,2724,9420,0,0,0,1.0,1,1.0,1,1.0,1,0.14583778435469016,58
3674,0,12144,2724,9420,0,0,0,1.0,1,1.0,1,1.0,1,0.15963012939971505,57
3675,0,12144,2724,9420,0,0,0,1.0,1,1.0,1,1.0,1,0.17391173886746078,58
3676,6,12150,2725,9425,0,0,0,1.0,1,1.0,1,1.0,1,0.15072370376714808,59
3677,4,12154,2726,9428,0,0,0,1.0,1,1.0,1,1.0,1,0.12506721783421182,60
3678,2,12156,2726,9430,0,0,0,1.0,1,1.0,1,1.0,1,0.14687876956126222,62
3679,0,12156,2726,9430,0,0,0,1.0,1,1.0,1,1.0,1,0.14687876956126222,62
3680,0,12156,2726,9430,0,0,0,1.0,1,1.0,1,1.0,1,0.1301184238903615,63
3681,5,12161,2726,9435,0,0,0,1.0,1,1.0,1,1.0,1,0.12253788716449436,64
3682,2,12163,2726,9437,0,0,0,1.0,1,1.0,1,1.0,1,0.12253788716449436,64
3683,2,12165,2726,9439,0,0,0,1.0,1,1.0,1,1.0,1,0.12253788716449436,64
3684,2,12167,2727,9440,0,0,0,1.0,1,1.0,1,1.0,1,0.14055046046393185,64
3685,1,12168,2727,9441,0,0,0,1.0,1,1.0,1,1.0,1,0.1411327970847421,64
3686,2,12170,2727,9443,0,0,0,1.0,1,1.0,1,1.0,1,0.1341108292431381,65
3687,2,12172,2727,9445,0,0,0,1.0,1,1.0,1,1.0,1,0.1341108292431381,65
3688,4,12176,2727,9449,0,0,0,1.0,1,1.0,1,1.0,1,0.15570531400196772,66
3689,2,12178,2727,9451,0,0,0,1.0,1,1.0,1,1.0,1,0.13404676697168608,66
3690,2,12180,2727,9453,0,0,0,1.0,1,1.0,1,1.0,1,0.13997395721935832,67
3691,3,12183,2727,9456,0,0,0,1.0,1,1.0,1,1.0,1,0.09669085571166805,68
3692,1,12184,2727,9457,0,0,0,1.0,1,1.0,1,1.0,1,0.08335495794699613,69
3693,3,12187,2727,9460,0,0,0,1.0,1,1.0,1,1.0,1,0.08225532076349579,69
3694,2,12189,2728,9461,0,0,0,1.0,1,1.0,1,1.0,1,0.09226405210930362,70
3695,0,12189,2728,9461,0,0,0,1.0,1,1.0,1,1.0,1,0.09226405210930362,70
3696,1,12190,2729,9461,0,0,0,1.0,1,1.0,1,1.0,1,0.07423852777695675,71
3697,1,12191,2730,9461,0,0,0,1.0,1,1.0,1,1.0,1,0.08759467623297791,70
3698,1,12192,2731,9461,0,0,0,1.0,1,1.0,1,1.0,1,0.10459970484324116,70
3699,1,12193,2732,9461,0,0,0,1.0,1,1.0,1,1.0,1,0.09539727813117885,70
3700,4,12197,2736,9461,0,0,0,1.0,1,1.0,1,1.0,1,0.13204714836958648,68
3701,1,12198,2737,9461,0,0,0,1.0,1,1.0,1,1.0,1,0.16173909775016626,69
3702,3,12201,2738,9463,0,0,0,1.0,1,1.0,1,1.0,1,0.1637692758173071,69
3703,2,12203,2738,9465,0,0,0,1.0,1,1.0,1,1.0,1,0.1605453171125212,70
3704,2,12205,2738,9467,0,0,0,1.0,1,1.0,1,1.0,1,0.16309190054300943,69
3705,2,12207,2739,9468,0,0,0,1.0,1,1.0,1,1.0,1,0.14314705148980317,69
3706,8,12215,2742,9473,0,0,0,1.0,1,1.0,1,1.0,1,0.14001602294688342,69
3707,0,12215,2742,9473,0,0,0,1.0,1,1.0,1,1.0,1,0.12113927155538111,67
3708,2,12217,2742,9475,0,0,0,1.0,1,1.0,1,1.0,1,0.10111586381566708,67
3709,1,12218,2742,9476,0,0,0,1.0,1,1.0,1,1.0,1,0.10006052236607649,67
3710,2,12220,2742,9478,0,0,0,1.0,1,1.0,1,1.0,1,0.10535831366461738,67
3711,1,12221,2742,9479,0,0,0,1.0,1,1.0,1,1.0,1,0.08591059236235164,68
3712,2,12223,2742,9481,0,0,0,1.0,1,1.0,1,1.0,1,0.08591059236235164,68
3713,3,12226,2744,9482,0,0,0,1.0,1,1.0,1,1.0,1,0.07646636453042123,68
3714,1,12227,2744,9483,0,0,0,1.0,1,1.0,1,1.0,1,0.08920189402417754,67
3715,0,12227,2744,9483,0,0,0,1.0,1,1.0,1,1.0,1,0.1003009822620584,68
3716,0,12227,2744,9483,0,0,0,1.0,1,1.0,1,1.0,1,0.10988004624563447,67
3717,2,12229,2744,9485,0,0,0,1.0,1,1.0,1,1.0,1,0.12531771442652082,68
3718,0,12229,2744,9485,0,0,0,1.0,1,1.0,1,1.0,1,0.14125256735280176,68
3719,1,12230,2745,9485,0,0,0,1.0,1,1.0,1,1.0,1,0.18257412296333742,68
3720,0,12230,2745,9485,0,0,0,1.0,1,1.0,1,1.0,1,0.18257412296333742,68
3721,9,12239,2748,9491,0,0,0,1.0,1,1.0,1,1.0,1,0.14931293107429547,70
3722,0,12239,2748,9491,0,0,0,1.0,1,1.0,1,1.0,1,0.15728192434810087,71
3723,5,12244,2749,9495,0,0,0,1.0,1,1.0,1,1.0,1,0.15442122059477825,71
3724,1,12245,2750,9495,0,0,0,1.0,1,1.0,1,1.0,1,0.1594303432755995,72
3725,2,12247,2750,9497,0,0,0,1.0,1,1.0,1,1.0,1,0.15309243148297047,72
3726,1,12248,2750,9498,0,0,0,1.0,1,1.0,1,1.0,1,0.16167895931083676,71
3727,4,12252,2751,9501,0,0,0,1.0,1,1.0,1,1.0,1,0.17218132631577562,71
3728,5,12257,2752,9505,0,0,0,1.0,1,1.0,1,1.0,1,0.17024952520823605,70
3729,8,12265,2752,9513,0,0,0,1.0,1,1.0,1,1.0,1,0.1457691463448995,70
3730,6,12271,2754,9517,0,0,0,1.0,1,1.0,1,1.0,1,0.1602944053415018,71
3731,3,12274,2754,9520,0,0,0,1.0,1,1.0,1,1.0,1,0.17135327531475786,71
3732,3,12277,2754,9523,0,0,0,1.0,1,1.0,1,1.0,1,0.16805598998553012,72
3733,6,12283,2755,9528,0,0,0,1.0,1,1.0,1,1.0,1,0.18012329956206322,73
3734,10,12293,2756,9537,0,0,0,1.0,1,1.0,1,1.0,1,0.18511254976631783,74
3735,7,12300,2757,9543,0,0,0,1.0,1,1.0,1,1.0,1,0.16492887354978633,72
3736,3,12303,2757,9546,0,0,0,1.0,1,1.0,1,1.0,1,0.11703491948695667,72
3737,3,12306,2757,9549,0,0,0,1.0,1,1.0,1,1.0,1,0.08501447965131954,73
3738,0,12306,2757,9549,0,0,0,1.0,1,1.0,1,1.0,1,0.10235076826597399,72
3739,0,12306,2757,9549,0,0,0,1.0,1,1.0,1,1.0,1,0.10580806225061486,73
3740,0,12306,2757,9549,0,0,0,1.0,1,1.0,1,1.0,1,0.11849620308943852,70
3741,1,12307,2757,9550,0,0,0,1.0,1,1.0,1,1.0,1,0.10301892447806468,70
3742,0,12307,2757,9550,0,0,0,1.0,1,1.0,1,1.0,1,0.10301892447806468,70
3743,0,12307,2757,9550,0,0,0,1.0,1,1.0,1,1.0,1,0.11060756727874213,69
3744,4,12311,2760,9551,0,0,0,1.0,1,1.0,1,1.0,1,0.13879268166128048,69
3745,3,12314,2761,9553,0,0,0,1.0,1,1.0,1,1.0,1,0.10147431659729556,68
3746,1,12315,2761,9554,0,0,0,1.0,1,1.0,1,1.0,1,0.12038170422916454,66
3747,2,12317,2762,9555,0,0,0,1.0,1,1.0,1,1.0,1,0.11139550693291801,66
3748,1,12318,2762,9556,0,0,0,1.0,1,1.0,1,1.0,1,0.09652680112912825,65
3749,3,12321,2763,9558,0,0,0,1.0,1,1.0,1,1.0,1,0.10346689326031606,64
3750,1,12322,2763,9559,0,0,0,1.0,1,1.0,1,1.0,1,0.11912151595667828,63
3751,4,12326,2763,9563,0,0,0,1.0,1,1.0,1,1.0,1,0.082533541484447,64
3752,2,12328,2765,9563,0,0,0,1.0,1,1.0,1,1.0,1,0.10376086375063213,64
3753,4,12332,2767,9565,0,0,0,1.0,1,1.0,1,1.0,1,0.12253492531623834,65
3754,5,12337,2770,9567,0,0,0,1.0,1,1.0,1,1.0,1,0.16044755123721988,65
3755,6,12343,2771,9572,0,0,0,1.0,1,1.0,1,1.0,1,0.17464667756693383,65
3756,4,12347,2771,9576,0,0,0,1.0,1,1.0,1,1.0,1,0.17334093287538307,65
3757,3,12350,2771,9579,0,0,0,1.0,1,1.0,1,1.0,1,0.14998183388425476,65
3758,1,12351,2771,9580,0,0,0,1.0,1,1.0,1,1.0,1,0.15654286236568532,64
3759,2,12353,2772,9581,0,0,0,1.0,1,1.0,1,1.0,1,0.15862355370736836,64
3760,1,12354,2772,9582,0,0,0,1.0,1,1.0,1,1.0,1,0.18395064835229982,63
3761,1,12355,2772,9583,0,0,0,1.0,1,1.0,1,1.0,1,0.1849949466011229,63
3762,2,12357,2772,9585,0,0,0,1.0,1,1.0,1,1.0,1,0.18577085186292705,65
3763,3,12360,2774,9586,0,0,0,1.0,1,1.0,1,1.0,1,0.19644797510621761,65
3764,4,12364,2774,9590,0,0,0,1.0,1,1.0,1,1.0,1,0.2018865802494811,66
3765,7,12371,2774,9597,0,0,0,1.0,1,1.0,1,1.0,1,0.19550943010839283,67
3766,11,12382,2776,9606,0,0,0,1.0,1,1.0,1,1.0,1,0.1462289667907829,67
3767,4,12386,2777,9609,0,0,0,1.0,1,1.0,1,1.0,1,0.12804458908180755,68
3768,6,12392,2779,9613,0,0,0,1.0,1,1.0,1,1.0,1,0.16323115263005755,67
3769,3,12395,2779,9616,0,0,0,1.0,1,1.0,1,1.0,1,0.1576355527249375,69
3770,3,12398,2779,9619,0,0,0,1.0,1,1.0,1,1.0,1,0.15051573685266917,69
3771,2,12400,2779,9621,0,0,0,1.0,1,1.0,1,1.0,1,0.16743250138578228,69
3772,5,12405,2779,9626,0,0,0,1.0,1,1.0,1,1.0,1,0.1805179178074534,70
3773,6,12411,2779,9632,0,0,0,1.0,1,1.0,1,1.0,1,0.16239142010907714,68
3774,3,12414,2780,9634,0,0,0,1.0,1,1.0,1,1.0,1,0.14105637563359105,68
3775,4,12418,2782,9636,0,0,0,1.0,1,1.0,1,1.0,1,0.17184196685687222,68
3776,2,12420,2783,9637,0,0,0,1.0,1,1.0,1,1.0,1,0.173932647784361,66
3777,3,12423,2784,9639,0,0,0,1.0,1,1.0,1,1.0,1,0.1552643736416362,65
3778,2,12425,2785,9640,0,0,0,1.0,1,1.0,1,1.0,1,0.141840781496099,65
3779,2,12427,2786,9641,0,0,0,1.0,1,1.0,1,1.0,1,0.1483349424735239,65
3780,3,12430,2788,9642,0,0,0,1.0,1,1.0,1,1.0,1,0.15849678437204967,64
3781,6,12436,2788,9648,0,0,0,1.0,1,1.0,1,1.0,1,0.10125366782032807,64
3782,6,12442,2790,9652,0,0,0,1.0,1,1.0,1,1.0,1,0.12512766315638754,67
3783,2,12444,2791,9653,0,0,0,1.0,1,1.0,1,1.0,1,0.13132706195660845,65
3784,7,12451,2793,9658,0,0,0,1.0,1,1.0,1,1.0,1,0.11304374964146001,65
3785,2,12453,2793,9660,0,0,0,1.0,1,1.0,1,1.0,1,0.12175347199277123,63
3786,3,12456,2793,9663,0,0,0,1.0,1,1.0,1,1.0,1,0.11466579524006783,66
3787,2,12458,2795,9663,0,0,0,1.0,1,1.0,1,1.0,1,0.15145723857772084,65
3788,3,12461,2796,9665,0,0,0,1.0,1,1.0,1,1.0,1,0.15147250550902,65
3789,2,12463,2798,9665,0,0,0,1.0,1,1.0,1,1.0,1,0.18512815527549614,65
3790,3,12466,2799,9667,0,0,0,1.0,1,1.0,1,1.0,1,0.17902699348176873,64
3791,2,12468,2801,9667,0,0,0,1.0,1,1.0,1,1.0,1,0.20574648911148127,64
3792,2,12470,2802,9668,0,0,0,1.0,1,1.0,1,1.0,1,0.2054969671772954,65
3793,5,12475,2803,9672,0,0,0,1.0,1,1.0,1,1.0,1,0.20772626642935904,68
3794,5,12480,2804,9676,0,0,0,1.0,1,1.0,1,1.0,1,0.22497161428655854,68
3795,3,12483,2804,9679,0,0,0,1.0,1,1.0,1,1.0,1,0.2107024065857425,69
3796,13,12496,2804,9692,0,0,0,1.0,1,1.0,1,1.0,1,0.14361135653310697,69
3797,5,12501,2805,9696,0,0,0,1.0,1,1.0,1,1.0,1,0.16567600591217221,70
3798,5,12506,2805,9701,0,0,0,1.0,1,1.0,1,1.0,1,0.13483544170184497,70
3799,2,12508,2806,9702,0,0,0,1.0,1,1.0,1,1.0,1,0.15635799432326739,69
3800,2,12510,2806,9704,0,0,0,1.0,1,1.0,1,1.0,1,0.132894869679652,69
3801,3,12513,2806,9707,0,0,0,1.0,1,1.0,1,1.0,1,0.13173978033256611,67
3802,3,12516,2806,9710,0,0,0,1.0,1,1.0,1,1.0,1,0.13434171033590614,67
3803,3,12519,2807,9712,0,0,0,1.0,1,1.0,1,1.0,1,0.1391689790957371,69
3804,3,12522,2808,9714,0,0,0,1.0,1,1.0,1,1.0,1,0.14272818381560312,70
3805,2,12524,2809,9715,0,0,0,1.0,1,1.0,1,1.0,1,0.15750324518188527,71
3806,2,12526,2810,9716,0,0,0,1.0,1,1.0,1,1.0,1,0.15553081155450077,71
3807,6,12532,2810,9722,0,0,0,1.0,1,1.0,1,1.0,1,0.15301824968191313,72
3808,5,12537,2810,9727,0,0,0,1.0,1,1.0,1,1.0,1,0.15556410518588146,72
3809,2,12539,2810,9729,0,0,0,1.0,1,1.0,1,1.0,1,0.16266659518830545,72
3810,6,12545,2812,9733,0,0,0,1.0,1,1.0,1,1.0,1,0.19149686562463977,72
3811,8,12553,2812,9741,0,0,0,1.0,1,1.0,1,1.0,1,0.09742506945299587,71
3812,0,12553,2812,9741,0,0,0,1.0,1,1.0,1,1.0,1,0.10269399150375404,72
3813,1,12554,2813,9741,0,0,0,1.0,1,1.0,1,1.0,1,0.13195283432652963,71
3814,1,12555,2814,9741,0,0,0,1.0,1,1.0,1,1.0,1,0.13638891106601436,72
3815,0,12555,2814,9741,0,0,0,1.0,1,1.0,1,1.0,1,0.14400916092616056,71
3816,1,12556,2815,9741,0,0,0,1.0,1,1.0,1,1.0,1,0.16233000131764122,69
3817,0,12556,2815,9741,0,0,0,1.0,1,1.0,1,1.0,1,0.16319154027341395,72
3818,4,12560,2817,9743,0,0,0,1.0,1,1.0,1,1.0,1,0.1416902196977475,72
3819,0,12560,2817,9743,0,0,0,1.0,1,1.0,1,1.0,1,0.1416902196977475,72
3820,5,12565,2818,9747,0,0,0,1.0,1,1.0,1,1.0,1,0.1635258781334195,72
3821,2,12567,2819,9748,0,0,0,1.0,1,1.0,1,1.0,1,0.1659821841933325,72
3822,0,12567,2819,9748,0,0,0,1.0,1,1.0,1,1.0,1,0.19210371736219647,69
3823,3,12570,2821,9749,0,0,0,1.0,1,1.0,1,1.0,1,0.18839549058968985,69
3824,3,12573,2822,9751,0,0,0,1.0,1,1.0,1,1.0,1,0.20489984044380746,65
3825,0,12573,2822,9751,0,0,0,1.0,1,1.0,1,1.0,1,0.200684591256925,64
3826,5,12578,2823,9755,0,0,0,1.0,1,1.0,1,1.0,1,0.15725238088868812,65
3827,2,12580,2823,9757,0,0,0,1.0,1,1.0,1,1.0,1,0.13180066749197908,64
3828,2,12582,2823,9759,0,0,0,1.0,1,1.0,1,1.0,1,0.12530987482339925,65
3829,7,12589,2826,9763,0,0,0,1.0,1,1.0,1,1.0,1,0.14998915583196873,65
3830,3,12592,2826,9766,0,0,0,1.0,1,1.0,1,1.0,1,0.12741453141616563,64
3831,10,12602,2830,9772,0,0,0,1.0,1,1.0,1,1.0,1,0.13446196714768938,63
3832,6,12608,2831,9777,0,0,0,1.0,1,1.0,1,1.0,1,0.154904573560462,64
3833,2,12610,2831,9779,0,0,0,1.0,1,1.0,1,1.0,1,0.13821556639424426,64
3834,5,12615,2832,9783,0,0,0,1.0,1,1.0,1,1.0,1,0.1745869143966472,63
3835,4,12619,2833,9786,0,0,0,1.0,1,1.0,1,1.0,1,0.1939269689872018,63
3836,5,12624,2834,9790,0,0,0,1.0,1,1.0,1,1.0,1,0.15859840902645442,63
3837,4,12628,2836,9792,0,0,0,1.0,1,1.0,1,1.0,1,0.19392784558630055,62
3838,3,12631,2837,9794,0,0,0,1.0,1,1.0,1,1.0,1,0.1908571620596517,62
3839,4,12635,2839,9796,0,0,0,1.0,1,1.0,1,1.0,1,0.23735018678298117,60
3840,2,12637,2840,9797,0,0,0,1.0,1,1.0,1,1.0,1,0.23912845572073313,62
3841,10,12647,2841,9806,0,0,0,1.0,1,1.0,1,1.0,1,0.17175747523007934,62
3842,1,12648,2841,9807,0,0,0,1.0,1,1.0,1,1.0,1,0.15005559928431303,63
3843,1,12649,2841,9808,0,0,0,1.0,1,1.0,1,1.0,1,0.15814599635331728,64
3844,2,12651,2841,9810,0,0,0,1.0,1,1.0,1,1.0,1,0.15988197469362697,65
3845,5,12656,2841,9815,0,0,0,1.0,1,1.0,1,1.0,1,0.13627090173805653,66
3846,4,12660,2841,9819,0,0,0,1.0,1,1.0,1,1.0,1,0.1311967294446391,67
3847,6,12666,2841,9825,0,0,0,1.0,1,1.0,1,1.0,1,0.10404422426066788,67
3848,4,12670,2843,9827,0,0,0,1.0,1,1.0,1,1.0,1,0.10662776890519449,67
3849,5,12675,2843,9832,0,0,0,1.0,1,1.0,1,1.0,1,0.1344342468401004,67
3850,6,12681,2844,9837,0,0,0,1.0,1,1.0,1,1.0,1,0.13594903409229647,68
3851,3,12684,2844,9840,0,0,0,1.0,1,1.0,1,1.0,1,0.11507984872243472,68
3852,4,12688,2845,9843,0,0,0,1.0,1,1.0,1,1.0,1,0.12175846614777415,70
3853,3,12691,2845,9846,0,0,0,1.0,1,1.0,1,1.0,1,0.14683108960029037,70
3854,2,12693,2845,9848,0,0,0,1.0,1,1.0,1,1.0,1,0.11688947001774205,70
3855,1,12694,2845,9849,0,0,0,1.0,1,1.0,1,1.0,1,0.1298042328969076,69
3856,6,12700,2845,9855,0,0,0,1.0,1,1.0,1,1.0,1,0.11820697045481428,70
3857,4,12704,2847,9857,0,0,0,1.0,1,1.0,1,1.0,1,0.16498275803562795,68
3858,7,12711,2848,9863,0,0,0,1.0,1,1.0,1,1.0,1,0.1106906582270633,67
3859,0,12711,2848,9863,0,0,0,1.0,1,1.0,1,1.0,1,0.10838971042006512,66
3860,2,12713,2849,9864,0,0,0,1.0,1,1.0,1,1.0,1,0.13539890678559297,66
3861,1,12714,2849,9865,0,0,0,1.0,1,1.0,1,1.0,1,0.1228448483468362,66
3862,3,12717,2851,9866,0,0,0,1.0,1,1.0,1,1.0,1,0.15729175283772806,66
3863,3,12720,2852,9868,0,0,0,1.0,1,1.0,1,1.0,1,0.13746404168047105,63
3864,1,12721,2853,9868,0,0,0,1.0,1,1.0,1,1.0,1,0.14546009414731031,63
3865,1,12722,2854,9868,0,0,0,1.0,1,1.0,1,1.0,1,0.153696037798811,61
3866,0,12722,2854,9868,0,0,0,1.0,1,1.0,1,1.0,1,0.15725251931464865,61
3867,0,12722,2854,9868,0,0,0,1.0,1,1.0,1,1.0,1,0.16366299300115447,60
3868,2,12724,2856,9868,0,0,0,1.0,1,1.0,1,1.0,1,0.17927085944622714,59
3869,2,12726,2857,9869,0,0,0,1.0,1,1.0,1,1.0,1,0.18133902878373537,61
3870,4,12730,2858,9872,0,0,0,1.0,1,1.0,1,1.0,1,0.2042386408031516,61
3871,20,12750,2859,9891,0,0,0,1.0,1,1.0,1,1.0,1,0.10746539663705042,64
3872,8,12758,2859,9899,0,0,0,1.0,1,1.0,1,1.0,1,0.10195240672607804,63
3873,6,12764,2859,9905,0,0,0,1.0,1,1.0,1,1.0,1,0.13771122976097447,62
3874,6,12770,2860,9910,0,0,0,1.0,1,1.0,1,1.0,1,0.10835176699301204,63
3875,5,12775,2861,9914,0,0,0,1.0,1,1.0,1,1.0,1,0.15729410174451325,61
3876,10,12785,2861,9924,0,0,0,1.0,1,1.0,1,1.0,1,0.17125762320634771,62
3877,10,12795,2861,9934,0,0,0,1.0,1,1.0,1,1.0,1,0.16093719554807195,63
3878,4,12799,2861,9938,0,0,0,1.0,1,1.0,1,1.0,1,0.15837899153432247,63
3879,9,12808,2862,9946,0,0,0,1.0,1,1.0,1,1.0,1,0.15860335102352296,63
3880,7,12815,2864,9951,0,0,0,1.0,1,1.0,1,1.0,1,0.1743359295957202,65
3881,11,12826,2865,9961,0,0,0,1.0,1,1.0,1,1.0,1,0.17959845229540128,65
3882,6,12832,2865,9967,0,0,0,1.0,1,1.0,1,1.0,1,0.21140344503693503,66
3883,8,12840,2865,9975,0,0,0,1.0,1,1.0,1,1.0,1,0.20269263514123784,66
3884,14,12854,2865,9989,0,0,0,1.0,1,1.0,1,1.0,1,0.19624841666429957,66
3885,11,12865,2865,10000,0,0,0,1.0,1,1.0,1,1.0,1,0.22608309819275527,66
3886,10,12875,2867,10008,0,0,0,1.0,1,1.0,1,1.0,1,0.1489791471193764,65
3887,7,12882,2867,10015,0,0,0,1.0,1,1.0,1,1.0,1,0.09559938663603365,65
3888,2,12884,2868,10016,0,0,0,1.0,1,1.0,1,1.0,1,0.08480656788879612,66
3889,1,12885,2869,10016,0,0,0,1.0,1,1.0,1,1.0,1,0.10866939101235083,64
3890,3,12888,2869,10019,0,0,0,1.0,1,1.0,1,1.0,1,0.10043988400988407,63
3891,5,12893,2870,10023,0,0,0,1.0,1,1.0,1,1.0,1,0.10732212471241989,66
3892,6,12899,2871,10028,0,0,0,1.0,1,1.0,1,1.0,1,0.11760350311928924,67
3893,2,12901,2871,10030,0,0,0,1.0,1,1.0,1,1.0,1,0.11732884923067805,66
3894,4,12905,2871,10034,0,0,0,1.0,1,1.0,1,1.0,1,0.13125986398449946,67
3895,5,12910,2871,10039,0,0,0,1.0,1,1.0,1,1.0,1,0.13675842794172025,66
3896,5,12915,2872,10043,0,0,0,1.0,1,1.0,1,1.0,1,0.13003093722593306,66
3897,2,12917,2872,10045,0,0,0,1.0,1,1.0,1,1.0,1,0.14143918860983604,65
3898,11,12928,2877,10051,0,0,0,1.0,1,1.0,1,1.0,1,0.18921916967419786,65
3899,9,12937,2879,10058,0,0,0,1.0,1,1.0,1,1.0,1,0.17383635382111284,64
3900,5,12942,2880,10062,0,0,0,1.0,1,1.0,1,1.0,1,0.18292945935689506,63
3901,6,12948,2883,10065,0,0,0,1.0,1,1.0,1,1.0,1,0.1398418575908163,63
3902,2,12950,2883,10067,0,0,0,1.0,1,1.0,1,1.0,1,0.12897945645362358,64
3903,2,12952,2883,10069,0,0,0,1.0,1,1.0,1,1.0,1,0.11645567956114378,64
3904,0,12952,2883,10069,0,0,0,1.0,1,1.0,1,1.0,1,0.12978586905187453,63
3905,0,12952,2883,10069,0,0,0,1.0,1,1.0,1,1.0,1,0.14159792848857333,63
3906,3,12955,2885,10070,0,0,0,1.0,1,1.0,1,1.0,1,0.10231321294576866,64
3907,2,12957,2887,10070,0,0,0,1.0,1,1.0,1,1.0,1,0.14552077341294367,64
3908,0,12957,2887,10070,0,0,0,1.0,1,1.0,1,1.0,1,0.15278435296856732,63
3909,3,12960,2888,10072,0,0,0,1.0,1,1.0,1,1.0,1,0.16160496072223743,62
3910,2,12962,2888,10074,0,0,0,1.0,1,1.0,1,1.0,1,0.17743875784773683,62
3911,3,12965,2889,10076,0,0,0,1.0,1,1.0,1,1.0,1,0.15652821536311218,64
3912,6,12971,2891,10080,0,0,0,1.0,1,1.0,1,1.0,1,0.16240925981165616,64
3913,4,12975,2891,10084,0,0,0,1.0,1,1.0,1,1.0,1,0.1751696251415706,65
3914,3,12978,2891,10087,0,0,0,1.0,1,1.0,1,1.0,1,0.15781800709525962,65
3915,2,12980,2891,10089,0,0,0,1.0,1,1.0,1,1.0,1,0.15166641372559314,66
3916,5,12985,2892,10093,0,0,0,1.0,1,1.0,1,1.0,1,0.13352025517632407,66
3917,1,12986,2892,10094,0,0,0,1.0,1,1.0,1,1.0,1,0.13154854519891623,66
3918,4,12990,2892,10098,0,0,0,1.0,1,1.0,1,1.0,1,0.11496506390208719,67
3919,2,12992,2893,10099,0,0,0,1.0,1,1.0,1,1.0,1,0.10566504337258548,68
3920,1,12993,2893,10100,0,0,0,1.0,1,1.0,1,1.0,1,0.10639812943173595,69
3921,3,12996,2893,10103,0,0,0,1.0,1,1.0,1,1.0,1,0.11315252804525418,68
3922,4,13000,2895,10105,0,0,0,1.0,1,1.0,1,1.0,1,0.15218529313710688,68
3923,1,13001,2895,10106,0,0,0,1.0,1,1.0,1,1.0,1,0.16986428194722047,69
3924,2,13003,2895,10108,0,0,0,1.0,1,1.0,1,1.0,1,0.17442865927949733,69
3925,3,13006,2896,10110,0,0,0,1.0,1,1.0,1,1.0,1,0.1535593333879586,67
3926,4,13010,2896,10114,0,0,0,1.0,1,1.0,1,1.0,1,0.19438771661010734,67
3927,5,13015,2896,10119,0,0,0,1.0,1,1.0,1,1.0,1,0.188866209810756,65
3928,5,13020,2897,10123,0,0,0,1.0,1,1.0,1,1.0,1,0.16544183804728463,65
3929,4,13024,2898,10126,0,0,0,1.0,1,1.0,1,1.0,1,0.1517767696391064,64
3930,3,13027,2900,10127,0,0,0,1.0,1,1.0,1,1.0,1,0.16976190239571395,64
3931,4,13031,2901,10130,0,0,0,1.0,1,1.0,1,1.0,1,0.12355794604940734,62
3932,0,13031,2901,10130,0,0,0,1.0,1,1.0,1,1.0,1,0.12355794604940734,62
3933,1,13032,2902,10130,0,0,0,1.0,1,1.0,1,1.0,1,0.12730603810971194,62
3934,1,13033,2903,10130,0,0,0,1.0,1,1.0,1,1.0,1,0.12967186812861314,61
3935,2,13035,2904,10131,0,0,0,1.0,1,1.0,1,1.0,1,0.14315065915759642,64
3936,2,13037,2905,10132,0,0,0,1.0,1,1.0,1,1.0,1,0.17351934256780147,65
3937,5,13042,2906,10136,0,0,0,1.0,1,1.0,1,1.0,1,0.18689321870705772,66
3938,6,13048,2908,10140,0,0,0,1.0,1,1.0,1,1.0,1,0.20209697704434287,66
3939,2,13050,2908,10142,0,0,0,1.0,1,1.0,1,1.0,1,0.20083738729722012,67
3940,5,13055,2909,10146,0,0,0,1.0,1,1.0,1,1.0,1,0.19566585731846156,69
3941,5,13060,2909,10151,0,0,0,1.0,1,1.0,1,1.0,1,0.1613260935275308,69
3942,5,13065,2911,10154,0,0,0,1.0,1,1.0,1,1.0,1,0.16163273048302304,69
3943,3,13068,2912,10156,0,0,0,1.0,1,1.0,1,1.0,1,0.17627618477287121,68
3944,5,13073,2913,10160,0,0,0,1.0,1,1.0,1,1.0,1,0.1587765624509084,68
3945,5,13078,2916,10162,0,0,0,1.0,1,1.0,1,1.0,1,0.2079638960463352,67
3946,10,13088,2917,10171,0,0,0,1.0,1,1.0,1,1.0,1,0.12864008456021017,67
3947,2,13090,2917,10173,0,0,0,1.0,1,1.0,1,1.0,1,0.12695047311771065,66
3948,1,13091,2918,10173,0,0,0,1.0,1,1.0,1,1.0,1,0.13150965342229337,67
3949,3,13094,2921,10173,0,0,0,1.0,1,1.0,1,1.0,1,0.1788614980340283,66
3950,1,13095,2921,10174,0,0,0,1.0,1,1.0,1,1.0,1,0.18627778509231518,65
3951,1,13096,2921,10175,0,0,0,1.0,1,1.0,1,1.0,1,0.1655368773851594,65
3952,1,13097,2922,10175,0,0,0,1.0,1,1.0,1,1.0,1,0.1661303780601391,65
3953,1,13098,2922,10176,0,0,0,1.0,1,1.0,1,1.0,1,0.1768609484085992,65
3954,1,13099,2922,10177,0,0,0,1.0,1,1.0,1,1.0,1,0.17468209297732085,64
3955,2,13101,2923,10178,0,0,0,1.0,1,1.0,1,1.0,1,0.2045531298855749,64
3956,4,13105,2925,10180,0,0,0,1.0,1,1.0,1,1.0,1,0.2127089479755818,63
3957,1,13106,2925,10181,0,0,0,1.0,1,1.0,1,1.0,1,0.1844203326693949,63
3958,1,13107,2925,10182,0,0,0,1.0,1,1.0,1,1.0,1,0.1905296616435573,63
3959,1,13108,2926,10182,0,0,0,1.0,1,1.0,1,1.0,1,0.1957079086443167,62
3960,0,13108,2926,10182,0,0,0,1.0,1,1.0,1,1.0,1,0.1957079086443167,62
3961,7,13115,2928,10187,0,0,0,1.0,1,1.0,1,1.0,1,0.14552805302489358,64
3962,5,13120,2930,10190,0,0,0,1.0,1,1.0,1,1.0,1,0.13343352235193182,64
3963,4,13124,2931,10193,0,0,0,1.0,1,1.0,1,1.0,1,0.14145221825998547,62
3964,8,13132,2933,10199,0,0,0,1.0,1,1.0,1,1.0,1,0.1331631498912685,63
3965,5,13137,2933,10204,0,0,0,1.0,1,1.0,1,1.0,1,0.11671725581734804,63
3966,5,13142,2934,10208,0,0,0,1.0,1,1.0,1,1.0,1,0.12101766204776346,62
3967,6,13148,2934,10214,0,0,0,1.0,1,1.0,1,1.0,1,0.1413628253663697,64
3968,4,13152,2935,10217,0,0,0,1.0,1,1.0,1,1.0,1,0.1538429583148377,63
3969,7,13159,2936,10223,0,0,0,1.0,1,1.0,1,1.0,1,0.14835662139537123,63
3970,4,13163,2936,10227,0,0,0,1.0,1,1.0,1,1.0,1,0.17431166458209013,65
3971,3,13166,2936,10230,0,0,0,1.0,1,1.0,1,1.0,1,0.15497060041677338,65
3972,6,13172,2937,10235,0,0,0,1.0,1,1.0,1,1.0,1,0.21643483999481397,66
3973,6,13178,2937,10241,0,0,0,1.0,1,1.0,1,1.0,1,0.19101710452492401,66
3974,17,13195,2939,10256,0,0,0,1.0,1,1.0,1,1.0,1,0.1842659334316258,66
3975,12,13207,2941,10266,0,0,0,1.0,1,1.0,1,1.0,1,0.1921554896308471,66
3976,9,13216,2941,10275,0,0,0,1.0,1,1.0,1,1.0,1,0.15004442893526806,66
3977,3,13219,2942,10277,0,0,0,1.0,1,1.0,1,1.0,1,0.15253477428084858,64
3978,4,13223,2944,10279,0,0,0,1.0,1,1.0,1,1.0,1,0.19061395786832616,63
3979,4,13227,2944,10283,0,0,0,1.0,1,1.0,1,1.0,1,0.19614716030129759,63
3980,4,13231,2944,10287,0,0,0,1.0,1,1.0,1,1.0,1,0.1830563181714265,63
3981,4,13235,2944,10291,0,0,0,1.0,1,1.0,1,1.0,1,0.16942946065872688,64
3982,2,13237,2944,10293,0,0,0,1.0,1,1.0,1,1.0,1,0.1655070016600463,65
3983,3,13240,2945,10295,0,0,0,1.0,1,1.0,1,1.0,1,0.1531489463483024,64
3984,2,13242,2946,10296,0,0,0,1.0,1,1.0,1,1.0,1,0.15277397938700735,65
3985,5,13247,2949,10298,0,0,0,1.0,1,1.0,1,1.0,1,0.18508526216751095,64
3986,3,13250,2949,10301,0,0,0,1.0,1,1.0,1,1.0,1,0.17490019993570483,63
3987,3,13253,2950,10303,0,0,0,1.0,1,1.0,1,1.0,1,0.21022181609353777,63
3988,7,13260,2952,10308,0,0,0,1.0,1,1.0,1,1.0,1,0.21754384028622867,63
3989,7,13267,2954,10313,0,0,0,1.0,1,1.0,1,1.0,1,0.24392443533434371,63
3990,12,13279,2957,10322,0,0,0,1.0,1,1.0,1,1.0,1,0.3056061454853123,62
3991,12,13291,2957,10334,0,0,0,1.0,1,1.0,1,1.0,1,0.1511659636093657,62
3992,7,13298,2957,10341,0,0,0,1.0,1,1.0,1,1.0,1,0.13543307373344293,65
3993,4,13302,2957,10345,0,0,0,1.0,1,1.0,1,1.0,1,0.13619943280506108,65
3994,7,13309,2957,10352,0,0,0,1.0,1,1.0,1,1.0,1,0.1294496438363023,64
3995,6,13315,2957,10358,0,0,0,1.0,1,1.0,1,1.0,1,0.1294496438363023,64
3996,8,13323,2957,10366,0,0,0,1.0,1,1.0,1,1.0,1,0.10690020064486068,67
3997,10,13333,2957,10376,0,0,0,1.0,1,1.0,1,1.0,1,0.08976190636625954,69
3998,10,13343,2958,10385,0,0,0,1.0,1,1.0,1,1.0,1,0.1051489669547807,69
3999,6,13349,2958,10391,0,0,0,1.0,1,1.0,1,1.0,1,0.12106423320798643,69
4000,11,13360,2958,10402,0,0,0,1.0,1,1.0,1,1.0,1,0.10197676141500052,69
4001,4,13364,2958,10406,0,0,0,1.0,1,1.0,1,1.0,1,0.09817269170992295,68
4002,7,13371,2958,10413,0,0,0,1.0,1,1.0,1,1.0,1,0.1286060275550679,68
4003,10,13381,2960,10421,0,0,0,1.0,1,1.0,1,1.0,1,0.16869297061674227,68
4004,7,13388,2961,10427,0,0,0,1.0,1,1.0,1,1.0,1,0.16304843989537263,67
4005,10,13398,2961,10437,0,0,0,1.0,1,1.0,1,1.0,1,0.1624982201177437,67
4006,10,13408,2963,10445,0,0,0,1.0,1,1.0,1,1.0,1,0.14154295143441473,67
4007,4,13412,2963,10449,0,0,0,1.0,1,1.0,1,1.0,1,0.13175066855257953,67
4008,4,13416,2964,10452,0,0,0,1.0,1,1.0,1,1.0,1,0.13918013589428127,67
4009,3,13419,2964,10455,0,0,0,1.0,1,1.0,1,1.0,1,0.13704213686322744,67
4010,8,13427,2966,10461,0,0,0,1.0,1,1.0,1,1.0,1,0.1747495007752077,66
4011,7,13434,2967,10467,0,0,0,1.0,1,1.0,1,1.0,1,0.1545618824344856,66
4012,4,13438,2967,10471,0,0,0,1.0,1,1.0,1,1.0,1,0.16705602946213355,66
4013,6,13444,2967,10477,0,0,0,1.0,1,1.0,1,1.0,1,0.1728193236593232,66
4014,5,13449,2968,10481,0,0,0,1.0,1,1.0,1,1.0,1,0.18655981916824582,66
4015,3,13452,2968,10484,0,0,0,1.0,1,1.0,1,1.0,1,0.2001839496796164,64
4016,6,13458,2970,10488,0,0,0,1.0,1,1.0,1,1.0,1,0.2488573507254945,64
4017,3,13461,2970,10491,0,0,0,1.0,1,1.0,1,1.0,1,0.25374726088633226,66
4018,9,13470,2970,10500,0,0,0,1.0,1,1.0,1,1.0,1,0.2652977651956093,67
4019,13,13483,2972,10511,0,0,0,1.0,1,1.0,1,1.0,1,0.3046173319744098,67
4020,11,13494,2972,10522,0,0,0,1.0,1,1.0,1,1.0,1,0.30039765441850935,66
4021,14,13508,2974,10534,0,0,0,1.0,1,1.0,1,1.0,1,0.21289522816041087,66
4022,4,13512,2975,10537,0,0,0,1.0,1,1.0,1,1.0,1,0.19794619652455256,66
4023,2,13514,2977,10537,0,0,0,1.0,1,1.0,1,1.0,1,0.18709466209180609,66
4024,2,13516,2978,10538,0,0,0,1.0,1,1.0,1,1.0,1,0.19333461970976387,66
4025,5,13521,2978,10543,0,0,0,1.0,1,1.0,1,1.0,1,0.1526413440246786,66
4026,4,13525,2978,10547,0,0,0,1.0,1,1.0,1,1.0,1,0.15138420829213378,66
4027,7,13532,2979,10553,0,0,0,1.0,1,1.0,1,1.0,1,0.16206299623372797,64
4028,6,13538,2980,10558,0,0,0,1.0,1,1.0,1,1.0,1,0.14281953970534683,63
4029,6,13544,2981,10563,0,0,0,1.0,1,1.0,1,1.0,1,0.13471003723168254,62
4030,5,13549,2982,10567,0,0,0,1.0,1,1.0,1,1.0,1,0.16487600555512968,63
4031,4,13553,2983,10570,0,0,0,1.0,1,1.0,1,1.0,1,0.15971208608674922,62
4032,7,13560,2986,10574,0,0,0,1.0,1,1.0,1,1.0,1,0.19852139122312773,62
4033,8,13568,2988,10580,0,0,0,1.0,1,1.0,1,1.0,1,0.19275967535871968,61
4034,6,13574,2988,10586,0,0,0,1.0,1,1.0,1,1.0,1,0.22423360232662923,60
4035,5,13579,2988,10591,0,0,0,1.0,1,1.0,1,1.0,1,0.23841684690229673,59
4036,8,13587,2989,10598,0,0,0,1.0,1,1.0,1,1.0,1,0.18443209451523954,58
4037,7,13594,2990,10604,0,0,0,1.0,1,1.0,1,1.0,1,0.14230258786674047,59
4038,5,13599,2990,10609,0,0,0,1.0,1,1.0,1,1.0,1,0.11286674495717992,58
4039,6,13605,2992,10613,0,0,0,1.0,1,1.0,1,1.0,1,0.14677896014411745,56
4040,6,13611,2992,10619,0,0,0,1.0,1,1.0,1,1.0,1,0.1583515003535768,55
4041,4,13615,2993,10622,0,0,0,1.0,1,1.0,1,1.0,1,0.24315809815316664,54
4042,10,13625,2995,10630,0,0,0,1.0,1,1.0,1,1.0,1,0.26220784465078584,56
4043,9,13634,2996,10638,0,0,0,1.0,1,1.0,1,1.0,1,0.2855924217045612,56
4044,6,13640,2996,10644,0,0,0,1.0,1,1.0,1,1.0,1,0.27046416660209066,56
4045,11,13651,2997,10654,0,0,0,1.0,1,1.0,1,1.0,1,0.28229302617432045,57
4046,7,13658,2997,10661,0,0,0,1.0,1,1.0,1,1.0,1,0.3070069928597363,59
4047,19,13677,2999,10678,0,0,0,1.0,1,1.0,1,1.0,1,0.2919820195050435,59
4048,7,13684,2999,10685,0,0,0,1.0,1,1.0,1,1.0,1,0.31899110441075273,59
4049,7,13691,2999,10692,0,0,0,1.0,1,1.0,1,1.0,1,0.28039994263975293,60
4050,12,13703,2999,10704,0,0,0,1.0,1,1.0,1,1.0,1,0.2858680657244725,60
4051,7,13710,2999,10711,0,0,0,1.0,1,1.0,1,1.0,1,0.21911374174599518,60
4052,1,13711,2999,10712,0,0,0,1.0,1,1.0,1,1.0,1,0.21557700498768323,60
4053,0,13711,2999,10712,0,0,0,1.0,1,1.0,1,1.0,1,0.21557700498768323,60
4054,3,13714,3000,10714,0,0,0,1.0,1,1.0,1,1.0,1,0.21140233119699148,61
4055,0,13714,3000,10714,0,0,0,1.0,1,1.0,1,1.0,1,0.21140233119699148,61
4056,2,13716,3000,10716,0,0,0,1.0,1,1.0,1,1.0,1,0.2046454377590063,62
4057,2,13718,3000,10718,0,0,0,1.0,1,1.0,1,1.0,1,0.20792881042301029,63
4058,1,13719,3001,10718,0,0,0,1.0,1,1.0,1,1.0,1,0.21379855105196305,64
4059,0,13719,3001,10718,0,0,0,1.0,1,1.0,1,1.0,1,0.2304047375007609,63
4060,0,13719,3001,10718,0,0,0,1.0,1,1.0,1,1.0,1,0.2304047375007609,63
4061,0,13719,3001,10718,0,0,0,1.0,1,1.0,1,1.0,1,0.23422965680691601,63
4062,3,13722,3003,10719,0,0,0,1.0,1,1.0,1,1.0,1,0.2291838082439924,65
4063,4,13726,3003,10723,0,0,0,1.0,1,1.0,1,1.0,1,0.1824981450219741,64
4064,6,13732,3005,10727,0,0,0,1.0,1,1.0,1,1.0,1,0.1784803263473611,65
4065,4,13736,3006,10730,0,0,0,1.0,1,1.0,1,1.0,1,0.15559246762446927,64
4066,4,13740,3008,10732,0,0,0,1.0,1,1.0,1,1.0,1,0.14464846350262828,64
4067,2,13742,3009,10733,0,0,0,1.0,1,1.0,1,1.0,1,0.162363778451322,63
4068,1,13743,3009,10734,0,0,0,1.0,1,1.0,1,1.0,1,0.17234403791470754,64
4069,8,13751,3013,10738,0,0,0,1.0,1,1.0,1,1.0,1,0.2128919361069627,62
4070,5,13756,3015,10741,0,0,0,1.0,1,1.0,1,1.0,1,0.22058002107567548,61
4071,8,13764,3018,10746,0,0,0,1.0,1,1.0,1,1.0,1,0.23924746222749615,61
4072,11,13775,3023,10752,0,0,0,1.0,1,1.0,1,1.0,1,0.24087017010010786,60
4073,6,13781,3025,10756,0,0,0,1.0,1,1.0,1,1.0,1,0.22506459773083382,60
4074,5,13786,3028,10758,0,0,0,1.0,1,1.0,1,1.0,1,0.21608856736248014,60
4075,3,13789,3029,10760,0,0,0,1.0,1,1.0,1,1.0,1,0.2159152361134075,59
4076,2,13791,3029,10762,0,0,0,1.0,1,1.0,1,1.0,1,0.20339489620366663,60
4077,2,13793,3029,10764,0,0,0,1.0,1,1.0,1,1.0,1,0.20984686660566337,61
4078,2,13795,3029,10766,0,0,0,1.0,1,1.0,1,1.0,1,0.21980395455429538,60
4079,2,13797,3030,10767,0,0,0,1.0,1,1.0,1,1.0,1,0.2523068397518213,58
4080,1,13798,3030,10768,0,0,0,1.0,1,1.0,1,1.0,1,0.27714935241480615,56
4081,10,13808,3031,10777,0,0,0,1.0,1,1.0,1,1.0,1,0.16313588640149754,56
4082,2,13810,3031,10779,0,0,0,1.0,1,1.0,1,1.0,1,0.1670403763013964,55
4083,1,13811,3032,10779,0,0,0,1.0,1,1.0,1,1.0,1,0.18297481907469554,55
4084,3,13814,3033,10781,0,0,0,1.0,1,1.0,1,1.0,1,0.19338329117666148,55
4085,7,13821,3035,10786,0,0,0,1.0,1,1.0,1,1.0,1,0.16719570895177496,56
4086,4,13825,3036,10789,0,0,0,1.0,1,1.0,1,1.0,1,0.14092735727011688,57
4087,4,13829,3037,10792,0,0,0,1.0,1,1.0,1,1.0,1,0.16882772620663283,57
4088,3,13832,3037,10795,0,0,0,1.0,1,1.0,1,1.0,1,0.17500266484815208,57
4089,6,13838,3037,10801,0,0,0,1.0,1,1.0,1,1.0,1,0.19887352725180418,56
4090,6,13844,3038,10806,0,0,0,1.0,1,1.0,1,1.0,1,0.19460823932510024,56
4091,4,13848,3038,10810,0,0,0,1.0,1,1.0,1,1.0,1,0.24881738285792515,56
4092,8,13856,3038,10818,0,0,0,1.0,1,1.0,1,1.0,1,0.2172733712423813,57
4093,8,13864,3039,10825,0,0,0,1.0,1,1.0,1,1.0,1,0.21712366215855433,58
4094,10,13874,3039,10835,0,0,0,1.0,1,1.0,1,1.0,1,0.18532753133291638,57
4095,4,13878,3039,10839,0,0,0,1.0,1,1.0,1,1.0,1,0.18806378060996687,57
4096,8,13886,3040,10846,0,0,0,1.0,1,1.0,1,1.0,1,0.12487462427068345,59
4097,3,13889,3040,10849,0,0,0,1.0,1,1.0,1,1.0,1,0.11799088796217073,59
4098,2,13891,3041,10850,0,0,0,1.0,1,1.0,1,1.0,1,0.10619015862676309,59
4099,2,13893,3043,10850,0,0,0,1.0,1,1.0,1,1.0,1,0.16105358943869044,60
4100,2,13895,3043,10852,0,0,0,1.0,1,1.0,1,1.0,1,0.14142345390987102,60
4101,3,13898,3043,10855,0,0,0,1.0,1,1.0,1,1.0,1,0.14132322736182823,60
4102,7,13905,3048,10857,0,0,0,1.0,1,1.0,1,1.0,1,0.13527430488428707,60
4103,3,13908,3049,10859,0,0,0,1.0,1,1.0,1,1.0,1,0.18186289429082095,58
4104,3,13911,3050,10861,0,0,0,1.0,1,1.0,1,1.0,1,0.1336121874729934,60
4105,5,13916,3052,10864,0,0,0,1.0,1,1.0,1,1.0,1,0.13298542433041347,59
4106,3,13919,3053,10866,0,0,0,1.0,1,1.0,1,1.0,1,0.15774163356619986,61
4107,2,13921,3054,10867,0,0,0,1.0,1,1.0,1,1.0,1,0.18111338139903255,59
4108,4,13925,3056,10869,0,0,0,1.0,1,1.0,1,1.0,1,0.18893265343357288,60
4109,5,13930,3056,10874,0,0,0,1.0,1,1.0,1,1.0,1,0.1698561458128577,59
4110,7,13937,3059,10878,0,0,0,1.0,1,1.0,1,1.0,1,0.15057118578533132,60
4111,6,13943,3059,10884,0,0,0,1.0,1,1.0,1,1.0,1,0.12251120667383254,61
4112,1,13944,3059,10885,0,0,0,1.0,1,1.0,1,1.0,1,0.12307522943741715,60
4113,1,13945,3060,10885,0,0,0,1.0,1,1.0,1,1.0,1,0.12007398776594627,61
4114,6,13951,3061,10890,0,0,0,1.0,1,1.0,1,1.0,1,0.154869844848017,62
4115,4,13955,3062,10893,0,0,0,1.0,1,1.0,1,1.0,1,0.13711328138658024,60
4116,2,13957,3062,10895,0,0,0,1.0,1,1.0,1,1.0,1,0.12985331811676878,59
4117,3,13960,3064,10896,0,0,0,1.0,1,1.0,1,1.0,1,0.15331411065906808,56
4118,1,13961,3064,10897,0,0,0,1.0,1,1.0,1,1.0,1,0.1268942918743479,55
4119,3,13964,3064,10900,0,0,0,1.0,1,1.0,1,1.0,1,0.14807507232383832,53
4120,4,13968,3065,10903,0,0,0,1.0,1,1.0,1,1.0,1,0.20570963008867574,52
4121,2,13970,3066,10904,0,0,0,1.0,1,1.0,1,1.0,1,0.21434413687821788,53
4122,1,13971,3066,10905,0,0,0,1.0,1,1.0,1,1.0,1,0.22508656947797454,52
4123,2,13973,3067,10906,0,0,0,1.0,1,1.0,1,1.0,1,0.2059005403543677,51
4124,3,13976,3069,10907,0,0,0,1.0,1,1.0,1,1.0,1,0.2199257814640106,51
4125,3,13979,3069,10910,0,0,0,1.0,1,1.0,1,1.0,1,0.2484286511074837,50
4126,9,13988,3071,10917,0,0,0,1.0,1,1.0,1,1.0,1,0.1433143417266844,50
4127,3,13991,3072,10919,0,0,0,1.0,1,1.0,1,1.0,1,0.15060647624621912,49
4128,3,13994,3073,10921,0,0,0,1.0,1,1.0,1,1.0,1,0.17458502899497189,49
4129,3,13997,3073,10924,0,0,0,1.0,1,1.0,1,1.0,1,0.18693153651758643,49
4130,3,14000,3073,10927,0,0,0,1.0,1,1.0,1,1.0,1,0.1336518540450009,50
4131,4,14004,3073,10931,0,0,0,1.0,1,1.0,1,1.0,1,0.15007714285730717,50
4132,3,14007,3073,10934,0,0,0,1.0,1,1.0,1,1.0,1,0.14014957297447395,50
4133,4,14011,3074,10937,0,0,0,1.0,1,1.0,1,1.0,1,0.1794900017260372,51
4134,6,14017,3074,10943,0,0,0,1.0,1,1.0,1,1.0,1,0.19382735118403052,53
4135,6,14023,3074,10949,0,0,0,1.0,1,1.0,1,1.0,1,0.17680915606110303,54
4136,5,14028,3074,10954,0,0,0,1.0,1,1.0,1,1.0,1,0.15788195642237263,54
4137,8,14036,3075,10961,0,0,0,1.0,1,1.0,1,1.0,1,0.1696983990693713,55
4138,3,14039,3076,10963,0,0,0,1.0,1,1.0,1,1.0,1,0.20418631979829494,54
4139,8,14047,3077,10970,0,0,0,1.0,1,1.0,1,1.0,1,0.2345936785123452,54
4140,15,14062,3079,10983,0,0,0,1.0,1,1.0,1,1.0,1,0.2714298159183883,55
4141,10,14072,3079,10993,0,0,0,1.0,1,1.0,1,1.0,1,0.18681081327569296,55
4142,9,14081,3081,11000,0,0,0,1.0,1,1.0,1,1.0,1,0.1693175467878522,55
4143,7,14088,3084,11004,0,0,0,1.0,1,1.0,1,1.0,1,0.2187424732211353,53
4144,6,14094,3084,11010,0,0,0,1.0,1,1.0,1,1.0,1,0.22740988934397935,52
4145,11,14105,3086,11019,0,0,0,1.0,1,1.0,1,1.0,1,0.2338780294624112,51
4146,4,14109,3086,11023,0,0,0,1.0,1,1.0,1,1.0,1,0.21392526743899928,51
4147,9,14118,3090,11028,0,0,0,1.0,1,1.0,1,1.0,1,0.3093526735503438,50
4148,9,14127,3090,11037,0,0,0,1.0,1,1.0,1,1.0,1,0.2886071916968335,52
4149,5,14132,3090,11042,0,0,0,1.0,1,1.0,1,1.0,1,0.26609829277552177,53
4150,8,14140,3091,11049,0,0,0,1.0,1,1.0,1,1.0,1,0.24135088420504588,53
4151,5,14145,3091,11054,0,0,0,1.0,1,1.0,1,1.0,1,0.2650325398839368,53
4152,6,14151,3091,11060,0,0,0,1.0,1,1.0,1,1.0,1,0.24299530796051763,54
4153,9,14160,3091,11069,0,0,0,1.0,1,1.0,1,1.0,1,0.22138213965660752,51
4154,7,14167,3091,11076,0,0,0,1.0,1,1.0,1,1.0,1,0.23083009543460706,51
4155,6,14173,3092,11081,0,0,0,1.0,1,1.0,1,1.0,1,0.2287692752064964,51
4156,10,14183,3093,11090,0,0,0,1.0,1,1.0,1,1.0,1,0.13169736673126559,52
4157,8,14191,3095,11096,0,0,0,1.0,1,1.0,1,1.0,1,0.17049393861149484,52
4158,4,14195,3095,11100,0,0,0,1.0,1,1.0,1,1.0,1,0.16243011374996072,52
4159,5,14200,3095,11105,0,0,0,1.0,1,1.0,1,1.0,1,0.165483312472667,52
4160,6,14206,3095,11111,0,0,0,1.0,1,1.0,1,1.0,1,0.1785966758008616,50
4161,3,14209,3095,11114,0,0,0,1.0,1,1.0,1,1.0,1,0.16610047093531902,50
4162,4,14213,3096,11117,0,0,0,1.0,1,1.0,1,1.0,1,0.18626841811317654,51
4163,7,14220,3097,11123,0,0,0,1.0,1,1.0,1,1.0,1,0.1667847951853099,48
4164,6,14226,3098,11128,0,0,0,1.0,1,1.0,1,1.0,1,0.16339554193116668,50
4165,2,14228,3098,11130,0,0,0,1.0,1,1.0,1,1.0,1,0.19326153664155038,49
4166,5,14233,3099,11134,0,0,0,1.0,1,1.0,1,1.0,1,0.17064956026078745,50
4167,4,14237,3099,11138,0,0,0,1.0,1,1.0,1,1.0,1,0.17077831747433675,50
4168,3,14240,3099,11141,0,0,0,1.0,1,1.0,1,1.0,1,0.1912226191798082,50
4169,6,14246,3100,11146,0,0,0,1.0,1,1.0,1,1.0,1,0.20957031879961083,51
4170,4,14250,3102,11148,0,0,0,1.0,1,1.0,1,1.0,1,0.2749323562814751,50
4171,9,14259,3103,11156,0,0,0,1.0,1,1.0,1,1.0,1,0.2396556154475577,50
4172,1,14260,3103,11157,0,0,0,1.0,1,1.0,1,1.0,1,0.2392860007661617,49
4173,0,14260,3103,11157,0,0,0,1.0,1,1.0,1,1.0,1,0.26615072042139926,48
4174,1,14261,3103,11158,0,0,0,1.0,1,1.0,1,1.0,1,0.25372880961416794,48
4175,1,14262,3103,11159,0,0,0,1.0,1,1.0,1,1.0,1,0.23434784982537368,48
4176,2,14264,3104,11160,0,0,0,1.0,1,1.0,1,1.0,1,0.22673067627204327,50
4177,5,14269,3106,11163,0,0,0,1.0,1,1.0,1,1.0,1,0.20973322249234405,52
4178,3,14272,3108,11164,0,0,0,1.0,1,1.0,1,1.0,1,0.21084647659691944,53
4179,2,14274,3109,11165,0,0,0,1.0,1,1.0,1,1.0,1,0.19305472564215712,54
4180,2,14276,3109,11167,0,0,0,1.0,1,1.0,1,1.0,1,0.18618860917600338,55
4181,4,14280,3109,11171,0,0,0,1.0,1,1.0,1,1.0,1,0.17808237073987931,56
4182,3,14283,3109,11174,0,0,0,1.0,1,1.0,1,1.0,1,0.1813826903922877,56
4183,4,14287,3110,11177,0,0,0,1.0,1,1.0,1,1.0,1,0.16143555252684785,57
4184,6,14293,3113,11180,0,0,0,1.0,1,1.0,1,1.0,1,0.19854186437883073,57
4185,7,14300,3114,11186,0,0,0,1.0,1,1.0,1,1.0,1,0.2235594997467662,54
4186,8,14308,3115,11193,0,0,0,1.0,1,1.0,1,1.0,1,0.13934818599172774,55
4187,1,14309,3115,11194,0,0,0,1.0,1,1.0,1,1.0,1,0.14583883951632154,53
4188,2,14311,3115,11196,0,0,0,1.0,1,1.0,1,1.0,1,0.13469323835657138,53
4189,6,14317,3116,11201,0,0,0,1.0,1,1.0,1,1.0,1,0.1048869160288452,53
4190,2,14319,3117,11202,0,0,0,1.0,1,1.0,1,1.0,1,0.1302498608876433,53
4191,1,14320,3117,11203,0,0,0,1.0,1,1.0,1,1.0,1,0.14924664908782262,51
4192,4,14324,3119,11205,0,0,0,1.0,1,1.0,1,1.0,1,0.14988541832230487,51
4193,2,14326,3119,11207,0,0,0,1.0,1,1.0,1,1.0,1,0.145310426161462,50
4194,1,14327,3119,11208,0,0,0,1.0,1,1.0,1,1.0,1,0.16224887999090792,50
4195,5,14332,3122,11210,0,0,0,1.0,1,1.0,1,1.0,1,0.14881974110096144,50
4196,4,14336,3124,11212,0,0,0,1.0,1,1.0,1,1.0,1,0.21861890168451767,51
4197,4,14340,3124,11216,0,0,0,1.0,1,1.0,1,1.0,1,0.22510680290365637,50
4198,2,14342,3126,11216,0,0,0,1.0,1,1.0,1,1.0,1,0.22481036331034776,48
4199,1,14343,3126,11217,0,0,0,1.0,1,1.0,1,1.0,1,0.24894484008412088,48
4200,4,14347,3127,11220,0,0,0,1.0,1,1.0,1,1.0,1,0.2726113882350479,48
4201,5,14352,3127,11225,0,0,0,1.0,1,1.0,1,1.0,1,0.20848335439694085,47
4202,4,14356,3128,11228,0,0,0,1.0,1,1.0,1,1.0,1,0.20264910664347366,47
4203,3,14359,3129,11230,0,0,0,1.0,1,1.0,1,1.0,1,0.23838980385034453,47
4204,2,14361,3130,11231,0,0,0,1.0,1,1.0,1,1.0,1,0.24843376128027453,48
4205,2,14363,3130,11233,0,0,0,1.0,1,1.0,1,1.0,1,0.23894034467570752,49
4206,2,14365,3130,11235,0,0,0,1.0,1,1.0,1,1.0,1,0.23894034467570752,49
4207,2,14367,3130,11237,0,0,0,1.0,1,1.0,1,1.0,1,0.25340574133693516,48
4208,1,14368,3131,11237,0,0,0,1.0,1,1.0,1,1.0,1,0.2425063949303016,49
4209,5,14373,3133,11240,0,0,0,1.0,1,1.0,1,1.0,1,0.21853077564667606,51
4210,4,14377,3134,11243,0,0,0,1.0,1,1.0,1,1.0,1,0.20412454162193586,52
4211,1,14378,3134,11244,0,0,0,1.0,1,1.0,1,1.0,1,0.18686948572222306,53
4212,1,14379,3134,11245,0,0,0,1.0,1,1.0,1,1.0,1,0.19328303127007443,53
4213,1,14380,3134,11246,0,0,0,1.0,1,1.0,1,1.0,1,0.1737563023518925,54
4214,6,14386,3135,11251,0,0,0,1.0,1,1.0,1,1.0,1,0.1814294975763922,54
4215,4,14390,3136,11254,0,0,0,1.0,1,1.0,1,1.0,1,0.17974433319890532,54
4216,2,14392,3136,11256,0,0,0,1.0,1,1.0,1,1.0,1,0.18151928290308159,53
4217,3,14395,3138,11257,0,0,0,1.0,1,1.0,1,1.0,1,0.24353499099608086,54
4218,2,14397,3138,11259,0,0,0,1.0,1,1.0,1,1.0,1,0.22724758003033618,53
4219,2,14399,3139,11260,0,0,0,1.0,1,1.0,1,1.0,1,0.2337031252104429,53
4220,1,14400,3140,11260,0,0,0,1.0,1,1.0,1,1.0,1,0.2537033711178116,53
4221,4,14404,3141,11263,0,0,0,1.0,1,1.0,1,1.0,1,0.2586274019120473,54
4222,5,14409,3144,11265,0,0,0,1.0,1,1.0,1,1.0,1,0.26077537509217824,55
4223,5,14414,3146,11268,0,0,0,1.0,1,1.0,1,1.0,1,0.26783278835938007,56
4224,4,14418,3147,11271,0,0,0,1.0,1,1.0,1,1.0,1,0.2632331046062496,55
4225,0,14418,3147,11271,0,0,0,1.0,1,1.0,1,1.0,1,0.265022167663246,53
4226,4,14422,3150,11272,0,0,0,1.0,1,1.0,1,1.0,1,0.2766714424912666,54
4227,1,14423,3150,11273,0,0,0,1.0,1,1.0,1,1.0,1,0.274802203945508,52
4228,5,14428,3151,11277,0,0,0,1.0,1,1.0,1,1.0,1,0.27898685567392656,51
4229,3,14431,3152,11279,0,0,0,1.0,1,1.0,1,1.0,1,0.28475597310467976,48
4230,3,14434,3154,11280,0,0,0,1.0,1,1.0,1,1.0,1,0.2813543488009841,48
4231,6,14440,3154,11286,0,0,0,1.0,1,1.0,1,1.0,1,0.19062614043743772,48
4232,4,14444,3155,11289,0,0,0,1.0,1,1.0,1,1.0,1,0.1618748652694334,48
4233,3,14447,3155,11292,0,0,0,1.0,1,1.0,1,1.0,1,0.1514961647312883,48
4234,7,14454,3157,11297,0,0,0,1.0,1,1.0,1,1.0,1,0.1597810419260698,49
4235,5,14459,3157,11302,0,0,0,1.0,1,1.0,1,1.0,1,0.19135731590832827,47
4236,8,14467,3158,11309,0,0,0,1.0,1,1.0,1,1.0,1,0.137048702541908,47
4237,6,14473,3158,11315,0,0,0,1.0,1,1.0,1,1.0,1,0.1933377847796415,48
4238,2,14475,3158,11317,0,0,0,1.0,1,1.0,1,1.0,1,0.16469659810027246,47
4239,2,14477,3158,11319,0,0,0,1.0,1,1.0,1,1.0,1,0.1483118229338848,48
4240,2,14479,3158,11321,0,0,0,1.0,1,1.0,1,1.0,1,0.11767797663212114,47
4241,3,14482,3158,11324,0,0,0,1.0,1,1.0,1,1.0,1,0.09922903137239845,49
4242,5,14487,3158,11329,0,0,0,1.0,1,1.0,1,1.0,1,0.10513608024518499,49
4243,1,14488,3158,11330,0,0,0,1.0,1,1.0,1,1.0,1,0.14848035637727625,50
4244,5,14493,3158,11335,0,0,0,1.0,1,1.0,1,1.0,1,0.0873589096618335,51
4245,8,14501,3158,11343,0,0,0,1.0,1,1.0,1,1.0,1,0.12100835846221837,51
4246,3,14504,3158,11346,0,0,0,1.0,1,1.0,1,1.0,1,0.046236375683056996,51
4247,2,14506,3158,11348,0,0,0,1.0,1,1.0,1,1.0,1,0.043706715917283555,52
4248,1,14507,3159,11348,0,0,0,1.0,1,1.0,1,1.0,1,0.06269295670538888,52
4249,0,14507,3159,11348,0,0,0,1.0,1,1.0,1,1.0,1,0.06269295670538888,52
4250,2,14509,3161,11348,0,0,0,1.0,1,1.0,1,1.0,1,0.10692570193812856,52
4251,4,14513,3162,11351,0,0,0,1.0,1,1.0,1,1.0,1,0.09572732578151194,53
4252,6,14519,3164,11355,0,0,0,1.0,1,1.0,1,1.0,1,0.13385383098033227,53
4253,3,14522,3166,11356,0,0,0,1.0,1,1.0,1,1.0,1,0.14717706535502983,54
4254,2,14524,3166,11358,0,0,0,1.0,1,1.0,1,1.0,1,0.1466096648548448,54
4255,4,14528,3166,11362,0,0,0,1.0,1,1.0,1,1.0,1,0.15745696557459343,55
4256,11,14539,3168,11371,0,0,0,1.0,1,1.0,1,1.0,1,0.1844977062598619,57
4257,10,14549,3169,11380,0,0,0,1.0,1,1.0,1,1.0,1,0.18206815457614497,57
4258,7,14556,3169,11387,0,0,0,1.0,1,1.0,1,1.0,1,0.1720356361628491,57
4259,6,14562,3169,11393,0,0,0,1.0,1,1.0,1,1.0,1,0.1720356361628491,57
4260,8,14570,3169,11401,0,0,0,1.0,1,1.0,1,1.0,1,0.18844864189234903,58
4261,10,14580,3170,11410,0,0,0,1.0,1,1.0,1,1.0,1,0.08600357738317116,59
4262,6,14586,3171,11415,0,0,0,1.0,1,1.0,1,1.0,1,0.09633369342214952,60
4263,2,14588,3172,11416,0,0,0,1.0,1,1.0,1,1.0,1,0.09828964828290074,59
4264,5,14593,3174,11419,0,0,0,1.0,1,1.0,1,1.0,1,0.11415509386105088,58
4265,3,14596,3175,11421,0,0,0,1.0,1,1.0,1,1.0,1,0.18756826068117702,58
4266,3,14599,3175,11424,0,0,0,1.0,1,1.0,1,1.0,1,0.1704553785301469,58
4267,3,14602,3177,11425,0,0,0,1.0,1,1.0,1,1.0,1,0.18434094852587246,55
4268,3,14605,3179,11426,0,0,0,1.0,1,1.0,1,1.0,1,0.18969144805299337,55
4269,2,14607,3180,11427,0,0,0,1.0,1,1.0,1,1.0,1,0.19629869859282253,50
4270,1,14608,3181,11427,0,0,0,1.0,1,1.0,1,1.0,1,0.20999717835339052,47
4271,2,14610,3182,11428,0,0,0,1.0,1,1.0,1,1.0,1,0.22933953298141344,47
4272,2,14612,3183,11429,0,0,0,1.0,1,1.0,1,1.0,1,0.21282942240410238,46
4273,2,14614,3184,11430,0,0,0,1.0,1,1.0,1,1.0,1,0.22886901810046031,47
4274,4,14618,3187,11431,0,0,0,1.0,1,1.0,1,1.0,1,0.21034225854089003,45
4275,4,14622,3191,11431,0,0,0,1.0,1,1.0,1,1.0,1,0.3112426213221434,44
4276,11,14633,3193,11440,0,0,0,1.0,1,1.0,1,1.0,1,0.1334700783796299,43
4277,6,14639,3193,11446,0,0,0,1.0,1,1.0,1,1.0,1,0.1537159460466305,42
4278,7,14646,3193,11453,0,0,0,1.0,1,1.0,1,1.0,1,0.1578473091477107,43
4279,9,14655,3195,11460,0,0,0,1.0,1,1.0,1,1.0,1,0.2633973859353395,42
4280,9,14664,3195,11469,0,0,0,1.0,1,1.0,1,1.0,1,0.18542352190236583,44
4281,3,14667,3195,11472,0,0,0,1.0,1,1.0,1,1.0,1,0.21912055594549681,44
4282,4,14671,3195,11476,0,0,0,1.0,1,1.0,1,1.0,1,0.21904242609718905,44
4283,3,14674,3196,11478,0,0,0,1.0,1,1.0,1,1.0,1,0.17556580885005363,45
4284,3,14677,3196,11481,0,0,0,1.0,1,1.0,1,1.0,1,0.18036823191668427,45
4285,5,14682,3196,11486,0,0,0,1.0,1,1.0,1,1.0,1,0.17263250925235346,47
4286,6,14688,3196,11492,0,0,0,1.0,1,1.0,1,1.0,1,0.1682555765745178,47
4287,7,14695,3196,11499,0,0,0,1.0,1,1.0,1,1.0,1,0.17863058943806606,49
4288,7,14702,3196,11506,0,0,0,1.0,1,1.0,1,1.0,1,0.16769868141583677,49
4289,10,14712,3196,11516,0,0,0,1.0,1,1.0,1,1.0,1,0.1757646078604463,50
4290,8,14720,3197,11523,0,0,0,1.0,1,1.0,1,1.0,1,0.14172703605386167,51
4291,8,14728,3198,11530,0,0,0,1.0,1,1.0,1,1.0,1,0.09561366783698008,50
4292,2,14730,3199,11531,0,0,0,1.0,1,1.0,1,1.0,1,0.11141688326589876,51
4293,2,14732,3200,11532,0,0,0,1.0,1,1.0,1,1.0,1,0.09169476877796919,51
4294,3,14735,3201,11534,0,0,0,1.0,1,1.0,1,1.0,1,0.11883944271951144,50
4295,4,14739,3203,11536,0,0,0,1.0,1,1.0,1,1.0,1,0.13602408825537735,50
4296,3,14742,3203,11539,0,0,0,1.0,1,1.0,1,1.0,1,0.1343170752602095,49
4297,1,14743,3203,11540,0,0,0,1.0,1,1.0,1,1.0,1,0.13523668549976106,49
4298,2,14745,3204,11541,0,0,0,1.0,1,1.0,1,1.0,1,0.14440728465611577,49
4299,1,14746,3204,11542,0,0,0,1.0,1,1.0,1,1.0,1,0.14580442362834908,48
4300,0,14746,3204,11542,0,0,0,1.0,1,1.0,1,1.0,1,0.12771638670184007,49
4301,2,14748,3205,11543,0,0,0,1.0,1,1.0,1,1.0,1,0.09774546938454313,50
4302,1,14749,3206,11543,0,0,0,1.0,1,1.0,1,1.0,1,0.13119194014148183,51
4303,2,14751,3207,11544,0,0,0,1.0,1,1.0,1,1.0,1,0.12576028847859902,51
4304,3,14754,3209,11545,0,0,0,1.0,1,1.0,1,1.0,1,0.1759409670666199,51
4305,3,14757,3210,11547,0,0,0,1.0,1,1.0,1,1.0,1,0.1917992860077396,49
4306,10,14767,3213,11554,0,0,0,1.0,1,1.0,1,1.0,1,0.13892627085877146,49
4307,4,14771,3216,11555,0,0,0,1.0,1,1.0,1,1.0,1,0.1676228662327673,46
4308,0,14771,3216,11555,0,0,0,1.0,1,1.0,1,1.0,1,0.16999053712039877,44
4309,3,14774,3217,11557,0,0,0,1.0,1,1.0,1,1.0,1,0.16186820338419416,44
4310,1,14775,3218,11557,0,0,0,1.0,1,1.0,1,1.0,1,0.1753674316807063,42
4311,3,14778,3219,11559,0,0,0,1.0,1,1.0,1,1.0,1,0.1886333659977356,42
4312,3,14781,3220,11561,0,0,0,1.0,1,1.0,1,1.0,1,0.2236393369332419,40
4313,5,14786,3223,11563,0,0,0,1.0,1,1.0,1,1.0,1,0.18595801110816212,40
4314,1,14787,3223,11564,0,0,0,1.0,1,1.0,1,1.0,1,0.2273569531718559,36
4315,2,14789,3225,11564,0,0,0,1.0,1,1.0,1,1.0,1,0.16515823220395187,37
4316,1,14790,3226,11564,0,0,0,1.0,1,1.0,1,1.0,1,0.19485871197429755,37
4317,5,14795,3231,11564,0,0,0,1.0,1,1.0,1,1.0,1,0.28461216717896587,36
4318,2,14797,3231,11566,0,0,0,1.0,1,1.0,1,1.0,1,0.22418962885742516,34
4319,0,14797,3231,11566,0,0,0,1.0,1,1.0,1,1.0,1,0.23579976727279814,34
4320,0,14797,3231,11566,0,0,0,1.0,1,1.0,1,1.0,1,0.23579976727279814,34
4321,7,14804,3231,11573,0,0,0,1.0,1,1.0,1,1.0,1,0.15562944941144613,35
4322,0,14804,3231,11573,0,0,0,1.0,1,1.0,1,1.0,1,0.15562944941144613,35
4323,2,14806,3233,11573,0,0,0,1.0,1,1.0,1,1.0,1,0.18822080780713898,35
4324,3,14809,3233,11576,0,0,0,1.0,1,1.0,1,1.0,1,0.17567076195590797,34
4325,3,14812,3234,11578,0,0,0,1.0,1,1.0,1,1.0,1,0.16889342479449507,34
4326,3,14815,3234,11581,0,0,0,1.0,1,1.0,1,1.0,1,0.10674919898621235,36
4327,1,14816,3234,11582,0,0,0,1.0,1,1.0,1,1.0,1,0.13230658837560727,35
4328,3,14819,3235,11584,0,0,0,1.0,1,1.0,1,1.0,1,0.13077796875387465,35
4329,1,14820,3235,11585,0,0,0,1.0,1,1.0,1,1.0,1,0.1400199553166159,38
4330,2,14822,3236,11586,0,0,0,1.0,1,1.0,1,1.0,1,0.14690356888401238,38
4331,2,14824,3236,11588,0,0,0,1.0,1,1.0,1,1.0,1,0.17242259923264644,39
4332,5,14829,3236,11593,0,0,0,1.0,1,1.0,1,1.0,1,0.1359064072317772,40
4333,1,14830,3236,11594,0,0,0,1.0,1,1.0,1,1.0,1,0.10110004640156481,41
4334,3,14833,3236,11597,0,0,0,1.0,1,1.0,1,1.0,1,0.07400122015036653,41
4335,3,14836,3237,11599,0,0,0,1.0,1,1.0,1,1.0,1,0.0960001168200888,42
4336,1,14837,3237,11600,0,0,0,1.0,1,1.0,1,1.0,1,0.0971906957825848,43
4337,0,14837,3237,11600,0,0,0,1.0,1,1.0,1,1.0,1,0.07683765029577742,44
4338,0,14837,3237,11600,0,0,0,1.0,1,1.0,1,1.0,1,0.07683765029577742,44
4339,2,14839,3238,11601,0,0,0,1.0,1,1.0,1,1.0,1,0.09540355124783935,46
4340,0,14839,3238,11601,0,0,0,1.0,1,1.0,1,1.0,1,0.10547362023643393,47
4341,1,14840,3239,11601,0,0,0,1.0,1,1.0,1,1.0,1,0.1387837733601324,47
4342,5,14845,3242,11603,0,0,0,1.0,1,1.0,1,1.0,1,0.18136184849627351,47
4343,1,14846,3243,11603,0,0,0,1.0,1,1.0,1,1.0,1,0.19247808494151827,42
4344,5,14851,3246,11605,0,0,0,1.0,1,1.0,1,1.0,1,0.23279180409368902,42
4345,3,14854,3248,11606,0,0,0,1.0,1,1.0,1,1.0,1,0.227142847589578,39
4346,2,14856,3250,11606,0,0,0,1.0,1,1.0,1,1.0,1,0.24773137979634285,37
4347,1,14857,3251,11606,0,0,0,1.0,1,1.0,1,1.0,1,0.27574656957369087,37
4348,5,14862,3255,11607,0,0,0,1.0,1,1.0,1,1.0,1,0.359803760302644,38
4349,3,14865,3255,11610,0,0,0,1.0,1,1.0,1,1.0,1,0.2980085453670689,36
4350,1,14866,3256,11610,0,0,0,1.0,1,1.0,1,1.0,1,0.3156357567378419,37
4351,9,14875,3257,11618,0,0,0,1.0,1,1.0,1,1.0,1,0.22978552763018495,35
4352,7,14882,3259,11623,0,0,0,1.0,1,1.0,1,1.0,1,0.3310205688358822,34
4353,4,14886,3259,11627,0,0,0,1.0,1,1.0,1,1.0,1,0.29091317085052215,34
4354,2,14888,3259,11629,0,0,0,1.0,1,1.0,1,1.0,1,0.30600733141811204,32
4355,4,14892,3259,11633,0,0,0,1.0,1,1.0,1,1.0,1,0.2150325048736359,32
4356,4,14896,3260,11636,0,0,0,1.0,1,1.0,1,1.0,1,0.20050495141352162,34
4357,3,14899,3260,11639,0,0,0,1.0,1,1.0,1,1.0,1,0.20607855398848088,35
4358,7,14906,3262,11644,0,0,0,1.0,1,1.0,1,1.0,1,0.2131732986330177,35
4359,3,14909,3262,11647,0,0,0,1.0,1,1.0,1,1.0,1,0.23756426622114407,37
4360,5,14914,3262,11652,0,0,0,1.0,1,1.0,1,1.0,1,0.22338044285867784,38
4361,2,14916,3262,11654,0,0,0,1.0,1,1.0,1,1.0,1,0.15829080720559557,39
4362,7,14923,3264,11659,0,0,0,1.0,1,1.0,1,1.0,1,0.2106247631922441,38
4363,3,14926,3264,11662,0,0,0,1.0,1,1.0,1,1.0,1,0.24223626546215804,38
4364,4,14930,3265,11665,0,0,0,1.0,1,1.0,1,1.0,1,0.24565821017327064,39
4365,4,14934,3265,11669,0,0,0,1.0,1,1.0,1,1.0,1,0.25677048625384935,39
4366,7,14941,3265,11676,0,0,0,1.0,1,1.0,1,1.0,1,0.13112775122427658,39
4367,5,14946,3266,11680,0,0,0,1.0,1,1.0,1,1.0,1,0.11031553452227201,41
4368,5,14951,3266,11685,0,0,0,1.0,1,1.0,1,1.0,1,0.10361012821194962,41
4369,2,14953,3266,11687,0,0,0,1.0,1,1.0,1,1.0,1,0.12371893820091939,42
4370,1,14954,3266,11688,0,0,0,1.0,1,1.0,1,1.0,1,0.10359986975029103,42
4371,2,14956,3266,11690,0,0,0,1.0,1,1.0,1,1.0,1,0.11865699589579272,43
4372,3,14959,3268,11691,0,0,0,1.0,1,1.0,1,1.0,1,0.1727135194005964,43
4373,5,14964,3268,11696,0,0,0,1.0,1,1.0,1,1.0,1,0.18051088953281638,43
4374,3,14967,3268,11699,0,0,0,1.0,1,1.0,1,1.0,1,0.19089370895561245,44
4375,2,14969,3269,11700,0,0,0,1.0,1,1.0,1,1.0,1,0.19599486922334675,45
4376,6,14975,3269,11706,0,0,0,1.0,1,1.0,1,1.0,1,0.14656998804309512,46
4377,12,14987,3271,11716,0,0,0,1.0,1,1.0,1,1.0,1,0.19767148916508348,47
4378,12,14999,3272,11727,0,0,0,1.0,1,1.0,1,1.0,1,0.2198967652724736,49
4379,13,15012,3274,11738,0,0,0,1.0,1,1.0,1,1.0,1,0.18953990361464443,51
4380,13,15025,3274,11751,0,0,0,1.0,1,1.0,1,1.0,1,0.2042562512803416,50
4381,5,15030,3275,11755,0,0,0,1.0,1,1.0,1,1.0,1,0.14569245869973893,49
4382,1,15031,3276,11755,0,0,0,1.0,1,1.0,1,1.0,1,0.21073206382729487,47
4383,2,15033,3276,11757,0,0,0,1.0,1,1.0,1,1.0,1,0.2048952868266705,47
4384,2,15035,3277,11758,0,0,0,1.0,1,1.0,1,1.0,1,0.20842153092229873,44
4385,1,15036,3278,11758,0,0,0,1.0,1,1.0,1,1.0,1,0.22554632872986488,42
4386,3,15039,3279,11760,0,0,0,1.0,1,1.0,1,1.0,1,0.2718417934265407,41
4387,1,15040,3279,11761,0,0,0,1.0,1,1.0,1,1.0,1,0.28539443563461947,39
4388,1,15041,3280,11761,0,0,0,1.0,1,1.0,1,1.0,1,0.280275791201774,39
4389,1,15042,3281,11761,0,0,0,1.0,1,1.0,1,1.0,1,0.29082978117262376,38
4390,1,15043,3281,11762,0,0,0,1.0,1,1.0,1,1.0,1,0.22271077002923456,38
4391,0,15043,3281,11762,0,0,0,1.0,1,1.0,1,1.0,1,0.20920582554461475,39
4392,0,15043,3281,11762,0,0,0,1.0,1,1.0,1,1.0,1,0.20920582554461475,39
4393,0,15043,3281,11762,0,0,0,1.0,1,1.0,1,1.0,1,0.20195918215898104,40
4394,0,15043,3281,11762,0,0,0,1.0,1,1.0,1,1.0,1,0.22099472868692424,39
4395,1,15044,3282,11762,0,0,0,1.0,1,1.0,1,1.0,1,0.21509199704507115,39
4396,8,15052,3283,11769,0,0,0,1.0,1,1.0,1,1.0,1,0.1549597716060707,39
4397,1,15053,3284,11769,0,0,0,1.0,1,1.0,1,1.0,1,0.1889689645149809,38
4398,0,15053,3284,11769,0,0,0,1.0,1,1.0,1,1.0,1,0.19683951898568114,39
4399,2,15055,3284,11771,0,0,0,1.0,1,1.0,1,1.0,1,0.1867517142748567,42
4400,3,15058,3284,11774,0,0,0,1.0,1,1.0,1,1.0,1,0.17454527043223728,43
4401,0,15058,3284,11774,0,0,0,1.0,1,1.0,1,1.0,1,0.1575334053073483,44
4402,0,15058,3284,11774,0,0,0,1.0,1,1.0,1,1.0,1,0.1575334053073483,44
4403,0,15058,3284,11774,0,0,0,1.0,1,1.0,1,1.0,1,0.14143633155064642,45
4404,1,15059,3284,11775,0,0,0,1.0,1,1.0,1,1.0,1,0.14787990168576995,45
4405,3,15062,3284,11778,0,0,0,1.0,1,1.0,1,1.0,1,0.12919056072996596,46
4406,3,15065,3285,11780,0,0,0,1.0,1,1.0,1,1.0,1,0.18085129352444423,46
4407,3,15068,3285,11783,0,0,0,1.0,1,1.0,1,1.0,1,0.17522333952634886,46
4408,2,15070,3285,11785,0,0,0,1.0,1,1.0,1,1.0,1,0.17278463934782995,47
4409,4,15074,3285,11789,0,0,0,1.0,1,1.0,1,1.0,1,0.17238069630324399,48
4410,2,15076,3285,11791,0,0,0,1.0,1,1.0,1,1.0,1,0.17768517912402784,48
4411,3,15079,3285,11794,0,0,0,1.0,1,1.0,1,1.0,1,0.12584181863318816,50
4412,1,15080,3286,11794,0,0,0,1.0,1,1.0,1,1.0,1,0.13696051302826676,50
4413,1,15081,3286,11795,0,0,0,1.0,1,1.0,1,1.0,1,0.1489759575697927,50
4414,1,15082,3286,11796,0,0,0,1.0,1,1.0,1,1.0,1,0.1451307216808527,51
4415,0,15082,3286,11796,0,0,0,1.0,1,1.0,1,1.0,1,0.1451307216808527,51
4416,0,15082,3286,11796,0,0,0,1.0,1,1.0,1,1.0,1,0.1451307216808527,51
4417,2,15084,3288,11796,0,0,0,1.0,1,1.0,1,1.0,1,0.16717747249613393,51
4418,5,15089,3288,11801,0,0,0,1.0,1,1.0,1,1.0,1,0.1604415847759818,51
4419,2,15091,3288,11803,0,0,0,1.0,1,1.0,1,1.0,1,0.16094446788637348,50
4420,3,15094,3289,11805,0,0,0,1.0,1,1.0,1,1.0,1,0.19325780871569645,50
4421,1,15095,3289,11806,0,0,0,1.0,1,1.0,1,1.0,1,0.1690760602597737,52
4422,0,15095,3289,11806,0,0,0,1.0,1,1.0,1,1.0,1,0.1886192387738091,51
4423,4,15099,3290,11809,0,0,0,1.0,1,1.0,1,1.0,1,0.21422085411405734,51
4424,2,15101,3290,11811,0,0,0,1.0,1,1.0,1,1.0,1,0.203105610736883,53
4425,4,15105,3290,11815,0,0,0,1.0,1,1.0,1,1.0,1,0.1957731186810809,54
4426,8,15113,3291,11822,0,0,0,1.0,1,1.0,1,1.0,1,0.0993571746476689,55
4427,1,15114,3291,11823,0,0,0,1.0,1,1.0,1,1.0,1,0.10270317906806886,55
4428,1,15115,3291,11824,0,0,0,1.0,1,1.0,1,1.0,1,0.08765344054486783,55
4429,3,15118,3291,11827,0,0,0,1.0,1,1.0,1,1.0,1,0.10717563495472723,56
4430,2,15120,3291,11829,0,0,0,1.0,1,1.0,1,1.0,1,0.11520428196377437,55
4431,1,15121,3291,11830,0,0,0,1.0,1,1.0,1,1.0,1,0.12521670595481219,56
4432,3,15124,3292,11832,0,0,0,1.0,1,1.0,1,1.0,1,0.11000375734222921,56
4433,2,15126,3292,11834,0,0,0,1.0,1,1.0,1,1.0,1,0.10095958530893073,57
4434,1,15127,3292,11835,0,0,0,1.0,1,1.0,1,1.0,1,0.10820081974507169,56
4435,3,15130,3292,11838,0,0,0,1.0,1,1.0,1,1.0,1,0.1003551164704293,56
4436,4,15134,3294,11840,0,0,0,1.0,1,1.0,1,1.0,1,0.13969544496382016,55
4437,1,15135,3294,11841,0,0,0,1.0,1,1.0,1,1.0,1,0.1485567073787163,54
4438,5,15140,3296,11844,0,0,0,1.0,1,1.0,1,1.0,1,0.19689912661171402,54
4439,5,15145,3297,11848,0,0,0,1.0,1,1.0,1,1.0,1,0.1913080364591029,55
4440,4,15149,3298,11851,0,0,0,1.0,1,1.0,1,1.0,1,0.20735135637011412,55
4441,8,15157,3301,11856,0,0,0,1.0,1,1.0,1,1.0,1,0.10688611553688798,59
4442,4,15161,3302,11859,0,0,0,1.0,1,1.0,1,1.0,1,0.1291085145508406,61
4443,3,15164,3303,11861,0,0,0,1.0,1,1.0,1,1.0,1,0.10665403922763206,60
4444,5,15169,3303,11866,0,0,0,1.0,1,1.0,1,1.0,1,0.11224290576195085,61
4445,3,15172,3303,11869,0,0,0,1.0,1,1.0,1,1.0,1,0.12895374739961232,61
4446,0,15172,3303,11869,0,0,0,1.0,1,1.0,1,1.0,1,0.1414021858023093,62
4447,0,15172,3303,11869,0,0,0,1.0,1,1.0,1,1.0,1,0.13182573822242544,63
4448,0,15172,3303,11869,0,0,0,1.0,1,1.0,1,1.0,1,0.13182573822242544,63
4449,1,15173,3304,11869,0,0,0,1.0,1,1.0,1,1.0,1,0.14574807842950513,63
4450,0,15173,3304,11869,0,0,0,1.0,1,1.0,1,1.0,1,0.15191903455956038,62
4451,0,15173,3304,11869,0,0,0,1.0,1,1.0,1,1.0,1,0.1468505675735036,63
4452,3,15176,3304,11872,0,0,0,1.0,1,1.0,1,1.0,1,0.14507745499779706,64
4453,5,15181,3304,11877,0,0,0,1.0,1,1.0,1,1.0,1,0.14775201013574385,65
4454,4,15185,3304,11881,0,0,0,1.0,1,1.0,1,1.0,1,0.14801091671235742,66
4455,3,15188,3304,11884,0,0,0,1.0,1,1.0,1,1.0,1,0.12610423033765186,67
4456,5,15193,3304,11889,0,0,0,1.0,1,1.0,1,1.0,1,0.09209095282126063,67
4457,0,15193,3304,11889,0,0,0,1.0,1,1.0,1,1.0,1,0.0939788176493094,65
4458,5,15198,3305,11893,0,0,0,1.0,1,1.0,1,1.0,1,0.08962967583804833,65
4459,5,15203,3308,11895,0,0,0,1.0,1,1.0,1,1.0,1,0.11642020029686959,64
4460,2,15205,3308,11897,0,0,0,1.0,1,1.0,1,1.0,1,0.1265570368593527,63
4461,7,15212,3311,11901,0,0,0,1.0,1,1.0,1,1.0,1,0.1762735422427336,62
4462,3,15215,3314,11901,0,0,0,1.0,1,1.0,1,1.0,1,0.19374903802119722,61
4463,5,15220,3316,11904,0,0,0,1.0,1,1.0,1,1.0,1,0.24000769622530796,61
4464,3,15223,3318,11905,0,0,0,1.0,1,1.0,1,1.0,1,0.24612059467567746,58
4465,1,15224,3318,11906,0,0,0,1.0,1,1.0,1,1.0,1,0.26173735550277505,57
4466,3,15227,3320,11907,0,0,0,1.0,1,1.0,1,1.0,1,0.2712896977044566,54
4467,1,15228,3320,11908,0,0,0,1.0,1,1.0,1,1.0,1,0.2167089428660218,52
4468,3,15231,3322,11909,0,0,0,1.0,1,1.0,1,1.0,1,0.19341171307822952,52
4469,3,15234,3324,11910,0,0,0,1.0,1,1.0,1,1.0,1,0.17317370614186733,51
4470,1,15235,3324,11911,0,0,0,1.0,1,1.0,1,1.0,1,0.1456867601489366,51
4471,5,15240,3326,11914,0,0,0,1.0,1,1.0,1,1.0,1,0.08730632553522781,50
4472,2,15242,3327,11915,0,0,0,1.0,1,1.0,1,1.0,1,0.10582892338261916,48
4473,1,15243,3328,11915,0,0,0,1.0,1,1.0,1,1.0,1,0.15152480995395845,47
4474,3,15246,3329,11917,0,0,0,1.0,1,1.0,1,1.0,1,0.1605538173996669,49
4475,4,15250,3331,11919,0,0,0,1.0,1,1.0,1,1.0,1,0.24586736622198274,47
4476,4,15254,3333,11921,0,0,0,1.0,1,1.0,1,1.0,1,0.25231081482919226,49
4477,2,15256,3333,11923,0,0,0,1.0,1,1.0,1,1.0,1,0.25336539474453623,48
4478,1,15257,3333,11924,0,0,0,1.0,1,1.0,1,1.0,1,0.24556028891678203,48
4479,0,15257,3333,11924,0,0,0,1.0,1,1.0,1,1.0,1,0.24556028891678203,48
4480,2,15259,3333,11926,0,0,0,1.0,1,1.0,1,1.0,1,0.20788928219230723,49
4481,0,15259,3333,11926,0,0,0,1.0,1,1.0,1,1.0,1,0.22515732679974293,49
4482,1,15260,3333,11927,0,0,0,1.0,1,1.0,1,1.0,1,0.2180322876086774,49
4483,0,15260,3333,11927,0,0,0,1.0,1,1.0,1,1.0,1,0.21163182376959164,50
4484,6,15266,3335,11931,0,0,0,1.0,1,1.0,1,1.0,1,0.18827636155258573,52
4485,3,15269,3335,11934,0,0,0,1.0,1,1.0,1,1.0,1,0.1895676410018638,53
4486,7,15276,3336,11940,0,0,0,1.0,1,1.0,1,1.0,1,0.11869295782601352,55
4487,5,15281,3338,11943,0,0,0,1.0,1,1.0,1,1.0,1,0.1277956388442559,55
4488,3,15284,3340,11944,0,0,0,1.0,1,1.0,1,1.0,1,0.1629253493650442,54
4489,7,15291,3340,11951,0,0,0,1.0,1,1.0,1,1.0,1,0.1867548745988855,53
4490,4,15295,3340,11955,0,0,0,1.0,1,1.0,1,1.0,1,0.1807822176569779,53
4491,4,15299,3340,11959,0,0,0,1.0,1,1.0,1,1.0,1,0.19708030009847824,52
4492,8,15307,3341,11966,0,0,0,1.0,1,1.0,1,1.0,1,0.20114403249652982,52
4493,6,15313,3341,11972,0,0,0,1.0,1,1.0,1,1.0,1,0.221652394130511,52
4494,6,15319,3341,11978,0,0,0,1.0,1,1.0,1,1.0,1,0.22297533831951546,53
4495,11,15330,3344,11986,0,0,0,1.0,1,1.0,1,1.0,1,0.2561192839187219,50
4496,6,15336,3346,11990,0,0,0,1.0,1,1.0,1,1.0,1,0.21486852311958565,51
4497,3,15339,3346,11993,0,0,0,1.0,1,1.0,1,1.0,1,0.21730193119793162,50
4498,8,15347,3347,12000,0,0,0,1.0,1,1.0,1,1.0,1,0.253730857723207,49
4499,5,15352,3347,12005,0,0,0,1.0,1,1.0,1,1.0,1,0.24489994287063607,48
4500,4,15356,3347,12009,0,0,0,1.0,1,1.0,1,1.0,1,0.2886557595870316,48
4501,7,15363,3348,12015,0,0,0,1.0,1,1.0,1,1.0,1,0.1515455273249614,48
4502,1,15364,3348,12016,0,0,0,1.0,1,1.0,1,1.0,1,0.1422461836030141,49
4503,5,15369,3350,12019,0,0,0,1.0,1,1.0,1,1.0,1,0.16707195376709819,49
4504,3,15372,3350,12022,0,0,0,1.0,1,1.0,1,1.0,1,0.1836759429503144,45
4505,5,15377,3351,12026,0,0,0,1.0,1,1.0,1,1.0,1,0.17608950716036392,46
4506,2,15379,3351,12028,0,0,0,1.0,1,1.0,1,1.0,1,0.21826096463139333,45
4507,9,15388,3352,12036,0,0,0,1.0,1,1.0,1,1.0,1,0.2589420616898317,45
4508,5,15393,3355,12038,0,0,0,1.0,1,1.0,1,1.0,1,0.19818105317153847,43
4509,1,15394,3356,12038,0,0,0,1.0,1,1.0,1,1.0,1,0.20031851213861276,41
4510,2,15396,3357,12039,0,0,0,1.0,1,1.0,1,1.0,1,0.21909691155909555,42
4511,3,15399,3358,12041,0,0,0,1.0,1,1.0,1,1.0,1,0.21173139382627673,41
4512,5,15404,3358,12046,0,0,0,1.0,1,1.0,1,1.0,1,0.21682343721749445,41
4513,2,15406,3358,12048,0,0,0,1.0,1,1.0,1,1.0,1,0.2624308515256572,41
4514,7,15413,3360,12053,0,0,0,1.0,1,1.0,1,1.0,1,0.2477439659921327,42
4515,3,15416,3360,12056,0,0,0,1.0,1,1.0,1,1.0,1,0.23572513064395206,41
4516,5,15421,3361,12060,0,0,0,1.0,1,1.0,1,1.0,1,0.17875633797367527,42
4517,4,15425,3362,12063,0,0,0,1.0,1,1.0,1,1.0,1,0.18964073070504017,43
4518,1,15426,3362,12064,0,0,0,1.0,1,1.0,1,1.0,1,0.19449311513141,42
4519,2,15428,3364,12064,0,0,0,1.0,1,1.0,1,1.0,1,0.23885259937209838,42
4520,5,15433,3364,12069,0,0,0,1.0,1,1.0,1,1.0,1,0.2697157216885578,42
4521,5,15438,3364,12074,0,0,0,1.0,1,1.0,1,1.0,1,0.2153428393484521,42
4522,3,15441,3366,12075,0,0,0,1.0,1,1.0,1,1.0,1,0.19112349115955343,42
4523,3,15444,3366,12078,0,0,0,1.0,1,1.0,1,1.0,1,0.20244417979324683,42
4524,6,15450,3369,12081,0,0,0,1.0,1,1.0,1,1.0,1,0.2318989398760006,43
4525,5,15455,3369,12086,0,0,0,1.0,1,1.0,1,1.0,1,0.1638651949747126,46
4526,9,15464,3371,12093,0,0,0,1.0,1,1.0,1,1.0,1,0.24579135536765892,46
4527,7,15471,3371,12100,0,0,0,1.0,1,1.0,1,1.0,1,0.15396557715403844,47
4528,12,15483,3371,12112,0,0,0,1.0,1,1.0,1,1.0,1,0.1754856909507334,49
4529,9,15492,3371,12121,0,0,0,1.0,1,1.0,1,1.0,1,0.1885585264280584,50
4530,6,15498,3371,12127,0,0,0,1.0,1,1.0,1,1.0,1,0.2405337857835934,51
4531,9,15507,3371,12136,0,0,0,1.0,1,1.0,1,1.0,1,0.09828003490838327,51
4532,1,15508,3371,12137,0,0,0,1.0,1,1.0,1,1.0,1,0.10855665239077777,51
4533,3,15511,3371,12140,0,0,0,1.0,1,1.0,1,1.0,1,0.16163959498190714,50
4534,7,15518,3371,12147,0,0,0,1.0,1,1.0,1,1.0,1,0.14398035173483759,51
4535,4,15522,3372,12150,0,0,0,1.0,1,1.0,1,1.0,1,0.11144713092169968,50
4536,1,15523,3372,12151,0,0,0,1.0,1,1.0,1,1.0,1,0.1549718769322191,48
4537,1,15524,3372,12152,0,0,0,1.0,1,1.0,1,1.0,1,0.1345539267681628,49
4538,4,15528,3372,12156,0,0,0,1.0,1,1.0,1,1.0,1,0.15437739352118612,48
4539,8,15536,3373,12163,0,0,0,1.0,1,1.0,1,1.0,1,0.17924041812021035,50
4540,3,15539,3373,12166,0,0,0,1.0,1,1.0,1,1.0,1,0.2144290393012148,49
4541,7,15546,3374,12172,0,0,0,1.0,1,1.0,1,1.0,1,0.2058036750128494,49
4542,6,15552,3375,12177,0,0,0,1.0,1,1.0,1,1.0,1,0.24473161359842002,47
4543,4,15556,3375,12181,0,0,0,1.0,1,1.0,1,1.0,1,0.21669335250770208,45
4544,4,15560,3376,12184,0,0,0,1.0,1,1.0,1,1.0,1,0.24968893937090017,45
4545,3,15563,3377,12186,0,0,0,1.0,1,1.0,1,1.0,1,0.23901514740396768,43
4546,6,15569,3379,12190,0,0,0,1.0,1,1.0,1,1.0,1,0.20765828228607122,43
4547,1,15570,3379,12191,0,0,0,1.0,1,1.0,1,1.0,1,0.167809431657504,41
4548,2,15572,3380,12192,0,0,0,1.0,1,1.0,1,1.0,1,0.14743524716354606,42
4549,0,15572,3380,12192,0,0,0,1.0,1,1.0,1,1.0,1,0.16653898063057096,41
4550,3,15575,3382,12193,0,0,0,1.0,1,1.0,1,1.0,1,0.1702381108593222,41
4551,1,15576,3383,12193,0,0,0,1.0,1,1.0,1,1.0,1,0.191927403512649,39
4552,0,15576,3383,12193,0,0,0,1.0,1,1.0,1,1.0,1,0.21815166436428915,38
4553,1,15577,3384,12193,0,0,0,1.0,1,1.0,1,1.0,1,0.19639486854741264,39
4554,3,15580,3387,12193,0,0,0,1.0,1,1.0,1,1.0,1,0.2489710880600766,38
4555,3,15583,3388,12195,0,0,0,1.0,1,1.0,1,1.0,1,0.21278033725883197,37
4556,0,15583,3388,12195,0,0,0,1.0,1,1.0,1,1.0,1,0.2524530127277339,36
4557,0,15583,3388,12195,0,0,0,1.0,1,1.0,1,1.0,1,0.19659881589679895,38
4558,1,15584,3388,12196,0,0,0,1.0,1,1.0,1,1.0,1,0.21529694804685942,39
4559,4,15588,3391,12197,0,0,0,1.0,1,1.0,1,1.0,1,0.2636127223988508,38
4560,1,15589,3391,12198,0,0,0,1.0,1,1.0,1,1.0,1,0.22674052422853003,41
4561,3,15592,3391,12201,0,0,0,1.0,1,1.0,1,1.0,1,0.15226109570977187,41
4562,1,15593,3391,12202,0,0,0,1.0,1,1.0,1,1.0,1,0.14858287557713132,43
4563,0,15593,3391,12202,0,0,0,1.0,1,1.0,1,1.0,1,0.16791848708195695,42
4564,1,15594,3391,12203,0,0,0,1.0,1,1.0,1,1.0,1,0.16980280843022247,43
4565,2,15596,3391,12205,0,0,0,1.0,1,1.0,1,1.0,1,0.16747475098518583,44
4566,3,15599,3391,12208,0,0,0,1.0,1,1.0,1,1.0,1,0.1396432982516496,45
4567,6,15605,3393,12212,0,0,0,1.0,1,1.0,1,1.0,1,0.1310547969264952,47
4568,3,15608,3393,12215,0,0,0,1.0,1,1.0,1,1.0,1,0.14927545728186037,47
4569,7,15615,3395,12220,0,0,0,1.0,1,1.0,1,1.0,1,0.13647241057706624,49
4570,4,15619,3395,12224,0,0,0,1.0,1,1.0,1,1.0,1,0.12519066291771186,49
4571,4,15623,3397,12226,0,0,0,1.0,1,1.0,1,1.0,1,0.19409163345600516,48
4572,6,15629,3397,12232,0,0,0,1.0,1,1.0,1,1.0,1,0.20049189190768188,48
4573,2,15631,3397,12234,0,0,0,1.0,1,1.0,1,1.0,1,0.17951444535077382,48
4574,4,15635,3397,12238,0,0,0,1.0,1,1.0,1,1.0,1,0.20135372048551178,50
4575,5,15640,3399,12241,0,0,0,1.0,1,1.0,1,1.0,1,0.19046548536293945,51
4576,2,15642,3399,12243,0,0,0,1.0,1,1.0,1,1.0,1,0.15247564640138478,48
4577,0,15642,3399,12243,0,0,0,1.0,1,1.0,1,1.0,1,0.1581499185969166,47
4578,1,15643,3399,12244,0,0,0,1.0,1,1.0,1,1.0,1,0.15752333777720834,46
4579,2,15645,3399,12246,0,0,0,1.0,1,1.0,1,1.0,1,0.17047366815276663,46
4580,1,15646,3399,12247,0,0,0,1.0,1,1.0,1,1.0,1,0.15846447061755023,47
4581,0,15646,3399,12247,0,0,0,1.0,1,1.0,1,1.0,1,0.15846447061755023,47
4582,1,15647,3399,12248,0,0,0,1.0,1,1.0,1,1.0,1,0.14959456579741603,48
4583,0,15647,3399,12248,0,0,0,1.0,1,1.0,1,1.0,1,0.14959456579741603,48
4584,0,15647,3399,12248,0,0,0,1.0,1,1.0,1,1.0,1,0.167052503790893,50
4585,1,15648,3400,12248,0,0,0,1.0,1,1.0,1,1.0,1,0.17411403801005296,50
4586,0,15648,3400,12248,0,0,0,1.0,1,1.0,1,1.0,1,0.17411403801005296,50
4587,0,15648,3400,12248,0,0,0,1.0,1,1.0,1,1.0,1,0.17411403801005296,50
4588,0,15648,3400,12248,0,0,0,1.0,1,1.0,1,1.0,1,0.17411403801005296,50
4589,2,15650,3401,12249,0,0,0,1.0,1,1.0,1,1.0,1,0.19474280319131773,52
4590,0,15650,3401,12249,0,0,0,1.0,1,1.0,1,1.0,1,0.19474280319131773,52
4591,2,15652,3401,12251,0,0,0,1.0,1,1.0,1,1.0,1,0.1914770241112229,53
4592,2,15654,3401,12253,0,0,0,1.0,1,1.0,1,1.0,1,0.17802441133658173,54
4593,3,15657,3403,12254,0,0,0,1.0,1,1.0,1,1.0,1,0.16107668548607623,56
4594,2,15659,3403,12256,0,0,0,1.0,1,1.0,1,1.0,1,0.14006000487833448,57
4595,0,15659,3403,12256,0,0,0,1.0,1,1.0,1,1.0,1,0.13133134491640283,56
4596,2,15661,3403,12258,0,0,0,1.0,1,1.0,1,1.0,1,0.11953385319239455,56
4597,1,15662,3404,12258,0,0,0,1.0,1,1.0,1,1.0,1,0.12263225129208145,56
4598,6,15668,3407,12261,0,0,0,1.0,1,1.0,1,1.0,1,0.16881501699216178,57
4599,2,15670,3407,12263,0,0,0,1.0,1,1.0,1,1.0,1,0.17121385480550363,59
4600,5,15675,3407,12268,0,0,0,1.0,1,1.0,1,1.0,1,0.16718708728012216,60
4601,6,15681,3409,12272,0,0,0,1.0,1,1.0,1,1.0,1,0.22017249938965808,60
4602,4,15685,3409,12276,0,0,0,1.0,1,1.0,1,1.0,1,0.17366023357193866,62
4603,4,15689,3409,12280,0,0,0,1.0,1,1.0,1,1.0,1,0.18252761558975036,62
4604,4,15693,3409,12284,0,0,0,1.0,1,1.0,1,1.0,1,0.1837314881011578,63
4605,4,15697,3409,12288,0,0,0,1.0,1,1.0,1,1.0,1,0.15278529177786565,63
4606,2,15699,3409,12290,0,0,0,1.0,1,1.0,1,1.0,1,0.14280750046538784,64
4607,3,15702,3410,12292,0,0,0,1.0,1,1.0,1,1.0,1,0.1453681946301461,65
4608,1,15703,3410,12293,0,0,0,1.0,1,1.0,1,1.0,1,0.15142710570902979,66
4609,4,15707,3411,12296,0,0,0,1.0,1,1.0,1,1.0,1,0.1639292777288767,65
4610,0,15707,3411,12296,0,0,0,1.0,1,1.0,1,1.0,1,0.1592727563603052,63
4611,2,15709,3411,12298,0,0,0,1.0,1,1.0,1,1.0,1,0.14229949272545867,64
4612,0,15709,3411,12298,0,0,0,1.0,1,1.0,1,1.0,1,0.14710219184583195,62
4613,2,15711,3413,12298,0,0,0,1.0,1,1.0,1,1.0,1,0.1461482592065681,63
4614,2,15713,3415,12298,0,0,0,1.0,1,1.0,1,1.0,1,0.15808353655215898,61
4615,1,15714,3416,12298,0,0,0,1.0,1,1.0,1,1.0,1,0.1941240318374329,59
4616,1,15715,3417,12298,0,0,0,1.0,1,1.0,1,1.0,1,0.19428529014500218,58
4617,0,15715,3417,12298,0,0,0,1.0,1,1.0,1,1.0,1,0.21363923004252539,58
4618,1,15716,3417,12299,0,0,0,1.0,1,1.0,1,1.0,1,0.21038412040479493,57
4619,2,15718,3418,12300,0,0,0,1.0,1,1.0,1,1.0,1,0.24294651088071048,57
4620,0,15718,3418,12300,0,0,0,1.0,1,1.0,1,1.0,1,0.24294651088071048,57
4621,7,15725,3419,12306,0,0,0,1.0,1,1.0,1,1.0,1,0.16108458172678328,59
4622,4,15729,3419,12310,0,0,0,1.0,1,1.0,1,1.0,1,0.15270833995385794,60
4623,3,15732,3419,12313,0,0,0,1.0,1,1.0,1,1.0,1,0.16255426059153785,59
4624,4,15736,3421,12315,0,0,0,1.0,1,1.0,1,1.0,1,0.15342887033009506,59
4625,3,15739,3422,12317,0,0,0,1.0,1,1.0,1,1.0,1,0.15718932228304017,57
4626,4,15743,3426,12317,0,0,0,1.0,1,1.0,1,1.0,1,0.220633221139988,56
4627,3,15746,3427,12319,0,0,0,1.0,1,1.0,1,1.0,1,0.21830684498257635,56
4628,4,15750,3427,12323,0,0,0,1.0,1,1.0,1,1.0,1,0.23442833693261095,56
4629,1,15751,3427,12324,0,0,0,1.0,1,1.0,1,1.0,1,0.25161958841278287,56
4630,2,15753,3428,12325,0,0,0,1.0,1,1.0,1,1.0,1,0.24222285258116488,57
4631,3,15756,3429,12327,0,0,0,1.0,1,1.0,1,1.0,1,0.25982077373361895,56
4632,1,15757,3430,12327,0,0,0,1.0,1,1.0,1,1.0,1,0.30053604884757806,57
4633,2,15759,3430,12329,0,0,0,1.0,1,1.0,1,1.0,1,0.28523946419117713,58
4634,0,15759,3430,12329,0,0,0,1.0,1,1.0,1,1.0,1,0.28523946419117713,58
4635,4,15763,3430,12333,0,0,0,1.0,1,1.0,1,1.0,1,0.23238455952636627,59
4636,7,15770,3430,12340,0,0,0,1.0,1,1.0,1,1.0,1,0.15952583974103335,60
4637,1,15771,3430,12341,0,0,0,1.0,1,1.0,1,1.0,1,0.14836980296691712,60
4638,1,15772,3430,12342,0,0,0,1.0,1,1.0,1,1.0,1,0.15554419241791617,61
4639,4,15776,3430,12346,0,0,0,1.0,1,1.0,1,1.0,1,0.12750491427978936,62
4640,3,15779,3430,12349,0,0,0,1.0,1,1.0,1,1.0,1,0.14379014983228378,63
4641,3,15782,3432,12350,0,0,0,1.0,1,1.0,1,1.0,1,0.1542276320117086,63
4642,2,15784,3432,12352,0,0,0,1.0,1,1.0,1,1.0,1,0.14927787963173475,62
4643,3,15787,3434,12353,0,0,0,1.0,1,1.0,1,1.0,1,0.17316078073820845,63
4644,4,15791,3435,12356,0,0,0,1.0,1,1.0,1,1.0,1,0.1616694817401125,62
4645,5,15796,3436,12360,0,0,0,1.0,1,1.0,1,1.0,1,0.1669204849018593,63
4646,6,15802,3437,12365,0,0,0,1.0,1,1.0,1,1.0,1,0.17474869643396104,63
4647,6,15808,3439,12369,0,0,0,1.0,1,1.0,1,1.0,1,0.17877960157367215,62
4648,6,15814,3441,12373,0,0,0,1.0,1,1.0,1,1.0,1,0.22778291886255167,63
4649,5,15819,3441,12378,0,0,0,1.0,1,1.0,1,1.0,1,0.19874250562446225,61
4650,7,15826,3442,12384,0,0,0,1.0,1,1.0,1,1.0,1,0.1523902565887618,63
4651,7,15833,3443,12390,0,0,0,1.0,1,1.0,1,1.0,1,0.11863376798288441,62
4652,0,15833,3443,12390,0,0,0,1.0,1,1.0,1,1.0,1,0.1352675555206797,59
4653,3,15836,3445,12391,0,0,0,1.0,1,1.0,1,1.0,1,0.15960086164782278,60
4654,2,15838,3446,12392,0,0,0,1.0,1,1.0,1,1.0,1,0.17703283889863847,60
4655,1,15839,3446,12393,0,0,0,1.0,1,1.0,1,1.0,1,0.1618073349610107,60
4656,7,15846,3448,12398,0,0,0,1.0,1,1.0,1,1.0,1,0.2170929604864217,61
4657,4,15850,3448,12402,0,0,0,1.0,1,1.0,1,1.0,1,0.20931525068100587,62
4658,5,15855,3449,12406,0,0,0,1.0,1,1.0,1,1.0,1,0.20516771381744847,62
4659,4,15859,3450,12409,0,0,0,1.0,1,1.0,1,1.0,1,0.234749936934678,61
4660,7,15866,3451,12415,0,0,0,1.0,1,1.0,1,1.0,1,0.258108952887071,61
4661,6,15872,3451,12421,0,0,0,1.0,1,1.0,1,1.0,1,0.27098697669566163,61
4662,6,15878,3452,12426,0,0,0,1.0,1,1.0,1,1.0,1,0.2627865341316064,62
4663,5,15883,3452,12431,0,0,0,1.0,1,1.0,1,1.0,1,0.19980671704233116,61
4664,3,15886,3453,12433,0,0,0,1.0,1,1.0,1,1.0,1,0.20923525792818806,62
4665,5,15891,3455,12436,0,0,0,1.0,1,1.0,1,1.0,1,0.20960417110960508,61
4666,9,15900,3456,12444,0,0,0,1.0,1,1.0,1,1.0,1,0.11760930491049496,61
4667,1,15901,3456,12445,0,0,0,1.0,1,1.0,1,1.0,1,0.13780286235264416,59
4668,2,15903,3458,12445,0,0,0,1.0,1,1.0,1,1.0,1,0.12648264755232178,59
4669,0,15903,3458,12445,0,0,0,1.0,1,1.0,1,1.0,1,0.14527064711220516,58
4670,3,15906,3461,12445,0,0,0,1.0,1,1.0,1,1.0,1,0.14802975009748495,57
4671,0,15906,3461,12445,0,0,0,1.0,1,1.0,1,1.0,1,0.1525634159042225,55
4672,3,15909,3462,12447,0,0,0,1.0,1,1.0,1,1.0,1,0.16034004950072944,56
4673,2,15911,3463,12448,0,0,0,1.0,1,1.0,1,1.0,1,0.12854891891108386,58
4674,5,15916,3465,12451,0,0,0,1.0,1,1.0,1,1.0,1,0.15308324260141296,58
4675,3,15919,3465,12454,0,0,0,1.0,1,1.0,1,1.0,1,0.17527350913344958,57
4676,2,15921,3466,12455,0,0,0,1.0,1,1.0,1,1.0,1,0.1959690232953001,58
4677,1,15922,3466,12456,0,0,0,1.0,1,1.0,1,1.0,1,0.19918924648392144,57
4678,2,15924,3468,12456,0,0,0,1.0,1,1.0,1,1.0,1,0.1935188324153306,57
4679,0,15924,3468,12456,0,0,0,1.0,1,1.0,1,1.0,1,0.1935188324153306,57
4680,1,15925,3469,12456,0,0,0,1.0,1,1.0,1,1.0,1,0.18651073482245772,59
4681,6,15931,3470,12461,0,0,0,1.0,1,1.0,1,1.0,1,0.14736710211699186,60
4682,2,15933,3471,12462,0,0,0,1.0,1,1.0,1,1.0,1,0.17543541258126163,60
4683,4,15937,3472,12465,0,0,0,1.0,1,1.0,1,1.0,1,0.18003553964135674,60
4684,5,15942,3474,12468,0,0,0,1.0,1,1.0,1,1.0,1,0.19251077377368317,60
4685,5,15947,3476,12471,0,0,0,1.0,1,1.0,1,1.0,1,0.20929544624597907,59
4686,11,15958,3479,12479,0,0,0,1.0,1,1.0,1,1.0,1,0.24406415611287943,60
4687,6,15964,3480,12484,0,0,0,1.0,1,1.0,1,1.0,1,0.269345523252069,59
4688,5,15969,3481,12488,0,0,0,1.0,1,1.0,1,1.0,1,0.2463604616929248,59
4689,4,15973,3481,12492,0,0,0,1.0,1,1.0,1,1.0,1,0.24782957478088485,59
4690,5,15978,3481,12497,0,0,0,1.0,1,1.0,1,1.0,1,0.23066935424694177,58
4691,3,15981,3482,12499,0,0,0,1.0,1,1.0,1,1.0,1,0.22583539391591798,57
4692,3,15984,3482,12502,0,0,0,1.0,1,1.0,1,1.0,1,0.21196205818329125,58
4693,1,15985,3482,12503,0,0,0,1.0,1,1.0,1,1.0,1,0.22486443685473403,57
4694,3,15988,3483,12505,0,0,0,1.0,1,1.0,1,1.0,1,0.24455219298501463,57
4695,3,15991,3484,12507,0,0,0,1.0,1,1.0,1,1.0,1,0.2539086918315385,56
4696,6,15997,3485,12512,0,0,0,1.0,1,1.0,1,1.0,1,0.20157093729871844,57
4697,2,15999,3485,12514,0,0,0,1.0,1,1.0,1,1.0,1,0.1895406377690915,58
4698,2,16001,3485,12516,0,0,0,1.0,1,1.0,1,1.0,1,0.156385975099844,59
4699,3,16004,3486,12518,0,0,0,1.0,1,1.0,1,1.0,1,0.20050400983327207,58
4700,2,16006,3486,12520,0,0,0,1.0,1,1.0,1,1.0,1,0.15095645753730372,59
4701,1,16007,3486,12521,0,0,0,1.0,1,1.0,1,1.0,1,0.16177270838367344,60
4702,3,16010,3487,12523,0,0,0,1.0,1,1.0,1,1.0,1,0.14946121601395446,61
4703,5,16015,3489,12526,0,0,0,1.0,1,1.0,1,1.0,1,0.12511319989659306,59
4704,0,16015,3489,12526,0,0,0,1.0,1,1.0,1,1.0,1,0.11377874368303195,58
4705,2,16017,3490,12527,0,0,0,1.0,1,1.0,1,1.0,1,0.13661723273828105,58
4706,6,16023,3493,12530,0,0,0,1.0,1,1.0,1,1.0,1,0.1610767135669311,60
4707,3,16026,3494,12532,0,0,0,1.0,1,1.0,1,1.0,1,0.1970759734683623,57
4708,7,16033,3496,12537,0,0,0,1.0,1,1.0,1,1.0,1,0.22242283846363858,57
4709,4,16037,3498,12539,0,0,0,1.0,1,1.0,1,1.0,1,0.20800792979553404,55
4710,2,16039,3499,12540,0,0,0,1.0,1,1.0,1,1.0,1,0.24166991302290702,53
4711,8,16047,3501,12546,0,0,0,1.0,1,1.0,1,1.0,1,0.13887010107525982,52
4712,4,16051,3504,12547,0,0,0,1.0,1,1.0,1,1.0,1,0.1711898808154621,52
4713,4,16055,3505,12550,0,0,0,1.0,1,1.0,1,1.0,1,0.19288042590264545,51
4714,2,16057,3505,12552,0,0,0,1.0,1,1.0,1,1.0,1,0.1635464272870854,50
4715,4,16061,3506,12555,0,0,0,1.0,1,1.0,1,1.0,1,0.1786193911638107,50
4716,1,16062,3507,12555,0,0,0,1.0,1,1.0,1,1.0,1,0.1838692021501489,49
4717,2,16064,3508,12556,0,0,0,1.0,1,1.0,1,1.0,1,0.19694260684779333,49
4718,1,16065,3508,12557,0,0,0,1.0,1,1.0,1,1.0,1,0.19782738740640446,50
4719,1,16066,3508,12558,0,0,0,1.0,1,1.0,1,1.0,1,0.18630782087123277,49
4720,0,16066,3508,12558,0,0,0,1.0,1,1.0,1,1.0,1,0.18630782087123277,49
4721,1,16067,3509,12558,0,0,0,1.0,1,1.0,1,1.0,1,0.16573133887381974,50
4722,8,16075,3510,12565,0,0,0,1.0,1,1.0,1,1.0,1,0.1843613027399527,51
4723,3,16078,3510,12568,0,0,0,1.0,1,1.0,1,1.0,1,0.15666954997284063,50
4724,2,16080,3510,12570,0,0,0,1.0,1,1.0,1,1.0,1,0.14152836176774408,50
4725,1,16081,3510,12571,0,0,0,1.0,1,1.0,1,1.0,1,0.1607611795754223,52
4726,3,16084,3511,12573,0,0,0,1.0,1,1.0,1,1.0,1,0.13513026215076948,51
4727,0,16084,3511,12573,0,0,0,1.0,1,1.0,1,1.0,1,0.14973781006169776,52
4728,0,16084,3511,12573,0,0,0,1.0,1,1.0,1,1.0,1,0.14973781006169776,52
4729,5,16089,3513,12576,0,0,0,1.0,1,1.0,1,1.0,1,0.18233551541387355,52
4730,4,16093,3513,12580,0,0,0,1.0,1,1.0,1,1.0,1,0.20050473592964366,50
4731,6,16099,3514,12585,0,0,0,1.0,1,1.0,1,1.0,1,0.21059477863646892,51
4732,5,16104,3516,12588,0,0,0,1.0,1,1.0,1,1.0,1,0.23734011083012213,52
4733,6,16110,3516,12594,0,0,0,1.0,1,1.0,1,1.0,1,0.2358879097886732,53
4734,7,16117,3517,12600,0,0,0,1.0,1,1.0,1,1.0,1,0.26514929880431476,53
4735,8,16125,3518,12607,0,0,0,1.0,1,1.0,1,1.0,1,0.29821868576578003,53
4736,12,16137,3519,12618,0,0,0,1.0,1,1.0,1,1.0,1,0.32329887830057613,55
4737,12,16149,3519,12630,0,0,0,1.0,1,1.0,1,1.0,1,0.3054463534651272,57
4738,8,16157,3519,12638,0,0,0,1.0,1,1.0,1,1.0,1,0.2995180901201011,57
4739,8,16165,3519,12646,0,0,0,1.0,1,1.0,1,1.0,1,0.30079982323147086,57
4740,9,16174,3519,12655,0,0,0,1.0,1,1.0,1,1.0,1,0.28375297498644814,57
4741,11,16185,3519,12666,0,0,0,1.0,1,1.0,1,1.0,1,0.19818392734106774,58
4742,2,16187,3520,12667,0,0,0,1.0,1,1.0,1,1.0,1,0.1974716983826542,58
4743,4,16191,3520,12671,0,0,0,1.0,1,1.0,1,1.0,1,0.1367209013671096,56
4744,4,16195,3522,12673,0,0,0,1.0,1,1.0,1,1.0,1,0.1464327261667708,57
4745,3,16198,3522,12676,0,0,0,1.0,1,1.0,1,1.0,1,0.11648569982342573,56
4746,3,16201,3522,12679,0,0,0,1.0,1,1.0,1,1.0,1,0.13620038314968533,56
4747,3,16204,3523,12681,0,0,0,1.0,1,1.0,1,1.0,1,0.09920485406578929,55
4748,4,16208,3524,12684,0,0,0,1.0,1,1.0,1,1.0,1,0.10176549068899249,55
4749,5,16213,3526,12687,0,0,0,1.0,1,1.0,1,1.0,1,0.06840882131781567,54
4750,2,16215,3527,12688,0,0,0,1.0,1,1.0,1,1.0,1,0.11115962834688746,53
4751,4,16219,3529,12690,0,0,0,1.0,1,1.0,1,1.0,1,0.16098377784643844,53
4752,2,16221,3529,12692,0,0,0,1.0,1,1.0,1,1.0,1,0.12842292128815322,53
4753,6,16227,3530,12697,0,0,0,1.0,1,1.0,1,1.0,1,0.1508394703932638,52
4754,2,16229,3530,12699,0,0,0,1.0,1,1.0,1,1.0,1,0.16474118260257478,52
4755,3,16232,3530,12702,0,0,0,1.0,1,1.0,1,1.0,1,0.15537124492917856,51
4756,8,16240,3531,12709,0,0,0,1.0,1,1.0,1,1.0,1,0.0877848633324799,52
4757,3,16243,3531,12712,0,0,0,1.0,1,1.0,1,1.0,1,0.09395679997776808,51
4758,2,16245,3531,12714,0,0,0,1.0,1,1.0,1,1.0,1,0.09390879822306601,51
4759,2,16247,3532,12715,0,0,0,1.0,1,1.0,1,1.0,1,0.1055118131769964,51
4760,2,16249,3532,12717,0,0,0,1.0,1,1.0,1,1.0,1,0.10847346125793225,52
4761,6,16255,3535,12720,0,0,0,1.0,1,1.0,1,1.0,1,0.18684504222065282,50
4762,7,16262,3537,12725,0,0,0,1.0,1,1.0,1,1.0,1,0.2579423799058976,51
4763,5,16267,3537,12730,0,0,0,1.0,1,1.0,1,1.0,1,0.226893649871663,51
4764,5,16272,3538,12734,0,0,0,1.0,1,1.0,1,1.0,1,0.18107641735400054,53
4765,7,16279,3539,12740,0,0,0,1.0,1,1.0,1,1.0,1,0.16845857900602676,53
4766,5,16284,3539,12745,0,0,0,1.0,1,1.0,1,1.0,1,0.1764428202900752,55
4767,8,16292,3540,12752,0,0,0,1.0,1,1.0,1,1.0,1,0.17769336585091094,56
4768,5,16297,3540,12757,0,0,0,1.0,1,1.0,1,1.0,1,0.16387969500437982,56
4769,11,16308,3540,12768,0,0,0,1.0,1,1.0,1,1.0,1,0.15866603729679365,56
4770,6,16314,3540,12774,0,0,0,1.0,1,1.0,1,1.0,1,0.17968868993648895,56
4771,7,16321,3540,12781,0,0,0,1.0,1,1.0,1,1.0,1,0.09123421359544645,55
4772,2,16323,3540,12783,0,0,0,1.0,1,1.0,1,1.0,1,0.11169626372285069,56
4773,3,16326,3540,12786,0,0,0,1.0,1,1.0,1,1.0,1,0.10103732603784885,56
4774,2,16328,3540,12788,0,0,0,1.0,1,1.0,1,1.0,1,0.07553214595573234,58
4775,3,16331,3541,12790,0,0,0,1.0,1,1.0,1,1.0,1,0.0685747955665731,59
4776,1,16332,3541,12791,0,0,0,1.0,1,1.0,1,1.0,1,0.06247160275178003,59
4777,2,16334,3541,12793,0,0,0,1.0,1,1.0,1,1.0,1,0.07335371639163675,60
4778,3,16337,3541,12796,0,0,0,1.0,1,1.0,1,1.0,1,0.06285330355189991,60
4779,7,16344,3541,12803,0,0,0,1.0,1,1.0,1,1.0,1,0.042231108414327166,61
4780,6,16350,3541,12809,0,0,0,1.0,1,1.0,1,1.0,1,0.07581928769464816,63
4781,3,16353,3542,12811,0,0,0,1.0,1,1.0,1,1.0,1,0.1004650521920463,62
4782,3,16356,3543,12813,0,0,0,1.0,1,1.0,1,1.0,1,0.136051022252421,63
4783,4,16360,3544,12816,0,0,0,1.0,1,1.0,1,1.0,1,0.1170429525480473,62
4784,9,16369,3547,12822,0,0,0,1.0,1,1.0,1,1.0,1,0.09908591753231594,62
4785,11,16380,3548,12832,0,0,0,1.0,1,1.0,1,1.0,1,0.11255526852575404,62
4786,7,16387,3550,12837,0,0,0,1.0,1,1.0,1,1.0,1,0.11420462996031877,63
4787,7,16394,3552,12842,0,0,0,1.0,1,1.0,1,1.0,1,0.16068603184140537,62
4788,10,16404,3555,12849,0,0,0,1.0,1,1.0,1,1.0,1,0.17697729695244485,62
4789,5,16409,3555,12854,0,0,0,1.0,1,1.0,1,1.0,1,0.12053583257149904,60
4790,6,16415,3556,12859,0,0,0,1.0,1,1.0,1,1.0,1,0.15695727362737313,61
4791,7,16422,3558,12864,0,0,0,1.0,1,1.0,1,1.0,1,0.14288343139681106,60
4792,9,16431,3560,12871,0,0,0,1.0,1,1.0,1,1.0,1,0.12748356713530176,60
4793,6,16437,3562,12875,0,0,0,1.0,1,1.0,1,1.0,1,0.1557617729886012,61
4794,9,16446,3564,12882,0,0,0,1.0,1,1.0,1,1.0,1,0.1906986037924681,59
4795,11,16457,3565,12892,0,0,0,1.0,1,1.0,1,1.0,1,0.13993023372622193,61
4796,6,16463,3566,12897,0,0,0,1.0,1,1.0,1,1.0,1,0.16443094968511104,59
4797,7,16470,3566,12904,0,0,0,1.0,1,1.0,1,1.0,1,0.19471805647677976,58
4798,7,16477,3567,12910,0,0,0,1.0,1,1.0,1,1.0,1,0.2275072355879881,59
4799,10,16487,3568,12919,0,0,0,1.0,1,1.0,1,1.0,1,0.2185004695146416,57
4800,9,16496,3569,12927,0,0,0,1.0,1,1.0,1,1.0,1,0.2106504342674831,58
4801,10,16506,3570,12936,0,0,0,1.0,1,1.0,1,1.0,1,0.09560363113303431,57
4802,5,16511,3571,12940,0,0,0,1.0,1,1.0,1,1.0,1,0.12442187347586833,57
4803,4,16515,3572,12943,0,0,0,1.0,1,1.0,1,1.0,1,0.09726638337854458,56
4804,2,16517,3572,12945,0,0,0,1.0,1,1.0,1,1.0,1,0.07846108965856245,54
4805,2,16519,3572,12947,0,0,0,1.0,1,1.0,1,1.0,1,0.10121220410507901,56
4806,1,16520,3572,12948,0,0,0,1.0,1,1.0,1,1.0,1,0.1346745808323268,55
4807,1,16521,3572,12949,0,0,0,1.0,1,1.0,1,1.0,1,0.1083968356715408,54
4808,5,16526,3572,12954,0,0,0,1.0,1,1.0,1,1.0,1,0.1294372101121627,53
4809,7,16533,3573,12960,0,0,0,1.0,1,1.0,1,1.0,1,0.10988933982524268,53
4810,5,16538,3574,12964,0,0,0,1.0,1,1.0,1,1.0,1,0.13819910175868305,51
4811,2,16540,3574,12966,0,0,0,1.0,1,1.0,1,1.0,1,0.11468115088504474,52
4812,4,16544,3574,12970,0,0,0,1.0,1,1.0,1,1.0,1,0.13760212504381578,52
4813,4,16548,3574,12974,0,0,0,1.0,1,1.0,1,1.0,1,0.1389978164886041,52
4814,6,16554,3577,12977,0,0,0,1.0,1,1.0,1,1.0,1,0.1615926996517584,53
4815,9,16563,3582,12981,0,0,0,1.0,1,1.0,1,1.0,1,0.15322991297103103,54
4816,5,16568,3583,12985,0,0,0,1.0,1,1.0,1,1.0,1,0.10483963441301897,54
4817,3,16571,3585,12986,0,0,0,1.0,1,1.0,1,1.0,1,0.08717541453840301,55
4818,4,16575,3586,12989,0,0,0,1.0,1,1.0,1,1.0,1,0.07814253617857402,55
4819,2,16577,3588,12989,0,0,0,1.0,1,1.0,1,1.0,1,0.08440157265503383,55
4820,1,16578,3588,12990,0,0,0,1.0,1,1.0,1,1.0,1,0.08551340892677883,55
4821,3,16581,3590,12991,0,0,0,1.0,1,1.0,1,1.0,1,0.13345117864436337,55
4822,1,16582,3590,12992,0,0,0,1.0,1,1.0,1,1.0,1,0.1276344416245294,54
4823,1,16583,3591,12992,0,0,0,1.0,1,1.0,1,1.0,1,0.13635978255271883,54
4824,3,16586,3592,12994,0,0,0,1.0,1,1.0,1,1.0,1,0.1378497147243134,55
4825,3,16589,3595,12994,0,0,0,1.0,1,1.0,1,1.0,1,0.20662301139439038,53
4826,8,16597,3598,12999,0,0,0,1.0,1,1.0,1,1.0,1,0.13542079118360423,54
4827,9,16606,3599,13007,0,0,0,1.0,1,1.0,1,1.0,1,0.17210434776335745,53
4828,6,16612,3601,13011,0,0,0,1.0,1,1.0,1,1.0,1,0.13859826342036424,54
4829,2,16614,3601,13013,0,0,0,1.0,1,1.0,1,1.0,1,0.1412480275245578,54
4830,5,16619,3602,13017,0,0,0,1.0,1,1.0,1,1.0,1,0.1736583943268938,53
4831,6,16625,3604,13021,0,0,0,1.0,1,1.0,1,1.0,1,0.12455150232878745,52
4832,0,16625,3604,13021,0,0,0,1.0,1,1.0,1,1.0,1,0.1261089814666986,50
4833,0,16625,3604,13021,0,0,0,1.0,1,1.0,1,1.0,1,0.13768577118727773,51
4834,2,16627,3606,13021,0,0,0,1.0,1,1.0,1,1.0,1,0.20297421778995275,51
4835,1,16628,3606,13022,0,0,0,1.0,1,1.0,1,1.0,1,0.18147616239847766,50
4836,2,16630,3607,13023,0,0,0,1.0,1,1.0,1,1.0,1,0.21211339254891187,50
4837,2,16632,3608,13024,0,0,0,1.0,1,1.0,1,1.0,1,0.22536665001347886,46
4838,4,16636,3611,13025,0,0,0,1.0,1,1.0,1,1.0,1,0.24192889061171546,47
4839,3,16639,3612,13027,0,0,0,1.0,1,1.0,1,1.0,1,0.2496461065423495,45
4840,1,16640,3613,13027,0,0,0,1.0,1,1.0,1,1.0,1,0.25613301083116835,45
4841,2,16642,3614,13028,0,0,0,1.0,1,1.0,1,1.0,1,0.22632807405768846,43
4842,0,16642,3614,13028,0,0,0,1.0,1,1.0,1,1.0,1,0.20832335339139207,43
4843,1,16643,3615,13028,0,0,0,1.0,1,1.0,1,1.0,1,0.215253970029925,44
4844,0,16643,3615,13028,0,0,0,1.0,1,1.0,1,1.0,1,0.21620608772839525,43
4845,3,16646,3618,13028,0,0,0,1.0,1,1.0,1,1.0,1,0.28997000799937184,44
4846,7,16653,3618,13035,0,0,0,1.0,1,1.0,1,1.0,1,0.16606487822564037,43
4847,2,16655,3619,13036,0,0,0,1.0,1,1.0,1,1.0,1,0.15529147627306306,42
4848,3,16658,3621,13037,0,0,0,1.0,1,1.0,1,1.0,1,0.19141578363731265,41
4849,1,16659,3622,13037,0,0,0,1.0,1,1.0,1,1.0,1,0.15981824454371485,41
4850,0,16659,3622,13037,0,0,0,1.0,1,1.0,1,1.0,1,0.1849503046041847,41
4851,0,16659,3622,13037,0,0,0,1.0,1,1.0,1,1.0,1,0.1849503046041847,41
4852,3,16662,3622,13040,0,0,0,1.0,1,1.0,1,1.0,1,0.18550645718324432,43
4853,2,16664,3624,13040,0,0,0,1.0,1,1.0,1,1.0,1,0.21834274057553663,44
4854,9,16673,3624,13049,0,0,0,1.0,1,1.0,1,1.0,1,0.20930628823064623,45
4855,4,16677,3624,13053,0,0,0,1.0,1,1.0,1,1.0,1,0.2096203909941222,44
4856,3,16680,3625,13055,0,0,0,1.0,1,1.0,1,1.0,1,0.19311803428737964,44
4857,2,16682,3625,13057,0,0,0,1.0,1,1.0,1,1.0,1,0.21922204995760763,44
4858,4,16686,3625,13061,0,0,0,1.0,1,1.0,1,1.0,1,0.23652304670201957,45
4859,6,16692,3625,13067,0,0,0,1.0,1,1.0,1,1.0,1,0.2486408909338387,46
4860,7,16699,3625,13074,0,0,0,1.0,1,1.0,1,1.0,1,0.19504835558973416,46
4861,3,16702,3625,13077,0,0,0,1.0,1,1.0,1,1.0,1,0.11724589339909758,46
4862,1,16703,3625,13078,0,0,0,1.0,1,1.0,1,1.0,1,0.10597162108304924,47
4863,4,16707,3625,13082,0,0,0,1.0,1,1.0,1,1.0,1,0.10213586678205029,47
4864,0,16707,3625,13082,0,0,0,1.0,1,1.0,1,1.0,1,0.10189786846659296,47
4865,3,16710,3625,13085,0,0,0,1.0,1,1.0,1,1.0,1,0.09146984287175465,48
4866,1,16711,3625,13086,0,0,0,1.0,1,1.0,1,1.0,1,0.08688434842959569,49
4867,2,16713,3625,13088,0,0,0,1.0,1,1.0,1,1.0,1,0.09423288894583684,50
4868,3,16716,3625,13091,0,0,0,1.0,1,1.0,1,1.0,1,0.12328630100560611,50
4869,2,16718,3625,13093,0,0,0,1.0,1,1.0,1,1.0,1,0.13507106535057872,50
4870,10,16728,3628,13100,0,0,0,1.0,1,1.0,1,1.0,1,0.17350295948069333,52
4871,5,16733,3628,13105,0,0,0,1.0,1,1.0,1,1.0,1,0.16451794504572262,52
4872,4,16737,3628,13109,0,0,0,1.0,1,1.0,1,1.0,1,0.08897018942573537,53
4873,5,16742,3629,13113,0,0,0,1.0,1,1.0,1,1.0,1,0.1388304021990023,55
4874,1,16743,3629,13114,0,0,0,1.0,1,1.0,1,1.0,1,0.13104852767694752,56
4875,11,16754,3630,13124,0,0,0,1.0,1,1.0,1,1.0,1,0.1608855177928323,55
4876,8,16762,3632,13130,0,0,0,1.0,1,1.0,1,1.0,1,0.13347442600256465,55
4877,2,16764,3633,13131,0,0,0,1.0,1,1.0,1,1.0,1,0.1350646075270261,54
4878,2,16766,3633,13133,0,0,0,1.0,1,1.0,1,1.0,1,0.12597449670707758,53
4879,2,16768,3634,13134,0,0,0,1.0,1,1.0,1,1.0,1,0.17499060757684004,54
4880,4,16772,3634,13138,0,0,0,1.0,1,1.0,1,1.0,1,0.18108934344442335,54
4881,5,16777,3635,13142,0,0,0,1.0,1,1.0,1,1.0,1,0.1654502236686734,53
4882,3,16780,3637,13143,0,0,0,1.0,1,1.0,1,1.0,1,0.19660322793899174,53
4883,3,16783,3638,13145,0,0,0,1.0,1,1.0,1,1.0,1,0.2192940646039327,53
4884,4,16787,3639,13148,0,0,0,1.0,1,1.0,1,1.0,1,0.2271709953524407,51
4885,0,16787,3639,13148,0,0,0,1.0,1,1.0,1,1.0,1,0.21996855398006432,50
4886,0,16787,3639,13148,0,0,0,1.0,1,1.0,1,1.0,1,0.223057080083863,48
4887,0,16787,3639,13148,0,0,0,1.0,1,1.0,1,1.0,1,0.223057080083863,48
4888,1,16788,3640,13148,0,0,0,1.0,1,1.0,1,1.0,1,0.2486330330300601,48
4889,3,16791,3640,13151,0,0,0,1.0,1,1.0,1,1.0,1,0.2579862116109139,48
4890,3,16794,3640,13154,0,0,0,1.0,1,1.0,1,1.0,1,0.2496104573121404,49
4891,7,16801,3641,13160,0,0,0,1.0,1,1.0,1,1.0,1,0.18947062693255068,50
4892,3,16804,3641,13163,0,0,0,1.0,1,1.0,1,1.0,1,0.17292311850131706,49
4893,3,16807,3641,13166,0,0,0,1.0,1,1.0,1,1.0,1,0.15047421969135372,50
4894,1,16808,3641,13167,0,0,0,1.0,1,1.0,1,1.0,1,0.1312294149145008,51
4895,0,16808,3641,13167,0,0,0,1.0,1,1.0,1,1.0,1,0.12284535575919821,52
4896,4,16812,3641,13171,0,0,0,1.0,1,1.0,1,1.0,1,0.14292529127288536,53
4897,3,16815,3641,13174,0,0,0,1.0,1,1.0,1,1.0,1,0.10832957117590661,53
4898,1,16816,3641,13175,0,0,0,1.0,1,1.0,1,1.0,1,0.11941222867894417,53
4899,3,16819,3642,13177,0,0,0,1.0,1,1.0,1,1.0,1,0.07586794450091276,55
4900,2,16821,3643,13178,0,0,0,1.0,1,1.0,1,1.0,1,0.11943309187676061,55
4901,3,16824,3644,13180,0,0,0,1.0,1,1.0,1,1.0,1,0.09049065616503925,56
4902,4,16828,3645,13183,0,0,0,1.0,1,1.0,1,1.0,1,0.12472845176622814,58
4903,4,16832,3646,13186,0,0,0,1.0,1,1.0,1,1.0,1,0.13168962057212796,58
4904,11,16843,3648,13195,0,0,0,1.0,1,1.0,1,1.0,1,0.12957248230707719,57
4905,7,16850,3649,13201,0,0,0,1.0,1,1.0,1,1.0,1,0.17460654005173826,54
4906,3,16853,3650,13203,0,0,0,1.0,1,1.0,1,1.0,1,0.16496170696576878,55
4907,1,16854,3650,13204,0,0,0,1.0,1,1.0,1,1.0,1,0.16517311887741018,52
4908,4,16858,3652,13206,0,0,0,1.0,1,1.0,1,1.0,1,0.17390794370845067,53
4909,0,16858,3652,13206,0,0,0,1.0,1,1.0,1,1.0,1,0.17933293306658207,52
4910,2,16860,3652,13208,0,0,0,1.0,1,1.0,1,1.0,1,0.1777814570173793,53
4911,2,16862,3652,13210,0,0,0,1.0,1,1.0,1,1.0,1,0.19045883957352336,55
4912,1,16863,3652,13211,0,0,0,1.0,1,1.0,1,1.0,1,0.1721693600288533,54
4913,1,16864,3652,13212,0,0,0,1.0,1,1.0,1,1.0,1,0.1551568807901757,53
4914,2,16866,3653,13213,0,0,0,1.0,1,1.0,1,1.0,1,0.13822214898208998,53
4915,3,16869,3655,13214,0,0,0,1.0,1,1.0,1,1.0,1,0.13316658901388922,54
4916,7,16876,3656,13220,0,0,0,1.0,1,1.0,1,1.0,1,0.09542155141871667,52
4917,1,16877,3657,13220,0,0,0,1.0,1,1.0,1,1.0,1,0.1264031983313477,52
4918,1,16878,3658,13220,0,0,0,1.0,1,1.0,1,1.0,1,0.1643124990108532,51
4919,2,16880,3658,13222,0,0,0,1.0,1,1.0,1,1.0,1,0.16498637798976368,50
4920,2,16882,3658,13224,0,0,0,1.0,1,1.0,1,1.0,1,0.12934604920512388,51
4921,2,16884,3658,13226,0,0,0,1.0,1,1.0,1,1.0,1,0.12270212195991002,51
4922,2,16886,3659,13227,0,0,0,1.0,1,1.0,1,1.0,1,0.1428381724042095,53
4923,0,16886,3659,13227,0,0,0,1.0,1,1.0,1,1.0,1,0.1428381724042095,53
4924,2,16888,3659,13229,0,0,0,1.0,1,1.0,1,1.0,1,0.12304142126627222,55
4925,2,16890,3661,13229,0,0,0,1.0,1,1.0,1,1.0,1,0.09841120455538908,56
4926,0,16890,3661,13229,0,0,0,1.0,1,1.0,1,1.0,1,0.08380567164244083,55
4927,2,16892,3663,13229,0,0,0,1.0,1,1.0,1,1.0,1,0.108210096798329,55
4928,0,16892,3663,13229,0,0,0,1.0,1,1.0,1,1.0,1,0.108210096798329,55
4929,1,16893,3663,13230,0,0,0,1.0,1,1.0,1,1.0,1,0.0908446131747958,56
4930,4,16897,3665,13232,0,0,0,1.0,1,1.0,1,1.0,1,0.11593498806788079,58
4931,2,16899,3665,13234,0,0,0,1.0,1,1.0,1,1.0,1,0.126344855789648,59
4932,4,16903,3666,13237,0,0,0,1.0,1,1.0,1,1.0,1,0.14738008049843848,60
4933,4,16907,3666,13241,0,0,0,1.0,1,1.0,1,1.0,1,0.1471717803516522,60
4934,3,16910,3666,13244,0,0,0,1.0,1,1.0,1,1.0,1,0.14888525173336198,60
4935,3,16913,3666,13247,0,0,0,1.0,1,1.0,1,1.0,1,0.15578559447981327,60
4936,5,16918,3666,13252,0,0,0,1.0,1,1.0,1,1.0,1,0.11240923385011421,61
4937,3,16921,3667,13254,0,0,0,1.0,1,1.0,1,1.0,1,0.14323742506067236,62
4938,1,16922,3667,13255,0,0,0,1.0,1,1.0,1,1.0,1,0.11835776525718399,62
4939,4,16926,3670,13256,0,0,0,1.0,1,1.0,1,1.0,1,0.14886068610072697,64
4940,6,16932,3670,13262,0,0,0,1.0,1,1.0,1,1.0,1,0.1271190917982868,67
4941,2,16934,3671,13263,0,0,0,1.0,1,1.0,1,1.0,1,0.1546724024727581,66
4942,6,16940,3673,13267,0,0,0,1.0,1,1.0,1,1.0,1,0.1690832043583446,67
4943,4,16944,3673,13271,0,0,0,1.0,1,1.0,1,1.0,1,0.15388952632415379,65
4944,4,16948,3675,13273,0,0,0,1.0,1,1.0,1,1.0,1,0.17499818861702854,65
4945,5,16953,3677,13276,0,0,0,1.0,1,1.0,1,1.0,1,0.17882976670469233,62
4946,3,16956,3679,13277,0,0,0,1.0,1,1.0,1,1.0,1,0.179367110541008,61
4947,2,16958,3680,13278,0,0,0,1.0,1,1.0,1,1.0,1,0.1768582257834137,59
4948,4,16962,3682,13280,0,0,0,1.0,1,1.0,1,1.0,1,0.16685245068426383,59
4949,3,16965,3683,13282,0,0,0,1.0,1,1.0,1,1.0,1,0.15630491773279093,57
4950,6,16971,3685,13286,0,0,0,1.0,1,1.0,1,1.0,1,0.15087560866112107,58
4951,6,16977,3687,13290,0,0,0,1.0,1,1.0,1,1.0,1,0.09175885277807838,55
4952,3,16980,3690,13290,0,0,0,1.0,1,1.0,1,1.0,1,0.09217743389585924,53
4953,4,16984,3694,13290,0,0,0,1.0,1,1.0,1,1.0,1,0.07952792908289041,54
4954,0,16984,3694,13290,0,0,0,1.0,1,1.0,1,1.0,1,0.07780458066650259,52
4955,5,16989,3697,13292,0,0,0,1.0,1,1.0,1,1.0,1,0.11993969032721813,51
4956,0,16989,3697,13292,0,0,0,1.0,1,1.0,1,1.0,1,0.1331927465751828,47
4957,1,16990,3697,13293,0,0,0,1.0,1,1.0,1,1.0,1,0.13227122183392395,48
4958,0,16990,3697,13293,0,0,0,1.0,1,1.0,1,1.0,1,0.1335893072637992,47
4959,0,16990,3697,13293,0,0,0,1.0,1,1.0,1,1.0,1,0.1335893072637992,47
4960,0,16990,3697,13293,0,0,0,1.0,1,1.0,1,1.0,1,0.130868310365183,48
4961,1,16991,3698,13293,0,0,0,1.0,1,1.0,1,1.0,1,0.12903132802442954,49
4962,0,16991,3698,13293,0,0,0,1.0,1,1.0,1,1.0,1,0.12903132802442954,49
4963,2,16993,3699,13294,0,0,0,1.0,1,1.0,1,1.0,1,0.11947274170787642,51
4964,4,16997,3702,13295,0,0,0,1.0,1,1.0,1,1.0,1,0.15144985979579684,51
4965,1,16998,3702,13296,0,0,0,1.0,1,1.0,1,1.0,1,0.1445040643292668,51
4966,4,17002,3702,13300,0,0,0,1.0,1,1.0,1,1.0,1,0.0953159370564974,51
4967,2,17004,3704,13300,0,0,0,1.0,1,1.0,1,1.0,1,0.15338618671513465,51
4968,3,17007,3705,13302,0,0,0,1.0,1,1.0,1,1.0,1,0.11761488636464319,52
4969,0,17007,3705,13302,0,0,0,1.0,1,1.0,1,1.0,1,0.12518070553007743,53
4970,4,17011,3707,13304,0,0,0,1.0,1,1.0,1,1.0,1,0.18296099150124498,54
4971,5,17016,3707,13309,0,0,0,1.0,1,1.0,1,1.0,1,0.19284345801391403,55
4972,6,17022,3707,13315,0,0,0,1.0,1,1.0,1,1.0,1,0.19896411014218257,56
4973,8,17030,3709,13321,0,0,0,1.0,1,1.0,1,1.0,1,0.15462220313562633,57
4974,5,17035,3710,13325,0,0,0,1.0,1,1.0,1,1.0,1,0.23352497699660768,56
4975,9,17044,3711,13333,0,0,0,1.0,1,1.0,1,1.0,1,0.16704133246381006,57
4976,4,17048,3712,13336,0,0,0,1.0,1,1.0,1,1.0,1,0.16747701512214955,57
4977,5,17053,3712,13341,0,0,0,1.0,1,1.0,1,1.0,1,0.16508412778549147,57
4978,9,17062,3713,13349,0,0,0,1.0,1,1.0,1,1.0,1,0.12556023139990669,58
4979,4,17066,3713,13353,0,0,0,1.0,1,1.0,1,1.0,1,0.15182765285077687,58
4980,8,17074,3713,13361,0,0,0,1.0,1,1.0,1,1.0,1,0.13051382005057252,59
4981,3,17077,3714,13363,0,0,0,1.0,1,1.0,1,1.0,1,0.09856125343976316,60
4982,1,17078,3715,13363,0,0,0,1.0,1,1.0,1,1.0,1,0.09304390446507078,61
4983,1,17079,3716,13363,0,0,0,1.0,1,1.0,1,1.0,1,0.10402809234870436,61
4984,1,17080,3717,13363,0,0,0,1.0,1,1.0,1,1.0,1,0.11050421232339598,59
4985,2,17082,3718,13364,0,0,0,1.0,1,1.0,1,1.0,1,0.12102941970643881,58
4986,4,17086,3720,13366,0,0,0,1.0,1,1.0,1,1.0,1,0.11067754147551724,59
4987,2,17088,3720,13368,0,0,0,1.0,1,1.0,1,1.0,1,0.106331998970575,58
4988,2,17090,3722,13368,0,0,0,1.0,1,1.0,1,1.0,1,0.10407076561104713,57
4989,2,17092,3723,13369,0,0,0,1.0,1,1.0,1,1.0,1,0.1259100879890829,54
4990,1,17093,3723,13370,0,0,0,1.0,1,1.0,1,1.0,1,0.13523606444655217,53
4991,3,17096,3726,13370,0,0,0,1.0,1,1.0,1,1.0,1,0.15476018948541959,52
4992,3,17099,3728,13371,0,0,0,1.0,1,1.0,1,1.0,1,0.19882331171035994,48
4993,1,17100,3728,13372,0,0,0,1.0,1,1.0,1,1.0,1,0.18757750415261717,48
4994,1,17101,3729,13372,0,0,0,1.0,1,1.0,1,1.0,1,0.19749883424268122,45
4995,5,17106,3733,13373,0,0,0,1.0,1,1.0,1,1.0,1,0.24216781081103986,45
4996,8,17114,3735,13379,0,0,0,1.0,1,1.0,1,1.0,1,0.08698622357733903,45
4997,3,17117,3735,13382,0,0,0,1.0,1,1.0,1,1.0,1,0.09269460633438276,42
4998,7,17124,3738,13386,0,0,0,1.0,1,1.0,1,1.0,1,0.14678564247593895,44
4999,7,17131,3738,13393,0,0,0,1.0,1,1.0,1,1.0,1,0.14338283872503996,44
5000,3,17134,3739,13395,0,0,0,1.0,1,1.0,1,1.0,1,0.17269196468667325,42
5001,5,17139,3739,13400,0,0,0,1.0,1,1.0,1,1.0,1,0.1704997430308211,42
5002,3,17142,3740,13402,0,0,0,1.0,1,1.0,1,1.0,1,0.1848517951639081,41
5003,7,17149,3741,13408,0,0,0,1.0,1,1.0,1,1.0,1,0.23680178865826912,41
5004,3,17152,3741,13411,0,0,0,1.0,1,1.0,1,1.0,1,0.21106570008110156,41
5005,5,17157,3741,13416,0,0,0,1.0,1,1.0,1,1.0,1,0.22620541673011638,41
5006,3,17160,3741,13419,0,0,0,1.0,1,1.0,1,1.0,1,0.2347138287801467,42
5007,4,17164,3741,13423,0,0,0,1.0,1,1.0,1,1.0,1,0.2416273598316548,43
5008,3,17167,3741,13426,0,0,0,1.0,1,1.0,1,1.0,1,0.1882109556564861,46
5009,6,17173,3741,13432,0,0,0,1.0,1,1.0,1,1.0,1,0.1882109556564861,46
5010,3,17176,3741,13435,0,0,0,1.0,1,1.0,1,1.0,1,0.23702412070147946,46
5011,7,17183,3741,13442,0,0,0,1.0,1,1.0,1,1.0,1,0.13343238705214858,47
5012,2,17185,3741,13444,0,0,0,1.0,1,1.0,1,1.0,1,0.1200873675163934,48
5013,0,17185,3741,13444,0,0,0,1.0,1,1.0,1,1.0,1,0.1200873675163934,48
5014,2,17187,3741,13446,0,0,0,1.0,1,1.0,1,1.0,1,0.11995774874467273,49
5015,2,17189,3741,13448,0,0,0,1.0,1,1.0,1,1.0,1,0.099094896408793,50
5016,5,17194,3742,13452,0,0,0,1.0,1,1.0,1,1.0,1,0.17374259427060243,51
5017,4,17198,3742,13456,0,0,0,1.0,1,1.0,1,1.0,1,0.14645736940141094,51
5018,4,17202,3742,13460,0,0,0,1.0,1,1.0,1,1.0,1,0.1805589960654732,51
5019,5,17207,3743,13464,0,0,0,1.0,1,1.0,1,1.0,1,0.21366375577952293,51
5020,5,17212,3743,13469,0,0,0,1.0,1,1.0,1,1.0,1,0.19409579197404472,51
5021,4,17216,3743,13473,0,0,0,1.0,1,1.0,1,1.0,1,0.1996392361421846,52
5022,6,17222,3744,13478,0,0,0,1.0,1,1.0,1,1.0,1,0.19186659735780676,52
5023,9,17231,3747,13484,0,0,0,1.0,1,1.0,1,1.0,1,0.20359943171675265,52
5024,9,17240,3750,13490,0,0,0,1.0,1,1.0,1,1.0,1,0.19471304352306487,51
5025,5,17245,3750,13495,0,0,0,1.0,1,1.0,1,1.0,1,0.16120154737205405,50
5026,6,17251,3751,13500,0,0,0,1.0,1,1.0,1,1.0,1,0.1557729054474119,49
5027,1,17252,3751,13501,0,0,0,1.0,1,1.0,1,1.0,1,0.13591171583137707,47
5028,5,17257,3753,13504,0,0,0,1.0,1,1.0,1,1.0,1,0.23288014191372877,47
5029,3,17260,3754,13506,0,0,0,1.0,1,1.0,1,1.0,1,0.21938752007921428,46
5030,4,17264,3754,13510,0,0,0,1.0,1,1.0,1,1.0,1,0.19099179082514822,48
5031,6,17270,3756,13514,0,0,0,1.0,1,1.0,1,1.0,1,0.214427841767864,46
5032,4,17274,3756,13518,0,0,0,1.0,1,1.0,1,1.0,1,0.214427841767864,46
5033,4,17278,3756,13522,0,0,0,1.0,1,1.0,1,1.0,1,0.20620403675986382,47
5034,4,17282,3757,13525,0,0,0,1.0,1,1.0,1,1.0,1,0.20812619969475618,48
5035,2,17284,3757,13527,0,0,0,1.0,1,1.0,1,1.0,1,0.21502539143110636,47
5036,6,17290,3758,13532,0,0,0,1.0,1,1.0,1,1.0,1,0.2158211258510978,47
5037,2,17292,3758,13534,0,0,0,1.0,1,1.0,1,1.0,1,0.19453061189793153,47
5038,3,17295,3759,13536,0,0,0,1.0,1,1.0,1,1.0,1,0.23163412359579982,48
5039,5,17300,3759,13541,0,0,0,1.0,1,1.0,1,1.0,1,0.2159848971737778,47
5040,4,17304,3759,13545,0,0,0,1.0,1,1.0,1,1.0,1,0.21731303284042028,48
5041,7,17311,3760,13551,0,0,0,1.0,1,1.0,1,1.0,1,0.10478579920015764,49
5042,0,17311,3760,13551,0,0,0,1.0,1,1.0,1,1.0,1,0.11976837749260254,50
5043,2,17313,3761,13552,0,0,0,1.0,1,1.0,1,1.0,1,0.12189665974001804,51
5044,3,17316,3761,13555,0,0,0,1.0,1,1.0,1,1.0,1,0.09613378088444369,51
5045,1,17317,3761,13556,0,0,0,1.0,1,1.0,1,1.0,1,0.10390253497576012,51
5046,6,17323,3762,13561,0,0,0,1.0,1,1.0,1,1.0,1,0.10538790184929145,52
5047,3,17326,3762,13564,0,0,0,1.0,1,1.0,1,1.0,1,0.10336117197073073,52
5048,2,17328,3762,13566,0,0,0,1.0,1,1.0,1,1.0,1,0.0959555220712076,52
5049,1,17329,3762,13567,0,0,0,1.0,1,1.0,1,1.0,1,0.1164297003658315,52
5050,4,17333,3762,13571,0,0,0,1.0,1,1.0,1,1.0,1,0.10961478178148792,55
5051,0,17333,3762,13571,0,0,0,1.0,1,1.0,1,1.0,1,0.11524019891677383,55
5052,0,17333,3762,13571,0,0,0,1.0,1,1.0,1,1.0,1,0.11524019891677383,55
5053,0,17333,3762,13571,0,0,0,1.0,1,1.0,1,1.0,1,0.12325161362253262,54
5054,0,17333,3762,13571,0,0,0,1.0,1,1.0,1,1.0,1,0.12325161362253262,54
5055,1,17334,3762,13572,0,0,0,1.0,1,1.0,1,1.0,1,0.12054341693063805,54
5056,3,17337,3762,13575,0,0,0,1.0,1,1.0,1,1.0,1,0.07054005038264516,55
5057,0,17337,3762,13575,0,0,0,1.0,1,1.0,1,1.0,1,0.08098965936866029,56
5058,0,17337,3762,13575,0,0,0,1.0,1,1.0,1,1.0,1,0.09550796407910797,58
5059,0,17337,3762,13575,0,0,0,1.0,1,1.0,1,1.0,1,0.09550796407910797,58
5060,4,17341,3763,13578,0,0,0,1.0,1,1.0,1,1.0,1,0.08582921422382019,59
5061,2,17343,3764,13579,0,0,0,1.0,1,1.0,1,1.0,1,0.10470648853013292,58
5062,2,17345,3765,13580,0,0,0,1.0,1,1.0,1,1.0,1,0.08849784881763173,58
5063,6,17351,3768,13583,0,0,0,1.0,1,1.0,1,1.0,1,0.09311808662780162,57
5064,2,17353,3770,13583,0,0,0,1.0,1,1.0,1,1.0,1,0.14184875337275624,57
5065,2,17355,3771,13584,0,0,0,1.0,1,1.0,1,1.0,1,0.14329253583822046,56
5066,7,17362,3775,13587,0,0,0,1.0,1,1.0,1,1.0,1,0.2646842833586446,55
5067,5,17367,3776,13591,0,0,0,1.0,1,1.0,1,1.0,1,0.23831000771438793,54
5068,8,17375,3779,13596,0,0,0,1.0,1,1.0,1,1.0,1,0.2574143365062343,54
5069,3,17378,3779,13599,0,0,0,1.0,1,1.0,1,1.0,1,0.23303576338670925,53
5070,2,17380,3779,13601,0,0,0,1.0,1,1.0,1,1.0,1,0.22685375304955652,53
5071,10,17390,3779,13611,0,0,0,1.0,1,1.0,1,1.0,1,0.14425602318887593,53
5072,1,17391,3780,13611,0,0,0,1.0,1,1.0,1,1.0,1,0.10822614657007719,53
5073,2,17393,3781,13612,0,0,0,1.0,1,1.0,1,1.0,1,0.08760437961088041,53
5074,2,17395,3781,13614,0,0,0,1.0,1,1.0,1,1.0,1,0.09938695612445166,52
5075,0,17395,3781,13614,0,0,0,1.0,1,1.0,1,1.0,1,0.09938695612445166,52
5076,1,17396,3781,13615,0,0,0,1.0,1,1.0,1,1.0,1,0.11319955301054548,55
5077,3,17399,3782,13617,0,0,0,1.0,1,1.0,1,1.0,1,0.152604300960254,55
5078,3,17402,3782,13620,0,0,0,1.0,1,1.0,1,1.0,1,0.16976248245521794,55
5079,2,17404,3782,13622,0,0,0,1.0,1,1.0,1,1.0,1,0.1852290746678417,54
5080,2,17406,3783,13623,0,0,0,1.0,1,1.0,1,1.0,1,0.17344879041387426,55
5081,2,17408,3783,13625,0,0,0,1.0,1,1.0,1,1.0,1,0.1664482091913073,57
5082,4,17412,3783,13629,0,0,0,1.0,1,1.0,1,1.0,1,0.15212250272615546,57
5083,9,17421,3784,13637,0,0,0,1.0,1,1.0,1,1.0,1,0.14821212242125975,58
5084,2,17423,3784,13639,0,0,0,1.0,1,1.0,1,1.0,1,0.10931312638677439,58
5085,6,17429,3785,13644,0,0,0,1.0,1,1.0,1,1.0,1,0.12313431603703995,59
5086,5,17434,3785,13649,0,0,0,1.0,1,1.0,1,1.0,1,0.06756613199476037,60
5087,3,17437,3786,13651,0,0,0,1.0,1,1.0,1,1.0,1,0.0670438081239649,61
5088,2,17439,3787,13652,0,0,0,1.0,1,1.0,1,1.0,1,0.09662974326208204,62
5089,2,17441,3789,13652,0,0,0,1.0,1,1.0,1,1.0,1,0.09512108468258473,63
5090,0,17441,3789,13652,0,0,0,1.0,1,1.0,1,1.0,1,0.09512108468258473,63
5091,2,17443,3791,13652,0,0,0,1.0,1,1.0,1,1.0,1,0.1354025771333029,63
5092,7,17450,3792,13658,0,0,0,1.0,1,1.0,1,1.0,1,0.14205976249500132,63
5093,5,17455,3792,13663,0,0,0,1.0,1,1.0,1,1.0,1,0.12141125042906747,63
5094,8,17463,3794,13669,0,0,0,1.0,1,1.0,1,1.0,1,0.13193757619458224,64
5095,3,17466,3794,13672,0,0,0,1.0,1,1.0,1,1.0,1,0.15436214439538334,64
5096,11,17477,3795,13682,0,0,0,1.0,1,1.0,1,1.0,1,0.13080791910171816,67
5097,13,17490,3795,13695,0,0,0,1.0,1,1.0,1,1.0,1,0.1278933137267193,67
5098,9,17499,3795,13704,0,0,0,1.0,1,1.0,1,1.0,1,0.16363313356456669,68
5099,7,17506,3795,13711,0,0,0,1.0,1,1.0,1,1.0,1,0.1541403647195441,70
5100,10,17516,3795,13721,0,0,0,1.0,1,1.0,1,1.0,1,0.1512876051787218,71
5101,6,17522,3796,13726,0,0,0,1.0,1,1.0,1,1.0,1,0.10197423860845045,71
5102,2,17524,3798,13726,0,0,0,1.0,1,1.0,1,1.0,1,0.11044497464544491,70
5103,1,17525,3799,13726,0,0,0,1.0,1,1.0,1,1.0,1,0.09433541038695789,67
5104,3,17528,3802,13726,0,0,0,1.0,1,1.0,1,1.0,1,0.12563262097333466,67
5105,3,17531,3804,13727,0,0,0,1.0,1,1.0,1,1.0,1,0.12625525873058208,63
5106,4,17535,3807,13728,0,0,0,1.0,1,1.0,1,1.0,1,0.15895805648724776,63
5107,5,17540,3812,13728,0,0,0,1.0,1,1.0,1,1.0,1,0.19079210904035565,60
5108,6,17546,3815,13731,0,0,0,1.0,1,1.0,1,1.0,1,0.20431526652408072,56
5109,5,17551,3819,13732,0,0,0,1.0,1,1.0,1,1.0,1,0.2555277292055492,56
5110,1,17552,3819,13733,0,0,0,1.0,1,1.0,1,1.0,1,0.24879137215322258,52
5111,3,17555,3822,13733,0,0,0,1.0,1,1.0,1,1.0,1,0.23393378234995635,51
5112,2,17557,3823,13734,0,0,0,1.0,1,1.0,1,1.0,1,0.22454917689442958,50
5113,3,17560,3826,13734,0,0,0,1.0,1,1.0,1,1.0,1,0.2777232673676983,48
5114,2,17562,3828,13734,0,0,0,1.0,1,1.0,1,1.0,1,0.26705262671545654,46
5115,0,17562,3828,13734,0,0,0,1.0,1,1.0,1,1.0,1,0.2502934980833392,44
5116,10,17572,3831,13741,0,0,0,1.0,1,1.0,1,1.0,1,0.16268613982186228,44
5117,2,17574,3831,13743,0,0,0,1.0,1,1.0,1,1.0,1,0.15087540258364998,46
5118,6,17580,3832,13748,0,0,0,1.0,1,1.0,1,1.0,1,0.14565823901872846,46
5119,5,17585,3833,13752,0,0,0,1.0,1,1.0,1,1.0,1,0.15913975156554036,46
5120,5,17590,3833,13757,0,0,0,1.0,1,1.0,1,1.0,1,0.17034466655326969,46
5121,11,17601,3835,13766,0,0,0,1.0,1,1.0,1,1.0,1,0.1992603285578714,46
5122,9,17610,3837,13773,0,0,0,1.0,1,1.0,1,1.0,1,0.1910508531422274,46
5123,4,17614,3837,13777,0,0,0,1.0,1,1.0,1,1.0,1,0.22829621502501543,45
5124,7,17621,3837,13784,0,0,0,1.0,1,1.0,1,1.0,1,0.17531041518973142,47
5125,9,17630,3837,13793,0,0,0,1.0,1,1.0,1,1.0,1,0.1810362379252228,50
5126,14,17644,3838,13806,0,0,0,1.0,1,1.0,1,1.0,1,0.20354114495543546,50
5127,11,17655,3838,13817,0,0,0,1.0,1,1.0,1,1.0,1,0.19446612132691257,52
5128,11,17666,3840,13826,0,0,0,1.0,1,1.0,1,1.0,1,0.21891541676217957,53
5129,12,17678,3840,13838,0,0,0,1.0,1,1.0,1,1.0,1,0.23338866944326897,55
5130,16,17694,3841,13853,0,0,0,1.0,1,1.0,1,1.0,1,0.2236687598246893,55
5131,9,17703,3842,13861,0,0,0,1.0,1,1.0,1,1.0,1,0.0874984492532561,54
5132,0,17703,3842,13861,0,0,0,1.0,1,1.0,1,1.0,1,0.1078555616816702,54
5133,0,17703,3842,13861,0,0,0,1.0,1,1.0,1,1.0,1,0.1078555616816702,54
5134,0,17703,3842,13861,0,0,0,1.0,1,1.0,1,1.0,1,0.1075551962291969,53
5135,0,17703,3842,13861,0,0,0,1.0,1,1.0,1,1.0,1,0.11050106626079857,54
5136,4,17707,3842,13865,0,0,0,1.0,1,1.0,1,1.0,1,0.10338372861943138,54
5137,2,17709,3842,13867,0,0,0,1.0,1,1.0,1,1.0,1,0.09868031278703832,54
5138,2,17711,3843,13868,0,0,0,1.0,1,1.0,1,1.0,1,0.15243401135807882,54
5139,2,17713,3843,13870,0,0,0,1.0,1,1.0,1,1.0,1,0.14233434078942822,55
5140,2,17715,3844,13871,0,0,0,1.0,1,1.0,1,1.0,1,0.16080449485652162,55
5141,0,17715,3844,13871,0,0,0,1.0,1,1.0,1,1.0,1,0.15354902406213988,53
5142,3,17718,3846,13872,0,0,0,1.0,1,1.0,1,1.0,1,0.17152700779455332,54
5143,1,17719,3847,13872,0,0,0,1.0,1,1.0,1,1.0,1,0.1971383591418327,52
5144,2,17721,3849,13872,0,0,0,1.0,1,1.0,1,1.0,1,0.24130062666077837,50
5145,0,17721,3849,13872,0,0,0,1.0,1,1.0,1,1.0,1,0.23175410624722317,49
5146,14,17735,3851,13884,0,0,0,1.0,1,1.0,1,1.0,1,0.14521081360389415,49
5147,6,17741,3853,13888,0,0,0,1.0,1,1.0,1,1.0,1,0.12613577847481888,46
5148,3,17744,3853,13891,0,0,0,1.0,1,1.0,1,1.0,1,0.12196658064874226,46
5149,4,17748,3853,13895,0,0,0,1.0,1,1.0,1,1.0,1,0.1580807943396118,45
5150,4,17752,3855,13897,0,0,0,1.0,1,1.0,1,1.0,1,0.16743797523161552,47
5151,2,17754,3856,13898,0,0,0,1.0,1,1.0,1,1.0,1,0.22684039243264048,46
5152,4,17758,3858,13900,0,0,0,1.0,1,1.0,1,1.0,1,0.21217000672113484,46
5153,1,17759,3858,13901,0,0,0,1.0,1,1.0,1,1.0,1,0.23318269095503716,45
5154,2,17761,3859,13902,0,0,0,1.0,1,1.0,1,1.0,1,0.20488398987677384,47
5155,3,17764,3859,13905,0,0,0,1.0,1,1.0,1,1.0,1,0.20246021955338692,47
5156,4,17768,3860,13908,0,0,0,1.0,1,1.0,1,1.0,1,0.16538206380622916,47
5157,4,17772,3862,13910,0,0,0,1.0,1,1.0,1,1.0,1,0.17641562149831572,46
5158,2,17774,3862,13912,0,0,0,1.0,1,1.0,1,1.0,1,0.18717704924183207,47
5159,2,17776,3862,13914,0,0,0,1.0,1,1.0,1,1.0,1,0.19295230323700624,49
5160,3,17779,3862,13917,0,0,0,1.0,1,1.0,1,1.0,1,0.22579495656561313,48
5161,8,17787,3862,13925,0,0,0,1.0,1,1.0,1,1.0,1,0.09111251303312706,48
5162,0,17787,3862,13925,0,0,0,1.0,1,1.0,1,1.0,1,0.09177767067413885,49
5163,3,17790,3863,13927,0,0,0,1.0,1,1.0,1,1.0,1,0.09179075792961175,51
5164,0,17790,3863,13927,0,0,0,1.0,1,1.0,1,1.0,1,0.09179075792961175,51
5165,2,17792,3864,13928,0,0,0,1.0,1,1.0,1,1.0,1,0.12060584169213909,52
5166,0,17792,3864,13928,0,0,0,1.0,1,1.0,1,1.0,1,0.12060584169213909,52
5167,2,17794,3865,13929,0,0,0,1.0,1,1.0,1,1.0,1,0.12072115342193614,52
5168,3,17797,3865,13932,0,0,0,1.0,1,1.0,1,1.0,1,0.12331449623244069,52
5169,4,17801,3867,13934,0,0,0,1.0,1,1.0,1,1.0,1,0.1249341853496421,53
5170,2,17803,3867,13936,0,0,0,1.0,1,1.0,1,1.0,1,0.1325271174879448,53
5171,2,17805,3867,13938,0,0,0,1.0,1,1.0,1,1.0,1,0.1363623222344231,52
5172,4,17809,3868,13941,0,0,0,1.0,1,1.0,1,1.0,1,0.14531692647046557,53
5173,5,17814,3868,13946,0,0,0,1.0,1,1.0,1,1.0,1,0.14979652235370347,54
5174,7,17821,3869,13952,0,0,0,1.0,1,1.0,1,1.0,1,0.1606873033272213,56
5175,8,17829,3869,13960,0,0,0,1.0,1,1.0,1,1.0,1,0.1519140012481424,58
5176,8,17837,3869,13968,0,0,0,1.0,1,1.0,1,1.0,1,0.08056412678106636,58
5177,3,17840,3869,13971,0,0,0,1.0,1,1.0,1,1.0,1,0.06699934986497129,59
5178,7,17847,3871,13976,0,0,0,1.0,1,1.0,1,1.0,1,0.10266676106478122,57
5179,3,17850,3871,13979,0,0,0,1.0,1,1.0,1,1.0,1,0.1412918606930189,58
5180,4,17854,3873,13981,0,0,0,1.0,1,1.0,1,1.0,1,0.14323071045437624,56
5181,5,17859,3874,13985,0,0,0,1.0,1,1.0,1,1.0,1,0.1552575246381047,57
5182,4,17863,3876,13987,0,0,0,1.0,1,1.0,1,1.0,1,0.18633620822871294,56
5183,7,17870,3876,13994,0,0,0,1.0,1,1.0,1,1.0,1,0.1764942285255496,57
5184,5,17875,3878,13997,0,0,0,1.0,1,1.0,1,1.0,1,0.1666399640203757,56
5185,9,17884,3879,14005,0,0,0,1.0,1,1.0,1,1.0,1,0.16969469164274184,56
5186,4,17888,3881,14007,0,0,0,1.0,1,1.0,1,1.0,1,0.15056263753466712,54
5187,5,17893,3881,14012,0,0,0,1.0,1,1.0,1,1.0,1,0.16974932889814448,51
5188,5,17898,3883,14015,0,0,0,1.0,1,1.0,1,1.0,1,0.18018705853593936,50
5189,3,17901,3883,14018,0,0,0,1.0,1,1.0,1,1.0,1,0.2031795709698171,49
5190,5,17906,3886,14020,0,0,0,1.0,1,1.0,1,1.0,1,0.1879860312619025,50
5191,8,17914,3887,14027,0,0,0,1.0,1,1.0,1,1.0,1,0.07759193917159538,50
5192,3,17917,3888,14029,0,0,0,1.0,1,1.0,1,1.0,1,0.07727824141680742,49
5193,3,17920,3889,14031,0,0,0,1.0,1,1.0,1,1.0,1,0.09790738384129048,50
5194,6,17926,3890,14036,0,0,0,1.0,1,1.0,1,1.0,1,0.12249029279835759,51
5195,2,17928,3890,14038,0,0,0,1.0,1,1.0,1,1.0,1,0.11378998391565762,51
5196,1,17929,3890,14039,0,0,0,1.0,1,1.0,1,1.0,1,0.1246375758904888,51
5197,4,17933,3890,14043,0,0,0,1.0,1,1.0,1,1.0,1,0.1246375758904888,51
5198,4,17937,3890,14047,0,0,0,1.0,1,1.0,1,1.0,1,0.1246375758904888,51
5199,4,17941,3890,14051,0,0,0,1.0,1,1.0,1,1.0,1,0.127319197422984,54
5200,5,17946,3891,14055,0,0,0,1.0,1,1.0,1,1.0,1,0.12120473318191081,54
5201,4,17950,3893,14057,0,0,0,1.0,1,1.0,1,1.0,1,0.12857978217992921,55
5202,5,17955,3893,14062,0,0,0,1.0,1,1.0,1,1.0,1,0.1728496139351362,56
5203,6,17961,3893,14068,0,0,0,1.0,1,1.0,1,1.0,1,0.1599481131803604,56
5204,10,17971,3893,14078,0,0,0,1.0,1,1.0,1,1.0,1,0.1483155995173635,58
5205,8,17979,3893,14086,0,0,0,1.0,1,1.0,1,1.0,1,0.16191316195140978,58
5206,3,17982,3893,14089,0,0,0,1.0,1,1.0,1,1.0,1,0.11352633849057836,58
5207,1,17983,3893,14090,0,0,0,1.0,1,1.0,1,1.0,1,0.1183143177995219,59
5208,0,17983,3893,14090,0,0,0,1.0,1,1.0,1,1.0,1,0.12356123740696165,58
5209,0,17983,3893,14090,0,0,0,1.0,1,1.0,1,1.0,1,0.12356123740696165,58
5210,0,17983,3893,14090,0,0,0,1.0,1,1.0,1,1.0,1,0.14057887015889156,57
5211,1,17984,3894,14090,0,0,0,1.0,1,1.0,1,1.0,1,0.16415514157595779,57
5212,3,17987,3894,14093,0,0,0,1.0,1,1.0,1,1.0,1,0.1360349022355156,59
5213,2,17989,3895,14094,0,0,0,1.0,1,1.0,1,1.0,1,0.15792554351083918,59
5214,1,17990,3895,14095,0,0,0,1.0,1,1.0,1,1.0,1,0.15597478759932878,59
5215,3,17993,3896,14097,0,0,0,1.0,1,1.0,1,1.0,1,0.20225430316902704,58
5216,7,18000,3897,14103,0,0,0,1.0,1,1.0,1,1.0,1,0.18246097429808622,59
5217,8,18008,3901,14107,0,0,0,1.0,1,1.0,1,1.0,1,0.1625420893832105,58
5218,9,18017,3905,14112,0,0,0,1.0,1,1.0,1,1.0,1,0.20229442873442077,58
5219,4,18021,3905,14116,0,0,0,1.0,1,1.0,1,1.0,1,0.16212114300549788,57
5220,5,18026,3906,14120,0,0,0,1.0,1,1.0,1,1.0,1,0.20856533575814337,56
5221,7,18033,3908,14125,0,0,0,1.0,1,1.0,1,1.0,1,0.22252554672751565,58
5222,2,18035,3909,14126,0,0,0,1.0,1,1.0,1,1.0,1,0.17770891567603947,56
5223,2,18037,3910,14127,0,0,0,1.0,1,1.0,1,1.0,1,0.184036549108375,55
5224,1,18038,3911,14127,0,0,0,1.0,1,1.0,1,1.0,1,0.18424706590447854,56
5225,1,18039,3912,14127,0,0,0,1.0,1,1.0,1,1.0,1,0.20586246522530638,55
5226,1,18040,3913,14127,0,0,0,1.0,1,1.0,1,1.0,1,0.19509014625691473,55
5227,0,18040,3913,14127,0,0,0,1.0,1,1.0,1,1.0,1,0.19937653483949033,53
5228,1,18041,3914,14127,0,0,0,1.0,1,1.0,1,1.0,1,0.17304753183607677,51
5229,2,18043,3915,14128,0,0,0,1.0,1,1.0,1,1.0,1,0.15473346383980333,51
5230,0,18043,3915,14128,0,0,0,1.0,1,1.0,1,1.0,1,0.15467136757385883,51
5231,2,18045,3916,14129,0,0,0,1.0,1,1.0,1,1.0,1,0.17409801962908109,52
5232,4,18049,3918,14131,0,0,0,1.0,1,1.0,1,1.0,1,0.17240739467160596,52
5233,1,18050,3918,14132,0,0,0,1.0,1,1.0,1,1.0,1,0.19040738433989704,53
5234,2,18052,3919,14133,0,0,0,1.0,1,1.0,1,1.0,1,0.21016604127471294,53
5235,2,18054,3920,14134,0,0,0,1.0,1,1.0,1,1.0,1,0.21039465771409982,53
5236,9,18063,3920,14143,0,0,0,1.0,1,1.0,1,1.0,1,0.143025513709043,52
5237,5,18068,3920,14148,0,0,0,1.0,1,1.0,1,1.0,1,0.14355140820476417,52
5238,6,18074,3922,14152,0,0,0,1.0,1,1.0,1,1.0,1,0.18114355832661813,52
5239,3,18077,3922,14155,0,0,0,1.0,1,1.0,1,1.0,1,0.16247925408432295,51
5240,3,18080,3922,14158,0,0,0,1.0,1,1.0,1,1.0,1,0.19606058852908786,53
5241,6,18086,3922,14164,0,0,0,1.0,1,1.0,1,1.0,1,0.20967031154483487,53
5242,6,18092,3924,14168,0,0,0,1.0,1,1.0,1,1.0,1,0.21683253590507645,51
5243,13,18105,3926,14179,0,0,0,1.0,1,1.0,1,1.0,1,0.20954239247766174,51
5244,16,18121,3927,14194,0,0,0,1.0,1,1.0,1,1.0,1,0.23459439551611952,52
5245,15,18136,3929,14207,0,0,0,1.0,1,1.0,1,1.0,1,0.29519325605018965,53
5246,13,18149,3930,14219,0,0,0,1.0,1,1.0,1,1.0,1,0.24847744090805587,53
5247,16,18165,3931,14234,0,0,0,1.0,1,1.0,1,1.0,1,0.2730689925403696,54
5248,18,18183,3933,14250,0,0,0,1.0,1,1.0,1,1.0,1,0.26269239923981075,54
5249,10,18193,3934,14259,0,0,0,1.0,1,1.0,1,1.0,1,0.3542350877123909,55
5250,17,18210,3935,14275,0,0,0,1.0,1,1.0,1,1.0,1,0.28668967013173763,57
5251,12,18222,3935,14287,0,0,0,1.0,1,1.0,1,1.0,1,0.15584130579780833,58
5252,3,18225,3935,14290,0,0,0,1.0,1,1.0,1,1.0,1,0.14370497323230524,58
5253,6,18231,3937,14294,0,0,0,1.0,1,1.0,1,1.0,1,0.1750559472042707,58
5254,6,18237,3938,14299,0,0,0,1.0,1,1.0,1,1.0,1,0.22790688221169403,59
5255,3,18240,3938,14302,0,0,0,1.0,1,1.0,1,1.0,1,0.18153791892400079,58
5256,3,18243,3938,14305,0,0,0,1.0,1,1.0,1,1.0,1,0.2019876865245931,58
5257,3,18246,3938,14308,0,0,0,1.0,1,1.0,1,1.0,1,0.16124408509841942,57
5258,3,18249,3939,14310,0,0,0,1.0,1,1.0,1,1.0,1,0.19445774574294106,55
5259,5,18254,3940,14314,0,0,0,1.0,1,1.0,1,1.0,1,0.1907808000814892,56
5260,4,18258,3940,14318,0,0,0,1.0,1,1.0,1,1.0,1,0.20579253645726786,55
5261,3,18261,3940,14321,0,0,0,1.0,1,1.0,1,1.0,1,0.24153858097627703,54
5262,5,18266,3941,14325,0,0,0,1.0,1,1.0,1,1.0,1,0.2535580900240236,54
5263,5,18271,3943,14328,0,0,0,1.0,1,1.0,1,1.0,1,0.23688450396695343,55
5264,2,18273,3943,14330,0,0,0,1.0,1,1.0,1,1.0,1,0.28935431426193464,53
5265,4,18277,3946,14331,0,0,0,1.0,1,1.0,1,1.0,1,0.24388132848450153,52
5266,6,18283,3946,14337,0,0,0,1.0,1,1.0,1,1.0,1,0.19299917246866807,49
5267,4,18287,3947,14340,0,0,0,1.0,1,1.0,1,1.0,1,0.20861437880950798,49
5268,2,18289,3947,14342,0,0,0,1.0,1,1.0,1,1.0,1,0.20739370234784543,46
5269,0,18289,3947,14342,0,0,0,1.0,1,1.0,1,1.0,1,0.20367035266453645,45
5270,7,18296,3949,14347,0,0,0,1.0,1,1.0,1,1.0,1,0.1827187527400308,46
5271,6,18302,3951,14351,0,0,0,1.0,1,1.0,1,1.0,1,0.1684016952557922,46
5272,4,18306,3951,14355,0,0,0,1.0,1,1.0,1,1.0,1,0.1939113081965003,45
5273,3,18309,3953,14356,0,0,0,1.0,1,1.0,1,1.0,1,0.1974373864812273,45
5274,2,18311,3953,14358,0,0,0,1.0,1,1.0,1,1.0,1,0.200590702272305,45
5275,6,18317,3956,14361,0,0,0,1.0,1,1.0,1,1.0,1,0.2627857054897056,46
5276,11,18328,3959,14369,0,0,0,1.0,1,1.0,1,1.0,1,0.2828832372637882,45
5277,7,18335,3960,14375,0,0,0,1.0,1,1.0,1,1.0,1,0.26092532034785126,45
5278,3,18338,3961,14377,0,0,0,1.0,1,1.0,1,1.0,1,0.27663761149239224,44
5279,3,18341,3961,14380,0,0,0,1.0,1,1.0,1,1.0,1,0.28164799040046123,45
5280,3,18344,3961,14383,0,0,0,1.0,1,1.0,1,1.0,1,0.2647126777524693,46
5281,8,18352,3961,14391,0,0,0,1.0,1,1.0,1,1.0,1,0.15532802662170958,46
5282,4,18356,3962,14394,0,0,0,1.0,1,1.0,1,1.0,1,0.1766661540550385,47
5283,5,18361,3962,14399,0,0,0,1.0,1,1.0,1,1.0,1,0.1677740386841535,48
5284,3,18364,3962,14402,0,0,0,1.0,1,1.0,1,1.0,1,0.172967733698509,48
5285,1,18365,3962,14403,0,0,0,1.0,1,1.0,1,1.0,1,0.12864902035179673,48
5286,3,18368,3962,14406,0,0,0,1.0,1,1.0,1,1.0,1,0.11450600264389953,50
5287,3,18371,3962,14409,0,0,0,1.0,1,1.0,1,1.0,1,0.10678371858933264,50
5288,3,18374,3962,14412,0,0,0,1.0,1,1.0,1,1.0,1,0.11509002722907534,51
5289,2,18376,3962,14414,0,0,0,1.0,1,1.0,1,1.0,1,0.08878978593895476,51
5290,1,18377,3962,14415,0,0,0,1.0,1,1.0,1,1.0,1,0.10559730871034947,52
5291,7,18384,3964,14420,0,0,0,1.0,1,1.0,1,1.0,1,0.15203134374591135,52
5292,4,18388,3964,14424,0,0,0,1.0,1,1.0,1,1.0,1,0.1596479119427808,53
5293,5,18393,3965,14428,0,0,0,1.0,1,1.0,1,1.0,1,0.18901257225683862,51
5294,3,18396,3965,14431,0,0,0,1.0,1,1.0,1,1.0,1,0.18301882516549017,50
5295,6,18402,3965,14437,0,0,0,1.0,1,1.0,1,1.0,1,0.2541660731652296,49
5296,4,18406,3966,14440,0,0,0,1.0,1,1.0,1,1.0,1,0.2147730569544448,48
5297,1,18407,3966,14441,0,0,0,1.0,1,1.0,1,1.0,1,0.24427914145744217,46
5298,0,18407,3966,14441,0,0,0,1.0,1,1.0,1,1.0,1,0.24505184889403794,46
5299,1,18408,3966,14442,0,0,0,1.0,1,1.0,1,1.0,1,0.2435960845022015,47
5300,1,18409,3966,14443,0,0,0,1.0,1,1.0,1,1.0,1,0.22764258410063004,48
5301,1,18410,3966,14444,0,0,0,1.0,1,1.0,1,1.0,1,0.2186221848479826,48
5302,3,18413,3968,14445,0,0,0,1.0,1,1.0,1,1.0,1,0.2346219091885834,49
5303,0,18413,3968,14445,0,0,0,1.0,1,1.0,1,1.0,1,0.228659010165899,48
5304,1,18414,3969,14445,0,0,0,1.0,1,1.0,1,1.0,1,0.22310546586526028,48
5305,1,18415,3970,14445,0,0,0,1.0,1,1.0,1,1.0,1,0.23251836536954143,47
5306,3,18418,3973,14445,0,0,0,1.0,1,1.0,1,1.0,1,0.3074194435189199,48
5307,6,18424,3973,14451,0,0,0,1.0,1,1.0,1,1.0,1,0.20705565289412856,48
5308,1,18425,3974,14451,0,0,0,1.0,1,1.0,1,1.0,1,0.21931428963754493,47
5309,1,18426,3975,14451,0,0,0,1.0,1,1.0,1,1.0,1,0.23517407646171917,46
5310,3,18429,3976,14453,0,0,0,1.0,1,1.0,1,1.0,1,0.2223868216139516,46
5311,4,18433,3976,14457,0,0,0,1.0,1,1.0,1,1.0,1,0.1311218178618379,46
5312,1,18434,3977,14457,0,0,0,1.0,1,1.0,1,1.0,1,0.15082340406606443,46
5313,2,18436,3977,14459,0,0,0,1.0,1,1.0,1,1.0,1,0.14555002380101237,46
5314,1,18437,3977,14460,0,0,0,1.0,1,1.0,1,1.0,1,0.14786962434806544,46
5315,7,18444,3979,14465,0,0,0,1.0,1,1.0,1,1.0,1,0.12337896879197324,47
5316,6,18450,3979,14471,0,0,0,1.0,1,1.0,1,1.0,1,0.1703513937452551,48
5317,8,18458,3980,14478,0,0,0,1.0,1,1.0,1,1.0,1,0.1937975225815363,49
5318,6,18464,3980,14484,0,0,0,1.0,1,1.0,1,1.0,1,0.1852166981512348,49
5319,7,18471,3981,14490,0,0,0,1.0,1,1.0,1,1.0,1,0.21316383259906577,50
5320,5,18476,3981,14495,0,0,0,1.0,1,1.0,1,1.0,1,0.17670721993192406,51
5321,4,18480,3981,14499,0,0,0,1.0,1,1.0,1,1.0,1,0.16840380053664653,52
5322,7,18487,3981,14506,0,0,0,1.0,1,1.0,1,1.0,1,0.12571991916988445,53
5323,5,18492,3981,14511,0,0,0,1.0,1,1.0,1,1.0,1,0.18766110268756184,53
5324,10,18502,3981,14521,0,0,0,1.0,1,1.0,1,1.0,1,0.21085004275322275,55
5325,7,18509,3981,14528,0,0,0,1.0,1,1.0,1,1.0,1,0.1863954013032614,55
5326,6,18515,3981,14534,0,0,0,1.0,1,1.0,1,1.0,1,0.10212693837051624,55
5327,2,18517,3981,14536,0,0,0,1.0,1,1.0,1,1.0,1,0.10743363157502596,56
5328,4,18521,3983,14538,0,0,0,1.0,1,1.0,1,1.0,1,0.11347543282746414,57
5329,0,18521,3983,14538,0,0,0,1.0,1,1.0,1,1.0,1,0.11347543282746414,57
5330,2,18523,3984,14539,0,0,0,1.0,1,1.0,1,1.0,1,0.12409326548757307,56
5331,4,18527,3985,14542,0,0,0,1.0,1,1.0,1,1.0,1,0.1312417314849561,57
5332,4,18531,3985,14546,0,0,0,1.0,1,1.0,1,1.0,1,0.1055871923320976,58
5333,8,18539,3986,14553,0,0,0,1.0,1,1.0,1,1.0,1,0.08718055435909448,59
5334,11,18550,3988,14562,0,0,0,1.0,1,1.0,1,1.0,1,0.13140848760672064,59
5335,7,18557,3988,14569,0,0,0,1.0,1,1.0,1,1.0,1,0.11432794962011376,58
5336,9,18566,3988,14578,0,0,0,1.0,1,1.0,1,1.0,1,0.10848975620676918,59
5337,9,18575,3989,14586,0,0,0,1.0,1,1.0,1,1.0,1,0.09139331096440166,60
5338,6,18581,3989,14592,0,0,0,1.0,1,1.0,1,1.0,1,0.10910196214926401,60
5339,5,18586,3989,14597,0,0,0,1.0,1,1.0,1,1.0,1,0.1448453386399281,60
5340,7,18593,3991,14602,0,0,0,1.0,1,1.0,1,1.0,1,0.12862551227747082,60
5341,3,18596,3991,14605,0,0,0,1.0,1,1.0,1,1.0,1,0.07212295126671266,61
5342,2,18598,3993,14605,0,0,0,1.0,1,1.0,1,1.0,1,0.11966727789888769,59
5343,5,18603,3994,14609,0,0,0,1.0,1,1.0,1,1.0,1,0.07952460119846476,58
5344,1,18604,3995,14609,0,0,0,1.0,1,1.0,1,1.0,1,0.11857770649856336,58
5345,1,18605,3996,14609,0,0,0,1.0,1,1.0,1,1.0,1,0.10750297026009269,54
5346,2,18607,3997,14610,0,0,0,1.0,1,1.0,1,1.0,1,0.11078396037144,54
5347,0,18607,3997,14610,0,0,0,1.0,1,1.0,1,1.0,1,0.11167340590308737,54
5348,3,18610,3998,14612,0,0,0,1.0,1,1.0,1,1.0,1,0.11204275108287441,55
5349,1,18611,3999,14612,0,0,0,1.0,1,1.0,1,1.0,1,0.11359782570016584,56
5350,1,18612,3999,14613,0,0,0,1.0,1,1.0,1,1.0,1,0.11276268910763906,56
5351,4,18616,4001,14615,0,0,0,1.0,1,1.0,1,1.0,1,0.13796540902539464,57
5352,3,18619,4002,14617,0,0,0,1.0,1,1.0,1,1.0,1,0.11384507084707537,57
5353,0,18619,4002,14617,0,0,0,1.0,1,1.0,1,1.0,1,0.11384507084707537,57
5354,0,18619,4002,14617,0,0,0,1.0,1,1.0,1,1.0,1,0.11175097110427501,56
5355,1,18620,4003,14617,0,0,0,1.0,1,1.0,1,1.0,1,0.12056141673882614,57
5356,3,18623,4003,14620,0,0,0,1.0,1,1.0,1,1.0,1,0.11036779015118292,56
5357,1,18624,4003,14621,0,0,0,1.0,1,1.0,1,1.0,1,0.11626848126767056,56
5358,0,18624,4003,14621,0,0,0,1.0,1,1.0,1,1.0,1,0.10662084025736505,57
5359,1,18625,4004,14621,0,0,0,1.0,1,1.0,1,1.0,1,0.12904449203802695,57
5360,0,18625,4004,14621,0,0,0,1.0,1,1.0,1,1.0,1,0.14236613781379365,55
5361,4,18629,4006,14623,0,0,0,1.0,1,1.0,1,1.0,1,0.14927236098673774,56
5362,1,18630,4006,14624,0,0,0,1.0,1,1.0,1,1.0,1,0.1349242344216178,57
5363,2,18632,4007,14625,0,0,0,1.0,1,1.0,1,1.0,1,0.15916221942755704,57
5364,2,18634,4007,14627,0,0,0,1.0,1,1.0,1,1.0,1,0.17538074623477495,58
5365,2,18636,4007,14629,0,0,0,1.0,1,1.0,1,1.0,1,0.15099739326378767,59
5366,10,18646,4009,14637,0,0,0,1.0,1,1.0,1,1.0,1,0.17254622381928597,60
5367,6,18652,4010,14642,0,0,0,1.0,1,1.0,1,1.0,1,0.15662461561589444,60
5368,6,18658,4011,14647,0,0,0,1.0,1,1.0,1,1.0,1,0.1432076968738529,58
5369,1,18659,4012,14647,0,0,0,1.0,1,1.0,1,1.0,1,0.15436745137341593,58
5370,1,18660,4013,14647,0,0,0,1.0,1,1.0,1,1.0,1,0.17343002451962533,57
5371,8,18668,4015,14653,0,0,0,1.0,1,1.0,1,1.0,1,0.14659976309770295,56
5372,3,18671,4018,14653,0,0,0,1.0,1,1.0,1,1.0,1,0.1728688965935757,55
5373,3,18674,4020,14654,0,0,0,1.0,1,1.0,1,1.0,1,0.1925780166391203,54
5374,0,18674,4020,14654,0,0,0,1.0,1,1.0,1,1.0,1,0.1609092748307253,53
5375,2,18676,4021,14655,0,0,0,1.0,1,1.0,1,1.0,1,0.17793236560249676,52
5376,2,18678,4021,14657,0,0,0,1.0,1,1.0,1,1.0,1,0.15509632945931068,52
5377,3,18681,4023,14658,0,0,0,1.0,1,1.0,1,1.0,1,0.19515849082692407,51
5378,2,18683,4025,14658,0,0,0,1.0,1,1.0,1,1.0,1,0.20548729318101275,52
5379,1,18684,4026,14658,0,0,0,1.0,1,1.0,1,1.0,1,0.21607152792631593,50
5380,3,18687,4028,14659,0,0,0,1.0,1,1.0,1,1.0,1,0.2660388589154998,51
5381,2,18689,4029,14660,0,0,0,1.0,1,1.0,1,1.0,1,0.19851655349085115,50
5382,3,18692,4030,14662,0,0,0,1.0,1,1.0,1,1.0,1,0.17806716850534063,48
5383,1,18693,4030,14663,0,0,0,1.0,1,1.0,1,1.0,1,0.18209555741797284,48
5384,4,18697,4030,14667,0,0,0,1.0,1,1.0,1,1.0,1,0.1773397774014576,48
5385,0,18697,4030,14667,0,0,0,1.0,1,1.0,1,1.0,1,0.1876864604121336,47
5386,6,18703,4031,14672,0,0,0,1.0,1,1.0,1,1.0,1,0.12923227041549815,48
5387,0,18703,4031,14672,0,0,0,1.0,1,1.0,1,1.0,1,0.13133873781699487,48
5388,2,18705,4032,14673,0,0,0,1.0,1,1.0,1,1.0,1,0.10802445420221242,48
5389,4,18709,4033,14676,0,0,0,1.0,1,1.0,1,1.0,1,0.10347647458135786,50
5390,3,18712,4034,14678,0,0,0,1.0,1,1.0,1,1.0,1,0.14107717772015643,52
5391,1,18713,4034,14679,0,0,0,1.0,1,1.0,1,1.0,1,0.1477992632189411,52
5392,3,18716,4034,14682,0,0,0,1.0,1,1.0,1,1.0,1,0.15380084265102562,51
5393,4,18720,4034,14686,0,0,0,1.0,1,1.0,1,1.0,1,0.16356493833498897,50
5394,3,18723,4034,14689,0,0,0,1.0,1,1.0,1,1.0,1,0.15951953513972253,50
5395,3,18726,4036,14690,0,0,0,1.0,1,1.0,1,1.0,1,0.18561275356782514,49
5396,6,18732,4037,14695,0,0,0,1.0,1,1.0,1,1.0,1,0.19679597758796522,48
5397,6,18738,4039,14699,0,0,0,1.0,1,1.0,1,1.0,1,0.23889983346535867,48
5398,6,18744,4039,14705,0,0,0,1.0,1,1.0,1,1.0,1,0.22925872115301854,46
5399,7,18751,4041,14710,0,0,0,1.0,1,1.0,1,1.0,1,0.24977917306584482,46
5400,5,18756,4041,14715,0,0,0,1.0,1,1.0,1,1.0,1,0.2312710990462586,48
5401,11,18767,4041,14726,0,0,0,1.0,1,1.0,1,1.0,1,0.0703216297663883,49
5402,0,18767,4041,14726,0,0,0,1.0,1,1.0,1,1.0,1,0.0,0
