,SuccessfulHandoverCount,TotalSuccessfulHandoverCount,TotalSuccessfulHandoverCountRange,TotalSuccessfulHandoverCountLoadBalancing,TotalSuccessfulHandoverCountOverload,FailedHandoverCount,TotalFailedHandoverCount,AvgQoS,MinQoS,AvgQoS_LoadBased,MinQoS_LoadBased,AvgQoS_RangeBased,MinQoS_RangeBased,GiniLoad,VehicleCount
0,0,0,0,0,0,0,0,1.0,1,1.0,1,1.0,1,0.0,0
1,21,21,0,21,0,0,0,1.0,1,1.0,1,1.0,1,0.22146556179179222,30
2,17,38,0,38,0,0,0,1.0,1,1.0,1,1.0,1,0.23998861497877716,32
3,7,45,0,45,0,0,0,1.0,1,1.0,1,1.0,1,0.13125773898387924,33
4,1,46,0,46,0,0,0,1.0,1,1.0,1,1.0,1,0.16930107670181638,34
5,0,46,0,46,0,0,0,1.0,1,1.0,1,1.0,1,0.15390081399762018,36
6,1,47,0,47,0,0,0,1.0,1,1.0,1,1.0,1,0.1420138489580654,38
7,1,48,0,48,0,0,0,1.0,1,1.0,1,1.0,1,0.1433995670578598,40
8,0,48,0,48,0,0,0,1.0,1,1.0,1,1.0,1,0.1433995670578598,40
9,0,48,0,48,0,0,0,1.0,1,1.0,1,1.0,1,0.1433995670578598,40
10,3,51,1,50,0,0,0,1.0,1,1.0,1,1.0,1,0.1502231373843254,41
11,0,51,1,50,0,0,0,1.0,1,1.0,1,1.0,1,0.1502442437595102,40
12,3,54,2,52,0,0,0,1.0,1,1.0,1,1.0,1,0.07953093920142408,39
13,3,57,5,52,0,0,0,1.0,1,1.0,1,1.0,1,0.16861430263998226,37
14,1,58,5,53,0,0,0,1.0,1,1.0,1,1.0,1,0.20764663188187393,35
15,4,62,5,57,0,0,0,1.0,1,1.0,1,1.0,1,0.15418439479524168,36
16,3,65,7,58,0,0,0,1.0,1,1.0,1,1.0,1,0.20767002723046185,34
17,3,68,7,61,0,0,0,1.0,1,1.0,1,1.0,1,0.2111585607879382,33
18,0,68,7,61,0,0,0,1.0,1,1.0,1,1.0,1,0.2234812494998465,34
19,1,69,8,61,0,0,0,1.0,1,1.0,1,1.0,1,0.2462970513643385,34
20,1,70,8,62,0,0,0,1.0,1,1.0,1,1.0,1,0.2184890682305183,34
21,5,75,9,66,0,0,0,1.0,1,1.0,1,1.0,1,0.19429626372426267,36
22,0,75,9,66,0,0,0,1.0,1,1.0,1,1.0,1,0.21715330173680197,35
23,6,81,11,70,0,0,0,1.0,1,1.0,1,1.0,1,0.16732567101346357,35
24,2,83,12,71,0,0,0,1.0,1,1.0,1,1.0,1,0.12288111404467049,35
25,2,85,13,72,0,0,0,1.0,1,1.0,1,1.0,1,0.11209299298518174,35
26,3,88,15,73,0,0,0,1.0,1,1.0,1,1.0,1,0.1418315548898318,36
27,2,90,16,74,0,0,0,1.0,1,1.0,1,1.0,1,0.1046986133387297,34
28,2,92,17,75,0,0,0,1.0,1,1.0,1,1.0,1,0.1418212471421897,35
29,3,95,17,78,0,0,0,1.0,1,1.0,1,1.0,1,0.09650117443835161,33
30,3,98,19,79,0,0,0,1.0,1,1.0,1,1.0,1,0.11715933141257538,33
31,1,99,19,80,0,0,0,1.0,1,1.0,1,1.0,1,0.18869480980718029,33
32,1,100,20,80,0,0,0,1.0,1,1.0,1,1.0,1,0.23509176630405718,32
33,1,101,20,81,0,0,0,1.0,1,1.0,1,1.0,1,0.22587201236398272,33
34,2,103,21,82,0,0,0,1.0,1,1.0,1,1.0,1,0.2214097677885397,33
35,3,106,21,85,0,0,0,1.0,1,1.0,1,1.0,1,0.16936004988137338,35
36,1,107,21,86,0,0,0,1.0,1,1.0,1,1.0,1,0.17075084934531023,36
37,4,111,22,89,0,0,0,1.0,1,1.0,1,1.0,1,0.11725932065078176,37
38,2,113,23,90,0,0,0,1.0,1,1.0,1,1.0,1,0.1251226767784909,36
39,1,114,23,91,0,0,0,1.0,1,1.0,1,1.0,1,0.14545796588624674,38
40,1,115,23,92,0,0,0,1.0,1,1.0,1,1.0,1,0.15406270430780125,40
41,0,115,23,92,0,0,0,1.0,1,1.0,1,1.0,1,0.15406270430780125,40
42,1,116,24,92,0,0,0,1.0,1,1.0,1,1.0,1,0.17039707331402806,40
43,3,119,26,93,0,0,0,1.0,1,1.0,1,1.0,1,0.23472091578119714,43
44,0,119,26,93,0,0,0,1.0,1,1.0,1,1.0,1,0.23472091578119714,43
45,4,123,27,96,0,0,0,1.0,1,1.0,1,1.0,1,0.18999828551650838,44
46,0,123,27,96,0,0,0,1.0,1,1.0,1,1.0,1,0.18999828551650838,44
47,0,123,27,96,0,0,0,1.0,1,1.0,1,1.0,1,0.18999828551650838,44
48,1,124,28,96,0,0,0,1.0,1,1.0,1,1.0,1,0.2242435241858091,44
49,1,125,28,97,0,0,0,1.0,1,1.0,1,1.0,1,0.21055629526696515,41
50,0,125,28,97,0,0,0,1.0,1,1.0,1,1.0,1,0.2071289515653343,40
51,0,125,28,97,0,0,0,1.0,1,1.0,1,1.0,1,0.21319568842448017,38
52,1,126,29,97,0,0,0,1.0,1,1.0,1,1.0,1,0.2637105674210142,37
53,4,130,29,101,0,0,0,1.0,1,1.0,1,1.0,1,0.2303768786556277,38
54,2,132,29,103,0,0,0,1.0,1,1.0,1,1.0,1,0.2342969422577745,38
55,5,137,30,107,0,0,0,1.0,1,1.0,1,1.0,1,0.1927522374369917,38
56,1,138,31,107,0,0,0,1.0,1,1.0,1,1.0,1,0.18165334431882402,38
57,2,140,32,108,0,0,0,1.0,1,1.0,1,1.0,1,0.17819843333039126,38
58,3,143,35,108,0,0,0,1.0,1,1.0,1,1.0,1,0.24265091588238427,38
59,4,147,35,112,0,0,0,1.0,1,1.0,1,1.0,1,0.14012689988424623,40
60,1,148,36,112,0,0,0,1.0,1,1.0,1,1.0,1,0.16021584823929758,40
61,0,148,36,112,0,0,0,1.0,1,1.0,1,1.0,1,0.15325527517524307,40
62,2,150,37,113,0,0,0,1.0,1,1.0,1,1.0,1,0.15077372935034014,42
63,1,151,38,113,0,0,0,1.0,1,1.0,1,1.0,1,0.15665233953731986,40
64,0,151,38,113,0,0,0,1.0,1,1.0,1,1.0,1,0.15347012885553188,41
65,1,152,39,113,0,0,0,1.0,1,1.0,1,1.0,1,0.17368436735611223,41
66,0,152,39,113,0,0,0,1.0,1,1.0,1,1.0,1,0.1738765016419069,41
67,0,152,39,113,0,0,0,1.0,1,1.0,1,1.0,1,0.1738765016419069,41
68,1,153,40,113,0,0,0,1.0,1,1.0,1,1.0,1,0.18343406548618021,41
69,6,159,42,117,0,0,0,1.0,1,1.0,1,1.0,1,0.16529063842820976,41
70,0,159,42,117,0,0,0,1.0,1,1.0,1,1.0,1,0.18265772007666925,42
71,4,163,42,121,0,0,0,1.0,1,1.0,1,1.0,1,0.1131485484220068,44
72,0,163,42,121,0,0,0,1.0,1,1.0,1,1.0,1,0.1131485484220068,44
73,1,164,42,122,0,0,0,1.0,1,1.0,1,1.0,1,0.09941188828193723,46
74,1,165,43,122,0,0,0,1.0,1,1.0,1,1.0,1,0.1440733288066841,44
75,2,167,44,123,0,0,0,1.0,1,1.0,1,1.0,1,0.10517128276039545,44
76,4,171,47,124,0,0,0,1.0,1,1.0,1,1.0,1,0.21138443252949982,45
77,5,176,48,128,0,0,0,1.0,1,1.0,1,1.0,1,0.15792650760398813,44
78,2,178,48,130,0,0,0,1.0,1,1.0,1,1.0,1,0.1498482189689562,44
79,0,178,48,130,0,0,0,1.0,1,1.0,1,1.0,1,0.1637850687672439,43
80,2,180,50,130,0,0,0,1.0,1,1.0,1,1.0,1,0.17500673024660177,43
81,5,185,52,133,0,0,0,1.0,1,1.0,1,1.0,1,0.20667801896402727,44
82,3,188,54,134,0,0,0,1.0,1,1.0,1,1.0,1,0.22875488314023554,45
83,8,196,56,140,0,0,0,1.0,1,1.0,1,1.0,1,0.2118095038533487,45
84,1,197,56,141,0,0,0,1.0,1,1.0,1,1.0,1,0.20487904279355404,45
85,1,198,56,142,0,0,0,1.0,1,1.0,1,1.0,1,0.19257803950554003,45
86,0,198,56,142,0,0,0,1.0,1,1.0,1,1.0,1,0.19257803950554003,45
87,0,198,56,142,0,0,0,1.0,1,1.0,1,1.0,1,0.20824444909440287,44
88,0,198,56,142,0,0,0,1.0,1,1.0,1,1.0,1,0.19217444317470225,45
89,6,204,58,146,0,0,0,1.0,1,1.0,1,1.0,1,0.1856786076320491,46
90,1,205,58,147,0,0,0,1.0,1,1.0,1,1.0,1,0.2004492061440277,44
91,1,206,59,147,0,0,0,1.0,1,1.0,1,1.0,1,0.18329312198541803,45
92,0,206,59,147,0,0,0,1.0,1,1.0,1,1.0,1,0.1964652741144086,46
93,0,206,59,147,0,0,0,1.0,1,1.0,1,1.0,1,0.1964652741144086,46
94,0,206,59,147,0,0,0,1.0,1,1.0,1,1.0,1,0.1964652741144086,46
95,1,207,59,148,0,0,0,1.0,1,1.0,1,1.0,1,0.20231959218813947,46
96,1,208,59,149,0,0,0,1.0,1,1.0,1,1.0,1,0.19772452987867215,46
97,0,208,59,149,0,0,0,1.0,1,1.0,1,1.0,1,0.19024505790874455,47
98,0,208,59,149,0,0,0,1.0,1,1.0,1,1.0,1,0.19024505790874455,47
99,7,215,61,154,0,0,0,1.0,1,1.0,1,1.0,1,0.20407226779885002,46
100,2,217,62,155,0,0,0,1.0,1,1.0,1,1.0,1,0.20955969200299754,48
101,1,218,62,156,0,0,0,1.0,1,1.0,1,1.0,1,0.2059949040831407,49
102,2,220,63,157,0,0,0,1.0,1,1.0,1,1.0,1,0.18154764975492224,49
103,1,221,63,158,0,0,0,1.0,1,1.0,1,1.0,1,0.16249969027292419,48
104,2,223,64,159,0,0,0,1.0,1,1.0,1,1.0,1,0.16969340717122888,49
105,4,227,67,160,0,0,0,1.0,1,1.0,1,1.0,1,0.156022835457939,48
106,3,230,68,162,0,0,0,1.0,1,1.0,1,1.0,1,0.12470317179490395,48
107,2,232,69,163,0,0,0,1.0,1,1.0,1,1.0,1,0.13099381006913854,47
108,3,235,70,165,0,0,0,1.0,1,1.0,1,1.0,1,0.09197217163969672,47
109,3,238,73,165,0,0,0,1.0,1,1.0,1,1.0,1,0.14644543295792206,47
110,0,238,73,165,0,0,0,1.0,1,1.0,1,1.0,1,0.14571163835853587,47
111,3,241,74,167,0,0,0,1.0,1,1.0,1,1.0,1,0.07428979271600843,46
112,1,242,75,167,0,0,0,1.0,1,1.0,1,1.0,1,0.09973521966453114,46
113,5,247,78,169,0,0,0,1.0,1,1.0,1,1.0,1,0.12835147647133993,45
114,1,248,78,170,0,0,0,1.0,1,1.0,1,1.0,1,0.11017122966871691,46
115,1,249,78,171,0,0,0,1.0,1,1.0,1,1.0,1,0.11426500164802193,47
116,1,250,79,171,0,0,0,1.0,1,1.0,1,1.0,1,0.1259498527751745,48
117,4,254,82,172,0,0,0,1.0,1,1.0,1,1.0,1,0.12406947091805,48
118,1,255,82,173,0,0,0,1.0,1,1.0,1,1.0,1,0.1282334464341874,49
119,1,256,83,173,0,0,0,1.0,1,1.0,1,1.0,1,0.13894902043173643,50
120,0,256,83,173,0,0,0,1.0,1,1.0,1,1.0,1,0.13397503133754682,51
121,2,258,83,175,0,0,0,1.0,1,1.0,1,1.0,1,0.11456683499271575,51
122,1,259,84,175,0,0,0,1.0,1,1.0,1,1.0,1,0.10855680209473896,51
123,0,259,84,175,0,0,0,1.0,1,1.0,1,1.0,1,0.10855680209473896,51
124,0,259,84,175,0,0,0,1.0,1,1.0,1,1.0,1,0.10855680209473896,51
125,1,260,84,176,0,0,0,1.0,1,1.0,1,1.0,1,0.13867305679509215,50
126,3,263,85,178,0,0,0,1.0,1,1.0,1,1.0,1,0.09882780929121693,52
127,3,266,85,181,0,0,0,1.0,1,1.0,1,1.0,1,0.0884595893260912,50
128,0,266,85,181,0,0,0,1.0,1,1.0,1,1.0,1,0.0884595893260912,50
129,3,269,86,183,0,0,0,1.0,1,1.0,1,1.0,1,0.09835939245978849,52
130,1,270,87,183,0,0,0,1.0,1,1.0,1,1.0,1,0.1272591989844026,52
131,3,273,87,186,0,0,0,1.0,1,1.0,1,1.0,1,0.09021001300882321,54
132,0,273,87,186,0,0,0,1.0,1,1.0,1,1.0,1,0.09021001300882321,54
133,2,275,87,188,0,0,0,1.0,1,1.0,1,1.0,1,0.08689458836714364,52
134,2,277,88,189,0,0,0,1.0,1,1.0,1,1.0,1,0.060034061995642055,52
135,4,281,92,189,0,0,0,1.0,1,1.0,1,1.0,1,0.14928616131626465,51
136,4,285,92,193,0,0,0,1.0,1,1.0,1,1.0,1,0.11282649786046794,51
137,1,286,92,194,0,0,0,1.0,1,1.0,1,1.0,1,0.07288708562984848,50
138,3,289,93,196,0,0,0,1.0,1,1.0,1,1.0,1,0.07452347172301453,52
139,4,293,95,198,0,0,0,1.0,1,1.0,1,1.0,1,0.1063361836200093,51
140,1,294,96,198,0,0,0,1.0,1,1.0,1,1.0,1,0.09641623348275831,51
141,2,296,98,198,0,0,0,1.0,1,1.0,1,1.0,1,0.13387603876198453,50
142,2,298,100,198,0,0,0,1.0,1,1.0,1,1.0,1,0.135702136392105,51
143,4,302,101,201,0,0,0,1.0,1,1.0,1,1.0,1,0.08495982711118204,48
144,5,307,103,204,0,0,0,1.0,1,1.0,1,1.0,1,0.10235070536893077,49
145,1,308,104,204,0,0,0,1.0,1,1.0,1,1.0,1,0.09754715781753916,47
146,4,312,105,207,0,0,0,1.0,1,1.0,1,1.0,1,0.07433994549113097,49
147,3,315,106,209,0,0,0,1.0,1,1.0,1,1.0,1,0.09445645062729176,46
148,1,316,107,209,0,0,0,1.0,1,1.0,1,1.0,1,0.07957756455159737,47
149,1,317,108,209,0,0,0,1.0,1,1.0,1,1.0,1,0.09465379161495807,46
150,0,317,108,209,0,0,0,1.0,1,1.0,1,1.0,1,0.07922558161834614,47
151,2,319,110,209,0,0,0,1.0,1,1.0,1,1.0,1,0.11897399456877428,46
152,0,319,110,209,0,0,0,1.0,1,1.0,1,1.0,1,0.13612885355893348,45
153,1,320,110,210,0,0,0,1.0,1,1.0,1,1.0,1,0.13748078641584183,46
154,0,320,110,210,0,0,0,1.0,1,1.0,1,1.0,1,0.15616336550334342,44
155,2,322,111,211,0,0,0,1.0,1,1.0,1,1.0,1,0.14538362706715854,45
156,3,325,112,213,0,0,0,1.0,1,1.0,1,1.0,1,0.1352545967333028,43
157,2,327,112,215,0,0,0,1.0,1,1.0,1,1.0,1,0.12743408227169242,42
158,3,330,112,218,0,0,0,1.0,1,1.0,1,1.0,1,0.10961652690235954,43
159,1,331,113,218,0,0,0,1.0,1,1.0,1,1.0,1,0.15938755957037462,44
160,0,331,113,218,0,0,0,1.0,1,1.0,1,1.0,1,0.15651331952779596,44
161,4,335,114,221,0,0,0,1.0,1,1.0,1,1.0,1,0.14071240669977625,44
162,2,337,115,222,0,0,0,1.0,1,1.0,1,1.0,1,0.15003946220585668,44
163,7,344,121,223,0,0,0,1.0,1,1.0,1,1.0,1,0.20622124810857692,44
164,2,346,122,224,0,0,0,1.0,1,1.0,1,1.0,1,0.21798106536752376,44
165,7,353,124,229,0,0,0,1.0,1,1.0,1,1.0,1,0.15158733962895932,43
166,3,356,125,231,0,0,0,1.0,1,1.0,1,1.0,1,0.19236554061344632,43
167,4,360,126,234,0,0,0,1.0,1,1.0,1,1.0,1,0.1579427126410337,42
168,0,360,126,234,0,0,0,1.0,1,1.0,1,1.0,1,0.11647892154379721,40
169,2,362,126,236,0,0,0,1.0,1,1.0,1,1.0,1,0.09077329152738024,41
170,0,362,126,236,0,0,0,1.0,1,1.0,1,1.0,1,0.06861950731100261,39
171,2,364,127,237,0,0,0,1.0,1,1.0,1,1.0,1,0.07145371044121833,39
172,0,364,127,237,0,0,0,1.0,1,1.0,1,1.0,1,0.0853303830350418,38
173,1,365,128,237,0,0,0,1.0,1,1.0,1,1.0,1,0.11229277912727387,38
174,0,365,128,237,0,0,0,1.0,1,1.0,1,1.0,1,0.13341120211208754,37
175,2,367,130,237,0,0,0,1.0,1,1.0,1,1.0,1,0.2047572629461254,36
176,3,370,131,239,0,0,0,1.0,1,1.0,1,1.0,1,0.1858813658314998,36
177,4,374,134,240,0,0,0,1.0,1,1.0,1,1.0,1,0.17677156279303732,38
178,1,375,134,241,0,0,0,1.0,1,1.0,1,1.0,1,0.18827318253907432,39
179,2,377,134,243,0,0,0,1.0,1,1.0,1,1.0,1,0.16172364050565374,40
180,1,378,134,244,0,0,0,1.0,1,1.0,1,1.0,1,0.15095551484289269,40
181,0,378,134,244,0,0,0,1.0,1,1.0,1,1.0,1,0.181836875953706,39
182,2,380,136,244,0,0,0,1.0,1,1.0,1,1.0,1,0.2026610207486157,40
183,3,383,138,245,0,0,0,1.0,1,1.0,1,1.0,1,0.2345008079700934,40
184,1,384,138,246,0,0,0,1.0,1,1.0,1,1.0,1,0.21316472281724966,38
185,4,388,139,249,0,0,0,1.0,1,1.0,1,1.0,1,0.16508653544542487,38
186,3,391,141,250,0,0,0,1.0,1,1.0,1,1.0,1,0.1971478468116282,37
187,7,398,142,256,0,0,0,1.0,1,1.0,1,1.0,1,0.15777274512250616,36
188,4,402,143,259,0,0,0,1.0,1,1.0,1,1.0,1,0.15574194670112293,36
189,3,405,144,261,0,0,0,1.0,1,1.0,1,1.0,1,0.08618307226383368,36
190,0,405,144,261,0,0,0,1.0,1,1.0,1,1.0,1,0.12523393580960365,36
191,1,406,145,261,0,0,0,1.0,1,1.0,1,1.0,1,0.13899084903063583,37
192,0,406,145,261,0,0,0,1.0,1,1.0,1,1.0,1,0.13899084903063583,37
193,1,407,146,261,0,0,0,1.0,1,1.0,1,1.0,1,0.14791865987116565,38
194,1,408,147,261,0,0,0,1.0,1,1.0,1,1.0,1,0.16419224618513614,39
195,7,415,148,267,0,0,0,1.0,1,1.0,1,1.0,1,0.12448368021678899,40
196,1,416,149,267,0,0,0,1.0,1,1.0,1,1.0,1,0.11670334134731622,40
197,2,418,149,269,0,0,0,1.0,1,1.0,1,1.0,1,0.11373886841682893,40
198,2,420,150,270,0,0,0,1.0,1,1.0,1,1.0,1,0.11392700575804837,40
199,1,421,151,270,0,0,0,1.0,1,1.0,1,1.0,1,0.12618039123396022,40
200,0,421,151,270,0,0,0,1.0,1,1.0,1,1.0,1,0.12618039123396022,40
201,0,421,151,270,0,0,0,1.0,1,1.0,1,1.0,1,0.14317901204513603,39
202,0,421,151,270,0,0,0,1.0,1,1.0,1,1.0,1,0.1256704956934197,40
203,2,423,153,270,0,0,0,1.0,1,1.0,1,1.0,1,0.1387926730691914,39
204,1,424,154,270,0,0,0,1.0,1,1.0,1,1.0,1,0.15224360412580742,38
205,2,426,154,272,0,0,0,1.0,1,1.0,1,1.0,1,0.08029990211114492,37
206,2,428,155,273,0,0,0,1.0,1,1.0,1,1.0,1,0.07451945180116541,36
207,1,429,156,273,0,0,0,1.0,1,1.0,1,1.0,1,0.10875152842816317,37
208,2,431,156,275,0,0,0,1.0,1,1.0,1,1.0,1,0.11651506029959927,36
209,2,433,158,275,0,0,0,1.0,1,1.0,1,1.0,1,0.15297515920971147,36
210,1,434,159,275,0,0,0,1.0,1,1.0,1,1.0,1,0.21105390380145586,36
211,1,435,159,276,0,0,0,1.0,1,1.0,1,1.0,1,0.1903939475879476,34
212,1,436,160,276,0,0,0,1.0,1,1.0,1,1.0,1,0.24349339346306054,34
213,5,441,160,281,0,0,0,1.0,1,1.0,1,1.0,1,0.20753810315584506,36
214,3,444,162,282,0,0,0,1.0,1,1.0,1,1.0,1,0.2564172696356925,35
215,5,449,162,287,0,0,0,1.0,1,1.0,1,1.0,1,0.17658833611992225,35
216,2,451,162,289,0,0,0,1.0,1,1.0,1,1.0,1,0.12436051985168615,37
217,0,451,162,289,0,0,0,1.0,1,1.0,1,1.0,1,0.12436051985168615,37
218,2,453,164,289,0,0,0,1.0,1,1.0,1,1.0,1,0.11694316259714028,37
219,2,455,165,290,0,0,0,1.0,1,1.0,1,1.0,1,0.10758572540798864,37
220,0,455,165,290,0,0,0,1.0,1,1.0,1,1.0,1,0.11683717963047648,38
221,0,455,165,290,0,0,0,1.0,1,1.0,1,1.0,1,0.10263001413263435,39
222,1,456,166,290,0,0,0,1.0,1,1.0,1,1.0,1,0.10789092764693954,39
223,4,460,168,292,0,0,0,1.0,1,1.0,1,1.0,1,0.11344574280980174,40
224,1,461,169,292,0,0,0,1.0,1,1.0,1,1.0,1,0.11250327406899455,40
225,3,464,169,295,0,0,0,1.0,1,1.0,1,1.0,1,0.0783264795750139,39
226,5,469,173,296,0,0,0,1.0,1,1.0,1,1.0,1,0.17716162176942737,39
227,5,474,174,300,0,0,0,1.0,1,1.0,1,1.0,1,0.15775718774760816,39
228,2,476,176,300,0,0,0,1.0,1,1.0,1,1.0,1,0.1871949718130441,38
229,3,479,177,302,0,0,0,1.0,1,1.0,1,1.0,1,0.15409844111574525,39
230,1,480,178,302,0,0,0,1.0,1,1.0,1,1.0,1,0.1454081410190684,38
231,3,483,179,304,0,0,0,1.0,1,1.0,1,1.0,1,0.12935020877942804,38
232,2,485,180,305,0,0,0,1.0,1,1.0,1,1.0,1,0.1489295765446324,37
233,2,487,181,306,0,0,0,1.0,1,1.0,1,1.0,1,0.1404125584394675,36
234,0,487,181,306,0,0,0,1.0,1,1.0,1,1.0,1,0.17306029095005954,34
235,2,489,183,306,0,0,0,1.0,1,1.0,1,1.0,1,0.2328269086880806,34
236,0,489,183,306,0,0,0,1.0,1,1.0,1,1.0,1,0.2512457185538879,33
237,1,490,183,307,0,0,0,1.0,1,1.0,1,1.0,1,0.2618823081508706,32
238,0,490,183,307,0,0,0,1.0,1,1.0,1,1.0,1,0.2629975572177606,32
239,2,492,185,307,0,0,0,1.0,1,1.0,1,1.0,1,0.2272333896369147,31
240,0,492,185,307,0,0,0,1.0,1,1.0,1,1.0,1,0.22276998285349023,28
241,4,496,186,310,0,0,0,1.0,1,1.0,1,1.0,1,0.20318692323253704,27
242,1,497,186,311,0,0,0,1.0,1,1.0,1,1.0,1,0.19550228754640572,29
243,2,499,187,312,0,0,0,1.0,1,1.0,1,1.0,1,0.17242968329872357,28
244,1,500,188,312,0,0,0,1.0,1,1.0,1,1.0,1,0.20035112977458522,28
245,1,501,189,312,0,0,0,1.0,1,1.0,1,1.0,1,0.1828437112649179,27
246,2,503,191,312,0,0,0,1.0,1,1.0,1,1.0,1,0.18095778485644345,25
247,3,506,192,314,0,0,0,1.0,1,1.0,1,1.0,1,0.15078751166779614,26
248,0,506,192,314,0,0,0,1.0,1,1.0,1,1.0,1,0.18295358191893002,27
249,1,507,193,314,0,0,0,1.0,1,1.0,1,1.0,1,0.14893719649876602,26
250,1,508,193,315,0,0,0,1.0,1,1.0,1,1.0,1,0.16941957598928742,27
251,2,510,194,316,0,0,0,1.0,1,1.0,1,1.0,1,0.17847768334617137,28
252,0,510,194,316,0,0,0,1.0,1,1.0,1,1.0,1,0.17847768334617137,28
253,1,511,195,316,0,0,0,1.0,1,1.0,1,1.0,1,0.17649067602647014,28
254,2,513,195,318,0,0,0,1.0,1,1.0,1,1.0,1,0.158024453157787,29
255,2,515,196,319,0,0,0,1.0,1,1.0,1,1.0,1,0.19329637273531577,30
256,0,515,196,319,0,0,0,1.0,1,1.0,1,1.0,1,0.19329637273531577,30
257,3,518,197,321,0,0,0,1.0,1,1.0,1,1.0,1,0.20167512200178583,32
258,4,522,198,324,0,0,0,1.0,1,1.0,1,1.0,1,0.20806695144993073,32
259,1,523,198,325,0,0,0,1.0,1,1.0,1,1.0,1,0.1868322608063347,32
260,0,523,198,325,0,0,0,1.0,1,1.0,1,1.0,1,0.13804807166992486,34
261,0,523,198,325,0,0,0,1.0,1,1.0,1,1.0,1,0.15621427705683946,35
262,4,527,200,327,0,0,0,1.0,1,1.0,1,1.0,1,0.20025150572757092,36
263,0,527,200,327,0,0,0,1.0,1,1.0,1,1.0,1,0.2003517505399315,34
264,1,528,200,328,0,0,0,1.0,1,1.0,1,1.0,1,0.1566466711293415,34
265,0,528,200,328,0,0,0,1.0,1,1.0,1,1.0,1,0.1856080955672129,33
266,1,529,201,328,0,0,0,1.0,1,1.0,1,1.0,1,0.21151091889990145,34
267,0,529,201,328,0,0,0,1.0,1,1.0,1,1.0,1,0.22299792584109554,33
268,2,531,201,330,0,0,0,1.0,1,1.0,1,1.0,1,0.2169697745137701,34
269,0,531,201,330,0,0,0,1.0,1,1.0,1,1.0,1,0.2169697745137701,34
270,1,532,201,331,0,0,0,1.0,1,1.0,1,1.0,1,0.20866005763012574,36
271,0,532,201,331,0,0,0,1.0,1,1.0,1,1.0,1,0.20866005763012574,36
272,2,534,201,333,0,0,0,1.0,1,1.0,1,1.0,1,0.20117129764096672,38
273,1,535,201,334,0,0,0,1.0,1,1.0,1,1.0,1,0.1836632270197006,38
274,2,537,202,335,0,0,0,1.0,1,1.0,1,1.0,1,0.18191958444843168,38
275,2,539,202,337,0,0,0,1.0,1,1.0,1,1.0,1,0.15860581442832947,38
276,2,541,202,339,0,0,0,1.0,1,1.0,1,1.0,1,0.13665435960630526,39
277,1,542,203,339,0,0,0,1.0,1,1.0,1,1.0,1,0.1770943789030119,38
278,4,546,203,343,0,0,0,1.0,1,1.0,1,1.0,1,0.1267661686903148,38
279,2,548,203,345,0,0,0,1.0,1,1.0,1,1.0,1,0.0914227623043195,38
280,1,549,204,345,0,0,0,1.0,1,1.0,1,1.0,1,0.12196666490278003,38
281,0,549,204,345,0,0,0,1.0,1,1.0,1,1.0,1,0.11263088930035281,38
282,0,549,204,345,0,0,0,1.0,1,1.0,1,1.0,1,0.11961453984541603,38
283,1,550,205,345,0,0,0,1.0,1,1.0,1,1.0,1,0.13570850857069797,38
284,0,550,205,345,0,0,0,1.0,1,1.0,1,1.0,1,0.13609777307036447,39
285,1,551,206,345,0,0,0,1.0,1,1.0,1,1.0,1,0.17414891615939618,39
286,0,551,206,345,0,0,0,1.0,1,1.0,1,1.0,1,0.17414891615939618,39
287,3,554,206,348,0,0,0,1.0,1,1.0,1,1.0,1,0.18049535746665543,39
288,2,556,206,350,0,0,0,1.0,1,1.0,1,1.0,1,0.13095089555931064,39
289,0,556,206,350,0,0,0,1.0,1,1.0,1,1.0,1,0.13095089555931064,39
290,1,557,207,350,0,0,0,1.0,1,1.0,1,1.0,1,0.14810439599800004,39
291,2,559,208,351,0,0,0,1.0,1,1.0,1,1.0,1,0.13870307531225454,39
292,1,560,208,352,0,0,0,1.0,1,1.0,1,1.0,1,0.12273333077834309,40
293,2,562,208,354,0,0,0,1.0,1,1.0,1,1.0,1,0.08791879705323191,41
294,1,563,209,354,0,0,0,1.0,1,1.0,1,1.0,1,0.07451343608047979,40
295,5,568,212,356,0,0,0,1.0,1,1.0,1,1.0,1,0.12465850359087502,42
296,2,570,214,356,0,0,0,1.0,1,1.0,1,1.0,1,0.11984818502858727,42
297,2,572,215,357,0,0,0,1.0,1,1.0,1,1.0,1,0.11475008428946872,43
298,2,574,216,358,0,0,0,1.0,1,1.0,1,1.0,1,0.15938498585049968,44
299,3,577,217,360,0,0,0,1.0,1,1.0,1,1.0,1,0.11496107293043645,44
300,4,581,217,364,0,0,0,1.0,1,1.0,1,1.0,1,0.07975924978884114,45
301,2,583,219,364,0,0,0,1.0,1,1.0,1,1.0,1,0.11576248043180588,47
302,3,586,220,366,0,0,0,1.0,1,1.0,1,1.0,1,0.10629654453173065,46
303,3,589,222,367,0,0,0,1.0,1,1.0,1,1.0,1,0.10005302458317497,45
304,2,591,224,367,0,0,0,1.0,1,1.0,1,1.0,1,0.12647261635827545,45
305,1,592,224,368,0,0,0,1.0,1,1.0,1,1.0,1,0.09888586343477326,43
306,1,593,224,369,0,0,0,1.0,1,1.0,1,1.0,1,0.13218168619150775,44
307,5,598,226,372,0,0,0,1.0,1,1.0,1,1.0,1,0.13128171973645944,42
308,1,599,227,372,0,0,0,1.0,1,1.0,1,1.0,1,0.14535883252818194,41
309,2,601,227,374,0,0,0,1.0,1,1.0,1,1.0,1,0.11642932121252242,42
310,0,601,227,374,0,0,0,1.0,1,1.0,1,1.0,1,0.0994277780315488,41
311,1,602,227,375,0,0,0,1.0,1,1.0,1,1.0,1,0.08041918125113245,41
312,0,602,227,375,0,0,0,1.0,1,1.0,1,1.0,1,0.07560058591966157,44
313,0,602,227,375,0,0,0,1.0,1,1.0,1,1.0,1,0.06679797037275101,43
314,2,604,228,376,0,0,0,1.0,1,1.0,1,1.0,1,0.06567711592407888,43
315,1,605,229,376,0,0,0,1.0,1,1.0,1,1.0,1,0.11780843860563116,43
316,0,605,229,376,0,0,0,1.0,1,1.0,1,1.0,1,0.11780843860563116,43
317,1,606,229,377,0,0,0,1.0,1,1.0,1,1.0,1,0.11217468930806915,44
318,3,609,232,377,0,0,0,1.0,1,1.0,1,1.0,1,0.2185932281446618,45
319,3,612,232,380,0,0,0,1.0,1,1.0,1,1.0,1,0.15082574845486119,46
320,2,614,233,381,0,0,0,1.0,1,1.0,1,1.0,1,0.19297910182577016,45
321,2,616,233,383,0,0,0,1.0,1,1.0,1,1.0,1,0.1386010958861058,44
322,0,616,233,383,0,0,0,1.0,1,1.0,1,1.0,1,0.13197105944363877,42
323,3,619,235,384,0,0,0,1.0,1,1.0,1,1.0,1,0.07691667462013294,42
324,0,619,235,384,0,0,0,1.0,1,1.0,1,1.0,1,0.07330956619664598,43
325,2,621,237,384,0,0,0,1.0,1,1.0,1,1.0,1,0.14293111112727494,43
326,0,621,237,384,0,0,0,1.0,1,1.0,1,1.0,1,0.14293111112727494,43
327,3,624,239,385,0,0,0,1.0,1,1.0,1,1.0,1,0.1311712465218604,44
328,0,624,239,385,0,0,0,1.0,1,1.0,1,1.0,1,0.1311712465218604,44
329,0,624,239,385,0,0,0,1.0,1,1.0,1,1.0,1,0.11511184658809301,45
330,0,624,239,385,0,0,0,1.0,1,1.0,1,1.0,1,0.12825393141757657,46
331,0,624,239,385,0,0,0,1.0,1,1.0,1,1.0,1,0.12825393141757657,46
332,0,624,239,385,0,0,0,1.0,1,1.0,1,1.0,1,0.10602380584760862,47
333,1,625,239,386,0,0,0,1.0,1,1.0,1,1.0,1,0.10558732764075697,48
334,0,625,239,386,0,0,0,1.0,1,1.0,1,1.0,1,0.10558732764075697,48
335,1,626,240,386,0,0,0,1.0,1,1.0,1,1.0,1,0.10747241654997887,49
336,3,629,240,389,0,0,0,1.0,1,1.0,1,1.0,1,0.09700228787490185,50
337,2,631,241,390,0,0,0,1.0,1,1.0,1,1.0,1,0.10496685334084187,51
338,0,631,241,390,0,0,0,1.0,1,1.0,1,1.0,1,0.10496685334084187,51
339,2,633,242,391,0,0,0,1.0,1,1.0,1,1.0,1,0.10643587633779088,51
340,1,634,243,391,0,0,0,1.0,1,1.0,1,1.0,1,0.13374073698820432,51
341,2,636,243,393,0,0,0,1.0,1,1.0,1,1.0,1,0.08834838447196164,51
342,1,637,244,393,0,0,0,1.0,1,1.0,1,1.0,1,0.114755196003325,51
343,1,638,244,394,0,0,0,1.0,1,1.0,1,1.0,1,0.11023987236847327,51
344,1,639,245,394,0,0,0,1.0,1,1.0,1,1.0,1,0.10356272541525091,50
345,0,639,245,394,0,0,0,1.0,1,1.0,1,1.0,1,0.10356272541525091,50
346,4,643,247,396,0,0,0,1.0,1,1.0,1,1.0,1,0.15356976071020134,50
347,3,646,247,399,0,0,0,1.0,1,1.0,1,1.0,1,0.11254499388891372,51
348,0,646,247,399,0,0,0,1.0,1,1.0,1,1.0,1,0.10857895247880121,52
349,3,649,249,400,0,0,0,1.0,1,1.0,1,1.0,1,0.11448371440617731,54
350,3,652,249,403,0,0,0,1.0,1,1.0,1,1.0,1,0.12223343923023326,54
351,6,658,253,405,0,0,0,1.0,1,1.0,1,1.0,1,0.1892885286450085,54
352,5,663,254,409,0,0,0,1.0,1,1.0,1,1.0,1,0.18283218466002368,56
353,6,669,256,413,0,0,0,1.0,1,1.0,1,1.0,1,0.13307492967015055,54
354,1,670,256,414,0,0,0,1.0,1,1.0,1,1.0,1,0.15096116220106387,53
355,2,672,257,415,0,0,0,1.0,1,1.0,1,1.0,1,0.12665220824801485,54
356,0,672,257,415,0,0,0,1.0,1,1.0,1,1.0,1,0.12734305991135447,54
357,4,676,258,418,0,0,0,1.0,1,1.0,1,1.0,1,0.133700374356819,53
358,0,676,258,418,0,0,0,1.0,1,1.0,1,1.0,1,0.17004149309332844,49
359,2,678,258,420,0,0,0,1.0,1,1.0,1,1.0,1,0.148014300741208,48
360,1,679,258,421,0,0,0,1.0,1,1.0,1,1.0,1,0.15501817897796305,47
361,3,682,258,424,0,0,0,1.0,1,1.0,1,1.0,1,0.12333568646254546,46
362,0,682,258,424,0,0,0,1.0,1,1.0,1,1.0,1,0.12289180090639344,46
363,1,683,258,425,0,0,0,1.0,1,1.0,1,1.0,1,0.12584944195346473,47
364,0,683,258,425,0,0,0,1.0,1,1.0,1,1.0,1,0.12584944195346473,47
365,1,684,258,426,0,0,0,1.0,1,1.0,1,1.0,1,0.10656534071003355,47
366,7,691,260,431,0,0,0,1.0,1,1.0,1,1.0,1,0.11604623257676804,50
367,2,693,261,432,0,0,0,1.0,1,1.0,1,1.0,1,0.11993547986111751,50
368,1,694,261,433,0,0,0,1.0,1,1.0,1,1.0,1,0.08611638899808718,51
369,0,694,261,433,0,0,0,1.0,1,1.0,1,1.0,1,0.10505579147840098,51
370,0,694,261,433,0,0,0,1.0,1,1.0,1,1.0,1,0.10505579147840098,51
371,0,694,261,433,0,0,0,1.0,1,1.0,1,1.0,1,0.12929984947159698,52
372,2,696,261,435,0,0,0,1.0,1,1.0,1,1.0,1,0.1181166574465844,53
373,1,697,262,435,0,0,0,1.0,1,1.0,1,1.0,1,0.11880336100502929,53
374,6,703,264,439,0,0,0,1.0,1,1.0,1,1.0,1,0.08291745123530211,53
375,2,705,266,439,0,0,0,1.0,1,1.0,1,1.0,1,0.09445996554979862,53
376,1,706,267,439,0,0,0,1.0,1,1.0,1,1.0,1,0.09991217413099128,53
377,4,710,270,440,0,0,0,1.0,1,1.0,1,1.0,1,0.1136309665299283,53
378,2,712,272,440,0,0,0,1.0,1,1.0,1,1.0,1,0.09646300537447651,53
379,3,715,273,442,0,0,0,1.0,1,1.0,1,1.0,1,0.08726451874864653,54
380,2,717,274,443,0,0,0,1.0,1,1.0,1,1.0,1,0.08601486122996296,54
381,1,718,275,443,0,0,0,1.0,1,1.0,1,1.0,1,0.09009714130204123,54
382,3,721,276,445,0,0,0,1.0,1,1.0,1,1.0,1,0.08698151710084571,55
383,2,723,277,446,0,0,0,1.0,1,1.0,1,1.0,1,0.07838725962836647,55
384,0,723,277,446,0,0,0,1.0,1,1.0,1,1.0,1,0.0808451852847124,54
385,1,724,277,447,0,0,0,1.0,1,1.0,1,1.0,1,0.08105126589458998,52
386,2,726,278,448,0,0,0,1.0,1,1.0,1,1.0,1,0.07918631068787702,52
387,2,728,279,449,0,0,0,1.0,1,1.0,1,1.0,1,0.09448388559108964,50
388,3,731,280,451,0,0,0,1.0,1,1.0,1,1.0,1,0.09984660292697739,52
389,1,732,281,451,0,0,0,1.0,1,1.0,1,1.0,1,0.1248163177487863,51
390,2,734,282,452,0,0,0,1.0,1,1.0,1,1.0,1,0.13302335927820602,50
391,7,741,286,455,0,0,0,1.0,1,1.0,1,1.0,1,0.10804005062196918,49
392,6,747,288,459,0,0,0,1.0,1,1.0,1,1.0,1,0.123743858285902,47
393,6,753,290,463,0,0,0,1.0,1,1.0,1,1.0,1,0.15521706091394838,47
394,7,760,292,468,0,0,0,1.0,1,1.0,1,1.0,1,0.13000781974957226,48
395,3,763,293,470,0,0,0,1.0,1,1.0,1,1.0,1,0.11379120837153005,46
396,4,767,295,472,0,0,0,1.0,1,1.0,1,1.0,1,0.08232359292672053,43
397,0,767,295,472,0,0,0,1.0,1,1.0,1,1.0,1,0.08318168533683419,42
398,1,768,296,472,0,0,0,1.0,1,1.0,1,1.0,1,0.12737285244070273,40
399,2,770,297,473,0,0,0,1.0,1,1.0,1,1.0,1,0.15218175513381205,39
400,1,771,298,473,0,0,0,1.0,1,1.0,1,1.0,1,0.13249242276920936,38
401,1,772,298,474,0,0,0,1.0,1,1.0,1,1.0,1,0.11527121800133246,37
402,0,772,298,474,0,0,0,1.0,1,1.0,1,1.0,1,0.12161428396544054,36
403,1,773,299,474,0,0,0,1.0,1,1.0,1,1.0,1,0.09699428883234822,38
404,2,775,300,475,0,0,0,1.0,1,1.0,1,1.0,1,0.07984899285530261,39
405,0,775,300,475,0,0,0,1.0,1,1.0,1,1.0,1,0.06229456059844121,40
406,1,776,301,475,0,0,0,1.0,1,1.0,1,1.0,1,0.08220470603863352,41
407,0,776,301,475,0,0,0,1.0,1,1.0,1,1.0,1,0.08983747674351736,42
408,0,776,301,475,0,0,0,1.0,1,1.0,1,1.0,1,0.10520419103536485,43
409,1,777,302,475,0,0,0,1.0,1,1.0,1,1.0,1,0.12147595615293233,44
410,2,779,302,477,0,0,0,1.0,1,1.0,1,1.0,1,0.11918670771636013,46
411,1,780,303,477,0,0,0,1.0,1,1.0,1,1.0,1,0.13693043139816216,46
412,1,781,303,478,0,0,0,1.0,1,1.0,1,1.0,1,0.13325454822287544,47
413,1,782,304,478,0,0,0,1.0,1,1.0,1,1.0,1,0.16224165739729077,47
414,1,783,304,479,0,0,0,1.0,1,1.0,1,1.0,1,0.14944307704978382,47
415,3,786,304,482,0,0,0,1.0,1,1.0,1,1.0,1,0.12801365974565596,48
416,2,788,305,483,0,0,0,1.0,1,1.0,1,1.0,1,0.14848301262270655,49
417,2,790,305,485,0,0,0,1.0,1,1.0,1,1.0,1,0.095116036795039,49
418,3,793,307,486,0,0,0,1.0,1,1.0,1,1.0,1,0.14252199490222878,50
419,2,795,307,488,0,0,0,1.0,1,1.0,1,1.0,1,0.1006247533415631,50
420,0,795,307,488,0,0,0,1.0,1,1.0,1,1.0,1,0.1006247533415631,50
421,1,796,308,488,0,0,0,1.0,1,1.0,1,1.0,1,0.12703480638934317,50
422,0,796,308,488,0,0,0,1.0,1,1.0,1,1.0,1,0.14563308106304027,50
423,5,801,309,492,0,0,0,1.0,1,1.0,1,1.0,1,0.14386885494635676,51
424,1,802,309,493,0,0,0,1.0,1,1.0,1,1.0,1,0.14466555269377196,49
425,2,804,310,494,0,0,0,1.0,1,1.0,1,1.0,1,0.15268872591041352,48
426,6,810,312,498,0,0,0,1.0,1,1.0,1,1.0,1,0.09188752582050547,50
427,3,813,313,500,0,0,0,1.0,1,1.0,1,1.0,1,0.0557881095755991,48
428,3,816,315,501,0,0,0,1.0,1,1.0,1,1.0,1,0.12407038212094437,49
429,2,818,316,502,0,0,0,1.0,1,1.0,1,1.0,1,0.09924690941238054,45
430,2,820,318,502,0,0,0,1.0,1,1.0,1,1.0,1,0.1337442200987301,44
431,1,821,318,503,0,0,0,1.0,1,1.0,1,1.0,1,0.08769038203165648,42
432,0,821,318,503,0,0,0,1.0,1,1.0,1,1.0,1,0.12873944369474444,40
433,1,822,319,503,0,0,0,1.0,1,1.0,1,1.0,1,0.1639704211806426,39
434,2,824,319,505,0,0,0,1.0,1,1.0,1,1.0,1,0.13609770966372078,39
435,4,828,320,508,0,0,0,1.0,1,1.0,1,1.0,1,0.1253432522824046,38
436,3,831,321,510,0,0,0,1.0,1,1.0,1,1.0,1,0.09577167268550167,38
437,0,831,321,510,0,0,0,1.0,1,1.0,1,1.0,1,0.10046064125238188,39
438,2,833,322,511,0,0,0,1.0,1,1.0,1,1.0,1,0.12522606320267474,38
439,1,834,322,512,0,0,0,1.0,1,1.0,1,1.0,1,0.13821831926599235,39
440,0,834,322,512,0,0,0,1.0,1,1.0,1,1.0,1,0.13821831926599235,39
441,1,835,323,512,0,0,0,1.0,1,1.0,1,1.0,1,0.14755260680463217,41
442,5,840,323,517,0,0,0,1.0,1,1.0,1,1.0,1,0.08018209380385227,42
443,2,842,324,518,0,0,0,1.0,1,1.0,1,1.0,1,0.09302462571063931,42
444,0,842,324,518,0,0,0,1.0,1,1.0,1,1.0,1,0.09865931655108284,43
445,3,845,325,520,0,0,0,1.0,1,1.0,1,1.0,1,0.08291174494545592,44
446,1,846,326,520,0,0,0,1.0,1,1.0,1,1.0,1,0.06923949937709223,44
447,2,848,328,520,0,0,0,1.0,1,1.0,1,1.0,1,0.11114943295261161,47
448,0,848,328,520,0,0,0,1.0,1,1.0,1,1.0,1,0.11354576962147479,46
449,1,849,328,521,0,0,0,1.0,1,1.0,1,1.0,1,0.10264202755678935,46
450,0,849,328,521,0,0,0,1.0,1,1.0,1,1.0,1,0.14106313690614694,46
451,2,851,328,523,0,0,0,1.0,1,1.0,1,1.0,1,0.12056443892553392,47
452,0,851,328,523,0,0,0,1.0,1,1.0,1,1.0,1,0.14957967760131796,47
453,0,851,328,523,0,0,0,1.0,1,1.0,1,1.0,1,0.14957967760131796,47
454,1,852,328,524,0,0,0,1.0,1,1.0,1,1.0,1,0.12614586650177131,46
455,2,854,329,525,0,0,0,1.0,1,1.0,1,1.0,1,0.11653638799941426,47
456,4,858,330,528,0,0,0,1.0,1,1.0,1,1.0,1,0.08678266282186134,49
457,3,861,331,530,0,0,0,1.0,1,1.0,1,1.0,1,0.08714581244910692,50
458,0,861,331,530,0,0,0,1.0,1,1.0,1,1.0,1,0.08714581244910692,50
459,3,864,331,533,0,0,0,1.0,1,1.0,1,1.0,1,0.050400566456836035,52
460,0,864,331,533,0,0,0,1.0,1,1.0,1,1.0,1,0.0673562165780211,53
461,1,865,331,534,0,0,0,1.0,1,1.0,1,1.0,1,0.06807254562489538,54
462,0,865,331,534,0,0,0,1.0,1,1.0,1,1.0,1,0.06807254562489538,54
463,7,872,334,538,0,0,0,1.0,1,1.0,1,1.0,1,0.07806886423604488,55
464,2,874,334,540,0,0,0,1.0,1,1.0,1,1.0,1,0.07694371065295605,56
465,3,877,335,542,0,0,0,1.0,1,1.0,1,1.0,1,0.06127560687115599,54
466,4,881,338,543,0,0,0,1.0,1,1.0,1,1.0,1,0.12980085252136686,54
467,5,886,339,547,0,0,0,1.0,1,1.0,1,1.0,1,0.12743076618321428,51
468,6,892,344,548,0,0,0,1.0,1,1.0,1,1.0,1,0.18113933602495164,51
469,4,896,345,551,0,0,0,1.0,1,1.0,1,1.0,1,0.12565113681039713,48
470,3,899,347,552,0,0,0,1.0,1,1.0,1,1.0,1,0.13662461423598973,47
471,2,901,349,552,0,0,0,1.0,1,1.0,1,1.0,1,0.1290365913750107,44
472,4,905,351,554,0,0,0,1.0,1,1.0,1,1.0,1,0.16294073503186132,43
473,1,906,351,555,0,0,0,1.0,1,1.0,1,1.0,1,0.16234132186989472,41
474,2,908,352,556,0,0,0,1.0,1,1.0,1,1.0,1,0.17348745165666876,39
475,4,912,353,559,0,0,0,1.0,1,1.0,1,1.0,1,0.12232859489194386,40
476,3,915,354,561,0,0,0,1.0,1,1.0,1,1.0,1,0.10333246862807746,38
477,2,917,356,561,0,0,0,1.0,1,1.0,1,1.0,1,0.1790659649044687,35
478,2,919,357,562,0,0,0,1.0,1,1.0,1,1.0,1,0.20071167772671553,35
479,0,919,357,562,0,0,0,1.0,1,1.0,1,1.0,1,0.24471633385262662,32
480,1,920,357,563,0,0,0,1.0,1,1.0,1,1.0,1,0.2334677508851809,32
481,1,921,357,564,0,0,0,1.0,1,1.0,1,1.0,1,0.21179454965732375,33
482,5,926,360,566,0,0,0,1.0,1,1.0,1,1.0,1,0.2567040560151853,34
483,1,927,360,567,0,0,0,1.0,1,1.0,1,1.0,1,0.2315590436915536,32
484,4,931,361,570,0,0,0,1.0,1,1.0,1,1.0,1,0.18688843500733807,33
485,5,936,362,574,0,0,0,1.0,1,1.0,1,1.0,1,0.1274573380655952,34
486,3,939,362,577,0,0,0,1.0,1,1.0,1,1.0,1,0.10529627326092134,36
487,1,940,362,578,0,0,0,1.0,1,1.0,1,1.0,1,0.07197175038383648,36
488,0,940,362,578,0,0,0,1.0,1,1.0,1,1.0,1,0.08956656422847944,37
489,2,942,364,578,0,0,0,1.0,1,1.0,1,1.0,1,0.14170307619432823,38
490,1,943,365,578,0,0,0,1.0,1,1.0,1,1.0,1,0.13629564162672272,38
491,1,944,365,579,0,0,0,1.0,1,1.0,1,1.0,1,0.11497891771525548,37
492,2,946,366,580,0,0,0,1.0,1,1.0,1,1.0,1,0.13077846586958497,37
493,1,947,366,581,0,0,0,1.0,1,1.0,1,1.0,1,0.09778193847654787,37
494,0,947,366,581,0,0,0,1.0,1,1.0,1,1.0,1,0.12585458764709467,39
495,0,947,366,581,0,0,0,1.0,1,1.0,1,1.0,1,0.12761832854066452,40
496,0,947,366,581,0,0,0,1.0,1,1.0,1,1.0,1,0.12761832854066452,40
497,2,949,366,583,0,0,0,1.0,1,1.0,1,1.0,1,0.09685014760894853,43
498,1,950,367,583,0,0,0,1.0,1,1.0,1,1.0,1,0.10479648476575515,43
499,3,953,369,584,0,0,0,1.0,1,1.0,1,1.0,1,0.16402023381735584,44
500,4,957,370,587,0,0,0,1.0,1,1.0,1,1.0,1,0.09382248870434873,45
501,4,961,371,590,0,0,0,1.0,1,1.0,1,1.0,1,0.0760964205349945,45
502,2,963,373,590,0,0,0,1.0,1,1.0,1,1.0,1,0.10971192119439065,45
503,4,967,376,591,0,0,0,1.0,1,1.0,1,1.0,1,0.1380616721507454,46
504,4,971,377,594,0,0,0,1.0,1,1.0,1,1.0,1,0.16101658697539026,47
505,3,974,377,597,0,0,0,1.0,1,1.0,1,1.0,1,0.11563027677225551,42
506,3,977,380,597,0,0,0,1.0,1,1.0,1,1.0,1,0.18109005037685266,41
507,1,978,380,598,0,0,0,1.0,1,1.0,1,1.0,1,0.1856410370028429,38
508,1,979,381,598,0,0,0,1.0,1,1.0,1,1.0,1,0.19696821592072752,38
509,1,980,381,599,0,0,0,1.0,1,1.0,1,1.0,1,0.1911049000030204,37
510,1,981,382,599,0,0,0,1.0,1,1.0,1,1.0,1,0.20683539499262057,36
511,2,983,383,600,0,0,0,1.0,1,1.0,1,1.0,1,0.21247309425294145,34
512,0,983,383,600,0,0,0,1.0,1,1.0,1,1.0,1,0.2161103185870575,32
513,2,985,383,602,0,0,0,1.0,1,1.0,1,1.0,1,0.11393109637152445,32
514,1,986,383,603,0,0,0,1.0,1,1.0,1,1.0,1,0.10647698668671916,35
515,0,986,383,603,0,0,0,1.0,1,1.0,1,1.0,1,0.10647698668671916,35
516,1,987,383,604,0,0,0,1.0,1,1.0,1,1.0,1,0.12384281559526734,36
517,0,987,383,604,0,0,0,1.0,1,1.0,1,1.0,1,0.12384281559526734,36
518,0,987,383,604,0,0,0,1.0,1,1.0,1,1.0,1,0.15913509632313588,39
519,1,988,384,604,0,0,0,1.0,1,1.0,1,1.0,1,0.17676980014020038,39
520,3,991,386,605,0,0,0,1.0,1,1.0,1,1.0,1,0.20649669232301454,39
521,3,994,387,607,0,0,0,1.0,1,1.0,1,1.0,1,0.169612982921262,40
522,0,994,387,607,0,0,0,1.0,1,1.0,1,1.0,1,0.169612982921262,40
523,2,996,387,609,0,0,0,1.0,1,1.0,1,1.0,1,0.1403298560058848,41
524,1,997,388,609,0,0,0,1.0,1,1.0,1,1.0,1,0.14950439409783664,41
525,3,1000,390,610,0,0,0,1.0,1,1.0,1,1.0,1,0.14586844168537466,40
526,1,1001,390,611,0,0,0,1.0,1,1.0,1,1.0,1,0.15440019067904937,40
527,0,1001,390,611,0,0,0,1.0,1,1.0,1,1.0,1,0.15440019067904937,40
528,0,1001,390,611,0,0,0,1.0,1,1.0,1,1.0,1,0.15440019067904937,40
529,1,1002,390,612,0,0,0,1.0,1,1.0,1,1.0,1,0.1550805261486888,39
530,1,1003,391,612,0,0,0,1.0,1,1.0,1,1.0,1,0.17001584182275314,39
531,2,1005,392,613,0,0,0,1.0,1,1.0,1,1.0,1,0.16905428657424312,39
532,3,1008,392,616,0,0,0,1.0,1,1.0,1,1.0,1,0.10291027146482239,40
533,1,1009,393,616,0,0,0,1.0,1,1.0,1,1.0,1,0.15911798926814583,40
534,3,1012,393,619,0,0,0,1.0,1,1.0,1,1.0,1,0.1449872661966372,42
535,0,1012,393,619,0,0,0,1.0,1,1.0,1,1.0,1,0.14983970127331972,42
536,0,1012,393,619,0,0,0,1.0,1,1.0,1,1.0,1,0.16108733367027953,43
537,0,1012,393,619,0,0,0,1.0,1,1.0,1,1.0,1,0.16108733367027953,43
538,2,1014,394,620,0,0,0,1.0,1,1.0,1,1.0,1,0.17297972649963334,44
539,2,1016,394,622,0,0,0,1.0,1,1.0,1,1.0,1,0.14921994038689926,44
540,1,1017,395,622,0,0,0,1.0,1,1.0,1,1.0,1,0.17172400605075744,44
541,3,1020,396,624,0,0,0,1.0,1,1.0,1,1.0,1,0.13719503582600717,45
542,4,1024,397,627,0,0,0,1.0,1,1.0,1,1.0,1,0.12286170624759664,46
543,4,1028,399,629,0,0,0,1.0,1,1.0,1,1.0,1,0.15208739091424603,43
544,1,1029,400,629,0,0,0,1.0,1,1.0,1,1.0,1,0.18516245743797452,42
545,4,1033,402,631,0,0,0,1.0,1,1.0,1,1.0,1,0.11482230103393966,43
546,3,1036,405,631,0,0,0,1.0,1,1.0,1,1.0,1,0.1981682205559142,41
547,3,1039,405,634,0,0,0,1.0,1,1.0,1,1.0,1,0.0953190557047906,40
548,1,1040,406,634,0,0,0,1.0,1,1.0,1,1.0,1,0.09166214030047964,40
549,3,1043,408,635,0,0,0,1.0,1,1.0,1,1.0,1,0.1347539937492466,39
550,1,1044,409,635,0,0,0,1.0,1,1.0,1,1.0,1,0.16238047370269107,38
551,3,1047,410,637,0,0,0,1.0,1,1.0,1,1.0,1,0.135043905148186,38
552,2,1049,412,637,0,0,0,1.0,1,1.0,1,1.0,1,0.19475698201074576,39
553,1,1050,412,638,0,0,0,1.0,1,1.0,1,1.0,1,0.13343925602037773,38
554,3,1053,413,640,0,0,0,1.0,1,1.0,1,1.0,1,0.1268948534888307,39
555,2,1055,413,642,0,0,0,1.0,1,1.0,1,1.0,1,0.10085960119436903,39
556,2,1057,414,643,0,0,0,1.0,1,1.0,1,1.0,1,0.09881403232580435,40
557,0,1057,414,643,0,0,0,1.0,1,1.0,1,1.0,1,0.10967411766582076,40
558,0,1057,414,643,0,0,0,1.0,1,1.0,1,1.0,1,0.10967411766582076,40
559,1,1058,415,643,0,0,0,1.0,1,1.0,1,1.0,1,0.1077961416869586,40
560,1,1059,415,644,0,0,0,1.0,1,1.0,1,1.0,1,0.10523961441080752,41
561,2,1061,416,645,0,0,0,1.0,1,1.0,1,1.0,1,0.14146909198383473,42
562,2,1063,418,645,0,0,0,1.0,1,1.0,1,1.0,1,0.1716435011395637,42
563,3,1066,419,647,0,0,0,1.0,1,1.0,1,1.0,1,0.19102552499335132,42
564,1,1067,419,648,0,0,0,1.0,1,1.0,1,1.0,1,0.1998995121386225,43
565,4,1071,420,651,0,0,0,1.0,1,1.0,1,1.0,1,0.2050438851656262,44
566,2,1073,420,653,0,0,0,1.0,1,1.0,1,1.0,1,0.19932809002826893,45
567,3,1076,421,655,0,0,0,1.0,1,1.0,1,1.0,1,0.20423655406988203,45
568,3,1079,421,658,0,0,0,1.0,1,1.0,1,1.0,1,0.1676432376100496,46
569,2,1081,423,658,0,0,0,1.0,1,1.0,1,1.0,1,0.16181617353019864,47
570,2,1083,424,659,0,0,0,1.0,1,1.0,1,1.0,1,0.18083107785633482,48
571,2,1085,425,660,0,0,0,1.0,1,1.0,1,1.0,1,0.1838690556711824,48
572,1,1086,425,661,0,0,0,1.0,1,1.0,1,1.0,1,0.19094469626922542,47
573,1,1087,425,662,0,0,0,1.0,1,1.0,1,1.0,1,0.18764493778864869,49
574,3,1090,425,665,0,0,0,1.0,1,1.0,1,1.0,1,0.17230096188404562,49
575,6,1096,425,671,0,0,0,1.0,1,1.0,1,1.0,1,0.11013561946330633,50
576,2,1098,425,673,0,0,0,1.0,1,1.0,1,1.0,1,0.12987201584234198,51
577,5,1103,425,678,0,0,0,1.0,1,1.0,1,1.0,1,0.07841895218877568,51
578,0,1103,425,678,0,0,0,1.0,1,1.0,1,1.0,1,0.07841895218877568,51
579,1,1104,426,678,0,0,0,1.0,1,1.0,1,1.0,1,0.10824231218346479,52
580,3,1107,427,680,0,0,0,1.0,1,1.0,1,1.0,1,0.1240021683539656,52
581,2,1109,427,682,0,0,0,1.0,1,1.0,1,1.0,1,0.10694514002779981,52
582,0,1109,427,682,0,0,0,1.0,1,1.0,1,1.0,1,0.11119334208762549,53
583,0,1109,427,682,0,0,0,1.0,1,1.0,1,1.0,1,0.11237005125561801,51
584,3,1112,430,682,0,0,0,1.0,1,1.0,1,1.0,1,0.13472635158668,51
585,8,1120,433,687,0,0,0,1.0,1,1.0,1,1.0,1,0.1040120401664067,49
586,0,1120,433,687,0,0,0,1.0,1,1.0,1,1.0,1,0.0956037227144353,49
587,2,1122,434,688,0,0,0,1.0,1,1.0,1,1.0,1,0.09539028200250865,48
588,1,1123,435,688,0,0,0,1.0,1,1.0,1,1.0,1,0.10740945613015808,46
589,3,1126,436,690,0,0,0,1.0,1,1.0,1,1.0,1,0.14463277223508056,48
590,3,1129,438,691,0,0,0,1.0,1,1.0,1,1.0,1,0.15922283815196064,47
591,1,1130,439,691,0,0,0,1.0,1,1.0,1,1.0,1,0.18733781893489768,48
592,1,1131,440,691,0,0,0,1.0,1,1.0,1,1.0,1,0.18574558866639015,47
593,4,1135,443,692,0,0,0,1.0,1,1.0,1,1.0,1,0.21134608526868431,45
594,2,1137,443,694,0,0,0,1.0,1,1.0,1,1.0,1,0.15220337766872175,44
595,0,1137,443,694,0,0,0,1.0,1,1.0,1,1.0,1,0.1574868628538918,43
596,3,1140,445,695,0,0,0,1.0,1,1.0,1,1.0,1,0.15465366178852846,44
597,2,1142,445,697,0,0,0,1.0,1,1.0,1,1.0,1,0.13384597997792877,43
598,6,1148,447,701,0,0,0,1.0,1,1.0,1,1.0,1,0.12246348458137225,45
599,1,1149,448,701,0,0,0,1.0,1,1.0,1,1.0,1,0.15977489826941033,44
600,1,1150,448,702,0,0,0,1.0,1,1.0,1,1.0,1,0.13006614253083768,44
601,1,1151,448,703,0,0,0,1.0,1,1.0,1,1.0,1,0.13402165663059587,45
602,0,1151,448,703,0,0,0,1.0,1,1.0,1,1.0,1,0.1451777096804684,46
603,0,1151,448,703,0,0,0,1.0,1,1.0,1,1.0,1,0.1458557718326115,46
604,3,1154,449,705,0,0,0,1.0,1,1.0,1,1.0,1,0.12434302214657869,47
605,0,1154,449,705,0,0,0,1.0,1,1.0,1,1.0,1,0.12434302214657869,47
606,0,1154,449,705,0,0,0,1.0,1,1.0,1,1.0,1,0.13226335645883355,47
607,1,1155,449,706,0,0,0,1.0,1,1.0,1,1.0,1,0.12219498960630724,48
608,0,1155,449,706,0,0,0,1.0,1,1.0,1,1.0,1,0.1447340253518259,47
609,2,1157,449,708,0,0,0,1.0,1,1.0,1,1.0,1,0.11829603671901914,48
610,1,1158,449,709,0,0,0,1.0,1,1.0,1,1.0,1,0.10836487218807342,48
611,1,1159,450,709,0,0,0,1.0,1,1.0,1,1.0,1,0.10253273051119492,49
612,3,1162,450,712,0,0,0,1.0,1,1.0,1,1.0,1,0.08749587658257732,50
613,1,1163,451,712,0,0,0,1.0,1,1.0,1,1.0,1,0.08454518700302205,50
614,0,1163,451,712,0,0,0,1.0,1,1.0,1,1.0,1,0.08454518700302205,50
615,1,1164,452,712,0,0,0,1.0,1,1.0,1,1.0,1,0.1073548125104057,50
616,0,1164,452,712,0,0,0,1.0,1,1.0,1,1.0,1,0.1073548125104057,50
617,4,1168,452,716,0,0,0,1.0,1,1.0,1,1.0,1,0.06755781073104054,52
618,0,1168,452,716,0,0,0,1.0,1,1.0,1,1.0,1,0.06755781073104054,52
619,0,1168,452,716,0,0,0,1.0,1,1.0,1,1.0,1,0.06386838925325511,50
620,1,1169,453,716,0,0,0,1.0,1,1.0,1,1.0,1,0.1218461294289333,50
621,4,1173,455,718,0,0,0,1.0,1,1.0,1,1.0,1,0.11919384076336283,49
622,0,1173,455,718,0,0,0,1.0,1,1.0,1,1.0,1,0.13315380185856424,49
623,5,1178,457,721,0,0,0,1.0,1,1.0,1,1.0,1,0.11878021561280096,48
624,5,1183,458,725,0,0,0,1.0,1,1.0,1,1.0,1,0.09756224700804281,46
625,1,1184,458,726,0,0,0,1.0,1,1.0,1,1.0,1,0.10025787206446697,45
626,6,1190,461,729,0,0,0,1.0,1,1.0,1,1.0,1,0.0923393328880273,44
627,4,1194,464,730,0,0,0,1.0,1,1.0,1,1.0,1,0.11543146719928904,44
628,3,1197,467,730,0,0,0,1.0,1,1.0,1,1.0,1,0.19010370583319167,44
629,2,1199,468,731,0,0,0,1.0,1,1.0,1,1.0,1,0.14285174065904985,41
630,1,1200,469,731,0,0,0,1.0,1,1.0,1,1.0,1,0.1441665627001919,40
631,2,1202,470,732,0,0,0,1.0,1,1.0,1,1.0,1,0.20057673962960232,38
632,2,1204,471,733,0,0,0,1.0,1,1.0,1,1.0,1,0.20018119751262115,38
633,0,1204,471,733,0,0,0,1.0,1,1.0,1,1.0,1,0.19982115641284506,36
634,1,1205,472,733,0,0,0,1.0,1,1.0,1,1.0,1,0.21422036323567636,35
635,2,1207,472,735,0,0,0,1.0,1,1.0,1,1.0,1,0.14924462786606973,35
636,2,1209,473,736,0,0,0,1.0,1,1.0,1,1.0,1,0.1550902624416951,36
637,0,1209,473,736,0,0,0,1.0,1,1.0,1,1.0,1,0.16454322740265867,35
638,1,1210,474,736,0,0,0,1.0,1,1.0,1,1.0,1,0.20988946241331843,34
639,7,1217,476,741,0,0,0,1.0,1,1.0,1,1.0,1,0.1165110283047057,36
640,0,1217,476,741,0,0,0,1.0,1,1.0,1,1.0,1,0.14269003476584988,37
641,1,1218,476,742,0,0,0,1.0,1,1.0,1,1.0,1,0.11113073854632662,37
642,1,1219,476,743,0,0,0,1.0,1,1.0,1,1.0,1,0.10012000067536936,38
643,1,1220,477,743,0,0,0,1.0,1,1.0,1,1.0,1,0.11595251621073975,39
644,1,1221,478,743,0,0,0,1.0,1,1.0,1,1.0,1,0.14770857273961416,39
645,4,1225,478,747,0,0,0,1.0,1,1.0,1,1.0,1,0.09476360811749275,39
646,3,1228,479,749,0,0,0,1.0,1,1.0,1,1.0,1,0.1297003723478701,40
647,1,1229,479,750,0,0,0,1.0,1,1.0,1,1.0,1,0.12010587582374664,40
648,0,1229,479,750,0,0,0,1.0,1,1.0,1,1.0,1,0.12010587582374664,40
649,0,1229,479,750,0,0,0,1.0,1,1.0,1,1.0,1,0.12010587582374664,40
650,2,1231,480,751,0,0,0,1.0,1,1.0,1,1.0,1,0.1314036121217123,41
651,2,1233,480,753,0,0,0,1.0,1,1.0,1,1.0,1,0.10853909743185572,42
652,1,1234,481,753,0,0,0,1.0,1,1.0,1,1.0,1,0.14721602027758526,41
653,0,1234,481,753,0,0,0,1.0,1,1.0,1,1.0,1,0.14721602027758526,41
654,1,1235,481,754,0,0,0,1.0,1,1.0,1,1.0,1,0.15046288938794564,42
655,2,1237,481,756,0,0,0,1.0,1,1.0,1,1.0,1,0.11116333026685474,45
656,3,1240,484,756,0,0,0,1.0,1,1.0,1,1.0,1,0.16914647553834944,45
657,2,1242,484,758,0,0,0,1.0,1,1.0,1,1.0,1,0.17208186978845424,43
658,4,1246,486,760,0,0,0,1.0,1,1.0,1,1.0,1,0.20511497174120769,43
659,2,1248,487,761,0,0,0,1.0,1,1.0,1,1.0,1,0.1811624339910255,43
660,7,1255,490,765,0,0,0,1.0,1,1.0,1,1.0,1,0.22271852056541533,43
661,3,1258,490,768,0,0,0,1.0,1,1.0,1,1.0,1,0.17366526702092852,41
662,3,1261,492,769,0,0,0,1.0,1,1.0,1,1.0,1,0.20707007551746331,40
663,3,1264,493,771,0,0,0,1.0,1,1.0,1,1.0,1,0.18291327084788664,39
664,3,1267,494,773,0,0,0,1.0,1,1.0,1,1.0,1,0.19088189594756688,36
665,3,1270,495,775,0,0,0,1.0,1,1.0,1,1.0,1,0.16207383707803058,36
666,4,1274,497,777,0,0,0,1.0,1,1.0,1,1.0,1,0.18617268963367375,36
667,1,1275,497,778,0,0,0,1.0,1,1.0,1,1.0,1,0.17492217119292466,35
668,3,1278,498,780,0,0,0,1.0,1,1.0,1,1.0,1,0.16062718987617206,34
669,5,1283,500,783,0,0,0,1.0,1,1.0,1,1.0,1,0.1818997912945205,34
670,3,1286,501,785,0,0,0,1.0,1,1.0,1,1.0,1,0.1447218990874945,32
671,2,1288,502,786,0,0,0,1.0,1,1.0,1,1.0,1,0.09401917703446976,33
672,0,1288,502,786,0,0,0,1.0,1,1.0,1,1.0,1,0.12372761489827214,32
673,0,1288,502,786,0,0,0,1.0,1,1.0,1,1.0,1,0.12372761489827214,32
674,1,1289,503,786,0,0,0,1.0,1,1.0,1,1.0,1,0.15398138845943785,32
675,5,1294,505,789,0,0,0,1.0,1,1.0,1,1.0,1,0.1302194327608993,34
676,1,1295,505,790,0,0,0,1.0,1,1.0,1,1.0,1,0.1010419258797099,35
677,0,1295,505,790,0,0,0,1.0,1,1.0,1,1.0,1,0.1010419258797099,35
678,0,1295,505,790,0,0,0,1.0,1,1.0,1,1.0,1,0.1010419258797099,35
679,2,1297,507,790,0,0,0,1.0,1,1.0,1,1.0,1,0.16675398417779863,36
680,2,1299,507,792,0,0,0,1.0,1,1.0,1,1.0,1,0.1278944932849775,37
681,1,1300,507,793,0,0,0,1.0,1,1.0,1,1.0,1,0.0926285421029664,37
682,1,1301,508,793,0,0,0,1.0,1,1.0,1,1.0,1,0.0926014863242073,37
683,2,1303,509,794,0,0,0,1.0,1,1.0,1,1.0,1,0.07934638073847754,38
684,1,1304,510,794,0,0,0,1.0,1,1.0,1,1.0,1,0.11251558807821559,39
685,0,1304,510,794,0,0,0,1.0,1,1.0,1,1.0,1,0.10332324341734721,38
686,0,1304,510,794,0,0,0,1.0,1,1.0,1,1.0,1,0.13510133986040707,37
687,3,1307,512,795,0,0,0,1.0,1,1.0,1,1.0,1,0.2110858824534617,38
688,0,1307,512,795,0,0,0,1.0,1,1.0,1,1.0,1,0.21068115348052557,37
689,2,1309,513,796,0,0,0,1.0,1,1.0,1,1.0,1,0.23662394045345528,39
690,1,1310,513,797,0,0,0,1.0,1,1.0,1,1.0,1,0.23135794611794472,38
691,2,1312,514,798,0,0,0,1.0,1,1.0,1,1.0,1,0.19537112311899402,38
692,1,1313,514,799,0,0,0,1.0,1,1.0,1,1.0,1,0.18620292429583915,38
693,1,1314,515,799,0,0,0,1.0,1,1.0,1,1.0,1,0.20384785518390622,40
694,7,1321,517,804,0,0,0,1.0,1,1.0,1,1.0,1,0.1755964617856696,42
695,3,1324,519,805,0,0,0,1.0,1,1.0,1,1.0,1,0.17992407517292427,40
696,4,1328,520,808,0,0,0,1.0,1,1.0,1,1.0,1,0.19030676955203937,39
697,1,1329,520,809,0,0,0,1.0,1,1.0,1,1.0,1,0.16890418129380588,39
698,3,1332,521,811,0,0,0,1.0,1,1.0,1,1.0,1,0.13959287385682842,37
699,0,1332,521,811,0,0,0,1.0,1,1.0,1,1.0,1,0.13440613557224787,37
700,1,1333,521,812,0,0,0,1.0,1,1.0,1,1.0,1,0.14801409822198222,37
701,3,1336,522,814,0,0,0,1.0,1,1.0,1,1.0,1,0.11682383148625158,37
702,1,1337,523,814,0,0,0,1.0,1,1.0,1,1.0,1,0.14238313638717656,38
703,6,1343,526,817,0,0,0,1.0,1,1.0,1,1.0,1,0.17257732011672483,36
704,4,1347,529,818,0,0,0,1.0,1,1.0,1,1.0,1,0.1742098665884709,36
705,3,1350,531,819,0,0,0,1.0,1,1.0,1,1.0,1,0.17304676382429998,36
706,5,1355,534,821,0,0,0,1.0,1,1.0,1,1.0,1,0.23153975924228387,35
707,5,1360,536,824,0,0,0,1.0,1,1.0,1,1.0,1,0.16379451419440375,36
708,2,1362,537,825,0,0,0,1.0,1,1.0,1,1.0,1,0.14698630047183786,36
709,0,1362,537,825,0,0,0,1.0,1,1.0,1,1.0,1,0.1144301891836981,34
710,1,1363,538,825,0,0,0,1.0,1,1.0,1,1.0,1,0.12499690886544493,34
711,0,1363,538,825,0,0,0,1.0,1,1.0,1,1.0,1,0.11622609739657265,34
712,5,1368,540,828,0,0,0,1.0,1,1.0,1,1.0,1,0.13201865751515288,35
713,1,1369,541,828,0,0,0,1.0,1,1.0,1,1.0,1,0.1569720271272438,34
714,0,1369,541,828,0,0,0,1.0,1,1.0,1,1.0,1,0.1637338851708636,34
715,1,1370,541,829,0,0,0,1.0,1,1.0,1,1.0,1,0.12364151328695126,35
716,1,1371,542,829,0,0,0,1.0,1,1.0,1,1.0,1,0.17250089178646544,33
717,5,1376,545,831,0,0,0,1.0,1,1.0,1,1.0,1,0.24421495657219916,33
718,2,1378,546,832,0,0,0,1.0,1,1.0,1,1.0,1,0.2606361945527265,32
719,1,1379,546,833,0,0,0,1.0,1,1.0,1,1.0,1,0.23470292697150727,32
720,3,1382,547,835,0,0,0,1.0,1,1.0,1,1.0,1,0.21868175994939817,33
721,0,1382,547,835,0,0,0,1.0,1,1.0,1,1.0,1,0.21868175994939817,33
722,7,1389,548,841,0,0,0,1.0,1,1.0,1,1.0,1,0.15391496125876983,34
723,3,1392,548,844,0,0,0,1.0,1,1.0,1,1.0,1,0.12219992219518384,34
724,0,1392,548,844,0,0,0,1.0,1,1.0,1,1.0,1,0.1247399039551884,36
725,0,1392,548,844,0,0,0,1.0,1,1.0,1,1.0,1,0.1247399039551884,36
726,0,1392,548,844,0,0,0,1.0,1,1.0,1,1.0,1,0.1247399039551884,36
727,1,1393,548,845,0,0,0,1.0,1,1.0,1,1.0,1,0.10641283984667899,36
728,1,1394,548,846,0,0,0,1.0,1,1.0,1,1.0,1,0.09354836868551482,37
729,1,1395,548,847,0,0,0,1.0,1,1.0,1,1.0,1,0.06986498925170122,37
730,0,1395,548,847,0,0,0,1.0,1,1.0,1,1.0,1,0.07488108997108842,38
731,2,1397,549,848,0,0,0,1.0,1,1.0,1,1.0,1,0.13849532393077196,39
732,0,1397,549,848,0,0,0,1.0,1,1.0,1,1.0,1,0.12645512237750936,41
733,1,1398,550,848,0,0,0,1.0,1,1.0,1,1.0,1,0.11889671893583027,39
734,3,1401,551,850,0,0,0,1.0,1,1.0,1,1.0,1,0.07708501487668173,39
735,2,1403,553,850,0,0,0,1.0,1,1.0,1,1.0,1,0.1594947910128841,39
736,1,1404,553,851,0,0,0,1.0,1,1.0,1,1.0,1,0.13769905462197174,38
737,2,1406,554,852,0,0,0,1.0,1,1.0,1,1.0,1,0.14896551075849096,39
738,0,1406,554,852,0,0,0,1.0,1,1.0,1,1.0,1,0.15209311990034133,37
739,1,1407,554,853,0,0,0,1.0,1,1.0,1,1.0,1,0.14284117722701015,37
740,1,1408,555,853,0,0,0,1.0,1,1.0,1,1.0,1,0.22199900457995864,35
741,1,1409,555,854,0,0,0,1.0,1,1.0,1,1.0,1,0.241697040807699,33
742,4,1413,556,857,0,0,0,1.0,1,1.0,1,1.0,1,0.1876944660126976,35
743,4,1417,559,858,0,0,0,1.0,1,1.0,1,1.0,1,0.22253729757447233,35
744,2,1419,560,859,0,0,0,1.0,1,1.0,1,1.0,1,0.1939635961232794,34
745,7,1426,563,863,0,0,0,1.0,1,1.0,1,1.0,1,0.1833414816192862,34
746,3,1429,565,864,0,0,0,1.0,1,1.0,1,1.0,1,0.14084011871415567,33
747,2,1431,565,866,0,0,0,1.0,1,1.0,1,1.0,1,0.11710377501439699,32
748,0,1431,565,866,0,0,0,1.0,1,1.0,1,1.0,1,0.11164688811444655,33
749,0,1431,565,866,0,0,0,1.0,1,1.0,1,1.0,1,0.11164688811444655,33
750,1,1432,566,866,0,0,0,1.0,1,1.0,1,1.0,1,0.11437863428600521,34
751,3,1435,567,868,0,0,0,1.0,1,1.0,1,1.0,1,0.10705991263359001,36
752,1,1436,568,868,0,0,0,1.0,1,1.0,1,1.0,1,0.11550130859677568,35
753,3,1439,570,869,0,0,0,1.0,1,1.0,1,1.0,1,0.18156306137207348,37
754,1,1440,570,870,0,0,0,1.0,1,1.0,1,1.0,1,0.16810296331092675,37
755,2,1442,571,871,0,0,0,1.0,1,1.0,1,1.0,1,0.16320969339638772,35
756,3,1445,571,874,0,0,0,1.0,1,1.0,1,1.0,1,0.12599666385413694,36
757,1,1446,571,875,0,0,0,1.0,1,1.0,1,1.0,1,0.06568183575631387,35
758,0,1446,571,875,0,0,0,1.0,1,1.0,1,1.0,1,0.09328416295094276,36
759,1,1447,572,875,0,0,0,1.0,1,1.0,1,1.0,1,0.14471199868776008,37
760,0,1447,572,875,0,0,0,1.0,1,1.0,1,1.0,1,0.14732480860325856,36
761,0,1447,572,875,0,0,0,1.0,1,1.0,1,1.0,1,0.14732480860325856,36
762,0,1447,572,875,0,0,0,1.0,1,1.0,1,1.0,1,0.16009998372298287,37
763,0,1447,572,875,0,0,0,1.0,1,1.0,1,1.0,1,0.1667520232857168,38
764,0,1447,572,875,0,0,0,1.0,1,1.0,1,1.0,1,0.1667520232857168,38
765,0,1447,572,875,0,0,0,1.0,1,1.0,1,1.0,1,0.1667520232857168,38
766,2,1449,572,877,0,0,0,1.0,1,1.0,1,1.0,1,0.14352334948405004,40
767,3,1452,572,880,0,0,0,1.0,1,1.0,1,1.0,1,0.10779729436444857,41
768,2,1454,573,881,0,0,0,1.0,1,1.0,1,1.0,1,0.13559043430102155,41
769,3,1457,573,884,0,0,0,1.0,1,1.0,1,1.0,1,0.09486189693596792,42
770,2,1459,573,886,0,0,0,1.0,1,1.0,1,1.0,1,0.05710061318585989,41
771,0,1459,573,886,0,0,0,1.0,1,1.0,1,1.0,1,0.08717131129034646,41
772,2,1461,575,886,0,0,0,1.0,1,1.0,1,1.0,1,0.09056642766483068,41
773,1,1462,575,887,0,0,0,1.0,1,1.0,1,1.0,1,0.05680401816866281,41
774,2,1464,577,887,0,0,0,1.0,1,1.0,1,1.0,1,0.13644959440434584,42
775,3,1467,577,890,0,0,0,1.0,1,1.0,1,1.0,1,0.11476835405307755,42
776,0,1467,577,890,0,0,0,1.0,1,1.0,1,1.0,1,0.11476835405307755,42
777,1,1468,577,891,0,0,0,1.0,1,1.0,1,1.0,1,0.09630795855253521,42
778,3,1471,578,893,0,0,0,1.0,1,1.0,1,1.0,1,0.08975868002728779,44
779,1,1472,579,893,0,0,0,1.0,1,1.0,1,1.0,1,0.1373386818243853,44
780,2,1474,579,895,0,0,0,1.0,1,1.0,1,1.0,1,0.1040482482959348,44
781,1,1475,579,896,0,0,0,1.0,1,1.0,1,1.0,1,0.08299854213762961,46
782,1,1476,580,896,0,0,0,1.0,1,1.0,1,1.0,1,0.12309485933166418,45
783,4,1480,581,899,0,0,0,1.0,1,1.0,1,1.0,1,0.13908704838237107,44
784,1,1481,581,900,0,0,0,1.0,1,1.0,1,1.0,1,0.130125212211383,44
785,3,1484,582,902,0,0,0,1.0,1,1.0,1,1.0,1,0.08253523741809685,43
786,1,1485,583,902,0,0,0,1.0,1,1.0,1,1.0,1,0.07910572837698247,43
787,0,1485,583,902,0,0,0,1.0,1,1.0,1,1.0,1,0.07910572837698247,43
788,5,1490,585,905,0,0,0,1.0,1,1.0,1,1.0,1,0.1370516101713007,45
789,2,1492,586,906,0,0,0,1.0,1,1.0,1,1.0,1,0.14291336881108704,46
790,4,1496,586,910,0,0,0,1.0,1,1.0,1,1.0,1,0.16008418419486614,45
791,3,1499,587,912,0,0,0,1.0,1,1.0,1,1.0,1,0.12836932030555534,46
792,2,1501,588,913,0,0,0,1.0,1,1.0,1,1.0,1,0.11499728881552,46
793,1,1502,588,914,0,0,0,1.0,1,1.0,1,1.0,1,0.11066829071457156,46
794,2,1504,588,916,0,0,0,1.0,1,1.0,1,1.0,1,0.1336995207468814,47
795,1,1505,588,917,0,0,0,1.0,1,1.0,1,1.0,1,0.11646269455146833,47
796,0,1505,588,917,0,0,0,1.0,1,1.0,1,1.0,1,0.1230821360329871,46
797,4,1509,589,920,0,0,0,1.0,1,1.0,1,1.0,1,0.14632405733251921,47
798,5,1514,590,924,0,0,0,1.0,1,1.0,1,1.0,1,0.1237821284487742,48
799,4,1518,590,928,0,0,0,1.0,1,1.0,1,1.0,1,0.10521500850857056,48
800,2,1520,591,929,0,0,0,1.0,1,1.0,1,1.0,1,0.11980798378399554,48
801,4,1524,592,932,0,0,0,1.0,1,1.0,1,1.0,1,0.11224027480054904,49
802,0,1524,592,932,0,0,0,1.0,1,1.0,1,1.0,1,0.11012061591880445,50
803,3,1527,592,935,0,0,0,1.0,1,1.0,1,1.0,1,0.10378698167096408,49
804,1,1528,592,936,0,0,0,1.0,1,1.0,1,1.0,1,0.09834897441382155,50
805,0,1528,592,936,0,0,0,1.0,1,1.0,1,1.0,1,0.09834897441382155,50
806,0,1528,592,936,0,0,0,1.0,1,1.0,1,1.0,1,0.09834897441382155,50
807,0,1528,592,936,0,0,0,1.0,1,1.0,1,1.0,1,0.09813690682285248,51
808,2,1530,593,937,0,0,0,1.0,1,1.0,1,1.0,1,0.0852257648631522,51
809,3,1533,594,939,0,0,0,1.0,1,1.0,1,1.0,1,0.07536282907084642,51
810,2,1535,595,940,0,0,0,1.0,1,1.0,1,1.0,1,0.07837212249880467,52
811,2,1537,596,941,0,0,0,1.0,1,1.0,1,1.0,1,0.07940315544167525,50
812,1,1538,597,941,0,0,0,1.0,1,1.0,1,1.0,1,0.15148259860577803,48
813,7,1545,599,946,0,0,0,1.0,1,1.0,1,1.0,1,0.12353537283196307,49
814,0,1545,599,946,0,0,0,1.0,1,1.0,1,1.0,1,0.14164911211093534,48
815,6,1551,601,950,0,0,0,1.0,1,1.0,1,1.0,1,0.11141574062127584,48
816,1,1552,602,950,0,0,0,1.0,1,1.0,1,1.0,1,0.14275853789403706,46
817,3,1555,602,953,0,0,0,1.0,1,1.0,1,1.0,1,0.18802318936281642,44
818,3,1558,602,956,0,0,0,1.0,1,1.0,1,1.0,1,0.1624950211404563,46
819,3,1561,603,958,0,0,0,1.0,1,1.0,1,1.0,1,0.15377476581772698,44
820,2,1563,603,960,0,0,0,1.0,1,1.0,1,1.0,1,0.11455311158264173,44
821,0,1563,603,960,0,0,0,1.0,1,1.0,1,1.0,1,0.11455311158264173,44
822,3,1566,605,961,0,0,0,1.0,1,1.0,1,1.0,1,0.1349193999930106,44
823,1,1567,605,962,0,0,0,1.0,1,1.0,1,1.0,1,0.10452537845540245,42
824,6,1573,609,964,0,0,0,1.0,1,1.0,1,1.0,1,0.09222985054559284,42
825,4,1577,612,965,0,0,0,1.0,1,1.0,1,1.0,1,0.10805196401378594,40
826,4,1581,613,968,0,0,0,1.0,1,1.0,1,1.0,1,0.10727766508256595,41
827,0,1581,613,968,0,0,0,1.0,1,1.0,1,1.0,1,0.09883732411394709,40
828,2,1583,615,968,0,0,0,1.0,1,1.0,1,1.0,1,0.08783254292608593,40
829,4,1587,617,970,0,0,0,1.0,1,1.0,1,1.0,1,0.07851020434265271,42
830,3,1590,618,972,0,0,0,1.0,1,1.0,1,1.0,1,0.12842106820165974,42
831,6,1596,620,976,0,0,0,1.0,1,1.0,1,1.0,1,0.10871917923483758,43
832,2,1598,621,977,0,0,0,1.0,1,1.0,1,1.0,1,0.08665356124592768,42
833,1,1599,621,978,0,0,0,1.0,1,1.0,1,1.0,1,0.09942990207269271,41
834,3,1602,624,978,0,0,0,1.0,1,1.0,1,1.0,1,0.14753202080073877,41
835,2,1604,625,979,0,0,0,1.0,1,1.0,1,1.0,1,0.14715206936507128,41
836,1,1605,625,980,0,0,0,1.0,1,1.0,1,1.0,1,0.11510765072505089,40
837,1,1606,625,981,0,0,0,1.0,1,1.0,1,1.0,1,0.09096326141840205,41
838,1,1607,626,981,0,0,0,1.0,1,1.0,1,1.0,1,0.1251984191486066,41
839,3,1610,626,984,0,0,0,1.0,1,1.0,1,1.0,1,0.046588883151448025,41
840,1,1611,627,984,0,0,0,1.0,1,1.0,1,1.0,1,0.11217505081165662,42
841,1,1612,628,984,0,0,0,1.0,1,1.0,1,1.0,1,0.13557917740160622,42
842,1,1613,629,984,0,0,0,1.0,1,1.0,1,1.0,1,0.16092725575601324,42
843,3,1616,631,985,0,0,0,1.0,1,1.0,1,1.0,1,0.1782282176640265,42
844,3,1619,632,987,0,0,0,1.0,1,1.0,1,1.0,1,0.19398793982206153,42
845,8,1627,633,994,0,0,0,1.0,1,1.0,1,1.0,1,0.12955635058464704,44
846,2,1629,634,995,0,0,0,1.0,1,1.0,1,1.0,1,0.126111525733816,44
847,1,1630,634,996,0,0,0,1.0,1,1.0,1,1.0,1,0.12258176658644868,42
848,0,1630,634,996,0,0,0,1.0,1,1.0,1,1.0,1,0.1384903969673751,43
849,2,1632,634,998,0,0,0,1.0,1,1.0,1,1.0,1,0.1100948306689718,43
850,2,1634,634,1000,0,0,0,1.0,1,1.0,1,1.0,1,0.12432209067685665,41
851,2,1636,634,1002,0,0,0,1.0,1,1.0,1,1.0,1,0.12755116220297108,40
852,1,1637,635,1002,0,0,0,1.0,1,1.0,1,1.0,1,0.1385935973560132,40
853,1,1638,636,1002,0,0,0,1.0,1,1.0,1,1.0,1,0.13276397926073133,40
854,2,1640,637,1003,0,0,0,1.0,1,1.0,1,1.0,1,0.1286593214054356,40
855,2,1642,638,1004,0,0,0,1.0,1,1.0,1,1.0,1,0.11701547950478168,41
856,1,1643,639,1004,0,0,0,1.0,1,1.0,1,1.0,1,0.13496548646226836,41
857,2,1645,640,1005,0,0,0,1.0,1,1.0,1,1.0,1,0.12749050808985884,42
858,2,1647,640,1007,0,0,0,1.0,1,1.0,1,1.0,1,0.07250446814757025,43
859,0,1647,640,1007,0,0,0,1.0,1,1.0,1,1.0,1,0.07250446814757025,43
860,0,1647,640,1007,0,0,0,1.0,1,1.0,1,1.0,1,0.08352493242085987,44
861,1,1648,641,1007,0,0,0,1.0,1,1.0,1,1.0,1,0.08739627552000039,44
862,0,1648,641,1007,0,0,0,1.0,1,1.0,1,1.0,1,0.08739627552000039,44
863,5,1653,644,1009,0,0,0,1.0,1,1.0,1,1.0,1,0.12922314504177057,44
864,3,1656,645,1011,0,0,0,1.0,1,1.0,1,1.0,1,0.119962029698857,44
865,2,1658,647,1011,0,0,0,1.0,1,1.0,1,1.0,1,0.09217201893276257,43
866,7,1665,651,1014,0,0,0,1.0,1,1.0,1,1.0,1,0.14344011088149553,45
867,3,1668,651,1017,0,0,0,1.0,1,1.0,1,1.0,1,0.10628289208755042,44
868,4,1672,654,1018,0,0,0,1.0,1,1.0,1,1.0,1,0.10683838535255386,45
869,5,1677,658,1019,0,0,0,1.0,1,1.0,1,1.0,1,0.14410247004197255,44
870,1,1678,659,1019,0,0,0,1.0,1,1.0,1,1.0,1,0.1536364265198612,44
871,4,1682,659,1023,0,0,0,1.0,1,1.0,1,1.0,1,0.10929580605105299,43
872,3,1685,659,1026,0,0,0,1.0,1,1.0,1,1.0,1,0.0912860434050262,43
873,3,1688,660,1028,0,0,0,1.0,1,1.0,1,1.0,1,0.11388280000320603,43
874,4,1692,661,1031,0,0,0,1.0,1,1.0,1,1.0,1,0.1073656754684072,46
875,3,1695,662,1033,0,0,0,1.0,1,1.0,1,1.0,1,0.12279831409394014,43
876,3,1698,663,1035,0,0,0,1.0,1,1.0,1,1.0,1,0.09578731179962448,44
877,1,1699,663,1036,0,0,0,1.0,1,1.0,1,1.0,1,0.1027419769425324,44
878,0,1699,663,1036,0,0,0,1.0,1,1.0,1,1.0,1,0.1027419769425324,44
879,2,1701,664,1037,0,0,0,1.0,1,1.0,1,1.0,1,0.10117709210636062,44
880,2,1703,666,1037,0,0,0,1.0,1,1.0,1,1.0,1,0.13020337435801912,44
881,1,1704,666,1038,0,0,0,1.0,1,1.0,1,1.0,1,0.10406909261815353,43
882,1,1705,667,1038,0,0,0,1.0,1,1.0,1,1.0,1,0.11660638558550104,45
883,2,1707,667,1040,0,0,0,1.0,1,1.0,1,1.0,1,0.09983121902430497,45
884,4,1711,669,1042,0,0,0,1.0,1,1.0,1,1.0,1,0.09306742971833096,45
885,2,1713,670,1043,0,0,0,1.0,1,1.0,1,1.0,1,0.03892556728486683,43
886,1,1714,671,1043,0,0,0,1.0,1,1.0,1,1.0,1,0.13891993929236024,43
887,2,1716,671,1045,0,0,0,1.0,1,1.0,1,1.0,1,0.09160366219667807,41
888,1,1717,671,1046,0,0,0,1.0,1,1.0,1,1.0,1,0.15570186202205635,40
889,3,1720,672,1048,0,0,0,1.0,1,1.0,1,1.0,1,0.11797152450974012,40
890,1,1721,673,1048,0,0,0,1.0,1,1.0,1,1.0,1,0.09928683090077749,38
891,5,1726,675,1051,0,0,0,1.0,1,1.0,1,1.0,1,0.15999236464631464,39
892,1,1727,675,1052,0,0,0,1.0,1,1.0,1,1.0,1,0.13540556777986218,39
893,0,1727,675,1052,0,0,0,1.0,1,1.0,1,1.0,1,0.14551751344065011,37
894,3,1730,678,1052,0,0,0,1.0,1,1.0,1,1.0,1,0.22201442507313304,36
895,3,1733,678,1055,0,0,0,1.0,1,1.0,1,1.0,1,0.1825135384199371,37
896,1,1734,679,1055,0,0,0,1.0,1,1.0,1,1.0,1,0.2416792921233777,36
897,3,1737,680,1057,0,0,0,1.0,1,1.0,1,1.0,1,0.21846643753674858,36
898,0,1737,680,1057,0,0,0,1.0,1,1.0,1,1.0,1,0.2332875133566521,35
899,2,1739,681,1058,0,0,0,1.0,1,1.0,1,1.0,1,0.23286407330857165,35
900,1,1740,682,1058,0,0,0,1.0,1,1.0,1,1.0,1,0.2640333556516636,36
901,0,1740,682,1058,0,0,0,1.0,1,1.0,1,1.0,1,0.2640333556516636,36
902,4,1744,684,1060,0,0,0,1.0,1,1.0,1,1.0,1,0.2565746012300023,36
903,2,1746,684,1062,0,0,0,1.0,1,1.0,1,1.0,1,0.19469295284760801,35
904,5,1751,687,1064,0,0,0,1.0,1,1.0,1,1.0,1,0.1668881812459829,37
905,3,1754,689,1065,0,0,0,1.0,1,1.0,1,1.0,1,0.14876221348371668,36
906,1,1755,690,1065,0,0,0,1.0,1,1.0,1,1.0,1,0.18470775728353575,37
907,6,1761,693,1068,0,0,0,1.0,1,1.0,1,1.0,1,0.11820285259141954,37
908,5,1766,696,1070,0,0,0,1.0,1,1.0,1,1.0,1,0.16727844142429632,36
909,5,1771,696,1075,0,0,0,1.0,1,1.0,1,1.0,1,0.15438285362508672,36
910,2,1773,697,1076,0,0,0,1.0,1,1.0,1,1.0,1,0.16353990119563752,37
911,5,1778,698,1080,0,0,0,1.0,1,1.0,1,1.0,1,0.14765086329736518,36
912,1,1779,699,1080,0,0,0,1.0,1,1.0,1,1.0,1,0.14537951710101127,34
913,3,1782,701,1081,0,0,0,1.0,1,1.0,1,1.0,1,0.17091044178273648,34
914,1,1783,702,1081,0,0,0,1.0,1,1.0,1,1.0,1,0.1826621747527672,33
915,3,1786,702,1084,0,0,0,1.0,1,1.0,1,1.0,1,0.09399277398014182,33
916,0,1786,702,1084,0,0,0,1.0,1,1.0,1,1.0,1,0.11827361735825655,34
917,1,1787,703,1084,0,0,0,1.0,1,1.0,1,1.0,1,0.13428241177118697,34
918,1,1788,703,1085,0,0,0,1.0,1,1.0,1,1.0,1,0.1110066085766019,36
919,2,1790,703,1087,0,0,0,1.0,1,1.0,1,1.0,1,0.0428686002039776,36
920,1,1791,703,1088,0,0,0,1.0,1,1.0,1,1.0,1,0.06606228869978889,37
921,0,1791,703,1088,0,0,0,1.0,1,1.0,1,1.0,1,0.06606228869978889,37
922,2,1793,704,1089,0,0,0,1.0,1,1.0,1,1.0,1,0.10950600044458265,38
923,1,1794,705,1089,0,0,0,1.0,1,1.0,1,1.0,1,0.059630673695467595,36
924,0,1794,705,1089,0,0,0,1.0,1,1.0,1,1.0,1,0.08161353145092635,35
925,0,1794,705,1089,0,0,0,1.0,1,1.0,1,1.0,1,0.16441619339507788,35
926,1,1795,706,1089,0,0,0,1.0,1,1.0,1,1.0,1,0.16656212807050816,34
927,4,1799,707,1092,0,0,0,1.0,1,1.0,1,1.0,1,0.12610209164151517,32
928,0,1799,707,1092,0,0,0,1.0,1,1.0,1,1.0,1,0.17920616620261637,32
929,5,1804,709,1095,0,0,0,1.0,1,1.0,1,1.0,1,0.16555242421867644,31
930,1,1805,710,1095,0,0,0,1.0,1,1.0,1,1.0,1,0.21807250260477967,30
931,4,1809,712,1097,0,0,0,1.0,1,1.0,1,1.0,1,0.21811331776760412,29
932,0,1809,712,1097,0,0,0,1.0,1,1.0,1,1.0,1,0.21811331776760412,29
933,2,1811,712,1099,0,0,0,1.0,1,1.0,1,1.0,1,0.1638119560882838,29
934,0,1811,712,1099,0,0,0,1.0,1,1.0,1,1.0,1,0.1638119560882838,29
935,2,1813,712,1101,0,0,0,1.0,1,1.0,1,1.0,1,0.127176718754759,31
936,1,1814,713,1101,0,0,0,1.0,1,1.0,1,1.0,1,0.14670488138902815,31
937,3,1817,714,1103,0,0,0,1.0,1,1.0,1,1.0,1,0.12883726931660205,34
938,0,1817,714,1103,0,0,0,1.0,1,1.0,1,1.0,1,0.11494181092038985,33
939,4,1821,715,1106,0,0,0,1.0,1,1.0,1,1.0,1,0.15698246139953284,36
940,0,1821,715,1106,0,0,0,1.0,1,1.0,1,1.0,1,0.16778926988979992,36
941,0,1821,715,1106,0,0,0,1.0,1,1.0,1,1.0,1,0.16778926988979992,36
942,3,1824,716,1108,0,0,0,1.0,1,1.0,1,1.0,1,0.1419323661656035,36
943,1,1825,717,1108,0,0,0,1.0,1,1.0,1,1.0,1,0.14503211886284179,35
944,2,1827,719,1108,0,0,0,1.0,1,1.0,1,1.0,1,0.17766220382260658,35
945,3,1830,719,1111,0,0,0,1.0,1,1.0,1,1.0,1,0.11051604223655057,33
946,7,1837,721,1116,0,0,0,1.0,1,1.0,1,1.0,1,0.18359205145780536,36
947,3,1840,722,1118,0,0,0,1.0,1,1.0,1,1.0,1,0.1788901914502601,34
948,1,1841,723,1118,0,0,0,1.0,1,1.0,1,1.0,1,0.22926438097325202,33
949,3,1844,724,1120,0,0,0,1.0,1,1.0,1,1.0,1,0.27438354508421225,34
950,1,1845,724,1121,0,0,0,1.0,1,1.0,1,1.0,1,0.30443860774108616,33
951,2,1847,724,1123,0,0,0,1.0,1,1.0,1,1.0,1,0.2662215347518809,33
952,1,1848,724,1124,0,0,0,1.0,1,1.0,1,1.0,1,0.2764159831653263,32
953,0,1848,724,1124,0,0,0,1.0,1,1.0,1,1.0,1,0.2764159831653263,32
954,0,1848,724,1124,0,0,0,1.0,1,1.0,1,1.0,1,0.3038941308054911,31
955,4,1852,724,1128,0,0,0,1.0,1,1.0,1,1.0,1,0.23863642651051553,32
956,3,1855,725,1130,0,0,0,1.0,1,1.0,1,1.0,1,0.20062108268239623,32
957,1,1856,725,1131,0,0,0,1.0,1,1.0,1,1.0,1,0.1561876731772633,33
958,1,1857,725,1132,0,0,0,1.0,1,1.0,1,1.0,1,0.13165009042941594,35
959,1,1858,726,1132,0,0,0,1.0,1,1.0,1,1.0,1,0.15206159614472745,36
960,0,1858,726,1132,0,0,0,1.0,1,1.0,1,1.0,1,0.15876721031282,38
961,3,1861,727,1134,0,0,0,1.0,1,1.0,1,1.0,1,0.22122516378767326,37
962,1,1862,728,1134,0,0,0,1.0,1,1.0,1,1.0,1,0.26964232135676297,35
963,2,1864,728,1136,0,0,0,1.0,1,1.0,1,1.0,1,0.21252208306797035,35
964,2,1866,728,1138,0,0,0,1.0,1,1.0,1,1.0,1,0.17964844377180372,34
965,1,1867,728,1139,0,0,0,1.0,1,1.0,1,1.0,1,0.1540751443285358,35
966,1,1868,728,1140,0,0,0,1.0,1,1.0,1,1.0,1,0.17301937737266576,34
967,2,1870,728,1142,0,0,0,1.0,1,1.0,1,1.0,1,0.1569653703714915,35
968,1,1871,729,1142,0,0,0,1.0,1,1.0,1,1.0,1,0.1548064487328452,36
969,2,1873,730,1143,0,0,0,1.0,1,1.0,1,1.0,1,0.19478133875169432,35
970,1,1874,730,1144,0,0,0,1.0,1,1.0,1,1.0,1,0.20756865018720289,34
971,2,1876,730,1146,0,0,0,1.0,1,1.0,1,1.0,1,0.1901781278114975,35
972,0,1876,730,1146,0,0,0,1.0,1,1.0,1,1.0,1,0.1901781278114975,35
973,1,1877,730,1147,0,0,0,1.0,1,1.0,1,1.0,1,0.19363186056040704,36
974,0,1877,730,1147,0,0,0,1.0,1,1.0,1,1.0,1,0.23120088508831108,35
975,0,1877,730,1147,0,0,0,1.0,1,1.0,1,1.0,1,0.20379843955105714,36
976,1,1878,730,1148,0,0,0,1.0,1,1.0,1,1.0,1,0.21070890630636627,38
977,1,1879,731,1148,0,0,0,1.0,1,1.0,1,1.0,1,0.2313993833906064,38
978,0,1879,731,1148,0,0,0,1.0,1,1.0,1,1.0,1,0.2313993833906064,38
979,2,1881,731,1150,0,0,0,1.0,1,1.0,1,1.0,1,0.20123829211037236,39
980,3,1884,733,1151,0,0,0,1.0,1,1.0,1,1.0,1,0.2132888054296202,39
981,4,1888,735,1153,0,0,0,1.0,1,1.0,1,1.0,1,0.23225185910250692,40
982,6,1894,738,1156,0,0,0,1.0,1,1.0,1,1.0,1,0.23589315404051123,40
983,1,1895,738,1157,0,0,0,1.0,1,1.0,1,1.0,1,0.1797594304421686,38
984,4,1899,740,1159,0,0,0,1.0,1,1.0,1,1.0,1,0.14333463312313804,39
985,5,1904,743,1161,0,0,0,1.0,1,1.0,1,1.0,1,0.19964070620676588,38
986,4,1908,744,1164,0,0,0,1.0,1,1.0,1,1.0,1,0.14833880703564217,38
987,2,1910,745,1165,0,0,0,1.0,1,1.0,1,1.0,1,0.14825909382045546,38
988,0,1910,745,1165,0,0,0,1.0,1,1.0,1,1.0,1,0.14825909382045546,38
989,2,1912,745,1167,0,0,0,1.0,1,1.0,1,1.0,1,0.10511574008054488,38
990,1,1913,745,1168,0,0,0,1.0,1,1.0,1,1.0,1,0.08379798153091944,38
991,0,1913,745,1168,0,0,0,1.0,1,1.0,1,1.0,1,0.08308715791354498,40
992,1,1914,746,1168,0,0,0,1.0,1,1.0,1,1.0,1,0.1037945070743447,39
993,2,1916,747,1169,0,0,0,1.0,1,1.0,1,1.0,1,0.1236388569230451,38
994,1,1917,747,1170,0,0,0,1.0,1,1.0,1,1.0,1,0.13638185665383384,39
995,1,1918,747,1171,0,0,0,1.0,1,1.0,1,1.0,1,0.12330344047336814,41
996,0,1918,747,1171,0,0,0,1.0,1,1.0,1,1.0,1,0.1291353967465971,40
997,0,1918,747,1171,0,0,0,1.0,1,1.0,1,1.0,1,0.15218481996882102,41
998,0,1918,747,1171,0,0,0,1.0,1,1.0,1,1.0,1,0.14315045108478539,40
999,0,1918,747,1171,0,0,0,1.0,1,1.0,1,1.0,1,0.1609569532638915,40
1000,0,1918,747,1171,0,0,0,1.0,1,1.0,1,1.0,1,0.1609569532638915,40
1001,1,1919,747,1172,0,0,0,1.0,1,1.0,1,1.0,1,0.14266653375499744,39
1002,0,1919,747,1172,0,0,0,1.0,1,1.0,1,1.0,1,0.14266653375499744,39
1003,0,1919,747,1172,0,0,0,1.0,1,1.0,1,1.0,1,0.14266653375499744,39
1004,0,1919,747,1172,0,0,0,1.0,1,1.0,1,1.0,1,0.14266653375499744,39
1005,0,1919,747,1172,0,0,0,1.0,1,1.0,1,1.0,1,0.15868321073997224,40
1006,0,1919,747,1172,0,0,0,1.0,1,1.0,1,1.0,1,0.14706665332361893,41
1007,3,1922,747,1175,0,0,0,1.0,1,1.0,1,1.0,1,0.11109773660996382,42
1008,2,1924,748,1176,0,0,0,1.0,1,1.0,1,1.0,1,0.10326516721106052,43
1009,0,1924,748,1176,0,0,0,1.0,1,1.0,1,1.0,1,0.11614590795516863,44
1010,0,1924,748,1176,0,0,0,1.0,1,1.0,1,1.0,1,0.11614590795516863,44
1011,1,1925,749,1176,0,0,0,1.0,1,1.0,1,1.0,1,0.15422387336818064,44
1012,4,1929,751,1178,0,0,0,1.0,1,1.0,1,1.0,1,0.16706900359900992,46
1013,2,1931,751,1180,0,0,0,1.0,1,1.0,1,1.0,1,0.1178815867013941,46
1014,2,1933,752,1181,0,0,0,1.0,1,1.0,1,1.0,1,0.14821206681267565,46
1015,0,1933,752,1181,0,0,0,1.0,1,1.0,1,1.0,1,0.14821206681267565,46
1016,1,1934,753,1181,0,0,0,1.0,1,1.0,1,1.0,1,0.16216086543216152,47
1017,1,1935,753,1182,0,0,0,1.0,1,1.0,1,1.0,1,0.15684077372766894,47
1018,7,1942,754,1188,0,0,0,1.0,1,1.0,1,1.0,1,0.12770603370872413,48
1019,2,1944,755,1189,0,0,0,1.0,1,1.0,1,1.0,1,0.12622601387640814,49
1020,1,1945,755,1190,0,0,0,1.0,1,1.0,1,1.0,1,0.11095896501250829,51
1021,3,1948,757,1191,0,0,0,1.0,1,1.0,1,1.0,1,0.1569708033280847,51
1022,2,1950,758,1192,0,0,0,1.0,1,1.0,1,1.0,1,0.13108722203668047,52
1023,2,1952,758,1194,0,0,0,1.0,1,1.0,1,1.0,1,0.11782151024869028,52
1024,0,1952,758,1194,0,0,0,1.0,1,1.0,1,1.0,1,0.11782151024869028,52
1025,1,1953,758,1195,0,0,0,1.0,1,1.0,1,1.0,1,0.11006422820566134,54
1026,0,1953,758,1195,0,0,0,1.0,1,1.0,1,1.0,1,0.11006422820566134,54
1027,2,1955,758,1197,0,0,0,1.0,1,1.0,1,1.0,1,0.08309215984092444,55
1028,1,1956,758,1198,0,0,0,1.0,1,1.0,1,1.0,1,0.08711863847325234,56
1029,0,1956,758,1198,0,0,0,1.0,1,1.0,1,1.0,1,0.08711863847325234,56
1030,2,1958,759,1199,0,0,0,1.0,1,1.0,1,1.0,1,0.10540590681419998,57
1031,2,1960,759,1201,0,0,0,1.0,1,1.0,1,1.0,1,0.0759016963727923,58
1032,3,1963,762,1201,0,0,0,1.0,1,1.0,1,1.0,1,0.11196734937529762,58
1033,4,1967,762,1205,0,0,0,1.0,1,1.0,1,1.0,1,0.07739495682300884,57
1034,3,1970,765,1205,0,0,0,1.0,1,1.0,1,1.0,1,0.13146310298545427,57
1035,3,1973,767,1206,0,0,0,1.0,1,1.0,1,1.0,1,0.11228752501760411,57
1036,4,1977,769,1208,0,0,0,1.0,1,1.0,1,1.0,1,0.10633831187399198,59
1037,4,1981,771,1210,0,0,0,1.0,1,1.0,1,1.0,1,0.10693953033069253,57
1038,3,1984,772,1212,0,0,0,1.0,1,1.0,1,1.0,1,0.15091080239430255,59
1039,6,1990,774,1216,0,0,0,1.0,1,1.0,1,1.0,1,0.085424932074371,57
1040,0,1990,774,1216,0,0,0,1.0,1,1.0,1,1.0,1,0.12904244869053372,56
1041,3,1993,775,1218,0,0,0,1.0,1,1.0,1,1.0,1,0.11006597400307325,54
1042,0,1993,775,1218,0,0,0,1.0,1,1.0,1,1.0,1,0.07827625966671256,52
1043,1,1994,776,1218,0,0,0,1.0,1,1.0,1,1.0,1,0.09970548611330476,52
1044,2,1996,778,1218,0,0,0,1.0,1,1.0,1,1.0,1,0.12782857493522165,50
1045,2,1998,779,1219,0,0,0,1.0,1,1.0,1,1.0,1,0.13743245851544306,51
1046,1,1999,780,1219,0,0,0,1.0,1,1.0,1,1.0,1,0.1508543381439062,50
1047,2,2001,781,1220,0,0,0,1.0,1,1.0,1,1.0,1,0.12644775145819429,50
1048,1,2002,781,1221,0,0,0,1.0,1,1.0,1,1.0,1,0.10535925458884178,50
1049,3,2005,782,1223,0,0,0,1.0,1,1.0,1,1.0,1,0.12808868281177332,50
1050,1,2006,783,1223,0,0,0,1.0,1,1.0,1,1.0,1,0.12875388594187023,50
1051,2,2008,783,1225,0,0,0,1.0,1,1.0,1,1.0,1,0.09987521285997511,50
1052,2,2010,783,1227,0,0,0,1.0,1,1.0,1,1.0,1,0.09230555510824558,51
1053,0,2010,783,1227,0,0,0,1.0,1,1.0,1,1.0,1,0.09230555510824558,51
1054,0,2010,783,1227,0,0,0,1.0,1,1.0,1,1.0,1,0.07985786715658863,53
1055,1,2011,783,1228,0,0,0,1.0,1,1.0,1,1.0,1,0.08256614288748786,54
1056,0,2011,783,1228,0,0,0,1.0,1,1.0,1,1.0,1,0.08082983386346661,54
1057,1,2012,784,1228,0,0,0,1.0,1,1.0,1,1.0,1,0.11792633691297683,55
1058,1,2013,784,1229,0,0,0,1.0,1,1.0,1,1.0,1,0.12838180193312873,54
1059,5,2018,786,1232,0,0,0,1.0,1,1.0,1,1.0,1,0.16551074357805964,53
1060,2,2020,787,1233,0,0,0,1.0,1,1.0,1,1.0,1,0.16031665639758994,53
1061,6,2026,790,1236,0,0,0,1.0,1,1.0,1,1.0,1,0.14700958455122085,53
1062,4,2030,794,1236,0,0,0,1.0,1,1.0,1,1.0,1,0.12637388233776367,54
1063,1,2031,794,1237,0,0,0,1.0,1,1.0,1,1.0,1,0.15804976483474495,53
1064,3,2034,797,1237,0,0,0,1.0,1,1.0,1,1.0,1,0.14053734524656417,55
1065,3,2037,797,1240,0,0,0,1.0,1,1.0,1,1.0,1,0.15003439913062325,54
1066,6,2043,799,1244,0,0,0,1.0,1,1.0,1,1.0,1,0.139683833663155,55
1067,3,2046,800,1246,0,0,0,1.0,1,1.0,1,1.0,1,0.13014183172664517,55
1068,1,2047,800,1247,0,0,0,1.0,1,1.0,1,1.0,1,0.13619361293922602,55
1069,3,2050,800,1250,0,0,0,1.0,1,1.0,1,1.0,1,0.13781956604286988,55
1070,1,2051,801,1250,0,0,0,1.0,1,1.0,1,1.0,1,0.15053861728120407,54
1071,3,2054,802,1252,0,0,0,1.0,1,1.0,1,1.0,1,0.1580214843622115,55
1072,1,2055,803,1252,0,0,0,1.0,1,1.0,1,1.0,1,0.13347524999333787,54
1073,2,2057,804,1253,0,0,0,1.0,1,1.0,1,1.0,1,0.13974297456043233,54
1074,2,2059,805,1254,0,0,0,1.0,1,1.0,1,1.0,1,0.1362607771008746,52
1075,0,2059,805,1254,0,0,0,1.0,1,1.0,1,1.0,1,0.15726705086058357,51
1076,4,2063,806,1257,0,0,0,1.0,1,1.0,1,1.0,1,0.17539778958229377,52
1077,7,2070,807,1263,0,0,0,1.0,1,1.0,1,1.0,1,0.08507879957455415,49
1078,5,2075,810,1265,0,0,0,1.0,1,1.0,1,1.0,1,0.11090115124467571,48
1079,1,2076,811,1265,0,0,0,1.0,1,1.0,1,1.0,1,0.13359782558249675,47
1080,2,2078,813,1265,0,0,0,1.0,1,1.0,1,1.0,1,0.14332349266270353,47
1081,1,2079,814,1265,0,0,0,1.0,1,1.0,1,1.0,1,0.18347285474895886,45
1082,1,2080,815,1265,0,0,0,1.0,1,1.0,1,1.0,1,0.214722170891909,42
1083,2,2082,816,1266,0,0,0,1.0,1,1.0,1,1.0,1,0.23525095380554656,42
1084,1,2083,816,1267,0,0,0,1.0,1,1.0,1,1.0,1,0.24799915945474726,40
1085,1,2084,816,1268,0,0,0,1.0,1,1.0,1,1.0,1,0.20994859354836878,43
1086,3,2087,817,1270,0,0,0,1.0,1,1.0,1,1.0,1,0.21727624161115622,41
1087,3,2090,817,1273,0,0,0,1.0,1,1.0,1,1.0,1,0.22889421386002184,41
1088,3,2093,817,1276,0,0,0,1.0,1,1.0,1,1.0,1,0.16241357323103456,41
1089,2,2095,818,1277,0,0,0,1.0,1,1.0,1,1.0,1,0.14748131688678645,42
1090,1,2096,818,1278,0,0,0,1.0,1,1.0,1,1.0,1,0.13219632284585475,43
1091,2,2098,819,1279,0,0,0,1.0,1,1.0,1,1.0,1,0.15442461986428868,43
1092,0,2098,819,1279,0,0,0,1.0,1,1.0,1,1.0,1,0.15442461986428868,43
1093,1,2099,820,1279,0,0,0,1.0,1,1.0,1,1.0,1,0.15825473370387905,43
1094,1,2100,820,1280,0,0,0,1.0,1,1.0,1,1.0,1,0.13884185887297226,43
1095,2,2102,821,1281,0,0,0,1.0,1,1.0,1,1.0,1,0.16071048102132107,44
1096,1,2103,822,1281,0,0,0,1.0,1,1.0,1,1.0,1,0.17664477018633126,44
1097,5,2108,824,1284,0,0,0,1.0,1,1.0,1,1.0,1,0.20549999806880123,45
1098,0,2108,824,1284,0,0,0,1.0,1,1.0,1,1.0,1,0.20548310039523515,46
1099,3,2111,825,1286,0,0,0,1.0,1,1.0,1,1.0,1,0.19914116664508447,48
1100,1,2112,825,1287,0,0,0,1.0,1,1.0,1,1.0,1,0.17668112954525236,49
1101,1,2113,825,1288,0,0,0,1.0,1,1.0,1,1.0,1,0.1561792788451473,49
1102,4,2117,827,1290,0,0,0,1.0,1,1.0,1,1.0,1,0.1520200085443471,50
1103,5,2122,828,1294,0,0,0,1.0,1,1.0,1,1.0,1,0.1050548098916566,48
1104,3,2125,829,1296,0,0,0,1.0,1,1.0,1,1.0,1,0.057589010247693195,50
1105,2,2127,831,1296,0,0,0,1.0,1,1.0,1,1.0,1,0.07395904360574078,48
1106,1,2128,832,1296,0,0,0,1.0,1,1.0,1,1.0,1,0.08364692318307664,48
1107,1,2129,833,1296,0,0,0,1.0,1,1.0,1,1.0,1,0.07182531332833858,47
1108,1,2130,834,1296,0,0,0,1.0,1,1.0,1,1.0,1,0.09615795787407055,47
1109,6,2136,836,1300,0,0,0,1.0,1,1.0,1,1.0,1,0.08492801705853109,46
1110,2,2138,837,1301,0,0,0,1.0,1,1.0,1,1.0,1,0.14617715044775295,43
1111,4,2142,838,1304,0,0,0,1.0,1,1.0,1,1.0,1,0.11367288441082032,44
1112,1,2143,839,1304,0,0,0,1.0,1,1.0,1,1.0,1,0.13964488382568066,43
1113,1,2144,839,1305,0,0,0,1.0,1,1.0,1,1.0,1,0.13627185592030588,39
1114,0,2144,839,1305,0,0,0,1.0,1,1.0,1,1.0,1,0.13627185592030588,39
1115,6,2150,841,1309,0,0,0,1.0,1,1.0,1,1.0,1,0.13510340823811076,37
1116,1,2151,842,1309,0,0,0,1.0,1,1.0,1,1.0,1,0.12996367116216626,37
1117,5,2156,844,1312,0,0,0,1.0,1,1.0,1,1.0,1,0.12807812053687959,36
1118,2,2158,844,1314,0,0,0,1.0,1,1.0,1,1.0,1,0.13951724885447706,36
1119,1,2159,844,1315,0,0,0,1.0,1,1.0,1,1.0,1,0.11080291127377559,36
1120,0,2159,844,1315,0,0,0,1.0,1,1.0,1,1.0,1,0.11080291127377559,36
1121,1,2160,845,1315,0,0,0,1.0,1,1.0,1,1.0,1,0.15303884699575507,36
1122,1,2161,845,1316,0,0,0,1.0,1,1.0,1,1.0,1,0.16953443556729142,37
1123,1,2162,845,1317,0,0,0,1.0,1,1.0,1,1.0,1,0.14345260066983448,37
1124,0,2162,845,1317,0,0,0,1.0,1,1.0,1,1.0,1,0.14345260066983448,37
1125,0,2162,845,1317,0,0,0,1.0,1,1.0,1,1.0,1,0.1716772900715661,38
1126,1,2163,846,1317,0,0,0,1.0,1,1.0,1,1.0,1,0.197400919734749,38
1127,2,2165,847,1318,0,0,0,1.0,1,1.0,1,1.0,1,0.2218730116441336,39
1128,1,2166,847,1319,0,0,0,1.0,1,1.0,1,1.0,1,0.20127092344112557,39
1129,1,2167,847,1320,0,0,0,1.0,1,1.0,1,1.0,1,0.19432502366598423,39
1130,1,2168,848,1320,0,0,0,1.0,1,1.0,1,1.0,1,0.22713762390116998,39
1131,2,2170,848,1322,0,0,0,1.0,1,1.0,1,1.0,1,0.17512663561281985,39
1132,1,2171,848,1323,0,0,0,1.0,1,1.0,1,1.0,1,0.16874704658481815,39
1133,1,2172,848,1324,0,0,0,1.0,1,1.0,1,1.0,1,0.152431900254744,42
1134,0,2172,848,1324,0,0,0,1.0,1,1.0,1,1.0,1,0.152431900254744,42
1135,1,2173,848,1325,0,0,0,1.0,1,1.0,1,1.0,1,0.1751605382705368,44
1136,2,2175,848,1327,0,0,0,1.0,1,1.0,1,1.0,1,0.1662814987048186,46
1137,0,2175,848,1327,0,0,0,1.0,1,1.0,1,1.0,1,0.18242957042154198,45
1138,4,2179,848,1331,0,0,0,1.0,1,1.0,1,1.0,1,0.1207352507579447,46
1139,1,2180,849,1331,0,0,0,1.0,1,1.0,1,1.0,1,0.14085545518154705,47
1140,0,2180,849,1331,0,0,0,1.0,1,1.0,1,1.0,1,0.15446782185113256,46
1141,2,2182,849,1333,0,0,0,1.0,1,1.0,1,1.0,1,0.14707509041916775,45
1142,3,2185,852,1333,0,0,0,1.0,1,1.0,1,1.0,1,0.1672731980909656,45
1143,5,2190,855,1335,0,0,0,1.0,1,1.0,1,1.0,1,0.14275326989867004,43
1144,5,2195,858,1337,0,0,0,1.0,1,1.0,1,1.0,1,0.09915722061352078,45
1145,3,2198,859,1339,0,0,0,1.0,1,1.0,1,1.0,1,0.09434727920984554,44
1146,4,2202,860,1342,0,0,0,1.0,1,1.0,1,1.0,1,0.1098380538592622,45
1147,2,2204,861,1343,0,0,0,1.0,1,1.0,1,1.0,1,0.0654264726363998,44
1148,2,2206,863,1343,0,0,0,1.0,1,1.0,1,1.0,1,0.11559784931205219,43
1149,2,2208,864,1344,0,0,0,1.0,1,1.0,1,1.0,1,0.16201884194779104,42
1150,7,2215,867,1348,0,0,0,1.0,1,1.0,1,1.0,1,0.18614531419160996,45
1151,3,2218,867,1351,0,0,0,1.0,1,1.0,1,1.0,1,0.16116492953086856,40
1152,6,2224,870,1354,0,0,0,1.0,1,1.0,1,1.0,1,0.16914251533442096,41
1153,4,2228,874,1354,0,0,0,1.0,1,1.0,1,1.0,1,0.2294933681066018,38
1154,2,2230,875,1355,0,0,0,1.0,1,1.0,1,1.0,1,0.20353852045923757,37
1155,0,2230,875,1355,0,0,0,1.0,1,1.0,1,1.0,1,0.191133765515907,38
1156,2,2232,876,1356,0,0,0,1.0,1,1.0,1,1.0,1,0.21669145391885447,38
1157,1,2233,876,1357,0,0,0,1.0,1,1.0,1,1.0,1,0.1709490740835515,37
1158,1,2234,877,1357,0,0,0,1.0,1,1.0,1,1.0,1,0.19658602718120732,36
1159,1,2235,877,1358,0,0,0,1.0,1,1.0,1,1.0,1,0.16158056844214091,35
1160,2,2237,878,1359,0,0,0,1.0,1,1.0,1,1.0,1,0.1699945606405043,35
1161,1,2238,878,1360,0,0,0,1.0,1,1.0,1,1.0,1,0.17626991138255474,36
1162,0,2238,878,1360,0,0,0,1.0,1,1.0,1,1.0,1,0.18247840501650756,37
1163,1,2239,878,1361,0,0,0,1.0,1,1.0,1,1.0,1,0.17206426011379886,37
1164,0,2239,878,1361,0,0,0,1.0,1,1.0,1,1.0,1,0.16016852199319928,38
1165,0,2239,878,1361,0,0,0,1.0,1,1.0,1,1.0,1,0.16016852199319928,38
1166,0,2239,878,1361,0,0,0,1.0,1,1.0,1,1.0,1,0.18062397089953555,40
1167,3,2242,879,1363,0,0,0,1.0,1,1.0,1,1.0,1,0.1519917690305168,40
1168,0,2242,879,1363,0,0,0,1.0,1,1.0,1,1.0,1,0.1519917690305168,40
1169,1,2243,879,1364,0,0,0,1.0,1,1.0,1,1.0,1,0.14342792056142756,41
1170,3,2246,881,1365,0,0,0,1.0,1,1.0,1,1.0,1,0.11751912368467779,41
1171,2,2248,882,1366,0,0,0,1.0,1,1.0,1,1.0,1,0.11159707309740191,43
1172,1,2249,883,1366,0,0,0,1.0,1,1.0,1,1.0,1,0.11557122730846453,43
1173,0,2249,883,1366,0,0,0,1.0,1,1.0,1,1.0,1,0.11557122730846453,43
1174,1,2250,884,1366,0,0,0,1.0,1,1.0,1,1.0,1,0.12715448941294777,43
1175,1,2251,884,1367,0,0,0,1.0,1,1.0,1,1.0,1,0.10894335699449144,44
1176,3,2254,885,1369,0,0,0,1.0,1,1.0,1,1.0,1,0.1291017909308061,45
1177,2,2256,886,1370,0,0,0,1.0,1,1.0,1,1.0,1,0.1540856812472262,45
1178,1,2257,887,1370,0,0,0,1.0,1,1.0,1,1.0,1,0.15037512144009874,45
1179,5,2262,889,1373,0,0,0,1.0,1,1.0,1,1.0,1,0.1824340611395233,46
1180,0,2262,889,1373,0,0,0,1.0,1,1.0,1,1.0,1,0.16574206751874887,47
1181,1,2263,889,1374,0,0,0,1.0,1,1.0,1,1.0,1,0.1697968474731259,48
1182,1,2264,890,1374,0,0,0,1.0,1,1.0,1,1.0,1,0.1671229156490817,48
1183,1,2265,890,1375,0,0,0,1.0,1,1.0,1,1.0,1,0.17127069755392463,46
1184,3,2268,893,1375,0,0,0,1.0,1,1.0,1,1.0,1,0.16639239762280414,47
1185,4,2272,894,1378,0,0,0,1.0,1,1.0,1,1.0,1,0.14973216187894126,44
1186,1,2273,894,1379,0,0,0,1.0,1,1.0,1,1.0,1,0.16561828793283292,47
1187,1,2274,894,1380,0,0,0,1.0,1,1.0,1,1.0,1,0.1541710116229945,49
1188,2,2276,895,1381,0,0,0,1.0,1,1.0,1,1.0,1,0.1570211916719024,50
1189,0,2276,895,1381,0,0,0,1.0,1,1.0,1,1.0,1,0.1352625516095903,48
1190,0,2276,895,1381,0,0,0,1.0,1,1.0,1,1.0,1,0.13310584296680636,48
1191,0,2276,895,1381,0,0,0,1.0,1,1.0,1,1.0,1,0.14627571812647763,46
1192,2,2278,897,1381,0,0,0,1.0,1,1.0,1,1.0,1,0.17747300629785503,46
1193,3,2281,897,1384,0,0,0,1.0,1,1.0,1,1.0,1,0.16296838749447545,45
1194,1,2282,897,1385,0,0,0,1.0,1,1.0,1,1.0,1,0.15247102045214786,45
1195,3,2285,898,1387,0,0,0,1.0,1,1.0,1,1.0,1,0.14024084693184516,47
1196,1,2286,898,1388,0,0,0,1.0,1,1.0,1,1.0,1,0.13623485914541295,48
1197,4,2290,898,1392,0,0,0,1.0,1,1.0,1,1.0,1,0.12828378949849517,49
1198,1,2291,899,1392,0,0,0,1.0,1,1.0,1,1.0,1,0.11430526239443557,49
1199,1,2292,899,1393,0,0,0,1.0,1,1.0,1,1.0,1,0.12480671057501676,50
1200,1,2293,900,1393,0,0,0,1.0,1,1.0,1,1.0,1,0.12712940094355205,50
1201,1,2294,900,1394,0,0,0,1.0,1,1.0,1,1.0,1,0.11346691774012213,50
1202,1,2295,901,1394,0,0,0,1.0,1,1.0,1,1.0,1,0.0993195672142458,51
1203,1,2296,901,1395,0,0,0,1.0,1,1.0,1,1.0,1,0.08494127793895635,52
1204,0,2296,901,1395,0,0,0,1.0,1,1.0,1,1.0,1,0.08494127793895635,52
1205,2,2298,902,1396,0,0,0,1.0,1,1.0,1,1.0,1,0.10018786366464646,53
1206,0,2298,902,1396,0,0,0,1.0,1,1.0,1,1.0,1,0.10018786366464646,53
1207,0,2298,902,1396,0,0,0,1.0,1,1.0,1,1.0,1,0.1074135940702239,55
1208,2,2300,902,1398,0,0,0,1.0,1,1.0,1,1.0,1,0.10099989921335004,56
1209,1,2301,902,1399,0,0,0,1.0,1,1.0,1,1.0,1,0.10393724172121604,55
1210,0,2301,902,1399,0,0,0,1.0,1,1.0,1,1.0,1,0.10393724172121604,55
1211,0,2301,902,1399,0,0,0,1.0,1,1.0,1,1.0,1,0.0831911236527868,57
1212,1,2302,903,1399,0,0,0,1.0,1,1.0,1,1.0,1,0.09864113915723001,57
1213,0,2302,903,1399,0,0,0,1.0,1,1.0,1,1.0,1,0.09864113915723001,57
1214,5,2307,907,1400,0,0,0,1.0,1,1.0,1,1.0,1,0.17750212024286247,57
1215,5,2312,907,1405,0,0,0,1.0,1,1.0,1,1.0,1,0.13773494198247313,59
1216,2,2314,907,1407,0,0,0,1.0,1,1.0,1,1.0,1,0.11996867819632524,61
1217,0,2314,907,1407,0,0,0,1.0,1,1.0,1,1.0,1,0.11996867819632524,61
1218,2,2316,907,1409,0,0,0,1.0,1,1.0,1,1.0,1,0.12480543793822278,61
1219,2,2318,908,1410,0,0,0,1.0,1,1.0,1,1.0,1,0.12472996705013946,61
1220,4,2322,909,1413,0,0,0,1.0,1,1.0,1,1.0,1,0.11636198443743852,60
1221,3,2325,909,1416,0,0,0,1.0,1,1.0,1,1.0,1,0.12324498496449275,61
1222,2,2327,909,1418,0,0,0,1.0,1,1.0,1,1.0,1,0.12144239817153242,61
1223,3,2330,910,1420,0,0,0,1.0,1,1.0,1,1.0,1,0.12068413209427732,59
1224,4,2334,913,1421,0,0,0,1.0,1,1.0,1,1.0,1,0.12228901313391773,60
1225,5,2339,913,1426,0,0,0,1.0,1,1.0,1,1.0,1,0.09645588492894751,60
1226,2,2341,914,1427,0,0,0,1.0,1,1.0,1,1.0,1,0.11460263157460869,61
1227,2,2343,916,1427,0,0,0,1.0,1,1.0,1,1.0,1,0.10288734492188288,59
1228,2,2345,917,1428,0,0,0,1.0,1,1.0,1,1.0,1,0.06225626323800025,58
1229,1,2346,917,1429,0,0,0,1.0,1,1.0,1,1.0,1,0.05186747290559241,57
1230,2,2348,919,1429,0,0,0,1.0,1,1.0,1,1.0,1,0.07953064584879545,55
1231,4,2352,920,1432,0,0,0,1.0,1,1.0,1,1.0,1,0.07149307556592317,54
1232,2,2354,922,1432,0,0,0,1.0,1,1.0,1,1.0,1,0.08718411384682673,51
1233,3,2357,924,1433,0,0,0,1.0,1,1.0,1,1.0,1,0.09948535289146695,49
1234,3,2360,926,1434,0,0,0,1.0,1,1.0,1,1.0,1,0.1640843775230988,49
1235,2,2362,926,1436,0,0,0,1.0,1,1.0,1,1.0,1,0.14768436318456515,48
1236,2,2364,926,1438,0,0,0,1.0,1,1.0,1,1.0,1,0.14068385171319572,49
1237,2,2366,927,1439,0,0,0,1.0,1,1.0,1,1.0,1,0.17271051453158034,48
1238,1,2367,927,1440,0,0,0,1.0,1,1.0,1,1.0,1,0.15336938043732862,47
1239,3,2370,927,1443,0,0,0,1.0,1,1.0,1,1.0,1,0.11001943329690099,48
1240,0,2370,927,1443,0,0,0,1.0,1,1.0,1,1.0,1,0.12233357994972208,49
1241,3,2373,928,1445,0,0,0,1.0,1,1.0,1,1.0,1,0.13475564298474033,49
1242,1,2374,928,1446,0,0,0,1.0,1,1.0,1,1.0,1,0.11668656809984558,49
1243,1,2375,928,1447,0,0,0,1.0,1,1.0,1,1.0,1,0.09650342248789592,50
1244,1,2376,928,1448,0,0,0,1.0,1,1.0,1,1.0,1,0.09854812584389148,50
1245,2,2378,929,1449,0,0,0,1.0,1,1.0,1,1.0,1,0.1006121846727285,51
1246,1,2379,930,1449,0,0,0,1.0,1,1.0,1,1.0,1,0.16337665708967214,52
1247,1,2380,930,1450,0,0,0,1.0,1,1.0,1,1.0,1,0.1470763384590847,52
1248,4,2384,933,1451,0,0,0,1.0,1,1.0,1,1.0,1,0.20417682117063207,51
1249,5,2389,935,1454,0,0,0,1.0,1,1.0,1,1.0,1,0.13500862205625513,51
1250,0,2389,935,1454,0,0,0,1.0,1,1.0,1,1.0,1,0.13500862205625513,51
1251,3,2392,935,1457,0,0,0,1.0,1,1.0,1,1.0,1,0.10722314998844236,53
1252,0,2392,935,1457,0,0,0,1.0,1,1.0,1,1.0,1,0.11105338268437907,52
1253,2,2394,935,1459,0,0,0,1.0,1,1.0,1,1.0,1,0.08067409879805326,52
1254,0,2394,935,1459,0,0,0,1.0,1,1.0,1,1.0,1,0.0844708823737065,53
1255,1,2395,936,1459,0,0,0,1.0,1,1.0,1,1.0,1,0.08531528908416516,55
1256,0,2395,936,1459,0,0,0,1.0,1,1.0,1,1.0,1,0.08531528908416516,55
1257,1,2396,936,1460,0,0,0,1.0,1,1.0,1,1.0,1,0.10596682727021739,57
1258,0,2396,936,1460,0,0,0,1.0,1,1.0,1,1.0,1,0.10608273776390395,57
1259,0,2396,936,1460,0,0,0,1.0,1,1.0,1,1.0,1,0.10608273776390395,57
1260,0,2396,936,1460,0,0,0,1.0,1,1.0,1,1.0,1,0.112213123756042,56
1261,1,2397,936,1461,0,0,0,1.0,1,1.0,1,1.0,1,0.11241341593597912,57
1262,3,2400,937,1463,0,0,0,1.0,1,1.0,1,1.0,1,0.10904215379065811,58
1263,6,2406,938,1468,0,0,0,1.0,1,1.0,1,1.0,1,0.0617100600191654,58
1264,1,2407,939,1468,0,0,0,1.0,1,1.0,1,1.0,1,0.08880080929755468,57
1265,9,2416,944,1472,0,0,0,1.0,1,1.0,1,1.0,1,0.08994462494251299,56
1266,2,2418,945,1473,0,0,0,1.0,1,1.0,1,1.0,1,0.12140763745561872,55
1267,4,2422,947,1475,0,0,0,1.0,1,1.0,1,1.0,1,0.13424940695691534,53
1268,3,2425,950,1475,0,0,0,1.0,1,1.0,1,1.0,1,0.22289558805912835,52
1269,10,2435,951,1484,0,0,0,1.0,1,1.0,1,1.0,1,0.10852299712035658,51
1270,2,2437,951,1486,0,0,0,1.0,1,1.0,1,1.0,1,0.1250458175575514,47
1271,5,2442,952,1490,0,0,0,1.0,1,1.0,1,1.0,1,0.08996019892581501,46
1272,1,2443,953,1490,0,0,0,1.0,1,1.0,1,1.0,1,0.07133173128909534,43
1273,0,2443,953,1490,0,0,0,1.0,1,1.0,1,1.0,1,0.05474312924255285,44
1274,2,2445,954,1491,0,0,0,1.0,1,1.0,1,1.0,1,0.11254421338181153,44
1275,4,2449,956,1493,0,0,0,1.0,1,1.0,1,1.0,1,0.08404752678056708,45
1276,1,2450,957,1493,0,0,0,1.0,1,1.0,1,1.0,1,0.07575460028402836,43
1277,2,2452,958,1494,0,0,0,1.0,1,1.0,1,1.0,1,0.08541122232400901,44
1278,3,2455,961,1494,0,0,0,1.0,1,1.0,1,1.0,1,0.12561061134697496,45
1279,2,2457,961,1496,0,0,0,1.0,1,1.0,1,1.0,1,0.08253491847330723,47
1280,0,2457,961,1496,0,0,0,1.0,1,1.0,1,1.0,1,0.08253491847330723,47
1281,1,2458,961,1497,0,0,0,1.0,1,1.0,1,1.0,1,0.0719988419309662,47
1282,1,2459,962,1497,0,0,0,1.0,1,1.0,1,1.0,1,0.09714209418762144,46
1283,2,2461,964,1497,0,0,0,1.0,1,1.0,1,1.0,1,0.1255719293046628,46
1284,1,2462,964,1498,0,0,0,1.0,1,1.0,1,1.0,1,0.11432109981971626,46
1285,2,2464,964,1500,0,0,0,1.0,1,1.0,1,1.0,1,0.10613496608248547,46
1286,0,2464,964,1500,0,0,0,1.0,1,1.0,1,1.0,1,0.09068541069399853,45
1287,1,2465,964,1501,0,0,0,1.0,1,1.0,1,1.0,1,0.11649049117342247,49
1288,0,2465,964,1501,0,0,0,1.0,1,1.0,1,1.0,1,0.11649049117342247,49
1289,1,2466,964,1502,0,0,0,1.0,1,1.0,1,1.0,1,0.11586276682683029,52
1290,0,2466,964,1502,0,0,0,1.0,1,1.0,1,1.0,1,0.11586276682683029,52
1291,3,2469,964,1505,0,0,0,1.0,1,1.0,1,1.0,1,0.06406109322108626,52
1292,3,2472,965,1507,0,0,0,1.0,1,1.0,1,1.0,1,0.0632027395950197,53
1293,0,2472,965,1507,0,0,0,1.0,1,1.0,1,1.0,1,0.0632027395950197,53
1294,0,2472,965,1507,0,0,0,1.0,1,1.0,1,1.0,1,0.0632027395950197,53
1295,1,2473,965,1508,0,0,0,1.0,1,1.0,1,1.0,1,0.047580321516059315,54
1296,1,2474,965,1509,0,0,0,1.0,1,1.0,1,1.0,1,0.028682748421378104,55
1297,0,2474,965,1509,0,0,0,1.0,1,1.0,1,1.0,1,0.045088088774228374,54
1298,0,2474,965,1509,0,0,0,1.0,1,1.0,1,1.0,1,0.05605842641228059,55
1299,0,2474,965,1509,0,0,0,1.0,1,1.0,1,1.0,1,0.0737449443477944,54
1300,1,2475,965,1510,0,0,0,1.0,1,1.0,1,1.0,1,0.08599794030158091,55
1301,5,2480,968,1512,0,0,0,1.0,1,1.0,1,1.0,1,0.10402700881868404,54
1302,1,2481,969,1512,0,0,0,1.0,1,1.0,1,1.0,1,0.1096587809402938,54
1303,4,2485,972,1513,0,0,0,1.0,1,1.0,1,1.0,1,0.18919359317664716,50
1304,7,2492,977,1515,0,0,0,1.0,1,1.0,1,1.0,1,0.13749278577366159,51
1305,3,2495,979,1516,0,0,0,1.0,1,1.0,1,1.0,1,0.16868092462139633,48
1306,8,2503,984,1519,0,0,0,1.0,1,1.0,1,1.0,1,0.2401226818544383,48
1307,6,2509,985,1524,0,0,0,1.0,1,1.0,1,1.0,1,0.15109965643558368,48
1308,1,2510,985,1525,0,0,0,1.0,1,1.0,1,1.0,1,0.1449846138944989,46
1309,3,2513,985,1528,0,0,0,1.0,1,1.0,1,1.0,1,0.0952017151147233,47
1310,0,2513,985,1528,0,0,0,1.0,1,1.0,1,1.0,1,0.09213541666771982,46
1311,3,2516,988,1528,0,0,0,1.0,1,1.0,1,1.0,1,0.1569510130194371,46
1312,1,2517,989,1528,0,0,0,1.0,1,1.0,1,1.0,1,0.17239135229023128,45
1313,6,2523,990,1533,0,0,0,1.0,1,1.0,1,1.0,1,0.18300999170013987,44
1314,2,2525,990,1535,0,0,0,1.0,1,1.0,1,1.0,1,0.17602276920528187,42
1315,2,2527,991,1536,0,0,0,1.0,1,1.0,1,1.0,1,0.19103554607312953,40
1316,2,2529,991,1538,0,0,0,1.0,1,1.0,1,1.0,1,0.1553860597787778,42
1317,3,2532,991,1541,0,0,0,1.0,1,1.0,1,1.0,1,0.15126643119828748,42
1318,0,2532,991,1541,0,0,0,1.0,1,1.0,1,1.0,1,0.15126643119828748,42
1319,1,2533,992,1541,0,0,0,1.0,1,1.0,1,1.0,1,0.19617143524651862,42
1320,2,2535,992,1543,0,0,0,1.0,1,1.0,1,1.0,1,0.1622406102320493,42
1321,3,2538,992,1546,0,0,0,1.0,1,1.0,1,1.0,1,0.09160243607600867,45
1322,4,2542,992,1550,0,0,0,1.0,1,1.0,1,1.0,1,0.08533001779087727,45
1323,2,2544,993,1551,0,0,0,1.0,1,1.0,1,1.0,1,0.08132668059484204,46
1324,0,2544,993,1551,0,0,0,1.0,1,1.0,1,1.0,1,0.09501488398637976,45
1325,1,2545,994,1551,0,0,0,1.0,1,1.0,1,1.0,1,0.12252521068970813,46
1326,0,2545,994,1551,0,0,0,1.0,1,1.0,1,1.0,1,0.1386753378621537,45
1327,1,2546,994,1552,0,0,0,1.0,1,1.0,1,1.0,1,0.15252163818793663,46
1328,0,2546,994,1552,0,0,0,1.0,1,1.0,1,1.0,1,0.1625410054648536,47
1329,1,2547,995,1552,0,0,0,1.0,1,1.0,1,1.0,1,0.16870363779147252,47
1330,1,2548,995,1553,0,0,0,1.0,1,1.0,1,1.0,1,0.17039169990835865,46
1331,2,2550,996,1554,0,0,0,1.0,1,1.0,1,1.0,1,0.15697870466996605,46
1332,3,2553,997,1556,0,0,0,1.0,1,1.0,1,1.0,1,0.1907793298465507,49
1333,3,2556,997,1559,0,0,0,1.0,1,1.0,1,1.0,1,0.13681481314132854,50
1334,0,2556,997,1559,0,0,0,1.0,1,1.0,1,1.0,1,0.13681481314132854,50
1335,1,2557,998,1559,0,0,0,1.0,1,1.0,1,1.0,1,0.17105090266428313,52
1336,1,2558,998,1560,0,0,0,1.0,1,1.0,1,1.0,1,0.1531738516839107,53
1337,6,2564,999,1565,0,0,0,1.0,1,1.0,1,1.0,1,0.1443274673875865,54
1338,5,2569,1001,1568,0,0,0,1.0,1,1.0,1,1.0,1,0.15538529818858485,54
1339,1,2570,1001,1569,0,0,0,1.0,1,1.0,1,1.0,1,0.15110580627050288,54
1340,0,2570,1001,1569,0,0,0,1.0,1,1.0,1,1.0,1,0.15021180513230367,53
1341,0,2570,1001,1569,0,0,0,1.0,1,1.0,1,1.0,1,0.1673537787110079,53
1342,1,2571,1002,1569,0,0,0,1.0,1,1.0,1,1.0,1,0.1950665989450444,52
1343,4,2575,1002,1573,0,0,0,1.0,1,1.0,1,1.0,1,0.14655674656608675,50
1344,3,2578,1004,1574,0,0,0,1.0,1,1.0,1,1.0,1,0.17305643251302186,51
1345,0,2578,1004,1574,0,0,0,1.0,1,1.0,1,1.0,1,0.1672111237885724,50
1346,8,2586,1008,1578,0,0,0,1.0,1,1.0,1,1.0,1,0.1586000956449018,50
1347,5,2591,1008,1583,0,0,0,1.0,1,1.0,1,1.0,1,0.10019052740831327,48
1348,1,2592,1008,1584,0,0,0,1.0,1,1.0,1,1.0,1,0.0749287129144806,49
1349,0,2592,1008,1584,0,0,0,1.0,1,1.0,1,1.0,1,0.07848561744696096,48
1350,1,2593,1009,1584,0,0,0,1.0,1,1.0,1,1.0,1,0.10655997134094401,49
1351,0,2593,1009,1584,0,0,0,1.0,1,1.0,1,1.0,1,0.08466255116288837,48
1352,1,2594,1010,1584,0,0,0,1.0,1,1.0,1,1.0,1,0.09382752634347641,49
1353,1,2595,1010,1585,0,0,0,1.0,1,1.0,1,1.0,1,0.06036828868770171,49
1354,0,2595,1010,1585,0,0,0,1.0,1,1.0,1,1.0,1,0.08036675501776697,49
1355,0,2595,1010,1585,0,0,0,1.0,1,1.0,1,1.0,1,0.0700411282075535,50
1356,2,2597,1011,1586,0,0,0,1.0,1,1.0,1,1.0,1,0.09109313823153808,50
1357,3,2600,1012,1588,0,0,0,1.0,1,1.0,1,1.0,1,0.09115526446646235,50
1358,4,2604,1013,1591,0,0,0,1.0,1,1.0,1,1.0,1,0.08569928590656282,51
1359,3,2607,1014,1593,0,0,0,1.0,1,1.0,1,1.0,1,0.11172367421750103,53
1360,3,2610,1014,1596,0,0,0,1.0,1,1.0,1,1.0,1,0.08097061986559646,54
1361,0,2610,1014,1596,0,0,0,1.0,1,1.0,1,1.0,1,0.08097061986559646,54
1362,1,2611,1015,1596,0,0,0,1.0,1,1.0,1,1.0,1,0.0703532630294342,55
1363,1,2612,1015,1597,0,0,0,1.0,1,1.0,1,1.0,1,0.054777919563934574,55
1364,1,2613,1015,1598,0,0,0,1.0,1,1.0,1,1.0,1,0.06856381635410014,55
1365,4,2617,1016,1601,0,0,0,1.0,1,1.0,1,1.0,1,0.08400602193886555,56
1366,1,2618,1017,1601,0,0,0,1.0,1,1.0,1,1.0,1,0.10232982453431007,56
1367,2,2620,1017,1603,0,0,0,1.0,1,1.0,1,1.0,1,0.08218194775244052,56
1368,2,2622,1018,1604,0,0,0,1.0,1,1.0,1,1.0,1,0.11120262405785249,58
1369,2,2624,1018,1606,0,0,0,1.0,1,1.0,1,1.0,1,0.09240645589787543,59
1370,2,2626,1019,1607,0,0,0,1.0,1,1.0,1,1.0,1,0.07082917685144098,59
1371,1,2627,1019,1608,0,0,0,1.0,1,1.0,1,1.0,1,0.06314930186154447,59
1372,2,2629,1020,1609,0,0,0,1.0,1,1.0,1,1.0,1,0.07806143743946273,59
1373,1,2630,1020,1610,0,0,0,1.0,1,1.0,1,1.0,1,0.06755780478871606,59
1374,7,2637,1024,1613,0,0,0,1.0,1,1.0,1,1.0,1,0.09543661779405375,60
1375,2,2639,1024,1615,0,0,0,1.0,1,1.0,1,1.0,1,0.08379853318540036,61
1376,2,2641,1024,1617,0,0,0,1.0,1,1.0,1,1.0,1,0.09586845397846853,61
1377,2,2643,1025,1618,0,0,0,1.0,1,1.0,1,1.0,1,0.10761343018465151,61
1378,3,2646,1028,1618,0,0,0,1.0,1,1.0,1,1.0,1,0.18380884154664484,61
1379,4,2650,1028,1622,0,0,0,1.0,1,1.0,1,1.0,1,0.13840027168805744,60
1380,2,2652,1029,1623,0,0,0,1.0,1,1.0,1,1.0,1,0.1517476217521918,60
1381,1,2653,1029,1624,0,0,0,1.0,1,1.0,1,1.0,1,0.1291064264041461,58
1382,2,2655,1030,1625,0,0,0,1.0,1,1.0,1,1.0,1,0.1536063084415318,58
1383,4,2659,1032,1627,0,0,0,1.0,1,1.0,1,1.0,1,0.11073410621827534,57
1384,2,2661,1034,1627,0,0,0,1.0,1,1.0,1,1.0,1,0.1104582724908069,54
1385,1,2662,1035,1627,0,0,0,1.0,1,1.0,1,1.0,1,0.09514292100997443,52
1386,3,2665,1037,1628,0,0,0,1.0,1,1.0,1,1.0,1,0.09531495038124674,51
1387,1,2666,1037,1629,0,0,0,1.0,1,1.0,1,1.0,1,0.09552849102218308,51
1388,1,2667,1038,1629,0,0,0,1.0,1,1.0,1,1.0,1,0.10678009125578855,52
1389,3,2670,1038,1632,0,0,0,1.0,1,1.0,1,1.0,1,0.11253623296552837,50
1390,2,2672,1039,1633,0,0,0,1.0,1,1.0,1,1.0,1,0.12138319652965321,51
1391,3,2675,1039,1636,0,0,0,1.0,1,1.0,1,1.0,1,0.09734592822756895,50
1392,1,2676,1040,1636,0,0,0,1.0,1,1.0,1,1.0,1,0.10597039305709348,50
1393,0,2676,1040,1636,0,0,0,1.0,1,1.0,1,1.0,1,0.11907512393527164,49
1394,2,2678,1041,1637,0,0,0,1.0,1,1.0,1,1.0,1,0.13473797491991713,50
1395,3,2681,1041,1640,0,0,0,1.0,1,1.0,1,1.0,1,0.09832945925956374,51
1396,1,2682,1042,1640,0,0,0,1.0,1,1.0,1,1.0,1,0.14844383587691273,52
1397,2,2684,1042,1642,0,0,0,1.0,1,1.0,1,1.0,1,0.13498124661016306,52
1398,0,2684,1042,1642,0,0,0,1.0,1,1.0,1,1.0,1,0.12416183746295621,53
1399,1,2685,1043,1642,0,0,0,1.0,1,1.0,1,1.0,1,0.14513149630799754,54
1400,2,2687,1044,1643,0,0,0,1.0,1,1.0,1,1.0,1,0.1545296898464017,54
1401,2,2689,1045,1644,0,0,0,1.0,1,1.0,1,1.0,1,0.15806080240238532,54
1402,4,2693,1047,1646,0,0,0,1.0,1,1.0,1,1.0,1,0.16413589714753618,53
1403,0,2693,1047,1646,0,0,0,1.0,1,1.0,1,1.0,1,0.18175659840235675,52
1404,1,2694,1047,1647,0,0,0,1.0,1,1.0,1,1.0,1,0.18497883736594428,53
1405,2,2696,1047,1649,0,0,0,1.0,1,1.0,1,1.0,1,0.18894740577482716,52
1406,0,2696,1047,1649,0,0,0,1.0,1,1.0,1,1.0,1,0.17494844138544074,53
1407,1,2697,1047,1650,0,0,0,1.0,1,1.0,1,1.0,1,0.177269493755523,54
1408,0,2697,1047,1650,0,0,0,1.0,1,1.0,1,1.0,1,0.1894452358444072,53
1409,0,2697,1047,1650,0,0,0,1.0,1,1.0,1,1.0,1,0.19293078220767737,55
1410,0,2697,1047,1650,0,0,0,1.0,1,1.0,1,1.0,1,0.19718486720381864,54
1411,2,2699,1047,1652,0,0,0,1.0,1,1.0,1,1.0,1,0.17316868188316414,54
1412,0,2699,1047,1652,0,0,0,1.0,1,1.0,1,1.0,1,0.1769455433162113,53
1413,2,2701,1047,1654,0,0,0,1.0,1,1.0,1,1.0,1,0.15667659143881088,54
1414,3,2704,1047,1657,0,0,0,1.0,1,1.0,1,1.0,1,0.14825527072481445,55
1415,1,2705,1047,1658,0,0,0,1.0,1,1.0,1,1.0,1,0.11593456906851785,57
1416,4,2709,1048,1661,0,0,0,1.0,1,1.0,1,1.0,1,0.13936191951297242,59
1417,4,2713,1052,1661,0,0,0,1.0,1,1.0,1,1.0,1,0.1888618485902653,58
1418,4,2717,1053,1664,0,0,0,1.0,1,1.0,1,1.0,1,0.17533511199594637,57
1419,3,2720,1054,1666,0,0,0,1.0,1,1.0,1,1.0,1,0.17166167473082997,56
1420,2,2722,1055,1667,0,0,0,1.0,1,1.0,1,1.0,1,0.22654113665592693,54
1421,7,2729,1055,1674,0,0,0,1.0,1,1.0,1,1.0,1,0.15455748444522158,55
1422,0,2729,1055,1674,0,0,0,1.0,1,1.0,1,1.0,1,0.17451121613258772,52
1423,10,2739,1057,1682,0,0,0,1.0,1,1.0,1,1.0,1,0.15969314908705567,52
1424,4,2743,1059,1684,0,0,0,1.0,1,1.0,1,1.0,1,0.1393242995064037,51
1425,5,2748,1059,1689,0,0,0,1.0,1,1.0,1,1.0,1,0.10615214160049491,50
1426,4,2752,1060,1692,0,0,0,1.0,1,1.0,1,1.0,1,0.10599030767081877,50
1427,2,2754,1060,1694,0,0,0,1.0,1,1.0,1,1.0,1,0.10846017262326763,48
1428,3,2757,1062,1695,0,0,0,1.0,1,1.0,1,1.0,1,0.11439184329734253,48
1429,1,2758,1062,1696,0,0,0,1.0,1,1.0,1,1.0,1,0.11311719380623904,48
1430,1,2759,1062,1697,0,0,0,1.0,1,1.0,1,1.0,1,0.09980875498451841,48
1431,0,2759,1062,1697,0,0,0,1.0,1,1.0,1,1.0,1,0.09980875498451841,48
1432,0,2759,1062,1697,0,0,0,1.0,1,1.0,1,1.0,1,0.07411311537828326,50
1433,1,2760,1062,1698,0,0,0,1.0,1,1.0,1,1.0,1,0.06797707425515388,51
1434,3,2763,1065,1698,0,0,0,1.0,1,1.0,1,1.0,1,0.10355104506563186,51
1435,2,2765,1067,1698,0,0,0,1.0,1,1.0,1,1.0,1,0.11693961361942394,50
1436,4,2769,1069,1700,0,0,0,1.0,1,1.0,1,1.0,1,0.11223201115669916,51
1437,1,2770,1069,1701,0,0,0,1.0,1,1.0,1,1.0,1,0.09485318916253553,51
1438,2,2772,1071,1701,0,0,0,1.0,1,1.0,1,1.0,1,0.11617535626298554,51
1439,3,2775,1073,1702,0,0,0,1.0,1,1.0,1,1.0,1,0.13920959434576488,50
1440,4,2779,1074,1705,0,0,0,1.0,1,1.0,1,1.0,1,0.1507842286243263,51
1441,2,2781,1074,1707,0,0,0,1.0,1,1.0,1,1.0,1,0.13325340332810873,51
1442,5,2786,1075,1711,0,0,0,1.0,1,1.0,1,1.0,1,0.11222969806848714,52
1443,1,2787,1075,1712,0,0,0,1.0,1,1.0,1,1.0,1,0.1262039118654659,53
1444,1,2788,1075,1713,0,0,0,1.0,1,1.0,1,1.0,1,0.11252507292165141,54
1445,3,2791,1076,1715,0,0,0,1.0,1,1.0,1,1.0,1,0.0941804710823711,54
1446,1,2792,1076,1716,0,0,0,1.0,1,1.0,1,1.0,1,0.11200844034390961,54
1447,0,2792,1076,1716,0,0,0,1.0,1,1.0,1,1.0,1,0.10046612245322656,55
1448,1,2793,1076,1717,0,0,0,1.0,1,1.0,1,1.0,1,0.08851793010388245,55
1449,0,2793,1076,1717,0,0,0,1.0,1,1.0,1,1.0,1,0.08851793010388245,55
1450,2,2795,1076,1719,0,0,0,1.0,1,1.0,1,1.0,1,0.08450439241282624,57
1451,0,2795,1076,1719,0,0,0,1.0,1,1.0,1,1.0,1,0.08450439241282624,57
1452,0,2795,1076,1719,0,0,0,1.0,1,1.0,1,1.0,1,0.08450439241282624,57
1453,3,2798,1077,1721,0,0,0,1.0,1,1.0,1,1.0,1,0.10280203789640635,57
1454,2,2800,1078,1722,0,0,0,1.0,1,1.0,1,1.0,1,0.13146207965411782,58
1455,0,2800,1078,1722,0,0,0,1.0,1,1.0,1,1.0,1,0.1323301383322464,56
1456,2,2802,1079,1723,0,0,0,1.0,1,1.0,1,1.0,1,0.13904162761033045,55
1457,3,2805,1079,1726,0,0,0,1.0,1,1.0,1,1.0,1,0.10986971886986543,54
1458,1,2806,1080,1726,0,0,0,1.0,1,1.0,1,1.0,1,0.12236227452716882,53
1459,2,2808,1080,1728,0,0,0,1.0,1,1.0,1,1.0,1,0.11321250269058371,52
1460,0,2808,1080,1728,0,0,0,1.0,1,1.0,1,1.0,1,0.10552505856747914,51
1461,2,2810,1082,1728,0,0,0,1.0,1,1.0,1,1.0,1,0.12857452405206649,51
1462,4,2814,1085,1729,0,0,0,1.0,1,1.0,1,1.0,1,0.10040622868913912,51
1463,6,2820,1089,1731,0,0,0,1.0,1,1.0,1,1.0,1,0.16162864135442268,52
1464,5,2825,1092,1733,0,0,0,1.0,1,1.0,1,1.0,1,0.16278745847470344,52
1465,3,2828,1094,1734,0,0,0,1.0,1,1.0,1,1.0,1,0.18254503625585844,51
1466,5,2833,1098,1735,0,0,0,1.0,1,1.0,1,1.0,1,0.21039738126434912,50
1467,6,2839,1100,1739,0,0,0,1.0,1,1.0,1,1.0,1,0.18275473361641648,48
1468,3,2842,1101,1741,0,0,0,1.0,1,1.0,1,1.0,1,0.13097860000780384,48
1469,11,2853,1104,1749,0,0,0,1.0,1,1.0,1,1.0,1,0.11396532123792537,48
1470,1,2854,1104,1750,0,0,0,1.0,1,1.0,1,1.0,1,0.12559307360669256,48
1471,2,2856,1106,1750,0,0,0,1.0,1,1.0,1,1.0,1,0.1545445930729714,45
1472,2,2858,1106,1752,0,0,0,1.0,1,1.0,1,1.0,1,0.1402218514713831,45
1473,2,2860,1106,1754,0,0,0,1.0,1,1.0,1,1.0,1,0.11482218946001996,46
1474,3,2863,1106,1757,0,0,0,1.0,1,1.0,1,1.0,1,0.10877955367973709,46
1475,2,2865,1107,1758,0,0,0,1.0,1,1.0,1,1.0,1,0.07419513762384493,46
1476,0,2865,1107,1758,0,0,0,1.0,1,1.0,1,1.0,1,0.08380957581927369,47
1477,2,2867,1108,1759,0,0,0,1.0,1,1.0,1,1.0,1,0.08275022007083883,47
1478,3,2870,1109,1761,0,0,0,1.0,1,1.0,1,1.0,1,0.09328921114887209,47
1479,0,2870,1109,1761,0,0,0,1.0,1,1.0,1,1.0,1,0.1017058837448818,48
1480,2,2872,1110,1762,0,0,0,1.0,1,1.0,1,1.0,1,0.09316653848224073,47
1481,2,2874,1111,1763,0,0,0,1.0,1,1.0,1,1.0,1,0.10138052575705904,47
1482,1,2875,1112,1763,0,0,0,1.0,1,1.0,1,1.0,1,0.11196924016299338,46
1483,1,2876,1113,1763,0,0,0,1.0,1,1.0,1,1.0,1,0.12468033734781446,47
1484,3,2879,1113,1766,0,0,0,1.0,1,1.0,1,1.0,1,0.11131314898317445,47
1485,1,2880,1113,1767,0,0,0,1.0,1,1.0,1,1.0,1,0.13823211342272546,47
1486,3,2883,1113,1770,0,0,0,1.0,1,1.0,1,1.0,1,0.12031116458839526,49
1487,1,2884,1113,1771,0,0,0,1.0,1,1.0,1,1.0,1,0.10910488698666654,49
1488,1,2885,1114,1771,0,0,0,1.0,1,1.0,1,1.0,1,0.11534002811579866,51
1489,3,2888,1115,1773,0,0,0,1.0,1,1.0,1,1.0,1,0.13029643766875867,52
1490,1,2889,1116,1773,0,0,0,1.0,1,1.0,1,1.0,1,0.1130595031974619,52
1491,3,2892,1119,1773,0,0,0,1.0,1,1.0,1,1.0,1,0.1517064251476659,53
1492,7,2899,1123,1776,0,0,0,1.0,1,1.0,1,1.0,1,0.1715112570196757,53
1493,3,2902,1124,1778,0,0,0,1.0,1,1.0,1,1.0,1,0.1333282265993001,52
1494,2,2904,1125,1779,0,0,0,1.0,1,1.0,1,1.0,1,0.10873102073654228,50
1495,4,2908,1127,1781,0,0,0,1.0,1,1.0,1,1.0,1,0.10241237809741044,50
1496,1,2909,1127,1782,0,0,0,1.0,1,1.0,1,1.0,1,0.10551351829455756,52
1497,4,2913,1129,1784,0,0,0,1.0,1,1.0,1,1.0,1,0.13305631810735177,51
1498,1,2914,1130,1784,0,0,0,1.0,1,1.0,1,1.0,1,0.13971688137039753,50
1499,2,2916,1131,1785,0,0,0,1.0,1,1.0,1,1.0,1,0.12017709905968958,50
1500,1,2917,1132,1785,0,0,0,1.0,1,1.0,1,1.0,1,0.1278023756597384,49
1501,3,2920,1133,1787,0,0,0,1.0,1,1.0,1,1.0,1,0.10024560156213694,47
1502,3,2923,1136,1787,0,0,0,1.0,1,1.0,1,1.0,1,0.13739452926354304,47
1503,3,2926,1136,1790,0,0,0,1.0,1,1.0,1,1.0,1,0.09954319842171698,47
1504,1,2927,1137,1790,0,0,0,1.0,1,1.0,1,1.0,1,0.11561851740790935,48
1505,4,2931,1139,1792,0,0,0,1.0,1,1.0,1,1.0,1,0.08178953428481137,47
1506,2,2933,1141,1792,0,0,0,1.0,1,1.0,1,1.0,1,0.1126083427776934,47
1507,3,2936,1143,1793,0,0,0,1.0,1,1.0,1,1.0,1,0.13904389884452328,45
1508,2,2938,1143,1795,0,0,0,1.0,1,1.0,1,1.0,1,0.11754027544563966,45
1509,3,2941,1145,1796,0,0,0,1.0,1,1.0,1,1.0,1,0.1502159285699307,44
1510,4,2945,1147,1798,0,0,0,1.0,1,1.0,1,1.0,1,0.18164098508971388,42
1511,0,2945,1147,1798,0,0,0,1.0,1,1.0,1,1.0,1,0.1650838508373558,40
1512,3,2948,1150,1798,0,0,0,1.0,1,1.0,1,1.0,1,0.2600698842294678,39
1513,5,2953,1150,1803,0,0,0,1.0,1,1.0,1,1.0,1,0.16739925509274906,39
1514,0,2953,1150,1803,0,0,0,1.0,1,1.0,1,1.0,1,0.18398253219638827,38
1515,3,2956,1151,1805,0,0,0,1.0,1,1.0,1,1.0,1,0.18344398693525307,39
1516,1,2957,1151,1806,0,0,0,1.0,1,1.0,1,1.0,1,0.16389388118192086,39
1517,6,2963,1153,1810,0,0,0,1.0,1,1.0,1,1.0,1,0.13094385621543386,39
1518,2,2965,1154,1811,0,0,0,1.0,1,1.0,1,1.0,1,0.14674953752205994,39
1519,2,2967,1154,1813,0,0,0,1.0,1,1.0,1,1.0,1,0.09634363296359329,39
1520,3,2970,1157,1813,0,0,0,1.0,1,1.0,1,1.0,1,0.17827980306166086,39
1521,3,2973,1158,1815,0,0,0,1.0,1,1.0,1,1.0,1,0.18075769290506813,40
1522,1,2974,1159,1815,0,0,0,1.0,1,1.0,1,1.0,1,0.2071388536363978,40
1523,4,2978,1159,1819,0,0,0,1.0,1,1.0,1,1.0,1,0.1166074135826738,41
1524,0,2978,1159,1819,0,0,0,1.0,1,1.0,1,1.0,1,0.12525301278319895,42
1525,0,2978,1159,1819,0,0,0,1.0,1,1.0,1,1.0,1,0.1354776344777135,45
1526,0,2978,1159,1819,0,0,0,1.0,1,1.0,1,1.0,1,0.1391424149202231,46
1527,1,2979,1159,1820,0,0,0,1.0,1,1.0,1,1.0,1,0.1097239655286906,46
1528,1,2980,1159,1821,0,0,0,1.0,1,1.0,1,1.0,1,0.10547088712942088,47
1529,0,2980,1159,1821,0,0,0,1.0,1,1.0,1,1.0,1,0.10547088712942088,47
1530,0,2980,1159,1821,0,0,0,1.0,1,1.0,1,1.0,1,0.12074992299946928,48
1531,1,2981,1159,1822,0,0,0,1.0,1,1.0,1,1.0,1,0.1120090566665524,46
1532,3,2984,1161,1823,0,0,0,1.0,1,1.0,1,1.0,1,0.10362539531672625,47
1533,0,2984,1161,1823,0,0,0,1.0,1,1.0,1,1.0,1,0.0980846651218936,46
1534,1,2985,1162,1823,0,0,0,1.0,1,1.0,1,1.0,1,0.1077473349554688,47
1535,1,2986,1163,1823,0,0,0,1.0,1,1.0,1,1.0,1,0.1077224069842049,47
1536,0,2986,1163,1823,0,0,0,1.0,1,1.0,1,1.0,1,0.12206698501865089,48
1537,1,2987,1163,1824,0,0,0,1.0,1,1.0,1,1.0,1,0.10075731819311631,46
1538,3,2990,1163,1827,0,0,0,1.0,1,1.0,1,1.0,1,0.10866016768694618,47
1539,2,2992,1163,1829,0,0,0,1.0,1,1.0,1,1.0,1,0.09455318706293,47
1540,2,2994,1164,1830,0,0,0,1.0,1,1.0,1,1.0,1,0.09554291589335587,47
1541,1,2995,1164,1831,0,0,0,1.0,1,1.0,1,1.0,1,0.08387875664658896,47
1542,3,2998,1166,1832,0,0,0,1.0,1,1.0,1,1.0,1,0.14274686148640067,50
1543,3,3001,1167,1834,0,0,0,1.0,1,1.0,1,1.0,1,0.10703763323223392,47
1544,4,3005,1171,1834,0,0,0,1.0,1,1.0,1,1.0,1,0.19409583816922232,48
1545,6,3011,1173,1838,0,0,0,1.0,1,1.0,1,1.0,1,0.09144154964663444,47
1546,3,3014,1175,1839,0,0,0,1.0,1,1.0,1,1.0,1,0.10048458977315787,47
1547,2,3016,1176,1840,0,0,0,1.0,1,1.0,1,1.0,1,0.10535370446677948,47
1548,4,3020,1180,1840,0,0,0,1.0,1,1.0,1,1.0,1,0.13912462754196556,47
1549,4,3024,1183,1841,0,0,0,1.0,1,1.0,1,1.0,1,0.11272280288595503,46
1550,4,3028,1185,1843,0,0,0,1.0,1,1.0,1,1.0,1,0.12548680266782025,44
1551,6,3034,1187,1847,0,0,0,1.0,1,1.0,1,1.0,1,0.07099360987044726,45
1552,5,3039,1189,1850,0,0,0,1.0,1,1.0,1,1.0,1,0.07100387096335599,43
1553,3,3042,1192,1850,0,0,0,1.0,1,1.0,1,1.0,1,0.11803305386860186,43
1554,0,3042,1192,1850,0,0,0,1.0,1,1.0,1,1.0,1,0.11264845945557823,41
1555,3,3045,1192,1853,0,0,0,1.0,1,1.0,1,1.0,1,0.08227183301043522,44
1556,2,3047,1193,1854,0,0,0,1.0,1,1.0,1,1.0,1,0.096910094198872,45
1557,1,3048,1194,1854,0,0,0,1.0,1,1.0,1,1.0,1,0.1337169551391391,45
1558,1,3049,1194,1855,0,0,0,1.0,1,1.0,1,1.0,1,0.10941783284689091,46
1559,6,3055,1196,1859,0,0,0,1.0,1,1.0,1,1.0,1,0.09436420898371929,47
1560,1,3056,1196,1860,0,0,0,1.0,1,1.0,1,1.0,1,0.08355521754797782,46
1561,0,3056,1196,1860,0,0,0,1.0,1,1.0,1,1.0,1,0.08142603400458694,47
1562,0,3056,1196,1860,0,0,0,1.0,1,1.0,1,1.0,1,0.10211347972357915,47
1563,0,3056,1196,1860,0,0,0,1.0,1,1.0,1,1.0,1,0.10211347972357915,47
1564,0,3056,1196,1860,0,0,0,1.0,1,1.0,1,1.0,1,0.10211347972357915,47
1565,1,3057,1196,1861,0,0,0,1.0,1,1.0,1,1.0,1,0.11356758513870178,48
1566,2,3059,1197,1862,0,0,0,1.0,1,1.0,1,1.0,1,0.10737592499977376,48
1567,4,3063,1197,1866,0,0,0,1.0,1,1.0,1,1.0,1,0.048534208917919444,48
1568,2,3065,1198,1867,0,0,0,1.0,1,1.0,1,1.0,1,0.08590893319901838,48
1569,0,3065,1198,1867,0,0,0,1.0,1,1.0,1,1.0,1,0.08236945081108034,45
1570,0,3065,1198,1867,0,0,0,1.0,1,1.0,1,1.0,1,0.09462102131405627,44
1571,5,3070,1202,1868,0,0,0,1.0,1,1.0,1,1.0,1,0.15877012532415702,42
1572,3,3073,1203,1870,0,0,0,1.0,1,1.0,1,1.0,1,0.2079971754036371,43
1573,5,3078,1203,1875,0,0,0,1.0,1,1.0,1,1.0,1,0.11063436946625417,43
1574,3,3081,1205,1876,0,0,0,1.0,1,1.0,1,1.0,1,0.1144660560994551,42
1575,2,3083,1207,1876,0,0,0,1.0,1,1.0,1,1.0,1,0.17781997805366956,43
1576,2,3085,1209,1876,0,0,0,1.0,1,1.0,1,1.0,1,0.15128495626611632,41
1577,4,3089,1210,1879,0,0,0,1.0,1,1.0,1,1.0,1,0.10950923478161512,40
1578,0,3089,1210,1879,0,0,0,1.0,1,1.0,1,1.0,1,0.11385971940534688,40
1579,0,3089,1210,1879,0,0,0,1.0,1,1.0,1,1.0,1,0.11463972347439273,40
1580,0,3089,1210,1879,0,0,0,1.0,1,1.0,1,1.0,1,0.11463972347439273,40
1581,1,3090,1211,1879,0,0,0,1.0,1,1.0,1,1.0,1,0.12754476447622837,40
1582,5,3095,1214,1881,0,0,0,1.0,1,1.0,1,1.0,1,0.18569071948143118,40
1583,5,3100,1214,1886,0,0,0,1.0,1,1.0,1,1.0,1,0.14337373388966315,38
1584,4,3104,1217,1887,0,0,0,1.0,1,1.0,1,1.0,1,0.2181261309604795,39
1585,6,3110,1218,1892,0,0,0,1.0,1,1.0,1,1.0,1,0.10518108291131614,38
1586,1,3111,1219,1892,0,0,0,1.0,1,1.0,1,1.0,1,0.11637047935470442,38
1587,3,3114,1220,1894,0,0,0,1.0,1,1.0,1,1.0,1,0.09534847842064366,37
1588,6,3120,1223,1897,0,0,0,1.0,1,1.0,1,1.0,1,0.11063065727502534,39
1589,2,3122,1225,1897,0,0,0,1.0,1,1.0,1,1.0,1,0.10134341314143987,37
1590,1,3123,1226,1897,0,0,0,1.0,1,1.0,1,1.0,1,0.15107394852243505,37
1591,5,3128,1228,1900,0,0,0,1.0,1,1.0,1,1.0,1,0.16734369556686057,36
1592,2,3130,1228,1902,0,0,0,1.0,1,1.0,1,1.0,1,0.20857154787187318,34
1593,1,3131,1229,1902,0,0,0,1.0,1,1.0,1,1.0,1,0.22390914639279447,33
1594,0,3131,1229,1902,0,0,0,1.0,1,1.0,1,1.0,1,0.28402071664576295,31
1595,6,3137,1230,1907,0,0,0,1.0,1,1.0,1,1.0,1,0.17109097639809562,34
1596,2,3139,1230,1909,0,0,0,1.0,1,1.0,1,1.0,1,0.1496205857793129,33
1597,1,3140,1231,1909,0,0,0,1.0,1,1.0,1,1.0,1,0.18263977325284922,33
1598,0,3140,1231,1909,0,0,0,1.0,1,1.0,1,1.0,1,0.1712346300159923,33
1599,0,3140,1231,1909,0,0,0,1.0,1,1.0,1,1.0,1,0.1712346300159923,33
1600,2,3142,1232,1910,0,0,0,1.0,1,1.0,1,1.0,1,0.1653276312234364,34
1601,2,3144,1233,1911,0,0,0,1.0,1,1.0,1,1.0,1,0.17968244212462084,35
1602,3,3147,1234,1913,0,0,0,1.0,1,1.0,1,1.0,1,0.1267783143710466,36
1603,2,3149,1234,1915,0,0,0,1.0,1,1.0,1,1.0,1,0.11136380251784377,38
1604,0,3149,1234,1915,0,0,0,1.0,1,1.0,1,1.0,1,0.11136380251784377,38
1605,1,3150,1235,1915,0,0,0,1.0,1,1.0,1,1.0,1,0.1303843140466221,38
1606,6,3156,1238,1918,0,0,0,1.0,1,1.0,1,1.0,1,0.1385961295726151,39
1607,0,3156,1238,1918,0,0,0,1.0,1,1.0,1,1.0,1,0.12761212234798167,37
1608,0,3156,1238,1918,0,0,0,1.0,1,1.0,1,1.0,1,0.14859041552764665,36
1609,0,3156,1238,1918,0,0,0,1.0,1,1.0,1,1.0,1,0.1254909108037287,34
1610,0,3156,1238,1918,0,0,0,1.0,1,1.0,1,1.0,1,0.12926142107940516,34
1611,3,3159,1239,1920,0,0,0,1.0,1,1.0,1,1.0,1,0.15998302048883048,35
1612,1,3160,1239,1921,0,0,0,1.0,1,1.0,1,1.0,1,0.14410418232603958,33
1613,2,3162,1240,1922,0,0,0,1.0,1,1.0,1,1.0,1,0.18222849983434053,34
1614,0,3162,1240,1922,0,0,0,1.0,1,1.0,1,1.0,1,0.17454625837414897,35
1615,2,3164,1240,1924,0,0,0,1.0,1,1.0,1,1.0,1,0.1324833892598916,35
1616,2,3166,1241,1925,0,0,0,1.0,1,1.0,1,1.0,1,0.1391360501370803,37
1617,3,3169,1243,1926,0,0,0,1.0,1,1.0,1,1.0,1,0.1382304988518685,38
1618,1,3170,1243,1927,0,0,0,1.0,1,1.0,1,1.0,1,0.12576638455316094,38
1619,2,3172,1244,1928,0,0,0,1.0,1,1.0,1,1.0,1,0.12731691721451413,38
1620,2,3174,1245,1929,0,0,0,1.0,1,1.0,1,1.0,1,0.14808471103367937,39
1621,1,3175,1245,1930,0,0,0,1.0,1,1.0,1,1.0,1,0.14299539995812752,37
1622,3,3178,1246,1932,0,0,0,1.0,1,1.0,1,1.0,1,0.15819862846650468,37
1623,2,3180,1248,1932,0,0,0,1.0,1,1.0,1,1.0,1,0.19810775861383373,37
1624,2,3182,1249,1933,0,0,0,1.0,1,1.0,1,1.0,1,0.18837960350387445,37
1625,2,3184,1249,1935,0,0,0,1.0,1,1.0,1,1.0,1,0.15260053269728105,35
1626,2,3186,1250,1936,0,0,0,1.0,1,1.0,1,1.0,1,0.17919812556548229,35
1627,2,3188,1251,1937,0,0,0,1.0,1,1.0,1,1.0,1,0.163512002311433,34
1628,3,3191,1252,1939,0,0,0,1.0,1,1.0,1,1.0,1,0.16885761810589023,35
1629,2,3193,1254,1939,0,0,0,1.0,1,1.0,1,1.0,1,0.17318871340033806,34
1630,1,3194,1254,1940,0,0,0,1.0,1,1.0,1,1.0,1,0.0931397441455423,32
1631,0,3194,1254,1940,0,0,0,1.0,1,1.0,1,1.0,1,0.1117463483505608,33
1632,1,3195,1255,1940,0,0,0,1.0,1,1.0,1,1.0,1,0.17676577094855161,32
1633,0,3195,1255,1940,0,0,0,1.0,1,1.0,1,1.0,1,0.1600526253701787,31
1634,1,3196,1256,1940,0,0,0,1.0,1,1.0,1,1.0,1,0.22100512078805712,31
1635,0,3196,1256,1940,0,0,0,1.0,1,1.0,1,1.0,1,0.2188504936109198,31
1636,2,3198,1256,1942,0,0,0,1.0,1,1.0,1,1.0,1,0.2003526714108703,33
1637,0,3198,1256,1942,0,0,0,1.0,1,1.0,1,1.0,1,0.2003526714108703,33
1638,1,3199,1256,1943,0,0,0,1.0,1,1.0,1,1.0,1,0.1977950372833478,36
1639,2,3201,1256,1945,0,0,0,1.0,1,1.0,1,1.0,1,0.1608021472982748,36
1640,1,3202,1257,1945,0,0,0,1.0,1,1.0,1,1.0,1,0.18427674869898558,36
1641,0,3202,1257,1945,0,0,0,1.0,1,1.0,1,1.0,1,0.1909049178663902,38
1642,1,3203,1258,1945,0,0,0,1.0,1,1.0,1,1.0,1,0.23752932179055944,37
1643,2,3205,1259,1946,0,0,0,1.0,1,1.0,1,1.0,1,0.20144146251988918,37
1644,2,3207,1261,1946,0,0,0,1.0,1,1.0,1,1.0,1,0.28429709910155465,38
1645,4,3211,1261,1950,0,0,0,1.0,1,1.0,1,1.0,1,0.21032384665275447,36
1646,2,3213,1262,1951,0,0,0,1.0,1,1.0,1,1.0,1,0.21914126819705582,37
1647,6,3219,1264,1955,0,0,0,1.0,1,1.0,1,1.0,1,0.15343851354189683,35
1648,1,3220,1264,1956,0,0,0,1.0,1,1.0,1,1.0,1,0.16835222261112218,38
1649,2,3222,1265,1957,0,0,0,1.0,1,1.0,1,1.0,1,0.14968595043069804,35
1650,0,3222,1265,1957,0,0,0,1.0,1,1.0,1,1.0,1,0.16231543777949117,34
1651,0,3222,1265,1957,0,0,0,1.0,1,1.0,1,1.0,1,0.17938045608212463,32
1652,1,3223,1265,1958,0,0,0,1.0,1,1.0,1,1.0,1,0.18311791206554914,33
1653,0,3223,1265,1958,0,0,0,1.0,1,1.0,1,1.0,1,0.18311791206554914,33
1654,1,3224,1265,1959,0,0,0,1.0,1,1.0,1,1.0,1,0.1738548360378433,34
1655,2,3226,1265,1961,0,0,0,1.0,1,1.0,1,1.0,1,0.15614601540188136,35
1656,1,3227,1265,1962,0,0,0,1.0,1,1.0,1,1.0,1,0.12909480662245654,35
1657,0,3227,1265,1962,0,0,0,1.0,1,1.0,1,1.0,1,0.140811914625633,36
1658,1,3228,1266,1962,0,0,0,1.0,1,1.0,1,1.0,1,0.1146864063040909,36
1659,0,3228,1266,1962,0,0,0,1.0,1,1.0,1,1.0,1,0.1146864063040909,36
1660,5,3233,1269,1964,0,0,0,1.0,1,1.0,1,1.0,1,0.11429201896999143,38
1661,1,3234,1269,1965,0,0,0,1.0,1,1.0,1,1.0,1,0.09473703897532594,38
1662,4,3238,1272,1966,0,0,0,1.0,1,1.0,1,1.0,1,0.0963818233832963,39
1663,2,3240,1273,1967,0,0,0,1.0,1,1.0,1,1.0,1,0.13340685636154528,40
1664,1,3241,1274,1967,0,0,0,1.0,1,1.0,1,1.0,1,0.17001113021646252,39
1665,5,3246,1275,1971,0,0,0,1.0,1,1.0,1,1.0,1,0.13114084868721426,40
1666,2,3248,1277,1971,0,0,0,1.0,1,1.0,1,1.0,1,0.18327333754228728,40
1667,5,3253,1281,1972,0,0,0,1.0,1,1.0,1,1.0,1,0.15968026181556164,40
1668,2,3255,1282,1973,0,0,0,1.0,1,1.0,1,1.0,1,0.11479871570301875,41
1669,1,3256,1282,1974,0,0,0,1.0,1,1.0,1,1.0,1,0.06772988199003924,40
1670,0,3256,1282,1974,0,0,0,1.0,1,1.0,1,1.0,1,0.06772988199003924,40
1671,1,3257,1283,1974,0,0,0,1.0,1,1.0,1,1.0,1,0.11456655771278004,41
1672,1,3258,1284,1974,0,0,0,1.0,1,1.0,1,1.0,1,0.15232726802468075,40
1673,3,3261,1286,1975,0,0,0,1.0,1,1.0,1,1.0,1,0.1722399581348239,39
1674,2,3263,1286,1977,0,0,0,1.0,1,1.0,1,1.0,1,0.13721745123438653,40
1675,2,3265,1286,1979,0,0,0,1.0,1,1.0,1,1.0,1,0.12017464987628033,38
1676,1,3266,1287,1979,0,0,0,1.0,1,1.0,1,1.0,1,0.1206313647799389,39
1677,1,3267,1287,1980,0,0,0,1.0,1,1.0,1,1.0,1,0.08095700537645457,39
1678,0,3267,1287,1980,0,0,0,1.0,1,1.0,1,1.0,1,0.08095700537645457,39
1679,1,3268,1288,1980,0,0,0,1.0,1,1.0,1,1.0,1,0.0788877241163482,39
1680,3,3271,1290,1981,0,0,0,1.0,1,1.0,1,1.0,1,0.11152200655227391,41
1681,2,3273,1291,1982,0,0,0,1.0,1,1.0,1,1.0,1,0.10937610306613085,41
1682,2,3275,1291,1984,0,0,0,1.0,1,1.0,1,1.0,1,0.08544304787210395,43
1683,3,3278,1294,1984,0,0,0,1.0,1,1.0,1,1.0,1,0.1300854825914126,43
1684,2,3280,1295,1985,0,0,0,1.0,1,1.0,1,1.0,1,0.13940844300570102,42
1685,2,3282,1296,1986,0,0,0,1.0,1,1.0,1,1.0,1,0.15768859866828727,41
1686,5,3287,1297,1990,0,0,0,1.0,1,1.0,1,1.0,1,0.14771279529136375,41
1687,2,3289,1297,1992,0,0,0,1.0,1,1.0,1,1.0,1,0.09967789960446712,40
1688,3,3292,1300,1992,0,0,0,1.0,1,1.0,1,1.0,1,0.14931020960266014,39
1689,4,3296,1301,1995,0,0,0,1.0,1,1.0,1,1.0,1,0.1503222012401359,38
1690,0,3296,1301,1995,0,0,0,1.0,1,1.0,1,1.0,1,0.14240145257696704,38
1691,0,3296,1301,1995,0,0,0,1.0,1,1.0,1,1.0,1,0.1404400061057443,36
1692,1,3297,1302,1995,0,0,0,1.0,1,1.0,1,1.0,1,0.1775589160789388,36
1693,1,3298,1303,1995,0,0,0,1.0,1,1.0,1,1.0,1,0.1875205842897421,35
1694,0,3298,1303,1995,0,0,0,1.0,1,1.0,1,1.0,1,0.17069205279075778,33
1695,0,3298,1303,1995,0,0,0,1.0,1,1.0,1,1.0,1,0.18142659217162896,34
1696,2,3300,1304,1996,0,0,0,1.0,1,1.0,1,1.0,1,0.17365252862193206,35
1697,3,3303,1305,1998,0,0,0,1.0,1,1.0,1,1.0,1,0.1635946843569188,36
1698,2,3305,1307,1998,0,0,0,1.0,1,1.0,1,1.0,1,0.1948793501907088,38
1699,2,3307,1308,1999,0,0,0,1.0,1,1.0,1,1.0,1,0.21124105031851498,38
1700,2,3309,1308,2001,0,0,0,1.0,1,1.0,1,1.0,1,0.18177606512841019,39
1701,3,3312,1309,2003,0,0,0,1.0,1,1.0,1,1.0,1,0.1749714733672569,40
1702,5,3317,1312,2005,0,0,0,1.0,1,1.0,1,1.0,1,0.1852965887117965,41
1703,3,3320,1313,2007,0,0,0,1.0,1,1.0,1,1.0,1,0.17681879959205038,41
1704,4,3324,1316,2008,0,0,0,1.0,1,1.0,1,1.0,1,0.1895638339767337,41
1705,2,3326,1317,2009,0,0,0,1.0,1,1.0,1,1.0,1,0.1453167763633584,40
1706,1,3327,1317,2010,0,0,0,1.0,1,1.0,1,1.0,1,0.13443410269530873,40
1707,4,3331,1317,2014,0,0,0,1.0,1,1.0,1,1.0,1,0.07064790840938981,39
1708,1,3332,1318,2014,0,0,0,1.0,1,1.0,1,1.0,1,0.09768246280870822,39
1709,0,3332,1318,2014,0,0,0,1.0,1,1.0,1,1.0,1,0.08706097599792313,38
1710,4,3336,1320,2016,0,0,0,1.0,1,1.0,1,1.0,1,0.1511290713765496,39
1711,4,3340,1321,2019,0,0,0,1.0,1,1.0,1,1.0,1,0.14077119747234182,38
1712,3,3343,1323,2020,0,0,0,1.0,1,1.0,1,1.0,1,0.15720856871955677,38
1713,1,3344,1323,2021,0,0,0,1.0,1,1.0,1,1.0,1,0.14615380576145773,37
1714,2,3346,1324,2022,0,0,0,1.0,1,1.0,1,1.0,1,0.15388555681622942,38
1715,2,3348,1325,2023,0,0,0,1.0,1,1.0,1,1.0,1,0.14362761298132942,40
1716,0,3348,1325,2023,0,0,0,1.0,1,1.0,1,1.0,1,0.1494536162939962,39
1717,0,3348,1325,2023,0,0,0,1.0,1,1.0,1,1.0,1,0.14625158576963868,38
1718,0,3348,1325,2023,0,0,0,1.0,1,1.0,1,1.0,1,0.1765620511336952,38
1719,0,3348,1325,2023,0,0,0,1.0,1,1.0,1,1.0,1,0.1765620511336952,38
1720,0,3348,1325,2023,0,0,0,1.0,1,1.0,1,1.0,1,0.18201643691465735,41
1721,1,3349,1326,2023,0,0,0,1.0,1,1.0,1,1.0,1,0.16054498758806338,39
1722,4,3353,1328,2025,0,0,0,1.0,1,1.0,1,1.0,1,0.15350479079946783,40
1723,1,3354,1329,2025,0,0,0,1.0,1,1.0,1,1.0,1,0.1508373017896496,38
1724,0,3354,1329,2025,0,0,0,1.0,1,1.0,1,1.0,1,0.1477962608423577,37
1725,1,3355,1329,2026,0,0,0,1.0,1,1.0,1,1.0,1,0.14351315193813105,38
1726,2,3357,1330,2027,0,0,0,1.0,1,1.0,1,1.0,1,0.10619553257022611,37
1727,0,3357,1330,2027,0,0,0,1.0,1,1.0,1,1.0,1,0.10619553257022611,37
1728,0,3357,1330,2027,0,0,0,1.0,1,1.0,1,1.0,1,0.10459640686792725,35
1729,0,3357,1330,2027,0,0,0,1.0,1,1.0,1,1.0,1,0.1346538812439737,37
1730,1,3358,1331,2027,0,0,0,1.0,1,1.0,1,1.0,1,0.1917986843347136,37
1731,1,3359,1331,2028,0,0,0,1.0,1,1.0,1,1.0,1,0.16855815612999342,37
1732,2,3361,1331,2030,0,0,0,1.0,1,1.0,1,1.0,1,0.19834867749770202,37
1733,6,3367,1333,2034,0,0,0,1.0,1,1.0,1,1.0,1,0.15286116948158002,36
1734,0,3367,1333,2034,0,0,0,1.0,1,1.0,1,1.0,1,0.153196821955171,35
1735,6,3373,1336,2037,0,0,0,1.0,1,1.0,1,1.0,1,0.14722729738376042,34
1736,2,3375,1337,2038,0,0,0,1.0,1,1.0,1,1.0,1,0.10827105186454285,35
1737,2,3377,1339,2038,0,0,0,1.0,1,1.0,1,1.0,1,0.15619245833053438,36
1738,2,3379,1339,2040,0,0,0,1.0,1,1.0,1,1.0,1,0.11560717782000889,37
1739,1,3380,1340,2040,0,0,0,1.0,1,1.0,1,1.0,1,0.11321534973283338,38
1740,0,3380,1340,2040,0,0,0,1.0,1,1.0,1,1.0,1,0.12121900456814998,37
1741,3,3383,1341,2042,0,0,0,1.0,1,1.0,1,1.0,1,0.11119083603348412,38
1742,6,3389,1344,2045,0,0,0,1.0,1,1.0,1,1.0,1,0.19925849543601956,39
1743,4,3393,1344,2049,0,0,0,1.0,1,1.0,1,1.0,1,0.12606533875678352,37
1744,5,3398,1346,2052,0,0,0,1.0,1,1.0,1,1.0,1,0.150230334933731,38
1745,4,3402,1347,2055,0,0,0,1.0,1,1.0,1,1.0,1,0.16226195885523007,37
1746,3,3405,1348,2057,0,0,0,1.0,1,1.0,1,1.0,1,0.11516065145480203,38
1747,2,3407,1349,2058,0,0,0,1.0,1,1.0,1,1.0,1,0.10651898651340107,38
1748,1,3408,1350,2058,0,0,0,1.0,1,1.0,1,1.0,1,0.13557631711840534,38
1749,1,3409,1350,2059,0,0,0,1.0,1,1.0,1,1.0,1,0.1211897341558871,37
1750,0,3409,1350,2059,0,0,0,1.0,1,1.0,1,1.0,1,0.13161539569832248,39
1751,0,3409,1350,2059,0,0,0,1.0,1,1.0,1,1.0,1,0.13407054431750323,38
1752,1,3410,1350,2060,0,0,0,1.0,1,1.0,1,1.0,1,0.13604686982250955,39
1753,1,3411,1351,2060,0,0,0,1.0,1,1.0,1,1.0,1,0.14071190549076779,40
1754,2,3413,1351,2062,0,0,0,1.0,1,1.0,1,1.0,1,0.12921346545088563,41
1755,3,3416,1351,2065,0,0,0,1.0,1,1.0,1,1.0,1,0.08449603570149666,41
1756,2,3418,1352,2066,0,0,0,1.0,1,1.0,1,1.0,1,0.10037962972700071,42
1757,1,3419,1353,2066,0,0,0,1.0,1,1.0,1,1.0,1,0.11536464341136111,42
1758,3,3422,1356,2066,0,0,0,1.0,1,1.0,1,1.0,1,0.20543842655460856,42
1759,3,3425,1356,2069,0,0,0,1.0,1,1.0,1,1.0,1,0.17717388887079114,39
1760,1,3426,1356,2070,0,0,0,1.0,1,1.0,1,1.0,1,0.18825230104632631,39
1761,3,3429,1357,2072,0,0,0,1.0,1,1.0,1,1.0,1,0.12858211502916,38
1762,1,3430,1357,2073,0,0,0,1.0,1,1.0,1,1.0,1,0.1231317201218722,37
1763,1,3431,1358,2073,0,0,0,1.0,1,1.0,1,1.0,1,0.149949608466041,37
1764,2,3433,1360,2073,0,0,0,1.0,1,1.0,1,1.0,1,0.1835916713366533,36
1765,4,3437,1362,2075,0,0,0,1.0,1,1.0,1,1.0,1,0.12496979497572931,37
1766,1,3438,1362,2076,0,0,0,1.0,1,1.0,1,1.0,1,0.10510238343864735,36
1767,0,3438,1362,2076,0,0,0,1.0,1,1.0,1,1.0,1,0.10510238343864735,36
1768,0,3438,1362,2076,0,0,0,1.0,1,1.0,1,1.0,1,0.10510238343864735,36
1769,3,3441,1363,2078,0,0,0,1.0,1,1.0,1,1.0,1,0.10168207941551913,38
1770,2,3443,1364,2079,0,0,0,1.0,1,1.0,1,1.0,1,0.13285269854179946,38
1771,0,3443,1364,2079,0,0,0,1.0,1,1.0,1,1.0,1,0.13285269854179946,38
1772,3,3446,1365,2081,0,0,0,1.0,1,1.0,1,1.0,1,0.10349645565235963,40
1773,0,3446,1365,2081,0,0,0,1.0,1,1.0,1,1.0,1,0.09146517885899744,40
1774,0,3446,1365,2081,0,0,0,1.0,1,1.0,1,1.0,1,0.09146517885899744,40
1775,0,3446,1365,2081,0,0,0,1.0,1,1.0,1,1.0,1,0.10425015202503451,41
1776,0,3446,1365,2081,0,0,0,1.0,1,1.0,1,1.0,1,0.09899368066014219,43
1777,2,3448,1366,2082,0,0,0,1.0,1,1.0,1,1.0,1,0.0755369580517629,44
1778,2,3450,1368,2082,0,0,0,1.0,1,1.0,1,1.0,1,0.08917584152721428,44
1779,1,3451,1369,2082,0,0,0,1.0,1,1.0,1,1.0,1,0.11343085551841209,44
1780,3,3454,1369,2085,0,0,0,1.0,1,1.0,1,1.0,1,0.09503543436600369,46
1781,3,3457,1371,2086,0,0,0,1.0,1,1.0,1,1.0,1,0.09430096984702026,46
1782,4,3461,1373,2088,0,0,0,1.0,1,1.0,1,1.0,1,0.11375156302743675,45
1783,2,3463,1374,2089,0,0,0,1.0,1,1.0,1,1.0,1,0.1351264921454041,44
1784,0,3463,1374,2089,0,0,0,1.0,1,1.0,1,1.0,1,0.1314384687174575,44
1785,2,3465,1375,2090,0,0,0,1.0,1,1.0,1,1.0,1,0.13540839271239685,42
1786,7,3472,1378,2094,0,0,0,1.0,1,1.0,1,1.0,1,0.13328658328378604,42
1787,4,3476,1379,2097,0,0,0,1.0,1,1.0,1,1.0,1,0.11037901897136514,41
1788,4,3480,1382,2098,0,0,0,1.0,1,1.0,1,1.0,1,0.18086514474915463,41
1789,2,3482,1382,2100,0,0,0,1.0,1,1.0,1,1.0,1,0.13011245574488545,41
1790,4,3486,1384,2102,0,0,0,1.0,1,1.0,1,1.0,1,0.1455680438480592,41
1791,4,3490,1384,2106,0,0,0,1.0,1,1.0,1,1.0,1,0.08431578467286376,41
1792,0,3490,1384,2106,0,0,0,1.0,1,1.0,1,1.0,1,0.09566868475024602,43
1793,2,3492,1386,2106,0,0,0,1.0,1,1.0,1,1.0,1,0.09539530858668174,43
1794,1,3493,1387,2106,0,0,0,1.0,1,1.0,1,1.0,1,0.09000692166959119,41
1795,4,3497,1390,2107,0,0,0,1.0,1,1.0,1,1.0,1,0.11364224175153735,41
1796,1,3498,1391,2107,0,0,0,1.0,1,1.0,1,1.0,1,0.11307527748031734,40
1797,0,3498,1391,2107,0,0,0,1.0,1,1.0,1,1.0,1,0.11170455756030302,38
1798,3,3501,1392,2109,0,0,0,1.0,1,1.0,1,1.0,1,0.1200895100052293,38
1799,3,3504,1394,2110,0,0,0,1.0,1,1.0,1,1.0,1,0.14553330304273668,37
1800,2,3506,1395,2111,0,0,0,1.0,1,1.0,1,1.0,1,0.1662726229653928,35
1801,4,3510,1397,2113,0,0,0,1.0,1,1.0,1,1.0,1,0.15373873452201642,34
1802,0,3510,1397,2113,0,0,0,1.0,1,1.0,1,1.0,1,0.13612881488354656,33
1803,2,3512,1399,2113,0,0,0,1.0,1,1.0,1,1.0,1,0.2249924613531485,33
1804,2,3514,1400,2114,0,0,0,1.0,1,1.0,1,1.0,1,0.1854804783087114,33
1805,2,3516,1400,2116,0,0,0,1.0,1,1.0,1,1.0,1,0.11336817555995074,35
1806,1,3517,1400,2117,0,0,0,1.0,1,1.0,1,1.0,1,0.0899070122476887,36
1807,0,3517,1400,2117,0,0,0,1.0,1,1.0,1,1.0,1,0.0867764740667622,35
1808,1,3518,1401,2117,0,0,0,1.0,1,1.0,1,1.0,1,0.07765172879314972,37
1809,1,3519,1401,2118,0,0,0,1.0,1,1.0,1,1.0,1,0.08460644093630731,35
1810,0,3519,1401,2118,0,0,0,1.0,1,1.0,1,1.0,1,0.1057767939183045,36
1811,1,3520,1402,2118,0,0,0,1.0,1,1.0,1,1.0,1,0.20158460556500502,34
1812,0,3520,1402,2118,0,0,0,1.0,1,1.0,1,1.0,1,0.22847772815340633,36
1813,1,3521,1402,2119,0,0,0,1.0,1,1.0,1,1.0,1,0.24163470738367063,35
1814,3,3524,1402,2122,0,0,0,1.0,1,1.0,1,1.0,1,0.20310047745223458,36
1815,1,3525,1402,2123,0,0,0,1.0,1,1.0,1,1.0,1,0.20518732185906735,35
1816,2,3527,1402,2125,0,0,0,1.0,1,1.0,1,1.0,1,0.18099228067348516,35
1817,1,3528,1403,2125,0,0,0,1.0,1,1.0,1,1.0,1,0.1875021219753831,35
1818,4,3532,1406,2126,0,0,0,1.0,1,1.0,1,1.0,1,0.13341258855756574,36
1819,3,3535,1409,2126,0,0,0,1.0,1,1.0,1,1.0,1,0.1569296497020689,37
1820,1,3536,1409,2127,0,0,0,1.0,1,1.0,1,1.0,1,0.1381405930128607,37
1821,1,3537,1409,2128,0,0,0,1.0,1,1.0,1,1.0,1,0.13119344122822266,38
1822,4,3541,1412,2129,0,0,0,1.0,1,1.0,1,1.0,1,0.17282997658789756,37
1823,2,3543,1414,2129,0,0,0,1.0,1,1.0,1,1.0,1,0.20402454359731678,36
1824,2,3545,1416,2129,0,0,0,1.0,1,1.0,1,1.0,1,0.20901026631738234,36
1825,3,3548,1417,2131,0,0,0,1.0,1,1.0,1,1.0,1,0.1280293328993787,34
1826,5,3553,1420,2133,0,0,0,1.0,1,1.0,1,1.0,1,0.15405209603901987,35
1827,2,3555,1421,2134,0,0,0,1.0,1,1.0,1,1.0,1,0.1563146764174816,34
1828,1,3556,1422,2134,0,0,0,1.0,1,1.0,1,1.0,1,0.16444550096184488,33
1829,1,3557,1423,2134,0,0,0,1.0,1,1.0,1,1.0,1,0.16472639160148234,31
1830,0,3557,1423,2134,0,0,0,1.0,1,1.0,1,1.0,1,0.15247344207173502,31
1831,1,3558,1424,2134,0,0,0,1.0,1,1.0,1,1.0,1,0.16297348866803524,30
1832,0,3558,1424,2134,0,0,0,1.0,1,1.0,1,1.0,1,0.15755602590803308,29
1833,3,3561,1427,2134,0,0,0,1.0,1,1.0,1,1.0,1,0.28647004731487113,28
1834,1,3562,1428,2134,0,0,0,1.0,1,1.0,1,1.0,1,0.3316464673022926,27
1835,8,3570,1431,2139,0,0,0,1.0,1,1.0,1,1.0,1,0.2324995877680336,26
1836,2,3572,1431,2141,0,0,0,1.0,1,1.0,1,1.0,1,0.2428130339446207,26
1837,2,3574,1431,2143,0,0,0,1.0,1,1.0,1,1.0,1,0.15578646746330774,25
1838,1,3575,1431,2144,0,0,0,1.0,1,1.0,1,1.0,1,0.12046360773394243,25
1839,1,3576,1431,2145,0,0,0,1.0,1,1.0,1,1.0,1,0.13793314796889986,24
1840,1,3577,1432,2145,0,0,0,1.0,1,1.0,1,1.0,1,0.209126603043859,23
1841,0,3577,1432,2145,0,0,0,1.0,1,1.0,1,1.0,1,0.19543874901307443,22
1842,0,3577,1432,2145,0,0,0,1.0,1,1.0,1,1.0,1,0.1912822527627064,23
1843,1,3578,1433,2145,0,0,0,1.0,1,1.0,1,1.0,1,0.1727793167351633,23
1844,0,3578,1433,2145,0,0,0,1.0,1,1.0,1,1.0,1,0.1727793167351633,23
1845,2,3580,1435,2145,0,0,0,1.0,1,1.0,1,1.0,1,0.23689052484407333,23
1846,2,3582,1436,2146,0,0,0,1.0,1,1.0,1,1.0,1,0.11561246807810274,23
1847,0,3582,1436,2146,0,0,0,1.0,1,1.0,1,1.0,1,0.12989714614588582,24
1848,0,3582,1436,2146,0,0,0,1.0,1,1.0,1,1.0,1,0.12989714614588582,24
1849,1,3583,1436,2147,0,0,0,1.0,1,1.0,1,1.0,1,0.1336304797164194,25
1850,0,3583,1436,2147,0,0,0,1.0,1,1.0,1,1.0,1,0.1336304797164194,25
1851,0,3583,1436,2147,0,0,0,1.0,1,1.0,1,1.0,1,0.1336304797164194,25
1852,0,3583,1436,2147,0,0,0,1.0,1,1.0,1,1.0,1,0.1336304797164194,25
1853,0,3583,1436,2147,0,0,0,1.0,1,1.0,1,1.0,1,0.15331248870250752,25
1854,1,3584,1437,2147,0,0,0,1.0,1,1.0,1,1.0,1,0.21333122366571808,25
1855,1,3585,1437,2148,0,0,0,1.0,1,1.0,1,1.0,1,0.22640989817281756,26
1856,1,3586,1438,2148,0,0,0,1.0,1,1.0,1,1.0,1,0.2274774767323125,27
1857,1,3587,1438,2149,0,0,0,1.0,1,1.0,1,1.0,1,0.20403703933254336,28
1858,1,3588,1439,2149,0,0,0,1.0,1,1.0,1,1.0,1,0.2094786428072169,28
1859,3,3591,1440,2151,0,0,0,1.0,1,1.0,1,1.0,1,0.20110951816804878,28
1860,0,3591,1440,2151,0,0,0,1.0,1,1.0,1,1.0,1,0.20110951816804878,28
1861,0,3591,1440,2151,0,0,0,1.0,1,1.0,1,1.0,1,0.20110951816804878,28
1862,0,3591,1440,2151,0,0,0,1.0,1,1.0,1,1.0,1,0.20110951816804878,28
1863,1,3592,1441,2151,0,0,0,1.0,1,1.0,1,1.0,1,0.23248123056785971,29
1864,2,3594,1443,2151,0,0,0,1.0,1,1.0,1,1.0,1,0.2429972114492177,27
1865,2,3596,1444,2152,0,0,0,1.0,1,1.0,1,1.0,1,0.2747460997295402,26
1866,2,3598,1445,2153,0,0,0,1.0,1,1.0,1,1.0,1,0.2968714440692797,26
1867,1,3599,1445,2154,0,0,0,1.0,1,1.0,1,1.0,1,0.24882980357322043,26
1868,1,3600,1445,2155,0,0,0,1.0,1,1.0,1,1.0,1,0.24696412270379914,26
1869,3,3603,1445,2158,0,0,0,1.0,1,1.0,1,1.0,1,0.1754348514606822,26
1870,0,3603,1445,2158,0,0,0,1.0,1,1.0,1,1.0,1,0.19221973963446676,27
1871,1,3604,1445,2159,0,0,0,1.0,1,1.0,1,1.0,1,0.16268896822145876,27
1872,0,3604,1445,2159,0,0,0,1.0,1,1.0,1,1.0,1,0.18826570187391584,25
1873,0,3604,1445,2159,0,0,0,1.0,1,1.0,1,1.0,1,0.18826570187391584,25
1874,1,3605,1445,2160,0,0,0,1.0,1,1.0,1,1.0,1,0.2205686123307207,25
1875,1,3606,1445,2161,0,0,0,1.0,1,1.0,1,1.0,1,0.19619408456735388,25
1876,0,3606,1445,2161,0,0,0,1.0,1,1.0,1,1.0,1,0.1724573098906677,26
1877,0,3606,1445,2161,0,0,0,1.0,1,1.0,1,1.0,1,0.1738088132621918,27
1878,2,3608,1447,2161,0,0,0,1.0,1,1.0,1,1.0,1,0.2230306599780426,28
1879,0,3608,1447,2161,0,0,0,1.0,1,1.0,1,1.0,1,0.2145216841405495,29
1880,1,3609,1447,2162,0,0,0,1.0,1,1.0,1,1.0,1,0.1960205364030271,29
1881,0,3609,1447,2162,0,0,0,1.0,1,1.0,1,1.0,1,0.1960205364030271,29
1882,0,3609,1447,2162,0,0,0,1.0,1,1.0,1,1.0,1,0.1961397061282157,28
1883,0,3609,1447,2162,0,0,0,1.0,1,1.0,1,1.0,1,0.1961397061282157,28
1884,0,3609,1447,2162,0,0,0,1.0,1,1.0,1,1.0,1,0.1961397061282157,28
1885,0,3609,1447,2162,0,0,0,1.0,1,1.0,1,1.0,1,0.1961397061282157,28
1886,1,3610,1448,2162,0,0,0,1.0,1,1.0,1,1.0,1,0.2538639796480531,29
1887,1,3611,1448,2163,0,0,0,1.0,1,1.0,1,1.0,1,0.21155273689732307,29
1888,3,3614,1448,2166,0,0,0,1.0,1,1.0,1,1.0,1,0.17429225558006572,31
1889,1,3615,1448,2167,0,0,0,1.0,1,1.0,1,1.0,1,0.15864431910475213,31
1890,0,3615,1448,2167,0,0,0,1.0,1,1.0,1,1.0,1,0.15864431910475213,31
1891,0,3615,1448,2167,0,0,0,1.0,1,1.0,1,1.0,1,0.18021527207384128,32
1892,0,3615,1448,2167,0,0,0,1.0,1,1.0,1,1.0,1,0.18021527207384128,32
1893,0,3615,1448,2167,0,0,0,1.0,1,1.0,1,1.0,1,0.18021527207384128,32
1894,0,3615,1448,2167,0,0,0,1.0,1,1.0,1,1.0,1,0.16277163515061538,33
1895,2,3617,1449,2168,0,0,0,1.0,1,1.0,1,1.0,1,0.12593527058064366,35
1896,0,3617,1449,2168,0,0,0,1.0,1,1.0,1,1.0,1,0.14888858844597816,34
1897,0,3617,1449,2168,0,0,0,1.0,1,1.0,1,1.0,1,0.14888858844597816,34
1898,0,3617,1449,2168,0,0,0,1.0,1,1.0,1,1.0,1,0.14888858844597816,34
1899,0,3617,1449,2168,0,0,0,1.0,1,1.0,1,1.0,1,0.14888858844597816,34
1900,0,3617,1449,2168,0,0,0,1.0,1,1.0,1,1.0,1,0.15085626127751273,35
1901,0,3617,1449,2168,0,0,0,1.0,1,1.0,1,1.0,1,0.15085626127751273,35
1902,0,3617,1449,2168,0,0,0,1.0,1,1.0,1,1.0,1,0.15085626127751273,35
1903,0,3617,1449,2168,0,0,0,1.0,1,1.0,1,1.0,1,0.15085626127751273,35
1904,0,3617,1449,2168,0,0,0,1.0,1,1.0,1,1.0,1,0.15085626127751273,35
1905,1,3618,1449,2169,0,0,0,1.0,1,1.0,1,1.0,1,0.1247160480339091,37
1906,0,3618,1449,2169,0,0,0,1.0,1,1.0,1,1.0,1,0.1247160480339091,37
1907,0,3618,1449,2169,0,0,0,1.0,1,1.0,1,1.0,1,0.15201808312713322,39
1908,0,3618,1449,2169,0,0,0,1.0,1,1.0,1,1.0,1,0.15201808312713322,39
1909,3,3621,1449,2172,0,0,0,1.0,1,1.0,1,1.0,1,0.12232871658198197,41
1910,0,3621,1449,2172,0,0,0,1.0,1,1.0,1,1.0,1,0.12232871658198197,41
1911,4,3625,1450,2175,0,0,0,1.0,1,1.0,1,1.0,1,0.1704889878708602,40
1912,2,3627,1452,2175,0,0,0,1.0,1,1.0,1,1.0,1,0.20032263673890452,39
1913,2,3629,1452,2177,0,0,0,1.0,1,1.0,1,1.0,1,0.18334662193664256,40
1914,1,3630,1453,2177,0,0,0,1.0,1,1.0,1,1.0,1,0.20634511912396294,41
1915,2,3632,1454,2178,0,0,0,1.0,1,1.0,1,1.0,1,0.18894150049752573,42
1916,3,3635,1456,2179,0,0,0,1.0,1,1.0,1,1.0,1,0.21593895365688856,42
1917,3,3638,1458,2180,0,0,0,1.0,1,1.0,1,1.0,1,0.21250061014373872,41
1918,2,3640,1459,2181,0,0,0,1.0,1,1.0,1,1.0,1,0.20974545560618274,38
1919,2,3642,1459,2183,0,0,0,1.0,1,1.0,1,1.0,1,0.22753825246620174,38
1920,2,3644,1459,2185,0,0,0,1.0,1,1.0,1,1.0,1,0.23085184980297752,38
1921,1,3645,1459,2186,0,0,0,1.0,1,1.0,1,1.0,1,0.18174761872991874,39
1922,1,3646,1460,2186,0,0,0,1.0,1,1.0,1,1.0,1,0.18927608255033007,40
1923,2,3648,1460,2188,0,0,0,1.0,1,1.0,1,1.0,1,0.15817057156493183,41
1924,5,3653,1463,2190,0,0,0,1.0,1,1.0,1,1.0,1,0.16843469839188313,41
1925,2,3655,1463,2192,0,0,0,1.0,1,1.0,1,1.0,1,0.13465314346164162,41
1926,0,3655,1463,2192,0,0,0,1.0,1,1.0,1,1.0,1,0.13465314346164162,41
1927,0,3655,1463,2192,0,0,0,1.0,1,1.0,1,1.0,1,0.13465314346164162,41
1928,1,3656,1464,2192,0,0,0,1.0,1,1.0,1,1.0,1,0.13624220165459167,42
1929,0,3656,1464,2192,0,0,0,1.0,1,1.0,1,1.0,1,0.13531454075985425,41
1930,0,3656,1464,2192,0,0,0,1.0,1,1.0,1,1.0,1,0.13531454075985425,41
1931,0,3656,1464,2192,0,0,0,1.0,1,1.0,1,1.0,1,0.13531454075985425,41
1932,0,3656,1464,2192,0,0,0,1.0,1,1.0,1,1.0,1,0.13531454075985425,41
1933,3,3659,1465,2194,0,0,0,1.0,1,1.0,1,1.0,1,0.14709835475686814,43
1934,1,3660,1465,2195,0,0,0,1.0,1,1.0,1,1.0,1,0.13699177173515215,44
1935,0,3660,1465,2195,0,0,0,1.0,1,1.0,1,1.0,1,0.11060171502240543,45
1936,1,3661,1465,2196,0,0,0,1.0,1,1.0,1,1.0,1,0.11607014455968909,48
1937,1,3662,1466,2196,0,0,0,1.0,1,1.0,1,1.0,1,0.1431931744828403,48
1938,0,3662,1466,2196,0,0,0,1.0,1,1.0,1,1.0,1,0.1431931744828403,48
1939,4,3666,1467,2199,0,0,0,1.0,1,1.0,1,1.0,1,0.10300620692175004,48
1940,0,3666,1467,2199,0,0,0,1.0,1,1.0,1,1.0,1,0.10300620692175004,48
1941,0,3666,1467,2199,0,0,0,1.0,1,1.0,1,1.0,1,0.10300620692175004,48
1942,3,3669,1469,2200,0,0,0,1.0,1,1.0,1,1.0,1,0.17735995523372572,49
1943,2,3671,1470,2201,0,0,0,1.0,1,1.0,1,1.0,1,0.13343975148163004,48
1944,2,3673,1471,2202,0,0,0,1.0,1,1.0,1,1.0,1,0.15888613782061553,47
1945,3,3676,1474,2202,0,0,0,1.0,1,1.0,1,1.0,1,0.16382830773022547,46
1946,3,3679,1475,2204,0,0,0,1.0,1,1.0,1,1.0,1,0.17664084636406427,46
1947,8,3687,1477,2210,0,0,0,1.0,1,1.0,1,1.0,1,0.1299122525725094,45
1948,2,3689,1478,2211,0,0,0,1.0,1,1.0,1,1.0,1,0.14129612557804969,46
1949,3,3692,1480,2212,0,0,0,1.0,1,1.0,1,1.0,1,0.19114108602482835,42
1950,1,3693,1480,2213,0,0,0,1.0,1,1.0,1,1.0,1,0.18242683497400336,40
1951,4,3697,1483,2214,0,0,0,1.0,1,1.0,1,1.0,1,0.17349271992457108,39
1952,1,3698,1484,2214,0,0,0,1.0,1,1.0,1,1.0,1,0.23428016569328797,35
1953,5,3703,1486,2217,0,0,0,1.0,1,1.0,1,1.0,1,0.14537149349276632,36
1954,1,3704,1487,2217,0,0,0,1.0,1,1.0,1,1.0,1,0.17646993236566005,34
1955,2,3706,1488,2218,0,0,0,1.0,1,1.0,1,1.0,1,0.14488801573766225,35
1956,2,3708,1490,2218,0,0,0,1.0,1,1.0,1,1.0,1,0.19142087704495914,37
1957,3,3711,1490,2221,0,0,0,1.0,1,1.0,1,1.0,1,0.14350661215977878,37
1958,3,3714,1490,2224,0,0,0,1.0,1,1.0,1,1.0,1,0.13763745322211676,39
1959,1,3715,1490,2225,0,0,0,1.0,1,1.0,1,1.0,1,0.14116460833755515,41
1960,1,3716,1491,2225,0,0,0,1.0,1,1.0,1,1.0,1,0.14762359168000755,40
1961,3,3719,1492,2227,0,0,0,1.0,1,1.0,1,1.0,1,0.13299794755394456,41
1962,1,3720,1493,2227,0,0,0,1.0,1,1.0,1,1.0,1,0.16836708619106266,40
1963,1,3721,1493,2228,0,0,0,1.0,1,1.0,1,1.0,1,0.1432849641702718,41
1964,0,3721,1493,2228,0,0,0,1.0,1,1.0,1,1.0,1,0.16954239072482333,40
1965,5,3726,1494,2232,0,0,0,1.0,1,1.0,1,1.0,1,0.12186309221150722,41
1966,0,3726,1494,2232,0,0,0,1.0,1,1.0,1,1.0,1,0.12186309221150722,41
1967,2,3728,1495,2233,0,0,0,1.0,1,1.0,1,1.0,1,0.1020619882600328,42
1968,0,3728,1495,2233,0,0,0,1.0,1,1.0,1,1.0,1,0.12276690689457223,42
1969,1,3729,1496,2233,0,0,0,1.0,1,1.0,1,1.0,1,0.13497398288529763,43
1970,0,3729,1496,2233,0,0,0,1.0,1,1.0,1,1.0,1,0.14604070946442654,42
1971,2,3731,1496,2235,0,0,0,1.0,1,1.0,1,1.0,1,0.11919659821346401,42
1972,0,3731,1496,2235,0,0,0,1.0,1,1.0,1,1.0,1,0.11919659821346401,42
1973,0,3731,1496,2235,0,0,0,1.0,1,1.0,1,1.0,1,0.1326922588173441,43
1974,2,3733,1497,2236,0,0,0,1.0,1,1.0,1,1.0,1,0.16592337921349917,43
1975,2,3735,1497,2238,0,0,0,1.0,1,1.0,1,1.0,1,0.1373864266718949,43
1976,0,3735,1497,2238,0,0,0,1.0,1,1.0,1,1.0,1,0.1373864266718949,43
1977,4,3739,1497,2242,0,0,0,1.0,1,1.0,1,1.0,1,0.145882196486056,48
1978,4,3743,1499,2244,0,0,0,1.0,1,1.0,1,1.0,1,0.1360053837706786,48
1979,4,3747,1500,2247,0,0,0,1.0,1,1.0,1,1.0,1,0.14780463837211963,49
1980,1,3748,1501,2247,0,0,0,1.0,1,1.0,1,1.0,1,0.1776385931016561,50
1981,6,3754,1502,2252,0,0,0,1.0,1,1.0,1,1.0,1,0.14152104252039463,50
1982,1,3755,1503,2252,0,0,0,1.0,1,1.0,1,1.0,1,0.14082364045656312,50
1983,1,3756,1504,2252,0,0,0,1.0,1,1.0,1,1.0,1,0.14986370658442572,49
1984,0,3756,1504,2252,0,0,0,1.0,1,1.0,1,1.0,1,0.13842837086436358,48
1985,1,3757,1505,2252,0,0,0,1.0,1,1.0,1,1.0,1,0.12873771001497894,46
1986,3,3760,1508,2252,0,0,0,1.0,1,1.0,1,1.0,1,0.13422610173286353,46
1987,2,3762,1510,2252,0,0,0,1.0,1,1.0,1,1.0,1,0.18373264041515588,42
1988,0,3762,1510,2252,0,0,0,1.0,1,1.0,1,1.0,1,0.20217078670666447,40
1989,5,3767,1512,2255,0,0,0,1.0,1,1.0,1,1.0,1,0.1806362556889414,38
1990,1,3768,1512,2256,0,0,0,1.0,1,1.0,1,1.0,1,0.15838014108061294,38
1991,3,3771,1514,2257,0,0,0,1.0,1,1.0,1,1.0,1,0.1614697650266154,38
1992,0,3771,1514,2257,0,0,0,1.0,1,1.0,1,1.0,1,0.16581117146875243,39
1993,3,3774,1516,2258,0,0,0,1.0,1,1.0,1,1.0,1,0.2635427593809058,38
1994,1,3775,1516,2259,0,0,0,1.0,1,1.0,1,1.0,1,0.23661984221552534,37
1995,4,3779,1517,2262,0,0,0,1.0,1,1.0,1,1.0,1,0.21230542643536832,37
1996,1,3780,1518,2262,0,0,0,1.0,1,1.0,1,1.0,1,0.24099947951388634,37
1997,4,3784,1518,2266,0,0,0,1.0,1,1.0,1,1.0,1,0.18830803598231566,35
1998,1,3785,1519,2266,0,0,0,1.0,1,1.0,1,1.0,1,0.20676569482401533,34
1999,2,3787,1521,2266,0,0,0,1.0,1,1.0,1,1.0,1,0.23033876381018298,35
2000,0,3787,1521,2266,0,0,0,1.0,1,1.0,1,1.0,1,0.24699997637558377,34
2001,2,3789,1521,2268,0,0,0,1.0,1,1.0,1,1.0,1,0.2283146169034914,35
2002,2,3791,1522,2269,0,0,0,1.0,1,1.0,1,1.0,1,0.2635953776038668,36
2003,5,3796,1522,2274,0,0,0,1.0,1,1.0,1,1.0,1,0.21829839856698557,37
2004,2,3798,1522,2276,0,0,0,1.0,1,1.0,1,1.0,1,0.173847253554929,38
2005,1,3799,1522,2277,0,0,0,1.0,1,1.0,1,1.0,1,0.15749912457060028,38
2006,0,3799,1522,2277,0,0,0,1.0,1,1.0,1,1.0,1,0.15749912457060028,38
2007,1,3800,1523,2277,0,0,0,1.0,1,1.0,1,1.0,1,0.1417980806747206,40
2008,0,3800,1523,2277,0,0,0,1.0,1,1.0,1,1.0,1,0.1417980806747206,40
2009,2,3802,1525,2277,0,0,0,1.0,1,1.0,1,1.0,1,0.14974977586712546,41
2010,1,3803,1525,2278,0,0,0,1.0,1,1.0,1,1.0,1,0.12314925262469338,41
2011,1,3804,1525,2279,0,0,0,1.0,1,1.0,1,1.0,1,0.10536208012983785,41
2012,0,3804,1525,2279,0,0,0,1.0,1,1.0,1,1.0,1,0.10536208012983785,41
2013,0,3804,1525,2279,0,0,0,1.0,1,1.0,1,1.0,1,0.12471854543306671,43
2014,0,3804,1525,2279,0,0,0,1.0,1,1.0,1,1.0,1,0.14669713771815937,43
2015,0,3804,1525,2279,0,0,0,1.0,1,1.0,1,1.0,1,0.14669713771815937,43
2016,1,3805,1525,2280,0,0,0,1.0,1,1.0,1,1.0,1,0.14836232277089062,44
2017,2,3807,1525,2282,0,0,0,1.0,1,1.0,1,1.0,1,0.12665332297180878,45
2018,2,3809,1526,2283,0,0,0,1.0,1,1.0,1,1.0,1,0.13128017946146456,46
2019,2,3811,1526,2285,0,0,0,1.0,1,1.0,1,1.0,1,0.08600657581445148,47
2020,2,3813,1528,2285,0,0,0,1.0,1,1.0,1,1.0,1,0.1203331850893067,47
2021,3,3816,1529,2287,0,0,0,1.0,1,1.0,1,1.0,1,0.11258337854578436,47
2022,2,3818,1529,2289,0,0,0,1.0,1,1.0,1,1.0,1,0.11451603228249332,48
2023,2,3820,1531,2289,0,0,0,1.0,1,1.0,1,1.0,1,0.14593486573983033,48
2024,6,3826,1535,2291,0,0,0,1.0,1,1.0,1,1.0,1,0.15198065126876553,45
2025,4,3830,1537,2293,0,0,0,1.0,1,1.0,1,1.0,1,0.19250814178995046,42
2026,9,3839,1541,2298,0,0,0,1.0,1,1.0,1,1.0,1,0.18588473589072418,44
2027,4,3843,1543,2300,0,0,0,1.0,1,1.0,1,1.0,1,0.16070802112768626,40
2028,1,3844,1543,2301,0,0,0,1.0,1,1.0,1,1.0,1,0.17717133237648888,39
2029,3,3847,1543,2304,0,0,0,1.0,1,1.0,1,1.0,1,0.13536876981223797,37
2030,2,3849,1544,2305,0,0,0,1.0,1,1.0,1,1.0,1,0.14666482124806918,34
2031,0,3849,1544,2305,0,0,0,1.0,1,1.0,1,1.0,1,0.1595691627097406,35
2032,3,3852,1545,2307,0,0,0,1.0,1,1.0,1,1.0,1,0.256664810238696,34
2033,4,3856,1547,2309,0,0,0,1.0,1,1.0,1,1.0,1,0.22585660627951296,36
2034,0,3856,1547,2309,0,0,0,1.0,1,1.0,1,1.0,1,0.21223801271362172,34
2035,4,3860,1547,2313,0,0,0,1.0,1,1.0,1,1.0,1,0.1953622537833501,35
2036,2,3862,1548,2314,0,0,0,1.0,1,1.0,1,1.0,1,0.17826901844272935,34
2037,0,3862,1548,2314,0,0,0,1.0,1,1.0,1,1.0,1,0.17268260890385112,35
2038,0,3862,1548,2314,0,0,0,1.0,1,1.0,1,1.0,1,0.1683488949239389,36
2039,3,3865,1549,2316,0,0,0,1.0,1,1.0,1,1.0,1,0.12677552534636424,38
2040,0,3865,1549,2316,0,0,0,1.0,1,1.0,1,1.0,1,0.12677552534636424,38
2041,0,3865,1549,2316,0,0,0,1.0,1,1.0,1,1.0,1,0.12853788139421304,39
2042,1,3866,1549,2317,0,0,0,1.0,1,1.0,1,1.0,1,0.10576464438934122,39
2043,0,3866,1549,2317,0,0,0,1.0,1,1.0,1,1.0,1,0.10576464438934122,39
2044,0,3866,1549,2317,0,0,0,1.0,1,1.0,1,1.0,1,0.10576464438934122,39
2045,1,3867,1550,2317,0,0,0,1.0,1,1.0,1,1.0,1,0.11479734732924549,41
2046,0,3867,1550,2317,0,0,0,1.0,1,1.0,1,1.0,1,0.1381195922725809,42
2047,1,3868,1550,2318,0,0,0,1.0,1,1.0,1,1.0,1,0.1177224629708444,42
2048,1,3869,1551,2318,0,0,0,1.0,1,1.0,1,1.0,1,0.14421746986003445,43
2049,6,3875,1553,2322,0,0,0,1.0,1,1.0,1,1.0,1,0.11596148389439014,44
2050,2,3877,1553,2324,0,0,0,1.0,1,1.0,1,1.0,1,0.1234626371474041,44
2051,5,3882,1554,2328,0,0,0,1.0,1,1.0,1,1.0,1,0.11718683407972286,45
2052,0,3882,1554,2328,0,0,0,1.0,1,1.0,1,1.0,1,0.11718683407972286,45
2053,3,3885,1554,2331,0,0,0,1.0,1,1.0,1,1.0,1,0.06163505856860379,45
2054,1,3886,1554,2332,0,0,0,1.0,1,1.0,1,1.0,1,0.074668194046588,46
2055,0,3886,1554,2332,0,0,0,1.0,1,1.0,1,1.0,1,0.074668194046588,46
2056,2,3888,1556,2332,0,0,0,1.0,1,1.0,1,1.0,1,0.1127050089279019,46
2057,3,3891,1558,2333,0,0,0,1.0,1,1.0,1,1.0,1,0.07905778708900693,47
2058,4,3895,1562,2333,0,0,0,1.0,1,1.0,1,1.0,1,0.15592572928947954,47
2059,4,3899,1563,2336,0,0,0,1.0,1,1.0,1,1.0,1,0.1061844491062836,48
2060,6,3905,1565,2340,0,0,0,1.0,1,1.0,1,1.0,1,0.11318679335927537,50
2061,1,3906,1565,2341,0,0,0,1.0,1,1.0,1,1.0,1,0.0786377395343397,51
2062,0,3906,1565,2341,0,0,0,1.0,1,1.0,1,1.0,1,0.07984352443457646,49
2063,1,3907,1566,2341,0,0,0,1.0,1,1.0,1,1.0,1,0.07675528134927197,48
2064,0,3907,1566,2341,0,0,0,1.0,1,1.0,1,1.0,1,0.09140305787733355,45
2065,2,3909,1566,2343,0,0,0,1.0,1,1.0,1,1.0,1,0.08259715561257425,44
2066,1,3910,1567,2343,0,0,0,1.0,1,1.0,1,1.0,1,0.140928840639303,42
2067,3,3913,1568,2345,0,0,0,1.0,1,1.0,1,1.0,1,0.10887585029007057,41
2068,1,3914,1569,2345,0,0,0,1.0,1,1.0,1,1.0,1,0.16108459415468096,40
2069,1,3915,1569,2346,0,0,0,1.0,1,1.0,1,1.0,1,0.1509683219496176,40
2070,1,3916,1569,2347,0,0,0,1.0,1,1.0,1,1.0,1,0.11417108665356149,40
2071,1,3917,1570,2347,0,0,0,1.0,1,1.0,1,1.0,1,0.12353559430811048,40
2072,2,3919,1570,2349,0,0,0,1.0,1,1.0,1,1.0,1,0.12889238469359937,41
2073,3,3922,1571,2351,0,0,0,1.0,1,1.0,1,1.0,1,0.10342348441035319,41
2074,0,3922,1571,2351,0,0,0,1.0,1,1.0,1,1.0,1,0.10293240529014303,41
2075,0,3922,1571,2351,0,0,0,1.0,1,1.0,1,1.0,1,0.10293240529014303,41
2076,4,3926,1573,2353,0,0,0,1.0,1,1.0,1,1.0,1,0.10869301353327902,41
2077,0,3926,1573,2353,0,0,0,1.0,1,1.0,1,1.0,1,0.1217901385330199,40
2078,1,3927,1574,2353,0,0,0,1.0,1,1.0,1,1.0,1,0.12442385913018432,40
2079,2,3929,1574,2355,0,0,0,1.0,1,1.0,1,1.0,1,0.06797395014225478,39
2080,2,3931,1575,2356,0,0,0,1.0,1,1.0,1,1.0,1,0.05752218279428425,38
2081,1,3932,1575,2357,0,0,0,1.0,1,1.0,1,1.0,1,0.03521448278576573,40
2082,1,3933,1576,2357,0,0,0,1.0,1,1.0,1,1.0,1,0.09772215961824812,41
2083,2,3935,1577,2358,0,0,0,1.0,1,1.0,1,1.0,1,0.0824514830783849,40
2084,2,3937,1579,2358,0,0,0,1.0,1,1.0,1,1.0,1,0.1434451110877846,42
2085,2,3939,1580,2359,0,0,0,1.0,1,1.0,1,1.0,1,0.1252859717016366,42
2086,0,3939,1580,2359,0,0,0,1.0,1,1.0,1,1.0,1,0.10954262153902199,43
2087,2,3941,1581,2360,0,0,0,1.0,1,1.0,1,1.0,1,0.12116101489791632,45
2088,7,3948,1584,2364,0,0,0,1.0,1,1.0,1,1.0,1,0.16859143610308094,46
2089,2,3950,1584,2366,0,0,0,1.0,1,1.0,1,1.0,1,0.13654978332222995,47
2090,4,3954,1585,2369,0,0,0,1.0,1,1.0,1,1.0,1,0.15833630392272594,49
2091,1,3955,1585,2370,0,0,0,1.0,1,1.0,1,1.0,1,0.14944120242334666,49
2092,0,3955,1585,2370,0,0,0,1.0,1,1.0,1,1.0,1,0.14944120242334666,49
2093,2,3957,1586,2371,0,0,0,1.0,1,1.0,1,1.0,1,0.1226998097617234,49
2094,1,3958,1586,2372,0,0,0,1.0,1,1.0,1,1.0,1,0.1165554276757629,49
2095,0,3958,1586,2372,0,0,0,1.0,1,1.0,1,1.0,1,0.10107722555065761,49
2096,0,3958,1586,2372,0,0,0,1.0,1,1.0,1,1.0,1,0.09400921057086646,51
2097,1,3959,1587,2372,0,0,0,1.0,1,1.0,1,1.0,1,0.07663971074884819,51
2098,2,3961,1588,2373,0,0,0,1.0,1,1.0,1,1.0,1,0.06715736779629786,52
2099,2,3963,1589,2374,0,0,0,1.0,1,1.0,1,1.0,1,0.09200254217081245,51
2100,2,3965,1590,2375,0,0,0,1.0,1,1.0,1,1.0,1,0.06616769507148518,51
2101,2,3967,1590,2377,0,0,0,1.0,1,1.0,1,1.0,1,0.0823087061826103,48
2102,3,3970,1593,2377,0,0,0,1.0,1,1.0,1,1.0,1,0.17438390447890512,49
2103,9,3979,1596,2383,0,0,0,1.0,1,1.0,1,1.0,1,0.13029554832634221,48
2104,2,3981,1597,2384,0,0,0,1.0,1,1.0,1,1.0,1,0.1258254774271279,43
2105,2,3983,1598,2385,0,0,0,1.0,1,1.0,1,1.0,1,0.13475032403013856,42
2106,2,3985,1599,2386,0,0,0,1.0,1,1.0,1,1.0,1,0.17002240104971975,40
2107,3,3988,1601,2387,0,0,0,1.0,1,1.0,1,1.0,1,0.15785769230564228,39
2108,3,3991,1603,2388,0,0,0,1.0,1,1.0,1,1.0,1,0.14065051250548255,38
2109,0,3991,1603,2388,0,0,0,1.0,1,1.0,1,1.0,1,0.13224863288498612,37
2110,2,3993,1604,2389,0,0,0,1.0,1,1.0,1,1.0,1,0.11057319115827223,38
2111,1,3994,1605,2389,0,0,0,1.0,1,1.0,1,1.0,1,0.12803614260371057,37
2112,2,3996,1607,2389,0,0,0,1.0,1,1.0,1,1.0,1,0.1861668402675495,36
2113,2,3998,1608,2390,0,0,0,1.0,1,1.0,1,1.0,1,0.24673986379436583,36
2114,2,4000,1609,2391,0,0,0,1.0,1,1.0,1,1.0,1,0.2193206023763298,36
2115,1,4001,1609,2392,0,0,0,1.0,1,1.0,1,1.0,1,0.18947242111351398,35
2116,1,4002,1609,2393,0,0,0,1.0,1,1.0,1,1.0,1,0.16443929096725865,37
2117,1,4003,1609,2394,0,0,0,1.0,1,1.0,1,1.0,1,0.12905733689738993,38
2118,0,4003,1609,2394,0,0,0,1.0,1,1.0,1,1.0,1,0.1381107013155092,40
2119,1,4004,1609,2395,0,0,0,1.0,1,1.0,1,1.0,1,0.13053402372403583,40
2120,1,4005,1610,2395,0,0,0,1.0,1,1.0,1,1.0,1,0.13192732429120407,41
2121,1,4006,1610,2396,0,0,0,1.0,1,1.0,1,1.0,1,0.10670889572115853,41
2122,0,4006,1610,2396,0,0,0,1.0,1,1.0,1,1.0,1,0.10898471376591655,42
2123,0,4006,1610,2396,0,0,0,1.0,1,1.0,1,1.0,1,0.11350852879960648,43
2124,0,4006,1610,2396,0,0,0,1.0,1,1.0,1,1.0,1,0.126447586718814,41
2125,0,4006,1610,2396,0,0,0,1.0,1,1.0,1,1.0,1,0.126447586718814,41
2126,0,4006,1610,2396,0,0,0,1.0,1,1.0,1,1.0,1,0.11657140808667832,40
2127,0,4006,1610,2396,0,0,0,1.0,1,1.0,1,1.0,1,0.11657140808667832,40
2128,0,4006,1610,2396,0,0,0,1.0,1,1.0,1,1.0,1,0.12911925473715583,41
2129,0,4006,1610,2396,0,0,0,1.0,1,1.0,1,1.0,1,0.13119822097355902,42
2130,0,4006,1610,2396,0,0,0,1.0,1,1.0,1,1.0,1,0.153579078868922,45
2131,1,4007,1610,2397,0,0,0,1.0,1,1.0,1,1.0,1,0.1308238212760612,45
2132,2,4009,1610,2399,0,0,0,1.0,1,1.0,1,1.0,1,0.12070987478723635,46
2133,3,4012,1611,2401,0,0,0,1.0,1,1.0,1,1.0,1,0.11694596699327281,46
2134,2,4014,1612,2402,0,0,0,1.0,1,1.0,1,1.0,1,0.09228494061940683,47
2135,0,4014,1612,2402,0,0,0,1.0,1,1.0,1,1.0,1,0.09228494061940683,47
2136,2,4016,1613,2403,0,0,0,1.0,1,1.0,1,1.0,1,0.10042296951242818,47
2137,4,4020,1615,2405,0,0,0,1.0,1,1.0,1,1.0,1,0.10003869724380376,49
2138,0,4020,1615,2405,0,0,0,1.0,1,1.0,1,1.0,1,0.10003869724380376,49
2139,4,4024,1616,2408,0,0,0,1.0,1,1.0,1,1.0,1,0.10112383015844018,47
2140,6,4030,1617,2413,0,0,0,1.0,1,1.0,1,1.0,1,0.13731713728804312,48
2141,4,4034,1618,2416,0,0,0,1.0,1,1.0,1,1.0,1,0.10815390656548622,47
2142,1,4035,1618,2417,0,0,0,1.0,1,1.0,1,1.0,1,0.08198910602236469,47
2143,3,4038,1619,2419,0,0,0,1.0,1,1.0,1,1.0,1,0.09603537097562805,48
2144,4,4042,1623,2419,0,0,0,1.0,1,1.0,1,1.0,1,0.17146140262401263,48
2145,8,4050,1625,2425,0,0,0,1.0,1,1.0,1,1.0,1,0.09883021671605786,46
2146,3,4053,1626,2427,0,0,0,1.0,1,1.0,1,1.0,1,0.1011567251371925,47
2147,4,4057,1628,2429,0,0,0,1.0,1,1.0,1,1.0,1,0.06922118304608532,48
2148,0,4057,1628,2429,0,0,0,1.0,1,1.0,1,1.0,1,0.07500096037854548,46
2149,6,4063,1631,2432,0,0,0,1.0,1,1.0,1,1.0,1,0.14400140326384286,46
2150,3,4066,1633,2433,0,0,0,1.0,1,1.0,1,1.0,1,0.14066209413514652,46
2151,6,4072,1636,2436,0,0,0,1.0,1,1.0,1,1.0,1,0.09521030547919729,44
2152,1,4073,1637,2436,0,0,0,1.0,1,1.0,1,1.0,1,0.1454907779098995,45
2153,2,4075,1638,2437,0,0,0,1.0,1,1.0,1,1.0,1,0.14153861939917864,48
2154,0,4075,1638,2437,0,0,0,1.0,1,1.0,1,1.0,1,0.15997371187581383,47
2155,5,4080,1640,2440,0,0,0,1.0,1,1.0,1,1.0,1,0.15702709529498513,48
2156,1,4081,1641,2440,0,0,0,1.0,1,1.0,1,1.0,1,0.1908824124161252,45
2157,1,4082,1641,2441,0,0,0,1.0,1,1.0,1,1.0,1,0.18991606511695372,43
2158,2,4084,1642,2442,0,0,0,1.0,1,1.0,1,1.0,1,0.17790858344004107,43
2159,4,4088,1644,2444,0,0,0,1.0,1,1.0,1,1.0,1,0.22214507329604027,43
2160,2,4090,1644,2446,0,0,0,1.0,1,1.0,1,1.0,1,0.17173078117462182,41
2161,3,4093,1644,2449,0,0,0,1.0,1,1.0,1,1.0,1,0.11526039120380657,41
2162,2,4095,1645,2450,0,0,0,1.0,1,1.0,1,1.0,1,0.10078691971832136,42
2163,4,4099,1646,2453,0,0,0,1.0,1,1.0,1,1.0,1,0.07780801716696938,43
2164,3,4102,1648,2454,0,0,0,1.0,1,1.0,1,1.0,1,0.16495776490424405,44
2165,4,4106,1648,2458,0,0,0,1.0,1,1.0,1,1.0,1,0.10204243249523862,44
2166,0,4106,1648,2458,0,0,0,1.0,1,1.0,1,1.0,1,0.11682034785648261,46
2167,3,4109,1649,2460,0,0,0,1.0,1,1.0,1,1.0,1,0.0832385699174784,46
2168,0,4109,1649,2460,0,0,0,1.0,1,1.0,1,1.0,1,0.07234415167792112,45
2169,3,4112,1650,2462,0,0,0,1.0,1,1.0,1,1.0,1,0.082517077285684,49
2170,0,4112,1650,2462,0,0,0,1.0,1,1.0,1,1.0,1,0.082517077285684,49
2171,2,4114,1651,2463,0,0,0,1.0,1,1.0,1,1.0,1,0.09479943733774256,51
2172,1,4115,1651,2464,0,0,0,1.0,1,1.0,1,1.0,1,0.080541351649309,52
2173,1,4116,1652,2464,0,0,0,1.0,1,1.0,1,1.0,1,0.11642803247223432,52
2174,3,4119,1654,2465,0,0,0,1.0,1,1.0,1,1.0,1,0.12082674075211867,52
2175,0,4119,1654,2465,0,0,0,1.0,1,1.0,1,1.0,1,0.1315766989263239,53
2176,2,4121,1654,2467,0,0,0,1.0,1,1.0,1,1.0,1,0.09469134419506268,54
2177,3,4124,1657,2467,0,0,0,1.0,1,1.0,1,1.0,1,0.15046547272109576,55
2178,5,4129,1658,2471,0,0,0,1.0,1,1.0,1,1.0,1,0.10961991310889918,54
2179,2,4131,1659,2472,0,0,0,1.0,1,1.0,1,1.0,1,0.10388983877776639,52
2180,2,4133,1660,2473,0,0,0,1.0,1,1.0,1,1.0,1,0.1278870525599972,51
2181,2,4135,1660,2475,0,0,0,1.0,1,1.0,1,1.0,1,0.11582114975511336,49
2182,2,4137,1662,2475,0,0,0,1.0,1,1.0,1,1.0,1,0.13879566767994778,49
2183,6,4143,1666,2477,0,0,0,1.0,1,1.0,1,1.0,1,0.14723762607216248,46
2184,6,4149,1668,2481,0,0,0,1.0,1,1.0,1,1.0,1,0.15842182591434897,45
2185,3,4152,1670,2482,0,0,0,1.0,1,1.0,1,1.0,1,0.1293792389486642,44
2186,6,4158,1674,2484,0,0,0,1.0,1,1.0,1,1.0,1,0.0918478687333145,42
2187,4,4162,1677,2485,0,0,0,1.0,1,1.0,1,1.0,1,0.1671459619550424,40
2188,5,4167,1680,2487,0,0,0,1.0,1,1.0,1,1.0,1,0.14324176023824978,38
2189,3,4170,1682,2488,0,0,0,1.0,1,1.0,1,1.0,1,0.15948896532200432,36
2190,3,4173,1683,2490,0,0,0,1.0,1,1.0,1,1.0,1,0.17282954526120012,34
2191,2,4175,1684,2491,0,0,0,1.0,1,1.0,1,1.0,1,0.08798448039553046,34
2192,2,4177,1686,2491,0,0,0,1.0,1,1.0,1,1.0,1,0.12735147420437157,33
2193,0,4177,1686,2491,0,0,0,1.0,1,1.0,1,1.0,1,0.11835234555867677,32
2194,1,4178,1686,2492,0,0,0,1.0,1,1.0,1,1.0,1,0.08063198695491304,32
2195,0,4178,1686,2492,0,0,0,1.0,1,1.0,1,1.0,1,0.0948054499027408,31
2196,2,4180,1688,2492,0,0,0,1.0,1,1.0,1,1.0,1,0.1414436778164505,32
2197,2,4182,1688,2494,0,0,0,1.0,1,1.0,1,1.0,1,0.08123906195421646,31
2198,0,4182,1688,2494,0,0,0,1.0,1,1.0,1,1.0,1,0.08123906195421646,31
2199,1,4183,1689,2494,0,0,0,1.0,1,1.0,1,1.0,1,0.08599968691969453,32
2200,1,4184,1689,2495,0,0,0,1.0,1,1.0,1,1.0,1,0.10292484189219211,35
2201,1,4185,1689,2496,0,0,0,1.0,1,1.0,1,1.0,1,0.08319203208566824,36
2202,1,4186,1690,2496,0,0,0,1.0,1,1.0,1,1.0,1,0.08936710356278874,36
2203,3,4189,1691,2498,0,0,0,1.0,1,1.0,1,1.0,1,0.05176971133255572,37
2204,2,4191,1693,2498,0,0,0,1.0,1,1.0,1,1.0,1,0.1121844660029804,36
2205,0,4191,1693,2498,0,0,0,1.0,1,1.0,1,1.0,1,0.11708363870844056,37
2206,5,4196,1696,2500,0,0,0,1.0,1,1.0,1,1.0,1,0.1863312875287082,35
2207,5,4201,1698,2503,0,0,0,1.0,1,1.0,1,1.0,1,0.15919158332778105,37
2208,0,4201,1698,2503,0,0,0,1.0,1,1.0,1,1.0,1,0.14517217351877226,36
2209,0,4201,1698,2503,0,0,0,1.0,1,1.0,1,1.0,1,0.15193831569946145,35
2210,1,4202,1698,2504,0,0,0,1.0,1,1.0,1,1.0,1,0.15991438700390576,38
2211,2,4204,1698,2506,0,0,0,1.0,1,1.0,1,1.0,1,0.10903048030833742,37
2212,3,4207,1698,2509,0,0,0,1.0,1,1.0,1,1.0,1,0.11099339300018181,38
2213,1,4208,1698,2510,0,0,0,1.0,1,1.0,1,1.0,1,0.08266469316682912,38
2214,0,4208,1698,2510,0,0,0,1.0,1,1.0,1,1.0,1,0.06363405125109531,39
2215,1,4209,1699,2510,0,0,0,1.0,1,1.0,1,1.0,1,0.11349236408148056,39
2216,1,4210,1700,2510,0,0,0,1.0,1,1.0,1,1.0,1,0.15742755708091824,39
2217,3,4213,1701,2512,0,0,0,1.0,1,1.0,1,1.0,1,0.08062444822580793,38
2218,1,4214,1702,2512,0,0,0,1.0,1,1.0,1,1.0,1,0.08057687345898708,37
2219,0,4214,1702,2512,0,0,0,1.0,1,1.0,1,1.0,1,0.07953336126234146,36
2220,0,4214,1702,2512,0,0,0,1.0,1,1.0,1,1.0,1,0.12173298778514698,34
2221,4,4218,1704,2514,0,0,0,1.0,1,1.0,1,1.0,1,0.10380727593098202,35
2222,1,4219,1705,2514,0,0,0,1.0,1,1.0,1,1.0,1,0.12434959143927292,33
2223,3,4222,1706,2516,0,0,0,1.0,1,1.0,1,1.0,1,0.11188865161667606,34
2224,1,4223,1707,2516,0,0,0,1.0,1,1.0,1,1.0,1,0.15717540397409804,32
2225,7,4230,1709,2521,0,0,0,1.0,1,1.0,1,1.0,1,0.14086141676111902,33
2226,2,4232,1710,2522,0,0,0,1.0,1,1.0,1,1.0,1,0.18877101011373523,32
2227,5,4237,1711,2526,0,0,0,1.0,1,1.0,1,1.0,1,0.13888482561186263,31
2228,0,4237,1711,2526,0,0,0,1.0,1,1.0,1,1.0,1,0.15398230529024332,32
2229,2,4239,1712,2527,0,0,0,1.0,1,1.0,1,1.0,1,0.13348695659893609,32
2230,1,4240,1713,2527,0,0,0,1.0,1,1.0,1,1.0,1,0.15496542115149903,31
2231,0,4240,1713,2527,0,0,0,1.0,1,1.0,1,1.0,1,0.1366257351976987,32
2232,0,4240,1713,2527,0,0,0,1.0,1,1.0,1,1.0,1,0.1489756392388685,32
2233,1,4241,1714,2527,0,0,0,1.0,1,1.0,1,1.0,1,0.18552617601751478,31
2234,2,4243,1715,2528,0,0,0,1.0,1,1.0,1,1.0,1,0.18213752545335674,32
2235,1,4244,1715,2529,0,0,0,1.0,1,1.0,1,1.0,1,0.21449563402899935,31
2236,0,4244,1715,2529,0,0,0,1.0,1,1.0,1,1.0,1,0.21449563402899935,31
2237,3,4247,1716,2531,0,0,0,1.0,1,1.0,1,1.0,1,0.15182645299990738,31
2238,1,4248,1717,2531,0,0,0,1.0,1,1.0,1,1.0,1,0.18089532068710407,31
2239,3,4251,1717,2534,0,0,0,1.0,1,1.0,1,1.0,1,0.10590737097049951,31
2240,0,4251,1717,2534,0,0,0,1.0,1,1.0,1,1.0,1,0.12067659160541115,32
2241,2,4253,1719,2534,0,0,0,1.0,1,1.0,1,1.0,1,0.15885126520607812,32
2242,3,4256,1720,2536,0,0,0,1.0,1,1.0,1,1.0,1,0.09926558330685517,34
2243,5,4261,1723,2538,0,0,0,1.0,1,1.0,1,1.0,1,0.15719979621609004,34
2244,0,4261,1723,2538,0,0,0,1.0,1,1.0,1,1.0,1,0.1684229327087765,36
2245,1,4262,1723,2539,0,0,0,1.0,1,1.0,1,1.0,1,0.1505787825848677,36
2246,1,4263,1723,2540,0,0,0,1.0,1,1.0,1,1.0,1,0.1532848423488566,39
2247,0,4263,1723,2540,0,0,0,1.0,1,1.0,1,1.0,1,0.15003224264262188,40
2248,0,4263,1723,2540,0,0,0,1.0,1,1.0,1,1.0,1,0.15003224264262188,40
2249,1,4264,1723,2541,0,0,0,1.0,1,1.0,1,1.0,1,0.13094690282333174,41
2250,0,4264,1723,2541,0,0,0,1.0,1,1.0,1,1.0,1,0.13094690282333174,41
2251,1,4265,1723,2542,0,0,0,1.0,1,1.0,1,1.0,1,0.14041053479395307,42
2252,1,4266,1723,2543,0,0,0,1.0,1,1.0,1,1.0,1,0.1441466076059912,41
2253,1,4267,1723,2544,0,0,0,1.0,1,1.0,1,1.0,1,0.11456212328967025,40
2254,1,4268,1724,2544,0,0,0,1.0,1,1.0,1,1.0,1,0.14421953201372367,39
2255,3,4271,1724,2547,0,0,0,1.0,1,1.0,1,1.0,1,0.1507759447132584,39
2256,2,4273,1726,2547,0,0,0,1.0,1,1.0,1,1.0,1,0.19723814156996794,40
2257,4,4277,1727,2550,0,0,0,1.0,1,1.0,1,1.0,1,0.15499862517977986,40
2258,2,4279,1729,2550,0,0,0,1.0,1,1.0,1,1.0,1,0.14611480543292824,39
2259,1,4280,1730,2550,0,0,0,1.0,1,1.0,1,1.0,1,0.14526554653235105,41
2260,0,4280,1730,2550,0,0,0,1.0,1,1.0,1,1.0,1,0.16176609853937765,38
2261,1,4281,1731,2550,0,0,0,1.0,1,1.0,1,1.0,1,0.16068950171997273,38
2262,2,4283,1731,2552,0,0,0,1.0,1,1.0,1,1.0,1,0.1804559080342855,36
2263,5,4288,1734,2554,0,0,0,1.0,1,1.0,1,1.0,1,0.18159578820745945,35
2264,4,4292,1737,2555,0,0,0,1.0,1,1.0,1,1.0,1,0.23424442387036068,33
2265,5,4297,1739,2558,0,0,0,1.0,1,1.0,1,1.0,1,0.1788524718940562,33
2266,5,4302,1741,2561,0,0,0,1.0,1,1.0,1,1.0,1,0.24757964978974156,33
2267,5,4307,1743,2564,0,0,0,1.0,1,1.0,1,1.0,1,0.1407192614408091,33
2268,3,4310,1744,2566,0,0,0,1.0,1,1.0,1,1.0,1,0.1592317614676809,35
2269,5,4315,1745,2570,0,0,0,1.0,1,1.0,1,1.0,1,0.052080997218321795,36
2270,0,4315,1745,2570,0,0,0,1.0,1,1.0,1,1.0,1,0.07027984969621032,34
2271,3,4318,1748,2570,0,0,0,1.0,1,1.0,1,1.0,1,0.16265205760340035,34
2272,4,4322,1750,2572,0,0,0,1.0,1,1.0,1,1.0,1,0.1722895075515508,33
2273,3,4325,1752,2573,0,0,0,1.0,1,1.0,1,1.0,1,0.14722506326491505,32
2274,4,4329,1754,2575,0,0,0,1.0,1,1.0,1,1.0,1,0.18833078852678764,32
2275,1,4330,1754,2576,0,0,0,1.0,1,1.0,1,1.0,1,0.198939116276305,32
2276,0,4330,1754,2576,0,0,0,1.0,1,1.0,1,1.0,1,0.1825361951801153,31
2277,2,4332,1755,2577,0,0,0,1.0,1,1.0,1,1.0,1,0.16950031001772076,30
2278,1,4333,1755,2578,0,0,0,1.0,1,1.0,1,1.0,1,0.1418178989683147,33
2279,2,4335,1755,2580,0,0,0,1.0,1,1.0,1,1.0,1,0.10195226715463271,33
2280,0,4335,1755,2580,0,0,0,1.0,1,1.0,1,1.0,1,0.10648804817238994,35
2281,1,4336,1755,2581,0,0,0,1.0,1,1.0,1,1.0,1,0.11765928422654098,36
2282,0,4336,1755,2581,0,0,0,1.0,1,1.0,1,1.0,1,0.11765928422654098,36
2283,1,4337,1756,2581,0,0,0,1.0,1,1.0,1,1.0,1,0.13969257086005066,36
2284,1,4338,1757,2581,0,0,0,1.0,1,1.0,1,1.0,1,0.1433429601249424,36
2285,1,4339,1757,2582,0,0,0,1.0,1,1.0,1,1.0,1,0.10265809276147915,37
2286,1,4340,1758,2582,0,0,0,1.0,1,1.0,1,1.0,1,0.12981956369805492,38
2287,1,4341,1758,2583,0,0,0,1.0,1,1.0,1,1.0,1,0.09288151055360702,38
2288,8,4349,1760,2589,0,0,0,1.0,1,1.0,1,1.0,1,0.13243324758246566,40
2289,4,4353,1760,2593,0,0,0,1.0,1,1.0,1,1.0,1,0.07448602201638346,40
2290,0,4353,1760,2593,0,0,0,1.0,1,1.0,1,1.0,1,0.09375374496083995,39
2291,0,4353,1760,2593,0,0,0,1.0,1,1.0,1,1.0,1,0.09470276480953399,37
2292,1,4354,1761,2593,0,0,0,1.0,1,1.0,1,1.0,1,0.1787060890751949,35
2293,3,4357,1763,2594,0,0,0,1.0,1,1.0,1,1.0,1,0.20953313993776554,35
2294,1,4358,1763,2595,0,0,0,1.0,1,1.0,1,1.0,1,0.1523880720231494,35
2295,1,4359,1763,2596,0,0,0,1.0,1,1.0,1,1.0,1,0.15202764312830394,36
2296,0,4359,1763,2596,0,0,0,1.0,1,1.0,1,1.0,1,0.1833584387163723,34
2297,2,4361,1763,2598,0,0,0,1.0,1,1.0,1,1.0,1,0.17279832914059393,35
2298,0,4361,1763,2598,0,0,0,1.0,1,1.0,1,1.0,1,0.18798527927341738,34
2299,2,4363,1764,2599,0,0,0,1.0,1,1.0,1,1.0,1,0.1879197984403413,35
2300,3,4366,1764,2602,0,0,0,1.0,1,1.0,1,1.0,1,0.16879148368307462,35
2301,0,4366,1764,2602,0,0,0,1.0,1,1.0,1,1.0,1,0.16879148368307462,35
2302,2,4368,1766,2602,0,0,0,1.0,1,1.0,1,1.0,1,0.20849319060423327,37
2303,0,4368,1766,2602,0,0,0,1.0,1,1.0,1,1.0,1,0.16595412764272552,35
2304,1,4369,1767,2602,0,0,0,1.0,1,1.0,1,1.0,1,0.21053880053486518,36
2305,2,4371,1767,2604,0,0,0,1.0,1,1.0,1,1.0,1,0.17416571166761366,34
2306,3,4374,1768,2606,0,0,0,1.0,1,1.0,1,1.0,1,0.1817270848461191,35
2307,1,4375,1768,2607,0,0,0,1.0,1,1.0,1,1.0,1,0.18514510219330885,35
2308,0,4375,1768,2607,0,0,0,1.0,1,1.0,1,1.0,1,0.18514510219330885,35
2309,1,4376,1768,2608,0,0,0,1.0,1,1.0,1,1.0,1,0.16455397842603986,34
2310,1,4377,1769,2608,0,0,0,1.0,1,1.0,1,1.0,1,0.19912987482888259,36
2311,3,4380,1769,2611,0,0,0,1.0,1,1.0,1,1.0,1,0.13860460246555406,38
2312,3,4383,1771,2612,0,0,0,1.0,1,1.0,1,1.0,1,0.18440469867268888,39
2313,4,4387,1772,2615,0,0,0,1.0,1,1.0,1,1.0,1,0.09459007975639418,39
2314,0,4387,1772,2615,0,0,0,1.0,1,1.0,1,1.0,1,0.09459007975639418,39
2315,4,4391,1774,2617,0,0,0,1.0,1,1.0,1,1.0,1,0.12006366896324482,40
2316,2,4393,1774,2619,0,0,0,1.0,1,1.0,1,1.0,1,0.11989893769173991,40
2317,2,4395,1775,2620,0,0,0,1.0,1,1.0,1,1.0,1,0.15223182685510434,41
2318,1,4396,1776,2620,0,0,0,1.0,1,1.0,1,1.0,1,0.1553075002702302,41
2319,3,4399,1776,2623,0,0,0,1.0,1,1.0,1,1.0,1,0.11970782574099344,41
2320,2,4401,1776,2625,0,0,0,1.0,1,1.0,1,1.0,1,0.09107615831810945,42
2321,0,4401,1776,2625,0,0,0,1.0,1,1.0,1,1.0,1,0.08484203541508806,43
2322,0,4401,1776,2625,0,0,0,1.0,1,1.0,1,1.0,1,0.09080955392331524,42
2323,1,4402,1777,2625,0,0,0,1.0,1,1.0,1,1.0,1,0.14154745229543622,43
2324,1,4403,1777,2626,0,0,0,1.0,1,1.0,1,1.0,1,0.15580469005472092,44
2325,3,4406,1778,2628,0,0,0,1.0,1,1.0,1,1.0,1,0.15417001050810225,44
2326,3,4409,1779,2630,0,0,0,1.0,1,1.0,1,1.0,1,0.1579141823858676,45
2327,2,4411,1779,2632,0,0,0,1.0,1,1.0,1,1.0,1,0.12589782815913883,45
2328,1,4412,1780,2632,0,0,0,1.0,1,1.0,1,1.0,1,0.15458506361366123,46
2329,1,4413,1780,2633,0,0,0,1.0,1,1.0,1,1.0,1,0.12461158713685574,45
2330,0,4413,1780,2633,0,0,0,1.0,1,1.0,1,1.0,1,0.10916895143921475,47
2331,0,4413,1780,2633,0,0,0,1.0,1,1.0,1,1.0,1,0.12861561426315474,48
2332,0,4413,1780,2633,0,0,0,1.0,1,1.0,1,1.0,1,0.12861561426315474,48
2333,2,4415,1782,2633,0,0,0,1.0,1,1.0,1,1.0,1,0.16997818220238825,49
2334,3,4418,1783,2635,0,0,0,1.0,1,1.0,1,1.0,1,0.18280148967854756,47
2335,4,4422,1783,2639,0,0,0,1.0,1,1.0,1,1.0,1,0.0933483674716337,46
2336,0,4422,1783,2639,0,0,0,1.0,1,1.0,1,1.0,1,0.10765606284773244,46
2337,0,4422,1783,2639,0,0,0,1.0,1,1.0,1,1.0,1,0.1100459769474815,45
2338,1,4423,1784,2639,0,0,0,1.0,1,1.0,1,1.0,1,0.115983407781664,44
2339,2,4425,1785,2640,0,0,0,1.0,1,1.0,1,1.0,1,0.11256057583109919,45
2340,1,4426,1786,2640,0,0,0,1.0,1,1.0,1,1.0,1,0.09653019374133028,44
2341,1,4427,1786,2641,0,0,0,1.0,1,1.0,1,1.0,1,0.10057557795391077,45
2342,2,4429,1788,2641,0,0,0,1.0,1,1.0,1,1.0,1,0.09770255999119251,47
2343,2,4431,1788,2643,0,0,0,1.0,1,1.0,1,1.0,1,0.06260159504847661,46
2344,1,4432,1789,2643,0,0,0,1.0,1,1.0,1,1.0,1,0.09590494956093377,46
2345,0,4432,1789,2643,0,0,0,1.0,1,1.0,1,1.0,1,0.10975283421004202,45
2346,0,4432,1789,2643,0,0,0,1.0,1,1.0,1,1.0,1,0.09733190202843993,46
2347,0,4432,1789,2643,0,0,0,1.0,1,1.0,1,1.0,1,0.10181252473300913,47
2348,3,4435,1790,2645,0,0,0,1.0,1,1.0,1,1.0,1,0.10876302890274561,49
2349,2,4437,1791,2646,0,0,0,1.0,1,1.0,1,1.0,1,0.13412817996188903,49
2350,0,4437,1791,2646,0,0,0,1.0,1,1.0,1,1.0,1,0.11580622757018563,50
2351,1,4438,1792,2646,0,0,0,1.0,1,1.0,1,1.0,1,0.13586219428267804,50
2352,1,4439,1792,2647,0,0,0,1.0,1,1.0,1,1.0,1,0.14143333355672405,51
2353,1,4440,1792,2648,0,0,0,1.0,1,1.0,1,1.0,1,0.12100718178143105,51
2354,0,4440,1792,2648,0,0,0,1.0,1,1.0,1,1.0,1,0.13398636438135944,51
2355,6,4446,1794,2652,0,0,0,1.0,1,1.0,1,1.0,1,0.10367007383068728,50
2356,0,4446,1794,2652,0,0,0,1.0,1,1.0,1,1.0,1,0.10367007383068728,50
2357,0,4446,1794,2652,0,0,0,1.0,1,1.0,1,1.0,1,0.09237762061762535,49
2358,2,4448,1794,2654,0,0,0,1.0,1,1.0,1,1.0,1,0.09225839558268505,51
2359,1,4449,1794,2655,0,0,0,1.0,1,1.0,1,1.0,1,0.08501522322728401,51
2360,2,4451,1795,2656,0,0,0,1.0,1,1.0,1,1.0,1,0.09012969350047746,51
2361,1,4452,1796,2656,0,0,0,1.0,1,1.0,1,1.0,1,0.14014548811664193,52
2362,4,4456,1798,2658,0,0,0,1.0,1,1.0,1,1.0,1,0.1360975675015726,53
2363,3,4459,1799,2660,0,0,0,1.0,1,1.0,1,1.0,1,0.10478110763353263,54
2364,1,4460,1799,2661,0,0,0,1.0,1,1.0,1,1.0,1,0.10159230909924637,55
2365,6,4466,1803,2663,0,0,0,1.0,1,1.0,1,1.0,1,0.13406690139213864,53
2366,3,4469,1805,2664,0,0,0,1.0,1,1.0,1,1.0,1,0.1336673691028521,53
2367,1,4470,1806,2664,0,0,0,1.0,1,1.0,1,1.0,1,0.19308607525503257,51
2368,4,4474,1808,2666,0,0,0,1.0,1,1.0,1,1.0,1,0.19291093110297197,50
2369,6,4480,1809,2671,0,0,0,1.0,1,1.0,1,1.0,1,0.20602345189799776,47
2370,2,4482,1809,2673,0,0,0,1.0,1,1.0,1,1.0,1,0.19806315796003252,48
2371,1,4483,1809,2674,0,0,0,1.0,1,1.0,1,1.0,1,0.20944433292567233,49
2372,0,4483,1809,2674,0,0,0,1.0,1,1.0,1,1.0,1,0.2262575446157499,48
2373,0,4483,1809,2674,0,0,0,1.0,1,1.0,1,1.0,1,0.23481715335884823,49
2374,2,4485,1809,2676,0,0,0,1.0,1,1.0,1,1.0,1,0.20526246871302822,50
2375,2,4487,1810,2677,0,0,0,1.0,1,1.0,1,1.0,1,0.2051037799665074,50
2376,1,4488,1810,2678,0,0,0,1.0,1,1.0,1,1.0,1,0.20714760932785176,50
2377,1,4489,1810,2679,0,0,0,1.0,1,1.0,1,1.0,1,0.2105607310439606,49
2378,2,4491,1810,2681,0,0,0,1.0,1,1.0,1,1.0,1,0.19022044195411483,49
2379,3,4494,1811,2683,0,0,0,1.0,1,1.0,1,1.0,1,0.19431821338080105,50
2380,3,4497,1812,2685,0,0,0,1.0,1,1.0,1,1.0,1,0.20484449840058322,50
2381,2,4499,1813,2686,0,0,0,1.0,1,1.0,1,1.0,1,0.20559203404722948,51
2382,3,4502,1814,2688,0,0,0,1.0,1,1.0,1,1.0,1,0.19665867151547012,51
2383,6,4508,1815,2693,0,0,0,1.0,1,1.0,1,1.0,1,0.1423613419829786,52
2384,0,4508,1815,2693,0,0,0,1.0,1,1.0,1,1.0,1,0.11474540422304373,52
2385,3,4511,1816,2695,0,0,0,1.0,1,1.0,1,1.0,1,0.13534211365730325,51
2386,3,4514,1818,2696,0,0,0,1.0,1,1.0,1,1.0,1,0.16767158532869111,52
2387,3,4517,1819,2698,0,0,0,1.0,1,1.0,1,1.0,1,0.18179725549065162,49
2388,4,4521,1820,2701,0,0,0,1.0,1,1.0,1,1.0,1,0.15237698105287567,48
2389,3,4524,1821,2703,0,0,0,1.0,1,1.0,1,1.0,1,0.11191617142990085,48
2390,2,4526,1822,2704,0,0,0,1.0,1,1.0,1,1.0,1,0.10336594462085932,49
2391,3,4529,1825,2704,0,0,0,1.0,1,1.0,1,1.0,1,0.16977370297307195,48
2392,3,4532,1827,2705,0,0,0,1.0,1,1.0,1,1.0,1,0.17145824562477543,49
2393,5,4537,1828,2709,0,0,0,1.0,1,1.0,1,1.0,1,0.15342837055660136,50
2394,3,4540,1830,2710,0,0,0,1.0,1,1.0,1,1.0,1,0.1841965013426058,50
2395,1,4541,1830,2711,0,0,0,1.0,1,1.0,1,1.0,1,0.158246635690906,49
2396,3,4544,1831,2713,0,0,0,1.0,1,1.0,1,1.0,1,0.14844363669621408,50
2397,2,4546,1833,2713,0,0,0,1.0,1,1.0,1,1.0,1,0.19339941944532785,51
2398,1,4547,1833,2714,0,0,0,1.0,1,1.0,1,1.0,1,0.1409523748965697,49
2399,1,4548,1833,2715,0,0,0,1.0,1,1.0,1,1.0,1,0.1260243795513176,50
2400,1,4549,1834,2715,0,0,0,1.0,1,1.0,1,1.0,1,0.16497819879640535,51
2401,2,4551,1834,2717,0,0,0,1.0,1,1.0,1,1.0,1,0.15749053659147996,50
2402,1,4552,1834,2718,0,0,0,1.0,1,1.0,1,1.0,1,0.14087521842489453,51
2403,0,4552,1834,2718,0,0,0,1.0,1,1.0,1,1.0,1,0.14203127128593016,52
2404,2,4554,1834,2720,0,0,0,1.0,1,1.0,1,1.0,1,0.10648746036335918,53
2405,2,4556,1834,2722,0,0,0,1.0,1,1.0,1,1.0,1,0.10558743751856306,52
2406,1,4557,1835,2722,0,0,0,1.0,1,1.0,1,1.0,1,0.11523297644981463,52
2407,0,4557,1835,2722,0,0,0,1.0,1,1.0,1,1.0,1,0.1314162101611252,51
2408,1,4558,1836,2722,0,0,0,1.0,1,1.0,1,1.0,1,0.1540083304300658,50
2409,0,4558,1836,2722,0,0,0,1.0,1,1.0,1,1.0,1,0.1666403620239102,50
2410,2,4560,1837,2723,0,0,0,1.0,1,1.0,1,1.0,1,0.18823282853884768,49
2411,0,4560,1837,2723,0,0,0,1.0,1,1.0,1,1.0,1,0.19473507380934757,48
2412,1,4561,1837,2724,0,0,0,1.0,1,1.0,1,1.0,1,0.20793648174510812,47
2413,2,4563,1837,2726,0,0,0,1.0,1,1.0,1,1.0,1,0.17129660586891984,47
2414,2,4565,1838,2727,0,0,0,1.0,1,1.0,1,1.0,1,0.23833620331116756,47
2415,4,4569,1838,2731,0,0,0,1.0,1,1.0,1,1.0,1,0.2023754548832733,46
2416,1,4570,1838,2732,0,0,0,1.0,1,1.0,1,1.0,1,0.18198016842172923,47
2417,2,4572,1839,2733,0,0,0,1.0,1,1.0,1,1.0,1,0.19242723320928923,46
2418,3,4575,1840,2735,0,0,0,1.0,1,1.0,1,1.0,1,0.19058228857781526,48
2419,3,4578,1841,2737,0,0,0,1.0,1,1.0,1,1.0,1,0.17649988483390455,47
2420,2,4580,1841,2739,0,0,0,1.0,1,1.0,1,1.0,1,0.13426597527109346,49
2421,0,4580,1841,2739,0,0,0,1.0,1,1.0,1,1.0,1,0.12927453913486364,50
2422,5,4585,1844,2741,0,0,0,1.0,1,1.0,1,1.0,1,0.11142409691232716,50
2423,0,4585,1844,2741,0,0,0,1.0,1,1.0,1,1.0,1,0.12668846928385108,51
2424,2,4587,1846,2741,0,0,0,1.0,1,1.0,1,1.0,1,0.1413732481223974,50
2425,1,4588,1846,2742,0,0,0,1.0,1,1.0,1,1.0,1,0.1450200260605279,48
2426,4,4592,1849,2743,0,0,0,1.0,1,1.0,1,1.0,1,0.13509720240940026,51
2427,2,4594,1850,2744,0,0,0,1.0,1,1.0,1,1.0,1,0.11491801311235375,50
2428,5,4599,1854,2745,0,0,0,1.0,1,1.0,1,1.0,1,0.13641831438227398,49
2429,2,4601,1855,2746,0,0,0,1.0,1,1.0,1,1.0,1,0.15790988463529906,49
2430,0,4601,1855,2746,0,0,0,1.0,1,1.0,1,1.0,1,0.17052096693282043,46
2431,1,4602,1855,2747,0,0,0,1.0,1,1.0,1,1.0,1,0.15162448353294433,45
2432,4,4606,1856,2750,0,0,0,1.0,1,1.0,1,1.0,1,0.19609099224967227,44
2433,1,4607,1856,2751,0,0,0,1.0,1,1.0,1,1.0,1,0.12403869711658339,45
2434,1,4608,1857,2751,0,0,0,1.0,1,1.0,1,1.0,1,0.15198955574479422,44
2435,0,4608,1857,2751,0,0,0,1.0,1,1.0,1,1.0,1,0.15198955574479422,44
2436,1,4609,1858,2751,0,0,0,1.0,1,1.0,1,1.0,1,0.1644208693410183,44
2437,3,4612,1859,2753,0,0,0,1.0,1,1.0,1,1.0,1,0.13391082933585746,45
2438,2,4614,1860,2754,0,0,0,1.0,1,1.0,1,1.0,1,0.135788687255108,45
2439,2,4616,1860,2756,0,0,0,1.0,1,1.0,1,1.0,1,0.1269150152478976,46
2440,0,4616,1860,2756,0,0,0,1.0,1,1.0,1,1.0,1,0.14146604622489328,45
2441,3,4619,1861,2758,0,0,0,1.0,1,1.0,1,1.0,1,0.12623949129731055,45
2442,0,4619,1861,2758,0,0,0,1.0,1,1.0,1,1.0,1,0.11969589997509804,46
2443,1,4620,1861,2759,0,0,0,1.0,1,1.0,1,1.0,1,0.12599977759145634,45
2444,3,4623,1863,2760,0,0,0,1.0,1,1.0,1,1.0,1,0.1539768266606165,46
2445,3,4626,1863,2763,0,0,0,1.0,1,1.0,1,1.0,1,0.13314068273337537,44
2446,3,4629,1864,2765,0,0,0,1.0,1,1.0,1,1.0,1,0.14108411529615558,44
2447,5,4634,1865,2769,0,0,0,1.0,1,1.0,1,1.0,1,0.14054569193405322,42
2448,3,4637,1868,2769,0,0,0,1.0,1,1.0,1,1.0,1,0.1618960993999769,41
2449,2,4639,1869,2770,0,0,0,1.0,1,1.0,1,1.0,1,0.14563844010758087,40
2450,3,4642,1871,2771,0,0,0,1.0,1,1.0,1,1.0,1,0.12814088551380584,42
2451,0,4642,1871,2771,0,0,0,1.0,1,1.0,1,1.0,1,0.12429926846266257,43
2452,0,4642,1871,2771,0,0,0,1.0,1,1.0,1,1.0,1,0.12429926846266257,43
2453,1,4643,1871,2772,0,0,0,1.0,1,1.0,1,1.0,1,0.1472952788316694,45
2454,2,4645,1873,2772,0,0,0,1.0,1,1.0,1,1.0,1,0.19477047774203743,47
2455,1,4646,1873,2773,0,0,0,1.0,1,1.0,1,1.0,1,0.1771016870357536,48
2456,4,4650,1875,2775,0,0,0,1.0,1,1.0,1,1.0,1,0.2040227546609991,49
2457,2,4652,1876,2776,0,0,0,1.0,1,1.0,1,1.0,1,0.23659230004256276,48
2458,1,4653,1877,2776,0,0,0,1.0,1,1.0,1,1.0,1,0.23408983453856438,49
2459,4,4657,1877,2780,0,0,0,1.0,1,1.0,1,1.0,1,0.15494644814912664,49
2460,4,4661,1879,2782,0,0,0,1.0,1,1.0,1,1.0,1,0.18923408654004434,50
2461,1,4662,1879,2783,0,0,0,1.0,1,1.0,1,1.0,1,0.17829715522477657,50
2462,3,4665,1881,2784,0,0,0,1.0,1,1.0,1,1.0,1,0.2134976109089058,51
2463,4,4669,1883,2786,0,0,0,1.0,1,1.0,1,1.0,1,0.21025682678923294,51
2464,3,4672,1886,2786,0,0,0,1.0,1,1.0,1,1.0,1,0.18650410635058373,50
2465,3,4675,1888,2787,0,0,0,1.0,1,1.0,1,1.0,1,0.19094640015198974,49
2466,3,4678,1889,2789,0,0,0,1.0,1,1.0,1,1.0,1,0.16656277745232542,49
2467,2,4680,1889,2791,0,0,0,1.0,1,1.0,1,1.0,1,0.1162078577917213,48
2468,1,4681,1890,2791,0,0,0,1.0,1,1.0,1,1.0,1,0.14901198870718627,47
2469,3,4684,1891,2793,0,0,0,1.0,1,1.0,1,1.0,1,0.10578497629010673,46
2470,1,4685,1891,2794,0,0,0,1.0,1,1.0,1,1.0,1,0.1299719851662014,44
2471,1,4686,1891,2795,0,0,0,1.0,1,1.0,1,1.0,1,0.13957963451228436,44
2472,3,4689,1891,2798,0,0,0,1.0,1,1.0,1,1.0,1,0.11412453096549392,44
2473,1,4690,1891,2799,0,0,0,1.0,1,1.0,1,1.0,1,0.12057235377198061,43
2474,3,4693,1893,2800,0,0,0,1.0,1,1.0,1,1.0,1,0.1523045531677174,44
2475,3,4696,1894,2802,0,0,0,1.0,1,1.0,1,1.0,1,0.12172997486824974,46
2476,2,4698,1894,2804,0,0,0,1.0,1,1.0,1,1.0,1,0.08765732850494881,46
2477,0,4698,1894,2804,0,0,0,1.0,1,1.0,1,1.0,1,0.08765732850494881,46
2478,0,4698,1894,2804,0,0,0,1.0,1,1.0,1,1.0,1,0.08765732850494881,46
2479,0,4698,1894,2804,0,0,0,1.0,1,1.0,1,1.0,1,0.08765732850494881,46
2480,2,4700,1895,2805,0,0,0,1.0,1,1.0,1,1.0,1,0.10597372695539722,47
2481,3,4703,1897,2806,0,0,0,1.0,1,1.0,1,1.0,1,0.09598694792966483,47
2482,1,4704,1898,2806,0,0,0,1.0,1,1.0,1,1.0,1,0.12899730263581272,45
2483,1,4705,1898,2807,0,0,0,1.0,1,1.0,1,1.0,1,0.1263291025748457,45
2484,1,4706,1899,2807,0,0,0,1.0,1,1.0,1,1.0,1,0.14395448141875877,46
2485,1,4707,1900,2807,0,0,0,1.0,1,1.0,1,1.0,1,0.15506760165387218,44
2486,0,4707,1900,2807,0,0,0,1.0,1,1.0,1,1.0,1,0.16216190927477583,43
2487,0,4707,1900,2807,0,0,0,1.0,1,1.0,1,1.0,1,0.15569068970201808,44
2488,4,4711,1903,2808,0,0,0,1.0,1,1.0,1,1.0,1,0.16440140662711467,45
2489,2,4713,1903,2810,0,0,0,1.0,1,1.0,1,1.0,1,0.17016940928575014,44
2490,3,4716,1904,2812,0,0,0,1.0,1,1.0,1,1.0,1,0.1358849998679185,44
2491,2,4718,1904,2814,0,0,0,1.0,1,1.0,1,1.0,1,0.17780228180248125,44
2492,0,4718,1904,2814,0,0,0,1.0,1,1.0,1,1.0,1,0.17780228180248125,44
2493,0,4718,1904,2814,0,0,0,1.0,1,1.0,1,1.0,1,0.21685228116503663,42
2494,2,4720,1906,2814,0,0,0,1.0,1,1.0,1,1.0,1,0.24481819727906348,42
2495,3,4723,1906,2817,0,0,0,1.0,1,1.0,1,1.0,1,0.16671715709844562,42
2496,1,4724,1907,2817,0,0,0,1.0,1,1.0,1,1.0,1,0.15181392241491076,42
2497,0,4724,1907,2817,0,0,0,1.0,1,1.0,1,1.0,1,0.15943062592870372,44
2498,1,4725,1907,2818,0,0,0,1.0,1,1.0,1,1.0,1,0.14631793218622172,43
2499,0,4725,1907,2818,0,0,0,1.0,1,1.0,1,1.0,1,0.14631793218622172,43
2500,4,4729,1909,2820,0,0,0,1.0,1,1.0,1,1.0,1,0.1207423104390141,44
2501,2,4731,1910,2821,0,0,0,1.0,1,1.0,1,1.0,1,0.10599339481306663,46
2502,3,4734,1911,2823,0,0,0,1.0,1,1.0,1,1.0,1,0.10860657113798862,47
2503,2,4736,1913,2823,0,0,0,1.0,1,1.0,1,1.0,1,0.14777216219939804,47
2504,1,4737,1914,2823,0,0,0,1.0,1,1.0,1,1.0,1,0.17641281006666817,46
2505,7,4744,1918,2826,0,0,0,1.0,1,1.0,1,1.0,1,0.16412235227226332,46
2506,1,4745,1918,2827,0,0,0,1.0,1,1.0,1,1.0,1,0.14428347169966887,45
2507,3,4748,1919,2829,0,0,0,1.0,1,1.0,1,1.0,1,0.1689439290885244,45
2508,2,4750,1920,2830,0,0,0,1.0,1,1.0,1,1.0,1,0.1666084177410795,46
2509,4,4754,1921,2833,0,0,0,1.0,1,1.0,1,1.0,1,0.09686460268260519,45
2510,3,4757,1923,2834,0,0,0,1.0,1,1.0,1,1.0,1,0.138298373806043,46
2511,4,4761,1923,2838,0,0,0,1.0,1,1.0,1,1.0,1,0.09331818903707075,47
2512,3,4764,1924,2840,0,0,0,1.0,1,1.0,1,1.0,1,0.12756900993093218,47
2513,2,4766,1924,2842,0,0,0,1.0,1,1.0,1,1.0,1,0.09369866449937915,48
2514,2,4768,1926,2842,0,0,0,1.0,1,1.0,1,1.0,1,0.1651894134360854,48
2515,4,4772,1926,2846,0,0,0,1.0,1,1.0,1,1.0,1,0.10755828757677036,49
2516,1,4773,1927,2846,0,0,0,1.0,1,1.0,1,1.0,1,0.12349832451194587,49
2517,4,4777,1929,2848,0,0,0,1.0,1,1.0,1,1.0,1,0.10376928860047357,49
2518,1,4778,1930,2848,0,0,0,1.0,1,1.0,1,1.0,1,0.12838334511960955,48
2519,2,4780,1930,2850,0,0,0,1.0,1,1.0,1,1.0,1,0.08437435296935526,48
2520,1,4781,1931,2850,0,0,0,1.0,1,1.0,1,1.0,1,0.12635613369543203,46
2521,3,4784,1933,2851,0,0,0,1.0,1,1.0,1,1.0,1,0.16808271584768888,47
2522,1,4785,1933,2852,0,0,0,1.0,1,1.0,1,1.0,1,0.18651951970576525,45
2523,4,4789,1935,2854,0,0,0,1.0,1,1.0,1,1.0,1,0.2055931488872414,44
2524,0,4789,1935,2854,0,0,0,1.0,1,1.0,1,1.0,1,0.19830179503843645,42
2525,4,4793,1936,2857,0,0,0,1.0,1,1.0,1,1.0,1,0.18970364561601005,42
2526,0,4793,1936,2857,0,0,0,1.0,1,1.0,1,1.0,1,0.1943948727547256,41
2527,2,4795,1936,2859,0,0,0,1.0,1,1.0,1,1.0,1,0.15949493767201417,41
2528,1,4796,1936,2860,0,0,0,1.0,1,1.0,1,1.0,1,0.13765891847917233,41
2529,1,4797,1937,2860,0,0,0,1.0,1,1.0,1,1.0,1,0.15096618078113203,42
2530,0,4797,1937,2860,0,0,0,1.0,1,1.0,1,1.0,1,0.15948269566359027,41
2531,0,4797,1937,2860,0,0,0,1.0,1,1.0,1,1.0,1,0.15948269566359027,41
2532,1,4798,1937,2861,0,0,0,1.0,1,1.0,1,1.0,1,0.16553232903934004,43
2533,1,4799,1937,2862,0,0,0,1.0,1,1.0,1,1.0,1,0.15606962937053245,43
2534,0,4799,1937,2862,0,0,0,1.0,1,1.0,1,1.0,1,0.15606962937053245,43
2535,2,4801,1938,2863,0,0,0,1.0,1,1.0,1,1.0,1,0.18117200840404285,44
2536,1,4802,1938,2864,0,0,0,1.0,1,1.0,1,1.0,1,0.17675406782726144,44
2537,1,4803,1939,2864,0,0,0,1.0,1,1.0,1,1.0,1,0.2067524921845861,45
2538,1,4804,1939,2865,0,0,0,1.0,1,1.0,1,1.0,1,0.20832724676859038,48
2539,5,4809,1941,2868,0,0,0,1.0,1,1.0,1,1.0,1,0.22138118538986562,48
2540,3,4812,1942,2870,0,0,0,1.0,1,1.0,1,1.0,1,0.21918907180388492,50
2541,2,4814,1942,2872,0,0,0,1.0,1,1.0,1,1.0,1,0.20033230572246372,52
2542,6,4820,1946,2874,0,0,0,1.0,1,1.0,1,1.0,1,0.25607701513207015,52
2543,6,4826,1947,2879,0,0,0,1.0,1,1.0,1,1.0,1,0.20552745105788522,51
2544,4,4830,1950,2880,0,0,0,1.0,1,1.0,1,1.0,1,0.19682363108066836,51
2545,2,4832,1951,2881,0,0,0,1.0,1,1.0,1,1.0,1,0.18672766448729042,50
2546,2,4834,1952,2882,0,0,0,1.0,1,1.0,1,1.0,1,0.18185274346279762,50
2547,3,4837,1953,2884,0,0,0,1.0,1,1.0,1,1.0,1,0.17242012125126066,47
2548,0,4837,1953,2884,0,0,0,1.0,1,1.0,1,1.0,1,0.1566613084703088,46
2549,4,4841,1956,2885,0,0,0,1.0,1,1.0,1,1.0,1,0.15653917405463458,46
2550,3,4844,1958,2886,0,0,0,1.0,1,1.0,1,1.0,1,0.16291841363196655,44
2551,3,4847,1958,2889,0,0,0,1.0,1,1.0,1,1.0,1,0.08477268921522899,43
2552,0,4847,1958,2889,0,0,0,1.0,1,1.0,1,1.0,1,0.12186086983772755,43
2553,0,4847,1958,2889,0,0,0,1.0,1,1.0,1,1.0,1,0.13151233287954167,44
2554,1,4848,1959,2889,0,0,0,1.0,1,1.0,1,1.0,1,0.14526395389470653,45
2555,5,4853,1960,2893,0,0,0,1.0,1,1.0,1,1.0,1,0.1069892905661053,44
2556,0,4853,1960,2893,0,0,0,1.0,1,1.0,1,1.0,1,0.11584284727694986,44
2557,1,4854,1961,2893,0,0,0,1.0,1,1.0,1,1.0,1,0.1497270053990087,41
2558,0,4854,1961,2893,0,0,0,1.0,1,1.0,1,1.0,1,0.1543012720547807,40
2559,1,4855,1961,2894,0,0,0,1.0,1,1.0,1,1.0,1,0.14793171343764264,41
2560,0,4855,1961,2894,0,0,0,1.0,1,1.0,1,1.0,1,0.14793171343764264,41
2561,4,4859,1961,2898,0,0,0,1.0,1,1.0,1,1.0,1,0.13033249604177546,43
2562,3,4862,1962,2900,0,0,0,1.0,1,1.0,1,1.0,1,0.14221705033014914,44
2563,0,4862,1962,2900,0,0,0,1.0,1,1.0,1,1.0,1,0.14221705033014914,44
2564,2,4864,1964,2900,0,0,0,1.0,1,1.0,1,1.0,1,0.16124704111087174,44
2565,0,4864,1964,2900,0,0,0,1.0,1,1.0,1,1.0,1,0.15359358630691408,45
2566,2,4866,1965,2901,0,0,0,1.0,1,1.0,1,1.0,1,0.1872839094614231,46
2567,2,4868,1966,2902,0,0,0,1.0,1,1.0,1,1.0,1,0.18757020942418884,48
2568,2,4870,1967,2903,0,0,0,1.0,1,1.0,1,1.0,1,0.20773689582321486,48
2569,4,4874,1967,2907,0,0,0,1.0,1,1.0,1,1.0,1,0.1872081067757351,49
2570,2,4876,1967,2909,0,0,0,1.0,1,1.0,1,1.0,1,0.1933294139911566,48
2571,3,4879,1967,2912,0,0,0,1.0,1,1.0,1,1.0,1,0.15431928421928962,48
2572,1,4880,1967,2913,0,0,0,1.0,1,1.0,1,1.0,1,0.13006344561003322,49
2573,1,4881,1967,2914,0,0,0,1.0,1,1.0,1,1.0,1,0.11277757386153135,50
2574,2,4883,1968,2915,0,0,0,1.0,1,1.0,1,1.0,1,0.13081723724236746,49
2575,1,4884,1968,2916,0,0,0,1.0,1,1.0,1,1.0,1,0.12784115555361153,48
2576,0,4884,1968,2916,0,0,0,1.0,1,1.0,1,1.0,1,0.12784115555361153,48
2577,0,4884,1968,2916,0,0,0,1.0,1,1.0,1,1.0,1,0.15604640431719505,50
2578,2,4886,1969,2917,0,0,0,1.0,1,1.0,1,1.0,1,0.1554777726466333,50
2579,3,4889,1970,2919,0,0,0,1.0,1,1.0,1,1.0,1,0.12593316493050496,51
2580,3,4892,1972,2920,0,0,0,1.0,1,1.0,1,1.0,1,0.14227719864284383,52
2581,2,4894,1972,2922,0,0,0,1.0,1,1.0,1,1.0,1,0.1292031672503199,51
2582,3,4897,1974,2923,0,0,0,1.0,1,1.0,1,1.0,1,0.14202278708879773,51
2583,3,4900,1975,2925,0,0,0,1.0,1,1.0,1,1.0,1,0.145884095154866,51
2584,6,4906,1978,2928,0,0,0,1.0,1,1.0,1,1.0,1,0.1295086308506489,51
2585,2,4908,1979,2929,0,0,0,1.0,1,1.0,1,1.0,1,0.11200579999686966,50
2586,2,4910,1981,2929,0,0,0,1.0,1,1.0,1,1.0,1,0.1175071433148644,50
2587,2,4912,1983,2929,0,0,0,1.0,1,1.0,1,1.0,1,0.10540112166089571,48
2588,5,4917,1984,2933,0,0,0,1.0,1,1.0,1,1.0,1,0.09845141786802131,50
2589,2,4919,1985,2934,0,0,0,1.0,1,1.0,1,1.0,1,0.050608799676273665,48
2590,0,4919,1985,2934,0,0,0,1.0,1,1.0,1,1.0,1,0.06300054312309135,47
2591,0,4919,1985,2934,0,0,0,1.0,1,1.0,1,1.0,1,0.06300054312309135,47
2592,1,4920,1986,2934,0,0,0,1.0,1,1.0,1,1.0,1,0.052740954274712794,47
2593,2,4922,1987,2935,0,0,0,1.0,1,1.0,1,1.0,1,0.05662568630810199,47
2594,5,4927,1988,2939,0,0,0,1.0,1,1.0,1,1.0,1,0.06755059447360268,49
2595,3,4930,1990,2940,0,0,0,1.0,1,1.0,1,1.0,1,0.09423376435245834,48
2596,1,4931,1991,2940,0,0,0,1.0,1,1.0,1,1.0,1,0.10883456627131381,47
2597,2,4933,1993,2940,0,0,0,1.0,1,1.0,1,1.0,1,0.10020818507305927,48
2598,2,4935,1994,2941,0,0,0,1.0,1,1.0,1,1.0,1,0.10526271038463864,48
2599,3,4938,1995,2943,0,0,0,1.0,1,1.0,1,1.0,1,0.0787891058967293,49
2600,0,4938,1995,2943,0,0,0,1.0,1,1.0,1,1.0,1,0.08521660133007178,52
2601,5,4943,1997,2946,0,0,0,1.0,1,1.0,1,1.0,1,0.1257906405366679,51
2602,2,4945,1998,2947,0,0,0,1.0,1,1.0,1,1.0,1,0.13835947672457144,52
2603,3,4948,1999,2949,0,0,0,1.0,1,1.0,1,1.0,1,0.15665237538591817,53
2604,0,4948,1999,2949,0,0,0,1.0,1,1.0,1,1.0,1,0.15665237538591817,53
2605,4,4952,2000,2952,0,0,0,1.0,1,1.0,1,1.0,1,0.1585851396812769,52
2606,3,4955,2000,2955,0,0,0,1.0,1,1.0,1,1.0,1,0.14264327875035313,52
2607,2,4957,2000,2957,0,0,0,1.0,1,1.0,1,1.0,1,0.11845398071062459,52
2608,1,4958,2000,2958,0,0,0,1.0,1,1.0,1,1.0,1,0.11562784455139573,52
2609,1,4959,2001,2958,0,0,0,1.0,1,1.0,1,1.0,1,0.10827656854634607,53
2610,2,4961,2001,2960,0,0,0,1.0,1,1.0,1,1.0,1,0.1048832336965063,54
2611,5,4966,2003,2963,0,0,0,1.0,1,1.0,1,1.0,1,0.09420160539019058,54
2612,1,4967,2004,2963,0,0,0,1.0,1,1.0,1,1.0,1,0.10176460816237345,56
2613,4,4971,2006,2965,0,0,0,1.0,1,1.0,1,1.0,1,0.08569721743809675,56
2614,2,4973,2007,2966,0,0,0,1.0,1,1.0,1,1.0,1,0.0839055101642366,56
2615,0,4973,2007,2966,0,0,0,1.0,1,1.0,1,1.0,1,0.07144447216617994,57
2616,0,4973,2007,2966,0,0,0,1.0,1,1.0,1,1.0,1,0.07144447216617994,57
2617,2,4975,2008,2967,0,0,0,1.0,1,1.0,1,1.0,1,0.08237275607368409,58
2618,2,4977,2009,2968,0,0,0,1.0,1,1.0,1,1.0,1,0.060230513312948535,58
2619,1,4978,2009,2969,0,0,0,1.0,1,1.0,1,1.0,1,0.08500362651221259,58
2620,1,4979,2009,2970,0,0,0,1.0,1,1.0,1,1.0,1,0.08557916682981254,60
2621,1,4980,2009,2971,0,0,0,1.0,1,1.0,1,1.0,1,0.061545674004202654,59
2622,1,4981,2010,2971,0,0,0,1.0,1,1.0,1,1.0,1,0.08459642907193954,60
2623,5,4986,2012,2974,0,0,0,1.0,1,1.0,1,1.0,1,0.054430697642868654,59
2624,3,4989,2015,2974,0,0,0,1.0,1,1.0,1,1.0,1,0.09895159089911479,58
2625,4,4993,2018,2975,0,0,0,1.0,1,1.0,1,1.0,1,0.11779851381659966,58
2626,5,4998,2020,2978,0,0,0,1.0,1,1.0,1,1.0,1,0.06108731456614667,57
2627,0,4998,2020,2978,0,0,0,1.0,1,1.0,1,1.0,1,0.06985781598334449,55
2628,3,5001,2023,2978,0,0,0,1.0,1,1.0,1,1.0,1,0.10775884218848807,55
2629,0,5001,2023,2978,0,0,0,1.0,1,1.0,1,1.0,1,0.1074052408074705,54
2630,2,5003,2024,2979,0,0,0,1.0,1,1.0,1,1.0,1,0.13436195838281173,55
2631,4,5007,2025,2982,0,0,0,1.0,1,1.0,1,1.0,1,0.11385531071609992,55
2632,2,5009,2026,2983,0,0,0,1.0,1,1.0,1,1.0,1,0.12891855624009632,55
2633,1,5010,2027,2983,0,0,0,1.0,1,1.0,1,1.0,1,0.098707302125003,53
2634,2,5012,2028,2984,0,0,0,1.0,1,1.0,1,1.0,1,0.1229029452466466,52
2635,2,5014,2028,2986,0,0,0,1.0,1,1.0,1,1.0,1,0.08566980019534572,52
2636,2,5016,2030,2986,0,0,0,1.0,1,1.0,1,1.0,1,0.11546829242430638,51
2637,3,5019,2032,2987,0,0,0,1.0,1,1.0,1,1.0,1,0.11790192207532903,50
2638,1,5020,2033,2987,0,0,0,1.0,1,1.0,1,1.0,1,0.12519923660414894,48
2639,1,5021,2034,2987,0,0,0,1.0,1,1.0,1,1.0,1,0.1247002288850078,48
2640,4,5025,2038,2987,0,0,0,1.0,1,1.0,1,1.0,1,0.12790001746494178,46
2641,6,5031,2042,2989,0,0,0,1.0,1,1.0,1,1.0,1,0.17368730895117168,46
2642,9,5040,2048,2992,0,0,0,1.0,1,1.0,1,1.0,1,0.1420340692528905,47
2643,4,5044,2050,2994,0,0,0,1.0,1,1.0,1,1.0,1,0.17774980291411877,45
2644,2,5046,2052,2994,0,0,0,1.0,1,1.0,1,1.0,1,0.21375775748004222,44
2645,3,5049,2053,2996,0,0,0,1.0,1,1.0,1,1.0,1,0.1509225273781615,42
2646,2,5051,2053,2998,0,0,0,1.0,1,1.0,1,1.0,1,0.14185862448535067,43
2647,1,5052,2053,2999,0,0,0,1.0,1,1.0,1,1.0,1,0.09247017489706008,40
2648,1,5053,2054,2999,0,0,0,1.0,1,1.0,1,1.0,1,0.13394403329386198,41
2649,4,5057,2055,3002,0,0,0,1.0,1,1.0,1,1.0,1,0.08053536167011865,43
2650,1,5058,2055,3003,0,0,0,1.0,1,1.0,1,1.0,1,0.11354437030634688,43
2651,3,5061,2055,3006,0,0,0,1.0,1,1.0,1,1.0,1,0.06838125396164745,44
2652,0,5061,2055,3006,0,0,0,1.0,1,1.0,1,1.0,1,0.06838125396164745,44
2653,0,5061,2055,3006,0,0,0,1.0,1,1.0,1,1.0,1,0.06838125396164745,44
2654,1,5062,2056,3006,0,0,0,1.0,1,1.0,1,1.0,1,0.11565658631305419,45
2655,1,5063,2057,3006,0,0,0,1.0,1,1.0,1,1.0,1,0.11085972633173453,45
2656,2,5065,2059,3006,0,0,0,1.0,1,1.0,1,1.0,1,0.15766838732261712,45
2657,4,5069,2059,3010,0,0,0,1.0,1,1.0,1,1.0,1,0.10293425959472734,45
2658,3,5072,2059,3013,0,0,0,1.0,1,1.0,1,1.0,1,0.09531781210303507,47
2659,1,5073,2059,3014,0,0,0,1.0,1,1.0,1,1.0,1,0.08726547401137556,46
2660,0,5073,2059,3014,0,0,0,1.0,1,1.0,1,1.0,1,0.08726547401137556,46
2661,1,5074,2059,3015,0,0,0,1.0,1,1.0,1,1.0,1,0.08372035818893166,46
2662,2,5076,2060,3016,0,0,0,1.0,1,1.0,1,1.0,1,0.08708651106840062,47
2663,4,5080,2062,3018,0,0,0,1.0,1,1.0,1,1.0,1,0.07476851339330014,46
2664,2,5082,2064,3018,0,0,0,1.0,1,1.0,1,1.0,1,0.12035797379004866,45
2665,6,5088,2066,3022,0,0,0,1.0,1,1.0,1,1.0,1,0.060242207069949455,47
2666,5,5093,2068,3025,0,0,0,1.0,1,1.0,1,1.0,1,0.137620970344164,47
2667,9,5102,2071,3031,0,0,0,1.0,1,1.0,1,1.0,1,0.09848484655414806,45
2668,2,5104,2071,3033,0,0,0,1.0,1,1.0,1,1.0,1,0.07981909620897298,45
2669,2,5106,2072,3034,0,0,0,1.0,1,1.0,1,1.0,1,0.10933378777842725,45
2670,3,5109,2074,3035,0,0,0,1.0,1,1.0,1,1.0,1,0.11077921519689991,45
2671,0,5109,2074,3035,0,0,0,1.0,1,1.0,1,1.0,1,0.09392339153305194,41
2672,2,5111,2075,3036,0,0,0,1.0,1,1.0,1,1.0,1,0.08783840087004131,40
2673,1,5112,2076,3036,0,0,0,1.0,1,1.0,1,1.0,1,0.12427608701771242,39
2674,2,5114,2078,3036,0,0,0,1.0,1,1.0,1,1.0,1,0.16519124756821002,37
2675,1,5115,2078,3037,0,0,0,1.0,1,1.0,1,1.0,1,0.13901792946041006,35
2676,2,5117,2079,3038,0,0,0,1.0,1,1.0,1,1.0,1,0.21539788841365903,34
2677,3,5120,2080,3040,0,0,0,1.0,1,1.0,1,1.0,1,0.14386206659899814,32
2678,4,5124,2081,3043,0,0,0,1.0,1,1.0,1,1.0,1,0.12928208774742544,33
2679,3,5127,2083,3044,0,0,0,1.0,1,1.0,1,1.0,1,0.17666739020393457,33
2680,6,5133,2086,3047,0,0,0,1.0,1,1.0,1,1.0,1,0.12954256287292068,33
2681,1,5134,2086,3048,0,0,0,1.0,1,1.0,1,1.0,1,0.05434437787133411,32
2682,0,5134,2086,3048,0,0,0,1.0,1,1.0,1,1.0,1,0.05434437787133411,32
2683,1,5135,2087,3048,0,0,0,1.0,1,1.0,1,1.0,1,0.1911087393019394,32
2684,0,5135,2087,3048,0,0,0,1.0,1,1.0,1,1.0,1,0.19853412214690272,31
2685,4,5139,2087,3052,0,0,0,1.0,1,1.0,1,1.0,1,0.16465016874929655,30
2686,2,5141,2088,3053,0,0,0,1.0,1,1.0,1,1.0,1,0.1861527280257173,29
2687,1,5142,2088,3054,0,0,0,1.0,1,1.0,1,1.0,1,0.18316142181723824,28
2688,0,5142,2088,3054,0,0,0,1.0,1,1.0,1,1.0,1,0.18316142181723824,28
2689,2,5144,2088,3056,0,0,0,1.0,1,1.0,1,1.0,1,0.18644588221938438,29
2690,1,5145,2088,3057,0,0,0,1.0,1,1.0,1,1.0,1,0.13237604774102954,29
2691,1,5146,2089,3057,0,0,0,1.0,1,1.0,1,1.0,1,0.1526776223250296,29
2692,3,5149,2089,3060,0,0,0,1.0,1,1.0,1,1.0,1,0.0935301368944645,31
2693,2,5151,2091,3060,0,0,0,1.0,1,1.0,1,1.0,1,0.16452236076555177,32
2694,1,5152,2092,3060,0,0,0,1.0,1,1.0,1,1.0,1,0.15606688775781816,32
2695,2,5154,2092,3062,0,0,0,1.0,1,1.0,1,1.0,1,0.10127708496813821,33
2696,0,5154,2092,3062,0,0,0,1.0,1,1.0,1,1.0,1,0.10127708496813821,33
2697,3,5157,2093,3064,0,0,0,1.0,1,1.0,1,1.0,1,0.11051340542556408,34
2698,1,5158,2094,3064,0,0,0,1.0,1,1.0,1,1.0,1,0.10775111864227278,34
2699,0,5158,2094,3064,0,0,0,1.0,1,1.0,1,1.0,1,0.12464454335888048,36
2700,1,5159,2095,3064,0,0,0,1.0,1,1.0,1,1.0,1,0.19668395494005064,36
2701,0,5159,2095,3064,0,0,0,1.0,1,1.0,1,1.0,1,0.19668395494005064,36
2702,4,5163,2096,3067,0,0,0,1.0,1,1.0,1,1.0,1,0.17730751318277596,36
2703,3,5166,2098,3068,0,0,0,1.0,1,1.0,1,1.0,1,0.16421459057669682,38
2704,2,5168,2099,3069,0,0,0,1.0,1,1.0,1,1.0,1,0.19517392591316926,37
2705,5,5173,2101,3072,0,0,0,1.0,1,1.0,1,1.0,1,0.15922313960825532,36
2706,1,5174,2102,3072,0,0,0,1.0,1,1.0,1,1.0,1,0.1845217589395523,34
2707,1,5175,2102,3073,0,0,0,1.0,1,1.0,1,1.0,1,0.14740887897470942,36
2708,3,5178,2105,3073,0,0,0,1.0,1,1.0,1,1.0,1,0.20673701043744738,36
2709,3,5181,2107,3074,0,0,0,1.0,1,1.0,1,1.0,1,0.16913620918212424,33
2710,1,5182,2108,3074,0,0,0,1.0,1,1.0,1,1.0,1,0.19302947085727074,32
2711,0,5182,2108,3074,0,0,0,1.0,1,1.0,1,1.0,1,0.16736948781124633,29
2712,1,5183,2109,3074,0,0,0,1.0,1,1.0,1,1.0,1,0.2292606248003719,28
2713,1,5184,2110,3074,0,0,0,1.0,1,1.0,1,1.0,1,0.29245722670513047,28
2714,0,5184,2110,3074,0,0,0,1.0,1,1.0,1,1.0,1,0.27950826599117284,25
2715,3,5187,2112,3075,0,0,0,1.0,1,1.0,1,1.0,1,0.3076406778754918,24
2716,1,5188,2113,3075,0,0,0,1.0,1,1.0,1,1.0,1,0.3685359110869237,23
2717,5,5193,2114,3079,0,0,0,1.0,1,1.0,1,1.0,1,0.20525667934913122,24
2718,2,5195,2114,3081,0,0,0,1.0,1,1.0,1,1.0,1,0.1287749802722907,24
2719,1,5196,2114,3082,0,0,0,1.0,1,1.0,1,1.0,1,0.13554537289065927,25
2720,2,5198,2116,3082,0,0,0,1.0,1,1.0,1,1.0,1,0.144500503205802,25
2721,2,5200,2118,3082,0,0,0,1.0,1,1.0,1,1.0,1,0.13420849129552553,26
2722,1,5201,2119,3082,0,0,0,1.0,1,1.0,1,1.0,1,0.17596270600671274,26
2723,2,5203,2120,3083,0,0,0,1.0,1,1.0,1,1.0,1,0.09820125696655099,26
2724,1,5204,2121,3083,0,0,0,1.0,1,1.0,1,1.0,1,0.14906686210445888,27
2725,1,5205,2122,3083,0,0,0,1.0,1,1.0,1,1.0,1,0.16134277316170997,27
2726,1,5206,2122,3084,0,0,0,1.0,1,1.0,1,1.0,1,0.11541474819153676,28
2727,0,5206,2122,3084,0,0,0,1.0,1,1.0,1,1.0,1,0.11411750797458196,29
2728,0,5206,2122,3084,0,0,0,1.0,1,1.0,1,1.0,1,0.12832616028129065,28
2729,1,5207,2123,3084,0,0,0,1.0,1,1.0,1,1.0,1,0.13578003434088698,28
2730,0,5207,2123,3084,0,0,0,1.0,1,1.0,1,1.0,1,0.15712643514213578,29
2731,4,5211,2124,3087,0,0,0,1.0,1,1.0,1,1.0,1,0.13194075258045568,30
2732,1,5212,2124,3088,0,0,0,1.0,1,1.0,1,1.0,1,0.11663846372572063,29
2733,0,5212,2124,3088,0,0,0,1.0,1,1.0,1,1.0,1,0.11663846372572063,29
2734,0,5212,2124,3088,0,0,0,1.0,1,1.0,1,1.0,1,0.11663846372572063,29
2735,2,5214,2126,3088,0,0,0,1.0,1,1.0,1,1.0,1,0.20420927768174008,29
2736,1,5215,2126,3089,0,0,0,1.0,1,1.0,1,1.0,1,0.1893442173273696,30
2737,0,5215,2126,3089,0,0,0,1.0,1,1.0,1,1.0,1,0.1893442173273696,30
2738,2,5217,2128,3089,0,0,0,1.0,1,1.0,1,1.0,1,0.23917572907055248,29
2739,1,5218,2128,3090,0,0,0,1.0,1,1.0,1,1.0,1,0.23658574228445864,30
2740,1,5219,2129,3090,0,0,0,1.0,1,1.0,1,1.0,1,0.2822160762566202,29
2741,3,5222,2129,3093,0,0,0,1.0,1,1.0,1,1.0,1,0.2099320417378163,29
2742,3,5225,2130,3095,0,0,0,1.0,1,1.0,1,1.0,1,0.15121992877328144,29
2743,5,5230,2131,3099,0,0,0,1.0,1,1.0,1,1.0,1,0.1490262602176393,30
2744,3,5233,2133,3100,0,0,0,1.0,1,1.0,1,1.0,1,0.1637319262378858,28
2745,1,5234,2133,3101,0,0,0,1.0,1,1.0,1,1.0,1,0.13635642201584244,27
2746,4,5238,2135,3103,0,0,0,1.0,1,1.0,1,1.0,1,0.1413918112276903,26
2747,2,5240,2136,3104,0,0,0,1.0,1,1.0,1,1.0,1,0.27456555342277666,22
2748,2,5242,2138,3104,0,0,0,1.0,1,1.0,1,1.0,1,0.3410986905577824,22
2749,3,5245,2138,3107,0,0,0,1.0,1,1.0,1,1.0,1,0.282729294684548,20
2750,2,5247,2138,3109,0,0,0,1.0,1,1.0,1,1.0,1,0.2978928004565624,17
2751,1,5248,2138,3110,0,0,0,1.0,1,1.0,1,1.0,1,0.24034265815881126,17
2752,0,5248,2138,3110,0,0,0,1.0,1,1.0,1,1.0,1,0.24226272577627686,16
2753,0,5248,2138,3110,0,0,0,1.0,1,1.0,1,1.0,1,0.24226272577627686,16
2754,0,5248,2138,3110,0,0,0,1.0,1,1.0,1,1.0,1,0.24226272577627686,16
2755,0,5248,2138,3110,0,0,0,1.0,1,1.0,1,1.0,1,0.24226272577627686,16
2756,0,5248,2138,3110,0,0,0,1.0,1,1.0,1,1.0,1,0.25848335050312043,17
2757,1,5249,2139,3110,0,0,0,1.0,1,1.0,1,1.0,1,0.2191984704373602,18
2758,0,5249,2139,3110,0,0,0,1.0,1,1.0,1,1.0,1,0.2191984704373602,18
2759,1,5250,2140,3110,0,0,0,1.0,1,1.0,1,1.0,1,0.25020751235856953,19
2760,1,5251,2140,3111,0,0,0,1.0,1,1.0,1,1.0,1,0.276166216749336,18
2761,1,5252,2140,3112,0,0,0,1.0,1,1.0,1,1.0,1,0.20117009022302,18
2762,0,5252,2140,3112,0,0,0,1.0,1,1.0,1,1.0,1,0.20117009022302,18
2763,0,5252,2140,3112,0,0,0,1.0,1,1.0,1,1.0,1,0.20117009022302,18
2764,0,5252,2140,3112,0,0,0,1.0,1,1.0,1,1.0,1,0.20117009022302,18
2765,1,5253,2141,3112,0,0,0,1.0,1,1.0,1,1.0,1,0.21254071761404647,18
2766,1,5254,2142,3112,0,0,0,1.0,1,1.0,1,1.0,1,0.27367247474465484,18
2767,1,5255,2142,3113,0,0,0,1.0,1,1.0,1,1.0,1,0.22047280316334056,17
2768,0,5255,2142,3113,0,0,0,1.0,1,1.0,1,1.0,1,0.22047280316334056,17
2769,0,5255,2142,3113,0,0,0,1.0,1,1.0,1,1.0,1,0.22047280316334056,17
2770,0,5255,2142,3113,0,0,0,1.0,1,1.0,1,1.0,1,0.22047280316334056,17
2771,0,5255,2142,3113,0,0,0,1.0,1,1.0,1,1.0,1,0.22047280316334056,17
2772,0,5255,2142,3113,0,0,0,1.0,1,1.0,1,1.0,1,0.22047280316334056,17
2773,2,5257,2144,3113,0,0,0,1.0,1,1.0,1,1.0,1,0.33360315490315073,17
2774,1,5258,2144,3114,0,0,0,1.0,1,1.0,1,1.0,1,0.2596247724645172,18
2775,2,5260,2145,3115,0,0,0,1.0,1,1.0,1,1.0,1,0.2823149660204337,20
2776,1,5261,2146,3115,0,0,0,1.0,1,1.0,1,1.0,1,0.3586596508744163,21
2777,2,5263,2146,3117,0,0,0,1.0,1,1.0,1,1.0,1,0.28607099285838467,21
2778,1,5264,2146,3118,0,0,0,1.0,1,1.0,1,1.0,1,0.21297127186922826,21
2779,0,5264,2146,3118,0,0,0,1.0,1,1.0,1,1.0,1,0.2100372792775661,22
2780,1,5265,2147,3118,0,0,0,1.0,1,1.0,1,1.0,1,0.26742489732287744,22
2781,0,5265,2147,3118,0,0,0,1.0,1,1.0,1,1.0,1,0.26742489732287744,22
2782,4,5269,2149,3120,0,0,0,1.0,1,1.0,1,1.0,1,0.2298096783105866,23
2783,1,5270,2150,3120,0,0,0,1.0,1,1.0,1,1.0,1,0.22361946250812437,22
2784,1,5271,2151,3120,0,0,0,1.0,1,1.0,1,1.0,1,0.27754271337476555,21
2785,1,5272,2151,3121,0,0,0,1.0,1,1.0,1,1.0,1,0.1802393144365843,19
2786,1,5273,2152,3121,0,0,0,1.0,1,1.0,1,1.0,1,0.2518710218387421,19
2787,0,5273,2152,3121,0,0,0,1.0,1,1.0,1,1.0,1,0.2635996063751964,20
2788,0,5273,2152,3121,0,0,0,1.0,1,1.0,1,1.0,1,0.2635996063751964,20
2789,0,5273,2152,3121,0,0,0,1.0,1,1.0,1,1.0,1,0.26910348944064333,19
2790,1,5274,2153,3121,0,0,0,1.0,1,1.0,1,1.0,1,0.26647095125158354,20
2791,0,5274,2153,3121,0,0,0,1.0,1,1.0,1,1.0,1,0.26647095125158354,20
2792,1,5275,2153,3122,0,0,0,1.0,1,1.0,1,1.0,1,0.22527817284378343,20
2793,1,5276,2153,3123,0,0,0,1.0,1,1.0,1,1.0,1,0.136944128785674,19
2794,0,5276,2153,3123,0,0,0,1.0,1,1.0,1,1.0,1,0.1652693221814761,20
2795,0,5276,2153,3123,0,0,0,1.0,1,1.0,1,1.0,1,0.18310655169625698,21
2796,0,5276,2153,3123,0,0,0,1.0,1,1.0,1,1.0,1,0.1810375844155536,22
2797,0,5276,2153,3123,0,0,0,1.0,1,1.0,1,1.0,1,0.21926003700212118,21
2798,1,5277,2154,3123,0,0,0,1.0,1,1.0,1,1.0,1,0.2739450059538442,21
2799,0,5277,2154,3123,0,0,0,1.0,1,1.0,1,1.0,1,0.25169220383929025,20
2800,0,5277,2154,3123,0,0,0,1.0,1,1.0,1,1.0,1,0.25169220383929025,20
2801,1,5278,2154,3124,0,0,0,1.0,1,1.0,1,1.0,1,0.21726286465571484,20
2802,0,5278,2154,3124,0,0,0,1.0,1,1.0,1,1.0,1,0.21726286465571484,20
2803,1,5279,2154,3125,0,0,0,1.0,1,1.0,1,1.0,1,0.18534884352121603,21
2804,2,5281,2154,3127,0,0,0,1.0,1,1.0,1,1.0,1,0.1285667207002998,22
2805,0,5281,2154,3127,0,0,0,1.0,1,1.0,1,1.0,1,0.1285667207002998,22
2806,3,5284,2156,3128,0,0,0,1.0,1,1.0,1,1.0,1,0.16379812891914403,23
2807,3,5287,2158,3129,0,0,0,1.0,1,1.0,1,1.0,1,0.2336221152979601,24
2808,2,5289,2160,3129,0,0,0,1.0,1,1.0,1,1.0,1,0.28871519418098135,24
2809,2,5291,2160,3131,0,0,0,1.0,1,1.0,1,1.0,1,0.19614979491731993,26
2810,0,5291,2160,3131,0,0,0,1.0,1,1.0,1,1.0,1,0.17122303062487768,26
2811,1,5292,2160,3132,0,0,0,1.0,1,1.0,1,1.0,1,0.12637699017523124,27
2812,1,5293,2160,3133,0,0,0,1.0,1,1.0,1,1.0,1,0.08547965740332217,27
2813,0,5293,2160,3133,0,0,0,1.0,1,1.0,1,1.0,1,0.08747877626299548,28
2814,1,5294,2161,3133,0,0,0,1.0,1,1.0,1,1.0,1,0.14560845051794447,29
2815,0,5294,2161,3133,0,0,0,1.0,1,1.0,1,1.0,1,0.1574190487143013,30
2816,0,5294,2161,3133,0,0,0,1.0,1,1.0,1,1.0,1,0.1413050028887923,31
2817,0,5294,2161,3133,0,0,0,1.0,1,1.0,1,1.0,1,0.1413050028887923,31
2818,5,5299,2163,3136,0,0,0,1.0,1,1.0,1,1.0,1,0.11121626419207839,32
2819,0,5299,2163,3136,0,0,0,1.0,1,1.0,1,1.0,1,0.11121626419207839,32
2820,0,5299,2163,3136,0,0,0,1.0,1,1.0,1,1.0,1,0.13553418587077107,33
2821,0,5299,2163,3136,0,0,0,1.0,1,1.0,1,1.0,1,0.15117261389479703,34
2822,2,5301,2164,3137,0,0,0,1.0,1,1.0,1,1.0,1,0.1634503700993061,35
2823,1,5302,2165,3137,0,0,0,1.0,1,1.0,1,1.0,1,0.20122023649572773,31
2824,4,5306,2166,3140,0,0,0,1.0,1,1.0,1,1.0,1,0.21501168809785226,33
2825,1,5307,2166,3141,0,0,0,1.0,1,1.0,1,1.0,1,0.15929804463305278,31
2826,1,5308,2167,3141,0,0,0,1.0,1,1.0,1,1.0,1,0.19904003280855953,31
2827,4,5312,2169,3143,0,0,0,1.0,1,1.0,1,1.0,1,0.1563216402600455,32
2828,5,5317,2171,3146,0,0,0,1.0,1,1.0,1,1.0,1,0.254209995855764,33
2829,6,5323,2171,3152,0,0,0,1.0,1,1.0,1,1.0,1,0.09870230424347946,33
2830,0,5323,2171,3152,0,0,0,1.0,1,1.0,1,1.0,1,0.10987789713418607,32
2831,1,5324,2172,3152,0,0,0,1.0,1,1.0,1,1.0,1,0.07509318279582865,31
2832,1,5325,2173,3152,0,0,0,1.0,1,1.0,1,1.0,1,0.12276990295356048,30
2833,2,5327,2174,3153,0,0,0,1.0,1,1.0,1,1.0,1,0.13190803626361616,29
2834,3,5330,2176,3154,0,0,0,1.0,1,1.0,1,1.0,1,0.2085290568226706,29
2835,3,5333,2176,3157,0,0,0,1.0,1,1.0,1,1.0,1,0.07393498147143433,27
2836,1,5334,2176,3158,0,0,0,1.0,1,1.0,1,1.0,1,0.11155795570665507,27
2837,0,5334,2176,3158,0,0,0,1.0,1,1.0,1,1.0,1,0.1259596562291628,28
2838,1,5335,2177,3158,0,0,0,1.0,1,1.0,1,1.0,1,0.13198204421353865,29
2839,1,5336,2177,3159,0,0,0,1.0,1,1.0,1,1.0,1,0.11529577196289818,29
2840,0,5336,2177,3159,0,0,0,1.0,1,1.0,1,1.0,1,0.11529577196289818,29
2841,1,5337,2177,3160,0,0,0,1.0,1,1.0,1,1.0,1,0.10061730118576985,31
2842,2,5339,2178,3161,0,0,0,1.0,1,1.0,1,1.0,1,0.15175086001433646,32
2843,0,5339,2178,3161,0,0,0,1.0,1,1.0,1,1.0,1,0.15175086001433646,32
2844,3,5342,2180,3162,0,0,0,1.0,1,1.0,1,1.0,1,0.2112573811076801,33
2845,4,5346,2182,3164,0,0,0,1.0,1,1.0,1,1.0,1,0.14832216933492634,34
2846,1,5347,2183,3164,0,0,0,1.0,1,1.0,1,1.0,1,0.17831509007741467,34
2847,1,5348,2184,3164,0,0,0,1.0,1,1.0,1,1.0,1,0.14205223076213264,35
2848,3,5351,2185,3166,0,0,0,1.0,1,1.0,1,1.0,1,0.1312248584964564,37
2849,0,5351,2185,3166,0,0,0,1.0,1,1.0,1,1.0,1,0.1312248584964564,37
2850,0,5351,2185,3166,0,0,0,1.0,1,1.0,1,1.0,1,0.1312248584964564,37
2851,2,5353,2186,3167,0,0,0,1.0,1,1.0,1,1.0,1,0.11473751132077481,38
2852,0,5353,2186,3167,0,0,0,1.0,1,1.0,1,1.0,1,0.13626711617120024,36
2853,1,5354,2186,3168,0,0,0,1.0,1,1.0,1,1.0,1,0.17845174053531646,36
2854,2,5356,2186,3170,0,0,0,1.0,1,1.0,1,1.0,1,0.1679261578020224,37
2855,5,5361,2186,3175,0,0,0,1.0,1,1.0,1,1.0,1,0.0806931578359211,37
2856,0,5361,2186,3175,0,0,0,1.0,1,1.0,1,1.0,1,0.08827290852864031,38
2857,2,5363,2188,3175,0,0,0,1.0,1,1.0,1,1.0,1,0.13287834408377183,39
2858,0,5363,2188,3175,0,0,0,1.0,1,1.0,1,1.0,1,0.1754388561718136,39
2859,2,5365,2188,3177,0,0,0,1.0,1,1.0,1,1.0,1,0.148634386437653,39
2860,2,5367,2189,3178,0,0,0,1.0,1,1.0,1,1.0,1,0.13730216635473932,40
2861,1,5368,2190,3178,0,0,0,1.0,1,1.0,1,1.0,1,0.10976266751231832,38
2862,5,5373,2195,3178,0,0,0,1.0,1,1.0,1,1.0,1,0.1663183429094763,38
2863,1,5374,2196,3178,0,0,0,1.0,1,1.0,1,1.0,1,0.17882213785277404,37
2864,5,5379,2201,3178,0,0,0,1.0,1,1.0,1,1.0,1,0.25744820181543115,35
2865,6,5385,2203,3182,0,0,0,1.0,1,1.0,1,1.0,1,0.20768212517092652,33
2866,1,5386,2204,3182,0,0,0,1.0,1,1.0,1,1.0,1,0.22820127439737214,31
2867,5,5391,2204,3187,0,0,0,1.0,1,1.0,1,1.0,1,0.14714837878531947,30
2868,2,5393,2206,3187,0,0,0,1.0,1,1.0,1,1.0,1,0.19885705346067445,31
2869,2,5395,2207,3188,0,0,0,1.0,1,1.0,1,1.0,1,0.2350337562995646,30
2870,0,5395,2207,3188,0,0,0,1.0,1,1.0,1,1.0,1,0.273643474736397,26
2871,3,5398,2209,3189,0,0,0,1.0,1,1.0,1,1.0,1,0.2698720534889629,27
2872,0,5398,2209,3189,0,0,0,1.0,1,1.0,1,1.0,1,0.26147034321550544,25
2873,2,5400,2209,3191,0,0,0,1.0,1,1.0,1,1.0,1,0.24273823387665394,24
2874,0,5400,2209,3191,0,0,0,1.0,1,1.0,1,1.0,1,0.1964626531031899,25
2875,2,5402,2210,3192,0,0,0,1.0,1,1.0,1,1.0,1,0.2324540036764151,26
2876,3,5405,2211,3194,0,0,0,1.0,1,1.0,1,1.0,1,0.2472984134056303,28
2877,1,5406,2211,3195,0,0,0,1.0,1,1.0,1,1.0,1,0.20852524181737675,29
2878,1,5407,2211,3196,0,0,0,1.0,1,1.0,1,1.0,1,0.15257871340523674,31
2879,1,5408,2211,3197,0,0,0,1.0,1,1.0,1,1.0,1,0.14564001925459913,31
2880,1,5409,2212,3197,0,0,0,1.0,1,1.0,1,1.0,1,0.1758040485091628,32
2881,2,5411,2212,3199,0,0,0,1.0,1,1.0,1,1.0,1,0.1475596625442585,31
2882,0,5411,2212,3199,0,0,0,1.0,1,1.0,1,1.0,1,0.1475596625442585,31
2883,0,5411,2212,3199,0,0,0,1.0,1,1.0,1,1.0,1,0.1704320860668702,32
2884,2,5413,2213,3200,0,0,0,1.0,1,1.0,1,1.0,1,0.22128636140527339,32
2885,5,5418,2214,3204,0,0,0,1.0,1,1.0,1,1.0,1,0.146814868348882,33
2886,2,5420,2215,3205,0,0,0,1.0,1,1.0,1,1.0,1,0.11021339988711294,34
2887,1,5421,2215,3206,0,0,0,1.0,1,1.0,1,1.0,1,0.10964825262748591,34
2888,1,5422,2216,3206,0,0,0,1.0,1,1.0,1,1.0,1,0.10904756875562663,34
2889,2,5424,2218,3206,0,0,0,1.0,1,1.0,1,1.0,1,0.1598473146477188,37
2890,1,5425,2218,3207,0,0,0,1.0,1,1.0,1,1.0,1,0.14982259665666856,37
2891,1,5426,2219,3207,0,0,0,1.0,1,1.0,1,1.0,1,0.1881638177699967,37
2892,0,5426,2219,3207,0,0,0,1.0,1,1.0,1,1.0,1,0.1881638177699967,37
2893,3,5429,2220,3209,0,0,0,1.0,1,1.0,1,1.0,1,0.1644295318784869,38
2894,3,5432,2220,3212,0,0,0,1.0,1,1.0,1,1.0,1,0.1256319298060012,39
2895,2,5434,2221,3213,0,0,0,1.0,1,1.0,1,1.0,1,0.11366063448432603,40
2896,1,5435,2222,3213,0,0,0,1.0,1,1.0,1,1.0,1,0.16346002883332167,41
2897,2,5437,2222,3215,0,0,0,1.0,1,1.0,1,1.0,1,0.09483796908496696,41
2898,3,5440,2224,3216,0,0,0,1.0,1,1.0,1,1.0,1,0.11863815974699232,41
2899,1,5441,2225,3216,0,0,0,1.0,1,1.0,1,1.0,1,0.13535971707402386,39
2900,11,5452,2229,3223,0,0,0,1.0,1,1.0,1,1.0,1,0.18085813692395872,40
2901,3,5455,2229,3226,0,0,0,1.0,1,1.0,1,1.0,1,0.12177818542067168,40
2902,1,5456,2230,3226,0,0,0,1.0,1,1.0,1,1.0,1,0.17979811967340334,38
2903,0,5456,2230,3226,0,0,0,1.0,1,1.0,1,1.0,1,0.13666264304679585,36
2904,1,5457,2230,3227,0,0,0,1.0,1,1.0,1,1.0,1,0.11036634066105211,36
2905,0,5457,2230,3227,0,0,0,1.0,1,1.0,1,1.0,1,0.1231012478749313,35
2906,1,5458,2231,3227,0,0,0,1.0,1,1.0,1,1.0,1,0.12760506040958297,36
2907,2,5460,2232,3228,0,0,0,1.0,1,1.0,1,1.0,1,0.1713802640498394,37
2908,2,5462,2233,3229,0,0,0,1.0,1,1.0,1,1.0,1,0.17673923932252797,38
2909,1,5463,2234,3229,0,0,0,1.0,1,1.0,1,1.0,1,0.20473285052296636,37
2910,3,5466,2235,3231,0,0,0,1.0,1,1.0,1,1.0,1,0.1608214925396534,37
2911,0,5466,2235,3231,0,0,0,1.0,1,1.0,1,1.0,1,0.21344022263251614,36
2912,4,5470,2238,3232,0,0,0,1.0,1,1.0,1,1.0,1,0.2106470605833131,36
2913,3,5473,2238,3235,0,0,0,1.0,1,1.0,1,1.0,1,0.14754327941938877,36
2914,1,5474,2238,3236,0,0,0,1.0,1,1.0,1,1.0,1,0.1751822163115005,38
2915,1,5475,2238,3237,0,0,0,1.0,1,1.0,1,1.0,1,0.15935495704560296,37
2916,3,5478,2238,3240,0,0,0,1.0,1,1.0,1,1.0,1,0.09488641467980825,39
2917,1,5479,2239,3240,0,0,0,1.0,1,1.0,1,1.0,1,0.13201788286116342,40
2918,5,5484,2241,3243,0,0,0,1.0,1,1.0,1,1.0,1,0.18217578200939313,40
2919,4,5488,2242,3246,0,0,0,1.0,1,1.0,1,1.0,1,0.16161463637353002,42
2920,2,5490,2242,3248,0,0,0,1.0,1,1.0,1,1.0,1,0.16161463637353002,42
2921,3,5493,2242,3251,0,0,0,1.0,1,1.0,1,1.0,1,0.10578199452933439,42
2922,1,5494,2243,3251,0,0,0,1.0,1,1.0,1,1.0,1,0.11461025382491757,43
2923,2,5496,2243,3253,0,0,0,1.0,1,1.0,1,1.0,1,0.10381858165916834,45
2924,1,5497,2244,3253,0,0,0,1.0,1,1.0,1,1.0,1,0.1076569184025854,46
2925,1,5498,2245,3253,0,0,0,1.0,1,1.0,1,1.0,1,0.10347595762527563,46
2926,0,5498,2245,3253,0,0,0,1.0,1,1.0,1,1.0,1,0.10347595762527563,46
2927,1,5499,2246,3253,0,0,0,1.0,1,1.0,1,1.0,1,0.10225946756882703,48
2928,1,5500,2247,3253,0,0,0,1.0,1,1.0,1,1.0,1,0.13361150269508756,48
2929,1,5501,2247,3254,0,0,0,1.0,1,1.0,1,1.0,1,0.10875260989873053,48
2930,1,5502,2247,3255,0,0,0,1.0,1,1.0,1,1.0,1,0.12365982344236869,50
2931,2,5504,2248,3256,0,0,0,1.0,1,1.0,1,1.0,1,0.12425462556104873,51
2932,2,5506,2249,3257,0,0,0,1.0,1,1.0,1,1.0,1,0.14274441379056682,52
2933,3,5509,2249,3260,0,0,0,1.0,1,1.0,1,1.0,1,0.11347308752154038,53
2934,2,5511,2250,3261,0,0,0,1.0,1,1.0,1,1.0,1,0.14042367321662386,54
2935,3,5514,2251,3263,0,0,0,1.0,1,1.0,1,1.0,1,0.1454601927810004,53
2936,0,5514,2251,3263,0,0,0,1.0,1,1.0,1,1.0,1,0.1454601927810004,53
2937,1,5515,2252,3263,0,0,0,1.0,1,1.0,1,1.0,1,0.1719912736663201,51
2938,2,5517,2253,3264,0,0,0,1.0,1,1.0,1,1.0,1,0.17865660998602567,53
2939,0,5517,2253,3264,0,0,0,1.0,1,1.0,1,1.0,1,0.18199956827130714,52
2940,3,5520,2254,3266,0,0,0,1.0,1,1.0,1,1.0,1,0.1783021248857677,52
2941,2,5522,2255,3267,0,0,0,1.0,1,1.0,1,1.0,1,0.1759616802326246,50
2942,2,5524,2256,3268,0,0,0,1.0,1,1.0,1,1.0,1,0.19711029773442126,50
2943,2,5526,2257,3269,0,0,0,1.0,1,1.0,1,1.0,1,0.18704222531805811,49
2944,2,5528,2258,3270,0,0,0,1.0,1,1.0,1,1.0,1,0.18392725204321414,48
2945,2,5530,2259,3271,0,0,0,1.0,1,1.0,1,1.0,1,0.19004624651121874,48
2946,5,5535,2261,3274,0,0,0,1.0,1,1.0,1,1.0,1,0.12375655731509913,47
2947,3,5538,2261,3277,0,0,0,1.0,1,1.0,1,1.0,1,0.08435045430600716,47
2948,2,5540,2262,3278,0,0,0,1.0,1,1.0,1,1.0,1,0.09763671189046735,48
2949,1,5541,2262,3279,0,0,0,1.0,1,1.0,1,1.0,1,0.06681936208517673,48
2950,1,5542,2263,3279,0,0,0,1.0,1,1.0,1,1.0,1,0.09958253112981456,48
2951,0,5542,2263,3279,0,0,0,1.0,1,1.0,1,1.0,1,0.1246479677812951,50
2952,1,5543,2264,3279,0,0,0,1.0,1,1.0,1,1.0,1,0.12113654779624408,50
2953,2,5545,2264,3281,0,0,0,1.0,1,1.0,1,1.0,1,0.11332536275471693,51
2954,0,5545,2264,3281,0,0,0,1.0,1,1.0,1,1.0,1,0.11332536275471693,51
2955,1,5546,2265,3281,0,0,0,1.0,1,1.0,1,1.0,1,0.1450360168817968,51
2956,3,5549,2266,3283,0,0,0,1.0,1,1.0,1,1.0,1,0.13609784505604094,51
2957,2,5551,2266,3285,0,0,0,1.0,1,1.0,1,1.0,1,0.11970499612873906,52
2958,0,5551,2266,3285,0,0,0,1.0,1,1.0,1,1.0,1,0.11970499612873906,52
2959,4,5555,2267,3288,0,0,0,1.0,1,1.0,1,1.0,1,0.09769439551300145,53
2960,1,5556,2267,3289,0,0,0,1.0,1,1.0,1,1.0,1,0.07591198161693508,52
2961,0,5556,2267,3289,0,0,0,1.0,1,1.0,1,1.0,1,0.09039782938709512,53
2962,1,5557,2267,3290,0,0,0,1.0,1,1.0,1,1.0,1,0.09975730621375833,54
2963,4,5561,2269,3292,0,0,0,1.0,1,1.0,1,1.0,1,0.11950568757083287,55
2964,0,5561,2269,3292,0,0,0,1.0,1,1.0,1,1.0,1,0.13861109079535153,55
2965,1,5562,2269,3293,0,0,0,1.0,1,1.0,1,1.0,1,0.1387589022952506,55
2966,0,5562,2269,3293,0,0,0,1.0,1,1.0,1,1.0,1,0.1387589022952506,55
2967,2,5564,2269,3295,0,0,0,1.0,1,1.0,1,1.0,1,0.11925985046291208,56
2968,0,5564,2269,3295,0,0,0,1.0,1,1.0,1,1.0,1,0.11925985046291208,56
2969,2,5566,2270,3296,0,0,0,1.0,1,1.0,1,1.0,1,0.14091413107739567,55
2970,3,5569,2271,3298,0,0,0,1.0,1,1.0,1,1.0,1,0.13989560592325098,57
2971,1,5570,2271,3299,0,0,0,1.0,1,1.0,1,1.0,1,0.1430758665303006,56
2972,3,5573,2272,3301,0,0,0,1.0,1,1.0,1,1.0,1,0.14493818151664647,57
2973,4,5577,2273,3304,0,0,0,1.0,1,1.0,1,1.0,1,0.14771277092203144,59
2974,1,5578,2273,3305,0,0,0,1.0,1,1.0,1,1.0,1,0.11733784141727113,60
2975,3,5581,2274,3307,0,0,0,1.0,1,1.0,1,1.0,1,0.1169553586732303,58
2976,3,5584,2275,3309,0,0,0,1.0,1,1.0,1,1.0,1,0.13792930834378006,59
2977,3,5587,2276,3311,0,0,0,1.0,1,1.0,1,1.0,1,0.10035495892862226,59
2978,2,5589,2277,3312,0,0,0,1.0,1,1.0,1,1.0,1,0.10463777412281668,58
2979,2,5591,2279,3312,0,0,0,1.0,1,1.0,1,1.0,1,0.10583117817524595,57
2980,1,5592,2280,3312,0,0,0,1.0,1,1.0,1,1.0,1,0.10122141664971412,56
2981,2,5594,2282,3312,0,0,0,1.0,1,1.0,1,1.0,1,0.15010128953987464,56
2982,5,5599,2285,3314,0,0,0,1.0,1,1.0,1,1.0,1,0.1635417598255659,57
2983,4,5603,2286,3317,0,0,0,1.0,1,1.0,1,1.0,1,0.13629352943022996,57
2984,2,5605,2287,3318,0,0,0,1.0,1,1.0,1,1.0,1,0.10059943221352072,56
2985,6,5611,2288,3323,0,0,0,1.0,1,1.0,1,1.0,1,0.10588596938701157,55
2986,8,5619,2292,3327,0,0,0,1.0,1,1.0,1,1.0,1,0.10272014955808245,55
2987,3,5622,2292,3330,0,0,0,1.0,1,1.0,1,1.0,1,0.10230550762251711,51
2988,2,5624,2293,3331,0,0,0,1.0,1,1.0,1,1.0,1,0.077953052552768,52
2989,0,5624,2293,3331,0,0,0,1.0,1,1.0,1,1.0,1,0.09675692878842193,50
2990,1,5625,2294,3331,0,0,0,1.0,1,1.0,1,1.0,1,0.09593691374943716,50
2991,0,5625,2294,3331,0,0,0,1.0,1,1.0,1,1.0,1,0.09157498270277552,50
2992,1,5626,2295,3331,0,0,0,1.0,1,1.0,1,1.0,1,0.09373663378468614,50
2993,1,5627,2295,3332,0,0,0,1.0,1,1.0,1,1.0,1,0.11091209442625846,51
2994,1,5628,2296,3332,0,0,0,1.0,1,1.0,1,1.0,1,0.12478609455137794,51
2995,4,5632,2297,3335,0,0,0,1.0,1,1.0,1,1.0,1,0.10739650411462907,51
2996,1,5633,2298,3335,0,0,0,1.0,1,1.0,1,1.0,1,0.1486895554600903,52
2997,3,5636,2298,3338,0,0,0,1.0,1,1.0,1,1.0,1,0.09440843500492084,52
2998,1,5637,2299,3338,0,0,0,1.0,1,1.0,1,1.0,1,0.10823046537434948,51
2999,2,5639,2299,3340,0,0,0,1.0,1,1.0,1,1.0,1,0.0781162254896429,51
3000,2,5641,2301,3340,0,0,0,1.0,1,1.0,1,1.0,1,0.0763625835688472,52
3001,0,5641,2301,3340,0,0,0,1.0,1,1.0,1,1.0,1,0.0763625835688472,52
3002,1,5642,2302,3340,0,0,0,1.0,1,1.0,1,1.0,1,0.09709204341441656,53
3003,0,5642,2302,3340,0,0,0,1.0,1,1.0,1,1.0,1,0.1055136251632185,54
3004,0,5642,2302,3340,0,0,0,1.0,1,1.0,1,1.0,1,0.11380550143046604,55
3005,2,5644,2302,3342,0,0,0,1.0,1,1.0,1,1.0,1,0.100512636964507,56
3006,1,5645,2302,3343,0,0,0,1.0,1,1.0,1,1.0,1,0.09796945421741367,57
3007,0,5645,2302,3343,0,0,0,1.0,1,1.0,1,1.0,1,0.10823406907667112,58
3008,4,5649,2305,3344,0,0,0,1.0,1,1.0,1,1.0,1,0.12871883045583427,59
3009,0,5649,2305,3344,0,0,0,1.0,1,1.0,1,1.0,1,0.12871883045583427,59
3010,3,5652,2305,3347,0,0,0,1.0,1,1.0,1,1.0,1,0.09375883870028193,59
3011,2,5654,2305,3349,0,0,0,1.0,1,1.0,1,1.0,1,0.06272255155149258,59
3012,6,5660,2307,3353,0,0,0,1.0,1,1.0,1,1.0,1,0.09920855015170588,61
3013,1,5661,2307,3354,0,0,0,1.0,1,1.0,1,1.0,1,0.09051647412471689,59
3014,2,5663,2308,3355,0,0,0,1.0,1,1.0,1,1.0,1,0.10613529858720976,60
3015,2,5665,2309,3356,0,0,0,1.0,1,1.0,1,1.0,1,0.11789402797713831,58
3016,0,5665,2309,3356,0,0,0,1.0,1,1.0,1,1.0,1,0.13387008792793817,57
3017,5,5670,2312,3358,0,0,0,1.0,1,1.0,1,1.0,1,0.13719063583922908,58
3018,0,5670,2312,3358,0,0,0,1.0,1,1.0,1,1.0,1,0.18369325591271823,55
3019,5,5675,2313,3362,0,0,0,1.0,1,1.0,1,1.0,1,0.1517873015118394,56
3020,2,5677,2313,3364,0,0,0,1.0,1,1.0,1,1.0,1,0.18529598751967133,55
3021,3,5680,2314,3366,0,0,0,1.0,1,1.0,1,1.0,1,0.160867001864368,55
3022,2,5682,2315,3367,0,0,0,1.0,1,1.0,1,1.0,1,0.18328625278497193,55
3023,3,5685,2316,3369,0,0,0,1.0,1,1.0,1,1.0,1,0.1438878638086189,54
3024,1,5686,2317,3369,0,0,0,1.0,1,1.0,1,1.0,1,0.15710884212493223,54
3025,6,5692,2321,3371,0,0,0,1.0,1,1.0,1,1.0,1,0.1839614842219594,54
3026,3,5695,2321,3374,0,0,0,1.0,1,1.0,1,1.0,1,0.10794281529854688,53
3027,4,5699,2324,3375,0,0,0,1.0,1,1.0,1,1.0,1,0.11905933734326034,53
3028,4,5703,2326,3377,0,0,0,1.0,1,1.0,1,1.0,1,0.14144249089047012,51
3029,5,5708,2326,3382,0,0,0,1.0,1,1.0,1,1.0,1,0.06146952271165742,51
3030,2,5710,2328,3382,0,0,0,1.0,1,1.0,1,1.0,1,0.11813820199501578,52
3031,3,5713,2329,3384,0,0,0,1.0,1,1.0,1,1.0,1,0.08566520863707795,51
3032,0,5713,2329,3384,0,0,0,1.0,1,1.0,1,1.0,1,0.07322887671706092,50
3033,1,5714,2330,3384,0,0,0,1.0,1,1.0,1,1.0,1,0.10484180696207064,52
3034,1,5715,2331,3384,0,0,0,1.0,1,1.0,1,1.0,1,0.1255165032125568,51
3035,3,5718,2331,3387,0,0,0,1.0,1,1.0,1,1.0,1,0.09503105873664175,51
3036,0,5718,2331,3387,0,0,0,1.0,1,1.0,1,1.0,1,0.09940446071838974,53
3037,1,5719,2331,3388,0,0,0,1.0,1,1.0,1,1.0,1,0.0682531933354525,52
3038,1,5720,2332,3388,0,0,0,1.0,1,1.0,1,1.0,1,0.09332074324986328,52
3039,2,5722,2333,3389,0,0,0,1.0,1,1.0,1,1.0,1,0.10930356247918446,54
3040,1,5723,2333,3390,0,0,0,1.0,1,1.0,1,1.0,1,0.07663853932022077,55
3041,3,5726,2334,3392,0,0,0,1.0,1,1.0,1,1.0,1,0.09314263239514334,56
3042,1,5727,2334,3393,0,0,0,1.0,1,1.0,1,1.0,1,0.08074521815706563,56
3043,1,5728,2334,3394,0,0,0,1.0,1,1.0,1,1.0,1,0.06315532982914183,57
3044,2,5730,2336,3394,0,0,0,1.0,1,1.0,1,1.0,1,0.08448849205374082,57
3045,1,5731,2336,3395,0,0,0,1.0,1,1.0,1,1.0,1,0.08181713180997244,56
3046,1,5732,2337,3395,0,0,0,1.0,1,1.0,1,1.0,1,0.10207255904186317,57
3047,1,5733,2337,3396,0,0,0,1.0,1,1.0,1,1.0,1,0.10196572549267523,56
3048,5,5738,2338,3400,0,0,0,1.0,1,1.0,1,1.0,1,0.09684115897955305,58
3049,1,5739,2338,3401,0,0,0,1.0,1,1.0,1,1.0,1,0.1238757255574095,59
3050,2,5741,2338,3403,0,0,0,1.0,1,1.0,1,1.0,1,0.1083416018920281,60
3051,2,5743,2339,3404,0,0,0,1.0,1,1.0,1,1.0,1,0.12062394788525038,59
3052,4,5747,2340,3407,0,0,0,1.0,1,1.0,1,1.0,1,0.10485768162468877,58
3053,2,5749,2341,3408,0,0,0,1.0,1,1.0,1,1.0,1,0.09016811713022974,57
3054,3,5752,2344,3408,0,0,0,1.0,1,1.0,1,1.0,1,0.1564758325325805,55
3055,7,5759,2346,3413,0,0,0,1.0,1,1.0,1,1.0,1,0.1251948196423638,54
3056,4,5763,2348,3415,0,0,0,1.0,1,1.0,1,1.0,1,0.1445699222466581,55
3057,1,5764,2348,3416,0,0,0,1.0,1,1.0,1,1.0,1,0.14632538919225904,54
3058,5,5769,2350,3419,0,0,0,1.0,1,1.0,1,1.0,1,0.20880082964679586,55
3059,3,5772,2350,3422,0,0,0,1.0,1,1.0,1,1.0,1,0.1628193342789748,56
3060,0,5772,2350,3422,0,0,0,1.0,1,1.0,1,1.0,1,0.1628193342789748,56
3061,0,5772,2350,3422,0,0,0,1.0,1,1.0,1,1.0,1,0.1628193342789748,56
3062,4,5776,2352,3424,0,0,0,1.0,1,1.0,1,1.0,1,0.16570550877283086,57
3063,7,5783,2353,3430,0,0,0,1.0,1,1.0,1,1.0,1,0.11196700338338109,55
3064,2,5785,2354,3431,0,0,0,1.0,1,1.0,1,1.0,1,0.12222275914310064,56
3065,0,5785,2354,3431,0,0,0,1.0,1,1.0,1,1.0,1,0.09814604739266251,55
3066,2,5787,2356,3431,0,0,0,1.0,1,1.0,1,1.0,1,0.14133746596652672,55
3067,5,5792,2358,3434,0,0,0,1.0,1,1.0,1,1.0,1,0.14546212921170676,54
3068,3,5795,2359,3436,0,0,0,1.0,1,1.0,1,1.0,1,0.13057384862010685,53
3069,5,5800,2362,3438,0,0,0,1.0,1,1.0,1,1.0,1,0.13595012936146433,51
3070,0,5800,2362,3438,0,0,0,1.0,1,1.0,1,1.0,1,0.14110371411890338,50
3071,3,5803,2363,3440,0,0,0,1.0,1,1.0,1,1.0,1,0.07287070829759007,51
3072,3,5806,2365,3441,0,0,0,1.0,1,1.0,1,1.0,1,0.0927129099658243,53
3073,0,5806,2365,3441,0,0,0,1.0,1,1.0,1,1.0,1,0.08327735613698538,51
3074,1,5807,2366,3441,0,0,0,1.0,1,1.0,1,1.0,1,0.10695589806539876,50
3075,2,5809,2366,3443,0,0,0,1.0,1,1.0,1,1.0,1,0.08026241202746234,52
3076,1,5810,2367,3443,0,0,0,1.0,1,1.0,1,1.0,1,0.13006836083983267,53
3077,1,5811,2367,3444,0,0,0,1.0,1,1.0,1,1.0,1,0.09822673640052616,52
3078,0,5811,2367,3444,0,0,0,1.0,1,1.0,1,1.0,1,0.14230789630067986,53
3079,4,5815,2368,3447,0,0,0,1.0,1,1.0,1,1.0,1,0.10212698822917377,53
3080,1,5816,2369,3447,0,0,0,1.0,1,1.0,1,1.0,1,0.1348680620384388,52
3081,1,5817,2370,3447,0,0,0,1.0,1,1.0,1,1.0,1,0.15454031914449282,54
3082,3,5820,2372,3448,0,0,0,1.0,1,1.0,1,1.0,1,0.18155916826465554,54
3083,2,5822,2372,3450,0,0,0,1.0,1,1.0,1,1.0,1,0.15235406651291616,54
3084,2,5824,2373,3451,0,0,0,1.0,1,1.0,1,1.0,1,0.1600346760190605,55
3085,2,5826,2374,3452,0,0,0,1.0,1,1.0,1,1.0,1,0.19669979878309002,55
3086,1,5827,2374,3453,0,0,0,1.0,1,1.0,1,1.0,1,0.1708417587476921,56
3087,1,5828,2374,3454,0,0,0,1.0,1,1.0,1,1.0,1,0.17671972903746164,57
3088,0,5828,2374,3454,0,0,0,1.0,1,1.0,1,1.0,1,0.18978722005306775,56
3089,1,5829,2375,3454,0,0,0,1.0,1,1.0,1,1.0,1,0.2313947144073802,55
3090,1,5830,2375,3455,0,0,0,1.0,1,1.0,1,1.0,1,0.23272675052741226,54
3091,1,5831,2375,3456,0,0,0,1.0,1,1.0,1,1.0,1,0.23867133108644226,53
3092,2,5833,2375,3458,0,0,0,1.0,1,1.0,1,1.0,1,0.20434662305243367,56
3093,0,5833,2375,3458,0,0,0,1.0,1,1.0,1,1.0,1,0.20434662305243367,56
3094,0,5833,2375,3458,0,0,0,1.0,1,1.0,1,1.0,1,0.2214758257216499,58
3095,3,5836,2375,3461,0,0,0,1.0,1,1.0,1,1.0,1,0.1933537904277734,59
3096,3,5839,2375,3464,0,0,0,1.0,1,1.0,1,1.0,1,0.17115189833936492,60
3097,2,5841,2375,3466,0,0,0,1.0,1,1.0,1,1.0,1,0.1770772434957033,60
3098,1,5842,2376,3466,0,0,0,1.0,1,1.0,1,1.0,1,0.1997730657856907,58
3099,1,5843,2376,3467,0,0,0,1.0,1,1.0,1,1.0,1,0.1954043171231975,57
3100,1,5844,2376,3468,0,0,0,1.0,1,1.0,1,1.0,1,0.191557336273017,57
3101,3,5847,2376,3471,0,0,0,1.0,1,1.0,1,1.0,1,0.16440299330799457,58
3102,2,5849,2377,3472,0,0,0,1.0,1,1.0,1,1.0,1,0.17966285095988227,59
3103,2,5851,2377,3474,0,0,0,1.0,1,1.0,1,1.0,1,0.15058363773234934,58
3104,6,5857,2380,3477,0,0,0,1.0,1,1.0,1,1.0,1,0.13787181989831512,58
3105,0,5857,2380,3477,0,0,0,1.0,1,1.0,1,1.0,1,0.11878563334104955,56
3106,3,5860,2382,3478,0,0,0,1.0,1,1.0,1,1.0,1,0.12480868288650374,57
3107,1,5861,2383,3478,0,0,0,1.0,1,1.0,1,1.0,1,0.11167372616529858,55
3108,7,5868,2387,3481,0,0,0,1.0,1,1.0,1,1.0,1,0.09909930368690602,55
3109,3,5871,2389,3482,0,0,0,1.0,1,1.0,1,1.0,1,0.09689715610866743,54
3110,1,5872,2389,3483,0,0,0,1.0,1,1.0,1,1.0,1,0.06993304888288669,54
3111,2,5874,2391,3483,0,0,0,1.0,1,1.0,1,1.0,1,0.11313374172075186,54
3112,5,5879,2396,3483,0,0,0,1.0,1,1.0,1,1.0,1,0.21276051755058,56
3113,9,5888,2398,3490,0,0,0,1.0,1,1.0,1,1.0,1,0.1305967837178474,55
3114,5,5893,2399,3494,0,0,0,1.0,1,1.0,1,1.0,1,0.10166242238205335,54
3115,0,5893,2399,3494,0,0,0,1.0,1,1.0,1,1.0,1,0.07208724582187483,56
3116,3,5896,2401,3495,0,0,0,1.0,1,1.0,1,1.0,1,0.060097124735046394,56
3117,2,5898,2401,3497,0,0,0,1.0,1,1.0,1,1.0,1,0.09546674799723037,58
3118,2,5900,2402,3498,0,0,0,1.0,1,1.0,1,1.0,1,0.09243972711745313,57
3119,1,5901,2403,3498,0,0,0,1.0,1,1.0,1,1.0,1,0.09241214185689166,57
3120,0,5901,2403,3498,0,0,0,1.0,1,1.0,1,1.0,1,0.09185104855036583,56
3121,4,5905,2404,3501,0,0,0,1.0,1,1.0,1,1.0,1,0.09060577010192632,57
3122,1,5906,2404,3502,0,0,0,1.0,1,1.0,1,1.0,1,0.06362631256376637,57
3123,0,5906,2404,3502,0,0,0,1.0,1,1.0,1,1.0,1,0.06362631256376637,57
3124,0,5906,2404,3502,0,0,0,1.0,1,1.0,1,1.0,1,0.04858981230845781,59
3125,3,5909,2406,3503,0,0,0,1.0,1,1.0,1,1.0,1,0.08072440786279333,61
3126,0,5909,2406,3503,0,0,0,1.0,1,1.0,1,1.0,1,0.0912366374312704,60
3127,1,5910,2406,3504,0,0,0,1.0,1,1.0,1,1.0,1,0.06931741832413787,58
3128,1,5911,2407,3504,0,0,0,1.0,1,1.0,1,1.0,1,0.1206419275029372,58
3129,1,5912,2407,3505,0,0,0,1.0,1,1.0,1,1.0,1,0.10953934126889579,56
3130,4,5916,2407,3509,0,0,0,1.0,1,1.0,1,1.0,1,0.10519630417882618,56
3131,2,5918,2408,3510,0,0,0,1.0,1,1.0,1,1.0,1,0.09630190362940844,55
3132,2,5920,2409,3511,0,0,0,1.0,1,1.0,1,1.0,1,0.12035774866852907,53
3133,3,5923,2409,3514,0,0,0,1.0,1,1.0,1,1.0,1,0.08887238750138685,52
3134,1,5924,2410,3514,0,0,0,1.0,1,1.0,1,1.0,1,0.10961182984660586,52
3135,3,5927,2410,3517,0,0,0,1.0,1,1.0,1,1.0,1,0.059646581139192065,53
3136,4,5931,2413,3518,0,0,0,1.0,1,1.0,1,1.0,1,0.08387507435496262,54
3137,2,5933,2415,3518,0,0,0,1.0,1,1.0,1,1.0,1,0.1263971030198496,55
3138,8,5941,2418,3523,0,0,0,1.0,1,1.0,1,1.0,1,0.1465892812881345,57
3139,9,5950,2420,3530,0,0,0,1.0,1,1.0,1,1.0,1,0.10496246314295778,56
3140,0,5950,2420,3530,0,0,0,1.0,1,1.0,1,1.0,1,0.12154814842098174,56
3141,1,5951,2420,3531,0,0,0,1.0,1,1.0,1,1.0,1,0.10176180880498076,56
3142,0,5951,2420,3531,0,0,0,1.0,1,1.0,1,1.0,1,0.10176180880498076,56
3143,1,5952,2421,3531,0,0,0,1.0,1,1.0,1,1.0,1,0.1221753725020178,56
3144,0,5952,2421,3531,0,0,0,1.0,1,1.0,1,1.0,1,0.0943942893720986,54
3145,5,5957,2422,3535,0,0,0,1.0,1,1.0,1,1.0,1,0.06941309873009469,55
3146,1,5958,2423,3535,0,0,0,1.0,1,1.0,1,1.0,1,0.09973977239581419,53
3147,3,5961,2424,3537,0,0,0,1.0,1,1.0,1,1.0,1,0.06855287434741936,54
3148,0,5961,2424,3537,0,0,0,1.0,1,1.0,1,1.0,1,0.06855287434741936,54
3149,0,5961,2424,3537,0,0,0,1.0,1,1.0,1,1.0,1,0.07351480520579018,53
3150,1,5962,2424,3538,0,0,0,1.0,1,1.0,1,1.0,1,0.0539689736577649,53
3151,1,5963,2424,3539,0,0,0,1.0,1,1.0,1,1.0,1,0.07424973603653134,53
3152,0,5963,2424,3539,0,0,0,1.0,1,1.0,1,1.0,1,0.0586515056875216,54
3153,0,5963,2424,3539,0,0,0,1.0,1,1.0,1,1.0,1,0.08251183546166149,53
3154,3,5966,2425,3541,0,0,0,1.0,1,1.0,1,1.0,1,0.07111544789895834,55
3155,0,5966,2425,3541,0,0,0,1.0,1,1.0,1,1.0,1,0.0669529677456404,56
3156,1,5967,2426,3541,0,0,0,1.0,1,1.0,1,1.0,1,0.11606778660696127,56
3157,3,5970,2426,3544,0,0,0,1.0,1,1.0,1,1.0,1,0.08173363041823467,56
3158,2,5972,2426,3546,0,0,0,1.0,1,1.0,1,1.0,1,0.06767370127948673,57
3159,0,5972,2426,3546,0,0,0,1.0,1,1.0,1,1.0,1,0.08061675434359689,56
3160,2,5974,2427,3547,0,0,0,1.0,1,1.0,1,1.0,1,0.11292587338233209,58
3161,2,5976,2428,3548,0,0,0,1.0,1,1.0,1,1.0,1,0.0911232469960129,59
3162,3,5979,2429,3550,0,0,0,1.0,1,1.0,1,1.0,1,0.09014065598239099,59
3163,2,5981,2431,3550,0,0,0,1.0,1,1.0,1,1.0,1,0.12763886200970678,59
3164,1,5982,2431,3551,0,0,0,1.0,1,1.0,1,1.0,1,0.13017607019036145,60
3165,5,5987,2432,3555,0,0,0,1.0,1,1.0,1,1.0,1,0.1130889927580289,58
3166,0,5987,2432,3555,0,0,0,1.0,1,1.0,1,1.0,1,0.10418252662639045,59
3167,6,5993,2436,3557,0,0,0,1.0,1,1.0,1,1.0,1,0.12103966338698181,57
3168,5,5998,2437,3561,0,0,0,1.0,1,1.0,1,1.0,1,0.1430687485057868,58
3169,6,6004,2438,3566,0,0,0,1.0,1,1.0,1,1.0,1,0.07816949655739039,57
3170,2,6006,2439,3567,0,0,0,1.0,1,1.0,1,1.0,1,0.10218944476195256,55
3171,10,6016,2443,3573,0,0,0,1.0,1,1.0,1,1.0,1,0.15411079317348716,56
3172,2,6018,2443,3575,0,0,0,1.0,1,1.0,1,1.0,1,0.16056884638570934,54
3173,6,6024,2445,3579,0,0,0,1.0,1,1.0,1,1.0,1,0.1417112555521436,53
3174,1,6025,2445,3580,0,0,0,1.0,1,1.0,1,1.0,1,0.103207835192691,53
3175,0,6025,2445,3580,0,0,0,1.0,1,1.0,1,1.0,1,0.09768257792384591,52
3176,5,6030,2449,3581,0,0,0,1.0,1,1.0,1,1.0,1,0.10430590794212498,53
3177,2,6032,2450,3582,0,0,0,1.0,1,1.0,1,1.0,1,0.14710911005955404,52
3178,2,6034,2450,3584,0,0,0,1.0,1,1.0,1,1.0,1,0.11812183959342185,53
3179,2,6036,2451,3585,0,0,0,1.0,1,1.0,1,1.0,1,0.13248901431728838,54
3180,1,6037,2451,3586,0,0,0,1.0,1,1.0,1,1.0,1,0.13777644486170887,54
3181,3,6040,2452,3588,0,0,0,1.0,1,1.0,1,1.0,1,0.12781499258623163,55
3182,0,6040,2452,3588,0,0,0,1.0,1,1.0,1,1.0,1,0.13812526121880855,54
3183,6,6046,2453,3593,0,0,0,1.0,1,1.0,1,1.0,1,0.13113467405942517,56
3184,3,6049,2455,3594,0,0,0,1.0,1,1.0,1,1.0,1,0.12465736199382096,54
3185,0,6049,2455,3594,0,0,0,1.0,1,1.0,1,1.0,1,0.12040207883532798,53
3186,4,6053,2457,3596,0,0,0,1.0,1,1.0,1,1.0,1,0.14500797517906963,52
3187,2,6055,2457,3598,0,0,0,1.0,1,1.0,1,1.0,1,0.14427755020989044,50
3188,2,6057,2458,3599,0,0,0,1.0,1,1.0,1,1.0,1,0.13746679816905924,50
3189,3,6060,2459,3601,0,0,0,1.0,1,1.0,1,1.0,1,0.1522695264273553,49
3190,2,6062,2460,3602,0,0,0,1.0,1,1.0,1,1.0,1,0.15966291053714496,50
3191,4,6066,2462,3604,0,0,0,1.0,1,1.0,1,1.0,1,0.18261702065758695,49
3192,3,6069,2462,3607,0,0,0,1.0,1,1.0,1,1.0,1,0.13356152547381428,49
3193,0,6069,2462,3607,0,0,0,1.0,1,1.0,1,1.0,1,0.13187948296962412,49
3194,3,6072,2464,3608,0,0,0,1.0,1,1.0,1,1.0,1,0.17614827960238097,50
3195,1,6073,2464,3609,0,0,0,1.0,1,1.0,1,1.0,1,0.16233065433299818,49
3196,0,6073,2464,3609,0,0,0,1.0,1,1.0,1,1.0,1,0.16233065433299818,49
3197,4,6077,2464,3613,0,0,0,1.0,1,1.0,1,1.0,1,0.10888815886605414,50
3198,2,6079,2464,3615,0,0,0,1.0,1,1.0,1,1.0,1,0.0682131892008293,50
3199,0,6079,2464,3615,0,0,0,1.0,1,1.0,1,1.0,1,0.08718435735235902,52
3200,4,6083,2466,3617,0,0,0,1.0,1,1.0,1,1.0,1,0.11279787046224138,53
3201,2,6085,2466,3619,0,0,0,1.0,1,1.0,1,1.0,1,0.09010704289530953,55
3202,3,6088,2466,3622,0,0,0,1.0,1,1.0,1,1.0,1,0.07212872477573105,55
3203,0,6088,2466,3622,0,0,0,1.0,1,1.0,1,1.0,1,0.07231948693474853,53
3204,0,6088,2466,3622,0,0,0,1.0,1,1.0,1,1.0,1,0.10774241572956997,53
3205,2,6090,2467,3623,0,0,0,1.0,1,1.0,1,1.0,1,0.10448198950967588,53
3206,0,6090,2467,3623,0,0,0,1.0,1,1.0,1,1.0,1,0.09230299622734095,52
3207,1,6091,2468,3623,0,0,0,1.0,1,1.0,1,1.0,1,0.13202933200484407,53
3208,2,6093,2468,3625,0,0,0,1.0,1,1.0,1,1.0,1,0.17459904863965192,51
3209,4,6097,2468,3629,0,0,0,1.0,1,1.0,1,1.0,1,0.13297598299618427,52
3210,2,6099,2468,3631,0,0,0,1.0,1,1.0,1,1.0,1,0.13369655440659087,49
3211,4,6103,2470,3633,0,0,0,1.0,1,1.0,1,1.0,1,0.16858618588233862,48
3212,0,6103,2470,3633,0,0,0,1.0,1,1.0,1,1.0,1,0.16921439679490125,48
3213,4,6107,2471,3636,0,0,0,1.0,1,1.0,1,1.0,1,0.12632355491070787,49
3214,2,6109,2472,3637,0,0,0,1.0,1,1.0,1,1.0,1,0.13335057904586975,51
3215,3,6112,2472,3640,0,0,0,1.0,1,1.0,1,1.0,1,0.0903509506110053,51
3216,2,6114,2474,3640,0,0,0,1.0,1,1.0,1,1.0,1,0.10394958845139617,51
3217,2,6116,2474,3642,0,0,0,1.0,1,1.0,1,1.0,1,0.06318910612786266,51
3218,0,6116,2474,3642,0,0,0,1.0,1,1.0,1,1.0,1,0.06318910612786266,51
3219,1,6117,2474,3643,0,0,0,1.0,1,1.0,1,1.0,1,0.05836356441292611,52
3220,0,6117,2474,3643,0,0,0,1.0,1,1.0,1,1.0,1,0.05836356441292611,52
3221,1,6118,2475,3643,0,0,0,1.0,1,1.0,1,1.0,1,0.06279658044962828,54
3222,0,6118,2475,3643,0,0,0,1.0,1,1.0,1,1.0,1,0.05315139402079341,54
3223,0,6118,2475,3643,0,0,0,1.0,1,1.0,1,1.0,1,0.07287492942484364,56
3224,1,6119,2476,3643,0,0,0,1.0,1,1.0,1,1.0,1,0.0945711534626673,57
3225,1,6120,2476,3644,0,0,0,1.0,1,1.0,1,1.0,1,0.09970519746645534,58
3226,0,6120,2476,3644,0,0,0,1.0,1,1.0,1,1.0,1,0.09970519746645534,58
3227,0,6120,2476,3644,0,0,0,1.0,1,1.0,1,1.0,1,0.09970519746645534,58
3228,0,6120,2476,3644,0,0,0,1.0,1,1.0,1,1.0,1,0.09970519746645534,58
3229,6,6126,2478,3648,0,0,0,1.0,1,1.0,1,1.0,1,0.14402748867569792,60
3230,1,6127,2478,3649,0,0,0,1.0,1,1.0,1,1.0,1,0.13274606252483226,61
3231,1,6128,2478,3650,0,0,0,1.0,1,1.0,1,1.0,1,0.10867999651919776,61
3232,0,6128,2478,3650,0,0,0,1.0,1,1.0,1,1.0,1,0.10867999651919776,61
3233,1,6129,2478,3651,0,0,0,1.0,1,1.0,1,1.0,1,0.12350301533700278,63
3234,1,6130,2479,3651,0,0,0,1.0,1,1.0,1,1.0,1,0.1629253699303386,64
3235,5,6135,2479,3656,0,0,0,1.0,1,1.0,1,1.0,1,0.11748167756858809,65
3236,2,6137,2479,3658,0,0,0,1.0,1,1.0,1,1.0,1,0.0994067052189335,66
3237,1,6138,2479,3659,0,0,0,1.0,1,1.0,1,1.0,1,0.08713804686917553,67
3238,0,6138,2479,3659,0,0,0,1.0,1,1.0,1,1.0,1,0.08713804686917553,67
3239,0,6138,2479,3659,0,0,0,1.0,1,1.0,1,1.0,1,0.10546419986022433,69
3240,1,6139,2480,3659,0,0,0,1.0,1,1.0,1,1.0,1,0.12003204241534984,69
3241,5,6144,2482,3662,0,0,0,1.0,1,1.0,1,1.0,1,0.09678297555122109,68
3242,1,6145,2483,3662,0,0,0,1.0,1,1.0,1,1.0,1,0.10010144563879639,67
3243,3,6148,2484,3664,0,0,0,1.0,1,1.0,1,1.0,1,0.0765730373029885,68
3244,1,6149,2484,3665,0,0,0,1.0,1,1.0,1,1.0,1,0.08392029373807038,68
3245,1,6150,2484,3666,0,0,0,1.0,1,1.0,1,1.0,1,0.062465924523009884,69
3246,0,6150,2484,3666,0,0,0,1.0,1,1.0,1,1.0,1,0.07249173243557618,68
3247,1,6151,2484,3667,0,0,0,1.0,1,1.0,1,1.0,1,0.06446364026939823,68
3248,2,6153,2486,3667,0,0,0,1.0,1,1.0,1,1.0,1,0.09951720605311751,68
3249,5,6158,2486,3672,0,0,0,1.0,1,1.0,1,1.0,1,0.06191953537988664,69
3250,4,6162,2487,3675,0,0,0,1.0,1,1.0,1,1.0,1,0.05799461836203179,69
3251,2,6164,2488,3676,0,0,0,1.0,1,1.0,1,1.0,1,0.06894994265122267,68
3252,0,6164,2488,3676,0,0,0,1.0,1,1.0,1,1.0,1,0.05755314771190271,68
3253,0,6164,2488,3676,0,0,0,1.0,1,1.0,1,1.0,1,0.0628558675874751,69
3254,0,6164,2488,3676,0,0,0,1.0,1,1.0,1,1.0,1,0.0628558675874751,69
3255,0,6164,2488,3676,0,0,0,1.0,1,1.0,1,1.0,1,0.0765081554125641,70
3256,0,6164,2488,3676,0,0,0,1.0,1,1.0,1,1.0,1,0.0765081554125641,70
3257,1,6165,2488,3677,0,0,0,1.0,1,1.0,1,1.0,1,0.07370449091681498,71
3258,2,6167,2490,3677,0,0,0,1.0,1,1.0,1,1.0,1,0.06415761259256257,72
3259,1,6168,2491,3677,0,0,0,1.0,1,1.0,1,1.0,1,0.07923670924869097,71
3260,2,6170,2491,3679,0,0,0,1.0,1,1.0,1,1.0,1,0.08438719292917742,72
3261,2,6172,2492,3680,0,0,0,1.0,1,1.0,1,1.0,1,0.08274366599422407,74
3262,5,6177,2495,3682,0,0,0,1.0,1,1.0,1,1.0,1,0.1020884317311659,73
3263,3,6180,2497,3683,0,0,0,1.0,1,1.0,1,1.0,1,0.1006706022529273,73
3264,3,6183,2499,3684,0,0,0,1.0,1,1.0,1,1.0,1,0.15503971273362332,71
3265,4,6187,2501,3686,0,0,0,1.0,1,1.0,1,1.0,1,0.1216154141109463,70
3266,1,6188,2502,3686,0,0,0,1.0,1,1.0,1,1.0,1,0.1313477351712353,69
3267,3,6191,2503,3688,0,0,0,1.0,1,1.0,1,1.0,1,0.1332898681500788,69
3268,3,6194,2506,3688,0,0,0,1.0,1,1.0,1,1.0,1,0.1450043818629342,68
3269,8,6202,2508,3694,0,0,0,1.0,1,1.0,1,1.0,1,0.15121372360653504,68
3270,1,6203,2508,3695,0,0,0,1.0,1,1.0,1,1.0,1,0.1579166054278965,67
3271,0,6203,2508,3695,0,0,0,1.0,1,1.0,1,1.0,1,0.1584691091117669,66
3272,1,6204,2509,3695,0,0,0,1.0,1,1.0,1,1.0,1,0.15262520167728205,67
3273,4,6208,2509,3699,0,0,0,1.0,1,1.0,1,1.0,1,0.13550754172275914,66
3274,1,6209,2510,3699,0,0,0,1.0,1,1.0,1,1.0,1,0.13188324980580435,68
3275,4,6213,2510,3703,0,0,0,1.0,1,1.0,1,1.0,1,0.10118951315028321,68
3276,2,6215,2510,3705,0,0,0,1.0,1,1.0,1,1.0,1,0.10467547596391297,69
3277,4,6219,2511,3708,0,0,0,1.0,1,1.0,1,1.0,1,0.10637822213396543,68
3278,2,6221,2511,3710,0,0,0,1.0,1,1.0,1,1.0,1,0.09895704166979911,69
3279,1,6222,2512,3710,0,0,0,1.0,1,1.0,1,1.0,1,0.11178579800921054,67
3280,3,6225,2514,3711,0,0,0,1.0,1,1.0,1,1.0,1,0.12905170279531417,66
3281,3,6228,2516,3712,0,0,0,1.0,1,1.0,1,1.0,1,0.13973232631164734,67
3282,2,6230,2516,3714,0,0,0,1.0,1,1.0,1,1.0,1,0.12569309479065707,66
3283,3,6233,2517,3716,0,0,0,1.0,1,1.0,1,1.0,1,0.13943049358987078,67
3284,0,6233,2517,3716,0,0,0,1.0,1,1.0,1,1.0,1,0.10865768014018455,66
3285,0,6233,2517,3716,0,0,0,1.0,1,1.0,1,1.0,1,0.10865768014018455,66
3286,0,6233,2517,3716,0,0,0,1.0,1,1.0,1,1.0,1,0.11416098034700106,63
3287,3,6236,2519,3717,0,0,0,1.0,1,1.0,1,1.0,1,0.15199229421826352,61
3288,1,6237,2519,3718,0,0,0,1.0,1,1.0,1,1.0,1,0.16566190695890615,63
3289,3,6240,2519,3721,0,0,0,1.0,1,1.0,1,1.0,1,0.14864511596511584,62
3290,2,6242,2520,3722,0,0,0,1.0,1,1.0,1,1.0,1,0.15356123482304362,63
3291,5,6247,2522,3725,0,0,0,1.0,1,1.0,1,1.0,1,0.15293504274202144,62
3292,2,6249,2523,3726,0,0,0,1.0,1,1.0,1,1.0,1,0.16904356241380689,63
3293,5,6254,2523,3731,0,0,0,1.0,1,1.0,1,1.0,1,0.15087708629859534,65
3294,0,6254,2523,3731,0,0,0,1.0,1,1.0,1,1.0,1,0.15087708629859534,65
3295,0,6254,2523,3731,0,0,0,1.0,1,1.0,1,1.0,1,0.15087708629859534,65
3296,2,6256,2524,3732,0,0,0,1.0,1,1.0,1,1.0,1,0.16267846260408889,65
3297,2,6258,2524,3734,0,0,0,1.0,1,1.0,1,1.0,1,0.14697301372299304,66
3298,1,6259,2524,3735,0,0,0,1.0,1,1.0,1,1.0,1,0.13414756952377654,66
3299,2,6261,2525,3736,0,0,0,1.0,1,1.0,1,1.0,1,0.1502710085063649,67
3300,3,6264,2527,3737,0,0,0,1.0,1,1.0,1,1.0,1,0.18174946266774203,67
3301,6,6270,2528,3742,0,0,0,1.0,1,1.0,1,1.0,1,0.15066226218560408,68
3302,0,6270,2528,3742,0,0,0,1.0,1,1.0,1,1.0,1,0.16290987584235642,67
3303,1,6271,2528,3743,0,0,0,1.0,1,1.0,1,1.0,1,0.1618441478059487,67
3304,0,6271,2528,3743,0,0,0,1.0,1,1.0,1,1.0,1,0.16208604875453156,67
3305,5,6276,2528,3748,0,0,0,1.0,1,1.0,1,1.0,1,0.14876657491835868,69
3306,0,6276,2528,3748,0,0,0,1.0,1,1.0,1,1.0,1,0.1384331235164583,70
3307,3,6279,2528,3751,0,0,0,1.0,1,1.0,1,1.0,1,0.11404287485218705,70
3308,0,6279,2528,3751,0,0,0,1.0,1,1.0,1,1.0,1,0.11404287485218705,70
3309,1,6280,2528,3752,0,0,0,1.0,1,1.0,1,1.0,1,0.12114992785627306,72
3310,1,6281,2528,3753,0,0,0,1.0,1,1.0,1,1.0,1,0.13375434407192013,74
3311,1,6282,2528,3754,0,0,0,1.0,1,1.0,1,1.0,1,0.12547339936473134,74
3312,0,6282,2528,3754,0,0,0,1.0,1,1.0,1,1.0,1,0.12547339936473134,74
3313,1,6283,2528,3755,0,0,0,1.0,1,1.0,1,1.0,1,0.12475136960922949,75
3314,2,6285,2528,3757,0,0,0,1.0,1,1.0,1,1.0,1,0.12254232522748763,76
3315,4,6289,2529,3760,0,0,0,1.0,1,1.0,1,1.0,1,0.14469306775644483,75
3316,2,6291,2530,3761,0,0,0,1.0,1,1.0,1,1.0,1,0.15245259342980155,76
3317,3,6294,2530,3764,0,0,0,1.0,1,1.0,1,1.0,1,0.12436252024267136,73
3318,2,6296,2532,3764,0,0,0,1.0,1,1.0,1,1.0,1,0.14011719644249845,72
3319,3,6299,2533,3766,0,0,0,1.0,1,1.0,1,1.0,1,0.1357803382445739,71
3320,1,6300,2533,3767,0,0,0,1.0,1,1.0,1,1.0,1,0.12536632526736183,70
3321,4,6304,2535,3769,0,0,0,1.0,1,1.0,1,1.0,1,0.14486893768443035,69
3322,0,6304,2535,3769,0,0,0,1.0,1,1.0,1,1.0,1,0.1512917132131226,68
3323,5,6309,2536,3773,0,0,0,1.0,1,1.0,1,1.0,1,0.1497065913135574,69
3324,1,6310,2537,3773,0,0,0,1.0,1,1.0,1,1.0,1,0.1462817297540997,69
3325,2,6312,2537,3775,0,0,0,1.0,1,1.0,1,1.0,1,0.14030231078741512,70
3326,1,6313,2538,3775,0,0,0,1.0,1,1.0,1,1.0,1,0.14850918882099556,69
3327,1,6314,2539,3775,0,0,0,1.0,1,1.0,1,1.0,1,0.15488853926559537,70
3328,5,6319,2540,3779,0,0,0,1.0,1,1.0,1,1.0,1,0.14477497747103146,73
3329,1,6320,2541,3779,0,0,0,1.0,1,1.0,1,1.0,1,0.18721255479648005,72
3330,1,6321,2541,3780,0,0,0,1.0,1,1.0,1,1.0,1,0.18309565016085594,72
3331,3,6324,2541,3783,0,0,0,1.0,1,1.0,1,1.0,1,0.18070466011756178,72
3332,3,6327,2541,3786,0,0,0,1.0,1,1.0,1,1.0,1,0.15558305153441124,73
3333,1,6328,2541,3787,0,0,0,1.0,1,1.0,1,1.0,1,0.14186222560392434,72
3334,1,6329,2541,3788,0,0,0,1.0,1,1.0,1,1.0,1,0.13670939248805855,73
3335,2,6331,2542,3789,0,0,0,1.0,1,1.0,1,1.0,1,0.16968366412252686,74
3336,3,6334,2542,3792,0,0,0,1.0,1,1.0,1,1.0,1,0.14135199994814943,74
3337,2,6336,2543,3793,0,0,0,1.0,1,1.0,1,1.0,1,0.14672239554702657,74
3338,1,6337,2543,3794,0,0,0,1.0,1,1.0,1,1.0,1,0.14460517811978615,74
3339,2,6339,2543,3796,0,0,0,1.0,1,1.0,1,1.0,1,0.14546704631752527,75
3340,1,6340,2543,3797,0,0,0,1.0,1,1.0,1,1.0,1,0.13486354731665767,75
3341,1,6341,2543,3798,0,0,0,1.0,1,1.0,1,1.0,1,0.13960422620899499,76
3342,0,6341,2543,3798,0,0,0,1.0,1,1.0,1,1.0,1,0.16070652922527257,76
3343,3,6344,2544,3800,0,0,0,1.0,1,1.0,1,1.0,1,0.15008005606010028,75
3344,5,6349,2545,3804,0,0,0,1.0,1,1.0,1,1.0,1,0.15618488717467047,75
3345,1,6350,2546,3804,0,0,0,1.0,1,1.0,1,1.0,1,0.15443003370317937,72
3346,4,6354,2547,3807,0,0,0,1.0,1,1.0,1,1.0,1,0.15904479547269143,73
3347,5,6359,2548,3811,0,0,0,1.0,1,1.0,1,1.0,1,0.14327385409942714,73
3348,1,6360,2548,3812,0,0,0,1.0,1,1.0,1,1.0,1,0.12771674536435493,73
3349,3,6363,2549,3814,0,0,0,1.0,1,1.0,1,1.0,1,0.12631525615550895,74
3350,4,6367,2552,3815,0,0,0,1.0,1,1.0,1,1.0,1,0.1689734717661377,73
3351,2,6369,2553,3816,0,0,0,1.0,1,1.0,1,1.0,1,0.15852912228268873,72
3352,2,6371,2553,3818,0,0,0,1.0,1,1.0,1,1.0,1,0.1558147978483746,72
3353,1,6372,2554,3818,0,0,0,1.0,1,1.0,1,1.0,1,0.18520020945650845,72
3354,2,6374,2555,3819,0,0,0,1.0,1,1.0,1,1.0,1,0.1975996748963217,70
3355,4,6378,2555,3823,0,0,0,1.0,1,1.0,1,1.0,1,0.16415658153478788,69
3356,5,6383,2558,3825,0,0,0,1.0,1,1.0,1,1.0,1,0.16614370896268252,69
3357,3,6386,2559,3827,0,0,0,1.0,1,1.0,1,1.0,1,0.14275937071839756,68
3358,6,6392,2562,3830,0,0,0,1.0,1,1.0,1,1.0,1,0.14905913529913642,68
3359,1,6393,2562,3831,0,0,0,1.0,1,1.0,1,1.0,1,0.13686261616451062,66
3360,3,6396,2564,3832,0,0,0,1.0,1,1.0,1,1.0,1,0.16745116054647471,65
3361,3,6399,2564,3835,0,0,0,1.0,1,1.0,1,1.0,1,0.16844232710378979,64
3362,0,6399,2564,3835,0,0,0,1.0,1,1.0,1,1.0,1,0.16844232710378979,64
3363,0,6399,2564,3835,0,0,0,1.0,1,1.0,1,1.0,1,0.16351493523285746,65
3364,0,6399,2564,3835,0,0,0,1.0,1,1.0,1,1.0,1,0.16848781680239291,66
3365,2,6401,2564,3837,0,0,0,1.0,1,1.0,1,1.0,1,0.1643318149538574,68
3366,2,6403,2565,3838,0,0,0,1.0,1,1.0,1,1.0,1,0.17493986062154135,66
3367,5,6408,2565,3843,0,0,0,1.0,1,1.0,1,1.0,1,0.16151150514876575,68
3368,3,6411,2565,3846,0,0,0,1.0,1,1.0,1,1.0,1,0.14445409125578085,68
3369,2,6413,2565,3848,0,0,0,1.0,1,1.0,1,1.0,1,0.13074722697418859,69
3370,0,6413,2565,3848,0,0,0,1.0,1,1.0,1,1.0,1,0.11591983750604487,71
3371,1,6414,2565,3849,0,0,0,1.0,1,1.0,1,1.0,1,0.11176805061121985,71
3372,2,6416,2566,3850,0,0,0,1.0,1,1.0,1,1.0,1,0.11232519010115201,71
3373,0,6416,2566,3850,0,0,0,1.0,1,1.0,1,1.0,1,0.11423432739386812,72
3374,0,6416,2566,3850,0,0,0,1.0,1,1.0,1,1.0,1,0.10890585251213257,72
3375,2,6418,2567,3851,0,0,0,1.0,1,1.0,1,1.0,1,0.10735867819213822,73
3376,0,6418,2567,3851,0,0,0,1.0,1,1.0,1,1.0,1,0.1076116099567892,75
3377,3,6421,2568,3853,0,0,0,1.0,1,1.0,1,1.0,1,0.10806110996799209,77
3378,1,6422,2569,3853,0,0,0,1.0,1,1.0,1,1.0,1,0.12017511745256425,77
3379,9,6431,2572,3859,0,0,0,1.0,1,1.0,1,1.0,1,0.12678274861345978,77
3380,2,6433,2573,3860,0,0,0,1.0,1,1.0,1,1.0,1,0.13661127294972308,76
3381,7,6440,2575,3865,0,0,0,1.0,1,1.0,1,1.0,1,0.10874733563670119,76
3382,1,6441,2575,3866,0,0,0,1.0,1,1.0,1,1.0,1,0.11772586327807455,78
3383,8,6449,2576,3873,0,0,0,1.0,1,1.0,1,1.0,1,0.12627255250231195,77
3384,5,6454,2578,3876,0,0,0,1.0,1,1.0,1,1.0,1,0.13660384580400603,77
3385,4,6458,2579,3879,0,0,0,1.0,1,1.0,1,1.0,1,0.10497345182106876,75
3386,2,6460,2581,3879,0,0,0,1.0,1,1.0,1,1.0,1,0.13364372118016335,76
3387,4,6464,2581,3883,0,0,0,1.0,1,1.0,1,1.0,1,0.10187188629034909,75
3388,3,6467,2582,3885,0,0,0,1.0,1,1.0,1,1.0,1,0.10914145833006729,76
3389,2,6469,2583,3886,0,0,0,1.0,1,1.0,1,1.0,1,0.0932162996244825,77
3390,0,6469,2583,3886,0,0,0,1.0,1,1.0,1,1.0,1,0.09576898676416123,76
3391,1,6470,2584,3886,0,0,0,1.0,1,1.0,1,1.0,1,0.06727363371130103,77
3392,2,6472,2585,3887,0,0,0,1.0,1,1.0,1,1.0,1,0.0752733871278207,78
3393,1,6473,2586,3887,0,0,0,1.0,1,1.0,1,1.0,1,0.0812624070292,76
3394,0,6473,2586,3887,0,0,0,1.0,1,1.0,1,1.0,1,0.10631192531688266,75
3395,3,6476,2586,3890,0,0,0,1.0,1,1.0,1,1.0,1,0.06838951812524736,73
3396,1,6477,2586,3891,0,0,0,1.0,1,1.0,1,1.0,1,0.06575567985715779,73
3397,0,6477,2586,3891,0,0,0,1.0,1,1.0,1,1.0,1,0.056706323930267755,74
3398,0,6477,2586,3891,0,0,0,1.0,1,1.0,1,1.0,1,0.056706323930267755,74
3399,0,6477,2586,3891,0,0,0,1.0,1,1.0,1,1.0,1,0.05355058571329788,75
3400,1,6478,2587,3891,0,0,0,1.0,1,1.0,1,1.0,1,0.06919205514146257,75
3401,3,6481,2588,3893,0,0,0,1.0,1,1.0,1,1.0,1,0.052124182174239,77
3402,1,6482,2589,3893,0,0,0,1.0,1,1.0,1,1.0,1,0.0622443331489977,77
3403,2,6484,2590,3894,0,0,0,1.0,1,1.0,1,1.0,1,0.06992133915689765,78
3404,1,6485,2591,3894,0,0,0,1.0,1,1.0,1,1.0,1,0.09183899579836464,78
3405,4,6489,2591,3898,0,0,0,1.0,1,1.0,1,1.0,1,0.04707877116399211,78
3406,1,6490,2592,3898,0,0,0,1.0,1,1.0,1,1.0,1,0.06714204250407722,78
3407,3,6493,2593,3900,0,0,0,1.0,1,1.0,1,1.0,1,0.09132758059287739,78
3408,1,6494,2594,3900,0,0,0,1.0,1,1.0,1,1.0,1,0.11536817217034769,79
3409,6,6500,2594,3906,0,0,0,1.0,1,1.0,1,1.0,1,0.08014362235331272,81
3410,0,6500,2594,3906,0,0,0,1.0,1,1.0,1,1.0,1,0.08931152471350201,82
3411,2,6502,2595,3907,0,0,0,1.0,1,1.0,1,1.0,1,0.08500936438532988,84
3412,0,6502,2595,3907,0,0,0,1.0,1,1.0,1,1.0,1,0.08500936438532988,84
3413,2,6504,2595,3909,0,0,0,1.0,1,1.0,1,1.0,1,0.06374366964697069,84
3414,0,6504,2595,3909,0,0,0,1.0,1,1.0,1,1.0,1,0.06374366964697069,84
3415,3,6507,2596,3911,0,0,0,1.0,1,1.0,1,1.0,1,0.06126383941121602,85
3416,1,6508,2597,3911,0,0,0,1.0,1,1.0,1,1.0,1,0.06756017573387278,85
3417,1,6509,2598,3911,0,0,0,1.0,1,1.0,1,1.0,1,0.07119060215597868,86
3418,3,6512,2601,3911,0,0,0,1.0,1,1.0,1,1.0,1,0.11642510404904088,86
3419,5,6517,2602,3915,0,0,0,1.0,1,1.0,1,1.0,1,0.11696368164141074,87
3420,0,6517,2602,3915,0,0,0,1.0,1,1.0,1,1.0,1,0.11976836173517026,88
3421,4,6521,2603,3918,0,0,0,1.0,1,1.0,1,1.0,1,0.12064880257483572,89
3422,3,6524,2604,3920,0,0,0,1.0,1,1.0,1,1.0,1,0.13452358006083195,90
3423,2,6526,2604,3922,0,0,0,1.0,1,1.0,1,1.0,1,0.13052738831168317,90
3424,2,6528,2604,3924,0,0,0,1.0,1,1.0,1,1.0,1,0.11589769917173695,91
3425,3,6531,2604,3927,0,0,0,1.0,1,1.0,1,1.0,1,0.10476482064859441,90
3426,1,6532,2605,3927,0,0,0,1.0,1,1.0,1,1.0,1,0.08659844355172237,92
3427,3,6535,2605,3930,0,0,0,1.0,1,1.0,1,1.0,1,0.09926432491566921,92
3428,1,6536,2605,3931,0,0,0,1.0,1,1.0,1,1.0,1,0.10150467540507789,91
3429,0,6536,2605,3931,0,0,0,1.0,1,1.0,1,1.0,1,0.10150467540507789,91
3430,4,6540,2607,3933,0,0,0,1.0,1,1.0,1,1.0,1,0.13361800864730705,91
3431,1,6541,2607,3934,0,0,0,1.0,1,1.0,1,1.0,1,0.11387660618300535,90
3432,5,6546,2610,3936,0,0,0,1.0,1,1.0,1,1.0,1,0.1167892663816417,91
3433,2,6548,2610,3938,0,0,0,1.0,1,1.0,1,1.0,1,0.10628041676385097,90
3434,0,6548,2610,3938,0,0,0,1.0,1,1.0,1,1.0,1,0.10862492040611664,89
3435,2,6550,2611,3939,0,0,0,1.0,1,1.0,1,1.0,1,0.1177958990479467,88
3436,0,6550,2611,3939,0,0,0,1.0,1,1.0,1,1.0,1,0.1212298627991122,86
3437,0,6550,2611,3939,0,0,0,1.0,1,1.0,1,1.0,1,0.11436703314471741,86
3438,1,6551,2611,3940,0,0,0,1.0,1,1.0,1,1.0,1,0.11421870643831958,87
3439,3,6554,2612,3942,0,0,0,1.0,1,1.0,1,1.0,1,0.11638837886452977,86
3440,0,6554,2612,3942,0,0,0,1.0,1,1.0,1,1.0,1,0.1158061273012428,86
3441,7,6561,2614,3947,0,0,0,1.0,1,1.0,1,1.0,1,0.09598820938100985,85
3442,1,6562,2615,3947,0,0,0,1.0,1,1.0,1,1.0,1,0.10918759011983938,85
3443,5,6567,2615,3952,0,0,0,1.0,1,1.0,1,1.0,1,0.08552974800882261,85
3444,3,6570,2617,3953,0,0,0,1.0,1,1.0,1,1.0,1,0.09687664049320358,85
3445,1,6571,2618,3953,0,0,0,1.0,1,1.0,1,1.0,1,0.11010943464514085,84
3446,3,6574,2620,3954,0,0,0,1.0,1,1.0,1,1.0,1,0.13714865356043887,85
3447,3,6577,2621,3956,0,0,0,1.0,1,1.0,1,1.0,1,0.14233496443802135,85
3448,2,6579,2623,3956,0,0,0,1.0,1,1.0,1,1.0,1,0.1551583018951595,85
3449,3,6582,2623,3959,0,0,0,1.0,1,1.0,1,1.0,1,0.1328447338447134,84
3450,0,6582,2623,3959,0,0,0,1.0,1,1.0,1,1.0,1,0.1328447338447134,84
3451,3,6585,2624,3961,0,0,0,1.0,1,1.0,1,1.0,1,0.14394523996448835,85
3452,0,6585,2624,3961,0,0,0,1.0,1,1.0,1,1.0,1,0.139042023557383,86
3453,1,6586,2625,3961,0,0,0,1.0,1,1.0,1,1.0,1,0.13708533505342918,85
3454,1,6587,2625,3962,0,0,0,1.0,1,1.0,1,1.0,1,0.12320334269334535,88
3455,2,6589,2626,3963,0,0,0,1.0,1,1.0,1,1.0,1,0.1227500640129454,88
3456,2,6591,2626,3965,0,0,0,1.0,1,1.0,1,1.0,1,0.11678520900641529,88
3457,1,6592,2626,3966,0,0,0,1.0,1,1.0,1,1.0,1,0.11368490966711796,89
3458,0,6592,2626,3966,0,0,0,1.0,1,1.0,1,1.0,1,0.1228143347919776,88
3459,0,6592,2626,3966,0,0,0,1.0,1,1.0,1,1.0,1,0.1228143347919776,88
3460,0,6592,2626,3966,0,0,0,1.0,1,1.0,1,1.0,1,0.11616260394580243,89
3461,2,6594,2627,3967,0,0,0,1.0,1,1.0,1,1.0,1,0.12546633884041414,89
3462,3,6597,2629,3968,0,0,0,1.0,1,1.0,1,1.0,1,0.12672347569904896,90
3463,2,6599,2629,3970,0,0,0,1.0,1,1.0,1,1.0,1,0.11910169609428217,89
3464,0,6599,2629,3970,0,0,0,1.0,1,1.0,1,1.0,1,0.1243899676144167,88
3465,3,6602,2629,3973,0,0,0,1.0,1,1.0,1,1.0,1,0.12555154353386078,87
3466,2,6604,2629,3975,0,0,0,1.0,1,1.0,1,1.0,1,0.11200295217186282,87
3467,3,6607,2630,3977,0,0,0,1.0,1,1.0,1,1.0,1,0.1086116225769229,87
3468,4,6611,2632,3979,0,0,0,1.0,1,1.0,1,1.0,1,0.13486558644294694,88
3469,6,6617,2633,3984,0,0,0,1.0,1,1.0,1,1.0,1,0.13042382427215407,85
3470,1,6618,2633,3985,0,0,0,1.0,1,1.0,1,1.0,1,0.12896830105987064,86
3471,2,6620,2633,3987,0,0,0,1.0,1,1.0,1,1.0,1,0.13205108141344915,84
3472,1,6621,2633,3988,0,0,0,1.0,1,1.0,1,1.0,1,0.12828682998383856,83
3473,3,6624,2633,3991,0,0,0,1.0,1,1.0,1,1.0,1,0.12492510401700226,81
3474,1,6625,2633,3992,0,0,0,1.0,1,1.0,1,1.0,1,0.12036361061840534,80
3475,9,6634,2634,4000,0,0,0,1.0,1,1.0,1,1.0,1,0.13762628063904744,82
3476,5,6639,2635,4004,0,0,0,1.0,1,1.0,1,1.0,1,0.1185786777917208,81
3477,8,6647,2636,4011,0,0,0,1.0,1,1.0,1,1.0,1,0.10964169657411002,83
3478,1,6648,2637,4011,0,0,0,1.0,1,1.0,1,1.0,1,0.11296115169416582,83
3479,3,6651,2637,4014,0,0,0,1.0,1,1.0,1,1.0,1,0.10624084251537738,83
3480,0,6651,2637,4014,0,0,0,1.0,1,1.0,1,1.0,1,0.10624084251537738,83
3481,4,6655,2638,4017,0,0,0,1.0,1,1.0,1,1.0,1,0.08988303996351772,83
3482,3,6658,2640,4018,0,0,0,1.0,1,1.0,1,1.0,1,0.1079528369481232,83
3483,4,6662,2642,4020,0,0,0,1.0,1,1.0,1,1.0,1,0.12713751398377754,82
3484,2,6664,2643,4021,0,0,0,1.0,1,1.0,1,1.0,1,0.12544328802091387,82
3485,5,6669,2645,4024,0,0,0,1.0,1,1.0,1,1.0,1,0.149114389633009,83
3486,0,6669,2645,4024,0,0,0,1.0,1,1.0,1,1.0,1,0.149114389633009,83
3487,3,6672,2645,4027,0,0,0,1.0,1,1.0,1,1.0,1,0.1322053254464048,84
3488,1,6673,2645,4028,0,0,0,1.0,1,1.0,1,1.0,1,0.12947571461200133,84
3489,2,6675,2645,4030,0,0,0,1.0,1,1.0,1,1.0,1,0.11427583719134769,84
3490,2,6677,2645,4032,0,0,0,1.0,1,1.0,1,1.0,1,0.10468483278945802,84
3491,3,6680,2645,4035,0,0,0,1.0,1,1.0,1,1.0,1,0.08183075382803977,86
3492,1,6681,2645,4036,0,0,0,1.0,1,1.0,1,1.0,1,0.07895463277616314,86
3493,0,6681,2645,4036,0,0,0,1.0,1,1.0,1,1.0,1,0.07895463277616314,86
3494,3,6684,2647,4037,0,0,0,1.0,1,1.0,1,1.0,1,0.08366760426147922,86
3495,1,6685,2647,4038,0,0,0,1.0,1,1.0,1,1.0,1,0.0682230582025149,87
3496,0,6685,2647,4038,0,0,0,1.0,1,1.0,1,1.0,1,0.07687964906124582,88
3497,2,6687,2648,4039,0,0,0,1.0,1,1.0,1,1.0,1,0.10358179996005658,89
3498,2,6689,2648,4041,0,0,0,1.0,1,1.0,1,1.0,1,0.09804667441071162,89
3499,2,6691,2649,4042,0,0,0,1.0,1,1.0,1,1.0,1,0.09878208458769872,91
3500,2,6693,2649,4044,0,0,0,1.0,1,1.0,1,1.0,1,0.09819880556987674,90
3501,0,6693,2649,4044,0,0,0,1.0,1,1.0,1,1.0,1,0.09819880556987674,90
3502,1,6694,2649,4045,0,0,0,1.0,1,1.0,1,1.0,1,0.09411277488903085,91
3503,2,6696,2650,4046,0,0,0,1.0,1,1.0,1,1.0,1,0.08944726820958496,91
3504,3,6699,2653,4046,0,0,0,1.0,1,1.0,1,1.0,1,0.14169232430883305,89
3505,5,6704,2654,4050,0,0,0,1.0,1,1.0,1,1.0,1,0.13162357835878027,87
3506,4,6708,2657,4051,0,0,0,1.0,1,1.0,1,1.0,1,0.14190371158733756,87
3507,4,6712,2658,4054,0,0,0,1.0,1,1.0,1,1.0,1,0.11402249233696742,84
3508,2,6714,2660,4054,0,0,0,1.0,1,1.0,1,1.0,1,0.13696353932440503,83
3509,5,6719,2663,4056,0,0,0,1.0,1,1.0,1,1.0,1,0.1328021905247075,80
3510,3,6722,2663,4059,0,0,0,1.0,1,1.0,1,1.0,1,0.11854050384994583,78
3511,2,6724,2664,4060,0,0,0,1.0,1,1.0,1,1.0,1,0.09991524909419931,77
3512,1,6725,2664,4061,0,0,0,1.0,1,1.0,1,1.0,1,0.11650836730510197,74
3513,4,6729,2665,4064,0,0,0,1.0,1,1.0,1,1.0,1,0.10700046543092634,76
3514,0,6729,2665,4064,0,0,0,1.0,1,1.0,1,1.0,1,0.10607903701925103,76
3515,2,6731,2666,4065,0,0,0,1.0,1,1.0,1,1.0,1,0.1064090871692852,75
3516,1,6732,2667,4065,0,0,0,1.0,1,1.0,1,1.0,1,0.1380410571761121,73
3517,6,6738,2668,4070,0,0,0,1.0,1,1.0,1,1.0,1,0.11959974226386655,74
3518,2,6740,2668,4072,0,0,0,1.0,1,1.0,1,1.0,1,0.12259212163853778,74
3519,1,6741,2668,4073,0,0,0,1.0,1,1.0,1,1.0,1,0.12398819920701795,73
3520,1,6742,2668,4074,0,0,0,1.0,1,1.0,1,1.0,1,0.11094177619721393,74
3521,2,6744,2668,4076,0,0,0,1.0,1,1.0,1,1.0,1,0.09010570969085431,75
3522,1,6745,2668,4077,0,0,0,1.0,1,1.0,1,1.0,1,0.0904007743484141,75
3523,1,6746,2668,4078,0,0,0,1.0,1,1.0,1,1.0,1,0.07757645997608924,75
3524,0,6746,2668,4078,0,0,0,1.0,1,1.0,1,1.0,1,0.07310175819215249,75
3525,2,6748,2668,4080,0,0,0,1.0,1,1.0,1,1.0,1,0.06277004020905391,75
3526,0,6748,2668,4080,0,0,0,1.0,1,1.0,1,1.0,1,0.05581076081721625,76
3527,3,6751,2670,4081,0,0,0,1.0,1,1.0,1,1.0,1,0.11160967441623279,77
3528,5,6756,2671,4085,0,0,0,1.0,1,1.0,1,1.0,1,0.09802374030993148,77
3529,5,6761,2674,4087,0,0,0,1.0,1,1.0,1,1.0,1,0.11735203042250797,78
3530,1,6762,2674,4088,0,0,0,1.0,1,1.0,1,1.0,1,0.12474107831600631,78
3531,2,6764,2675,4089,0,0,0,1.0,1,1.0,1,1.0,1,0.13421847184171287,79
3532,3,6767,2675,4092,0,0,0,1.0,1,1.0,1,1.0,1,0.14579949808289303,79
3533,4,6771,2676,4095,0,0,0,1.0,1,1.0,1,1.0,1,0.14879516603752788,79
3534,4,6775,2678,4097,0,0,0,1.0,1,1.0,1,1.0,1,0.14690574727537195,80
3535,4,6779,2678,4101,0,0,0,1.0,1,1.0,1,1.0,1,0.1208961429374605,81
3536,1,6780,2678,4102,0,0,0,1.0,1,1.0,1,1.0,1,0.1103270554679898,82
3537,1,6781,2678,4103,0,0,0,1.0,1,1.0,1,1.0,1,0.1011325529743402,82
3538,0,6781,2678,4103,0,0,0,1.0,1,1.0,1,1.0,1,0.10815034508534034,83
3539,0,6781,2678,4103,0,0,0,1.0,1,1.0,1,1.0,1,0.10815034508534034,83
3540,1,6782,2679,4103,0,0,0,1.0,1,1.0,1,1.0,1,0.10765568627314182,85
3541,2,6784,2680,4104,0,0,0,1.0,1,1.0,1,1.0,1,0.10953222315091966,85
3542,4,6788,2680,4108,0,0,0,1.0,1,1.0,1,1.0,1,0.09067069652301936,88
3543,1,6789,2680,4109,0,0,0,1.0,1,1.0,1,1.0,1,0.08181878004073946,87
3544,1,6790,2680,4110,0,0,0,1.0,1,1.0,1,1.0,1,0.07847879138927404,87
3545,2,6792,2681,4111,0,0,0,1.0,1,1.0,1,1.0,1,0.06300384326094224,85
3546,0,6792,2681,4111,0,0,0,1.0,1,1.0,1,1.0,1,0.07041919222437829,83
3547,3,6795,2681,4114,0,0,0,1.0,1,1.0,1,1.0,1,0.05710076717819511,82
3548,1,6796,2682,4114,0,0,0,1.0,1,1.0,1,1.0,1,0.06119575319638648,82
3549,0,6796,2682,4114,0,0,0,1.0,1,1.0,1,1.0,1,0.057753537344306265,81
3550,1,6797,2683,4114,0,0,0,1.0,1,1.0,1,1.0,1,0.08081259814518026,79
3551,4,6801,2684,4117,0,0,0,1.0,1,1.0,1,1.0,1,0.0863019160642879,80
3552,2,6803,2685,4118,0,0,0,1.0,1,1.0,1,1.0,1,0.08832736130990756,78
3553,4,6807,2685,4122,0,0,0,1.0,1,1.0,1,1.0,1,0.053306820589346875,79
3554,0,6807,2685,4122,0,0,0,1.0,1,1.0,1,1.0,1,0.07400829648754403,77
3555,2,6809,2685,4124,0,0,0,1.0,1,1.0,1,1.0,1,0.0760588405996025,77
3556,0,6809,2685,4124,0,0,0,1.0,1,1.0,1,1.0,1,0.08642642827104138,76
3557,1,6810,2685,4125,0,0,0,1.0,1,1.0,1,1.0,1,0.08084945096836862,76
3558,1,6811,2686,4125,0,0,0,1.0,1,1.0,1,1.0,1,0.11175784238257601,76
3559,4,6815,2686,4129,0,0,0,1.0,1,1.0,1,1.0,1,0.07523106328562237,76
3560,2,6817,2687,4130,0,0,0,1.0,1,1.0,1,1.0,1,0.07854470120975901,78
3561,3,6820,2687,4133,0,0,0,1.0,1,1.0,1,1.0,1,0.06327148030244757,79
3562,0,6820,2687,4133,0,0,0,1.0,1,1.0,1,1.0,1,0.06327148030244757,79
3563,2,6822,2688,4134,0,0,0,1.0,1,1.0,1,1.0,1,0.04890210419539917,79
3564,5,6827,2690,4137,0,0,0,1.0,1,1.0,1,1.0,1,0.08119722903728482,80
3565,3,6830,2691,4139,0,0,0,1.0,1,1.0,1,1.0,1,0.0828166473175529,83
3566,5,6835,2692,4143,0,0,0,1.0,1,1.0,1,1.0,1,0.07450207029811119,84
3567,0,6835,2692,4143,0,0,0,1.0,1,1.0,1,1.0,1,0.07450207029811119,84
3568,4,6839,2695,4144,0,0,0,1.0,1,1.0,1,1.0,1,0.1025106869181919,84
3569,4,6843,2696,4147,0,0,0,1.0,1,1.0,1,1.0,1,0.08466318301000857,84
3570,4,6847,2698,4149,0,0,0,1.0,1,1.0,1,1.0,1,0.09231105308660659,87
3571,7,6854,2700,4154,0,0,0,1.0,1,1.0,1,1.0,1,0.09945637485627574,86
3572,3,6857,2702,4155,0,0,0,1.0,1,1.0,1,1.0,1,0.0952245633421893,87
3573,4,6861,2704,4157,0,0,0,1.0,1,1.0,1,1.0,1,0.11111410963972693,87
3574,2,6863,2706,4157,0,0,0,1.0,1,1.0,1,1.0,1,0.13887593913470547,88
3575,4,6867,2706,4161,0,0,0,1.0,1,1.0,1,1.0,1,0.11080139111259195,88
3576,7,6874,2706,4168,0,0,0,1.0,1,1.0,1,1.0,1,0.084648324982061,90
3577,2,6876,2706,4170,0,0,0,1.0,1,1.0,1,1.0,1,0.06730563505193474,90
3578,0,6876,2706,4170,0,0,0,1.0,1,1.0,1,1.0,1,0.07607769324729513,91
3579,2,6878,2707,4171,0,0,0,1.0,1,1.0,1,1.0,1,0.0701023259417153,91
3580,1,6879,2707,4172,0,0,0,1.0,1,1.0,1,1.0,1,0.08947892559900224,91
3581,3,6882,2707,4175,0,0,0,1.0,1,1.0,1,1.0,1,0.0792011164723495,91
3582,3,6885,2707,4178,0,0,0,1.0,1,1.0,1,1.0,1,0.0717286261657792,92
3583,2,6887,2708,4179,0,0,0,1.0,1,1.0,1,1.0,1,0.08639733323632103,88
3584,1,6888,2709,4179,0,0,0,1.0,1,1.0,1,1.0,1,0.08518112737322903,87
3585,6,6894,2711,4183,0,0,0,1.0,1,1.0,1,1.0,1,0.08385126716160016,84
3586,3,6897,2714,4183,0,0,0,1.0,1,1.0,1,1.0,1,0.08684257690091385,83
3587,3,6900,2714,4186,0,0,0,1.0,1,1.0,1,1.0,1,0.05871421651962433,82
3588,0,6900,2714,4186,0,0,0,1.0,1,1.0,1,1.0,1,0.06399864234585063,81
3589,5,6905,2717,4188,0,0,0,1.0,1,1.0,1,1.0,1,0.0857372027615448,80
3590,3,6908,2718,4190,0,0,0,1.0,1,1.0,1,1.0,1,0.1086448776239952,78
3591,3,6911,2718,4193,0,0,0,1.0,1,1.0,1,1.0,1,0.06501264982363923,77
3592,1,6912,2719,4193,0,0,0,1.0,1,1.0,1,1.0,1,0.08073635756634119,75
3593,2,6914,2719,4195,0,0,0,1.0,1,1.0,1,1.0,1,0.08216317690094699,76
3594,2,6916,2720,4196,0,0,0,1.0,1,1.0,1,1.0,1,0.0755735026163341,74
3595,2,6918,2721,4197,0,0,0,1.0,1,1.0,1,1.0,1,0.08061183435670183,74
3596,1,6919,2721,4198,0,0,0,1.0,1,1.0,1,1.0,1,0.08788131529504296,73
3597,3,6922,2723,4199,0,0,0,1.0,1,1.0,1,1.0,1,0.09236303161704155,73
3598,2,6924,2724,4200,0,0,0,1.0,1,1.0,1,1.0,1,0.10325314722948864,73
3599,3,6927,2724,4203,0,0,0,1.0,1,1.0,1,1.0,1,0.08617548593354733,73
3600,2,6929,2724,4205,0,0,0,1.0,1,1.0,1,1.0,1,0.08401762132541661,74
3601,5,6934,2727,4207,0,0,0,1.0,1,1.0,1,1.0,1,0.09418594889758969,75
3602,1,6935,2727,4208,0,0,0,1.0,1,1.0,1,1.0,1,0.08633271561771279,76
3603,6,6941,2729,4212,0,0,0,1.0,1,1.0,1,1.0,1,0.10528822336381444,77
3604,5,6946,2731,4215,0,0,0,1.0,1,1.0,1,1.0,1,0.12992783167206848,78
3605,5,6951,2733,4218,0,0,0,1.0,1,1.0,1,1.0,1,0.11106931332137297,77
3606,2,6953,2733,4220,0,0,0,1.0,1,1.0,1,1.0,1,0.09300673260746496,79
3607,3,6956,2734,4222,0,0,0,1.0,1,1.0,1,1.0,1,0.07694280321807961,79
3608,0,6956,2734,4222,0,0,0,1.0,1,1.0,1,1.0,1,0.07694280321807961,79
3609,1,6957,2734,4223,0,0,0,1.0,1,1.0,1,1.0,1,0.05760276597594183,79
3610,2,6959,2736,4223,0,0,0,1.0,1,1.0,1,1.0,1,0.07923470395410169,80
3611,2,6961,2737,4224,0,0,0,1.0,1,1.0,1,1.0,1,0.06574806870584703,80
3612,3,6964,2739,4225,0,0,0,1.0,1,1.0,1,1.0,1,0.10635943095606476,79
3613,7,6971,2741,4230,0,0,0,1.0,1,1.0,1,1.0,1,0.06775705183983187,79
3614,4,6975,2744,4231,0,0,0,1.0,1,1.0,1,1.0,1,0.10257433333150617,78
3615,2,6977,2744,4233,0,0,0,1.0,1,1.0,1,1.0,1,0.0859607377056025,79
3616,2,6979,2745,4234,0,0,0,1.0,1,1.0,1,1.0,1,0.07983147382972301,79
3617,1,6980,2746,4234,0,0,0,1.0,1,1.0,1,1.0,1,0.09356830271286846,80
3618,2,6982,2746,4236,0,0,0,1.0,1,1.0,1,1.0,1,0.08277644402837189,82
3619,1,6983,2746,4237,0,0,0,1.0,1,1.0,1,1.0,1,0.08609828187390715,82
3620,2,6985,2747,4238,0,0,0,1.0,1,1.0,1,1.0,1,0.08990139377513648,81
3621,2,6987,2747,4240,0,0,0,1.0,1,1.0,1,1.0,1,0.09201839541129841,83
3622,0,6987,2747,4240,0,0,0,1.0,1,1.0,1,1.0,1,0.10478899244182595,81
3623,4,6991,2749,4242,0,0,0,1.0,1,1.0,1,1.0,1,0.1057440571655164,81
3624,1,6992,2750,4242,0,0,0,1.0,1,1.0,1,1.0,1,0.11437585507267271,79
3625,6,6998,2751,4247,0,0,0,1.0,1,1.0,1,1.0,1,0.10566880609890685,80
3626,2,7000,2751,4249,0,0,0,1.0,1,1.0,1,1.0,1,0.0877030071545403,78
3627,5,7005,2752,4253,0,0,0,1.0,1,1.0,1,1.0,1,0.07676085320941421,78
3628,1,7006,2752,4254,0,0,0,1.0,1,1.0,1,1.0,1,0.062209518116894964,77
3629,1,7007,2752,4255,0,0,0,1.0,1,1.0,1,1.0,1,0.052271570849093715,76
3630,2,7009,2753,4256,0,0,0,1.0,1,1.0,1,1.0,1,0.05229344465250648,77
3631,1,7010,2753,4257,0,0,0,1.0,1,1.0,1,1.0,1,0.054987762337923025,75
3632,0,7010,2753,4257,0,0,0,1.0,1,1.0,1,1.0,1,0.07014404038819493,74
3633,3,7013,2754,4259,0,0,0,1.0,1,1.0,1,1.0,1,0.07051274123534772,75
3634,3,7016,2756,4260,0,0,0,1.0,1,1.0,1,1.0,1,0.10178770037662717,74
3635,4,7020,2758,4262,0,0,0,1.0,1,1.0,1,1.0,1,0.1007938715934292,74
3636,2,7022,2759,4263,0,0,0,1.0,1,1.0,1,1.0,1,0.13141434373953154,74
3637,8,7030,2760,4270,0,0,0,1.0,1,1.0,1,1.0,1,0.09433027853945117,74
3638,2,7032,2760,4272,0,0,0,1.0,1,1.0,1,1.0,1,0.10363364333428066,75
3639,6,7038,2763,4275,0,0,0,1.0,1,1.0,1,1.0,1,0.09804912536081337,76
3640,1,7039,2763,4276,0,0,0,1.0,1,1.0,1,1.0,1,0.08577080015804753,76
3641,2,7041,2764,4277,0,0,0,1.0,1,1.0,1,1.0,1,0.10138578310266631,75
3642,2,7043,2766,4277,0,0,0,1.0,1,1.0,1,1.0,1,0.1185100086793445,75
3643,1,7044,2766,4278,0,0,0,1.0,1,1.0,1,1.0,1,0.11001541250046455,74
3644,0,7044,2766,4278,0,0,0,1.0,1,1.0,1,1.0,1,0.11001541250046455,74
3645,3,7047,2766,4281,0,0,0,1.0,1,1.0,1,1.0,1,0.08427530795133614,74
3646,1,7048,2766,4282,0,0,0,1.0,1,1.0,1,1.0,1,0.08146677714674684,75
3647,2,7050,2766,4284,0,0,0,1.0,1,1.0,1,1.0,1,0.06745309533620336,77
3648,1,7051,2766,4285,0,0,0,1.0,1,1.0,1,1.0,1,0.09020917303138601,78
3649,3,7054,2766,4288,0,0,0,1.0,1,1.0,1,1.0,1,0.07673255959175268,80
3650,3,7057,2767,4290,0,0,0,1.0,1,1.0,1,1.0,1,0.08148530068550838,81
3651,0,7057,2767,4290,0,0,0,1.0,1,1.0,1,1.0,1,0.08148530068550838,81
3652,2,7059,2768,4291,0,0,0,1.0,1,1.0,1,1.0,1,0.10416662019478977,83
3653,1,7060,2768,4292,0,0,0,1.0,1,1.0,1,1.0,1,0.09860329229517974,83
3654,0,7060,2768,4292,0,0,0,1.0,1,1.0,1,1.0,1,0.09860329229517974,83
3655,1,7061,2768,4293,0,0,0,1.0,1,1.0,1,1.0,1,0.08940681638374665,84
3656,1,7062,2768,4294,0,0,0,1.0,1,1.0,1,1.0,1,0.09167914225775385,85
3657,2,7064,2769,4295,0,0,0,1.0,1,1.0,1,1.0,1,0.09983524774830214,86
3658,1,7065,2770,4295,0,0,0,1.0,1,1.0,1,1.0,1,0.10639184726531346,87
3659,4,7069,2770,4299,0,0,0,1.0,1,1.0,1,1.0,1,0.08389615579774322,87
3660,0,7069,2770,4299,0,0,0,1.0,1,1.0,1,1.0,1,0.08031319939916291,86
3661,1,7070,2771,4299,0,0,0,1.0,1,1.0,1,1.0,1,0.10332462876047499,86
3662,0,7070,2771,4299,0,0,0,1.0,1,1.0,1,1.0,1,0.10805758654164517,83
3663,10,7080,2778,4302,0,0,0,1.0,1,1.0,1,1.0,1,0.16051087677068662,85
3664,4,7084,2780,4304,0,0,0,1.0,1,1.0,1,1.0,1,0.1343106047557,82
3665,4,7088,2780,4308,0,0,0,1.0,1,1.0,1,1.0,1,0.11290304950329871,81
3666,4,7092,2781,4311,0,0,0,1.0,1,1.0,1,1.0,1,0.11058105359448295,79
3667,3,7095,2782,4313,0,0,0,1.0,1,1.0,1,1.0,1,0.11021739529034327,79
3668,2,7097,2784,4313,0,0,0,1.0,1,1.0,1,1.0,1,0.1231088304186069,77
3669,2,7099,2784,4315,0,0,0,1.0,1,1.0,1,1.0,1,0.1082255848711834,75
3670,3,7102,2786,4316,0,0,0,1.0,1,1.0,1,1.0,1,0.11252496577257198,76
3671,3,7105,2787,4318,0,0,0,1.0,1,1.0,1,1.0,1,0.10185954618634492,74
3672,1,7106,2787,4319,0,0,0,1.0,1,1.0,1,1.0,1,0.09209340220524846,75
3673,1,7107,2787,4320,0,0,0,1.0,1,1.0,1,1.0,1,0.08572320666250954,75
3674,3,7110,2789,4321,0,0,0,1.0,1,1.0,1,1.0,1,0.09684449298952494,75
3675,0,7110,2789,4321,0,0,0,1.0,1,1.0,1,1.0,1,0.09812346318981098,75
3676,1,7111,2790,4321,0,0,0,1.0,1,1.0,1,1.0,1,0.12048684699816409,75
3677,3,7114,2790,4324,0,0,0,1.0,1,1.0,1,1.0,1,0.11283121569929164,75
3678,4,7118,2791,4327,0,0,0,1.0,1,1.0,1,1.0,1,0.11177327329270785,77
3679,2,7120,2792,4328,0,0,0,1.0,1,1.0,1,1.0,1,0.13312809416791732,78
3680,2,7122,2792,4330,0,0,0,1.0,1,1.0,1,1.0,1,0.1312280392045467,80
3681,0,7122,2792,4330,0,0,0,1.0,1,1.0,1,1.0,1,0.13475384302951593,81
3682,1,7123,2792,4331,0,0,0,1.0,1,1.0,1,1.0,1,0.13230510574752832,81
3683,1,7124,2793,4331,0,0,0,1.0,1,1.0,1,1.0,1,0.14776547272887963,81
3684,0,7124,2793,4331,0,0,0,1.0,1,1.0,1,1.0,1,0.14776547272887963,81
3685,0,7124,2793,4331,0,0,0,1.0,1,1.0,1,1.0,1,0.14776547272887963,81
3686,0,7124,2793,4331,0,0,0,1.0,1,1.0,1,1.0,1,0.14776547272887963,81
3687,1,7125,2793,4332,0,0,0,1.0,1,1.0,1,1.0,1,0.13522601737462747,82
3688,4,7129,2793,4336,0,0,0,1.0,1,1.0,1,1.0,1,0.13586456339084452,84
3689,0,7129,2793,4336,0,0,0,1.0,1,1.0,1,1.0,1,0.13586456339084452,84
3690,2,7131,2794,4337,0,0,0,1.0,1,1.0,1,1.0,1,0.12668454840104076,85
3691,0,7131,2794,4337,0,0,0,1.0,1,1.0,1,1.0,1,0.12237929893106149,86
3692,1,7132,2794,4338,0,0,0,1.0,1,1.0,1,1.0,1,0.10918873560378019,86
3693,0,7132,2794,4338,0,0,0,1.0,1,1.0,1,1.0,1,0.10918873560378019,86
3694,0,7132,2794,4338,0,0,0,1.0,1,1.0,1,1.0,1,0.10918873560378019,86
3695,2,7134,2796,4338,0,0,0,1.0,1,1.0,1,1.0,1,0.12751537999188248,86
3696,0,7134,2796,4338,0,0,0,1.0,1,1.0,1,1.0,1,0.11318556620406675,87
3697,2,7136,2798,4338,0,0,0,1.0,1,1.0,1,1.0,1,0.11985363297808464,85
3698,0,7136,2798,4338,0,0,0,1.0,1,1.0,1,1.0,1,0.12092572660196285,85
3699,0,7136,2798,4338,0,0,0,1.0,1,1.0,1,1.0,1,0.10647236288680628,85
3700,3,7139,2801,4338,0,0,0,1.0,1,1.0,1,1.0,1,0.11664346789790433,84
3701,4,7143,2802,4341,0,0,0,1.0,1,1.0,1,1.0,1,0.13854177493105405,85
3702,5,7148,2805,4343,0,0,0,1.0,1,1.0,1,1.0,1,0.1474355211521046,85
3703,0,7148,2805,4343,0,0,0,1.0,1,1.0,1,1.0,1,0.1474355211521046,85
3704,3,7151,2806,4345,0,0,0,1.0,1,1.0,1,1.0,1,0.15961583197509038,85
3705,2,7153,2806,4347,0,0,0,1.0,1,1.0,1,1.0,1,0.1398579472654677,86
3706,0,7153,2806,4347,0,0,0,1.0,1,1.0,1,1.0,1,0.1247125687880846,86
3707,2,7155,2808,4347,0,0,0,1.0,1,1.0,1,1.0,1,0.1457012419321106,85
3708,1,7156,2808,4348,0,0,0,1.0,1,1.0,1,1.0,1,0.12607877821564384,84
3709,1,7157,2809,4348,0,0,0,1.0,1,1.0,1,1.0,1,0.1461005240223148,85
3710,0,7157,2809,4348,0,0,0,1.0,1,1.0,1,1.0,1,0.15184606786544855,84
3711,5,7162,2809,4353,0,0,0,1.0,1,1.0,1,1.0,1,0.12785416998564753,85
3712,2,7164,2809,4355,0,0,0,1.0,1,1.0,1,1.0,1,0.11146651983408741,85
3713,0,7164,2809,4355,0,0,0,1.0,1,1.0,1,1.0,1,0.11146651983408741,85
3714,5,7169,2810,4359,0,0,0,1.0,1,1.0,1,1.0,1,0.12155907995456244,85
3715,0,7169,2810,4359,0,0,0,1.0,1,1.0,1,1.0,1,0.12155907995456244,85
3716,2,7171,2810,4361,0,0,0,1.0,1,1.0,1,1.0,1,0.12657670296956902,84
3717,2,7173,2810,4363,0,0,0,1.0,1,1.0,1,1.0,1,0.12030722116343974,86
3718,0,7173,2810,4363,0,0,0,1.0,1,1.0,1,1.0,1,0.13100932920788272,85
3719,3,7176,2810,4366,0,0,0,1.0,1,1.0,1,1.0,1,0.11450285947414825,84
3720,0,7176,2810,4366,0,0,0,1.0,1,1.0,1,1.0,1,0.13359383125724655,84
3721,3,7179,2812,4367,0,0,0,1.0,1,1.0,1,1.0,1,0.15026309013475556,85
3722,2,7181,2813,4368,0,0,0,1.0,1,1.0,1,1.0,1,0.14960349414636345,85
3723,7,7188,2813,4375,0,0,0,1.0,1,1.0,1,1.0,1,0.12428314333669438,85
3724,2,7190,2813,4377,0,0,0,1.0,1,1.0,1,1.0,1,0.11326009479482069,86
3725,2,7192,2814,4378,0,0,0,1.0,1,1.0,1,1.0,1,0.10687812118066811,86
3726,0,7192,2814,4378,0,0,0,1.0,1,1.0,1,1.0,1,0.10687812118066811,86
3727,0,7192,2814,4378,0,0,0,1.0,1,1.0,1,1.0,1,0.10687812118066811,86
3728,2,7194,2816,4378,0,0,0,1.0,1,1.0,1,1.0,1,0.141309471281703,86
3729,3,7197,2817,4380,0,0,0,1.0,1,1.0,1,1.0,1,0.1292627945668618,86
3730,0,7197,2817,4380,0,0,0,1.0,1,1.0,1,1.0,1,0.141169882357614,85
3731,1,7198,2817,4381,0,0,0,1.0,1,1.0,1,1.0,1,0.13860895389717623,86
3732,0,7198,2817,4381,0,0,0,1.0,1,1.0,1,1.0,1,0.13436499421904316,87
3733,3,7201,2819,4382,0,0,0,1.0,1,1.0,1,1.0,1,0.16619120525157893,87
3734,1,7202,2819,4383,0,0,0,1.0,1,1.0,1,1.0,1,0.16295615970213626,87
3735,6,7208,2821,4387,0,0,0,1.0,1,1.0,1,1.0,1,0.16217510686587838,86
3736,0,7208,2821,4387,0,0,0,1.0,1,1.0,1,1.0,1,0.14563957108843834,87
3737,1,7209,2821,4388,0,0,0,1.0,1,1.0,1,1.0,1,0.12987685758341486,87
3738,2,7211,2823,4388,0,0,0,1.0,1,1.0,1,1.0,1,0.13397655964073102,87
3739,2,7213,2823,4390,0,0,0,1.0,1,1.0,1,1.0,1,0.1200963978545257,88
3740,4,7217,2824,4393,0,0,0,1.0,1,1.0,1,1.0,1,0.12378700707557504,87
3741,4,7221,2824,4397,0,0,0,1.0,1,1.0,1,1.0,1,0.12022568184118697,87
3742,1,7222,2825,4397,0,0,0,1.0,1,1.0,1,1.0,1,0.11168693404196589,86
3743,1,7223,2825,4398,0,0,0,1.0,1,1.0,1,1.0,1,0.11968396148458697,84
3744,1,7224,2826,4398,0,0,0,1.0,1,1.0,1,1.0,1,0.1537906939110872,83
3745,6,7230,2827,4403,0,0,0,1.0,1,1.0,1,1.0,1,0.14539031522158255,83
3746,3,7233,2827,4406,0,0,0,1.0,1,1.0,1,1.0,1,0.13949020422496564,83
3747,5,7238,2829,4409,0,0,0,1.0,1,1.0,1,1.0,1,0.13358522985737872,81
3748,0,7238,2829,4409,0,0,0,1.0,1,1.0,1,1.0,1,0.1373954759334397,81
3749,2,7240,2829,4411,0,0,0,1.0,1,1.0,1,1.0,1,0.1256865753491469,80
3750,0,7240,2829,4411,0,0,0,1.0,1,1.0,1,1.0,1,0.12908263624470298,79
3751,4,7244,2831,4413,0,0,0,1.0,1,1.0,1,1.0,1,0.13143867322964728,80
3752,1,7245,2832,4413,0,0,0,1.0,1,1.0,1,1.0,1,0.15066764232287302,80
3753,4,7249,2833,4416,0,0,0,1.0,1,1.0,1,1.0,1,0.14440166340784846,81
3754,3,7252,2834,4418,0,0,0,1.0,1,1.0,1,1.0,1,0.1500040380885978,81
3755,4,7256,2835,4421,0,0,0,1.0,1,1.0,1,1.0,1,0.16226510616506717,80
3756,1,7257,2836,4421,0,0,0,1.0,1,1.0,1,1.0,1,0.19389993417634419,79
3757,5,7262,2836,4426,0,0,0,1.0,1,1.0,1,1.0,1,0.18769386667340818,80
3758,4,7266,2836,4430,0,0,0,1.0,1,1.0,1,1.0,1,0.1915892895216733,79
3759,2,7268,2837,4431,0,0,0,1.0,1,1.0,1,1.0,1,0.18487936138066954,79
3760,0,7268,2837,4431,0,0,0,1.0,1,1.0,1,1.0,1,0.18487936138066954,79
3761,0,7268,2837,4431,0,0,0,1.0,1,1.0,1,1.0,1,0.2006730326467933,78
3762,2,7270,2837,4433,0,0,0,1.0,1,1.0,1,1.0,1,0.18999859397848856,80
3763,0,7270,2837,4433,0,0,0,1.0,1,1.0,1,1.0,1,0.18999859397848856,80
3764,2,7272,2839,4433,0,0,0,1.0,1,1.0,1,1.0,1,0.2145753157445055,80
3765,6,7278,2839,4439,0,0,0,1.0,1,1.0,1,1.0,1,0.18670621416392105,81
3766,2,7280,2840,4440,0,0,0,1.0,1,1.0,1,1.0,1,0.1955329387853765,83
3767,7,7287,2841,4446,0,0,0,1.0,1,1.0,1,1.0,1,0.15986490653213753,83
3768,1,7288,2842,4446,0,0,0,1.0,1,1.0,1,1.0,1,0.15932678410800835,84
3769,6,7294,2842,4452,0,0,0,1.0,1,1.0,1,1.0,1,0.11319037925371951,86
3770,0,7294,2842,4452,0,0,0,1.0,1,1.0,1,1.0,1,0.12006325085962799,87
3771,1,7295,2842,4453,0,0,0,1.0,1,1.0,1,1.0,1,0.11004342323650679,87
3772,1,7296,2842,4454,0,0,0,1.0,1,1.0,1,1.0,1,0.1262044513185298,88
3773,1,7297,2842,4455,0,0,0,1.0,1,1.0,1,1.0,1,0.13189338975821646,85
3774,1,7298,2842,4456,0,0,0,1.0,1,1.0,1,1.0,1,0.12788955508890662,85
3775,3,7301,2843,4458,0,0,0,1.0,1,1.0,1,1.0,1,0.1477227526710456,83
3776,2,7303,2844,4459,0,0,0,1.0,1,1.0,1,1.0,1,0.16241697188675483,82
3777,4,7307,2846,4461,0,0,0,1.0,1,1.0,1,1.0,1,0.15184915173019295,81
3778,0,7307,2846,4461,0,0,0,1.0,1,1.0,1,1.0,1,0.14604099359032172,81
3779,3,7310,2848,4462,0,0,0,1.0,1,1.0,1,1.0,1,0.16062414202289288,80
3780,2,7312,2848,4464,0,0,0,1.0,1,1.0,1,1.0,1,0.1589190670810524,80
3781,4,7316,2848,4468,0,0,0,1.0,1,1.0,1,1.0,1,0.14020522235454827,80
3782,1,7317,2849,4468,0,0,0,1.0,1,1.0,1,1.0,1,0.15082741999731117,80
3783,1,7318,2850,4468,0,0,0,1.0,1,1.0,1,1.0,1,0.17299891504146447,80
3784,0,7318,2850,4468,0,0,0,1.0,1,1.0,1,1.0,1,0.17761933655443907,79
3785,4,7322,2850,4472,0,0,0,1.0,1,1.0,1,1.0,1,0.15710884157685448,77
3786,0,7322,2850,4472,0,0,0,1.0,1,1.0,1,1.0,1,0.14946997560385622,78
3787,1,7323,2850,4473,0,0,0,1.0,1,1.0,1,1.0,1,0.14555129936683925,77
3788,4,7327,2851,4476,0,0,0,1.0,1,1.0,1,1.0,1,0.14577885930013948,78
3789,5,7332,2853,4479,0,0,0,1.0,1,1.0,1,1.0,1,0.14809618070099195,77
3790,2,7334,2854,4480,0,0,0,1.0,1,1.0,1,1.0,1,0.1610704699928019,77
3791,0,7334,2854,4480,0,0,0,1.0,1,1.0,1,1.0,1,0.1610704699928019,77
3792,0,7334,2854,4480,0,0,0,1.0,1,1.0,1,1.0,1,0.14659896395646138,78
3793,1,7335,2854,4481,0,0,0,1.0,1,1.0,1,1.0,1,0.13826919543555852,80
3794,4,7339,2854,4485,0,0,0,1.0,1,1.0,1,1.0,1,0.11064196358135574,82
3795,2,7341,2854,4487,0,0,0,1.0,1,1.0,1,1.0,1,0.10577918960158766,83
3796,2,7343,2856,4487,0,0,0,1.0,1,1.0,1,1.0,1,0.10620176093128263,83
3797,5,7348,2856,4492,0,0,0,1.0,1,1.0,1,1.0,1,0.07969971444346673,82
3798,0,7348,2856,4492,0,0,0,1.0,1,1.0,1,1.0,1,0.08309987464281952,82
3799,1,7349,2856,4493,0,0,0,1.0,1,1.0,1,1.0,1,0.08748921873848328,83
3800,1,7350,2857,4493,0,0,0,1.0,1,1.0,1,1.0,1,0.10353645599559884,83
3801,2,7352,2858,4494,0,0,0,1.0,1,1.0,1,1.0,1,0.1024292711204872,83
3802,1,7353,2858,4495,0,0,0,1.0,1,1.0,1,1.0,1,0.11209877654814658,82
3803,3,7356,2858,4498,0,0,0,1.0,1,1.0,1,1.0,1,0.09597173890704087,84
3804,0,7356,2858,4498,0,0,0,1.0,1,1.0,1,1.0,1,0.09597173890704087,84
3805,2,7358,2859,4499,0,0,0,1.0,1,1.0,1,1.0,1,0.1295142776557848,86
3806,1,7359,2859,4500,0,0,0,1.0,1,1.0,1,1.0,1,0.11971619362118437,86
3807,3,7362,2860,4502,0,0,0,1.0,1,1.0,1,1.0,1,0.1312950503686705,86
3808,0,7362,2860,4502,0,0,0,1.0,1,1.0,1,1.0,1,0.1297460037749713,85
3809,4,7366,2861,4505,0,0,0,1.0,1,1.0,1,1.0,1,0.12586602854747303,85
3810,0,7366,2861,4505,0,0,0,1.0,1,1.0,1,1.0,1,0.12586602854747303,85
3811,2,7368,2862,4506,0,0,0,1.0,1,1.0,1,1.0,1,0.1310815228329239,84
3812,0,7368,2862,4506,0,0,0,1.0,1,1.0,1,1.0,1,0.13023271228163563,83
3813,1,7369,2862,4507,0,0,0,1.0,1,1.0,1,1.0,1,0.12245816991324902,82
3814,2,7371,2864,4507,0,0,0,1.0,1,1.0,1,1.0,1,0.14536163491952644,81
3815,3,7374,2864,4510,0,0,0,1.0,1,1.0,1,1.0,1,0.11609650815660276,82
3816,1,7375,2864,4511,0,0,0,1.0,1,1.0,1,1.0,1,0.09656555392341287,81
3817,1,7376,2865,4511,0,0,0,1.0,1,1.0,1,1.0,1,0.10267501988133468,81
3818,2,7378,2867,4511,0,0,0,1.0,1,1.0,1,1.0,1,0.1477850874343585,81
3819,5,7383,2869,4514,0,0,0,1.0,1,1.0,1,1.0,1,0.1597808334249011,82
3820,6,7389,2869,4520,0,0,0,1.0,1,1.0,1,1.0,1,0.1368206724020026,84
3821,3,7392,2869,4523,0,0,0,1.0,1,1.0,1,1.0,1,0.12237189932291984,84
3822,2,7394,2869,4525,0,0,0,1.0,1,1.0,1,1.0,1,0.1132852833653929,82
3823,2,7396,2870,4526,0,0,0,1.0,1,1.0,1,1.0,1,0.10122217300442657,81
3824,0,7396,2870,4526,0,0,0,1.0,1,1.0,1,1.0,1,0.11790526912359886,78
3825,2,7398,2870,4528,0,0,0,1.0,1,1.0,1,1.0,1,0.1207067293730218,76
3826,4,7402,2870,4532,0,0,0,1.0,1,1.0,1,1.0,1,0.11991057978546882,76
3827,2,7404,2871,4533,0,0,0,1.0,1,1.0,1,1.0,1,0.14405175556117122,75
3828,1,7405,2872,4533,0,0,0,1.0,1,1.0,1,1.0,1,0.1528185936351529,74
3829,5,7410,2874,4536,0,0,0,1.0,1,1.0,1,1.0,1,0.16768878632671727,74
3830,1,7411,2874,4537,0,0,0,1.0,1,1.0,1,1.0,1,0.1615690046852539,74
3831,8,7419,2875,4544,0,0,0,1.0,1,1.0,1,1.0,1,0.16610764442037676,74
3832,2,7421,2875,4546,0,0,0,1.0,1,1.0,1,1.0,1,0.1473274408691691,73
3833,3,7424,2877,4547,0,0,0,1.0,1,1.0,1,1.0,1,0.1506883726865143,73
3834,2,7426,2877,4549,0,0,0,1.0,1,1.0,1,1.0,1,0.15134315778597265,74
3835,3,7429,2878,4551,0,0,0,1.0,1,1.0,1,1.0,1,0.15731694846084815,75
3836,2,7431,2878,4553,0,0,0,1.0,1,1.0,1,1.0,1,0.1403015662561206,75
3837,7,7438,2879,4559,0,0,0,1.0,1,1.0,1,1.0,1,0.14891333247802813,78
3838,2,7440,2880,4560,0,0,0,1.0,1,1.0,1,1.0,1,0.14361609979811732,78
3839,3,7443,2880,4563,0,0,0,1.0,1,1.0,1,1.0,1,0.11691240806587314,79
3840,3,7446,2881,4565,0,0,0,1.0,1,1.0,1,1.0,1,0.11598016091161772,82
3841,1,7447,2881,4566,0,0,0,1.0,1,1.0,1,1.0,1,0.11239016237594635,82
3842,0,7447,2881,4566,0,0,0,1.0,1,1.0,1,1.0,1,0.11090326476732411,82
3843,2,7449,2881,4568,0,0,0,1.0,1,1.0,1,1.0,1,0.09253814287944113,82
3844,0,7449,2881,4568,0,0,0,1.0,1,1.0,1,1.0,1,0.09132442986736454,83
3845,1,7450,2881,4569,0,0,0,1.0,1,1.0,1,1.0,1,0.0875598879435388,84
3846,2,7452,2881,4571,0,0,0,1.0,1,1.0,1,1.0,1,0.0837033285251018,85
3847,2,7454,2881,4573,0,0,0,1.0,1,1.0,1,1.0,1,0.0838444583030493,84
3848,2,7456,2883,4573,0,0,0,1.0,1,1.0,1,1.0,1,0.10716373242277284,84
3849,3,7459,2883,4576,0,0,0,1.0,1,1.0,1,1.0,1,0.09453790814186094,83
3850,0,7459,2883,4576,0,0,0,1.0,1,1.0,1,1.0,1,0.11233451334469248,80
3851,3,7462,2883,4579,0,0,0,1.0,1,1.0,1,1.0,1,0.08524327324997157,80
3852,0,7462,2883,4579,0,0,0,1.0,1,1.0,1,1.0,1,0.10168807233707426,79
3853,2,7464,2884,4580,0,0,0,1.0,1,1.0,1,1.0,1,0.10944468813594516,79
3854,2,7466,2886,4580,0,0,0,1.0,1,1.0,1,1.0,1,0.14251282862192566,78
3855,3,7469,2887,4582,0,0,0,1.0,1,1.0,1,1.0,1,0.13824965067095885,78
3856,3,7472,2888,4584,0,0,0,1.0,1,1.0,1,1.0,1,0.13961811754251396,80
3857,4,7476,2888,4588,0,0,0,1.0,1,1.0,1,1.0,1,0.10549553417464257,81
3858,2,7478,2890,4588,0,0,0,1.0,1,1.0,1,1.0,1,0.12072845632950163,81
3859,0,7478,2890,4588,0,0,0,1.0,1,1.0,1,1.0,1,0.1256198506186094,83
3860,1,7479,2891,4588,0,0,0,1.0,1,1.0,1,1.0,1,0.14224621493552947,82
3861,1,7480,2891,4589,0,0,0,1.0,1,1.0,1,1.0,1,0.13876447488343893,84
3862,1,7481,2892,4589,0,0,0,1.0,1,1.0,1,1.0,1,0.1468740037911295,85
3863,2,7483,2892,4591,0,0,0,1.0,1,1.0,1,1.0,1,0.126438990015953,84
3864,4,7487,2895,4592,0,0,0,1.0,1,1.0,1,1.0,1,0.11733643876957667,83
3865,1,7488,2896,4592,0,0,0,1.0,1,1.0,1,1.0,1,0.1198079169789218,82
3866,0,7488,2896,4592,0,0,0,1.0,1,1.0,1,1.0,1,0.11388863130956767,81
3867,4,7492,2899,4593,0,0,0,1.0,1,1.0,1,1.0,1,0.11866357925986833,81
3868,4,7496,2900,4596,0,0,0,1.0,1,1.0,1,1.0,1,0.10662561303289143,81
3869,0,7496,2900,4596,0,0,0,1.0,1,1.0,1,1.0,1,0.10816549756007757,81
3870,0,7496,2900,4596,0,0,0,1.0,1,1.0,1,1.0,1,0.10246102211043112,80
3871,2,7498,2901,4597,0,0,0,1.0,1,1.0,1,1.0,1,0.10671573243647295,82
3872,4,7502,2902,4600,0,0,0,1.0,1,1.0,1,1.0,1,0.09745641223210992,81
3873,2,7504,2902,4602,0,0,0,1.0,1,1.0,1,1.0,1,0.08180300357873613,81
3874,3,7507,2904,4603,0,0,0,1.0,1,1.0,1,1.0,1,0.07579701437724234,78
3875,1,7508,2904,4604,0,0,0,1.0,1,1.0,1,1.0,1,0.0584195704510515,77
3876,0,7508,2904,4604,0,0,0,1.0,1,1.0,1,1.0,1,0.06410795922611708,78
3877,2,7510,2904,4606,0,0,0,1.0,1,1.0,1,1.0,1,0.08211477553490619,75
3878,0,7510,2904,4606,0,0,0,1.0,1,1.0,1,1.0,1,0.08211477553490619,75
3879,0,7510,2904,4606,0,0,0,1.0,1,1.0,1,1.0,1,0.10714961752967428,73
3880,0,7510,2904,4606,0,0,0,1.0,1,1.0,1,1.0,1,0.09516110854764971,74
3881,1,7511,2904,4607,0,0,0,1.0,1,1.0,1,1.0,1,0.0910272353998553,75
3882,3,7514,2904,4610,0,0,0,1.0,1,1.0,1,1.0,1,0.07429069882959699,76
3883,1,7515,2904,4611,0,0,0,1.0,1,1.0,1,1.0,1,0.06733939499720956,77
3884,6,7521,2906,4615,0,0,0,1.0,1,1.0,1,1.0,1,0.09001174228309931,78
3885,1,7522,2906,4616,0,0,0,1.0,1,1.0,1,1.0,1,0.07265697257288004,78
3886,2,7524,2906,4618,0,0,0,1.0,1,1.0,1,1.0,1,0.05903415972364833,79
3887,3,7527,2907,4620,0,0,0,1.0,1,1.0,1,1.0,1,0.05073407221128335,78
3888,2,7529,2909,4620,0,0,0,1.0,1,1.0,1,1.0,1,0.07823418983196896,80
3889,6,7535,2910,4625,0,0,0,1.0,1,1.0,1,1.0,1,0.10262268545348599,82
3890,7,7542,2912,4630,0,0,0,1.0,1,1.0,1,1.0,1,0.08298234642267237,82
3891,3,7545,2913,4632,0,0,0,1.0,1,1.0,1,1.0,1,0.08790563521006108,85
3892,10,7555,2916,4639,0,0,0,1.0,1,1.0,1,1.0,1,0.07858578642151824,87
3893,2,7557,2916,4641,0,0,0,1.0,1,1.0,1,1.0,1,0.07015860831261271,86
3894,0,7557,2916,4641,0,0,0,1.0,1,1.0,1,1.0,1,0.07647805074036108,87
3895,3,7560,2918,4642,0,0,0,1.0,1,1.0,1,1.0,1,0.09605331029970238,87
3896,0,7560,2918,4642,0,0,0,1.0,1,1.0,1,1.0,1,0.1064216532665128,85
3897,4,7564,2919,4645,0,0,0,1.0,1,1.0,1,1.0,1,0.1015301070038255,85
3898,8,7572,2921,4651,0,0,0,1.0,1,1.0,1,1.0,1,0.11101963793791285,86
3899,1,7573,2921,4652,0,0,0,1.0,1,1.0,1,1.0,1,0.10648435643672229,86
3900,0,7573,2921,4652,0,0,0,1.0,1,1.0,1,1.0,1,0.10648435643672229,86
3901,2,7575,2922,4653,0,0,0,1.0,1,1.0,1,1.0,1,0.11278479081819792,86
3902,1,7576,2923,4653,0,0,0,1.0,1,1.0,1,1.0,1,0.12149903815218177,87
3903,5,7581,2923,4658,0,0,0,1.0,1,1.0,1,1.0,1,0.0805061435854927,87
3904,4,7585,2926,4659,0,0,0,1.0,1,1.0,1,1.0,1,0.110422068444316,85
3905,6,7591,2927,4664,0,0,0,1.0,1,1.0,1,1.0,1,0.060564862480213276,84
3906,6,7597,2929,4668,0,0,0,1.0,1,1.0,1,1.0,1,0.055457960850551734,86
3907,1,7598,2930,4668,0,0,0,1.0,1,1.0,1,1.0,1,0.06553749538541757,84
3908,0,7598,2930,4668,0,0,0,1.0,1,1.0,1,1.0,1,0.06019582882231316,83
3909,0,7598,2930,4668,0,0,0,1.0,1,1.0,1,1.0,1,0.056095452751609015,81
3910,4,7602,2933,4669,0,0,0,1.0,1,1.0,1,1.0,1,0.06416824262217609,82
3911,4,7606,2936,4670,0,0,0,1.0,1,1.0,1,1.0,1,0.073818709151437,81
3912,3,7609,2937,4672,0,0,0,1.0,1,1.0,1,1.0,1,0.06152375862803197,80
3913,3,7612,2938,4674,0,0,0,1.0,1,1.0,1,1.0,1,0.06425738270800155,80
3914,1,7613,2939,4674,0,0,0,1.0,1,1.0,1,1.0,1,0.10115347866509262,81
3915,7,7620,2941,4679,0,0,0,1.0,1,1.0,1,1.0,1,0.08565926439289462,81
3916,7,7627,2943,4684,0,0,0,1.0,1,1.0,1,1.0,1,0.06945020001290256,81
3917,1,7628,2944,4684,0,0,0,1.0,1,1.0,1,1.0,1,0.06008827751354275,82
3918,1,7629,2945,4684,0,0,0,1.0,1,1.0,1,1.0,1,0.09613576520841448,85
3919,1,7630,2946,4684,0,0,0,1.0,1,1.0,1,1.0,1,0.08736330459046224,85
3920,1,7631,2947,4684,0,0,0,1.0,1,1.0,1,1.0,1,0.08141765533070416,85
3921,2,7633,2947,4686,0,0,0,1.0,1,1.0,1,1.0,1,0.07637157181204145,88
3922,2,7635,2947,4688,0,0,0,1.0,1,1.0,1,1.0,1,0.06316596147166956,88
3923,2,7637,2948,4689,0,0,0,1.0,1,1.0,1,1.0,1,0.07193049702580269,89
3924,1,7638,2948,4690,0,0,0,1.0,1,1.0,1,1.0,1,0.07995676909122161,90
3925,5,7643,2950,4693,0,0,0,1.0,1,1.0,1,1.0,1,0.07224971465775257,88
3926,1,7644,2950,4694,0,0,0,1.0,1,1.0,1,1.0,1,0.07198833438750622,89
3927,4,7648,2952,4696,0,0,0,1.0,1,1.0,1,1.0,1,0.10299551487628836,89
3928,1,7649,2952,4697,0,0,0,1.0,1,1.0,1,1.0,1,0.09719473452317483,88
3929,2,7651,2952,4699,0,0,0,1.0,1,1.0,1,1.0,1,0.09012260522979999,88
3930,0,7651,2952,4699,0,0,0,1.0,1,1.0,1,1.0,1,0.08198945447572192,87
3931,0,7651,2952,4699,0,0,0,1.0,1,1.0,1,1.0,1,0.0824725317074622,86
3932,1,7652,2953,4699,0,0,0,1.0,1,1.0,1,1.0,1,0.0939721133335422,85
3933,2,7654,2953,4701,0,0,0,1.0,1,1.0,1,1.0,1,0.08976917425656242,84
3934,3,7657,2954,4703,0,0,0,1.0,1,1.0,1,1.0,1,0.08580865499509693,85
3935,3,7660,2955,4705,0,0,0,1.0,1,1.0,1,1.0,1,0.07480951326295973,84
3936,0,7660,2955,4705,0,0,0,1.0,1,1.0,1,1.0,1,0.07397101421786136,84
3937,3,7663,2956,4707,0,0,0,1.0,1,1.0,1,1.0,1,0.08072608908448485,82
3938,1,7664,2956,4708,0,0,0,1.0,1,1.0,1,1.0,1,0.06970869203105033,82
3939,1,7665,2956,4709,0,0,0,1.0,1,1.0,1,1.0,1,0.06624433787026078,84
3940,4,7669,2958,4711,0,0,0,1.0,1,1.0,1,1.0,1,0.07296366145765858,84
3941,2,7671,2958,4713,0,0,0,1.0,1,1.0,1,1.0,1,0.0495881320332391,85
3942,4,7675,2961,4714,0,0,0,1.0,1,1.0,1,1.0,1,0.08427515259875747,85
3943,4,7679,2961,4718,0,0,0,1.0,1,1.0,1,1.0,1,0.053461606329171664,84
3944,1,7680,2962,4718,0,0,0,1.0,1,1.0,1,1.0,1,0.09026454229430682,83
3945,4,7684,2963,4721,0,0,0,1.0,1,1.0,1,1.0,1,0.07308358671140662,83
3946,3,7687,2964,4723,0,0,0,1.0,1,1.0,1,1.0,1,0.0878506892073863,83
3947,2,7689,2964,4725,0,0,0,1.0,1,1.0,1,1.0,1,0.07481879609928195,83
3948,4,7693,2965,4728,0,0,0,1.0,1,1.0,1,1.0,1,0.07261509995763352,84
3949,1,7694,2965,4729,0,0,0,1.0,1,1.0,1,1.0,1,0.0809616162078213,84
3950,1,7695,2966,4729,0,0,0,1.0,1,1.0,1,1.0,1,0.08890511347388996,86
3951,3,7698,2966,4732,0,0,0,1.0,1,1.0,1,1.0,1,0.07699729138011706,87
3952,0,7698,2966,4732,0,0,0,1.0,1,1.0,1,1.0,1,0.07512634851272149,86
3953,1,7699,2967,4732,0,0,0,1.0,1,1.0,1,1.0,1,0.08117713075738316,86
3954,1,7700,2967,4733,0,0,0,1.0,1,1.0,1,1.0,1,0.07322393709658409,85
3955,3,7703,2967,4736,0,0,0,1.0,1,1.0,1,1.0,1,0.0768525565465856,85
3956,0,7703,2967,4736,0,0,0,1.0,1,1.0,1,1.0,1,0.0886152641304282,84
3957,3,7706,2967,4739,0,0,0,1.0,1,1.0,1,1.0,1,0.08567835531438836,85
3958,0,7706,2967,4739,0,0,0,1.0,1,1.0,1,1.0,1,0.08443913348446246,84
3959,6,7712,2968,4744,0,0,0,1.0,1,1.0,1,1.0,1,0.07035926151402826,83
3960,3,7715,2969,4746,0,0,0,1.0,1,1.0,1,1.0,1,0.0975324398164241,84
3961,3,7718,2970,4748,0,0,0,1.0,1,1.0,1,1.0,1,0.10157905319514193,83
3962,1,7719,2971,4748,0,0,0,1.0,1,1.0,1,1.0,1,0.10436831782537864,84
3963,2,7721,2972,4749,0,0,0,1.0,1,1.0,1,1.0,1,0.09307009231580668,81
3964,5,7726,2975,4751,0,0,0,1.0,1,1.0,1,1.0,1,0.1028834062917099,81
3965,3,7729,2975,4754,0,0,0,1.0,1,1.0,1,1.0,1,0.07713822072117499,81
3966,1,7730,2976,4754,0,0,0,1.0,1,1.0,1,1.0,1,0.09345705750656756,79
3967,4,7734,2978,4756,0,0,0,1.0,1,1.0,1,1.0,1,0.09096925703876792,81
3968,1,7735,2978,4757,0,0,0,1.0,1,1.0,1,1.0,1,0.09260951624711673,79
3969,4,7739,2981,4758,0,0,0,1.0,1,1.0,1,1.0,1,0.1040031141988283,79
3970,1,7740,2982,4758,0,0,0,1.0,1,1.0,1,1.0,1,0.12132960323310485,78
3971,3,7743,2983,4760,0,0,0,1.0,1,1.0,1,1.0,1,0.10157085693961232,77
3972,1,7744,2984,4760,0,0,0,1.0,1,1.0,1,1.0,1,0.1070863654714995,78
3973,0,7744,2984,4760,0,0,0,1.0,1,1.0,1,1.0,1,0.11002526615009058,77
3974,0,7744,2984,4760,0,0,0,1.0,1,1.0,1,1.0,1,0.11002526615009058,77
3975,2,7746,2985,4761,0,0,0,1.0,1,1.0,1,1.0,1,0.12403107449291084,76
3976,0,7746,2985,4761,0,0,0,1.0,1,1.0,1,1.0,1,0.1267533134805936,77
3977,3,7749,2985,4764,0,0,0,1.0,1,1.0,1,1.0,1,0.11051211396968619,78
3978,2,7751,2986,4765,0,0,0,1.0,1,1.0,1,1.0,1,0.1377042517653816,79
3979,1,7752,2986,4766,0,0,0,1.0,1,1.0,1,1.0,1,0.13399291721272466,79
3980,0,7752,2986,4766,0,0,0,1.0,1,1.0,1,1.0,1,0.13399291721272466,79
3981,9,7761,2987,4774,0,0,0,1.0,1,1.0,1,1.0,1,0.1137123123226628,83
3982,1,7762,2987,4775,0,0,0,1.0,1,1.0,1,1.0,1,0.09550581818866924,83
3983,2,7764,2987,4777,0,0,0,1.0,1,1.0,1,1.0,1,0.08758288139694402,82
3984,1,7765,2987,4778,0,0,0,1.0,1,1.0,1,1.0,1,0.07723729479473077,83
3985,3,7768,2989,4779,0,0,0,1.0,1,1.0,1,1.0,1,0.07714515190920353,84
3986,1,7769,2990,4779,0,0,0,1.0,1,1.0,1,1.0,1,0.08831357209133212,83
3987,3,7772,2991,4781,0,0,0,1.0,1,1.0,1,1.0,1,0.10274382740067166,82
3988,2,7774,2992,4782,0,0,0,1.0,1,1.0,1,1.0,1,0.10002928315166648,83
3989,1,7775,2992,4783,0,0,0,1.0,1,1.0,1,1.0,1,0.10240515423255069,81
3990,1,7776,2992,4784,0,0,0,1.0,1,1.0,1,1.0,1,0.09998178784134197,81
3991,3,7779,2994,4785,0,0,0,1.0,1,1.0,1,1.0,1,0.10801653052108184,79
3992,1,7780,2994,4786,0,0,0,1.0,1,1.0,1,1.0,1,0.10573843865830901,81
3993,5,7785,2995,4790,0,0,0,1.0,1,1.0,1,1.0,1,0.07357584812710787,80
3994,1,7786,2996,4790,0,0,0,1.0,1,1.0,1,1.0,1,0.066939797920472,80
3995,1,7787,2997,4790,0,0,0,1.0,1,1.0,1,1.0,1,0.06922871302225174,81
3996,0,7787,2997,4790,0,0,0,1.0,1,1.0,1,1.0,1,0.09657812873383506,80
3997,2,7789,2998,4791,0,0,0,1.0,1,1.0,1,1.0,1,0.08963043582671971,81
3998,2,7791,2999,4792,0,0,0,1.0,1,1.0,1,1.0,1,0.08307610503437846,82
3999,2,7793,2999,4794,0,0,0,1.0,1,1.0,1,1.0,1,0.06364475176824169,82
4000,5,7798,3002,4796,0,0,0,1.0,1,1.0,1,1.0,1,0.06981316682716593,82
4001,2,7800,3003,4797,0,0,0,1.0,1,1.0,1,1.0,1,0.07263516236694079,81
4002,2,7802,3005,4797,0,0,0,1.0,1,1.0,1,1.0,1,0.08192177987513022,81
4003,4,7806,3008,4798,0,0,0,1.0,1,1.0,1,1.0,1,0.11562353669959423,81
4004,3,7809,3010,4799,0,0,0,1.0,1,1.0,1,1.0,1,0.12124428736761002,80
4005,4,7813,3012,4801,0,0,0,1.0,1,1.0,1,1.0,1,0.14133476178752163,78
4006,2,7815,3013,4802,0,0,0,1.0,1,1.0,1,1.0,1,0.10483609457340458,76
4007,2,7817,3014,4803,0,0,0,1.0,1,1.0,1,1.0,1,0.12749665027812673,75
4008,2,7819,3015,4804,0,0,0,1.0,1,1.0,1,1.0,1,0.0993694450297796,74
4009,4,7823,3016,4807,0,0,0,1.0,1,1.0,1,1.0,1,0.10294906818130051,75
4010,2,7825,3017,4808,0,0,0,1.0,1,1.0,1,1.0,1,0.10855888699957988,75
4011,3,7828,3018,4810,0,0,0,1.0,1,1.0,1,1.0,1,0.10341472694931936,74
4012,1,7829,3019,4810,0,0,0,1.0,1,1.0,1,1.0,1,0.10910655773422828,74
4013,2,7831,3020,4811,0,0,0,1.0,1,1.0,1,1.0,1,0.12174184527875503,74
4014,3,7834,3021,4813,0,0,0,1.0,1,1.0,1,1.0,1,0.12253081355483171,73
4015,2,7836,3021,4815,0,0,0,1.0,1,1.0,1,1.0,1,0.11588975049971482,74
4016,2,7838,3022,4816,0,0,0,1.0,1,1.0,1,1.0,1,0.13485408525049386,74
4017,7,7845,3024,4821,0,0,0,1.0,1,1.0,1,1.0,1,0.11896919383454822,78
4018,1,7846,3024,4822,0,0,0,1.0,1,1.0,1,1.0,1,0.12862728358822587,78
4019,4,7850,3024,4826,0,0,0,1.0,1,1.0,1,1.0,1,0.09411017159209946,78
4020,0,7850,3024,4826,0,0,0,1.0,1,1.0,1,1.0,1,0.09411017159209946,78
4021,0,7850,3024,4826,0,0,0,1.0,1,1.0,1,1.0,1,0.09411017159209946,78
4022,2,7852,3026,4826,0,0,0,1.0,1,1.0,1,1.0,1,0.11607622288273889,79
4023,1,7853,3027,4826,0,0,0,1.0,1,1.0,1,1.0,1,0.11355653675363239,78
4024,3,7856,3028,4828,0,0,0,1.0,1,1.0,1,1.0,1,0.12178127327400182,77
4025,5,7861,3030,4831,0,0,0,1.0,1,1.0,1,1.0,1,0.10039404991882965,76
4026,3,7864,3031,4833,0,0,0,1.0,1,1.0,1,1.0,1,0.0961940685215831,76
4027,4,7868,3034,4834,0,0,0,1.0,1,1.0,1,1.0,1,0.11235614196380395,75
4028,2,7870,3034,4836,0,0,0,1.0,1,1.0,1,1.0,1,0.0972738939259773,76
4029,0,7870,3034,4836,0,0,0,1.0,1,1.0,1,1.0,1,0.09625779783826108,75
4030,0,7870,3034,4836,0,0,0,1.0,1,1.0,1,1.0,1,0.1038702627324438,74
4031,4,7874,3036,4838,0,0,0,1.0,1,1.0,1,1.0,1,0.12085222502110729,73
4032,1,7875,3036,4839,0,0,0,1.0,1,1.0,1,1.0,1,0.11204398793115541,71
4033,2,7877,3037,4840,0,0,0,1.0,1,1.0,1,1.0,1,0.08883174457919234,73
4034,1,7878,3038,4840,0,0,0,1.0,1,1.0,1,1.0,1,0.08939059854632818,72
4035,1,7879,3039,4840,0,0,0,1.0,1,1.0,1,1.0,1,0.10633634358540991,71
4036,3,7882,3042,4840,0,0,0,1.0,1,1.0,1,1.0,1,0.08381111839889216,71
4037,3,7885,3044,4841,0,0,0,1.0,1,1.0,1,1.0,1,0.0909978147942135,70
4038,3,7888,3045,4843,0,0,0,1.0,1,1.0,1,1.0,1,0.09597223007390054,69
4039,4,7892,3046,4846,0,0,0,1.0,1,1.0,1,1.0,1,0.10610039358748477,68
4040,4,7896,3049,4847,0,0,0,1.0,1,1.0,1,1.0,1,0.1338928240412084,69
4041,2,7898,3050,4848,0,0,0,1.0,1,1.0,1,1.0,1,0.17092454248687566,67
4042,3,7901,3050,4851,0,0,0,1.0,1,1.0,1,1.0,1,0.1707540447213654,67
4043,4,7905,3051,4854,0,0,0,1.0,1,1.0,1,1.0,1,0.16432878915259783,66
4044,1,7906,3051,4855,0,0,0,1.0,1,1.0,1,1.0,1,0.1600267911326638,65
4045,0,7906,3051,4855,0,0,0,1.0,1,1.0,1,1.0,1,0.16419679909840446,66
4046,2,7908,3051,4857,0,0,0,1.0,1,1.0,1,1.0,1,0.16834826866575964,68
4047,2,7910,3051,4859,0,0,0,1.0,1,1.0,1,1.0,1,0.14098190350624293,68
4048,0,7910,3051,4859,0,0,0,1.0,1,1.0,1,1.0,1,0.14219007449998503,69
4049,2,7912,3053,4859,0,0,0,1.0,1,1.0,1,1.0,1,0.16970909920571156,69
4050,0,7912,3053,4859,0,0,0,1.0,1,1.0,1,1.0,1,0.1683923902603612,69
4051,2,7914,3053,4861,0,0,0,1.0,1,1.0,1,1.0,1,0.155492822428288,69
4052,1,7915,3053,4862,0,0,0,1.0,1,1.0,1,1.0,1,0.1463543660632478,69
4053,1,7916,3053,4863,0,0,0,1.0,1,1.0,1,1.0,1,0.14074065991636847,69
4054,1,7917,3054,4863,0,0,0,1.0,1,1.0,1,1.0,1,0.14709218053796785,70
4055,3,7920,3054,4866,0,0,0,1.0,1,1.0,1,1.0,1,0.11916574087235943,70
4056,0,7920,3054,4866,0,0,0,1.0,1,1.0,1,1.0,1,0.11916574087235943,70
4057,3,7923,3054,4869,0,0,0,1.0,1,1.0,1,1.0,1,0.09779881158174467,71
4058,0,7923,3054,4869,0,0,0,1.0,1,1.0,1,1.0,1,0.09779881158174467,71
4059,2,7925,3055,4870,0,0,0,1.0,1,1.0,1,1.0,1,0.10243235131259033,72
4060,0,7925,3055,4870,0,0,0,1.0,1,1.0,1,1.0,1,0.1104494938845155,71
4061,1,7926,3056,4870,0,0,0,1.0,1,1.0,1,1.0,1,0.12657565879513227,72
4062,4,7930,3057,4873,0,0,0,1.0,1,1.0,1,1.0,1,0.11881297280500738,72
4063,3,7933,3058,4875,0,0,0,1.0,1,1.0,1,1.0,1,0.1061730023193247,72
4064,1,7934,3059,4875,0,0,0,1.0,1,1.0,1,1.0,1,0.09908366052595345,71
4065,4,7938,3062,4876,0,0,0,1.0,1,1.0,1,1.0,1,0.11472581639618062,70
4066,3,7941,3062,4879,0,0,0,1.0,1,1.0,1,1.0,1,0.09236952454685211,70
4067,3,7944,3063,4881,0,0,0,1.0,1,1.0,1,1.0,1,0.07548353619107488,68
4068,3,7947,3064,4883,0,0,0,1.0,1,1.0,1,1.0,1,0.07977960147420096,70
4069,3,7950,3066,4884,0,0,0,1.0,1,1.0,1,1.0,1,0.08481334230517217,68
4070,2,7952,3067,4885,0,0,0,1.0,1,1.0,1,1.0,1,0.09032650642289589,67
4071,4,7956,3068,4888,0,0,0,1.0,1,1.0,1,1.0,1,0.08960594427532628,68
4072,2,7958,3069,4889,0,0,0,1.0,1,1.0,1,1.0,1,0.07479050605730568,70
4073,5,7963,3073,4890,0,0,0,1.0,1,1.0,1,1.0,1,0.1212939500688709,70
4074,11,7974,3079,4895,0,0,0,1.0,1,1.0,1,1.0,1,0.15754043797943104,71
4075,7,7981,3081,4900,0,0,0,1.0,1,1.0,1,1.0,1,0.10432587446289147,72
4076,7,7988,3081,4907,0,0,0,1.0,1,1.0,1,1.0,1,0.11844676503891034,73
4077,5,7993,3082,4911,0,0,0,1.0,1,1.0,1,1.0,1,0.11127947870813608,72
4078,5,7998,3084,4914,0,0,0,1.0,1,1.0,1,1.0,1,0.13573971545038396,71
4079,2,8000,3085,4915,0,0,0,1.0,1,1.0,1,1.0,1,0.14108224174990772,69
4080,1,8001,3086,4915,0,0,0,1.0,1,1.0,1,1.0,1,0.14864186406287605,67
4081,3,8004,3086,4918,0,0,0,1.0,1,1.0,1,1.0,1,0.120602731226873,66
4082,1,8005,3086,4919,0,0,0,1.0,1,1.0,1,1.0,1,0.12520301244650978,65
4083,3,8008,3088,4920,0,0,0,1.0,1,1.0,1,1.0,1,0.1354013838325474,64
4084,2,8010,3090,4920,0,0,0,1.0,1,1.0,1,1.0,1,0.16343838601171945,64
4085,4,8014,3090,4924,0,0,0,1.0,1,1.0,1,1.0,1,0.13233394657605735,65
4086,3,8017,3091,4926,0,0,0,1.0,1,1.0,1,1.0,1,0.13016524156594514,66
4087,2,8019,3091,4928,0,0,0,1.0,1,1.0,1,1.0,1,0.10363716675554577,66
4088,0,8019,3091,4928,0,0,0,1.0,1,1.0,1,1.0,1,0.14120733671030467,65
4089,1,8020,3092,4928,0,0,0,1.0,1,1.0,1,1.0,1,0.13992323334855566,65
4090,1,8021,3092,4929,0,0,0,1.0,1,1.0,1,1.0,1,0.14991473128629962,65
4091,1,8022,3092,4930,0,0,0,1.0,1,1.0,1,1.0,1,0.14438322605801795,65
4092,1,8023,3092,4931,0,0,0,1.0,1,1.0,1,1.0,1,0.1352498496429935,64
4093,3,8026,3092,4934,0,0,0,1.0,1,1.0,1,1.0,1,0.09791885042110894,66
4094,1,8027,3093,4934,0,0,0,1.0,1,1.0,1,1.0,1,0.13336951718475631,65
4095,1,8028,3093,4935,0,0,0,1.0,1,1.0,1,1.0,1,0.12284151806221376,65
4096,2,8030,3094,4936,0,0,0,1.0,1,1.0,1,1.0,1,0.11966733916664701,67
4097,3,8033,3095,4938,0,0,0,1.0,1,1.0,1,1.0,1,0.10743394451117717,67
4098,2,8035,3097,4938,0,0,0,1.0,1,1.0,1,1.0,1,0.12578014889893144,68
4099,6,8041,3098,4943,0,0,0,1.0,1,1.0,1,1.0,1,0.08706224531547677,69
4100,2,8043,3098,4945,0,0,0,1.0,1,1.0,1,1.0,1,0.07106553716554431,70
4101,1,8044,3098,4946,0,0,0,1.0,1,1.0,1,1.0,1,0.0794940001110969,71
4102,1,8045,3099,4946,0,0,0,1.0,1,1.0,1,1.0,1,0.07965298594085678,71
4103,3,8048,3100,4948,0,0,0,1.0,1,1.0,1,1.0,1,0.0746834643206128,71
4104,3,8051,3102,4949,0,0,0,1.0,1,1.0,1,1.0,1,0.11290380634689633,69
4105,3,8054,3103,4951,0,0,0,1.0,1,1.0,1,1.0,1,0.1200048661102441,67
4106,4,8058,3105,4953,0,0,0,1.0,1,1.0,1,1.0,1,0.13042256680449757,68
4107,5,8063,3105,4958,0,0,0,1.0,1,1.0,1,1.0,1,0.09769209826495402,70
4108,0,8063,3105,4958,0,0,0,1.0,1,1.0,1,1.0,1,0.0966553667144514,70
4109,0,8063,3105,4958,0,0,0,1.0,1,1.0,1,1.0,1,0.1013396180012599,69
4110,0,8063,3105,4958,0,0,0,1.0,1,1.0,1,1.0,1,0.08956238348851013,71
4111,2,8065,3105,4960,0,0,0,1.0,1,1.0,1,1.0,1,0.06846178915017861,70
4112,0,8065,3105,4960,0,0,0,1.0,1,1.0,1,1.0,1,0.07349857434730664,72
4113,2,8067,3106,4961,0,0,0,1.0,1,1.0,1,1.0,1,0.06082228051927731,72
4114,4,8071,3109,4962,0,0,0,1.0,1,1.0,1,1.0,1,0.10070166887509344,72
4115,4,8075,3111,4964,0,0,0,1.0,1,1.0,1,1.0,1,0.08622404226081486,70
4116,1,8076,3112,4964,0,0,0,1.0,1,1.0,1,1.0,1,0.09715509378767474,67
4117,4,8080,3115,4965,0,0,0,1.0,1,1.0,1,1.0,1,0.1327311715531131,67
4118,0,8080,3115,4965,0,0,0,1.0,1,1.0,1,1.0,1,0.16737510216923102,66
4119,3,8083,3116,4967,0,0,0,1.0,1,1.0,1,1.0,1,0.16730801145219004,67
4120,3,8086,3118,4968,0,0,0,1.0,1,1.0,1,1.0,1,0.20014044623549276,64
4121,2,8088,3118,4970,0,0,0,1.0,1,1.0,1,1.0,1,0.16202989028620285,63
4122,3,8091,3119,4972,0,0,0,1.0,1,1.0,1,1.0,1,0.15933375198663308,63
4123,3,8094,3120,4974,0,0,0,1.0,1,1.0,1,1.0,1,0.1366299592957617,61
4124,4,8098,3122,4976,0,0,0,1.0,1,1.0,1,1.0,1,0.1408225116297329,62
4125,1,8099,3122,4977,0,0,0,1.0,1,1.0,1,1.0,1,0.14360695481759087,60
4126,2,8101,3124,4977,0,0,0,1.0,1,1.0,1,1.0,1,0.15652913023995363,59
4127,4,8105,3125,4980,0,0,0,1.0,1,1.0,1,1.0,1,0.13590925421559216,60
4128,2,8107,3127,4980,0,0,0,1.0,1,1.0,1,1.0,1,0.15459080798145186,60
4129,2,8109,3127,4982,0,0,0,1.0,1,1.0,1,1.0,1,0.15977734011633762,60
4130,2,8111,3128,4983,0,0,0,1.0,1,1.0,1,1.0,1,0.1616822499149689,61
4131,3,8114,3129,4985,0,0,0,1.0,1,1.0,1,1.0,1,0.14914661946134739,60
4132,1,8115,3130,4985,0,0,0,1.0,1,1.0,1,1.0,1,0.1591059163912155,60
4133,4,8119,3131,4988,0,0,0,1.0,1,1.0,1,1.0,1,0.16859381920176622,62
4134,1,8120,3131,4989,0,0,0,1.0,1,1.0,1,1.0,1,0.1456957221707499,63
4135,2,8122,3131,4991,0,0,0,1.0,1,1.0,1,1.0,1,0.1241238394367788,65
4136,1,8123,3132,4991,0,0,0,1.0,1,1.0,1,1.0,1,0.13397728516319146,65
4137,3,8126,3133,4993,0,0,0,1.0,1,1.0,1,1.0,1,0.12076073380793462,66
4138,1,8127,3133,4994,0,0,0,1.0,1,1.0,1,1.0,1,0.12746030682080778,67
4139,2,8129,3135,4994,0,0,0,1.0,1,1.0,1,1.0,1,0.15490248939931384,67
4140,0,8129,3135,4994,0,0,0,1.0,1,1.0,1,1.0,1,0.14449326442611427,66
4141,3,8132,3135,4997,0,0,0,1.0,1,1.0,1,1.0,1,0.10875510829659839,67
4142,0,8132,3135,4997,0,0,0,1.0,1,1.0,1,1.0,1,0.10875510829659839,67
4143,0,8132,3135,4997,0,0,0,1.0,1,1.0,1,1.0,1,0.109807589021148,66
4144,1,8133,3136,4997,0,0,0,1.0,1,1.0,1,1.0,1,0.11749085960167234,64
4145,3,8136,3139,4997,0,0,0,1.0,1,1.0,1,1.0,1,0.14184503884418498,63
4146,4,8140,3143,4997,0,0,0,1.0,1,1.0,1,1.0,1,0.18120683461581016,62
4147,5,8145,3143,5002,0,0,0,1.0,1,1.0,1,1.0,1,0.1245559964721557,60
4148,5,8150,3145,5005,0,0,0,1.0,1,1.0,1,1.0,1,0.10691170863749823,62
4149,5,8155,3146,5009,0,0,0,1.0,1,1.0,1,1.0,1,0.08872929103948397,61
4150,2,8157,3147,5010,0,0,0,1.0,1,1.0,1,1.0,1,0.07214058699223476,60
4151,2,8159,3148,5011,0,0,0,1.0,1,1.0,1,1.0,1,0.08343233545792908,60
4152,2,8161,3149,5012,0,0,0,1.0,1,1.0,1,1.0,1,0.10650618418585149,60
4153,1,8162,3150,5012,0,0,0,1.0,1,1.0,1,1.0,1,0.12415265000165983,58
4154,1,8163,3150,5013,0,0,0,1.0,1,1.0,1,1.0,1,0.12765843571735946,57
4155,6,8169,3152,5017,0,0,0,1.0,1,1.0,1,1.0,1,0.10441575970446206,57
4156,1,8170,3153,5017,0,0,0,1.0,1,1.0,1,1.0,1,0.1288346006173745,58
4157,1,8171,3153,5018,0,0,0,1.0,1,1.0,1,1.0,1,0.11776697585619997,57
4158,1,8172,3154,5018,0,0,0,1.0,1,1.0,1,1.0,1,0.14819370549671929,55
4159,4,8176,3155,5021,0,0,0,1.0,1,1.0,1,1.0,1,0.15158546639935724,57
4160,1,8177,3156,5021,0,0,0,1.0,1,1.0,1,1.0,1,0.14831065726915008,58
4161,2,8179,3156,5023,0,0,0,1.0,1,1.0,1,1.0,1,0.12454043144161298,58
4162,0,8179,3156,5023,0,0,0,1.0,1,1.0,1,1.0,1,0.1256618392391618,57
4163,1,8180,3156,5024,0,0,0,1.0,1,1.0,1,1.0,1,0.10376250769041213,58
4164,3,8183,3158,5025,0,0,0,1.0,1,1.0,1,1.0,1,0.13841675026501576,56
4165,5,8188,3159,5029,0,0,0,1.0,1,1.0,1,1.0,1,0.126654932675526,58
4166,0,8188,3159,5029,0,0,0,1.0,1,1.0,1,1.0,1,0.12304158634056367,57
4167,1,8189,3160,5029,0,0,0,1.0,1,1.0,1,1.0,1,0.13998483447387688,57
4168,1,8190,3160,5030,0,0,0,1.0,1,1.0,1,1.0,1,0.12230352139978101,58
4169,0,8190,3160,5030,0,0,0,1.0,1,1.0,1,1.0,1,0.12230352139978101,58
4170,0,8190,3160,5030,0,0,0,1.0,1,1.0,1,1.0,1,0.13756860588505562,58
4171,0,8190,3160,5030,0,0,0,1.0,1,1.0,1,1.0,1,0.158052288917949,57
4172,1,8191,3160,5031,0,0,0,1.0,1,1.0,1,1.0,1,0.14889892165507757,57
4173,4,8195,3161,5034,0,0,0,1.0,1,1.0,1,1.0,1,0.15089750700490845,56
4174,2,8197,3162,5035,0,0,0,1.0,1,1.0,1,1.0,1,0.1686062455102145,56
4175,4,8201,3162,5039,0,0,0,1.0,1,1.0,1,1.0,1,0.14278662244730234,55
4176,1,8202,3162,5040,0,0,0,1.0,1,1.0,1,1.0,1,0.14991678501696593,57
4177,7,8209,3163,5046,0,0,0,1.0,1,1.0,1,1.0,1,0.1290122868281267,58
4178,5,8214,3165,5049,0,0,0,1.0,1,1.0,1,1.0,1,0.12481167482262995,60
4179,3,8217,3165,5052,0,0,0,1.0,1,1.0,1,1.0,1,0.10120113924468145,61
4180,2,8219,3166,5053,0,0,0,1.0,1,1.0,1,1.0,1,0.12507896814387334,62
4181,2,8221,3166,5055,0,0,0,1.0,1,1.0,1,1.0,1,0.10394294128951603,63
4182,0,8221,3166,5055,0,0,0,1.0,1,1.0,1,1.0,1,0.10394294128951603,63
4183,0,8221,3166,5055,0,0,0,1.0,1,1.0,1,1.0,1,0.09568242892012352,63
4184,1,8222,3167,5055,0,0,0,1.0,1,1.0,1,1.0,1,0.10299327971853774,63
4185,3,8225,3167,5058,0,0,0,1.0,1,1.0,1,1.0,1,0.08567970994990703,61
4186,3,8228,3169,5059,0,0,0,1.0,1,1.0,1,1.0,1,0.07236303673840462,62
4187,2,8230,3171,5059,0,0,0,1.0,1,1.0,1,1.0,1,0.09984548943458883,60
4188,0,8230,3171,5059,0,0,0,1.0,1,1.0,1,1.0,1,0.10496095164471765,60
4189,2,8232,3171,5061,0,0,0,1.0,1,1.0,1,1.0,1,0.07641415969453191,60
4190,3,8235,3174,5061,0,0,0,1.0,1,1.0,1,1.0,1,0.13499561045524064,61
4191,2,8237,3175,5062,0,0,0,1.0,1,1.0,1,1.0,1,0.1503742431037458,59
4192,1,8238,3175,5063,0,0,0,1.0,1,1.0,1,1.0,1,0.13379682294028405,58
4193,1,8239,3176,5063,0,0,0,1.0,1,1.0,1,1.0,1,0.15417427266670422,57
4194,4,8243,3178,5065,0,0,0,1.0,1,1.0,1,1.0,1,0.1943335213543305,54
4195,5,8248,3179,5069,0,0,0,1.0,1,1.0,1,1.0,1,0.16127395572822814,55
4196,2,8250,3179,5071,0,0,0,1.0,1,1.0,1,1.0,1,0.1535583432146797,56
4197,2,8252,3179,5073,0,0,0,1.0,1,1.0,1,1.0,1,0.11176651715907014,55
4198,1,8253,3180,5073,0,0,0,1.0,1,1.0,1,1.0,1,0.15265598339001707,56
4199,1,8254,3181,5073,0,0,0,1.0,1,1.0,1,1.0,1,0.19420907497976347,55
4200,0,8254,3181,5073,0,0,0,1.0,1,1.0,1,1.0,1,0.1942021424038797,55
4201,4,8258,3181,5077,0,0,0,1.0,1,1.0,1,1.0,1,0.14521186404859915,56
4202,0,8258,3181,5077,0,0,0,1.0,1,1.0,1,1.0,1,0.14521186404859915,56
4203,0,8258,3181,5077,0,0,0,1.0,1,1.0,1,1.0,1,0.15136067315673285,57
4204,1,8259,3182,5077,0,0,0,1.0,1,1.0,1,1.0,1,0.14912809151340856,57
4205,4,8263,3182,5081,0,0,0,1.0,1,1.0,1,1.0,1,0.11885792391595443,58
4206,2,8265,3183,5082,0,0,0,1.0,1,1.0,1,1.0,1,0.10437541239643905,58
4207,0,8265,3183,5082,0,0,0,1.0,1,1.0,1,1.0,1,0.10437541239643905,58
4208,2,8267,3184,5083,0,0,0,1.0,1,1.0,1,1.0,1,0.11234187928137304,60
4209,2,8269,3186,5083,0,0,0,1.0,1,1.0,1,1.0,1,0.10793680343331165,61
4210,1,8270,3187,5083,0,0,0,1.0,1,1.0,1,1.0,1,0.10130224602756406,62
4211,1,8271,3187,5084,0,0,0,1.0,1,1.0,1,1.0,1,0.07884656629251859,63
4212,0,8271,3187,5084,0,0,0,1.0,1,1.0,1,1.0,1,0.08694448132588921,64
4213,1,8272,3187,5085,0,0,0,1.0,1,1.0,1,1.0,1,0.0915739385240176,65
4214,0,8272,3187,5085,0,0,0,1.0,1,1.0,1,1.0,1,0.09504892669374608,65
4215,0,8272,3187,5085,0,0,0,1.0,1,1.0,1,1.0,1,0.09504892669374608,65
4216,0,8272,3187,5085,0,0,0,1.0,1,1.0,1,1.0,1,0.11028325855548245,64
4217,2,8274,3188,5086,0,0,0,1.0,1,1.0,1,1.0,1,0.11438602021789866,65
4218,0,8274,3188,5086,0,0,0,1.0,1,1.0,1,1.0,1,0.11438602021789866,65
4219,1,8275,3188,5087,0,0,0,1.0,1,1.0,1,1.0,1,0.09888704320729255,65
4220,2,8277,3189,5088,0,0,0,1.0,1,1.0,1,1.0,1,0.09494302662493866,65
4221,5,8282,3192,5090,0,0,0,1.0,1,1.0,1,1.0,1,0.14146645110194403,67
4222,3,8285,3193,5092,0,0,0,1.0,1,1.0,1,1.0,1,0.16090064160748951,68
4223,4,8289,3193,5096,0,0,0,1.0,1,1.0,1,1.0,1,0.1320471303338505,68
4224,3,8292,3195,5097,0,0,0,1.0,1,1.0,1,1.0,1,0.1380240063140504,68
4225,0,8292,3195,5097,0,0,0,1.0,1,1.0,1,1.0,1,0.12068801109425671,66
4226,1,8293,3196,5097,0,0,0,1.0,1,1.0,1,1.0,1,0.13597922108476926,66
4227,1,8294,3197,5097,0,0,0,1.0,1,1.0,1,1.0,1,0.16445924647091192,66
4228,0,8294,3197,5097,0,0,0,1.0,1,1.0,1,1.0,1,0.15254015826677486,65
4229,3,8297,3197,5100,0,0,0,1.0,1,1.0,1,1.0,1,0.1435172480568367,65
4230,3,8300,3198,5102,0,0,0,1.0,1,1.0,1,1.0,1,0.13046773873009632,64
4231,1,8301,3198,5103,0,0,0,1.0,1,1.0,1,1.0,1,0.12771495190799717,64
4232,2,8303,3198,5105,0,0,0,1.0,1,1.0,1,1.0,1,0.10256600290029046,65
4233,0,8303,3198,5105,0,0,0,1.0,1,1.0,1,1.0,1,0.10396601242157044,64
4234,0,8303,3198,5105,0,0,0,1.0,1,1.0,1,1.0,1,0.11583741029764277,63
4235,1,8304,3199,5105,0,0,0,1.0,1,1.0,1,1.0,1,0.12135026422495243,63
4236,0,8304,3199,5105,0,0,0,1.0,1,1.0,1,1.0,1,0.12135026422495243,63
4237,5,8309,3200,5109,0,0,0,1.0,1,1.0,1,1.0,1,0.10539807437784758,65
4238,1,8310,3200,5110,0,0,0,1.0,1,1.0,1,1.0,1,0.0877187298062243,65
4239,1,8311,3200,5111,0,0,0,1.0,1,1.0,1,1.0,1,0.08182443917968213,65
4240,1,8312,3201,5111,0,0,0,1.0,1,1.0,1,1.0,1,0.08311899146544711,66
4241,0,8312,3201,5111,0,0,0,1.0,1,1.0,1,1.0,1,0.08311899146544711,66
4242,1,8313,3201,5112,0,0,0,1.0,1,1.0,1,1.0,1,0.06587581071598905,69
4243,1,8314,3201,5113,0,0,0,1.0,1,1.0,1,1.0,1,0.06885629994675192,71
4244,0,8314,3201,5113,0,0,0,1.0,1,1.0,1,1.0,1,0.06885629994675192,71
4245,1,8315,3201,5114,0,0,0,1.0,1,1.0,1,1.0,1,0.06921904051771637,73
4246,1,8316,3201,5115,0,0,0,1.0,1,1.0,1,1.0,1,0.06229248680016329,74
4247,0,8316,3201,5115,0,0,0,1.0,1,1.0,1,1.0,1,0.06229248680016329,74
4248,0,8316,3201,5115,0,0,0,1.0,1,1.0,1,1.0,1,0.06229248680016329,74
4249,0,8316,3201,5115,0,0,0,1.0,1,1.0,1,1.0,1,0.06229248680016329,74
4250,1,8317,3202,5115,0,0,0,1.0,1,1.0,1,1.0,1,0.05728284104018687,74
4251,1,8318,3203,5115,0,0,0,1.0,1,1.0,1,1.0,1,0.06184898347263404,75
4252,3,8321,3206,5115,0,0,0,1.0,1,1.0,1,1.0,1,0.12377771486981407,75
4253,3,8324,3206,5118,0,0,0,1.0,1,1.0,1,1.0,1,0.10583306403454,76
4254,2,8326,3208,5118,0,0,0,1.0,1,1.0,1,1.0,1,0.11512980017987262,75
4255,5,8331,3210,5121,0,0,0,1.0,1,1.0,1,1.0,1,0.10419821037220442,76
4256,3,8334,3211,5123,0,0,0,1.0,1,1.0,1,1.0,1,0.09921954231433995,78
4257,5,8339,3213,5126,0,0,0,1.0,1,1.0,1,1.0,1,0.10313744498940222,78
4258,0,8339,3213,5126,0,0,0,1.0,1,1.0,1,1.0,1,0.1130989872726998,77
4259,3,8342,3214,5128,0,0,0,1.0,1,1.0,1,1.0,1,0.10340117263155246,78
4260,0,8342,3214,5128,0,0,0,1.0,1,1.0,1,1.0,1,0.1133492747973458,77
4261,4,8346,3216,5130,0,0,0,1.0,1,1.0,1,1.0,1,0.10393490114565387,76
4262,0,8346,3216,5130,0,0,0,1.0,1,1.0,1,1.0,1,0.13500514470988415,75
4263,3,8349,3217,5132,0,0,0,1.0,1,1.0,1,1.0,1,0.10994496004243655,74
4264,2,8351,3217,5134,0,0,0,1.0,1,1.0,1,1.0,1,0.12002960560288489,74
4265,6,8357,3219,5138,0,0,0,1.0,1,1.0,1,1.0,1,0.11243893671317667,73
4266,1,8358,3220,5138,0,0,0,1.0,1,1.0,1,1.0,1,0.12553666790933937,71
4267,3,8361,3222,5139,0,0,0,1.0,1,1.0,1,1.0,1,0.09582923245003282,69
4268,4,8365,3224,5141,0,0,0,1.0,1,1.0,1,1.0,1,0.11268772214722014,67
4269,6,8371,3226,5145,0,0,0,1.0,1,1.0,1,1.0,1,0.0892418763533797,64
4270,3,8374,3228,5146,0,0,0,1.0,1,1.0,1,1.0,1,0.09040181184183924,63
4271,1,8375,3229,5146,0,0,0,1.0,1,1.0,1,1.0,1,0.1251448341392404,63
4272,5,8380,3231,5149,0,0,0,1.0,1,1.0,1,1.0,1,0.17294028471328862,62
4273,3,8383,3232,5151,0,0,0,1.0,1,1.0,1,1.0,1,0.17518280354281104,62
4274,1,8384,3232,5152,0,0,0,1.0,1,1.0,1,1.0,1,0.16582396143700884,62
4275,2,8386,3232,5154,0,0,0,1.0,1,1.0,1,1.0,1,0.1556675645888123,61
4276,0,8386,3232,5154,0,0,0,1.0,1,1.0,1,1.0,1,0.14976769848076082,62
4277,2,8388,3232,5156,0,0,0,1.0,1,1.0,1,1.0,1,0.13817919499027267,63
4278,1,8389,3232,5157,0,0,0,1.0,1,1.0,1,1.0,1,0.12519568787698263,64
4279,2,8391,3233,5158,0,0,0,1.0,1,1.0,1,1.0,1,0.1441451149160018,65
4280,2,8393,3233,5160,0,0,0,1.0,1,1.0,1,1.0,1,0.11881045515973451,65
4281,1,8394,3233,5161,0,0,0,1.0,1,1.0,1,1.0,1,0.10559060710658169,65
4282,4,8398,3236,5162,0,0,0,1.0,1,1.0,1,1.0,1,0.13856196462589082,66
4283,3,8401,3237,5164,0,0,0,1.0,1,1.0,1,1.0,1,0.14104927320161198,66
4284,4,8405,3239,5166,0,0,0,1.0,1,1.0,1,1.0,1,0.17621412554062282,66
4285,3,8408,3239,5169,0,0,0,1.0,1,1.0,1,1.0,1,0.15908700562851633,67
4286,4,8412,3239,5173,0,0,0,1.0,1,1.0,1,1.0,1,0.15882307823614233,67
4287,2,8414,3239,5175,0,0,0,1.0,1,1.0,1,1.0,1,0.14380252232604337,67
4288,0,8414,3239,5175,0,0,0,1.0,1,1.0,1,1.0,1,0.13804647622079164,68
4289,1,8415,3239,5176,0,0,0,1.0,1,1.0,1,1.0,1,0.14033963504245348,68
4290,1,8416,3239,5177,0,0,0,1.0,1,1.0,1,1.0,1,0.13679138169043417,70
4291,1,8417,3240,5177,0,0,0,1.0,1,1.0,1,1.0,1,0.13799476310067738,71
4292,0,8417,3240,5177,0,0,0,1.0,1,1.0,1,1.0,1,0.13799476310067738,71
4293,1,8418,3240,5178,0,0,0,1.0,1,1.0,1,1.0,1,0.1304962879158674,71
4294,1,8419,3241,5178,0,0,0,1.0,1,1.0,1,1.0,1,0.14212337499568806,71
4295,2,8421,3241,5180,0,0,0,1.0,1,1.0,1,1.0,1,0.14087742460807026,72
4296,2,8423,3242,5181,0,0,0,1.0,1,1.0,1,1.0,1,0.1685906813993215,73
4297,2,8425,3242,5183,0,0,0,1.0,1,1.0,1,1.0,1,0.13783765280107507,73
4298,1,8426,3242,5184,0,0,0,1.0,1,1.0,1,1.0,1,0.13906360009818683,74
4299,3,8429,3242,5187,0,0,0,1.0,1,1.0,1,1.0,1,0.10892695512084095,75
4300,2,8431,3243,5188,0,0,0,1.0,1,1.0,1,1.0,1,0.11464574791620882,75
4301,1,8432,3243,5189,0,0,0,1.0,1,1.0,1,1.0,1,0.10462078291070284,76
4302,0,8432,3243,5189,0,0,0,1.0,1,1.0,1,1.0,1,0.10462078291070284,76
4303,1,8433,3243,5190,0,0,0,1.0,1,1.0,1,1.0,1,0.10413400966714881,75
4304,1,8434,3244,5190,0,0,0,1.0,1,1.0,1,1.0,1,0.12466699890744179,75
4305,2,8436,3244,5192,0,0,0,1.0,1,1.0,1,1.0,1,0.10234096101958337,73
4306,5,8441,3248,5193,0,0,0,1.0,1,1.0,1,1.0,1,0.1396479664160138,74
4307,7,8448,3250,5198,0,0,0,1.0,1,1.0,1,1.0,1,0.09631431467772386,73
4308,2,8450,3251,5199,0,0,0,1.0,1,1.0,1,1.0,1,0.10342580120941759,71
4309,0,8450,3251,5199,0,0,0,1.0,1,1.0,1,1.0,1,0.11486529997898874,70
4310,1,8451,3252,5199,0,0,0,1.0,1,1.0,1,1.0,1,0.13135270291524315,69
4311,3,8454,3253,5201,0,0,0,1.0,1,1.0,1,1.0,1,0.11982405963564742,69
4312,3,8457,3254,5203,0,0,0,1.0,1,1.0,1,1.0,1,0.1350486028078405,66
4313,3,8460,3254,5206,0,0,0,1.0,1,1.0,1,1.0,1,0.10784417520471512,64
4314,1,8461,3254,5207,0,0,0,1.0,1,1.0,1,1.0,1,0.12239661128346715,61
4315,4,8465,3256,5209,0,0,0,1.0,1,1.0,1,1.0,1,0.12865520432544134,61
4316,0,8465,3256,5209,0,0,0,1.0,1,1.0,1,1.0,1,0.13508555713179593,60
4317,1,8466,3257,5209,0,0,0,1.0,1,1.0,1,1.0,1,0.13774721719596372,62
4318,1,8467,3258,5209,0,0,0,1.0,1,1.0,1,1.0,1,0.15686839556438445,59
4319,2,8469,3258,5211,0,0,0,1.0,1,1.0,1,1.0,1,0.12474850453512225,60
4320,0,8469,3258,5211,0,0,0,1.0,1,1.0,1,1.0,1,0.12474850453512225,60
4321,4,8473,3262,5211,0,0,0,1.0,1,1.0,1,1.0,1,0.16867870873187849,61
4322,4,8477,3264,5213,0,0,0,1.0,1,1.0,1,1.0,1,0.1766690769331338,61
4323,4,8481,3266,5215,0,0,0,1.0,1,1.0,1,1.0,1,0.17108804280820858,61
4324,0,8481,3266,5215,0,0,0,1.0,1,1.0,1,1.0,1,0.18405345128003278,60
4325,4,8485,3267,5218,0,0,0,1.0,1,1.0,1,1.0,1,0.1858032400443934,60
4326,0,8485,3267,5218,0,0,0,1.0,1,1.0,1,1.0,1,0.18317581444236772,61
4327,4,8489,3267,5222,0,0,0,1.0,1,1.0,1,1.0,1,0.143623149763701,62
4328,0,8489,3267,5222,0,0,0,1.0,1,1.0,1,1.0,1,0.143623149763701,62
4329,1,8490,3267,5223,0,0,0,1.0,1,1.0,1,1.0,1,0.12716539575541436,65
4330,1,8491,3267,5224,0,0,0,1.0,1,1.0,1,1.0,1,0.12071328218420686,65
4331,2,8493,3267,5226,0,0,0,1.0,1,1.0,1,1.0,1,0.10257914337278519,65
4332,4,8497,3268,5229,0,0,0,1.0,1,1.0,1,1.0,1,0.10187327441461366,66
4333,1,8498,3268,5230,0,0,0,1.0,1,1.0,1,1.0,1,0.09565084021725805,66
4334,0,8498,3268,5230,0,0,0,1.0,1,1.0,1,1.0,1,0.09565084021725805,66
4335,2,8500,3268,5232,0,0,0,1.0,1,1.0,1,1.0,1,0.08494329538984968,65
4336,5,8505,3271,5234,0,0,0,1.0,1,1.0,1,1.0,1,0.1044303475763956,67
4337,4,8509,3272,5237,0,0,0,1.0,1,1.0,1,1.0,1,0.11815927720918384,69
4338,1,8510,3272,5238,0,0,0,1.0,1,1.0,1,1.0,1,0.11650702069891791,70
4339,1,8511,3272,5239,0,0,0,1.0,1,1.0,1,1.0,1,0.12149151419469767,70
4340,1,8512,3272,5240,0,0,0,1.0,1,1.0,1,1.0,1,0.13026067421140575,71
4341,4,8516,3275,5241,0,0,0,1.0,1,1.0,1,1.0,1,0.1499346605294103,70
4342,0,8516,3275,5241,0,0,0,1.0,1,1.0,1,1.0,1,0.15811138046191828,71
4343,7,8523,3277,5246,0,0,0,1.0,1,1.0,1,1.0,1,0.12233483327005497,67
4344,3,8526,3280,5246,0,0,0,1.0,1,1.0,1,1.0,1,0.161542371303559,67
4345,3,8529,3281,5248,0,0,0,1.0,1,1.0,1,1.0,1,0.15275311720194243,64
4346,6,8535,3284,5251,0,0,0,1.0,1,1.0,1,1.0,1,0.17254807965738952,64
4347,7,8542,3288,5254,0,0,0,1.0,1,1.0,1,1.0,1,0.20751736612167984,62
4348,5,8547,3291,5256,0,0,0,1.0,1,1.0,1,1.0,1,0.1971465020295364,62
4349,2,8549,3291,5258,0,0,0,1.0,1,1.0,1,1.0,1,0.2088115231934342,61
4350,3,8552,3292,5260,0,0,0,1.0,1,1.0,1,1.0,1,0.19088056669294784,60
4351,2,8554,3292,5262,0,0,0,1.0,1,1.0,1,1.0,1,0.16191955811339637,60
4352,0,8554,3292,5262,0,0,0,1.0,1,1.0,1,1.0,1,0.19031367426207108,57
4353,1,8555,3292,5263,0,0,0,1.0,1,1.0,1,1.0,1,0.19110906650420048,55
4354,4,8559,3293,5266,0,0,0,1.0,1,1.0,1,1.0,1,0.1617609808289072,55
4355,6,8565,3293,5272,0,0,0,1.0,1,1.0,1,1.0,1,0.1270764209216301,53
4356,1,8566,3293,5273,0,0,0,1.0,1,1.0,1,1.0,1,0.08414380619087479,55
4357,1,8567,3294,5273,0,0,0,1.0,1,1.0,1,1.0,1,0.07645698120348374,55
4358,0,8567,3294,5273,0,0,0,1.0,1,1.0,1,1.0,1,0.10108918037265904,55
4359,0,8567,3294,5273,0,0,0,1.0,1,1.0,1,1.0,1,0.12315955436537371,54
4360,0,8567,3294,5273,0,0,0,1.0,1,1.0,1,1.0,1,0.11463015549780868,55
4361,2,8569,3295,5274,0,0,0,1.0,1,1.0,1,1.0,1,0.10362681845288102,54
4362,2,8571,3296,5275,0,0,0,1.0,1,1.0,1,1.0,1,0.10699858946397038,55
4363,2,8573,3297,5276,0,0,0,1.0,1,1.0,1,1.0,1,0.11310574717164841,55
4364,4,8577,3299,5278,0,0,0,1.0,1,1.0,1,1.0,1,0.10193939698989808,55
4365,1,8578,3299,5279,0,0,0,1.0,1,1.0,1,1.0,1,0.09891007570062858,54
4366,2,8580,3300,5280,0,0,0,1.0,1,1.0,1,1.0,1,0.0932851714086041,54
4367,2,8582,3301,5281,0,0,0,1.0,1,1.0,1,1.0,1,0.10628258218029826,57
4368,2,8584,3301,5283,0,0,0,1.0,1,1.0,1,1.0,1,0.10968354499926417,57
4369,2,8586,3301,5285,0,0,0,1.0,1,1.0,1,1.0,1,0.09330408857426073,58
4370,2,8588,3302,5286,0,0,0,1.0,1,1.0,1,1.0,1,0.10172420010782723,59
4371,1,8589,3302,5287,0,0,0,1.0,1,1.0,1,1.0,1,0.08217162020176466,60
4372,0,8589,3302,5287,0,0,0,1.0,1,1.0,1,1.0,1,0.08217162020176466,60
4373,0,8589,3302,5287,0,0,0,1.0,1,1.0,1,1.0,1,0.08217162020176466,60
4374,0,8589,3302,5287,0,0,0,1.0,1,1.0,1,1.0,1,0.09484490360696164,59
4375,1,8590,3302,5288,0,0,0,1.0,1,1.0,1,1.0,1,0.09388418094466855,60
4376,0,8590,3302,5288,0,0,0,1.0,1,1.0,1,1.0,1,0.11826205764670214,60
4377,3,8593,3304,5289,0,0,0,1.0,1,1.0,1,1.0,1,0.16357986357064422,61
4378,4,8597,3307,5290,0,0,0,1.0,1,1.0,1,1.0,1,0.1932030118520713,64
4379,7,8604,3309,5295,0,0,0,1.0,1,1.0,1,1.0,1,0.2021440377081093,64
4380,4,8608,3310,5298,0,0,0,1.0,1,1.0,1,1.0,1,0.21551645839302486,65
4381,4,8612,3310,5302,0,0,0,1.0,1,1.0,1,1.0,1,0.1899275369971804,64
4382,3,8615,3311,5304,0,0,0,1.0,1,1.0,1,1.0,1,0.2035235940841872,64
4383,3,8618,3313,5305,0,0,0,1.0,1,1.0,1,1.0,1,0.21656187349352846,64
4384,5,8623,3316,5307,0,0,0,1.0,1,1.0,1,1.0,1,0.2753232890691792,60
4385,3,8626,3316,5310,0,0,0,1.0,1,1.0,1,1.0,1,0.2510090538604907,58
4386,5,8631,3319,5312,0,0,0,1.0,1,1.0,1,1.0,1,0.22923320532916405,58
4387,3,8634,3320,5314,0,0,0,1.0,1,1.0,1,1.0,1,0.20385800036189491,55
4388,2,8636,3320,5316,0,0,0,1.0,1,1.0,1,1.0,1,0.19592025933488955,56
4389,2,8638,3320,5318,0,0,0,1.0,1,1.0,1,1.0,1,0.17680715779055486,55
4390,1,8639,3321,5318,0,0,0,1.0,1,1.0,1,1.0,1,0.1863730854744334,55
4391,3,8642,3322,5320,0,0,0,1.0,1,1.0,1,1.0,1,0.1685613321867794,56
4392,2,8644,3322,5322,0,0,0,1.0,1,1.0,1,1.0,1,0.15725554931872054,56
4393,2,8646,3323,5323,0,0,0,1.0,1,1.0,1,1.0,1,0.1661359792128671,55
4394,0,8646,3323,5323,0,0,0,1.0,1,1.0,1,1.0,1,0.14939340573787385,53
4395,0,8646,3323,5323,0,0,0,1.0,1,1.0,1,1.0,1,0.14939340573787385,53
4396,1,8647,3324,5323,0,0,0,1.0,1,1.0,1,1.0,1,0.16076614883538834,53
4397,2,8649,3324,5325,0,0,0,1.0,1,1.0,1,1.0,1,0.15999201401982696,50
4398,0,8649,3324,5325,0,0,0,1.0,1,1.0,1,1.0,1,0.19225312004020037,50
4399,1,8650,3324,5326,0,0,0,1.0,1,1.0,1,1.0,1,0.182030242652084,52
4400,6,8656,3325,5331,0,0,0,1.0,1,1.0,1,1.0,1,0.2050862239407437,55
4401,2,8658,3325,5333,0,0,0,1.0,1,1.0,1,1.0,1,0.15847500256941244,56
4402,2,8660,3326,5334,0,0,0,1.0,1,1.0,1,1.0,1,0.17007022797251126,56
4403,2,8662,3327,5335,0,0,0,1.0,1,1.0,1,1.0,1,0.14708025303172764,57
4404,0,8662,3327,5335,0,0,0,1.0,1,1.0,1,1.0,1,0.14708025303172764,57
4405,1,8663,3327,5336,0,0,0,1.0,1,1.0,1,1.0,1,0.1269444525237437,58
4406,0,8663,3327,5336,0,0,0,1.0,1,1.0,1,1.0,1,0.1269444525237437,58
4407,0,8663,3327,5336,0,0,0,1.0,1,1.0,1,1.0,1,0.1269444525237437,58
4408,1,8664,3328,5336,0,0,0,1.0,1,1.0,1,1.0,1,0.14589477818091368,59
4409,0,8664,3328,5336,0,0,0,1.0,1,1.0,1,1.0,1,0.14589477818091368,59
4410,0,8664,3328,5336,0,0,0,1.0,1,1.0,1,1.0,1,0.14589477818091368,59
4411,1,8665,3328,5337,0,0,0,1.0,1,1.0,1,1.0,1,0.1295474609613991,62
4412,1,8666,3328,5338,0,0,0,1.0,1,1.0,1,1.0,1,0.12959946059363517,63
4413,2,8668,3329,5339,0,0,0,1.0,1,1.0,1,1.0,1,0.12223058226449533,63
4414,1,8669,3329,5340,0,0,0,1.0,1,1.0,1,1.0,1,0.11971372543637163,64
4415,2,8671,3330,5341,0,0,0,1.0,1,1.0,1,1.0,1,0.11310769516911784,64
4416,0,8671,3330,5341,0,0,0,1.0,1,1.0,1,1.0,1,0.11310769516911784,64
4417,1,8672,3331,5341,0,0,0,1.0,1,1.0,1,1.0,1,0.1311167290242739,65
4418,1,8673,3332,5341,0,0,0,1.0,1,1.0,1,1.0,1,0.14333468959983242,65
4419,7,8680,3332,5348,0,0,0,1.0,1,1.0,1,1.0,1,0.1474744664317238,62
4420,0,8680,3332,5348,0,0,0,1.0,1,1.0,1,1.0,1,0.1486233589103926,62
4421,5,8685,3333,5352,0,0,0,1.0,1,1.0,1,1.0,1,0.10593062422594106,65
4422,3,8688,3335,5353,0,0,0,1.0,1,1.0,1,1.0,1,0.12449861306778502,64
4423,2,8690,3336,5354,0,0,0,1.0,1,1.0,1,1.0,1,0.10890682565678306,63
4424,2,8692,3337,5355,0,0,0,1.0,1,1.0,1,1.0,1,0.11433772763021259,63
4425,5,8697,3339,5358,0,0,0,1.0,1,1.0,1,1.0,1,0.09564912257484721,63
4426,3,8700,3341,5359,0,0,0,1.0,1,1.0,1,1.0,1,0.06867739278199231,63
4427,1,8701,3342,5359,0,0,0,1.0,1,1.0,1,1.0,1,0.06678866477438648,62
4428,0,8701,3342,5359,0,0,0,1.0,1,1.0,1,1.0,1,0.0587119693977075,61
4429,3,8704,3344,5360,0,0,0,1.0,1,1.0,1,1.0,1,0.09012512867916814,62
4430,1,8705,3345,5360,0,0,0,1.0,1,1.0,1,1.0,1,0.10678592495002431,60
4431,5,8710,3348,5362,0,0,0,1.0,1,1.0,1,1.0,1,0.11730550791952105,59
4432,2,8712,3349,5363,0,0,0,1.0,1,1.0,1,1.0,1,0.1338485622520873,60
4433,5,8717,3352,5365,0,0,0,1.0,1,1.0,1,1.0,1,0.16749037692550955,61
4434,2,8719,3352,5367,0,0,0,1.0,1,1.0,1,1.0,1,0.1455049016492144,61
4435,6,8725,3354,5371,0,0,0,1.0,1,1.0,1,1.0,1,0.100245942877614,61
4436,1,8726,3354,5372,0,0,0,1.0,1,1.0,1,1.0,1,0.08348226980344552,61
4437,2,8728,3356,5372,0,0,0,1.0,1,1.0,1,1.0,1,0.08888368907766352,61
4438,1,8729,3357,5372,0,0,0,1.0,1,1.0,1,1.0,1,0.09046106367731961,62
4439,2,8731,3357,5374,0,0,0,1.0,1,1.0,1,1.0,1,0.08759309972483278,63
4440,2,8733,3358,5375,0,0,0,1.0,1,1.0,1,1.0,1,0.08435316031544102,64
4441,1,8734,3358,5376,0,0,0,1.0,1,1.0,1,1.0,1,0.06604903661476928,64
4442,5,8739,3361,5378,0,0,0,1.0,1,1.0,1,1.0,1,0.09983645151002078,67
4443,4,8743,3363,5380,0,0,0,1.0,1,1.0,1,1.0,1,0.10704414284349752,68
4444,0,8743,3363,5380,0,0,0,1.0,1,1.0,1,1.0,1,0.11203609609207348,69
4445,6,8749,3364,5385,0,0,0,1.0,1,1.0,1,1.0,1,0.0958681061614656,71
4446,0,8749,3364,5385,0,0,0,1.0,1,1.0,1,1.0,1,0.0958681061614656,71
4447,1,8750,3364,5386,0,0,0,1.0,1,1.0,1,1.0,1,0.09473335548185143,72
4448,0,8750,3364,5386,0,0,0,1.0,1,1.0,1,1.0,1,0.10488465103017694,71
4449,4,8754,3365,5389,0,0,0,1.0,1,1.0,1,1.0,1,0.08582382963027646,70
4450,0,8754,3365,5389,0,0,0,1.0,1,1.0,1,1.0,1,0.09400155371946808,69
4451,1,8755,3365,5390,0,0,0,1.0,1,1.0,1,1.0,1,0.08690716920187906,69
4452,1,8756,3365,5391,0,0,0,1.0,1,1.0,1,1.0,1,0.07984513493348717,70
4453,0,8756,3365,5391,0,0,0,1.0,1,1.0,1,1.0,1,0.08981430732999651,70
4454,6,8762,3368,5394,0,0,0,1.0,1,1.0,1,1.0,1,0.11026963842755902,71
4455,3,8765,3368,5397,0,0,0,1.0,1,1.0,1,1.0,1,0.08309608228294933,71
4456,5,8770,3372,5398,0,0,0,1.0,1,1.0,1,1.0,1,0.10386749960279618,71
4457,4,8774,3373,5401,0,0,0,1.0,1,1.0,1,1.0,1,0.0715912691432921,69
4458,2,8776,3374,5402,0,0,0,1.0,1,1.0,1,1.0,1,0.08199778663937406,70
4459,5,8781,3376,5405,0,0,0,1.0,1,1.0,1,1.0,1,0.08587520968976929,68
4460,3,8784,3379,5405,0,0,0,1.0,1,1.0,1,1.0,1,0.07176691625968985,68
4461,0,8784,3379,5405,0,0,0,1.0,1,1.0,1,1.0,1,0.08063915071696336,67
4462,3,8787,3382,5405,0,0,0,1.0,1,1.0,1,1.0,1,0.10689526461900649,66
4463,1,8788,3383,5405,0,0,0,1.0,1,1.0,1,1.0,1,0.1032311341888508,65
4464,4,8792,3385,5407,0,0,0,1.0,1,1.0,1,1.0,1,0.15213011573518426,62
4465,9,8801,3390,5411,0,0,0,1.0,1,1.0,1,1.0,1,0.12432725425247294,61
4466,4,8805,3391,5414,0,0,0,1.0,1,1.0,1,1.0,1,0.13017038633711778,60
4467,5,8810,3394,5416,0,0,0,1.0,1,1.0,1,1.0,1,0.11357472063124296,58
4468,1,8811,3395,5416,0,0,0,1.0,1,1.0,1,1.0,1,0.1285513585777747,57
4469,3,8814,3396,5418,0,0,0,1.0,1,1.0,1,1.0,1,0.1260181252547713,56
4470,2,8816,3397,5419,0,0,0,1.0,1,1.0,1,1.0,1,0.1299316910946222,55
4471,3,8819,3398,5421,0,0,0,1.0,1,1.0,1,1.0,1,0.11089720005212064,55
4472,1,8820,3399,5421,0,0,0,1.0,1,1.0,1,1.0,1,0.1303485270864853,55
4473,2,8822,3400,5422,0,0,0,1.0,1,1.0,1,1.0,1,0.12641242356444563,55
4474,4,8826,3402,5424,0,0,0,1.0,1,1.0,1,1.0,1,0.15423857463464266,55
4475,5,8831,3403,5428,0,0,0,1.0,1,1.0,1,1.0,1,0.09216469814058484,56
4476,1,8832,3404,5428,0,0,0,1.0,1,1.0,1,1.0,1,0.09865235051167466,56
4477,2,8834,3405,5429,0,0,0,1.0,1,1.0,1,1.0,1,0.10863435307770807,57
4478,2,8836,3405,5431,0,0,0,1.0,1,1.0,1,1.0,1,0.10635963134910434,55
4479,1,8837,3405,5432,0,0,0,1.0,1,1.0,1,1.0,1,0.09187512237268788,55
4480,1,8838,3406,5432,0,0,0,1.0,1,1.0,1,1.0,1,0.10185988301702538,54
4481,1,8839,3406,5433,0,0,0,1.0,1,1.0,1,1.0,1,0.1400185510830362,53
4482,3,8842,3408,5434,0,0,0,1.0,1,1.0,1,1.0,1,0.16639967593378055,54
4483,4,8846,3408,5438,0,0,0,1.0,1,1.0,1,1.0,1,0.11527771155274308,55
4484,5,8851,3409,5442,0,0,0,1.0,1,1.0,1,1.0,1,0.07651396747185,57
4485,1,8852,3410,5442,0,0,0,1.0,1,1.0,1,1.0,1,0.09991833289586798,60
4486,2,8854,3412,5442,0,0,0,1.0,1,1.0,1,1.0,1,0.09312388674368927,60
4487,0,8854,3412,5442,0,0,0,1.0,1,1.0,1,1.0,1,0.09312388674368927,60
4488,0,8854,3412,5442,0,0,0,1.0,1,1.0,1,1.0,1,0.09312388674368927,60
4489,1,8855,3413,5442,0,0,0,1.0,1,1.0,1,1.0,1,0.10986470743809594,60
4490,0,8855,3413,5442,0,0,0,1.0,1,1.0,1,1.0,1,0.10986470743809594,60
4491,1,8856,3413,5443,0,0,0,1.0,1,1.0,1,1.0,1,0.10158487286902085,61
4492,1,8857,3414,5443,0,0,0,1.0,1,1.0,1,1.0,1,0.09775003298610983,61
4493,1,8858,3415,5443,0,0,0,1.0,1,1.0,1,1.0,1,0.13832602116563408,60
4494,3,8861,3416,5445,0,0,0,1.0,1,1.0,1,1.0,1,0.11117713766707658,61
4495,2,8863,3416,5447,0,0,0,1.0,1,1.0,1,1.0,1,0.09271071264247266,59
4496,1,8864,3416,5448,0,0,0,1.0,1,1.0,1,1.0,1,0.12824366855943115,60
4497,5,8869,3416,5453,0,0,0,1.0,1,1.0,1,1.0,1,0.11458472033444436,59
4498,1,8870,3416,5454,0,0,0,1.0,1,1.0,1,1.0,1,0.14441042556631364,57
4499,5,8875,3417,5458,0,0,0,1.0,1,1.0,1,1.0,1,0.10164381982457577,58
4500,2,8877,3418,5459,0,0,0,1.0,1,1.0,1,1.0,1,0.09536664605907226,56
4501,4,8881,3420,5461,0,0,0,1.0,1,1.0,1,1.0,1,0.11432828897669169,57
4502,6,8887,3423,5464,0,0,0,1.0,1,1.0,1,1.0,1,0.15225707309014844,56
4503,4,8891,3425,5466,0,0,0,1.0,1,1.0,1,1.0,1,0.14536649673119098,54
4504,0,8891,3425,5466,0,0,0,1.0,1,1.0,1,1.0,1,0.12018159175358205,54
4505,1,8892,3426,5466,0,0,0,1.0,1,1.0,1,1.0,1,0.14407260547884654,51
4506,2,8894,3427,5467,0,0,0,1.0,1,1.0,1,1.0,1,0.1327115538399624,49
4507,4,8898,3428,5470,0,0,0,1.0,1,1.0,1,1.0,1,0.12195544203015354,48
4508,0,8898,3428,5470,0,0,0,1.0,1,1.0,1,1.0,1,0.15093214903234398,48
4509,2,8900,3430,5470,0,0,0,1.0,1,1.0,1,1.0,1,0.17410476846591724,46
4510,1,8901,3430,5471,0,0,0,1.0,1,1.0,1,1.0,1,0.1565874554420289,44
4511,5,8906,3431,5475,0,0,0,1.0,1,1.0,1,1.0,1,0.15246735798424668,45
4512,3,8909,3432,5477,0,0,0,1.0,1,1.0,1,1.0,1,0.1312822348421387,46
4513,3,8912,3433,5479,0,0,0,1.0,1,1.0,1,1.0,1,0.11694845929119017,45
4514,0,8912,3433,5479,0,0,0,1.0,1,1.0,1,1.0,1,0.12412170254871754,46
4515,1,8913,3433,5480,0,0,0,1.0,1,1.0,1,1.0,1,0.12485601781429966,48
4516,0,8913,3433,5480,0,0,0,1.0,1,1.0,1,1.0,1,0.13677510858732025,49
4517,1,8914,3433,5481,0,0,0,1.0,1,1.0,1,1.0,1,0.12185040593518927,50
4518,1,8915,3434,5481,0,0,0,1.0,1,1.0,1,1.0,1,0.1324211118560853,50
4519,3,8918,3436,5482,0,0,0,1.0,1,1.0,1,1.0,1,0.12839984065935048,49
4520,0,8918,3436,5482,0,0,0,1.0,1,1.0,1,1.0,1,0.12968991983550662,50
4521,2,8920,3436,5484,0,0,0,1.0,1,1.0,1,1.0,1,0.10508386961849997,50
4522,0,8920,3436,5484,0,0,0,1.0,1,1.0,1,1.0,1,0.10508386961849997,50
4523,2,8922,3437,5485,0,0,0,1.0,1,1.0,1,1.0,1,0.09493974267355605,51
4524,1,8923,3438,5485,0,0,0,1.0,1,1.0,1,1.0,1,0.10178973443890485,52
4525,3,8926,3439,5487,0,0,0,1.0,1,1.0,1,1.0,1,0.09988399763180816,53
4526,1,8927,3439,5488,0,0,0,1.0,1,1.0,1,1.0,1,0.0841160236796297,54
4527,1,8928,3439,5489,0,0,0,1.0,1,1.0,1,1.0,1,0.0736876598024751,55
4528,0,8928,3439,5489,0,0,0,1.0,1,1.0,1,1.0,1,0.0736876598024751,55
4529,4,8932,3441,5491,0,0,0,1.0,1,1.0,1,1.0,1,0.12714116140864126,55
4530,1,8933,3441,5492,0,0,0,1.0,1,1.0,1,1.0,1,0.11111361134195648,56
4531,5,8938,3444,5494,0,0,0,1.0,1,1.0,1,1.0,1,0.12099976460822215,56
4532,1,8939,3445,5494,0,0,0,1.0,1,1.0,1,1.0,1,0.15106840678884687,55
4533,3,8942,3446,5496,0,0,0,1.0,1,1.0,1,1.0,1,0.14565650495831672,54
4534,1,8943,3446,5497,0,0,0,1.0,1,1.0,1,1.0,1,0.13060027665858373,55
4535,2,8945,3446,5499,0,0,0,1.0,1,1.0,1,1.0,1,0.14544876031221146,52
4536,1,8946,3447,5499,0,0,0,1.0,1,1.0,1,1.0,1,0.1462267453044176,53
4537,3,8949,3448,5501,0,0,0,1.0,1,1.0,1,1.0,1,0.14331416941092967,52
4538,0,8949,3448,5501,0,0,0,1.0,1,1.0,1,1.0,1,0.14717856856217187,52
4539,7,8956,3450,5506,0,0,0,1.0,1,1.0,1,1.0,1,0.13180975690300745,53
4540,2,8958,3451,5507,0,0,0,1.0,1,1.0,1,1.0,1,0.13694655996053198,54
4541,1,8959,3451,5508,0,0,0,1.0,1,1.0,1,1.0,1,0.14330726432796326,53
4542,4,8963,3454,5509,0,0,0,1.0,1,1.0,1,1.0,1,0.1442129132636943,53
4543,1,8964,3454,5510,0,0,0,1.0,1,1.0,1,1.0,1,0.12805991687031823,53
4544,1,8965,3454,5511,0,0,0,1.0,1,1.0,1,1.0,1,0.11578925070143686,52
4545,3,8968,3454,5514,0,0,0,1.0,1,1.0,1,1.0,1,0.10377986846875717,50
4546,2,8970,3455,5515,0,0,0,1.0,1,1.0,1,1.0,1,0.1303024229843214,49
4547,0,8970,3455,5515,0,0,0,1.0,1,1.0,1,1.0,1,0.1297734848478419,49
4548,0,8970,3455,5515,0,0,0,1.0,1,1.0,1,1.0,1,0.1297734848478419,49
4549,0,8970,3455,5515,0,0,0,1.0,1,1.0,1,1.0,1,0.09603890362632093,50
4550,1,8971,3456,5515,0,0,0,1.0,1,1.0,1,1.0,1,0.08586433331264019,49
4551,0,8971,3456,5515,0,0,0,1.0,1,1.0,1,1.0,1,0.08586433331264019,49
4552,0,8971,3456,5515,0,0,0,1.0,1,1.0,1,1.0,1,0.08586433331264019,49
4553,1,8972,3457,5515,0,0,0,1.0,1,1.0,1,1.0,1,0.123420599071384,49
4554,1,8973,3458,5515,0,0,0,1.0,1,1.0,1,1.0,1,0.13788801304400136,49
4555,1,8974,3459,5515,0,0,0,1.0,1,1.0,1,1.0,1,0.13134514665613536,48
4556,4,8978,3461,5517,0,0,0,1.0,1,1.0,1,1.0,1,0.14701035847984584,48
4557,4,8982,3462,5520,0,0,0,1.0,1,1.0,1,1.0,1,0.13085891936024613,49
4558,0,8982,3462,5520,0,0,0,1.0,1,1.0,1,1.0,1,0.11872771604106418,49
4559,2,8984,3463,5521,0,0,0,1.0,1,1.0,1,1.0,1,0.14317156444121878,50
4560,2,8986,3463,5523,0,0,0,1.0,1,1.0,1,1.0,1,0.12926541485184628,51
4561,0,8986,3463,5523,0,0,0,1.0,1,1.0,1,1.0,1,0.12185283994606444,52
4562,0,8986,3463,5523,0,0,0,1.0,1,1.0,1,1.0,1,0.131267766880077,53
4563,1,8987,3463,5524,0,0,0,1.0,1,1.0,1,1.0,1,0.1102657558733086,52
4564,1,8988,3463,5525,0,0,0,1.0,1,1.0,1,1.0,1,0.09665330004808183,54
4565,2,8990,3465,5525,0,0,0,1.0,1,1.0,1,1.0,1,0.10961272965616607,55
4566,1,8991,3466,5525,0,0,0,1.0,1,1.0,1,1.0,1,0.09932935857763392,55
4567,2,8993,3468,5525,0,0,0,1.0,1,1.0,1,1.0,1,0.08952940638920032,56
4568,2,8995,3469,5526,0,0,0,1.0,1,1.0,1,1.0,1,0.1130920260328544,58
4569,2,8997,3469,5528,0,0,0,1.0,1,1.0,1,1.0,1,0.09323716805990158,59
4570,5,9002,3472,5530,0,0,0,1.0,1,1.0,1,1.0,1,0.09599153736857412,59
4571,0,9002,3472,5530,0,0,0,1.0,1,1.0,1,1.0,1,0.08348688382821734,57
4572,3,9005,3475,5530,0,0,0,1.0,1,1.0,1,1.0,1,0.13029774445295714,56
4573,4,9009,3476,5533,0,0,0,1.0,1,1.0,1,1.0,1,0.11925982247670316,56
4574,0,9009,3476,5533,0,0,0,1.0,1,1.0,1,1.0,1,0.14235871664544097,55
4575,2,9011,3477,5534,0,0,0,1.0,1,1.0,1,1.0,1,0.13502480013577312,55
4576,0,9011,3477,5534,0,0,0,1.0,1,1.0,1,1.0,1,0.13859534583145275,55
4577,1,9012,3477,5535,0,0,0,1.0,1,1.0,1,1.0,1,0.13748880988618614,54
4578,0,9012,3477,5535,0,0,0,1.0,1,1.0,1,1.0,1,0.1388647282023397,54
4579,1,9013,3478,5535,0,0,0,1.0,1,1.0,1,1.0,1,0.15598629050992205,54
4580,1,9014,3478,5536,0,0,0,1.0,1,1.0,1,1.0,1,0.1417614587659991,55
4581,3,9017,3480,5537,0,0,0,1.0,1,1.0,1,1.0,1,0.1683679925828771,56
4582,0,9017,3480,5537,0,0,0,1.0,1,1.0,1,1.0,1,0.1683679925828771,56
4583,1,9018,3480,5538,0,0,0,1.0,1,1.0,1,1.0,1,0.1510362998485444,57
4584,2,9020,3481,5539,0,0,0,1.0,1,1.0,1,1.0,1,0.15029275805772313,57
4585,0,9020,3481,5539,0,0,0,1.0,1,1.0,1,1.0,1,0.15029275805772313,57
4586,0,9020,3481,5539,0,0,0,1.0,1,1.0,1,1.0,1,0.15029275805772313,57
4587,0,9020,3481,5539,0,0,0,1.0,1,1.0,1,1.0,1,0.15029275805772313,57
4588,1,9021,3481,5540,0,0,0,1.0,1,1.0,1,1.0,1,0.14436036289454363,58
4589,0,9021,3481,5540,0,0,0,1.0,1,1.0,1,1.0,1,0.1416817601642122,59
4590,0,9021,3481,5540,0,0,0,1.0,1,1.0,1,1.0,1,0.15255945163952636,60
4591,0,9021,3481,5540,0,0,0,1.0,1,1.0,1,1.0,1,0.15574197398831877,61
4592,1,9022,3481,5541,0,0,0,1.0,1,1.0,1,1.0,1,0.13739364990136915,62
4593,1,9023,3481,5542,0,0,0,1.0,1,1.0,1,1.0,1,0.13521064780264916,64
4594,1,9024,3481,5543,0,0,0,1.0,1,1.0,1,1.0,1,0.10964652668749675,64
4595,2,9026,3482,5544,0,0,0,1.0,1,1.0,1,1.0,1,0.10884795862077887,63
4596,0,9026,3482,5544,0,0,0,1.0,1,1.0,1,1.0,1,0.10884795862077887,63
4597,2,9028,3482,5546,0,0,0,1.0,1,1.0,1,1.0,1,0.09231198892657116,63
4598,2,9030,3483,5547,0,0,0,1.0,1,1.0,1,1.0,1,0.06170513445774306,65
4599,0,9030,3483,5547,0,0,0,1.0,1,1.0,1,1.0,1,0.06947326326107005,66
4600,2,9032,3484,5548,0,0,0,1.0,1,1.0,1,1.0,1,0.10076207414862778,67
4601,3,9035,3485,5550,0,0,0,1.0,1,1.0,1,1.0,1,0.09205923906311146,67
4602,0,9035,3485,5550,0,0,0,1.0,1,1.0,1,1.0,1,0.08877754120730275,69
4603,2,9037,3486,5551,0,0,0,1.0,1,1.0,1,1.0,1,0.09218105227198817,69
4604,1,9038,3487,5551,0,0,0,1.0,1,1.0,1,1.0,1,0.08782017115594783,69
4605,1,9039,3488,5551,0,0,0,1.0,1,1.0,1,1.0,1,0.08744194700553821,70
4606,1,9040,3488,5552,0,0,0,1.0,1,1.0,1,1.0,1,0.0703200098294545,70
4607,1,9041,3489,5552,0,0,0,1.0,1,1.0,1,1.0,1,0.10663184661890734,72
4608,2,9043,3489,5554,0,0,0,1.0,1,1.0,1,1.0,1,0.09199776005138947,73
4609,1,9044,3490,5554,0,0,0,1.0,1,1.0,1,1.0,1,0.11047979211185084,72
4610,1,9045,3491,5554,0,0,0,1.0,1,1.0,1,1.0,1,0.12549496044427724,72
4611,4,9049,3492,5557,0,0,0,1.0,1,1.0,1,1.0,1,0.11014002644545338,71
4612,2,9051,3493,5558,0,0,0,1.0,1,1.0,1,1.0,1,0.1118746584389175,70
4613,2,9053,3493,5560,0,0,0,1.0,1,1.0,1,1.0,1,0.08196345793182361,69
4614,1,9054,3493,5561,0,0,0,1.0,1,1.0,1,1.0,1,0.09002281051066657,68
4615,1,9055,3494,5561,0,0,0,1.0,1,1.0,1,1.0,1,0.1012234569668198,68
4616,0,9055,3494,5561,0,0,0,1.0,1,1.0,1,1.0,1,0.1356230167670787,65
4617,3,9058,3496,5562,0,0,0,1.0,1,1.0,1,1.0,1,0.1313026626148519,66
4618,1,9059,3497,5562,0,0,0,1.0,1,1.0,1,1.0,1,0.14868836570113658,66
4619,3,9062,3498,5564,0,0,0,1.0,1,1.0,1,1.0,1,0.1311115756588023,65
4620,2,9064,3499,5565,0,0,0,1.0,1,1.0,1,1.0,1,0.12417318956936647,65
4621,7,9071,3503,5568,0,0,0,1.0,1,1.0,1,1.0,1,0.16185288479941096,67
4622,1,9072,3503,5569,0,0,0,1.0,1,1.0,1,1.0,1,0.15490550698837885,65
4623,1,9073,3503,5570,0,0,0,1.0,1,1.0,1,1.0,1,0.15080057635315577,66
4624,0,9073,3503,5570,0,0,0,1.0,1,1.0,1,1.0,1,0.15193299059706047,65
4625,3,9076,3503,5573,0,0,0,1.0,1,1.0,1,1.0,1,0.12928906931403475,64
4626,2,9078,3505,5573,0,0,0,1.0,1,1.0,1,1.0,1,0.11219801012298736,63
4627,3,9081,3505,5576,0,0,0,1.0,1,1.0,1,1.0,1,0.08539146752300986,65
4628,1,9082,3505,5577,0,0,0,1.0,1,1.0,1,1.0,1,0.08439885442072086,64
4629,1,9083,3506,5577,0,0,0,1.0,1,1.0,1,1.0,1,0.08526656943637552,64
4630,0,9083,3506,5577,0,0,0,1.0,1,1.0,1,1.0,1,0.08526656943637552,64
4631,6,9089,3509,5580,0,0,0,1.0,1,1.0,1,1.0,1,0.1488301400648819,66
4632,1,9090,3509,5581,0,0,0,1.0,1,1.0,1,1.0,1,0.14183839096136502,65
4633,4,9094,3509,5585,0,0,0,1.0,1,1.0,1,1.0,1,0.0901189088685256,66
4634,0,9094,3509,5585,0,0,0,1.0,1,1.0,1,1.0,1,0.0901189088685256,66
4635,0,9094,3509,5585,0,0,0,1.0,1,1.0,1,1.0,1,0.09151183657213549,66
4636,0,9094,3509,5585,0,0,0,1.0,1,1.0,1,1.0,1,0.09151183657213549,66
4637,0,9094,3509,5585,0,0,0,1.0,1,1.0,1,1.0,1,0.08303296443110839,68
4638,0,9094,3509,5585,0,0,0,1.0,1,1.0,1,1.0,1,0.08303296443110839,68
4639,2,9096,3510,5586,0,0,0,1.0,1,1.0,1,1.0,1,0.08252185276056184,69
4640,1,9097,3511,5586,0,0,0,1.0,1,1.0,1,1.0,1,0.08854617823611659,69
4641,1,9098,3511,5587,0,0,0,1.0,1,1.0,1,1.0,1,0.08424021059092154,70
4642,0,9098,3511,5587,0,0,0,1.0,1,1.0,1,1.0,1,0.09609875880571393,69
4643,2,9100,3512,5588,0,0,0,1.0,1,1.0,1,1.0,1,0.0953779054148037,70
4644,1,9101,3513,5588,0,0,0,1.0,1,1.0,1,1.0,1,0.12289277607605445,69
4645,2,9103,3513,5590,0,0,0,1.0,1,1.0,1,1.0,1,0.09727650622358665,70
4646,2,9105,3514,5591,0,0,0,1.0,1,1.0,1,1.0,1,0.135323595647016,68
4647,3,9108,3516,5592,0,0,0,1.0,1,1.0,1,1.0,1,0.17195838921546663,68
4648,3,9111,3516,5595,0,0,0,1.0,1,1.0,1,1.0,1,0.18926233082266972,67
4649,9,9120,3519,5601,0,0,0,1.0,1,1.0,1,1.0,1,0.15266487425457184,67
4650,0,9120,3519,5601,0,0,0,1.0,1,1.0,1,1.0,1,0.14131102582139102,67
4651,7,9127,3521,5606,0,0,0,1.0,1,1.0,1,1.0,1,0.12654161347396173,68
4652,1,9128,3521,5607,0,0,0,1.0,1,1.0,1,1.0,1,0.14056299246241932,66
4653,1,9129,3521,5608,0,0,0,1.0,1,1.0,1,1.0,1,0.1307595888297239,64
4654,0,9129,3521,5608,0,0,0,1.0,1,1.0,1,1.0,1,0.14271303487964257,65
4655,1,9130,3521,5609,0,0,0,1.0,1,1.0,1,1.0,1,0.12950091793777516,64
4656,5,9135,3523,5612,0,0,0,1.0,1,1.0,1,1.0,1,0.13376206917157255,65
4657,2,9137,3524,5613,0,0,0,1.0,1,1.0,1,1.0,1,0.14315382419751632,66
4658,3,9140,3527,5613,0,0,0,1.0,1,1.0,1,1.0,1,0.2088536142151717,65
4659,4,9144,3527,5617,0,0,0,1.0,1,1.0,1,1.0,1,0.15896021583417688,65
4660,1,9145,3528,5617,0,0,0,1.0,1,1.0,1,1.0,1,0.17224203731348994,66
4661,2,9147,3528,5619,0,0,0,1.0,1,1.0,1,1.0,1,0.17293005218974208,66
4662,2,9149,3528,5621,0,0,0,1.0,1,1.0,1,1.0,1,0.15102602495305564,68
4663,1,9150,3528,5622,0,0,0,1.0,1,1.0,1,1.0,1,0.14175253081717282,67
4664,3,9153,3529,5624,0,0,0,1.0,1,1.0,1,1.0,1,0.1424938041134585,67
4665,3,9156,3530,5626,0,0,0,1.0,1,1.0,1,1.0,1,0.12091873421149266,67
4666,1,9157,3531,5626,0,0,0,1.0,1,1.0,1,1.0,1,0.13149535969374385,67
4667,4,9161,3532,5629,0,0,0,1.0,1,1.0,1,1.0,1,0.0986678656471077,66
4668,2,9163,3533,5630,0,0,0,1.0,1,1.0,1,1.0,1,0.10639484056157271,66
4669,3,9166,3534,5632,0,0,0,1.0,1,1.0,1,1.0,1,0.11321538050151815,66
4670,0,9166,3534,5632,0,0,0,1.0,1,1.0,1,1.0,1,0.1303593611213234,64
4671,2,9168,3534,5634,0,0,0,1.0,1,1.0,1,1.0,1,0.1151438335942611,64
4672,2,9170,3535,5635,0,0,0,1.0,1,1.0,1,1.0,1,0.14654814705543423,64
4673,2,9172,3535,5637,0,0,0,1.0,1,1.0,1,1.0,1,0.12565027131254441,65
4674,1,9173,3536,5637,0,0,0,1.0,1,1.0,1,1.0,1,0.14267327766988427,66
4675,4,9177,3536,5641,0,0,0,1.0,1,1.0,1,1.0,1,0.12928159673468415,65
4676,1,9178,3536,5642,0,0,0,1.0,1,1.0,1,1.0,1,0.14353259787514244,65
4677,2,9180,3536,5644,0,0,0,1.0,1,1.0,1,1.0,1,0.14436165982998161,65
4678,0,9180,3536,5644,0,0,0,1.0,1,1.0,1,1.0,1,0.1561787557500544,64
4679,4,9184,3536,5648,0,0,0,1.0,1,1.0,1,1.0,1,0.13097404231381457,66
4680,1,9185,3536,5649,0,0,0,1.0,1,1.0,1,1.0,1,0.13738869551447538,67
4681,1,9186,3536,5650,0,0,0,1.0,1,1.0,1,1.0,1,0.12348783525661826,67
4682,5,9191,3539,5652,0,0,0,1.0,1,1.0,1,1.0,1,0.13550959699682932,67
4683,0,9191,3539,5652,0,0,0,1.0,1,1.0,1,1.0,1,0.13550959699682932,67
4684,2,9193,3540,5653,0,0,0,1.0,1,1.0,1,1.0,1,0.14021274876088505,66
4685,3,9196,3540,5656,0,0,0,1.0,1,1.0,1,1.0,1,0.11045975572161744,65
4686,1,9197,3541,5656,0,0,0,1.0,1,1.0,1,1.0,1,0.14249511959190386,65
4687,1,9198,3541,5657,0,0,0,1.0,1,1.0,1,1.0,1,0.12421474285339622,65
4688,5,9203,3544,5659,0,0,0,1.0,1,1.0,1,1.0,1,0.17649768237505903,64
4689,4,9207,3545,5662,0,0,0,1.0,1,1.0,1,1.0,1,0.17205981064246764,65
4690,0,9207,3545,5662,0,0,0,1.0,1,1.0,1,1.0,1,0.190177548900187,63
4691,6,9213,3547,5666,0,0,0,1.0,1,1.0,1,1.0,1,0.19489808428584005,64
4692,3,9216,3547,5669,0,0,0,1.0,1,1.0,1,1.0,1,0.1364133475713674,63
4693,2,9218,3548,5670,0,0,0,1.0,1,1.0,1,1.0,1,0.16047920634662796,64
4694,1,9219,3548,5671,0,0,0,1.0,1,1.0,1,1.0,1,0.1481300451100459,63
4695,0,9219,3548,5671,0,0,0,1.0,1,1.0,1,1.0,1,0.15079414253718418,62
4696,1,9220,3548,5672,0,0,0,1.0,1,1.0,1,1.0,1,0.1419367691305323,61
4697,5,9225,3549,5676,0,0,0,1.0,1,1.0,1,1.0,1,0.11393208924259568,63
4698,1,9226,3549,5677,0,0,0,1.0,1,1.0,1,1.0,1,0.11919003410681678,63
4699,1,9227,3549,5678,0,0,0,1.0,1,1.0,1,1.0,1,0.10471904761090112,65
4700,0,9227,3549,5678,0,0,0,1.0,1,1.0,1,1.0,1,0.11237523503830728,64
4701,3,9230,3551,5679,0,0,0,1.0,1,1.0,1,1.0,1,0.13853121125733175,64
4702,0,9230,3551,5679,0,0,0,1.0,1,1.0,1,1.0,1,0.14090701048026963,66
4703,2,9232,3551,5681,0,0,0,1.0,1,1.0,1,1.0,1,0.1210039014438753,65
4704,6,9238,3554,5684,0,0,0,1.0,1,1.0,1,1.0,1,0.12064105080742005,64
4705,4,9242,3556,5686,0,0,0,1.0,1,1.0,1,1.0,1,0.16789840262928188,65
4706,10,9252,3562,5690,0,0,0,1.0,1,1.0,1,1.0,1,0.21728258840007225,65
4707,8,9260,3563,5697,0,0,0,1.0,1,1.0,1,1.0,1,0.1665221374902424,63
4708,3,9263,3565,5698,0,0,0,1.0,1,1.0,1,1.0,1,0.15021502504494705,62
4709,4,9267,3568,5699,0,0,0,1.0,1,1.0,1,1.0,1,0.16553493859025079,61
4710,1,9268,3568,5700,0,0,0,1.0,1,1.0,1,1.0,1,0.15218634865064917,60
4711,4,9272,3569,5703,0,0,0,1.0,1,1.0,1,1.0,1,0.13009684286100703,59
4712,0,9272,3569,5703,0,0,0,1.0,1,1.0,1,1.0,1,0.12923504221662832,58
4713,0,9272,3569,5703,0,0,0,1.0,1,1.0,1,1.0,1,0.12923504221662832,58
4714,0,9272,3569,5703,0,0,0,1.0,1,1.0,1,1.0,1,0.1338870221984958,57
4715,2,9274,3569,5705,0,0,0,1.0,1,1.0,1,1.0,1,0.1342043272806776,57
4716,5,9279,3570,5709,0,0,0,1.0,1,1.0,1,1.0,1,0.1076384732316931,55
4717,1,9280,3570,5710,0,0,0,1.0,1,1.0,1,1.0,1,0.10480412365540998,57
4718,1,9281,3570,5711,0,0,0,1.0,1,1.0,1,1.0,1,0.09355213217758149,56
4719,2,9283,3571,5712,0,0,0,1.0,1,1.0,1,1.0,1,0.1295739940190695,56
4720,2,9285,3571,5714,0,0,0,1.0,1,1.0,1,1.0,1,0.10934971726319946,57
4721,1,9286,3571,5715,0,0,0,1.0,1,1.0,1,1.0,1,0.09616199733056577,57
4722,1,9287,3572,5715,0,0,0,1.0,1,1.0,1,1.0,1,0.09733135550737032,57
4723,0,9287,3572,5715,0,0,0,1.0,1,1.0,1,1.0,1,0.09492851703830016,57
4724,0,9287,3572,5715,0,0,0,1.0,1,1.0,1,1.0,1,0.09677228203450483,57
4725,1,9288,3572,5716,0,0,0,1.0,1,1.0,1,1.0,1,0.11298915657034503,57
4726,3,9291,3574,5717,0,0,0,1.0,1,1.0,1,1.0,1,0.14798386071165925,57
4727,4,9295,3575,5720,0,0,0,1.0,1,1.0,1,1.0,1,0.14200129780157703,56
4728,1,9296,3575,5721,0,0,0,1.0,1,1.0,1,1.0,1,0.1455298159792451,57
4729,1,9297,3575,5722,0,0,0,1.0,1,1.0,1,1.0,1,0.14556986363209237,56
4730,1,9298,3576,5722,0,0,0,1.0,1,1.0,1,1.0,1,0.19026183767929475,54
4731,4,9302,3577,5725,0,0,0,1.0,1,1.0,1,1.0,1,0.1607494289059423,54
4732,1,9303,3578,5725,0,0,0,1.0,1,1.0,1,1.0,1,0.18630020433854774,54
4733,1,9304,3579,5725,0,0,0,1.0,1,1.0,1,1.0,1,0.19168616471734165,55
4734,4,9308,3581,5727,0,0,0,1.0,1,1.0,1,1.0,1,0.2234778302701688,56
4735,4,9312,3583,5729,0,0,0,1.0,1,1.0,1,1.0,1,0.22743001783414762,56
4736,2,9314,3584,5730,0,0,0,1.0,1,1.0,1,1.0,1,0.21238378123241022,58
4737,1,9315,3584,5731,0,0,0,1.0,1,1.0,1,1.0,1,0.19151399682625425,59
4738,1,9316,3585,5731,0,0,0,1.0,1,1.0,1,1.0,1,0.22711623674042267,60
4739,2,9318,3586,5732,0,0,0,1.0,1,1.0,1,1.0,1,0.23043977042069763,60
4740,1,9319,3586,5733,0,0,0,1.0,1,1.0,1,1.0,1,0.2204847703918721,60
4741,1,9320,3586,5734,0,0,0,1.0,1,1.0,1,1.0,1,0.21652542522544757,61
4742,3,9323,3588,5735,0,0,0,1.0,1,1.0,1,1.0,1,0.22497794310199976,61
4743,2,9325,3588,5737,0,0,0,1.0,1,1.0,1,1.0,1,0.1969930334253021,60
4744,2,9327,3589,5738,0,0,0,1.0,1,1.0,1,1.0,1,0.17705118647242032,60
4745,1,9328,3590,5738,0,0,0,1.0,1,1.0,1,1.0,1,0.17357652353209,59
4746,1,9329,3591,5738,0,0,0,1.0,1,1.0,1,1.0,1,0.18527749310733863,59
4747,3,9332,3593,5739,0,0,0,1.0,1,1.0,1,1.0,1,0.14828104177231988,58
4748,3,9335,3595,5740,0,0,0,1.0,1,1.0,1,1.0,1,0.10017956834486495,58
4749,3,9338,3596,5742,0,0,0,1.0,1,1.0,1,1.0,1,0.08989136236134998,58
4750,2,9340,3597,5743,0,0,0,1.0,1,1.0,1,1.0,1,0.09845741778569085,56
4751,5,9345,3600,5745,0,0,0,1.0,1,1.0,1,1.0,1,0.11807442936779458,58
4752,2,9347,3601,5746,0,0,0,1.0,1,1.0,1,1.0,1,0.11837122810190762,55
4753,2,9349,3602,5747,0,0,0,1.0,1,1.0,1,1.0,1,0.10098740503660163,55
4754,1,9350,3603,5747,0,0,0,1.0,1,1.0,1,1.0,1,0.132345189351557,54
4755,6,9356,3604,5752,0,0,0,1.0,1,1.0,1,1.0,1,0.08664165538508307,54
4756,2,9358,3605,5753,0,0,0,1.0,1,1.0,1,1.0,1,0.10112301276818424,54
4757,2,9360,3605,5755,0,0,0,1.0,1,1.0,1,1.0,1,0.07701994983783776,53
4758,0,9360,3605,5755,0,0,0,1.0,1,1.0,1,1.0,1,0.07701994983783776,53
4759,1,9361,3606,5755,0,0,0,1.0,1,1.0,1,1.0,1,0.11150437870382043,53
4760,2,9363,3607,5756,0,0,0,1.0,1,1.0,1,1.0,1,0.1407630480469643,53
4761,6,9369,3608,5761,0,0,0,1.0,1,1.0,1,1.0,1,0.1074452884932905,52
4762,4,9373,3610,5763,0,0,0,1.0,1,1.0,1,1.0,1,0.14704188326347328,54
4763,4,9377,3611,5766,0,0,0,1.0,1,1.0,1,1.0,1,0.12642884903666077,54
4764,2,9379,3613,5766,0,0,0,1.0,1,1.0,1,1.0,1,0.17174915370556418,55
4765,2,9381,3614,5767,0,0,0,1.0,1,1.0,1,1.0,1,0.1924363767791211,56
4766,2,9383,3614,5769,0,0,0,1.0,1,1.0,1,1.0,1,0.1567779555219102,58
4767,1,9384,3614,5770,0,0,0,1.0,1,1.0,1,1.0,1,0.1531543457466344,59
4768,2,9386,3616,5770,0,0,0,1.0,1,1.0,1,1.0,1,0.16416723612049627,60
4769,1,9387,3616,5771,0,0,0,1.0,1,1.0,1,1.0,1,0.16350113701888594,59
4770,2,9389,3616,5773,0,0,0,1.0,1,1.0,1,1.0,1,0.15997776452341134,60
4771,1,9390,3616,5774,0,0,0,1.0,1,1.0,1,1.0,1,0.17802533686376248,59
4772,0,9390,3616,5774,0,0,0,1.0,1,1.0,1,1.0,1,0.17802533686376248,59
4773,0,9390,3616,5774,0,0,0,1.0,1,1.0,1,1.0,1,0.16156558124367978,60
4774,0,9390,3616,5774,0,0,0,1.0,1,1.0,1,1.0,1,0.16156558124367978,60
4775,1,9391,3616,5775,0,0,0,1.0,1,1.0,1,1.0,1,0.1537408970937018,62
4776,3,9394,3616,5778,0,0,0,1.0,1,1.0,1,1.0,1,0.12522565345658057,63
4777,1,9395,3616,5779,0,0,0,1.0,1,1.0,1,1.0,1,0.11755666754912747,63
4778,0,9395,3616,5779,0,0,0,1.0,1,1.0,1,1.0,1,0.11755666754912747,63
4779,1,9396,3617,5779,0,0,0,1.0,1,1.0,1,1.0,1,0.1213715791557742,63
4780,2,9398,3618,5780,0,0,0,1.0,1,1.0,1,1.0,1,0.1203279025096241,65
4781,4,9402,3619,5783,0,0,0,1.0,1,1.0,1,1.0,1,0.10229589754224162,64
4782,2,9404,3619,5785,0,0,0,1.0,1,1.0,1,1.0,1,0.09555333290293211,65
4783,6,9410,3622,5788,0,0,0,1.0,1,1.0,1,1.0,1,0.08373322361331349,66
4784,1,9411,3623,5788,0,0,0,1.0,1,1.0,1,1.0,1,0.07672506599449987,64
4785,4,9415,3625,5790,0,0,0,1.0,1,1.0,1,1.0,1,0.07477598100636963,65
4786,0,9415,3625,5790,0,0,0,1.0,1,1.0,1,1.0,1,0.0836861639828234,66
4787,3,9418,3627,5791,0,0,0,1.0,1,1.0,1,1.0,1,0.09300862879750593,63
4788,6,9424,3631,5793,0,0,0,1.0,1,1.0,1,1.0,1,0.09718419750088135,63
4789,3,9427,3633,5794,0,0,0,1.0,1,1.0,1,1.0,1,0.0936037773566929,60
4790,4,9431,3635,5796,0,0,0,1.0,1,1.0,1,1.0,1,0.09876597116884851,61
4791,5,9436,3638,5798,0,0,0,1.0,1,1.0,1,1.0,1,0.07758269931221119,59
4792,3,9439,3639,5800,0,0,0,1.0,1,1.0,1,1.0,1,0.08052810490035361,59
4793,6,9445,3641,5804,0,0,0,1.0,1,1.0,1,1.0,1,0.05982417358714856,61
4794,2,9447,3642,5805,0,0,0,1.0,1,1.0,1,1.0,1,0.05954586551831885,60
4795,3,9450,3643,5807,0,0,0,1.0,1,1.0,1,1.0,1,0.045336693217199,61
4796,1,9451,3644,5807,0,0,0,1.0,1,1.0,1,1.0,1,0.03737910402734805,60
4797,4,9455,3647,5808,0,0,0,1.0,1,1.0,1,1.0,1,0.10787548799544179,61
4798,1,9456,3648,5808,0,0,0,1.0,1,1.0,1,1.0,1,0.09570640392199702,61
4799,3,9459,3648,5811,0,0,0,1.0,1,1.0,1,1.0,1,0.06519943517126804,59
4800,0,9459,3648,5811,0,0,0,1.0,1,1.0,1,1.0,1,0.08853825714841884,57
4801,5,9464,3649,5815,0,0,0,1.0,1,1.0,1,1.0,1,0.0667104063265022,58
4802,0,9464,3649,5815,0,0,0,1.0,1,1.0,1,1.0,1,0.07277869547085672,56
4803,4,9468,3652,5816,0,0,0,1.0,1,1.0,1,1.0,1,0.10752623590815345,57
4804,1,9469,3653,5816,0,0,0,1.0,1,1.0,1,1.0,1,0.11391591208650682,55
4805,5,9474,3655,5819,0,0,0,1.0,1,1.0,1,1.0,1,0.11477675999837339,56
4806,3,9477,3656,5821,0,0,0,1.0,1,1.0,1,1.0,1,0.08346993912932248,55
4807,2,9479,3656,5823,0,0,0,1.0,1,1.0,1,1.0,1,0.059159514492129736,53
4808,1,9480,3657,5823,0,0,0,1.0,1,1.0,1,1.0,1,0.07921421035393564,54
4809,1,9481,3657,5824,0,0,0,1.0,1,1.0,1,1.0,1,0.10019958363625138,53
4810,1,9482,3657,5825,0,0,0,1.0,1,1.0,1,1.0,1,0.08869351460678919,53
4811,1,9483,3657,5826,0,0,0,1.0,1,1.0,1,1.0,1,0.0706961315508715,54
4812,1,9484,3658,5826,0,0,0,1.0,1,1.0,1,1.0,1,0.08075358762598533,54
4813,2,9486,3658,5828,0,0,0,1.0,1,1.0,1,1.0,1,0.050269955021649056,55
4814,4,9490,3662,5828,0,0,0,1.0,1,1.0,1,1.0,1,0.12188175199737056,55
4815,4,9494,3662,5832,0,0,0,1.0,1,1.0,1,1.0,1,0.07082969771460494,56
4816,1,9495,3663,5832,0,0,0,1.0,1,1.0,1,1.0,1,0.10109949400277826,56
4817,5,9500,3665,5835,0,0,0,1.0,1,1.0,1,1.0,1,0.13135444295442025,58
4818,3,9503,3667,5836,0,0,0,1.0,1,1.0,1,1.0,1,0.15688852132744785,58
4819,5,9508,3667,5841,0,0,0,1.0,1,1.0,1,1.0,1,0.11697181661929881,58
4820,1,9509,3667,5842,0,0,0,1.0,1,1.0,1,1.0,1,0.10784466134153549,58
4821,0,9509,3667,5842,0,0,0,1.0,1,1.0,1,1.0,1,0.10688097006792044,58
4822,1,9510,3668,5842,0,0,0,1.0,1,1.0,1,1.0,1,0.12162498760450358,58
4823,2,9512,3669,5843,0,0,0,1.0,1,1.0,1,1.0,1,0.1283329671578539,57
4824,2,9514,3669,5845,0,0,0,1.0,1,1.0,1,1.0,1,0.11745269751441759,56
4825,2,9516,3669,5847,0,0,0,1.0,1,1.0,1,1.0,1,0.11110817497737319,57
4826,0,9516,3669,5847,0,0,0,1.0,1,1.0,1,1.0,1,0.11110817497737319,57
4827,0,9516,3669,5847,0,0,0,1.0,1,1.0,1,1.0,1,0.14750789542940507,56
4828,1,9517,3670,5847,0,0,0,1.0,1,1.0,1,1.0,1,0.13172327854994773,57
4829,0,9517,3670,5847,0,0,0,1.0,1,1.0,1,1.0,1,0.1403753946630696,56
4830,2,9519,3671,5848,0,0,0,1.0,1,1.0,1,1.0,1,0.12141328092900211,57
4831,3,9522,3673,5849,0,0,0,1.0,1,1.0,1,1.0,1,0.15279822203591112,57
4832,1,9523,3673,5850,0,0,0,1.0,1,1.0,1,1.0,1,0.16589048659332672,55
4833,5,9528,3674,5854,0,0,0,1.0,1,1.0,1,1.0,1,0.13191037116330906,55
4834,1,9529,3674,5855,0,0,0,1.0,1,1.0,1,1.0,1,0.149297186894017,55
4835,3,9532,3674,5858,0,0,0,1.0,1,1.0,1,1.0,1,0.12542229540087443,55
4836,1,9533,3674,5859,0,0,0,1.0,1,1.0,1,1.0,1,0.11930403636777175,55
4837,1,9534,3675,5859,0,0,0,1.0,1,1.0,1,1.0,1,0.12872877096488666,53
4838,3,9537,3676,5861,0,0,0,1.0,1,1.0,1,1.0,1,0.10684678334773394,54
4839,5,9542,3679,5863,0,0,0,1.0,1,1.0,1,1.0,1,0.08692293320718486,53
4840,4,9546,3681,5865,0,0,0,1.0,1,1.0,1,1.0,1,0.11116539610127295,52
4841,1,9547,3682,5865,0,0,0,1.0,1,1.0,1,1.0,1,0.13402996092669175,51
4842,4,9551,3684,5867,0,0,0,1.0,1,1.0,1,1.0,1,0.17219220323493795,50
4843,8,9559,3686,5873,0,0,0,1.0,1,1.0,1,1.0,1,0.17703617041567019,51
4844,4,9563,3686,5877,0,0,0,1.0,1,1.0,1,1.0,1,0.16870460508745638,50
4845,3,9566,3687,5879,0,0,0,1.0,1,1.0,1,1.0,1,0.1519583372767948,49
4846,2,9568,3688,5880,0,0,0,1.0,1,1.0,1,1.0,1,0.14664007993197786,49
4847,2,9570,3688,5882,0,0,0,1.0,1,1.0,1,1.0,1,0.15239359535386254,48
4848,0,9570,3688,5882,0,0,0,1.0,1,1.0,1,1.0,1,0.15239359535386254,48
4849,2,9572,3690,5882,0,0,0,1.0,1,1.0,1,1.0,1,0.1547958455632728,48
4850,1,9573,3690,5883,0,0,0,1.0,1,1.0,1,1.0,1,0.1448529273672753,49
4851,2,9575,3690,5885,0,0,0,1.0,1,1.0,1,1.0,1,0.07159528270532388,49
4852,1,9576,3690,5886,0,0,0,1.0,1,1.0,1,1.0,1,0.10365926346264198,49
4853,0,9576,3690,5886,0,0,0,1.0,1,1.0,1,1.0,1,0.10292836905225673,50
4854,2,9578,3691,5887,0,0,0,1.0,1,1.0,1,1.0,1,0.11268449209451427,51
4855,0,9578,3691,5887,0,0,0,1.0,1,1.0,1,1.0,1,0.11268449209451427,51
4856,0,9578,3691,5887,0,0,0,1.0,1,1.0,1,1.0,1,0.12101466428672743,50
4857,2,9580,3691,5889,0,0,0,1.0,1,1.0,1,1.0,1,0.0860910473723625,51
4858,1,9581,3691,5890,0,0,0,1.0,1,1.0,1,1.0,1,0.0719018370132441,51
4859,1,9582,3691,5891,0,0,0,1.0,1,1.0,1,1.0,1,0.07184274504357148,52
4860,0,9582,3691,5891,0,0,0,1.0,1,1.0,1,1.0,1,0.07184274504357148,52
4861,0,9582,3691,5891,0,0,0,1.0,1,1.0,1,1.0,1,0.08936341083683488,53
4862,1,9583,3692,5891,0,0,0,1.0,1,1.0,1,1.0,1,0.11474246627152297,53
4863,0,9583,3692,5891,0,0,0,1.0,1,1.0,1,1.0,1,0.11577299671800179,51
4864,3,9586,3693,5893,0,0,0,1.0,1,1.0,1,1.0,1,0.09825383445761808,53
4865,1,9587,3693,5894,0,0,0,1.0,1,1.0,1,1.0,1,0.08598997190919491,52
4866,2,9589,3694,5895,0,0,0,1.0,1,1.0,1,1.0,1,0.10028838567251541,53
4867,1,9590,3695,5895,0,0,0,1.0,1,1.0,1,1.0,1,0.083085036452945,51
4868,1,9591,3696,5895,0,0,0,1.0,1,1.0,1,1.0,1,0.09802407582539331,53
4869,0,9591,3696,5895,0,0,0,1.0,1,1.0,1,1.0,1,0.09802407582539331,53
4870,5,9596,3698,5898,0,0,0,1.0,1,1.0,1,1.0,1,0.10796739017368613,55
4871,3,9599,3699,5900,0,0,0,1.0,1,1.0,1,1.0,1,0.10073386952960343,55
4872,2,9601,3700,5901,0,0,0,1.0,1,1.0,1,1.0,1,0.13552785825154787,56
4873,3,9604,3701,5903,0,0,0,1.0,1,1.0,1,1.0,1,0.10467350570171158,56
4874,5,9609,3704,5905,0,0,0,1.0,1,1.0,1,1.0,1,0.12315118541549705,58
4875,0,9609,3704,5905,0,0,0,1.0,1,1.0,1,1.0,1,0.10191210843304015,56
4876,1,9610,3704,5906,0,0,0,1.0,1,1.0,1,1.0,1,0.09732005709752554,56
4877,2,9612,3705,5907,0,0,0,1.0,1,1.0,1,1.0,1,0.0805449016644055,54
4878,4,9616,3707,5909,0,0,0,1.0,1,1.0,1,1.0,1,0.08691553087482504,54
4879,4,9620,3711,5909,0,0,0,1.0,1,1.0,1,1.0,1,0.14563903997100222,54
4880,5,9625,3712,5913,0,0,0,1.0,1,1.0,1,1.0,1,0.1566339961673812,53
4881,3,9628,3712,5916,0,0,0,1.0,1,1.0,1,1.0,1,0.11935026962234807,54
4882,1,9629,3713,5916,0,0,0,1.0,1,1.0,1,1.0,1,0.13861365445890492,52
4883,3,9632,3713,5919,0,0,0,1.0,1,1.0,1,1.0,1,0.11448180497621324,54
4884,0,9632,3713,5919,0,0,0,1.0,1,1.0,1,1.0,1,0.12913936902321202,52
4885,2,9634,3714,5920,0,0,0,1.0,1,1.0,1,1.0,1,0.14277029262067495,51
4886,1,9635,3714,5921,0,0,0,1.0,1,1.0,1,1.0,1,0.13900896415018388,50
4887,2,9637,3714,5923,0,0,0,1.0,1,1.0,1,1.0,1,0.1329543223380939,49
4888,0,9637,3714,5923,0,0,0,1.0,1,1.0,1,1.0,1,0.14719652128535934,48
4889,0,9637,3714,5923,0,0,0,1.0,1,1.0,1,1.0,1,0.14719652128535934,48
4890,0,9637,3714,5923,0,0,0,1.0,1,1.0,1,1.0,1,0.14719652128535934,48
4891,1,9638,3715,5923,0,0,0,1.0,1,1.0,1,1.0,1,0.18618330163709562,49
4892,3,9641,3715,5926,0,0,0,1.0,1,1.0,1,1.0,1,0.19372401891948204,51
4893,5,9646,3715,5931,0,0,0,1.0,1,1.0,1,1.0,1,0.12786622259383898,51
4894,0,9646,3715,5931,0,0,0,1.0,1,1.0,1,1.0,1,0.11892454120427223,52
4895,1,9647,3715,5932,0,0,0,1.0,1,1.0,1,1.0,1,0.1033919497497505,52
4896,0,9647,3715,5932,0,0,0,1.0,1,1.0,1,1.0,1,0.09201549311338436,51
4897,2,9649,3715,5934,0,0,0,1.0,1,1.0,1,1.0,1,0.07382482572836323,52
4898,0,9649,3715,5934,0,0,0,1.0,1,1.0,1,1.0,1,0.07382482572836323,52
4899,1,9650,3715,5935,0,0,0,1.0,1,1.0,1,1.0,1,0.06469959548518678,53
4900,1,9651,3715,5936,0,0,0,1.0,1,1.0,1,1.0,1,0.05340948020405879,54
4901,2,9653,3717,5936,0,0,0,1.0,1,1.0,1,1.0,1,0.06749795934641524,54
4902,0,9653,3717,5936,0,0,0,1.0,1,1.0,1,1.0,1,0.07219370171595299,55
4903,2,9655,3718,5937,0,0,0,1.0,1,1.0,1,1.0,1,0.09947855794889257,56
4904,2,9657,3720,5937,0,0,0,1.0,1,1.0,1,1.0,1,0.12782067200552177,55
4905,5,9662,3721,5941,0,0,0,1.0,1,1.0,1,1.0,1,0.0981825161654792,54
4906,5,9667,3722,5945,0,0,0,1.0,1,1.0,1,1.0,1,0.11245317190137492,54
4907,2,9669,3722,5947,0,0,0,1.0,1,1.0,1,1.0,1,0.09522242006708204,54
4908,1,9670,3722,5948,0,0,0,1.0,1,1.0,1,1.0,1,0.08364924741039795,53
4909,1,9671,3723,5948,0,0,0,1.0,1,1.0,1,1.0,1,0.10891899473815585,54
4910,0,9671,3723,5948,0,0,0,1.0,1,1.0,1,1.0,1,0.1098732434766195,55
4911,6,9677,3726,5951,0,0,0,1.0,1,1.0,1,1.0,1,0.11924983202024994,57
4912,4,9681,3729,5952,0,0,0,1.0,1,1.0,1,1.0,1,0.14066701427125758,57
4913,3,9684,3729,5955,0,0,0,1.0,1,1.0,1,1.0,1,0.1008831257793966,56
4914,0,9684,3729,5955,0,0,0,1.0,1,1.0,1,1.0,1,0.1008831257793966,56
4915,3,9687,3730,5957,0,0,0,1.0,1,1.0,1,1.0,1,0.054929416450149954,56
4916,0,9687,3730,5957,0,0,0,1.0,1,1.0,1,1.0,1,0.061391868064072375,54
4917,1,9688,3731,5957,0,0,0,1.0,1,1.0,1,1.0,1,0.08610817784186334,53
4918,0,9688,3731,5957,0,0,0,1.0,1,1.0,1,1.0,1,0.09940558700759623,52
4919,1,9689,3732,5957,0,0,0,1.0,1,1.0,1,1.0,1,0.15888118528605322,49
4920,0,9689,3732,5957,0,0,0,1.0,1,1.0,1,1.0,1,0.15888118528605322,49
4921,6,9695,3734,5961,0,0,0,1.0,1,1.0,1,1.0,1,0.16950673978268088,50
4922,2,9697,3734,5963,0,0,0,1.0,1,1.0,1,1.0,1,0.16156010320603667,50
4923,3,9700,3734,5966,0,0,0,1.0,1,1.0,1,1.0,1,0.1149981449989186,52
4924,0,9700,3734,5966,0,0,0,1.0,1,1.0,1,1.0,1,0.12398188331385566,53
4925,3,9703,3735,5968,0,0,0,1.0,1,1.0,1,1.0,1,0.08098288871331343,54
4926,2,9705,3735,5970,0,0,0,1.0,1,1.0,1,1.0,1,0.05637747693963718,54
4927,1,9706,3736,5970,0,0,0,1.0,1,1.0,1,1.0,1,0.0629415685851818,54
4928,0,9706,3736,5970,0,0,0,1.0,1,1.0,1,1.0,1,0.0629415685851818,54
4929,0,9706,3736,5970,0,0,0,1.0,1,1.0,1,1.0,1,0.07928706444163666,55
4930,2,9708,3737,5971,0,0,0,1.0,1,1.0,1,1.0,1,0.11731128604066064,58
4931,1,9709,3738,5971,0,0,0,1.0,1,1.0,1,1.0,1,0.1236080768399184,58
4932,1,9710,3738,5972,0,0,0,1.0,1,1.0,1,1.0,1,0.1170382764347798,59
4933,1,9711,3739,5972,0,0,0,1.0,1,1.0,1,1.0,1,0.1448642481619942,59
4934,3,9714,3740,5974,0,0,0,1.0,1,1.0,1,1.0,1,0.1397629160418123,59
4935,1,9715,3740,5975,0,0,0,1.0,1,1.0,1,1.0,1,0.13129152854065557,59
4936,0,9715,3740,5975,0,0,0,1.0,1,1.0,1,1.0,1,0.13129152854065557,59
4937,3,9718,3740,5978,0,0,0,1.0,1,1.0,1,1.0,1,0.11446852725759225,61
4938,1,9719,3740,5979,0,0,0,1.0,1,1.0,1,1.0,1,0.11636957622510327,62
4939,1,9720,3740,5980,0,0,0,1.0,1,1.0,1,1.0,1,0.10511022025140959,63
4940,1,9721,3740,5981,0,0,0,1.0,1,1.0,1,1.0,1,0.11577659073342486,65
4941,1,9722,3741,5981,0,0,0,1.0,1,1.0,1,1.0,1,0.13363097122445217,65
4942,6,9728,3743,5985,0,0,0,1.0,1,1.0,1,1.0,1,0.1159118415110863,67
4943,5,9733,3744,5989,0,0,0,1.0,1,1.0,1,1.0,1,0.10969035922716967,66
4944,4,9737,3746,5991,0,0,0,1.0,1,1.0,1,1.0,1,0.1315746455793389,63
4945,3,9740,3746,5994,0,0,0,1.0,1,1.0,1,1.0,1,0.08984028639770812,61
4946,3,9743,3748,5995,0,0,0,1.0,1,1.0,1,1.0,1,0.11068942064366953,60
4947,3,9746,3749,5997,0,0,0,1.0,1,1.0,1,1.0,1,0.08224555537804669,58
4948,2,9748,3751,5997,0,0,0,1.0,1,1.0,1,1.0,1,0.12107755045378546,57
4949,3,9751,3754,5997,0,0,0,1.0,1,1.0,1,1.0,1,0.13020396160873426,56
4950,7,9758,3756,6002,0,0,0,1.0,1,1.0,1,1.0,1,0.10605140094718377,57
4951,2,9760,3756,6004,0,0,0,1.0,1,1.0,1,1.0,1,0.08809627206634676,55
4952,4,9764,3759,6005,0,0,0,1.0,1,1.0,1,1.0,1,0.1367589594956413,55
4953,5,9769,3761,6008,0,0,0,1.0,1,1.0,1,1.0,1,0.10559645018246581,54
4954,0,9769,3761,6008,0,0,0,1.0,1,1.0,1,1.0,1,0.10686775363805529,54
4955,0,9769,3761,6008,0,0,0,1.0,1,1.0,1,1.0,1,0.08145098196153386,52
4956,1,9770,3761,6009,0,0,0,1.0,1,1.0,1,1.0,1,0.061810762366524725,52
4957,0,9770,3761,6009,0,0,0,1.0,1,1.0,1,1.0,1,0.07835527231499202,53
4958,0,9770,3761,6009,0,0,0,1.0,1,1.0,1,1.0,1,0.08325740733309869,52
4959,1,9771,3762,6009,0,0,0,1.0,1,1.0,1,1.0,1,0.096826519321159,51
4960,1,9772,3762,6010,0,0,0,1.0,1,1.0,1,1.0,1,0.0676248447655814,53
4961,0,9772,3762,6010,0,0,0,1.0,1,1.0,1,1.0,1,0.0676248447655814,53
4962,1,9773,3762,6011,0,0,0,1.0,1,1.0,1,1.0,1,0.07424304247417063,55
4963,0,9773,3762,6011,0,0,0,1.0,1,1.0,1,1.0,1,0.0692505862415482,54
4964,1,9774,3763,6011,0,0,0,1.0,1,1.0,1,1.0,1,0.09699299694984373,54
4965,3,9777,3764,6013,0,0,0,1.0,1,1.0,1,1.0,1,0.08208745926909582,54
4966,1,9778,3765,6013,0,0,0,1.0,1,1.0,1,1.0,1,0.09046391417908975,54
4967,4,9782,3767,6015,0,0,0,1.0,1,1.0,1,1.0,1,0.08457423366907506,55
4968,2,9784,3769,6015,0,0,0,1.0,1,1.0,1,1.0,1,0.11351122094720258,55
4969,3,9787,3769,6018,0,0,0,1.0,1,1.0,1,1.0,1,0.08835513245756889,57
4970,0,9787,3769,6018,0,0,0,1.0,1,1.0,1,1.0,1,0.10187403967719517,56
4971,2,9789,3770,6019,0,0,0,1.0,1,1.0,1,1.0,1,0.1027473043672951,57
4972,3,9792,3771,6021,0,0,0,1.0,1,1.0,1,1.0,1,0.12197180802555184,57
4973,4,9796,3772,6024,0,0,0,1.0,1,1.0,1,1.0,1,0.1122813854994711,60
4974,3,9799,3773,6026,0,0,0,1.0,1,1.0,1,1.0,1,0.12480235154714946,58
4975,3,9802,3774,6028,0,0,0,1.0,1,1.0,1,1.0,1,0.11226114948408081,59
4976,4,9806,3775,6031,0,0,0,1.0,1,1.0,1,1.0,1,0.08999288406003983,59
4977,3,9809,3778,6031,0,0,0,1.0,1,1.0,1,1.0,1,0.12983293586216957,59
4978,1,9810,3779,6031,0,0,0,1.0,1,1.0,1,1.0,1,0.12500366747672642,59
4979,2,9812,3779,6033,0,0,0,1.0,1,1.0,1,1.0,1,0.0847633669289957,61
4980,1,9813,3780,6033,0,0,0,1.0,1,1.0,1,1.0,1,0.09344360363693557,62
4981,5,9818,3783,6035,0,0,0,1.0,1,1.0,1,1.0,1,0.06359857951289645,62
4982,3,9821,3784,6037,0,0,0,1.0,1,1.0,1,1.0,1,0.06462868447151239,63
4983,0,9821,3784,6037,0,0,0,1.0,1,1.0,1,1.0,1,0.06337217490402888,63
4984,1,9822,3785,6037,0,0,0,1.0,1,1.0,1,1.0,1,0.08874414470462394,61
4985,0,9822,3785,6037,0,0,0,1.0,1,1.0,1,1.0,1,0.06959051020162144,59
4986,5,9827,3786,6041,0,0,0,1.0,1,1.0,1,1.0,1,0.06721764115395913,62
4987,2,9829,3788,6041,0,0,0,1.0,1,1.0,1,1.0,1,0.08442858274473324,60
4988,1,9830,3789,6041,0,0,0,1.0,1,1.0,1,1.0,1,0.09252571038930274,59
4989,4,9834,3790,6044,0,0,0,1.0,1,1.0,1,1.0,1,0.0998515163540512,57
4990,0,9834,3790,6044,0,0,0,1.0,1,1.0,1,1.0,1,0.13082427585341516,55
4991,6,9840,3793,6047,0,0,0,1.0,1,1.0,1,1.0,1,0.09398613779680223,54
4992,1,9841,3794,6047,0,0,0,1.0,1,1.0,1,1.0,1,0.1285499631745741,52
4993,2,9843,3795,6048,0,0,0,1.0,1,1.0,1,1.0,1,0.10164024613886811,51
4994,4,9847,3797,6050,0,0,0,1.0,1,1.0,1,1.0,1,0.11616257585360404,49
4995,4,9851,3799,6052,0,0,0,1.0,1,1.0,1,1.0,1,0.11380112976525525,48
4996,5,9856,3803,6053,0,0,0,1.0,1,1.0,1,1.0,1,0.13813043918726867,48
4997,4,9860,3803,6057,0,0,0,1.0,1,1.0,1,1.0,1,0.08986645409564567,46
4998,1,9861,3804,6057,0,0,0,1.0,1,1.0,1,1.0,1,0.09573053278466402,48
4999,5,9866,3806,6060,0,0,0,1.0,1,1.0,1,1.0,1,0.11116016200976966,48
5000,1,9867,3807,6060,0,0,0,1.0,1,1.0,1,1.0,1,0.11776959659106569,47
5001,1,9868,3808,6060,0,0,0,1.0,1,1.0,1,1.0,1,0.1515275897362324,45
5002,2,9870,3809,6061,0,0,0,1.0,1,1.0,1,1.0,1,0.16912166586728192,46
5003,3,9873,3809,6064,0,0,0,1.0,1,1.0,1,1.0,1,0.1657954232415328,46
5004,2,9875,3810,6065,0,0,0,1.0,1,1.0,1,1.0,1,0.1562896597013744,46
5005,2,9877,3810,6067,0,0,0,1.0,1,1.0,1,1.0,1,0.15041598117946242,45
5006,0,9877,3810,6067,0,0,0,1.0,1,1.0,1,1.0,1,0.1661728982447975,45
5007,1,9878,3810,6068,0,0,0,1.0,1,1.0,1,1.0,1,0.14914113501907889,46
5008,0,9878,3810,6068,0,0,0,1.0,1,1.0,1,1.0,1,0.1491195709923196,49
5009,0,9878,3810,6068,0,0,0,1.0,1,1.0,1,1.0,1,0.14810849177316124,49
5010,0,9878,3810,6068,0,0,0,1.0,1,1.0,1,1.0,1,0.16300978991357104,50
5011,1,9879,3810,6069,0,0,0,1.0,1,1.0,1,1.0,1,0.16394020716123678,51
5012,0,9879,3810,6069,0,0,0,1.0,1,1.0,1,1.0,1,0.17726094765702297,52
5013,0,9879,3810,6069,0,0,0,1.0,1,1.0,1,1.0,1,0.17726094765702297,52
5014,0,9879,3810,6069,0,0,0,1.0,1,1.0,1,1.0,1,0.17604848389756678,53
5015,5,9884,3811,6073,0,0,0,1.0,1,1.0,1,1.0,1,0.16420592555670097,54
5016,2,9886,3811,6075,0,0,0,1.0,1,1.0,1,1.0,1,0.1632685835552591,55
5017,3,9889,3811,6078,0,0,0,1.0,1,1.0,1,1.0,1,0.10524102401409499,55
5018,2,9891,3812,6079,0,0,0,1.0,1,1.0,1,1.0,1,0.0944375562662884,56
5019,0,9891,3812,6079,0,0,0,1.0,1,1.0,1,1.0,1,0.0944375562662884,56
5020,0,9891,3812,6079,0,0,0,1.0,1,1.0,1,1.0,1,0.11062147931287626,55
5021,2,9893,3813,6080,0,0,0,1.0,1,1.0,1,1.0,1,0.1092933350139723,56
5022,2,9895,3815,6080,0,0,0,1.0,1,1.0,1,1.0,1,0.1557400199945627,56
5023,7,9902,3816,6086,0,0,0,1.0,1,1.0,1,1.0,1,0.11456797251305588,55
5024,3,9905,3819,6086,0,0,0,1.0,1,1.0,1,1.0,1,0.14311108687116553,55
5025,1,9906,3820,6086,0,0,0,1.0,1,1.0,1,1.0,1,0.12891013486660416,53
5026,3,9909,3823,6086,0,0,0,1.0,1,1.0,1,1.0,1,0.149374162731733,52
5027,2,9911,3824,6087,0,0,0,1.0,1,1.0,1,1.0,1,0.13701078387604224,51
5028,4,9915,3827,6088,0,0,0,1.0,1,1.0,1,1.0,1,0.1810336986436827,51
5029,3,9918,3829,6089,0,0,0,1.0,1,1.0,1,1.0,1,0.20941712617045113,50
5030,1,9919,3830,6089,0,0,0,1.0,1,1.0,1,1.0,1,0.1655819093634655,49
5031,4,9923,3831,6092,0,0,0,1.0,1,1.0,1,1.0,1,0.13819634874996625,49
5032,2,9925,3833,6092,0,0,0,1.0,1,1.0,1,1.0,1,0.15383421177264905,48
5033,6,9931,3834,6097,0,0,0,1.0,1,1.0,1,1.0,1,0.14005930143461529,50
5034,2,9933,3835,6098,0,0,0,1.0,1,1.0,1,1.0,1,0.1521629701174622,49
5035,5,9938,3837,6101,0,0,0,1.0,1,1.0,1,1.0,1,0.1272913907240678,49
5036,0,9938,3837,6101,0,0,0,1.0,1,1.0,1,1.0,1,0.09914066447747581,47
5037,2,9940,3838,6102,0,0,0,1.0,1,1.0,1,1.0,1,0.07353260216262461,47
5038,1,9941,3838,6103,0,0,0,1.0,1,1.0,1,1.0,1,0.053381059784606964,47
5039,1,9942,3839,6103,0,0,0,1.0,1,1.0,1,1.0,1,0.08105490273845736,48
5040,0,9942,3839,6103,0,0,0,1.0,1,1.0,1,1.0,1,0.08105490273845736,48
5041,1,9943,3839,6104,0,0,0,1.0,1,1.0,1,1.0,1,0.07222140140908526,48
5042,0,9943,3839,6104,0,0,0,1.0,1,1.0,1,1.0,1,0.07484352314951806,50
5043,0,9943,3839,6104,0,0,0,1.0,1,1.0,1,1.0,1,0.0818738442273556,51
5044,0,9943,3839,6104,0,0,0,1.0,1,1.0,1,1.0,1,0.0818738442273556,51
5045,1,9944,3839,6105,0,0,0,1.0,1,1.0,1,1.0,1,0.09042375365460534,52
5046,2,9946,3840,6106,0,0,0,1.0,1,1.0,1,1.0,1,0.09469093506016982,51
5047,0,9946,3840,6106,0,0,0,1.0,1,1.0,1,1.0,1,0.09469093506016982,51
5048,1,9947,3841,6106,0,0,0,1.0,1,1.0,1,1.0,1,0.08551865609678398,52
5049,3,9950,3841,6109,0,0,0,1.0,1,1.0,1,1.0,1,0.0927188512009406,54
5050,3,9953,3841,6112,0,0,0,1.0,1,1.0,1,1.0,1,0.09834749013548358,56
5051,2,9955,3841,6114,0,0,0,1.0,1,1.0,1,1.0,1,0.07940144429114827,55
5052,0,9955,3841,6114,0,0,0,1.0,1,1.0,1,1.0,1,0.07940144429114827,55
5053,1,9956,3841,6115,0,0,0,1.0,1,1.0,1,1.0,1,0.06335289842839884,55
5054,1,9957,3842,6115,0,0,0,1.0,1,1.0,1,1.0,1,0.08468367175856348,55
5055,1,9958,3842,6116,0,0,0,1.0,1,1.0,1,1.0,1,0.07349322056070978,55
5056,2,9960,3843,6117,0,0,0,1.0,1,1.0,1,1.0,1,0.1094295965849068,56
5057,3,9963,3843,6120,0,0,0,1.0,1,1.0,1,1.0,1,0.08650517082571162,58
5058,0,9963,3843,6120,0,0,0,1.0,1,1.0,1,1.0,1,0.09939827857959958,59
5059,1,9964,3843,6121,0,0,0,1.0,1,1.0,1,1.0,1,0.08833636265916198,59
5060,0,9964,3843,6121,0,0,0,1.0,1,1.0,1,1.0,1,0.08833636265916198,59
5061,1,9965,3843,6122,0,0,0,1.0,1,1.0,1,1.0,1,0.06838398958707388,59
5062,2,9967,3845,6122,0,0,0,1.0,1,1.0,1,1.0,1,0.1369431970854266,59
5063,3,9970,3846,6124,0,0,0,1.0,1,1.0,1,1.0,1,0.14948665980898873,59
5064,5,9975,3850,6125,0,0,0,1.0,1,1.0,1,1.0,1,0.17233222669046458,57
5065,3,9978,3851,6127,0,0,0,1.0,1,1.0,1,1.0,1,0.1351258520805716,55
5066,4,9982,3853,6129,0,0,0,1.0,1,1.0,1,1.0,1,0.1751930135686991,55
5067,4,9986,3853,6133,0,0,0,1.0,1,1.0,1,1.0,1,0.11447270764858268,54
5068,0,9986,3853,6133,0,0,0,1.0,1,1.0,1,1.0,1,0.10648388671209938,54
5069,0,9986,3853,6133,0,0,0,1.0,1,1.0,1,1.0,1,0.09970325654566023,54
5070,2,9988,3855,6133,0,0,0,1.0,1,1.0,1,1.0,1,0.14508530511876816,52
5071,6,9994,3856,6138,0,0,0,1.0,1,1.0,1,1.0,1,0.10656868126620576,54
5072,3,9997,3856,6141,0,0,0,1.0,1,1.0,1,1.0,1,0.09248107935351983,52
5073,1,9998,3856,6142,0,0,0,1.0,1,1.0,1,1.0,1,0.09066988462864074,51
5074,3,10001,3857,6144,0,0,0,1.0,1,1.0,1,1.0,1,0.08114597388100767,52
5075,0,10001,3857,6144,0,0,0,1.0,1,1.0,1,1.0,1,0.08502745988057298,53
5076,0,10001,3857,6144,0,0,0,1.0,1,1.0,1,1.0,1,0.08502745988057298,53
5077,1,10002,3858,6144,0,0,0,1.0,1,1.0,1,1.0,1,0.10111694300341079,56
5078,2,10004,3858,6146,0,0,0,1.0,1,1.0,1,1.0,1,0.0854434142531904,55
5079,1,10005,3858,6147,0,0,0,1.0,1,1.0,1,1.0,1,0.07823500070361358,56
5080,0,10005,3858,6147,0,0,0,1.0,1,1.0,1,1.0,1,0.07529108014857676,57
5081,0,10005,3858,6147,0,0,0,1.0,1,1.0,1,1.0,1,0.08339556219065442,58
5082,0,10005,3858,6147,0,0,0,1.0,1,1.0,1,1.0,1,0.08339556219065442,58
5083,0,10005,3858,6147,0,0,0,1.0,1,1.0,1,1.0,1,0.09325561046113877,59
5084,1,10006,3858,6148,0,0,0,1.0,1,1.0,1,1.0,1,0.06613494057559186,59
5085,4,10010,3860,6150,0,0,0,1.0,1,1.0,1,1.0,1,0.09456273575256771,60
5086,2,10012,3861,6151,0,0,0,1.0,1,1.0,1,1.0,1,0.11233844835925637,61
5087,6,10018,3863,6155,0,0,0,1.0,1,1.0,1,1.0,1,0.058888141398833464,62
5088,1,10019,3863,6156,0,0,0,1.0,1,1.0,1,1.0,1,0.06415304687965488,64
5089,1,10020,3864,6156,0,0,0,1.0,1,1.0,1,1.0,1,0.07660477107972417,64
5090,0,10020,3864,6156,0,0,0,1.0,1,1.0,1,1.0,1,0.07660477107972417,64
5091,7,10027,3868,6159,0,0,0,1.0,1,1.0,1,1.0,1,0.10237123044654643,64
5092,2,10029,3870,6159,0,0,0,1.0,1,1.0,1,1.0,1,0.13301806799093852,64
5093,3,10032,3870,6162,0,0,0,1.0,1,1.0,1,1.0,1,0.11093914920506202,64
5094,2,10034,3871,6163,0,0,0,1.0,1,1.0,1,1.0,1,0.09985423591834368,65
5095,5,10039,3872,6167,0,0,0,1.0,1,1.0,1,1.0,1,0.09525622855925224,66
5096,0,10039,3872,6167,0,0,0,1.0,1,1.0,1,1.0,1,0.10310692069562707,66
5097,3,10042,3874,6168,0,0,0,1.0,1,1.0,1,1.0,1,0.11426465293536915,67
5098,2,10044,3874,6170,0,0,0,1.0,1,1.0,1,1.0,1,0.09060446192264189,67
5099,4,10048,3875,6173,0,0,0,1.0,1,1.0,1,1.0,1,0.08592479898654602,70
5100,0,10048,3875,6173,0,0,0,1.0,1,1.0,1,1.0,1,0.0836452334445962,71
5101,2,10050,3875,6175,0,0,0,1.0,1,1.0,1,1.0,1,0.07636572282100793,72
5102,6,10056,3879,6177,0,0,0,1.0,1,1.0,1,1.0,1,0.11250603613356039,72
5103,4,10060,3881,6179,0,0,0,1.0,1,1.0,1,1.0,1,0.07380043843356171,70
5104,4,10064,3884,6180,0,0,0,1.0,1,1.0,1,1.0,1,0.06354453629015744,67
5105,4,10068,3887,6181,0,0,0,1.0,1,1.0,1,1.0,1,0.10127106646735154,66
5106,6,10074,3891,6183,0,0,0,1.0,1,1.0,1,1.0,1,0.13690917652774667,64
5107,6,10080,3894,6186,0,0,0,1.0,1,1.0,1,1.0,1,0.11084661888377778,61
5108,2,10082,3896,6186,0,0,0,1.0,1,1.0,1,1.0,1,0.13199567969375606,57
5109,5,10087,3898,6189,0,0,0,1.0,1,1.0,1,1.0,1,0.10399629976410316,55
5110,5,10092,3900,6192,0,0,0,1.0,1,1.0,1,1.0,1,0.10237889867979427,53
5111,2,10094,3902,6192,0,0,0,1.0,1,1.0,1,1.0,1,0.15160855655663674,52
5112,4,10098,3904,6194,0,0,0,1.0,1,1.0,1,1.0,1,0.14105518701525063,52
5113,4,10102,3904,6198,0,0,0,1.0,1,1.0,1,1.0,1,0.09447363647717884,49
5114,3,10105,3907,6198,0,0,0,1.0,1,1.0,1,1.0,1,0.1519695291864782,49
5115,3,10108,3907,6201,0,0,0,1.0,1,1.0,1,1.0,1,0.12612784862816823,48
5116,2,10110,3908,6202,0,0,0,1.0,1,1.0,1,1.0,1,0.13796748736652836,47
5117,2,10112,3908,6204,0,0,0,1.0,1,1.0,1,1.0,1,0.12530712202949895,48
5118,0,10112,3908,6204,0,0,0,1.0,1,1.0,1,1.0,1,0.10739131528691306,49
5119,1,10113,3909,6204,0,0,0,1.0,1,1.0,1,1.0,1,0.10440407239265778,49
5120,1,10114,3909,6205,0,0,0,1.0,1,1.0,1,1.0,1,0.10770233676861607,48
5121,1,10115,3910,6205,0,0,0,1.0,1,1.0,1,1.0,1,0.14902762088624824,48
5122,4,10119,3912,6207,0,0,0,1.0,1,1.0,1,1.0,1,0.16775308024147392,46
5123,2,10121,3912,6209,0,0,0,1.0,1,1.0,1,1.0,1,0.1503330219993366,46
5124,0,10121,3912,6209,0,0,0,1.0,1,1.0,1,1.0,1,0.14671808245958998,47
5125,7,10128,3913,6215,0,0,0,1.0,1,1.0,1,1.0,1,0.15365654539058787,49
5126,3,10131,3913,6218,0,0,0,1.0,1,1.0,1,1.0,1,0.13002085274786046,49
5127,5,10136,3914,6222,0,0,0,1.0,1,1.0,1,1.0,1,0.10174409459981783,51
5128,4,10140,3916,6224,0,0,0,1.0,1,1.0,1,1.0,1,0.12632557745343803,53
5129,4,10144,3917,6227,0,0,0,1.0,1,1.0,1,1.0,1,0.10477470447641546,55
5130,0,10144,3917,6227,0,0,0,1.0,1,1.0,1,1.0,1,0.10477470447641546,55
5131,2,10146,3917,6229,0,0,0,1.0,1,1.0,1,1.0,1,0.084241265896675,55
5132,0,10146,3917,6229,0,0,0,1.0,1,1.0,1,1.0,1,0.084241265896675,55
5133,1,10147,3917,6230,0,0,0,1.0,1,1.0,1,1.0,1,0.08037371353918255,56
5134,0,10147,3917,6230,0,0,0,1.0,1,1.0,1,1.0,1,0.10879661738465249,56
5135,0,10147,3917,6230,0,0,0,1.0,1,1.0,1,1.0,1,0.10879661738465249,56
5136,1,10148,3917,6231,0,0,0,1.0,1,1.0,1,1.0,1,0.10561791256796269,55
5137,2,10150,3918,6232,0,0,0,1.0,1,1.0,1,1.0,1,0.11599773996265149,55
5138,0,10150,3918,6232,0,0,0,1.0,1,1.0,1,1.0,1,0.1272945334786755,54
5139,3,10153,3920,6233,0,0,0,1.0,1,1.0,1,1.0,1,0.12069699298145212,54
5140,1,10154,3921,6233,0,0,0,1.0,1,1.0,1,1.0,1,0.12494472040091442,54
5141,5,10159,3922,6237,0,0,0,1.0,1,1.0,1,1.0,1,0.09768533557896489,53
5142,6,10165,3925,6240,0,0,0,1.0,1,1.0,1,1.0,1,0.08361730830821332,55
5143,4,10169,3928,6241,0,0,0,1.0,1,1.0,1,1.0,1,0.11395830310183268,54
5144,3,10172,3929,6243,0,0,0,1.0,1,1.0,1,1.0,1,0.07747637331384709,50
5145,3,10175,3930,6245,0,0,0,1.0,1,1.0,1,1.0,1,0.058807200215322375,51
5146,1,10176,3931,6245,0,0,0,1.0,1,1.0,1,1.0,1,0.08871553827778711,48
5147,4,10180,3932,6248,0,0,0,1.0,1,1.0,1,1.0,1,0.04106359683774795,49
5148,1,10181,3933,6248,0,0,0,1.0,1,1.0,1,1.0,1,0.050861026010912705,47
5149,5,10186,3935,6251,0,0,0,1.0,1,1.0,1,1.0,1,0.12270352048719059,46
5150,5,10191,3938,6253,0,0,0,1.0,1,1.0,1,1.0,1,0.14566325001693492,46
5151,5,10196,3940,6256,0,0,0,1.0,1,1.0,1,1.0,1,0.1839942097037254,45
5152,6,10202,3943,6259,0,0,0,1.0,1,1.0,1,1.0,1,0.207679855067622,45
5153,2,10204,3944,6260,0,0,0,1.0,1,1.0,1,1.0,1,0.17127222468294817,45
5154,1,10205,3944,6261,0,0,0,1.0,1,1.0,1,1.0,1,0.15428157498944622,45
5155,1,10206,3944,6262,0,0,0,1.0,1,1.0,1,1.0,1,0.10262864465097951,44
5156,1,10207,3945,6262,0,0,0,1.0,1,1.0,1,1.0,1,0.10902862793185392,44
5157,0,10207,3945,6262,0,0,0,1.0,1,1.0,1,1.0,1,0.11869730156193639,42
5158,1,10208,3946,6262,0,0,0,1.0,1,1.0,1,1.0,1,0.14028364735311785,43
5159,1,10209,3946,6263,0,0,0,1.0,1,1.0,1,1.0,1,0.16499974347663762,43
5160,0,10209,3946,6263,0,0,0,1.0,1,1.0,1,1.0,1,0.16499974347663762,43
5161,0,10209,3946,6263,0,0,0,1.0,1,1.0,1,1.0,1,0.16499974347663762,43
5162,1,10210,3946,6264,0,0,0,1.0,1,1.0,1,1.0,1,0.15382792592507466,44
5163,3,10213,3947,6266,0,0,0,1.0,1,1.0,1,1.0,1,0.13774178497482395,46
5164,1,10214,3947,6267,0,0,0,1.0,1,1.0,1,1.0,1,0.11141101936166752,46
5165,1,10215,3947,6268,0,0,0,1.0,1,1.0,1,1.0,1,0.09097375942108366,46
5166,4,10219,3950,6269,0,0,0,1.0,1,1.0,1,1.0,1,0.0942007341308065,47
5167,0,10219,3950,6269,0,0,0,1.0,1,1.0,1,1.0,1,0.0942007341308065,47
5168,3,10222,3952,6270,0,0,0,1.0,1,1.0,1,1.0,1,0.12222392854328613,47
5169,2,10224,3952,6272,0,0,0,1.0,1,1.0,1,1.0,1,0.09729848746300447,47
5170,2,10226,3953,6273,0,0,0,1.0,1,1.0,1,1.0,1,0.09671367085966359,48
5171,1,10227,3954,6273,0,0,0,1.0,1,1.0,1,1.0,1,0.12082886464616793,48
5172,2,10229,3954,6275,0,0,0,1.0,1,1.0,1,1.0,1,0.07287610071078013,49
5173,0,10229,3954,6275,0,0,0,1.0,1,1.0,1,1.0,1,0.08456210136997974,49
5174,2,10231,3954,6277,0,0,0,1.0,1,1.0,1,1.0,1,0.07389633698873549,52
5175,0,10231,3954,6277,0,0,0,1.0,1,1.0,1,1.0,1,0.06629225427979785,53
5176,0,10231,3954,6277,0,0,0,1.0,1,1.0,1,1.0,1,0.08153283818259684,54
5177,3,10234,3957,6277,0,0,0,1.0,1,1.0,1,1.0,1,0.12364664525674947,54
5178,7,10241,3960,6281,0,0,0,1.0,1,1.0,1,1.0,1,0.1592590980106159,55
5179,2,10243,3961,6282,0,0,0,1.0,1,1.0,1,1.0,1,0.14362165218064035,53
5180,1,10244,3962,6282,0,0,0,1.0,1,1.0,1,1.0,1,0.17171490765458955,52
5181,7,10251,3964,6287,0,0,0,1.0,1,1.0,1,1.0,1,0.14855883233738315,52
5182,2,10253,3964,6289,0,0,0,1.0,1,1.0,1,1.0,1,0.14095882534313306,52
5183,5,10258,3966,6292,0,0,0,1.0,1,1.0,1,1.0,1,0.1490548960501496,52
5184,2,10260,3967,6293,0,0,0,1.0,1,1.0,1,1.0,1,0.1602488533577116,52
5185,2,10262,3968,6294,0,0,0,1.0,1,1.0,1,1.0,1,0.15114113654448547,50
5186,1,10263,3969,6294,0,0,0,1.0,1,1.0,1,1.0,1,0.17773319017886346,48
5187,3,10266,3969,6297,0,0,0,1.0,1,1.0,1,1.0,1,0.14715386561779537,46
5188,0,10266,3969,6297,0,0,0,1.0,1,1.0,1,1.0,1,0.1369078949507651,44
5189,1,10267,3969,6298,0,0,0,1.0,1,1.0,1,1.0,1,0.13208686842984546,44
5190,1,10268,3970,6298,0,0,0,1.0,1,1.0,1,1.0,1,0.15625303936442667,45
5191,0,10268,3970,6298,0,0,0,1.0,1,1.0,1,1.0,1,0.15338026855827092,45
5192,1,10269,3970,6299,0,0,0,1.0,1,1.0,1,1.0,1,0.1135366584984288,45
5193,0,10269,3970,6299,0,0,0,1.0,1,1.0,1,1.0,1,0.1135366584984288,45
5194,0,10269,3970,6299,0,0,0,1.0,1,1.0,1,1.0,1,0.12685808346868685,45
5195,3,10272,3971,6301,0,0,0,1.0,1,1.0,1,1.0,1,0.112468799157887,46
5196,0,10272,3971,6301,0,0,0,1.0,1,1.0,1,1.0,1,0.112468799157887,46
5197,1,10273,3972,6301,0,0,0,1.0,1,1.0,1,1.0,1,0.1398843361935488,46
5198,0,10273,3972,6301,0,0,0,1.0,1,1.0,1,1.0,1,0.1270031031479438,47
5199,4,10277,3973,6304,0,0,0,1.0,1,1.0,1,1.0,1,0.14650864768216298,49
5200,1,10278,3974,6304,0,0,0,1.0,1,1.0,1,1.0,1,0.16299582817253275,49
5201,5,10283,3976,6307,0,0,0,1.0,1,1.0,1,1.0,1,0.10171220300401491,50
5202,1,10284,3976,6308,0,0,0,1.0,1,1.0,1,1.0,1,0.09355065750105335,52
5203,0,10284,3976,6308,0,0,0,1.0,1,1.0,1,1.0,1,0.09355065750105335,52
5204,0,10284,3976,6308,0,0,0,1.0,1,1.0,1,1.0,1,0.09005440017815569,54
5205,0,10284,3976,6308,0,0,0,1.0,1,1.0,1,1.0,1,0.09005440017815569,54
5206,1,10285,3976,6309,0,0,0,1.0,1,1.0,1,1.0,1,0.09509138545911887,55
5207,2,10287,3976,6311,0,0,0,1.0,1,1.0,1,1.0,1,0.06843567721137446,54
5208,0,10287,3976,6311,0,0,0,1.0,1,1.0,1,1.0,1,0.06843567721137446,54
5209,0,10287,3976,6311,0,0,0,1.0,1,1.0,1,1.0,1,0.06843567721137446,54
5210,0,10287,3976,6311,0,0,0,1.0,1,1.0,1,1.0,1,0.06843567721137446,54
5211,2,10289,3977,6312,0,0,0,1.0,1,1.0,1,1.0,1,0.08457420438242957,56
5212,2,10291,3978,6313,0,0,0,1.0,1,1.0,1,1.0,1,0.07064267916393034,57
5213,5,10296,3982,6314,0,0,0,1.0,1,1.0,1,1.0,1,0.1210746478880144,57
5214,6,10302,3984,6318,0,0,0,1.0,1,1.0,1,1.0,1,0.17668719383684237,58
5215,3,10305,3984,6321,0,0,0,1.0,1,1.0,1,1.0,1,0.17013261602782764,57
5216,4,10309,3985,6324,0,0,0,1.0,1,1.0,1,1.0,1,0.15463119081800358,57
5217,2,10311,3986,6325,0,0,0,1.0,1,1.0,1,1.0,1,0.12182511215490269,56
5218,2,10313,3988,6325,0,0,0,1.0,1,1.0,1,1.0,1,0.15091897762892809,56
5219,3,10316,3988,6328,0,0,0,1.0,1,1.0,1,1.0,1,0.10403555210213204,54
5220,2,10318,3989,6329,0,0,0,1.0,1,1.0,1,1.0,1,0.1258271718636969,53
5221,2,10320,3989,6331,0,0,0,1.0,1,1.0,1,1.0,1,0.11719596716341461,52
5222,2,10322,3990,6332,0,0,0,1.0,1,1.0,1,1.0,1,0.11536387541748361,52
5223,3,10325,3991,6334,0,0,0,1.0,1,1.0,1,1.0,1,0.10471836266585996,52
5224,1,10326,3991,6335,0,0,0,1.0,1,1.0,1,1.0,1,0.10575558419622455,52
5225,0,10326,3991,6335,0,0,0,1.0,1,1.0,1,1.0,1,0.09770655676514123,50
5226,3,10329,3994,6335,0,0,0,1.0,1,1.0,1,1.0,1,0.13817337794543508,51
5227,6,10335,3995,6340,0,0,0,1.0,1,1.0,1,1.0,1,0.12914912100809098,49
5228,1,10336,3996,6340,0,0,0,1.0,1,1.0,1,1.0,1,0.16487872832191222,48
5229,2,10338,3996,6342,0,0,0,1.0,1,1.0,1,1.0,1,0.12872007933315707,49
5230,1,10339,3996,6343,0,0,0,1.0,1,1.0,1,1.0,1,0.11530337608366097,49
5231,0,10339,3996,6343,0,0,0,1.0,1,1.0,1,1.0,1,0.11530337608366097,49
5232,1,10340,3996,6344,0,0,0,1.0,1,1.0,1,1.0,1,0.11099409505245061,51
5233,3,10343,3997,6346,0,0,0,1.0,1,1.0,1,1.0,1,0.0992350692208532,51
5234,4,10347,4000,6347,0,0,0,1.0,1,1.0,1,1.0,1,0.09898385723855437,52
5235,1,10348,4000,6348,0,0,0,1.0,1,1.0,1,1.0,1,0.07458839256817724,52
5236,0,10348,4000,6348,0,0,0,1.0,1,1.0,1,1.0,1,0.07458839256817724,52
5237,0,10348,4000,6348,0,0,0,1.0,1,1.0,1,1.0,1,0.09100665600790066,53
5238,1,10349,4001,6348,0,0,0,1.0,1,1.0,1,1.0,1,0.09255526932066163,53
5239,2,10351,4001,6350,0,0,0,1.0,1,1.0,1,1.0,1,0.07291662345940789,53
5240,5,10356,4005,6351,0,0,0,1.0,1,1.0,1,1.0,1,0.1146798216015777,55
5241,3,10359,4005,6354,0,0,0,1.0,1,1.0,1,1.0,1,0.08037596427670037,56
5242,2,10361,4006,6355,0,0,0,1.0,1,1.0,1,1.0,1,0.07908973159009314,54
5243,2,10363,4007,6356,0,0,0,1.0,1,1.0,1,1.0,1,0.09545999547390104,55
5244,2,10365,4009,6356,0,0,0,1.0,1,1.0,1,1.0,1,0.14283850789367644,55
5245,3,10368,4009,6359,0,0,0,1.0,1,1.0,1,1.0,1,0.10065257590367829,55
5246,2,10370,4010,6360,0,0,0,1.0,1,1.0,1,1.0,1,0.12720787787120233,55
5247,4,10374,4012,6362,0,0,0,1.0,1,1.0,1,1.0,1,0.11694589399987501,54
5248,0,10374,4012,6362,0,0,0,1.0,1,1.0,1,1.0,1,0.12430438136890316,53
5249,4,10378,4013,6365,0,0,0,1.0,1,1.0,1,1.0,1,0.10404399098310614,55
5250,2,10380,4014,6366,0,0,0,1.0,1,1.0,1,1.0,1,0.07243257452178994,55
5251,2,10382,4014,6368,0,0,0,1.0,1,1.0,1,1.0,1,0.05631853384074444,57
5252,0,10382,4014,6368,0,0,0,1.0,1,1.0,1,1.0,1,0.05565528381930192,58
5253,2,10384,4016,6368,0,0,0,1.0,1,1.0,1,1.0,1,0.1049901351323566,59
5254,3,10387,4018,6369,0,0,0,1.0,1,1.0,1,1.0,1,0.10667044513704589,59
5255,2,10389,4019,6370,0,0,0,1.0,1,1.0,1,1.0,1,0.09768533050859997,58
5256,4,10393,4020,6373,0,0,0,1.0,1,1.0,1,1.0,1,0.08480503144037635,59
5257,3,10396,4021,6375,0,0,0,1.0,1,1.0,1,1.0,1,0.07555184172860303,58
5258,0,10396,4021,6375,0,0,0,1.0,1,1.0,1,1.0,1,0.09981891210636698,56
5259,1,10397,4022,6375,0,0,0,1.0,1,1.0,1,1.0,1,0.127543768577805,56
5260,2,10399,4023,6376,0,0,0,1.0,1,1.0,1,1.0,1,0.13505460898766217,55
5261,2,10401,4024,6377,0,0,0,1.0,1,1.0,1,1.0,1,0.09303805104137984,54
5262,1,10402,4025,6377,0,0,0,1.0,1,1.0,1,1.0,1,0.12304933396994824,54
5263,3,10405,4028,6377,0,0,0,1.0,1,1.0,1,1.0,1,0.17433264941851515,53
5264,3,10408,4029,6379,0,0,0,1.0,1,1.0,1,1.0,1,0.12394124907518245,51
5265,2,10410,4031,6379,0,0,0,1.0,1,1.0,1,1.0,1,0.13424369045265988,50
5266,2,10412,4033,6379,0,0,0,1.0,1,1.0,1,1.0,1,0.15554987962128067,49
5267,3,10415,4035,6380,0,0,0,1.0,1,1.0,1,1.0,1,0.176492581765035,48
5268,3,10418,4036,6382,0,0,0,1.0,1,1.0,1,1.0,1,0.1346345453541422,47
5269,4,10422,4037,6385,0,0,0,1.0,1,1.0,1,1.0,1,0.1390489635133508,45
5270,2,10424,4037,6387,0,0,0,1.0,1,1.0,1,1.0,1,0.13287351817522164,47
5271,4,10428,4038,6390,0,0,0,1.0,1,1.0,1,1.0,1,0.11528537721559687,45
5272,5,10433,4041,6392,0,0,0,1.0,1,1.0,1,1.0,1,0.15137231564786532,46
5273,1,10434,4041,6393,0,0,0,1.0,1,1.0,1,1.0,1,0.13022361385611178,44
5274,1,10435,4042,6393,0,0,0,1.0,1,1.0,1,1.0,1,0.16178299602933283,44
5275,7,10442,4044,6398,0,0,0,1.0,1,1.0,1,1.0,1,0.13119892807217362,46
5276,1,10443,4044,6399,0,0,0,1.0,1,1.0,1,1.0,1,0.10080382035974249,46
5277,0,10443,4044,6399,0,0,0,1.0,1,1.0,1,1.0,1,0.10080382035974249,46
5278,4,10447,4048,6399,0,0,0,1.0,1,1.0,1,1.0,1,0.139743234027646,46
5279,4,10451,4049,6402,0,0,0,1.0,1,1.0,1,1.0,1,0.14108812588608313,47
5280,2,10453,4050,6403,0,0,0,1.0,1,1.0,1,1.0,1,0.16452048505560077,47
5281,3,10456,4050,6406,0,0,0,1.0,1,1.0,1,1.0,1,0.11700010386676085,48
5282,0,10456,4050,6406,0,0,0,1.0,1,1.0,1,1.0,1,0.11700010386676085,48
5283,2,10458,4051,6407,0,0,0,1.0,1,1.0,1,1.0,1,0.14134282756728428,49
5284,0,10458,4051,6407,0,0,0,1.0,1,1.0,1,1.0,1,0.14134282756728428,49
5285,0,10458,4051,6407,0,0,0,1.0,1,1.0,1,1.0,1,0.13277666109501424,50
5286,1,10459,4051,6408,0,0,0,1.0,1,1.0,1,1.0,1,0.1257762767229833,51
5287,0,10459,4051,6408,0,0,0,1.0,1,1.0,1,1.0,1,0.1257762767229833,51
5288,1,10460,4051,6409,0,0,0,1.0,1,1.0,1,1.0,1,0.1028710492248788,51
5289,1,10461,4051,6410,0,0,0,1.0,1,1.0,1,1.0,1,0.10665944441734486,53
5290,1,10462,4051,6411,0,0,0,1.0,1,1.0,1,1.0,1,0.09382153579592223,53
5291,2,10464,4052,6412,0,0,0,1.0,1,1.0,1,1.0,1,0.11746964340561993,53
5292,8,10472,4054,6418,0,0,0,1.0,1,1.0,1,1.0,1,0.0966830473898419,53
5293,3,10475,4055,6420,0,0,0,1.0,1,1.0,1,1.0,1,0.0634260003333848,53
5294,3,10478,4058,6420,0,0,0,1.0,1,1.0,1,1.0,1,0.12116095631652905,54
5295,2,10480,4060,6420,0,0,0,1.0,1,1.0,1,1.0,1,0.145654827081679,52
5296,0,10480,4060,6420,0,0,0,1.0,1,1.0,1,1.0,1,0.14753109676235127,49
5297,3,10483,4061,6422,0,0,0,1.0,1,1.0,1,1.0,1,0.13976376770748133,49
5298,1,10484,4061,6423,0,0,0,1.0,1,1.0,1,1.0,1,0.15347818122609114,49
5299,3,10487,4062,6425,0,0,0,1.0,1,1.0,1,1.0,1,0.14323775229556693,50
5300,1,10488,4062,6426,0,0,0,1.0,1,1.0,1,1.0,1,0.16561927005309499,48
5301,4,10492,4063,6429,0,0,0,1.0,1,1.0,1,1.0,1,0.1712154527948821,46
5302,4,10496,4065,6431,0,0,0,1.0,1,1.0,1,1.0,1,0.18361698253167255,47
5303,5,10501,4067,6434,0,0,0,1.0,1,1.0,1,1.0,1,0.15289161316122932,46
5304,3,10504,4069,6435,0,0,0,1.0,1,1.0,1,1.0,1,0.2217190526071309,45
5305,4,10508,4069,6439,0,0,0,1.0,1,1.0,1,1.0,1,0.10440913911225859,44
5306,1,10509,4070,6439,0,0,0,1.0,1,1.0,1,1.0,1,0.14635346597773874,42
5307,2,10511,4071,6440,0,0,0,1.0,1,1.0,1,1.0,1,0.1767160499027176,42
5308,3,10514,4072,6442,0,0,0,1.0,1,1.0,1,1.0,1,0.15055905913156273,43
5309,2,10516,4073,6443,0,0,0,1.0,1,1.0,1,1.0,1,0.15775554284297988,41
5310,2,10518,4074,6444,0,0,0,1.0,1,1.0,1,1.0,1,0.19009659516859234,41
5311,1,10519,4075,6444,0,0,0,1.0,1,1.0,1,1.0,1,0.18112031323782862,42
5312,1,10520,4075,6445,0,0,0,1.0,1,1.0,1,1.0,1,0.18132859558055192,43
5313,2,10522,4075,6447,0,0,0,1.0,1,1.0,1,1.0,1,0.1370273069456482,44
5314,1,10523,4075,6448,0,0,0,1.0,1,1.0,1,1.0,1,0.13501604857902127,44
5315,2,10525,4076,6449,0,0,0,1.0,1,1.0,1,1.0,1,0.1373346400272517,45
5316,1,10526,4076,6450,0,0,0,1.0,1,1.0,1,1.0,1,0.13821079095245284,46
5317,5,10531,4078,6453,0,0,0,1.0,1,1.0,1,1.0,1,0.08294999446854188,46
5318,2,10533,4080,6453,0,0,0,1.0,1,1.0,1,1.0,1,0.10990763333983378,46
5319,3,10536,4081,6455,0,0,0,1.0,1,1.0,1,1.0,1,0.09832177710539507,47
5320,2,10538,4081,6457,0,0,0,1.0,1,1.0,1,1.0,1,0.06497373055526177,48
5321,1,10539,4082,6457,0,0,0,1.0,1,1.0,1,1.0,1,0.07055591327877665,49
5322,0,10539,4082,6457,0,0,0,1.0,1,1.0,1,1.0,1,0.07055591327877665,49
5323,1,10540,4082,6458,0,0,0,1.0,1,1.0,1,1.0,1,0.07685633513724624,51
5324,0,10540,4082,6458,0,0,0,1.0,1,1.0,1,1.0,1,0.08748372745871014,53
5325,1,10541,4083,6458,0,0,0,1.0,1,1.0,1,1.0,1,0.09229440376894642,53
5326,0,10541,4083,6458,0,0,0,1.0,1,1.0,1,1.0,1,0.09229440376894642,53
5327,3,10544,4083,6461,0,0,0,1.0,1,1.0,1,1.0,1,0.07108115850588094,53
5328,0,10544,4083,6461,0,0,0,1.0,1,1.0,1,1.0,1,0.0795358162178136,54
5329,2,10546,4085,6461,0,0,0,1.0,1,1.0,1,1.0,1,0.11304124986622831,53
5330,2,10548,4087,6461,0,0,0,1.0,1,1.0,1,1.0,1,0.15181045900484974,52
5331,1,10549,4087,6462,0,0,0,1.0,1,1.0,1,1.0,1,0.14182756269181845,51
5332,1,10550,4087,6463,0,0,0,1.0,1,1.0,1,1.0,1,0.1309267202115007,52
5333,1,10551,4088,6463,0,0,0,1.0,1,1.0,1,1.0,1,0.1678840741703577,53
5334,2,10553,4089,6464,0,0,0,1.0,1,1.0,1,1.0,1,0.17760541565589524,54
5335,3,10556,4089,6467,0,0,0,1.0,1,1.0,1,1.0,1,0.16068430713600634,55
5336,0,10556,4089,6467,0,0,0,1.0,1,1.0,1,1.0,1,0.15891929416958056,54
5337,0,10556,4089,6467,0,0,0,1.0,1,1.0,1,1.0,1,0.1680596829189833,55
5338,2,10558,4090,6468,0,0,0,1.0,1,1.0,1,1.0,1,0.16994670398085224,55
5339,1,10559,4090,6469,0,0,0,1.0,1,1.0,1,1.0,1,0.14934712578598755,55
5340,0,10559,4090,6469,0,0,0,1.0,1,1.0,1,1.0,1,0.14934712578598755,55
5341,3,10562,4091,6471,0,0,0,1.0,1,1.0,1,1.0,1,0.15354394166153598,54
5342,1,10563,4092,6471,0,0,0,1.0,1,1.0,1,1.0,1,0.16907888947624522,55
5343,4,10567,4094,6473,0,0,0,1.0,1,1.0,1,1.0,1,0.16469007653673096,54
5344,3,10570,4096,6474,0,0,0,1.0,1,1.0,1,1.0,1,0.19075395972925868,55
5345,5,10575,4098,6477,0,0,0,1.0,1,1.0,1,1.0,1,0.13024786684774636,53
5346,5,10580,4100,6480,0,0,0,1.0,1,1.0,1,1.0,1,0.08967989126719648,53
5347,2,10582,4101,6481,0,0,0,1.0,1,1.0,1,1.0,1,0.09121590464867402,51
5348,4,10586,4103,6483,0,0,0,1.0,1,1.0,1,1.0,1,0.10160349943985152,53
5349,7,10593,4105,6488,0,0,0,1.0,1,1.0,1,1.0,1,0.06547632773716025,52
5350,1,10594,4106,6488,0,0,0,1.0,1,1.0,1,1.0,1,0.06667006629884668,50
5351,6,10600,4108,6492,0,0,0,1.0,1,1.0,1,1.0,1,0.11161969251509565,52
5352,1,10601,4109,6492,0,0,0,1.0,1,1.0,1,1.0,1,0.10930880879964626,49
5353,0,10601,4109,6492,0,0,0,1.0,1,1.0,1,1.0,1,0.10930880879964626,49
5354,1,10602,4109,6493,0,0,0,1.0,1,1.0,1,1.0,1,0.0818841183632981,49
5355,1,10603,4109,6494,0,0,0,1.0,1,1.0,1,1.0,1,0.08417993988356003,48
5356,3,10606,4110,6496,0,0,0,1.0,1,1.0,1,1.0,1,0.09506005926694552,49
5357,0,10606,4110,6496,0,0,0,1.0,1,1.0,1,1.0,1,0.11416091967149893,47
5358,2,10608,4111,6497,0,0,0,1.0,1,1.0,1,1.0,1,0.09957293258098793,48
5359,0,10608,4111,6497,0,0,0,1.0,1,1.0,1,1.0,1,0.09957293258098793,48
5360,0,10608,4111,6497,0,0,0,1.0,1,1.0,1,1.0,1,0.09957293258098793,48
5361,0,10608,4111,6497,0,0,0,1.0,1,1.0,1,1.0,1,0.10485579365077294,50
5362,0,10608,4111,6497,0,0,0,1.0,1,1.0,1,1.0,1,0.10485579365077294,50
5363,1,10609,4112,6497,0,0,0,1.0,1,1.0,1,1.0,1,0.11535299776782165,50
5364,0,10609,4112,6497,0,0,0,1.0,1,1.0,1,1.0,1,0.11255731520816945,51
5365,5,10614,4112,6502,0,0,0,1.0,1,1.0,1,1.0,1,0.07565909525150297,52
5366,0,10614,4112,6502,0,0,0,1.0,1,1.0,1,1.0,1,0.07565909525150297,52
5367,1,10615,4113,6502,0,0,0,1.0,1,1.0,1,1.0,1,0.10713134945906215,54
5368,3,10618,4115,6503,0,0,0,1.0,1,1.0,1,1.0,1,0.14175998710244983,55
5369,5,10623,4117,6506,0,0,0,1.0,1,1.0,1,1.0,1,0.1038469384027418,53
5370,4,10627,4119,6508,0,0,0,1.0,1,1.0,1,1.0,1,0.14515451337643442,54
5371,6,10633,4122,6511,0,0,0,1.0,1,1.0,1,1.0,1,0.14537477411874805,53
5372,1,10634,4122,6512,0,0,0,1.0,1,1.0,1,1.0,1,0.1189997860228167,53
5373,1,10635,4122,6513,0,0,0,1.0,1,1.0,1,1.0,1,0.10531415172743253,52
5374,3,10638,4124,6514,0,0,0,1.0,1,1.0,1,1.0,1,0.09036208480766875,51
5375,1,10639,4124,6515,0,0,0,1.0,1,1.0,1,1.0,1,0.06887186445037405,52
5376,2,10641,4126,6515,0,0,0,1.0,1,1.0,1,1.0,1,0.0905762531087961,51
5377,0,10641,4126,6515,0,0,0,1.0,1,1.0,1,1.0,1,0.10498612838161385,52
5378,2,10643,4128,6515,0,0,0,1.0,1,1.0,1,1.0,1,0.14675264115631256,50
5379,2,10645,4128,6517,0,0,0,1.0,1,1.0,1,1.0,1,0.12913338042456285,50
5380,2,10647,4128,6519,0,0,0,1.0,1,1.0,1,1.0,1,0.1058935562017141,52
5381,0,10647,4128,6519,0,0,0,1.0,1,1.0,1,1.0,1,0.1058935562017141,52
5382,0,10647,4128,6519,0,0,0,1.0,1,1.0,1,1.0,1,0.10563878773214314,52
5383,0,10647,4128,6519,0,0,0,1.0,1,1.0,1,1.0,1,0.09158391948159511,51
5384,2,10649,4129,6520,0,0,0,1.0,1,1.0,1,1.0,1,0.09867166279028888,52
5385,3,10652,4130,6522,0,0,0,1.0,1,1.0,1,1.0,1,0.10007155984615222,51
5386,2,10654,4131,6523,0,0,0,1.0,1,1.0,1,1.0,1,0.08554229466440891,52
5387,2,10656,4131,6525,0,0,0,1.0,1,1.0,1,1.0,1,0.085928877413571,53
5388,1,10657,4131,6526,0,0,0,1.0,1,1.0,1,1.0,1,0.06253723493911342,54
5389,0,10657,4131,6526,0,0,0,1.0,1,1.0,1,1.0,1,0.06993039367015891,55
5390,2,10659,4132,6527,0,0,0,1.0,1,1.0,1,1.0,1,0.07379929482933056,56
5391,1,10660,4133,6527,0,0,0,1.0,1,1.0,1,1.0,1,0.05619494837716703,56
5392,4,10664,4136,6528,0,0,0,1.0,1,1.0,1,1.0,1,0.07368433007978746,56
5393,3,10667,4138,6529,0,0,0,1.0,1,1.0,1,1.0,1,0.09579048231374424,54
5394,2,10669,4139,6530,0,0,0,1.0,1,1.0,1,1.0,1,0.1009017790633418,53
5395,4,10673,4141,6532,0,0,0,1.0,1,1.0,1,1.0,1,0.08260910313475978,53
5396,2,10675,4141,6534,0,0,0,1.0,1,1.0,1,1.0,1,0.09668271930019003,54
5397,2,10677,4142,6535,0,0,0,1.0,1,1.0,1,1.0,1,0.06854972017008146,53
5398,2,10679,4144,6535,0,0,0,1.0,1,1.0,1,1.0,1,0.06968005705963452,53
5399,5,10684,4147,6537,0,0,0,1.0,1,1.0,1,1.0,1,0.1305002010009003,55
5400,3,10687,4147,6540,0,0,0,1.0,1,1.0,1,1.0,1,0.09305008379316532,55
5401,6,10693,4150,6543,0,0,0,1.0,1,1.0,1,1.0,1,0.10613017923281991,56
5402,0,10693,4150,6543,0,0,0,1.0,1,1.0,1,1.0,1,0.0,0
