,SuccessfulHandoverCount,TotalSuccessfulHandoverCount,TotalSuccessfulHandoverCountRange,TotalSuccessfulHandoverCountLoadBalancing,TotalSuccessfulHandoverCountOverload,FailedHandoverCount,TotalFailedHandoverCount,AvgQoS,MinQoS,AvgQoS_LoadBased,MinQoS_LoadBased,AvgQoS_RangeBased,MinQoS_RangeBased,GiniLoad,VehicleCount
0,0,0,0,0,0,0,0,1.0,1,1.0,1,1.0,1,0.0,0
1,22,22,0,22,0,0,0,1.0,1,1.0,1,1.0,1,0.2666439998729147,30
2,23,45,0,45,0,0,0,1.0,1,1.0,1,1.0,1,0.2713985427960271,32
3,5,50,0,50,0,0,0,1.0,1,1.0,1,1.0,1,0.19834962300253023,33
4,0,50,0,50,0,0,0,1.0,1,1.0,1,1.0,1,0.210301118278833,34
5,0,50,0,50,0,0,0,1.0,1,1.0,1,1.0,1,0.18796316697495175,36
6,2,52,0,52,0,0,0,1.0,1,1.0,1,1.0,1,0.16499133683119177,38
7,1,53,0,53,0,0,0,1.0,1,1.0,1,1.0,1,0.17411461242557677,40
8,0,53,0,53,0,0,0,1.0,1,1.0,1,1.0,1,0.17411461242557677,40
9,0,53,0,53,0,0,0,1.0,1,1.0,1,1.0,1,0.17411461242557677,40
10,2,55,1,54,0,0,0,1.0,1,1.0,1,1.0,1,0.21402941310774062,41
11,3,58,3,55,0,0,0,1.0,1,1.0,1,1.0,1,0.16439869241411662,40
12,3,61,4,57,0,0,0,1.0,1,1.0,1,1.0,1,0.1399995908878035,39
13,3,64,5,59,0,0,0,1.0,1,1.0,1,1.0,1,0.1391884190260934,37
14,0,64,5,59,0,0,0,1.0,1,1.0,1,1.0,1,0.18630690769781866,35
15,4,68,6,62,0,0,0,1.0,1,1.0,1,1.0,1,0.12276096583028977,36
16,2,70,8,62,0,0,0,1.0,1,1.0,1,1.0,1,0.15347493236505227,34
17,2,72,8,64,0,0,0,1.0,1,1.0,1,1.0,1,0.15240928509850166,33
18,0,72,8,64,0,0,0,1.0,1,1.0,1,1.0,1,0.168501720214147,34
19,1,73,9,64,0,0,0,1.0,1,1.0,1,1.0,1,0.18990123168758866,34
20,1,74,9,65,0,0,0,1.0,1,1.0,1,1.0,1,0.15624808405737622,34
21,2,76,10,66,0,0,0,1.0,1,1.0,1,1.0,1,0.16416701779314571,36
22,0,76,10,66,0,0,0,1.0,1,1.0,1,1.0,1,0.1702755307106081,35
23,2,78,11,67,0,0,0,1.0,1,1.0,1,1.0,1,0.18703667451560935,35
24,1,79,12,67,0,0,0,1.0,1,1.0,1,1.0,1,0.15244761054073577,35
25,7,86,14,72,0,0,0,1.0,1,1.0,1,1.0,1,0.12468171728133227,35
26,6,92,16,76,0,0,0,1.0,1,1.0,1,1.0,1,0.14229668411896615,36
27,3,95,18,77,0,0,0,1.0,1,1.0,1,1.0,1,0.09845123720282581,34
28,1,96,19,77,0,0,0,1.0,1,1.0,1,1.0,1,0.14263439617953397,35
29,1,97,19,78,0,0,0,1.0,1,1.0,1,1.0,1,0.12103094777492031,33
30,2,99,21,78,0,0,0,1.0,1,1.0,1,1.0,1,0.20013435328265586,33
31,2,101,21,80,0,0,0,1.0,1,1.0,1,1.0,1,0.1485183397857011,33
32,1,102,22,80,0,0,0,1.0,1,1.0,1,1.0,1,0.14736570798696244,32
33,2,104,22,82,0,0,0,1.0,1,1.0,1,1.0,1,0.10266227405246471,33
34,1,105,23,82,0,0,0,1.0,1,1.0,1,1.0,1,0.1375814879020598,33
35,2,107,23,84,0,0,0,1.0,1,1.0,1,1.0,1,0.09585773852280371,35
36,2,109,24,85,0,0,0,1.0,1,1.0,1,1.0,1,0.1340427776531243,36
37,3,112,26,86,0,0,0,1.0,1,1.0,1,1.0,1,0.17578522320371368,37
38,2,114,26,88,0,0,0,1.0,1,1.0,1,1.0,1,0.13367111350979233,36
39,2,116,27,89,0,0,0,1.0,1,1.0,1,1.0,1,0.1406620450971898,38
40,1,117,27,90,0,0,0,1.0,1,1.0,1,1.0,1,0.1654969491605075,40
41,2,119,27,92,0,0,0,1.0,1,1.0,1,1.0,1,0.137306816992587,40
42,2,121,29,92,0,0,0,1.0,1,1.0,1,1.0,1,0.169978407465284,40
43,4,125,30,95,0,0,0,1.0,1,1.0,1,1.0,1,0.15439013253352118,43
44,0,125,30,95,0,0,0,1.0,1,1.0,1,1.0,1,0.15439013253352118,43
45,0,125,30,95,0,0,0,1.0,1,1.0,1,1.0,1,0.14070499947132942,44
46,0,125,30,95,0,0,0,1.0,1,1.0,1,1.0,1,0.14070499947132942,44
47,2,127,31,96,0,0,0,1.0,1,1.0,1,1.0,1,0.16131225479295278,44
48,2,129,32,97,0,0,0,1.0,1,1.0,1,1.0,1,0.19058834399975166,44
49,0,129,32,97,0,0,0,1.0,1,1.0,1,1.0,1,0.16963977754056234,41
50,1,130,33,97,0,0,0,1.0,1,1.0,1,1.0,1,0.18726894680496106,40
51,1,131,33,98,0,0,0,1.0,1,1.0,1,1.0,1,0.1759157608217292,38
52,0,131,33,98,0,0,0,1.0,1,1.0,1,1.0,1,0.20336494036579963,37
53,1,132,33,99,0,0,0,1.0,1,1.0,1,1.0,1,0.21674558091744553,38
54,2,134,33,101,0,0,0,1.0,1,1.0,1,1.0,1,0.20761819865478656,38
55,2,136,34,102,0,0,0,1.0,1,1.0,1,1.0,1,0.19710128808245636,38
56,2,138,36,102,0,0,0,1.0,1,1.0,1,1.0,1,0.20458601237534005,38
57,3,141,38,103,0,0,0,1.0,1,1.0,1,1.0,1,0.19370870345369565,38
58,3,144,39,105,0,0,0,1.0,1,1.0,1,1.0,1,0.20938541784407458,38
59,5,149,40,109,0,0,0,1.0,1,1.0,1,1.0,1,0.13890056546393778,40
60,1,150,40,110,0,0,0,1.0,1,1.0,1,1.0,1,0.13916722200282344,40
61,0,150,40,110,0,0,0,1.0,1,1.0,1,1.0,1,0.1395006811611256,40
62,2,152,41,111,0,0,0,1.0,1,1.0,1,1.0,1,0.13368904556787287,42
63,1,153,41,112,0,0,0,1.0,1,1.0,1,1.0,1,0.1392350306370383,40
64,0,153,41,112,0,0,0,1.0,1,1.0,1,1.0,1,0.14949027883661564,41
65,0,153,41,112,0,0,0,1.0,1,1.0,1,1.0,1,0.14949027883661564,41
66,1,154,42,112,0,0,0,1.0,1,1.0,1,1.0,1,0.17069314890935314,41
67,0,154,42,112,0,0,0,1.0,1,1.0,1,1.0,1,0.17069314890935314,41
68,1,155,42,113,0,0,0,1.0,1,1.0,1,1.0,1,0.1561523771237656,41
69,1,156,43,113,0,0,0,1.0,1,1.0,1,1.0,1,0.18738779290866378,41
70,3,159,44,115,0,0,0,1.0,1,1.0,1,1.0,1,0.18122497248126535,42
71,7,166,46,120,0,0,0,1.0,1,1.0,1,1.0,1,0.1064567404810992,44
72,0,166,46,120,0,0,0,1.0,1,1.0,1,1.0,1,0.1064567404810992,44
73,1,167,46,121,0,0,0,1.0,1,1.0,1,1.0,1,0.09484566690219871,46
74,2,169,48,121,0,0,0,1.0,1,1.0,1,1.0,1,0.15755066564102874,44
75,2,171,48,123,0,0,0,1.0,1,1.0,1,1.0,1,0.1177311493321212,44
76,2,173,50,123,0,0,0,1.0,1,1.0,1,1.0,1,0.1890171508357145,45
77,2,175,51,124,0,0,0,1.0,1,1.0,1,1.0,1,0.1828433835084514,44
78,4,179,53,126,0,0,0,1.0,1,1.0,1,1.0,1,0.18795113137667516,44
79,1,180,53,127,0,0,0,1.0,1,1.0,1,1.0,1,0.19662295942628977,43
80,1,181,54,127,0,0,0,1.0,1,1.0,1,1.0,1,0.21177861851168067,43
81,4,185,56,129,0,0,0,1.0,1,1.0,1,1.0,1,0.27484282434055385,44
82,3,188,58,130,0,0,0,1.0,1,1.0,1,1.0,1,0.2531515497459919,45
83,7,195,59,136,0,0,0,1.0,1,1.0,1,1.0,1,0.20938089377139232,45
84,0,195,59,136,0,0,0,1.0,1,1.0,1,1.0,1,0.20938089377139232,45
85,0,195,59,136,0,0,0,1.0,1,1.0,1,1.0,1,0.20938089377139232,45
86,1,196,59,137,0,0,0,1.0,1,1.0,1,1.0,1,0.18606307885454057,45
87,0,196,59,137,0,0,0,1.0,1,1.0,1,1.0,1,0.20103743662334617,44
88,0,196,59,137,0,0,0,1.0,1,1.0,1,1.0,1,0.19435939223739987,45
89,1,197,60,137,0,0,0,1.0,1,1.0,1,1.0,1,0.2322764838770436,46
90,1,198,60,138,0,0,0,1.0,1,1.0,1,1.0,1,0.24033062497884147,44
91,1,199,60,139,0,0,0,1.0,1,1.0,1,1.0,1,0.21754503472184056,45
92,0,199,60,139,0,0,0,1.0,1,1.0,1,1.0,1,0.23045410033213232,46
93,1,200,60,140,0,0,0,1.0,1,1.0,1,1.0,1,0.2134707935131246,46
94,1,201,60,141,0,0,0,1.0,1,1.0,1,1.0,1,0.21001279347636395,46
95,2,203,60,143,0,0,0,1.0,1,1.0,1,1.0,1,0.20754196927525884,46
96,0,203,60,143,0,0,0,1.0,1,1.0,1,1.0,1,0.20754196927525884,46
97,0,203,60,143,0,0,0,1.0,1,1.0,1,1.0,1,0.20267013326720512,47
98,1,204,61,143,0,0,0,1.0,1,1.0,1,1.0,1,0.2055115614854622,47
99,2,206,61,145,0,0,0,1.0,1,1.0,1,1.0,1,0.20783284734097232,46
100,2,208,62,146,0,0,0,1.0,1,1.0,1,1.0,1,0.2231301351808326,48
101,3,211,63,148,0,0,0,1.0,1,1.0,1,1.0,1,0.1966137755030857,49
102,3,214,65,149,0,0,0,1.0,1,1.0,1,1.0,1,0.1729694420869447,49
103,3,217,65,152,0,0,0,1.0,1,1.0,1,1.0,1,0.1238519896444573,48
104,3,220,68,152,0,0,0,1.0,1,1.0,1,1.0,1,0.20490680575042308,49
105,6,226,70,156,0,0,0,1.0,1,1.0,1,1.0,1,0.13720367872349284,48
106,2,228,71,157,0,0,0,1.0,1,1.0,1,1.0,1,0.11510788982501373,48
107,2,230,72,158,0,0,0,1.0,1,1.0,1,1.0,1,0.11103004622097404,47
108,1,231,72,159,0,0,0,1.0,1,1.0,1,1.0,1,0.12855618819993506,47
109,3,234,74,160,0,0,0,1.0,1,1.0,1,1.0,1,0.12170476573874718,47
110,1,235,75,160,0,0,0,1.0,1,1.0,1,1.0,1,0.1223082340526258,47
111,2,237,75,162,0,0,0,1.0,1,1.0,1,1.0,1,0.1044113300000172,46
112,4,241,78,163,0,0,0,1.0,1,1.0,1,1.0,1,0.12413669410985277,46
113,6,247,82,165,0,0,0,1.0,1,1.0,1,1.0,1,0.14094278485311285,45
114,3,250,82,168,0,0,0,1.0,1,1.0,1,1.0,1,0.11206860743480766,46
115,4,254,83,171,0,0,0,1.0,1,1.0,1,1.0,1,0.11829122847074067,47
116,0,254,83,171,0,0,0,1.0,1,1.0,1,1.0,1,0.1116753116033211,48
117,3,257,85,172,0,0,0,1.0,1,1.0,1,1.0,1,0.12264062367924981,48
118,1,258,85,173,0,0,0,1.0,1,1.0,1,1.0,1,0.12405530501429456,49
119,1,259,86,173,0,0,0,1.0,1,1.0,1,1.0,1,0.1340405258866569,50
120,1,260,86,174,0,0,0,1.0,1,1.0,1,1.0,1,0.12124207350308451,51
121,2,262,86,176,0,0,0,1.0,1,1.0,1,1.0,1,0.09911746211638828,51
122,1,263,87,176,0,0,0,1.0,1,1.0,1,1.0,1,0.09266761605001744,51
123,0,263,87,176,0,0,0,1.0,1,1.0,1,1.0,1,0.09266761605001744,51
124,0,263,87,176,0,0,0,1.0,1,1.0,1,1.0,1,0.09266761605001744,51
125,0,263,87,176,0,0,0,1.0,1,1.0,1,1.0,1,0.13479265838992027,50
126,4,267,89,178,0,0,0,1.0,1,1.0,1,1.0,1,0.08737102598418854,52
127,0,267,89,178,0,0,0,1.0,1,1.0,1,1.0,1,0.11622388810146303,50
128,0,267,89,178,0,0,0,1.0,1,1.0,1,1.0,1,0.11622388810146303,50
129,3,270,90,180,0,0,0,1.0,1,1.0,1,1.0,1,0.11542207362912389,52
130,3,273,92,181,0,0,0,1.0,1,1.0,1,1.0,1,0.14966825488693672,52
131,4,277,92,185,0,0,0,1.0,1,1.0,1,1.0,1,0.10284219359643526,54
132,1,278,93,185,0,0,0,1.0,1,1.0,1,1.0,1,0.1117391691489005,54
133,2,280,94,186,0,0,0,1.0,1,1.0,1,1.0,1,0.13035383095858585,52
134,2,282,94,188,0,0,0,1.0,1,1.0,1,1.0,1,0.10593675985947099,52
135,6,288,99,189,0,0,0,1.0,1,1.0,1,1.0,1,0.14582443503379997,51
136,3,291,100,191,0,0,0,1.0,1,1.0,1,1.0,1,0.15157896032781382,51
137,3,294,100,194,0,0,0,1.0,1,1.0,1,1.0,1,0.06064360057739219,50
138,4,298,101,197,0,0,0,1.0,1,1.0,1,1.0,1,0.05793628891493062,52
139,1,299,102,197,0,0,0,1.0,1,1.0,1,1.0,1,0.08027698695371986,51
140,1,300,103,197,0,0,0,1.0,1,1.0,1,1.0,1,0.08373663335060322,51
141,1,301,104,197,0,0,0,1.0,1,1.0,1,1.0,1,0.1250352270746643,50
142,3,304,105,199,0,0,0,1.0,1,1.0,1,1.0,1,0.11187371057396475,51
143,1,305,106,199,0,0,0,1.0,1,1.0,1,1.0,1,0.08825538094014501,48
144,4,309,108,201,0,0,0,1.0,1,1.0,1,1.0,1,0.06960746894844762,49
145,1,310,109,201,0,0,0,1.0,1,1.0,1,1.0,1,0.0850788044032081,47
146,3,313,110,203,0,0,0,1.0,1,1.0,1,1.0,1,0.08654309152016199,49
147,0,313,110,203,0,0,0,1.0,1,1.0,1,1.0,1,0.09197981613684258,46
148,1,314,110,204,0,0,0,1.0,1,1.0,1,1.0,1,0.09468573538275166,47
149,2,316,111,205,0,0,0,1.0,1,1.0,1,1.0,1,0.10283709342999006,46
150,0,316,111,205,0,0,0,1.0,1,1.0,1,1.0,1,0.08536781782492556,47
151,1,317,112,205,0,0,0,1.0,1,1.0,1,1.0,1,0.12199727839338542,46
152,0,317,112,205,0,0,0,1.0,1,1.0,1,1.0,1,0.1475096788683685,45
153,2,319,112,207,0,0,0,1.0,1,1.0,1,1.0,1,0.1083425132911973,46
154,1,320,113,207,0,0,0,1.0,1,1.0,1,1.0,1,0.14847176583191704,44
155,8,328,116,212,0,0,0,1.0,1,1.0,1,1.0,1,0.1561072316839687,45
156,5,333,117,216,0,0,0,1.0,1,1.0,1,1.0,1,0.15675440977515917,43
157,2,335,117,218,0,0,0,1.0,1,1.0,1,1.0,1,0.11613574676897502,42
158,1,336,117,219,0,0,0,1.0,1,1.0,1,1.0,1,0.12208305543086014,43
159,2,338,118,220,0,0,0,1.0,1,1.0,1,1.0,1,0.17053556228972805,44
160,2,340,118,222,0,0,0,1.0,1,1.0,1,1.0,1,0.14517914451356068,44
161,3,343,119,224,0,0,0,1.0,1,1.0,1,1.0,1,0.12556780521655006,44
162,3,346,121,225,0,0,0,1.0,1,1.0,1,1.0,1,0.12958640807092353,44
163,7,353,125,228,0,0,0,1.0,1,1.0,1,1.0,1,0.21183923722747303,44
164,5,358,126,232,0,0,0,1.0,1,1.0,1,1.0,1,0.2217915674633521,44
165,4,362,128,234,0,0,0,1.0,1,1.0,1,1.0,1,0.12028479781830166,43
166,4,366,129,237,0,0,0,1.0,1,1.0,1,1.0,1,0.1361571564089539,43
167,2,368,130,238,0,0,0,1.0,1,1.0,1,1.0,1,0.12483847262857073,42
168,0,368,130,238,0,0,0,1.0,1,1.0,1,1.0,1,0.09317339963757378,40
169,2,370,130,240,0,0,0,1.0,1,1.0,1,1.0,1,0.07055443932027618,41
170,1,371,131,240,0,0,0,1.0,1,1.0,1,1.0,1,0.11363425867351283,39
171,2,373,132,241,0,0,0,1.0,1,1.0,1,1.0,1,0.08373994269306158,39
172,0,373,132,241,0,0,0,1.0,1,1.0,1,1.0,1,0.11406400998442687,38
173,1,374,133,241,0,0,0,1.0,1,1.0,1,1.0,1,0.1306682582052746,38
174,0,374,133,241,0,0,0,1.0,1,1.0,1,1.0,1,0.13574984899377687,37
175,2,376,135,241,0,0,0,1.0,1,1.0,1,1.0,1,0.1859795309938691,36
176,0,376,135,241,0,0,0,1.0,1,1.0,1,1.0,1,0.187278312405519,36
177,4,380,138,242,0,0,0,1.0,1,1.0,1,1.0,1,0.18201865438103082,38
178,2,382,138,244,0,0,0,1.0,1,1.0,1,1.0,1,0.1709497342069373,39
179,2,384,138,246,0,0,0,1.0,1,1.0,1,1.0,1,0.16084176115010757,40
180,0,384,138,246,0,0,0,1.0,1,1.0,1,1.0,1,0.16084176115010757,40
181,0,384,138,246,0,0,0,1.0,1,1.0,1,1.0,1,0.19194708185364814,39
182,2,386,140,246,0,0,0,1.0,1,1.0,1,1.0,1,0.20711401668491453,40
183,5,391,142,249,0,0,0,1.0,1,1.0,1,1.0,1,0.19583360238336017,40
184,0,391,142,249,0,0,0,1.0,1,1.0,1,1.0,1,0.1919222007522558,38
185,4,395,143,252,0,0,0,1.0,1,1.0,1,1.0,1,0.12468155192961745,38
186,2,397,145,252,0,0,0,1.0,1,1.0,1,1.0,1,0.16325317709930875,37
187,7,404,146,258,0,0,0,1.0,1,1.0,1,1.0,1,0.14985498879150735,36
188,2,406,147,259,0,0,0,1.0,1,1.0,1,1.0,1,0.1477839524820071,36
189,4,410,148,262,0,0,0,1.0,1,1.0,1,1.0,1,0.12018946539763072,36
190,0,410,148,262,0,0,0,1.0,1,1.0,1,1.0,1,0.13783678814720907,36
191,2,412,149,263,0,0,0,1.0,1,1.0,1,1.0,1,0.11748069524566049,37
192,1,413,150,263,0,0,0,1.0,1,1.0,1,1.0,1,0.11013622921833711,37
193,1,414,151,263,0,0,0,1.0,1,1.0,1,1.0,1,0.13853257701738092,38
194,1,415,151,264,0,0,0,1.0,1,1.0,1,1.0,1,0.13222842676456065,39
195,3,418,152,266,0,0,0,1.0,1,1.0,1,1.0,1,0.12785444462459686,40
196,0,418,152,266,0,0,0,1.0,1,1.0,1,1.0,1,0.12785444462459686,40
197,3,421,152,269,0,0,0,1.0,1,1.0,1,1.0,1,0.13336201704987025,40
198,1,422,153,269,0,0,0,1.0,1,1.0,1,1.0,1,0.14209819114739097,40
199,3,425,154,271,0,0,0,1.0,1,1.0,1,1.0,1,0.13104940731037418,40
200,5,430,155,275,0,0,0,1.0,1,1.0,1,1.0,1,0.1019684022203565,40
201,2,432,156,276,0,0,0,1.0,1,1.0,1,1.0,1,0.08879370384957899,39
202,1,433,156,277,0,0,0,1.0,1,1.0,1,1.0,1,0.08497367680047845,40
203,3,436,158,278,0,0,0,1.0,1,1.0,1,1.0,1,0.09831807715523537,39
204,2,438,160,278,0,0,0,1.0,1,1.0,1,1.0,1,0.10821533149525071,38
205,2,440,162,278,0,0,0,1.0,1,1.0,1,1.0,1,0.11598000761085382,37
206,0,440,162,278,0,0,0,1.0,1,1.0,1,1.0,1,0.13025307951757265,36
207,1,441,162,279,0,0,0,1.0,1,1.0,1,1.0,1,0.13113460303548272,37
208,1,442,162,280,0,0,0,1.0,1,1.0,1,1.0,1,0.144646145291385,36
209,1,443,163,280,0,0,0,1.0,1,1.0,1,1.0,1,0.16845255097504103,36
210,1,444,164,280,0,0,0,1.0,1,1.0,1,1.0,1,0.2165861118630777,36
211,2,446,164,282,0,0,0,1.0,1,1.0,1,1.0,1,0.23440002574723673,34
212,4,450,165,285,0,0,0,1.0,1,1.0,1,1.0,1,0.21310928063940768,34
213,1,451,165,286,0,0,0,1.0,1,1.0,1,1.0,1,0.2292316573754253,36
214,1,452,165,287,0,0,0,1.0,1,1.0,1,1.0,1,0.20160558060682043,35
215,2,454,165,289,0,0,0,1.0,1,1.0,1,1.0,1,0.15160655310929633,35
216,2,456,165,291,0,0,0,1.0,1,1.0,1,1.0,1,0.12622503098850635,37
217,1,457,166,291,0,0,0,1.0,1,1.0,1,1.0,1,0.13287841147908408,37
218,4,461,168,293,0,0,0,1.0,1,1.0,1,1.0,1,0.15429346076045894,37
219,4,465,169,296,0,0,0,1.0,1,1.0,1,1.0,1,0.12093077055337928,37
220,1,466,169,297,0,0,0,1.0,1,1.0,1,1.0,1,0.11368768254910691,38
221,0,466,169,297,0,0,0,1.0,1,1.0,1,1.0,1,0.09945796226127017,39
222,4,470,172,298,0,0,0,1.0,1,1.0,1,1.0,1,0.11800956214289873,39
223,5,475,173,302,0,0,0,1.0,1,1.0,1,1.0,1,0.08266083980135107,40
224,4,479,176,303,0,0,0,1.0,1,1.0,1,1.0,1,0.14674652083001175,40
225,3,482,177,305,0,0,0,1.0,1,1.0,1,1.0,1,0.1366580473786572,39
226,3,485,179,306,0,0,0,1.0,1,1.0,1,1.0,1,0.13860975991911956,39
227,0,485,179,306,0,0,0,1.0,1,1.0,1,1.0,1,0.14147114550223122,39
228,2,487,181,306,0,0,0,1.0,1,1.0,1,1.0,1,0.11444477300216002,38
229,3,490,182,308,0,0,0,1.0,1,1.0,1,1.0,1,0.09712521281581259,39
230,2,492,184,308,0,0,0,1.0,1,1.0,1,1.0,1,0.10298974153414395,38
231,3,495,186,309,0,0,0,1.0,1,1.0,1,1.0,1,0.12678047738572187,38
232,3,498,188,310,0,0,0,1.0,1,1.0,1,1.0,1,0.15346127182218705,37
233,2,500,189,311,0,0,0,1.0,1,1.0,1,1.0,1,0.08928913106585654,36
234,0,500,189,311,0,0,0,1.0,1,1.0,1,1.0,1,0.11842755970494612,34
235,1,501,190,311,0,0,0,1.0,1,1.0,1,1.0,1,0.16428808593167032,34
236,1,502,190,312,0,0,0,1.0,1,1.0,1,1.0,1,0.19293284029108643,33
237,0,502,190,312,0,0,0,1.0,1,1.0,1,1.0,1,0.17586789932122465,32
238,1,503,191,312,0,0,0,1.0,1,1.0,1,1.0,1,0.21293058426886943,32
239,2,505,193,312,0,0,0,1.0,1,1.0,1,1.0,1,0.2404542966181934,31
240,0,505,193,312,0,0,0,1.0,1,1.0,1,1.0,1,0.29259261111279283,28
241,2,507,193,314,0,0,0,1.0,1,1.0,1,1.0,1,0.21095436850985905,27
242,0,507,193,314,0,0,0,1.0,1,1.0,1,1.0,1,0.25124540956131824,29
243,3,510,195,315,0,0,0,1.0,1,1.0,1,1.0,1,0.2616679027412268,28
244,2,512,195,317,0,0,0,1.0,1,1.0,1,1.0,1,0.17309271921255553,28
245,2,514,196,318,0,0,0,1.0,1,1.0,1,1.0,1,0.12979583575069503,27
246,2,516,198,318,0,0,0,1.0,1,1.0,1,1.0,1,0.19077265549446373,25
247,3,519,198,321,0,0,0,1.0,1,1.0,1,1.0,1,0.13625557538372596,26
248,0,519,198,321,0,0,0,1.0,1,1.0,1,1.0,1,0.15724170980262514,27
249,1,520,199,321,0,0,0,1.0,1,1.0,1,1.0,1,0.17834986748758228,26
250,0,520,199,321,0,0,0,1.0,1,1.0,1,1.0,1,0.20916401831828876,27
251,1,521,199,322,0,0,0,1.0,1,1.0,1,1.0,1,0.19248461824058039,28
252,0,521,199,322,0,0,0,1.0,1,1.0,1,1.0,1,0.19248461824058039,28
253,1,522,199,323,0,0,0,1.0,1,1.0,1,1.0,1,0.1422392282494686,28
254,0,522,199,323,0,0,0,1.0,1,1.0,1,1.0,1,0.17589372665680877,29
255,1,523,199,324,0,0,0,1.0,1,1.0,1,1.0,1,0.14422347430582966,30
256,3,526,200,326,0,0,0,1.0,1,1.0,1,1.0,1,0.17495501413969308,30
257,3,529,201,328,0,0,0,1.0,1,1.0,1,1.0,1,0.21782675503477067,32
258,2,531,202,329,0,0,0,1.0,1,1.0,1,1.0,1,0.23607796904243963,32
259,1,532,202,330,0,0,0,1.0,1,1.0,1,1.0,1,0.2092742259908368,32
260,1,533,202,331,0,0,0,1.0,1,1.0,1,1.0,1,0.1359489414047571,34
261,0,533,202,331,0,0,0,1.0,1,1.0,1,1.0,1,0.1541659440413975,35
262,4,537,204,333,0,0,0,1.0,1,1.0,1,1.0,1,0.19623054219717506,36
263,0,537,204,333,0,0,0,1.0,1,1.0,1,1.0,1,0.19814336575579275,34
264,1,538,204,334,0,0,0,1.0,1,1.0,1,1.0,1,0.1568619122510035,34
265,0,538,204,334,0,0,0,1.0,1,1.0,1,1.0,1,0.1858321854527435,33
266,1,539,205,334,0,0,0,1.0,1,1.0,1,1.0,1,0.21336633083162354,34
267,0,539,205,334,0,0,0,1.0,1,1.0,1,1.0,1,0.22479149056587672,33
268,2,541,205,336,0,0,0,1.0,1,1.0,1,1.0,1,0.2245758550439342,34
269,0,541,205,336,0,0,0,1.0,1,1.0,1,1.0,1,0.2245758550439342,34
270,2,543,205,338,0,0,0,1.0,1,1.0,1,1.0,1,0.1996449301496248,36
271,0,543,205,338,0,0,0,1.0,1,1.0,1,1.0,1,0.1996449301496248,36
272,1,544,205,339,0,0,0,1.0,1,1.0,1,1.0,1,0.19834333590735853,38
273,1,545,205,340,0,0,0,1.0,1,1.0,1,1.0,1,0.18147016769487878,38
274,2,547,206,341,0,0,0,1.0,1,1.0,1,1.0,1,0.18365573285954936,38
275,2,549,206,343,0,0,0,1.0,1,1.0,1,1.0,1,0.16283500781891222,38
276,3,552,206,346,0,0,0,1.0,1,1.0,1,1.0,1,0.13811518371802395,39
277,1,553,207,346,0,0,0,1.0,1,1.0,1,1.0,1,0.17867309331794523,38
278,2,555,208,347,0,0,0,1.0,1,1.0,1,1.0,1,0.19159129776498682,38
279,3,558,208,350,0,0,0,1.0,1,1.0,1,1.0,1,0.1345065957590701,38
280,1,559,208,351,0,0,0,1.0,1,1.0,1,1.0,1,0.12884414729745639,38
281,0,559,208,351,0,0,0,1.0,1,1.0,1,1.0,1,0.11752869235983801,38
282,0,559,208,351,0,0,0,1.0,1,1.0,1,1.0,1,0.11850034618175438,38
283,1,560,209,351,0,0,0,1.0,1,1.0,1,1.0,1,0.14617064694815726,38
284,0,560,209,351,0,0,0,1.0,1,1.0,1,1.0,1,0.14360343157359273,39
285,0,560,209,351,0,0,0,1.0,1,1.0,1,1.0,1,0.14360343157359273,39
286,0,560,209,351,0,0,0,1.0,1,1.0,1,1.0,1,0.14360343157359273,39
287,2,562,209,353,0,0,0,1.0,1,1.0,1,1.0,1,0.1928781130387447,39
288,2,564,209,355,0,0,0,1.0,1,1.0,1,1.0,1,0.13463607497068938,39
289,1,565,210,355,0,0,0,1.0,1,1.0,1,1.0,1,0.18089136131141717,39
290,0,565,210,355,0,0,0,1.0,1,1.0,1,1.0,1,0.18120609229975318,39
291,0,565,210,355,0,0,0,1.0,1,1.0,1,1.0,1,0.18120609229975318,39
292,2,567,210,357,0,0,0,1.0,1,1.0,1,1.0,1,0.14620079032852004,40
293,3,570,210,360,0,0,0,1.0,1,1.0,1,1.0,1,0.06864689730325944,41
294,4,574,212,362,0,0,0,1.0,1,1.0,1,1.0,1,0.10814758822126525,40
295,4,578,214,364,0,0,0,1.0,1,1.0,1,1.0,1,0.09926310824455871,42
296,2,580,216,364,0,0,0,1.0,1,1.0,1,1.0,1,0.1531104999701961,42
297,4,584,218,366,0,0,0,1.0,1,1.0,1,1.0,1,0.11074610667114608,43
298,4,588,219,369,0,0,0,1.0,1,1.0,1,1.0,1,0.1791859236186515,44
299,5,593,220,373,0,0,0,1.0,1,1.0,1,1.0,1,0.14514613627169812,44
300,1,594,220,374,0,0,0,1.0,1,1.0,1,1.0,1,0.09730248583047099,45
301,1,595,221,374,0,0,0,1.0,1,1.0,1,1.0,1,0.10850324536813682,47
302,3,598,222,376,0,0,0,1.0,1,1.0,1,1.0,1,0.0917998773255237,46
303,2,600,224,376,0,0,0,1.0,1,1.0,1,1.0,1,0.09205147282338956,45
304,2,602,226,376,0,0,0,1.0,1,1.0,1,1.0,1,0.14181472223828095,45
305,5,607,227,380,0,0,0,1.0,1,1.0,1,1.0,1,0.08131041501434814,43
306,1,608,227,381,0,0,0,1.0,1,1.0,1,1.0,1,0.12259693084750341,44
307,3,611,228,383,0,0,0,1.0,1,1.0,1,1.0,1,0.1169259178514539,42
308,1,612,229,383,0,0,0,1.0,1,1.0,1,1.0,1,0.14781615660403954,41
309,3,615,229,386,0,0,0,1.0,1,1.0,1,1.0,1,0.11010161380530699,42
310,0,615,229,386,0,0,0,1.0,1,1.0,1,1.0,1,0.10977780721048594,41
311,1,616,230,386,0,0,0,1.0,1,1.0,1,1.0,1,0.14091217795394392,41
312,2,618,230,388,0,0,0,1.0,1,1.0,1,1.0,1,0.10618972389606225,44
313,0,618,230,388,0,0,0,1.0,1,1.0,1,1.0,1,0.11955472666106778,43
314,2,620,231,389,0,0,0,1.0,1,1.0,1,1.0,1,0.11395045194051731,43
315,1,621,231,390,0,0,0,1.0,1,1.0,1,1.0,1,0.08484913262080025,43
316,1,622,232,390,0,0,0,1.0,1,1.0,1,1.0,1,0.11215340237296668,43
317,0,622,232,390,0,0,0,1.0,1,1.0,1,1.0,1,0.11222716591136962,44
318,1,623,233,390,0,0,0,1.0,1,1.0,1,1.0,1,0.16972202829276525,45
319,3,626,233,393,0,0,0,1.0,1,1.0,1,1.0,1,0.14498631446253074,46
320,0,626,233,393,0,0,0,1.0,1,1.0,1,1.0,1,0.16078672536343447,45
321,0,626,233,393,0,0,0,1.0,1,1.0,1,1.0,1,0.1458123712869664,44
322,1,627,233,394,0,0,0,1.0,1,1.0,1,1.0,1,0.12413359748358367,42
323,3,630,234,396,0,0,0,1.0,1,1.0,1,1.0,1,0.10252520876316328,42
324,0,630,234,396,0,0,0,1.0,1,1.0,1,1.0,1,0.10615875966145771,43
325,3,633,236,397,0,0,0,1.0,1,1.0,1,1.0,1,0.14535474838227475,43
326,0,633,236,397,0,0,0,1.0,1,1.0,1,1.0,1,0.14535474838227475,43
327,6,639,238,401,0,0,0,1.0,1,1.0,1,1.0,1,0.13506885457064913,44
328,1,640,239,401,0,0,0,1.0,1,1.0,1,1.0,1,0.14898844231890584,44
329,1,641,239,402,0,0,0,1.0,1,1.0,1,1.0,1,0.1378713733009592,45
330,1,642,239,403,0,0,0,1.0,1,1.0,1,1.0,1,0.10536931848268195,46
331,1,643,239,404,0,0,0,1.0,1,1.0,1,1.0,1,0.09053907221642575,46
332,3,646,239,407,0,0,0,1.0,1,1.0,1,1.0,1,0.07532157330851758,47
333,0,646,239,407,0,0,0,1.0,1,1.0,1,1.0,1,0.09056560447446661,48
334,0,646,239,407,0,0,0,1.0,1,1.0,1,1.0,1,0.09056560447446661,48
335,1,647,240,407,0,0,0,1.0,1,1.0,1,1.0,1,0.11952547843445718,49
336,0,647,240,407,0,0,0,1.0,1,1.0,1,1.0,1,0.12393443108264025,50
337,2,649,241,408,0,0,0,1.0,1,1.0,1,1.0,1,0.125969703507997,51
338,1,650,242,408,0,0,0,1.0,1,1.0,1,1.0,1,0.16148947992140944,51
339,5,655,243,412,0,0,0,1.0,1,1.0,1,1.0,1,0.09683319543005427,51
340,3,658,244,414,0,0,0,1.0,1,1.0,1,1.0,1,0.11504641648758497,51
341,4,662,245,417,0,0,0,1.0,1,1.0,1,1.0,1,0.10786017777668469,51
342,1,663,246,417,0,0,0,1.0,1,1.0,1,1.0,1,0.13057971423516665,51
343,2,665,246,419,0,0,0,1.0,1,1.0,1,1.0,1,0.11391219797649152,51
344,2,667,248,419,0,0,0,1.0,1,1.0,1,1.0,1,0.13703139261059635,50
345,2,669,248,421,0,0,0,1.0,1,1.0,1,1.0,1,0.09927396301182621,50
346,2,671,249,422,0,0,0,1.0,1,1.0,1,1.0,1,0.13685134632020243,50
347,1,672,249,423,0,0,0,1.0,1,1.0,1,1.0,1,0.13531601986615846,51
348,1,673,250,423,0,0,0,1.0,1,1.0,1,1.0,1,0.1548498522534476,52
349,3,676,251,425,0,0,0,1.0,1,1.0,1,1.0,1,0.11766783633779107,54
350,1,677,251,426,0,0,0,1.0,1,1.0,1,1.0,1,0.13181299743396388,54
351,4,681,254,427,0,0,0,1.0,1,1.0,1,1.0,1,0.14478118223051614,54
352,2,683,254,429,0,0,0,1.0,1,1.0,1,1.0,1,0.13249913621880183,56
353,2,685,255,430,0,0,0,1.0,1,1.0,1,1.0,1,0.13401497838774776,54
354,3,688,255,433,0,0,0,1.0,1,1.0,1,1.0,1,0.0924647531513605,53
355,2,690,257,433,0,0,0,1.0,1,1.0,1,1.0,1,0.08757843294448263,54
356,1,691,258,433,0,0,0,1.0,1,1.0,1,1.0,1,0.13635431506835832,54
357,4,695,260,435,0,0,0,1.0,1,1.0,1,1.0,1,0.14315775330955485,53
358,0,695,260,435,0,0,0,1.0,1,1.0,1,1.0,1,0.1553295180991276,49
359,1,696,260,436,0,0,0,1.0,1,1.0,1,1.0,1,0.14676811210742702,48
360,2,698,260,438,0,0,0,1.0,1,1.0,1,1.0,1,0.12105899552735572,47
361,3,701,260,441,0,0,0,1.0,1,1.0,1,1.0,1,0.08738658931922341,46
362,0,701,260,441,0,0,0,1.0,1,1.0,1,1.0,1,0.0877273813214794,46
363,0,701,260,441,0,0,0,1.0,1,1.0,1,1.0,1,0.11142413960325163,47
364,0,701,260,441,0,0,0,1.0,1,1.0,1,1.0,1,0.11142413960325163,47
365,1,702,261,441,0,0,0,1.0,1,1.0,1,1.0,1,0.14373478913327614,47
366,7,709,262,447,0,0,0,1.0,1,1.0,1,1.0,1,0.13908115844149113,50
367,2,711,262,449,0,0,0,1.0,1,1.0,1,1.0,1,0.1252200903242875,50
368,0,711,262,449,0,0,0,1.0,1,1.0,1,1.0,1,0.10494846149968264,51
369,2,713,262,451,0,0,0,1.0,1,1.0,1,1.0,1,0.09840423927216128,51
370,0,713,262,451,0,0,0,1.0,1,1.0,1,1.0,1,0.09840423927216128,51
371,3,716,263,453,0,0,0,1.0,1,1.0,1,1.0,1,0.10371412893539529,52
372,1,717,263,454,0,0,0,1.0,1,1.0,1,1.0,1,0.12254866888513899,53
373,4,721,265,456,0,0,0,1.0,1,1.0,1,1.0,1,0.11685095633397757,53
374,4,725,267,458,0,0,0,1.0,1,1.0,1,1.0,1,0.09552497238446706,53
375,3,728,269,459,0,0,0,1.0,1,1.0,1,1.0,1,0.1197388611105638,53
376,3,731,270,461,0,0,0,1.0,1,1.0,1,1.0,1,0.0741000042965823,53
377,1,732,271,461,0,0,0,1.0,1,1.0,1,1.0,1,0.07967384099285865,53
378,1,733,272,461,0,0,0,1.0,1,1.0,1,1.0,1,0.08637351357496613,53
379,3,736,273,463,0,0,0,1.0,1,1.0,1,1.0,1,0.06220783486578856,54
380,1,737,274,463,0,0,0,1.0,1,1.0,1,1.0,1,0.05944216361290645,54
381,1,738,275,463,0,0,0,1.0,1,1.0,1,1.0,1,0.07073613693403687,54
382,1,739,276,463,0,0,0,1.0,1,1.0,1,1.0,1,0.09133106605841292,55
383,2,741,277,464,0,0,0,1.0,1,1.0,1,1.0,1,0.09972501252641894,55
384,0,741,277,464,0,0,0,1.0,1,1.0,1,1.0,1,0.13044749002873246,54
385,3,744,278,466,0,0,0,1.0,1,1.0,1,1.0,1,0.11410561460292923,52
386,1,745,279,466,0,0,0,1.0,1,1.0,1,1.0,1,0.14138383756811196,52
387,3,748,280,468,0,0,0,1.0,1,1.0,1,1.0,1,0.11753493997512021,50
388,5,753,282,471,0,0,0,1.0,1,1.0,1,1.0,1,0.10576469338528068,52
389,3,756,284,472,0,0,0,1.0,1,1.0,1,1.0,1,0.11683942565711364,51
390,1,757,284,473,0,0,0,1.0,1,1.0,1,1.0,1,0.11239857478484827,50
391,5,762,288,474,0,0,0,1.0,1,1.0,1,1.0,1,0.13604239701864582,49
392,4,766,290,476,0,0,0,1.0,1,1.0,1,1.0,1,0.13058796594992067,47
393,9,775,294,481,0,0,0,1.0,1,1.0,1,1.0,1,0.17744222311876587,47
394,6,781,297,484,0,0,0,1.0,1,1.0,1,1.0,1,0.210431688671057,48
395,6,787,299,488,0,0,0,1.0,1,1.0,1,1.0,1,0.20418122370476766,46
396,2,789,299,490,0,0,0,1.0,1,1.0,1,1.0,1,0.1663402623114673,43
397,2,791,299,492,0,0,0,1.0,1,1.0,1,1.0,1,0.1685576588194703,42
398,1,792,300,492,0,0,0,1.0,1,1.0,1,1.0,1,0.21569819689824524,40
399,2,794,300,494,0,0,0,1.0,1,1.0,1,1.0,1,0.1793991497537161,39
400,1,795,301,494,0,0,0,1.0,1,1.0,1,1.0,1,0.15966000778202497,38
401,1,796,301,495,0,0,0,1.0,1,1.0,1,1.0,1,0.15688365138797847,37
402,0,796,301,495,0,0,0,1.0,1,1.0,1,1.0,1,0.16801649314002642,36
403,1,797,302,495,0,0,0,1.0,1,1.0,1,1.0,1,0.12410705473851492,38
404,1,798,303,495,0,0,0,1.0,1,1.0,1,1.0,1,0.13202384314523435,39
405,0,798,303,495,0,0,0,1.0,1,1.0,1,1.0,1,0.12151741521840319,40
406,2,800,304,496,0,0,0,1.0,1,1.0,1,1.0,1,0.13369826429868495,41
407,1,801,304,497,0,0,0,1.0,1,1.0,1,1.0,1,0.1113795173037114,42
408,1,802,304,498,0,0,0,1.0,1,1.0,1,1.0,1,0.1104766312906402,43
409,1,803,305,498,0,0,0,1.0,1,1.0,1,1.0,1,0.15725351551693484,44
410,0,803,305,498,0,0,0,1.0,1,1.0,1,1.0,1,0.17372114325086455,46
411,1,804,306,498,0,0,0,1.0,1,1.0,1,1.0,1,0.2051375366129923,46
412,3,807,306,501,0,0,0,1.0,1,1.0,1,1.0,1,0.16602767931665702,47
413,1,808,306,502,0,0,0,1.0,1,1.0,1,1.0,1,0.14463354632303052,47
414,0,808,306,502,0,0,0,1.0,1,1.0,1,1.0,1,0.14463354632303052,47
415,2,810,306,504,0,0,0,1.0,1,1.0,1,1.0,1,0.1337127979272652,48
416,2,812,306,506,0,0,0,1.0,1,1.0,1,1.0,1,0.1235929725732678,49
417,0,812,306,506,0,0,0,1.0,1,1.0,1,1.0,1,0.1235929725732678,49
418,3,815,307,508,0,0,0,1.0,1,1.0,1,1.0,1,0.1253379498211559,50
419,0,815,307,508,0,0,0,1.0,1,1.0,1,1.0,1,0.1253379498211559,50
420,2,817,309,508,0,0,0,1.0,1,1.0,1,1.0,1,0.14626821697787776,50
421,1,818,310,508,0,0,0,1.0,1,1.0,1,1.0,1,0.15947324851857958,50
422,3,821,311,510,0,0,0,1.0,1,1.0,1,1.0,1,0.17212905621950106,50
423,5,826,313,513,0,0,0,1.0,1,1.0,1,1.0,1,0.18833858873126916,51
424,0,826,313,513,0,0,0,1.0,1,1.0,1,1.0,1,0.18744101964288312,49
425,3,829,314,515,0,0,0,1.0,1,1.0,1,1.0,1,0.17622426947343844,48
426,3,832,314,518,0,0,0,1.0,1,1.0,1,1.0,1,0.12668206913824095,50
427,4,836,317,519,0,0,0,1.0,1,1.0,1,1.0,1,0.13573808918044075,48
428,7,843,319,524,0,0,0,1.0,1,1.0,1,1.0,1,0.13772783275681794,49
429,2,845,320,525,0,0,0,1.0,1,1.0,1,1.0,1,0.1371447608017189,45
430,3,848,321,527,0,0,0,1.0,1,1.0,1,1.0,1,0.11143065652821119,44
431,2,850,322,528,0,0,0,1.0,1,1.0,1,1.0,1,0.10726503856014954,42
432,1,851,323,528,0,0,0,1.0,1,1.0,1,1.0,1,0.1434088375048947,40
433,2,853,324,529,0,0,0,1.0,1,1.0,1,1.0,1,0.15534822545117932,39
434,0,853,324,529,0,0,0,1.0,1,1.0,1,1.0,1,0.15534822545117932,39
435,5,858,326,532,0,0,0,1.0,1,1.0,1,1.0,1,0.14399116086935151,38
436,1,859,326,533,0,0,0,1.0,1,1.0,1,1.0,1,0.12703657947089103,38
437,1,860,326,534,0,0,0,1.0,1,1.0,1,1.0,1,0.13496922723419455,39
438,1,861,327,534,0,0,0,1.0,1,1.0,1,1.0,1,0.1638575829771658,38
439,3,864,328,536,0,0,0,1.0,1,1.0,1,1.0,1,0.1749798688849499,39
440,2,866,328,538,0,0,0,1.0,1,1.0,1,1.0,1,0.10756936338517024,39
441,3,869,328,541,0,0,0,1.0,1,1.0,1,1.0,1,0.09344162198627032,41
442,0,869,328,541,0,0,0,1.0,1,1.0,1,1.0,1,0.10614386790336171,42
443,1,870,329,541,0,0,0,1.0,1,1.0,1,1.0,1,0.10122941203010243,42
444,1,871,329,542,0,0,0,1.0,1,1.0,1,1.0,1,0.08416017204993045,43
445,2,873,331,542,0,0,0,1.0,1,1.0,1,1.0,1,0.1031860539577485,44
446,0,873,331,542,0,0,0,1.0,1,1.0,1,1.0,1,0.09745573748394563,44
447,3,876,332,544,0,0,0,1.0,1,1.0,1,1.0,1,0.08704454409710989,47
448,2,878,333,545,0,0,0,1.0,1,1.0,1,1.0,1,0.12842089555764713,46
449,1,879,333,546,0,0,0,1.0,1,1.0,1,1.0,1,0.10056592672289538,46
450,2,881,333,548,0,0,0,1.0,1,1.0,1,1.0,1,0.11012495373739112,46
451,2,883,333,550,0,0,0,1.0,1,1.0,1,1.0,1,0.08820317677033802,47
452,0,883,333,550,0,0,0,1.0,1,1.0,1,1.0,1,0.10600836640391395,47
453,0,883,333,550,0,0,0,1.0,1,1.0,1,1.0,1,0.10600836640391395,47
454,1,884,333,551,0,0,0,1.0,1,1.0,1,1.0,1,0.11208890973634847,46
455,3,887,334,553,0,0,0,1.0,1,1.0,1,1.0,1,0.08957946611421683,47
456,2,889,334,555,0,0,0,1.0,1,1.0,1,1.0,1,0.07330917093069106,49
457,0,889,334,555,0,0,0,1.0,1,1.0,1,1.0,1,0.07553182946757758,50
458,0,889,334,555,0,0,0,1.0,1,1.0,1,1.0,1,0.07553182946757758,50
459,0,889,334,555,0,0,0,1.0,1,1.0,1,1.0,1,0.07099171488694857,52
460,0,889,334,555,0,0,0,1.0,1,1.0,1,1.0,1,0.07920290479532861,53
461,1,890,334,556,0,0,0,1.0,1,1.0,1,1.0,1,0.07965258700326727,54
462,1,891,335,556,0,0,0,1.0,1,1.0,1,1.0,1,0.06716117415316873,54
463,4,895,337,558,0,0,0,1.0,1,1.0,1,1.0,1,0.0801085271143752,55
464,4,899,339,560,0,0,0,1.0,1,1.0,1,1.0,1,0.10792897562754311,56
465,2,901,339,562,0,0,0,1.0,1,1.0,1,1.0,1,0.08972442697211108,54
466,6,907,342,565,0,0,0,1.0,1,1.0,1,1.0,1,0.1235227077142599,54
467,4,911,344,567,0,0,0,1.0,1,1.0,1,1.0,1,0.06649357706219433,51
468,5,916,348,568,0,0,0,1.0,1,1.0,1,1.0,1,0.12464431815357703,51
469,4,920,350,570,0,0,0,1.0,1,1.0,1,1.0,1,0.1485984934177274,48
470,2,922,352,570,0,0,0,1.0,1,1.0,1,1.0,1,0.19203170168543657,47
471,4,926,355,571,0,0,0,1.0,1,1.0,1,1.0,1,0.15990945250165878,44
472,3,929,358,571,0,0,0,1.0,1,1.0,1,1.0,1,0.1839265108119667,43
473,1,930,358,572,0,0,0,1.0,1,1.0,1,1.0,1,0.11711633312091381,41
474,0,930,358,572,0,0,0,1.0,1,1.0,1,1.0,1,0.13641632751261,39
475,3,933,360,573,0,0,0,1.0,1,1.0,1,1.0,1,0.13441318342814482,40
476,4,937,363,574,0,0,0,1.0,1,1.0,1,1.0,1,0.23043667692417613,38
477,3,940,364,576,0,0,0,1.0,1,1.0,1,1.0,1,0.2674397129692247,35
478,1,941,364,577,0,0,0,1.0,1,1.0,1,1.0,1,0.23966099141088018,35
479,3,944,365,579,0,0,0,1.0,1,1.0,1,1.0,1,0.23898417870188862,32
480,0,944,365,579,0,0,0,1.0,1,1.0,1,1.0,1,0.2656149906201647,32
481,2,946,365,581,0,0,0,1.0,1,1.0,1,1.0,1,0.20432248982409157,33
482,4,950,366,584,0,0,0,1.0,1,1.0,1,1.0,1,0.1778362862158462,34
483,0,950,366,584,0,0,0,1.0,1,1.0,1,1.0,1,0.17731415961290645,32
484,2,952,367,585,0,0,0,1.0,1,1.0,1,1.0,1,0.16964977329392236,33
485,3,955,368,587,0,0,0,1.0,1,1.0,1,1.0,1,0.15710060146236013,34
486,2,957,368,589,0,0,0,1.0,1,1.0,1,1.0,1,0.1207041089823778,36
487,1,958,368,590,0,0,0,1.0,1,1.0,1,1.0,1,0.11235321725646147,36
488,0,958,368,590,0,0,0,1.0,1,1.0,1,1.0,1,0.128296551950067,37
489,3,961,370,591,0,0,0,1.0,1,1.0,1,1.0,1,0.17892519023890027,38
490,4,965,371,594,0,0,0,1.0,1,1.0,1,1.0,1,0.13845015924962553,38
491,2,967,371,596,0,0,0,1.0,1,1.0,1,1.0,1,0.11097400708026686,37
492,0,967,371,596,0,0,0,1.0,1,1.0,1,1.0,1,0.11097400708026686,37
493,0,967,371,596,0,0,0,1.0,1,1.0,1,1.0,1,0.11097400708026686,37
494,5,972,373,599,0,0,0,1.0,1,1.0,1,1.0,1,0.14352054058151512,39
495,3,975,373,602,0,0,0,1.0,1,1.0,1,1.0,1,0.09472738181057674,40
496,0,975,373,602,0,0,0,1.0,1,1.0,1,1.0,1,0.09472738181057674,40
497,0,975,373,602,0,0,0,1.0,1,1.0,1,1.0,1,0.10149894112172059,43
498,2,977,374,603,0,0,0,1.0,1,1.0,1,1.0,1,0.09602127422402092,43
499,2,979,376,603,0,0,0,1.0,1,1.0,1,1.0,1,0.12619984735515916,44
500,2,981,377,604,0,0,0,1.0,1,1.0,1,1.0,1,0.13933172864940543,45
501,3,984,378,606,0,0,0,1.0,1,1.0,1,1.0,1,0.10380345324454925,45
502,1,985,379,606,0,0,0,1.0,1,1.0,1,1.0,1,0.11360827250733249,45
503,1,986,380,606,0,0,0,1.0,1,1.0,1,1.0,1,0.12791528428655405,46
504,2,988,382,606,0,0,0,1.0,1,1.0,1,1.0,1,0.19368609762113723,47
505,7,995,383,612,0,0,0,1.0,1,1.0,1,1.0,1,0.10065382340906891,42
506,1,996,384,612,0,0,0,1.0,1,1.0,1,1.0,1,0.10231053601688643,41
507,0,996,384,612,0,0,0,1.0,1,1.0,1,1.0,1,0.1289233731468221,38
508,1,997,385,612,0,0,0,1.0,1,1.0,1,1.0,1,0.12261690019815706,38
509,0,997,385,612,0,0,0,1.0,1,1.0,1,1.0,1,0.15666547003615025,37
510,0,997,385,612,0,0,0,1.0,1,1.0,1,1.0,1,0.16974173028208517,36
511,2,999,386,613,0,0,0,1.0,1,1.0,1,1.0,1,0.22089663347467792,34
512,0,999,386,613,0,0,0,1.0,1,1.0,1,1.0,1,0.19376768063552494,32
513,0,999,386,613,0,0,0,1.0,1,1.0,1,1.0,1,0.19376768063552494,32
514,2,1001,386,615,0,0,0,1.0,1,1.0,1,1.0,1,0.16863304986608435,35
515,0,1001,386,615,0,0,0,1.0,1,1.0,1,1.0,1,0.16863304986608435,35
516,2,1003,386,617,0,0,0,1.0,1,1.0,1,1.0,1,0.1399968873773519,36
517,1,1004,387,617,0,0,0,1.0,1,1.0,1,1.0,1,0.1675345345684102,36
518,2,1006,387,619,0,0,0,1.0,1,1.0,1,1.0,1,0.18233758108853487,39
519,1,1007,388,619,0,0,0,1.0,1,1.0,1,1.0,1,0.1644508786271137,39
520,1,1008,388,620,0,0,0,1.0,1,1.0,1,1.0,1,0.16396833760306948,39
521,1,1009,388,621,0,0,0,1.0,1,1.0,1,1.0,1,0.14150382768779216,40
522,0,1009,388,621,0,0,0,1.0,1,1.0,1,1.0,1,0.14150382768779216,40
523,2,1011,388,623,0,0,0,1.0,1,1.0,1,1.0,1,0.1308369627272827,41
524,1,1012,389,623,0,0,0,1.0,1,1.0,1,1.0,1,0.14743181704358843,41
525,5,1017,391,626,0,0,0,1.0,1,1.0,1,1.0,1,0.12604922063487414,40
526,2,1019,392,627,0,0,0,1.0,1,1.0,1,1.0,1,0.15679488824227544,40
527,3,1022,393,629,0,0,0,1.0,1,1.0,1,1.0,1,0.1505309398986041,40
528,0,1022,393,629,0,0,0,1.0,1,1.0,1,1.0,1,0.1505309398986041,40
529,1,1023,393,630,0,0,0,1.0,1,1.0,1,1.0,1,0.13193335248130708,39
530,0,1023,393,630,0,0,0,1.0,1,1.0,1,1.0,1,0.13193335248130708,39
531,1,1024,394,630,0,0,0,1.0,1,1.0,1,1.0,1,0.17156159619203892,39
532,0,1024,394,630,0,0,0,1.0,1,1.0,1,1.0,1,0.17141773943552838,40
533,5,1029,396,633,0,0,0,1.0,1,1.0,1,1.0,1,0.1529853896019661,40
534,0,1029,396,633,0,0,0,1.0,1,1.0,1,1.0,1,0.1713296294063866,42
535,1,1030,396,634,0,0,0,1.0,1,1.0,1,1.0,1,0.16636921560605955,42
536,0,1030,396,634,0,0,0,1.0,1,1.0,1,1.0,1,0.1711694957209858,43
537,0,1030,396,634,0,0,0,1.0,1,1.0,1,1.0,1,0.1711694957209858,43
538,2,1032,398,634,0,0,0,1.0,1,1.0,1,1.0,1,0.20087461344565988,44
539,3,1035,398,637,0,0,0,1.0,1,1.0,1,1.0,1,0.17237026955816745,44
540,0,1035,398,637,0,0,0,1.0,1,1.0,1,1.0,1,0.17237026955816745,44
541,2,1037,398,639,0,0,0,1.0,1,1.0,1,1.0,1,0.14053578304508982,45
542,1,1038,399,639,0,0,0,1.0,1,1.0,1,1.0,1,0.14441362508372685,46
543,5,1043,401,642,0,0,0,1.0,1,1.0,1,1.0,1,0.17567750059225629,43
544,6,1049,404,645,0,0,0,1.0,1,1.0,1,1.0,1,0.21573938199513634,42
545,5,1054,406,648,0,0,0,1.0,1,1.0,1,1.0,1,0.08160722459970181,43
546,1,1055,407,648,0,0,0,1.0,1,1.0,1,1.0,1,0.11304393833550698,41
547,2,1057,407,650,0,0,0,1.0,1,1.0,1,1.0,1,0.09324837096875437,40
548,3,1060,410,650,0,0,0,1.0,1,1.0,1,1.0,1,0.11407732682992887,40
549,4,1064,412,652,0,0,0,1.0,1,1.0,1,1.0,1,0.14681401084358123,39
550,3,1067,414,653,0,0,0,1.0,1,1.0,1,1.0,1,0.17511987833789522,38
551,2,1069,414,655,0,0,0,1.0,1,1.0,1,1.0,1,0.13948044470273685,38
552,0,1069,414,655,0,0,0,1.0,1,1.0,1,1.0,1,0.12944442590842456,39
553,0,1069,414,655,0,0,0,1.0,1,1.0,1,1.0,1,0.13590570917789457,38
554,2,1071,415,656,0,0,0,1.0,1,1.0,1,1.0,1,0.12587192765445293,39
555,1,1072,415,657,0,0,0,1.0,1,1.0,1,1.0,1,0.09422376618979834,39
556,1,1073,415,658,0,0,0,1.0,1,1.0,1,1.0,1,0.07461912322494475,40
557,0,1073,415,658,0,0,0,1.0,1,1.0,1,1.0,1,0.10093383935218081,40
558,0,1073,415,658,0,0,0,1.0,1,1.0,1,1.0,1,0.10093383935218081,40
559,2,1075,417,658,0,0,0,1.0,1,1.0,1,1.0,1,0.0957285274147627,40
560,2,1077,417,660,0,0,0,1.0,1,1.0,1,1.0,1,0.10443486139379402,41
561,1,1078,417,661,0,0,0,1.0,1,1.0,1,1.0,1,0.11032810566825423,42
562,1,1079,418,661,0,0,0,1.0,1,1.0,1,1.0,1,0.1457400947748471,42
563,3,1082,419,663,0,0,0,1.0,1,1.0,1,1.0,1,0.1696457706803452,42
564,0,1082,419,663,0,0,0,1.0,1,1.0,1,1.0,1,0.18299410660260831,43
565,2,1084,420,664,0,0,0,1.0,1,1.0,1,1.0,1,0.1738966579933763,44
566,1,1085,420,665,0,0,0,1.0,1,1.0,1,1.0,1,0.1580504984488763,45
567,2,1087,422,665,0,0,0,1.0,1,1.0,1,1.0,1,0.20639981002363797,45
568,3,1090,422,668,0,0,0,1.0,1,1.0,1,1.0,1,0.15748450937473488,46
569,4,1094,424,670,0,0,0,1.0,1,1.0,1,1.0,1,0.14134356924096841,47
570,1,1095,424,671,0,0,0,1.0,1,1.0,1,1.0,1,0.147610596428152,48
571,3,1098,426,672,0,0,0,1.0,1,1.0,1,1.0,1,0.17296533183085772,48
572,0,1098,426,672,0,0,0,1.0,1,1.0,1,1.0,1,0.18471812531423776,47
573,1,1099,426,673,0,0,0,1.0,1,1.0,1,1.0,1,0.18172723323900117,49
574,2,1101,426,675,0,0,0,1.0,1,1.0,1,1.0,1,0.15455071959306116,49
575,2,1103,426,677,0,0,0,1.0,1,1.0,1,1.0,1,0.11050748093479167,50
576,0,1103,426,677,0,0,0,1.0,1,1.0,1,1.0,1,0.12706431658160228,51
577,2,1105,426,679,0,0,0,1.0,1,1.0,1,1.0,1,0.09781985467304188,51
578,0,1105,426,679,0,0,0,1.0,1,1.0,1,1.0,1,0.09781985467304188,51
579,3,1108,427,681,0,0,0,1.0,1,1.0,1,1.0,1,0.10487444709742515,52
580,2,1110,428,682,0,0,0,1.0,1,1.0,1,1.0,1,0.12214272649721124,52
581,2,1112,429,683,0,0,0,1.0,1,1.0,1,1.0,1,0.1347313631726938,52
582,0,1112,429,683,0,0,0,1.0,1,1.0,1,1.0,1,0.14559554342422207,53
583,1,1113,429,684,0,0,0,1.0,1,1.0,1,1.0,1,0.1148321106688033,51
584,2,1115,430,685,0,0,0,1.0,1,1.0,1,1.0,1,0.11319286023162238,51
585,6,1121,434,687,0,0,0,1.0,1,1.0,1,1.0,1,0.09641900591811646,49
586,1,1122,435,687,0,0,0,1.0,1,1.0,1,1.0,1,0.08145902933431584,49
587,3,1125,438,687,0,0,0,1.0,1,1.0,1,1.0,1,0.11253961715587821,48
588,2,1127,438,689,0,0,0,1.0,1,1.0,1,1.0,1,0.07506894069918489,46
589,2,1129,439,690,0,0,0,1.0,1,1.0,1,1.0,1,0.0991472369117152,48
590,2,1131,440,691,0,0,0,1.0,1,1.0,1,1.0,1,0.09970295496013579,47
591,3,1134,442,692,0,0,0,1.0,1,1.0,1,1.0,1,0.11976368519025277,48
592,3,1137,444,693,0,0,0,1.0,1,1.0,1,1.0,1,0.1928780011610422,47
593,5,1142,445,697,0,0,0,1.0,1,1.0,1,1.0,1,0.17035385808771364,45
594,0,1142,445,697,0,0,0,1.0,1,1.0,1,1.0,1,0.15976091644600426,44
595,2,1144,446,698,0,0,0,1.0,1,1.0,1,1.0,1,0.1714696528956473,43
596,3,1147,448,699,0,0,0,1.0,1,1.0,1,1.0,1,0.16898733913625755,44
597,4,1151,449,702,0,0,0,1.0,1,1.0,1,1.0,1,0.14461272926014607,43
598,1,1152,450,702,0,0,0,1.0,1,1.0,1,1.0,1,0.13612028952688898,45
599,3,1155,451,704,0,0,0,1.0,1,1.0,1,1.0,1,0.1257433431020938,44
600,1,1156,451,705,0,0,0,1.0,1,1.0,1,1.0,1,0.10793297864130343,44
601,1,1157,451,706,0,0,0,1.0,1,1.0,1,1.0,1,0.1125696864028983,45
602,3,1160,452,708,0,0,0,1.0,1,1.0,1,1.0,1,0.14037550002906976,46
603,0,1160,452,708,0,0,0,1.0,1,1.0,1,1.0,1,0.14485989186941586,46
604,1,1161,452,709,0,0,0,1.0,1,1.0,1,1.0,1,0.12601051714028874,47
605,1,1162,452,710,0,0,0,1.0,1,1.0,1,1.0,1,0.09711362148388014,47
606,0,1162,452,710,0,0,0,1.0,1,1.0,1,1.0,1,0.11967084851460537,47
607,1,1163,452,711,0,0,0,1.0,1,1.0,1,1.0,1,0.11001222725087563,48
608,0,1163,452,711,0,0,0,1.0,1,1.0,1,1.0,1,0.1332022676058451,47
609,2,1165,452,713,0,0,0,1.0,1,1.0,1,1.0,1,0.10326201400332864,48
610,3,1168,452,716,0,0,0,1.0,1,1.0,1,1.0,1,0.08752651756908926,48
611,0,1168,452,716,0,0,0,1.0,1,1.0,1,1.0,1,0.08975213652450496,49
612,0,1168,452,716,0,0,0,1.0,1,1.0,1,1.0,1,0.12039048454257698,50
613,3,1171,454,717,0,0,0,1.0,1,1.0,1,1.0,1,0.09705124857561066,50
614,1,1172,454,718,0,0,0,1.0,1,1.0,1,1.0,1,0.07928819365510022,50
615,2,1174,455,719,0,0,0,1.0,1,1.0,1,1.0,1,0.08196623959315182,50
616,1,1175,455,720,0,0,0,1.0,1,1.0,1,1.0,1,0.06990006354662695,50
617,1,1176,455,721,0,0,0,1.0,1,1.0,1,1.0,1,0.07791794395921556,52
618,1,1177,456,721,0,0,0,1.0,1,1.0,1,1.0,1,0.0677718113727077,52
619,1,1178,457,721,0,0,0,1.0,1,1.0,1,1.0,1,0.09284517662984741,50
620,1,1179,458,721,0,0,0,1.0,1,1.0,1,1.0,1,0.11886289168314396,50
621,6,1185,460,725,0,0,0,1.0,1,1.0,1,1.0,1,0.11388394976716429,49
622,1,1186,460,726,0,0,0,1.0,1,1.0,1,1.0,1,0.144415228333763,49
623,3,1189,461,728,0,0,0,1.0,1,1.0,1,1.0,1,0.10921340191908897,48
624,1,1190,462,728,0,0,0,1.0,1,1.0,1,1.0,1,0.08313409957207518,46
625,3,1193,463,730,0,0,0,1.0,1,1.0,1,1.0,1,0.07104096123873628,45
626,3,1196,465,731,0,0,0,1.0,1,1.0,1,1.0,1,0.11511118599601947,44
627,4,1200,467,733,0,0,0,1.0,1,1.0,1,1.0,1,0.08945144100436621,44
628,5,1205,470,735,0,0,0,1.0,1,1.0,1,1.0,1,0.12420757853360842,44
629,1,1206,471,735,0,0,0,1.0,1,1.0,1,1.0,1,0.12127932854693356,41
630,2,1208,472,736,0,0,0,1.0,1,1.0,1,1.0,1,0.16190827919678555,40
631,5,1213,475,738,0,0,0,1.0,1,1.0,1,1.0,1,0.2358301030407996,38
632,3,1216,477,739,0,0,0,1.0,1,1.0,1,1.0,1,0.2533734239825774,38
633,3,1219,477,742,0,0,0,1.0,1,1.0,1,1.0,1,0.24395700504856518,36
634,2,1221,478,743,0,0,0,1.0,1,1.0,1,1.0,1,0.2142031784875114,35
635,3,1224,479,745,0,0,0,1.0,1,1.0,1,1.0,1,0.17366070033769704,35
636,4,1228,480,748,0,0,0,1.0,1,1.0,1,1.0,1,0.14626638948165935,36
637,2,1230,480,750,0,0,0,1.0,1,1.0,1,1.0,1,0.1204537917723811,35
638,0,1230,480,750,0,0,0,1.0,1,1.0,1,1.0,1,0.13429809078505167,34
639,2,1232,481,751,0,0,0,1.0,1,1.0,1,1.0,1,0.12300624402881165,36
640,2,1234,482,752,0,0,0,1.0,1,1.0,1,1.0,1,0.1332055456169391,37
641,2,1236,482,754,0,0,0,1.0,1,1.0,1,1.0,1,0.08844069422652569,37
642,0,1236,482,754,0,0,0,1.0,1,1.0,1,1.0,1,0.09358006336991757,38
643,0,1236,482,754,0,0,0,1.0,1,1.0,1,1.0,1,0.08826657873568444,39
644,0,1236,482,754,0,0,0,1.0,1,1.0,1,1.0,1,0.08826657873568444,39
645,1,1237,482,755,0,0,0,1.0,1,1.0,1,1.0,1,0.10147617838418045,39
646,4,1241,485,756,0,0,0,1.0,1,1.0,1,1.0,1,0.15064582576948343,40
647,2,1243,485,758,0,0,0,1.0,1,1.0,1,1.0,1,0.0990022992718024,40
648,0,1243,485,758,0,0,0,1.0,1,1.0,1,1.0,1,0.0990022992718024,40
649,0,1243,485,758,0,0,0,1.0,1,1.0,1,1.0,1,0.0990022992718024,40
650,2,1245,486,759,0,0,0,1.0,1,1.0,1,1.0,1,0.09454188033347147,41
651,1,1246,486,760,0,0,0,1.0,1,1.0,1,1.0,1,0.08977143194086541,42
652,0,1246,486,760,0,0,0,1.0,1,1.0,1,1.0,1,0.10343784966438774,41
653,0,1246,486,760,0,0,0,1.0,1,1.0,1,1.0,1,0.10343784966438774,41
654,0,1246,486,760,0,0,0,1.0,1,1.0,1,1.0,1,0.11666140141156237,42
655,2,1248,486,762,0,0,0,1.0,1,1.0,1,1.0,1,0.0980007340465793,45
656,5,1253,491,762,0,0,0,1.0,1,1.0,1,1.0,1,0.2203958617089738,45
657,3,1256,491,765,0,0,0,1.0,1,1.0,1,1.0,1,0.1279628253057063,43
658,3,1259,493,766,0,0,0,1.0,1,1.0,1,1.0,1,0.2084681251958789,43
659,3,1262,495,767,0,0,0,1.0,1,1.0,1,1.0,1,0.1947647395410945,43
660,2,1264,496,768,0,0,0,1.0,1,1.0,1,1.0,1,0.22474389927433638,43
661,3,1267,497,770,0,0,0,1.0,1,1.0,1,1.0,1,0.18290271446044556,41
662,2,1269,498,771,0,0,0,1.0,1,1.0,1,1.0,1,0.2022769727804022,40
663,3,1272,499,773,0,0,0,1.0,1,1.0,1,1.0,1,0.182893180284732,39
664,2,1274,500,774,0,0,0,1.0,1,1.0,1,1.0,1,0.18650583910988944,36
665,3,1277,501,776,0,0,0,1.0,1,1.0,1,1.0,1,0.1340978376981223,36
666,3,1280,502,778,0,0,0,1.0,1,1.0,1,1.0,1,0.10766201521505582,36
667,1,1281,503,778,0,0,0,1.0,1,1.0,1,1.0,1,0.145128640024298,35
668,2,1283,505,778,0,0,0,1.0,1,1.0,1,1.0,1,0.1611235828751958,34
669,6,1289,507,782,0,0,0,1.0,1,1.0,1,1.0,1,0.11288620473816202,34
670,2,1291,508,783,0,0,0,1.0,1,1.0,1,1.0,1,0.13676964805828723,32
671,1,1292,509,783,0,0,0,1.0,1,1.0,1,1.0,1,0.13744843889893602,33
672,0,1292,509,783,0,0,0,1.0,1,1.0,1,1.0,1,0.16345003403223615,32
673,4,1296,509,787,0,0,0,1.0,1,1.0,1,1.0,1,0.16522801528872388,32
674,2,1298,510,788,0,0,0,1.0,1,1.0,1,1.0,1,0.17282224014392444,32
675,3,1301,512,789,0,0,0,1.0,1,1.0,1,1.0,1,0.16048847980361597,34
676,1,1302,512,790,0,0,0,1.0,1,1.0,1,1.0,1,0.10911854692423596,35
677,1,1303,513,790,0,0,0,1.0,1,1.0,1,1.0,1,0.11027526149966962,35
678,0,1303,513,790,0,0,0,1.0,1,1.0,1,1.0,1,0.11027526149966962,35
679,3,1306,513,793,0,0,0,1.0,1,1.0,1,1.0,1,0.07257399939396979,36
680,0,1306,513,793,0,0,0,1.0,1,1.0,1,1.0,1,0.07733557086499032,37
681,0,1306,513,793,0,0,0,1.0,1,1.0,1,1.0,1,0.07733557086499032,37
682,1,1307,514,793,0,0,0,1.0,1,1.0,1,1.0,1,0.07747451102690842,37
683,1,1308,514,794,0,0,0,1.0,1,1.0,1,1.0,1,0.056848807852235665,38
684,1,1309,515,794,0,0,0,1.0,1,1.0,1,1.0,1,0.0831879615534645,39
685,1,1310,516,794,0,0,0,1.0,1,1.0,1,1.0,1,0.10539732477228943,38
686,0,1310,516,794,0,0,0,1.0,1,1.0,1,1.0,1,0.1372418658316054,37
687,3,1313,517,796,0,0,0,1.0,1,1.0,1,1.0,1,0.17820035694869454,38
688,1,1314,517,797,0,0,0,1.0,1,1.0,1,1.0,1,0.15547503003796628,37
689,5,1319,519,800,0,0,0,1.0,1,1.0,1,1.0,1,0.19740731545423992,39
690,0,1319,519,800,0,0,0,1.0,1,1.0,1,1.0,1,0.22067549177749154,38
691,2,1321,520,801,0,0,0,1.0,1,1.0,1,1.0,1,0.21223079516611923,38
692,2,1323,522,801,0,0,0,1.0,1,1.0,1,1.0,1,0.26641139734596925,38
693,6,1329,524,805,0,0,0,1.0,1,1.0,1,1.0,1,0.22853452213601633,40
694,2,1331,525,806,0,0,0,1.0,1,1.0,1,1.0,1,0.2501126613121245,42
695,4,1335,526,809,0,0,0,1.0,1,1.0,1,1.0,1,0.1661241893056102,40
696,1,1336,527,809,0,0,0,1.0,1,1.0,1,1.0,1,0.18772850454376946,39
697,0,1336,527,809,0,0,0,1.0,1,1.0,1,1.0,1,0.19188715482119126,39
698,2,1338,528,810,0,0,0,1.0,1,1.0,1,1.0,1,0.183415743515002,37
699,0,1338,528,810,0,0,0,1.0,1,1.0,1,1.0,1,0.1698372088067446,37
700,1,1339,528,811,0,0,0,1.0,1,1.0,1,1.0,1,0.18788000691422976,37
701,0,1339,528,811,0,0,0,1.0,1,1.0,1,1.0,1,0.18788000691422976,37
702,4,1343,528,815,0,0,0,1.0,1,1.0,1,1.0,1,0.1216453023292048,38
703,2,1345,530,815,0,0,0,1.0,1,1.0,1,1.0,1,0.13236219826960885,36
704,6,1351,533,818,0,0,0,1.0,1,1.0,1,1.0,1,0.12648476819985977,36
705,3,1354,535,819,0,0,0,1.0,1,1.0,1,1.0,1,0.13304703600144735,36
706,5,1359,539,820,0,0,0,1.0,1,1.0,1,1.0,1,0.16327613901399954,35
707,2,1361,540,821,0,0,0,1.0,1,1.0,1,1.0,1,0.13635006413143064,36
708,2,1363,542,821,0,0,0,1.0,1,1.0,1,1.0,1,0.20515938600934602,36
709,3,1366,542,824,0,0,0,1.0,1,1.0,1,1.0,1,0.13327705119693023,34
710,0,1366,542,824,0,0,0,1.0,1,1.0,1,1.0,1,0.13327705119693023,34
711,0,1366,542,824,0,0,0,1.0,1,1.0,1,1.0,1,0.12936215119591987,34
712,2,1368,544,824,0,0,0,1.0,1,1.0,1,1.0,1,0.2006960909445476,35
713,4,1372,545,827,0,0,0,1.0,1,1.0,1,1.0,1,0.11787460450159787,34
714,0,1372,545,827,0,0,0,1.0,1,1.0,1,1.0,1,0.09862563127009377,34
715,0,1372,545,827,0,0,0,1.0,1,1.0,1,1.0,1,0.11457493922661868,35
716,1,1373,546,827,0,0,0,1.0,1,1.0,1,1.0,1,0.14655746519697696,33
717,4,1377,548,829,0,0,0,1.0,1,1.0,1,1.0,1,0.1677392109416919,33
718,3,1380,550,830,0,0,0,1.0,1,1.0,1,1.0,1,0.222625250643193,32
719,2,1382,550,832,0,0,0,1.0,1,1.0,1,1.0,1,0.16635009371157422,32
720,2,1384,551,833,0,0,0,1.0,1,1.0,1,1.0,1,0.15040785215430658,33
721,0,1384,551,833,0,0,0,1.0,1,1.0,1,1.0,1,0.15040785215430658,33
722,4,1388,552,836,0,0,0,1.0,1,1.0,1,1.0,1,0.1756958188296213,34
723,2,1390,552,838,0,0,0,1.0,1,1.0,1,1.0,1,0.12816871600192625,34
724,0,1390,552,838,0,0,0,1.0,1,1.0,1,1.0,1,0.133668927491769,36
725,0,1390,552,838,0,0,0,1.0,1,1.0,1,1.0,1,0.133668927491769,36
726,0,1390,552,838,0,0,0,1.0,1,1.0,1,1.0,1,0.133668927491769,36
727,1,1391,552,839,0,0,0,1.0,1,1.0,1,1.0,1,0.1157532311558271,36
728,1,1392,552,840,0,0,0,1.0,1,1.0,1,1.0,1,0.12187488482794875,37
729,0,1392,552,840,0,0,0,1.0,1,1.0,1,1.0,1,0.110494178914405,37
730,0,1392,552,840,0,0,0,1.0,1,1.0,1,1.0,1,0.1118847300602961,38
731,1,1393,553,840,0,0,0,1.0,1,1.0,1,1.0,1,0.180121805734782,39
732,3,1396,553,843,0,0,0,1.0,1,1.0,1,1.0,1,0.12180491441710269,41
733,1,1397,554,843,0,0,0,1.0,1,1.0,1,1.0,1,0.12563447582698972,39
734,2,1399,555,844,0,0,0,1.0,1,1.0,1,1.0,1,0.131227485772663,39
735,1,1400,556,844,0,0,0,1.0,1,1.0,1,1.0,1,0.1687668735809548,39
736,0,1400,556,844,0,0,0,1.0,1,1.0,1,1.0,1,0.15762314366799862,38
737,1,1401,557,844,0,0,0,1.0,1,1.0,1,1.0,1,0.19122128451232437,39
738,0,1401,557,844,0,0,0,1.0,1,1.0,1,1.0,1,0.1983613080537099,37
739,0,1401,557,844,0,0,0,1.0,1,1.0,1,1.0,1,0.1983613080537099,37
740,0,1401,557,844,0,0,0,1.0,1,1.0,1,1.0,1,0.22196517999638382,35
741,1,1402,557,845,0,0,0,1.0,1,1.0,1,1.0,1,0.2322961628809039,33
742,4,1406,558,848,0,0,0,1.0,1,1.0,1,1.0,1,0.18307029073210385,35
743,5,1411,561,850,0,0,0,1.0,1,1.0,1,1.0,1,0.21774580224012147,35
744,4,1415,563,852,0,0,0,1.0,1,1.0,1,1.0,1,0.14679337649100202,34
745,4,1419,565,854,0,0,0,1.0,1,1.0,1,1.0,1,0.13475170625700453,34
746,2,1421,566,855,0,0,0,1.0,1,1.0,1,1.0,1,0.12915359932502976,33
747,1,1422,566,856,0,0,0,1.0,1,1.0,1,1.0,1,0.09647970385907298,32
748,0,1422,566,856,0,0,0,1.0,1,1.0,1,1.0,1,0.08666591320290123,33
749,0,1422,566,856,0,0,0,1.0,1,1.0,1,1.0,1,0.08666591320290123,33
750,0,1422,566,856,0,0,0,1.0,1,1.0,1,1.0,1,0.08720817101403565,34
751,3,1425,568,857,0,0,0,1.0,1,1.0,1,1.0,1,0.13524720644672722,36
752,1,1426,569,857,0,0,0,1.0,1,1.0,1,1.0,1,0.11087889185283237,35
753,1,1427,570,857,0,0,0,1.0,1,1.0,1,1.0,1,0.15241191432095264,37
754,3,1430,573,857,0,0,0,1.0,1,1.0,1,1.0,1,0.23282640515676434,37
755,3,1433,573,860,0,0,0,1.0,1,1.0,1,1.0,1,0.15703752135562168,35
756,5,1438,574,864,0,0,0,1.0,1,1.0,1,1.0,1,0.15172076868143092,36
757,2,1440,574,866,0,0,0,1.0,1,1.0,1,1.0,1,0.11291639898051525,35
758,0,1440,574,866,0,0,0,1.0,1,1.0,1,1.0,1,0.09903238188349392,36
759,0,1440,574,866,0,0,0,1.0,1,1.0,1,1.0,1,0.11132529610081458,37
760,0,1440,574,866,0,0,0,1.0,1,1.0,1,1.0,1,0.16217602617264662,36
761,1,1441,574,867,0,0,0,1.0,1,1.0,1,1.0,1,0.13638508818169073,36
762,0,1441,574,867,0,0,0,1.0,1,1.0,1,1.0,1,0.1521068566568555,37
763,2,1443,574,869,0,0,0,1.0,1,1.0,1,1.0,1,0.1483125223749143,38
764,1,1444,574,870,0,0,0,1.0,1,1.0,1,1.0,1,0.11989009015364195,38
765,0,1444,574,870,0,0,0,1.0,1,1.0,1,1.0,1,0.11989009015364195,38
766,0,1444,574,870,0,0,0,1.0,1,1.0,1,1.0,1,0.09860854505530983,40
767,2,1446,574,872,0,0,0,1.0,1,1.0,1,1.0,1,0.07866629676513247,41
768,1,1447,575,872,0,0,0,1.0,1,1.0,1,1.0,1,0.11570623215743756,41
769,2,1449,576,873,0,0,0,1.0,1,1.0,1,1.0,1,0.14041596131513043,42
770,1,1450,576,874,0,0,0,1.0,1,1.0,1,1.0,1,0.17131406569536686,41
771,2,1452,576,876,0,0,0,1.0,1,1.0,1,1.0,1,0.14579209191668108,41
772,4,1456,578,878,0,0,0,1.0,1,1.0,1,1.0,1,0.12824056108654,41
773,0,1456,578,878,0,0,0,1.0,1,1.0,1,1.0,1,0.11857855790203148,41
774,5,1461,580,881,0,0,0,1.0,1,1.0,1,1.0,1,0.16037585580128103,42
775,4,1465,580,885,0,0,0,1.0,1,1.0,1,1.0,1,0.1221913271362599,42
776,0,1465,580,885,0,0,0,1.0,1,1.0,1,1.0,1,0.1221913271362599,42
777,1,1466,580,886,0,0,0,1.0,1,1.0,1,1.0,1,0.10310247343317551,42
778,1,1467,580,887,0,0,0,1.0,1,1.0,1,1.0,1,0.11139111955243577,44
779,1,1468,580,888,0,0,0,1.0,1,1.0,1,1.0,1,0.09030765130033012,44
780,1,1469,581,888,0,0,0,1.0,1,1.0,1,1.0,1,0.11647594444432299,44
781,0,1469,581,888,0,0,0,1.0,1,1.0,1,1.0,1,0.11091797239810396,46
782,4,1473,583,890,0,0,0,1.0,1,1.0,1,1.0,1,0.15652476376205873,45
783,4,1477,584,893,0,0,0,1.0,1,1.0,1,1.0,1,0.13831422932749143,44
784,1,1478,585,893,0,0,0,1.0,1,1.0,1,1.0,1,0.18835055347429597,44
785,4,1482,586,896,0,0,0,1.0,1,1.0,1,1.0,1,0.10445452896939532,43
786,0,1482,586,896,0,0,0,1.0,1,1.0,1,1.0,1,0.10445452896939532,43
787,0,1482,586,896,0,0,0,1.0,1,1.0,1,1.0,1,0.10445452896939532,43
788,3,1485,588,897,0,0,0,1.0,1,1.0,1,1.0,1,0.18715526489788037,45
789,4,1489,589,900,0,0,0,1.0,1,1.0,1,1.0,1,0.13222466176340325,46
790,1,1490,589,901,0,0,0,1.0,1,1.0,1,1.0,1,0.14567824121641454,45
791,4,1494,591,903,0,0,0,1.0,1,1.0,1,1.0,1,0.15171972093231503,46
792,3,1497,592,905,0,0,0,1.0,1,1.0,1,1.0,1,0.14103297371096374,46
793,1,1498,592,906,0,0,0,1.0,1,1.0,1,1.0,1,0.1280928355289432,46
794,0,1498,592,906,0,0,0,1.0,1,1.0,1,1.0,1,0.16882324170157414,47
795,1,1499,592,907,0,0,0,1.0,1,1.0,1,1.0,1,0.15590183022456833,47
796,0,1499,592,907,0,0,0,1.0,1,1.0,1,1.0,1,0.1811277030881027,46
797,6,1505,593,912,0,0,0,1.0,1,1.0,1,1.0,1,0.11875923769787132,47
798,4,1509,594,915,0,0,0,1.0,1,1.0,1,1.0,1,0.12124846538148074,48
799,1,1510,594,916,0,0,0,1.0,1,1.0,1,1.0,1,0.10961164967563092,48
800,1,1511,595,916,0,0,0,1.0,1,1.0,1,1.0,1,0.13031133483070098,48
801,5,1516,596,920,0,0,0,1.0,1,1.0,1,1.0,1,0.09463203118110401,49
802,0,1516,596,920,0,0,0,1.0,1,1.0,1,1.0,1,0.08249703998591182,50
803,1,1517,596,921,0,0,0,1.0,1,1.0,1,1.0,1,0.07356570744136728,49
804,4,1521,598,923,0,0,0,1.0,1,1.0,1,1.0,1,0.08304840704121487,50
805,0,1521,598,923,0,0,0,1.0,1,1.0,1,1.0,1,0.08304840704121487,50
806,0,1521,598,923,0,0,0,1.0,1,1.0,1,1.0,1,0.08304840704121487,50
807,1,1522,598,924,0,0,0,1.0,1,1.0,1,1.0,1,0.08809701985332262,51
808,1,1523,599,924,0,0,0,1.0,1,1.0,1,1.0,1,0.12242238391921237,51
809,1,1524,599,925,0,0,0,1.0,1,1.0,1,1.0,1,0.07513649653942105,51
810,1,1525,599,926,0,0,0,1.0,1,1.0,1,1.0,1,0.0646057635250855,52
811,2,1527,601,926,0,0,0,1.0,1,1.0,1,1.0,1,0.12386611779827776,50
812,2,1529,603,926,0,0,0,1.0,1,1.0,1,1.0,1,0.15772133642366126,48
813,5,1534,605,929,0,0,0,1.0,1,1.0,1,1.0,1,0.13228513506449371,49
814,1,1535,605,930,0,0,0,1.0,1,1.0,1,1.0,1,0.11575925687282161,48
815,2,1537,606,931,0,0,0,1.0,1,1.0,1,1.0,1,0.12110564514984964,48
816,1,1538,607,931,0,0,0,1.0,1,1.0,1,1.0,1,0.1385015047968143,46
817,3,1541,607,934,0,0,0,1.0,1,1.0,1,1.0,1,0.1403215313422531,44
818,0,1541,607,934,0,0,0,1.0,1,1.0,1,1.0,1,0.1409235644470535,46
819,4,1545,608,937,0,0,0,1.0,1,1.0,1,1.0,1,0.1419196651105145,44
820,1,1546,609,937,0,0,0,1.0,1,1.0,1,1.0,1,0.1643265064939009,44
821,2,1548,609,939,0,0,0,1.0,1,1.0,1,1.0,1,0.11961036802946771,44
822,3,1551,610,941,0,0,0,1.0,1,1.0,1,1.0,1,0.1265676029960886,44
823,1,1552,611,941,0,0,0,1.0,1,1.0,1,1.0,1,0.12054914151096759,42
824,2,1554,613,941,0,0,0,1.0,1,1.0,1,1.0,1,0.13674849044968965,42
825,3,1557,614,943,0,0,0,1.0,1,1.0,1,1.0,1,0.11527394442485826,40
826,5,1562,617,945,0,0,0,1.0,1,1.0,1,1.0,1,0.13543005233960625,41
827,7,1569,620,949,0,0,0,1.0,1,1.0,1,1.0,1,0.1021263272789389,40
828,3,1572,622,950,0,0,0,1.0,1,1.0,1,1.0,1,0.0727008239136871,40
829,3,1575,624,951,0,0,0,1.0,1,1.0,1,1.0,1,0.09794403484968903,42
830,2,1577,626,951,0,0,0,1.0,1,1.0,1,1.0,1,0.13059262459656726,42
831,2,1579,627,952,0,0,0,1.0,1,1.0,1,1.0,1,0.13214092171355032,43
832,0,1579,627,952,0,0,0,1.0,1,1.0,1,1.0,1,0.11357965267236886,42
833,0,1579,627,952,0,0,0,1.0,1,1.0,1,1.0,1,0.1262838611571212,41
834,3,1582,629,953,0,0,0,1.0,1,1.0,1,1.0,1,0.15863251172622422,41
835,1,1583,629,954,0,0,0,1.0,1,1.0,1,1.0,1,0.14572422214621636,41
836,0,1583,629,954,0,0,0,1.0,1,1.0,1,1.0,1,0.14225291405863533,40
837,0,1583,629,954,0,0,0,1.0,1,1.0,1,1.0,1,0.14370196362965482,41
838,1,1584,630,954,0,0,0,1.0,1,1.0,1,1.0,1,0.14902241396714117,41
839,3,1587,631,956,0,0,0,1.0,1,1.0,1,1.0,1,0.11646294901091249,41
840,2,1589,631,958,0,0,0,1.0,1,1.0,1,1.0,1,0.08570564598551013,42
841,1,1590,632,958,0,0,0,1.0,1,1.0,1,1.0,1,0.12699900554743362,42
842,2,1592,633,959,0,0,0,1.0,1,1.0,1,1.0,1,0.13406360843559104,42
843,3,1595,635,960,0,0,0,1.0,1,1.0,1,1.0,1,0.15535647394730162,42
844,1,1596,635,961,0,0,0,1.0,1,1.0,1,1.0,1,0.17424645235332764,42
845,8,1604,637,967,0,0,0,1.0,1,1.0,1,1.0,1,0.23488480264900044,44
846,3,1607,637,970,0,0,0,1.0,1,1.0,1,1.0,1,0.18536948400026862,44
847,2,1609,637,972,0,0,0,1.0,1,1.0,1,1.0,1,0.13248670733152967,42
848,1,1610,637,973,0,0,0,1.0,1,1.0,1,1.0,1,0.15323185999176456,43
849,1,1611,637,974,0,0,0,1.0,1,1.0,1,1.0,1,0.1348673973301525,43
850,2,1613,637,976,0,0,0,1.0,1,1.0,1,1.0,1,0.11973734535113133,41
851,0,1613,637,976,0,0,0,1.0,1,1.0,1,1.0,1,0.12994234199017832,40
852,2,1615,638,977,0,0,0,1.0,1,1.0,1,1.0,1,0.13205569602162034,40
853,3,1618,639,979,0,0,0,1.0,1,1.0,1,1.0,1,0.10549050788030001,40
854,2,1620,641,979,0,0,0,1.0,1,1.0,1,1.0,1,0.1387473707749463,40
855,2,1622,642,980,0,0,0,1.0,1,1.0,1,1.0,1,0.12666146266050854,41
856,1,1623,643,980,0,0,0,1.0,1,1.0,1,1.0,1,0.14461147772975858,41
857,2,1625,644,981,0,0,0,1.0,1,1.0,1,1.0,1,0.13789132357282044,42
858,3,1628,645,983,0,0,0,1.0,1,1.0,1,1.0,1,0.08703118419043995,43
859,0,1628,645,983,0,0,0,1.0,1,1.0,1,1.0,1,0.08703118419043995,43
860,0,1628,645,983,0,0,0,1.0,1,1.0,1,1.0,1,0.09418576434620667,44
861,1,1629,646,983,0,0,0,1.0,1,1.0,1,1.0,1,0.12645525353242607,44
862,1,1630,646,984,0,0,0,1.0,1,1.0,1,1.0,1,0.10521146782455132,44
863,5,1635,648,987,0,0,0,1.0,1,1.0,1,1.0,1,0.09844700886826165,44
864,5,1640,650,990,0,0,0,1.0,1,1.0,1,1.0,1,0.09509382399891782,44
865,2,1642,652,990,0,0,0,1.0,1,1.0,1,1.0,1,0.07810833407746419,43
866,6,1648,655,993,0,0,0,1.0,1,1.0,1,1.0,1,0.10081356035420751,45
867,1,1649,655,994,0,0,0,1.0,1,1.0,1,1.0,1,0.10515238182540386,44
868,8,1657,658,999,0,0,0,1.0,1,1.0,1,1.0,1,0.12158687686917478,45
869,5,1662,662,1000,0,0,0,1.0,1,1.0,1,1.0,1,0.08715378051078819,44
870,3,1665,664,1001,0,0,0,1.0,1,1.0,1,1.0,1,0.08724466933195782,44
871,1,1666,664,1002,0,0,0,1.0,1,1.0,1,1.0,1,0.09339011405843882,43
872,0,1666,664,1002,0,0,0,1.0,1,1.0,1,1.0,1,0.09339011405843882,43
873,3,1669,665,1004,0,0,0,1.0,1,1.0,1,1.0,1,0.1007349150120971,43
874,4,1673,666,1007,0,0,0,1.0,1,1.0,1,1.0,1,0.14320643022653654,46
875,2,1675,667,1008,0,0,0,1.0,1,1.0,1,1.0,1,0.16013766673950586,43
876,3,1678,668,1010,0,0,0,1.0,1,1.0,1,1.0,1,0.10987546970166003,44
877,3,1681,669,1012,0,0,0,1.0,1,1.0,1,1.0,1,0.10242096200682911,44
878,0,1681,669,1012,0,0,0,1.0,1,1.0,1,1.0,1,0.10242096200682911,44
879,1,1682,670,1012,0,0,0,1.0,1,1.0,1,1.0,1,0.11741966756989149,44
880,2,1684,672,1012,0,0,0,1.0,1,1.0,1,1.0,1,0.15565883892091312,44
881,2,1686,673,1013,0,0,0,1.0,1,1.0,1,1.0,1,0.15158449902910623,43
882,2,1688,674,1014,0,0,0,1.0,1,1.0,1,1.0,1,0.1348393396055944,45
883,3,1691,675,1016,0,0,0,1.0,1,1.0,1,1.0,1,0.11552503366915919,45
884,3,1694,676,1018,0,0,0,1.0,1,1.0,1,1.0,1,0.11305477166311449,45
885,1,1695,677,1018,0,0,0,1.0,1,1.0,1,1.0,1,0.08570093128810972,43
886,4,1699,679,1020,0,0,0,1.0,1,1.0,1,1.0,1,0.10635047545331351,43
887,2,1701,680,1021,0,0,0,1.0,1,1.0,1,1.0,1,0.11672072200196426,41
888,1,1702,680,1022,0,0,0,1.0,1,1.0,1,1.0,1,0.15894099142813978,40
889,0,1702,680,1022,0,0,0,1.0,1,1.0,1,1.0,1,0.15894099142813978,40
890,1,1703,681,1022,0,0,0,1.0,1,1.0,1,1.0,1,0.1495250655458709,38
891,1,1704,681,1023,0,0,0,1.0,1,1.0,1,1.0,1,0.17405884845358624,39
892,0,1704,681,1023,0,0,0,1.0,1,1.0,1,1.0,1,0.17300478550963225,39
893,2,1706,682,1024,0,0,0,1.0,1,1.0,1,1.0,1,0.14852293551879828,37
894,2,1708,684,1024,0,0,0,1.0,1,1.0,1,1.0,1,0.23199724695543109,36
895,3,1711,684,1027,0,0,0,1.0,1,1.0,1,1.0,1,0.17942538451413065,37
896,2,1713,686,1027,0,0,0,1.0,1,1.0,1,1.0,1,0.24060306664810974,36
897,4,1717,688,1029,0,0,0,1.0,1,1.0,1,1.0,1,0.1768556713126404,36
898,0,1717,688,1029,0,0,0,1.0,1,1.0,1,1.0,1,0.19037044136017353,35
899,2,1719,689,1030,0,0,0,1.0,1,1.0,1,1.0,1,0.19698576348285196,35
900,2,1721,690,1031,0,0,0,1.0,1,1.0,1,1.0,1,0.248781800190503,36
901,2,1723,691,1032,0,0,0,1.0,1,1.0,1,1.0,1,0.23742022719332068,36
902,3,1726,694,1032,0,0,0,1.0,1,1.0,1,1.0,1,0.3005902379562354,36
903,4,1730,695,1035,0,0,0,1.0,1,1.0,1,1.0,1,0.2355167336381817,35
904,4,1734,696,1038,0,0,0,1.0,1,1.0,1,1.0,1,0.1903134714832618,37
905,0,1734,696,1038,0,0,0,1.0,1,1.0,1,1.0,1,0.1729886027461475,36
906,1,1735,697,1038,0,0,0,1.0,1,1.0,1,1.0,1,0.18656657903811905,37
907,4,1739,698,1041,0,0,0,1.0,1,1.0,1,1.0,1,0.09756985613765495,37
908,4,1743,701,1042,0,0,0,1.0,1,1.0,1,1.0,1,0.17082725000399984,36
909,0,1743,701,1042,0,0,0,1.0,1,1.0,1,1.0,1,0.16329834166003387,36
910,4,1747,702,1045,0,0,0,1.0,1,1.0,1,1.0,1,0.15950642694194,37
911,4,1751,703,1048,0,0,0,1.0,1,1.0,1,1.0,1,0.12524657169239764,36
912,1,1752,704,1048,0,0,0,1.0,1,1.0,1,1.0,1,0.12473722651624757,34
913,2,1754,705,1049,0,0,0,1.0,1,1.0,1,1.0,1,0.17168830785297845,34
914,1,1755,705,1050,0,0,0,1.0,1,1.0,1,1.0,1,0.18910181175826116,33
915,2,1757,705,1052,0,0,0,1.0,1,1.0,1,1.0,1,0.14594050463684313,33
916,0,1757,705,1052,0,0,0,1.0,1,1.0,1,1.0,1,0.16863456891385553,34
917,2,1759,706,1053,0,0,0,1.0,1,1.0,1,1.0,1,0.15610955942632426,34
918,2,1761,706,1055,0,0,0,1.0,1,1.0,1,1.0,1,0.11915853047666011,36
919,0,1761,706,1055,0,0,0,1.0,1,1.0,1,1.0,1,0.11915853047666011,36
920,1,1762,707,1055,0,0,0,1.0,1,1.0,1,1.0,1,0.13499051437699316,37
921,1,1763,708,1055,0,0,0,1.0,1,1.0,1,1.0,1,0.14743378729407028,37
922,1,1764,708,1056,0,0,0,1.0,1,1.0,1,1.0,1,0.16213381049391656,38
923,2,1766,709,1057,0,0,0,1.0,1,1.0,1,1.0,1,0.1310420410113723,36
924,0,1766,709,1057,0,0,0,1.0,1,1.0,1,1.0,1,0.16502685827617786,35
925,5,1771,711,1060,0,0,0,1.0,1,1.0,1,1.0,1,0.16708348276089505,35
926,1,1772,712,1060,0,0,0,1.0,1,1.0,1,1.0,1,0.1735153288687443,34
927,1,1773,712,1061,0,0,0,1.0,1,1.0,1,1.0,1,0.19568322501350705,32
928,1,1774,712,1062,0,0,0,1.0,1,1.0,1,1.0,1,0.17436068974110477,32
929,3,1777,713,1064,0,0,0,1.0,1,1.0,1,1.0,1,0.18648346819027473,31
930,0,1777,713,1064,0,0,0,1.0,1,1.0,1,1.0,1,0.20645704530423403,30
931,4,1781,715,1066,0,0,0,1.0,1,1.0,1,1.0,1,0.22624564937119812,29
932,1,1782,715,1067,0,0,0,1.0,1,1.0,1,1.0,1,0.2084133662549365,29
933,2,1784,715,1069,0,0,0,1.0,1,1.0,1,1.0,1,0.15476898867578356,29
934,0,1784,715,1069,0,0,0,1.0,1,1.0,1,1.0,1,0.15476898867578356,29
935,1,1785,715,1070,0,0,0,1.0,1,1.0,1,1.0,1,0.1506295736619258,31
936,1,1786,716,1070,0,0,0,1.0,1,1.0,1,1.0,1,0.16651403615290025,31
937,5,1791,717,1074,0,0,0,1.0,1,1.0,1,1.0,1,0.12875338006592277,34
938,0,1791,717,1074,0,0,0,1.0,1,1.0,1,1.0,1,0.1523283417086374,33
939,5,1796,718,1078,0,0,0,1.0,1,1.0,1,1.0,1,0.14798154364441388,36
940,2,1798,718,1080,0,0,0,1.0,1,1.0,1,1.0,1,0.16813623447283396,36
941,1,1799,719,1080,0,0,0,1.0,1,1.0,1,1.0,1,0.18315913635771378,36
942,0,1799,719,1080,0,0,0,1.0,1,1.0,1,1.0,1,0.18315913635771378,36
943,4,1803,720,1083,0,0,0,1.0,1,1.0,1,1.0,1,0.08631295252701197,35
944,5,1808,723,1085,0,0,0,1.0,1,1.0,1,1.0,1,0.08087860168685519,35
945,1,1809,723,1086,0,0,0,1.0,1,1.0,1,1.0,1,0.11261545566320771,33
946,1,1810,724,1086,0,0,0,1.0,1,1.0,1,1.0,1,0.15662310023961834,36
947,4,1814,725,1089,0,0,0,1.0,1,1.0,1,1.0,1,0.12229187628148125,34
948,1,1815,726,1089,0,0,0,1.0,1,1.0,1,1.0,1,0.18266031943974892,33
949,1,1816,727,1089,0,0,0,1.0,1,1.0,1,1.0,1,0.24215116398715755,34
950,1,1817,727,1090,0,0,0,1.0,1,1.0,1,1.0,1,0.2655091689896146,33
951,0,1817,727,1090,0,0,0,1.0,1,1.0,1,1.0,1,0.2655091689896146,33
952,0,1817,727,1090,0,0,0,1.0,1,1.0,1,1.0,1,0.28129252345435224,32
953,1,1818,727,1091,0,0,0,1.0,1,1.0,1,1.0,1,0.2411763362901065,32
954,0,1818,727,1091,0,0,0,1.0,1,1.0,1,1.0,1,0.26291908454609825,31
955,1,1819,727,1092,0,0,0,1.0,1,1.0,1,1.0,1,0.2759413190565588,32
956,2,1821,728,1093,0,0,0,1.0,1,1.0,1,1.0,1,0.19777056932984816,32
957,1,1822,728,1094,0,0,0,1.0,1,1.0,1,1.0,1,0.1692508833390343,33
958,0,1822,728,1094,0,0,0,1.0,1,1.0,1,1.0,1,0.1788285440494412,35
959,1,1823,729,1094,0,0,0,1.0,1,1.0,1,1.0,1,0.20013131502770684,36
960,2,1825,729,1096,0,0,0,1.0,1,1.0,1,1.0,1,0.18310870320729009,38
961,5,1830,731,1099,0,0,0,1.0,1,1.0,1,1.0,1,0.2566051996776963,37
962,1,1831,732,1099,0,0,0,1.0,1,1.0,1,1.0,1,0.2879492802455348,35
963,1,1832,732,1100,0,0,0,1.0,1,1.0,1,1.0,1,0.26569925744169426,35
964,3,1835,732,1103,0,0,0,1.0,1,1.0,1,1.0,1,0.20401040531552317,34
965,1,1836,732,1104,0,0,0,1.0,1,1.0,1,1.0,1,0.19940785383610646,35
966,1,1837,733,1104,0,0,0,1.0,1,1.0,1,1.0,1,0.1629028097479489,34
967,3,1840,734,1106,0,0,0,1.0,1,1.0,1,1.0,1,0.162013553402207,35
968,1,1841,735,1106,0,0,0,1.0,1,1.0,1,1.0,1,0.13937125844612244,36
969,0,1841,735,1106,0,0,0,1.0,1,1.0,1,1.0,1,0.14659635462741752,35
970,0,1841,735,1106,0,0,0,1.0,1,1.0,1,1.0,1,0.1801513118100208,34
971,2,1843,735,1108,0,0,0,1.0,1,1.0,1,1.0,1,0.17813628996097827,35
972,1,1844,736,1108,0,0,0,1.0,1,1.0,1,1.0,1,0.16218469734501761,35
973,0,1844,736,1108,0,0,0,1.0,1,1.0,1,1.0,1,0.15765435969392994,36
974,1,1845,737,1108,0,0,0,1.0,1,1.0,1,1.0,1,0.18901154974576295,35
975,0,1845,737,1108,0,0,0,1.0,1,1.0,1,1.0,1,0.1670052553657411,36
976,1,1846,737,1109,0,0,0,1.0,1,1.0,1,1.0,1,0.18088388742661196,38
977,0,1846,737,1109,0,0,0,1.0,1,1.0,1,1.0,1,0.18088388742661196,38
978,0,1846,737,1109,0,0,0,1.0,1,1.0,1,1.0,1,0.18088388742661196,38
979,4,1850,737,1113,0,0,0,1.0,1,1.0,1,1.0,1,0.14590601659685984,39
980,3,1853,739,1114,0,0,0,1.0,1,1.0,1,1.0,1,0.18088196632732284,39
981,3,1856,741,1115,0,0,0,1.0,1,1.0,1,1.0,1,0.23280586793564614,40
982,5,1861,745,1116,0,0,0,1.0,1,1.0,1,1.0,1,0.2933692073069094,40
983,3,1864,745,1119,0,0,0,1.0,1,1.0,1,1.0,1,0.19513175603057298,38
984,3,1867,747,1120,0,0,0,1.0,1,1.0,1,1.0,1,0.1866959049748135,39
985,6,1873,749,1124,0,0,0,1.0,1,1.0,1,1.0,1,0.17621720206906527,38
986,3,1876,751,1125,0,0,0,1.0,1,1.0,1,1.0,1,0.1869564744174044,38
987,2,1878,751,1127,0,0,0,1.0,1,1.0,1,1.0,1,0.15056296114438658,38
988,2,1880,753,1127,0,0,0,1.0,1,1.0,1,1.0,1,0.19789096265085618,38
989,1,1881,753,1128,0,0,0,1.0,1,1.0,1,1.0,1,0.17619834643681084,38
990,2,1883,754,1129,0,0,0,1.0,1,1.0,1,1.0,1,0.1920692106134292,38
991,4,1887,755,1132,0,0,0,1.0,1,1.0,1,1.0,1,0.1786274657826294,40
992,0,1887,755,1132,0,0,0,1.0,1,1.0,1,1.0,1,0.17309889256586394,39
993,1,1888,755,1133,0,0,0,1.0,1,1.0,1,1.0,1,0.16706053998653075,38
994,1,1889,755,1134,0,0,0,1.0,1,1.0,1,1.0,1,0.18215414284027956,39
995,1,1890,755,1135,0,0,0,1.0,1,1.0,1,1.0,1,0.14637267865242223,41
996,0,1890,755,1135,0,0,0,1.0,1,1.0,1,1.0,1,0.14903416147547718,40
997,1,1891,755,1136,0,0,0,1.0,1,1.0,1,1.0,1,0.1506909919182434,41
998,0,1891,755,1136,0,0,0,1.0,1,1.0,1,1.0,1,0.1730452986429437,40
999,2,1893,755,1138,0,0,0,1.0,1,1.0,1,1.0,1,0.15330110828377244,40
1000,1,1894,756,1138,0,0,0,1.0,1,1.0,1,1.0,1,0.16836904336715355,40
1001,0,1894,756,1138,0,0,0,1.0,1,1.0,1,1.0,1,0.16653130947625375,39
1002,0,1894,756,1138,0,0,0,1.0,1,1.0,1,1.0,1,0.16653130947625375,39
1003,0,1894,756,1138,0,0,0,1.0,1,1.0,1,1.0,1,0.16653130947625375,39
1004,0,1894,756,1138,0,0,0,1.0,1,1.0,1,1.0,1,0.16653130947625375,39
1005,1,1895,756,1139,0,0,0,1.0,1,1.0,1,1.0,1,0.14636625402329903,40
1006,4,1899,756,1143,0,0,0,1.0,1,1.0,1,1.0,1,0.12674180355131517,41
1007,2,1901,756,1145,0,0,0,1.0,1,1.0,1,1.0,1,0.11021126440811126,42
1008,5,1906,758,1148,0,0,0,1.0,1,1.0,1,1.0,1,0.13769717185712974,43
1009,0,1906,758,1148,0,0,0,1.0,1,1.0,1,1.0,1,0.1408162111767477,44
1010,0,1906,758,1148,0,0,0,1.0,1,1.0,1,1.0,1,0.1408162111767477,44
1011,0,1906,758,1148,0,0,0,1.0,1,1.0,1,1.0,1,0.1408162111767477,44
1012,3,1909,760,1149,0,0,0,1.0,1,1.0,1,1.0,1,0.15258160350092212,46
1013,1,1910,760,1150,0,0,0,1.0,1,1.0,1,1.0,1,0.14364560879399424,46
1014,2,1912,761,1151,0,0,0,1.0,1,1.0,1,1.0,1,0.1622689800167086,46
1015,0,1912,761,1151,0,0,0,1.0,1,1.0,1,1.0,1,0.1622689800167086,46
1016,2,1914,762,1152,0,0,0,1.0,1,1.0,1,1.0,1,0.16511606361264541,47
1017,1,1915,762,1153,0,0,0,1.0,1,1.0,1,1.0,1,0.15720044265696448,47
1018,2,1917,763,1154,0,0,0,1.0,1,1.0,1,1.0,1,0.18226304509027128,48
1019,3,1920,764,1156,0,0,0,1.0,1,1.0,1,1.0,1,0.16563054897061258,49
1020,3,1923,764,1159,0,0,0,1.0,1,1.0,1,1.0,1,0.1683263637187466,51
1021,5,1928,765,1163,0,0,0,1.0,1,1.0,1,1.0,1,0.16302679963597244,51
1022,2,1930,766,1164,0,0,0,1.0,1,1.0,1,1.0,1,0.1334109605502946,52
1023,1,1931,766,1165,0,0,0,1.0,1,1.0,1,1.0,1,0.12994364287250074,52
1024,1,1932,767,1165,0,0,0,1.0,1,1.0,1,1.0,1,0.13818595635389103,52
1025,3,1935,767,1168,0,0,0,1.0,1,1.0,1,1.0,1,0.1339102824432181,54
1026,1,1936,767,1169,0,0,0,1.0,1,1.0,1,1.0,1,0.11597395162907598,54
1027,2,1938,768,1170,0,0,0,1.0,1,1.0,1,1.0,1,0.10639208196843664,55
1028,3,1941,768,1173,0,0,0,1.0,1,1.0,1,1.0,1,0.08040771725445627,56
1029,0,1941,768,1173,0,0,0,1.0,1,1.0,1,1.0,1,0.08040771725445627,56
1030,0,1941,768,1173,0,0,0,1.0,1,1.0,1,1.0,1,0.09637071092464494,57
1031,0,1941,768,1173,0,0,0,1.0,1,1.0,1,1.0,1,0.09597064355367761,58
1032,1,1942,769,1173,0,0,0,1.0,1,1.0,1,1.0,1,0.10588828038084011,58
1033,2,1944,770,1174,0,0,0,1.0,1,1.0,1,1.0,1,0.09306385099677039,57
1034,2,1946,772,1174,0,0,0,1.0,1,1.0,1,1.0,1,0.13433648681801585,57
1035,3,1949,774,1175,0,0,0,1.0,1,1.0,1,1.0,1,0.1550674611893509,57
1036,2,1951,775,1176,0,0,0,1.0,1,1.0,1,1.0,1,0.17056716280308526,59
1037,8,1959,777,1182,0,0,0,1.0,1,1.0,1,1.0,1,0.11865737593719297,57
1038,3,1962,779,1183,0,0,0,1.0,1,1.0,1,1.0,1,0.16138438669742075,59
1039,5,1967,783,1184,0,0,0,1.0,1,1.0,1,1.0,1,0.16450699691545886,57
1040,4,1971,784,1187,0,0,0,1.0,1,1.0,1,1.0,1,0.18555378250449442,56
1041,7,1978,785,1193,0,0,0,1.0,1,1.0,1,1.0,1,0.13505867336877875,54
1042,0,1978,785,1193,0,0,0,1.0,1,1.0,1,1.0,1,0.11658042928370914,52
1043,2,1980,785,1195,0,0,0,1.0,1,1.0,1,1.0,1,0.07942860908312434,52
1044,1,1981,786,1195,0,0,0,1.0,1,1.0,1,1.0,1,0.08006993344097017,50
1045,3,1984,787,1197,0,0,0,1.0,1,1.0,1,1.0,1,0.1010937444359881,51
1046,1,1985,788,1197,0,0,0,1.0,1,1.0,1,1.0,1,0.11097031156759253,50
1047,3,1988,788,1200,0,0,0,1.0,1,1.0,1,1.0,1,0.09281154692379512,50
1048,2,1990,790,1200,0,0,0,1.0,1,1.0,1,1.0,1,0.09233534360406016,50
1049,2,1992,791,1201,0,0,0,1.0,1,1.0,1,1.0,1,0.0786716840079712,50
1050,2,1994,791,1203,0,0,0,1.0,1,1.0,1,1.0,1,0.04414732919496186,50
1051,0,1994,791,1203,0,0,0,1.0,1,1.0,1,1.0,1,0.042895834117491656,50
1052,0,1994,791,1203,0,0,0,1.0,1,1.0,1,1.0,1,0.06070401337658214,51
1053,0,1994,791,1203,0,0,0,1.0,1,1.0,1,1.0,1,0.06070401337658214,51
1054,0,1994,791,1203,0,0,0,1.0,1,1.0,1,1.0,1,0.06856970557452204,53
1055,1,1995,791,1204,0,0,0,1.0,1,1.0,1,1.0,1,0.07140038646781148,54
1056,0,1995,791,1204,0,0,0,1.0,1,1.0,1,1.0,1,0.09854747501196762,54
1057,5,2000,793,1207,0,0,0,1.0,1,1.0,1,1.0,1,0.10436438173571307,55
1058,0,2000,793,1207,0,0,0,1.0,1,1.0,1,1.0,1,0.10652908943357951,54
1059,5,2005,795,1210,0,0,0,1.0,1,1.0,1,1.0,1,0.14729732006750615,53
1060,2,2007,795,1212,0,0,0,1.0,1,1.0,1,1.0,1,0.11261929188815548,53
1061,1,2008,796,1212,0,0,0,1.0,1,1.0,1,1.0,1,0.15751987331332917,53
1062,6,2014,801,1213,0,0,0,1.0,1,1.0,1,1.0,1,0.1624393992700377,54
1063,5,2019,801,1218,0,0,0,1.0,1,1.0,1,1.0,1,0.1410220328005773,53
1064,3,2022,801,1221,0,0,0,1.0,1,1.0,1,1.0,1,0.1331269519535086,55
1065,2,2024,801,1223,0,0,0,1.0,1,1.0,1,1.0,1,0.1530350285297648,54
1066,3,2027,802,1225,0,0,0,1.0,1,1.0,1,1.0,1,0.12173151124003434,55
1067,5,2032,803,1229,0,0,0,1.0,1,1.0,1,1.0,1,0.10555007868736657,55
1068,1,2033,804,1229,0,0,0,1.0,1,1.0,1,1.0,1,0.11076009702746574,55
1069,2,2035,805,1230,0,0,0,1.0,1,1.0,1,1.0,1,0.1264914272191391,55
1070,0,2035,805,1230,0,0,0,1.0,1,1.0,1,1.0,1,0.1361757227966921,54
1071,5,2040,806,1234,0,0,0,1.0,1,1.0,1,1.0,1,0.12042186157920158,55
1072,1,2041,807,1234,0,0,0,1.0,1,1.0,1,1.0,1,0.11243207109685233,54
1073,2,2043,808,1235,0,0,0,1.0,1,1.0,1,1.0,1,0.11248846589936708,54
1074,1,2044,809,1235,0,0,0,1.0,1,1.0,1,1.0,1,0.12051132641818194,52
1075,1,2045,809,1236,0,0,0,1.0,1,1.0,1,1.0,1,0.1333516779878075,51
1076,1,2046,809,1237,0,0,0,1.0,1,1.0,1,1.0,1,0.14238403580888326,52
1077,5,2051,810,1241,0,0,0,1.0,1,1.0,1,1.0,1,0.07234567444530624,49
1078,3,2054,813,1241,0,0,0,1.0,1,1.0,1,1.0,1,0.1566855194628472,48
1079,4,2058,815,1243,0,0,0,1.0,1,1.0,1,1.0,1,0.16011042748269289,47
1080,2,2060,817,1243,0,0,0,1.0,1,1.0,1,1.0,1,0.16202634227030138,47
1081,1,2061,818,1243,0,0,0,1.0,1,1.0,1,1.0,1,0.20537143025266305,45
1082,0,2061,818,1243,0,0,0,1.0,1,1.0,1,1.0,1,0.19025873047273104,42
1083,1,2062,819,1243,0,0,0,1.0,1,1.0,1,1.0,1,0.24160760393053918,42
1084,1,2063,819,1244,0,0,0,1.0,1,1.0,1,1.0,1,0.24267375478250056,40
1085,1,2064,819,1245,0,0,0,1.0,1,1.0,1,1.0,1,0.2048170157473512,43
1086,2,2066,819,1247,0,0,0,1.0,1,1.0,1,1.0,1,0.17401971013474385,41
1087,3,2069,820,1249,0,0,0,1.0,1,1.0,1,1.0,1,0.17728785058475793,41
1088,1,2070,820,1250,0,0,0,1.0,1,1.0,1,1.0,1,0.14384103514902957,41
1089,2,2072,822,1250,0,0,0,1.0,1,1.0,1,1.0,1,0.14879713509883943,42
1090,1,2073,822,1251,0,0,0,1.0,1,1.0,1,1.0,1,0.13814344736523956,43
1091,1,2074,823,1251,0,0,0,1.0,1,1.0,1,1.0,1,0.14433743148558692,43
1092,1,2075,824,1251,0,0,0,1.0,1,1.0,1,1.0,1,0.13016030129770156,43
1093,2,2077,826,1251,0,0,0,1.0,1,1.0,1,1.0,1,0.17522363897300156,43
1094,1,2078,827,1251,0,0,0,1.0,1,1.0,1,1.0,1,0.1853964157843052,43
1095,2,2080,827,1253,0,0,0,1.0,1,1.0,1,1.0,1,0.18056511273266918,44
1096,1,2081,828,1253,0,0,0,1.0,1,1.0,1,1.0,1,0.18181880059997726,44
1097,4,2085,830,1255,0,0,0,1.0,1,1.0,1,1.0,1,0.23713852274805947,45
1098,0,2085,830,1255,0,0,0,1.0,1,1.0,1,1.0,1,0.23633644459519482,46
1099,4,2089,830,1259,0,0,0,1.0,1,1.0,1,1.0,1,0.18696811929111776,48
1100,1,2090,830,1260,0,0,0,1.0,1,1.0,1,1.0,1,0.1684898075605262,49
1101,2,2092,831,1261,0,0,0,1.0,1,1.0,1,1.0,1,0.15037114866819662,49
1102,5,2097,833,1264,0,0,0,1.0,1,1.0,1,1.0,1,0.1465724725030955,50
1103,2,2099,834,1265,0,0,0,1.0,1,1.0,1,1.0,1,0.1452173945221738,48
1104,2,2101,836,1265,0,0,0,1.0,1,1.0,1,1.0,1,0.12177838818340136,50
1105,2,2103,837,1266,0,0,0,1.0,1,1.0,1,1.0,1,0.10424028004668137,48
1106,2,2105,839,1266,0,0,0,1.0,1,1.0,1,1.0,1,0.11350536089485773,48
1107,6,2111,842,1269,0,0,0,1.0,1,1.0,1,1.0,1,0.05868260237503705,47
1108,2,2113,843,1270,0,0,0,1.0,1,1.0,1,1.0,1,0.08902928819289,47
1109,5,2118,845,1273,0,0,0,1.0,1,1.0,1,1.0,1,0.05046123806130312,46
1110,2,2120,847,1273,0,0,0,1.0,1,1.0,1,1.0,1,0.09622294448526832,43
1111,4,2124,849,1275,0,0,0,1.0,1,1.0,1,1.0,1,0.13285143247970713,44
1112,2,2126,850,1276,0,0,0,1.0,1,1.0,1,1.0,1,0.1509717657874559,43
1113,4,2130,851,1279,0,0,0,1.0,1,1.0,1,1.0,1,0.1603007633772719,39
1114,1,2131,852,1279,0,0,0,1.0,1,1.0,1,1.0,1,0.14562572482639777,39
1115,1,2132,853,1279,0,0,0,1.0,1,1.0,1,1.0,1,0.12739627931070535,37
1116,1,2133,854,1279,0,0,0,1.0,1,1.0,1,1.0,1,0.13176526661609783,37
1117,2,2135,855,1280,0,0,0,1.0,1,1.0,1,1.0,1,0.1458308476772979,36
1118,1,2136,855,1281,0,0,0,1.0,1,1.0,1,1.0,1,0.11901779064010852,36
1119,0,2136,855,1281,0,0,0,1.0,1,1.0,1,1.0,1,0.11901779064010852,36
1120,0,2136,855,1281,0,0,0,1.0,1,1.0,1,1.0,1,0.11901779064010852,36
1121,1,2137,856,1281,0,0,0,1.0,1,1.0,1,1.0,1,0.14327548688678746,36
1122,0,2137,856,1281,0,0,0,1.0,1,1.0,1,1.0,1,0.17114614754015905,37
1123,3,2140,857,1283,0,0,0,1.0,1,1.0,1,1.0,1,0.16372092799625815,37
1124,1,2141,858,1283,0,0,0,1.0,1,1.0,1,1.0,1,0.16706437492504372,37
1125,3,2144,859,1285,0,0,0,1.0,1,1.0,1,1.0,1,0.1909544485532689,38
1126,3,2147,860,1287,0,0,0,1.0,1,1.0,1,1.0,1,0.1655063332641121,38
1127,4,2151,861,1290,0,0,0,1.0,1,1.0,1,1.0,1,0.11988427311647942,39
1128,0,2151,861,1290,0,0,0,1.0,1,1.0,1,1.0,1,0.11988427311647942,39
1129,1,2152,861,1291,0,0,0,1.0,1,1.0,1,1.0,1,0.1043241461078091,39
1130,2,2154,862,1292,0,0,0,1.0,1,1.0,1,1.0,1,0.12618543900620635,39
1131,0,2154,862,1292,0,0,0,1.0,1,1.0,1,1.0,1,0.12618543900620635,39
1132,0,2154,862,1292,0,0,0,1.0,1,1.0,1,1.0,1,0.12618543900620635,39
1133,0,2154,862,1292,0,0,0,1.0,1,1.0,1,1.0,1,0.11968423898758661,42
1134,0,2154,862,1292,0,0,0,1.0,1,1.0,1,1.0,1,0.11968423898758661,42
1135,1,2155,862,1293,0,0,0,1.0,1,1.0,1,1.0,1,0.15626788549659767,44
1136,6,2161,863,1298,0,0,0,1.0,1,1.0,1,1.0,1,0.13110207097983262,46
1137,0,2161,863,1298,0,0,0,1.0,1,1.0,1,1.0,1,0.1514499325807738,45
1138,1,2162,864,1298,0,0,0,1.0,1,1.0,1,1.0,1,0.16030958436396162,46
1139,3,2165,865,1300,0,0,0,1.0,1,1.0,1,1.0,1,0.17229176008482075,47
1140,0,2165,865,1300,0,0,0,1.0,1,1.0,1,1.0,1,0.1645946759187939,46
1141,3,2168,865,1303,0,0,0,1.0,1,1.0,1,1.0,1,0.1499475012087455,45
1142,3,2171,867,1304,0,0,0,1.0,1,1.0,1,1.0,1,0.13445698125096603,45
1143,5,2176,869,1307,0,0,0,1.0,1,1.0,1,1.0,1,0.1979326797970266,43
1144,3,2179,872,1307,0,0,0,1.0,1,1.0,1,1.0,1,0.1989085841869862,45
1145,8,2187,874,1313,0,0,0,1.0,1,1.0,1,1.0,1,0.10650779301084663,44
1146,5,2192,876,1316,0,0,0,1.0,1,1.0,1,1.0,1,0.15134186474944897,45
1147,5,2197,878,1319,0,0,0,1.0,1,1.0,1,1.0,1,0.10157096971184272,44
1148,2,2199,879,1320,0,0,0,1.0,1,1.0,1,1.0,1,0.10982275892395378,43
1149,7,2206,881,1325,0,0,0,1.0,1,1.0,1,1.0,1,0.14526278136795456,42
1150,2,2208,881,1327,0,0,0,1.0,1,1.0,1,1.0,1,0.15000978275613833,45
1151,0,2208,881,1327,0,0,0,1.0,1,1.0,1,1.0,1,0.17521169973239217,40
1152,2,2210,882,1328,0,0,0,1.0,1,1.0,1,1.0,1,0.1394371885731117,41
1153,1,2211,883,1328,0,0,0,1.0,1,1.0,1,1.0,1,0.1813569996891266,38
1154,2,2213,885,1328,0,0,0,1.0,1,1.0,1,1.0,1,0.1803870498924145,37
1155,7,2220,887,1333,0,0,0,1.0,1,1.0,1,1.0,1,0.14702664968546625,38
1156,3,2223,887,1336,0,0,0,1.0,1,1.0,1,1.0,1,0.1685580115289345,38
1157,2,2225,887,1338,0,0,0,1.0,1,1.0,1,1.0,1,0.1387456165506573,37
1158,0,2225,887,1338,0,0,0,1.0,1,1.0,1,1.0,1,0.16685846711900523,36
1159,0,2225,887,1338,0,0,0,1.0,1,1.0,1,1.0,1,0.1801022998283818,35
1160,1,2226,888,1338,0,0,0,1.0,1,1.0,1,1.0,1,0.1719053422608042,35
1161,1,2227,888,1339,0,0,0,1.0,1,1.0,1,1.0,1,0.16511388370519475,36
1162,0,2227,888,1339,0,0,0,1.0,1,1.0,1,1.0,1,0.1676691439890185,37
1163,0,2227,888,1339,0,0,0,1.0,1,1.0,1,1.0,1,0.1676691439890185,37
1164,0,2227,888,1339,0,0,0,1.0,1,1.0,1,1.0,1,0.15544423209992694,38
1165,1,2228,888,1340,0,0,0,1.0,1,1.0,1,1.0,1,0.14572370769699214,38
1166,1,2229,888,1341,0,0,0,1.0,1,1.0,1,1.0,1,0.17130007349356266,40
1167,3,2232,890,1342,0,0,0,1.0,1,1.0,1,1.0,1,0.18568517841722446,40
1168,1,2233,890,1343,0,0,0,1.0,1,1.0,1,1.0,1,0.14688935696876426,40
1169,5,2238,891,1347,0,0,0,1.0,1,1.0,1,1.0,1,0.12044315667300763,41
1170,2,2240,892,1348,0,0,0,1.0,1,1.0,1,1.0,1,0.08292563545040922,41
1171,2,2242,893,1349,0,0,0,1.0,1,1.0,1,1.0,1,0.11337064897575545,43
1172,1,2243,894,1349,0,0,0,1.0,1,1.0,1,1.0,1,0.08992383641495322,43
1173,0,2243,894,1349,0,0,0,1.0,1,1.0,1,1.0,1,0.08992383641495322,43
1174,0,2243,894,1349,0,0,0,1.0,1,1.0,1,1.0,1,0.08992383641495322,43
1175,0,2243,894,1349,0,0,0,1.0,1,1.0,1,1.0,1,0.10646143405925111,44
1176,1,2244,895,1349,0,0,0,1.0,1,1.0,1,1.0,1,0.1439597821008281,45
1177,0,2244,895,1349,0,0,0,1.0,1,1.0,1,1.0,1,0.1439597821008281,45
1178,1,2245,896,1349,0,0,0,1.0,1,1.0,1,1.0,1,0.15041659486752443,45
1179,2,2247,897,1350,0,0,0,1.0,1,1.0,1,1.0,1,0.17321167931921336,46
1180,1,2248,897,1351,0,0,0,1.0,1,1.0,1,1.0,1,0.15591711512123255,47
1181,3,2251,897,1354,0,0,0,1.0,1,1.0,1,1.0,1,0.1437412705012941,48
1182,1,2252,898,1354,0,0,0,1.0,1,1.0,1,1.0,1,0.1466913765739752,48
1183,1,2253,898,1355,0,0,0,1.0,1,1.0,1,1.0,1,0.12276936115702507,46
1184,3,2256,900,1356,0,0,0,1.0,1,1.0,1,1.0,1,0.11546009356390605,47
1185,2,2258,901,1357,0,0,0,1.0,1,1.0,1,1.0,1,0.12704538468798326,44
1186,2,2260,901,1359,0,0,0,1.0,1,1.0,1,1.0,1,0.12863945074569433,47
1187,3,2263,902,1361,0,0,0,1.0,1,1.0,1,1.0,1,0.1480894896996326,49
1188,1,2264,903,1361,0,0,0,1.0,1,1.0,1,1.0,1,0.1516719068899106,50
1189,0,2264,903,1361,0,0,0,1.0,1,1.0,1,1.0,1,0.1423702715004557,48
1190,2,2266,903,1363,0,0,0,1.0,1,1.0,1,1.0,1,0.1599747400573996,48
1191,0,2266,903,1363,0,0,0,1.0,1,1.0,1,1.0,1,0.16427401586827647,46
1192,1,2267,904,1363,0,0,0,1.0,1,1.0,1,1.0,1,0.18819497696383403,46
1193,1,2268,904,1364,0,0,0,1.0,1,1.0,1,1.0,1,0.1654471142814754,45
1194,0,2268,904,1364,0,0,0,1.0,1,1.0,1,1.0,1,0.1654471142814754,45
1195,4,2272,905,1367,0,0,0,1.0,1,1.0,1,1.0,1,0.1580543401705745,47
1196,1,2273,905,1368,0,0,0,1.0,1,1.0,1,1.0,1,0.15479594061623597,48
1197,3,2276,905,1371,0,0,0,1.0,1,1.0,1,1.0,1,0.11013766651069752,49
1198,1,2277,905,1372,0,0,0,1.0,1,1.0,1,1.0,1,0.1153772893536124,49
1199,1,2278,905,1373,0,0,0,1.0,1,1.0,1,1.0,1,0.12972320045041666,50
1200,1,2279,906,1373,0,0,0,1.0,1,1.0,1,1.0,1,0.1264503293596705,50
1201,1,2280,906,1374,0,0,0,1.0,1,1.0,1,1.0,1,0.09970316460342783,50
1202,1,2281,907,1374,0,0,0,1.0,1,1.0,1,1.0,1,0.11057241566792149,51
1203,0,2281,907,1374,0,0,0,1.0,1,1.0,1,1.0,1,0.10865479316098867,52
1204,0,2281,907,1374,0,0,0,1.0,1,1.0,1,1.0,1,0.10865479316098867,52
1205,2,2283,908,1375,0,0,0,1.0,1,1.0,1,1.0,1,0.14954563242616079,53
1206,1,2284,908,1376,0,0,0,1.0,1,1.0,1,1.0,1,0.14215635573814095,53
1207,2,2286,908,1378,0,0,0,1.0,1,1.0,1,1.0,1,0.1336475428534804,55
1208,2,2288,908,1380,0,0,0,1.0,1,1.0,1,1.0,1,0.12971752321858215,56
1209,3,2291,908,1383,0,0,0,1.0,1,1.0,1,1.0,1,0.09433258343020548,55
1210,1,2292,908,1384,0,0,0,1.0,1,1.0,1,1.0,1,0.08443514128217917,55
1211,1,2293,908,1385,0,0,0,1.0,1,1.0,1,1.0,1,0.0543752152626994,57
1212,1,2294,909,1385,0,0,0,1.0,1,1.0,1,1.0,1,0.05802500783817889,57
1213,0,2294,909,1385,0,0,0,1.0,1,1.0,1,1.0,1,0.05802500783817889,57
1214,2,2296,911,1385,0,0,0,1.0,1,1.0,1,1.0,1,0.11023924355443714,57
1215,3,2299,911,1388,0,0,0,1.0,1,1.0,1,1.0,1,0.08363618761680756,59
1216,0,2299,911,1388,0,0,0,1.0,1,1.0,1,1.0,1,0.09441096279412976,61
1217,2,2301,912,1389,0,0,0,1.0,1,1.0,1,1.0,1,0.12075490550129082,61
1218,1,2302,913,1389,0,0,0,1.0,1,1.0,1,1.0,1,0.1474770219247293,61
1219,3,2305,914,1391,0,0,0,1.0,1,1.0,1,1.0,1,0.12265138509471375,61
1220,1,2306,914,1392,0,0,0,1.0,1,1.0,1,1.0,1,0.12881686144503735,60
1221,5,2311,915,1396,0,0,0,1.0,1,1.0,1,1.0,1,0.1198333681227439,61
1222,4,2315,917,1398,0,0,0,1.0,1,1.0,1,1.0,1,0.11396362091762743,61
1223,3,2318,917,1401,0,0,0,1.0,1,1.0,1,1.0,1,0.07952364763896248,59
1224,3,2321,919,1402,0,0,0,1.0,1,1.0,1,1.0,1,0.08167925143813402,60
1225,2,2323,919,1404,0,0,0,1.0,1,1.0,1,1.0,1,0.10331119761926885,60
1226,6,2329,920,1409,0,0,0,1.0,1,1.0,1,1.0,1,0.09912966948268824,61
1227,1,2330,921,1409,0,0,0,1.0,1,1.0,1,1.0,1,0.08007002441712979,59
1228,3,2333,922,1411,0,0,0,1.0,1,1.0,1,1.0,1,0.09350069151646596,58
1229,3,2336,923,1413,0,0,0,1.0,1,1.0,1,1.0,1,0.08640526847542403,57
1230,3,2339,924,1415,0,0,0,1.0,1,1.0,1,1.0,1,0.07495883373181125,55
1231,1,2340,925,1415,0,0,0,1.0,1,1.0,1,1.0,1,0.0932725589260957,54
1232,5,2345,928,1417,0,0,0,1.0,1,1.0,1,1.0,1,0.12289207784843512,51
1233,4,2349,930,1419,0,0,0,1.0,1,1.0,1,1.0,1,0.13419004897746634,49
1234,3,2352,932,1420,0,0,0,1.0,1,1.0,1,1.0,1,0.17548239764062318,49
1235,4,2356,933,1423,0,0,0,1.0,1,1.0,1,1.0,1,0.14214832169002123,48
1236,4,2360,933,1427,0,0,0,1.0,1,1.0,1,1.0,1,0.11231937859928247,49
1237,3,2363,934,1429,0,0,0,1.0,1,1.0,1,1.0,1,0.1257971270579612,48
1238,0,2363,934,1429,0,0,0,1.0,1,1.0,1,1.0,1,0.1277377589329079,47
1239,0,2363,934,1429,0,0,0,1.0,1,1.0,1,1.0,1,0.11811510626210814,48
1240,2,2365,934,1431,0,0,0,1.0,1,1.0,1,1.0,1,0.1041111274327194,49
1241,2,2367,935,1432,0,0,0,1.0,1,1.0,1,1.0,1,0.08279005794540191,49
1242,0,2367,935,1432,0,0,0,1.0,1,1.0,1,1.0,1,0.09188239433297776,49
1243,2,2369,935,1434,0,0,0,1.0,1,1.0,1,1.0,1,0.07360422138009,50
1244,1,2370,936,1434,0,0,0,1.0,1,1.0,1,1.0,1,0.0994444533518522,50
1245,2,2372,937,1435,0,0,0,1.0,1,1.0,1,1.0,1,0.11267449087500567,51
1246,2,2374,937,1437,0,0,0,1.0,1,1.0,1,1.0,1,0.13300120549674582,52
1247,2,2376,937,1439,0,0,0,1.0,1,1.0,1,1.0,1,0.1116695225356612,52
1248,2,2378,939,1439,0,0,0,1.0,1,1.0,1,1.0,1,0.1541771807346291,51
1249,3,2381,941,1440,0,0,0,1.0,1,1.0,1,1.0,1,0.12345881002594652,51
1250,2,2383,943,1440,0,0,0,1.0,1,1.0,1,1.0,1,0.1183916111860086,51
1251,1,2384,943,1441,0,0,0,1.0,1,1.0,1,1.0,1,0.10906504883486451,53
1252,1,2385,944,1441,0,0,0,1.0,1,1.0,1,1.0,1,0.10974985840348019,52
1253,2,2387,944,1443,0,0,0,1.0,1,1.0,1,1.0,1,0.08901569326210058,52
1254,0,2387,944,1443,0,0,0,1.0,1,1.0,1,1.0,1,0.09392204024517847,53
1255,3,2390,945,1445,0,0,0,1.0,1,1.0,1,1.0,1,0.10702599774357713,55
1256,0,2390,945,1445,0,0,0,1.0,1,1.0,1,1.0,1,0.10702599774357713,55
1257,2,2392,945,1447,0,0,0,1.0,1,1.0,1,1.0,1,0.09130684636804735,57
1258,0,2392,945,1447,0,0,0,1.0,1,1.0,1,1.0,1,0.09121690341667582,57
1259,0,2392,945,1447,0,0,0,1.0,1,1.0,1,1.0,1,0.09121690341667582,57
1260,0,2392,945,1447,0,0,0,1.0,1,1.0,1,1.0,1,0.08735536190637758,56
1261,1,2393,945,1448,0,0,0,1.0,1,1.0,1,1.0,1,0.0838581119339297,57
1262,2,2395,946,1449,0,0,0,1.0,1,1.0,1,1.0,1,0.07901919738995986,58
1263,4,2399,948,1451,0,0,0,1.0,1,1.0,1,1.0,1,0.05644180597891794,58
1264,1,2400,949,1451,0,0,0,1.0,1,1.0,1,1.0,1,0.057261146353800536,57
1265,8,2408,955,1453,0,0,0,1.0,1,1.0,1,1.0,1,0.1507544914693566,56
1266,4,2412,957,1455,0,0,0,1.0,1,1.0,1,1.0,1,0.15387969445847607,55
1267,5,2417,958,1459,0,0,0,1.0,1,1.0,1,1.0,1,0.0967910959496152,53
1268,2,2419,960,1459,0,0,0,1.0,1,1.0,1,1.0,1,0.1384148744439128,52
1269,5,2424,961,1463,0,0,0,1.0,1,1.0,1,1.0,1,0.06481069410241645,51
1270,1,2425,961,1464,0,0,0,1.0,1,1.0,1,1.0,1,0.10051585330834792,47
1271,4,2429,962,1467,0,0,0,1.0,1,1.0,1,1.0,1,0.047622343077816535,46
1272,0,2429,962,1467,0,0,0,1.0,1,1.0,1,1.0,1,0.09580547352136605,43
1273,3,2432,963,1469,0,0,0,1.0,1,1.0,1,1.0,1,0.07254899767118964,44
1274,1,2433,964,1469,0,0,0,1.0,1,1.0,1,1.0,1,0.097754382033468,44
1275,2,2435,966,1469,0,0,0,1.0,1,1.0,1,1.0,1,0.15922972766448057,45
1276,2,2437,966,1471,0,0,0,1.0,1,1.0,1,1.0,1,0.11192995311978887,43
1277,3,2440,968,1472,0,0,0,1.0,1,1.0,1,1.0,1,0.10521698661368983,44
1278,5,2445,971,1474,0,0,0,1.0,1,1.0,1,1.0,1,0.12405673291243176,45
1279,4,2449,971,1478,0,0,0,1.0,1,1.0,1,1.0,1,0.10598776341372394,47
1280,4,2453,972,1481,0,0,0,1.0,1,1.0,1,1.0,1,0.11844846571814888,47
1281,1,2454,972,1482,0,0,0,1.0,1,1.0,1,1.0,1,0.10629586994402637,47
1282,0,2454,972,1482,0,0,0,1.0,1,1.0,1,1.0,1,0.10925573507905063,46
1283,2,2456,973,1483,0,0,0,1.0,1,1.0,1,1.0,1,0.09407550298674237,46
1284,0,2456,973,1483,0,0,0,1.0,1,1.0,1,1.0,1,0.09407550298674237,46
1285,2,2458,973,1485,0,0,0,1.0,1,1.0,1,1.0,1,0.09242528305718199,46
1286,1,2459,974,1485,0,0,0,1.0,1,1.0,1,1.0,1,0.15301779791104864,45
1287,4,2463,975,1488,0,0,0,1.0,1,1.0,1,1.0,1,0.15776761307831466,49
1288,0,2463,975,1488,0,0,0,1.0,1,1.0,1,1.0,1,0.15776761307831466,49
1289,3,2466,975,1491,0,0,0,1.0,1,1.0,1,1.0,1,0.12624485274221783,52
1290,1,2467,976,1491,0,0,0,1.0,1,1.0,1,1.0,1,0.12128427188768409,52
1291,1,2468,976,1492,0,0,0,1.0,1,1.0,1,1.0,1,0.11137012243525267,52
1292,1,2469,977,1492,0,0,0,1.0,1,1.0,1,1.0,1,0.10170536757899011,53
1293,0,2469,977,1492,0,0,0,1.0,1,1.0,1,1.0,1,0.10170536757899011,53
1294,0,2469,977,1492,0,0,0,1.0,1,1.0,1,1.0,1,0.10170536757899011,53
1295,0,2469,977,1492,0,0,0,1.0,1,1.0,1,1.0,1,0.11258342863448999,54
1296,2,2471,978,1493,0,0,0,1.0,1,1.0,1,1.0,1,0.08678175600456976,55
1297,1,2472,978,1494,0,0,0,1.0,1,1.0,1,1.0,1,0.10273679167707624,54
1298,2,2474,978,1496,0,0,0,1.0,1,1.0,1,1.0,1,0.09137338309630123,55
1299,1,2475,978,1497,0,0,0,1.0,1,1.0,1,1.0,1,0.08776966798364372,54
1300,0,2475,978,1497,0,0,0,1.0,1,1.0,1,1.0,1,0.1071991409065094,55
1301,4,2479,979,1500,0,0,0,1.0,1,1.0,1,1.0,1,0.11026591858813788,54
1302,4,2483,981,1502,0,0,0,1.0,1,1.0,1,1.0,1,0.14791917757966763,54
1303,9,2492,984,1508,0,0,0,1.0,1,1.0,1,1.0,1,0.16085796958565754,50
1304,5,2497,987,1510,0,0,0,1.0,1,1.0,1,1.0,1,0.1542138755293896,51
1305,9,2506,989,1517,0,0,0,1.0,1,1.0,1,1.0,1,0.10688219864745971,48
1306,2,2508,990,1518,0,0,0,1.0,1,1.0,1,1.0,1,0.155802842487248,48
1307,5,2513,991,1522,0,0,0,1.0,1,1.0,1,1.0,1,0.06946394608073908,48
1308,0,2513,991,1522,0,0,0,1.0,1,1.0,1,1.0,1,0.08985191322510136,46
1309,3,2516,993,1523,0,0,0,1.0,1,1.0,1,1.0,1,0.08779547489103517,47
1310,0,2516,993,1523,0,0,0,1.0,1,1.0,1,1.0,1,0.09956993893400165,46
1311,3,2519,996,1523,0,0,0,1.0,1,1.0,1,1.0,1,0.15949833396830876,46
1312,0,2519,996,1523,0,0,0,1.0,1,1.0,1,1.0,1,0.13841638013314791,45
1313,2,2521,997,1524,0,0,0,1.0,1,1.0,1,1.0,1,0.16691619127006505,44
1314,1,2522,998,1524,0,0,0,1.0,1,1.0,1,1.0,1,0.162128378216905,42
1315,1,2523,999,1524,0,0,0,1.0,1,1.0,1,1.0,1,0.1759859847317801,40
1316,2,2525,999,1526,0,0,0,1.0,1,1.0,1,1.0,1,0.1410029373601842,42
1317,1,2526,999,1527,0,0,0,1.0,1,1.0,1,1.0,1,0.12266327145290522,42
1318,0,2526,999,1527,0,0,0,1.0,1,1.0,1,1.0,1,0.12266327145290522,42
1319,1,2527,1000,1527,0,0,0,1.0,1,1.0,1,1.0,1,0.16756829659648012,42
1320,1,2528,1000,1528,0,0,0,1.0,1,1.0,1,1.0,1,0.1630596959008821,42
1321,2,2530,1000,1530,0,0,0,1.0,1,1.0,1,1.0,1,0.11646049642537329,45
1322,1,2531,1001,1530,0,0,0,1.0,1,1.0,1,1.0,1,0.10681822952337872,45
1323,1,2532,1002,1530,0,0,0,1.0,1,1.0,1,1.0,1,0.12651712580673047,46
1324,0,2532,1002,1530,0,0,0,1.0,1,1.0,1,1.0,1,0.12172370782017226,45
1325,2,2534,1003,1531,0,0,0,1.0,1,1.0,1,1.0,1,0.1368779205880991,46
1326,0,2534,1003,1531,0,0,0,1.0,1,1.0,1,1.0,1,0.13266251768226872,45
1327,1,2535,1003,1532,0,0,0,1.0,1,1.0,1,1.0,1,0.154075103145617,46
1328,1,2536,1003,1533,0,0,0,1.0,1,1.0,1,1.0,1,0.13404147317073076,47
1329,0,2536,1003,1533,0,0,0,1.0,1,1.0,1,1.0,1,0.13404147317073076,47
1330,0,2536,1003,1533,0,0,0,1.0,1,1.0,1,1.0,1,0.14898631149213623,46
1331,2,2538,1004,1534,0,0,0,1.0,1,1.0,1,1.0,1,0.12724555598886056,46
1332,2,2540,1005,1535,0,0,0,1.0,1,1.0,1,1.0,1,0.168574718114601,49
1333,4,2544,1005,1539,0,0,0,1.0,1,1.0,1,1.0,1,0.12122627846236414,50
1334,0,2544,1005,1539,0,0,0,1.0,1,1.0,1,1.0,1,0.12122627846236414,50
1335,1,2545,1006,1539,0,0,0,1.0,1,1.0,1,1.0,1,0.16327201578836395,52
1336,2,2547,1006,1541,0,0,0,1.0,1,1.0,1,1.0,1,0.1327069456013837,53
1337,1,2548,1007,1541,0,0,0,1.0,1,1.0,1,1.0,1,0.17347366778805293,54
1338,5,2553,1009,1544,0,0,0,1.0,1,1.0,1,1.0,1,0.1865921959530994,54
1339,2,2555,1010,1545,0,0,0,1.0,1,1.0,1,1.0,1,0.17374403812594874,54
1340,0,2555,1010,1545,0,0,0,1.0,1,1.0,1,1.0,1,0.15934405413840536,53
1341,0,2555,1010,1545,0,0,0,1.0,1,1.0,1,1.0,1,0.1738787953544213,53
1342,0,2555,1010,1545,0,0,0,1.0,1,1.0,1,1.0,1,0.17460232574854265,52
1343,1,2556,1011,1545,0,0,0,1.0,1,1.0,1,1.0,1,0.17923609095122814,50
1344,1,2557,1012,1545,0,0,0,1.0,1,1.0,1,1.0,1,0.20962486278366926,51
1345,4,2561,1012,1549,0,0,0,1.0,1,1.0,1,1.0,1,0.149432114549043,50
1346,3,2564,1015,1549,0,0,0,1.0,1,1.0,1,1.0,1,0.16579106119573006,50
1347,0,2564,1015,1549,0,0,0,1.0,1,1.0,1,1.0,1,0.12388517179600297,48
1348,1,2565,1015,1550,0,0,0,1.0,1,1.0,1,1.0,1,0.11077323519699009,49
1349,2,2567,1016,1551,0,0,0,1.0,1,1.0,1,1.0,1,0.11035255070711282,48
1350,1,2568,1017,1551,0,0,0,1.0,1,1.0,1,1.0,1,0.134894569305595,49
1351,0,2568,1017,1551,0,0,0,1.0,1,1.0,1,1.0,1,0.11373032909901641,48
1352,4,2572,1019,1553,0,0,0,1.0,1,1.0,1,1.0,1,0.09526328833370236,49
1353,1,2573,1019,1554,0,0,0,1.0,1,1.0,1,1.0,1,0.08492480997604152,49
1354,0,2573,1019,1554,0,0,0,1.0,1,1.0,1,1.0,1,0.08644439948690347,49
1355,0,2573,1019,1554,0,0,0,1.0,1,1.0,1,1.0,1,0.07704257001117555,50
1356,3,2576,1020,1556,0,0,0,1.0,1,1.0,1,1.0,1,0.07930007031522684,50
1357,4,2580,1022,1558,0,0,0,1.0,1,1.0,1,1.0,1,0.11622430720803861,50
1358,3,2583,1023,1560,0,0,0,1.0,1,1.0,1,1.0,1,0.13952210330400663,51
1359,7,2590,1024,1566,0,0,0,1.0,1,1.0,1,1.0,1,0.13601385841118194,53
1360,1,2591,1024,1567,0,0,0,1.0,1,1.0,1,1.0,1,0.1393667398174629,54
1361,6,2597,1024,1573,0,0,0,1.0,1,1.0,1,1.0,1,0.0906591404571509,54
1362,3,2600,1025,1575,0,0,0,1.0,1,1.0,1,1.0,1,0.08807461194279878,55
1363,2,2602,1025,1577,0,0,0,1.0,1,1.0,1,1.0,1,0.08044304994104196,55
1364,0,2602,1025,1577,0,0,0,1.0,1,1.0,1,1.0,1,0.11100884719706108,55
1365,3,2605,1027,1578,0,0,0,1.0,1,1.0,1,1.0,1,0.11935654846920371,56
1366,1,2606,1028,1578,0,0,0,1.0,1,1.0,1,1.0,1,0.1359090461430473,56
1367,2,2608,1028,1580,0,0,0,1.0,1,1.0,1,1.0,1,0.11452111855179806,56
1368,1,2609,1029,1580,0,0,0,1.0,1,1.0,1,1.0,1,0.13892265493874584,58
1369,2,2611,1029,1582,0,0,0,1.0,1,1.0,1,1.0,1,0.1070847595192113,59
1370,1,2612,1030,1582,0,0,0,1.0,1,1.0,1,1.0,1,0.09892647938556842,59
1371,1,2613,1030,1583,0,0,0,1.0,1,1.0,1,1.0,1,0.06973257543585958,59
1372,0,2613,1030,1583,0,0,0,1.0,1,1.0,1,1.0,1,0.06973257543585958,59
1373,0,2613,1030,1583,0,0,0,1.0,1,1.0,1,1.0,1,0.06973257543585958,59
1374,7,2620,1034,1586,0,0,0,1.0,1,1.0,1,1.0,1,0.08767315302988318,60
1375,3,2623,1035,1588,0,0,0,1.0,1,1.0,1,1.0,1,0.0773061305850297,61
1376,1,2624,1035,1589,0,0,0,1.0,1,1.0,1,1.0,1,0.0842065335584292,61
1377,1,2625,1036,1589,0,0,0,1.0,1,1.0,1,1.0,1,0.0955329661631463,61
1378,3,2628,1038,1590,0,0,0,1.0,1,1.0,1,1.0,1,0.14303280978828492,61
1379,0,2628,1038,1590,0,0,0,1.0,1,1.0,1,1.0,1,0.13618854676612965,60
1380,4,2632,1039,1593,0,0,0,1.0,1,1.0,1,1.0,1,0.135765489176757,60
1381,4,2636,1039,1597,0,0,0,1.0,1,1.0,1,1.0,1,0.08731730574375747,58
1382,4,2640,1043,1597,0,0,0,1.0,1,1.0,1,1.0,1,0.11946961734412276,58
1383,5,2645,1045,1600,0,0,0,1.0,1,1.0,1,1.0,1,0.0791926480146274,57
1384,3,2648,1048,1600,0,0,0,1.0,1,1.0,1,1.0,1,0.10630514204660765,54
1385,2,2650,1049,1601,0,0,0,1.0,1,1.0,1,1.0,1,0.10027312017859248,52
1386,2,2652,1049,1603,0,0,0,1.0,1,1.0,1,1.0,1,0.0841558784379817,51
1387,3,2655,1050,1605,0,0,0,1.0,1,1.0,1,1.0,1,0.08405461825612058,51
1388,2,2657,1052,1605,0,0,0,1.0,1,1.0,1,1.0,1,0.09102066668322475,52
1389,3,2660,1052,1608,0,0,0,1.0,1,1.0,1,1.0,1,0.1128369181372548,50
1390,4,2664,1054,1610,0,0,0,1.0,1,1.0,1,1.0,1,0.10454828844203924,51
1391,0,2664,1054,1610,0,0,0,1.0,1,1.0,1,1.0,1,0.11420292055534867,50
1392,4,2668,1055,1613,0,0,0,1.0,1,1.0,1,1.0,1,0.08971077921989079,50
1393,1,2669,1055,1614,0,0,0,1.0,1,1.0,1,1.0,1,0.10124056270387567,49
1394,2,2671,1057,1614,0,0,0,1.0,1,1.0,1,1.0,1,0.11419593955317123,50
1395,2,2673,1057,1616,0,0,0,1.0,1,1.0,1,1.0,1,0.10861807075148232,51
1396,1,2674,1058,1616,0,0,0,1.0,1,1.0,1,1.0,1,0.1361902441518917,52
1397,1,2675,1058,1617,0,0,0,1.0,1,1.0,1,1.0,1,0.12360990661109893,52
1398,1,2676,1059,1617,0,0,0,1.0,1,1.0,1,1.0,1,0.11844947247102698,53
1399,2,2678,1060,1618,0,0,0,1.0,1,1.0,1,1.0,1,0.15003825155122347,54
1400,3,2681,1061,1620,0,0,0,1.0,1,1.0,1,1.0,1,0.153125827381409,54
1401,2,2683,1063,1620,0,0,0,1.0,1,1.0,1,1.0,1,0.146697278368266,54
1402,1,2684,1064,1620,0,0,0,1.0,1,1.0,1,1.0,1,0.1681140957118834,53
1403,2,2686,1064,1622,0,0,0,1.0,1,1.0,1,1.0,1,0.1657804462755398,52
1404,1,2687,1064,1623,0,0,0,1.0,1,1.0,1,1.0,1,0.16394773712755578,53
1405,1,2688,1065,1623,0,0,0,1.0,1,1.0,1,1.0,1,0.21098913880991874,52
1406,0,2688,1065,1623,0,0,0,1.0,1,1.0,1,1.0,1,0.19677990400862871,53
1407,1,2689,1065,1624,0,0,0,1.0,1,1.0,1,1.0,1,0.19637261663163538,54
1408,0,2689,1065,1624,0,0,0,1.0,1,1.0,1,1.0,1,0.21749140020358412,53
1409,0,2689,1065,1624,0,0,0,1.0,1,1.0,1,1.0,1,0.21195669948560725,55
1410,0,2689,1065,1624,0,0,0,1.0,1,1.0,1,1.0,1,0.2161289763510237,54
1411,4,2693,1065,1628,0,0,0,1.0,1,1.0,1,1.0,1,0.20515174543909126,54
1412,0,2693,1065,1628,0,0,0,1.0,1,1.0,1,1.0,1,0.19508596154877825,53
1413,3,2696,1065,1631,0,0,0,1.0,1,1.0,1,1.0,1,0.16416301373121983,54
1414,1,2697,1065,1632,0,0,0,1.0,1,1.0,1,1.0,1,0.17255315315385217,55
1415,2,2699,1065,1634,0,0,0,1.0,1,1.0,1,1.0,1,0.12634173285094652,57
1416,5,2704,1066,1638,0,0,0,1.0,1,1.0,1,1.0,1,0.15108540251655087,59
1417,2,2706,1067,1639,0,0,0,1.0,1,1.0,1,1.0,1,0.1592205521835854,58
1418,2,2708,1068,1640,0,0,0,1.0,1,1.0,1,1.0,1,0.1545813773660937,57
1419,1,2709,1069,1640,0,0,0,1.0,1,1.0,1,1.0,1,0.17883353686732142,56
1420,4,2713,1070,1643,0,0,0,1.0,1,1.0,1,1.0,1,0.19161855386188362,54
1421,4,2717,1070,1647,0,0,0,1.0,1,1.0,1,1.0,1,0.14876505288270203,55
1422,0,2717,1070,1647,0,0,0,1.0,1,1.0,1,1.0,1,0.14504120328846495,52
1423,3,2720,1072,1648,0,0,0,1.0,1,1.0,1,1.0,1,0.16949329501743646,52
1424,2,2722,1074,1648,0,0,0,1.0,1,1.0,1,1.0,1,0.1492790078566156,51
1425,5,2727,1074,1653,0,0,0,1.0,1,1.0,1,1.0,1,0.11416059249669186,50
1426,2,2729,1075,1654,0,0,0,1.0,1,1.0,1,1.0,1,0.1300211422050395,50
1427,2,2731,1075,1656,0,0,0,1.0,1,1.0,1,1.0,1,0.12291145300811787,48
1428,2,2733,1077,1656,0,0,0,1.0,1,1.0,1,1.0,1,0.14007773380180052,48
1429,1,2734,1077,1657,0,0,0,1.0,1,1.0,1,1.0,1,0.13920268584182963,48
1430,0,2734,1077,1657,0,0,0,1.0,1,1.0,1,1.0,1,0.13920268584182963,48
1431,1,2735,1077,1658,0,0,0,1.0,1,1.0,1,1.0,1,0.13526876198812535,48
1432,1,2736,1077,1659,0,0,0,1.0,1,1.0,1,1.0,1,0.10915637290206338,50
1433,0,2736,1077,1659,0,0,0,1.0,1,1.0,1,1.0,1,0.09827245835609559,51
1434,3,2739,1080,1659,0,0,0,1.0,1,1.0,1,1.0,1,0.12735137284419779,51
1435,8,2747,1084,1663,0,0,0,1.0,1,1.0,1,1.0,1,0.0904523341757111,50
1436,5,2752,1086,1666,0,0,0,1.0,1,1.0,1,1.0,1,0.13735915702140625,51
1437,1,2753,1086,1667,0,0,0,1.0,1,1.0,1,1.0,1,0.12054804591643387,51
1438,1,2754,1087,1667,0,0,0,1.0,1,1.0,1,1.0,1,0.14157620964929044,51
1439,3,2757,1089,1668,0,0,0,1.0,1,1.0,1,1.0,1,0.1544347335608936,50
1440,5,2762,1090,1672,0,0,0,1.0,1,1.0,1,1.0,1,0.17227826283196263,51
1441,3,2765,1090,1675,0,0,0,1.0,1,1.0,1,1.0,1,0.16610296239322792,51
1442,4,2769,1091,1678,0,0,0,1.0,1,1.0,1,1.0,1,0.14901738717904847,52
1443,5,2774,1091,1683,0,0,0,1.0,1,1.0,1,1.0,1,0.1085913491172276,53
1444,0,2774,1091,1683,0,0,0,1.0,1,1.0,1,1.0,1,0.1214676861511372,54
1445,1,2775,1091,1684,0,0,0,1.0,1,1.0,1,1.0,1,0.09716133758694238,54
1446,2,2777,1091,1686,0,0,0,1.0,1,1.0,1,1.0,1,0.09190035543899873,54
1447,0,2777,1091,1686,0,0,0,1.0,1,1.0,1,1.0,1,0.08135297886677016,55
1448,0,2777,1091,1686,0,0,0,1.0,1,1.0,1,1.0,1,0.08135297886677016,55
1449,1,2778,1091,1687,0,0,0,1.0,1,1.0,1,1.0,1,0.07123636642889344,55
1450,1,2779,1091,1688,0,0,0,1.0,1,1.0,1,1.0,1,0.0760118703040875,57
1451,0,2779,1091,1688,0,0,0,1.0,1,1.0,1,1.0,1,0.0760118703040875,57
1452,0,2779,1091,1688,0,0,0,1.0,1,1.0,1,1.0,1,0.0760118703040875,57
1453,3,2782,1093,1689,0,0,0,1.0,1,1.0,1,1.0,1,0.12646929487548622,57
1454,3,2785,1094,1691,0,0,0,1.0,1,1.0,1,1.0,1,0.12811846303470056,58
1455,2,2787,1094,1693,0,0,0,1.0,1,1.0,1,1.0,1,0.10314422196499969,56
1456,2,2789,1095,1694,0,0,0,1.0,1,1.0,1,1.0,1,0.09790268255462203,55
1457,1,2790,1096,1694,0,0,0,1.0,1,1.0,1,1.0,1,0.1327452838467928,54
1458,3,2793,1097,1696,0,0,0,1.0,1,1.0,1,1.0,1,0.1009643519833737,53
1459,2,2795,1097,1698,0,0,0,1.0,1,1.0,1,1.0,1,0.09392441928448793,52
1460,0,2795,1097,1698,0,0,0,1.0,1,1.0,1,1.0,1,0.08508521793630028,51
1461,3,2798,1100,1698,0,0,0,1.0,1,1.0,1,1.0,1,0.09489062156788035,51
1462,2,2800,1102,1698,0,0,0,1.0,1,1.0,1,1.0,1,0.10067320265851763,51
1463,8,2808,1106,1702,0,0,0,1.0,1,1.0,1,1.0,1,0.13429742177783444,52
1464,3,2811,1109,1702,0,0,0,1.0,1,1.0,1,1.0,1,0.15974795789246418,52
1465,3,2814,1109,1705,0,0,0,1.0,1,1.0,1,1.0,1,0.1385221510195587,51
1466,4,2818,1112,1706,0,0,0,1.0,1,1.0,1,1.0,1,0.15162003075310967,50
1467,9,2827,1114,1713,0,0,0,1.0,1,1.0,1,1.0,1,0.13915401697946211,48
1468,6,2833,1117,1716,0,0,0,1.0,1,1.0,1,1.0,1,0.1359460475180342,48
1469,5,2838,1119,1719,0,0,0,1.0,1,1.0,1,1.0,1,0.1201409290919922,48
1470,0,2838,1119,1719,0,0,0,1.0,1,1.0,1,1.0,1,0.1201409290919922,48
1471,2,2840,1120,1720,0,0,0,1.0,1,1.0,1,1.0,1,0.15962071134050873,45
1472,1,2841,1120,1721,0,0,0,1.0,1,1.0,1,1.0,1,0.13475721359386522,45
1473,1,2842,1120,1722,0,0,0,1.0,1,1.0,1,1.0,1,0.11731952389119965,46
1474,3,2845,1120,1725,0,0,0,1.0,1,1.0,1,1.0,1,0.08767956204717135,46
1475,1,2846,1121,1725,0,0,0,1.0,1,1.0,1,1.0,1,0.08098657064838051,46
1476,1,2847,1122,1725,0,0,0,1.0,1,1.0,1,1.0,1,0.09525470233654064,47
1477,2,2849,1123,1726,0,0,0,1.0,1,1.0,1,1.0,1,0.08067902843581023,47
1478,0,2849,1123,1726,0,0,0,1.0,1,1.0,1,1.0,1,0.11087445957315935,47
1479,1,2850,1123,1727,0,0,0,1.0,1,1.0,1,1.0,1,0.09263779462528285,48
1480,1,2851,1124,1727,0,0,0,1.0,1,1.0,1,1.0,1,0.12081959754477761,47
1481,3,2854,1125,1729,0,0,0,1.0,1,1.0,1,1.0,1,0.1000090714488461,47
1482,1,2855,1126,1729,0,0,0,1.0,1,1.0,1,1.0,1,0.1178247239948679,46
1483,1,2856,1126,1730,0,0,0,1.0,1,1.0,1,1.0,1,0.10999017339002254,47
1484,1,2857,1126,1731,0,0,0,1.0,1,1.0,1,1.0,1,0.11866310652337697,47
1485,2,2859,1126,1733,0,0,0,1.0,1,1.0,1,1.0,1,0.14923054805579655,47
1486,2,2861,1127,1734,0,0,0,1.0,1,1.0,1,1.0,1,0.13691840730415256,49
1487,4,2865,1129,1736,0,0,0,1.0,1,1.0,1,1.0,1,0.09443192544808572,49
1488,2,2867,1130,1737,0,0,0,1.0,1,1.0,1,1.0,1,0.1000636277027062,51
1489,3,2870,1131,1739,0,0,0,1.0,1,1.0,1,1.0,1,0.11230607418528978,52
1490,2,2872,1132,1740,0,0,0,1.0,1,1.0,1,1.0,1,0.11650638156759337,52
1491,4,2876,1134,1742,0,0,0,1.0,1,1.0,1,1.0,1,0.12829942201334,53
1492,6,2882,1137,1745,0,0,0,1.0,1,1.0,1,1.0,1,0.17792104769683448,53
1493,5,2887,1139,1748,0,0,0,1.0,1,1.0,1,1.0,1,0.14403510070351183,52
1494,2,2889,1140,1749,0,0,0,1.0,1,1.0,1,1.0,1,0.11836695816899473,50
1495,1,2890,1141,1749,0,0,0,1.0,1,1.0,1,1.0,1,0.11916128733619843,50
1496,4,2894,1143,1751,0,0,0,1.0,1,1.0,1,1.0,1,0.10171003830956571,52
1497,1,2895,1144,1751,0,0,0,1.0,1,1.0,1,1.0,1,0.12201825752814013,51
1498,0,2895,1144,1751,0,0,0,1.0,1,1.0,1,1.0,1,0.10729353214190918,50
1499,0,2895,1144,1751,0,0,0,1.0,1,1.0,1,1.0,1,0.10674962159249173,50
1500,1,2896,1145,1751,0,0,0,1.0,1,1.0,1,1.0,1,0.13114723286896365,49
1501,2,2898,1145,1753,0,0,0,1.0,1,1.0,1,1.0,1,0.10603462278757081,47
1502,2,2900,1147,1753,0,0,0,1.0,1,1.0,1,1.0,1,0.12040989952350868,47
1503,3,2903,1147,1756,0,0,0,1.0,1,1.0,1,1.0,1,0.08855280145775557,47
1504,3,2906,1149,1757,0,0,0,1.0,1,1.0,1,1.0,1,0.13446147061799396,48
1505,4,2910,1150,1760,0,0,0,1.0,1,1.0,1,1.0,1,0.09692451924515139,47
1506,3,2913,1153,1760,0,0,0,1.0,1,1.0,1,1.0,1,0.166485352290926,47
1507,2,2915,1154,1761,0,0,0,1.0,1,1.0,1,1.0,1,0.12373071288499878,45
1508,2,2917,1155,1762,0,0,0,1.0,1,1.0,1,1.0,1,0.12238762436130088,45
1509,2,2919,1156,1763,0,0,0,1.0,1,1.0,1,1.0,1,0.11653345542727896,44
1510,2,2921,1158,1763,0,0,0,1.0,1,1.0,1,1.0,1,0.1770695349690668,42
1511,3,2924,1159,1765,0,0,0,1.0,1,1.0,1,1.0,1,0.17577425817624398,40
1512,5,2929,1162,1767,0,0,0,1.0,1,1.0,1,1.0,1,0.22199420679810825,39
1513,4,2933,1163,1770,0,0,0,1.0,1,1.0,1,1.0,1,0.1946780627260913,39
1514,2,2935,1163,1772,0,0,0,1.0,1,1.0,1,1.0,1,0.1840628603826566,38
1515,1,2936,1163,1773,0,0,0,1.0,1,1.0,1,1.0,1,0.1863009610590244,39
1516,2,2938,1163,1775,0,0,0,1.0,1,1.0,1,1.0,1,0.13466515767091536,39
1517,1,2939,1164,1775,0,0,0,1.0,1,1.0,1,1.0,1,0.13900947669544922,39
1518,1,2940,1165,1775,0,0,0,1.0,1,1.0,1,1.0,1,0.15557125116904322,39
1519,3,2943,1166,1777,0,0,0,1.0,1,1.0,1,1.0,1,0.1293815313935482,39
1520,3,2946,1168,1778,0,0,0,1.0,1,1.0,1,1.0,1,0.17040694714929108,39
1521,3,2949,1169,1780,0,0,0,1.0,1,1.0,1,1.0,1,0.1835740330773958,40
1522,1,2950,1170,1780,0,0,0,1.0,1,1.0,1,1.0,1,0.20844546431709354,40
1523,3,2953,1171,1782,0,0,0,1.0,1,1.0,1,1.0,1,0.18441747800318734,41
1524,0,2953,1171,1782,0,0,0,1.0,1,1.0,1,1.0,1,0.20092773365749866,42
1525,2,2955,1171,1784,0,0,0,1.0,1,1.0,1,1.0,1,0.17136907144242955,45
1526,6,2961,1171,1790,0,0,0,1.0,1,1.0,1,1.0,1,0.12574210018574858,46
1527,2,2963,1171,1792,0,0,0,1.0,1,1.0,1,1.0,1,0.08517509266459061,46
1528,0,2963,1171,1792,0,0,0,1.0,1,1.0,1,1.0,1,0.09322877111953275,47
1529,0,2963,1171,1792,0,0,0,1.0,1,1.0,1,1.0,1,0.09322877111953275,47
1530,1,2964,1171,1793,0,0,0,1.0,1,1.0,1,1.0,1,0.0803226963343325,48
1531,1,2965,1171,1794,0,0,0,1.0,1,1.0,1,1.0,1,0.08748229557415764,46
1532,1,2966,1172,1794,0,0,0,1.0,1,1.0,1,1.0,1,0.09610738224399439,47
1533,0,2966,1172,1794,0,0,0,1.0,1,1.0,1,1.0,1,0.09579508146012557,46
1534,1,2967,1172,1795,0,0,0,1.0,1,1.0,1,1.0,1,0.0796250182524084,47
1535,0,2967,1172,1795,0,0,0,1.0,1,1.0,1,1.0,1,0.0796250182524084,47
1536,0,2967,1172,1795,0,0,0,1.0,1,1.0,1,1.0,1,0.0909628666316556,48
1537,1,2968,1172,1796,0,0,0,1.0,1,1.0,1,1.0,1,0.09688871503573979,46
1538,2,2970,1172,1798,0,0,0,1.0,1,1.0,1,1.0,1,0.08481671458012385,47
1539,0,2970,1172,1798,0,0,0,1.0,1,1.0,1,1.0,1,0.10603080707123809,47
1540,2,2972,1173,1799,0,0,0,1.0,1,1.0,1,1.0,1,0.11316785265804548,47
1541,2,2974,1173,1801,0,0,0,1.0,1,1.0,1,1.0,1,0.08833239918599604,47
1542,4,2978,1175,1803,0,0,0,1.0,1,1.0,1,1.0,1,0.13758024216559234,50
1543,6,2984,1177,1807,0,0,0,1.0,1,1.0,1,1.0,1,0.10692005921918166,47
1544,2,2986,1179,1807,0,0,0,1.0,1,1.0,1,1.0,1,0.12189017679716753,48
1545,3,2989,1180,1809,0,0,0,1.0,1,1.0,1,1.0,1,0.09418158294654241,47
1546,3,2992,1182,1810,0,0,0,1.0,1,1.0,1,1.0,1,0.09360696573656818,47
1547,3,2995,1182,1813,0,0,0,1.0,1,1.0,1,1.0,1,0.07553104155503113,47
1548,2,2997,1184,1813,0,0,0,1.0,1,1.0,1,1.0,1,0.09067732361404539,47
1549,7,3004,1188,1816,0,0,0,1.0,1,1.0,1,1.0,1,0.11132487371081114,46
1550,4,3008,1190,1818,0,0,0,1.0,1,1.0,1,1.0,1,0.14113685759162622,44
1551,5,3013,1193,1820,0,0,0,1.0,1,1.0,1,1.0,1,0.1263587188607357,45
1552,3,3016,1194,1822,0,0,0,1.0,1,1.0,1,1.0,1,0.10933491269620906,43
1553,5,3021,1196,1825,0,0,0,1.0,1,1.0,1,1.0,1,0.11387415108687868,43
1554,1,3022,1196,1826,0,0,0,1.0,1,1.0,1,1.0,1,0.12595905163824472,41
1555,1,3023,1196,1827,0,0,0,1.0,1,1.0,1,1.0,1,0.10902131058795836,44
1556,2,3025,1197,1828,0,0,0,1.0,1,1.0,1,1.0,1,0.09829732831607357,45
1557,1,3026,1198,1828,0,0,0,1.0,1,1.0,1,1.0,1,0.1304491422244044,45
1558,2,3028,1198,1830,0,0,0,1.0,1,1.0,1,1.0,1,0.08517050350693359,46
1559,4,3032,1200,1832,0,0,0,1.0,1,1.0,1,1.0,1,0.11348545254487315,47
1560,1,3033,1201,1832,0,0,0,1.0,1,1.0,1,1.0,1,0.09210938093288423,46
1561,2,3035,1202,1833,0,0,0,1.0,1,1.0,1,1.0,1,0.09606242836409659,47
1562,2,3037,1202,1835,0,0,0,1.0,1,1.0,1,1.0,1,0.06963974831649242,47
1563,0,3037,1202,1835,0,0,0,1.0,1,1.0,1,1.0,1,0.06963974831649242,47
1564,0,3037,1202,1835,0,0,0,1.0,1,1.0,1,1.0,1,0.06963974831649242,47
1565,1,3038,1202,1836,0,0,0,1.0,1,1.0,1,1.0,1,0.10356613800018157,48
1566,0,3038,1202,1836,0,0,0,1.0,1,1.0,1,1.0,1,0.10356613800018157,48
1567,1,3039,1202,1837,0,0,0,1.0,1,1.0,1,1.0,1,0.11758844471026096,48
1568,0,3039,1202,1837,0,0,0,1.0,1,1.0,1,1.0,1,0.11758844471026096,48
1569,2,3041,1203,1838,0,0,0,1.0,1,1.0,1,1.0,1,0.10467809572889544,45
1570,1,3042,1203,1839,0,0,0,1.0,1,1.0,1,1.0,1,0.10249688483700187,44
1571,3,3045,1205,1840,0,0,0,1.0,1,1.0,1,1.0,1,0.12335067926784131,42
1572,3,3048,1206,1842,0,0,0,1.0,1,1.0,1,1.0,1,0.1272091329708683,43
1573,0,3048,1206,1842,0,0,0,1.0,1,1.0,1,1.0,1,0.1272091329708683,43
1574,4,3052,1210,1842,0,0,0,1.0,1,1.0,1,1.0,1,0.1684265166131015,42
1575,5,3057,1212,1845,0,0,0,1.0,1,1.0,1,1.0,1,0.14861952559717767,43
1576,3,3060,1215,1845,0,0,0,1.0,1,1.0,1,1.0,1,0.18747669120160068,41
1577,3,3063,1216,1847,0,0,0,1.0,1,1.0,1,1.0,1,0.17989950792740467,40
1578,3,3066,1217,1849,0,0,0,1.0,1,1.0,1,1.0,1,0.161128769803853,40
1579,0,3066,1217,1849,0,0,0,1.0,1,1.0,1,1.0,1,0.16103914124716426,40
1580,0,3066,1217,1849,0,0,0,1.0,1,1.0,1,1.0,1,0.16103914124716426,40
1581,2,3068,1219,1849,0,0,0,1.0,1,1.0,1,1.0,1,0.18711606814522694,40
1582,4,3072,1221,1851,0,0,0,1.0,1,1.0,1,1.0,1,0.16339658305692645,40
1583,3,3075,1222,1853,0,0,0,1.0,1,1.0,1,1.0,1,0.15645340304661842,38
1584,3,3078,1224,1854,0,0,0,1.0,1,1.0,1,1.0,1,0.15093872596153388,39
1585,4,3082,1226,1856,0,0,0,1.0,1,1.0,1,1.0,1,0.09495440323277927,38
1586,5,3087,1229,1858,0,0,0,1.0,1,1.0,1,1.0,1,0.09309502825371017,38
1587,4,3091,1231,1860,0,0,0,1.0,1,1.0,1,1.0,1,0.11045995958057966,37
1588,5,3096,1233,1863,0,0,0,1.0,1,1.0,1,1.0,1,0.12639791350889004,39
1589,1,3097,1234,1863,0,0,0,1.0,1,1.0,1,1.0,1,0.12284338918645146,37
1590,3,3100,1235,1865,0,0,0,1.0,1,1.0,1,1.0,1,0.07498757785060502,37
1591,3,3103,1236,1867,0,0,0,1.0,1,1.0,1,1.0,1,0.0997752945968024,36
1592,0,3103,1236,1867,0,0,0,1.0,1,1.0,1,1.0,1,0.1654050210728814,34
1593,2,3105,1237,1868,0,0,0,1.0,1,1.0,1,1.0,1,0.17901462859224263,33
1594,1,3106,1238,1868,0,0,0,1.0,1,1.0,1,1.0,1,0.22659881829341244,31
1595,5,3111,1238,1873,0,0,0,1.0,1,1.0,1,1.0,1,0.08456743033320878,34
1596,0,3111,1238,1873,0,0,0,1.0,1,1.0,1,1.0,1,0.09957696961315268,33
1597,0,3111,1238,1873,0,0,0,1.0,1,1.0,1,1.0,1,0.09957696961315268,33
1598,1,3112,1239,1873,0,0,0,1.0,1,1.0,1,1.0,1,0.08697671430622388,33
1599,0,3112,1239,1873,0,0,0,1.0,1,1.0,1,1.0,1,0.08697671430622388,33
1600,1,3113,1240,1873,0,0,0,1.0,1,1.0,1,1.0,1,0.11245795331011989,34
1601,2,3115,1241,1874,0,0,0,1.0,1,1.0,1,1.0,1,0.13453552985215084,35
1602,0,3115,1241,1874,0,0,0,1.0,1,1.0,1,1.0,1,0.13046437617244694,36
1603,2,3117,1242,1875,0,0,0,1.0,1,1.0,1,1.0,1,0.16903587656106983,38
1604,3,3120,1242,1878,0,0,0,1.0,1,1.0,1,1.0,1,0.10891148267411317,38
1605,0,3120,1242,1878,0,0,0,1.0,1,1.0,1,1.0,1,0.10891148267411317,38
1606,4,3124,1244,1880,0,0,0,1.0,1,1.0,1,1.0,1,0.15637266680092698,39
1607,3,3127,1245,1882,0,0,0,1.0,1,1.0,1,1.0,1,0.12498938611787329,37
1608,3,3130,1247,1883,0,0,0,1.0,1,1.0,1,1.0,1,0.1461502592019843,36
1609,1,3131,1247,1884,0,0,0,1.0,1,1.0,1,1.0,1,0.12887994018070473,34
1610,1,3132,1248,1884,0,0,0,1.0,1,1.0,1,1.0,1,0.17459042492097018,34
1611,2,3134,1249,1885,0,0,0,1.0,1,1.0,1,1.0,1,0.17111803770200232,35
1612,0,3134,1249,1885,0,0,0,1.0,1,1.0,1,1.0,1,0.18290452528882736,33
1613,3,3137,1250,1887,0,0,0,1.0,1,1.0,1,1.0,1,0.16459372915954695,34
1614,2,3139,1251,1888,0,0,0,1.0,1,1.0,1,1.0,1,0.09557504470325302,35
1615,0,3139,1251,1888,0,0,0,1.0,1,1.0,1,1.0,1,0.09557504470325302,35
1616,1,3140,1252,1888,0,0,0,1.0,1,1.0,1,1.0,1,0.134335674727233,37
1617,3,3143,1253,1890,0,0,0,1.0,1,1.0,1,1.0,1,0.1331148341858447,38
1618,2,3145,1254,1891,0,0,0,1.0,1,1.0,1,1.0,1,0.12101134454574836,38
1619,1,3146,1255,1891,0,0,0,1.0,1,1.0,1,1.0,1,0.14530750623370908,38
1620,3,3149,1256,1893,0,0,0,1.0,1,1.0,1,1.0,1,0.1457278672598723,39
1621,4,3153,1258,1895,0,0,0,1.0,1,1.0,1,1.0,1,0.1412743605051102,37
1622,1,3154,1258,1896,0,0,0,1.0,1,1.0,1,1.0,1,0.1293508390732986,37
1623,5,3159,1261,1898,0,0,0,1.0,1,1.0,1,1.0,1,0.12654816825775198,37
1624,1,3160,1262,1898,0,0,0,1.0,1,1.0,1,1.0,1,0.11789675942872775,37
1625,0,3160,1262,1898,0,0,0,1.0,1,1.0,1,1.0,1,0.14450338904416346,35
1626,2,3162,1264,1898,0,0,0,1.0,1,1.0,1,1.0,1,0.21797323533463792,35
1627,1,3163,1264,1899,0,0,0,1.0,1,1.0,1,1.0,1,0.18100357219366411,34
1628,2,3165,1265,1900,0,0,0,1.0,1,1.0,1,1.0,1,0.18075506589310353,35
1629,4,3169,1267,1902,0,0,0,1.0,1,1.0,1,1.0,1,0.18897435342484295,34
1630,1,3170,1267,1903,0,0,0,1.0,1,1.0,1,1.0,1,0.14006725229552333,32
1631,1,3171,1267,1904,0,0,0,1.0,1,1.0,1,1.0,1,0.145331255190821,33
1632,0,3171,1267,1904,0,0,0,1.0,1,1.0,1,1.0,1,0.18271358907110327,32
1633,1,3172,1267,1905,0,0,0,1.0,1,1.0,1,1.0,1,0.1640759427165446,31
1634,1,3173,1268,1905,0,0,0,1.0,1,1.0,1,1.0,1,0.18980914199944454,31
1635,3,3176,1268,1908,0,0,0,1.0,1,1.0,1,1.0,1,0.16471972839978666,31
1636,0,3176,1268,1908,0,0,0,1.0,1,1.0,1,1.0,1,0.17706103964679876,33
1637,1,3177,1268,1909,0,0,0,1.0,1,1.0,1,1.0,1,0.17024906471618906,33
1638,1,3178,1268,1910,0,0,0,1.0,1,1.0,1,1.0,1,0.170591552593475,36
1639,0,3178,1268,1910,0,0,0,1.0,1,1.0,1,1.0,1,0.170591552593475,36
1640,1,3179,1269,1910,0,0,0,1.0,1,1.0,1,1.0,1,0.21125392271864143,36
1641,5,3184,1270,1914,0,0,0,1.0,1,1.0,1,1.0,1,0.13417500177132075,38
1642,0,3184,1270,1914,0,0,0,1.0,1,1.0,1,1.0,1,0.15276995131948434,37
1643,3,3187,1272,1915,0,0,0,1.0,1,1.0,1,1.0,1,0.16621392331930715,37
1644,3,3190,1274,1916,0,0,0,1.0,1,1.0,1,1.0,1,0.22123350792979768,38
1645,2,3192,1274,1918,0,0,0,1.0,1,1.0,1,1.0,1,0.1651410979080026,36
1646,0,3192,1274,1918,0,0,0,1.0,1,1.0,1,1.0,1,0.1637141900568223,37
1647,0,3192,1274,1918,0,0,0,1.0,1,1.0,1,1.0,1,0.2025952457899248,35
1648,0,3192,1274,1918,0,0,0,1.0,1,1.0,1,1.0,1,0.24187268115062494,38
1649,1,3193,1275,1918,0,0,0,1.0,1,1.0,1,1.0,1,0.22331633269631646,35
1650,0,3193,1275,1918,0,0,0,1.0,1,1.0,1,1.0,1,0.24160181576936646,34
1651,1,3194,1275,1919,0,0,0,1.0,1,1.0,1,1.0,1,0.2766989886879814,32
1652,2,3196,1275,1921,0,0,0,1.0,1,1.0,1,1.0,1,0.21425941960208622,33
1653,1,3197,1275,1922,0,0,0,1.0,1,1.0,1,1.0,1,0.19816434838325844,33
1654,0,3197,1275,1922,0,0,0,1.0,1,1.0,1,1.0,1,0.21818677448474455,34
1655,2,3199,1275,1924,0,0,0,1.0,1,1.0,1,1.0,1,0.1586334832795164,35
1656,1,3200,1275,1925,0,0,0,1.0,1,1.0,1,1.0,1,0.131514897186027,35
1657,1,3201,1275,1926,0,0,0,1.0,1,1.0,1,1.0,1,0.13699934709984818,36
1658,1,3202,1276,1926,0,0,0,1.0,1,1.0,1,1.0,1,0.1295553182570028,36
1659,1,3203,1276,1927,0,0,0,1.0,1,1.0,1,1.0,1,0.09203011799514609,36
1660,4,3207,1279,1928,0,0,0,1.0,1,1.0,1,1.0,1,0.12327814152457982,38
1661,1,3208,1279,1929,0,0,0,1.0,1,1.0,1,1.0,1,0.08746564573669462,38
1662,4,3212,1282,1930,0,0,0,1.0,1,1.0,1,1.0,1,0.13219744641720815,39
1663,4,3216,1283,1933,0,0,0,1.0,1,1.0,1,1.0,1,0.11291417868367226,40
1664,2,3218,1284,1934,0,0,0,1.0,1,1.0,1,1.0,1,0.16026126525481624,39
1665,5,3223,1286,1937,0,0,0,1.0,1,1.0,1,1.0,1,0.14280937516404024,40
1666,3,3226,1288,1938,0,0,0,1.0,1,1.0,1,1.0,1,0.18400540803017323,40
1667,2,3228,1288,1940,0,0,0,1.0,1,1.0,1,1.0,1,0.14186073167666727,40
1668,1,3229,1289,1940,0,0,0,1.0,1,1.0,1,1.0,1,0.13795238516280883,41
1669,0,3229,1289,1940,0,0,0,1.0,1,1.0,1,1.0,1,0.11849398475243522,40
1670,0,3229,1289,1940,0,0,0,1.0,1,1.0,1,1.0,1,0.11849398475243522,40
1671,1,3230,1290,1940,0,0,0,1.0,1,1.0,1,1.0,1,0.12516908924993825,41
1672,0,3230,1290,1940,0,0,0,1.0,1,1.0,1,1.0,1,0.14812885982916743,40
1673,1,3231,1290,1941,0,0,0,1.0,1,1.0,1,1.0,1,0.132673008301181,39
1674,2,3233,1290,1943,0,0,0,1.0,1,1.0,1,1.0,1,0.11091275576492134,40
1675,0,3233,1290,1943,0,0,0,1.0,1,1.0,1,1.0,1,0.14543580513044277,38
1676,1,3234,1291,1943,0,0,0,1.0,1,1.0,1,1.0,1,0.13292760877509888,39
1677,0,3234,1291,1943,0,0,0,1.0,1,1.0,1,1.0,1,0.13334573857589793,39
1678,0,3234,1291,1943,0,0,0,1.0,1,1.0,1,1.0,1,0.13334573857589793,39
1679,2,3236,1292,1944,0,0,0,1.0,1,1.0,1,1.0,1,0.1327697962257686,39
1680,4,3240,1294,1946,0,0,0,1.0,1,1.0,1,1.0,1,0.12974503311518631,41
1681,3,3243,1295,1948,0,0,0,1.0,1,1.0,1,1.0,1,0.07738926523300764,41
1682,3,3246,1296,1950,0,0,0,1.0,1,1.0,1,1.0,1,0.08945660868548973,43
1683,6,3252,1299,1953,0,0,0,1.0,1,1.0,1,1.0,1,0.1645691828791635,43
1684,3,3255,1300,1955,0,0,0,1.0,1,1.0,1,1.0,1,0.15021715881389985,42
1685,3,3258,1300,1958,0,0,0,1.0,1,1.0,1,1.0,1,0.10456797647138356,41
1686,5,3263,1302,1961,0,0,0,1.0,1,1.0,1,1.0,1,0.12169099004196411,41
1687,4,3267,1303,1964,0,0,0,1.0,1,1.0,1,1.0,1,0.09021411975275345,40
1688,1,3268,1304,1964,0,0,0,1.0,1,1.0,1,1.0,1,0.0924002143068224,39
1689,1,3269,1304,1965,0,0,0,1.0,1,1.0,1,1.0,1,0.11921228372523499,38
1690,0,3269,1304,1965,0,0,0,1.0,1,1.0,1,1.0,1,0.11771344639772822,38
1691,0,3269,1304,1965,0,0,0,1.0,1,1.0,1,1.0,1,0.14950435698620562,36
1692,0,3269,1304,1965,0,0,0,1.0,1,1.0,1,1.0,1,0.16511757625499848,36
1693,3,3272,1306,1966,0,0,0,1.0,1,1.0,1,1.0,1,0.13963729517339116,35
1694,1,3273,1307,1966,0,0,0,1.0,1,1.0,1,1.0,1,0.18021232691753736,33
1695,0,3273,1307,1966,0,0,0,1.0,1,1.0,1,1.0,1,0.17065018303998788,34
1696,1,3274,1308,1966,0,0,0,1.0,1,1.0,1,1.0,1,0.2197547343337842,35
1697,0,3274,1308,1966,0,0,0,1.0,1,1.0,1,1.0,1,0.23577308444642708,36
1698,4,3278,1310,1968,0,0,0,1.0,1,1.0,1,1.0,1,0.23217824047340024,38
1699,2,3280,1311,1969,0,0,0,1.0,1,1.0,1,1.0,1,0.22586390725764513,38
1700,3,3283,1311,1972,0,0,0,1.0,1,1.0,1,1.0,1,0.18353275425430804,39
1701,0,3283,1311,1972,0,0,0,1.0,1,1.0,1,1.0,1,0.19961481112500162,40
1702,4,3287,1313,1974,0,0,0,1.0,1,1.0,1,1.0,1,0.22855444115818283,41
1703,4,3291,1314,1977,0,0,0,1.0,1,1.0,1,1.0,1,0.22465078929486115,41
1704,4,3295,1315,1980,0,0,0,1.0,1,1.0,1,1.0,1,0.11366973340177385,41
1705,3,3298,1315,1983,0,0,0,1.0,1,1.0,1,1.0,1,0.08462787418670494,40
1706,1,3299,1316,1983,0,0,0,1.0,1,1.0,1,1.0,1,0.09633899217437182,40
1707,2,3301,1316,1985,0,0,0,1.0,1,1.0,1,1.0,1,0.12068937104850103,39
1708,1,3302,1317,1985,0,0,0,1.0,1,1.0,1,1.0,1,0.12853631544196858,39
1709,0,3302,1317,1985,0,0,0,1.0,1,1.0,1,1.0,1,0.13880138837632064,38
1710,3,3305,1318,1987,0,0,0,1.0,1,1.0,1,1.0,1,0.1640923604517856,39
1711,2,3307,1318,1989,0,0,0,1.0,1,1.0,1,1.0,1,0.09295825530770992,38
1712,1,3308,1319,1989,0,0,0,1.0,1,1.0,1,1.0,1,0.11248778217880885,38
1713,0,3308,1319,1989,0,0,0,1.0,1,1.0,1,1.0,1,0.12296889701361133,37
1714,4,3312,1321,1991,0,0,0,1.0,1,1.0,1,1.0,1,0.19140918830671957,38
1715,1,3313,1321,1992,0,0,0,1.0,1,1.0,1,1.0,1,0.1685431518906111,40
1716,0,3313,1321,1992,0,0,0,1.0,1,1.0,1,1.0,1,0.18129482209101294,39
1717,2,3315,1323,1992,0,0,0,1.0,1,1.0,1,1.0,1,0.1740297684588083,38
1718,0,3315,1323,1992,0,0,0,1.0,1,1.0,1,1.0,1,0.20726924325264184,38
1719,0,3315,1323,1992,0,0,0,1.0,1,1.0,1,1.0,1,0.20726924325264184,38
1720,2,3317,1324,1993,0,0,0,1.0,1,1.0,1,1.0,1,0.21628102088055837,41
1721,3,3320,1326,1994,0,0,0,1.0,1,1.0,1,1.0,1,0.21157250275456752,39
1722,5,3325,1328,1997,0,0,0,1.0,1,1.0,1,1.0,1,0.20361625655352697,40
1723,1,3326,1328,1998,0,0,0,1.0,1,1.0,1,1.0,1,0.16699674620050195,38
1724,1,3327,1328,1999,0,0,0,1.0,1,1.0,1,1.0,1,0.1451930285815824,37
1725,0,3327,1328,1999,0,0,0,1.0,1,1.0,1,1.0,1,0.17244741561241528,38
1726,0,3327,1328,1999,0,0,0,1.0,1,1.0,1,1.0,1,0.16338164581376718,37
1727,1,3328,1328,2000,0,0,0,1.0,1,1.0,1,1.0,1,0.14095636207894474,37
1728,0,3328,1328,2000,0,0,0,1.0,1,1.0,1,1.0,1,0.14487988585074926,35
1729,1,3329,1328,2001,0,0,0,1.0,1,1.0,1,1.0,1,0.1266515768471906,37
1730,2,3331,1330,2001,0,0,0,1.0,1,1.0,1,1.0,1,0.19556861599047443,37
1731,7,3338,1331,2007,0,0,0,1.0,1,1.0,1,1.0,1,0.1135851387596827,37
1732,1,3339,1331,2008,0,0,0,1.0,1,1.0,1,1.0,1,0.13322094152398029,37
1733,2,3341,1332,2009,0,0,0,1.0,1,1.0,1,1.0,1,0.16078121051567723,36
1734,1,3342,1332,2010,0,0,0,1.0,1,1.0,1,1.0,1,0.16682001035220748,35
1735,3,3345,1333,2012,0,0,0,1.0,1,1.0,1,1.0,1,0.1324940914068931,34
1736,0,3345,1333,2012,0,0,0,1.0,1,1.0,1,1.0,1,0.12902229575659266,35
1737,5,3350,1336,2014,0,0,0,1.0,1,1.0,1,1.0,1,0.1355700021253305,36
1738,3,3353,1337,2016,0,0,0,1.0,1,1.0,1,1.0,1,0.16767163455145614,37
1739,3,3356,1338,2018,0,0,0,1.0,1,1.0,1,1.0,1,0.11763981698382196,38
1740,1,3357,1338,2019,0,0,0,1.0,1,1.0,1,1.0,1,0.09400900435471507,37
1741,0,3357,1338,2019,0,0,0,1.0,1,1.0,1,1.0,1,0.11417076072574477,38
1742,4,3361,1340,2021,0,0,0,1.0,1,1.0,1,1.0,1,0.16420000209096353,39
1743,3,3364,1341,2023,0,0,0,1.0,1,1.0,1,1.0,1,0.1082677184956335,37
1744,2,3366,1343,2023,0,0,0,1.0,1,1.0,1,1.0,1,0.12295461705980637,38
1745,1,3367,1344,2023,0,0,0,1.0,1,1.0,1,1.0,1,0.1778473161943235,37
1746,2,3369,1344,2025,0,0,0,1.0,1,1.0,1,1.0,1,0.1448252988056113,38
1747,2,3371,1344,2027,0,0,0,1.0,1,1.0,1,1.0,1,0.10251629177496749,38
1748,0,3371,1344,2027,0,0,0,1.0,1,1.0,1,1.0,1,0.10251629177496749,38
1749,1,3372,1344,2028,0,0,0,1.0,1,1.0,1,1.0,1,0.09701083014803184,37
1750,0,3372,1344,2028,0,0,0,1.0,1,1.0,1,1.0,1,0.10450606197343652,39
1751,0,3372,1344,2028,0,0,0,1.0,1,1.0,1,1.0,1,0.12103034409082677,38
1752,1,3373,1344,2029,0,0,0,1.0,1,1.0,1,1.0,1,0.10367359376644007,39
1753,0,3373,1344,2029,0,0,0,1.0,1,1.0,1,1.0,1,0.09253856012643316,40
1754,2,3375,1345,2030,0,0,0,1.0,1,1.0,1,1.0,1,0.11594942314495672,41
1755,3,3378,1345,2033,0,0,0,1.0,1,1.0,1,1.0,1,0.053341428719863186,41
1756,1,3379,1346,2033,0,0,0,1.0,1,1.0,1,1.0,1,0.07998153874649269,42
1757,1,3380,1347,2033,0,0,0,1.0,1,1.0,1,1.0,1,0.10251490722349553,42
1758,2,3382,1349,2033,0,0,0,1.0,1,1.0,1,1.0,1,0.16257727555951135,42
1759,4,3386,1349,2037,0,0,0,1.0,1,1.0,1,1.0,1,0.10996882688670248,39
1760,4,3390,1352,2038,0,0,0,1.0,1,1.0,1,1.0,1,0.23573309740528248,39
1761,4,3394,1353,2041,0,0,0,1.0,1,1.0,1,1.0,1,0.13843788714179758,38
1762,1,3395,1354,2041,0,0,0,1.0,1,1.0,1,1.0,1,0.10455929871162438,37
1763,1,3396,1355,2041,0,0,0,1.0,1,1.0,1,1.0,1,0.14792888433233606,37
1764,3,3399,1358,2041,0,0,0,1.0,1,1.0,1,1.0,1,0.20335906377866267,36
1765,5,3404,1360,2044,0,0,0,1.0,1,1.0,1,1.0,1,0.13880076385646464,37
1766,1,3405,1360,2045,0,0,0,1.0,1,1.0,1,1.0,1,0.11492961107729535,36
1767,0,3405,1360,2045,0,0,0,1.0,1,1.0,1,1.0,1,0.11492961107729535,36
1768,1,3406,1360,2046,0,0,0,1.0,1,1.0,1,1.0,1,0.08633158380718668,36
1769,0,3406,1360,2046,0,0,0,1.0,1,1.0,1,1.0,1,0.08464784740137204,38
1770,0,3406,1360,2046,0,0,0,1.0,1,1.0,1,1.0,1,0.08464784740137204,38
1771,0,3406,1360,2046,0,0,0,1.0,1,1.0,1,1.0,1,0.08464784740137204,38
1772,0,3406,1360,2046,0,0,0,1.0,1,1.0,1,1.0,1,0.10383755623045557,40
1773,1,3407,1361,2046,0,0,0,1.0,1,1.0,1,1.0,1,0.1318553665853573,40
1774,0,3407,1361,2046,0,0,0,1.0,1,1.0,1,1.0,1,0.1318553665853573,40
1775,1,3408,1361,2047,0,0,0,1.0,1,1.0,1,1.0,1,0.11972294131722477,41
1776,0,3408,1361,2047,0,0,0,1.0,1,1.0,1,1.0,1,0.10543181457692237,43
1777,2,3410,1361,2049,0,0,0,1.0,1,1.0,1,1.0,1,0.08734478916858719,44
1778,2,3412,1363,2049,0,0,0,1.0,1,1.0,1,1.0,1,0.12135190578602081,44
1779,1,3413,1363,2050,0,0,0,1.0,1,1.0,1,1.0,1,0.11010884362774744,44
1780,3,3416,1364,2052,0,0,0,1.0,1,1.0,1,1.0,1,0.09838140026524407,46
1781,2,3418,1366,2052,0,0,0,1.0,1,1.0,1,1.0,1,0.1004955345767434,46
1782,3,3421,1368,2053,0,0,0,1.0,1,1.0,1,1.0,1,0.14154781607778616,45
1783,2,3423,1369,2054,0,0,0,1.0,1,1.0,1,1.0,1,0.14128704671355866,44
1784,3,3426,1371,2055,0,0,0,1.0,1,1.0,1,1.0,1,0.17043245437974025,44
1785,4,3430,1373,2057,0,0,0,1.0,1,1.0,1,1.0,1,0.17935038548444426,42
1786,4,3434,1375,2059,0,0,0,1.0,1,1.0,1,1.0,1,0.1808852308443526,42
1787,4,3438,1376,2062,0,0,0,1.0,1,1.0,1,1.0,1,0.1760379754340408,41
1788,7,3445,1378,2067,0,0,0,1.0,1,1.0,1,1.0,1,0.10149332380121145,41
1789,3,3448,1380,2068,0,0,0,1.0,1,1.0,1,1.0,1,0.10263430340434258,41
1790,1,3449,1381,2068,0,0,0,1.0,1,1.0,1,1.0,1,0.12476404460863581,41
1791,3,3452,1381,2071,0,0,0,1.0,1,1.0,1,1.0,1,0.07115347895658668,41
1792,2,3454,1381,2073,0,0,0,1.0,1,1.0,1,1.0,1,0.08178824770328612,43
1793,1,3455,1382,2073,0,0,0,1.0,1,1.0,1,1.0,1,0.09167927079143962,43
1794,0,3455,1382,2073,0,0,0,1.0,1,1.0,1,1.0,1,0.09272938290003026,41
1795,4,3459,1385,2074,0,0,0,1.0,1,1.0,1,1.0,1,0.11279635421106962,41
1796,1,3460,1386,2074,0,0,0,1.0,1,1.0,1,1.0,1,0.18619411665946933,40
1797,5,3465,1387,2078,0,0,0,1.0,1,1.0,1,1.0,1,0.15379215836170548,38
1798,1,3466,1387,2079,0,0,0,1.0,1,1.0,1,1.0,1,0.12453300926419134,38
1799,3,3469,1389,2080,0,0,0,1.0,1,1.0,1,1.0,1,0.1538628954670492,37
1800,1,3470,1390,2080,0,0,0,1.0,1,1.0,1,1.0,1,0.20638292203888697,35
1801,2,3472,1390,2082,0,0,0,1.0,1,1.0,1,1.0,1,0.12811375388705776,34
1802,0,3472,1390,2082,0,0,0,1.0,1,1.0,1,1.0,1,0.11432246546455044,33
1803,3,3475,1392,2083,0,0,0,1.0,1,1.0,1,1.0,1,0.171930256078919,33
1804,2,3477,1393,2084,0,0,0,1.0,1,1.0,1,1.0,1,0.19055173164990058,33
1805,3,3480,1393,2087,0,0,0,1.0,1,1.0,1,1.0,1,0.12546343299742116,35
1806,2,3482,1393,2089,0,0,0,1.0,1,1.0,1,1.0,1,0.12446752934929146,36
1807,2,3484,1393,2091,0,0,0,1.0,1,1.0,1,1.0,1,0.08439716065896857,35
1808,4,3488,1394,2094,0,0,0,1.0,1,1.0,1,1.0,1,0.0810065081311764,37
1809,1,3489,1394,2095,0,0,0,1.0,1,1.0,1,1.0,1,0.11212026880582705,35
1810,1,3490,1395,2095,0,0,0,1.0,1,1.0,1,1.0,1,0.1652692937914637,36
1811,0,3490,1395,2095,0,0,0,1.0,1,1.0,1,1.0,1,0.19168701702804106,34
1812,1,3491,1395,2096,0,0,0,1.0,1,1.0,1,1.0,1,0.19643938881898407,36
1813,1,3492,1396,2096,0,0,0,1.0,1,1.0,1,1.0,1,0.21740208226030966,35
1814,3,3495,1398,2097,0,0,0,1.0,1,1.0,1,1.0,1,0.2855692126835907,36
1815,2,3497,1398,2099,0,0,0,1.0,1,1.0,1,1.0,1,0.2535535570673625,35
1816,2,3499,1398,2101,0,0,0,1.0,1,1.0,1,1.0,1,0.21499806794810394,35
1817,1,3500,1398,2102,0,0,0,1.0,1,1.0,1,1.0,1,0.206377446585375,35
1818,5,3505,1402,2103,0,0,0,1.0,1,1.0,1,1.0,1,0.17600422133297922,36
1819,5,3510,1404,2106,0,0,0,1.0,1,1.0,1,1.0,1,0.13543320525299307,37
1820,0,3510,1404,2106,0,0,0,1.0,1,1.0,1,1.0,1,0.13543320525299307,37
1821,2,3512,1405,2107,0,0,0,1.0,1,1.0,1,1.0,1,0.12594510846527449,38
1822,5,3517,1408,2109,0,0,0,1.0,1,1.0,1,1.0,1,0.1603412544931254,37
1823,3,3520,1410,2110,0,0,0,1.0,1,1.0,1,1.0,1,0.15801047077728142,36
1824,2,3522,1412,2110,0,0,0,1.0,1,1.0,1,1.0,1,0.19360770068664518,36
1825,2,3524,1414,2110,0,0,0,1.0,1,1.0,1,1.0,1,0.17935021663210332,34
1826,4,3528,1416,2112,0,0,0,1.0,1,1.0,1,1.0,1,0.1607102566104601,35
1827,1,3529,1417,2112,0,0,0,1.0,1,1.0,1,1.0,1,0.13874298689087294,34
1828,2,3531,1419,2112,0,0,0,1.0,1,1.0,1,1.0,1,0.1457648850974619,33
1829,0,3531,1419,2112,0,0,0,1.0,1,1.0,1,1.0,1,0.11397967649086876,31
1830,0,3531,1419,2112,0,0,0,1.0,1,1.0,1,1.0,1,0.11532617902999896,31
1831,2,3533,1421,2112,0,0,0,1.0,1,1.0,1,1.0,1,0.11019703020374493,30
1832,0,3533,1421,2112,0,0,0,1.0,1,1.0,1,1.0,1,0.12393009573149806,29
1833,6,3539,1424,2115,0,0,0,1.0,1,1.0,1,1.0,1,0.1333914623935756,28
1834,0,3539,1424,2115,0,0,0,1.0,1,1.0,1,1.0,1,0.14905537874973865,27
1835,4,3543,1427,2116,0,0,0,1.0,1,1.0,1,1.0,1,0.190653828510033,26
1836,1,3544,1427,2117,0,0,0,1.0,1,1.0,1,1.0,1,0.2322976521492422,26
1837,3,3547,1427,2120,0,0,0,1.0,1,1.0,1,1.0,1,0.18321506739960458,25
1838,0,3547,1427,2120,0,0,0,1.0,1,1.0,1,1.0,1,0.17570265428566262,25
1839,2,3549,1427,2122,0,0,0,1.0,1,1.0,1,1.0,1,0.2077785774032052,24
1840,1,3550,1428,2122,0,0,0,1.0,1,1.0,1,1.0,1,0.31465471769356246,23
1841,1,3551,1428,2123,0,0,0,1.0,1,1.0,1,1.0,1,0.2524814790791228,22
1842,5,3556,1429,2127,0,0,0,1.0,1,1.0,1,1.0,1,0.22675718727327102,23
1843,1,3557,1429,2128,0,0,0,1.0,1,1.0,1,1.0,1,0.20151308330698017,23
1844,0,3557,1429,2128,0,0,0,1.0,1,1.0,1,1.0,1,0.20151308330698017,23
1845,2,3559,1430,2129,0,0,0,1.0,1,1.0,1,1.0,1,0.1824179599367776,23
1846,1,3560,1430,2130,0,0,0,1.0,1,1.0,1,1.0,1,0.14653275329217808,23
1847,0,3560,1430,2130,0,0,0,1.0,1,1.0,1,1.0,1,0.16886560493840336,24
1848,0,3560,1430,2130,0,0,0,1.0,1,1.0,1,1.0,1,0.16886560493840336,24
1849,1,3561,1430,2131,0,0,0,1.0,1,1.0,1,1.0,1,0.184865553608063,25
1850,0,3561,1430,2131,0,0,0,1.0,1,1.0,1,1.0,1,0.184865553608063,25
1851,0,3561,1430,2131,0,0,0,1.0,1,1.0,1,1.0,1,0.184865553608063,25
1852,0,3561,1430,2131,0,0,0,1.0,1,1.0,1,1.0,1,0.184865553608063,25
1853,0,3561,1430,2131,0,0,0,1.0,1,1.0,1,1.0,1,0.2149200348662142,25
1854,0,3561,1430,2131,0,0,0,1.0,1,1.0,1,1.0,1,0.2149200348662142,25
1855,0,3561,1430,2131,0,0,0,1.0,1,1.0,1,1.0,1,0.23719478839932306,26
1856,0,3561,1430,2131,0,0,0,1.0,1,1.0,1,1.0,1,0.22839063772502904,27
1857,2,3563,1431,2132,0,0,0,1.0,1,1.0,1,1.0,1,0.25115155321441335,28
1858,2,3565,1432,2133,0,0,0,1.0,1,1.0,1,1.0,1,0.2280059695447316,28
1859,4,3569,1435,2134,0,0,0,1.0,1,1.0,1,1.0,1,0.31214406096423103,28
1860,1,3570,1435,2135,0,0,0,1.0,1,1.0,1,1.0,1,0.30014777169914075,28
1861,1,3571,1435,2136,0,0,0,1.0,1,1.0,1,1.0,1,0.2920911404028012,28
1862,1,3572,1435,2137,0,0,0,1.0,1,1.0,1,1.0,1,0.2778472095235767,28
1863,3,3575,1436,2139,0,0,0,1.0,1,1.0,1,1.0,1,0.2847439474410823,29
1864,0,3575,1436,2139,0,0,0,1.0,1,1.0,1,1.0,1,0.2728295107330829,27
1865,3,3578,1436,2142,0,0,0,1.0,1,1.0,1,1.0,1,0.2058924528229879,26
1866,1,3579,1437,2142,0,0,0,1.0,1,1.0,1,1.0,1,0.2233797181308216,26
1867,1,3580,1437,2143,0,0,0,1.0,1,1.0,1,1.0,1,0.20984276654378603,26
1868,1,3581,1437,2144,0,0,0,1.0,1,1.0,1,1.0,1,0.16629367809291004,26
1869,0,3581,1437,2144,0,0,0,1.0,1,1.0,1,1.0,1,0.16629367809291004,26
1870,1,3582,1437,2145,0,0,0,1.0,1,1.0,1,1.0,1,0.1736295149010182,27
1871,0,3582,1437,2145,0,0,0,1.0,1,1.0,1,1.0,1,0.1736295149010182,27
1872,0,3582,1437,2145,0,0,0,1.0,1,1.0,1,1.0,1,0.24339292975865187,25
1873,0,3582,1437,2145,0,0,0,1.0,1,1.0,1,1.0,1,0.24339292975865187,25
1874,1,3583,1437,2146,0,0,0,1.0,1,1.0,1,1.0,1,0.26867678920193044,25
1875,0,3583,1437,2146,0,0,0,1.0,1,1.0,1,1.0,1,0.26867678920193044,25
1876,0,3583,1437,2146,0,0,0,1.0,1,1.0,1,1.0,1,0.24764717618271564,26
1877,0,3583,1437,2146,0,0,0,1.0,1,1.0,1,1.0,1,0.23766036230085963,27
1878,2,3585,1439,2146,0,0,0,1.0,1,1.0,1,1.0,1,0.28858974189140024,28
1879,1,3586,1439,2147,0,0,0,1.0,1,1.0,1,1.0,1,0.24844122420871786,29
1880,1,3587,1439,2148,0,0,0,1.0,1,1.0,1,1.0,1,0.23228752958212737,29
1881,0,3587,1439,2148,0,0,0,1.0,1,1.0,1,1.0,1,0.23228752958212737,29
1882,0,3587,1439,2148,0,0,0,1.0,1,1.0,1,1.0,1,0.23239405749805453,28
1883,0,3587,1439,2148,0,0,0,1.0,1,1.0,1,1.0,1,0.23239405749805453,28
1884,0,3587,1439,2148,0,0,0,1.0,1,1.0,1,1.0,1,0.23239405749805453,28
1885,0,3587,1439,2148,0,0,0,1.0,1,1.0,1,1.0,1,0.23239405749805453,28
1886,0,3587,1439,2148,0,0,0,1.0,1,1.0,1,1.0,1,0.23219994123691556,29
1887,0,3587,1439,2148,0,0,0,1.0,1,1.0,1,1.0,1,0.23219994123691556,29
1888,3,3590,1439,2151,0,0,0,1.0,1,1.0,1,1.0,1,0.21475501299152758,31
1889,0,3590,1439,2151,0,0,0,1.0,1,1.0,1,1.0,1,0.21475501299152758,31
1890,0,3590,1439,2151,0,0,0,1.0,1,1.0,1,1.0,1,0.21475501299152758,31
1891,0,3590,1439,2151,0,0,0,1.0,1,1.0,1,1.0,1,0.23334879051219243,32
1892,0,3590,1439,2151,0,0,0,1.0,1,1.0,1,1.0,1,0.23334879051219243,32
1893,1,3591,1439,2152,0,0,0,1.0,1,1.0,1,1.0,1,0.19998751256303135,32
1894,0,3591,1439,2152,0,0,0,1.0,1,1.0,1,1.0,1,0.20793540467490673,33
1895,2,3593,1439,2154,0,0,0,1.0,1,1.0,1,1.0,1,0.18906123746637182,35
1896,0,3593,1439,2154,0,0,0,1.0,1,1.0,1,1.0,1,0.20812828197921357,34
1897,0,3593,1439,2154,0,0,0,1.0,1,1.0,1,1.0,1,0.20812828197921357,34
1898,0,3593,1439,2154,0,0,0,1.0,1,1.0,1,1.0,1,0.20812828197921357,34
1899,0,3593,1439,2154,0,0,0,1.0,1,1.0,1,1.0,1,0.20812828197921357,34
1900,1,3594,1439,2155,0,0,0,1.0,1,1.0,1,1.0,1,0.1796528949875279,35
1901,0,3594,1439,2155,0,0,0,1.0,1,1.0,1,1.0,1,0.1796528949875279,35
1902,1,3595,1440,2155,0,0,0,1.0,1,1.0,1,1.0,1,0.19359561642400686,35
1903,1,3596,1440,2156,0,0,0,1.0,1,1.0,1,1.0,1,0.17142609271453224,35
1904,0,3596,1440,2156,0,0,0,1.0,1,1.0,1,1.0,1,0.17142609271453224,35
1905,1,3597,1440,2157,0,0,0,1.0,1,1.0,1,1.0,1,0.12490704196982888,37
1906,0,3597,1440,2157,0,0,0,1.0,1,1.0,1,1.0,1,0.12490704196982888,37
1907,1,3598,1440,2158,0,0,0,1.0,1,1.0,1,1.0,1,0.130612903502494,39
1908,2,3600,1441,2159,0,0,0,1.0,1,1.0,1,1.0,1,0.12086806402444437,39
1909,3,3603,1442,2161,0,0,0,1.0,1,1.0,1,1.0,1,0.1148986805199546,41
1910,0,3603,1442,2161,0,0,0,1.0,1,1.0,1,1.0,1,0.1148986805199546,41
1911,3,3606,1442,2164,0,0,0,1.0,1,1.0,1,1.0,1,0.12275823224091274,40
1912,1,3607,1443,2164,0,0,0,1.0,1,1.0,1,1.0,1,0.1741736193110568,39
1913,2,3609,1443,2166,0,0,0,1.0,1,1.0,1,1.0,1,0.13659925839150144,40
1914,2,3611,1445,2166,0,0,0,1.0,1,1.0,1,1.0,1,0.18108395277492173,41
1915,0,3611,1445,2166,0,0,0,1.0,1,1.0,1,1.0,1,0.189781988686893,42
1916,1,3612,1445,2167,0,0,0,1.0,1,1.0,1,1.0,1,0.1826524689270476,42
1917,5,3617,1447,2170,0,0,0,1.0,1,1.0,1,1.0,1,0.15419557494128153,41
1918,3,3620,1449,2171,0,0,0,1.0,1,1.0,1,1.0,1,0.18647745808498403,38
1919,3,3623,1450,2173,0,0,0,1.0,1,1.0,1,1.0,1,0.22372022557620477,38
1920,1,3624,1450,2174,0,0,0,1.0,1,1.0,1,1.0,1,0.23207382592756692,38
1921,1,3625,1450,2175,0,0,0,1.0,1,1.0,1,1.0,1,0.1932070309583514,39
1922,2,3627,1452,2175,0,0,0,1.0,1,1.0,1,1.0,1,0.241149862194171,40
1923,2,3629,1452,2177,0,0,0,1.0,1,1.0,1,1.0,1,0.2057380456088532,41
1924,1,3630,1453,2177,0,0,0,1.0,1,1.0,1,1.0,1,0.19296878269204332,41
1925,2,3632,1453,2179,0,0,0,1.0,1,1.0,1,1.0,1,0.16781902428563306,41
1926,0,3632,1453,2179,0,0,0,1.0,1,1.0,1,1.0,1,0.16781902428563306,41
1927,1,3633,1453,2180,0,0,0,1.0,1,1.0,1,1.0,1,0.16274023491967024,41
1928,1,3634,1454,2180,0,0,0,1.0,1,1.0,1,1.0,1,0.16189667743519462,42
1929,0,3634,1454,2180,0,0,0,1.0,1,1.0,1,1.0,1,0.1631246200138931,41
1930,0,3634,1454,2180,0,0,0,1.0,1,1.0,1,1.0,1,0.1631246200138931,41
1931,0,3634,1454,2180,0,0,0,1.0,1,1.0,1,1.0,1,0.1631246200138931,41
1932,0,3634,1454,2180,0,0,0,1.0,1,1.0,1,1.0,1,0.1631246200138931,41
1933,1,3635,1455,2180,0,0,0,1.0,1,1.0,1,1.0,1,0.190287510662269,43
1934,3,3638,1455,2183,0,0,0,1.0,1,1.0,1,1.0,1,0.17219196658736735,44
1935,2,3640,1455,2185,0,0,0,1.0,1,1.0,1,1.0,1,0.119827767068702,45
1936,2,3642,1455,2187,0,0,0,1.0,1,1.0,1,1.0,1,0.12952033877276453,48
1937,2,3644,1456,2188,0,0,0,1.0,1,1.0,1,1.0,1,0.13405760786848642,48
1938,0,3644,1456,2188,0,0,0,1.0,1,1.0,1,1.0,1,0.13405760786848642,48
1939,2,3646,1456,2190,0,0,0,1.0,1,1.0,1,1.0,1,0.1048466862342966,48
1940,0,3646,1456,2190,0,0,0,1.0,1,1.0,1,1.0,1,0.1048466862342966,48
1941,1,3647,1457,2190,0,0,0,1.0,1,1.0,1,1.0,1,0.1351838570009014,48
1942,3,3650,1458,2192,0,0,0,1.0,1,1.0,1,1.0,1,0.1614112879666197,49
1943,1,3651,1458,2193,0,0,0,1.0,1,1.0,1,1.0,1,0.12682505477158304,48
1944,3,3654,1460,2194,0,0,0,1.0,1,1.0,1,1.0,1,0.16678326877631508,47
1945,4,3658,1463,2195,0,0,0,1.0,1,1.0,1,1.0,1,0.12987606114433345,46
1946,0,3658,1463,2195,0,0,0,1.0,1,1.0,1,1.0,1,0.13459391887832087,46
1947,5,3663,1465,2198,0,0,0,1.0,1,1.0,1,1.0,1,0.20429457990961936,45
1948,2,3665,1466,2199,0,0,0,1.0,1,1.0,1,1.0,1,0.17537441343581706,46
1949,7,3672,1469,2203,0,0,0,1.0,1,1.0,1,1.0,1,0.21578859767465627,42
1950,0,3672,1469,2203,0,0,0,1.0,1,1.0,1,1.0,1,0.21837444229408798,40
1951,3,3675,1471,2204,0,0,0,1.0,1,1.0,1,1.0,1,0.21361985748390247,39
1952,1,3676,1472,2204,0,0,0,1.0,1,1.0,1,1.0,1,0.2454099489509041,35
1953,7,3683,1475,2208,0,0,0,1.0,1,1.0,1,1.0,1,0.1781773640855406,36
1954,0,3683,1475,2208,0,0,0,1.0,1,1.0,1,1.0,1,0.1991565101211407,34
1955,1,3684,1475,2209,0,0,0,1.0,1,1.0,1,1.0,1,0.19463988908680682,35
1956,2,3686,1476,2210,0,0,0,1.0,1,1.0,1,1.0,1,0.19997582709929546,37
1957,2,3688,1476,2212,0,0,0,1.0,1,1.0,1,1.0,1,0.1728752169568509,37
1958,2,3690,1476,2214,0,0,0,1.0,1,1.0,1,1.0,1,0.15069893087838585,39
1959,1,3691,1476,2215,0,0,0,1.0,1,1.0,1,1.0,1,0.15223439849975137,41
1960,2,3693,1478,2215,0,0,0,1.0,1,1.0,1,1.0,1,0.1954434065567811,40
1961,3,3696,1479,2217,0,0,0,1.0,1,1.0,1,1.0,1,0.1499824984911808,41
1962,0,3696,1479,2217,0,0,0,1.0,1,1.0,1,1.0,1,0.17301132321909038,40
1963,0,3696,1479,2217,0,0,0,1.0,1,1.0,1,1.0,1,0.18798680415268842,41
1964,0,3696,1479,2217,0,0,0,1.0,1,1.0,1,1.0,1,0.21285980975962465,40
1965,2,3698,1480,2218,0,0,0,1.0,1,1.0,1,1.0,1,0.18590111817781366,41
1966,2,3700,1480,2220,0,0,0,1.0,1,1.0,1,1.0,1,0.17783932667784685,41
1967,4,3704,1481,2223,0,0,0,1.0,1,1.0,1,1.0,1,0.14788910286561274,42
1968,0,3704,1481,2223,0,0,0,1.0,1,1.0,1,1.0,1,0.15880323345479283,42
1969,5,3709,1482,2227,0,0,0,1.0,1,1.0,1,1.0,1,0.1487773184969302,43
1970,0,3709,1482,2227,0,0,0,1.0,1,1.0,1,1.0,1,0.17383694402451808,42
1971,3,3712,1483,2229,0,0,0,1.0,1,1.0,1,1.0,1,0.16774811808074172,42
1972,0,3712,1483,2229,0,0,0,1.0,1,1.0,1,1.0,1,0.16774811808074172,42
1973,3,3715,1483,2232,0,0,0,1.0,1,1.0,1,1.0,1,0.1398998406727325,43
1974,1,3716,1483,2233,0,0,0,1.0,1,1.0,1,1.0,1,0.15832488670287886,43
1975,1,3717,1483,2234,0,0,0,1.0,1,1.0,1,1.0,1,0.13334606379076744,43
1976,0,3717,1483,2234,0,0,0,1.0,1,1.0,1,1.0,1,0.13334606379076744,43
1977,3,3720,1483,2237,0,0,0,1.0,1,1.0,1,1.0,1,0.15100890232871367,48
1978,4,3724,1485,2239,0,0,0,1.0,1,1.0,1,1.0,1,0.16178444374393544,48
1979,2,3726,1485,2241,0,0,0,1.0,1,1.0,1,1.0,1,0.15440110857689723,49
1980,3,3729,1486,2243,0,0,0,1.0,1,1.0,1,1.0,1,0.16371849406341177,50
1981,3,3732,1488,2244,0,0,0,1.0,1,1.0,1,1.0,1,0.13894529821829546,50
1982,1,3733,1489,2244,0,0,0,1.0,1,1.0,1,1.0,1,0.13823610133352032,50
1983,1,3734,1490,2244,0,0,0,1.0,1,1.0,1,1.0,1,0.13488268576305415,49
1984,1,3735,1491,2244,0,0,0,1.0,1,1.0,1,1.0,1,0.1648149174275271,48
1985,1,3736,1491,2245,0,0,0,1.0,1,1.0,1,1.0,1,0.13493686499286406,46
1986,1,3737,1492,2245,0,0,0,1.0,1,1.0,1,1.0,1,0.14009535699941078,46
1987,2,3739,1494,2245,0,0,0,1.0,1,1.0,1,1.0,1,0.1657345074438816,42
1988,1,3740,1494,2246,0,0,0,1.0,1,1.0,1,1.0,1,0.1602181626778178,40
1989,5,3745,1498,2247,0,0,0,1.0,1,1.0,1,1.0,1,0.15390813451638063,38
1990,0,3745,1498,2247,0,0,0,1.0,1,1.0,1,1.0,1,0.14403373320672805,38
1991,5,3750,1500,2250,0,0,0,1.0,1,1.0,1,1.0,1,0.1673598617273835,38
1992,0,3750,1500,2250,0,0,0,1.0,1,1.0,1,1.0,1,0.18184999822367395,39
1993,4,3754,1501,2253,0,0,0,1.0,1,1.0,1,1.0,1,0.20058163064801732,38
1994,3,3757,1503,2254,0,0,0,1.0,1,1.0,1,1.0,1,0.17784008675501703,37
1995,5,3762,1506,2256,0,0,0,1.0,1,1.0,1,1.0,1,0.22320131759464057,37
1996,1,3763,1506,2257,0,0,0,1.0,1,1.0,1,1.0,1,0.20300926509715533,37
1997,3,3766,1507,2259,0,0,0,1.0,1,1.0,1,1.0,1,0.19734981902511853,35
1998,1,3767,1508,2259,0,0,0,1.0,1,1.0,1,1.0,1,0.2317886648253492,34
1999,3,3770,1510,2260,0,0,0,1.0,1,1.0,1,1.0,1,0.21579192712056341,35
2000,1,3771,1510,2261,0,0,0,1.0,1,1.0,1,1.0,1,0.21754428287894,34
2001,4,3775,1510,2265,0,0,0,1.0,1,1.0,1,1.0,1,0.1930709483049036,35
2002,2,3777,1511,2266,0,0,0,1.0,1,1.0,1,1.0,1,0.23491685735851858,36
2003,1,3778,1511,2267,0,0,0,1.0,1,1.0,1,1.0,1,0.22351860170449134,37
2004,2,3780,1511,2269,0,0,0,1.0,1,1.0,1,1.0,1,0.17014298731074368,38
2005,1,3781,1511,2270,0,0,0,1.0,1,1.0,1,1.0,1,0.1525913587268766,38
2006,0,3781,1511,2270,0,0,0,1.0,1,1.0,1,1.0,1,0.1525913587268766,38
2007,1,3782,1512,2270,0,0,0,1.0,1,1.0,1,1.0,1,0.1342485369593723,40
2008,0,3782,1512,2270,0,0,0,1.0,1,1.0,1,1.0,1,0.1342485369593723,40
2009,2,3784,1513,2271,0,0,0,1.0,1,1.0,1,1.0,1,0.11714862728965295,41
2010,0,3784,1513,2271,0,0,0,1.0,1,1.0,1,1.0,1,0.11714862728965295,41
2011,0,3784,1513,2271,0,0,0,1.0,1,1.0,1,1.0,1,0.11714862728965295,41
2012,0,3784,1513,2271,0,0,0,1.0,1,1.0,1,1.0,1,0.11714862728965295,41
2013,2,3786,1513,2273,0,0,0,1.0,1,1.0,1,1.0,1,0.11378750338878324,43
2014,0,3786,1513,2273,0,0,0,1.0,1,1.0,1,1.0,1,0.1235428135187265,43
2015,0,3786,1513,2273,0,0,0,1.0,1,1.0,1,1.0,1,0.1235428135187265,43
2016,1,3787,1513,2274,0,0,0,1.0,1,1.0,1,1.0,1,0.12947501438867526,44
2017,3,3790,1513,2277,0,0,0,1.0,1,1.0,1,1.0,1,0.0995121742578811,45
2018,3,3793,1516,2277,0,0,0,1.0,1,1.0,1,1.0,1,0.13119577576218158,46
2019,2,3795,1516,2279,0,0,0,1.0,1,1.0,1,1.0,1,0.08502956237450542,47
2020,5,3800,1518,2282,0,0,0,1.0,1,1.0,1,1.0,1,0.0964851424838672,47
2021,0,3800,1518,2282,0,0,0,1.0,1,1.0,1,1.0,1,0.0964851424838672,47
2022,0,3800,1518,2282,0,0,0,1.0,1,1.0,1,1.0,1,0.09929410710271193,48
2023,2,3802,1520,2282,0,0,0,1.0,1,1.0,1,1.0,1,0.12418478322258608,48
2024,6,3808,1526,2282,0,0,0,1.0,1,1.0,1,1.0,1,0.13914278873137687,45
2025,2,3810,1528,2282,0,0,0,1.0,1,1.0,1,1.0,1,0.17291993523400662,42
2026,6,3816,1532,2284,0,0,0,1.0,1,1.0,1,1.0,1,0.2018472953139583,44
2027,2,3818,1533,2285,0,0,0,1.0,1,1.0,1,1.0,1,0.19737150322921326,40
2028,5,3823,1535,2288,0,0,0,1.0,1,1.0,1,1.0,1,0.22675679443574087,39
2029,2,3825,1535,2290,0,0,0,1.0,1,1.0,1,1.0,1,0.1813834786173042,37
2030,1,3826,1535,2291,0,0,0,1.0,1,1.0,1,1.0,1,0.20938125498799987,34
2031,4,3830,1537,2293,0,0,0,1.0,1,1.0,1,1.0,1,0.1870561663089782,35
2032,2,3832,1538,2294,0,0,0,1.0,1,1.0,1,1.0,1,0.24800763082410904,34
2033,5,3837,1541,2296,0,0,0,1.0,1,1.0,1,1.0,1,0.22674557250899535,36
2034,2,3839,1541,2298,0,0,0,1.0,1,1.0,1,1.0,1,0.23182966414099598,34
2035,2,3841,1542,2299,0,0,0,1.0,1,1.0,1,1.0,1,0.218903025209013,35
2036,3,3844,1543,2301,0,0,0,1.0,1,1.0,1,1.0,1,0.17616382800165192,34
2037,0,3844,1543,2301,0,0,0,1.0,1,1.0,1,1.0,1,0.17654762378282593,35
2038,0,3844,1543,2301,0,0,0,1.0,1,1.0,1,1.0,1,0.18891289209522732,36
2039,1,3845,1543,2302,0,0,0,1.0,1,1.0,1,1.0,1,0.17073802405314964,38
2040,0,3845,1543,2302,0,0,0,1.0,1,1.0,1,1.0,1,0.17073802405314964,38
2041,1,3846,1543,2303,0,0,0,1.0,1,1.0,1,1.0,1,0.1643387340767287,39
2042,1,3847,1543,2304,0,0,0,1.0,1,1.0,1,1.0,1,0.1444582808658734,39
2043,1,3848,1543,2305,0,0,0,1.0,1,1.0,1,1.0,1,0.12847923347950208,39
2044,0,3848,1543,2305,0,0,0,1.0,1,1.0,1,1.0,1,0.12847923347950208,39
2045,1,3849,1543,2306,0,0,0,1.0,1,1.0,1,1.0,1,0.11788432780818238,41
2046,1,3850,1543,2307,0,0,0,1.0,1,1.0,1,1.0,1,0.12997244211192077,42
2047,1,3851,1543,2308,0,0,0,1.0,1,1.0,1,1.0,1,0.10937978401242172,42
2048,1,3852,1544,2308,0,0,0,1.0,1,1.0,1,1.0,1,0.14056842678807208,43
2049,3,3855,1545,2310,0,0,0,1.0,1,1.0,1,1.0,1,0.13561618041302867,44
2050,0,3855,1545,2310,0,0,0,1.0,1,1.0,1,1.0,1,0.1329602950395012,44
2051,4,3859,1546,2313,0,0,0,1.0,1,1.0,1,1.0,1,0.14693616905998558,45
2052,1,3860,1546,2314,0,0,0,1.0,1,1.0,1,1.0,1,0.14301701156492982,45
2053,5,3865,1546,2319,0,0,0,1.0,1,1.0,1,1.0,1,0.06277459514379621,45
2054,2,3867,1547,2320,0,0,0,1.0,1,1.0,1,1.0,1,0.09546344889146703,46
2055,0,3867,1547,2320,0,0,0,1.0,1,1.0,1,1.0,1,0.09546344889146703,46
2056,1,3868,1547,2321,0,0,0,1.0,1,1.0,1,1.0,1,0.08120342381538219,46
2057,2,3870,1549,2321,0,0,0,1.0,1,1.0,1,1.0,1,0.11203165111858625,47
2058,5,3875,1552,2323,0,0,0,1.0,1,1.0,1,1.0,1,0.1114630372544973,47
2059,4,3879,1555,2324,0,0,0,1.0,1,1.0,1,1.0,1,0.1061345376461322,48
2060,2,3881,1555,2326,0,0,0,1.0,1,1.0,1,1.0,1,0.09836366264520818,50
2061,0,3881,1555,2326,0,0,0,1.0,1,1.0,1,1.0,1,0.08981327176017338,51
2062,3,3884,1558,2326,0,0,0,1.0,1,1.0,1,1.0,1,0.12345039752875592,49
2063,1,3885,1559,2326,0,0,0,1.0,1,1.0,1,1.0,1,0.13553963711738468,48
2064,4,3889,1561,2328,0,0,0,1.0,1,1.0,1,1.0,1,0.1533963712500022,45
2065,3,3892,1561,2331,0,0,0,1.0,1,1.0,1,1.0,1,0.09707181275551542,44
2066,0,3892,1561,2331,0,0,0,1.0,1,1.0,1,1.0,1,0.1170504546776004,42
2067,3,3895,1562,2333,0,0,0,1.0,1,1.0,1,1.0,1,0.12258136178099475,41
2068,0,3895,1562,2333,0,0,0,1.0,1,1.0,1,1.0,1,0.14904677560516275,40
2069,3,3898,1563,2335,0,0,0,1.0,1,1.0,1,1.0,1,0.16042578379811834,40
2070,2,3900,1563,2337,0,0,0,1.0,1,1.0,1,1.0,1,0.12117179479064427,40
2071,3,3903,1565,2338,0,0,0,1.0,1,1.0,1,1.0,1,0.13169806320664754,40
2072,1,3904,1565,2339,0,0,0,1.0,1,1.0,1,1.0,1,0.12097263780287718,41
2073,1,3905,1566,2339,0,0,0,1.0,1,1.0,1,1.0,1,0.16059552752864562,41
2074,3,3908,1566,2342,0,0,0,1.0,1,1.0,1,1.0,1,0.12771176569093365,41
2075,2,3910,1567,2343,0,0,0,1.0,1,1.0,1,1.0,1,0.1143895459036063,41
2076,1,3911,1568,2343,0,0,0,1.0,1,1.0,1,1.0,1,0.14477487531135502,41
2077,1,3912,1568,2344,0,0,0,1.0,1,1.0,1,1.0,1,0.11976125869130996,40
2078,1,3913,1569,2344,0,0,0,1.0,1,1.0,1,1.0,1,0.14574057350719574,40
2079,2,3915,1569,2346,0,0,0,1.0,1,1.0,1,1.0,1,0.09489644007986037,39
2080,1,3916,1569,2347,0,0,0,1.0,1,1.0,1,1.0,1,0.09994847303102332,38
2081,1,3917,1569,2348,0,0,0,1.0,1,1.0,1,1.0,1,0.09570511344778423,40
2082,1,3918,1570,2348,0,0,0,1.0,1,1.0,1,1.0,1,0.1481295134448721,41
2083,5,3923,1572,2351,0,0,0,1.0,1,1.0,1,1.0,1,0.055680481643339635,40
2084,5,3928,1575,2353,0,0,0,1.0,1,1.0,1,1.0,1,0.09554186972391814,42
2085,1,3929,1575,2354,0,0,0,1.0,1,1.0,1,1.0,1,0.07778625893944714,42
2086,1,3930,1576,2354,0,0,0,1.0,1,1.0,1,1.0,1,0.10262583209665398,43
2087,2,3932,1576,2356,0,0,0,1.0,1,1.0,1,1.0,1,0.09392786406665439,45
2088,4,3936,1578,2358,0,0,0,1.0,1,1.0,1,1.0,1,0.12588520151684823,46
2089,2,3938,1578,2360,0,0,0,1.0,1,1.0,1,1.0,1,0.10413140845859108,47
2090,1,3939,1579,2360,0,0,0,1.0,1,1.0,1,1.0,1,0.16136193907755975,49
2091,2,3941,1579,2362,0,0,0,1.0,1,1.0,1,1.0,1,0.13475090611984059,49
2092,1,3942,1579,2363,0,0,0,1.0,1,1.0,1,1.0,1,0.12597721463050082,49
2093,1,3943,1580,2363,0,0,0,1.0,1,1.0,1,1.0,1,0.11938713530908047,49
2094,0,3943,1580,2363,0,0,0,1.0,1,1.0,1,1.0,1,0.11938713530908047,49
2095,1,3944,1581,2363,0,0,0,1.0,1,1.0,1,1.0,1,0.07495941263364753,49
2096,0,3944,1581,2363,0,0,0,1.0,1,1.0,1,1.0,1,0.0775277048283006,51
2097,0,3944,1581,2363,0,0,0,1.0,1,1.0,1,1.0,1,0.0775277048283006,51
2098,1,3945,1582,2363,0,0,0,1.0,1,1.0,1,1.0,1,0.10688616744887397,52
2099,4,3949,1583,2366,0,0,0,1.0,1,1.0,1,1.0,1,0.06836312803172477,51
2100,0,3949,1583,2366,0,0,0,1.0,1,1.0,1,1.0,1,0.0858105995039032,51
2101,1,3950,1583,2367,0,0,0,1.0,1,1.0,1,1.0,1,0.08553980673121973,48
2102,4,3954,1586,2368,0,0,0,1.0,1,1.0,1,1.0,1,0.1520168946141899,49
2103,9,3963,1589,2374,0,0,0,1.0,1,1.0,1,1.0,1,0.16785892733376612,48
2104,1,3964,1590,2374,0,0,0,1.0,1,1.0,1,1.0,1,0.1844588176685889,43
2105,6,3970,1591,2379,0,0,0,1.0,1,1.0,1,1.0,1,0.1535054571700121,42
2106,2,3972,1592,2380,0,0,0,1.0,1,1.0,1,1.0,1,0.16229532341918607,40
2107,3,3975,1593,2382,0,0,0,1.0,1,1.0,1,1.0,1,0.13268172433846848,39
2108,1,3976,1593,2383,0,0,0,1.0,1,1.0,1,1.0,1,0.09935975444698932,38
2109,0,3976,1593,2383,0,0,0,1.0,1,1.0,1,1.0,1,0.11064778753218515,37
2110,2,3978,1595,2383,0,0,0,1.0,1,1.0,1,1.0,1,0.11832682756167699,38
2111,1,3979,1596,2383,0,0,0,1.0,1,1.0,1,1.0,1,0.14999080187703645,37
2112,2,3981,1598,2383,0,0,0,1.0,1,1.0,1,1.0,1,0.19833325645686675,36
2113,2,3983,1599,2384,0,0,0,1.0,1,1.0,1,1.0,1,0.25569744067015593,36
2114,1,3984,1599,2385,0,0,0,1.0,1,1.0,1,1.0,1,0.19991621462389483,36
2115,1,3985,1599,2386,0,0,0,1.0,1,1.0,1,1.0,1,0.193679333024268,35
2116,2,3987,1599,2388,0,0,0,1.0,1,1.0,1,1.0,1,0.10863949951381614,37
2117,0,3987,1599,2388,0,0,0,1.0,1,1.0,1,1.0,1,0.1268944672542571,38
2118,0,3987,1599,2388,0,0,0,1.0,1,1.0,1,1.0,1,0.13903886843978536,40
2119,1,3988,1600,2388,0,0,0,1.0,1,1.0,1,1.0,1,0.14751224595007484,40
2120,1,3989,1601,2388,0,0,0,1.0,1,1.0,1,1.0,1,0.16527682317802378,41
2121,2,3991,1601,2390,0,0,0,1.0,1,1.0,1,1.0,1,0.14707049616140902,41
2122,0,3991,1601,2390,0,0,0,1.0,1,1.0,1,1.0,1,0.14233723678573826,42
2123,1,3992,1601,2391,0,0,0,1.0,1,1.0,1,1.0,1,0.13070079974519677,43
2124,0,3992,1601,2391,0,0,0,1.0,1,1.0,1,1.0,1,0.16097736277156,41
2125,1,3993,1601,2392,0,0,0,1.0,1,1.0,1,1.0,1,0.1442637396522055,41
2126,0,3993,1601,2392,0,0,0,1.0,1,1.0,1,1.0,1,0.13962657139080456,40
2127,1,3994,1601,2393,0,0,0,1.0,1,1.0,1,1.0,1,0.12005482025896291,40
2128,1,3995,1601,2394,0,0,0,1.0,1,1.0,1,1.0,1,0.12958853693434785,41
2129,0,3995,1601,2394,0,0,0,1.0,1,1.0,1,1.0,1,0.1278592730121977,42
2130,2,3997,1601,2396,0,0,0,1.0,1,1.0,1,1.0,1,0.10246821505536649,45
2131,0,3997,1601,2396,0,0,0,1.0,1,1.0,1,1.0,1,0.10246821505536649,45
2132,1,3998,1601,2397,0,0,0,1.0,1,1.0,1,1.0,1,0.09829206781292145,46
2133,2,4000,1602,2398,0,0,0,1.0,1,1.0,1,1.0,1,0.10057757607161298,46
2134,2,4002,1603,2399,0,0,0,1.0,1,1.0,1,1.0,1,0.12480819686005304,47
2135,4,4006,1604,2402,0,0,0,1.0,1,1.0,1,1.0,1,0.07879029160700828,47
2136,0,4006,1604,2402,0,0,0,1.0,1,1.0,1,1.0,1,0.07879029160700828,47
2137,2,4008,1605,2403,0,0,0,1.0,1,1.0,1,1.0,1,0.06437606070076932,49
2138,0,4008,1605,2403,0,0,0,1.0,1,1.0,1,1.0,1,0.06437606070076932,49
2139,1,4009,1606,2403,0,0,0,1.0,1,1.0,1,1.0,1,0.0920817865461759,47
2140,4,4013,1608,2405,0,0,0,1.0,1,1.0,1,1.0,1,0.10623238793817902,48
2141,3,4016,1609,2407,0,0,0,1.0,1,1.0,1,1.0,1,0.06666646632066675,47
2142,0,4016,1609,2407,0,0,0,1.0,1,1.0,1,1.0,1,0.06666646632066675,47
2143,1,4017,1610,2407,0,0,0,1.0,1,1.0,1,1.0,1,0.10028696399399227,48
2144,3,4020,1612,2408,0,0,0,1.0,1,1.0,1,1.0,1,0.11366633889956906,48
2145,5,4025,1614,2411,0,0,0,1.0,1,1.0,1,1.0,1,0.09719080999770488,46
2146,1,4026,1614,2412,0,0,0,1.0,1,1.0,1,1.0,1,0.08911363159710763,47
2147,5,4031,1618,2413,0,0,0,1.0,1,1.0,1,1.0,1,0.08051495612662002,48
2148,1,4032,1619,2413,0,0,0,1.0,1,1.0,1,1.0,1,0.14601058864583003,46
2149,5,4037,1623,2414,0,0,0,1.0,1,1.0,1,1.0,1,0.1547841141278263,46
2150,5,4042,1625,2417,0,0,0,1.0,1,1.0,1,1.0,1,0.11413958793052116,46
2151,3,4045,1627,2418,0,0,0,1.0,1,1.0,1,1.0,1,0.10806780714012434,44
2152,1,4046,1628,2418,0,0,0,1.0,1,1.0,1,1.0,1,0.16567006438202853,45
2153,3,4049,1629,2420,0,0,0,1.0,1,1.0,1,1.0,1,0.15639083803695825,48
2154,2,4051,1630,2421,0,0,0,1.0,1,1.0,1,1.0,1,0.175748337055844,47
2155,5,4056,1632,2424,0,0,0,1.0,1,1.0,1,1.0,1,0.15818529583137822,48
2156,2,4058,1633,2425,0,0,0,1.0,1,1.0,1,1.0,1,0.1816233374540453,45
2157,2,4060,1633,2427,0,0,0,1.0,1,1.0,1,1.0,1,0.1329907762392568,43
2158,2,4062,1634,2428,0,0,0,1.0,1,1.0,1,1.0,1,0.15126907567292497,43
2159,7,4069,1637,2432,0,0,0,1.0,1,1.0,1,1.0,1,0.12303281350639464,43
2160,2,4071,1637,2434,0,0,0,1.0,1,1.0,1,1.0,1,0.09741917828065365,41
2161,1,4072,1637,2435,0,0,0,1.0,1,1.0,1,1.0,1,0.07702291177164643,41
2162,0,4072,1637,2435,0,0,0,1.0,1,1.0,1,1.0,1,0.07691088438563967,42
2163,2,4074,1638,2436,0,0,0,1.0,1,1.0,1,1.0,1,0.07379182069020153,43
2164,3,4077,1640,2437,0,0,0,1.0,1,1.0,1,1.0,1,0.14723058494326394,44
2165,2,4079,1640,2439,0,0,0,1.0,1,1.0,1,1.0,1,0.12465386622862552,44
2166,0,4079,1640,2439,0,0,0,1.0,1,1.0,1,1.0,1,0.12276829842571443,46
2167,3,4082,1641,2441,0,0,0,1.0,1,1.0,1,1.0,1,0.09215460942244133,46
2168,0,4082,1641,2441,0,0,0,1.0,1,1.0,1,1.0,1,0.08500184402589332,45
2169,3,4085,1642,2443,0,0,0,1.0,1,1.0,1,1.0,1,0.07298912787406209,49
2170,0,4085,1642,2443,0,0,0,1.0,1,1.0,1,1.0,1,0.07298912787406209,49
2171,1,4086,1642,2444,0,0,0,1.0,1,1.0,1,1.0,1,0.07258305936117984,51
2172,1,4087,1643,2444,0,0,0,1.0,1,1.0,1,1.0,1,0.06836388845977354,52
2173,1,4088,1644,2444,0,0,0,1.0,1,1.0,1,1.0,1,0.08586335693078419,52
2174,2,4090,1645,2445,0,0,0,1.0,1,1.0,1,1.0,1,0.09881963871032656,52
2175,0,4090,1645,2445,0,0,0,1.0,1,1.0,1,1.0,1,0.11136909345905072,53
2176,1,4091,1645,2446,0,0,0,1.0,1,1.0,1,1.0,1,0.10143914440493143,54
2177,3,4094,1647,2447,0,0,0,1.0,1,1.0,1,1.0,1,0.13182133755446873,55
2178,2,4096,1649,2447,0,0,0,1.0,1,1.0,1,1.0,1,0.12054559198092868,54
2179,2,4098,1650,2448,0,0,0,1.0,1,1.0,1,1.0,1,0.12386607611548861,52
2180,1,4099,1651,2448,0,0,0,1.0,1,1.0,1,1.0,1,0.15011330038065432,51
2181,6,4105,1651,2454,0,0,0,1.0,1,1.0,1,1.0,1,0.07466639106971933,49
2182,0,4105,1651,2454,0,0,0,1.0,1,1.0,1,1.0,1,0.09196395145429885,49
2183,5,4110,1655,2455,0,0,0,1.0,1,1.0,1,1.0,1,0.16802445707940922,46
2184,6,4116,1658,2458,0,0,0,1.0,1,1.0,1,1.0,1,0.19167910193002585,45
2185,8,4124,1660,2464,0,0,0,1.0,1,1.0,1,1.0,1,0.13502871544664813,44
2186,4,4128,1662,2466,0,0,0,1.0,1,1.0,1,1.0,1,0.1396023995908176,42
2187,5,4133,1666,2467,0,0,0,1.0,1,1.0,1,1.0,1,0.1485002908626433,40
2188,3,4136,1668,2468,0,0,0,1.0,1,1.0,1,1.0,1,0.1494780739442206,38
2189,5,4141,1670,2471,0,0,0,1.0,1,1.0,1,1.0,1,0.12117975684311454,36
2190,4,4145,1671,2474,0,0,0,1.0,1,1.0,1,1.0,1,0.16281962274587472,34
2191,2,4147,1672,2475,0,0,0,1.0,1,1.0,1,1.0,1,0.15304780987481145,34
2192,2,4149,1673,2476,0,0,0,1.0,1,1.0,1,1.0,1,0.11893538773023302,33
2193,0,4149,1673,2476,0,0,0,1.0,1,1.0,1,1.0,1,0.1509631561231042,32
2194,1,4150,1674,2476,0,0,0,1.0,1,1.0,1,1.0,1,0.16056037596595066,32
2195,0,4150,1674,2476,0,0,0,1.0,1,1.0,1,1.0,1,0.16900851255045718,31
2196,2,4152,1675,2477,0,0,0,1.0,1,1.0,1,1.0,1,0.16116079987701334,32
2197,0,4152,1675,2477,0,0,0,1.0,1,1.0,1,1.0,1,0.16532908269947227,31
2198,1,4153,1675,2478,0,0,0,1.0,1,1.0,1,1.0,1,0.12192510206497396,31
2199,2,4155,1676,2479,0,0,0,1.0,1,1.0,1,1.0,1,0.08836011100217617,32
2200,2,4157,1676,2481,0,0,0,1.0,1,1.0,1,1.0,1,0.08529966703162364,35
2201,0,4157,1676,2481,0,0,0,1.0,1,1.0,1,1.0,1,0.07641200478850811,36
2202,1,4158,1677,2481,0,0,0,1.0,1,1.0,1,1.0,1,0.07622300472865122,36
2203,0,4158,1677,2481,0,0,0,1.0,1,1.0,1,1.0,1,0.09847749628103789,37
2204,1,4159,1678,2481,0,0,0,1.0,1,1.0,1,1.0,1,0.12265769119702646,36
2205,3,4162,1679,2483,0,0,0,1.0,1,1.0,1,1.0,1,0.1077288779414088,37
2206,3,4165,1682,2483,0,0,0,1.0,1,1.0,1,1.0,1,0.21835983652723528,35
2207,4,4169,1683,2486,0,0,0,1.0,1,1.0,1,1.0,1,0.1425524813516237,37
2208,0,4169,1683,2486,0,0,0,1.0,1,1.0,1,1.0,1,0.149741852369476,36
2209,0,4169,1683,2486,0,0,0,1.0,1,1.0,1,1.0,1,0.17676866758271703,35
2210,2,4171,1683,2488,0,0,0,1.0,1,1.0,1,1.0,1,0.13953590404107952,38
2211,2,4173,1683,2490,0,0,0,1.0,1,1.0,1,1.0,1,0.11026186886010532,37
2212,3,4176,1683,2493,0,0,0,1.0,1,1.0,1,1.0,1,0.11297954253637872,38
2213,0,4176,1683,2493,0,0,0,1.0,1,1.0,1,1.0,1,0.11297954253637872,38
2214,0,4176,1683,2493,0,0,0,1.0,1,1.0,1,1.0,1,0.09915729812144666,39
2215,2,4178,1684,2494,0,0,0,1.0,1,1.0,1,1.0,1,0.13137549514329733,39
2216,2,4180,1685,2495,0,0,0,1.0,1,1.0,1,1.0,1,0.14906574038014347,39
2217,3,4183,1686,2497,0,0,0,1.0,1,1.0,1,1.0,1,0.09777562624053167,38
2218,2,4185,1687,2498,0,0,0,1.0,1,1.0,1,1.0,1,0.08858542672832481,37
2219,1,4186,1688,2498,0,0,0,1.0,1,1.0,1,1.0,1,0.10890204185737166,36
2220,1,4187,1688,2499,0,0,0,1.0,1,1.0,1,1.0,1,0.11963144368722671,34
2221,3,4190,1690,2500,0,0,0,1.0,1,1.0,1,1.0,1,0.12097539938024873,35
2222,0,4190,1690,2500,0,0,0,1.0,1,1.0,1,1.0,1,0.13540879395142116,33
2223,2,4192,1692,2500,0,0,0,1.0,1,1.0,1,1.0,1,0.15539334398719815,34
2224,1,4193,1693,2500,0,0,0,1.0,1,1.0,1,1.0,1,0.15184125540395665,32
2225,7,4200,1696,2504,0,0,0,1.0,1,1.0,1,1.0,1,0.17792036341197318,33
2226,6,4206,1698,2508,0,0,0,1.0,1,1.0,1,1.0,1,0.15938422599545612,32
2227,2,4208,1698,2510,0,0,0,1.0,1,1.0,1,1.0,1,0.1505347112895645,31
2228,3,4211,1698,2513,0,0,0,1.0,1,1.0,1,1.0,1,0.14765813175171644,32
2229,2,4213,1699,2514,0,0,0,1.0,1,1.0,1,1.0,1,0.14958355137520163,32
2230,1,4214,1699,2515,0,0,0,1.0,1,1.0,1,1.0,1,0.14075760053292172,31
2231,0,4214,1699,2515,0,0,0,1.0,1,1.0,1,1.0,1,0.11776652248784944,32
2232,1,4215,1699,2516,0,0,0,1.0,1,1.0,1,1.0,1,0.1323012233728436,32
2233,2,4217,1700,2517,0,0,0,1.0,1,1.0,1,1.0,1,0.16231456432873145,31
2234,0,4217,1700,2517,0,0,0,1.0,1,1.0,1,1.0,1,0.15761342073514445,32
2235,2,4219,1700,2519,0,0,0,1.0,1,1.0,1,1.0,1,0.16699636518648478,31
2236,0,4219,1700,2519,0,0,0,1.0,1,1.0,1,1.0,1,0.16699636518648478,31
2237,2,4221,1702,2519,0,0,0,1.0,1,1.0,1,1.0,1,0.18001422588156793,31
2238,1,4222,1703,2519,0,0,0,1.0,1,1.0,1,1.0,1,0.2383000813570147,31
2239,5,4227,1703,2524,0,0,0,1.0,1,1.0,1,1.0,1,0.1530665911217205,31
2240,2,4229,1704,2525,0,0,0,1.0,1,1.0,1,1.0,1,0.15561419331721232,32
2241,4,4233,1705,2528,0,0,0,1.0,1,1.0,1,1.0,1,0.10247852880093353,32
2242,2,4235,1706,2529,0,0,0,1.0,1,1.0,1,1.0,1,0.10053731975509068,34
2243,3,4238,1709,2529,0,0,0,1.0,1,1.0,1,1.0,1,0.20353763722466314,34
2244,3,4241,1709,2532,0,0,0,1.0,1,1.0,1,1.0,1,0.1571405067803253,36
2245,1,4242,1709,2533,0,0,0,1.0,1,1.0,1,1.0,1,0.14757869530540502,36
2246,2,4244,1709,2535,0,0,0,1.0,1,1.0,1,1.0,1,0.126959451521827,39
2247,0,4244,1709,2535,0,0,0,1.0,1,1.0,1,1.0,1,0.13074287089418787,40
2248,1,4245,1709,2536,0,0,0,1.0,1,1.0,1,1.0,1,0.12353994919806914,40
2249,1,4246,1709,2537,0,0,0,1.0,1,1.0,1,1.0,1,0.08891259344017037,41
2250,0,4246,1709,2537,0,0,0,1.0,1,1.0,1,1.0,1,0.08891259344017037,41
2251,0,4246,1709,2537,0,0,0,1.0,1,1.0,1,1.0,1,0.1072342233171323,42
2252,1,4247,1709,2538,0,0,0,1.0,1,1.0,1,1.0,1,0.1087123397874894,41
2253,0,4247,1709,2538,0,0,0,1.0,1,1.0,1,1.0,1,0.09365967051451748,40
2254,1,4248,1710,2538,0,0,0,1.0,1,1.0,1,1.0,1,0.12494942158660029,39
2255,4,4252,1710,2542,0,0,0,1.0,1,1.0,1,1.0,1,0.11575112077606962,39
2256,3,4255,1712,2543,0,0,0,1.0,1,1.0,1,1.0,1,0.10779071266622074,40
2257,1,4256,1713,2543,0,0,0,1.0,1,1.0,1,1.0,1,0.14371602392864424,40
2258,1,4257,1714,2543,0,0,0,1.0,1,1.0,1,1.0,1,0.17463053159992165,39
2259,6,4263,1717,2546,0,0,0,1.0,1,1.0,1,1.0,1,0.1333153105191846,41
2260,0,4263,1717,2546,0,0,0,1.0,1,1.0,1,1.0,1,0.13212701665671753,38
2261,2,4265,1718,2547,0,0,0,1.0,1,1.0,1,1.0,1,0.12025601094376165,38
2262,2,4267,1719,2548,0,0,0,1.0,1,1.0,1,1.0,1,0.1739975026491187,36
2263,0,4267,1719,2548,0,0,0,1.0,1,1.0,1,1.0,1,0.14775561349703473,35
2264,3,4270,1722,2548,0,0,0,1.0,1,1.0,1,1.0,1,0.24033951262920145,33
2265,8,4278,1724,2554,0,0,0,1.0,1,1.0,1,1.0,1,0.16754922440852987,33
2266,2,4280,1725,2555,0,0,0,1.0,1,1.0,1,1.0,1,0.177768519525228,33
2267,3,4283,1727,2556,0,0,0,1.0,1,1.0,1,1.0,1,0.16531895336386815,33
2268,3,4286,1728,2558,0,0,0,1.0,1,1.0,1,1.0,1,0.15388515800769675,35
2269,2,4288,1729,2559,0,0,0,1.0,1,1.0,1,1.0,1,0.15001398850302378,36
2270,0,4288,1729,2559,0,0,0,1.0,1,1.0,1,1.0,1,0.15958898008822373,34
2271,7,4295,1733,2562,0,0,0,1.0,1,1.0,1,1.0,1,0.1452552303599353,34
2272,4,4299,1736,2563,0,0,0,1.0,1,1.0,1,1.0,1,0.18478656782458822,33
2273,3,4302,1737,2565,0,0,0,1.0,1,1.0,1,1.0,1,0.14136771534208883,32
2274,2,4304,1738,2566,0,0,0,1.0,1,1.0,1,1.0,1,0.14374049463112862,32
2275,0,4304,1738,2566,0,0,0,1.0,1,1.0,1,1.0,1,0.153884986030304,32
2276,0,4304,1738,2566,0,0,0,1.0,1,1.0,1,1.0,1,0.1902928758821927,31
2277,2,4306,1739,2567,0,0,0,1.0,1,1.0,1,1.0,1,0.17015971714835493,30
2278,1,4307,1739,2568,0,0,0,1.0,1,1.0,1,1.0,1,0.14006276453618535,33
2279,1,4308,1739,2569,0,0,0,1.0,1,1.0,1,1.0,1,0.10526459214094867,33
2280,2,4310,1739,2571,0,0,0,1.0,1,1.0,1,1.0,1,0.10808397289878931,35
2281,2,4312,1739,2573,0,0,0,1.0,1,1.0,1,1.0,1,0.08253361663698056,36
2282,0,4312,1739,2573,0,0,0,1.0,1,1.0,1,1.0,1,0.08253361663698056,36
2283,0,4312,1739,2573,0,0,0,1.0,1,1.0,1,1.0,1,0.08253361663698056,36
2284,1,4313,1740,2573,0,0,0,1.0,1,1.0,1,1.0,1,0.0861643686985756,36
2285,0,4313,1740,2573,0,0,0,1.0,1,1.0,1,1.0,1,0.07678079018549087,37
2286,1,4314,1741,2573,0,0,0,1.0,1,1.0,1,1.0,1,0.10524984908226952,38
2287,1,4315,1741,2574,0,0,0,1.0,1,1.0,1,1.0,1,0.0791098429732872,38
2288,1,4316,1742,2574,0,0,0,1.0,1,1.0,1,1.0,1,0.15403246336811957,40
2289,2,4318,1742,2576,0,0,0,1.0,1,1.0,1,1.0,1,0.1083437249843384,40
2290,0,4318,1742,2576,0,0,0,1.0,1,1.0,1,1.0,1,0.12828861956867554,39
2291,3,4321,1744,2577,0,0,0,1.0,1,1.0,1,1.0,1,0.16426478268061542,37
2292,1,4322,1745,2577,0,0,0,1.0,1,1.0,1,1.0,1,0.2150386953743419,35
2293,5,4327,1747,2580,0,0,0,1.0,1,1.0,1,1.0,1,0.24066513109830806,35
2294,3,4330,1747,2583,0,0,0,1.0,1,1.0,1,1.0,1,0.22615511938276187,35
2295,4,4334,1747,2587,0,0,0,1.0,1,1.0,1,1.0,1,0.10953441369723574,36
2296,2,4336,1747,2589,0,0,0,1.0,1,1.0,1,1.0,1,0.14695377593524517,34
2297,1,4337,1747,2590,0,0,0,1.0,1,1.0,1,1.0,1,0.14833402614871705,35
2298,0,4337,1747,2590,0,0,0,1.0,1,1.0,1,1.0,1,0.16561650354190538,34
2299,1,4338,1748,2590,0,0,0,1.0,1,1.0,1,1.0,1,0.1591665415202315,35
2300,1,4339,1748,2591,0,0,0,1.0,1,1.0,1,1.0,1,0.14413724778153006,35
2301,0,4339,1748,2591,0,0,0,1.0,1,1.0,1,1.0,1,0.14413724778153006,35
2302,3,4342,1751,2591,0,0,0,1.0,1,1.0,1,1.0,1,0.2147181442315978,37
2303,2,4344,1752,2592,0,0,0,1.0,1,1.0,1,1.0,1,0.1513328340378249,35
2304,2,4346,1754,2592,0,0,0,1.0,1,1.0,1,1.0,1,0.23532206099801106,36
2305,0,4346,1754,2592,0,0,0,1.0,1,1.0,1,1.0,1,0.23981701711509504,34
2306,4,4350,1754,2596,0,0,0,1.0,1,1.0,1,1.0,1,0.16011964737548337,35
2307,2,4352,1754,2598,0,0,0,1.0,1,1.0,1,1.0,1,0.11533543287482921,35
2308,0,4352,1754,2598,0,0,0,1.0,1,1.0,1,1.0,1,0.11533543287482921,35
2309,0,4352,1754,2598,0,0,0,1.0,1,1.0,1,1.0,1,0.1313734369463909,34
2310,0,4352,1754,2598,0,0,0,1.0,1,1.0,1,1.0,1,0.1335479155547447,36
2311,3,4355,1755,2600,0,0,0,1.0,1,1.0,1,1.0,1,0.12034021857983428,38
2312,3,4358,1757,2601,0,0,0,1.0,1,1.0,1,1.0,1,0.17906675881674317,39
2313,6,4364,1759,2605,0,0,0,1.0,1,1.0,1,1.0,1,0.12704213468222492,39
2314,2,4366,1759,2607,0,0,0,1.0,1,1.0,1,1.0,1,0.10287434670094307,39
2315,2,4368,1760,2608,0,0,0,1.0,1,1.0,1,1.0,1,0.14129219651768274,40
2316,1,4369,1761,2608,0,0,0,1.0,1,1.0,1,1.0,1,0.13931057132129523,40
2317,2,4371,1761,2610,0,0,0,1.0,1,1.0,1,1.0,1,0.12138919059253134,41
2318,2,4373,1762,2611,0,0,0,1.0,1,1.0,1,1.0,1,0.10298562141049346,41
2319,1,4374,1762,2612,0,0,0,1.0,1,1.0,1,1.0,1,0.06758253621268838,41
2320,0,4374,1762,2612,0,0,0,1.0,1,1.0,1,1.0,1,0.09150552586760725,42
2321,0,4374,1762,2612,0,0,0,1.0,1,1.0,1,1.0,1,0.08343954235641374,43
2322,0,4374,1762,2612,0,0,0,1.0,1,1.0,1,1.0,1,0.09308872338443575,42
2323,1,4375,1763,2612,0,0,0,1.0,1,1.0,1,1.0,1,0.14025408204345755,43
2324,2,4377,1764,2613,0,0,0,1.0,1,1.0,1,1.0,1,0.17150102209005832,44
2325,4,4381,1765,2616,0,0,0,1.0,1,1.0,1,1.0,1,0.11846005793992997,44
2326,2,4383,1765,2618,0,0,0,1.0,1,1.0,1,1.0,1,0.10448086976579514,45
2327,1,4384,1765,2619,0,0,0,1.0,1,1.0,1,1.0,1,0.08954825643042495,45
2328,0,4384,1765,2619,0,0,0,1.0,1,1.0,1,1.0,1,0.09752285396109303,46
2329,0,4384,1765,2619,0,0,0,1.0,1,1.0,1,1.0,1,0.12027697746421397,45
2330,1,4385,1766,2619,0,0,0,1.0,1,1.0,1,1.0,1,0.11568770435915399,47
2331,2,4387,1767,2620,0,0,0,1.0,1,1.0,1,1.0,1,0.12198540379739702,48
2332,0,4387,1767,2620,0,0,0,1.0,1,1.0,1,1.0,1,0.12198540379739702,48
2333,3,4390,1768,2622,0,0,0,1.0,1,1.0,1,1.0,1,0.13824894836356122,49
2334,0,4390,1768,2622,0,0,0,1.0,1,1.0,1,1.0,1,0.1452722901518405,47
2335,2,4392,1769,2623,0,0,0,1.0,1,1.0,1,1.0,1,0.16525122563983868,46
2336,1,4393,1769,2624,0,0,0,1.0,1,1.0,1,1.0,1,0.17345125792432947,46
2337,3,4396,1770,2626,0,0,0,1.0,1,1.0,1,1.0,1,0.14380574942219412,45
2338,2,4398,1770,2628,0,0,0,1.0,1,1.0,1,1.0,1,0.14838917845410055,44
2339,5,4403,1770,2633,0,0,0,1.0,1,1.0,1,1.0,1,0.09185204586370352,45
2340,1,4404,1771,2633,0,0,0,1.0,1,1.0,1,1.0,1,0.09452846127979368,44
2341,1,4405,1771,2634,0,0,0,1.0,1,1.0,1,1.0,1,0.08862298926610487,45
2342,1,4406,1772,2634,0,0,0,1.0,1,1.0,1,1.0,1,0.10506091357811556,47
2343,2,4408,1773,2635,0,0,0,1.0,1,1.0,1,1.0,1,0.09368326008737557,46
2344,1,4409,1773,2636,0,0,0,1.0,1,1.0,1,1.0,1,0.09320677974517859,46
2345,1,4410,1773,2637,0,0,0,1.0,1,1.0,1,1.0,1,0.09162118188407614,45
2346,0,4410,1773,2637,0,0,0,1.0,1,1.0,1,1.0,1,0.07828378623508045,46
2347,1,4411,1773,2638,0,0,0,1.0,1,1.0,1,1.0,1,0.06612658086032006,47
2348,2,4413,1775,2638,0,0,0,1.0,1,1.0,1,1.0,1,0.11911707519228786,49
2349,1,4414,1776,2638,0,0,0,1.0,1,1.0,1,1.0,1,0.15294328134106483,49
2350,0,4414,1776,2638,0,0,0,1.0,1,1.0,1,1.0,1,0.1287507250014319,50
2351,1,4415,1777,2638,0,0,0,1.0,1,1.0,1,1.0,1,0.1552839832775527,50
2352,1,4416,1777,2639,0,0,0,1.0,1,1.0,1,1.0,1,0.15604627863119974,51
2353,4,4420,1777,2643,0,0,0,1.0,1,1.0,1,1.0,1,0.12151847627030965,51
2354,2,4422,1777,2645,0,0,0,1.0,1,1.0,1,1.0,1,0.12998902509939061,51
2355,3,4425,1778,2647,0,0,0,1.0,1,1.0,1,1.0,1,0.11524014216204229,50
2356,0,4425,1778,2647,0,0,0,1.0,1,1.0,1,1.0,1,0.11524014216204229,50
2357,2,4427,1778,2649,0,0,0,1.0,1,1.0,1,1.0,1,0.09164158049605792,49
2358,1,4428,1778,2650,0,0,0,1.0,1,1.0,1,1.0,1,0.09178076664627524,51
2359,2,4430,1778,2652,0,0,0,1.0,1,1.0,1,1.0,1,0.06480540666872012,51
2360,0,4430,1778,2652,0,0,0,1.0,1,1.0,1,1.0,1,0.06480540666872012,51
2361,2,4432,1779,2653,0,0,0,1.0,1,1.0,1,1.0,1,0.08535715961266857,52
2362,2,4434,1780,2654,0,0,0,1.0,1,1.0,1,1.0,1,0.1094104441158034,53
2363,3,4437,1781,2656,0,0,0,1.0,1,1.0,1,1.0,1,0.09738485472336311,54
2364,3,4440,1782,2658,0,0,0,1.0,1,1.0,1,1.0,1,0.06696131605848336,55
2365,4,4444,1786,2658,0,0,0,1.0,1,1.0,1,1.0,1,0.09456912353594364,53
2366,3,4447,1789,2658,0,0,0,1.0,1,1.0,1,1.0,1,0.1068687292854825,53
2367,3,4450,1791,2659,0,0,0,1.0,1,1.0,1,1.0,1,0.15396070508359647,51
2368,3,4453,1793,2660,0,0,0,1.0,1,1.0,1,1.0,1,0.18741175621320838,50
2369,2,4455,1794,2661,0,0,0,1.0,1,1.0,1,1.0,1,0.212071696192833,47
2370,3,4458,1794,2664,0,0,0,1.0,1,1.0,1,1.0,1,0.18248347251395453,48
2371,3,4461,1796,2665,0,0,0,1.0,1,1.0,1,1.0,1,0.19281494285106235,49
2372,2,4463,1796,2667,0,0,0,1.0,1,1.0,1,1.0,1,0.1813788193679339,48
2373,1,4464,1797,2667,0,0,0,1.0,1,1.0,1,1.0,1,0.19403013458688173,49
2374,0,4464,1797,2667,0,0,0,1.0,1,1.0,1,1.0,1,0.19060119998901748,50
2375,1,4465,1797,2668,0,0,0,1.0,1,1.0,1,1.0,1,0.16002706657221827,50
2376,0,4465,1797,2668,0,0,0,1.0,1,1.0,1,1.0,1,0.16286298754884876,50
2377,0,4465,1797,2668,0,0,0,1.0,1,1.0,1,1.0,1,0.1653375660987667,49
2378,0,4465,1797,2668,0,0,0,1.0,1,1.0,1,1.0,1,0.1653375660987667,49
2379,0,4465,1797,2668,0,0,0,1.0,1,1.0,1,1.0,1,0.1775724856696072,50
2380,2,4467,1799,2668,0,0,0,1.0,1,1.0,1,1.0,1,0.2273846108309066,50
2381,3,4470,1800,2670,0,0,0,1.0,1,1.0,1,1.0,1,0.21993093125108285,51
2382,1,4471,1801,2670,0,0,0,1.0,1,1.0,1,1.0,1,0.23740805651500776,51
2383,6,4477,1802,2675,0,0,0,1.0,1,1.0,1,1.0,1,0.18007548329025488,52
2384,2,4479,1803,2676,0,0,0,1.0,1,1.0,1,1.0,1,0.15820920122010024,52
2385,5,4484,1805,2679,0,0,0,1.0,1,1.0,1,1.0,1,0.1763763121343653,51
2386,4,4488,1806,2682,0,0,0,1.0,1,1.0,1,1.0,1,0.18070477770176208,52
2387,1,4489,1806,2683,0,0,0,1.0,1,1.0,1,1.0,1,0.17608246873884237,49
2388,3,4492,1808,2684,0,0,0,1.0,1,1.0,1,1.0,1,0.20669968447986725,48
2389,5,4497,1809,2688,0,0,0,1.0,1,1.0,1,1.0,1,0.14986364769348953,48
2390,4,4501,1810,2691,0,0,0,1.0,1,1.0,1,1.0,1,0.12304672497498773,49
2391,2,4503,1811,2692,0,0,0,1.0,1,1.0,1,1.0,1,0.15176812737817777,48
2392,3,4506,1813,2693,0,0,0,1.0,1,1.0,1,1.0,1,0.15727862186367203,49
2393,3,4509,1814,2695,0,0,0,1.0,1,1.0,1,1.0,1,0.15849532508278216,50
2394,2,4511,1815,2696,0,0,0,1.0,1,1.0,1,1.0,1,0.12851048664607997,50
2395,2,4513,1817,2696,0,0,0,1.0,1,1.0,1,1.0,1,0.15430343165641944,49
2396,1,4514,1817,2697,0,0,0,1.0,1,1.0,1,1.0,1,0.1607139899278756,50
2397,3,4517,1819,2698,0,0,0,1.0,1,1.0,1,1.0,1,0.1937454247363812,51
2398,4,4521,1821,2700,0,0,0,1.0,1,1.0,1,1.0,1,0.16161063596789446,49
2399,1,4522,1821,2701,0,0,0,1.0,1,1.0,1,1.0,1,0.1519617038535503,50
2400,2,4524,1821,2703,0,0,0,1.0,1,1.0,1,1.0,1,0.13684028474397048,51
2401,2,4526,1821,2705,0,0,0,1.0,1,1.0,1,1.0,1,0.13531091548282628,50
2402,0,4526,1821,2705,0,0,0,1.0,1,1.0,1,1.0,1,0.1325829957538338,51
2403,0,4526,1821,2705,0,0,0,1.0,1,1.0,1,1.0,1,0.14208834944032706,52
2404,2,4528,1821,2707,0,0,0,1.0,1,1.0,1,1.0,1,0.11342697635074066,53
2405,1,4529,1821,2708,0,0,0,1.0,1,1.0,1,1.0,1,0.10363132834544618,52
2406,1,4530,1822,2708,0,0,0,1.0,1,1.0,1,1.0,1,0.11234370137980518,52
2407,3,4533,1822,2711,0,0,0,1.0,1,1.0,1,1.0,1,0.12032964540320722,51
2408,0,4533,1822,2711,0,0,0,1.0,1,1.0,1,1.0,1,0.14373090928812793,50
2409,1,4534,1822,2712,0,0,0,1.0,1,1.0,1,1.0,1,0.15243313011814594,50
2410,1,4535,1823,2712,0,0,0,1.0,1,1.0,1,1.0,1,0.17189722440799834,49
2411,1,4536,1824,2712,0,0,0,1.0,1,1.0,1,1.0,1,0.20939609103336546,48
2412,1,4537,1824,2713,0,0,0,1.0,1,1.0,1,1.0,1,0.2162288186651447,47
2413,1,4538,1824,2714,0,0,0,1.0,1,1.0,1,1.0,1,0.20329496979079922,47
2414,3,4541,1825,2716,0,0,0,1.0,1,1.0,1,1.0,1,0.24613035245513118,47
2415,2,4543,1825,2718,0,0,0,1.0,1,1.0,1,1.0,1,0.2224771006533018,46
2416,0,4543,1825,2718,0,0,0,1.0,1,1.0,1,1.0,1,0.194084952105219,47
2417,1,4544,1825,2719,0,0,0,1.0,1,1.0,1,1.0,1,0.19356989053939638,46
2418,2,4546,1826,2720,0,0,0,1.0,1,1.0,1,1.0,1,0.20429099213856053,48
2419,2,4548,1826,2722,0,0,0,1.0,1,1.0,1,1.0,1,0.1869104045568539,47
2420,2,4550,1826,2724,0,0,0,1.0,1,1.0,1,1.0,1,0.15790651496682762,49
2421,1,4551,1826,2725,0,0,0,1.0,1,1.0,1,1.0,1,0.14196912444436677,50
2422,4,4555,1829,2726,0,0,0,1.0,1,1.0,1,1.0,1,0.1459689439719523,50
2423,3,4558,1829,2729,0,0,0,1.0,1,1.0,1,1.0,1,0.1164245567562614,51
2424,2,4560,1831,2729,0,0,0,1.0,1,1.0,1,1.0,1,0.1273167287814546,50
2425,2,4562,1831,2731,0,0,0,1.0,1,1.0,1,1.0,1,0.09483919231091413,48
2426,1,4563,1832,2731,0,0,0,1.0,1,1.0,1,1.0,1,0.1135300482644126,51
2427,3,4566,1834,2732,0,0,0,1.0,1,1.0,1,1.0,1,0.11900077727717671,50
2428,1,4567,1834,2733,0,0,0,1.0,1,1.0,1,1.0,1,0.09249464037433151,49
2429,4,4571,1837,2734,0,0,0,1.0,1,1.0,1,1.0,1,0.1514635539864798,49
2430,0,4571,1837,2734,0,0,0,1.0,1,1.0,1,1.0,1,0.18800478800347437,46
2431,2,4573,1838,2735,0,0,0,1.0,1,1.0,1,1.0,1,0.17616467416856665,45
2432,4,4577,1839,2738,0,0,0,1.0,1,1.0,1,1.0,1,0.22797474301849663,44
2433,2,4579,1839,2740,0,0,0,1.0,1,1.0,1,1.0,1,0.13135545362129936,45
2434,0,4579,1839,2740,0,0,0,1.0,1,1.0,1,1.0,1,0.141796149056083,44
2435,1,4580,1839,2741,0,0,0,1.0,1,1.0,1,1.0,1,0.12310191497502807,44
2436,0,4580,1839,2741,0,0,0,1.0,1,1.0,1,1.0,1,0.12310191497502807,44
2437,3,4583,1841,2742,0,0,0,1.0,1,1.0,1,1.0,1,0.11508790887087539,45
2438,1,4584,1842,2742,0,0,0,1.0,1,1.0,1,1.0,1,0.14956163168055847,45
2439,3,4587,1842,2745,0,0,0,1.0,1,1.0,1,1.0,1,0.11500909385459443,46
2440,0,4587,1842,2745,0,0,0,1.0,1,1.0,1,1.0,1,0.1293895826517432,45
2441,3,4590,1843,2747,0,0,0,1.0,1,1.0,1,1.0,1,0.11939941340054333,45
2442,2,4592,1843,2749,0,0,0,1.0,1,1.0,1,1.0,1,0.09034008613000909,46
2443,0,4592,1843,2749,0,0,0,1.0,1,1.0,1,1.0,1,0.095617217633351,45
2444,3,4595,1846,2749,0,0,0,1.0,1,1.0,1,1.0,1,0.1813942033176829,46
2445,4,4599,1846,2753,0,0,0,1.0,1,1.0,1,1.0,1,0.1611701300302217,44
2446,8,4607,1849,2758,0,0,0,1.0,1,1.0,1,1.0,1,0.1007609187597209,44
2447,1,4608,1849,2759,0,0,0,1.0,1,1.0,1,1.0,1,0.12703639636338415,42
2448,1,4609,1850,2759,0,0,0,1.0,1,1.0,1,1.0,1,0.1457866801473368,41
2449,4,4613,1851,2762,0,0,0,1.0,1,1.0,1,1.0,1,0.12343495719828687,40
2450,4,4617,1854,2763,0,0,0,1.0,1,1.0,1,1.0,1,0.1581742980184045,42
2451,0,4617,1854,2763,0,0,0,1.0,1,1.0,1,1.0,1,0.1531894931354823,43
2452,2,4619,1854,2765,0,0,0,1.0,1,1.0,1,1.0,1,0.11154601114836533,43
2453,0,4619,1854,2765,0,0,0,1.0,1,1.0,1,1.0,1,0.13584425646571519,45
2454,3,4622,1855,2767,0,0,0,1.0,1,1.0,1,1.0,1,0.15671266118543178,47
2455,0,4622,1855,2767,0,0,0,1.0,1,1.0,1,1.0,1,0.1640755374806281,48
2456,4,4626,1857,2769,0,0,0,1.0,1,1.0,1,1.0,1,0.1794602670080884,49
2457,3,4629,1859,2770,0,0,0,1.0,1,1.0,1,1.0,1,0.2253156663603128,48
2458,2,4631,1859,2772,0,0,0,1.0,1,1.0,1,1.0,1,0.21344500140270126,49
2459,3,4634,1859,2775,0,0,0,1.0,1,1.0,1,1.0,1,0.1631700776855643,49
2460,2,4636,1860,2776,0,0,0,1.0,1,1.0,1,1.0,1,0.18801441539767375,50
2461,2,4638,1860,2778,0,0,0,1.0,1,1.0,1,1.0,1,0.16732910321327896,50
2462,5,4643,1862,2781,0,0,0,1.0,1,1.0,1,1.0,1,0.1723414095201224,51
2463,4,4647,1864,2783,0,0,0,1.0,1,1.0,1,1.0,1,0.21826177443769396,51
2464,4,4651,1866,2785,0,0,0,1.0,1,1.0,1,1.0,1,0.2070430741500433,50
2465,5,4656,1868,2788,0,0,0,1.0,1,1.0,1,1.0,1,0.21124785053645995,49
2466,5,4661,1869,2792,0,0,0,1.0,1,1.0,1,1.0,1,0.16873683699657488,49
2467,2,4663,1869,2794,0,0,0,1.0,1,1.0,1,1.0,1,0.13926594227816896,48
2468,3,4666,1871,2795,0,0,0,1.0,1,1.0,1,1.0,1,0.16904514725040914,47
2469,3,4669,1871,2798,0,0,0,1.0,1,1.0,1,1.0,1,0.08264989234065323,46
2470,1,4670,1871,2799,0,0,0,1.0,1,1.0,1,1.0,1,0.06825235497065027,44
2471,0,4670,1871,2799,0,0,0,1.0,1,1.0,1,1.0,1,0.09082062010428878,44
2472,2,4672,1871,2801,0,0,0,1.0,1,1.0,1,1.0,1,0.10252672300755974,44
2473,2,4674,1872,2802,0,0,0,1.0,1,1.0,1,1.0,1,0.09969353746399566,43
2474,4,4678,1874,2804,0,0,0,1.0,1,1.0,1,1.0,1,0.09211736811157874,44
2475,0,4678,1874,2804,0,0,0,1.0,1,1.0,1,1.0,1,0.07381861872679413,46
2476,0,4678,1874,2804,0,0,0,1.0,1,1.0,1,1.0,1,0.07381861872679413,46
2477,0,4678,1874,2804,0,0,0,1.0,1,1.0,1,1.0,1,0.07381861872679413,46
2478,0,4678,1874,2804,0,0,0,1.0,1,1.0,1,1.0,1,0.07381861872679413,46
2479,0,4678,1874,2804,0,0,0,1.0,1,1.0,1,1.0,1,0.07381861872679413,46
2480,3,4681,1875,2806,0,0,0,1.0,1,1.0,1,1.0,1,0.07883804520140433,47
2481,3,4684,1877,2807,0,0,0,1.0,1,1.0,1,1.0,1,0.061351598947310994,47
2482,0,4684,1877,2807,0,0,0,1.0,1,1.0,1,1.0,1,0.11558556041042342,45
2483,1,4685,1877,2808,0,0,0,1.0,1,1.0,1,1.0,1,0.13869462900201096,45
2484,4,4689,1879,2810,0,0,0,1.0,1,1.0,1,1.0,1,0.1416379101841048,46
2485,1,4690,1880,2810,0,0,0,1.0,1,1.0,1,1.0,1,0.13925577587477436,44
2486,0,4690,1880,2810,0,0,0,1.0,1,1.0,1,1.0,1,0.1379584172891637,43
2487,1,4691,1881,2810,0,0,0,1.0,1,1.0,1,1.0,1,0.16924499058392384,44
2488,4,4695,1883,2812,0,0,0,1.0,1,1.0,1,1.0,1,0.18344808048897826,45
2489,5,4700,1883,2817,0,0,0,1.0,1,1.0,1,1.0,1,0.12012845769208028,44
2490,3,4703,1885,2818,0,0,0,1.0,1,1.0,1,1.0,1,0.13992142550872344,44
2491,2,4705,1885,2820,0,0,0,1.0,1,1.0,1,1.0,1,0.15081535832517323,44
2492,0,4705,1885,2820,0,0,0,1.0,1,1.0,1,1.0,1,0.15081535832517323,44
2493,0,4705,1885,2820,0,0,0,1.0,1,1.0,1,1.0,1,0.19166232865552482,42
2494,0,4705,1885,2820,0,0,0,1.0,1,1.0,1,1.0,1,0.19166232865552482,42
2495,2,4707,1886,2821,0,0,0,1.0,1,1.0,1,1.0,1,0.19861932816763989,42
2496,0,4707,1886,2821,0,0,0,1.0,1,1.0,1,1.0,1,0.19861932816763989,42
2497,4,4711,1886,2825,0,0,0,1.0,1,1.0,1,1.0,1,0.16314341338522553,44
2498,2,4713,1887,2826,0,0,0,1.0,1,1.0,1,1.0,1,0.1859070958055984,43
2499,1,4714,1888,2826,0,0,0,1.0,1,1.0,1,1.0,1,0.15691627333033692,43
2500,1,4715,1888,2827,0,0,0,1.0,1,1.0,1,1.0,1,0.13106809016889878,44
2501,3,4718,1888,2830,0,0,0,1.0,1,1.0,1,1.0,1,0.13527133972290167,46
2502,3,4721,1890,2831,0,0,0,1.0,1,1.0,1,1.0,1,0.12503678586548833,47
2503,0,4721,1890,2831,0,0,0,1.0,1,1.0,1,1.0,1,0.1251947991058584,47
2504,3,4724,1892,2832,0,0,0,1.0,1,1.0,1,1.0,1,0.16475667934706723,46
2505,5,4729,1896,2833,0,0,0,1.0,1,1.0,1,1.0,1,0.17888543829051687,46
2506,0,4729,1896,2833,0,0,0,1.0,1,1.0,1,1.0,1,0.16638490295608974,45
2507,3,4732,1897,2835,0,0,0,1.0,1,1.0,1,1.0,1,0.16687144262864403,45
2508,4,4736,1899,2837,0,0,0,1.0,1,1.0,1,1.0,1,0.17260251638365903,46
2509,3,4739,1900,2839,0,0,0,1.0,1,1.0,1,1.0,1,0.1515800559846471,45
2510,3,4742,1901,2841,0,0,0,1.0,1,1.0,1,1.0,1,0.14698909739388033,46
2511,3,4745,1902,2843,0,0,0,1.0,1,1.0,1,1.0,1,0.13540848876197717,47
2512,2,4747,1902,2845,0,0,0,1.0,1,1.0,1,1.0,1,0.12570862284898968,47
2513,2,4749,1903,2846,0,0,0,1.0,1,1.0,1,1.0,1,0.12704625894330832,48
2514,3,4752,1905,2847,0,0,0,1.0,1,1.0,1,1.0,1,0.14624441942394806,48
2515,4,4756,1906,2850,0,0,0,1.0,1,1.0,1,1.0,1,0.08061040120318427,49
2516,1,4757,1907,2850,0,0,0,1.0,1,1.0,1,1.0,1,0.11155051139304373,49
2517,1,4758,1907,2851,0,0,0,1.0,1,1.0,1,1.0,1,0.10005461830234486,49
2518,3,4761,1909,2852,0,0,0,1.0,1,1.0,1,1.0,1,0.10750358870708569,48
2519,2,4763,1910,2853,0,0,0,1.0,1,1.0,1,1.0,1,0.11089221835301227,48
2520,2,4765,1911,2854,0,0,0,1.0,1,1.0,1,1.0,1,0.12679719843324008,46
2521,4,4769,1913,2856,0,0,0,1.0,1,1.0,1,1.0,1,0.11625665971995082,47
2522,1,4770,1914,2856,0,0,0,1.0,1,1.0,1,1.0,1,0.1775476593560767,45
2523,1,4771,1914,2857,0,0,0,1.0,1,1.0,1,1.0,1,0.17133615575453953,44
2524,0,4771,1914,2857,0,0,0,1.0,1,1.0,1,1.0,1,0.18607634706480658,42
2525,1,4772,1914,2858,0,0,0,1.0,1,1.0,1,1.0,1,0.19341257575072146,42
2526,0,4772,1914,2858,0,0,0,1.0,1,1.0,1,1.0,1,0.19675843322274733,41
2527,2,4774,1914,2860,0,0,0,1.0,1,1.0,1,1.0,1,0.1614527581055767,41
2528,1,4775,1914,2861,0,0,0,1.0,1,1.0,1,1.0,1,0.1431882483150286,41
2529,1,4776,1915,2861,0,0,0,1.0,1,1.0,1,1.0,1,0.15677018604198087,42
2530,0,4776,1915,2861,0,0,0,1.0,1,1.0,1,1.0,1,0.16428937015850975,41
2531,0,4776,1915,2861,0,0,0,1.0,1,1.0,1,1.0,1,0.16428937015850975,41
2532,1,4777,1915,2862,0,0,0,1.0,1,1.0,1,1.0,1,0.17084287068456525,43
2533,1,4778,1915,2863,0,0,0,1.0,1,1.0,1,1.0,1,0.1632164940131991,43
2534,0,4778,1915,2863,0,0,0,1.0,1,1.0,1,1.0,1,0.1632164940131991,43
2535,3,4781,1916,2865,0,0,0,1.0,1,1.0,1,1.0,1,0.18551711664089854,44
2536,0,4781,1916,2865,0,0,0,1.0,1,1.0,1,1.0,1,0.18551711664089854,44
2537,1,4782,1917,2865,0,0,0,1.0,1,1.0,1,1.0,1,0.21163429635419756,45
2538,0,4782,1917,2865,0,0,0,1.0,1,1.0,1,1.0,1,0.22233399617476055,48
2539,5,4787,1919,2868,0,0,0,1.0,1,1.0,1,1.0,1,0.23170797185836955,48
2540,3,4790,1919,2871,0,0,0,1.0,1,1.0,1,1.0,1,0.19708306293356703,50
2541,5,4795,1919,2876,0,0,0,1.0,1,1.0,1,1.0,1,0.17256624198441997,52
2542,9,4804,1923,2881,0,0,0,1.0,1,1.0,1,1.0,1,0.18592400805735276,52
2543,4,4808,1924,2884,0,0,0,1.0,1,1.0,1,1.0,1,0.2016625403666496,51
2544,3,4811,1926,2885,0,0,0,1.0,1,1.0,1,1.0,1,0.17574417257702613,51
2545,2,4813,1926,2887,0,0,0,1.0,1,1.0,1,1.0,1,0.13511724841318526,50
2546,2,4815,1928,2887,0,0,0,1.0,1,1.0,1,1.0,1,0.13633069130159345,50
2547,5,4820,1930,2890,0,0,0,1.0,1,1.0,1,1.0,1,0.10744086264203778,47
2548,0,4820,1930,2890,0,0,0,1.0,1,1.0,1,1.0,1,0.09914942874108984,46
2549,3,4823,1932,2891,0,0,0,1.0,1,1.0,1,1.0,1,0.1446370203407144,46
2550,2,4825,1933,2892,0,0,0,1.0,1,1.0,1,1.0,1,0.13290676141918392,44
2551,2,4827,1933,2894,0,0,0,1.0,1,1.0,1,1.0,1,0.05262606100739258,43
2552,0,4827,1933,2894,0,0,0,1.0,1,1.0,1,1.0,1,0.07895730378347014,43
2553,0,4827,1933,2894,0,0,0,1.0,1,1.0,1,1.0,1,0.09533826187899541,44
2554,1,4828,1934,2894,0,0,0,1.0,1,1.0,1,1.0,1,0.12768686411229266,45
2555,2,4830,1935,2895,0,0,0,1.0,1,1.0,1,1.0,1,0.13722960883582278,44
2556,2,4832,1935,2897,0,0,0,1.0,1,1.0,1,1.0,1,0.11528078621142789,44
2557,2,4834,1936,2898,0,0,0,1.0,1,1.0,1,1.0,1,0.15229558552350428,41
2558,1,4835,1936,2899,0,0,0,1.0,1,1.0,1,1.0,1,0.12169146131550046,40
2559,2,4837,1936,2901,0,0,0,1.0,1,1.0,1,1.0,1,0.09964500419601327,41
2560,0,4837,1936,2901,0,0,0,1.0,1,1.0,1,1.0,1,0.09964500419601327,41
2561,1,4838,1936,2902,0,0,0,1.0,1,1.0,1,1.0,1,0.09950154046922287,43
2562,1,4839,1937,2902,0,0,0,1.0,1,1.0,1,1.0,1,0.12156974985118581,44
2563,1,4840,1938,2902,0,0,0,1.0,1,1.0,1,1.0,1,0.14703946203364848,44
2564,3,4843,1940,2903,0,0,0,1.0,1,1.0,1,1.0,1,0.1886195900364201,44
2565,1,4844,1940,2904,0,0,0,1.0,1,1.0,1,1.0,1,0.16759904234017994,45
2566,1,4845,1940,2905,0,0,0,1.0,1,1.0,1,1.0,1,0.16217830077399153,46
2567,2,4847,1942,2905,0,0,0,1.0,1,1.0,1,1.0,1,0.18624640152824098,48
2568,2,4849,1943,2906,0,0,0,1.0,1,1.0,1,1.0,1,0.19484948161217283,48
2569,4,4853,1943,2910,0,0,0,1.0,1,1.0,1,1.0,1,0.1797820902916904,49
2570,2,4855,1943,2912,0,0,0,1.0,1,1.0,1,1.0,1,0.1827381954240175,48
2571,3,4858,1943,2915,0,0,0,1.0,1,1.0,1,1.0,1,0.16584535363045025,48
2572,2,4860,1943,2917,0,0,0,1.0,1,1.0,1,1.0,1,0.138831100215601,49
2573,0,4860,1943,2917,0,0,0,1.0,1,1.0,1,1.0,1,0.12580179919604514,50
2574,2,4862,1945,2917,0,0,0,1.0,1,1.0,1,1.0,1,0.14481796101454908,49
2575,1,4863,1945,2918,0,0,0,1.0,1,1.0,1,1.0,1,0.12846890107924122,48
2576,0,4863,1945,2918,0,0,0,1.0,1,1.0,1,1.0,1,0.12846890107924122,48
2577,1,4864,1945,2919,0,0,0,1.0,1,1.0,1,1.0,1,0.14110967213788297,50
2578,0,4864,1945,2919,0,0,0,1.0,1,1.0,1,1.0,1,0.14110967213788297,50
2579,1,4865,1946,2919,0,0,0,1.0,1,1.0,1,1.0,1,0.1517675437586165,51
2580,1,4866,1946,2920,0,0,0,1.0,1,1.0,1,1.0,1,0.1448060143918646,52
2581,1,4867,1946,2921,0,0,0,1.0,1,1.0,1,1.0,1,0.14386916216441056,51
2582,1,4868,1947,2921,0,0,0,1.0,1,1.0,1,1.0,1,0.15121884608918043,51
2583,3,4871,1948,2923,0,0,0,1.0,1,1.0,1,1.0,1,0.12201728161502712,51
2584,5,4876,1950,2926,0,0,0,1.0,1,1.0,1,1.0,1,0.09494221837587657,51
2585,2,4878,1951,2927,0,0,0,1.0,1,1.0,1,1.0,1,0.10714488076085994,50
2586,4,4882,1954,2928,0,0,0,1.0,1,1.0,1,1.0,1,0.1289138671686012,50
2587,2,4884,1955,2929,0,0,0,1.0,1,1.0,1,1.0,1,0.09680103877380557,48
2588,2,4886,1957,2929,0,0,0,1.0,1,1.0,1,1.0,1,0.11759773709177195,50
2589,0,4886,1957,2929,0,0,0,1.0,1,1.0,1,1.0,1,0.09041053895015809,48
2590,0,4886,1957,2929,0,0,0,1.0,1,1.0,1,1.0,1,0.10114629754059241,47
2591,3,4889,1958,2931,0,0,0,1.0,1,1.0,1,1.0,1,0.0823432608655659,47
2592,2,4891,1960,2931,0,0,0,1.0,1,1.0,1,1.0,1,0.10285755435360694,47
2593,3,4894,1961,2933,0,0,0,1.0,1,1.0,1,1.0,1,0.09590214043333367,47
2594,6,4900,1964,2936,0,0,0,1.0,1,1.0,1,1.0,1,0.15981926471762736,49
2595,7,4907,1966,2941,0,0,0,1.0,1,1.0,1,1.0,1,0.08522580718057345,48
2596,1,4908,1967,2941,0,0,0,1.0,1,1.0,1,1.0,1,0.08000665664791361,47
2597,0,4908,1967,2941,0,0,0,1.0,1,1.0,1,1.0,1,0.07236474155247825,48
2598,2,4910,1969,2941,0,0,0,1.0,1,1.0,1,1.0,1,0.07102422085773308,48
2599,0,4910,1969,2941,0,0,0,1.0,1,1.0,1,1.0,1,0.06047424669704877,49
2600,1,4911,1970,2941,0,0,0,1.0,1,1.0,1,1.0,1,0.06806449539997071,52
2601,4,4915,1972,2943,0,0,0,1.0,1,1.0,1,1.0,1,0.10254122145288083,51
2602,2,4917,1972,2945,0,0,0,1.0,1,1.0,1,1.0,1,0.10031096121345015,52
2603,2,4919,1973,2946,0,0,0,1.0,1,1.0,1,1.0,1,0.1369001195919137,53
2604,0,4919,1973,2946,0,0,0,1.0,1,1.0,1,1.0,1,0.1369001195919137,53
2605,2,4921,1973,2948,0,0,0,1.0,1,1.0,1,1.0,1,0.1351612021346184,52
2606,2,4923,1973,2950,0,0,0,1.0,1,1.0,1,1.0,1,0.12921206199441554,52
2607,1,4924,1973,2951,0,0,0,1.0,1,1.0,1,1.0,1,0.12497266847982381,52
2608,0,4924,1973,2951,0,0,0,1.0,1,1.0,1,1.0,1,0.12497266847982381,52
2609,2,4926,1974,2952,0,0,0,1.0,1,1.0,1,1.0,1,0.10509622606815486,53
2610,0,4926,1974,2952,0,0,0,1.0,1,1.0,1,1.0,1,0.11608465876769564,54
2611,4,4930,1976,2954,0,0,0,1.0,1,1.0,1,1.0,1,0.1031088941692251,54
2612,4,4934,1978,2956,0,0,0,1.0,1,1.0,1,1.0,1,0.1090851671319923,56
2613,3,4937,1979,2958,0,0,0,1.0,1,1.0,1,1.0,1,0.09958530058805523,56
2614,1,4938,1980,2958,0,0,0,1.0,1,1.0,1,1.0,1,0.10531807776314586,56
2615,2,4940,1981,2959,0,0,0,1.0,1,1.0,1,1.0,1,0.09874673010547302,57
2616,2,4942,1981,2961,0,0,0,1.0,1,1.0,1,1.0,1,0.04963781472602824,57
2617,1,4943,1982,2961,0,0,0,1.0,1,1.0,1,1.0,1,0.06963635295992136,58
2618,1,4944,1982,2962,0,0,0,1.0,1,1.0,1,1.0,1,0.05784087984184138,58
2619,0,4944,1982,2962,0,0,0,1.0,1,1.0,1,1.0,1,0.06124312118950265,58
2620,0,4944,1982,2962,0,0,0,1.0,1,1.0,1,1.0,1,0.06839131754019702,60
2621,1,4945,1982,2963,0,0,0,1.0,1,1.0,1,1.0,1,0.06344344999487073,59
2622,1,4946,1982,2964,0,0,0,1.0,1,1.0,1,1.0,1,0.0692797281003278,60
2623,3,4949,1984,2965,0,0,0,1.0,1,1.0,1,1.0,1,0.05993079699787436,59
2624,3,4952,1987,2965,0,0,0,1.0,1,1.0,1,1.0,1,0.1268747908195143,58
2625,5,4957,1989,2968,0,0,0,1.0,1,1.0,1,1.0,1,0.1264969916136073,58
2626,8,4965,1992,2973,0,0,0,1.0,1,1.0,1,1.0,1,0.09917398212280865,57
2627,1,4966,1992,2974,0,0,0,1.0,1,1.0,1,1.0,1,0.09117665803885476,55
2628,2,4968,1994,2974,0,0,0,1.0,1,1.0,1,1.0,1,0.09957471620562912,55
2629,2,4970,1994,2976,0,0,0,1.0,1,1.0,1,1.0,1,0.09046265858954054,54
2630,2,4972,1995,2977,0,0,0,1.0,1,1.0,1,1.0,1,0.13157234552261385,55
2631,1,4973,1995,2978,0,0,0,1.0,1,1.0,1,1.0,1,0.11928540898320816,55
2632,3,4976,1997,2979,0,0,0,1.0,1,1.0,1,1.0,1,0.14373375854713877,55
2633,3,4979,1998,2981,0,0,0,1.0,1,1.0,1,1.0,1,0.09224888191646673,53
2634,5,4984,1999,2985,0,0,0,1.0,1,1.0,1,1.0,1,0.1137935468978357,52
2635,1,4985,1999,2986,0,0,0,1.0,1,1.0,1,1.0,1,0.09709515830491681,52
2636,3,4988,2002,2986,0,0,0,1.0,1,1.0,1,1.0,1,0.20311459144318497,51
2637,4,4992,2004,2988,0,0,0,1.0,1,1.0,1,1.0,1,0.14650332200853264,50
2638,3,4995,2005,2990,0,0,0,1.0,1,1.0,1,1.0,1,0.13653882543962015,48
2639,4,4999,2006,2993,0,0,0,1.0,1,1.0,1,1.0,1,0.11228041323458658,48
2640,3,5002,2009,2993,0,0,0,1.0,1,1.0,1,1.0,1,0.14829060083009943,46
2641,5,5007,2011,2996,0,0,0,1.0,1,1.0,1,1.0,1,0.13899441591086073,46
2642,9,5016,2017,2999,0,0,0,1.0,1,1.0,1,1.0,1,0.15331439413707534,47
2643,5,5021,2017,3004,0,0,0,1.0,1,1.0,1,1.0,1,0.06012165764741705,45
2644,0,5021,2017,3004,0,0,0,1.0,1,1.0,1,1.0,1,0.051970275382968945,44
2645,0,5021,2017,3004,0,0,0,1.0,1,1.0,1,1.0,1,0.07303739958957695,42
2646,1,5022,2018,3004,0,0,0,1.0,1,1.0,1,1.0,1,0.08042643037929653,43
2647,3,5025,2019,3006,0,0,0,1.0,1,1.0,1,1.0,1,0.1266839168106905,40
2648,1,5026,2020,3006,0,0,0,1.0,1,1.0,1,1.0,1,0.0895426042715874,41
2649,0,5026,2020,3006,0,0,0,1.0,1,1.0,1,1.0,1,0.09953289852155166,43
2650,3,5029,2020,3009,0,0,0,1.0,1,1.0,1,1.0,1,0.05234274625003363,43
2651,0,5029,2020,3009,0,0,0,1.0,1,1.0,1,1.0,1,0.06847134300590152,44
2652,0,5029,2020,3009,0,0,0,1.0,1,1.0,1,1.0,1,0.06847134300590152,44
2653,0,5029,2020,3009,0,0,0,1.0,1,1.0,1,1.0,1,0.06847134300590152,44
2654,0,5029,2020,3009,0,0,0,1.0,1,1.0,1,1.0,1,0.07547281613978372,45
2655,1,5030,2021,3009,0,0,0,1.0,1,1.0,1,1.0,1,0.07050729831436396,45
2656,1,5031,2022,3009,0,0,0,1.0,1,1.0,1,1.0,1,0.09604784978176104,45
2657,1,5032,2022,3010,0,0,0,1.0,1,1.0,1,1.0,1,0.11728299227771086,45
2658,2,5034,2023,3011,0,0,0,1.0,1,1.0,1,1.0,1,0.12832792115457922,47
2659,1,5035,2023,3012,0,0,0,1.0,1,1.0,1,1.0,1,0.12804616467793553,46
2660,2,5037,2024,3013,0,0,0,1.0,1,1.0,1,1.0,1,0.10501940062246287,46
2661,2,5039,2025,3014,0,0,0,1.0,1,1.0,1,1.0,1,0.12343393558420644,46
2662,2,5041,2026,3015,0,0,0,1.0,1,1.0,1,1.0,1,0.12142730510989001,47
2663,7,5048,2029,3019,0,0,0,1.0,1,1.0,1,1.0,1,0.1068240369175431,46
2664,4,5052,2032,3020,0,0,0,1.0,1,1.0,1,1.0,1,0.09267731624538451,45
2665,8,5060,2035,3025,0,0,0,1.0,1,1.0,1,1.0,1,0.13016381856569129,47
2666,4,5064,2038,3026,0,0,0,1.0,1,1.0,1,1.0,1,0.14054864170031248,47
2667,3,5067,2039,3028,0,0,0,1.0,1,1.0,1,1.0,1,0.12512928155392677,45
2668,5,5072,2041,3031,0,0,0,1.0,1,1.0,1,1.0,1,0.11980902626257184,45
2669,3,5075,2043,3032,0,0,0,1.0,1,1.0,1,1.0,1,0.13591804258849854,45
2670,3,5078,2045,3033,0,0,0,1.0,1,1.0,1,1.0,1,0.1515557189945078,45
2671,3,5081,2046,3035,0,0,0,1.0,1,1.0,1,1.0,1,0.1535788437352451,41
2672,1,5082,2047,3035,0,0,0,1.0,1,1.0,1,1.0,1,0.14578741417164184,40
2673,1,5083,2047,3036,0,0,0,1.0,1,1.0,1,1.0,1,0.15825635548617764,39
2674,1,5084,2048,3036,0,0,0,1.0,1,1.0,1,1.0,1,0.17311485551038408,37
2675,3,5087,2050,3037,0,0,0,1.0,1,1.0,1,1.0,1,0.13239663402747118,35
2676,3,5090,2051,3039,0,0,0,1.0,1,1.0,1,1.0,1,0.130321592329675,34
2677,1,5091,2051,3040,0,0,0,1.0,1,1.0,1,1.0,1,0.1581558572901983,32
2678,1,5092,2051,3041,0,0,0,1.0,1,1.0,1,1.0,1,0.13822718147646365,33
2679,3,5095,2053,3042,0,0,0,1.0,1,1.0,1,1.0,1,0.17939075176231603,33
2680,4,5099,2056,3043,0,0,0,1.0,1,1.0,1,1.0,1,0.23864436768210506,33
2681,1,5100,2056,3044,0,0,0,1.0,1,1.0,1,1.0,1,0.15095929214899187,32
2682,3,5103,2057,3046,0,0,0,1.0,1,1.0,1,1.0,1,0.07832850082342926,32
2683,1,5104,2058,3046,0,0,0,1.0,1,1.0,1,1.0,1,0.17466039027740388,32
2684,0,5104,2058,3046,0,0,0,1.0,1,1.0,1,1.0,1,0.17533736971916913,31
2685,5,5109,2059,3050,0,0,0,1.0,1,1.0,1,1.0,1,0.16841218182848605,30
2686,4,5113,2061,3052,0,0,0,1.0,1,1.0,1,1.0,1,0.19082034369743264,29
2687,3,5116,2061,3055,0,0,0,1.0,1,1.0,1,1.0,1,0.1382004254313026,28
2688,0,5116,2061,3055,0,0,0,1.0,1,1.0,1,1.0,1,0.1382004254313026,28
2689,0,5116,2061,3055,0,0,0,1.0,1,1.0,1,1.0,1,0.17688624375709752,29
2690,0,5116,2061,3055,0,0,0,1.0,1,1.0,1,1.0,1,0.17688624375709752,29
2691,2,5118,2063,3055,0,0,0,1.0,1,1.0,1,1.0,1,0.1675530721257617,29
2692,3,5121,2063,3058,0,0,0,1.0,1,1.0,1,1.0,1,0.13159056071664113,31
2693,3,5124,2065,3059,0,0,0,1.0,1,1.0,1,1.0,1,0.19119087414156036,32
2694,2,5126,2066,3060,0,0,0,1.0,1,1.0,1,1.0,1,0.16657244932484278,32
2695,0,5126,2066,3060,0,0,0,1.0,1,1.0,1,1.0,1,0.14942027106066716,33
2696,0,5126,2066,3060,0,0,0,1.0,1,1.0,1,1.0,1,0.14942027106066716,33
2697,0,5126,2066,3060,0,0,0,1.0,1,1.0,1,1.0,1,0.1525198271262218,34
2698,1,5127,2067,3060,0,0,0,1.0,1,1.0,1,1.0,1,0.18528580206222714,34
2699,1,5128,2067,3061,0,0,0,1.0,1,1.0,1,1.0,1,0.16495830632234623,36
2700,1,5129,2067,3062,0,0,0,1.0,1,1.0,1,1.0,1,0.157420788201494,36
2701,1,5130,2067,3063,0,0,0,1.0,1,1.0,1,1.0,1,0.1401750005272155,36
2702,3,5133,2069,3064,0,0,0,1.0,1,1.0,1,1.0,1,0.17935887447324145,36
2703,4,5137,2070,3067,0,0,0,1.0,1,1.0,1,1.0,1,0.17091659042263202,38
2704,2,5139,2071,3068,0,0,0,1.0,1,1.0,1,1.0,1,0.15147241534938258,37
2705,3,5142,2073,3069,0,0,0,1.0,1,1.0,1,1.0,1,0.19967770357004733,36
2706,1,5143,2074,3069,0,0,0,1.0,1,1.0,1,1.0,1,0.23623605831492006,34
2707,3,5146,2075,3071,0,0,0,1.0,1,1.0,1,1.0,1,0.20525098386550936,36
2708,5,5151,2078,3073,0,0,0,1.0,1,1.0,1,1.0,1,0.17969773485356377,36
2709,2,5153,2079,3074,0,0,0,1.0,1,1.0,1,1.0,1,0.19318492258305306,33
2710,5,5158,2081,3077,0,0,0,1.0,1,1.0,1,1.0,1,0.15375628080963002,32
2711,2,5160,2082,3078,0,0,0,1.0,1,1.0,1,1.0,1,0.11852717282213074,29
2712,0,5160,2082,3078,0,0,0,1.0,1,1.0,1,1.0,1,0.1719261303352704,28
2713,1,5161,2082,3079,0,0,0,1.0,1,1.0,1,1.0,1,0.15806885615948674,28
2714,1,5162,2083,3079,0,0,0,1.0,1,1.0,1,1.0,1,0.21419332252499584,25
2715,3,5165,2084,3081,0,0,0,1.0,1,1.0,1,1.0,1,0.1945222470937463,24
2716,3,5168,2086,3082,0,0,0,1.0,1,1.0,1,1.0,1,0.3051984738707736,23
2717,3,5171,2087,3084,0,0,0,1.0,1,1.0,1,1.0,1,0.232151076951151,24
2718,1,5172,2087,3085,0,0,0,1.0,1,1.0,1,1.0,1,0.18613112098876955,24
2719,2,5174,2087,3087,0,0,0,1.0,1,1.0,1,1.0,1,0.14966068173354022,25
2720,2,5176,2088,3088,0,0,0,1.0,1,1.0,1,1.0,1,0.16919306663917513,25
2721,2,5178,2089,3089,0,0,0,1.0,1,1.0,1,1.0,1,0.06730693508744255,26
2722,1,5179,2090,3089,0,0,0,1.0,1,1.0,1,1.0,1,0.10551479315991903,26
2723,1,5180,2091,3089,0,0,0,1.0,1,1.0,1,1.0,1,0.12533953566188888,26
2724,1,5181,2092,3089,0,0,0,1.0,1,1.0,1,1.0,1,0.18894098578646554,27
2725,4,5185,2093,3092,0,0,0,1.0,1,1.0,1,1.0,1,0.20625290905844898,27
2726,3,5188,2093,3095,0,0,0,1.0,1,1.0,1,1.0,1,0.16150984730317994,28
2727,1,5189,2093,3096,0,0,0,1.0,1,1.0,1,1.0,1,0.11074960704885212,29
2728,0,5189,2093,3096,0,0,0,1.0,1,1.0,1,1.0,1,0.13405381158316404,28
2729,0,5189,2093,3096,0,0,0,1.0,1,1.0,1,1.0,1,0.13405381158316404,28
2730,1,5190,2093,3097,0,0,0,1.0,1,1.0,1,1.0,1,0.1408584227778886,29
2731,3,5193,2095,3098,0,0,0,1.0,1,1.0,1,1.0,1,0.12584382000584235,30
2732,2,5195,2096,3099,0,0,0,1.0,1,1.0,1,1.0,1,0.15925118920866352,29
2733,1,5196,2097,3099,0,0,0,1.0,1,1.0,1,1.0,1,0.19218195593862383,29
2734,0,5196,2097,3099,0,0,0,1.0,1,1.0,1,1.0,1,0.19218195593862383,29
2735,2,5198,2099,3099,0,0,0,1.0,1,1.0,1,1.0,1,0.2685457527210559,29
2736,3,5201,2099,3102,0,0,0,1.0,1,1.0,1,1.0,1,0.22146986551564213,30
2737,3,5204,2099,3105,0,0,0,1.0,1,1.0,1,1.0,1,0.1369568910563669,30
2738,1,5205,2099,3106,0,0,0,1.0,1,1.0,1,1.0,1,0.16309469310772,29
2739,1,5206,2099,3107,0,0,0,1.0,1,1.0,1,1.0,1,0.16301564577770744,30
2740,0,5206,2099,3107,0,0,0,1.0,1,1.0,1,1.0,1,0.16576927777389613,29
2741,1,5207,2099,3108,0,0,0,1.0,1,1.0,1,1.0,1,0.12694835221259923,29
2742,1,5208,2100,3108,0,0,0,1.0,1,1.0,1,1.0,1,0.1415028453198772,29
2743,1,5209,2100,3109,0,0,0,1.0,1,1.0,1,1.0,1,0.14570856190896594,30
2744,3,5212,2103,3109,0,0,0,1.0,1,1.0,1,1.0,1,0.27576579349696423,28
2745,1,5213,2103,3110,0,0,0,1.0,1,1.0,1,1.0,1,0.21764575200438263,27
2746,1,5214,2104,3110,0,0,0,1.0,1,1.0,1,1.0,1,0.26172134020877297,26
2747,1,5215,2105,3110,0,0,0,1.0,1,1.0,1,1.0,1,0.27640063568053486,22
2748,3,5218,2106,3112,0,0,0,1.0,1,1.0,1,1.0,1,0.20612559992781468,22
2749,1,5219,2106,3113,0,0,0,1.0,1,1.0,1,1.0,1,0.19364851398007124,20
2750,0,5219,2106,3113,0,0,0,1.0,1,1.0,1,1.0,1,0.20183673889467796,17
2751,0,5219,2106,3113,0,0,0,1.0,1,1.0,1,1.0,1,0.20183673889467796,17
2752,0,5219,2106,3113,0,0,0,1.0,1,1.0,1,1.0,1,0.23623832368520606,16
2753,0,5219,2106,3113,0,0,0,1.0,1,1.0,1,1.0,1,0.23623832368520606,16
2754,0,5219,2106,3113,0,0,0,1.0,1,1.0,1,1.0,1,0.23623832368520606,16
2755,1,5220,2107,3113,0,0,0,1.0,1,1.0,1,1.0,1,0.2599608028349314,16
2756,1,5221,2107,3114,0,0,0,1.0,1,1.0,1,1.0,1,0.2478857886009582,17
2757,1,5222,2107,3115,0,0,0,1.0,1,1.0,1,1.0,1,0.19260787672047103,18
2758,0,5222,2107,3115,0,0,0,1.0,1,1.0,1,1.0,1,0.19260787672047103,18
2759,0,5222,2107,3115,0,0,0,1.0,1,1.0,1,1.0,1,0.22370035941071537,19
2760,0,5222,2107,3115,0,0,0,1.0,1,1.0,1,1.0,1,0.2615158615426752,18
2761,0,5222,2107,3115,0,0,0,1.0,1,1.0,1,1.0,1,0.2615158615426752,18
2762,0,5222,2107,3115,0,0,0,1.0,1,1.0,1,1.0,1,0.2615158615426752,18
2763,0,5222,2107,3115,0,0,0,1.0,1,1.0,1,1.0,1,0.2615158615426752,18
2764,0,5222,2107,3115,0,0,0,1.0,1,1.0,1,1.0,1,0.2615158615426752,18
2765,1,5223,2108,3115,0,0,0,1.0,1,1.0,1,1.0,1,0.23470986191911583,18
2766,0,5223,2108,3115,0,0,0,1.0,1,1.0,1,1.0,1,0.23470986191911583,18
2767,0,5223,2108,3115,0,0,0,1.0,1,1.0,1,1.0,1,0.29705365330913897,17
2768,0,5223,2108,3115,0,0,0,1.0,1,1.0,1,1.0,1,0.29705365330913897,17
2769,0,5223,2108,3115,0,0,0,1.0,1,1.0,1,1.0,1,0.29705365330913897,17
2770,0,5223,2108,3115,0,0,0,1.0,1,1.0,1,1.0,1,0.29705365330913897,17
2771,0,5223,2108,3115,0,0,0,1.0,1,1.0,1,1.0,1,0.29705365330913897,17
2772,0,5223,2108,3115,0,0,0,1.0,1,1.0,1,1.0,1,0.29705365330913897,17
2773,3,5226,2111,3115,0,0,0,1.0,1,1.0,1,1.0,1,0.4101594814309522,17
2774,0,5226,2111,3115,0,0,0,1.0,1,1.0,1,1.0,1,0.3613070325795549,18
2775,1,5227,2111,3116,0,0,0,1.0,1,1.0,1,1.0,1,0.3862666143024773,20
2776,2,5229,2112,3117,0,0,0,1.0,1,1.0,1,1.0,1,0.3956576574149998,21
2777,2,5231,2112,3119,0,0,0,1.0,1,1.0,1,1.0,1,0.3511593363518094,21
2778,1,5232,2112,3120,0,0,0,1.0,1,1.0,1,1.0,1,0.2689442366304766,21
2779,2,5234,2113,3121,0,0,0,1.0,1,1.0,1,1.0,1,0.23061674338983737,22
2780,1,5235,2114,3121,0,0,0,1.0,1,1.0,1,1.0,1,0.28969620637153665,22
2781,4,5239,2115,3124,0,0,0,1.0,1,1.0,1,1.0,1,0.22942295989265293,22
2782,2,5241,2117,3124,0,0,0,1.0,1,1.0,1,1.0,1,0.2656344315446941,23
2783,2,5243,2118,3125,0,0,0,1.0,1,1.0,1,1.0,1,0.22494135023421077,22
2784,1,5244,2119,3125,0,0,0,1.0,1,1.0,1,1.0,1,0.2810147379623253,21
2785,0,5244,2119,3125,0,0,0,1.0,1,1.0,1,1.0,1,0.22879250668016402,19
2786,0,5244,2119,3125,0,0,0,1.0,1,1.0,1,1.0,1,0.22879250668016402,19
2787,0,5244,2119,3125,0,0,0,1.0,1,1.0,1,1.0,1,0.18821268360499757,20
2788,1,5245,2120,3125,0,0,0,1.0,1,1.0,1,1.0,1,0.22592870673483334,20
2789,0,5245,2120,3125,0,0,0,1.0,1,1.0,1,1.0,1,0.22663578686952793,19
2790,1,5246,2120,3126,0,0,0,1.0,1,1.0,1,1.0,1,0.1855304464133722,20
2791,0,5246,2120,3126,0,0,0,1.0,1,1.0,1,1.0,1,0.1855304464133722,20
2792,0,5246,2120,3126,0,0,0,1.0,1,1.0,1,1.0,1,0.1855304464133722,20
2793,0,5246,2120,3126,0,0,0,1.0,1,1.0,1,1.0,1,0.22911190233162074,19
2794,1,5247,2120,3127,0,0,0,1.0,1,1.0,1,1.0,1,0.19536856545892684,20
2795,0,5247,2120,3127,0,0,0,1.0,1,1.0,1,1.0,1,0.20612084101017128,21
2796,0,5247,2120,3127,0,0,0,1.0,1,1.0,1,1.0,1,0.19982404092324202,22
2797,1,5248,2120,3128,0,0,0,1.0,1,1.0,1,1.0,1,0.17462372073560622,21
2798,1,5249,2121,3128,0,0,0,1.0,1,1.0,1,1.0,1,0.2379796062220781,21
2799,0,5249,2121,3128,0,0,0,1.0,1,1.0,1,1.0,1,0.20847854254157128,20
2800,0,5249,2121,3128,0,0,0,1.0,1,1.0,1,1.0,1,0.20847854254157128,20
2801,0,5249,2121,3128,0,0,0,1.0,1,1.0,1,1.0,1,0.20847854254157128,20
2802,0,5249,2121,3128,0,0,0,1.0,1,1.0,1,1.0,1,0.20847854254157128,20
2803,1,5250,2121,3129,0,0,0,1.0,1,1.0,1,1.0,1,0.165905052063641,21
2804,3,5253,2122,3131,0,0,0,1.0,1,1.0,1,1.0,1,0.15721464718077155,22
2805,0,5253,2122,3131,0,0,0,1.0,1,1.0,1,1.0,1,0.15721464718077155,22
2806,1,5254,2123,3131,0,0,0,1.0,1,1.0,1,1.0,1,0.20639893795274078,23
2807,5,5259,2126,3133,0,0,0,1.0,1,1.0,1,1.0,1,0.23725776523762857,24
2808,2,5261,2128,3133,0,0,0,1.0,1,1.0,1,1.0,1,0.25213147217777726,24
2809,4,5265,2128,3137,0,0,0,1.0,1,1.0,1,1.0,1,0.1324529148880803,26
2810,1,5266,2128,3138,0,0,0,1.0,1,1.0,1,1.0,1,0.09488670827575982,26
2811,0,5266,2128,3138,0,0,0,1.0,1,1.0,1,1.0,1,0.12539206471636363,27
2812,0,5266,2128,3138,0,0,0,1.0,1,1.0,1,1.0,1,0.12539206471636363,27
2813,0,5266,2128,3138,0,0,0,1.0,1,1.0,1,1.0,1,0.12742737487990372,28
2814,3,5269,2129,3140,0,0,0,1.0,1,1.0,1,1.0,1,0.15810653941726055,29
2815,0,5269,2129,3140,0,0,0,1.0,1,1.0,1,1.0,1,0.17030955653226365,30
2816,0,5269,2129,3140,0,0,0,1.0,1,1.0,1,1.0,1,0.14626043017204157,31
2817,0,5269,2129,3140,0,0,0,1.0,1,1.0,1,1.0,1,0.14626043017204157,31
2818,3,5272,2129,3143,0,0,0,1.0,1,1.0,1,1.0,1,0.09615212220238173,32
2819,1,5273,2130,3143,0,0,0,1.0,1,1.0,1,1.0,1,0.0790686531946664,32
2820,0,5273,2130,3143,0,0,0,1.0,1,1.0,1,1.0,1,0.10476568451812117,33
2821,1,5274,2131,3143,0,0,0,1.0,1,1.0,1,1.0,1,0.11243647791929212,34
2822,1,5275,2132,3143,0,0,0,1.0,1,1.0,1,1.0,1,0.1352257314380742,35
2823,3,5278,2133,3145,0,0,0,1.0,1,1.0,1,1.0,1,0.16519229087055143,31
2824,2,5280,2135,3145,0,0,0,1.0,1,1.0,1,1.0,1,0.2467394670670016,33
2825,2,5282,2135,3147,0,0,0,1.0,1,1.0,1,1.0,1,0.14796565230297043,31
2826,2,5284,2137,3147,0,0,0,1.0,1,1.0,1,1.0,1,0.21023762739985077,31
2827,1,5285,2137,3148,0,0,0,1.0,1,1.0,1,1.0,1,0.18246229538185593,32
2828,4,5289,2138,3151,0,0,0,1.0,1,1.0,1,1.0,1,0.1815291812608796,33
2829,4,5293,2141,3152,0,0,0,1.0,1,1.0,1,1.0,1,0.2111726135421743,33
2830,2,5295,2141,3154,0,0,0,1.0,1,1.0,1,1.0,1,0.15716124315574753,32
2831,4,5299,2143,3156,0,0,0,1.0,1,1.0,1,1.0,1,0.13540656128486672,31
2832,0,5299,2143,3156,0,0,0,1.0,1,1.0,1,1.0,1,0.12097251496513423,30
2833,1,5300,2144,3156,0,0,0,1.0,1,1.0,1,1.0,1,0.10718026552137146,29
2834,4,5304,2147,3157,0,0,0,1.0,1,1.0,1,1.0,1,0.18351965290004926,29
2835,3,5307,2149,3158,0,0,0,1.0,1,1.0,1,1.0,1,0.2778070469729786,27
2836,2,5309,2149,3160,0,0,0,1.0,1,1.0,1,1.0,1,0.19724721152135635,27
2837,1,5310,2149,3161,0,0,0,1.0,1,1.0,1,1.0,1,0.17104979399644038,28
2838,1,5311,2150,3161,0,0,0,1.0,1,1.0,1,1.0,1,0.2064928924900892,29
2839,1,5312,2150,3162,0,0,0,1.0,1,1.0,1,1.0,1,0.16568264549245504,29
2840,0,5312,2150,3162,0,0,0,1.0,1,1.0,1,1.0,1,0.16568264549245504,29
2841,2,5314,2151,3163,0,0,0,1.0,1,1.0,1,1.0,1,0.1474654158380191,31
2842,1,5315,2151,3164,0,0,0,1.0,1,1.0,1,1.0,1,0.12696660545506294,32
2843,0,5315,2151,3164,0,0,0,1.0,1,1.0,1,1.0,1,0.12696660545506294,32
2844,1,5316,2152,3164,0,0,0,1.0,1,1.0,1,1.0,1,0.1582832942800117,33
2845,2,5318,2153,3165,0,0,0,1.0,1,1.0,1,1.0,1,0.20150708873971038,34
2846,2,5320,2154,3166,0,0,0,1.0,1,1.0,1,1.0,1,0.1898225463678946,34
2847,1,5321,2154,3167,0,0,0,1.0,1,1.0,1,1.0,1,0.1520168614908794,35
2848,3,5324,2155,3169,0,0,0,1.0,1,1.0,1,1.0,1,0.17534863849585028,37
2849,2,5326,2155,3171,0,0,0,1.0,1,1.0,1,1.0,1,0.12831178367353682,37
2850,0,5326,2155,3171,0,0,0,1.0,1,1.0,1,1.0,1,0.12831178367353682,37
2851,2,5328,2156,3172,0,0,0,1.0,1,1.0,1,1.0,1,0.12332096188772142,38
2852,0,5328,2156,3172,0,0,0,1.0,1,1.0,1,1.0,1,0.13976016067101815,36
2853,0,5328,2156,3172,0,0,0,1.0,1,1.0,1,1.0,1,0.18947246740853985,36
2854,1,5329,2156,3173,0,0,0,1.0,1,1.0,1,1.0,1,0.19378251350664247,37
2855,1,5330,2156,3174,0,0,0,1.0,1,1.0,1,1.0,1,0.21656975524237096,37
2856,1,5331,2156,3175,0,0,0,1.0,1,1.0,1,1.0,1,0.15714135942303534,38
2857,1,5332,2157,3175,0,0,0,1.0,1,1.0,1,1.0,1,0.20590846156789436,39
2858,3,5335,2157,3178,0,0,0,1.0,1,1.0,1,1.0,1,0.18001935256493862,39
2859,1,5336,2157,3179,0,0,0,1.0,1,1.0,1,1.0,1,0.16596057509729303,39
2860,2,5338,2158,3180,0,0,0,1.0,1,1.0,1,1.0,1,0.13380304580613803,40
2861,1,5339,2158,3181,0,0,0,1.0,1,1.0,1,1.0,1,0.09054546014257132,38
2862,5,5344,2162,3182,0,0,0,1.0,1,1.0,1,1.0,1,0.13947024613516343,38
2863,4,5348,2164,3184,0,0,0,1.0,1,1.0,1,1.0,1,0.11356858910218609,37
2864,3,5351,2166,3185,0,0,0,1.0,1,1.0,1,1.0,1,0.15682073820282233,35
2865,4,5355,2168,3187,0,0,0,1.0,1,1.0,1,1.0,1,0.15913277676804435,33
2866,2,5357,2170,3187,0,0,0,1.0,1,1.0,1,1.0,1,0.20482760253569463,31
2867,4,5361,2170,3191,0,0,0,1.0,1,1.0,1,1.0,1,0.15489804558882464,30
2868,4,5365,2172,3193,0,0,0,1.0,1,1.0,1,1.0,1,0.19301930964124958,31
2869,2,5367,2174,3193,0,0,0,1.0,1,1.0,1,1.0,1,0.22860695245644957,30
2870,0,5367,2174,3193,0,0,0,1.0,1,1.0,1,1.0,1,0.23565959655143187,26
2871,2,5369,2175,3194,0,0,0,1.0,1,1.0,1,1.0,1,0.24944649021072857,27
2872,0,5369,2175,3194,0,0,0,1.0,1,1.0,1,1.0,1,0.23787301956338913,25
2873,0,5369,2175,3194,0,0,0,1.0,1,1.0,1,1.0,1,0.2697158388316818,24
2874,0,5369,2175,3194,0,0,0,1.0,1,1.0,1,1.0,1,0.24168004332617202,25
2875,1,5370,2176,3194,0,0,0,1.0,1,1.0,1,1.0,1,0.2635647660688076,26
2876,3,5373,2177,3196,0,0,0,1.0,1,1.0,1,1.0,1,0.27908422686318657,28
2877,1,5374,2177,3197,0,0,0,1.0,1,1.0,1,1.0,1,0.23899912700337092,29
2878,4,5378,2177,3201,0,0,0,1.0,1,1.0,1,1.0,1,0.13534708216577757,31
2879,0,5378,2177,3201,0,0,0,1.0,1,1.0,1,1.0,1,0.13534708216577757,31
2880,0,5378,2177,3201,0,0,0,1.0,1,1.0,1,1.0,1,0.14083014866366403,32
2881,0,5378,2177,3201,0,0,0,1.0,1,1.0,1,1.0,1,0.16854073859382226,31
2882,1,5379,2178,3201,0,0,0,1.0,1,1.0,1,1.0,1,0.20599956967885744,31
2883,1,5380,2178,3202,0,0,0,1.0,1,1.0,1,1.0,1,0.17920472986406813,32
2884,1,5381,2179,3202,0,0,0,1.0,1,1.0,1,1.0,1,0.18883565653005244,32
2885,3,5384,2179,3205,0,0,0,1.0,1,1.0,1,1.0,1,0.16422036328789352,33
2886,1,5385,2180,3205,0,0,0,1.0,1,1.0,1,1.0,1,0.1489469783831905,34
2887,4,5389,2180,3209,0,0,0,1.0,1,1.0,1,1.0,1,0.09361231218868131,34
2888,1,5390,2181,3209,0,0,0,1.0,1,1.0,1,1.0,1,0.10852945585803532,34
2889,5,5395,2183,3212,0,0,0,1.0,1,1.0,1,1.0,1,0.1453773131597083,37
2890,0,5395,2183,3212,0,0,0,1.0,1,1.0,1,1.0,1,0.1453773131597083,37
2891,3,5398,2184,3214,0,0,0,1.0,1,1.0,1,1.0,1,0.15670236284258812,37
2892,1,5399,2184,3215,0,0,0,1.0,1,1.0,1,1.0,1,0.1467775726431243,37
2893,3,5402,2185,3217,0,0,0,1.0,1,1.0,1,1.0,1,0.1417781458001959,38
2894,3,5405,2185,3220,0,0,0,1.0,1,1.0,1,1.0,1,0.1002705615208629,39
2895,2,5407,2186,3221,0,0,0,1.0,1,1.0,1,1.0,1,0.1007051486034501,40
2896,3,5410,2187,3223,0,0,0,1.0,1,1.0,1,1.0,1,0.10904162838318633,41
2897,1,5411,2187,3224,0,0,0,1.0,1,1.0,1,1.0,1,0.08420519046783877,41
2898,1,5412,2188,3224,0,0,0,1.0,1,1.0,1,1.0,1,0.13377367328295778,41
2899,0,5412,2188,3224,0,0,0,1.0,1,1.0,1,1.0,1,0.1343471653202914,39
2900,2,5414,2190,3224,0,0,0,1.0,1,1.0,1,1.0,1,0.21041443443290525,40
2901,3,5417,2190,3227,0,0,0,1.0,1,1.0,1,1.0,1,0.11608266330386575,40
2902,2,5419,2191,3228,0,0,0,1.0,1,1.0,1,1.0,1,0.15418473324495208,38
2903,1,5420,2192,3228,0,0,0,1.0,1,1.0,1,1.0,1,0.12399862053553459,36
2904,2,5422,2193,3229,0,0,0,1.0,1,1.0,1,1.0,1,0.15240262578365069,36
2905,1,5423,2194,3229,0,0,0,1.0,1,1.0,1,1.0,1,0.10091285988061859,35
2906,2,5425,2195,3230,0,0,0,1.0,1,1.0,1,1.0,1,0.13993637074813978,36
2907,0,5425,2195,3230,0,0,0,1.0,1,1.0,1,1.0,1,0.1376728002191753,37
2908,2,5427,2196,3231,0,0,0,1.0,1,1.0,1,1.0,1,0.1505228655422898,38
2909,1,5428,2197,3231,0,0,0,1.0,1,1.0,1,1.0,1,0.1655258897099803,37
2910,0,5428,2197,3231,0,0,0,1.0,1,1.0,1,1.0,1,0.15386241978744153,37
2911,0,5428,2197,3231,0,0,0,1.0,1,1.0,1,1.0,1,0.1851995582376359,36
2912,2,5430,2199,3231,0,0,0,1.0,1,1.0,1,1.0,1,0.2023419389707106,36
2913,2,5432,2200,3232,0,0,0,1.0,1,1.0,1,1.0,1,0.17539423730893886,36
2914,3,5435,2201,3234,0,0,0,1.0,1,1.0,1,1.0,1,0.22319498314658312,38
2915,4,5439,2201,3238,0,0,0,1.0,1,1.0,1,1.0,1,0.1714104156751311,37
2916,2,5441,2201,3240,0,0,0,1.0,1,1.0,1,1.0,1,0.13101438693595005,39
2917,2,5443,2202,3241,0,0,0,1.0,1,1.0,1,1.0,1,0.1524094257385369,40
2918,2,5445,2204,3241,0,0,0,1.0,1,1.0,1,1.0,1,0.21063049270827494,40
2919,5,5450,2205,3245,0,0,0,1.0,1,1.0,1,1.0,1,0.15798520576445446,42
2920,0,5450,2205,3245,0,0,0,1.0,1,1.0,1,1.0,1,0.15798520576445446,42
2921,0,5450,2205,3245,0,0,0,1.0,1,1.0,1,1.0,1,0.15798520576445446,42
2922,2,5452,2206,3246,0,0,0,1.0,1,1.0,1,1.0,1,0.15424763118204077,43
2923,2,5454,2206,3248,0,0,0,1.0,1,1.0,1,1.0,1,0.14618468563697584,45
2924,2,5456,2206,3250,0,0,0,1.0,1,1.0,1,1.0,1,0.0875846924587057,46
2925,0,5456,2206,3250,0,0,0,1.0,1,1.0,1,1.0,1,0.0875846924587057,46
2926,0,5456,2206,3250,0,0,0,1.0,1,1.0,1,1.0,1,0.0875846924587057,46
2927,1,5457,2207,3250,0,0,0,1.0,1,1.0,1,1.0,1,0.08285370968153867,48
2928,2,5459,2209,3250,0,0,0,1.0,1,1.0,1,1.0,1,0.11267089303522666,48
2929,2,5461,2209,3252,0,0,0,1.0,1,1.0,1,1.0,1,0.06799513306815488,48
2930,1,5462,2209,3253,0,0,0,1.0,1,1.0,1,1.0,1,0.08400130530060777,50
2931,1,5463,2210,3253,0,0,0,1.0,1,1.0,1,1.0,1,0.10158234352574963,51
2932,1,5464,2210,3254,0,0,0,1.0,1,1.0,1,1.0,1,0.11034758595704261,52
2933,0,5464,2210,3254,0,0,0,1.0,1,1.0,1,1.0,1,0.11727584270721059,53
2934,2,5466,2211,3255,0,0,0,1.0,1,1.0,1,1.0,1,0.14217643708077732,54
2935,1,5467,2212,3255,0,0,0,1.0,1,1.0,1,1.0,1,0.14206747202925762,53
2936,1,5468,2213,3255,0,0,0,1.0,1,1.0,1,1.0,1,0.14734984686156685,53
2937,4,5472,2214,3258,0,0,0,1.0,1,1.0,1,1.0,1,0.1971394587672763,51
2938,6,5478,2215,3263,0,0,0,1.0,1,1.0,1,1.0,1,0.19987401547422917,53
2939,3,5481,2215,3266,0,0,0,1.0,1,1.0,1,1.0,1,0.16978548400296736,52
2940,4,5485,2216,3269,0,0,0,1.0,1,1.0,1,1.0,1,0.1584848697735743,52
2941,0,5485,2216,3269,0,0,0,1.0,1,1.0,1,1.0,1,0.1740272891204798,50
2942,1,5486,2217,3269,0,0,0,1.0,1,1.0,1,1.0,1,0.19861818894180955,50
2943,3,5489,2218,3271,0,0,0,1.0,1,1.0,1,1.0,1,0.17944677186498384,49
2944,4,5493,2219,3274,0,0,0,1.0,1,1.0,1,1.0,1,0.16830270879426085,48
2945,4,5497,2220,3277,0,0,0,1.0,1,1.0,1,1.0,1,0.136132220992902,48
2946,4,5501,2223,3278,0,0,0,1.0,1,1.0,1,1.0,1,0.12340166509790632,47
2947,4,5505,2224,3281,0,0,0,1.0,1,1.0,1,1.0,1,0.09467914677895907,47
2948,0,5505,2224,3281,0,0,0,1.0,1,1.0,1,1.0,1,0.10929467685335816,48
2949,1,5506,2224,3282,0,0,0,1.0,1,1.0,1,1.0,1,0.09768080951189932,48
2950,0,5506,2224,3282,0,0,0,1.0,1,1.0,1,1.0,1,0.09768080951189932,48
2951,1,5507,2225,3282,0,0,0,1.0,1,1.0,1,1.0,1,0.13983668042861588,50
2952,1,5508,2225,3283,0,0,0,1.0,1,1.0,1,1.0,1,0.11660418081991969,50
2953,2,5510,2226,3284,0,0,0,1.0,1,1.0,1,1.0,1,0.13466709677412483,51
2954,1,5511,2226,3285,0,0,0,1.0,1,1.0,1,1.0,1,0.12386823377609538,51
2955,0,5511,2226,3285,0,0,0,1.0,1,1.0,1,1.0,1,0.12386823377609538,51
2956,1,5512,2227,3285,0,0,0,1.0,1,1.0,1,1.0,1,0.1512176533608827,51
2957,2,5514,2227,3287,0,0,0,1.0,1,1.0,1,1.0,1,0.1385449407868863,52
2958,0,5514,2227,3287,0,0,0,1.0,1,1.0,1,1.0,1,0.1385449407868863,52
2959,3,5517,2228,3289,0,0,0,1.0,1,1.0,1,1.0,1,0.12286992530575015,53
2960,1,5518,2229,3289,0,0,0,1.0,1,1.0,1,1.0,1,0.11934101906732444,52
2961,3,5521,2229,3292,0,0,0,1.0,1,1.0,1,1.0,1,0.06633444562560818,53
2962,0,5521,2229,3292,0,0,0,1.0,1,1.0,1,1.0,1,0.07623517517834597,54
2963,2,5523,2230,3293,0,0,0,1.0,1,1.0,1,1.0,1,0.11052217982068273,55
2964,1,5524,2230,3294,0,0,0,1.0,1,1.0,1,1.0,1,0.12384249922251316,55
2965,2,5526,2230,3296,0,0,0,1.0,1,1.0,1,1.0,1,0.08889263276785028,55
2966,0,5526,2230,3296,0,0,0,1.0,1,1.0,1,1.0,1,0.08889263276785028,55
2967,1,5527,2230,3297,0,0,0,1.0,1,1.0,1,1.0,1,0.10743735437678535,56
2968,0,5527,2230,3297,0,0,0,1.0,1,1.0,1,1.0,1,0.10743735437678535,56
2969,2,5529,2231,3298,0,0,0,1.0,1,1.0,1,1.0,1,0.12267269409742476,55
2970,2,5531,2232,3299,0,0,0,1.0,1,1.0,1,1.0,1,0.12465206967152564,57
2971,1,5532,2232,3300,0,0,0,1.0,1,1.0,1,1.0,1,0.128624795545883,56
2972,2,5534,2233,3301,0,0,0,1.0,1,1.0,1,1.0,1,0.1396642605302398,57
2973,3,5537,2233,3304,0,0,0,1.0,1,1.0,1,1.0,1,0.130725243396216,59
2974,2,5539,2234,3305,0,0,0,1.0,1,1.0,1,1.0,1,0.10773386199083082,60
2975,3,5542,2235,3307,0,0,0,1.0,1,1.0,1,1.0,1,0.1375938515193464,58
2976,4,5546,2235,3311,0,0,0,1.0,1,1.0,1,1.0,1,0.10103977434076375,59
2977,2,5548,2236,3312,0,0,0,1.0,1,1.0,1,1.0,1,0.12918481038224322,59
2978,2,5550,2237,3313,0,0,0,1.0,1,1.0,1,1.0,1,0.11668011705930006,58
2979,4,5554,2240,3314,0,0,0,1.0,1,1.0,1,1.0,1,0.14010370746119838,57
2980,0,5554,2240,3314,0,0,0,1.0,1,1.0,1,1.0,1,0.14246236170249693,56
2981,2,5556,2241,3315,0,0,0,1.0,1,1.0,1,1.0,1,0.13744513863808616,56
2982,3,5559,2243,3316,0,0,0,1.0,1,1.0,1,1.0,1,0.16394140727105233,57
2983,8,5567,2246,3321,0,0,0,1.0,1,1.0,1,1.0,1,0.1199584564855892,57
2984,2,5569,2247,3322,0,0,0,1.0,1,1.0,1,1.0,1,0.12733617849851114,56
2985,7,5576,2248,3328,0,0,0,1.0,1,1.0,1,1.0,1,0.09153139431033144,55
2986,4,5580,2252,3328,0,0,0,1.0,1,1.0,1,1.0,1,0.1753599595920537,55
2987,5,5585,2252,3333,0,0,0,1.0,1,1.0,1,1.0,1,0.059823732092376215,51
2988,4,5589,2254,3335,0,0,0,1.0,1,1.0,1,1.0,1,0.0750559630474396,52
2989,0,5589,2254,3335,0,0,0,1.0,1,1.0,1,1.0,1,0.07594214507308776,50
2990,1,5590,2255,3335,0,0,0,1.0,1,1.0,1,1.0,1,0.06013820895941665,50
2991,0,5590,2255,3335,0,0,0,1.0,1,1.0,1,1.0,1,0.062110709676505095,50
2992,0,5590,2255,3335,0,0,0,1.0,1,1.0,1,1.0,1,0.062110709676505095,50
2993,2,5592,2255,3337,0,0,0,1.0,1,1.0,1,1.0,1,0.077534595319304,51
2994,3,5595,2257,3338,0,0,0,1.0,1,1.0,1,1.0,1,0.10405460901661102,51
2995,1,5596,2257,3339,0,0,0,1.0,1,1.0,1,1.0,1,0.0991876054644593,51
2996,1,5597,2258,3339,0,0,0,1.0,1,1.0,1,1.0,1,0.12401725004712723,52
2997,1,5598,2258,3340,0,0,0,1.0,1,1.0,1,1.0,1,0.12064439218037078,52
2998,1,5599,2259,3340,0,0,0,1.0,1,1.0,1,1.0,1,0.13995472016334598,51
2999,1,5600,2259,3341,0,0,0,1.0,1,1.0,1,1.0,1,0.13668970326115396,51
3000,1,5601,2260,3341,0,0,0,1.0,1,1.0,1,1.0,1,0.13493775569008215,52
3001,1,5602,2260,3342,0,0,0,1.0,1,1.0,1,1.0,1,0.12211672604686684,52
3002,3,5605,2261,3344,0,0,0,1.0,1,1.0,1,1.0,1,0.13958599249472758,53
3003,0,5605,2261,3344,0,0,0,1.0,1,1.0,1,1.0,1,0.1266952296045872,54
3004,0,5605,2261,3344,0,0,0,1.0,1,1.0,1,1.0,1,0.13823078289484778,55
3005,2,5607,2261,3346,0,0,0,1.0,1,1.0,1,1.0,1,0.12922259407849462,56
3006,5,5612,2263,3349,0,0,0,1.0,1,1.0,1,1.0,1,0.1512890036226394,57
3007,2,5614,2263,3351,0,0,0,1.0,1,1.0,1,1.0,1,0.14545431876682285,58
3008,2,5616,2265,3351,0,0,0,1.0,1,1.0,1,1.0,1,0.16902983029712615,59
3009,3,5619,2265,3354,0,0,0,1.0,1,1.0,1,1.0,1,0.14343946605611713,59
3010,2,5621,2265,3356,0,0,0,1.0,1,1.0,1,1.0,1,0.10574493014992753,59
3011,0,5621,2265,3356,0,0,0,1.0,1,1.0,1,1.0,1,0.10574493014992753,59
3012,3,5624,2268,3356,0,0,0,1.0,1,1.0,1,1.0,1,0.17882457339887708,61
3013,1,5625,2268,3357,0,0,0,1.0,1,1.0,1,1.0,1,0.15104301347573745,59
3014,4,5629,2269,3360,0,0,0,1.0,1,1.0,1,1.0,1,0.15925747708214644,60
3015,1,5630,2269,3361,0,0,0,1.0,1,1.0,1,1.0,1,0.14408454398221518,58
3016,0,5630,2269,3361,0,0,0,1.0,1,1.0,1,1.0,1,0.15098293354176795,57
3017,3,5633,2270,3363,0,0,0,1.0,1,1.0,1,1.0,1,0.14706740740793403,58
3018,1,5634,2270,3364,0,0,0,1.0,1,1.0,1,1.0,1,0.17116297674412412,55
3019,1,5635,2271,3364,0,0,0,1.0,1,1.0,1,1.0,1,0.17522657911106754,56
3020,3,5638,2272,3366,0,0,0,1.0,1,1.0,1,1.0,1,0.23990862369017105,55
3021,7,5645,2274,3371,0,0,0,1.0,1,1.0,1,1.0,1,0.1847056856187919,55
3022,5,5650,2276,3374,0,0,0,1.0,1,1.0,1,1.0,1,0.15819398065012294,55
3023,2,5652,2277,3375,0,0,0,1.0,1,1.0,1,1.0,1,0.15037550525782872,54
3024,2,5654,2278,3376,0,0,0,1.0,1,1.0,1,1.0,1,0.1726783677226334,54
3025,7,5661,2280,3381,0,0,0,1.0,1,1.0,1,1.0,1,0.14914419704985563,54
3026,2,5663,2280,3383,0,0,0,1.0,1,1.0,1,1.0,1,0.1257203695365933,53
3027,7,5670,2283,3387,0,0,0,1.0,1,1.0,1,1.0,1,0.0923467150367929,53
3028,1,5671,2284,3387,0,0,0,1.0,1,1.0,1,1.0,1,0.12670742703018809,51
3029,3,5674,2284,3390,0,0,0,1.0,1,1.0,1,1.0,1,0.06510925865391048,51
3030,4,5678,2286,3392,0,0,0,1.0,1,1.0,1,1.0,1,0.06490621296946084,52
3031,2,5680,2288,3392,0,0,0,1.0,1,1.0,1,1.0,1,0.0762798992231663,51
3032,0,5680,2288,3392,0,0,0,1.0,1,1.0,1,1.0,1,0.06206397876146487,50
3033,0,5680,2288,3392,0,0,0,1.0,1,1.0,1,1.0,1,0.07348480515407796,52
3034,1,5681,2289,3392,0,0,0,1.0,1,1.0,1,1.0,1,0.09287033552867086,51
3035,3,5684,2289,3395,0,0,0,1.0,1,1.0,1,1.0,1,0.06625974992702963,51
3036,0,5684,2289,3395,0,0,0,1.0,1,1.0,1,1.0,1,0.07173087631741815,53
3037,1,5685,2289,3396,0,0,0,1.0,1,1.0,1,1.0,1,0.04760692626964434,52
3038,2,5687,2290,3397,0,0,0,1.0,1,1.0,1,1.0,1,0.07221448845275666,52
3039,4,5691,2291,3400,0,0,0,1.0,1,1.0,1,1.0,1,0.059995592794572415,54
3040,0,5691,2291,3400,0,0,0,1.0,1,1.0,1,1.0,1,0.07381336667812381,55
3041,1,5692,2292,3400,0,0,0,1.0,1,1.0,1,1.0,1,0.1092532027490849,56
3042,3,5695,2294,3401,0,0,0,1.0,1,1.0,1,1.0,1,0.10885056279597174,56
3043,4,5699,2295,3404,0,0,0,1.0,1,1.0,1,1.0,1,0.0897515308803926,57
3044,2,5701,2296,3405,0,0,0,1.0,1,1.0,1,1.0,1,0.07825588316512723,57
3045,0,5701,2296,3405,0,0,0,1.0,1,1.0,1,1.0,1,0.09062705413294492,56
3046,1,5702,2297,3405,0,0,0,1.0,1,1.0,1,1.0,1,0.10225323401839063,57
3047,1,5703,2297,3406,0,0,0,1.0,1,1.0,1,1.0,1,0.09790014315798347,56
3048,4,5707,2298,3409,0,0,0,1.0,1,1.0,1,1.0,1,0.11781405916476656,58
3049,8,5715,2298,3417,0,0,0,1.0,1,1.0,1,1.0,1,0.0666718922857069,59
3050,0,5715,2298,3417,0,0,0,1.0,1,1.0,1,1.0,1,0.06449672654823992,60
3051,3,5718,2299,3419,0,0,0,1.0,1,1.0,1,1.0,1,0.09836149019434931,59
3052,1,5719,2299,3420,0,0,0,1.0,1,1.0,1,1.0,1,0.07810320086713156,58
3053,2,5721,2300,3421,0,0,0,1.0,1,1.0,1,1.0,1,0.08908025829541756,57
3054,3,5724,2302,3422,0,0,0,1.0,1,1.0,1,1.0,1,0.13632465532760055,55
3055,2,5726,2302,3424,0,0,0,1.0,1,1.0,1,1.0,1,0.13263368037584514,54
3056,4,5730,2305,3425,0,0,0,1.0,1,1.0,1,1.0,1,0.1999016845480572,55
3057,3,5733,2305,3428,0,0,0,1.0,1,1.0,1,1.0,1,0.1636535423000879,54
3058,0,5733,2305,3428,0,0,0,1.0,1,1.0,1,1.0,1,0.2044324262455518,55
3059,4,5737,2305,3432,0,0,0,1.0,1,1.0,1,1.0,1,0.19085440098087972,56
3060,3,5740,2305,3435,0,0,0,1.0,1,1.0,1,1.0,1,0.18109906278434257,56
3061,0,5740,2305,3435,0,0,0,1.0,1,1.0,1,1.0,1,0.18109906278434257,56
3062,4,5744,2307,3437,0,0,0,1.0,1,1.0,1,1.0,1,0.18961645497697754,57
3063,2,5746,2307,3439,0,0,0,1.0,1,1.0,1,1.0,1,0.15009889775535248,55
3064,6,5752,2311,3441,0,0,0,1.0,1,1.0,1,1.0,1,0.16455602501668984,56
3065,3,5755,2311,3444,0,0,0,1.0,1,1.0,1,1.0,1,0.12860690422572477,55
3066,3,5758,2312,3446,0,0,0,1.0,1,1.0,1,1.0,1,0.12649124998133718,55
3067,4,5762,2313,3449,0,0,0,1.0,1,1.0,1,1.0,1,0.11947406639920936,54
3068,2,5764,2314,3450,0,0,0,1.0,1,1.0,1,1.0,1,0.1298122533840467,53
3069,5,5769,2317,3452,0,0,0,1.0,1,1.0,1,1.0,1,0.12790201446488067,51
3070,0,5769,2317,3452,0,0,0,1.0,1,1.0,1,1.0,1,0.1284944006885297,50
3071,1,5770,2318,3452,0,0,0,1.0,1,1.0,1,1.0,1,0.12636513823141554,51
3072,4,5774,2320,3454,0,0,0,1.0,1,1.0,1,1.0,1,0.1517428245907677,53
3073,4,5778,2320,3458,0,0,0,1.0,1,1.0,1,1.0,1,0.07159275630552886,51
3074,1,5779,2321,3458,0,0,0,1.0,1,1.0,1,1.0,1,0.06856018425033862,50
3075,0,5779,2321,3458,0,0,0,1.0,1,1.0,1,1.0,1,0.09875652669693918,52
3076,1,5780,2322,3458,0,0,0,1.0,1,1.0,1,1.0,1,0.14976220853537148,53
3077,0,5780,2322,3458,0,0,0,1.0,1,1.0,1,1.0,1,0.13802594350040187,52
3078,1,5781,2322,3459,0,0,0,1.0,1,1.0,1,1.0,1,0.16796641414343808,53
3079,2,5783,2323,3460,0,0,0,1.0,1,1.0,1,1.0,1,0.14895890491952077,53
3080,2,5785,2324,3461,0,0,0,1.0,1,1.0,1,1.0,1,0.16101017400217466,52
3081,1,5786,2325,3461,0,0,0,1.0,1,1.0,1,1.0,1,0.18840443928186393,54
3082,5,5791,2327,3464,0,0,0,1.0,1,1.0,1,1.0,1,0.2031003511608389,54
3083,5,5796,2327,3469,0,0,0,1.0,1,1.0,1,1.0,1,0.12295027962462493,54
3084,2,5798,2328,3470,0,0,0,1.0,1,1.0,1,1.0,1,0.11531266403801584,55
3085,3,5801,2330,3471,0,0,0,1.0,1,1.0,1,1.0,1,0.17575929449150646,55
3086,1,5802,2330,3472,0,0,0,1.0,1,1.0,1,1.0,1,0.1605593997470756,56
3087,1,5803,2330,3473,0,0,0,1.0,1,1.0,1,1.0,1,0.15125803401831941,57
3088,0,5803,2330,3473,0,0,0,1.0,1,1.0,1,1.0,1,0.13579322337971778,56
3089,2,5805,2331,3474,0,0,0,1.0,1,1.0,1,1.0,1,0.17656969448768958,55
3090,1,5806,2331,3475,0,0,0,1.0,1,1.0,1,1.0,1,0.19139357892843767,54
3091,3,5809,2331,3478,0,0,0,1.0,1,1.0,1,1.0,1,0.19208781275440845,53
3092,5,5814,2331,3483,0,0,0,1.0,1,1.0,1,1.0,1,0.16239161185532913,56
3093,2,5816,2332,3484,0,0,0,1.0,1,1.0,1,1.0,1,0.17505849713897714,56
3094,0,5816,2332,3484,0,0,0,1.0,1,1.0,1,1.0,1,0.1934376554370945,58
3095,3,5819,2332,3487,0,0,0,1.0,1,1.0,1,1.0,1,0.16862252099352298,59
3096,1,5820,2332,3488,0,0,0,1.0,1,1.0,1,1.0,1,0.1715478620772351,60
3097,2,5822,2332,3490,0,0,0,1.0,1,1.0,1,1.0,1,0.16367347212226102,60
3098,1,5823,2333,3490,0,0,0,1.0,1,1.0,1,1.0,1,0.19994314531998525,58
3099,3,5826,2333,3493,0,0,0,1.0,1,1.0,1,1.0,1,0.18007198263506916,57
3100,0,5826,2333,3493,0,0,0,1.0,1,1.0,1,1.0,1,0.18007198263506916,57
3101,3,5829,2336,3493,0,0,0,1.0,1,1.0,1,1.0,1,0.20338873549479408,58
3102,7,5836,2337,3499,0,0,0,1.0,1,1.0,1,1.0,1,0.16715768872630052,59
3103,2,5838,2337,3501,0,0,0,1.0,1,1.0,1,1.0,1,0.1458227178408464,58
3104,3,5841,2339,3502,0,0,0,1.0,1,1.0,1,1.0,1,0.13287926424383936,58
3105,1,5842,2340,3502,0,0,0,1.0,1,1.0,1,1.0,1,0.13160072538679118,56
3106,3,5845,2342,3503,0,0,0,1.0,1,1.0,1,1.0,1,0.15817866889774815,57
3107,6,5851,2345,3506,0,0,0,1.0,1,1.0,1,1.0,1,0.10577441825628961,55
3108,3,5854,2345,3509,0,0,0,1.0,1,1.0,1,1.0,1,0.0728372966952254,55
3109,3,5857,2348,3509,0,0,0,1.0,1,1.0,1,1.0,1,0.09910222455933229,54
3110,4,5861,2352,3509,0,0,0,1.0,1,1.0,1,1.0,1,0.12547163969601358,54
3111,5,5866,2354,3512,0,0,0,1.0,1,1.0,1,1.0,1,0.11905808182445234,54
3112,5,5871,2358,3513,0,0,0,1.0,1,1.0,1,1.0,1,0.14139743566651441,56
3113,7,5878,2360,3518,0,0,0,1.0,1,1.0,1,1.0,1,0.15117679899881153,55
3114,3,5881,2360,3521,0,0,0,1.0,1,1.0,1,1.0,1,0.11552603871011773,54
3115,3,5884,2360,3524,0,0,0,1.0,1,1.0,1,1.0,1,0.06147014702476683,56
3116,1,5885,2361,3524,0,0,0,1.0,1,1.0,1,1.0,1,0.06697483849594112,56
3117,1,5886,2361,3525,0,0,0,1.0,1,1.0,1,1.0,1,0.0867949804563253,58
3118,2,5888,2362,3526,0,0,0,1.0,1,1.0,1,1.0,1,0.08325356213594677,57
3119,1,5889,2362,3527,0,0,0,1.0,1,1.0,1,1.0,1,0.06979121341419027,57
3120,0,5889,2362,3527,0,0,0,1.0,1,1.0,1,1.0,1,0.06619174224567523,56
3121,0,5889,2362,3527,0,0,0,1.0,1,1.0,1,1.0,1,0.061061343258881844,57
3122,0,5889,2362,3527,0,0,0,1.0,1,1.0,1,1.0,1,0.061061343258881844,57
3123,0,5889,2362,3527,0,0,0,1.0,1,1.0,1,1.0,1,0.061061343258881844,57
3124,1,5890,2363,3527,0,0,0,1.0,1,1.0,1,1.0,1,0.05941492180630559,59
3125,3,5893,2365,3528,0,0,0,1.0,1,1.0,1,1.0,1,0.10623438127148331,61
3126,1,5894,2365,3529,0,0,0,1.0,1,1.0,1,1.0,1,0.08540565183413247,60
3127,1,5895,2365,3530,0,0,0,1.0,1,1.0,1,1.0,1,0.08104268216161459,58
3128,2,5897,2366,3531,0,0,0,1.0,1,1.0,1,1.0,1,0.09307776894692517,58
3129,3,5900,2366,3534,0,0,0,1.0,1,1.0,1,1.0,1,0.06576581682641085,56
3130,1,5901,2366,3535,0,0,0,1.0,1,1.0,1,1.0,1,0.10737536187431038,56
3131,5,5906,2367,3539,0,0,0,1.0,1,1.0,1,1.0,1,0.08161312802781276,55
3132,1,5907,2368,3539,0,0,0,1.0,1,1.0,1,1.0,1,0.10566198541962044,53
3133,2,5909,2368,3541,0,0,0,1.0,1,1.0,1,1.0,1,0.11145534593554832,52
3134,3,5912,2368,3544,0,0,0,1.0,1,1.0,1,1.0,1,0.099646260041236,52
3135,0,5912,2368,3544,0,0,0,1.0,1,1.0,1,1.0,1,0.09712612158412548,53
3136,3,5915,2370,3545,0,0,0,1.0,1,1.0,1,1.0,1,0.09790239367512879,54
3137,5,5920,2372,3548,0,0,0,1.0,1,1.0,1,1.0,1,0.08733203928266695,55
3138,9,5929,2376,3553,0,0,0,1.0,1,1.0,1,1.0,1,0.10946769429680478,57
3139,4,5933,2377,3556,0,0,0,1.0,1,1.0,1,1.0,1,0.0945023888145492,56
3140,1,5934,2378,3556,0,0,0,1.0,1,1.0,1,1.0,1,0.13547396256425315,56
3141,1,5935,2378,3557,0,0,0,1.0,1,1.0,1,1.0,1,0.12750242041899992,56
3142,1,5936,2379,3557,0,0,0,1.0,1,1.0,1,1.0,1,0.13309213400462394,56
3143,5,5941,2382,3559,0,0,0,1.0,1,1.0,1,1.0,1,0.16506477908545353,56
3144,1,5942,2382,3560,0,0,0,1.0,1,1.0,1,1.0,1,0.13020294795529622,54
3145,5,5947,2383,3564,0,0,0,1.0,1,1.0,1,1.0,1,0.09976416362421765,55
3146,1,5948,2384,3564,0,0,0,1.0,1,1.0,1,1.0,1,0.11194919470579201,53
3147,1,5949,2384,3565,0,0,0,1.0,1,1.0,1,1.0,1,0.11845856167851457,54
3148,0,5949,2384,3565,0,0,0,1.0,1,1.0,1,1.0,1,0.11845856167851457,54
3149,1,5950,2385,3565,0,0,0,1.0,1,1.0,1,1.0,1,0.12476070476152047,53
3150,1,5951,2385,3566,0,0,0,1.0,1,1.0,1,1.0,1,0.11378481090080307,53
3151,3,5954,2385,3569,0,0,0,1.0,1,1.0,1,1.0,1,0.09693405477840647,53
3152,0,5954,2385,3569,0,0,0,1.0,1,1.0,1,1.0,1,0.10631930870428939,54
3153,2,5956,2385,3571,0,0,0,1.0,1,1.0,1,1.0,1,0.09751508242232457,53
3154,2,5958,2386,3572,0,0,0,1.0,1,1.0,1,1.0,1,0.11437308765629406,55
3155,0,5958,2386,3572,0,0,0,1.0,1,1.0,1,1.0,1,0.10949659830647046,56
3156,0,5958,2386,3572,0,0,0,1.0,1,1.0,1,1.0,1,0.13887697896649653,56
3157,1,5959,2386,3573,0,0,0,1.0,1,1.0,1,1.0,1,0.12298835718701043,56
3158,1,5960,2386,3574,0,0,0,1.0,1,1.0,1,1.0,1,0.09574355276640666,57
3159,2,5962,2386,3576,0,0,0,1.0,1,1.0,1,1.0,1,0.07796151686878183,56
3160,1,5963,2387,3576,0,0,0,1.0,1,1.0,1,1.0,1,0.1118179419744484,58
3161,3,5966,2388,3578,0,0,0,1.0,1,1.0,1,1.0,1,0.06293981413459014,59
3162,1,5967,2389,3578,0,0,0,1.0,1,1.0,1,1.0,1,0.08905668858244854,59
3163,3,5970,2391,3579,0,0,0,1.0,1,1.0,1,1.0,1,0.1290061965991244,59
3164,3,5973,2392,3581,0,0,0,1.0,1,1.0,1,1.0,1,0.1508469592418288,60
3165,9,5982,2393,3589,0,0,0,1.0,1,1.0,1,1.0,1,0.12144773406406945,58
3166,2,5984,2393,3591,0,0,0,1.0,1,1.0,1,1.0,1,0.11006185700992802,59
3167,4,5988,2396,3592,0,0,0,1.0,1,1.0,1,1.0,1,0.09497068151895295,57
3168,3,5991,2397,3594,0,0,0,1.0,1,1.0,1,1.0,1,0.10345121146503918,58
3169,3,5994,2398,3596,0,0,0,1.0,1,1.0,1,1.0,1,0.0688098789682925,57
3170,1,5995,2399,3596,0,0,0,1.0,1,1.0,1,1.0,1,0.0825759191473037,55
3171,2,5997,2401,3596,0,0,0,1.0,1,1.0,1,1.0,1,0.11908649776725189,56
3172,0,5997,2401,3596,0,0,0,1.0,1,1.0,1,1.0,1,0.13580414052698414,54
3173,5,6002,2403,3599,0,0,0,1.0,1,1.0,1,1.0,1,0.14609877599705395,53
3174,3,6005,2403,3602,0,0,0,1.0,1,1.0,1,1.0,1,0.09033990223738064,53
3175,1,6006,2403,3603,0,0,0,1.0,1,1.0,1,1.0,1,0.08597910015523567,52
3176,3,6009,2406,3603,0,0,0,1.0,1,1.0,1,1.0,1,0.13247484889719952,53
3177,5,6014,2408,3606,0,0,0,1.0,1,1.0,1,1.0,1,0.13163128746327657,52
3178,4,6018,2408,3610,0,0,0,1.0,1,1.0,1,1.0,1,0.0969352967888971,53
3179,1,6019,2408,3611,0,0,0,1.0,1,1.0,1,1.0,1,0.11036257279297278,54
3180,3,6022,2408,3614,0,0,0,1.0,1,1.0,1,1.0,1,0.09130635947319694,54
3181,1,6023,2408,3615,0,0,0,1.0,1,1.0,1,1.0,1,0.08696221667457657,55
3182,0,6023,2408,3615,0,0,0,1.0,1,1.0,1,1.0,1,0.102082625735753,54
3183,3,6026,2409,3617,0,0,0,1.0,1,1.0,1,1.0,1,0.13545865844122326,56
3184,7,6033,2413,3620,0,0,0,1.0,1,1.0,1,1.0,1,0.13267187812427056,54
3185,0,6033,2413,3620,0,0,0,1.0,1,1.0,1,1.0,1,0.12063983391357233,53
3186,0,6033,2413,3620,0,0,0,1.0,1,1.0,1,1.0,1,0.13098926465873276,52
3187,1,6034,2414,3620,0,0,0,1.0,1,1.0,1,1.0,1,0.12088260360983612,50
3188,2,6036,2416,3620,0,0,0,1.0,1,1.0,1,1.0,1,0.13724677133187022,50
3189,5,6041,2418,3623,0,0,0,1.0,1,1.0,1,1.0,1,0.1255019024225138,49
3190,1,6042,2419,3623,0,0,0,1.0,1,1.0,1,1.0,1,0.14609666700944277,50
3191,1,6043,2420,3623,0,0,0,1.0,1,1.0,1,1.0,1,0.1634513090652322,49
3192,0,6043,2420,3623,0,0,0,1.0,1,1.0,1,1.0,1,0.1634513090652322,49
3193,0,6043,2420,3623,0,0,0,1.0,1,1.0,1,1.0,1,0.1596662735081275,49
3194,5,6048,2422,3626,0,0,0,1.0,1,1.0,1,1.0,1,0.1555730920268433,50
3195,1,6049,2422,3627,0,0,0,1.0,1,1.0,1,1.0,1,0.1627263879601711,49
3196,0,6049,2422,3627,0,0,0,1.0,1,1.0,1,1.0,1,0.1627263879601711,49
3197,2,6051,2422,3629,0,0,0,1.0,1,1.0,1,1.0,1,0.11411265620943456,50
3198,0,6051,2422,3629,0,0,0,1.0,1,1.0,1,1.0,1,0.11411265620943456,50
3199,2,6053,2423,3630,0,0,0,1.0,1,1.0,1,1.0,1,0.0822910725826544,52
3200,0,6053,2423,3630,0,0,0,1.0,1,1.0,1,1.0,1,0.0864704748798208,53
3201,1,6054,2423,3631,0,0,0,1.0,1,1.0,1,1.0,1,0.08560256014260516,55
3202,0,6054,2423,3631,0,0,0,1.0,1,1.0,1,1.0,1,0.08560256014260516,55
3203,0,6054,2423,3631,0,0,0,1.0,1,1.0,1,1.0,1,0.0936780004504128,53
3204,1,6055,2424,3631,0,0,0,1.0,1,1.0,1,1.0,1,0.12652996803332556,53
3205,3,6058,2426,3632,0,0,0,1.0,1,1.0,1,1.0,1,0.13853608968718512,53
3206,1,6059,2426,3633,0,0,0,1.0,1,1.0,1,1.0,1,0.16637530498528993,52
3207,4,6063,2428,3635,0,0,0,1.0,1,1.0,1,1.0,1,0.18846651715698753,53
3208,3,6066,2428,3638,0,0,0,1.0,1,1.0,1,1.0,1,0.21250311332025484,51
3209,6,6072,2428,3644,0,0,0,1.0,1,1.0,1,1.0,1,0.15197582756349629,52
3210,3,6075,2428,3647,0,0,0,1.0,1,1.0,1,1.0,1,0.09137773649152897,49
3211,2,6077,2430,3647,0,0,0,1.0,1,1.0,1,1.0,1,0.17785899051424878,48
3212,2,6079,2431,3648,0,0,0,1.0,1,1.0,1,1.0,1,0.1428371766732186,48
3213,2,6081,2431,3650,0,0,0,1.0,1,1.0,1,1.0,1,0.11470167827026277,49
3214,2,6083,2432,3651,0,0,0,1.0,1,1.0,1,1.0,1,0.10396466846670957,51
3215,1,6084,2432,3652,0,0,0,1.0,1,1.0,1,1.0,1,0.09525139084647628,51
3216,2,6086,2434,3652,0,0,0,1.0,1,1.0,1,1.0,1,0.1168831043596192,51
3217,2,6088,2434,3654,0,0,0,1.0,1,1.0,1,1.0,1,0.07493441448548852,51
3218,0,6088,2434,3654,0,0,0,1.0,1,1.0,1,1.0,1,0.07493441448548852,51
3219,1,6089,2434,3655,0,0,0,1.0,1,1.0,1,1.0,1,0.0739883673811946,52
3220,0,6089,2434,3655,0,0,0,1.0,1,1.0,1,1.0,1,0.0739883673811946,52
3221,3,6092,2435,3657,0,0,0,1.0,1,1.0,1,1.0,1,0.06829274337278274,54
3222,0,6092,2435,3657,0,0,0,1.0,1,1.0,1,1.0,1,0.06242056512819263,54
3223,0,6092,2435,3657,0,0,0,1.0,1,1.0,1,1.0,1,0.08136066564195107,56
3224,1,6093,2436,3657,0,0,0,1.0,1,1.0,1,1.0,1,0.09940297487808261,57
3225,2,6095,2436,3659,0,0,0,1.0,1,1.0,1,1.0,1,0.07939112435317541,58
3226,0,6095,2436,3659,0,0,0,1.0,1,1.0,1,1.0,1,0.07939112435317541,58
3227,0,6095,2436,3659,0,0,0,1.0,1,1.0,1,1.0,1,0.07939112435317541,58
3228,0,6095,2436,3659,0,0,0,1.0,1,1.0,1,1.0,1,0.07939112435317541,58
3229,2,6097,2438,3659,0,0,0,1.0,1,1.0,1,1.0,1,0.16382890389581148,60
3230,3,6100,2438,3662,0,0,0,1.0,1,1.0,1,1.0,1,0.12217747325971753,61
3231,1,6101,2438,3663,0,0,0,1.0,1,1.0,1,1.0,1,0.10097817090801371,61
3232,0,6101,2438,3663,0,0,0,1.0,1,1.0,1,1.0,1,0.10097817090801371,61
3233,0,6101,2438,3663,0,0,0,1.0,1,1.0,1,1.0,1,0.11744885760111073,63
3234,2,6103,2439,3664,0,0,0,1.0,1,1.0,1,1.0,1,0.15406920428531068,64
3235,4,6107,2439,3668,0,0,0,1.0,1,1.0,1,1.0,1,0.12070472904803213,65
3236,1,6108,2439,3669,0,0,0,1.0,1,1.0,1,1.0,1,0.12180490746634848,66
3237,1,6109,2439,3670,0,0,0,1.0,1,1.0,1,1.0,1,0.10923380010708184,67
3238,0,6109,2439,3670,0,0,0,1.0,1,1.0,1,1.0,1,0.10923380010708184,67
3239,1,6110,2439,3671,0,0,0,1.0,1,1.0,1,1.0,1,0.12252438790842929,69
3240,1,6111,2440,3671,0,0,0,1.0,1,1.0,1,1.0,1,0.13035242745558187,69
3241,4,6115,2442,3673,0,0,0,1.0,1,1.0,1,1.0,1,0.1165028021583661,68
3242,1,6116,2443,3673,0,0,0,1.0,1,1.0,1,1.0,1,0.12014610271585985,67
3243,4,6120,2444,3676,0,0,0,1.0,1,1.0,1,1.0,1,0.08372999477255619,68
3244,0,6120,2444,3676,0,0,0,1.0,1,1.0,1,1.0,1,0.10052952432369297,68
3245,2,6122,2444,3678,0,0,0,1.0,1,1.0,1,1.0,1,0.07837763577253166,69
3246,0,6122,2444,3678,0,0,0,1.0,1,1.0,1,1.0,1,0.08857113145903941,68
3247,0,6122,2444,3678,0,0,0,1.0,1,1.0,1,1.0,1,0.08857113145903941,68
3248,5,6127,2446,3681,0,0,0,1.0,1,1.0,1,1.0,1,0.07633874787285139,68
3249,1,6128,2446,3682,0,0,0,1.0,1,1.0,1,1.0,1,0.06832511113502376,69
3250,2,6130,2447,3683,0,0,0,1.0,1,1.0,1,1.0,1,0.06043112018249939,69
3251,1,6131,2448,3683,0,0,0,1.0,1,1.0,1,1.0,1,0.08836431966784773,68
3252,0,6131,2448,3683,0,0,0,1.0,1,1.0,1,1.0,1,0.07247786736371323,68
3253,1,6132,2448,3684,0,0,0,1.0,1,1.0,1,1.0,1,0.07573328898848636,69
3254,0,6132,2448,3684,0,0,0,1.0,1,1.0,1,1.0,1,0.07573328898848636,69
3255,2,6134,2449,3685,0,0,0,1.0,1,1.0,1,1.0,1,0.08124129521695772,70
3256,0,6134,2449,3685,0,0,0,1.0,1,1.0,1,1.0,1,0.08124129521695772,70
3257,2,6136,2449,3687,0,0,0,1.0,1,1.0,1,1.0,1,0.054317786850219874,71
3258,2,6138,2451,3687,0,0,0,1.0,1,1.0,1,1.0,1,0.06257114186195421,72
3259,1,6139,2452,3687,0,0,0,1.0,1,1.0,1,1.0,1,0.06231073570298661,71
3260,3,6142,2453,3689,0,0,0,1.0,1,1.0,1,1.0,1,0.06472471796664414,72
3261,1,6143,2453,3690,0,0,0,1.0,1,1.0,1,1.0,1,0.08024380577790251,74
3262,1,6144,2454,3690,0,0,0,1.0,1,1.0,1,1.0,1,0.11098091597853149,73
3263,5,6149,2456,3693,0,0,0,1.0,1,1.0,1,1.0,1,0.11136854169460574,73
3264,3,6152,2458,3694,0,0,0,1.0,1,1.0,1,1.0,1,0.16475933365766282,71
3265,3,6155,2459,3696,0,0,0,1.0,1,1.0,1,1.0,1,0.11032423191857497,70
3266,2,6157,2460,3697,0,0,0,1.0,1,1.0,1,1.0,1,0.11789604733578991,69
3267,4,6161,2462,3699,0,0,0,1.0,1,1.0,1,1.0,1,0.12866480600897504,69
3268,2,6163,2464,3699,0,0,0,1.0,1,1.0,1,1.0,1,0.135372355321016,68
3269,9,6172,2466,3706,0,0,0,1.0,1,1.0,1,1.0,1,0.1315262480774617,68
3270,0,6172,2466,3706,0,0,0,1.0,1,1.0,1,1.0,1,0.1422456661991715,67
3271,2,6174,2466,3708,0,0,0,1.0,1,1.0,1,1.0,1,0.12498820026442158,66
3272,0,6174,2466,3708,0,0,0,1.0,1,1.0,1,1.0,1,0.11172556176491648,67
3273,1,6175,2466,3709,0,0,0,1.0,1,1.0,1,1.0,1,0.12997619518012243,66
3274,1,6176,2467,3709,0,0,0,1.0,1,1.0,1,1.0,1,0.14088509875320196,68
3275,3,6179,2467,3712,0,0,0,1.0,1,1.0,1,1.0,1,0.10108262512104389,68
3276,2,6181,2467,3714,0,0,0,1.0,1,1.0,1,1.0,1,0.0783866076174758,69
3277,3,6184,2468,3716,0,0,0,1.0,1,1.0,1,1.0,1,0.09681294834366734,68
3278,2,6186,2468,3718,0,0,0,1.0,1,1.0,1,1.0,1,0.09275487519138971,69
3279,1,6187,2469,3718,0,0,0,1.0,1,1.0,1,1.0,1,0.10446980837723518,67
3280,2,6189,2471,3718,0,0,0,1.0,1,1.0,1,1.0,1,0.13749934516148893,66
3281,4,6193,2472,3721,0,0,0,1.0,1,1.0,1,1.0,1,0.10322989993731334,67
3282,1,6194,2472,3722,0,0,0,1.0,1,1.0,1,1.0,1,0.10197335619414945,66
3283,3,6197,2474,3723,0,0,0,1.0,1,1.0,1,1.0,1,0.15764575808686726,67
3284,0,6197,2474,3723,0,0,0,1.0,1,1.0,1,1.0,1,0.12325055304028175,66
3285,2,6199,2475,3724,0,0,0,1.0,1,1.0,1,1.0,1,0.1320446025336141,66
3286,1,6200,2475,3725,0,0,0,1.0,1,1.0,1,1.0,1,0.12437695746946247,63
3287,2,6202,2476,3726,0,0,0,1.0,1,1.0,1,1.0,1,0.14594209880738787,61
3288,1,6203,2476,3727,0,0,0,1.0,1,1.0,1,1.0,1,0.15226551928749818,63
3289,4,6207,2477,3730,0,0,0,1.0,1,1.0,1,1.0,1,0.1451658349590023,62
3290,2,6209,2478,3731,0,0,0,1.0,1,1.0,1,1.0,1,0.14608935962924816,63
3291,7,6216,2481,3735,0,0,0,1.0,1,1.0,1,1.0,1,0.1852035222863773,62
3292,1,6217,2481,3736,0,0,0,1.0,1,1.0,1,1.0,1,0.1850777653572696,63
3293,7,6224,2481,3743,0,0,0,1.0,1,1.0,1,1.0,1,0.14666836293942648,65
3294,0,6224,2481,3743,0,0,0,1.0,1,1.0,1,1.0,1,0.14666836293942648,65
3295,2,6226,2481,3745,0,0,0,1.0,1,1.0,1,1.0,1,0.12430901023748481,65
3296,2,6228,2482,3746,0,0,0,1.0,1,1.0,1,1.0,1,0.13467824089383537,65
3297,1,6229,2482,3747,0,0,0,1.0,1,1.0,1,1.0,1,0.12326273127547278,66
3298,0,6229,2482,3747,0,0,0,1.0,1,1.0,1,1.0,1,0.12326273127547278,66
3299,2,6231,2483,3748,0,0,0,1.0,1,1.0,1,1.0,1,0.13707836529990794,67
3300,3,6234,2485,3749,0,0,0,1.0,1,1.0,1,1.0,1,0.16961962309996123,67
3301,3,6237,2486,3751,0,0,0,1.0,1,1.0,1,1.0,1,0.1791652684213494,68
3302,0,6237,2486,3751,0,0,0,1.0,1,1.0,1,1.0,1,0.19174869788788715,67
3303,3,6240,2487,3753,0,0,0,1.0,1,1.0,1,1.0,1,0.19906810693598007,67
3304,0,6240,2487,3753,0,0,0,1.0,1,1.0,1,1.0,1,0.19903349954238336,67
3305,9,6249,2487,3762,0,0,0,1.0,1,1.0,1,1.0,1,0.1455424853112218,69
3306,1,6250,2487,3763,0,0,0,1.0,1,1.0,1,1.0,1,0.14449455795027716,70
3307,1,6251,2487,3764,0,0,0,1.0,1,1.0,1,1.0,1,0.13761207688549312,70
3308,0,6251,2487,3764,0,0,0,1.0,1,1.0,1,1.0,1,0.13761207688549312,70
3309,4,6255,2487,3768,0,0,0,1.0,1,1.0,1,1.0,1,0.11305752776085795,72
3310,3,6258,2487,3771,0,0,0,1.0,1,1.0,1,1.0,1,0.10838681543505711,74
3311,0,6258,2487,3771,0,0,0,1.0,1,1.0,1,1.0,1,0.10838681543505711,74
3312,0,6258,2487,3771,0,0,0,1.0,1,1.0,1,1.0,1,0.10838681543505711,74
3313,1,6259,2487,3772,0,0,0,1.0,1,1.0,1,1.0,1,0.11200963954681062,75
3314,0,6259,2487,3772,0,0,0,1.0,1,1.0,1,1.0,1,0.12024840901923763,76
3315,1,6260,2488,3772,0,0,0,1.0,1,1.0,1,1.0,1,0.15415403265653332,75
3316,0,6260,2488,3772,0,0,0,1.0,1,1.0,1,1.0,1,0.1471836941435113,76
3317,1,6261,2488,3773,0,0,0,1.0,1,1.0,1,1.0,1,0.13649943029675926,73
3318,1,6262,2489,3773,0,0,0,1.0,1,1.0,1,1.0,1,0.16228659688257774,72
3319,3,6265,2490,3775,0,0,0,1.0,1,1.0,1,1.0,1,0.15698546064644117,71
3320,0,6265,2490,3775,0,0,0,1.0,1,1.0,1,1.0,1,0.15194640724580674,70
3321,4,6269,2492,3777,0,0,0,1.0,1,1.0,1,1.0,1,0.1802325739961843,69
3322,2,6271,2493,3778,0,0,0,1.0,1,1.0,1,1.0,1,0.17967300276729642,68
3323,4,6275,2494,3781,0,0,0,1.0,1,1.0,1,1.0,1,0.1772974635264263,69
3324,1,6276,2495,3781,0,0,0,1.0,1,1.0,1,1.0,1,0.1816692035806524,69
3325,3,6279,2495,3784,0,0,0,1.0,1,1.0,1,1.0,1,0.15452370308016167,70
3326,3,6282,2497,3785,0,0,0,1.0,1,1.0,1,1.0,1,0.15454087759787127,69
3327,2,6284,2497,3787,0,0,0,1.0,1,1.0,1,1.0,1,0.12870678772142574,70
3328,4,6288,2498,3790,0,0,0,1.0,1,1.0,1,1.0,1,0.1350819093064779,73
3329,3,6291,2499,3792,0,0,0,1.0,1,1.0,1,1.0,1,0.16176018748232443,72
3330,2,6293,2501,3792,0,0,0,1.0,1,1.0,1,1.0,1,0.1839624973734796,72
3331,5,6298,2503,3795,0,0,0,1.0,1,1.0,1,1.0,1,0.18421814135495126,72
3332,1,6299,2503,3796,0,0,0,1.0,1,1.0,1,1.0,1,0.17875293457927177,73
3333,3,6302,2503,3799,0,0,0,1.0,1,1.0,1,1.0,1,0.1564696753123484,72
3334,1,6303,2503,3800,0,0,0,1.0,1,1.0,1,1.0,1,0.14480099194696,73
3335,1,6304,2503,3801,0,0,0,1.0,1,1.0,1,1.0,1,0.1417345731848216,74
3336,1,6305,2503,3802,0,0,0,1.0,1,1.0,1,1.0,1,0.127875804046511,74
3337,0,6305,2503,3802,0,0,0,1.0,1,1.0,1,1.0,1,0.127875804046511,74
3338,2,6307,2503,3804,0,0,0,1.0,1,1.0,1,1.0,1,0.1208691621226049,74
3339,0,6307,2503,3804,0,0,0,1.0,1,1.0,1,1.0,1,0.12904581305748303,75
3340,0,6307,2503,3804,0,0,0,1.0,1,1.0,1,1.0,1,0.13310549687987625,75
3341,1,6308,2503,3805,0,0,0,1.0,1,1.0,1,1.0,1,0.13842227912811222,76
3342,1,6309,2504,3805,0,0,0,1.0,1,1.0,1,1.0,1,0.16626754240627287,76
3343,5,6314,2505,3809,0,0,0,1.0,1,1.0,1,1.0,1,0.13705641580796893,75
3344,3,6317,2506,3811,0,0,0,1.0,1,1.0,1,1.0,1,0.14094119153777554,75
3345,6,6323,2507,3816,0,0,0,1.0,1,1.0,1,1.0,1,0.1140905722042331,72
3346,4,6327,2507,3820,0,0,0,1.0,1,1.0,1,1.0,1,0.11742532502810955,73
3347,0,6327,2507,3820,0,0,0,1.0,1,1.0,1,1.0,1,0.10086760683314618,73
3348,0,6327,2507,3820,0,0,0,1.0,1,1.0,1,1.0,1,0.1204073634407794,73
3349,2,6329,2508,3821,0,0,0,1.0,1,1.0,1,1.0,1,0.12311576892026822,74
3350,3,6332,2510,3822,0,0,0,1.0,1,1.0,1,1.0,1,0.14210677028120405,73
3351,3,6335,2510,3825,0,0,0,1.0,1,1.0,1,1.0,1,0.12896283237230774,72
3352,2,6337,2511,3826,0,0,0,1.0,1,1.0,1,1.0,1,0.1305046430862599,72
3353,3,6340,2512,3828,0,0,0,1.0,1,1.0,1,1.0,1,0.14092913341408697,72
3354,3,6343,2513,3830,0,0,0,1.0,1,1.0,1,1.0,1,0.14531511990919027,70
3355,4,6347,2514,3833,0,0,0,1.0,1,1.0,1,1.0,1,0.13913059899458938,69
3356,2,6349,2516,3833,0,0,0,1.0,1,1.0,1,1.0,1,0.15977707480361675,69
3357,5,6354,2517,3837,0,0,0,1.0,1,1.0,1,1.0,1,0.1188613062288232,68
3358,1,6355,2518,3837,0,0,0,1.0,1,1.0,1,1.0,1,0.13174507737388147,68
3359,0,6355,2518,3837,0,0,0,1.0,1,1.0,1,1.0,1,0.14601482062477825,66
3360,6,6361,2521,3840,0,0,0,1.0,1,1.0,1,1.0,1,0.17134607534331003,65
3361,2,6363,2521,3842,0,0,0,1.0,1,1.0,1,1.0,1,0.17896492955465426,64
3362,0,6363,2521,3842,0,0,0,1.0,1,1.0,1,1.0,1,0.17896492955465426,64
3363,2,6365,2521,3844,0,0,0,1.0,1,1.0,1,1.0,1,0.15869603498526919,65
3364,0,6365,2521,3844,0,0,0,1.0,1,1.0,1,1.0,1,0.16184148073033663,66
3365,1,6366,2521,3845,0,0,0,1.0,1,1.0,1,1.0,1,0.15815943042292577,68
3366,2,6368,2522,3846,0,0,0,1.0,1,1.0,1,1.0,1,0.16803619418151547,66
3367,3,6371,2522,3849,0,0,0,1.0,1,1.0,1,1.0,1,0.16617058562057774,68
3368,4,6375,2523,3852,0,0,0,1.0,1,1.0,1,1.0,1,0.14413460402506684,68
3369,4,6379,2523,3856,0,0,0,1.0,1,1.0,1,1.0,1,0.14007616031451647,69
3370,1,6380,2523,3857,0,0,0,1.0,1,1.0,1,1.0,1,0.13262546240295384,71
3371,1,6381,2523,3858,0,0,0,1.0,1,1.0,1,1.0,1,0.1256156785208793,71
3372,3,6384,2524,3860,0,0,0,1.0,1,1.0,1,1.0,1,0.11446341137482062,71
3373,0,6384,2524,3860,0,0,0,1.0,1,1.0,1,1.0,1,0.11185793470903267,72
3374,0,6384,2524,3860,0,0,0,1.0,1,1.0,1,1.0,1,0.10563279657015005,72
3375,2,6386,2525,3861,0,0,0,1.0,1,1.0,1,1.0,1,0.10623181621035778,73
3376,0,6386,2525,3861,0,0,0,1.0,1,1.0,1,1.0,1,0.09904409223238027,75
3377,4,6390,2526,3864,0,0,0,1.0,1,1.0,1,1.0,1,0.09080796873329312,77
3378,1,6391,2526,3865,0,0,0,1.0,1,1.0,1,1.0,1,0.07998741169782105,77
3379,3,6394,2529,3865,0,0,0,1.0,1,1.0,1,1.0,1,0.11944082142198882,77
3380,1,6395,2529,3866,0,0,0,1.0,1,1.0,1,1.0,1,0.1255258591057652,76
3381,4,6399,2531,3868,0,0,0,1.0,1,1.0,1,1.0,1,0.13021237045243844,76
3382,2,6401,2532,3869,0,0,0,1.0,1,1.0,1,1.0,1,0.1267940817614892,78
3383,3,6404,2532,3872,0,0,0,1.0,1,1.0,1,1.0,1,0.11387007522131433,77
3384,7,6411,2536,3875,0,0,0,1.0,1,1.0,1,1.0,1,0.1445029237353682,77
3385,3,6414,2537,3877,0,0,0,1.0,1,1.0,1,1.0,1,0.12456673897449717,75
3386,2,6416,2539,3877,0,0,0,1.0,1,1.0,1,1.0,1,0.15373237966858258,76
3387,3,6419,2539,3880,0,0,0,1.0,1,1.0,1,1.0,1,0.1124594651086794,75
3388,1,6420,2540,3880,0,0,0,1.0,1,1.0,1,1.0,1,0.13089896928219882,76
3389,1,6421,2540,3881,0,0,0,1.0,1,1.0,1,1.0,1,0.12584454280181157,77
3390,0,6421,2540,3881,0,0,0,1.0,1,1.0,1,1.0,1,0.12286672898122267,76
3391,2,6423,2541,3882,0,0,0,1.0,1,1.0,1,1.0,1,0.09435818099372971,77
3392,1,6424,2541,3883,0,0,0,1.0,1,1.0,1,1.0,1,0.09114071359802045,78
3393,2,6426,2541,3885,0,0,0,1.0,1,1.0,1,1.0,1,0.07533169874771795,76
3394,1,6427,2542,3885,0,0,0,1.0,1,1.0,1,1.0,1,0.10890207777141996,75
3395,2,6429,2542,3887,0,0,0,1.0,1,1.0,1,1.0,1,0.0919566608938576,73
3396,0,6429,2542,3887,0,0,0,1.0,1,1.0,1,1.0,1,0.0919566608938576,73
3397,1,6430,2543,3887,0,0,0,1.0,1,1.0,1,1.0,1,0.09049832426456288,74
3398,0,6430,2543,3887,0,0,0,1.0,1,1.0,1,1.0,1,0.09049832426456288,74
3399,3,6433,2543,3890,0,0,0,1.0,1,1.0,1,1.0,1,0.06021471412307373,75
3400,2,6435,2544,3891,0,0,0,1.0,1,1.0,1,1.0,1,0.05569116726301221,75
3401,2,6437,2545,3892,0,0,0,1.0,1,1.0,1,1.0,1,0.05135325397280123,77
3402,1,6438,2546,3892,0,0,0,1.0,1,1.0,1,1.0,1,0.0648038921405894,77
3403,4,6442,2547,3895,0,0,0,1.0,1,1.0,1,1.0,1,0.05363608110241497,78
3404,2,6444,2548,3896,0,0,0,1.0,1,1.0,1,1.0,1,0.06949336521885846,78
3405,0,6444,2548,3896,0,0,0,1.0,1,1.0,1,1.0,1,0.06949336521885846,78
3406,2,6446,2550,3896,0,0,0,1.0,1,1.0,1,1.0,1,0.08979557585729335,78
3407,3,6449,2551,3898,0,0,0,1.0,1,1.0,1,1.0,1,0.09790975531911822,78
3408,1,6450,2551,3899,0,0,0,1.0,1,1.0,1,1.0,1,0.09541511454859779,79
3409,2,6452,2551,3901,0,0,0,1.0,1,1.0,1,1.0,1,0.07585769373496586,81
3410,0,6452,2551,3901,0,0,0,1.0,1,1.0,1,1.0,1,0.08507418336667229,82
3411,2,6454,2552,3902,0,0,0,1.0,1,1.0,1,1.0,1,0.078309982251056,84
3412,0,6454,2552,3902,0,0,0,1.0,1,1.0,1,1.0,1,0.078309982251056,84
3413,1,6455,2552,3903,0,0,0,1.0,1,1.0,1,1.0,1,0.07019920064748562,84
3414,1,6456,2553,3903,0,0,0,1.0,1,1.0,1,1.0,1,0.07296884722789021,84
3415,3,6459,2555,3904,0,0,0,1.0,1,1.0,1,1.0,1,0.09636175235296392,85
3416,1,6460,2556,3904,0,0,0,1.0,1,1.0,1,1.0,1,0.0927504079035591,85
3417,5,6465,2558,3907,0,0,0,1.0,1,1.0,1,1.0,1,0.08515915661219645,86
3418,3,6468,2560,3908,0,0,0,1.0,1,1.0,1,1.0,1,0.10926487324974966,86
3419,3,6471,2561,3910,0,0,0,1.0,1,1.0,1,1.0,1,0.11490781672856074,87
3420,1,6472,2561,3911,0,0,0,1.0,1,1.0,1,1.0,1,0.11794939065274974,88
3421,4,6476,2562,3914,0,0,0,1.0,1,1.0,1,1.0,1,0.1079843310347125,89
3422,5,6481,2563,3918,0,0,0,1.0,1,1.0,1,1.0,1,0.12125301275930664,90
3423,3,6484,2563,3921,0,0,0,1.0,1,1.0,1,1.0,1,0.11490688431342118,90
3424,1,6485,2563,3922,0,0,0,1.0,1,1.0,1,1.0,1,0.10201517298741243,91
3425,1,6486,2563,3923,0,0,0,1.0,1,1.0,1,1.0,1,0.09512323070324818,90
3426,0,6486,2563,3923,0,0,0,1.0,1,1.0,1,1.0,1,0.07968997510400352,92
3427,0,6486,2563,3923,0,0,0,1.0,1,1.0,1,1.0,1,0.09779144690225935,92
3428,0,6486,2563,3923,0,0,0,1.0,1,1.0,1,1.0,1,0.1033513996611279,91
3429,0,6486,2563,3923,0,0,0,1.0,1,1.0,1,1.0,1,0.1033513996611279,91
3430,5,6491,2566,3925,0,0,0,1.0,1,1.0,1,1.0,1,0.11170433724124793,91
3431,0,6491,2566,3925,0,0,0,1.0,1,1.0,1,1.0,1,0.10509948894714029,90
3432,3,6494,2568,3926,0,0,0,1.0,1,1.0,1,1.0,1,0.10569466371208584,91
3433,1,6495,2568,3927,0,0,0,1.0,1,1.0,1,1.0,1,0.10551922721162706,90
3434,0,6495,2568,3927,0,0,0,1.0,1,1.0,1,1.0,1,0.10832993717140751,89
3435,2,6497,2569,3928,0,0,0,1.0,1,1.0,1,1.0,1,0.11749631194966326,88
3436,0,6497,2569,3928,0,0,0,1.0,1,1.0,1,1.0,1,0.12284784774325824,86
3437,1,6498,2569,3929,0,0,0,1.0,1,1.0,1,1.0,1,0.11436988261828723,86
3438,1,6499,2569,3930,0,0,0,1.0,1,1.0,1,1.0,1,0.11521833919832808,87
3439,5,6504,2570,3934,0,0,0,1.0,1,1.0,1,1.0,1,0.11120852740819785,86
3440,0,6504,2570,3934,0,0,0,1.0,1,1.0,1,1.0,1,0.10889224535963885,86
3441,1,6505,2571,3934,0,0,0,1.0,1,1.0,1,1.0,1,0.11415959246655408,85
3442,3,6508,2572,3936,0,0,0,1.0,1,1.0,1,1.0,1,0.11486696653334155,85
3443,3,6511,2572,3939,0,0,0,1.0,1,1.0,1,1.0,1,0.11076556832580489,85
3444,6,6517,2575,3942,0,0,0,1.0,1,1.0,1,1.0,1,0.12136326578913725,85
3445,3,6520,2576,3944,0,0,0,1.0,1,1.0,1,1.0,1,0.12045960353840726,84
3446,4,6524,2579,3945,0,0,0,1.0,1,1.0,1,1.0,1,0.16405160617593625,85
3447,8,6532,2580,3952,0,0,0,1.0,1,1.0,1,1.0,1,0.1387903641231787,85
3448,2,6534,2581,3953,0,0,0,1.0,1,1.0,1,1.0,1,0.1482233075524279,85
3449,2,6536,2581,3955,0,0,0,1.0,1,1.0,1,1.0,1,0.1453577869012484,84
3450,0,6536,2581,3955,0,0,0,1.0,1,1.0,1,1.0,1,0.1453577869012484,84
3451,4,6540,2581,3959,0,0,0,1.0,1,1.0,1,1.0,1,0.13055933696719693,85
3452,0,6540,2581,3959,0,0,0,1.0,1,1.0,1,1.0,1,0.1257676679820835,86
3453,0,6540,2581,3959,0,0,0,1.0,1,1.0,1,1.0,1,0.1250959374692243,85
3454,3,6543,2581,3962,0,0,0,1.0,1,1.0,1,1.0,1,0.10288598592439348,88
3455,0,6543,2581,3962,0,0,0,1.0,1,1.0,1,1.0,1,0.10288598592439348,88
3456,2,6545,2582,3963,0,0,0,1.0,1,1.0,1,1.0,1,0.11249839399258207,88
3457,3,6548,2582,3966,0,0,0,1.0,1,1.0,1,1.0,1,0.09599788029127042,89
3458,0,6548,2582,3966,0,0,0,1.0,1,1.0,1,1.0,1,0.10496624948960574,88
3459,1,6549,2582,3967,0,0,0,1.0,1,1.0,1,1.0,1,0.09268212141596771,88
3460,1,6550,2582,3968,0,0,0,1.0,1,1.0,1,1.0,1,0.09594290930446286,89
3461,0,6550,2582,3968,0,0,0,1.0,1,1.0,1,1.0,1,0.09594290930446286,89
3462,1,6551,2582,3969,0,0,0,1.0,1,1.0,1,1.0,1,0.09708015102031055,90
3463,1,6552,2582,3970,0,0,0,1.0,1,1.0,1,1.0,1,0.09537840851904918,89
3464,0,6552,2582,3970,0,0,0,1.0,1,1.0,1,1.0,1,0.10044406372415875,88
3465,3,6555,2582,3973,0,0,0,1.0,1,1.0,1,1.0,1,0.10156705400161385,87
3466,2,6557,2583,3974,0,0,0,1.0,1,1.0,1,1.0,1,0.0874751638904529,87
3467,2,6559,2584,3975,0,0,0,1.0,1,1.0,1,1.0,1,0.09481679027539731,87
3468,5,6564,2586,3978,0,0,0,1.0,1,1.0,1,1.0,1,0.10649985237867428,88
3469,2,6566,2587,3979,0,0,0,1.0,1,1.0,1,1.0,1,0.11660694363042472,85
3470,6,6572,2589,3983,0,0,0,1.0,1,1.0,1,1.0,1,0.1055029044623111,86
3471,4,6576,2591,3985,0,0,0,1.0,1,1.0,1,1.0,1,0.1239513519133837,84
3472,1,6577,2592,3985,0,0,0,1.0,1,1.0,1,1.0,1,0.12706495351986088,83
3473,2,6579,2593,3986,0,0,0,1.0,1,1.0,1,1.0,1,0.1479370868013556,81
3474,1,6580,2593,3987,0,0,0,1.0,1,1.0,1,1.0,1,0.11349736154389371,80
3475,5,6585,2595,3990,0,0,0,1.0,1,1.0,1,1.0,1,0.148809118817046,82
3476,2,6587,2595,3992,0,0,0,1.0,1,1.0,1,1.0,1,0.1224886685796237,81
3477,4,6591,2596,3995,0,0,0,1.0,1,1.0,1,1.0,1,0.1426943885546779,83
3478,3,6594,2596,3998,0,0,0,1.0,1,1.0,1,1.0,1,0.11998876307785326,83
3479,1,6595,2596,3999,0,0,0,1.0,1,1.0,1,1.0,1,0.11374066130764929,83
3480,0,6595,2596,3999,0,0,0,1.0,1,1.0,1,1.0,1,0.11374066130764929,83
3481,7,6602,2598,4004,0,0,0,1.0,1,1.0,1,1.0,1,0.09872950007907993,83
3482,2,6604,2600,4004,0,0,0,1.0,1,1.0,1,1.0,1,0.12346160055850072,83
3483,2,6606,2601,4005,0,0,0,1.0,1,1.0,1,1.0,1,0.12554934426806136,82
3484,3,6609,2603,4006,0,0,0,1.0,1,1.0,1,1.0,1,0.15265388838649493,82
3485,4,6613,2604,4009,0,0,0,1.0,1,1.0,1,1.0,1,0.14507996417110444,83
3486,0,6613,2604,4009,0,0,0,1.0,1,1.0,1,1.0,1,0.14507996417110444,83
3487,3,6616,2604,4012,0,0,0,1.0,1,1.0,1,1.0,1,0.13235704964077874,84
3488,0,6616,2604,4012,0,0,0,1.0,1,1.0,1,1.0,1,0.13723337040552658,84
3489,2,6618,2604,4014,0,0,0,1.0,1,1.0,1,1.0,1,0.12759664104059332,84
3490,1,6619,2604,4015,0,0,0,1.0,1,1.0,1,1.0,1,0.10488078844035353,84
3491,1,6620,2604,4016,0,0,0,1.0,1,1.0,1,1.0,1,0.09682168077726233,86
3492,1,6621,2604,4017,0,0,0,1.0,1,1.0,1,1.0,1,0.08924046334085152,86
3493,0,6621,2604,4017,0,0,0,1.0,1,1.0,1,1.0,1,0.08924046334085152,86
3494,0,6621,2604,4017,0,0,0,1.0,1,1.0,1,1.0,1,0.08924046334085152,86
3495,2,6623,2604,4019,0,0,0,1.0,1,1.0,1,1.0,1,0.07928970539741326,87
3496,0,6623,2604,4019,0,0,0,1.0,1,1.0,1,1.0,1,0.08723119546177259,88
3497,2,6625,2605,4020,0,0,0,1.0,1,1.0,1,1.0,1,0.10052878255708697,89
3498,4,6629,2605,4024,0,0,0,1.0,1,1.0,1,1.0,1,0.09605393091001571,89
3499,2,6631,2605,4026,0,0,0,1.0,1,1.0,1,1.0,1,0.07933049821087391,91
3500,1,6632,2605,4027,0,0,0,1.0,1,1.0,1,1.0,1,0.08440922445245458,90
3501,0,6632,2605,4027,0,0,0,1.0,1,1.0,1,1.0,1,0.08440922445245458,90
3502,0,6632,2605,4027,0,0,0,1.0,1,1.0,1,1.0,1,0.09192039736008234,91
3503,2,6634,2607,4027,0,0,0,1.0,1,1.0,1,1.0,1,0.09606965478435982,91
3504,3,6637,2609,4028,0,0,0,1.0,1,1.0,1,1.0,1,0.11348808552931774,89
3505,4,6641,2610,4031,0,0,0,1.0,1,1.0,1,1.0,1,0.10009665705054825,87
3506,3,6644,2613,4031,0,0,0,1.0,1,1.0,1,1.0,1,0.12000765958433424,87
3507,4,6648,2615,4033,0,0,0,1.0,1,1.0,1,1.0,1,0.08910881857492818,84
3508,1,6649,2616,4033,0,0,0,1.0,1,1.0,1,1.0,1,0.12059273851972682,83
3509,6,6655,2619,4036,0,0,0,1.0,1,1.0,1,1.0,1,0.11963991934380035,80
3510,0,6655,2619,4036,0,0,0,1.0,1,1.0,1,1.0,1,0.11588142175859281,78
3511,3,6658,2621,4037,0,0,0,1.0,1,1.0,1,1.0,1,0.11267357568748199,77
3512,0,6658,2621,4037,0,0,0,1.0,1,1.0,1,1.0,1,0.12546397856112826,74
3513,4,6662,2623,4039,0,0,0,1.0,1,1.0,1,1.0,1,0.11453580912957194,76
3514,2,6664,2624,4040,0,0,0,1.0,1,1.0,1,1.0,1,0.11782785031252752,76
3515,0,6664,2624,4040,0,0,0,1.0,1,1.0,1,1.0,1,0.11932828745162762,75
3516,0,6664,2624,4040,0,0,0,1.0,1,1.0,1,1.0,1,0.13609245730615294,73
3517,5,6669,2626,4043,0,0,0,1.0,1,1.0,1,1.0,1,0.12875819909103373,74
3518,2,6671,2626,4045,0,0,0,1.0,1,1.0,1,1.0,1,0.13048030686879541,74
3519,3,6674,2626,4048,0,0,0,1.0,1,1.0,1,1.0,1,0.13134127312053792,73
3520,2,6676,2626,4050,0,0,0,1.0,1,1.0,1,1.0,1,0.0862580649770083,74
3521,1,6677,2626,4051,0,0,0,1.0,1,1.0,1,1.0,1,0.08855298064948916,75
3522,1,6678,2626,4052,0,0,0,1.0,1,1.0,1,1.0,1,0.08068174032126553,75
3523,0,6678,2626,4052,0,0,0,1.0,1,1.0,1,1.0,1,0.08068174032126553,75
3524,0,6678,2626,4052,0,0,0,1.0,1,1.0,1,1.0,1,0.0695579115466734,75
3525,0,6678,2626,4052,0,0,0,1.0,1,1.0,1,1.0,1,0.08157665543716741,75
3526,4,6682,2628,4054,0,0,0,1.0,1,1.0,1,1.0,1,0.06380427666703764,76
3527,4,6686,2630,4056,0,0,0,1.0,1,1.0,1,1.0,1,0.09937494068618818,77
3528,3,6689,2631,4058,0,0,0,1.0,1,1.0,1,1.0,1,0.11182272109533847,77
3529,3,6692,2632,4060,0,0,0,1.0,1,1.0,1,1.0,1,0.1081399937665304,78
3530,1,6693,2632,4061,0,0,0,1.0,1,1.0,1,1.0,1,0.12268369340010168,78
3531,6,6699,2633,4066,0,0,0,1.0,1,1.0,1,1.0,1,0.12499178690459288,79
3532,2,6701,2634,4067,0,0,0,1.0,1,1.0,1,1.0,1,0.1447091492620062,79
3533,3,6704,2636,4068,0,0,0,1.0,1,1.0,1,1.0,1,0.176042558740891,79
3534,5,6709,2638,4071,0,0,0,1.0,1,1.0,1,1.0,1,0.171111928742242,80
3535,3,6712,2638,4074,0,0,0,1.0,1,1.0,1,1.0,1,0.15556236118194858,81
3536,1,6713,2638,4075,0,0,0,1.0,1,1.0,1,1.0,1,0.14545685503329847,82
3537,2,6715,2638,4077,0,0,0,1.0,1,1.0,1,1.0,1,0.13177684134853582,82
3538,0,6715,2638,4077,0,0,0,1.0,1,1.0,1,1.0,1,0.13852163785899924,83
3539,1,6716,2638,4078,0,0,0,1.0,1,1.0,1,1.0,1,0.13529936783226462,83
3540,1,6717,2639,4078,0,0,0,1.0,1,1.0,1,1.0,1,0.13306703501109324,85
3541,4,6721,2640,4081,0,0,0,1.0,1,1.0,1,1.0,1,0.12248001171680031,85
3542,1,6722,2640,4082,0,0,0,1.0,1,1.0,1,1.0,1,0.11295208587090518,88
3543,0,6722,2640,4082,0,0,0,1.0,1,1.0,1,1.0,1,0.10918747603823797,87
3544,1,6723,2640,4083,0,0,0,1.0,1,1.0,1,1.0,1,0.09679300907645388,87
3545,2,6725,2640,4085,0,0,0,1.0,1,1.0,1,1.0,1,0.07769709376866261,85
3546,0,6725,2640,4085,0,0,0,1.0,1,1.0,1,1.0,1,0.07947516782097093,83
3547,2,6727,2640,4087,0,0,0,1.0,1,1.0,1,1.0,1,0.06870201124787888,82
3548,1,6728,2641,4087,0,0,0,1.0,1,1.0,1,1.0,1,0.07098424566334939,82
3549,1,6729,2642,4087,0,0,0,1.0,1,1.0,1,1.0,1,0.06963199495267137,81
3550,3,6732,2644,4088,0,0,0,1.0,1,1.0,1,1.0,1,0.0788634672702976,79
3551,2,6734,2644,4090,0,0,0,1.0,1,1.0,1,1.0,1,0.05284116847602915,80
3552,2,6736,2645,4091,0,0,0,1.0,1,1.0,1,1.0,1,0.05729625220564397,78
3553,0,6736,2645,4091,0,0,0,1.0,1,1.0,1,1.0,1,0.06732077793182877,79
3554,0,6736,2645,4091,0,0,0,1.0,1,1.0,1,1.0,1,0.08437345463601877,77
3555,4,6740,2646,4094,0,0,0,1.0,1,1.0,1,1.0,1,0.07533811954621893,77
3556,0,6740,2646,4094,0,0,0,1.0,1,1.0,1,1.0,1,0.08575630349713884,76
3557,1,6741,2646,4095,0,0,0,1.0,1,1.0,1,1.0,1,0.06631451299435809,76
3558,2,6743,2647,4096,0,0,0,1.0,1,1.0,1,1.0,1,0.09327626852827814,76
3559,2,6745,2647,4098,0,0,0,1.0,1,1.0,1,1.0,1,0.08238570632108062,76
3560,1,6746,2648,4098,0,0,0,1.0,1,1.0,1,1.0,1,0.10223263622465201,78
3561,3,6749,2649,4100,0,0,0,1.0,1,1.0,1,1.0,1,0.09967869552712076,79
3562,2,6751,2649,4102,0,0,0,1.0,1,1.0,1,1.0,1,0.09100157403010806,79
3563,5,6756,2651,4105,0,0,0,1.0,1,1.0,1,1.0,1,0.06586225070956384,79
3564,6,6762,2653,4109,0,0,0,1.0,1,1.0,1,1.0,1,0.10481054193092414,80
3565,3,6765,2654,4111,0,0,0,1.0,1,1.0,1,1.0,1,0.11399556261299498,83
3566,7,6772,2656,4116,0,0,0,1.0,1,1.0,1,1.0,1,0.13222968634707674,84
3567,4,6776,2656,4120,0,0,0,1.0,1,1.0,1,1.0,1,0.10721432113600714,84
3568,2,6778,2658,4120,0,0,0,1.0,1,1.0,1,1.0,1,0.1112895502747844,84
3569,3,6781,2659,4122,0,0,0,1.0,1,1.0,1,1.0,1,0.10742049042429615,84
3570,7,6788,2661,4127,0,0,0,1.0,1,1.0,1,1.0,1,0.096934294376828,87
3571,6,6794,2663,4131,0,0,0,1.0,1,1.0,1,1.0,1,0.10326586306503312,86
3572,6,6800,2665,4135,0,0,0,1.0,1,1.0,1,1.0,1,0.12450329561058837,87
3573,4,6804,2667,4137,0,0,0,1.0,1,1.0,1,1.0,1,0.13218450195331405,87
3574,3,6807,2668,4139,0,0,0,1.0,1,1.0,1,1.0,1,0.14109140157866512,88
3575,6,6813,2668,4145,0,0,0,1.0,1,1.0,1,1.0,1,0.11739256352705982,88
3576,1,6814,2669,4145,0,0,0,1.0,1,1.0,1,1.0,1,0.11816183965381011,90
3577,7,6821,2669,4152,0,0,0,1.0,1,1.0,1,1.0,1,0.08370495889790149,90
3578,3,6824,2669,4155,0,0,0,1.0,1,1.0,1,1.0,1,0.08215123633552758,91
3579,1,6825,2669,4156,0,0,0,1.0,1,1.0,1,1.0,1,0.08016096325862437,91
3580,0,6825,2669,4156,0,0,0,1.0,1,1.0,1,1.0,1,0.10276691608520695,91
3581,2,6827,2669,4158,0,0,0,1.0,1,1.0,1,1.0,1,0.08717381174869283,91
3582,0,6827,2669,4158,0,0,0,1.0,1,1.0,1,1.0,1,0.09485462133128111,92
3583,0,6827,2669,4158,0,0,0,1.0,1,1.0,1,1.0,1,0.09371606541690806,88
3584,2,6829,2670,4159,0,0,0,1.0,1,1.0,1,1.0,1,0.09013195290163384,87
3585,6,6835,2670,4165,0,0,0,1.0,1,1.0,1,1.0,1,0.09793413722982758,84
3586,4,6839,2673,4166,0,0,0,1.0,1,1.0,1,1.0,1,0.09331714748503946,83
3587,5,6844,2674,4170,0,0,0,1.0,1,1.0,1,1.0,1,0.06869313413678081,82
3588,3,6847,2675,4172,0,0,0,1.0,1,1.0,1,1.0,1,0.0667184588421589,81
3589,4,6851,2678,4173,0,0,0,1.0,1,1.0,1,1.0,1,0.09896752851114374,80
3590,1,6852,2678,4174,0,0,0,1.0,1,1.0,1,1.0,1,0.12074974338814692,78
3591,5,6857,2679,4178,0,0,0,1.0,1,1.0,1,1.0,1,0.08848446347168455,77
3592,2,6859,2680,4179,0,0,0,1.0,1,1.0,1,1.0,1,0.11325531634103005,75
3593,4,6863,2681,4182,0,0,0,1.0,1,1.0,1,1.0,1,0.0958665043625639,76
3594,2,6865,2683,4182,0,0,0,1.0,1,1.0,1,1.0,1,0.11439137744209131,74
3595,4,6869,2684,4185,0,0,0,1.0,1,1.0,1,1.0,1,0.10249640508769688,74
3596,2,6871,2684,4187,0,0,0,1.0,1,1.0,1,1.0,1,0.11040931026435143,73
3597,4,6875,2686,4189,0,0,0,1.0,1,1.0,1,1.0,1,0.10213647915922242,73
3598,2,6877,2687,4190,0,0,0,1.0,1,1.0,1,1.0,1,0.11480471840330528,73
3599,2,6879,2687,4192,0,0,0,1.0,1,1.0,1,1.0,1,0.09969348926786807,73
3600,1,6880,2687,4193,0,0,0,1.0,1,1.0,1,1.0,1,0.09871791494551109,74
3601,3,6883,2688,4195,0,0,0,1.0,1,1.0,1,1.0,1,0.09406142912714055,75
3602,3,6886,2688,4198,0,0,0,1.0,1,1.0,1,1.0,1,0.0697800775492687,76
3603,2,6888,2690,4198,0,0,0,1.0,1,1.0,1,1.0,1,0.11532940693050925,77
3604,3,6891,2691,4200,0,0,0,1.0,1,1.0,1,1.0,1,0.1095934995394956,78
3605,5,6896,2692,4204,0,0,0,1.0,1,1.0,1,1.0,1,0.08229800873085011,77
3606,1,6897,2693,4204,0,0,0,1.0,1,1.0,1,1.0,1,0.09560034930508997,79
3607,2,6899,2694,4205,0,0,0,1.0,1,1.0,1,1.0,1,0.0786657543011217,79
3608,0,6899,2694,4205,0,0,0,1.0,1,1.0,1,1.0,1,0.0786657543011217,79
3609,1,6900,2694,4206,0,0,0,1.0,1,1.0,1,1.0,1,0.07339027621425973,79
3610,2,6902,2696,4206,0,0,0,1.0,1,1.0,1,1.0,1,0.09285150544451369,80
3611,2,6904,2697,4207,0,0,0,1.0,1,1.0,1,1.0,1,0.07833938977713055,80
3612,2,6906,2698,4208,0,0,0,1.0,1,1.0,1,1.0,1,0.09474126857172771,79
3613,2,6908,2698,4210,0,0,0,1.0,1,1.0,1,1.0,1,0.06951122236165094,79
3614,3,6911,2701,4210,0,0,0,1.0,1,1.0,1,1.0,1,0.08217460393253563,78
3615,3,6914,2701,4213,0,0,0,1.0,1,1.0,1,1.0,1,0.05354544684673186,79
3616,0,6914,2701,4213,0,0,0,1.0,1,1.0,1,1.0,1,0.0689928481035369,79
3617,4,6918,2703,4215,0,0,0,1.0,1,1.0,1,1.0,1,0.061889856131319365,80
3618,2,6920,2703,4217,0,0,0,1.0,1,1.0,1,1.0,1,0.08289221056641595,82
3619,4,6924,2704,4220,0,0,0,1.0,1,1.0,1,1.0,1,0.06594033196375443,82
3620,3,6927,2706,4221,0,0,0,1.0,1,1.0,1,1.0,1,0.09000733490449386,81
3621,3,6930,2707,4223,0,0,0,1.0,1,1.0,1,1.0,1,0.10469992855904094,83
3622,1,6931,2708,4223,0,0,0,1.0,1,1.0,1,1.0,1,0.12430380371683325,81
3623,4,6935,2710,4225,0,0,0,1.0,1,1.0,1,1.0,1,0.11990805023074551,81
3624,0,6935,2710,4225,0,0,0,1.0,1,1.0,1,1.0,1,0.11487224374263445,79
3625,6,6941,2712,4229,0,0,0,1.0,1,1.0,1,1.0,1,0.08828643465455688,80
3626,2,6943,2712,4231,0,0,0,1.0,1,1.0,1,1.0,1,0.08327831020286555,78
3627,5,6948,2713,4235,0,0,0,1.0,1,1.0,1,1.0,1,0.06419135040934101,78
3628,2,6950,2713,4237,0,0,0,1.0,1,1.0,1,1.0,1,0.04988536922119995,77
3629,0,6950,2713,4237,0,0,0,1.0,1,1.0,1,1.0,1,0.05640295499483329,76
3630,1,6951,2714,4237,0,0,0,1.0,1,1.0,1,1.0,1,0.045148208432686576,77
3631,1,6952,2714,4238,0,0,0,1.0,1,1.0,1,1.0,1,0.041568836235646514,75
3632,5,6957,2717,4240,0,0,0,1.0,1,1.0,1,1.0,1,0.10018627440272726,74
3633,3,6960,2718,4242,0,0,0,1.0,1,1.0,1,1.0,1,0.09673158020133438,75
3634,0,6960,2718,4242,0,0,0,1.0,1,1.0,1,1.0,1,0.1007071005524346,74
3635,1,6961,2719,4242,0,0,0,1.0,1,1.0,1,1.0,1,0.11367686564414616,74
3636,1,6962,2719,4243,0,0,0,1.0,1,1.0,1,1.0,1,0.12099791150599847,74
3637,3,6965,2720,4245,0,0,0,1.0,1,1.0,1,1.0,1,0.12202507029643295,74
3638,2,6967,2720,4247,0,0,0,1.0,1,1.0,1,1.0,1,0.11639186860600663,75
3639,7,6974,2721,4253,0,0,0,1.0,1,1.0,1,1.0,1,0.10769848730311433,76
3640,0,6974,2721,4253,0,0,0,1.0,1,1.0,1,1.0,1,0.10769848730311433,76
3641,5,6979,2722,4257,0,0,0,1.0,1,1.0,1,1.0,1,0.09946486419802704,75
3642,5,6984,2724,4260,0,0,0,1.0,1,1.0,1,1.0,1,0.1270623134276642,75
3643,2,6986,2724,4262,0,0,0,1.0,1,1.0,1,1.0,1,0.10226615755630285,74
3644,0,6986,2724,4262,0,0,0,1.0,1,1.0,1,1.0,1,0.10226615755630285,74
3645,0,6986,2724,4262,0,0,0,1.0,1,1.0,1,1.0,1,0.10226615755630285,74
3646,0,6986,2724,4262,0,0,0,1.0,1,1.0,1,1.0,1,0.09379643469540648,75
3647,0,6986,2724,4262,0,0,0,1.0,1,1.0,1,1.0,1,0.09716551796473875,77
3648,1,6987,2724,4263,0,0,0,1.0,1,1.0,1,1.0,1,0.1019397462519342,78
3649,3,6990,2724,4266,0,0,0,1.0,1,1.0,1,1.0,1,0.08894579749003452,80
3650,2,6992,2725,4267,0,0,0,1.0,1,1.0,1,1.0,1,0.09744012425796239,81
3651,1,6993,2725,4268,0,0,0,1.0,1,1.0,1,1.0,1,0.09125303286354586,81
3652,2,6995,2726,4269,0,0,0,1.0,1,1.0,1,1.0,1,0.1093797196412805,83
3653,1,6996,2726,4270,0,0,0,1.0,1,1.0,1,1.0,1,0.10670439643793407,83
3654,0,6996,2726,4270,0,0,0,1.0,1,1.0,1,1.0,1,0.10670439643793407,83
3655,2,6998,2726,4272,0,0,0,1.0,1,1.0,1,1.0,1,0.08762699411288652,84
3656,1,6999,2726,4273,0,0,0,1.0,1,1.0,1,1.0,1,0.09400568271581743,85
3657,1,7000,2726,4274,0,0,0,1.0,1,1.0,1,1.0,1,0.08357733096867594,86
3658,1,7001,2727,4274,0,0,0,1.0,1,1.0,1,1.0,1,0.09668420249793346,87
3659,0,7001,2727,4274,0,0,0,1.0,1,1.0,1,1.0,1,0.09026206995441814,87
3660,0,7001,2727,4274,0,0,0,1.0,1,1.0,1,1.0,1,0.0954758610764318,86
3661,3,7004,2728,4276,0,0,0,1.0,1,1.0,1,1.0,1,0.09562743766787563,86
3662,3,7007,2729,4278,0,0,0,1.0,1,1.0,1,1.0,1,0.11507885130461103,83
3663,8,7015,2733,4282,0,0,0,1.0,1,1.0,1,1.0,1,0.16111359341875717,85
3664,4,7019,2735,4284,0,0,0,1.0,1,1.0,1,1.0,1,0.1666917965506915,82
3665,8,7027,2735,4292,0,0,0,1.0,1,1.0,1,1.0,1,0.10026608840033527,81
3666,2,7029,2736,4293,0,0,0,1.0,1,1.0,1,1.0,1,0.10821215463176401,79
3667,3,7032,2737,4295,0,0,0,1.0,1,1.0,1,1.0,1,0.09437559574842325,79
3668,1,7033,2738,4295,0,0,0,1.0,1,1.0,1,1.0,1,0.09517334419294704,77
3669,3,7036,2738,4298,0,0,0,1.0,1,1.0,1,1.0,1,0.07875117973514449,75
3670,2,7038,2740,4298,0,0,0,1.0,1,1.0,1,1.0,1,0.11187691765066579,76
3671,2,7040,2740,4300,0,0,0,1.0,1,1.0,1,1.0,1,0.07518153611731748,74
3672,2,7042,2741,4301,0,0,0,1.0,1,1.0,1,1.0,1,0.06764198810434592,75
3673,0,7042,2741,4301,0,0,0,1.0,1,1.0,1,1.0,1,0.06764198810434592,75
3674,3,7045,2743,4302,0,0,0,1.0,1,1.0,1,1.0,1,0.08401041071488764,75
3675,1,7046,2743,4303,0,0,0,1.0,1,1.0,1,1.0,1,0.07586461677052775,75
3676,1,7047,2744,4303,0,0,0,1.0,1,1.0,1,1.0,1,0.09936158789227306,75
3677,2,7049,2744,4305,0,0,0,1.0,1,1.0,1,1.0,1,0.09773101072426843,75
3678,3,7052,2745,4307,0,0,0,1.0,1,1.0,1,1.0,1,0.1113665747861287,77
3679,1,7053,2746,4307,0,0,0,1.0,1,1.0,1,1.0,1,0.13440440792845507,78
3680,2,7055,2746,4309,0,0,0,1.0,1,1.0,1,1.0,1,0.1330231703174518,80
3681,2,7057,2746,4311,0,0,0,1.0,1,1.0,1,1.0,1,0.12488311246010944,81
3682,0,7057,2746,4311,0,0,0,1.0,1,1.0,1,1.0,1,0.12488311246010944,81
3683,1,7058,2747,4311,0,0,0,1.0,1,1.0,1,1.0,1,0.14028262328189622,81
3684,0,7058,2747,4311,0,0,0,1.0,1,1.0,1,1.0,1,0.14028262328189622,81
3685,0,7058,2747,4311,0,0,0,1.0,1,1.0,1,1.0,1,0.14028262328189622,81
3686,0,7058,2747,4311,0,0,0,1.0,1,1.0,1,1.0,1,0.14028262328189622,81
3687,1,7059,2747,4312,0,0,0,1.0,1,1.0,1,1.0,1,0.12581371682186065,82
3688,1,7060,2747,4313,0,0,0,1.0,1,1.0,1,1.0,1,0.13009071584973206,84
3689,0,7060,2747,4313,0,0,0,1.0,1,1.0,1,1.0,1,0.13009071584973206,84
3690,3,7063,2749,4314,0,0,0,1.0,1,1.0,1,1.0,1,0.14547183155462254,85
3691,1,7064,2749,4315,0,0,0,1.0,1,1.0,1,1.0,1,0.13701449042142957,86
3692,0,7064,2749,4315,0,0,0,1.0,1,1.0,1,1.0,1,0.12306209394958262,86
3693,1,7065,2749,4316,0,0,0,1.0,1,1.0,1,1.0,1,0.11969562882766915,86
3694,0,7065,2749,4316,0,0,0,1.0,1,1.0,1,1.0,1,0.11969562882766915,86
3695,1,7066,2750,4316,0,0,0,1.0,1,1.0,1,1.0,1,0.14334778108214175,86
3696,0,7066,2750,4316,0,0,0,1.0,1,1.0,1,1.0,1,0.12958069344225007,87
3697,1,7067,2751,4316,0,0,0,1.0,1,1.0,1,1.0,1,0.13363349132855504,85
3698,0,7067,2751,4316,0,0,0,1.0,1,1.0,1,1.0,1,0.1361035888952794,85
3699,1,7068,2752,4316,0,0,0,1.0,1,1.0,1,1.0,1,0.11741657155267095,85
3700,5,7073,2756,4317,0,0,0,1.0,1,1.0,1,1.0,1,0.13087709820446428,84
3701,3,7076,2757,4319,0,0,0,1.0,1,1.0,1,1.0,1,0.1603021261097438,85
3702,2,7078,2759,4319,0,0,0,1.0,1,1.0,1,1.0,1,0.17296558223741682,85
3703,2,7080,2759,4321,0,0,0,1.0,1,1.0,1,1.0,1,0.15886262434688753,85
3704,2,7082,2759,4323,0,0,0,1.0,1,1.0,1,1.0,1,0.14497133331201098,85
3705,1,7083,2759,4324,0,0,0,1.0,1,1.0,1,1.0,1,0.13211290409625692,86
3706,1,7084,2760,4324,0,0,0,1.0,1,1.0,1,1.0,1,0.14028007898654676,86
3707,2,7086,2762,4324,0,0,0,1.0,1,1.0,1,1.0,1,0.1619592874647701,85
3708,1,7087,2762,4325,0,0,0,1.0,1,1.0,1,1.0,1,0.1495545223221855,84
3709,2,7089,2762,4327,0,0,0,1.0,1,1.0,1,1.0,1,0.14242010829499044,85
3710,0,7089,2762,4327,0,0,0,1.0,1,1.0,1,1.0,1,0.13812325102890563,84
3711,2,7091,2762,4329,0,0,0,1.0,1,1.0,1,1.0,1,0.1338584148281201,85
3712,2,7093,2762,4331,0,0,0,1.0,1,1.0,1,1.0,1,0.12028039716904457,85
3713,1,7094,2762,4332,0,0,0,1.0,1,1.0,1,1.0,1,0.11728109094819973,85
3714,3,7097,2763,4334,0,0,0,1.0,1,1.0,1,1.0,1,0.1274936029468984,85
3715,3,7100,2763,4337,0,0,0,1.0,1,1.0,1,1.0,1,0.12101775806375316,85
3716,1,7101,2764,4337,0,0,0,1.0,1,1.0,1,1.0,1,0.122009033076685,84
3717,3,7104,2764,4340,0,0,0,1.0,1,1.0,1,1.0,1,0.11652195648797642,86
3718,0,7104,2764,4340,0,0,0,1.0,1,1.0,1,1.0,1,0.1300587369466374,85
3719,3,7107,2766,4341,0,0,0,1.0,1,1.0,1,1.0,1,0.13508006955164673,84
3720,2,7109,2766,4343,0,0,0,1.0,1,1.0,1,1.0,1,0.14257870831556552,84
3721,6,7115,2769,4346,0,0,0,1.0,1,1.0,1,1.0,1,0.1381310791480511,85
3722,0,7115,2769,4346,0,0,0,1.0,1,1.0,1,1.0,1,0.13308303258883625,85
3723,1,7116,2769,4347,0,0,0,1.0,1,1.0,1,1.0,1,0.14212274079777976,85
3724,2,7118,2769,4349,0,0,0,1.0,1,1.0,1,1.0,1,0.12140315198084638,86
3725,1,7119,2770,4349,0,0,0,1.0,1,1.0,1,1.0,1,0.11267640770895722,86
3726,1,7120,2770,4350,0,0,0,1.0,1,1.0,1,1.0,1,0.10814124219017712,86
3727,0,7120,2770,4350,0,0,0,1.0,1,1.0,1,1.0,1,0.10814124219017712,86
3728,1,7121,2771,4350,0,0,0,1.0,1,1.0,1,1.0,1,0.11482308795332426,86
3729,1,7122,2772,4350,0,0,0,1.0,1,1.0,1,1.0,1,0.1290045210245879,86
3730,0,7122,2772,4350,0,0,0,1.0,1,1.0,1,1.0,1,0.14090859093979183,85
3731,1,7123,2772,4351,0,0,0,1.0,1,1.0,1,1.0,1,0.14373312941057795,86
3732,0,7123,2772,4351,0,0,0,1.0,1,1.0,1,1.0,1,0.13945187070630952,87
3733,1,7124,2773,4351,0,0,0,1.0,1,1.0,1,1.0,1,0.15886725340152405,87
3734,1,7125,2773,4352,0,0,0,1.0,1,1.0,1,1.0,1,0.1556322071656223,87
3735,4,7129,2774,4355,0,0,0,1.0,1,1.0,1,1.0,1,0.14541923457321274,86
3736,3,7132,2775,4357,0,0,0,1.0,1,1.0,1,1.0,1,0.14184505914247073,87
3737,6,7138,2777,4361,0,0,0,1.0,1,1.0,1,1.0,1,0.13212915386041305,87
3738,2,7140,2778,4362,0,0,0,1.0,1,1.0,1,1.0,1,0.14043074446535128,87
3739,3,7143,2778,4365,0,0,0,1.0,1,1.0,1,1.0,1,0.12799699145326046,88
3740,4,7147,2780,4367,0,0,0,1.0,1,1.0,1,1.0,1,0.14455678648068296,87
3741,7,7154,2780,4374,0,0,0,1.0,1,1.0,1,1.0,1,0.11682560572622004,87
3742,3,7157,2781,4376,0,0,0,1.0,1,1.0,1,1.0,1,0.12422035274081986,86
3743,5,7162,2782,4380,0,0,0,1.0,1,1.0,1,1.0,1,0.10434788483682907,84
3744,1,7163,2783,4380,0,0,0,1.0,1,1.0,1,1.0,1,0.12602574436118935,83
3745,3,7166,2783,4383,0,0,0,1.0,1,1.0,1,1.0,1,0.11049751533520275,83
3746,1,7167,2784,4383,0,0,0,1.0,1,1.0,1,1.0,1,0.14638999269295655,83
3747,6,7173,2786,4387,0,0,0,1.0,1,1.0,1,1.0,1,0.12225126659021023,81
3748,1,7174,2786,4388,0,0,0,1.0,1,1.0,1,1.0,1,0.13606237860678305,81
3749,2,7176,2786,4390,0,0,0,1.0,1,1.0,1,1.0,1,0.12027212661845811,80
3750,0,7176,2786,4390,0,0,0,1.0,1,1.0,1,1.0,1,0.12825370215327825,79
3751,3,7179,2788,4391,0,0,0,1.0,1,1.0,1,1.0,1,0.13432356941157325,80
3752,1,7180,2788,4392,0,0,0,1.0,1,1.0,1,1.0,1,0.13631724748083668,80
3753,8,7188,2792,4396,0,0,0,1.0,1,1.0,1,1.0,1,0.1311072248149221,81
3754,1,7189,2793,4396,0,0,0,1.0,1,1.0,1,1.0,1,0.1482589305076979,81
3755,4,7193,2794,4399,0,0,0,1.0,1,1.0,1,1.0,1,0.1597530627589232,80
3756,1,7194,2795,4399,0,0,0,1.0,1,1.0,1,1.0,1,0.18286392706607033,79
3757,3,7197,2795,4402,0,0,0,1.0,1,1.0,1,1.0,1,0.17639630553461444,80
3758,0,7197,2795,4402,0,0,0,1.0,1,1.0,1,1.0,1,0.18213177027779523,79
3759,1,7198,2796,4402,0,0,0,1.0,1,1.0,1,1.0,1,0.18054114982900715,79
3760,0,7198,2796,4402,0,0,0,1.0,1,1.0,1,1.0,1,0.18054114982900715,79
3761,0,7198,2796,4402,0,0,0,1.0,1,1.0,1,1.0,1,0.1962644713590375,78
3762,2,7200,2796,4404,0,0,0,1.0,1,1.0,1,1.0,1,0.1872847092727359,80
3763,0,7200,2796,4404,0,0,0,1.0,1,1.0,1,1.0,1,0.1872847092727359,80
3764,2,7202,2798,4404,0,0,0,1.0,1,1.0,1,1.0,1,0.21471801461523973,80
3765,5,7207,2798,4409,0,0,0,1.0,1,1.0,1,1.0,1,0.19326012683957178,81
3766,2,7209,2799,4410,0,0,0,1.0,1,1.0,1,1.0,1,0.19826221113202433,83
3767,5,7214,2799,4415,0,0,0,1.0,1,1.0,1,1.0,1,0.16701275349682174,83
3768,2,7216,2799,4417,0,0,0,1.0,1,1.0,1,1.0,1,0.1530755865208856,84
3769,2,7218,2799,4419,0,0,0,1.0,1,1.0,1,1.0,1,0.12374296616553118,86
3770,0,7218,2799,4419,0,0,0,1.0,1,1.0,1,1.0,1,0.1268909445590545,87
3771,4,7222,2800,4422,0,0,0,1.0,1,1.0,1,1.0,1,0.10197307141943533,87
3772,0,7222,2800,4422,0,0,0,1.0,1,1.0,1,1.0,1,0.12319319519678538,88
3773,2,7224,2800,4424,0,0,0,1.0,1,1.0,1,1.0,1,0.1166438623990936,85
3774,1,7225,2800,4425,0,0,0,1.0,1,1.0,1,1.0,1,0.11416845742459117,85
3775,4,7229,2801,4428,0,0,0,1.0,1,1.0,1,1.0,1,0.12187820835204019,83
3776,1,7230,2802,4428,0,0,0,1.0,1,1.0,1,1.0,1,0.15555261087713057,82
3777,3,7233,2802,4431,0,0,0,1.0,1,1.0,1,1.0,1,0.13272290931818193,81
3778,0,7233,2802,4431,0,0,0,1.0,1,1.0,1,1.0,1,0.13204968166471337,81
3779,2,7235,2804,4431,0,0,0,1.0,1,1.0,1,1.0,1,0.16769166955956344,80
3780,1,7236,2804,4432,0,0,0,1.0,1,1.0,1,1.0,1,0.16293302369880566,80
3781,2,7238,2804,4434,0,0,0,1.0,1,1.0,1,1.0,1,0.1586779894102047,80
3782,1,7239,2805,4434,0,0,0,1.0,1,1.0,1,1.0,1,0.17176375551600156,80
3783,4,7243,2806,4437,0,0,0,1.0,1,1.0,1,1.0,1,0.17579196097022037,80
3784,0,7243,2806,4437,0,0,0,1.0,1,1.0,1,1.0,1,0.17058659852780306,79
3785,3,7246,2806,4440,0,0,0,1.0,1,1.0,1,1.0,1,0.1531087414169394,77
3786,0,7246,2806,4440,0,0,0,1.0,1,1.0,1,1.0,1,0.14403015834312474,78
3787,0,7246,2806,4440,0,0,0,1.0,1,1.0,1,1.0,1,0.1460430703326025,77
3788,2,7248,2806,4442,0,0,0,1.0,1,1.0,1,1.0,1,0.13913502398124727,78
3789,4,7252,2808,4444,0,0,0,1.0,1,1.0,1,1.0,1,0.16710259195820176,77
3790,3,7255,2809,4446,0,0,0,1.0,1,1.0,1,1.0,1,0.17597464535385257,77
3791,3,7258,2810,4448,0,0,0,1.0,1,1.0,1,1.0,1,0.17107936612751454,77
3792,2,7260,2810,4450,0,0,0,1.0,1,1.0,1,1.0,1,0.1559217100275856,78
3793,2,7262,2810,4452,0,0,0,1.0,1,1.0,1,1.0,1,0.1333704294588594,80
3794,3,7265,2810,4455,0,0,0,1.0,1,1.0,1,1.0,1,0.11187284497755819,82
3795,2,7267,2810,4457,0,0,0,1.0,1,1.0,1,1.0,1,0.09944517301582692,83
3796,2,7269,2811,4458,0,0,0,1.0,1,1.0,1,1.0,1,0.08743364931426997,83
3797,1,7270,2811,4459,0,0,0,1.0,1,1.0,1,1.0,1,0.09464169979561018,82
3798,0,7270,2811,4459,0,0,0,1.0,1,1.0,1,1.0,1,0.09898053119467555,82
3799,1,7271,2811,4460,0,0,0,1.0,1,1.0,1,1.0,1,0.1015590176641521,83
3800,4,7275,2812,4463,0,0,0,1.0,1,1.0,1,1.0,1,0.11266958545178726,83
3801,4,7279,2813,4466,0,0,0,1.0,1,1.0,1,1.0,1,0.09931783672446468,83
3802,1,7280,2813,4467,0,0,0,1.0,1,1.0,1,1.0,1,0.10893925145744403,82
3803,3,7283,2813,4470,0,0,0,1.0,1,1.0,1,1.0,1,0.10343014398478599,84
3804,0,7283,2813,4470,0,0,0,1.0,1,1.0,1,1.0,1,0.10343014398478599,84
3805,3,7286,2814,4472,0,0,0,1.0,1,1.0,1,1.0,1,0.12859828995930758,86
3806,1,7287,2814,4473,0,0,0,1.0,1,1.0,1,1.0,1,0.12084510553250001,86
3807,3,7290,2815,4475,0,0,0,1.0,1,1.0,1,1.0,1,0.1284078507483257,86
3808,0,7290,2815,4475,0,0,0,1.0,1,1.0,1,1.0,1,0.13230835420952972,85
3809,3,7293,2816,4477,0,0,0,1.0,1,1.0,1,1.0,1,0.11928460285902025,85
3810,2,7295,2817,4478,0,0,0,1.0,1,1.0,1,1.0,1,0.11844824631216623,85
3811,1,7296,2818,4478,0,0,0,1.0,1,1.0,1,1.0,1,0.13183721054672143,84
3812,0,7296,2818,4478,0,0,0,1.0,1,1.0,1,1.0,1,0.13334304976959385,83
3813,2,7298,2818,4480,0,0,0,1.0,1,1.0,1,1.0,1,0.12251940303815635,82
3814,1,7299,2819,4480,0,0,0,1.0,1,1.0,1,1.0,1,0.12555071218665906,81
3815,1,7300,2819,4481,0,0,0,1.0,1,1.0,1,1.0,1,0.11375078803600237,82
3816,4,7304,2819,4485,0,0,0,1.0,1,1.0,1,1.0,1,0.07666850375055728,81
3817,1,7305,2819,4486,0,0,0,1.0,1,1.0,1,1.0,1,0.07343611367457634,81
3818,3,7308,2821,4487,0,0,0,1.0,1,1.0,1,1.0,1,0.09217032238359882,81
3819,4,7312,2823,4489,0,0,0,1.0,1,1.0,1,1.0,1,0.12247765325357697,82
3820,5,7317,2823,4494,0,0,0,1.0,1,1.0,1,1.0,1,0.1178135901899061,84
3821,4,7321,2824,4497,0,0,0,1.0,1,1.0,1,1.0,1,0.12587805957647177,84
3822,0,7321,2824,4497,0,0,0,1.0,1,1.0,1,1.0,1,0.11306765615382193,82
3823,2,7323,2824,4499,0,0,0,1.0,1,1.0,1,1.0,1,0.10387170984896593,81
3824,1,7324,2824,4500,0,0,0,1.0,1,1.0,1,1.0,1,0.12063663315402832,78
3825,2,7326,2824,4502,0,0,0,1.0,1,1.0,1,1.0,1,0.12070259303320492,76
3826,2,7328,2824,4504,0,0,0,1.0,1,1.0,1,1.0,1,0.12704179754211767,76
3827,2,7330,2825,4505,0,0,0,1.0,1,1.0,1,1.0,1,0.14405372525201193,75
3828,0,7330,2825,4505,0,0,0,1.0,1,1.0,1,1.0,1,0.15443868107911732,74
3829,5,7335,2827,4508,0,0,0,1.0,1,1.0,1,1.0,1,0.1465298071883789,74
3830,1,7336,2827,4509,0,0,0,1.0,1,1.0,1,1.0,1,0.13166430569172505,74
3831,5,7341,2829,4512,0,0,0,1.0,1,1.0,1,1.0,1,0.1531707474251078,74
3832,2,7343,2829,4514,0,0,0,1.0,1,1.0,1,1.0,1,0.1519400444290015,73
3833,5,7348,2831,4517,0,0,0,1.0,1,1.0,1,1.0,1,0.13735396569118224,73
3834,2,7350,2831,4519,0,0,0,1.0,1,1.0,1,1.0,1,0.13160597769089313,74
3835,2,7352,2832,4520,0,0,0,1.0,1,1.0,1,1.0,1,0.1415273633814553,75
3836,0,7352,2832,4520,0,0,0,1.0,1,1.0,1,1.0,1,0.14134722557029578,75
3837,6,7358,2833,4525,0,0,0,1.0,1,1.0,1,1.0,1,0.14357317711538922,78
3838,2,7360,2834,4526,0,0,0,1.0,1,1.0,1,1.0,1,0.14260350428946753,78
3839,6,7366,2834,4532,0,0,0,1.0,1,1.0,1,1.0,1,0.09465246792076595,79
3840,4,7370,2835,4535,0,0,0,1.0,1,1.0,1,1.0,1,0.1088539369555894,82
3841,0,7370,2835,4535,0,0,0,1.0,1,1.0,1,1.0,1,0.1088539369555894,82
3842,0,7370,2835,4535,0,0,0,1.0,1,1.0,1,1.0,1,0.10707674179415679,82
3843,2,7372,2835,4537,0,0,0,1.0,1,1.0,1,1.0,1,0.09546211665915849,82
3844,0,7372,2835,4537,0,0,0,1.0,1,1.0,1,1.0,1,0.09033398675388647,83
3845,4,7376,2835,4541,0,0,0,1.0,1,1.0,1,1.0,1,0.08806165768609733,84
3846,4,7380,2835,4545,0,0,0,1.0,1,1.0,1,1.0,1,0.06625967707571682,85
3847,0,7380,2835,4545,0,0,0,1.0,1,1.0,1,1.0,1,0.07694490641431975,84
3848,3,7383,2837,4546,0,0,0,1.0,1,1.0,1,1.0,1,0.08790722032636818,84
3849,2,7385,2837,4548,0,0,0,1.0,1,1.0,1,1.0,1,0.07004904316478051,83
3850,0,7385,2837,4548,0,0,0,1.0,1,1.0,1,1.0,1,0.09737082384923361,80
3851,2,7387,2837,4550,0,0,0,1.0,1,1.0,1,1.0,1,0.08652102803323994,80
3852,2,7389,2838,4551,0,0,0,1.0,1,1.0,1,1.0,1,0.11485502671840792,79
3853,3,7392,2839,4553,0,0,0,1.0,1,1.0,1,1.0,1,0.1076220212257031,79
3854,2,7394,2841,4553,0,0,0,1.0,1,1.0,1,1.0,1,0.13839754568083015,78
3855,4,7398,2842,4556,0,0,0,1.0,1,1.0,1,1.0,1,0.13972923539447704,78
3856,4,7402,2843,4559,0,0,0,1.0,1,1.0,1,1.0,1,0.1270087197767228,80
3857,3,7405,2843,4562,0,0,0,1.0,1,1.0,1,1.0,1,0.10511120797715662,81
3858,1,7406,2844,4562,0,0,0,1.0,1,1.0,1,1.0,1,0.12227720919840963,81
3859,1,7407,2844,4563,0,0,0,1.0,1,1.0,1,1.0,1,0.12620817414265412,83
3860,1,7408,2845,4563,0,0,0,1.0,1,1.0,1,1.0,1,0.131037814208981,82
3861,2,7410,2845,4565,0,0,0,1.0,1,1.0,1,1.0,1,0.12784221675720828,84
3862,2,7412,2846,4566,0,0,0,1.0,1,1.0,1,1.0,1,0.13410977447580974,85
3863,0,7412,2846,4566,0,0,0,1.0,1,1.0,1,1.0,1,0.12946875717265735,84
3864,1,7413,2847,4566,0,0,0,1.0,1,1.0,1,1.0,1,0.1259963183444608,83
3865,3,7416,2848,4568,0,0,0,1.0,1,1.0,1,1.0,1,0.12037136230736672,82
3866,1,7417,2848,4569,0,0,0,1.0,1,1.0,1,1.0,1,0.11480917107077254,81
3867,2,7419,2850,4569,0,0,0,1.0,1,1.0,1,1.0,1,0.11880037289026688,81
3868,4,7423,2852,4571,0,0,0,1.0,1,1.0,1,1.0,1,0.1254950384543633,81
3869,4,7427,2853,4574,0,0,0,1.0,1,1.0,1,1.0,1,0.10340386597637762,81
3870,0,7427,2853,4574,0,0,0,1.0,1,1.0,1,1.0,1,0.08330055046066882,80
3871,3,7430,2854,4576,0,0,0,1.0,1,1.0,1,1.0,1,0.08911131341081485,82
3872,0,7430,2854,4576,0,0,0,1.0,1,1.0,1,1.0,1,0.0829738999667473,81
3873,2,7432,2855,4577,0,0,0,1.0,1,1.0,1,1.0,1,0.08215648307759328,81
3874,0,7432,2855,4577,0,0,0,1.0,1,1.0,1,1.0,1,0.09473748762108573,78
3875,2,7434,2855,4579,0,0,0,1.0,1,1.0,1,1.0,1,0.06987086362810035,77
3876,3,7437,2855,4582,0,0,0,1.0,1,1.0,1,1.0,1,0.06629709047031064,78
3877,3,7440,2855,4585,0,0,0,1.0,1,1.0,1,1.0,1,0.06810679645438218,75
3878,0,7440,2855,4585,0,0,0,1.0,1,1.0,1,1.0,1,0.06810679645438218,75
3879,0,7440,2855,4585,0,0,0,1.0,1,1.0,1,1.0,1,0.0877538400334072,73
3880,0,7440,2855,4585,0,0,0,1.0,1,1.0,1,1.0,1,0.08356305184641186,74
3881,3,7443,2855,4588,0,0,0,1.0,1,1.0,1,1.0,1,0.06615694576307574,75
3882,2,7445,2855,4590,0,0,0,1.0,1,1.0,1,1.0,1,0.06297746246891245,76
3883,0,7445,2855,4590,0,0,0,1.0,1,1.0,1,1.0,1,0.056289885808938754,77
3884,2,7447,2857,4590,0,0,0,1.0,1,1.0,1,1.0,1,0.09785270567217885,78
3885,2,7449,2857,4592,0,0,0,1.0,1,1.0,1,1.0,1,0.08171991982389054,78
3886,2,7451,2859,4592,0,0,0,1.0,1,1.0,1,1.0,1,0.10461385825811167,79
3887,4,7455,2860,4595,0,0,0,1.0,1,1.0,1,1.0,1,0.08103809968869516,78
3888,2,7457,2861,4596,0,0,0,1.0,1,1.0,1,1.0,1,0.08778987586662712,80
3889,3,7460,2861,4599,0,0,0,1.0,1,1.0,1,1.0,1,0.07197676140724461,82
3890,3,7463,2862,4601,0,0,0,1.0,1,1.0,1,1.0,1,0.07405258253484477,82
3891,7,7470,2864,4606,0,0,0,1.0,1,1.0,1,1.0,1,0.0630829351798847,85
3892,3,7473,2866,4607,0,0,0,1.0,1,1.0,1,1.0,1,0.08583241644212802,87
3893,3,7476,2866,4610,0,0,0,1.0,1,1.0,1,1.0,1,0.06346548675893336,86
3894,0,7476,2866,4610,0,0,0,1.0,1,1.0,1,1.0,1,0.06858790530801641,87
3895,4,7480,2869,4611,0,0,0,1.0,1,1.0,1,1.0,1,0.11174667785592256,87
3896,0,7480,2869,4611,0,0,0,1.0,1,1.0,1,1.0,1,0.11544314587481673,85
3897,5,7485,2870,4615,0,0,0,1.0,1,1.0,1,1.0,1,0.11632506559554379,85
3898,4,7489,2871,4618,0,0,0,1.0,1,1.0,1,1.0,1,0.12776364981767172,86
3899,6,7495,2872,4623,0,0,0,1.0,1,1.0,1,1.0,1,0.0971527763002347,86
3900,1,7496,2872,4624,0,0,0,1.0,1,1.0,1,1.0,1,0.09282983304866248,86
3901,2,7498,2873,4625,0,0,0,1.0,1,1.0,1,1.0,1,0.0973727531541001,86
3902,3,7501,2874,4627,0,0,0,1.0,1,1.0,1,1.0,1,0.08765652197034542,87
3903,2,7503,2875,4628,0,0,0,1.0,1,1.0,1,1.0,1,0.08269479096373457,87
3904,3,7506,2877,4629,0,0,0,1.0,1,1.0,1,1.0,1,0.09260426177384425,85
3905,3,7509,2878,4631,0,0,0,1.0,1,1.0,1,1.0,1,0.07320734764601056,84
3906,4,7513,2879,4634,0,0,0,1.0,1,1.0,1,1.0,1,0.06548664053197792,86
3907,4,7517,2879,4638,0,0,0,1.0,1,1.0,1,1.0,1,0.06981253884672074,84
3908,1,7518,2880,4638,0,0,0,1.0,1,1.0,1,1.0,1,0.07079366771582822,83
3909,2,7520,2881,4639,0,0,0,1.0,1,1.0,1,1.0,1,0.07838675698939283,81
3910,5,7525,2883,4642,0,0,0,1.0,1,1.0,1,1.0,1,0.06118825713114228,82
3911,2,7527,2883,4644,0,0,0,1.0,1,1.0,1,1.0,1,0.03718807378786877,81
3912,1,7528,2883,4645,0,0,0,1.0,1,1.0,1,1.0,1,0.045316087664751196,80
3913,2,7530,2885,4645,0,0,0,1.0,1,1.0,1,1.0,1,0.06064082240519226,80
3914,3,7533,2887,4646,0,0,0,1.0,1,1.0,1,1.0,1,0.08431277477336478,81
3915,7,7540,2890,4650,0,0,0,1.0,1,1.0,1,1.0,1,0.07212037104687664,81
3916,4,7544,2892,4652,0,0,0,1.0,1,1.0,1,1.0,1,0.10065294340998247,81
3917,3,7547,2893,4654,0,0,0,1.0,1,1.0,1,1.0,1,0.08081171693578534,82
3918,5,7552,2895,4657,0,0,0,1.0,1,1.0,1,1.0,1,0.10171852008462216,85
3919,2,7554,2896,4658,0,0,0,1.0,1,1.0,1,1.0,1,0.09531244312491204,85
3920,2,7556,2897,4659,0,0,0,1.0,1,1.0,1,1.0,1,0.0871366688756242,85
3921,2,7558,2897,4661,0,0,0,1.0,1,1.0,1,1.0,1,0.08256953826580982,88
3922,1,7559,2898,4661,0,0,0,1.0,1,1.0,1,1.0,1,0.08262884848159913,88
3923,4,7563,2899,4664,0,0,0,1.0,1,1.0,1,1.0,1,0.0719933269668016,89
3924,0,7563,2899,4664,0,0,0,1.0,1,1.0,1,1.0,1,0.07874406738601605,90
3925,3,7566,2901,4665,0,0,0,1.0,1,1.0,1,1.0,1,0.08439586735092791,88
3926,4,7570,2902,4668,0,0,0,1.0,1,1.0,1,1.0,1,0.07758618251929948,89
3927,1,7571,2902,4669,0,0,0,1.0,1,1.0,1,1.0,1,0.07712430560680784,89
3928,0,7571,2902,4669,0,0,0,1.0,1,1.0,1,1.0,1,0.07427591348015539,88
3929,0,7571,2902,4669,0,0,0,1.0,1,1.0,1,1.0,1,0.07427591348015539,88
3930,0,7571,2902,4669,0,0,0,1.0,1,1.0,1,1.0,1,0.08260477269725111,87
3931,2,7573,2902,4671,0,0,0,1.0,1,1.0,1,1.0,1,0.07586623710418663,86
3932,1,7574,2903,4671,0,0,0,1.0,1,1.0,1,1.0,1,0.10122665893422321,85
3933,3,7577,2903,4674,0,0,0,1.0,1,1.0,1,1.0,1,0.07921198394313991,84
3934,0,7577,2903,4674,0,0,0,1.0,1,1.0,1,1.0,1,0.09108506166745571,85
3935,2,7579,2905,4674,0,0,0,1.0,1,1.0,1,1.0,1,0.10622378475729664,84
3936,1,7580,2905,4675,0,0,0,1.0,1,1.0,1,1.0,1,0.09745656030728056,84
3937,5,7585,2906,4679,0,0,0,1.0,1,1.0,1,1.0,1,0.08902912483616471,82
3938,1,7586,2906,4680,0,0,0,1.0,1,1.0,1,1.0,1,0.08607933084079983,82
3939,2,7588,2906,4682,0,0,0,1.0,1,1.0,1,1.0,1,0.06755891693486692,84
3940,3,7591,2907,4684,0,0,0,1.0,1,1.0,1,1.0,1,0.06874628628132017,84
3941,1,7592,2907,4685,0,0,0,1.0,1,1.0,1,1.0,1,0.04745359772783635,85
3942,3,7595,2909,4686,0,0,0,1.0,1,1.0,1,1.0,1,0.05821409109183542,85
3943,1,7596,2909,4687,0,0,0,1.0,1,1.0,1,1.0,1,0.04865490990626055,84
3944,2,7598,2911,4687,0,0,0,1.0,1,1.0,1,1.0,1,0.0895183311692513,83
3945,3,7601,2912,4689,0,0,0,1.0,1,1.0,1,1.0,1,0.07089320548096825,83
3946,2,7603,2914,4689,0,0,0,1.0,1,1.0,1,1.0,1,0.1127280162291616,83
3947,1,7604,2914,4690,0,0,0,1.0,1,1.0,1,1.0,1,0.10425412249255048,83
3948,1,7605,2915,4690,0,0,0,1.0,1,1.0,1,1.0,1,0.12114303951232125,84
3949,7,7612,2915,4697,0,0,0,1.0,1,1.0,1,1.0,1,0.09426987133079079,84
3950,4,7616,2916,4700,0,0,0,1.0,1,1.0,1,1.0,1,0.09988288296035354,86
3951,4,7620,2916,4704,0,0,0,1.0,1,1.0,1,1.0,1,0.07944307991408446,87
3952,0,7620,2916,4704,0,0,0,1.0,1,1.0,1,1.0,1,0.08018766580081774,86
3953,1,7621,2917,4704,0,0,0,1.0,1,1.0,1,1.0,1,0.07704759734288674,86
3954,1,7622,2917,4705,0,0,0,1.0,1,1.0,1,1.0,1,0.07476126134523155,85
3955,1,7623,2917,4706,0,0,0,1.0,1,1.0,1,1.0,1,0.09356152766099442,85
3956,1,7624,2917,4707,0,0,0,1.0,1,1.0,1,1.0,1,0.09917026845898187,84
3957,6,7630,2918,4712,0,0,0,1.0,1,1.0,1,1.0,1,0.0664165892260628,85
3958,1,7631,2918,4713,0,0,0,1.0,1,1.0,1,1.0,1,0.07094262544818737,84
3959,1,7632,2918,4714,0,0,0,1.0,1,1.0,1,1.0,1,0.07110160611623659,83
3960,2,7634,2919,4715,0,0,0,1.0,1,1.0,1,1.0,1,0.10357494490428489,84
3961,4,7638,2920,4718,0,0,0,1.0,1,1.0,1,1.0,1,0.0943472176097271,83
3962,2,7640,2921,4719,0,0,0,1.0,1,1.0,1,1.0,1,0.0994192111547461,84
3963,3,7643,2922,4721,0,0,0,1.0,1,1.0,1,1.0,1,0.07493003663097822,81
3964,3,7646,2925,4721,0,0,0,1.0,1,1.0,1,1.0,1,0.11573786085363656,81
3965,4,7650,2925,4725,0,0,0,1.0,1,1.0,1,1.0,1,0.08478609770483636,81
3966,2,7652,2927,4725,0,0,0,1.0,1,1.0,1,1.0,1,0.09499813229110715,79
3967,6,7658,2929,4729,0,0,0,1.0,1,1.0,1,1.0,1,0.08430007052628473,81
3968,0,7658,2929,4729,0,0,0,1.0,1,1.0,1,1.0,1,0.06855166853779836,79
3969,3,7661,2932,4729,0,0,0,1.0,1,1.0,1,1.0,1,0.11716919291408658,79
3970,2,7663,2934,4729,0,0,0,1.0,1,1.0,1,1.0,1,0.11460399961778732,78
3971,1,7664,2934,4730,0,0,0,1.0,1,1.0,1,1.0,1,0.10419922154446201,77
3972,1,7665,2935,4730,0,0,0,1.0,1,1.0,1,1.0,1,0.10474210194805196,78
3973,0,7665,2935,4730,0,0,0,1.0,1,1.0,1,1.0,1,0.10391547712468838,77
3974,0,7665,2935,4730,0,0,0,1.0,1,1.0,1,1.0,1,0.10391547712468838,77
3975,3,7668,2937,4731,0,0,0,1.0,1,1.0,1,1.0,1,0.1356594439346325,76
3976,3,7671,2937,4734,0,0,0,1.0,1,1.0,1,1.0,1,0.14503200157181864,77
3977,5,7676,2937,4739,0,0,0,1.0,1,1.0,1,1.0,1,0.11449956636639685,78
3978,3,7679,2938,4741,0,0,0,1.0,1,1.0,1,1.0,1,0.118051943811123,79
3979,3,7682,2938,4744,0,0,0,1.0,1,1.0,1,1.0,1,0.0941956218572181,79
3980,0,7682,2938,4744,0,0,0,1.0,1,1.0,1,1.0,1,0.0941956218572181,79
3981,3,7685,2940,4745,0,0,0,1.0,1,1.0,1,1.0,1,0.1375888841448295,83
3982,1,7686,2940,4746,0,0,0,1.0,1,1.0,1,1.0,1,0.12742553115261668,83
3983,5,7691,2940,4751,0,0,0,1.0,1,1.0,1,1.0,1,0.07606119749719269,82
3984,1,7692,2940,4752,0,0,0,1.0,1,1.0,1,1.0,1,0.08945816163872508,83
3985,3,7695,2941,4754,0,0,0,1.0,1,1.0,1,1.0,1,0.08079349813148132,84
3986,3,7698,2943,4755,0,0,0,1.0,1,1.0,1,1.0,1,0.10867243883312458,83
3987,7,7705,2943,4762,0,0,0,1.0,1,1.0,1,1.0,1,0.11257753203063472,82
3988,4,7709,2945,4764,0,0,0,1.0,1,1.0,1,1.0,1,0.11008125231644668,83
3989,2,7711,2945,4766,0,0,0,1.0,1,1.0,1,1.0,1,0.09995211902156648,81
3990,1,7712,2945,4767,0,0,0,1.0,1,1.0,1,1.0,1,0.08670056856405177,81
3991,1,7713,2946,4767,0,0,0,1.0,1,1.0,1,1.0,1,0.10517661294821479,79
3992,2,7715,2946,4769,0,0,0,1.0,1,1.0,1,1.0,1,0.09583052166993516,81
3993,3,7718,2947,4771,0,0,0,1.0,1,1.0,1,1.0,1,0.08249846869597459,80
3994,1,7719,2948,4771,0,0,0,1.0,1,1.0,1,1.0,1,0.08144941558290188,80
3995,2,7721,2950,4771,0,0,0,1.0,1,1.0,1,1.0,1,0.07114362388164903,81
3996,0,7721,2950,4771,0,0,0,1.0,1,1.0,1,1.0,1,0.09489358333966301,80
3997,2,7723,2951,4772,0,0,0,1.0,1,1.0,1,1.0,1,0.08548754264547564,81
3998,2,7725,2952,4773,0,0,0,1.0,1,1.0,1,1.0,1,0.07270191054020775,82
3999,1,7726,2952,4774,0,0,0,1.0,1,1.0,1,1.0,1,0.06908852103381043,82
4000,4,7730,2955,4775,0,0,0,1.0,1,1.0,1,1.0,1,0.08484071924690924,82
4001,1,7731,2956,4775,0,0,0,1.0,1,1.0,1,1.0,1,0.06892447023721437,81
4002,2,7733,2958,4775,0,0,0,1.0,1,1.0,1,1.0,1,0.09233421482929872,81
4003,6,7739,2961,4778,0,0,0,1.0,1,1.0,1,1.0,1,0.11272285057586984,81
4004,5,7744,2964,4780,0,0,0,1.0,1,1.0,1,1.0,1,0.11930495669172458,80
4005,5,7749,2966,4783,0,0,0,1.0,1,1.0,1,1.0,1,0.12994636413334887,78
4006,1,7750,2967,4783,0,0,0,1.0,1,1.0,1,1.0,1,0.11342720039344717,76
4007,2,7752,2968,4784,0,0,0,1.0,1,1.0,1,1.0,1,0.1318230033277702,75
4008,2,7754,2968,4786,0,0,0,1.0,1,1.0,1,1.0,1,0.09987830758532945,74
4009,4,7758,2969,4789,0,0,0,1.0,1,1.0,1,1.0,1,0.10866394742438668,75
4010,2,7760,2971,4789,0,0,0,1.0,1,1.0,1,1.0,1,0.11846987409512683,75
4011,5,7765,2972,4793,0,0,0,1.0,1,1.0,1,1.0,1,0.10925935567603996,74
4012,2,7767,2973,4794,0,0,0,1.0,1,1.0,1,1.0,1,0.11825129298689048,74
4013,4,7771,2974,4797,0,0,0,1.0,1,1.0,1,1.0,1,0.11795742947370493,74
4014,1,7772,2975,4797,0,0,0,1.0,1,1.0,1,1.0,1,0.14215203438966353,73
4015,2,7774,2975,4799,0,0,0,1.0,1,1.0,1,1.0,1,0.12334922741525595,74
4016,2,7776,2975,4801,0,0,0,1.0,1,1.0,1,1.0,1,0.13137647754381332,74
4017,4,7780,2977,4803,0,0,0,1.0,1,1.0,1,1.0,1,0.13575367230886623,78
4018,2,7782,2978,4804,0,0,0,1.0,1,1.0,1,1.0,1,0.15237481773740455,78
4019,4,7786,2978,4808,0,0,0,1.0,1,1.0,1,1.0,1,0.11492946109165529,78
4020,0,7786,2978,4808,0,0,0,1.0,1,1.0,1,1.0,1,0.11492946109165529,78
4021,1,7787,2978,4809,0,0,0,1.0,1,1.0,1,1.0,1,0.10725300084236672,78
4022,3,7790,2980,4810,0,0,0,1.0,1,1.0,1,1.0,1,0.11493742231681082,79
4023,3,7793,2981,4812,0,0,0,1.0,1,1.0,1,1.0,1,0.0985763942098311,78
4024,2,7795,2983,4812,0,0,0,1.0,1,1.0,1,1.0,1,0.1256910597276063,77
4025,3,7798,2984,4814,0,0,0,1.0,1,1.0,1,1.0,1,0.10374156207459252,76
4026,2,7800,2985,4815,0,0,0,1.0,1,1.0,1,1.0,1,0.10217974535407484,76
4027,4,7804,2988,4816,0,0,0,1.0,1,1.0,1,1.0,1,0.1251173678670246,75
4028,3,7807,2988,4819,0,0,0,1.0,1,1.0,1,1.0,1,0.10124777521657989,76
4029,2,7809,2988,4821,0,0,0,1.0,1,1.0,1,1.0,1,0.08004916407472072,75
4030,1,7810,2988,4822,0,0,0,1.0,1,1.0,1,1.0,1,0.0824272164656463,74
4031,3,7813,2989,4824,0,0,0,1.0,1,1.0,1,1.0,1,0.10320112813235095,73
4032,0,7813,2989,4824,0,0,0,1.0,1,1.0,1,1.0,1,0.10998821631630931,71
4033,3,7816,2989,4827,0,0,0,1.0,1,1.0,1,1.0,1,0.07953003324538754,73
4034,4,7820,2992,4828,0,0,0,1.0,1,1.0,1,1.0,1,0.08625931294594902,72
4035,2,7822,2993,4829,0,0,0,1.0,1,1.0,1,1.0,1,0.07880545147682107,71
4036,2,7824,2994,4830,0,0,0,1.0,1,1.0,1,1.0,1,0.059275060187467046,71
4037,2,7826,2996,4830,0,0,0,1.0,1,1.0,1,1.0,1,0.08918315879677646,70
4038,0,7826,2996,4830,0,0,0,1.0,1,1.0,1,1.0,1,0.10411946677785823,69
4039,2,7828,2997,4831,0,0,0,1.0,1,1.0,1,1.0,1,0.13479008149121288,68
4040,3,7831,2998,4833,0,0,0,1.0,1,1.0,1,1.0,1,0.15199168603078028,69
4041,4,7835,2999,4836,0,0,0,1.0,1,1.0,1,1.0,1,0.190789950219579,67
4042,2,7837,2999,4838,0,0,0,1.0,1,1.0,1,1.0,1,0.20864153453729536,67
4043,7,7844,3000,4844,0,0,0,1.0,1,1.0,1,1.0,1,0.16430079397848305,66
4044,1,7845,3000,4845,0,0,0,1.0,1,1.0,1,1.0,1,0.15644484635292016,65
4045,3,7848,3000,4848,0,0,0,1.0,1,1.0,1,1.0,1,0.15159935433711014,66
4046,0,7848,3000,4848,0,0,0,1.0,1,1.0,1,1.0,1,0.14993980392427803,68
4047,1,7849,3001,4848,0,0,0,1.0,1,1.0,1,1.0,1,0.1586339511352713,68
4048,1,7850,3001,4849,0,0,0,1.0,1,1.0,1,1.0,1,0.16121113751543673,69
4049,3,7853,3003,4850,0,0,0,1.0,1,1.0,1,1.0,1,0.18710867264686928,69
4050,0,7853,3003,4850,0,0,0,1.0,1,1.0,1,1.0,1,0.17153064960827635,69
4051,3,7856,3003,4853,0,0,0,1.0,1,1.0,1,1.0,1,0.15606624026620308,69
4052,1,7857,3003,4854,0,0,0,1.0,1,1.0,1,1.0,1,0.14622025032495675,69
4053,2,7859,3004,4855,0,0,0,1.0,1,1.0,1,1.0,1,0.1456827257796329,69
4054,1,7860,3005,4855,0,0,0,1.0,1,1.0,1,1.0,1,0.14402968485980364,70
4055,2,7862,3005,4857,0,0,0,1.0,1,1.0,1,1.0,1,0.12673174079051988,70
4056,0,7862,3005,4857,0,0,0,1.0,1,1.0,1,1.0,1,0.12673174079051988,70
4057,1,7863,3005,4858,0,0,0,1.0,1,1.0,1,1.0,1,0.11609333930586964,71
4058,0,7863,3005,4858,0,0,0,1.0,1,1.0,1,1.0,1,0.11609333930586964,71
4059,2,7865,3006,4859,0,0,0,1.0,1,1.0,1,1.0,1,0.12273288546141337,72
4060,1,7866,3006,4860,0,0,0,1.0,1,1.0,1,1.0,1,0.1278119765025815,71
4061,3,7869,3008,4861,0,0,0,1.0,1,1.0,1,1.0,1,0.12660673002108352,72
4062,1,7870,3008,4862,0,0,0,1.0,1,1.0,1,1.0,1,0.12227466356368522,72
4063,1,7871,3008,4863,0,0,0,1.0,1,1.0,1,1.0,1,0.12950899926986695,72
4064,2,7873,3009,4864,0,0,0,1.0,1,1.0,1,1.0,1,0.11812382863991584,71
4065,2,7875,3009,4866,0,0,0,1.0,1,1.0,1,1.0,1,0.08369402911624492,70
4066,2,7877,3011,4866,0,0,0,1.0,1,1.0,1,1.0,1,0.10930750806181434,70
4067,3,7880,3012,4868,0,0,0,1.0,1,1.0,1,1.0,1,0.09711570589342317,68
4068,2,7882,3013,4869,0,0,0,1.0,1,1.0,1,1.0,1,0.10880230217786811,70
4069,3,7885,3015,4870,0,0,0,1.0,1,1.0,1,1.0,1,0.10187728010024552,68
4070,6,7891,3018,4873,0,0,0,1.0,1,1.0,1,1.0,1,0.09891074612251634,67
4071,1,7892,3018,4874,0,0,0,1.0,1,1.0,1,1.0,1,0.11025831888429782,68
4072,4,7896,3019,4877,0,0,0,1.0,1,1.0,1,1.0,1,0.08951458260203891,70
4073,7,7903,3025,4878,0,0,0,1.0,1,1.0,1,1.0,1,0.12960870503389588,70
4074,8,7911,3031,4880,0,0,0,1.0,1,1.0,1,1.0,1,0.17639675271184668,71
4075,7,7918,3034,4884,0,0,0,1.0,1,1.0,1,1.0,1,0.14665334976792566,72
4076,4,7922,3035,4887,0,0,0,1.0,1,1.0,1,1.0,1,0.1407292789688115,73
4077,3,7925,3036,4889,0,0,0,1.0,1,1.0,1,1.0,1,0.1433082682216788,72
4078,5,7930,3038,4892,0,0,0,1.0,1,1.0,1,1.0,1,0.1596420754212649,71
4079,3,7933,3039,4894,0,0,0,1.0,1,1.0,1,1.0,1,0.15379626805594426,69
4080,2,7935,3040,4895,0,0,0,1.0,1,1.0,1,1.0,1,0.14190459844249328,67
4081,0,7935,3040,4895,0,0,0,1.0,1,1.0,1,1.0,1,0.1493158645003404,66
4082,0,7935,3040,4895,0,0,0,1.0,1,1.0,1,1.0,1,0.16469869099191226,65
4083,3,7938,3042,4896,0,0,0,1.0,1,1.0,1,1.0,1,0.17043748589114324,64
4084,1,7939,3043,4896,0,0,0,1.0,1,1.0,1,1.0,1,0.17581101990234563,64
4085,6,7945,3045,4900,0,0,0,1.0,1,1.0,1,1.0,1,0.13502138988407267,65
4086,1,7946,3046,4900,0,0,0,1.0,1,1.0,1,1.0,1,0.13856869372097408,66
4087,6,7952,3048,4904,0,0,0,1.0,1,1.0,1,1.0,1,0.10882886048904743,66
4088,1,7953,3048,4905,0,0,0,1.0,1,1.0,1,1.0,1,0.13842648317988215,65
4089,2,7955,3049,4906,0,0,0,1.0,1,1.0,1,1.0,1,0.13642839775361074,65
4090,1,7956,3049,4907,0,0,0,1.0,1,1.0,1,1.0,1,0.14857064980686085,65
4091,3,7959,3049,4910,0,0,0,1.0,1,1.0,1,1.0,1,0.1320472895927581,65
4092,1,7960,3049,4911,0,0,0,1.0,1,1.0,1,1.0,1,0.12250824522560091,64
4093,0,7960,3049,4911,0,0,0,1.0,1,1.0,1,1.0,1,0.11534143257105853,66
4094,0,7960,3049,4911,0,0,0,1.0,1,1.0,1,1.0,1,0.13532252192177344,65
4095,2,7962,3049,4913,0,0,0,1.0,1,1.0,1,1.0,1,0.11304557612411241,65
4096,1,7963,3050,4913,0,0,0,1.0,1,1.0,1,1.0,1,0.12795507257718888,67
4097,4,7967,3052,4915,0,0,0,1.0,1,1.0,1,1.0,1,0.11036616387998087,67
4098,2,7969,3053,4916,0,0,0,1.0,1,1.0,1,1.0,1,0.11233939611360172,68
4099,6,7975,3054,4921,0,0,0,1.0,1,1.0,1,1.0,1,0.08369708851012109,69
4100,2,7977,3054,4923,0,0,0,1.0,1,1.0,1,1.0,1,0.08424194286301352,70
4101,1,7978,3055,4923,0,0,0,1.0,1,1.0,1,1.0,1,0.09221707775906278,71
4102,1,7979,3056,4923,0,0,0,1.0,1,1.0,1,1.0,1,0.10722190110162828,71
4103,5,7984,3057,4927,0,0,0,1.0,1,1.0,1,1.0,1,0.1038448005655622,71
4104,3,7987,3060,4927,0,0,0,1.0,1,1.0,1,1.0,1,0.14297340586829302,69
4105,1,7988,3060,4928,0,0,0,1.0,1,1.0,1,1.0,1,0.11302517615308794,67
4106,4,7992,3061,4931,0,0,0,1.0,1,1.0,1,1.0,1,0.11712613166675098,68
4107,3,7995,3061,4934,0,0,0,1.0,1,1.0,1,1.0,1,0.08876511391331067,70
4108,0,7995,3061,4934,0,0,0,1.0,1,1.0,1,1.0,1,0.08814393156662616,70
4109,1,7996,3061,4935,0,0,0,1.0,1,1.0,1,1.0,1,0.08632224950035398,69
4110,2,7998,3062,4936,0,0,0,1.0,1,1.0,1,1.0,1,0.07255781053185249,71
4111,0,7998,3062,4936,0,0,0,1.0,1,1.0,1,1.0,1,0.0735977975690914,70
4112,1,7999,3062,4937,0,0,0,1.0,1,1.0,1,1.0,1,0.06686106238317366,72
4113,1,8000,3063,4937,0,0,0,1.0,1,1.0,1,1.0,1,0.06238653764774198,72
4114,4,8004,3066,4938,0,0,0,1.0,1,1.0,1,1.0,1,0.10441546932070163,72
4115,3,8007,3067,4940,0,0,0,1.0,1,1.0,1,1.0,1,0.08820749354856149,70
4116,1,8008,3068,4940,0,0,0,1.0,1,1.0,1,1.0,1,0.10028254068081194,67
4117,6,8014,3071,4943,0,0,0,1.0,1,1.0,1,1.0,1,0.11165191949525644,67
4118,1,8015,3071,4944,0,0,0,1.0,1,1.0,1,1.0,1,0.12850605155364347,66
4119,3,8018,3072,4946,0,0,0,1.0,1,1.0,1,1.0,1,0.12693690333287866,67
4120,2,8020,3073,4947,0,0,0,1.0,1,1.0,1,1.0,1,0.16199344132405422,64
4121,3,8023,3074,4949,0,0,0,1.0,1,1.0,1,1.0,1,0.15140967630325367,63
4122,3,8026,3075,4951,0,0,0,1.0,1,1.0,1,1.0,1,0.1444971490174654,63
4123,2,8028,3075,4953,0,0,0,1.0,1,1.0,1,1.0,1,0.14983635193396147,61
4124,3,8031,3076,4955,0,0,0,1.0,1,1.0,1,1.0,1,0.13225804153423545,62
4125,3,8034,3076,4958,0,0,0,1.0,1,1.0,1,1.0,1,0.13410618637388788,60
4126,1,8035,3077,4958,0,0,0,1.0,1,1.0,1,1.0,1,0.13456926690212676,59
4127,2,8037,3078,4959,0,0,0,1.0,1,1.0,1,1.0,1,0.15498711661121606,60
4128,1,8038,3079,4959,0,0,0,1.0,1,1.0,1,1.0,1,0.17832819712285924,60
4129,3,8041,3079,4962,0,0,0,1.0,1,1.0,1,1.0,1,0.16112821807724687,60
4130,1,8042,3080,4962,0,0,0,1.0,1,1.0,1,1.0,1,0.15256143376028714,61
4131,2,8044,3080,4964,0,0,0,1.0,1,1.0,1,1.0,1,0.1464456688652739,60
4132,2,8046,3081,4965,0,0,0,1.0,1,1.0,1,1.0,1,0.1466436572010259,60
4133,2,8048,3081,4967,0,0,0,1.0,1,1.0,1,1.0,1,0.1516433507917004,62
4134,2,8050,3083,4967,0,0,0,1.0,1,1.0,1,1.0,1,0.1852082160563996,63
4135,5,8055,3084,4971,0,0,0,1.0,1,1.0,1,1.0,1,0.12955287827909323,65
4136,1,8056,3084,4972,0,0,0,1.0,1,1.0,1,1.0,1,0.12148488328380332,65
4137,2,8058,3085,4973,0,0,0,1.0,1,1.0,1,1.0,1,0.11958650336861866,66
4138,1,8059,3086,4973,0,0,0,1.0,1,1.0,1,1.0,1,0.1278355544755615,67
4139,0,8059,3086,4973,0,0,0,1.0,1,1.0,1,1.0,1,0.1278355544755615,67
4140,1,8060,3086,4974,0,0,0,1.0,1,1.0,1,1.0,1,0.10269328656538018,66
4141,1,8061,3086,4975,0,0,0,1.0,1,1.0,1,1.0,1,0.09207171624868872,67
4142,1,8062,3086,4976,0,0,0,1.0,1,1.0,1,1.0,1,0.08517714202632284,67
4143,0,8062,3086,4976,0,0,0,1.0,1,1.0,1,1.0,1,0.08163008946204559,66
4144,1,8063,3086,4977,0,0,0,1.0,1,1.0,1,1.0,1,0.0757203049431317,64
4145,1,8064,3087,4977,0,0,0,1.0,1,1.0,1,1.0,1,0.08035518190432762,63
4146,3,8067,3090,4977,0,0,0,1.0,1,1.0,1,1.0,1,0.1278899296924287,62
4147,5,8072,3091,4981,0,0,0,1.0,1,1.0,1,1.0,1,0.11236733756181833,60
4148,4,8076,3094,4982,0,0,0,1.0,1,1.0,1,1.0,1,0.10261190762809208,62
4149,3,8079,3094,4985,0,0,0,1.0,1,1.0,1,1.0,1,0.0852178106100688,61
4150,1,8080,3095,4985,0,0,0,1.0,1,1.0,1,1.0,1,0.08076031610388625,60
4151,3,8083,3096,4987,0,0,0,1.0,1,1.0,1,1.0,1,0.09713985488525287,60
4152,1,8084,3097,4987,0,0,0,1.0,1,1.0,1,1.0,1,0.12904238634064985,60
4153,1,8085,3098,4987,0,0,0,1.0,1,1.0,1,1.0,1,0.1302792361265533,58
4154,3,8088,3099,4989,0,0,0,1.0,1,1.0,1,1.0,1,0.13762780322002555,57
4155,6,8094,3101,4993,0,0,0,1.0,1,1.0,1,1.0,1,0.12461724694620628,57
4156,2,8096,3102,4994,0,0,0,1.0,1,1.0,1,1.0,1,0.15692566290046883,58
4157,4,8100,3103,4997,0,0,0,1.0,1,1.0,1,1.0,1,0.1290548393674687,57
4158,2,8102,3104,4998,0,0,0,1.0,1,1.0,1,1.0,1,0.15763352299058608,55
4159,2,8104,3105,4999,0,0,0,1.0,1,1.0,1,1.0,1,0.15659244829341168,57
4160,1,8105,3105,5000,0,0,0,1.0,1,1.0,1,1.0,1,0.15546250734476724,58
4161,3,8108,3105,5003,0,0,0,1.0,1,1.0,1,1.0,1,0.09821851260924908,58
4162,0,8108,3105,5003,0,0,0,1.0,1,1.0,1,1.0,1,0.10207778993622914,57
4163,1,8109,3105,5004,0,0,0,1.0,1,1.0,1,1.0,1,0.09580453476444452,58
4164,4,8113,3108,5005,0,0,0,1.0,1,1.0,1,1.0,1,0.11572522705478742,56
4165,5,8118,3109,5009,0,0,0,1.0,1,1.0,1,1.0,1,0.11068694027293424,58
4166,0,8118,3109,5009,0,0,0,1.0,1,1.0,1,1.0,1,0.10486251882281003,57
4167,1,8119,3109,5010,0,0,0,1.0,1,1.0,1,1.0,1,0.09986546065421988,57
4168,0,8119,3109,5010,0,0,0,1.0,1,1.0,1,1.0,1,0.1046920077616518,58
4169,0,8119,3109,5010,0,0,0,1.0,1,1.0,1,1.0,1,0.1046920077616518,58
4170,0,8119,3109,5010,0,0,0,1.0,1,1.0,1,1.0,1,0.13313237247970522,58
4171,0,8119,3109,5010,0,0,0,1.0,1,1.0,1,1.0,1,0.15015849394602554,57
4172,1,8120,3109,5011,0,0,0,1.0,1,1.0,1,1.0,1,0.1376233839584288,57
4173,2,8122,3111,5011,0,0,0,1.0,1,1.0,1,1.0,1,0.18802806582453804,56
4174,3,8125,3112,5013,0,0,0,1.0,1,1.0,1,1.0,1,0.19487178432060998,56
4175,4,8129,3112,5017,0,0,0,1.0,1,1.0,1,1.0,1,0.1698240894980448,55
4176,2,8131,3112,5019,0,0,0,1.0,1,1.0,1,1.0,1,0.1660629663808604,57
4177,6,8137,3113,5024,0,0,0,1.0,1,1.0,1,1.0,1,0.1345496706957797,58
4178,6,8143,3115,5028,0,0,0,1.0,1,1.0,1,1.0,1,0.12674456514546237,60
4179,4,8147,3115,5032,0,0,0,1.0,1,1.0,1,1.0,1,0.08455317752374461,61
4180,0,8147,3115,5032,0,0,0,1.0,1,1.0,1,1.0,1,0.10129474058429953,62
4181,1,8148,3115,5033,0,0,0,1.0,1,1.0,1,1.0,1,0.09656996128120286,63
4182,2,8150,3116,5034,0,0,0,1.0,1,1.0,1,1.0,1,0.11493692980455782,63
4183,3,8153,3116,5037,0,0,0,1.0,1,1.0,1,1.0,1,0.07973394428579904,63
4184,2,8155,3117,5038,0,0,0,1.0,1,1.0,1,1.0,1,0.10970987092571868,63
4185,4,8159,3117,5042,0,0,0,1.0,1,1.0,1,1.0,1,0.11050086840647709,61
4186,3,8162,3119,5043,0,0,0,1.0,1,1.0,1,1.0,1,0.1293344766974826,62
4187,4,8166,3119,5047,0,0,0,1.0,1,1.0,1,1.0,1,0.0680409281082391,60
4188,0,8166,3119,5047,0,0,0,1.0,1,1.0,1,1.0,1,0.059939322835123245,60
4189,1,8167,3120,5047,0,0,0,1.0,1,1.0,1,1.0,1,0.06507228510667899,60
4190,2,8169,3122,5047,0,0,0,1.0,1,1.0,1,1.0,1,0.1027126916807669,61
4191,3,8172,3123,5049,0,0,0,1.0,1,1.0,1,1.0,1,0.09821211264760958,59
4192,1,8173,3124,5049,0,0,0,1.0,1,1.0,1,1.0,1,0.10811725083709725,58
4193,2,8175,3125,5050,0,0,0,1.0,1,1.0,1,1.0,1,0.10823923815622677,57
4194,1,8176,3126,5050,0,0,0,1.0,1,1.0,1,1.0,1,0.11922630706064398,54
4195,2,8178,3127,5051,0,0,0,1.0,1,1.0,1,1.0,1,0.12235509677314678,55
4196,2,8180,3127,5053,0,0,0,1.0,1,1.0,1,1.0,1,0.12339225151039769,56
4197,4,8184,3128,5056,0,0,0,1.0,1,1.0,1,1.0,1,0.10498075760679272,55
4198,1,8185,3128,5057,0,0,0,1.0,1,1.0,1,1.0,1,0.1309200340099285,56
4199,3,8188,3130,5058,0,0,0,1.0,1,1.0,1,1.0,1,0.15699978866936154,55
4200,0,8188,3130,5058,0,0,0,1.0,1,1.0,1,1.0,1,0.15692865305044124,55
4201,1,8189,3130,5059,0,0,0,1.0,1,1.0,1,1.0,1,0.12885982143003294,56
4202,1,8190,3130,5060,0,0,0,1.0,1,1.0,1,1.0,1,0.13833764341631646,56
4203,3,8193,3130,5063,0,0,0,1.0,1,1.0,1,1.0,1,0.12022062179400367,57
4204,0,8193,3130,5063,0,0,0,1.0,1,1.0,1,1.0,1,0.12022062179400367,57
4205,1,8194,3130,5064,0,0,0,1.0,1,1.0,1,1.0,1,0.10667235013870502,58
4206,2,8196,3131,5065,0,0,0,1.0,1,1.0,1,1.0,1,0.097576977820394,58
4207,1,8197,3132,5065,0,0,0,1.0,1,1.0,1,1.0,1,0.08653031350194877,58
4208,2,8199,3133,5066,0,0,0,1.0,1,1.0,1,1.0,1,0.09627077267015756,60
4209,4,8203,3136,5067,0,0,0,1.0,1,1.0,1,1.0,1,0.10275527384323901,61
4210,0,8203,3136,5067,0,0,0,1.0,1,1.0,1,1.0,1,0.08410045037100394,62
4211,2,8205,3137,5068,0,0,0,1.0,1,1.0,1,1.0,1,0.10572679236214953,63
4212,0,8205,3137,5068,0,0,0,1.0,1,1.0,1,1.0,1,0.09723274439208984,64
4213,1,8206,3137,5069,0,0,0,1.0,1,1.0,1,1.0,1,0.08198875280957826,65
4214,0,8206,3137,5069,0,0,0,1.0,1,1.0,1,1.0,1,0.10461013643711911,65
4215,1,8207,3137,5070,0,0,0,1.0,1,1.0,1,1.0,1,0.08158250602569199,65
4216,0,8207,3137,5070,0,0,0,1.0,1,1.0,1,1.0,1,0.09345514458655506,64
4217,1,8208,3138,5070,0,0,0,1.0,1,1.0,1,1.0,1,0.12946699162950728,65
4218,1,8209,3138,5071,0,0,0,1.0,1,1.0,1,1.0,1,0.10849796652527303,65
4219,3,8212,3140,5072,0,0,0,1.0,1,1.0,1,1.0,1,0.14748780254614424,65
4220,2,8214,3141,5073,0,0,0,1.0,1,1.0,1,1.0,1,0.16116837541138446,65
4221,5,8219,3141,5078,0,0,0,1.0,1,1.0,1,1.0,1,0.13528451108449818,67
4222,3,8222,3142,5080,0,0,0,1.0,1,1.0,1,1.0,1,0.11479019610861686,68
4223,5,8227,3144,5083,0,0,0,1.0,1,1.0,1,1.0,1,0.09892156301373245,68
4224,1,8228,3144,5084,0,0,0,1.0,1,1.0,1,1.0,1,0.10304755726184367,68
4225,2,8230,3144,5086,0,0,0,1.0,1,1.0,1,1.0,1,0.08728510479479201,66
4226,0,8230,3144,5086,0,0,0,1.0,1,1.0,1,1.0,1,0.08690871319798098,66
4227,1,8231,3145,5086,0,0,0,1.0,1,1.0,1,1.0,1,0.11177700696285489,66
4228,0,8231,3145,5086,0,0,0,1.0,1,1.0,1,1.0,1,0.11818384320056197,65
4229,0,8231,3145,5086,0,0,0,1.0,1,1.0,1,1.0,1,0.1111765358236153,65
4230,2,8233,3146,5087,0,0,0,1.0,1,1.0,1,1.0,1,0.0968653406840192,64
4231,3,8236,3147,5089,0,0,0,1.0,1,1.0,1,1.0,1,0.10630511828768086,64
4232,1,8237,3147,5090,0,0,0,1.0,1,1.0,1,1.0,1,0.08343871002642286,65
4233,0,8237,3147,5090,0,0,0,1.0,1,1.0,1,1.0,1,0.0859421339207989,64
4234,0,8237,3147,5090,0,0,0,1.0,1,1.0,1,1.0,1,0.09250127356682337,63
4235,3,8240,3148,5092,0,0,0,1.0,1,1.0,1,1.0,1,0.07925381984211963,63
4236,0,8240,3148,5092,0,0,0,1.0,1,1.0,1,1.0,1,0.07925381984211963,63
4237,2,8242,3150,5092,0,0,0,1.0,1,1.0,1,1.0,1,0.12743583385911197,65
4238,1,8243,3150,5093,0,0,0,1.0,1,1.0,1,1.0,1,0.11002557187103068,65
4239,2,8245,3150,5095,0,0,0,1.0,1,1.0,1,1.0,1,0.09590639242487392,65
4240,3,8248,3151,5097,0,0,0,1.0,1,1.0,1,1.0,1,0.08537586635078663,66
4241,2,8250,3151,5099,0,0,0,1.0,1,1.0,1,1.0,1,0.060559523734404416,66
4242,2,8252,3152,5100,0,0,0,1.0,1,1.0,1,1.0,1,0.06469707508405101,69
4243,1,8253,3152,5101,0,0,0,1.0,1,1.0,1,1.0,1,0.06970577330088357,71
4244,0,8253,3152,5101,0,0,0,1.0,1,1.0,1,1.0,1,0.06970577330088357,71
4245,2,8255,3152,5103,0,0,0,1.0,1,1.0,1,1.0,1,0.060821930951781615,73
4246,0,8255,3152,5103,0,0,0,1.0,1,1.0,1,1.0,1,0.06093172377017061,74
4247,0,8255,3152,5103,0,0,0,1.0,1,1.0,1,1.0,1,0.06093172377017061,74
4248,1,8256,3153,5103,0,0,0,1.0,1,1.0,1,1.0,1,0.06637508551898184,74
4249,1,8257,3153,5104,0,0,0,1.0,1,1.0,1,1.0,1,0.057688235608060995,74
4250,0,8257,3153,5104,0,0,0,1.0,1,1.0,1,1.0,1,0.057688235608060995,74
4251,0,8257,3153,5104,0,0,0,1.0,1,1.0,1,1.0,1,0.06478552014419188,75
4252,6,8263,3157,5106,0,0,0,1.0,1,1.0,1,1.0,1,0.1179222185964032,75
4253,3,8266,3157,5109,0,0,0,1.0,1,1.0,1,1.0,1,0.10739063900084529,76
4254,3,8269,3159,5110,0,0,0,1.0,1,1.0,1,1.0,1,0.10073240535919954,75
4255,5,8274,3161,5113,0,0,0,1.0,1,1.0,1,1.0,1,0.09388039042424219,76
4256,1,8275,3162,5113,0,0,0,1.0,1,1.0,1,1.0,1,0.09846236056344712,78
4257,3,8278,3163,5115,0,0,0,1.0,1,1.0,1,1.0,1,0.08634909150898251,78
4258,2,8280,3164,5116,0,0,0,1.0,1,1.0,1,1.0,1,0.10474288576153494,77
4259,4,8284,3165,5119,0,0,0,1.0,1,1.0,1,1.0,1,0.07654107277534167,78
4260,1,8285,3165,5120,0,0,0,1.0,1,1.0,1,1.0,1,0.08186325360027266,77
4261,0,8285,3165,5120,0,0,0,1.0,1,1.0,1,1.0,1,0.0906494528648899,76
4262,1,8286,3165,5121,0,0,0,1.0,1,1.0,1,1.0,1,0.1101521228807723,75
4263,7,8293,3168,5125,0,0,0,1.0,1,1.0,1,1.0,1,0.07274447603250686,74
4264,0,8293,3168,5125,0,0,0,1.0,1,1.0,1,1.0,1,0.10565727895515067,74
4265,5,8298,3169,5129,0,0,0,1.0,1,1.0,1,1.0,1,0.09113515691270543,73
4266,1,8299,3170,5129,0,0,0,1.0,1,1.0,1,1.0,1,0.10359835844388221,71
4267,3,8302,3172,5130,0,0,0,1.0,1,1.0,1,1.0,1,0.1002211251046584,69
4268,5,8307,3174,5133,0,0,0,1.0,1,1.0,1,1.0,1,0.10542946753603478,67
4269,4,8311,3177,5134,0,0,0,1.0,1,1.0,1,1.0,1,0.13308915611801667,64
4270,1,8312,3178,5134,0,0,0,1.0,1,1.0,1,1.0,1,0.11749890066856329,63
4271,1,8313,3179,5134,0,0,0,1.0,1,1.0,1,1.0,1,0.14466753220836434,63
4272,3,8316,3181,5135,0,0,0,1.0,1,1.0,1,1.0,1,0.20135286246495143,62
4273,9,8325,3181,5144,0,0,0,1.0,1,1.0,1,1.0,1,0.1474163275209446,62
4274,2,8327,3181,5146,0,0,0,1.0,1,1.0,1,1.0,1,0.13392809578131765,62
4275,1,8328,3181,5147,0,0,0,1.0,1,1.0,1,1.0,1,0.12509820785351905,61
4276,1,8329,3181,5148,0,0,0,1.0,1,1.0,1,1.0,1,0.11588889595009472,62
4277,2,8331,3181,5150,0,0,0,1.0,1,1.0,1,1.0,1,0.10500769731936369,63
4278,0,8331,3181,5150,0,0,0,1.0,1,1.0,1,1.0,1,0.10203147419730137,64
4279,2,8333,3181,5152,0,0,0,1.0,1,1.0,1,1.0,1,0.10252636296455389,65
4280,2,8335,3181,5154,0,0,0,1.0,1,1.0,1,1.0,1,0.08393483726470946,65
4281,1,8336,3182,5154,0,0,0,1.0,1,1.0,1,1.0,1,0.10206529781771816,65
4282,6,8342,3185,5157,0,0,0,1.0,1,1.0,1,1.0,1,0.13092031646817923,66
4283,5,8347,3187,5160,0,0,0,1.0,1,1.0,1,1.0,1,0.15129759290178635,66
4284,2,8349,3189,5160,0,0,0,1.0,1,1.0,1,1.0,1,0.1984429940381715,66
4285,6,8355,3189,5166,0,0,0,1.0,1,1.0,1,1.0,1,0.15651586487555394,67
4286,0,8355,3189,5166,0,0,0,1.0,1,1.0,1,1.0,1,0.1654556728542133,67
4287,3,8358,3189,5169,0,0,0,1.0,1,1.0,1,1.0,1,0.1406636226798209,67
4288,0,8358,3189,5169,0,0,0,1.0,1,1.0,1,1.0,1,0.13224216695127552,68
4289,0,8358,3189,5169,0,0,0,1.0,1,1.0,1,1.0,1,0.13779098405024615,68
4290,1,8359,3189,5170,0,0,0,1.0,1,1.0,1,1.0,1,0.1359846072344451,70
4291,0,8359,3189,5170,0,0,0,1.0,1,1.0,1,1.0,1,0.1323320830454153,71
4292,0,8359,3189,5170,0,0,0,1.0,1,1.0,1,1.0,1,0.1323320830454153,71
4293,1,8360,3189,5171,0,0,0,1.0,1,1.0,1,1.0,1,0.12360739961975017,71
4294,1,8361,3190,5171,0,0,0,1.0,1,1.0,1,1.0,1,0.13439748020978023,71
4295,4,8365,3191,5174,0,0,0,1.0,1,1.0,1,1.0,1,0.14368694069268279,72
4296,1,8366,3192,5174,0,0,0,1.0,1,1.0,1,1.0,1,0.15232731853874298,73
4297,2,8368,3192,5176,0,0,0,1.0,1,1.0,1,1.0,1,0.12788252328325564,73
4298,3,8371,3194,5177,0,0,0,1.0,1,1.0,1,1.0,1,0.1637895797714362,74
4299,3,8374,3194,5180,0,0,0,1.0,1,1.0,1,1.0,1,0.11773082994370747,75
4300,1,8375,3194,5181,0,0,0,1.0,1,1.0,1,1.0,1,0.1035676409311274,75
4301,2,8377,3194,5183,0,0,0,1.0,1,1.0,1,1.0,1,0.0905244928129144,76
4302,1,8378,3194,5184,0,0,0,1.0,1,1.0,1,1.0,1,0.08857482436177083,76
4303,0,8378,3194,5184,0,0,0,1.0,1,1.0,1,1.0,1,0.08853589143213417,75
4304,1,8379,3195,5184,0,0,0,1.0,1,1.0,1,1.0,1,0.10564672024490956,75
4305,3,8382,3196,5186,0,0,0,1.0,1,1.0,1,1.0,1,0.11068106065862461,73
4306,6,8388,3198,5190,0,0,0,1.0,1,1.0,1,1.0,1,0.09664428330817922,74
4307,4,8392,3200,5192,0,0,0,1.0,1,1.0,1,1.0,1,0.0920831032076182,73
4308,3,8395,3201,5194,0,0,0,1.0,1,1.0,1,1.0,1,0.09664119329343616,71
4309,0,8395,3201,5194,0,0,0,1.0,1,1.0,1,1.0,1,0.11146889832049821,70
4310,3,8398,3204,5194,0,0,0,1.0,1,1.0,1,1.0,1,0.12423254521598047,69
4311,3,8401,3205,5196,0,0,0,1.0,1,1.0,1,1.0,1,0.11199402746407952,69
4312,3,8404,3207,5197,0,0,0,1.0,1,1.0,1,1.0,1,0.15407252428362928,66
4313,2,8406,3207,5199,0,0,0,1.0,1,1.0,1,1.0,1,0.13164134202052882,64
4314,0,8406,3207,5199,0,0,0,1.0,1,1.0,1,1.0,1,0.16104721740823016,61
4315,5,8411,3208,5203,0,0,0,1.0,1,1.0,1,1.0,1,0.12694726907676476,61
4316,0,8411,3208,5203,0,0,0,1.0,1,1.0,1,1.0,1,0.14018189418917876,60
4317,1,8412,3209,5203,0,0,0,1.0,1,1.0,1,1.0,1,0.12296308575431421,62
4318,1,8413,3210,5203,0,0,0,1.0,1,1.0,1,1.0,1,0.14230292948661416,59
4319,2,8415,3211,5204,0,0,0,1.0,1,1.0,1,1.0,1,0.15809789287273424,60
4320,1,8416,3211,5205,0,0,0,1.0,1,1.0,1,1.0,1,0.14998193085475836,60
4321,5,8421,3214,5207,0,0,0,1.0,1,1.0,1,1.0,1,0.1873777868244722,61
4322,1,8422,3215,5207,0,0,0,1.0,1,1.0,1,1.0,1,0.1952652092127853,61
4323,4,8426,3217,5209,0,0,0,1.0,1,1.0,1,1.0,1,0.2096961085752263,61
4324,1,8427,3218,5209,0,0,0,1.0,1,1.0,1,1.0,1,0.23161624370574327,60
4325,8,8435,3219,5216,0,0,0,1.0,1,1.0,1,1.0,1,0.17789346191422037,60
4326,1,8436,3219,5217,0,0,0,1.0,1,1.0,1,1.0,1,0.17863300625097342,61
4327,5,8441,3220,5221,0,0,0,1.0,1,1.0,1,1.0,1,0.12719942396738063,62
4328,1,8442,3220,5222,0,0,0,1.0,1,1.0,1,1.0,1,0.12204175812425962,62
4329,2,8444,3220,5224,0,0,0,1.0,1,1.0,1,1.0,1,0.10441754947292471,65
4330,1,8445,3220,5225,0,0,0,1.0,1,1.0,1,1.0,1,0.09467673728752606,65
4331,0,8445,3220,5225,0,0,0,1.0,1,1.0,1,1.0,1,0.09467673728752606,65
4332,1,8446,3221,5225,0,0,0,1.0,1,1.0,1,1.0,1,0.11854104097876855,66
4333,3,8449,3222,5227,0,0,0,1.0,1,1.0,1,1.0,1,0.1132052669460792,66
4334,1,8450,3223,5227,0,0,0,1.0,1,1.0,1,1.0,1,0.10661553116901905,66
4335,3,8453,3223,5230,0,0,0,1.0,1,1.0,1,1.0,1,0.0939046052903258,65
4336,4,8457,3226,5231,0,0,0,1.0,1,1.0,1,1.0,1,0.12865812817918734,67
4337,2,8459,3227,5232,0,0,0,1.0,1,1.0,1,1.0,1,0.1564770679630938,69
4338,1,8460,3227,5233,0,0,0,1.0,1,1.0,1,1.0,1,0.1650226367727593,70
4339,2,8462,3227,5235,0,0,0,1.0,1,1.0,1,1.0,1,0.15846848615827855,70
4340,2,8464,3227,5237,0,0,0,1.0,1,1.0,1,1.0,1,0.1497560515639771,71
4341,4,8468,3228,5240,0,0,0,1.0,1,1.0,1,1.0,1,0.1469351520860885,70
4342,0,8468,3228,5240,0,0,0,1.0,1,1.0,1,1.0,1,0.15624636793562766,71
4343,5,8473,3230,5243,0,0,0,1.0,1,1.0,1,1.0,1,0.1620774525439272,67
4344,4,8477,3232,5245,0,0,0,1.0,1,1.0,1,1.0,1,0.1599664786501395,67
4345,5,8482,3233,5249,0,0,0,1.0,1,1.0,1,1.0,1,0.15453683148323333,64
4346,4,8486,3236,5250,0,0,0,1.0,1,1.0,1,1.0,1,0.1770245615566128,64
4347,5,8491,3238,5253,0,0,0,1.0,1,1.0,1,1.0,1,0.21614784025116895,62
4348,5,8496,3239,5257,0,0,0,1.0,1,1.0,1,1.0,1,0.18134136968688738,62
4349,2,8498,3239,5259,0,0,0,1.0,1,1.0,1,1.0,1,0.15877758863861358,61
4350,2,8500,3240,5260,0,0,0,1.0,1,1.0,1,1.0,1,0.16799820195067947,60
4351,0,8500,3240,5260,0,0,0,1.0,1,1.0,1,1.0,1,0.17142659185604517,60
4352,0,8500,3240,5260,0,0,0,1.0,1,1.0,1,1.0,1,0.19953964397247284,57
4353,5,8505,3241,5264,0,0,0,1.0,1,1.0,1,1.0,1,0.19972336589876638,55
4354,4,8509,3242,5267,0,0,0,1.0,1,1.0,1,1.0,1,0.15542581952561998,55
4355,3,8512,3242,5270,0,0,0,1.0,1,1.0,1,1.0,1,0.14871097445368206,53
4356,1,8513,3243,5270,0,0,0,1.0,1,1.0,1,1.0,1,0.1154157858822651,55
4357,1,8514,3244,5270,0,0,0,1.0,1,1.0,1,1.0,1,0.12287489358871977,55
4358,1,8515,3245,5270,0,0,0,1.0,1,1.0,1,1.0,1,0.14132271193359097,55
4359,1,8516,3245,5271,0,0,0,1.0,1,1.0,1,1.0,1,0.13898610103847045,54
4360,1,8517,3245,5272,0,0,0,1.0,1,1.0,1,1.0,1,0.1251169420151226,55
4361,2,8519,3246,5273,0,0,0,1.0,1,1.0,1,1.0,1,0.09150523295833277,54
4362,0,8519,3246,5273,0,0,0,1.0,1,1.0,1,1.0,1,0.0849470694423181,55
4363,3,8522,3247,5275,0,0,0,1.0,1,1.0,1,1.0,1,0.10744124361667154,55
4364,1,8523,3248,5275,0,0,0,1.0,1,1.0,1,1.0,1,0.13246110175992418,55
4365,2,8525,3249,5276,0,0,0,1.0,1,1.0,1,1.0,1,0.14329059006145237,54
4366,2,8527,3251,5276,0,0,0,1.0,1,1.0,1,1.0,1,0.1451894370446188,54
4367,2,8529,3252,5277,0,0,0,1.0,1,1.0,1,1.0,1,0.13629434250367953,57
4368,0,8529,3252,5277,0,0,0,1.0,1,1.0,1,1.0,1,0.1741007855815919,57
4369,1,8530,3252,5278,0,0,0,1.0,1,1.0,1,1.0,1,0.15943535399181605,58
4370,3,8533,3253,5280,0,0,0,1.0,1,1.0,1,1.0,1,0.16166841728768297,59
4371,5,8538,3253,5285,0,0,0,1.0,1,1.0,1,1.0,1,0.09719872671813427,60
4372,0,8538,3253,5285,0,0,0,1.0,1,1.0,1,1.0,1,0.09719872671813427,60
4373,1,8539,3253,5286,0,0,0,1.0,1,1.0,1,1.0,1,0.09324111476557065,60
4374,1,8540,3254,5286,0,0,0,1.0,1,1.0,1,1.0,1,0.1269213198791069,59
4375,1,8541,3254,5287,0,0,0,1.0,1,1.0,1,1.0,1,0.12660892302300703,60
4376,0,8541,3254,5287,0,0,0,1.0,1,1.0,1,1.0,1,0.14360164486652047,60
4377,3,8544,3256,5288,0,0,0,1.0,1,1.0,1,1.0,1,0.18564248987361012,61
4378,3,8547,3257,5290,0,0,0,1.0,1,1.0,1,1.0,1,0.17904783712377614,64
4379,2,8549,3259,5290,0,0,0,1.0,1,1.0,1,1.0,1,0.2133541630693718,64
4380,3,8552,3260,5292,0,0,0,1.0,1,1.0,1,1.0,1,0.22397329937111565,65
4381,3,8555,3260,5295,0,0,0,1.0,1,1.0,1,1.0,1,0.20299391641206171,64
4382,6,8561,3262,5299,0,0,0,1.0,1,1.0,1,1.0,1,0.20043108154319025,64
4383,6,8567,3265,5302,0,0,0,1.0,1,1.0,1,1.0,1,0.2170342795749922,64
4384,3,8570,3268,5302,0,0,0,1.0,1,1.0,1,1.0,1,0.282498665751503,60
4385,7,8577,3268,5309,0,0,0,1.0,1,1.0,1,1.0,1,0.2218547072003023,58
4386,2,8579,3269,5310,0,0,0,1.0,1,1.0,1,1.0,1,0.23767233519681472,58
4387,7,8586,3269,5317,0,0,0,1.0,1,1.0,1,1.0,1,0.16764983785693988,55
4388,2,8588,3270,5318,0,0,0,1.0,1,1.0,1,1.0,1,0.16942984442049122,56
4389,2,8590,3270,5320,0,0,0,1.0,1,1.0,1,1.0,1,0.11611121725879542,55
4390,3,8593,3272,5321,0,0,0,1.0,1,1.0,1,1.0,1,0.17165575817774628,55
4391,4,8597,3273,5324,0,0,0,1.0,1,1.0,1,1.0,1,0.13845112032797627,56
4392,1,8598,3273,5325,0,0,0,1.0,1,1.0,1,1.0,1,0.14500763679134818,56
4393,1,8599,3273,5326,0,0,0,1.0,1,1.0,1,1.0,1,0.15613562392658872,55
4394,0,8599,3273,5326,0,0,0,1.0,1,1.0,1,1.0,1,0.14535393869460464,53
4395,0,8599,3273,5326,0,0,0,1.0,1,1.0,1,1.0,1,0.14535393869460464,53
4396,1,8600,3274,5326,0,0,0,1.0,1,1.0,1,1.0,1,0.14336535061615718,53
4397,1,8601,3275,5326,0,0,0,1.0,1,1.0,1,1.0,1,0.1954622268312707,50
4398,1,8602,3276,5326,0,0,0,1.0,1,1.0,1,1.0,1,0.20861659191857018,50
4399,0,8602,3276,5326,0,0,0,1.0,1,1.0,1,1.0,1,0.19845871135774173,52
4400,3,8605,3277,5328,0,0,0,1.0,1,1.0,1,1.0,1,0.20748889456862554,55
4401,4,8609,3277,5332,0,0,0,1.0,1,1.0,1,1.0,1,0.15817874882687863,56
4402,1,8610,3277,5333,0,0,0,1.0,1,1.0,1,1.0,1,0.15510931403811545,56
4403,3,8613,3279,5334,0,0,0,1.0,1,1.0,1,1.0,1,0.14419801376811212,57
4404,0,8613,3279,5334,0,0,0,1.0,1,1.0,1,1.0,1,0.14419801376811212,57
4405,1,8614,3279,5335,0,0,0,1.0,1,1.0,1,1.0,1,0.1226195387556078,58
4406,0,8614,3279,5335,0,0,0,1.0,1,1.0,1,1.0,1,0.1226195387556078,58
4407,0,8614,3279,5335,0,0,0,1.0,1,1.0,1,1.0,1,0.1226195387556078,58
4408,0,8614,3279,5335,0,0,0,1.0,1,1.0,1,1.0,1,0.12513530265665976,59
4409,0,8614,3279,5335,0,0,0,1.0,1,1.0,1,1.0,1,0.12513530265665976,59
4410,0,8614,3279,5335,0,0,0,1.0,1,1.0,1,1.0,1,0.12513530265665976,59
4411,0,8614,3279,5335,0,0,0,1.0,1,1.0,1,1.0,1,0.11741445305997886,62
4412,0,8614,3279,5335,0,0,0,1.0,1,1.0,1,1.0,1,0.12488493364969473,63
4413,1,8615,3280,5335,0,0,0,1.0,1,1.0,1,1.0,1,0.13403554082578545,63
4414,3,8618,3280,5338,0,0,0,1.0,1,1.0,1,1.0,1,0.10575899560484174,64
4415,3,8621,3281,5340,0,0,0,1.0,1,1.0,1,1.0,1,0.09791484949752231,64
4416,0,8621,3281,5340,0,0,0,1.0,1,1.0,1,1.0,1,0.09791484949752231,64
4417,0,8621,3281,5340,0,0,0,1.0,1,1.0,1,1.0,1,0.09855596971797366,65
4418,2,8623,3283,5340,0,0,0,1.0,1,1.0,1,1.0,1,0.11465812501344518,65
4419,2,8625,3283,5342,0,0,0,1.0,1,1.0,1,1.0,1,0.15238560541248183,62
4420,2,8627,3284,5343,0,0,0,1.0,1,1.0,1,1.0,1,0.1757426139189444,62
4421,5,8632,3285,5347,0,0,0,1.0,1,1.0,1,1.0,1,0.1406739971306585,65
4422,3,8635,3286,5349,0,0,0,1.0,1,1.0,1,1.0,1,0.14987845937171326,64
4423,3,8638,3286,5352,0,0,0,1.0,1,1.0,1,1.0,1,0.1246566936284975,63
4424,4,8642,3287,5355,0,0,0,1.0,1,1.0,1,1.0,1,0.10630189314557167,63
4425,2,8644,3287,5357,0,0,0,1.0,1,1.0,1,1.0,1,0.10563792710609343,63
4426,1,8645,3288,5357,0,0,0,1.0,1,1.0,1,1.0,1,0.09004253572172775,63
4427,2,8647,3289,5358,0,0,0,1.0,1,1.0,1,1.0,1,0.07853426971302375,62
4428,0,8647,3289,5358,0,0,0,1.0,1,1.0,1,1.0,1,0.0705054967173854,61
4429,4,8651,3292,5359,0,0,0,1.0,1,1.0,1,1.0,1,0.13333325412956112,62
4430,4,8655,3293,5362,0,0,0,1.0,1,1.0,1,1.0,1,0.12170055543419786,60
4431,4,8659,3294,5365,0,0,0,1.0,1,1.0,1,1.0,1,0.04814930965901146,59
4432,2,8661,3295,5366,0,0,0,1.0,1,1.0,1,1.0,1,0.06335183039181595,60
4433,4,8665,3297,5368,0,0,0,1.0,1,1.0,1,1.0,1,0.04579755471033414,61
4434,0,8665,3297,5368,0,0,0,1.0,1,1.0,1,1.0,1,0.04579755471033414,61
4435,2,8667,3299,5368,0,0,0,1.0,1,1.0,1,1.0,1,0.060709673771580916,61
4436,0,8667,3299,5368,0,0,0,1.0,1,1.0,1,1.0,1,0.060709673771580916,61
4437,4,8671,3302,5369,0,0,0,1.0,1,1.0,1,1.0,1,0.1282823363041814,61
4438,1,8672,3302,5370,0,0,0,1.0,1,1.0,1,1.0,1,0.115256459933107,62
4439,7,8679,3302,5377,0,0,0,1.0,1,1.0,1,1.0,1,0.10290067646503667,63
4440,2,8681,3302,5379,0,0,0,1.0,1,1.0,1,1.0,1,0.101751529197636,64
4441,1,8682,3302,5380,0,0,0,1.0,1,1.0,1,1.0,1,0.09454583469979243,64
4442,4,8686,3305,5381,0,0,0,1.0,1,1.0,1,1.0,1,0.1400300499620458,67
4443,5,8691,3307,5384,0,0,0,1.0,1,1.0,1,1.0,1,0.10711141333252186,68
4444,0,8691,3307,5384,0,0,0,1.0,1,1.0,1,1.0,1,0.11616285341070914,69
4445,7,8698,3309,5389,0,0,0,1.0,1,1.0,1,1.0,1,0.09549426921718646,71
4446,0,8698,3309,5389,0,0,0,1.0,1,1.0,1,1.0,1,0.09549426921718646,71
4447,1,8699,3309,5390,0,0,0,1.0,1,1.0,1,1.0,1,0.09587549364886404,72
4448,0,8699,3309,5390,0,0,0,1.0,1,1.0,1,1.0,1,0.1037451743602856,71
4449,2,8701,3310,5391,0,0,0,1.0,1,1.0,1,1.0,1,0.10095666979231789,70
4450,1,8702,3310,5392,0,0,0,1.0,1,1.0,1,1.0,1,0.09747567209156904,69
4451,0,8702,3310,5392,0,0,0,1.0,1,1.0,1,1.0,1,0.09813125055117083,69
4452,2,8704,3310,5394,0,0,0,1.0,1,1.0,1,1.0,1,0.10373893305507038,70
4453,2,8706,3310,5396,0,0,0,1.0,1,1.0,1,1.0,1,0.0936447578863,70
4454,2,8708,3311,5397,0,0,0,1.0,1,1.0,1,1.0,1,0.10437654968973058,71
4455,2,8710,3311,5399,0,0,0,1.0,1,1.0,1,1.0,1,0.087051454862124,71
4456,3,8713,3313,5400,0,0,0,1.0,1,1.0,1,1.0,1,0.1120005904760254,71
4457,3,8716,3315,5401,0,0,0,1.0,1,1.0,1,1.0,1,0.10401991953033156,69
4458,5,8721,3318,5403,0,0,0,1.0,1,1.0,1,1.0,1,0.13467331184588355,70
4459,6,8727,3320,5407,0,0,0,1.0,1,1.0,1,1.0,1,0.11462144667511749,68
4460,4,8731,3321,5410,0,0,0,1.0,1,1.0,1,1.0,1,0.11624592062970462,68
4461,2,8733,3321,5412,0,0,0,1.0,1,1.0,1,1.0,1,0.10516237582529214,67
4462,4,8737,3324,5413,0,0,0,1.0,1,1.0,1,1.0,1,0.13942790886990597,66
4463,6,8743,3328,5415,0,0,0,1.0,1,1.0,1,1.0,1,0.137108799206567,65
4464,2,8745,3329,5416,0,0,0,1.0,1,1.0,1,1.0,1,0.16036770200465092,62
4465,6,8751,3331,5420,0,0,0,1.0,1,1.0,1,1.0,1,0.09593143257635717,61
4466,1,8752,3331,5421,0,0,0,1.0,1,1.0,1,1.0,1,0.10498585760391384,60
4467,3,8755,3333,5422,0,0,0,1.0,1,1.0,1,1.0,1,0.09261259832380074,58
4468,2,8757,3334,5423,0,0,0,1.0,1,1.0,1,1.0,1,0.06353094269516829,57
4469,2,8759,3335,5424,0,0,0,1.0,1,1.0,1,1.0,1,0.08290370133762592,56
4470,1,8760,3336,5424,0,0,0,1.0,1,1.0,1,1.0,1,0.09655622467889703,55
4471,3,8763,3337,5426,0,0,0,1.0,1,1.0,1,1.0,1,0.08287167850512758,55
4472,4,8767,3340,5427,0,0,0,1.0,1,1.0,1,1.0,1,0.10261399818327656,55
4473,4,8771,3343,5428,0,0,0,1.0,1,1.0,1,1.0,1,0.13619422972891215,55
4474,5,8776,3345,5431,0,0,0,1.0,1,1.0,1,1.0,1,0.1223346075237164,55
4475,4,8780,3346,5434,0,0,0,1.0,1,1.0,1,1.0,1,0.079328158184938,56
4476,0,8780,3346,5434,0,0,0,1.0,1,1.0,1,1.0,1,0.08024984017212598,56
4477,0,8780,3346,5434,0,0,0,1.0,1,1.0,1,1.0,1,0.0903700406361565,57
4478,0,8780,3346,5434,0,0,0,1.0,1,1.0,1,1.0,1,0.11631257218506037,55
4479,2,8782,3347,5435,0,0,0,1.0,1,1.0,1,1.0,1,0.12264734557743875,55
4480,1,8783,3348,5435,0,0,0,1.0,1,1.0,1,1.0,1,0.10757203131952883,54
4481,5,8788,3348,5440,0,0,0,1.0,1,1.0,1,1.0,1,0.06895718565899273,53
4482,0,8788,3348,5440,0,0,0,1.0,1,1.0,1,1.0,1,0.07632370756196043,54
4483,0,8788,3348,5440,0,0,0,1.0,1,1.0,1,1.0,1,0.07386882585121674,55
4484,1,8789,3349,5440,0,0,0,1.0,1,1.0,1,1.0,1,0.08111790832164886,57
4485,4,8793,3351,5442,0,0,0,1.0,1,1.0,1,1.0,1,0.10963757967961374,60
4486,1,8794,3352,5442,0,0,0,1.0,1,1.0,1,1.0,1,0.1068072243437639,60
4487,5,8799,3352,5447,0,0,0,1.0,1,1.0,1,1.0,1,0.053222039242389524,60
4488,1,8800,3352,5448,0,0,0,1.0,1,1.0,1,1.0,1,0.03809317234547256,60
4489,1,8801,3353,5448,0,0,0,1.0,1,1.0,1,1.0,1,0.057674868620325885,60
4490,0,8801,3353,5448,0,0,0,1.0,1,1.0,1,1.0,1,0.057674868620325885,60
4491,1,8802,3354,5448,0,0,0,1.0,1,1.0,1,1.0,1,0.07534696766487589,61
4492,0,8802,3354,5448,0,0,0,1.0,1,1.0,1,1.0,1,0.07534696766487589,61
4493,4,8806,3356,5450,0,0,0,1.0,1,1.0,1,1.0,1,0.10417680558609967,60
4494,2,8808,3358,5450,0,0,0,1.0,1,1.0,1,1.0,1,0.15255413311438118,61
4495,3,8811,3358,5453,0,0,0,1.0,1,1.0,1,1.0,1,0.12031980769292336,59
4496,2,8813,3359,5454,0,0,0,1.0,1,1.0,1,1.0,1,0.1509004348438677,60
4497,3,8816,3359,5457,0,0,0,1.0,1,1.0,1,1.0,1,0.10045160147207802,59
4498,0,8816,3359,5457,0,0,0,1.0,1,1.0,1,1.0,1,0.10081367375834759,57
4499,6,8822,3362,5460,0,0,0,1.0,1,1.0,1,1.0,1,0.1270698686044057,58
4500,1,8823,3362,5461,0,0,0,1.0,1,1.0,1,1.0,1,0.08607886305893495,56
4501,4,8827,3364,5463,0,0,0,1.0,1,1.0,1,1.0,1,0.0974081857790211,57
4502,4,8831,3367,5464,0,0,0,1.0,1,1.0,1,1.0,1,0.10605455753757546,56
4503,1,8832,3368,5464,0,0,0,1.0,1,1.0,1,1.0,1,0.11908712726519874,54
4504,1,8833,3369,5464,0,0,0,1.0,1,1.0,1,1.0,1,0.12443335209488868,54
4505,5,8838,3371,5467,0,0,0,1.0,1,1.0,1,1.0,1,0.10699012638343822,51
4506,2,8840,3372,5468,0,0,0,1.0,1,1.0,1,1.0,1,0.10170401415869756,49
4507,2,8842,3373,5469,0,0,0,1.0,1,1.0,1,1.0,1,0.14808483680574772,48
4508,1,8843,3373,5470,0,0,0,1.0,1,1.0,1,1.0,1,0.13670911911400657,48
4509,3,8846,3375,5471,0,0,0,1.0,1,1.0,1,1.0,1,0.14592892339412641,46
4510,1,8847,3375,5472,0,0,0,1.0,1,1.0,1,1.0,1,0.14754218066724686,44
4511,4,8851,3376,5475,0,0,0,1.0,1,1.0,1,1.0,1,0.1502000265844488,45
4512,4,8855,3377,5478,0,0,0,1.0,1,1.0,1,1.0,1,0.10147900440025431,46
4513,2,8857,3378,5479,0,0,0,1.0,1,1.0,1,1.0,1,0.12029359044016291,45
4514,1,8858,3379,5479,0,0,0,1.0,1,1.0,1,1.0,1,0.1062718326686308,46
4515,1,8859,3379,5480,0,0,0,1.0,1,1.0,1,1.0,1,0.1101047323915169,48
4516,0,8859,3379,5480,0,0,0,1.0,1,1.0,1,1.0,1,0.10780034080586971,49
4517,0,8859,3379,5480,0,0,0,1.0,1,1.0,1,1.0,1,0.11411472225629968,50
4518,1,8860,3380,5480,0,0,0,1.0,1,1.0,1,1.0,1,0.11650224221716705,50
4519,2,8862,3381,5481,0,0,0,1.0,1,1.0,1,1.0,1,0.15660509770071326,49
4520,0,8862,3381,5481,0,0,0,1.0,1,1.0,1,1.0,1,0.17052642336290671,50
4521,2,8864,3381,5483,0,0,0,1.0,1,1.0,1,1.0,1,0.13407690360064295,50
4522,0,8864,3381,5483,0,0,0,1.0,1,1.0,1,1.0,1,0.13407690360064295,50
4523,3,8867,3382,5485,0,0,0,1.0,1,1.0,1,1.0,1,0.11903250497916298,51
4524,4,8871,3383,5488,0,0,0,1.0,1,1.0,1,1.0,1,0.11108962423630135,52
4525,3,8874,3384,5490,0,0,0,1.0,1,1.0,1,1.0,1,0.08856416369016236,53
4526,0,8874,3384,5490,0,0,0,1.0,1,1.0,1,1.0,1,0.07802440781102678,54
4527,0,8874,3384,5490,0,0,0,1.0,1,1.0,1,1.0,1,0.09288062344390148,55
4528,0,8874,3384,5490,0,0,0,1.0,1,1.0,1,1.0,1,0.09288062344390148,55
4529,4,8878,3385,5493,0,0,0,1.0,1,1.0,1,1.0,1,0.09555850705921912,55
4530,0,8878,3385,5493,0,0,0,1.0,1,1.0,1,1.0,1,0.10422029500818908,56
4531,7,8885,3388,5497,0,0,0,1.0,1,1.0,1,1.0,1,0.10345814046366641,56
4532,3,8888,3389,5499,0,0,0,1.0,1,1.0,1,1.0,1,0.1459338607089601,55
4533,2,8890,3390,5500,0,0,0,1.0,1,1.0,1,1.0,1,0.11862104740963841,54
4534,1,8891,3390,5501,0,0,0,1.0,1,1.0,1,1.0,1,0.11717539329458526,55
4535,1,8892,3390,5502,0,0,0,1.0,1,1.0,1,1.0,1,0.1194722893874701,52
4536,2,8894,3391,5503,0,0,0,1.0,1,1.0,1,1.0,1,0.13050995492244627,53
4537,4,8898,3392,5506,0,0,0,1.0,1,1.0,1,1.0,1,0.11986456505764204,52
4538,0,8898,3392,5506,0,0,0,1.0,1,1.0,1,1.0,1,0.14039771124758046,52
4539,8,8906,3394,5512,0,0,0,1.0,1,1.0,1,1.0,1,0.12039649559787889,53
4540,3,8909,3395,5514,0,0,0,1.0,1,1.0,1,1.0,1,0.11542615732200312,54
4541,2,8911,3395,5516,0,0,0,1.0,1,1.0,1,1.0,1,0.10767642086419538,53
4542,6,8917,3399,5518,0,0,0,1.0,1,1.0,1,1.0,1,0.1604744132932078,53
4543,6,8923,3400,5523,0,0,0,1.0,1,1.0,1,1.0,1,0.12537127391766825,53
4544,3,8926,3401,5525,0,0,0,1.0,1,1.0,1,1.0,1,0.1095653578877522,52
4545,2,8928,3401,5527,0,0,0,1.0,1,1.0,1,1.0,1,0.09841870934009643,50
4546,0,8928,3401,5527,0,0,0,1.0,1,1.0,1,1.0,1,0.11229558043793085,49
4547,1,8929,3402,5527,0,0,0,1.0,1,1.0,1,1.0,1,0.10426998860552644,49
4548,0,8929,3402,5527,0,0,0,1.0,1,1.0,1,1.0,1,0.10426998860552644,49
4549,0,8929,3402,5527,0,0,0,1.0,1,1.0,1,1.0,1,0.09212022413309698,50
4550,1,8930,3403,5527,0,0,0,1.0,1,1.0,1,1.0,1,0.11043422714188249,49
4551,1,8931,3403,5528,0,0,0,1.0,1,1.0,1,1.0,1,0.09987680539853287,49
4552,0,8931,3403,5528,0,0,0,1.0,1,1.0,1,1.0,1,0.09987680539853287,49
4553,2,8933,3404,5529,0,0,0,1.0,1,1.0,1,1.0,1,0.1275785342325523,49
4554,3,8936,3406,5530,0,0,0,1.0,1,1.0,1,1.0,1,0.16133060600650373,49
4555,1,8937,3407,5530,0,0,0,1.0,1,1.0,1,1.0,1,0.16841969521606434,48
4556,1,8938,3408,5530,0,0,0,1.0,1,1.0,1,1.0,1,0.14892373111786736,48
4557,7,8945,3410,5535,0,0,0,1.0,1,1.0,1,1.0,1,0.17550218053770902,49
4558,2,8947,3411,5536,0,0,0,1.0,1,1.0,1,1.0,1,0.13117935609868214,49
4559,1,8948,3411,5537,0,0,0,1.0,1,1.0,1,1.0,1,0.13258773465068707,50
4560,0,8948,3411,5537,0,0,0,1.0,1,1.0,1,1.0,1,0.13920589099563455,51
4561,3,8951,3411,5540,0,0,0,1.0,1,1.0,1,1.0,1,0.09290603494871016,52
4562,4,8955,3412,5543,0,0,0,1.0,1,1.0,1,1.0,1,0.08400001201067687,53
4563,0,8955,3412,5543,0,0,0,1.0,1,1.0,1,1.0,1,0.08261445179737713,52
4564,0,8955,3412,5543,0,0,0,1.0,1,1.0,1,1.0,1,0.09845044308470868,54
4565,1,8956,3412,5544,0,0,0,1.0,1,1.0,1,1.0,1,0.08585724590624397,55
4566,0,8956,3412,5544,0,0,0,1.0,1,1.0,1,1.0,1,0.08585724590624397,55
4567,3,8959,3414,5545,0,0,0,1.0,1,1.0,1,1.0,1,0.06284024619862735,56
4568,3,8962,3415,5547,0,0,0,1.0,1,1.0,1,1.0,1,0.07675068687838177,58
4569,0,8962,3415,5547,0,0,0,1.0,1,1.0,1,1.0,1,0.07072192137249554,59
4570,0,8962,3415,5547,0,0,0,1.0,1,1.0,1,1.0,1,0.07072192137249554,59
4571,2,8964,3415,5549,0,0,0,1.0,1,1.0,1,1.0,1,0.04834607752424187,57
4572,1,8965,3416,5549,0,0,0,1.0,1,1.0,1,1.0,1,0.08535817111367004,56
4573,2,8967,3417,5550,0,0,0,1.0,1,1.0,1,1.0,1,0.11076031000773669,56
4574,4,8971,3417,5554,0,0,0,1.0,1,1.0,1,1.0,1,0.12799099160751534,55
4575,2,8973,3418,5555,0,0,0,1.0,1,1.0,1,1.0,1,0.11967600020789494,55
4576,2,8975,3418,5557,0,0,0,1.0,1,1.0,1,1.0,1,0.13332126207844297,55
4577,2,8977,3418,5559,0,0,0,1.0,1,1.0,1,1.0,1,0.12394746255327105,54
4578,0,8977,3418,5559,0,0,0,1.0,1,1.0,1,1.0,1,0.12376796086123712,54
4579,1,8978,3419,5559,0,0,0,1.0,1,1.0,1,1.0,1,0.1539723005491412,54
4580,1,8979,3419,5560,0,0,0,1.0,1,1.0,1,1.0,1,0.12449730265445945,55
4581,3,8982,3421,5561,0,0,0,1.0,1,1.0,1,1.0,1,0.1665954920142434,56
4582,0,8982,3421,5561,0,0,0,1.0,1,1.0,1,1.0,1,0.1665954920142434,56
4583,3,8985,3422,5563,0,0,0,1.0,1,1.0,1,1.0,1,0.14798616417930646,57
4584,2,8987,3424,5563,0,0,0,1.0,1,1.0,1,1.0,1,0.18984154871170011,57
4585,2,8989,3424,5565,0,0,0,1.0,1,1.0,1,1.0,1,0.17784995625682876,57
4586,0,8989,3424,5565,0,0,0,1.0,1,1.0,1,1.0,1,0.17784995625682876,57
4587,1,8990,3424,5566,0,0,0,1.0,1,1.0,1,1.0,1,0.16673606168431906,57
4588,0,8990,3424,5566,0,0,0,1.0,1,1.0,1,1.0,1,0.17922160228234224,58
4589,1,8991,3424,5567,0,0,0,1.0,1,1.0,1,1.0,1,0.15923220705477406,59
4590,0,8991,3424,5567,0,0,0,1.0,1,1.0,1,1.0,1,0.170055447904935,60
4591,0,8991,3424,5567,0,0,0,1.0,1,1.0,1,1.0,1,0.1786806764024081,61
4592,1,8992,3424,5568,0,0,0,1.0,1,1.0,1,1.0,1,0.17222416965918122,62
4593,8,9000,3424,5576,0,0,0,1.0,1,1.0,1,1.0,1,0.13533063440392926,64
4594,2,9002,3424,5578,0,0,0,1.0,1,1.0,1,1.0,1,0.10443134346627238,64
4595,0,9002,3424,5578,0,0,0,1.0,1,1.0,1,1.0,1,0.11002956404147884,63
4596,0,9002,3424,5578,0,0,0,1.0,1,1.0,1,1.0,1,0.11002956404147884,63
4597,0,9002,3424,5578,0,0,0,1.0,1,1.0,1,1.0,1,0.11002956404147884,63
4598,1,9003,3424,5579,0,0,0,1.0,1,1.0,1,1.0,1,0.0952882536970879,65
4599,0,9003,3424,5579,0,0,0,1.0,1,1.0,1,1.0,1,0.084564682348531,66
4600,2,9005,3425,5580,0,0,0,1.0,1,1.0,1,1.0,1,0.10187811166414772,67
4601,5,9010,3427,5583,0,0,0,1.0,1,1.0,1,1.0,1,0.08210637166321423,67
4602,1,9011,3427,5584,0,0,0,1.0,1,1.0,1,1.0,1,0.08489441331609374,69
4603,2,9013,3428,5585,0,0,0,1.0,1,1.0,1,1.0,1,0.09570765821166691,69
4604,0,9013,3428,5585,0,0,0,1.0,1,1.0,1,1.0,1,0.09570765821166691,69
4605,1,9014,3428,5586,0,0,0,1.0,1,1.0,1,1.0,1,0.08346425229387769,70
4606,1,9015,3428,5587,0,0,0,1.0,1,1.0,1,1.0,1,0.05967668708594969,70
4607,3,9018,3429,5589,0,0,0,1.0,1,1.0,1,1.0,1,0.08731607798033682,72
4608,1,9019,3429,5590,0,0,0,1.0,1,1.0,1,1.0,1,0.08624556794080818,73
4609,1,9020,3430,5590,0,0,0,1.0,1,1.0,1,1.0,1,0.10430305819301107,72
4610,1,9021,3431,5590,0,0,0,1.0,1,1.0,1,1.0,1,0.11324341145909247,72
4611,3,9024,3431,5593,0,0,0,1.0,1,1.0,1,1.0,1,0.09626412626605434,71
4612,1,9025,3432,5593,0,0,0,1.0,1,1.0,1,1.0,1,0.11280217412397316,70
4613,0,9025,3432,5593,0,0,0,1.0,1,1.0,1,1.0,1,0.10942202158773362,69
4614,3,9028,3432,5596,0,0,0,1.0,1,1.0,1,1.0,1,0.09686974168417528,68
4615,1,9029,3433,5596,0,0,0,1.0,1,1.0,1,1.0,1,0.11049546363270918,68
4616,0,9029,3433,5596,0,0,0,1.0,1,1.0,1,1.0,1,0.1388168963860466,65
4617,1,9030,3434,5596,0,0,0,1.0,1,1.0,1,1.0,1,0.12110067354882875,66
4618,2,9032,3435,5597,0,0,0,1.0,1,1.0,1,1.0,1,0.13432584219919186,66
4619,2,9034,3435,5599,0,0,0,1.0,1,1.0,1,1.0,1,0.11708446479071426,65
4620,2,9036,3436,5600,0,0,0,1.0,1,1.0,1,1.0,1,0.12617279912768,65
4621,6,9042,3439,5603,0,0,0,1.0,1,1.0,1,1.0,1,0.16056246650948053,67
4622,0,9042,3439,5603,0,0,0,1.0,1,1.0,1,1.0,1,0.1699740052349106,65
4623,6,9048,3442,5606,0,0,0,1.0,1,1.0,1,1.0,1,0.1482206511627713,66
4624,0,9048,3442,5606,0,0,0,1.0,1,1.0,1,1.0,1,0.14172236349550693,65
4625,3,9051,3442,5609,0,0,0,1.0,1,1.0,1,1.0,1,0.12478877747159765,64
4626,4,9055,3445,5610,0,0,0,1.0,1,1.0,1,1.0,1,0.12104006392208116,63
4627,2,9057,3446,5611,0,0,0,1.0,1,1.0,1,1.0,1,0.10671701182994954,65
4628,1,9058,3446,5612,0,0,0,1.0,1,1.0,1,1.0,1,0.10601552559227817,64
4629,3,9061,3447,5614,0,0,0,1.0,1,1.0,1,1.0,1,0.08698158400936234,64
4630,1,9062,3447,5615,0,0,0,1.0,1,1.0,1,1.0,1,0.0738616739737952,64
4631,3,9065,3450,5615,0,0,0,1.0,1,1.0,1,1.0,1,0.16361100258544772,66
4632,1,9066,3450,5616,0,0,0,1.0,1,1.0,1,1.0,1,0.15415594855649997,65
4633,1,9067,3450,5617,0,0,0,1.0,1,1.0,1,1.0,1,0.14865243083832674,66
4634,0,9067,3450,5617,0,0,0,1.0,1,1.0,1,1.0,1,0.14865243083832674,66
4635,2,9069,3450,5619,0,0,0,1.0,1,1.0,1,1.0,1,0.1347232697247989,66
4636,1,9070,3450,5620,0,0,0,1.0,1,1.0,1,1.0,1,0.11864974731339203,66
4637,2,9072,3450,5622,0,0,0,1.0,1,1.0,1,1.0,1,0.08678686733579416,68
4638,0,9072,3450,5622,0,0,0,1.0,1,1.0,1,1.0,1,0.08678686733579416,68
4639,2,9074,3451,5623,0,0,0,1.0,1,1.0,1,1.0,1,0.08257079629917205,69
4640,0,9074,3451,5623,0,0,0,1.0,1,1.0,1,1.0,1,0.08257079629917205,69
4641,3,9077,3451,5626,0,0,0,1.0,1,1.0,1,1.0,1,0.04519432015525971,70
4642,0,9077,3451,5626,0,0,0,1.0,1,1.0,1,1.0,1,0.05657705855356668,69
4643,1,9078,3452,5626,0,0,0,1.0,1,1.0,1,1.0,1,0.07414238291889313,70
4644,1,9079,3453,5626,0,0,0,1.0,1,1.0,1,1.0,1,0.10484967134944538,69
4645,3,9082,3454,5628,0,0,0,1.0,1,1.0,1,1.0,1,0.08565096505169571,70
4646,1,9083,3455,5628,0,0,0,1.0,1,1.0,1,1.0,1,0.11822771058400593,68
4647,6,9089,3458,5631,0,0,0,1.0,1,1.0,1,1.0,1,0.1472504250523545,68
4648,2,9091,3458,5633,0,0,0,1.0,1,1.0,1,1.0,1,0.16092221217919694,67
4649,5,9096,3459,5637,0,0,0,1.0,1,1.0,1,1.0,1,0.13944451324813445,67
4650,1,9097,3459,5638,0,0,0,1.0,1,1.0,1,1.0,1,0.11585908968865627,67
4651,5,9102,3461,5641,0,0,0,1.0,1,1.0,1,1.0,1,0.12524721828788804,68
4652,0,9102,3461,5641,0,0,0,1.0,1,1.0,1,1.0,1,0.13042455581307905,66
4653,2,9104,3461,5643,0,0,0,1.0,1,1.0,1,1.0,1,0.10655132031467969,64
4654,0,9104,3461,5643,0,0,0,1.0,1,1.0,1,1.0,1,0.12889278630186116,65
4655,2,9106,3461,5645,0,0,0,1.0,1,1.0,1,1.0,1,0.11576115559043199,64
4656,3,9109,3463,5646,0,0,0,1.0,1,1.0,1,1.0,1,0.13391687359376703,65
4657,3,9112,3464,5648,0,0,0,1.0,1,1.0,1,1.0,1,0.13670330213837786,66
4658,5,9117,3467,5650,0,0,0,1.0,1,1.0,1,1.0,1,0.19803411845056343,65
4659,5,9122,3467,5655,0,0,0,1.0,1,1.0,1,1.0,1,0.1524934432511138,65
4660,1,9123,3468,5655,0,0,0,1.0,1,1.0,1,1.0,1,0.15796783877699497,66
4661,3,9126,3468,5658,0,0,0,1.0,1,1.0,1,1.0,1,0.14872187717392046,66
4662,2,9128,3469,5659,0,0,0,1.0,1,1.0,1,1.0,1,0.13328712946339083,68
4663,1,9129,3469,5660,0,0,0,1.0,1,1.0,1,1.0,1,0.13347822592051334,67
4664,3,9132,3470,5662,0,0,0,1.0,1,1.0,1,1.0,1,0.125499706315773,67
4665,1,9133,3470,5663,0,0,0,1.0,1,1.0,1,1.0,1,0.11501092801584091,67
4666,1,9134,3471,5663,0,0,0,1.0,1,1.0,1,1.0,1,0.12831903204295278,67
4667,3,9137,3472,5665,0,0,0,1.0,1,1.0,1,1.0,1,0.11608336866464875,66
4668,2,9139,3474,5665,0,0,0,1.0,1,1.0,1,1.0,1,0.1362943579558386,66
4669,2,9141,3474,5667,0,0,0,1.0,1,1.0,1,1.0,1,0.1129329207007786,66
4670,0,9141,3474,5667,0,0,0,1.0,1,1.0,1,1.0,1,0.13625505878637004,64
4671,1,9142,3474,5668,0,0,0,1.0,1,1.0,1,1.0,1,0.13326797408593974,64
4672,2,9144,3475,5669,0,0,0,1.0,1,1.0,1,1.0,1,0.16097128000952465,64
4673,3,9147,3475,5672,0,0,0,1.0,1,1.0,1,1.0,1,0.13988690035096876,65
4674,2,9149,3476,5673,0,0,0,1.0,1,1.0,1,1.0,1,0.14407610290685754,66
4675,5,9154,3476,5678,0,0,0,1.0,1,1.0,1,1.0,1,0.13967998669618517,65
4676,0,9154,3476,5678,0,0,0,1.0,1,1.0,1,1.0,1,0.16341184362662334,65
4677,3,9157,3477,5680,0,0,0,1.0,1,1.0,1,1.0,1,0.1465547174746447,65
4678,0,9157,3477,5680,0,0,0,1.0,1,1.0,1,1.0,1,0.15841583083447577,64
4679,0,9157,3477,5680,0,0,0,1.0,1,1.0,1,1.0,1,0.15633670919229484,66
4680,3,9160,3478,5682,0,0,0,1.0,1,1.0,1,1.0,1,0.1646174771183615,67
4681,3,9163,3479,5684,0,0,0,1.0,1,1.0,1,1.0,1,0.14246840284871026,67
4682,3,9166,3481,5685,0,0,0,1.0,1,1.0,1,1.0,1,0.15473311900254708,67
4683,2,9168,3481,5687,0,0,0,1.0,1,1.0,1,1.0,1,0.13750813882807142,67
4684,1,9169,3482,5687,0,0,0,1.0,1,1.0,1,1.0,1,0.14173324891497738,66
4685,1,9170,3482,5688,0,0,0,1.0,1,1.0,1,1.0,1,0.13620827709987526,65
4686,2,9172,3484,5688,0,0,0,1.0,1,1.0,1,1.0,1,0.16131888927399723,65
4687,3,9175,3484,5691,0,0,0,1.0,1,1.0,1,1.0,1,0.13515085721172118,65
4688,2,9177,3486,5691,0,0,0,1.0,1,1.0,1,1.0,1,0.1621373590762613,64
4689,6,9183,3488,5695,0,0,0,1.0,1,1.0,1,1.0,1,0.19324603842274912,65
4690,1,9184,3488,5696,0,0,0,1.0,1,1.0,1,1.0,1,0.18614335228385903,63
4691,7,9191,3491,5700,0,0,0,1.0,1,1.0,1,1.0,1,0.19855051456324643,64
4692,2,9193,3491,5702,0,0,0,1.0,1,1.0,1,1.0,1,0.1712119389044716,63
4693,2,9195,3491,5704,0,0,0,1.0,1,1.0,1,1.0,1,0.16389838998674042,64
4694,1,9196,3491,5705,0,0,0,1.0,1,1.0,1,1.0,1,0.15821489192362903,63
4695,2,9198,3491,5707,0,0,0,1.0,1,1.0,1,1.0,1,0.15101681506374778,62
4696,2,9200,3491,5709,0,0,0,1.0,1,1.0,1,1.0,1,0.13635917286716276,61
4697,3,9203,3492,5711,0,0,0,1.0,1,1.0,1,1.0,1,0.1236942140659656,63
4698,0,9203,3492,5711,0,0,0,1.0,1,1.0,1,1.0,1,0.13262427826544018,63
4699,2,9205,3492,5713,0,0,0,1.0,1,1.0,1,1.0,1,0.10584788776000946,65
4700,0,9205,3492,5713,0,0,0,1.0,1,1.0,1,1.0,1,0.11467098590316706,64
4701,1,9206,3493,5713,0,0,0,1.0,1,1.0,1,1.0,1,0.12207053563881073,64
4702,1,9207,3493,5714,0,0,0,1.0,1,1.0,1,1.0,1,0.12608920144879626,66
4703,1,9208,3494,5714,0,0,0,1.0,1,1.0,1,1.0,1,0.12098255868176816,65
4704,4,9212,3496,5716,0,0,0,1.0,1,1.0,1,1.0,1,0.15600135011120778,64
4705,4,9216,3498,5718,0,0,0,1.0,1,1.0,1,1.0,1,0.1951952619193833,65
4706,5,9221,3502,5719,0,0,0,1.0,1,1.0,1,1.0,1,0.2228492295507343,65
4707,7,9228,3502,5726,0,0,0,1.0,1,1.0,1,1.0,1,0.1721942463670597,63
4708,2,9230,3503,5727,0,0,0,1.0,1,1.0,1,1.0,1,0.15243532614508187,62
4709,5,9235,3507,5728,0,0,0,1.0,1,1.0,1,1.0,1,0.16710418425571624,61
4710,0,9235,3507,5728,0,0,0,1.0,1,1.0,1,1.0,1,0.16118810817899473,60
4711,3,9238,3508,5730,0,0,0,1.0,1,1.0,1,1.0,1,0.1471353402871595,59
4712,2,9240,3509,5731,0,0,0,1.0,1,1.0,1,1.0,1,0.14400762683082538,58
4713,2,9242,3510,5732,0,0,0,1.0,1,1.0,1,1.0,1,0.1354212890515267,58
4714,0,9242,3510,5732,0,0,0,1.0,1,1.0,1,1.0,1,0.13317661076640852,57
4715,1,9243,3510,5733,0,0,0,1.0,1,1.0,1,1.0,1,0.14396284691474162,57
4716,2,9245,3511,5734,0,0,0,1.0,1,1.0,1,1.0,1,0.1369863049383642,55
4717,3,9248,3512,5736,0,0,0,1.0,1,1.0,1,1.0,1,0.16236068408512566,57
4718,2,9250,3512,5738,0,0,0,1.0,1,1.0,1,1.0,1,0.1236500676535828,56
4719,5,9255,3513,5742,0,0,0,1.0,1,1.0,1,1.0,1,0.12509582979429493,56
4720,1,9256,3513,5743,0,0,0,1.0,1,1.0,1,1.0,1,0.11681820942853727,57
4721,0,9256,3513,5743,0,0,0,1.0,1,1.0,1,1.0,1,0.11681820942853727,57
4722,1,9257,3514,5743,0,0,0,1.0,1,1.0,1,1.0,1,0.11769376258437832,57
4723,1,9258,3514,5744,0,0,0,1.0,1,1.0,1,1.0,1,0.11759986126780049,57
4724,0,9258,3514,5744,0,0,0,1.0,1,1.0,1,1.0,1,0.11949851252991377,57
4725,4,9262,3515,5747,0,0,0,1.0,1,1.0,1,1.0,1,0.11962378060946206,57
4726,4,9266,3518,5748,0,0,0,1.0,1,1.0,1,1.0,1,0.13940926976670429,57
4727,2,9268,3518,5750,0,0,0,1.0,1,1.0,1,1.0,1,0.14392201554815381,56
4728,0,9268,3518,5750,0,0,0,1.0,1,1.0,1,1.0,1,0.1460507494372002,57
4729,0,9268,3518,5750,0,0,0,1.0,1,1.0,1,1.0,1,0.15848443227432102,56
4730,1,9269,3519,5750,0,0,0,1.0,1,1.0,1,1.0,1,0.18870092788979131,54
4731,1,9270,3519,5751,0,0,0,1.0,1,1.0,1,1.0,1,0.16797756092695898,54
4732,5,9275,3522,5753,0,0,0,1.0,1,1.0,1,1.0,1,0.2578021136953221,54
4733,10,9285,3523,5762,0,0,0,1.0,1,1.0,1,1.0,1,0.19024371146901936,55
4734,5,9290,3525,5765,0,0,0,1.0,1,1.0,1,1.0,1,0.22405187603542576,56
4735,3,9293,3525,5768,0,0,0,1.0,1,1.0,1,1.0,1,0.1867683883638444,56
4736,1,9294,3526,5768,0,0,0,1.0,1,1.0,1,1.0,1,0.20356876381356145,58
4737,1,9295,3526,5769,0,0,0,1.0,1,1.0,1,1.0,1,0.1858383473642933,59
4738,2,9297,3527,5770,0,0,0,1.0,1,1.0,1,1.0,1,0.2097848541764729,60
4739,0,9297,3527,5770,0,0,0,1.0,1,1.0,1,1.0,1,0.2097848541764729,60
4740,0,9297,3527,5770,0,0,0,1.0,1,1.0,1,1.0,1,0.2097848541764729,60
4741,4,9301,3528,5773,0,0,0,1.0,1,1.0,1,1.0,1,0.20093735253746348,61
4742,2,9303,3529,5774,0,0,0,1.0,1,1.0,1,1.0,1,0.19765841694840317,61
4743,2,9305,3529,5776,0,0,0,1.0,1,1.0,1,1.0,1,0.172847920892809,60
4744,2,9307,3531,5776,0,0,0,1.0,1,1.0,1,1.0,1,0.1633045242003565,60
4745,2,9309,3531,5778,0,0,0,1.0,1,1.0,1,1.0,1,0.14715667800087043,59
4746,3,9312,3533,5779,0,0,0,1.0,1,1.0,1,1.0,1,0.16007824408981655,59
4747,5,9317,3535,5782,0,0,0,1.0,1,1.0,1,1.0,1,0.12076126254487478,58
4748,1,9318,3536,5782,0,0,0,1.0,1,1.0,1,1.0,1,0.12111574376756111,58
4749,3,9321,3538,5783,0,0,0,1.0,1,1.0,1,1.0,1,0.12648682971890848,58
4750,4,9325,3539,5786,0,0,0,1.0,1,1.0,1,1.0,1,0.10011292162300953,56
4751,5,9330,3541,5789,0,0,0,1.0,1,1.0,1,1.0,1,0.08050808597503072,58
4752,1,9331,3542,5789,0,0,0,1.0,1,1.0,1,1.0,1,0.07710536275919919,55
4753,0,9331,3542,5789,0,0,0,1.0,1,1.0,1,1.0,1,0.07710536275919919,55
4754,1,9332,3543,5789,0,0,0,1.0,1,1.0,1,1.0,1,0.11062531444503258,54
4755,3,9335,3543,5792,0,0,0,1.0,1,1.0,1,1.0,1,0.08829233535146193,54
4756,2,9337,3545,5792,0,0,0,1.0,1,1.0,1,1.0,1,0.1100444985441193,54
4757,1,9338,3545,5793,0,0,0,1.0,1,1.0,1,1.0,1,0.09696547070320974,53
4758,1,9339,3545,5794,0,0,0,1.0,1,1.0,1,1.0,1,0.07626279047326577,53
4759,1,9340,3546,5794,0,0,0,1.0,1,1.0,1,1.0,1,0.10813492727271,53
4760,3,9343,3547,5796,0,0,0,1.0,1,1.0,1,1.0,1,0.12813774598917757,53
4761,5,9348,3548,5800,0,0,0,1.0,1,1.0,1,1.0,1,0.12796509834306885,52
4762,4,9352,3550,5802,0,0,0,1.0,1,1.0,1,1.0,1,0.16094660947625142,54
4763,4,9356,3551,5805,0,0,0,1.0,1,1.0,1,1.0,1,0.14684927901006875,54
4764,3,9359,3551,5808,0,0,0,1.0,1,1.0,1,1.0,1,0.12121510951181241,55
4765,3,9362,3553,5809,0,0,0,1.0,1,1.0,1,1.0,1,0.19151307485484345,56
4766,2,9364,3554,5810,0,0,0,1.0,1,1.0,1,1.0,1,0.17014282186435473,58
4767,4,9368,3554,5814,0,0,0,1.0,1,1.0,1,1.0,1,0.1319197865288775,59
4768,1,9369,3555,5814,0,0,0,1.0,1,1.0,1,1.0,1,0.14630419218727123,60
4769,0,9369,3555,5814,0,0,0,1.0,1,1.0,1,1.0,1,0.15097570489978263,59
4770,0,9369,3555,5814,0,0,0,1.0,1,1.0,1,1.0,1,0.1525228724249128,60
4771,3,9372,3555,5817,0,0,0,1.0,1,1.0,1,1.0,1,0.16766155602884597,59
4772,1,9373,3556,5817,0,0,0,1.0,1,1.0,1,1.0,1,0.159040715460702,59
4773,1,9374,3556,5818,0,0,0,1.0,1,1.0,1,1.0,1,0.14371269325648853,60
4774,1,9375,3557,5818,0,0,0,1.0,1,1.0,1,1.0,1,0.16517683551514328,60
4775,2,9377,3557,5820,0,0,0,1.0,1,1.0,1,1.0,1,0.15647438784015097,62
4776,3,9380,3557,5823,0,0,0,1.0,1,1.0,1,1.0,1,0.13482033647528713,63
4777,1,9381,3557,5824,0,0,0,1.0,1,1.0,1,1.0,1,0.1087422482224012,63
4778,1,9382,3558,5824,0,0,0,1.0,1,1.0,1,1.0,1,0.11951354349464355,63
4779,3,9385,3558,5827,0,0,0,1.0,1,1.0,1,1.0,1,0.09587091925238764,63
4780,3,9388,3559,5829,0,0,0,1.0,1,1.0,1,1.0,1,0.11792735867615434,65
4781,5,9393,3559,5834,0,0,0,1.0,1,1.0,1,1.0,1,0.0840589886494427,64
4782,0,9393,3559,5834,0,0,0,1.0,1,1.0,1,1.0,1,0.0991325557311452,65
4783,3,9396,3560,5836,0,0,0,1.0,1,1.0,1,1.0,1,0.09183495199404461,66
4784,3,9399,3562,5837,0,0,0,1.0,1,1.0,1,1.0,1,0.10299212186703897,64
4785,7,9406,3564,5842,0,0,0,1.0,1,1.0,1,1.0,1,0.06240734566135182,65
4786,1,9407,3565,5842,0,0,0,1.0,1,1.0,1,1.0,1,0.08783462553992595,66
4787,3,9410,3566,5844,0,0,0,1.0,1,1.0,1,1.0,1,0.06401323065248063,63
4788,7,9417,3570,5847,0,0,0,1.0,1,1.0,1,1.0,1,0.07066769445383582,63
4789,1,9418,3571,5847,0,0,0,1.0,1,1.0,1,1.0,1,0.06706881610417556,60
4790,3,9421,3573,5848,0,0,0,1.0,1,1.0,1,1.0,1,0.09014709929329903,61
4791,6,9427,3577,5850,0,0,0,1.0,1,1.0,1,1.0,1,0.10655506255203394,59
4792,5,9432,3578,5854,0,0,0,1.0,1,1.0,1,1.0,1,0.0864496528034688,59
4793,2,9434,3579,5855,0,0,0,1.0,1,1.0,1,1.0,1,0.06859579160663588,61
4794,3,9437,3581,5856,0,0,0,1.0,1,1.0,1,1.0,1,0.0678207315875807,60
4795,1,9438,3582,5856,0,0,0,1.0,1,1.0,1,1.0,1,0.09009326344140046,61
4796,2,9440,3584,5856,0,0,0,1.0,1,1.0,1,1.0,1,0.07955651549646625,60
4797,2,9442,3586,5856,0,0,0,1.0,1,1.0,1,1.0,1,0.09593460274940831,61
4798,2,9444,3587,5857,0,0,0,1.0,1,1.0,1,1.0,1,0.11252237079735959,61
4799,4,9448,3587,5861,0,0,0,1.0,1,1.0,1,1.0,1,0.09312401247172936,59
4800,1,9449,3588,5861,0,0,0,1.0,1,1.0,1,1.0,1,0.09766604262532443,57
4801,1,9450,3588,5862,0,0,0,1.0,1,1.0,1,1.0,1,0.08486542487377781,58
4802,1,9451,3588,5863,0,0,0,1.0,1,1.0,1,1.0,1,0.11108880519451389,56
4803,6,9457,3590,5867,0,0,0,1.0,1,1.0,1,1.0,1,0.08074481266400436,57
4804,0,9457,3590,5867,0,0,0,1.0,1,1.0,1,1.0,1,0.06422716044286442,55
4805,4,9461,3593,5868,0,0,0,1.0,1,1.0,1,1.0,1,0.10273106389698046,56
4806,1,9462,3593,5869,0,0,0,1.0,1,1.0,1,1.0,1,0.09171866220259985,55
4807,1,9463,3593,5870,0,0,0,1.0,1,1.0,1,1.0,1,0.06730171001706933,53
4808,4,9467,3596,5871,0,0,0,1.0,1,1.0,1,1.0,1,0.11022664260245482,54
4809,2,9469,3596,5873,0,0,0,1.0,1,1.0,1,1.0,1,0.12010033928775031,53
4810,2,9471,3596,5875,0,0,0,1.0,1,1.0,1,1.0,1,0.10049758821888467,53
4811,2,9473,3597,5876,0,0,0,1.0,1,1.0,1,1.0,1,0.0936786415897676,54
4812,2,9475,3599,5876,0,0,0,1.0,1,1.0,1,1.0,1,0.09569161226723913,54
4813,2,9477,3599,5878,0,0,0,1.0,1,1.0,1,1.0,1,0.07372687204661776,55
4814,2,9479,3601,5878,0,0,0,1.0,1,1.0,1,1.0,1,0.11138482733290259,55
4815,1,9480,3601,5879,0,0,0,1.0,1,1.0,1,1.0,1,0.11702713401941986,56
4816,2,9482,3602,5880,0,0,0,1.0,1,1.0,1,1.0,1,0.10814515157120277,56
4817,3,9485,3604,5881,0,0,0,1.0,1,1.0,1,1.0,1,0.13805073409899268,58
4818,8,9493,3606,5887,0,0,0,1.0,1,1.0,1,1.0,1,0.14416234541781697,58
4819,5,9498,3606,5892,0,0,0,1.0,1,1.0,1,1.0,1,0.08973605351653909,58
4820,0,9498,3606,5892,0,0,0,1.0,1,1.0,1,1.0,1,0.08973605351653909,58
4821,1,9499,3606,5893,0,0,0,1.0,1,1.0,1,1.0,1,0.09658976853279475,58
4822,1,9500,3607,5893,0,0,0,1.0,1,1.0,1,1.0,1,0.10734891816189414,58
4823,3,9503,3608,5895,0,0,0,1.0,1,1.0,1,1.0,1,0.11687770530650927,57
4824,2,9505,3608,5897,0,0,0,1.0,1,1.0,1,1.0,1,0.11175006144191024,56
4825,3,9508,3608,5900,0,0,0,1.0,1,1.0,1,1.0,1,0.12257517075615638,57
4826,1,9509,3609,5900,0,0,0,1.0,1,1.0,1,1.0,1,0.1264903567197828,57
4827,2,9511,3609,5902,0,0,0,1.0,1,1.0,1,1.0,1,0.1425275111473893,56
4828,1,9512,3610,5902,0,0,0,1.0,1,1.0,1,1.0,1,0.12800911089171077,57
4829,1,9513,3611,5902,0,0,0,1.0,1,1.0,1,1.0,1,0.138011191472398,56
4830,1,9514,3612,5902,0,0,0,1.0,1,1.0,1,1.0,1,0.12412117988368494,57
4831,4,9518,3614,5904,0,0,0,1.0,1,1.0,1,1.0,1,0.1577423599274741,57
4832,0,9518,3614,5904,0,0,0,1.0,1,1.0,1,1.0,1,0.1663861789785989,55
4833,8,9526,3617,5909,0,0,0,1.0,1,1.0,1,1.0,1,0.12765607235242446,55
4834,0,9526,3617,5909,0,0,0,1.0,1,1.0,1,1.0,1,0.1393683670766476,55
4835,2,9528,3617,5911,0,0,0,1.0,1,1.0,1,1.0,1,0.13895869844944664,55
4836,1,9529,3617,5912,0,0,0,1.0,1,1.0,1,1.0,1,0.12741452092771824,55
4837,4,9533,3618,5915,0,0,0,1.0,1,1.0,1,1.0,1,0.1096778895372518,53
4838,1,9534,3618,5916,0,0,0,1.0,1,1.0,1,1.0,1,0.09090738263411048,54
4839,4,9538,3622,5916,0,0,0,1.0,1,1.0,1,1.0,1,0.13301197711332466,53
4840,2,9540,3623,5917,0,0,0,1.0,1,1.0,1,1.0,1,0.1284696300438709,52
4841,4,9544,3625,5919,0,0,0,1.0,1,1.0,1,1.0,1,0.09639353946882617,51
4842,4,9548,3627,5921,0,0,0,1.0,1,1.0,1,1.0,1,0.1054893295158909,50
4843,1,9549,3627,5922,0,0,0,1.0,1,1.0,1,1.0,1,0.09401305352085032,51
4844,0,9549,3627,5922,0,0,0,1.0,1,1.0,1,1.0,1,0.08893546291394318,50
4845,4,9553,3629,5924,0,0,0,1.0,1,1.0,1,1.0,1,0.1282712391450371,49
4846,1,9554,3629,5925,0,0,0,1.0,1,1.0,1,1.0,1,0.11099124102875556,49
4847,3,9557,3629,5928,0,0,0,1.0,1,1.0,1,1.0,1,0.09090229023113525,48
4848,3,9560,3631,5929,0,0,0,1.0,1,1.0,1,1.0,1,0.10582682572097205,48
4849,1,9561,3632,5929,0,0,0,1.0,1,1.0,1,1.0,1,0.11468665697755316,48
4850,0,9561,3632,5929,0,0,0,1.0,1,1.0,1,1.0,1,0.11354657433557919,49
4851,1,9562,3633,5929,0,0,0,1.0,1,1.0,1,1.0,1,0.1063667808462837,49
4852,1,9563,3633,5930,0,0,0,1.0,1,1.0,1,1.0,1,0.12974522198000032,49
4853,2,9565,3634,5931,0,0,0,1.0,1,1.0,1,1.0,1,0.15606051520312114,50
4854,3,9568,3635,5933,0,0,0,1.0,1,1.0,1,1.0,1,0.14876441891244738,51
4855,1,9569,3635,5934,0,0,0,1.0,1,1.0,1,1.0,1,0.1393988928528298,51
4856,0,9569,3635,5934,0,0,0,1.0,1,1.0,1,1.0,1,0.14902667019005628,50
4857,3,9572,3635,5937,0,0,0,1.0,1,1.0,1,1.0,1,0.10173540424410489,51
4858,0,9572,3635,5937,0,0,0,1.0,1,1.0,1,1.0,1,0.10223956526431556,51
4859,2,9574,3635,5939,0,0,0,1.0,1,1.0,1,1.0,1,0.09581574015233116,52
4860,0,9574,3635,5939,0,0,0,1.0,1,1.0,1,1.0,1,0.09581574015233116,52
4861,0,9574,3635,5939,0,0,0,1.0,1,1.0,1,1.0,1,0.11253786380706475,53
4862,2,9576,3637,5939,0,0,0,1.0,1,1.0,1,1.0,1,0.14363427679253887,53
4863,2,9578,3637,5941,0,0,0,1.0,1,1.0,1,1.0,1,0.1079972194631077,51
4864,5,9583,3638,5945,0,0,0,1.0,1,1.0,1,1.0,1,0.09417969151334675,53
4865,0,9583,3638,5945,0,0,0,1.0,1,1.0,1,1.0,1,0.08216538638351101,52
4866,1,9584,3639,5945,0,0,0,1.0,1,1.0,1,1.0,1,0.12422489069986029,53
4867,3,9587,3640,5947,0,0,0,1.0,1,1.0,1,1.0,1,0.07830220053062507,51
4868,3,9590,3641,5949,0,0,0,1.0,1,1.0,1,1.0,1,0.0738834488134162,53
4869,0,9590,3641,5949,0,0,0,1.0,1,1.0,1,1.0,1,0.0738834488134162,53
4870,5,9595,3643,5952,0,0,0,1.0,1,1.0,1,1.0,1,0.07632307606754106,55
4871,1,9596,3644,5952,0,0,0,1.0,1,1.0,1,1.0,1,0.09833002154674186,55
4872,4,9600,3645,5955,0,0,0,1.0,1,1.0,1,1.0,1,0.1139207333174759,56
4873,2,9602,3645,5957,0,0,0,1.0,1,1.0,1,1.0,1,0.09090128113312258,56
4874,3,9605,3646,5959,0,0,0,1.0,1,1.0,1,1.0,1,0.08047645604156471,58
4875,2,9607,3646,5961,0,0,0,1.0,1,1.0,1,1.0,1,0.07074159448608502,56
4876,1,9608,3647,5961,0,0,0,1.0,1,1.0,1,1.0,1,0.09011344849605171,56
4877,3,9611,3648,5963,0,0,0,1.0,1,1.0,1,1.0,1,0.07045549788307848,54
4878,1,9612,3648,5964,0,0,0,1.0,1,1.0,1,1.0,1,0.042708941123361245,54
4879,7,9619,3651,5968,0,0,0,1.0,1,1.0,1,1.0,1,0.10047034921526193,54
4880,2,9621,3651,5970,0,0,0,1.0,1,1.0,1,1.0,1,0.12767010088621727,53
4881,5,9626,3653,5973,0,0,0,1.0,1,1.0,1,1.0,1,0.15301996154257924,54
4882,3,9629,3653,5976,0,0,0,1.0,1,1.0,1,1.0,1,0.10994514041902581,52
4883,1,9630,3654,5976,0,0,0,1.0,1,1.0,1,1.0,1,0.12803388511946176,54
4884,0,9630,3654,5976,0,0,0,1.0,1,1.0,1,1.0,1,0.10616971970529626,52
4885,1,9631,3655,5976,0,0,0,1.0,1,1.0,1,1.0,1,0.10443621305440258,51
4886,0,9631,3655,5976,0,0,0,1.0,1,1.0,1,1.0,1,0.11325113272823319,50
4887,0,9631,3655,5976,0,0,0,1.0,1,1.0,1,1.0,1,0.13047787546009967,49
4888,0,9631,3655,5976,0,0,0,1.0,1,1.0,1,1.0,1,0.13849100425328267,48
4889,2,9633,3655,5978,0,0,0,1.0,1,1.0,1,1.0,1,0.12513272029748637,48
4890,0,9633,3655,5978,0,0,0,1.0,1,1.0,1,1.0,1,0.12513272029748637,48
4891,1,9634,3656,5978,0,0,0,1.0,1,1.0,1,1.0,1,0.1774996044132776,49
4892,2,9636,3656,5980,0,0,0,1.0,1,1.0,1,1.0,1,0.16956339318142766,51
4893,6,9642,3656,5986,0,0,0,1.0,1,1.0,1,1.0,1,0.11050446161825422,51
4894,0,9642,3656,5986,0,0,0,1.0,1,1.0,1,1.0,1,0.10607318537434118,52
4895,0,9642,3656,5986,0,0,0,1.0,1,1.0,1,1.0,1,0.10607318537434118,52
4896,0,9642,3656,5986,0,0,0,1.0,1,1.0,1,1.0,1,0.09664982423099937,51
4897,0,9642,3656,5986,0,0,0,1.0,1,1.0,1,1.0,1,0.10162372697079458,52
4898,2,9644,3658,5986,0,0,0,1.0,1,1.0,1,1.0,1,0.08033729257202733,52
4899,0,9644,3658,5986,0,0,0,1.0,1,1.0,1,1.0,1,0.09470326926620568,53
4900,4,9648,3661,5987,0,0,0,1.0,1,1.0,1,1.0,1,0.11058166121549282,54
4901,4,9652,3663,5989,0,0,0,1.0,1,1.0,1,1.0,1,0.08603788395775994,54
4902,1,9653,3663,5990,0,0,0,1.0,1,1.0,1,1.0,1,0.05340912213831313,55
4903,3,9656,3665,5991,0,0,0,1.0,1,1.0,1,1.0,1,0.08684618745708679,56
4904,2,9658,3666,5992,0,0,0,1.0,1,1.0,1,1.0,1,0.12657459440693597,55
4905,3,9661,3667,5994,0,0,0,1.0,1,1.0,1,1.0,1,0.12114881185626497,54
4906,5,9666,3669,5997,0,0,0,1.0,1,1.0,1,1.0,1,0.14221367837485585,54
4907,3,9669,3669,6000,0,0,0,1.0,1,1.0,1,1.0,1,0.10783146058186896,54
4908,1,9670,3669,6001,0,0,0,1.0,1,1.0,1,1.0,1,0.09851286642277267,53
4909,1,9671,3669,6002,0,0,0,1.0,1,1.0,1,1.0,1,0.07757698407813167,54
4910,1,9672,3669,6003,0,0,0,1.0,1,1.0,1,1.0,1,0.06670402062613562,55
4911,2,9674,3671,6003,0,0,0,1.0,1,1.0,1,1.0,1,0.13224926708672108,57
4912,4,9678,3673,6005,0,0,0,1.0,1,1.0,1,1.0,1,0.1605693313610203,57
4913,3,9681,3673,6008,0,0,0,1.0,1,1.0,1,1.0,1,0.1141266597968205,56
4914,1,9682,3673,6009,0,0,0,1.0,1,1.0,1,1.0,1,0.1091483393237546,56
4915,3,9685,3675,6010,0,0,0,1.0,1,1.0,1,1.0,1,0.0923379826946579,56
4916,1,9686,3675,6011,0,0,0,1.0,1,1.0,1,1.0,1,0.11376242880190623,54
4917,3,9689,3676,6013,0,0,0,1.0,1,1.0,1,1.0,1,0.11443330988551682,53
4918,3,9692,3678,6014,0,0,0,1.0,1,1.0,1,1.0,1,0.14381394420386986,52
4919,3,9695,3679,6016,0,0,0,1.0,1,1.0,1,1.0,1,0.1738309978332967,49
4920,0,9695,3679,6016,0,0,0,1.0,1,1.0,1,1.0,1,0.1738309978332967,49
4921,6,9701,3681,6020,0,0,0,1.0,1,1.0,1,1.0,1,0.17979954722551164,50
4922,1,9702,3681,6021,0,0,0,1.0,1,1.0,1,1.0,1,0.16509504840469935,50
4923,5,9707,3682,6025,0,0,0,1.0,1,1.0,1,1.0,1,0.10887468247072193,52
4924,1,9708,3683,6025,0,0,0,1.0,1,1.0,1,1.0,1,0.10743906554178197,53
4925,1,9709,3683,6026,0,0,0,1.0,1,1.0,1,1.0,1,0.07318924117489328,54
4926,0,9709,3683,6026,0,0,0,1.0,1,1.0,1,1.0,1,0.07318924117489328,54
4927,1,9710,3684,6026,0,0,0,1.0,1,1.0,1,1.0,1,0.06867908945150109,54
4928,0,9710,3684,6026,0,0,0,1.0,1,1.0,1,1.0,1,0.06867908945150109,54
4929,0,9710,3684,6026,0,0,0,1.0,1,1.0,1,1.0,1,0.07623699126525968,55
4930,0,9710,3684,6026,0,0,0,1.0,1,1.0,1,1.0,1,0.10605776698579854,58
4931,1,9711,3685,6026,0,0,0,1.0,1,1.0,1,1.0,1,0.11503786985750238,58
4932,1,9712,3686,6026,0,0,0,1.0,1,1.0,1,1.0,1,0.14536591891951087,59
4933,3,9715,3687,6028,0,0,0,1.0,1,1.0,1,1.0,1,0.14671992744620516,59
4934,0,9715,3687,6028,0,0,0,1.0,1,1.0,1,1.0,1,0.14671992744620516,59
4935,2,9717,3687,6030,0,0,0,1.0,1,1.0,1,1.0,1,0.1224938948262109,59
4936,0,9717,3687,6030,0,0,0,1.0,1,1.0,1,1.0,1,0.1224938948262109,59
4937,5,9722,3687,6035,0,0,0,1.0,1,1.0,1,1.0,1,0.1272389122024665,61
4938,3,9725,3687,6038,0,0,0,1.0,1,1.0,1,1.0,1,0.11453112866040499,62
4939,5,9730,3689,6041,0,0,0,1.0,1,1.0,1,1.0,1,0.1100144110454333,63
4940,4,9734,3689,6045,0,0,0,1.0,1,1.0,1,1.0,1,0.11374622344048646,65
4941,0,9734,3689,6045,0,0,0,1.0,1,1.0,1,1.0,1,0.11374622344048646,65
4942,7,9741,3692,6049,0,0,0,1.0,1,1.0,1,1.0,1,0.08462051781010078,67
4943,0,9741,3692,6049,0,0,0,1.0,1,1.0,1,1.0,1,0.10080465367184378,66
4944,3,9744,3695,6049,0,0,0,1.0,1,1.0,1,1.0,1,0.14610474108887186,63
4945,3,9747,3696,6051,0,0,0,1.0,1,1.0,1,1.0,1,0.09314562172408161,61
4946,4,9751,3698,6053,0,0,0,1.0,1,1.0,1,1.0,1,0.10885420590837852,60
4947,2,9753,3699,6054,0,0,0,1.0,1,1.0,1,1.0,1,0.08398817149889365,58
4948,4,9757,3701,6056,0,0,0,1.0,1,1.0,1,1.0,1,0.09318364022557732,57
4949,3,9760,3703,6057,0,0,0,1.0,1,1.0,1,1.0,1,0.0913882000832856,56
4950,2,9762,3703,6059,0,0,0,1.0,1,1.0,1,1.0,1,0.0873738128269212,57
4951,2,9764,3704,6060,0,0,0,1.0,1,1.0,1,1.0,1,0.07987602738228877,55
4952,3,9767,3707,6060,0,0,0,1.0,1,1.0,1,1.0,1,0.13970525213667281,55
4953,7,9774,3710,6064,0,0,0,1.0,1,1.0,1,1.0,1,0.062339210312981244,54
4954,0,9774,3710,6064,0,0,0,1.0,1,1.0,1,1.0,1,0.06181001536515015,54
4955,0,9774,3710,6064,0,0,0,1.0,1,1.0,1,1.0,1,0.03326796168726217,52
4956,0,9774,3710,6064,0,0,0,1.0,1,1.0,1,1.0,1,0.03326796168726217,52
4957,0,9774,3710,6064,0,0,0,1.0,1,1.0,1,1.0,1,0.06744536426835789,53
4958,1,9775,3711,6064,0,0,0,1.0,1,1.0,1,1.0,1,0.07072915455034164,52
4959,2,9777,3712,6065,0,0,0,1.0,1,1.0,1,1.0,1,0.04296308020151067,51
4960,0,9777,3712,6065,0,0,0,1.0,1,1.0,1,1.0,1,0.055051664457157055,53
4961,0,9777,3712,6065,0,0,0,1.0,1,1.0,1,1.0,1,0.055051664457157055,53
4962,0,9777,3712,6065,0,0,0,1.0,1,1.0,1,1.0,1,0.07416289229372877,55
4963,2,9779,3714,6065,0,0,0,1.0,1,1.0,1,1.0,1,0.0714770204709775,54
4964,0,9779,3714,6065,0,0,0,1.0,1,1.0,1,1.0,1,0.0714770204709775,54
4965,3,9782,3716,6066,0,0,0,1.0,1,1.0,1,1.0,1,0.09293465332878355,54
4966,2,9784,3718,6066,0,0,0,1.0,1,1.0,1,1.0,1,0.12178355847764873,54
4967,7,9791,3719,6072,0,0,0,1.0,1,1.0,1,1.0,1,0.08567856641389,55
4968,0,9791,3719,6072,0,0,0,1.0,1,1.0,1,1.0,1,0.08567856641389,55
4969,7,9798,3721,6077,0,0,0,1.0,1,1.0,1,1.0,1,0.07489453490001871,57
4970,4,9802,3721,6081,0,0,0,1.0,1,1.0,1,1.0,1,0.08802953480112624,56
4971,2,9804,3722,6082,0,0,0,1.0,1,1.0,1,1.0,1,0.10605735698825876,57
4972,1,9805,3723,6082,0,0,0,1.0,1,1.0,1,1.0,1,0.15819805479045837,57
4973,6,9811,3724,6087,0,0,0,1.0,1,1.0,1,1.0,1,0.12185777264887884,60
4974,1,9812,3725,6087,0,0,0,1.0,1,1.0,1,1.0,1,0.13762467283303806,58
4975,3,9815,3726,6089,0,0,0,1.0,1,1.0,1,1.0,1,0.14150572971986694,59
4976,5,9820,3728,6092,0,0,0,1.0,1,1.0,1,1.0,1,0.1076866826736577,59
4977,1,9821,3729,6092,0,0,0,1.0,1,1.0,1,1.0,1,0.12579383531999003,59
4978,2,9823,3730,6093,0,0,0,1.0,1,1.0,1,1.0,1,0.1124047240131807,59
4979,4,9827,3730,6097,0,0,0,1.0,1,1.0,1,1.0,1,0.08214626722416533,61
4980,1,9828,3731,6097,0,0,0,1.0,1,1.0,1,1.0,1,0.08661775172780382,62
4981,2,9830,3732,6098,0,0,0,1.0,1,1.0,1,1.0,1,0.08695699232303224,62
4982,5,9835,3734,6101,0,0,0,1.0,1,1.0,1,1.0,1,0.07385306329037003,63
4983,0,9835,3734,6101,0,0,0,1.0,1,1.0,1,1.0,1,0.07397739983155198,63
4984,1,9836,3735,6101,0,0,0,1.0,1,1.0,1,1.0,1,0.07946436924751088,61
4985,1,9837,3735,6102,0,0,0,1.0,1,1.0,1,1.0,1,0.07923144212799046,59
4986,2,9839,3736,6103,0,0,0,1.0,1,1.0,1,1.0,1,0.09449424182997623,62
4987,5,9844,3737,6107,0,0,0,1.0,1,1.0,1,1.0,1,0.06975087848961695,60
4988,1,9845,3738,6107,0,0,0,1.0,1,1.0,1,1.0,1,0.08174298057614876,59
4989,4,9849,3742,6107,0,0,0,1.0,1,1.0,1,1.0,1,0.13358165967560634,57
4990,1,9850,3742,6108,0,0,0,1.0,1,1.0,1,1.0,1,0.11947493490148298,55
4991,5,9855,3745,6110,0,0,0,1.0,1,1.0,1,1.0,1,0.0980376544539693,54
4992,1,9856,3746,6110,0,0,0,1.0,1,1.0,1,1.0,1,0.12484613774361715,52
4993,1,9857,3746,6111,0,0,0,1.0,1,1.0,1,1.0,1,0.10124864627534637,51
4994,2,9859,3748,6111,0,0,0,1.0,1,1.0,1,1.0,1,0.12892777664660257,49
4995,6,9865,3750,6115,0,0,0,1.0,1,1.0,1,1.0,1,0.10671776789096513,48
4996,2,9867,3752,6115,0,0,0,1.0,1,1.0,1,1.0,1,0.07714643313586994,48
4997,1,9868,3753,6115,0,0,0,1.0,1,1.0,1,1.0,1,0.08671269437349591,46
4998,1,9869,3754,6115,0,0,0,1.0,1,1.0,1,1.0,1,0.11739430450650577,48
4999,4,9873,3756,6117,0,0,0,1.0,1,1.0,1,1.0,1,0.14533599065871655,48
5000,1,9874,3756,6118,0,0,0,1.0,1,1.0,1,1.0,1,0.09710816517315696,47
5001,0,9874,3756,6118,0,0,0,1.0,1,1.0,1,1.0,1,0.12884685819982256,45
5002,1,9875,3757,6118,0,0,0,1.0,1,1.0,1,1.0,1,0.16900867908738348,46
5003,2,9877,3757,6120,0,0,0,1.0,1,1.0,1,1.0,1,0.1618815064451478,46
5004,3,9880,3759,6121,0,0,0,1.0,1,1.0,1,1.0,1,0.16935124146182692,46
5005,2,9882,3759,6123,0,0,0,1.0,1,1.0,1,1.0,1,0.16662896159370896,45
5006,0,9882,3759,6123,0,0,0,1.0,1,1.0,1,1.0,1,0.1911374745655902,45
5007,2,9884,3759,6125,0,0,0,1.0,1,1.0,1,1.0,1,0.1690529311210019,46
5008,0,9884,3759,6125,0,0,0,1.0,1,1.0,1,1.0,1,0.17405643333265597,49
5009,0,9884,3759,6125,0,0,0,1.0,1,1.0,1,1.0,1,0.17328454020018827,49
5010,0,9884,3759,6125,0,0,0,1.0,1,1.0,1,1.0,1,0.18536478883710306,50
5011,3,9887,3759,6128,0,0,0,1.0,1,1.0,1,1.0,1,0.17210155582610404,51
5012,2,9889,3759,6130,0,0,0,1.0,1,1.0,1,1.0,1,0.15470028447599657,52
5013,3,9892,3759,6133,0,0,0,1.0,1,1.0,1,1.0,1,0.12988540329560688,52
5014,1,9893,3759,6134,0,0,0,1.0,1,1.0,1,1.0,1,0.11921161566001295,53
5015,4,9897,3761,6136,0,0,0,1.0,1,1.0,1,1.0,1,0.1443408843423059,54
5016,2,9899,3762,6137,0,0,0,1.0,1,1.0,1,1.0,1,0.162814838020273,55
5017,2,9901,3762,6139,0,0,0,1.0,1,1.0,1,1.0,1,0.11644494893362849,55
5018,1,9902,3763,6139,0,0,0,1.0,1,1.0,1,1.0,1,0.10512163203625784,56
5019,1,9903,3763,6140,0,0,0,1.0,1,1.0,1,1.0,1,0.08974530277178748,56
5020,1,9904,3764,6140,0,0,0,1.0,1,1.0,1,1.0,1,0.09256581292987892,55
5021,2,9906,3764,6142,0,0,0,1.0,1,1.0,1,1.0,1,0.08549139406361494,56
5022,2,9908,3766,6142,0,0,0,1.0,1,1.0,1,1.0,1,0.11879346777456774,56
5023,2,9910,3767,6143,0,0,0,1.0,1,1.0,1,1.0,1,0.09008818293810253,55
5024,3,9913,3769,6144,0,0,0,1.0,1,1.0,1,1.0,1,0.10484909446857157,55
5025,3,9916,3771,6145,0,0,0,1.0,1,1.0,1,1.0,1,0.10033119505978252,53
5026,4,9920,3774,6146,0,0,0,1.0,1,1.0,1,1.0,1,0.11787138764951083,52
5027,1,9921,3775,6146,0,0,0,1.0,1,1.0,1,1.0,1,0.14427692830005687,51
5028,4,9925,3778,6147,0,0,0,1.0,1,1.0,1,1.0,1,0.1912754139302993,51
5029,5,9930,3779,6151,0,0,0,1.0,1,1.0,1,1.0,1,0.14903119411553842,50
5030,4,9934,3781,6153,0,0,0,1.0,1,1.0,1,1.0,1,0.11883161382188229,49
5031,1,9935,3782,6153,0,0,0,1.0,1,1.0,1,1.0,1,0.11565139479058568,49
5032,3,9938,3784,6154,0,0,0,1.0,1,1.0,1,1.0,1,0.16110625309878843,48
5033,3,9941,3785,6156,0,0,0,1.0,1,1.0,1,1.0,1,0.09277308939537975,50
5034,0,9941,3785,6156,0,0,0,1.0,1,1.0,1,1.0,1,0.0848571192193898,49
5035,2,9943,3787,6156,0,0,0,1.0,1,1.0,1,1.0,1,0.12077380412299184,49
5036,1,9944,3788,6156,0,0,0,1.0,1,1.0,1,1.0,1,0.11773418350937491,47
5037,2,9946,3788,6158,0,0,0,1.0,1,1.0,1,1.0,1,0.07708454570029792,47
5038,0,9946,3788,6158,0,0,0,1.0,1,1.0,1,1.0,1,0.0909750462888066,47
5039,0,9946,3788,6158,0,0,0,1.0,1,1.0,1,1.0,1,0.09093060450364106,48
5040,0,9946,3788,6158,0,0,0,1.0,1,1.0,1,1.0,1,0.09093060450364106,48
5041,0,9946,3788,6158,0,0,0,1.0,1,1.0,1,1.0,1,0.09093060450364106,48
5042,0,9946,3788,6158,0,0,0,1.0,1,1.0,1,1.0,1,0.08687882534544629,50
5043,1,9947,3789,6158,0,0,0,1.0,1,1.0,1,1.0,1,0.11405874767216494,51
5044,0,9947,3789,6158,0,0,0,1.0,1,1.0,1,1.0,1,0.11405874767216494,51
5045,2,9949,3789,6160,0,0,0,1.0,1,1.0,1,1.0,1,0.07739049990529737,52
5046,1,9950,3790,6160,0,0,0,1.0,1,1.0,1,1.0,1,0.10898127551147002,51
5047,2,9952,3791,6161,0,0,0,1.0,1,1.0,1,1.0,1,0.08439023457441024,51
5048,4,9956,3792,6164,0,0,0,1.0,1,1.0,1,1.0,1,0.08299250539431079,52
5049,1,9957,3792,6165,0,0,0,1.0,1,1.0,1,1.0,1,0.08599639574125424,54
5050,2,9959,3792,6167,0,0,0,1.0,1,1.0,1,1.0,1,0.08454517419187811,56
5051,1,9960,3792,6168,0,0,0,1.0,1,1.0,1,1.0,1,0.06954847117088221,55
5052,0,9960,3792,6168,0,0,0,1.0,1,1.0,1,1.0,1,0.06954847117088221,55
5053,0,9960,3792,6168,0,0,0,1.0,1,1.0,1,1.0,1,0.06954847117088221,55
5054,0,9960,3792,6168,0,0,0,1.0,1,1.0,1,1.0,1,0.06954847117088221,55
5055,1,9961,3792,6169,0,0,0,1.0,1,1.0,1,1.0,1,0.08735262660595966,55
5056,3,9964,3793,6171,0,0,0,1.0,1,1.0,1,1.0,1,0.10205370740029118,56
5057,2,9966,3793,6173,0,0,0,1.0,1,1.0,1,1.0,1,0.08265623450325628,58
5058,1,9967,3793,6174,0,0,0,1.0,1,1.0,1,1.0,1,0.09084229514316605,59
5059,1,9968,3793,6175,0,0,0,1.0,1,1.0,1,1.0,1,0.07222480801988279,59
5060,1,9969,3793,6176,0,0,0,1.0,1,1.0,1,1.0,1,0.056438963555254074,59
5061,0,9969,3793,6176,0,0,0,1.0,1,1.0,1,1.0,1,0.052485304529385504,59
5062,2,9971,3794,6177,0,0,0,1.0,1,1.0,1,1.0,1,0.0784377593509329,59
5063,1,9972,3795,6177,0,0,0,1.0,1,1.0,1,1.0,1,0.11764878236886209,59
5064,4,9976,3799,6177,0,0,0,1.0,1,1.0,1,1.0,1,0.1794228590651603,57
5065,5,9981,3801,6180,0,0,0,1.0,1,1.0,1,1.0,1,0.16434998621491625,55
5066,6,9987,3804,6183,0,0,0,1.0,1,1.0,1,1.0,1,0.2141202619365083,55
5067,6,9993,3805,6188,0,0,0,1.0,1,1.0,1,1.0,1,0.17645309383914728,54
5068,3,9996,3805,6191,0,0,0,1.0,1,1.0,1,1.0,1,0.14249469617898558,54
5069,1,9997,3805,6192,0,0,0,1.0,1,1.0,1,1.0,1,0.12419746045589186,54
5070,1,9998,3806,6192,0,0,0,1.0,1,1.0,1,1.0,1,0.1493814247608674,52
5071,3,10001,3807,6194,0,0,0,1.0,1,1.0,1,1.0,1,0.10811359415991063,54
5072,1,10002,3807,6195,0,0,0,1.0,1,1.0,1,1.0,1,0.09750676514375224,52
5073,0,10002,3807,6195,0,0,0,1.0,1,1.0,1,1.0,1,0.09363660586788385,51
5074,2,10004,3808,6196,0,0,0,1.0,1,1.0,1,1.0,1,0.1212677572087697,52
5075,2,10006,3808,6198,0,0,0,1.0,1,1.0,1,1.0,1,0.08629348401901131,53
5076,0,10006,3808,6198,0,0,0,1.0,1,1.0,1,1.0,1,0.08629348401901131,53
5077,2,10008,3809,6199,0,0,0,1.0,1,1.0,1,1.0,1,0.09556098065875786,56
5078,3,10011,3809,6202,0,0,0,1.0,1,1.0,1,1.0,1,0.08900392264505404,55
5079,1,10012,3809,6203,0,0,0,1.0,1,1.0,1,1.0,1,0.09756869245197763,56
5080,0,10012,3809,6203,0,0,0,1.0,1,1.0,1,1.0,1,0.09103918306608469,57
5081,1,10013,3809,6204,0,0,0,1.0,1,1.0,1,1.0,1,0.08351176314941042,58
5082,0,10013,3809,6204,0,0,0,1.0,1,1.0,1,1.0,1,0.08351176314941042,58
5083,0,10013,3809,6204,0,0,0,1.0,1,1.0,1,1.0,1,0.09190833431425682,59
5084,2,10015,3810,6205,0,0,0,1.0,1,1.0,1,1.0,1,0.06262364043603892,59
5085,1,10016,3811,6205,0,0,0,1.0,1,1.0,1,1.0,1,0.09434814214329618,60
5086,2,10018,3812,6206,0,0,0,1.0,1,1.0,1,1.0,1,0.08724316688063294,61
5087,1,10019,3813,6206,0,0,0,1.0,1,1.0,1,1.0,1,0.09857159838710268,62
5088,4,10023,3815,6208,0,0,0,1.0,1,1.0,1,1.0,1,0.10193449491737722,64
5089,3,10026,3815,6211,0,0,0,1.0,1,1.0,1,1.0,1,0.07016960830445614,64
5090,0,10026,3815,6211,0,0,0,1.0,1,1.0,1,1.0,1,0.07016960830445614,64
5091,5,10031,3819,6212,0,0,0,1.0,1,1.0,1,1.0,1,0.13719242464253034,64
5092,2,10033,3820,6213,0,0,0,1.0,1,1.0,1,1.0,1,0.14003809999591169,64
5093,6,10039,3820,6219,0,0,0,1.0,1,1.0,1,1.0,1,0.08560387408187344,64
5094,5,10044,3823,6221,0,0,0,1.0,1,1.0,1,1.0,1,0.12350437702695725,65
5095,4,10048,3824,6224,0,0,0,1.0,1,1.0,1,1.0,1,0.10224263179352856,66
5096,1,10049,3824,6225,0,0,0,1.0,1,1.0,1,1.0,1,0.10844549219299358,66
5097,3,10052,3826,6226,0,0,0,1.0,1,1.0,1,1.0,1,0.13241002487692197,67
5098,0,10052,3826,6226,0,0,0,1.0,1,1.0,1,1.0,1,0.13241002487692197,67
5099,7,10059,3827,6232,0,0,0,1.0,1,1.0,1,1.0,1,0.11731135653053198,70
5100,2,10061,3828,6233,0,0,0,1.0,1,1.0,1,1.0,1,0.11649575495676813,71
5101,3,10064,3828,6236,0,0,0,1.0,1,1.0,1,1.0,1,0.09202682969283388,72
5102,5,10069,3830,6239,0,0,0,1.0,1,1.0,1,1.0,1,0.09580147528883436,72
5103,4,10073,3831,6242,0,0,0,1.0,1,1.0,1,1.0,1,0.0823457934668311,70
5104,4,10077,3834,6243,0,0,0,1.0,1,1.0,1,1.0,1,0.08163354786102399,67
5105,5,10082,3835,6247,0,0,0,1.0,1,1.0,1,1.0,1,0.07081421038759621,66
5106,3,10085,3838,6247,0,0,0,1.0,1,1.0,1,1.0,1,0.12666606723981758,64
5107,3,10088,3839,6249,0,0,0,1.0,1,1.0,1,1.0,1,0.08678641147552206,61
5108,3,10091,3841,6250,0,0,0,1.0,1,1.0,1,1.0,1,0.09760995538570336,57
5109,4,10095,3843,6252,0,0,0,1.0,1,1.0,1,1.0,1,0.09982065336427406,55
5110,2,10097,3845,6252,0,0,0,1.0,1,1.0,1,1.0,1,0.12980367329707118,53
5111,5,10102,3847,6255,0,0,0,1.0,1,1.0,1,1.0,1,0.1681853966771116,52
5112,6,10108,3849,6259,0,0,0,1.0,1,1.0,1,1.0,1,0.0878617638588686,52
5113,0,10108,3849,6259,0,0,0,1.0,1,1.0,1,1.0,1,0.08471636636407491,49
5114,2,10110,3851,6259,0,0,0,1.0,1,1.0,1,1.0,1,0.1517506842303778,49
5115,3,10113,3851,6262,0,0,0,1.0,1,1.0,1,1.0,1,0.10934108983799902,48
5116,0,10113,3851,6262,0,0,0,1.0,1,1.0,1,1.0,1,0.09208305936489561,47
5117,0,10113,3851,6262,0,0,0,1.0,1,1.0,1,1.0,1,0.10519074881059336,48
5118,0,10113,3851,6262,0,0,0,1.0,1,1.0,1,1.0,1,0.0915533328107175,49
5119,3,10116,3853,6263,0,0,0,1.0,1,1.0,1,1.0,1,0.11182158076643844,49
5120,1,10117,3854,6263,0,0,0,1.0,1,1.0,1,1.0,1,0.10933957853306711,48
5121,3,10120,3856,6264,0,0,0,1.0,1,1.0,1,1.0,1,0.09688723042492312,48
5122,3,10123,3858,6265,0,0,0,1.0,1,1.0,1,1.0,1,0.16548481402526025,46
5123,0,10123,3858,6265,0,0,0,1.0,1,1.0,1,1.0,1,0.16548481402526025,46
5124,2,10125,3858,6267,0,0,0,1.0,1,1.0,1,1.0,1,0.12365111650802867,47
5125,7,10132,3859,6273,0,0,0,1.0,1,1.0,1,1.0,1,0.14926739262440344,49
5126,3,10135,3859,6276,0,0,0,1.0,1,1.0,1,1.0,1,0.13429192507358123,49
5127,7,10142,3860,6282,0,0,0,1.0,1,1.0,1,1.0,1,0.12865202310920443,51
5128,5,10147,3861,6286,0,0,0,1.0,1,1.0,1,1.0,1,0.12458092877009137,53
5129,2,10149,3861,6288,0,0,0,1.0,1,1.0,1,1.0,1,0.10429735282582946,55
5130,0,10149,3861,6288,0,0,0,1.0,1,1.0,1,1.0,1,0.10429735282582946,55
5131,1,10150,3861,6289,0,0,0,1.0,1,1.0,1,1.0,1,0.08574503660014912,55
5132,0,10150,3861,6289,0,0,0,1.0,1,1.0,1,1.0,1,0.08574503660014912,55
5133,0,10150,3861,6289,0,0,0,1.0,1,1.0,1,1.0,1,0.09210203820621318,56
5134,0,10150,3861,6289,0,0,0,1.0,1,1.0,1,1.0,1,0.11972468806008531,56
5135,1,10151,3862,6289,0,0,0,1.0,1,1.0,1,1.0,1,0.12343955737881895,56
5136,0,10151,3862,6289,0,0,0,1.0,1,1.0,1,1.0,1,0.13687224662815264,55
5137,3,10154,3863,6291,0,0,0,1.0,1,1.0,1,1.0,1,0.12208566261496903,55
5138,2,10156,3863,6293,0,0,0,1.0,1,1.0,1,1.0,1,0.11464915285435259,54
5139,0,10156,3863,6293,0,0,0,1.0,1,1.0,1,1.0,1,0.11464915285435259,54
5140,1,10157,3864,6293,0,0,0,1.0,1,1.0,1,1.0,1,0.1168572439137322,54
5141,5,10162,3866,6296,0,0,0,1.0,1,1.0,1,1.0,1,0.08876470516814344,53
5142,6,10168,3870,6298,0,0,0,1.0,1,1.0,1,1.0,1,0.1357462870810305,55
5143,3,10171,3872,6299,0,0,0,1.0,1,1.0,1,1.0,1,0.10055021861168678,54
5144,1,10172,3873,6299,0,0,0,1.0,1,1.0,1,1.0,1,0.09315656085624098,50
5145,5,10177,3874,6303,0,0,0,1.0,1,1.0,1,1.0,1,0.0738908928779545,51
5146,2,10179,3876,6303,0,0,0,1.0,1,1.0,1,1.0,1,0.07572245548608261,48
5147,4,10183,3879,6304,0,0,0,1.0,1,1.0,1,1.0,1,0.15700841350598355,49
5148,1,10184,3879,6305,0,0,0,1.0,1,1.0,1,1.0,1,0.11588725582129925,47
5149,4,10188,3880,6308,0,0,0,1.0,1,1.0,1,1.0,1,0.1494787123325368,46
5150,1,10189,3881,6308,0,0,0,1.0,1,1.0,1,1.0,1,0.16313247534220685,46
5151,5,10194,3881,6313,0,0,0,1.0,1,1.0,1,1.0,1,0.14824757775063432,45
5152,6,10200,3884,6316,0,0,0,1.0,1,1.0,1,1.0,1,0.18663645815741534,45
5153,5,10205,3885,6320,0,0,0,1.0,1,1.0,1,1.0,1,0.1743055998583012,45
5154,2,10207,3886,6321,0,0,0,1.0,1,1.0,1,1.0,1,0.21437722236531478,45
5155,3,10210,3886,6324,0,0,0,1.0,1,1.0,1,1.0,1,0.1562906185144729,44
5156,2,10212,3887,6325,0,0,0,1.0,1,1.0,1,1.0,1,0.16493275978691008,44
5157,1,10213,3887,6326,0,0,0,1.0,1,1.0,1,1.0,1,0.16200370472070663,42
5158,2,10215,3888,6327,0,0,0,1.0,1,1.0,1,1.0,1,0.14566183214113415,43
5159,2,10217,3888,6329,0,0,0,1.0,1,1.0,1,1.0,1,0.16875725670859154,43
5160,0,10217,3888,6329,0,0,0,1.0,1,1.0,1,1.0,1,0.16875725670859154,43
5161,1,10218,3888,6330,0,0,0,1.0,1,1.0,1,1.0,1,0.15157998888848515,43
5162,0,10218,3888,6330,0,0,0,1.0,1,1.0,1,1.0,1,0.1432562814979207,44
5163,3,10221,3889,6332,0,0,0,1.0,1,1.0,1,1.0,1,0.1486590735231324,46
5164,0,10221,3889,6332,0,0,0,1.0,1,1.0,1,1.0,1,0.1486590735231324,46
5165,2,10223,3890,6333,0,0,0,1.0,1,1.0,1,1.0,1,0.1313374633405955,46
5166,3,10226,3891,6335,0,0,0,1.0,1,1.0,1,1.0,1,0.14976759089584765,47
5167,2,10228,3892,6336,0,0,0,1.0,1,1.0,1,1.0,1,0.13368363037440373,47
5168,1,10229,3893,6336,0,0,0,1.0,1,1.0,1,1.0,1,0.1636583456878812,47
5169,3,10232,3894,6338,0,0,0,1.0,1,1.0,1,1.0,1,0.14963354765110998,47
5170,5,10237,3895,6342,0,0,0,1.0,1,1.0,1,1.0,1,0.12681750240267647,48
5171,2,10239,3896,6343,0,0,0,1.0,1,1.0,1,1.0,1,0.1175180158936112,48
5172,0,10239,3896,6343,0,0,0,1.0,1,1.0,1,1.0,1,0.09634350545293136,49
5173,2,10241,3896,6345,0,0,0,1.0,1,1.0,1,1.0,1,0.1096236012495585,49
5174,2,10243,3896,6347,0,0,0,1.0,1,1.0,1,1.0,1,0.10892797340728548,52
5175,0,10243,3896,6347,0,0,0,1.0,1,1.0,1,1.0,1,0.11015279200784096,53
5176,1,10244,3896,6348,0,0,0,1.0,1,1.0,1,1.0,1,0.10553291563886909,54
5177,1,10245,3897,6348,0,0,0,1.0,1,1.0,1,1.0,1,0.11993751471112164,54
5178,2,10247,3898,6349,0,0,0,1.0,1,1.0,1,1.0,1,0.15321860543220964,55
5179,4,10251,3899,6352,0,0,0,1.0,1,1.0,1,1.0,1,0.10319476629313813,53
5180,1,10252,3900,6352,0,0,0,1.0,1,1.0,1,1.0,1,0.08935820596454686,52
5181,3,10255,3902,6353,0,0,0,1.0,1,1.0,1,1.0,1,0.09779905893056319,52
5182,2,10257,3903,6354,0,0,0,1.0,1,1.0,1,1.0,1,0.10877862541565805,52
5183,4,10261,3905,6356,0,0,0,1.0,1,1.0,1,1.0,1,0.1334919444633147,52
5184,2,10263,3906,6357,0,0,0,1.0,1,1.0,1,1.0,1,0.13320865531482814,52
5185,2,10265,3907,6358,0,0,0,1.0,1,1.0,1,1.0,1,0.1354313166429556,50
5186,2,10267,3909,6358,0,0,0,1.0,1,1.0,1,1.0,1,0.18572447095792136,48
5187,5,10272,3909,6363,0,0,0,1.0,1,1.0,1,1.0,1,0.13782989776526933,46
5188,0,10272,3909,6363,0,0,0,1.0,1,1.0,1,1.0,1,0.1368398194169276,44
5189,0,10272,3909,6363,0,0,0,1.0,1,1.0,1,1.0,1,0.14280609794631155,44
5190,1,10273,3910,6363,0,0,0,1.0,1,1.0,1,1.0,1,0.16897244389779634,45
5191,1,10274,3910,6364,0,0,0,1.0,1,1.0,1,1.0,1,0.14782644192233668,45
5192,2,10276,3911,6365,0,0,0,1.0,1,1.0,1,1.0,1,0.12515560079028037,45
5193,2,10278,3911,6367,0,0,0,1.0,1,1.0,1,1.0,1,0.10153289591703904,45
5194,0,10278,3911,6367,0,0,0,1.0,1,1.0,1,1.0,1,0.10283782655329182,45
5195,1,10279,3912,6367,0,0,0,1.0,1,1.0,1,1.0,1,0.1130933117943086,46
5196,0,10279,3912,6367,0,0,0,1.0,1,1.0,1,1.0,1,0.1130933117943086,46
5197,1,10280,3913,6367,0,0,0,1.0,1,1.0,1,1.0,1,0.14114529820114521,46
5198,0,10280,3913,6367,0,0,0,1.0,1,1.0,1,1.0,1,0.12824569245338904,47
5199,4,10284,3914,6370,0,0,0,1.0,1,1.0,1,1.0,1,0.12666044411627722,49
5200,1,10285,3915,6370,0,0,0,1.0,1,1.0,1,1.0,1,0.14803648071865885,49
5201,2,10287,3917,6370,0,0,0,1.0,1,1.0,1,1.0,1,0.14038761904033012,50
5202,3,10290,3917,6373,0,0,0,1.0,1,1.0,1,1.0,1,0.10211927827639031,52
5203,0,10290,3917,6373,0,0,0,1.0,1,1.0,1,1.0,1,0.10211927827639031,52
5204,0,10290,3917,6373,0,0,0,1.0,1,1.0,1,1.0,1,0.1001471661712937,54
5205,1,10291,3917,6374,0,0,0,1.0,1,1.0,1,1.0,1,0.08005194726023408,54
5206,1,10292,3917,6375,0,0,0,1.0,1,1.0,1,1.0,1,0.08091924806798091,55
5207,0,10292,3917,6375,0,0,0,1.0,1,1.0,1,1.0,1,0.07802850787716174,54
5208,0,10292,3917,6375,0,0,0,1.0,1,1.0,1,1.0,1,0.07802850787716174,54
5209,0,10292,3917,6375,0,0,0,1.0,1,1.0,1,1.0,1,0.07802850787716174,54
5210,0,10292,3917,6375,0,0,0,1.0,1,1.0,1,1.0,1,0.07802850787716174,54
5211,2,10294,3917,6377,0,0,0,1.0,1,1.0,1,1.0,1,0.06957818807232084,56
5212,1,10295,3918,6377,0,0,0,1.0,1,1.0,1,1.0,1,0.061236791623685345,57
5213,4,10299,3921,6378,0,0,0,1.0,1,1.0,1,1.0,1,0.14260383783164898,57
5214,5,10304,3923,6381,0,0,0,1.0,1,1.0,1,1.0,1,0.18313843294638538,58
5215,5,10309,3923,6386,0,0,0,1.0,1,1.0,1,1.0,1,0.16689786386875213,57
5216,1,10310,3924,6386,0,0,0,1.0,1,1.0,1,1.0,1,0.16401039178485144,57
5217,4,10314,3925,6389,0,0,0,1.0,1,1.0,1,1.0,1,0.145987973507073,56
5218,3,10317,3927,6390,0,0,0,1.0,1,1.0,1,1.0,1,0.1488956646395634,56
5219,6,10323,3927,6396,0,0,0,1.0,1,1.0,1,1.0,1,0.10885380103704051,54
5220,1,10324,3927,6397,0,0,0,1.0,1,1.0,1,1.0,1,0.11571817459315677,53
5221,1,10325,3927,6398,0,0,0,1.0,1,1.0,1,1.0,1,0.10474649803466732,52
5222,2,10327,3928,6399,0,0,0,1.0,1,1.0,1,1.0,1,0.1396275268256785,52
5223,3,10330,3929,6401,0,0,0,1.0,1,1.0,1,1.0,1,0.12334353831092457,52
5224,1,10331,3929,6402,0,0,0,1.0,1,1.0,1,1.0,1,0.12276374627525796,52
5225,2,10333,3929,6404,0,0,0,1.0,1,1.0,1,1.0,1,0.11028148804529472,50
5226,4,10337,3931,6406,0,0,0,1.0,1,1.0,1,1.0,1,0.12470371597706112,51
5227,4,10341,3933,6408,0,0,0,1.0,1,1.0,1,1.0,1,0.10896786939065185,49
5228,1,10342,3933,6409,0,0,0,1.0,1,1.0,1,1.0,1,0.10778030812783812,48
5229,0,10342,3933,6409,0,0,0,1.0,1,1.0,1,1.0,1,0.09764926760977971,49
5230,1,10343,3934,6409,0,0,0,1.0,1,1.0,1,1.0,1,0.12290648574915823,49
5231,2,10345,3935,6410,0,0,0,1.0,1,1.0,1,1.0,1,0.09166503496987397,49
5232,2,10347,3936,6411,0,0,0,1.0,1,1.0,1,1.0,1,0.09929024223988968,51
5233,2,10349,3937,6412,0,0,0,1.0,1,1.0,1,1.0,1,0.09891056246422088,51
5234,5,10354,3939,6415,0,0,0,1.0,1,1.0,1,1.0,1,0.11338842347270482,52
5235,2,10356,3939,6417,0,0,0,1.0,1,1.0,1,1.0,1,0.08521767932887743,52
5236,0,10356,3939,6417,0,0,0,1.0,1,1.0,1,1.0,1,0.08521767932887743,52
5237,2,10358,3939,6419,0,0,0,1.0,1,1.0,1,1.0,1,0.07465397413456706,53
5238,0,10358,3939,6419,0,0,0,1.0,1,1.0,1,1.0,1,0.07465397413456706,53
5239,0,10358,3939,6419,0,0,0,1.0,1,1.0,1,1.0,1,0.07465397413456706,53
5240,3,10361,3941,6420,0,0,0,1.0,1,1.0,1,1.0,1,0.08458448350216748,55
5241,2,10363,3941,6422,0,0,0,1.0,1,1.0,1,1.0,1,0.051724950684204955,56
5242,1,10364,3942,6422,0,0,0,1.0,1,1.0,1,1.0,1,0.07034210413392207,54
5243,2,10366,3943,6423,0,0,0,1.0,1,1.0,1,1.0,1,0.055695902355706754,55
5244,1,10367,3944,6423,0,0,0,1.0,1,1.0,1,1.0,1,0.1060972259109364,55
5245,2,10369,3945,6424,0,0,0,1.0,1,1.0,1,1.0,1,0.1005932977928042,55
5246,4,10373,3947,6426,0,0,0,1.0,1,1.0,1,1.0,1,0.1285116453118749,55
5247,2,10375,3948,6427,0,0,0,1.0,1,1.0,1,1.0,1,0.1317598050834369,54
5248,0,10375,3948,6427,0,0,0,1.0,1,1.0,1,1.0,1,0.14222587617218663,53
5249,7,10382,3950,6432,0,0,0,1.0,1,1.0,1,1.0,1,0.11652720345272526,55
5250,0,10382,3950,6432,0,0,0,1.0,1,1.0,1,1.0,1,0.11652720345272526,55
5251,4,10386,3951,6435,0,0,0,1.0,1,1.0,1,1.0,1,0.08814033853253944,57
5252,2,10388,3951,6437,0,0,0,1.0,1,1.0,1,1.0,1,0.09667658111409219,58
5253,2,10390,3953,6437,0,0,0,1.0,1,1.0,1,1.0,1,0.11871047707373314,59
5254,2,10392,3954,6438,0,0,0,1.0,1,1.0,1,1.0,1,0.11115199762019881,59
5255,3,10395,3955,6440,0,0,0,1.0,1,1.0,1,1.0,1,0.09983914913702747,58
5256,1,10396,3956,6440,0,0,0,1.0,1,1.0,1,1.0,1,0.12426751498816346,59
5257,4,10400,3957,6443,0,0,0,1.0,1,1.0,1,1.0,1,0.11446952055733128,58
5258,0,10400,3957,6443,0,0,0,1.0,1,1.0,1,1.0,1,0.11551128394391495,56
5259,0,10400,3957,6443,0,0,0,1.0,1,1.0,1,1.0,1,0.1254033747343756,56
5260,1,10401,3958,6443,0,0,0,1.0,1,1.0,1,1.0,1,0.14700057163223423,55
5261,2,10403,3959,6444,0,0,0,1.0,1,1.0,1,1.0,1,0.09054734338000037,54
5262,2,10405,3960,6445,0,0,0,1.0,1,1.0,1,1.0,1,0.09789678474708297,54
5263,5,10410,3961,6449,0,0,0,1.0,1,1.0,1,1.0,1,0.10986737142765045,53
5264,1,10411,3962,6449,0,0,0,1.0,1,1.0,1,1.0,1,0.1149315711619805,51
5265,2,10413,3962,6451,0,0,0,1.0,1,1.0,1,1.0,1,0.07556292730720518,50
5266,3,10416,3965,6451,0,0,0,1.0,1,1.0,1,1.0,1,0.05731240383102371,49
5267,2,10418,3967,6451,0,0,0,1.0,1,1.0,1,1.0,1,0.04207752280120504,48
5268,2,10420,3969,6451,0,0,0,1.0,1,1.0,1,1.0,1,0.08823378666576498,47
5269,2,10422,3970,6452,0,0,0,1.0,1,1.0,1,1.0,1,0.0912215288266797,45
5270,0,10422,3970,6452,0,0,0,1.0,1,1.0,1,1.0,1,0.093181020997201,47
5271,1,10423,3970,6453,0,0,0,1.0,1,1.0,1,1.0,1,0.11976952370358501,45
5272,9,10432,3974,6458,0,0,0,1.0,1,1.0,1,1.0,1,0.16444195840695158,46
5273,5,10437,3974,6463,0,0,0,1.0,1,1.0,1,1.0,1,0.13125538165747203,44
5274,3,10440,3975,6465,0,0,0,1.0,1,1.0,1,1.0,1,0.1383296041795075,44
5275,3,10443,3976,6467,0,0,0,1.0,1,1.0,1,1.0,1,0.1393245629349513,46
5276,2,10445,3976,6469,0,0,0,1.0,1,1.0,1,1.0,1,0.10851412751757217,46
5277,2,10447,3977,6470,0,0,0,1.0,1,1.0,1,1.0,1,0.0896980682039627,46
5278,2,10449,3978,6471,0,0,0,1.0,1,1.0,1,1.0,1,0.10980414449521028,46
5279,2,10451,3980,6471,0,0,0,1.0,1,1.0,1,1.0,1,0.18204982361724664,47
5280,2,10453,3981,6472,0,0,0,1.0,1,1.0,1,1.0,1,0.1699842308509201,47
5281,5,10458,3981,6477,0,0,0,1.0,1,1.0,1,1.0,1,0.11627725818525753,48
5282,2,10460,3982,6478,0,0,0,1.0,1,1.0,1,1.0,1,0.14377591680113905,48
5283,1,10461,3982,6479,0,0,0,1.0,1,1.0,1,1.0,1,0.14640361287526896,49
5284,1,10462,3982,6480,0,0,0,1.0,1,1.0,1,1.0,1,0.1386095321938203,49
5285,1,10463,3982,6481,0,0,0,1.0,1,1.0,1,1.0,1,0.10382704803687062,50
5286,1,10464,3982,6482,0,0,0,1.0,1,1.0,1,1.0,1,0.09909539554595877,51
5287,0,10464,3982,6482,0,0,0,1.0,1,1.0,1,1.0,1,0.09909539554595877,51
5288,1,10465,3982,6483,0,0,0,1.0,1,1.0,1,1.0,1,0.09233082550523726,51
5289,2,10467,3982,6485,0,0,0,1.0,1,1.0,1,1.0,1,0.09500792002742982,53
5290,1,10468,3982,6486,0,0,0,1.0,1,1.0,1,1.0,1,0.07873961313654505,53
5291,0,10468,3982,6486,0,0,0,1.0,1,1.0,1,1.0,1,0.07873961313654505,53
5292,2,10470,3983,6487,0,0,0,1.0,1,1.0,1,1.0,1,0.08230091350498521,53
5293,4,10474,3985,6489,0,0,0,1.0,1,1.0,1,1.0,1,0.11230981893288541,53
5294,5,10479,3987,6492,0,0,0,1.0,1,1.0,1,1.0,1,0.12828892097259315,54
5295,2,10481,3988,6493,0,0,0,1.0,1,1.0,1,1.0,1,0.11000802149097555,52
5296,0,10481,3988,6493,0,0,0,1.0,1,1.0,1,1.0,1,0.13882265994369397,49
5297,4,10485,3990,6495,0,0,0,1.0,1,1.0,1,1.0,1,0.15295572079961323,49
5298,0,10485,3990,6495,0,0,0,1.0,1,1.0,1,1.0,1,0.15259495971256118,49
5299,4,10489,3992,6497,0,0,0,1.0,1,1.0,1,1.0,1,0.15277788297990305,50
5300,0,10489,3992,6497,0,0,0,1.0,1,1.0,1,1.0,1,0.16374959506283537,48
5301,3,10492,3993,6499,0,0,0,1.0,1,1.0,1,1.0,1,0.17626563449672575,46
5302,2,10494,3994,6500,0,0,0,1.0,1,1.0,1,1.0,1,0.17787949775371562,47
5303,5,10499,3996,6503,0,0,0,1.0,1,1.0,1,1.0,1,0.14620092566924323,46
5304,3,10502,3998,6504,0,0,0,1.0,1,1.0,1,1.0,1,0.20481495341961073,45
5305,4,10506,3998,6508,0,0,0,1.0,1,1.0,1,1.0,1,0.12136243436243713,44
5306,3,10509,4001,6508,0,0,0,1.0,1,1.0,1,1.0,1,0.19148064919168767,42
5307,2,10511,4002,6509,0,0,0,1.0,1,1.0,1,1.0,1,0.20256075071344007,42
5308,2,10513,4003,6510,0,0,0,1.0,1,1.0,1,1.0,1,0.20205264098890444,43
5309,2,10515,4004,6511,0,0,0,1.0,1,1.0,1,1.0,1,0.18976885583172087,41
5310,3,10518,4005,6513,0,0,0,1.0,1,1.0,1,1.0,1,0.21127392725096522,41
5311,1,10519,4006,6513,0,0,0,1.0,1,1.0,1,1.0,1,0.20309799078332597,42
5312,2,10521,4006,6515,0,0,0,1.0,1,1.0,1,1.0,1,0.18058547025266763,43
5313,2,10523,4006,6517,0,0,0,1.0,1,1.0,1,1.0,1,0.1388584744329546,44
5314,1,10524,4006,6518,0,0,0,1.0,1,1.0,1,1.0,1,0.1335732339393403,44
5315,3,10527,4008,6519,0,0,0,1.0,1,1.0,1,1.0,1,0.1525477604912064,45
5316,3,10530,4008,6522,0,0,0,1.0,1,1.0,1,1.0,1,0.1101667726193066,46
5317,3,10533,4009,6524,0,0,0,1.0,1,1.0,1,1.0,1,0.11264721317736591,46
5318,1,10534,4010,6524,0,0,0,1.0,1,1.0,1,1.0,1,0.10897848362715397,46
5319,2,10536,4010,6526,0,0,0,1.0,1,1.0,1,1.0,1,0.07833958514059815,47
5320,2,10538,4011,6527,0,0,0,1.0,1,1.0,1,1.0,1,0.06029351509361494,48
5321,2,10540,4012,6528,0,0,0,1.0,1,1.0,1,1.0,1,0.07233855460118052,49
5322,0,10540,4012,6528,0,0,0,1.0,1,1.0,1,1.0,1,0.07233855460118052,49
5323,1,10541,4012,6529,0,0,0,1.0,1,1.0,1,1.0,1,0.08770532165925779,51
5324,0,10541,4012,6529,0,0,0,1.0,1,1.0,1,1.0,1,0.08866810803683325,53
5325,2,10543,4013,6530,0,0,0,1.0,1,1.0,1,1.0,1,0.07900527813890246,53
5326,0,10543,4013,6530,0,0,0,1.0,1,1.0,1,1.0,1,0.07900527813890246,53
5327,0,10543,4013,6530,0,0,0,1.0,1,1.0,1,1.0,1,0.11611009307270652,53
5328,1,10544,4014,6530,0,0,0,1.0,1,1.0,1,1.0,1,0.12210668938547188,54
5329,4,10548,4016,6532,0,0,0,1.0,1,1.0,1,1.0,1,0.13533685236254153,53
5330,2,10550,4018,6532,0,0,0,1.0,1,1.0,1,1.0,1,0.1503127453927989,52
5331,1,10551,4018,6533,0,0,0,1.0,1,1.0,1,1.0,1,0.13830078143249125,51
5332,1,10552,4018,6534,0,0,0,1.0,1,1.0,1,1.0,1,0.12746551006011825,52
5333,1,10553,4019,6534,0,0,0,1.0,1,1.0,1,1.0,1,0.16508390499752726,53
5334,4,10557,4020,6537,0,0,0,1.0,1,1.0,1,1.0,1,0.15146903430071854,54
5335,2,10559,4020,6539,0,0,0,1.0,1,1.0,1,1.0,1,0.13171711246769638,55
5336,0,10559,4020,6539,0,0,0,1.0,1,1.0,1,1.0,1,0.13884418698675693,54
5337,2,10561,4021,6540,0,0,0,1.0,1,1.0,1,1.0,1,0.16516775021361435,55
5338,1,10562,4022,6540,0,0,0,1.0,1,1.0,1,1.0,1,0.17534212445861416,55
5339,3,10565,4022,6543,0,0,0,1.0,1,1.0,1,1.0,1,0.14676974832908796,55
5340,0,10565,4022,6543,0,0,0,1.0,1,1.0,1,1.0,1,0.14676974832908796,55
5341,3,10568,4022,6546,0,0,0,1.0,1,1.0,1,1.0,1,0.11420553895206235,54
5342,2,10570,4023,6547,0,0,0,1.0,1,1.0,1,1.0,1,0.1163876584691606,55
5343,3,10573,4025,6548,0,0,0,1.0,1,1.0,1,1.0,1,0.12681404761069848,54
5344,3,10576,4028,6548,0,0,0,1.0,1,1.0,1,1.0,1,0.16266194624324679,55
5345,2,10578,4029,6549,0,0,0,1.0,1,1.0,1,1.0,1,0.11460822268449991,53
5346,4,10582,4031,6551,0,0,0,1.0,1,1.0,1,1.0,1,0.11634076175704988,53
5347,3,10585,4033,6552,0,0,0,1.0,1,1.0,1,1.0,1,0.08661577166339922,51
5348,5,10590,4035,6555,0,0,0,1.0,1,1.0,1,1.0,1,0.10574714938655767,53
5349,4,10594,4037,6557,0,0,0,1.0,1,1.0,1,1.0,1,0.10856260344066544,52
5350,1,10595,4038,6557,0,0,0,1.0,1,1.0,1,1.0,1,0.11161900055620973,50
5351,4,10599,4040,6559,0,0,0,1.0,1,1.0,1,1.0,1,0.17657934343913195,52
5352,2,10601,4040,6561,0,0,0,1.0,1,1.0,1,1.0,1,0.08096508217967606,49
5353,0,10601,4040,6561,0,0,0,1.0,1,1.0,1,1.0,1,0.08096508217967606,49
5354,1,10602,4040,6562,0,0,0,1.0,1,1.0,1,1.0,1,0.07856436600435246,49
5355,2,10604,4040,6564,0,0,0,1.0,1,1.0,1,1.0,1,0.06837300348302436,48
5356,4,10608,4042,6566,0,0,0,1.0,1,1.0,1,1.0,1,0.0748385705111985,49
5357,1,10609,4042,6567,0,0,0,1.0,1,1.0,1,1.0,1,0.08057568660245543,47
5358,1,10610,4043,6567,0,0,0,1.0,1,1.0,1,1.0,1,0.10816222553320791,48
5359,3,10613,4044,6569,0,0,0,1.0,1,1.0,1,1.0,1,0.10225831005061287,48
5360,0,10613,4044,6569,0,0,0,1.0,1,1.0,1,1.0,1,0.10225831005061287,48
5361,1,10614,4044,6570,0,0,0,1.0,1,1.0,1,1.0,1,0.10125866479442397,50
5362,0,10614,4044,6570,0,0,0,1.0,1,1.0,1,1.0,1,0.10125866479442397,50
5363,0,10614,4044,6570,0,0,0,1.0,1,1.0,1,1.0,1,0.10125866479442397,50
5364,1,10615,4045,6570,0,0,0,1.0,1,1.0,1,1.0,1,0.111568658655004,51
5365,0,10615,4045,6570,0,0,0,1.0,1,1.0,1,1.0,1,0.11298771463465324,52
5366,1,10616,4045,6571,0,0,0,1.0,1,1.0,1,1.0,1,0.10278156493543521,52
5367,2,10618,4047,6571,0,0,0,1.0,1,1.0,1,1.0,1,0.1431999640643867,54
5368,6,10624,4048,6576,0,0,0,1.0,1,1.0,1,1.0,1,0.11786247178990578,55
5369,3,10627,4050,6577,0,0,0,1.0,1,1.0,1,1.0,1,0.10867636383307533,53
5370,4,10631,4052,6579,0,0,0,1.0,1,1.0,1,1.0,1,0.14600411196786134,54
5371,5,10636,4055,6581,0,0,0,1.0,1,1.0,1,1.0,1,0.1674698960918686,53
5372,2,10638,4057,6581,0,0,0,1.0,1,1.0,1,1.0,1,0.20020727871207566,53
5373,2,10640,4057,6583,0,0,0,1.0,1,1.0,1,1.0,1,0.16278185599446754,52
5374,3,10643,4059,6584,0,0,0,1.0,1,1.0,1,1.0,1,0.13509528731752476,51
5375,2,10645,4059,6586,0,0,0,1.0,1,1.0,1,1.0,1,0.08763356367611365,52
5376,2,10647,4061,6586,0,0,0,1.0,1,1.0,1,1.0,1,0.1321126840493515,51
5377,1,10648,4061,6587,0,0,0,1.0,1,1.0,1,1.0,1,0.13230877054394788,52
5378,3,10651,4063,6588,0,0,0,1.0,1,1.0,1,1.0,1,0.16020748323809722,50
5379,0,10651,4063,6588,0,0,0,1.0,1,1.0,1,1.0,1,0.16020748323809722,50
5380,3,10654,4063,6591,0,0,0,1.0,1,1.0,1,1.0,1,0.11236993991509735,52
5381,0,10654,4063,6591,0,0,0,1.0,1,1.0,1,1.0,1,0.11236993991509735,52
5382,0,10654,4063,6591,0,0,0,1.0,1,1.0,1,1.0,1,0.11212935512329726,52
5383,0,10654,4063,6591,0,0,0,1.0,1,1.0,1,1.0,1,0.11669716338541071,51
5384,3,10657,4065,6592,0,0,0,1.0,1,1.0,1,1.0,1,0.0936183749615795,52
5385,2,10659,4066,6593,0,0,0,1.0,1,1.0,1,1.0,1,0.1083203360792337,51
5386,2,10661,4067,6594,0,0,0,1.0,1,1.0,1,1.0,1,0.10767166590219848,52
5387,3,10664,4067,6597,0,0,0,1.0,1,1.0,1,1.0,1,0.0831354570354908,53
5388,2,10666,4068,6598,0,0,0,1.0,1,1.0,1,1.0,1,0.08643490447681927,54
5389,2,10668,4069,6599,0,0,0,1.0,1,1.0,1,1.0,1,0.07641923836423703,55
5390,2,10670,4070,6600,0,0,0,1.0,1,1.0,1,1.0,1,0.08997345262575442,56
5391,3,10673,4072,6601,0,0,0,1.0,1,1.0,1,1.0,1,0.08004188902660425,56
5392,2,10675,4073,6602,0,0,0,1.0,1,1.0,1,1.0,1,0.08504306542722677,56
5393,3,10678,4076,6602,0,0,0,1.0,1,1.0,1,1.0,1,0.08398178641179675,54
5394,2,10680,4077,6603,0,0,0,1.0,1,1.0,1,1.0,1,0.07870857278646254,53
5395,2,10682,4079,6603,0,0,0,1.0,1,1.0,1,1.0,1,0.10761268287973268,53
5396,4,10686,4079,6607,0,0,0,1.0,1,1.0,1,1.0,1,0.08517255162855031,54
5397,1,10687,4079,6608,0,0,0,1.0,1,1.0,1,1.0,1,0.0582003774632758,53
5398,1,10688,4080,6608,0,0,0,1.0,1,1.0,1,1.0,1,0.07047893339949768,53
5399,6,10694,4084,6610,0,0,0,1.0,1,1.0,1,1.0,1,0.11913855517044697,55
5400,5,10699,4084,6615,0,0,0,1.0,1,1.0,1,1.0,1,0.11319046481361027,55
5401,3,10702,4086,6616,0,0,0,1.0,1,1.0,1,1.0,1,0.11848142582701013,56
5402,0,10702,4086,6616,0,0,0,1.0,1,1.0,1,1.0,1,0.0,0
