,SuccessfulHandoverCount,TotalSuccessfulHandoverCount,TotalSuccessfulHandoverCountRange,TotalSuccessfulHandoverCountLoadBalancing,TotalSuccessfulHandoverCountOverload,FailedHandoverCount,TotalFailedHandoverCount,AvgQoS,MinQoS,AvgQoS_LoadBased,MinQoS_LoadBased,AvgQoS_RangeBased,MinQoS_RangeBased,GiniLoad,VehicleCount
0,0,0,0,0,0,0,0,1.0,1,1.0,1,1.0,1,0.0,0
1,27,27,27,0,0,0,0,1.0,1,1.0,1,1.0,1,0.3905046259170005,26
2,21,48,48,0,0,0,0,1.0,1,1.0,1,1.0,1,0.3793838538830105,27
3,18,66,66,0,0,0,0,1.0,1,1.0,1,1.0,1,0.2989232820026153,28
4,19,85,85,0,0,0,0,1.0,1,1.0,1,1.0,1,0.3156896039502257,29
5,20,105,105,0,0,0,0,1.0,1,1.0,1,1.0,1,0.38186577740202965,29
6,10,115,115,0,0,0,0,1.0,1,1.0,1,1.0,1,0.2578966812195085,32
7,12,127,127,0,0,0,0,1.0,1,1.0,1,1.0,1,0.19542688825460758,33
8,18,145,145,0,0,0,0,1.0,1,1.0,1,1.0,1,0.2591264093477705,35
9,21,166,166,0,0,0,0,1.0,1,1.0,1,1.0,1,0.3054145038319389,35
10,18,184,184,0,0,0,0,1.0,1,1.0,1,1.0,1,0.2707802349279975,35
11,14,198,198,0,0,0,0,1.0,1,1.0,1,1.0,1,0.3879603249546353,35
12,12,210,210,0,0,0,0,1.0,1,1.0,1,1.0,1,0.3439353225171717,34
13,13,223,223,0,0,0,0,1.0,1,1.0,1,1.0,1,0.41259472174903283,32
14,9,232,232,0,0,0,0,1.0,1,1.0,1,1.0,1,0.43407040474076924,31
15,12,244,244,0,0,0,0,1.0,1,1.0,1,1.0,1,0.45979083336513016,30
16,9,253,253,0,0,0,0,1.0,1,1.0,1,1.0,1,0.4152640567073253,30
17,6,259,259,0,0,0,0,1.0,1,1.0,1,1.0,1,0.31044030209094353,29
18,8,267,267,0,0,0,0,1.0,1,1.0,1,1.0,1,0.31004409721014253,29
19,8,275,275,0,0,0,0,1.0,1,1.0,1,1.0,1,0.3773299863977065,28
20,7,282,282,0,0,0,0,1.0,1,1.0,1,1.0,1,0.37493769317439957,28
21,7,289,289,0,0,0,0,1.0,1,1.0,1,1.0,1,0.3038264737269074,28
22,10,299,299,0,0,0,0,1.0,1,1.0,1,1.0,1,0.4071182188363583,28
23,9,308,308,0,0,0,0,1.0,1,1.0,1,1.0,1,0.34717960203152265,27
24,12,320,320,0,0,0,0,1.0,1,1.0,1,1.0,1,0.41153370600908057,28
25,9,329,329,0,0,0,0,1.0,1,1.0,1,1.0,1,0.34965947823508026,28
26,14,343,343,0,0,0,0,1.0,1,1.0,1,1.0,1,0.19790114474796044,30
27,15,358,358,0,0,0,0,1.0,1,1.0,1,1.0,1,0.2626867881781276,30
28,7,365,365,0,0,0,0,1.0,1,1.0,1,1.0,1,0.21963033904938373,31
29,8,373,373,0,0,0,0,1.0,1,1.0,1,1.0,1,0.2622404229564622,30
30,6,379,379,0,0,0,0,1.0,1,1.0,1,1.0,1,0.22608287821044692,30
31,6,385,385,0,0,0,0,1.0,1,1.0,1,1.0,1,0.2750801106774929,31
32,5,390,390,0,0,0,0,1.0,1,1.0,1,1.0,1,0.31455861967321885,31
33,16,406,406,0,0,0,0,1.0,1,1.0,1,1.0,1,0.16752714277846958,31
34,10,416,416,0,0,0,0,1.0,1,1.0,1,1.0,1,0.32877592222971086,29
35,13,429,429,0,0,0,0,1.0,1,1.0,1,1.0,1,0.27552808154134195,30
36,14,443,443,0,0,0,0,1.0,1,1.0,1,1.0,1,0.3067991610148014,30
37,11,454,454,0,0,0,0,1.0,1,1.0,1,1.0,1,0.30161527428738494,31
38,16,470,470,0,0,0,0,1.0,1,1.0,1,1.0,1,0.28684402111841784,32
39,11,481,481,0,0,0,0,1.0,1,1.0,1,1.0,1,0.2726138884234451,36
40,10,491,491,0,0,0,0,1.0,1,1.0,1,1.0,1,0.3047072886266699,37
41,12,503,503,0,0,0,0,1.0,1,1.0,1,1.0,1,0.3461253794653765,37
42,10,513,513,0,0,0,0,1.0,1,1.0,1,1.0,1,0.2865692114447036,38
43,15,528,528,0,0,0,0,1.0,1,1.0,1,1.0,1,0.3551698318363256,40
44,10,538,538,0,0,0,0,1.0,1,1.0,1,1.0,1,0.3784125061053523,39
45,11,549,549,0,0,0,0,1.0,1,1.0,1,1.0,1,0.33612232239988926,40
46,11,560,560,0,0,0,0,1.0,1,1.0,1,1.0,1,0.3487237135022875,39
47,12,572,572,0,0,0,0,1.0,1,1.0,1,1.0,1,0.35561066171221467,39
48,4,576,576,0,0,0,0,1.0,1,1.0,1,1.0,1,0.3547133412242818,39
49,5,581,581,0,0,0,0,1.0,1,1.0,1,1.0,1,0.3724762470571141,37
50,9,590,590,0,0,0,0,1.0,1,1.0,1,1.0,1,0.44510847106951956,35
51,14,604,604,0,0,0,0,1.0,1,1.0,1,1.0,1,0.468302040620056,34
52,9,613,613,0,0,0,0,1.0,1,1.0,1,1.0,1,0.4307897820379462,34
53,9,622,622,0,0,0,0,1.0,1,1.0,1,1.0,1,0.3624411693933601,35
54,10,632,632,0,0,0,0,1.0,1,1.0,1,1.0,1,0.31164685921934804,36
55,15,647,647,0,0,0,0,1.0,1,1.0,1,1.0,1,0.29871962935349317,36
56,10,657,657,0,0,0,0,1.0,1,1.0,1,1.0,1,0.41698626928140436,36
57,8,665,665,0,0,0,0,1.0,1,1.0,1,1.0,1,0.3459515568613656,37
58,6,671,671,0,0,0,0,1.0,1,1.0,1,1.0,1,0.40404937525419976,38
59,4,675,675,0,0,0,0,1.0,1,1.0,1,1.0,1,0.49312048153576143,37
60,7,682,682,0,0,0,0,1.0,1,1.0,1,1.0,1,0.44572734073823744,38
61,6,688,688,0,0,0,0,1.0,1,1.0,1,1.0,1,0.4637008755832956,37
62,7,695,695,0,0,0,0,1.0,1,1.0,1,1.0,1,0.39447794090660904,39
63,20,715,715,0,0,0,0,1.0,1,1.0,1,1.0,1,0.3383195298772599,39
64,11,726,726,0,0,0,0,1.0,1,1.0,1,1.0,1,0.3812295992248002,38
65,17,743,743,0,0,0,0,1.0,1,1.0,1,1.0,1,0.39393995396940223,39
66,9,752,752,0,0,0,0,1.0,1,1.0,1,1.0,1,0.37527910509892504,39
67,10,762,762,0,0,0,0,1.0,1,1.0,1,1.0,1,0.27059409704206966,36
68,8,770,770,0,0,0,0,1.0,1,1.0,1,1.0,1,0.33298095952935713,36
69,11,781,781,0,0,0,0,1.0,1,1.0,1,1.0,1,0.3850010040818209,37
70,7,788,788,0,0,0,0,1.0,1,1.0,1,1.0,1,0.4538762170510375,36
71,9,797,797,0,0,0,0,1.0,1,1.0,1,1.0,1,0.4544361562716286,38
72,10,807,807,0,0,0,0,1.0,1,1.0,1,1.0,1,0.5035288930677289,38
73,7,814,814,0,0,0,0,1.0,1,1.0,1,1.0,1,0.49649361563086825,37
74,15,829,829,0,0,0,0,1.0,1,1.0,1,1.0,1,0.44576301461252815,38
75,11,840,840,0,0,0,0,1.0,1,1.0,1,1.0,1,0.4999007979749771,38
76,20,860,860,0,0,0,0,1.0,1,1.0,1,1.0,1,0.46150419336577025,39
77,6,866,866,0,0,0,0,1.0,1,1.0,1,1.0,1,0.41786288393889987,40
78,17,883,883,0,0,0,0,1.0,1,1.0,1,1.0,1,0.4522407202916914,41
79,15,898,898,0,0,0,0,1.0,1,1.0,1,1.0,1,0.3532016335050169,41
80,11,909,909,0,0,0,0,1.0,1,1.0,1,1.0,1,0.4317921276746205,41
81,11,920,920,0,0,0,0,1.0,1,1.0,1,1.0,1,0.5017260430177682,41
82,14,934,934,0,0,0,0,1.0,1,1.0,1,1.0,1,0.4147170548122917,44
83,13,947,947,0,0,0,0,1.0,1,1.0,1,1.0,1,0.412694116392855,44
84,13,960,960,0,0,0,0,1.0,1,1.0,1,1.0,1,0.38627380950857326,45
85,10,970,970,0,0,0,0,1.0,1,1.0,1,1.0,1,0.4055487640058598,45
86,14,984,984,0,0,0,0,1.0,1,1.0,1,1.0,1,0.40886113225278703,45
87,9,993,993,0,0,0,0,1.0,1,1.0,1,1.0,1,0.46378720274244734,44
88,13,1006,1006,0,0,0,0,1.0,1,1.0,1,1.0,1,0.45304407559790955,44
89,9,1015,1015,0,0,0,0,1.0,1,1.0,1,1.0,1,0.5024663735227667,43
90,10,1025,1025,0,0,0,0,1.0,1,1.0,1,1.0,1,0.47307289507153416,44
91,7,1032,1032,0,0,0,0,1.0,1,1.0,1,1.0,1,0.4813029445511747,44
92,12,1044,1044,0,0,0,0,1.0,1,1.0,1,1.0,1,0.4635949453649707,43
93,12,1056,1056,0,0,0,0,1.0,1,1.0,1,1.0,1,0.5127284714762005,44
94,10,1066,1066,0,0,0,0,1.0,1,1.0,1,1.0,1,0.37618676355248365,44
95,21,1087,1087,0,0,0,0,1.0,1,1.0,1,1.0,1,0.5138409589482963,43
96,10,1097,1097,0,0,0,0,1.0,1,1.0,1,1.0,1,0.48516772657061336,44
97,17,1114,1114,0,0,0,0,1.0,1,1.0,1,1.0,1,0.5070548764938654,44
98,11,1125,1125,0,0,0,0,1.0,1,1.0,1,1.0,1,0.42401725532859935,43
99,14,1139,1139,0,0,0,0,1.0,1,1.0,1,1.0,1,0.5027294714523927,43
100,10,1149,1149,0,0,0,0,1.0,1,1.0,1,1.0,1,0.4496930559734885,47
101,10,1159,1159,0,0,0,0,1.0,1,1.0,1,1.0,1,0.4551404587819005,47
102,9,1168,1168,0,0,0,0,1.0,1,1.0,1,1.0,1,0.3200626295360158,47
103,18,1186,1186,0,0,0,0,1.0,1,1.0,1,1.0,1,0.26534484973218836,46
104,16,1202,1202,0,0,0,0,1.0,1,1.0,1,1.0,1,0.2868491997091887,45
105,14,1216,1216,0,0,0,0,1.0,1,1.0,1,1.0,1,0.4425465921414941,44
106,23,1239,1239,0,0,0,0,1.0,1,1.0,1,1.0,1,0.23584511797975785,45
107,20,1259,1259,0,0,0,0,1.0,1,1.0,1,1.0,1,0.3047314456229199,44
108,16,1275,1275,0,0,0,0,1.0,1,1.0,1,1.0,1,0.22175754532438174,46
109,27,1302,1302,0,0,0,0,1.0,1,1.0,1,1.0,1,0.3383576664998906,46
110,19,1321,1321,0,0,0,0,1.0,1,1.0,1,1.0,1,0.4050658088783387,46
111,11,1332,1332,0,0,0,0,1.0,1,1.0,1,1.0,1,0.34747772204455374,46
112,18,1350,1350,0,0,0,0,1.0,1,1.0,1,1.0,1,0.39031906309508674,46
113,9,1359,1359,0,0,0,0,1.0,1,1.0,1,1.0,1,0.30158049569789297,46
114,10,1369,1369,0,0,0,0,1.0,1,1.0,1,1.0,1,0.32615548183255444,46
115,9,1378,1378,0,0,0,0,1.0,1,1.0,1,1.0,1,0.19983644741778325,47
116,16,1394,1394,0,0,0,0,1.0,1,1.0,1,1.0,1,0.36798852455464603,47
117,4,1398,1398,0,0,0,0,1.0,1,1.0,1,1.0,1,0.3769327113409138,45
118,14,1412,1412,0,0,0,0,1.0,1,1.0,1,1.0,1,0.38634353983173353,46
119,18,1430,1430,0,0,0,0,1.0,1,1.0,1,1.0,1,0.37663485914480105,46
120,7,1437,1437,0,0,0,0,1.0,1,1.0,1,1.0,1,0.39970760062228444,47
121,9,1446,1446,0,0,0,0,1.0,1,1.0,1,1.0,1,0.41368998457396133,46
122,4,1450,1450,0,0,0,0,1.0,1,1.0,1,1.0,1,0.4334377515833706,46
123,9,1459,1459,0,0,0,0,1.0,1,1.0,1,1.0,1,0.3928041103749013,45
124,10,1469,1469,0,0,0,0,1.0,1,1.0,1,1.0,1,0.34787474049153394,46
125,11,1480,1480,0,0,0,0,1.0,1,1.0,1,1.0,1,0.3756656965925902,44
126,13,1493,1493,0,0,0,0,1.0,1,1.0,1,1.0,1,0.32725035539701813,45
127,8,1501,1501,0,0,0,0,1.0,1,1.0,1,1.0,1,0.32162321360898544,45
128,9,1510,1510,0,0,0,0,1.0,1,1.0,1,1.0,1,0.31156206775125755,46
129,15,1525,1525,0,0,0,0,1.0,1,1.0,1,1.0,1,0.3042328658743722,48
130,18,1543,1543,0,0,0,0,1.0,1,1.0,1,1.0,1,0.2887272192035815,48
131,20,1563,1563,0,0,0,0,1.0,1,1.0,1,1.0,1,0.33984654205555553,49
132,18,1581,1581,0,0,0,0,1.0,1,1.0,1,1.0,1,0.26767755103688795,51
133,16,1597,1597,0,0,0,0,1.0,1,1.0,1,1.0,1,0.2162754888908657,49
134,12,1609,1609,0,0,0,0,1.0,1,1.0,1,1.0,1,0.1729907113153697,49
135,18,1627,1627,0,0,0,0,1.0,1,1.0,1,1.0,1,0.19938915444263902,49
136,16,1643,1643,0,0,0,0,1.0,1,1.0,1,1.0,1,0.29787182633509557,48
137,16,1659,1659,0,0,0,0,1.0,1,1.0,1,1.0,1,0.24179258202491638,47
138,12,1671,1671,0,0,0,0,1.0,1,1.0,1,1.0,1,0.204924781788822,48
139,17,1688,1688,0,0,0,0,1.0,1,1.0,1,1.0,1,0.38685068596081307,48
140,19,1707,1707,0,0,0,0,1.0,1,1.0,1,1.0,1,0.28112092310183184,49
141,14,1721,1721,0,0,0,0,1.0,1,1.0,1,1.0,1,0.33708179215718226,49
142,12,1733,1733,0,0,0,0,1.0,1,1.0,1,1.0,1,0.37080704620735094,49
143,6,1739,1739,0,0,0,0,1.0,1,1.0,1,1.0,1,0.37971481421231934,47
144,14,1753,1753,0,0,0,0,1.0,1,1.0,1,1.0,1,0.41603168889617875,46
145,6,1759,1759,0,0,0,0,1.0,1,1.0,1,1.0,1,0.40767026342448004,44
146,9,1768,1768,0,0,0,0,1.0,1,1.0,1,1.0,1,0.40711108789204015,44
147,13,1781,1781,0,0,0,0,1.0,1,1.0,1,1.0,1,0.34705197449364006,43
148,15,1796,1796,0,0,0,0,1.0,1,1.0,1,1.0,1,0.3740730115348639,43
149,13,1809,1809,0,0,0,0,1.0,1,1.0,1,1.0,1,0.33845914141459904,43
150,10,1819,1819,0,0,0,0,1.0,1,1.0,1,1.0,1,0.48007917912477915,42
151,4,1823,1823,0,0,0,0,1.0,1,1.0,1,1.0,1,0.4553027572509105,42
152,13,1836,1836,0,0,0,0,1.0,1,1.0,1,1.0,1,0.42901203838622837,42
153,5,1841,1841,0,0,0,0,1.0,1,1.0,1,1.0,1,0.41328050948865797,42
154,9,1850,1850,0,0,0,0,1.0,1,1.0,1,1.0,1,0.3642387562060735,43
155,8,1858,1858,0,0,0,0,1.0,1,1.0,1,1.0,1,0.3597157056630579,43
156,16,1874,1874,0,0,0,0,1.0,1,1.0,1,1.0,1,0.36794507206076144,42
157,15,1889,1889,0,0,0,0,1.0,1,1.0,1,1.0,1,0.3900909478534248,41
158,13,1902,1902,0,0,0,0,1.0,1,1.0,1,1.0,1,0.34683258138928713,42
159,19,1921,1921,0,0,0,0,1.0,1,1.0,1,1.0,1,0.3341238030364607,43
160,17,1938,1938,0,0,0,0,1.0,1,1.0,1,1.0,1,0.38169727915577234,44
161,11,1949,1949,0,0,0,0,1.0,1,1.0,1,1.0,1,0.3715625289448191,44
162,11,1960,1960,0,0,0,0,1.0,1,1.0,1,1.0,1,0.3796981414313702,45
163,9,1969,1969,0,0,0,0,1.0,1,1.0,1,1.0,1,0.35856429490762914,43
164,18,1987,1987,0,0,0,0,1.0,1,1.0,1,1.0,1,0.2951353528654207,42
165,6,1993,1993,0,0,0,0,1.0,1,1.0,1,1.0,1,0.233052202171924,42
166,11,2004,2004,0,0,0,0,1.0,1,1.0,1,1.0,1,0.2822210396217394,42
167,12,2016,2016,0,0,0,0,1.0,1,1.0,1,1.0,1,0.22996753272547363,41
168,13,2029,2029,0,0,0,0,1.0,1,1.0,1,1.0,1,0.20231545241662338,40
169,11,2040,2040,0,0,0,0,1.0,1,1.0,1,1.0,1,0.19218580440459873,40
170,10,2050,2050,0,0,0,0,1.0,1,1.0,1,1.0,1,0.23692161878703188,38
171,12,2062,2062,0,0,0,0,1.0,1,1.0,1,1.0,1,0.20774132739467993,37
172,14,2076,2076,0,0,0,0,1.0,1,1.0,1,1.0,1,0.35413189827596014,35
173,11,2087,2087,0,0,0,0,1.0,1,1.0,1,1.0,1,0.30590187742433417,36
174,9,2096,2096,0,0,0,0,1.0,1,1.0,1,1.0,1,0.29986870583222,34
175,12,2108,2108,0,0,0,0,1.0,1,1.0,1,1.0,1,0.3725823090910548,33
176,17,2125,2125,0,0,0,0,1.0,1,1.0,1,1.0,1,0.38791619474223643,34
177,18,2143,2143,0,0,0,0,1.0,1,1.0,1,1.0,1,0.41105381161007415,36
178,11,2154,2154,0,0,0,0,1.0,1,1.0,1,1.0,1,0.2347411308289841,37
179,10,2164,2164,0,0,0,0,1.0,1,1.0,1,1.0,1,0.27927701156981927,37
180,10,2174,2174,0,0,0,0,1.0,1,1.0,1,1.0,1,0.33936791478114126,36
181,8,2182,2182,0,0,0,0,1.0,1,1.0,1,1.0,1,0.36631342146288753,36
182,8,2190,2190,0,0,0,0,1.0,1,1.0,1,1.0,1,0.382325068571728,38
183,19,2209,2209,0,0,0,0,1.0,1,1.0,1,1.0,1,0.37385655765739234,37
184,7,2216,2216,0,0,0,0,1.0,1,1.0,1,1.0,1,0.31788898787532605,36
185,14,2230,2230,0,0,0,0,1.0,1,1.0,1,1.0,1,0.19935228015459555,35
186,10,2240,2240,0,0,0,0,1.0,1,1.0,1,1.0,1,0.33813903573269477,34
187,17,2257,2257,0,0,0,0,1.0,1,1.0,1,1.0,1,0.2967847862551724,33
188,12,2269,2269,0,0,0,0,1.0,1,1.0,1,1.0,1,0.22738373670498938,33
189,18,2287,2287,0,0,0,0,1.0,1,1.0,1,1.0,1,0.3177599884523616,33
190,20,2307,2307,0,0,0,0,1.0,1,1.0,1,1.0,1,0.389383136639841,32
191,11,2318,2318,0,0,0,0,1.0,1,1.0,1,1.0,1,0.3298342548140356,34
192,12,2330,2330,0,0,0,0,1.0,1,1.0,1,1.0,1,0.46113226171035276,34
193,12,2342,2342,0,0,0,0,1.0,1,1.0,1,1.0,1,0.37173730513602854,35
194,17,2359,2359,0,0,0,0,1.0,1,1.0,1,1.0,1,0.3968171481709909,37
195,13,2372,2372,0,0,0,0,1.0,1,1.0,1,1.0,1,0.37898259896355474,36
196,9,2381,2381,0,0,0,0,1.0,1,1.0,1,1.0,1,0.3801400074811383,36
197,6,2387,2387,0,0,0,0,1.0,1,1.0,1,1.0,1,0.41641283849073185,37
198,8,2395,2395,0,0,0,0,1.0,1,1.0,1,1.0,1,0.3590473056183231,37
199,15,2410,2410,0,0,0,0,1.0,1,1.0,1,1.0,1,0.36981384201833256,37
200,7,2417,2417,0,0,0,0,1.0,1,1.0,1,1.0,1,0.4464503191420209,37
201,9,2426,2426,0,0,0,0,1.0,1,1.0,1,1.0,1,0.41983809905952546,36
202,9,2435,2435,0,0,0,0,1.0,1,1.0,1,1.0,1,0.33632307280337626,36
203,7,2442,2442,0,0,0,0,1.0,1,1.0,1,1.0,1,0.35432281700376084,35
204,11,2453,2453,0,0,0,0,1.0,1,1.0,1,1.0,1,0.34994100657424937,35
205,8,2461,2461,0,0,0,0,1.0,1,1.0,1,1.0,1,0.2826330629542557,35
206,12,2473,2473,0,0,0,0,1.0,1,1.0,1,1.0,1,0.3039101160460791,34
207,12,2485,2485,0,0,0,0,1.0,1,1.0,1,1.0,1,0.3015456343794623,34
208,13,2498,2498,0,0,0,0,1.0,1,1.0,1,1.0,1,0.22259647924217937,33
209,14,2512,2512,0,0,0,0,1.0,1,1.0,1,1.0,1,0.175626119651274,33
210,16,2528,2528,0,0,0,0,1.0,1,1.0,1,1.0,1,0.2958061601635724,34
211,14,2542,2542,0,0,0,0,1.0,1,1.0,1,1.0,1,0.2904609940262452,33
212,10,2552,2552,0,0,0,0,1.0,1,1.0,1,1.0,1,0.3480938346391626,33
213,16,2568,2568,0,0,0,0,1.0,1,1.0,1,1.0,1,0.2202247190472588,35
214,17,2585,2585,0,0,0,0,1.0,1,1.0,1,1.0,1,0.3406154360651531,34
215,11,2596,2596,0,0,0,0,1.0,1,1.0,1,1.0,1,0.4052653258786755,35
216,18,2614,2614,0,0,0,0,1.0,1,1.0,1,1.0,1,0.42822815700997774,36
217,7,2621,2621,0,0,0,0,1.0,1,1.0,1,1.0,1,0.39983893216027877,36
218,9,2630,2630,0,0,0,0,1.0,1,1.0,1,1.0,1,0.458456134234016,36
219,10,2640,2640,0,0,0,0,1.0,1,1.0,1,1.0,1,0.32514220406168665,37
220,18,2658,2658,0,0,0,0,1.0,1,1.0,1,1.0,1,0.3593960308131843,38
221,15,2673,2673,0,0,0,0,1.0,1,1.0,1,1.0,1,0.23973168931767538,37
222,13,2686,2686,0,0,0,0,1.0,1,1.0,1,1.0,1,0.2636956570852881,38
223,10,2696,2696,0,0,0,0,1.0,1,1.0,1,1.0,1,0.33025711543566877,38
224,17,2713,2713,0,0,0,0,1.0,1,1.0,1,1.0,1,0.3824044655339028,38
225,12,2725,2725,0,0,0,0,1.0,1,1.0,1,1.0,1,0.3444689883352763,36
226,10,2735,2735,0,0,0,0,1.0,1,1.0,1,1.0,1,0.33202930165217515,37
227,10,2745,2745,0,0,0,0,1.0,1,1.0,1,1.0,1,0.25927747385737093,35
228,9,2754,2754,0,0,0,0,1.0,1,1.0,1,1.0,1,0.23485029440149258,35
229,13,2767,2767,0,0,0,0,1.0,1,1.0,1,1.0,1,0.283565434154337,35
230,6,2773,2773,0,0,0,0,1.0,1,1.0,1,1.0,1,0.38158330311803185,35
231,7,2780,2780,0,0,0,0,1.0,1,1.0,1,1.0,1,0.3497375313508785,35
232,6,2786,2786,0,0,0,0,1.0,1,1.0,1,1.0,1,0.4156126711209813,36
233,8,2794,2794,0,0,0,0,1.0,1,1.0,1,1.0,1,0.3603047397245984,36
234,4,2798,2798,0,0,0,0,1.0,1,1.0,1,1.0,1,0.4169064401958755,34
235,7,2805,2805,0,0,0,0,1.0,1,1.0,1,1.0,1,0.3305896103907386,33
236,5,2810,2810,0,0,0,0,1.0,1,1.0,1,1.0,1,0.40974355138597923,31
237,5,2815,2815,0,0,0,0,1.0,1,1.0,1,1.0,1,0.4592703052204103,32
238,12,2827,2827,0,0,0,0,1.0,1,1.0,1,1.0,1,0.3855815852240462,31
239,10,2837,2837,0,0,0,0,1.0,1,1.0,1,1.0,1,0.2591327030653206,30
240,9,2846,2846,0,0,0,0,1.0,1,1.0,1,1.0,1,0.2903469369531495,27
241,12,2858,2858,0,0,0,0,1.0,1,1.0,1,1.0,1,0.23002689163376042,27
242,12,2870,2870,0,0,0,0,1.0,1,1.0,1,1.0,1,0.3074644047747827,28
243,14,2884,2884,0,0,0,0,1.0,1,1.0,1,1.0,1,0.3484283847611593,28
244,13,2897,2897,0,0,0,0,1.0,1,1.0,1,1.0,1,0.2980526197958543,27
245,16,2913,2913,0,0,0,0,1.0,1,1.0,1,1.0,1,0.3856105470230392,27
246,9,2922,2922,0,0,0,0,1.0,1,1.0,1,1.0,1,0.43269870428792684,25
247,7,2929,2929,0,0,0,0,1.0,1,1.0,1,1.0,1,0.44640508543221635,24
248,11,2940,2940,0,0,0,0,1.0,1,1.0,1,1.0,1,0.4758568862211829,24
249,11,2951,2951,0,0,0,0,1.0,1,1.0,1,1.0,1,0.47768480347772346,25
250,15,2966,2966,0,0,0,0,1.0,1,1.0,1,1.0,1,0.4133457146432241,27
251,9,2975,2975,0,0,0,0,1.0,1,1.0,1,1.0,1,0.4379794011814555,27
252,12,2987,2987,0,0,0,0,1.0,1,1.0,1,1.0,1,0.3622207494566368,27
253,15,3002,3002,0,0,0,0,1.0,1,1.0,1,1.0,1,0.41887358575417566,29
254,11,3013,3013,0,0,0,0,1.0,1,1.0,1,1.0,1,0.3384728918725457,30
255,20,3033,3033,0,0,0,0,1.0,1,1.0,1,1.0,1,0.2958921479481672,31
256,14,3047,3047,0,0,0,0,1.0,1,1.0,1,1.0,1,0.3533235673124131,31
257,10,3057,3057,0,0,0,0,1.0,1,1.0,1,1.0,1,0.3601145528827115,33
258,11,3068,3068,0,0,0,0,1.0,1,1.0,1,1.0,1,0.2580007436436189,33
259,14,3082,3082,0,0,0,0,1.0,1,1.0,1,1.0,1,0.33170329050048925,33
260,4,3086,3086,0,0,0,0,1.0,1,1.0,1,1.0,1,0.3878622097924764,35
261,9,3095,3095,0,0,0,0,1.0,1,1.0,1,1.0,1,0.4206670672943825,35
262,8,3103,3103,0,0,0,0,1.0,1,1.0,1,1.0,1,0.41361648314733523,35
263,2,3105,3105,0,0,0,0,1.0,1,1.0,1,1.0,1,0.46709922401091825,34
264,3,3108,3108,0,0,0,0,1.0,1,1.0,1,1.0,1,0.4968308054109901,32
265,5,3113,3113,0,0,0,0,1.0,1,1.0,1,1.0,1,0.5199786884897339,30
266,10,3123,3123,0,0,0,0,1.0,1,1.0,1,1.0,1,0.4984530132497159,31
267,12,3135,3135,0,0,0,0,1.0,1,1.0,1,1.0,1,0.4743911014168952,30
268,11,3146,3146,0,0,0,0,1.0,1,1.0,1,1.0,1,0.4279157301511774,31
269,13,3159,3159,0,0,0,0,1.0,1,1.0,1,1.0,1,0.4622038090971716,31
270,12,3171,3171,0,0,0,0,1.0,1,1.0,1,1.0,1,0.46026642432486653,32
271,9,3180,3180,0,0,0,0,1.0,1,1.0,1,1.0,1,0.4546755955343613,31
272,15,3195,3195,0,0,0,0,1.0,1,1.0,1,1.0,1,0.504308403796414,32
273,10,3205,3205,0,0,0,0,1.0,1,1.0,1,1.0,1,0.48134863070249473,32
274,4,3209,3209,0,0,0,0,1.0,1,1.0,1,1.0,1,0.4482895505151134,32
275,7,3216,3216,0,0,0,0,1.0,1,1.0,1,1.0,1,0.44109014540421965,33
276,10,3226,3226,0,0,0,0,1.0,1,1.0,1,1.0,1,0.4685507185956032,34
277,9,3235,3235,0,0,0,0,1.0,1,1.0,1,1.0,1,0.4579906738119146,32
278,7,3242,3242,0,0,0,0,1.0,1,1.0,1,1.0,1,0.3599576915167704,31
279,11,3253,3253,0,0,0,0,1.0,1,1.0,1,1.0,1,0.4342037986908442,31
280,17,3270,3270,0,0,0,0,1.0,1,1.0,1,1.0,1,0.32687887756029116,30
281,19,3289,3289,0,0,0,0,1.0,1,1.0,1,1.0,1,0.3691236285194085,31
282,14,3303,3303,0,0,0,0,1.0,1,1.0,1,1.0,1,0.3998716330430806,30
283,16,3319,3319,0,0,0,0,1.0,1,1.0,1,1.0,1,0.32803700048951234,31
284,15,3334,3334,0,0,0,0,1.0,1,1.0,1,1.0,1,0.34024856207019394,31
285,12,3346,3346,0,0,0,0,1.0,1,1.0,1,1.0,1,0.33190121597765154,31
286,6,3352,3352,0,0,0,0,1.0,1,1.0,1,1.0,1,0.37174129849450027,31
287,4,3356,3356,0,0,0,0,1.0,1,1.0,1,1.0,1,0.2906904051875497,33
288,10,3366,3366,0,0,0,0,1.0,1,1.0,1,1.0,1,0.3724590063468182,32
289,10,3376,3376,0,0,0,0,1.0,1,1.0,1,1.0,1,0.27961398071734306,32
290,7,3383,3383,0,0,0,0,1.0,1,1.0,1,1.0,1,0.28759721621340634,31
291,11,3394,3394,0,0,0,0,1.0,1,1.0,1,1.0,1,0.3468813227369297,30
292,11,3405,3405,0,0,0,0,1.0,1,1.0,1,1.0,1,0.29523180502163016,32
293,9,3414,3414,0,0,0,0,1.0,1,1.0,1,1.0,1,0.23034521965622307,32
294,11,3425,3425,0,0,0,0,1.0,1,1.0,1,1.0,1,0.23761117414961655,32
295,8,3433,3433,0,0,0,0,1.0,1,1.0,1,1.0,1,0.3548842011071407,34
296,9,3442,3442,0,0,0,0,1.0,1,1.0,1,1.0,1,0.29688952749926467,34
297,5,3447,3447,0,0,0,0,1.0,1,1.0,1,1.0,1,0.35562428563794496,34
298,6,3453,3453,0,0,0,0,1.0,1,1.0,1,1.0,1,0.2998483451603966,35
299,15,3468,3468,0,0,0,0,1.0,1,1.0,1,1.0,1,0.31019461832152184,35
300,15,3483,3483,0,0,0,0,1.0,1,1.0,1,1.0,1,0.32986151843039785,35
301,14,3497,3497,0,0,0,0,1.0,1,1.0,1,1.0,1,0.30222134206747125,38
302,18,3515,3515,0,0,0,0,1.0,1,1.0,1,1.0,1,0.3669768998476656,38
303,16,3531,3531,0,0,0,0,1.0,1,1.0,1,1.0,1,0.4386715470827518,37
304,16,3547,3547,0,0,0,0,1.0,1,1.0,1,1.0,1,0.41173653766353285,37
305,6,3553,3553,0,0,0,0,1.0,1,1.0,1,1.0,1,0.258799542608317,36
306,12,3565,3565,0,0,0,0,1.0,1,1.0,1,1.0,1,0.22586550377694298,36
307,8,3573,3573,0,0,0,0,1.0,1,1.0,1,1.0,1,0.2036189187811443,35
308,10,3583,3583,0,0,0,0,1.0,1,1.0,1,1.0,1,0.2024665862101061,37
309,10,3593,3593,0,0,0,0,1.0,1,1.0,1,1.0,1,0.24991929893900494,37
310,5,3598,3598,0,0,0,0,1.0,1,1.0,1,1.0,1,0.2446739212474064,37
311,8,3606,3606,0,0,0,0,1.0,1,1.0,1,1.0,1,0.22366268937215336,39
312,13,3619,3619,0,0,0,0,1.0,1,1.0,1,1.0,1,0.2549766543626583,40
313,12,3631,3631,0,0,0,0,1.0,1,1.0,1,1.0,1,0.18225247645797424,39
314,17,3648,3648,0,0,0,0,1.0,1,1.0,1,1.0,1,0.2512422487248069,40
315,11,3659,3659,0,0,0,0,1.0,1,1.0,1,1.0,1,0.2846144799357841,39
316,6,3665,3665,0,0,0,0,1.0,1,1.0,1,1.0,1,0.35138061323864567,39
317,14,3679,3679,0,0,0,0,1.0,1,1.0,1,1.0,1,0.32512140930954336,40
318,15,3694,3694,0,0,0,0,1.0,1,1.0,1,1.0,1,0.3163513416069182,41
319,12,3706,3706,0,0,0,0,1.0,1,1.0,1,1.0,1,0.3748159565475989,41
320,12,3718,3718,0,0,0,0,1.0,1,1.0,1,1.0,1,0.3468611715982411,41
321,10,3728,3728,0,0,0,0,1.0,1,1.0,1,1.0,1,0.35237217881242483,41
322,19,3747,3747,0,0,0,0,1.0,1,1.0,1,1.0,1,0.3225716649077273,41
323,20,3767,3767,0,0,0,0,1.0,1,1.0,1,1.0,1,0.4525227517943005,41
324,20,3787,3787,0,0,0,0,1.0,1,1.0,1,1.0,1,0.36109963488445396,42
325,12,3799,3799,0,0,0,0,1.0,1,1.0,1,1.0,1,0.3212424135308921,42
326,4,3803,3803,0,0,0,0,1.0,1,1.0,1,1.0,1,0.3313666635976147,42
327,6,3809,3809,0,0,0,0,1.0,1,1.0,1,1.0,1,0.2987507710767692,42
328,5,3814,3814,0,0,0,0,1.0,1,1.0,1,1.0,1,0.3023787867885356,43
329,14,3828,3828,0,0,0,0,1.0,1,1.0,1,1.0,1,0.3149590539589441,43
330,6,3834,3834,0,0,0,0,1.0,1,1.0,1,1.0,1,0.34784932209500563,45
331,17,3851,3851,0,0,0,0,1.0,1,1.0,1,1.0,1,0.3015582316374008,45
332,11,3862,3862,0,0,0,0,1.0,1,1.0,1,1.0,1,0.25800787081194354,45
333,11,3873,3873,0,0,0,0,1.0,1,1.0,1,1.0,1,0.36249767808632233,46
334,5,3878,3878,0,0,0,0,1.0,1,1.0,1,1.0,1,0.3942107450389012,48
335,8,3886,3886,0,0,0,0,1.0,1,1.0,1,1.0,1,0.365192327633296,48
336,7,3893,3893,0,0,0,0,1.0,1,1.0,1,1.0,1,0.31391402841278027,48
337,12,3905,3905,0,0,0,0,1.0,1,1.0,1,1.0,1,0.3708632553330034,49
338,8,3913,3913,0,0,0,0,1.0,1,1.0,1,1.0,1,0.30481036208122425,50
339,3,3916,3916,0,0,0,0,1.0,1,1.0,1,1.0,1,0.29470874853942414,50
340,8,3924,3924,0,0,0,0,1.0,1,1.0,1,1.0,1,0.2814737064600927,50
341,5,3929,3929,0,0,0,0,1.0,1,1.0,1,1.0,1,0.28700672801904614,51
342,8,3937,3937,0,0,0,0,1.0,1,1.0,1,1.0,1,0.30916870180540246,51
343,9,3946,3946,0,0,0,0,1.0,1,1.0,1,1.0,1,0.25831188509509634,51
344,17,3963,3963,0,0,0,0,1.0,1,1.0,1,1.0,1,0.17380414209892492,50
345,17,3980,3980,0,0,0,0,1.0,1,1.0,1,1.0,1,0.3288970390041049,51
346,12,3992,3992,0,0,0,0,1.0,1,1.0,1,1.0,1,0.24578424242041746,51
347,14,4006,4006,0,0,0,0,1.0,1,1.0,1,1.0,1,0.28204949057858986,51
348,17,4023,4023,0,0,0,0,1.0,1,1.0,1,1.0,1,0.3590577642561464,53
349,12,4035,4035,0,0,0,0,1.0,1,1.0,1,1.0,1,0.30374733823806105,55
350,14,4049,4049,0,0,0,0,1.0,1,1.0,1,1.0,1,0.3110048309515461,54
351,15,4064,4064,0,0,0,0,1.0,1,1.0,1,1.0,1,0.387130507813699,54
352,13,4077,4077,0,0,0,0,1.0,1,1.0,1,1.0,1,0.32488020512465476,53
353,9,4086,4086,0,0,0,0,1.0,1,1.0,1,1.0,1,0.3865222081388976,53
354,14,4100,4100,0,0,0,0,1.0,1,1.0,1,1.0,1,0.3629869242452274,50
355,11,4111,4111,0,0,0,0,1.0,1,1.0,1,1.0,1,0.33075495279698613,51
356,16,4127,4127,0,0,0,0,1.0,1,1.0,1,1.0,1,0.31135724700981915,51
357,16,4143,4143,0,0,0,0,1.0,1,1.0,1,1.0,1,0.36431995352181423,50
358,17,4160,4160,0,0,0,0,1.0,1,1.0,1,1.0,1,0.30414364827542867,48
359,9,4169,4169,0,0,0,0,1.0,1,1.0,1,1.0,1,0.3537995026126345,47
360,12,4181,4181,0,0,0,0,1.0,1,1.0,1,1.0,1,0.3980609616500519,45
361,9,4190,4190,0,0,0,0,1.0,1,1.0,1,1.0,1,0.2952310859242888,44
362,9,4199,4199,0,0,0,0,1.0,1,1.0,1,1.0,1,0.3333505754446327,44
363,12,4211,4211,0,0,0,0,1.0,1,1.0,1,1.0,1,0.27810794160496394,44
364,7,4218,4218,0,0,0,0,1.0,1,1.0,1,1.0,1,0.24838846054049926,43
365,10,4228,4228,0,0,0,0,1.0,1,1.0,1,1.0,1,0.3173734539003714,43
366,12,4240,4240,0,0,0,0,1.0,1,1.0,1,1.0,1,0.2976604082300148,45
367,5,4245,4245,0,0,0,0,1.0,1,1.0,1,1.0,1,0.3532947444043681,44
368,7,4252,4252,0,0,0,0,1.0,1,1.0,1,1.0,1,0.34162522005628565,46
369,9,4261,4261,0,0,0,0,1.0,1,1.0,1,1.0,1,0.3853061112804202,45
370,10,4271,4271,0,0,0,0,1.0,1,1.0,1,1.0,1,0.33143265312811926,46
371,12,4283,4283,0,0,0,0,1.0,1,1.0,1,1.0,1,0.334113198751505,47
372,10,4293,4293,0,0,0,0,1.0,1,1.0,1,1.0,1,0.3191759925201226,48
373,10,4303,4303,0,0,0,0,1.0,1,1.0,1,1.0,1,0.268734028907256,48
374,20,4323,4323,0,0,0,0,1.0,1,1.0,1,1.0,1,0.3433738407075538,49
375,14,4337,4337,0,0,0,0,1.0,1,1.0,1,1.0,1,0.23869613587418334,49
376,17,4354,4354,0,0,0,0,1.0,1,1.0,1,1.0,1,0.348006772709748,49
377,6,4360,4360,0,0,0,0,1.0,1,1.0,1,1.0,1,0.23620535916803911,49
378,14,4374,4374,0,0,0,0,1.0,1,1.0,1,1.0,1,0.2660431768367715,49
379,12,4386,4386,0,0,0,0,1.0,1,1.0,1,1.0,1,0.27979351099381433,50
380,12,4398,4398,0,0,0,0,1.0,1,1.0,1,1.0,1,0.2703595796567228,50
381,15,4413,4413,0,0,0,0,1.0,1,1.0,1,1.0,1,0.28623600503620783,51
382,9,4422,4422,0,0,0,0,1.0,1,1.0,1,1.0,1,0.3221890767512008,50
383,13,4435,4435,0,0,0,0,1.0,1,1.0,1,1.0,1,0.30862726906271665,51
384,9,4444,4444,0,0,0,0,1.0,1,1.0,1,1.0,1,0.2956999582520586,50
385,14,4458,4458,0,0,0,0,1.0,1,1.0,1,1.0,1,0.40192395683938914,50
386,15,4473,4473,0,0,0,0,1.0,1,1.0,1,1.0,1,0.3848612166115674,48
387,14,4487,4487,0,0,0,0,1.0,1,1.0,1,1.0,1,0.318693726339854,47
388,15,4502,4502,0,0,0,0,1.0,1,1.0,1,1.0,1,0.3515869449736148,48
389,12,4514,4514,0,0,0,0,1.0,1,1.0,1,1.0,1,0.3910170185841867,47
390,18,4532,4532,0,0,0,0,1.0,1,1.0,1,1.0,1,0.3485387551746906,49
391,19,4551,4551,0,0,0,0,1.0,1,1.0,1,1.0,1,0.4302573000866049,46
392,13,4564,4564,0,0,0,0,1.0,1,1.0,1,1.0,1,0.4356084042171198,46
393,18,4582,4582,0,0,0,0,1.0,1,1.0,1,1.0,1,0.35687970152879206,44
394,19,4601,4601,0,0,0,0,1.0,1,1.0,1,1.0,1,0.39324468843415383,43
395,20,4621,4621,0,0,0,0,1.0,1,1.0,1,1.0,1,0.4114880250684339,42
396,23,4644,4644,0,0,0,0,1.0,1,1.0,1,1.0,1,0.3307733307362663,39
397,16,4660,4660,0,0,0,0,1.0,1,1.0,1,1.0,1,0.3625223027565764,39
398,19,4679,4679,0,0,0,0,1.0,1,1.0,1,1.0,1,0.358541702415205,36
399,9,4688,4688,0,0,0,0,1.0,1,1.0,1,1.0,1,0.3760527962752845,36
400,11,4699,4699,0,0,0,0,1.0,1,1.0,1,1.0,1,0.33951460911289894,34
401,11,4710,4710,0,0,0,0,1.0,1,1.0,1,1.0,1,0.3205514042647274,33
402,17,4727,4727,0,0,0,0,1.0,1,1.0,1,1.0,1,0.2717753965417763,34
403,13,4740,4740,0,0,0,0,1.0,1,1.0,1,1.0,1,0.38235951883554964,36
404,21,4761,4761,0,0,0,0,1.0,1,1.0,1,1.0,1,0.36105554571869225,36
405,13,4774,4774,0,0,0,0,1.0,1,1.0,1,1.0,1,0.2399744577010015,37
406,10,4784,4784,0,0,0,0,1.0,1,1.0,1,1.0,1,0.47320873214777076,37
407,12,4796,4796,0,0,0,0,1.0,1,1.0,1,1.0,1,0.2829761503528581,39
408,19,4815,4815,0,0,0,0,1.0,1,1.0,1,1.0,1,0.30321175777846326,40
409,10,4825,4825,0,0,0,0,1.0,1,1.0,1,1.0,1,0.4116982841053116,41
410,16,4841,4841,0,0,0,0,1.0,1,1.0,1,1.0,1,0.3942300450879502,42
411,11,4852,4852,0,0,0,0,1.0,1,1.0,1,1.0,1,0.37657917050629297,43
412,9,4861,4861,0,0,0,0,1.0,1,1.0,1,1.0,1,0.3667667963762303,44
413,12,4873,4873,0,0,0,0,1.0,1,1.0,1,1.0,1,0.45406992413807723,44
414,11,4884,4884,0,0,0,0,1.0,1,1.0,1,1.0,1,0.44128165885610976,45
415,10,4894,4894,0,0,0,0,1.0,1,1.0,1,1.0,1,0.48816364177988364,45
416,7,4901,4901,0,0,0,0,1.0,1,1.0,1,1.0,1,0.3916878228985992,46
417,15,4916,4916,0,0,0,0,1.0,1,1.0,1,1.0,1,0.4603750131733553,46
418,10,4926,4926,0,0,0,0,1.0,1,1.0,1,1.0,1,0.4444060750790377,47
419,6,4932,4932,0,0,0,0,1.0,1,1.0,1,1.0,1,0.43889584070092136,47
420,8,4940,4940,0,0,0,0,1.0,1,1.0,1,1.0,1,0.35323337204066163,47
421,6,4946,4946,0,0,0,0,1.0,1,1.0,1,1.0,1,0.4140508956397534,47
422,9,4955,4955,0,0,0,0,1.0,1,1.0,1,1.0,1,0.3567555054850262,49
423,6,4961,4961,0,0,0,0,1.0,1,1.0,1,1.0,1,0.35648528143500413,47
424,17,4978,4978,0,0,0,0,1.0,1,1.0,1,1.0,1,0.3509952642001951,45
425,17,4995,4995,0,0,0,0,1.0,1,1.0,1,1.0,1,0.3481240264681106,46
426,20,5015,5015,0,0,0,0,1.0,1,1.0,1,1.0,1,0.38326455151801,46
427,21,5036,5036,0,0,0,0,1.0,1,1.0,1,1.0,1,0.2813594792456256,45
428,19,5055,5055,0,0,0,0,1.0,1,1.0,1,1.0,1,0.2878303241469155,45
429,17,5072,5072,0,0,0,0,1.0,1,1.0,1,1.0,1,0.23760294262431036,42
430,10,5082,5082,0,0,0,0,1.0,1,1.0,1,1.0,1,0.1985134425564609,40
431,14,5096,5096,0,0,0,0,1.0,1,1.0,1,1.0,1,0.31364649869335426,39
432,8,5104,5104,0,0,0,0,1.0,1,1.0,1,1.0,1,0.28917926773933933,37
433,7,5111,5111,0,0,0,0,1.0,1,1.0,1,1.0,1,0.3464335676254982,35
434,5,5116,5116,0,0,0,0,1.0,1,1.0,1,1.0,1,0.37379881702276674,33
435,9,5125,5125,0,0,0,0,1.0,1,1.0,1,1.0,1,0.36829747330969054,33
436,6,5131,5131,0,0,0,0,1.0,1,1.0,1,1.0,1,0.29900051686508383,33
437,9,5140,5140,0,0,0,0,1.0,1,1.0,1,1.0,1,0.2512265328200164,33
438,7,5147,5147,0,0,0,0,1.0,1,1.0,1,1.0,1,0.39245353360525337,32
439,9,5156,5156,0,0,0,0,1.0,1,1.0,1,1.0,1,0.36440633937966943,34
440,12,5168,5168,0,0,0,0,1.0,1,1.0,1,1.0,1,0.1592512453041607,34
441,9,5177,5177,0,0,0,0,1.0,1,1.0,1,1.0,1,0.18748373498104456,35
442,12,5189,5189,0,0,0,0,1.0,1,1.0,1,1.0,1,0.2003383547267066,37
443,14,5203,5203,0,0,0,0,1.0,1,1.0,1,1.0,1,0.29052799567265297,37
444,9,5212,5212,0,0,0,0,1.0,1,1.0,1,1.0,1,0.36291694059281837,38
445,11,5223,5223,0,0,0,0,1.0,1,1.0,1,1.0,1,0.37233288137231957,39
446,12,5235,5235,0,0,0,0,1.0,1,1.0,1,1.0,1,0.40561052869871345,39
447,10,5245,5245,0,0,0,0,1.0,1,1.0,1,1.0,1,0.35659459816773603,41
448,13,5258,5258,0,0,0,0,1.0,1,1.0,1,1.0,1,0.37030522565210566,41
449,9,5267,5267,0,0,0,0,1.0,1,1.0,1,1.0,1,0.31505406475656744,40
450,6,5273,5273,0,0,0,0,1.0,1,1.0,1,1.0,1,0.4537342002513372,40
451,18,5291,5291,0,0,0,0,1.0,1,1.0,1,1.0,1,0.2827320777935772,41
452,13,5304,5304,0,0,0,0,1.0,1,1.0,1,1.0,1,0.2879251741332077,41
453,23,5327,5327,0,0,0,0,1.0,1,1.0,1,1.0,1,0.2690906820668203,40
454,8,5335,5335,0,0,0,0,1.0,1,1.0,1,1.0,1,0.2424985656571994,41
455,25,5360,5360,0,0,0,0,1.0,1,1.0,1,1.0,1,0.32502322208535694,41
456,15,5375,5375,0,0,0,0,1.0,1,1.0,1,1.0,1,0.32429347797015806,43
457,21,5396,5396,0,0,0,0,1.0,1,1.0,1,1.0,1,0.34095413421466714,43
458,10,5406,5406,0,0,0,0,1.0,1,1.0,1,1.0,1,0.32786026085923453,43
459,11,5417,5417,0,0,0,0,1.0,1,1.0,1,1.0,1,0.2882896868996641,44
460,14,5431,5431,0,0,0,0,1.0,1,1.0,1,1.0,1,0.2303093843935203,47
461,12,5443,5443,0,0,0,0,1.0,1,1.0,1,1.0,1,0.20954684152783043,48
462,11,5454,5454,0,0,0,0,1.0,1,1.0,1,1.0,1,0.2563092688893946,49
463,3,5457,5457,0,0,0,0,1.0,1,1.0,1,1.0,1,0.22951779979548087,47
464,5,5462,5462,0,0,0,0,1.0,1,1.0,1,1.0,1,0.23152031632480718,48
465,11,5473,5473,0,0,0,0,1.0,1,1.0,1,1.0,1,0.25721639462421403,47
466,6,5479,5479,0,0,0,0,1.0,1,1.0,1,1.0,1,0.2509919687460355,46
467,8,5487,5487,0,0,0,0,1.0,1,1.0,1,1.0,1,0.2591571794739033,44
468,11,5498,5498,0,0,0,0,1.0,1,1.0,1,1.0,1,0.26461698509412507,41
469,7,5505,5505,0,0,0,0,1.0,1,1.0,1,1.0,1,0.2811187561876802,40
470,11,5516,5516,0,0,0,0,1.0,1,1.0,1,1.0,1,0.29673729879296135,39
471,13,5529,5529,0,0,0,0,1.0,1,1.0,1,1.0,1,0.3638973996771582,38
472,7,5536,5536,0,0,0,0,1.0,1,1.0,1,1.0,1,0.3644844559806625,36
473,8,5544,5544,0,0,0,0,1.0,1,1.0,1,1.0,1,0.3926276871770817,36
474,7,5551,5551,0,0,0,0,1.0,1,1.0,1,1.0,1,0.3428190684058669,34
475,6,5557,5557,0,0,0,0,1.0,1,1.0,1,1.0,1,0.36129659381129453,34
476,5,5562,5562,0,0,0,0,1.0,1,1.0,1,1.0,1,0.3635517822430009,32
477,8,5570,5570,0,0,0,0,1.0,1,1.0,1,1.0,1,0.3512626185699501,32
478,5,5575,5575,0,0,0,0,1.0,1,1.0,1,1.0,1,0.3772761975798014,30
479,10,5585,5585,0,0,0,0,1.0,1,1.0,1,1.0,1,0.2889896098710562,31
480,10,5595,5595,0,0,0,0,1.0,1,1.0,1,1.0,1,0.24423514174270922,27
481,8,5603,5603,0,0,0,0,1.0,1,1.0,1,1.0,1,0.1454419138014374,28
482,11,5614,5614,0,0,0,0,1.0,1,1.0,1,1.0,1,0.32012926743194936,28
483,13,5627,5627,0,0,0,0,1.0,1,1.0,1,1.0,1,0.21893299529030807,29
484,19,5646,5646,0,0,0,0,1.0,1,1.0,1,1.0,1,0.3503753822118046,29
485,12,5658,5658,0,0,0,0,1.0,1,1.0,1,1.0,1,0.4206527044090943,29
486,19,5677,5677,0,0,0,0,1.0,1,1.0,1,1.0,1,0.4052247745281819,31
487,21,5698,5698,0,0,0,0,1.0,1,1.0,1,1.0,1,0.3407609399907892,33
488,11,5709,5709,0,0,0,0,1.0,1,1.0,1,1.0,1,0.25783148841189935,34
489,11,5720,5720,0,0,0,0,1.0,1,1.0,1,1.0,1,0.40645544634141617,34
490,18,5738,5738,0,0,0,0,1.0,1,1.0,1,1.0,1,0.3667839390730699,34
491,2,5740,5740,0,0,0,0,1.0,1,1.0,1,1.0,1,0.37251917017868585,34
492,5,5745,5745,0,0,0,0,1.0,1,1.0,1,1.0,1,0.3337953973683097,34
493,10,5755,5755,0,0,0,0,1.0,1,1.0,1,1.0,1,0.41334268497826426,34
494,12,5767,5767,0,0,0,0,1.0,1,1.0,1,1.0,1,0.33518936133516003,36
495,11,5778,5778,0,0,0,0,1.0,1,1.0,1,1.0,1,0.39389583641286824,36
496,7,5785,5785,0,0,0,0,1.0,1,1.0,1,1.0,1,0.35395015250521766,37
497,10,5795,5795,0,0,0,0,1.0,1,1.0,1,1.0,1,0.3692872524552535,39
498,13,5808,5808,0,0,0,0,1.0,1,1.0,1,1.0,1,0.2701994044513281,40
499,14,5822,5822,0,0,0,0,1.0,1,1.0,1,1.0,1,0.3313617379008598,40
500,11,5833,5833,0,0,0,0,1.0,1,1.0,1,1.0,1,0.3238857503524625,42
501,17,5850,5850,0,0,0,0,1.0,1,1.0,1,1.0,1,0.2941603822027524,42
502,17,5867,5867,0,0,0,0,1.0,1,1.0,1,1.0,1,0.3780493167474981,42
503,14,5881,5881,0,0,0,0,1.0,1,1.0,1,1.0,1,0.31595834863258615,41
504,13,5894,5894,0,0,0,0,1.0,1,1.0,1,1.0,1,0.37032724709723563,42
505,10,5904,5904,0,0,0,0,1.0,1,1.0,1,1.0,1,0.24566288617051066,38
506,12,5916,5916,0,0,0,0,1.0,1,1.0,1,1.0,1,0.266690204315223,37
507,10,5926,5926,0,0,0,0,1.0,1,1.0,1,1.0,1,0.20268574194592479,35
508,10,5936,5936,0,0,0,0,1.0,1,1.0,1,1.0,1,0.24377881984469327,35
509,5,5941,5941,0,0,0,0,1.0,1,1.0,1,1.0,1,0.2826640345845712,34
510,7,5948,5948,0,0,0,0,1.0,1,1.0,1,1.0,1,0.37974211236213695,34
511,6,5954,5954,0,0,0,0,1.0,1,1.0,1,1.0,1,0.36718254726038774,32
512,4,5958,5958,0,0,0,0,1.0,1,1.0,1,1.0,1,0.48746304805453616,30
513,15,5973,5973,0,0,0,0,1.0,1,1.0,1,1.0,1,0.37852098661308403,31
514,6,5979,5979,0,0,0,0,1.0,1,1.0,1,1.0,1,0.46699775592955606,31
515,11,5990,5990,0,0,0,0,1.0,1,1.0,1,1.0,1,0.3886686221389065,32
516,16,6006,6006,0,0,0,0,1.0,1,1.0,1,1.0,1,0.3798699848276997,31
517,15,6021,6021,0,0,0,0,1.0,1,1.0,1,1.0,1,0.3372608778413838,32
518,13,6034,6034,0,0,0,0,1.0,1,1.0,1,1.0,1,0.35859941482300195,31
519,16,6050,6050,0,0,0,0,1.0,1,1.0,1,1.0,1,0.38065053559270917,31
520,9,6059,6059,0,0,0,0,1.0,1,1.0,1,1.0,1,0.47377309716471533,33
521,16,6075,6075,0,0,0,0,1.0,1,1.0,1,1.0,1,0.33061783756175406,34
522,7,6082,6082,0,0,0,0,1.0,1,1.0,1,1.0,1,0.4168882565154408,34
523,7,6089,6089,0,0,0,0,1.0,1,1.0,1,1.0,1,0.4262400851907189,33
524,10,6099,6099,0,0,0,0,1.0,1,1.0,1,1.0,1,0.3070868350463776,34
525,4,6103,6103,0,0,0,0,1.0,1,1.0,1,1.0,1,0.36011966925202366,32
526,13,6116,6116,0,0,0,0,1.0,1,1.0,1,1.0,1,0.3405617598268344,32
527,13,6129,6129,0,0,0,0,1.0,1,1.0,1,1.0,1,0.42368513215095815,31
528,15,6144,6144,0,0,0,0,1.0,1,1.0,1,1.0,1,0.33097647922876255,31
529,8,6152,6152,0,0,0,0,1.0,1,1.0,1,1.0,1,0.4448921334173571,30
530,9,6161,6161,0,0,0,0,1.0,1,1.0,1,1.0,1,0.4138528487708179,30
531,6,6167,6167,0,0,0,0,1.0,1,1.0,1,1.0,1,0.46361648447228854,32
532,8,6175,6175,0,0,0,0,1.0,1,1.0,1,1.0,1,0.4354553541101239,32
533,10,6185,6185,0,0,0,0,1.0,1,1.0,1,1.0,1,0.4276414354012397,34
534,10,6195,6195,0,0,0,0,1.0,1,1.0,1,1.0,1,0.4271522366116069,34
535,7,6202,6202,0,0,0,0,1.0,1,1.0,1,1.0,1,0.4424162337707347,37
536,8,6210,6210,0,0,0,0,1.0,1,1.0,1,1.0,1,0.33424211685153704,37
537,9,6219,6219,0,0,0,0,1.0,1,1.0,1,1.0,1,0.41311399243684305,37
538,5,6224,6224,0,0,0,0,1.0,1,1.0,1,1.0,1,0.37052261451445034,38
539,8,6232,6232,0,0,0,0,1.0,1,1.0,1,1.0,1,0.3744713858874898,38
540,4,6236,6236,0,0,0,0,1.0,1,1.0,1,1.0,1,0.4331515161573361,38
541,7,6243,6243,0,0,0,0,1.0,1,1.0,1,1.0,1,0.3506418452124022,39
542,10,6253,6253,0,0,0,0,1.0,1,1.0,1,1.0,1,0.40146439891501745,40
543,9,6262,6262,0,0,0,0,1.0,1,1.0,1,1.0,1,0.5056557097521756,37
544,9,6271,6271,0,0,0,0,1.0,1,1.0,1,1.0,1,0.5162343319531562,35
545,8,6279,6279,0,0,0,0,1.0,1,1.0,1,1.0,1,0.4309827872531913,35
546,12,6291,6291,0,0,0,0,1.0,1,1.0,1,1.0,1,0.457920453031773,35
547,15,6306,6306,0,0,0,0,1.0,1,1.0,1,1.0,1,0.45011419372141376,34
548,12,6318,6318,0,0,0,0,1.0,1,1.0,1,1.0,1,0.3885151304212119,34
549,12,6330,6330,0,0,0,0,1.0,1,1.0,1,1.0,1,0.5131548499177848,31
550,9,6339,6339,0,0,0,0,1.0,1,1.0,1,1.0,1,0.30512205854981295,30
551,11,6350,6350,0,0,0,0,1.0,1,1.0,1,1.0,1,0.39301037692253454,31
552,9,6359,6359,0,0,0,0,1.0,1,1.0,1,1.0,1,0.44083364822094684,29
553,16,6375,6375,0,0,0,0,1.0,1,1.0,1,1.0,1,0.47391215068560055,30
554,9,6384,6384,0,0,0,0,1.0,1,1.0,1,1.0,1,0.48327276905667177,30
555,15,6399,6399,0,0,0,0,1.0,1,1.0,1,1.0,1,0.40500220183419866,30
556,13,6412,6412,0,0,0,0,1.0,1,1.0,1,1.0,1,0.49890150750049483,31
557,16,6428,6428,0,0,0,0,1.0,1,1.0,1,1.0,1,0.5190694745001133,31
558,14,6442,6442,0,0,0,0,1.0,1,1.0,1,1.0,1,0.35856241329233146,31
559,15,6457,6457,0,0,0,0,1.0,1,1.0,1,1.0,1,0.4904088809301329,31
560,21,6478,6478,0,0,0,0,1.0,1,1.0,1,1.0,1,0.4722248762053421,32
561,19,6497,6497,0,0,0,0,1.0,1,1.0,1,1.0,1,0.3152546250368993,33
562,17,6514,6514,0,0,0,0,1.0,1,1.0,1,1.0,1,0.39044286524534005,33
563,13,6527,6527,0,0,0,0,1.0,1,1.0,1,1.0,1,0.4343488365917172,33
564,12,6539,6539,0,0,0,0,1.0,1,1.0,1,1.0,1,0.3814081762307271,34
565,15,6554,6554,0,0,0,0,1.0,1,1.0,1,1.0,1,0.32947088103645145,35
566,11,6565,6565,0,0,0,0,1.0,1,1.0,1,1.0,1,0.30236693309761337,36
567,14,6579,6579,0,0,0,0,1.0,1,1.0,1,1.0,1,0.38285235833969283,37
568,16,6595,6595,0,0,0,0,1.0,1,1.0,1,1.0,1,0.36822849112532463,36
569,8,6603,6603,0,0,0,0,1.0,1,1.0,1,1.0,1,0.32605663643073396,37
570,6,6609,6609,0,0,0,0,1.0,1,1.0,1,1.0,1,0.2729087978032814,38
571,10,6619,6619,0,0,0,0,1.0,1,1.0,1,1.0,1,0.3516705710689109,38
572,3,6622,6622,0,0,0,0,1.0,1,1.0,1,1.0,1,0.31424051314033996,39
573,8,6630,6630,0,0,0,0,1.0,1,1.0,1,1.0,1,0.37984162479873074,39
574,8,6638,6638,0,0,0,0,1.0,1,1.0,1,1.0,1,0.28100283608293,41
575,10,6648,6648,0,0,0,0,1.0,1,1.0,1,1.0,1,0.31054807231889986,41
576,10,6658,6658,0,0,0,0,1.0,1,1.0,1,1.0,1,0.3272626389095168,42
577,6,6664,6664,0,0,0,0,1.0,1,1.0,1,1.0,1,0.3158083642428458,42
578,7,6671,6671,0,0,0,0,1.0,1,1.0,1,1.0,1,0.28773119627312527,41
579,5,6676,6676,0,0,0,0,1.0,1,1.0,1,1.0,1,0.2718427380735059,42
580,11,6687,6687,0,0,0,0,1.0,1,1.0,1,1.0,1,0.31365991051980074,43
581,8,6695,6695,0,0,0,0,1.0,1,1.0,1,1.0,1,0.25241782302764737,42
582,14,6709,6709,0,0,0,0,1.0,1,1.0,1,1.0,1,0.2438059618580071,41
583,11,6720,6720,0,0,0,0,1.0,1,1.0,1,1.0,1,0.2890866804732887,40
584,19,6739,6739,0,0,0,0,1.0,1,1.0,1,1.0,1,0.3351590813758477,38
585,18,6757,6757,0,0,0,0,1.0,1,1.0,1,1.0,1,0.2643949126230414,38
586,11,6768,6768,0,0,0,0,1.0,1,1.0,1,1.0,1,0.27520836945715554,37
587,13,6781,6781,0,0,0,0,1.0,1,1.0,1,1.0,1,0.2640784198269127,35
588,16,6797,6797,0,0,0,0,1.0,1,1.0,1,1.0,1,0.3919027123494188,35
589,9,6806,6806,0,0,0,0,1.0,1,1.0,1,1.0,1,0.2433405964327616,34
590,17,6823,6823,0,0,0,0,1.0,1,1.0,1,1.0,1,0.4452561140927301,36
591,10,6833,6833,0,0,0,0,1.0,1,1.0,1,1.0,1,0.30383716321391313,35
592,14,6847,6847,0,0,0,0,1.0,1,1.0,1,1.0,1,0.29443269883387135,37
593,11,6858,6858,0,0,0,0,1.0,1,1.0,1,1.0,1,0.3903997390470398,36
594,18,6876,6876,0,0,0,0,1.0,1,1.0,1,1.0,1,0.24888010471400618,35
595,14,6890,6890,0,0,0,0,1.0,1,1.0,1,1.0,1,0.43114546725925385,34
596,10,6900,6900,0,0,0,0,1.0,1,1.0,1,1.0,1,0.3012173622496129,34
597,17,6917,6917,0,0,0,0,1.0,1,1.0,1,1.0,1,0.48041077837314383,33
598,19,6936,6936,0,0,0,0,1.0,1,1.0,1,1.0,1,0.4610995121047951,33
599,15,6951,6951,0,0,0,0,1.0,1,1.0,1,1.0,1,0.49818256451840964,33
600,8,6959,6959,0,0,0,0,1.0,1,1.0,1,1.0,1,0.5209231493964535,33
601,9,6968,6968,0,0,0,0,1.0,1,1.0,1,1.0,1,0.5942403278956492,34
602,15,6983,6983,0,0,0,0,1.0,1,1.0,1,1.0,1,0.6096640160325665,35
603,12,6995,6995,0,0,0,0,1.0,1,1.0,1,1.0,1,0.5391229977975484,35
604,7,7002,7002,0,0,0,0,1.0,1,1.0,1,1.0,1,0.5514677932087981,35
605,11,7013,7013,0,0,0,0,1.0,1,1.0,1,1.0,1,0.4791142387891825,35
606,9,7022,7022,0,0,0,0,1.0,1,1.0,1,1.0,1,0.5582013459707005,35
607,13,7035,7035,0,0,0,0,1.0,1,1.0,1,1.0,1,0.5341351012874564,35
608,14,7049,7049,0,0,0,0,1.0,1,1.0,1,1.0,1,0.6294851683222561,36
609,13,7062,7062,0,0,0,0,1.0,1,1.0,1,1.0,1,0.41052715791521965,37
610,16,7078,7078,0,0,0,0,1.0,1,1.0,1,1.0,1,0.29147635104988295,37
611,17,7095,7095,0,0,0,0,1.0,1,1.0,1,1.0,1,0.4312572508236648,39
612,16,7111,7111,0,0,0,0,1.0,1,1.0,1,1.0,1,0.34320999042849876,39
613,18,7129,7129,0,0,0,0,1.0,1,1.0,1,1.0,1,0.2907797507467116,39
614,13,7142,7142,0,0,0,0,1.0,1,1.0,1,1.0,1,0.24332075475040527,39
615,13,7155,7155,0,0,0,0,1.0,1,1.0,1,1.0,1,0.3875672177058116,39
616,4,7159,7159,0,0,0,0,1.0,1,1.0,1,1.0,1,0.36186254021965386,38
617,8,7167,7167,0,0,0,0,1.0,1,1.0,1,1.0,1,0.39631881628521054,39
618,9,7176,7176,0,0,0,0,1.0,1,1.0,1,1.0,1,0.4456844132945547,40
619,7,7183,7183,0,0,0,0,1.0,1,1.0,1,1.0,1,0.4071487785082247,39
620,8,7191,7191,0,0,0,0,1.0,1,1.0,1,1.0,1,0.32329934785264786,38
621,13,7204,7204,0,0,0,0,1.0,1,1.0,1,1.0,1,0.3143610410449579,38
622,12,7216,7216,0,0,0,0,1.0,1,1.0,1,1.0,1,0.318069743352686,38
623,16,7232,7232,0,0,0,0,1.0,1,1.0,1,1.0,1,0.3681734198849951,37
624,13,7245,7245,0,0,0,0,1.0,1,1.0,1,1.0,1,0.32629366479521293,33
625,15,7260,7260,0,0,0,0,1.0,1,1.0,1,1.0,1,0.34203617781333395,32
626,17,7277,7277,0,0,0,0,1.0,1,1.0,1,1.0,1,0.4128322157456543,31
627,9,7286,7286,0,0,0,0,1.0,1,1.0,1,1.0,1,0.46257116803957943,30
628,18,7304,7304,0,0,0,0,1.0,1,1.0,1,1.0,1,0.3990160346122381,32
629,6,7310,7310,0,0,0,0,1.0,1,1.0,1,1.0,1,0.37440130730029003,29
630,10,7320,7320,0,0,0,0,1.0,1,1.0,1,1.0,1,0.3984051979466797,29
631,8,7328,7328,0,0,0,0,1.0,1,1.0,1,1.0,1,0.5189492378158908,25
632,5,7333,7333,0,0,0,0,1.0,1,1.0,1,1.0,1,0.5562369761398674,24
633,15,7348,7348,0,0,0,0,1.0,1,1.0,1,1.0,1,0.5281280011455305,23
634,6,7354,7354,0,0,0,0,1.0,1,1.0,1,1.0,1,0.5114919583149483,23
635,13,7367,7367,0,0,0,0,1.0,1,1.0,1,1.0,1,0.3581127378857254,22
636,7,7374,7374,0,0,0,0,1.0,1,1.0,1,1.0,1,0.42243541314642574,22
637,6,7380,7380,0,0,0,0,1.0,1,1.0,1,1.0,1,0.3829626436475461,23
638,5,7385,7385,0,0,0,0,1.0,1,1.0,1,1.0,1,0.35184658329394536,23
639,5,7390,7390,0,0,0,0,1.0,1,1.0,1,1.0,1,0.2562345908766216,24
640,5,7395,7395,0,0,0,0,1.0,1,1.0,1,1.0,1,0.24874945234535523,24
641,10,7405,7405,0,0,0,0,1.0,1,1.0,1,1.0,1,0.3083274348964032,25
642,10,7415,7415,0,0,0,0,1.0,1,1.0,1,1.0,1,0.20359845060458412,26
643,9,7424,7424,0,0,0,0,1.0,1,1.0,1,1.0,1,0.3460932635940488,28
644,13,7437,7437,0,0,0,0,1.0,1,1.0,1,1.0,1,0.37695147695212317,28
645,11,7448,7448,0,0,0,0,1.0,1,1.0,1,1.0,1,0.3006762933165395,28
646,9,7457,7457,0,0,0,0,1.0,1,1.0,1,1.0,1,0.3974130124853614,29
647,9,7466,7466,0,0,0,0,1.0,1,1.0,1,1.0,1,0.40215626772842555,30
648,7,7473,7473,0,0,0,0,1.0,1,1.0,1,1.0,1,0.3411637736284811,30
649,10,7483,7483,0,0,0,0,1.0,1,1.0,1,1.0,1,0.3689828221116064,31
650,7,7490,7490,0,0,0,0,1.0,1,1.0,1,1.0,1,0.22671750889263345,31
651,11,7501,7501,0,0,0,0,1.0,1,1.0,1,1.0,1,0.42286359706573273,32
652,9,7510,7510,0,0,0,0,1.0,1,1.0,1,1.0,1,0.3779472233773734,32
653,10,7520,7520,0,0,0,0,1.0,1,1.0,1,1.0,1,0.2897317023389212,33
654,17,7537,7537,0,0,0,0,1.0,1,1.0,1,1.0,1,0.43918379558425635,33
655,16,7553,7553,0,0,0,0,1.0,1,1.0,1,1.0,1,0.38634339353785296,36
656,11,7564,7564,0,0,0,0,1.0,1,1.0,1,1.0,1,0.3498222182635765,36
657,13,7577,7577,0,0,0,0,1.0,1,1.0,1,1.0,1,0.22301594535971375,35
658,18,7595,7595,0,0,0,0,1.0,1,1.0,1,1.0,1,0.2947785348090523,33
659,12,7607,7607,0,0,0,0,1.0,1,1.0,1,1.0,1,0.37819509930935313,35
660,10,7617,7617,0,0,0,0,1.0,1,1.0,1,1.0,1,0.3492688770864225,34
661,7,7624,7624,0,0,0,0,1.0,1,1.0,1,1.0,1,0.4334485039609959,33
662,11,7635,7635,0,0,0,0,1.0,1,1.0,1,1.0,1,0.4473346067639829,31
663,17,7652,7652,0,0,0,0,1.0,1,1.0,1,1.0,1,0.3284368496563203,29
664,8,7660,7660,0,0,0,0,1.0,1,1.0,1,1.0,1,0.3613377317260219,27
665,17,7677,7677,0,0,0,0,1.0,1,1.0,1,1.0,1,0.36538695638749297,27
666,15,7692,7692,0,0,0,0,1.0,1,1.0,1,1.0,1,0.27552368906324515,28
667,10,7702,7702,0,0,0,0,1.0,1,1.0,1,1.0,1,0.3675848335471028,26
668,14,7716,7716,0,0,0,0,1.0,1,1.0,1,1.0,1,0.43430002720291455,26
669,11,7727,7727,0,0,0,0,1.0,1,1.0,1,1.0,1,0.43466906654285126,25
670,3,7730,7730,0,0,0,0,1.0,1,1.0,1,1.0,1,0.49640403872966815,24
671,3,7733,7733,0,0,0,0,1.0,1,1.0,1,1.0,1,0.46155128639344245,24
672,7,7740,7740,0,0,0,0,1.0,1,1.0,1,1.0,1,0.3968505673811206,25
673,7,7747,7747,0,0,0,0,1.0,1,1.0,1,1.0,1,0.3884175904628092,25
674,7,7754,7754,0,0,0,0,1.0,1,1.0,1,1.0,1,0.24893282192180258,25
675,8,7762,7762,0,0,0,0,1.0,1,1.0,1,1.0,1,0.3173943455809431,26
676,10,7772,7772,0,0,0,0,1.0,1,1.0,1,1.0,1,0.28941211324544036,27
677,8,7780,7780,0,0,0,0,1.0,1,1.0,1,1.0,1,0.33491511696277293,28
678,8,7788,7788,0,0,0,0,1.0,1,1.0,1,1.0,1,0.40856860221599883,28
679,9,7797,7797,0,0,0,0,1.0,1,1.0,1,1.0,1,0.372242668229535,30
680,14,7811,7811,0,0,0,0,1.0,1,1.0,1,1.0,1,0.42518373638372026,29
681,9,7820,7820,0,0,0,0,1.0,1,1.0,1,1.0,1,0.38743595471311676,29
682,6,7826,7826,0,0,0,0,1.0,1,1.0,1,1.0,1,0.45164271090398056,30
683,7,7833,7833,0,0,0,0,1.0,1,1.0,1,1.0,1,0.331370495272256,30
684,17,7850,7850,0,0,0,0,1.0,1,1.0,1,1.0,1,0.2569643441881709,31
685,17,7867,7867,0,0,0,0,1.0,1,1.0,1,1.0,1,0.4161973846858424,30
686,9,7876,7876,0,0,0,0,1.0,1,1.0,1,1.0,1,0.36134579019375446,30
687,6,7882,7882,0,0,0,0,1.0,1,1.0,1,1.0,1,0.3619459464008041,30
688,10,7892,7892,0,0,0,0,1.0,1,1.0,1,1.0,1,0.2980887663231827,31
689,11,7903,7903,0,0,0,0,1.0,1,1.0,1,1.0,1,0.3318245009991034,32
690,17,7920,7920,0,0,0,0,1.0,1,1.0,1,1.0,1,0.44408237591592564,32
691,9,7929,7929,0,0,0,0,1.0,1,1.0,1,1.0,1,0.36605581644169644,32
692,11,7940,7940,0,0,0,0,1.0,1,1.0,1,1.0,1,0.4936470545608473,32
693,12,7952,7952,0,0,0,0,1.0,1,1.0,1,1.0,1,0.43234384900372375,34
694,19,7971,7971,0,0,0,0,1.0,1,1.0,1,1.0,1,0.4455498796207855,36
695,12,7983,7983,0,0,0,0,1.0,1,1.0,1,1.0,1,0.41692772181094473,34
696,17,8000,8000,0,0,0,0,1.0,1,1.0,1,1.0,1,0.31008994269874135,33
697,17,8017,8017,0,0,0,0,1.0,1,1.0,1,1.0,1,0.504155024626515,33
698,11,8028,8028,0,0,0,0,1.0,1,1.0,1,1.0,1,0.42360275848279705,34
699,12,8040,8040,0,0,0,0,1.0,1,1.0,1,1.0,1,0.31229916313837447,33
700,9,8049,8049,0,0,0,0,1.0,1,1.0,1,1.0,1,0.4091577144956025,32
701,4,8053,8053,0,0,0,0,1.0,1,1.0,1,1.0,1,0.46492812984420673,33
702,12,8065,8065,0,0,0,0,1.0,1,1.0,1,1.0,1,0.3560753761760006,34
703,11,8076,8076,0,0,0,0,1.0,1,1.0,1,1.0,1,0.43768165772025297,32
704,10,8086,8086,0,0,0,0,1.0,1,1.0,1,1.0,1,0.34969004094915096,31
705,12,8098,8098,0,0,0,0,1.0,1,1.0,1,1.0,1,0.4022934422847844,33
706,16,8114,8114,0,0,0,0,1.0,1,1.0,1,1.0,1,0.4224986456504699,33
707,14,8128,8128,0,0,0,0,1.0,1,1.0,1,1.0,1,0.5014309293287591,31
708,8,8136,8136,0,0,0,0,1.0,1,1.0,1,1.0,1,0.4681861996380639,31
709,16,8152,8152,0,0,0,0,1.0,1,1.0,1,1.0,1,0.4715354178645463,30
710,9,8161,8161,0,0,0,0,1.0,1,1.0,1,1.0,1,0.5588645060925579,30
711,5,8166,8166,0,0,0,0,1.0,1,1.0,1,1.0,1,0.5576889251463907,30
712,10,8176,8176,0,0,0,0,1.0,1,1.0,1,1.0,1,0.5814823366038918,30
713,15,8191,8191,0,0,0,0,1.0,1,1.0,1,1.0,1,0.6195522194092116,31
714,14,8205,8205,0,0,0,0,1.0,1,1.0,1,1.0,1,0.5059841118414494,31
715,11,8216,8216,0,0,0,0,1.0,1,1.0,1,1.0,1,0.6101886330675872,30
716,13,8229,8229,0,0,0,0,1.0,1,1.0,1,1.0,1,0.42719697344352725,31
717,20,8249,8249,0,0,0,0,1.0,1,1.0,1,1.0,1,0.5203846540269244,32
718,11,8260,8260,0,0,0,0,1.0,1,1.0,1,1.0,1,0.5021789142914908,32
719,15,8275,8275,0,0,0,0,1.0,1,1.0,1,1.0,1,0.46995866854544155,32
720,18,8293,8293,0,0,0,0,1.0,1,1.0,1,1.0,1,0.5043078011411554,34
721,17,8310,8310,0,0,0,0,1.0,1,1.0,1,1.0,1,0.5053576579635437,34
722,8,8318,8318,0,0,0,0,1.0,1,1.0,1,1.0,1,0.6334878941363042,34
723,15,8333,8333,0,0,0,0,1.0,1,1.0,1,1.0,1,0.46325440270453744,35
724,18,8351,8351,0,0,0,0,1.0,1,1.0,1,1.0,1,0.4162195737206211,36
725,15,8366,8366,0,0,0,0,1.0,1,1.0,1,1.0,1,0.5846194329813783,37
726,14,8380,8380,0,0,0,0,1.0,1,1.0,1,1.0,1,0.47375124666486623,37
727,8,8388,8388,0,0,0,0,1.0,1,1.0,1,1.0,1,0.4846497864752923,38
728,10,8398,8398,0,0,0,0,1.0,1,1.0,1,1.0,1,0.39972089815617545,39
729,11,8409,8409,0,0,0,0,1.0,1,1.0,1,1.0,1,0.5284016528231336,39
730,8,8417,8417,0,0,0,0,1.0,1,1.0,1,1.0,1,0.4899088077559575,40
731,12,8429,8429,0,0,0,0,1.0,1,1.0,1,1.0,1,0.5282209198202212,40
732,17,8446,8446,0,0,0,0,1.0,1,1.0,1,1.0,1,0.495197431817968,41
733,9,8455,8455,0,0,0,0,1.0,1,1.0,1,1.0,1,0.5572099277679083,41
734,25,8480,8480,0,0,0,0,1.0,1,1.0,1,1.0,1,0.420713860683996,42
735,28,8508,8508,0,0,0,0,1.0,1,1.0,1,1.0,1,0.5749315517610023,42
736,25,8533,8533,0,0,0,0,1.0,1,1.0,1,1.0,1,0.5396911471465267,41
737,13,8546,8546,0,0,0,0,1.0,1,1.0,1,1.0,1,0.4118071506286358,41
738,21,8567,8567,0,0,0,0,1.0,1,1.0,1,1.0,1,0.45863578648058195,39
739,17,8584,8584,0,0,0,0,1.0,1,1.0,1,1.0,1,0.3898017597321325,39
740,16,8600,8600,0,0,0,0,1.0,1,1.0,1,1.0,1,0.4199071978008212,39
741,20,8620,8620,0,0,0,0,1.0,1,1.0,1,1.0,1,0.3958849225967231,38
742,19,8639,8639,0,0,0,0,1.0,1,1.0,1,1.0,1,0.38223312533461967,39
743,20,8659,8659,0,0,0,0,1.0,1,1.0,1,1.0,1,0.3186364676781284,39
744,11,8670,8670,0,0,0,0,1.0,1,1.0,1,1.0,1,0.28999017022247126,39
745,16,8686,8686,0,0,0,0,1.0,1,1.0,1,1.0,1,0.2717357454741741,39
746,11,8697,8697,0,0,0,0,1.0,1,1.0,1,1.0,1,0.22666131671095513,40
747,12,8709,8709,0,0,0,0,1.0,1,1.0,1,1.0,1,0.395328404312604,41
748,7,8716,8716,0,0,0,0,1.0,1,1.0,1,1.0,1,0.3416908750155615,41
749,11,8727,8727,0,0,0,0,1.0,1,1.0,1,1.0,1,0.2804321866722254,41
750,15,8742,8742,0,0,0,0,1.0,1,1.0,1,1.0,1,0.25229043616142793,39
751,7,8749,8749,0,0,0,0,1.0,1,1.0,1,1.0,1,0.2917769763191292,41
752,9,8758,8758,0,0,0,0,1.0,1,1.0,1,1.0,1,0.3923742843269004,41
753,19,8777,8777,0,0,0,0,1.0,1,1.0,1,1.0,1,0.3591679989088891,41
754,14,8791,8791,0,0,0,0,1.0,1,1.0,1,1.0,1,0.31273961493103003,41
755,7,8798,8798,0,0,0,0,1.0,1,1.0,1,1.0,1,0.2365709090177636,41
756,5,8803,8803,0,0,0,0,1.0,1,1.0,1,1.0,1,0.3670223700981222,41
757,15,8818,8818,0,0,0,0,1.0,1,1.0,1,1.0,1,0.2266917506604427,39
758,15,8833,8833,0,0,0,0,1.0,1,1.0,1,1.0,1,0.23638048618823526,39
759,10,8843,8843,0,0,0,0,1.0,1,1.0,1,1.0,1,0.4024406592476221,39
760,8,8851,8851,0,0,0,0,1.0,1,1.0,1,1.0,1,0.344300033136323,40
761,15,8866,8866,0,0,0,0,1.0,1,1.0,1,1.0,1,0.40316541710558673,41
762,5,8871,8871,0,0,0,0,1.0,1,1.0,1,1.0,1,0.29963145327488794,42
763,6,8877,8877,0,0,0,0,1.0,1,1.0,1,1.0,1,0.37146452700447496,43
764,9,8886,8886,0,0,0,0,1.0,1,1.0,1,1.0,1,0.4261701657561359,43
765,6,8892,8892,0,0,0,0,1.0,1,1.0,1,1.0,1,0.39100292199574865,45
766,15,8907,8907,0,0,0,0,1.0,1,1.0,1,1.0,1,0.28511470290709173,45
767,17,8924,8924,0,0,0,0,1.0,1,1.0,1,1.0,1,0.20481143594714066,46
768,10,8934,8934,0,0,0,0,1.0,1,1.0,1,1.0,1,0.3115513178976632,45
769,14,8948,8948,0,0,0,0,1.0,1,1.0,1,1.0,1,0.33839280365525765,46
770,10,8958,8958,0,0,0,0,1.0,1,1.0,1,1.0,1,0.2899832824406536,47
771,12,8970,8970,0,0,0,0,1.0,1,1.0,1,1.0,1,0.35883685107447555,47
772,13,8983,8983,0,0,0,0,1.0,1,1.0,1,1.0,1,0.20064868941102235,46
773,16,8999,8999,0,0,0,0,1.0,1,1.0,1,1.0,1,0.29447719162739033,45
774,10,9009,9009,0,0,0,0,1.0,1,1.0,1,1.0,1,0.23571705452435812,45
775,15,9024,9024,0,0,0,0,1.0,1,1.0,1,1.0,1,0.3214835026796901,45
776,14,9038,9038,0,0,0,0,1.0,1,1.0,1,1.0,1,0.30189244665043635,43
777,11,9049,9049,0,0,0,0,1.0,1,1.0,1,1.0,1,0.36193602514209167,44
778,17,9066,9066,0,0,0,0,1.0,1,1.0,1,1.0,1,0.35343740685870223,45
779,19,9085,9085,0,0,0,0,1.0,1,1.0,1,1.0,1,0.35129338943504657,45
780,23,9108,9108,0,0,0,0,1.0,1,1.0,1,1.0,1,0.3396807104590223,45
781,19,9127,9127,0,0,0,0,1.0,1,1.0,1,1.0,1,0.33987907990296606,46
782,17,9144,9144,0,0,0,0,1.0,1,1.0,1,1.0,1,0.41168402767410434,47
783,25,9169,9169,0,0,0,0,1.0,1,1.0,1,1.0,1,0.40204618353888966,46
784,33,9202,9202,0,0,0,0,1.0,1,1.0,1,1.0,1,0.4032686416396893,45
785,26,9228,9228,0,0,0,0,1.0,1,1.0,1,1.0,1,0.3979720772928796,43
786,32,9260,9260,0,0,0,0,1.0,1,1.0,1,1.0,1,0.4158925426808275,43
787,17,9277,9277,0,0,0,0,1.0,1,1.0,1,1.0,1,0.3699626814054213,43
788,24,9301,9301,0,0,0,0,1.0,1,1.0,1,1.0,1,0.3542665971940139,44
789,10,9311,9311,0,0,0,0,1.0,1,1.0,1,1.0,1,0.3448435693291521,46
790,18,9329,9329,0,0,0,0,1.0,1,1.0,1,1.0,1,0.3417770159468584,46
791,15,9344,9344,0,0,0,0,1.0,1,1.0,1,1.0,1,0.33122817656779713,46
792,9,9353,9353,0,0,0,0,1.0,1,1.0,1,1.0,1,0.33532769335138296,47
793,7,9360,9360,0,0,0,0,1.0,1,1.0,1,1.0,1,0.25943844881613576,48
794,19,9379,9379,0,0,0,0,1.0,1,1.0,1,1.0,1,0.3585575169454858,48
795,16,9395,9395,0,0,0,0,1.0,1,1.0,1,1.0,1,0.26534226934400457,47
796,18,9413,9413,0,0,0,0,1.0,1,1.0,1,1.0,1,0.3296087473370824,45
797,14,9427,9427,0,0,0,0,1.0,1,1.0,1,1.0,1,0.32177673544971547,47
798,20,9447,9447,0,0,0,0,1.0,1,1.0,1,1.0,1,0.3203660537434261,48
799,19,9466,9466,0,0,0,0,1.0,1,1.0,1,1.0,1,0.4493764100764037,48
800,18,9484,9484,0,0,0,0,1.0,1,1.0,1,1.0,1,0.37664922091102143,48
801,24,9508,9508,0,0,0,0,1.0,1,1.0,1,1.0,1,0.3569119729538919,49
802,12,9520,9520,0,0,0,0,1.0,1,1.0,1,1.0,1,0.36949707716576113,50
803,13,9533,9533,0,0,0,0,1.0,1,1.0,1,1.0,1,0.3606966509432886,50
804,16,9549,9549,0,0,0,0,1.0,1,1.0,1,1.0,1,0.35219015076462923,50
805,11,9560,9560,0,0,0,0,1.0,1,1.0,1,1.0,1,0.3501051206986902,50
806,22,9582,9582,0,0,0,0,1.0,1,1.0,1,1.0,1,0.41162743527336254,51
807,15,9597,9597,0,0,0,0,1.0,1,1.0,1,1.0,1,0.3769581446305633,51
808,11,9608,9608,0,0,0,0,1.0,1,1.0,1,1.0,1,0.45472582374888865,53
809,23,9631,9631,0,0,0,0,1.0,1,1.0,1,1.0,1,0.46295572108225025,51
810,26,9657,9657,0,0,0,0,1.0,1,1.0,1,1.0,1,0.39463103538595606,52
811,18,9675,9675,0,0,0,0,1.0,1,1.0,1,1.0,1,0.37216813206846067,50
812,26,9701,9701,0,0,0,0,1.0,1,1.0,1,1.0,1,0.3378424206801389,51
813,20,9721,9721,0,0,0,0,1.0,1,1.0,1,1.0,1,0.38530148934734776,51
814,23,9744,9744,0,0,0,0,1.0,1,1.0,1,1.0,1,0.40459152902682954,52
815,16,9760,9760,0,0,0,0,1.0,1,1.0,1,1.0,1,0.31424957276572574,50
816,20,9780,9780,0,0,0,0,1.0,1,1.0,1,1.0,1,0.35659767821906563,50
817,13,9793,9793,0,0,0,0,1.0,1,1.0,1,1.0,1,0.3420525685113951,49
818,10,9803,9803,0,0,0,0,1.0,1,1.0,1,1.0,1,0.34686175630258487,49
819,14,9817,9817,0,0,0,0,1.0,1,1.0,1,1.0,1,0.3642800474376997,50
820,12,9829,9829,0,0,0,0,1.0,1,1.0,1,1.0,1,0.3655914501376475,49
821,7,9836,9836,0,0,0,0,1.0,1,1.0,1,1.0,1,0.3424628198404098,49
822,8,9844,9844,0,0,0,0,1.0,1,1.0,1,1.0,1,0.3441053742952267,49
823,12,9856,9856,0,0,0,0,1.0,1,1.0,1,1.0,1,0.363856809821601,47
824,12,9868,9868,0,0,0,0,1.0,1,1.0,1,1.0,1,0.3409079047715859,45
825,13,9881,9881,0,0,0,0,1.0,1,1.0,1,1.0,1,0.35552499925632164,43
826,15,9896,9896,0,0,0,0,1.0,1,1.0,1,1.0,1,0.37428085549146295,44
827,8,9904,9904,0,0,0,0,1.0,1,1.0,1,1.0,1,0.35627001721943913,43
828,16,9920,9920,0,0,0,0,1.0,1,1.0,1,1.0,1,0.3408650315050505,43
829,13,9933,9933,0,0,0,0,1.0,1,1.0,1,1.0,1,0.32999737101018106,45
830,14,9947,9947,0,0,0,0,1.0,1,1.0,1,1.0,1,0.3769420568714059,46
831,13,9960,9960,0,0,0,0,1.0,1,1.0,1,1.0,1,0.2964991303470491,48
832,18,9978,9978,0,0,0,0,1.0,1,1.0,1,1.0,1,0.2816975951819792,47
833,19,9997,9997,0,0,0,0,1.0,1,1.0,1,1.0,1,0.29020974703313523,47
834,16,10013,10013,0,0,0,0,1.0,1,1.0,1,1.0,1,0.35912994861907543,46
835,13,10026,10026,0,0,0,0,1.0,1,1.0,1,1.0,1,0.3909931692750914,45
836,14,10040,10040,0,0,0,0,1.0,1,1.0,1,1.0,1,0.39865046821274336,46
837,18,10058,10058,0,0,0,0,1.0,1,1.0,1,1.0,1,0.3784225515039445,46
838,22,10080,10080,0,0,0,0,1.0,1,1.0,1,1.0,1,0.3821271411946001,45
839,14,10094,10094,0,0,0,0,1.0,1,1.0,1,1.0,1,0.36220795392417765,46
840,17,10111,10111,0,0,0,0,1.0,1,1.0,1,1.0,1,0.31766910651387675,46
841,11,10122,10122,0,0,0,0,1.0,1,1.0,1,1.0,1,0.3653860441407133,46
842,13,10135,10135,0,0,0,0,1.0,1,1.0,1,1.0,1,0.34035359975139234,46
843,9,10144,10144,0,0,0,0,1.0,1,1.0,1,1.0,1,0.35563697001678796,46
844,9,10153,10153,0,0,0,0,1.0,1,1.0,1,1.0,1,0.3945697393889875,47
845,9,10162,10162,0,0,0,0,1.0,1,1.0,1,1.0,1,0.34458007532648366,48
846,15,10177,10177,0,0,0,0,1.0,1,1.0,1,1.0,1,0.3257470375390318,47
847,10,10187,10187,0,0,0,0,1.0,1,1.0,1,1.0,1,0.2598801571217114,48
848,15,10202,10202,0,0,0,0,1.0,1,1.0,1,1.0,1,0.28405417329020194,48
849,16,10218,10218,0,0,0,0,1.0,1,1.0,1,1.0,1,0.1968740737848206,48
850,16,10234,10234,0,0,0,0,1.0,1,1.0,1,1.0,1,0.25209967216342927,46
851,15,10249,10249,0,0,0,0,1.0,1,1.0,1,1.0,1,0.2078414973669462,45
852,11,10260,10260,0,0,0,0,1.0,1,1.0,1,1.0,1,0.354198982567836,44
853,10,10270,10270,0,0,0,0,1.0,1,1.0,1,1.0,1,0.24856333066214137,44
854,14,10284,10284,0,0,0,0,1.0,1,1.0,1,1.0,1,0.27536357780215115,45
855,10,10294,10294,0,0,0,0,1.0,1,1.0,1,1.0,1,0.3349322647853598,46
856,12,10306,10306,0,0,0,0,1.0,1,1.0,1,1.0,1,0.3034412934350576,46
857,11,10317,10317,0,0,0,0,1.0,1,1.0,1,1.0,1,0.42003809044675877,47
858,12,10329,10329,0,0,0,0,1.0,1,1.0,1,1.0,1,0.41237982122523237,48
859,7,10336,10336,0,0,0,0,1.0,1,1.0,1,1.0,1,0.2759762158519192,48
860,15,10351,10351,0,0,0,0,1.0,1,1.0,1,1.0,1,0.3746883921376134,49
861,6,10357,10357,0,0,0,0,1.0,1,1.0,1,1.0,1,0.3746909381471226,49
862,16,10373,10373,0,0,0,0,1.0,1,1.0,1,1.0,1,0.377476840931235,49
863,7,10380,10380,0,0,0,0,1.0,1,1.0,1,1.0,1,0.33555994181041726,48
864,11,10391,10391,0,0,0,0,1.0,1,1.0,1,1.0,1,0.3512095282887437,49
865,11,10402,10402,0,0,0,0,1.0,1,1.0,1,1.0,1,0.38917709577371357,48
866,13,10415,10415,0,0,0,0,1.0,1,1.0,1,1.0,1,0.3067225038752467,50
867,9,10424,10424,0,0,0,0,1.0,1,1.0,1,1.0,1,0.3541413445630827,50
868,15,10439,10439,0,0,0,0,1.0,1,1.0,1,1.0,1,0.32041040530917125,51
869,18,10457,10457,0,0,0,0,1.0,1,1.0,1,1.0,1,0.2900790953938909,49
870,16,10473,10473,0,0,0,0,1.0,1,1.0,1,1.0,1,0.3362194470757934,49
871,11,10484,10484,0,0,0,0,1.0,1,1.0,1,1.0,1,0.30684764434295186,49
872,11,10495,10495,0,0,0,0,1.0,1,1.0,1,1.0,1,0.3035923865665687,48
873,13,10508,10508,0,0,0,0,1.0,1,1.0,1,1.0,1,0.23957608219225246,49
874,13,10521,10521,0,0,0,0,1.0,1,1.0,1,1.0,1,0.27395394211977175,49
875,11,10532,10532,0,0,0,0,1.0,1,1.0,1,1.0,1,0.22819588858946224,50
876,9,10541,10541,0,0,0,0,1.0,1,1.0,1,1.0,1,0.21382463888797257,50
877,19,10560,10560,0,0,0,0,1.0,1,1.0,1,1.0,1,0.23881076839489251,50
878,8,10568,10568,0,0,0,0,1.0,1,1.0,1,1.0,1,0.2705882100306194,49
879,15,10583,10583,0,0,0,0,1.0,1,1.0,1,1.0,1,0.3187889873011177,49
880,11,10594,10594,0,0,0,0,1.0,1,1.0,1,1.0,1,0.3621006036395007,48
881,7,10601,10601,0,0,0,0,1.0,1,1.0,1,1.0,1,0.3540419242670048,49
882,6,10607,10607,0,0,0,0,1.0,1,1.0,1,1.0,1,0.3964156127968931,48
883,12,10619,10619,0,0,0,0,1.0,1,1.0,1,1.0,1,0.37340301436220463,50
884,9,10628,10628,0,0,0,0,1.0,1,1.0,1,1.0,1,0.3166328879381553,50
885,9,10637,10637,0,0,0,0,1.0,1,1.0,1,1.0,1,0.38769740878434056,49
886,13,10650,10650,0,0,0,0,1.0,1,1.0,1,1.0,1,0.38518746615166405,49
887,10,10660,10660,0,0,0,0,1.0,1,1.0,1,1.0,1,0.38161560438711656,49
888,6,10666,10666,0,0,0,0,1.0,1,1.0,1,1.0,1,0.29473251736699924,47
889,9,10675,10675,0,0,0,0,1.0,1,1.0,1,1.0,1,0.3712987191591967,46
890,11,10686,10686,0,0,0,0,1.0,1,1.0,1,1.0,1,0.38602596907573145,44
891,11,10697,10697,0,0,0,0,1.0,1,1.0,1,1.0,1,0.3767319145607855,45
892,9,10706,10706,0,0,0,0,1.0,1,1.0,1,1.0,1,0.2715225791367637,45
893,16,10722,10722,0,0,0,0,1.0,1,1.0,1,1.0,1,0.35624918055316734,45
894,12,10734,10734,0,0,0,0,1.0,1,1.0,1,1.0,1,0.3060046927993768,44
895,20,10754,10754,0,0,0,0,1.0,1,1.0,1,1.0,1,0.2811980689262095,45
896,8,10762,10762,0,0,0,0,1.0,1,1.0,1,1.0,1,0.38098041665149357,44
897,5,10767,10767,0,0,0,0,1.0,1,1.0,1,1.0,1,0.359923462307971,44
898,9,10776,10776,0,0,0,0,1.0,1,1.0,1,1.0,1,0.2739835008550714,45
899,6,10782,10782,0,0,0,0,1.0,1,1.0,1,1.0,1,0.36341090808391546,44
900,8,10790,10790,0,0,0,0,1.0,1,1.0,1,1.0,1,0.3085600209077221,46
901,16,10806,10806,0,0,0,0,1.0,1,1.0,1,1.0,1,0.2909636636272218,45
902,22,10828,10828,0,0,0,0,1.0,1,1.0,1,1.0,1,0.30045778170815757,45
903,25,10853,10853,0,0,0,0,1.0,1,1.0,1,1.0,1,0.26431782188375624,44
904,13,10866,10866,0,0,0,0,1.0,1,1.0,1,1.0,1,0.3836249734527507,45
905,18,10884,10884,0,0,0,0,1.0,1,1.0,1,1.0,1,0.38983575548159083,45
906,14,10898,10898,0,0,0,0,1.0,1,1.0,1,1.0,1,0.3048240224655052,45
907,16,10914,10914,0,0,0,0,1.0,1,1.0,1,1.0,1,0.3193750010109735,46
908,19,10933,10933,0,0,0,0,1.0,1,1.0,1,1.0,1,0.27125677400029286,46
909,11,10944,10944,0,0,0,0,1.0,1,1.0,1,1.0,1,0.32849167239598,46
910,20,10964,10964,0,0,0,0,1.0,1,1.0,1,1.0,1,0.39766161448130144,44
911,15,10979,10979,0,0,0,0,1.0,1,1.0,1,1.0,1,0.28665231120793994,45
912,30,11009,11009,0,0,0,0,1.0,1,1.0,1,1.0,1,0.3356230226688615,44
913,8,11017,11017,0,0,0,0,1.0,1,1.0,1,1.0,1,0.36215841452135705,45
914,21,11038,11038,0,0,0,0,1.0,1,1.0,1,1.0,1,0.3529845158011975,45
915,13,11051,11051,0,0,0,0,1.0,1,1.0,1,1.0,1,0.3779847515325453,45
916,17,11068,11068,0,0,0,0,1.0,1,1.0,1,1.0,1,0.4294934953774513,45
917,14,11082,11082,0,0,0,0,1.0,1,1.0,1,1.0,1,0.5027828938421718,46
918,10,11092,11092,0,0,0,0,1.0,1,1.0,1,1.0,1,0.33129084038063206,47
919,19,11111,11111,0,0,0,0,1.0,1,1.0,1,1.0,1,0.40092523925967855,47
920,21,11132,11132,0,0,0,0,1.0,1,1.0,1,1.0,1,0.3801787887812023,47
921,20,11152,11152,0,0,0,0,1.0,1,1.0,1,1.0,1,0.39353248495392823,49
922,16,11168,11168,0,0,0,0,1.0,1,1.0,1,1.0,1,0.3855949328480442,49
923,11,11179,11179,0,0,0,0,1.0,1,1.0,1,1.0,1,0.32716679384527375,47
924,9,11188,11188,0,0,0,0,1.0,1,1.0,1,1.0,1,0.23330944401225684,47
925,21,11209,11209,0,0,0,0,1.0,1,1.0,1,1.0,1,0.27789619046170855,47
926,8,11217,11217,0,0,0,0,1.0,1,1.0,1,1.0,1,0.30210467885259473,46
927,15,11232,11232,0,0,0,0,1.0,1,1.0,1,1.0,1,0.27949070647581653,45
928,9,11241,11241,0,0,0,0,1.0,1,1.0,1,1.0,1,0.2780217387786805,43
929,10,11251,11251,0,0,0,0,1.0,1,1.0,1,1.0,1,0.21983966847330147,42
930,10,11261,11261,0,0,0,0,1.0,1,1.0,1,1.0,1,0.146526932747686,41
931,14,11275,11275,0,0,0,0,1.0,1,1.0,1,1.0,1,0.19584390086090078,40
932,12,11287,11287,0,0,0,0,1.0,1,1.0,1,1.0,1,0.22704042862296678,40
933,11,11298,11298,0,0,0,0,1.0,1,1.0,1,1.0,1,0.2767826012295642,39
934,13,11311,11311,0,0,0,0,1.0,1,1.0,1,1.0,1,0.2035327670852141,39
935,16,11327,11327,0,0,0,0,1.0,1,1.0,1,1.0,1,0.34778600035879553,41
936,15,11342,11342,0,0,0,0,1.0,1,1.0,1,1.0,1,0.37413455461525824,42
937,16,11358,11358,0,0,0,0,1.0,1,1.0,1,1.0,1,0.42526385769910047,43
938,14,11372,11372,0,0,0,0,1.0,1,1.0,1,1.0,1,0.3291832302778164,44
939,19,11391,11391,0,0,0,0,1.0,1,1.0,1,1.0,1,0.3170470246559985,46
940,12,11403,11403,0,0,0,0,1.0,1,1.0,1,1.0,1,0.4463584112640965,46
941,15,11418,11418,0,0,0,0,1.0,1,1.0,1,1.0,1,0.402541251377663,46
942,17,11435,11435,0,0,0,0,1.0,1,1.0,1,1.0,1,0.418536358817301,46
943,14,11449,11449,0,0,0,0,1.0,1,1.0,1,1.0,1,0.3851978426140112,45
944,18,11467,11467,0,0,0,0,1.0,1,1.0,1,1.0,1,0.3570322649120555,45
945,16,11483,11483,0,0,0,0,1.0,1,1.0,1,1.0,1,0.4595527002045076,44
946,22,11505,11505,0,0,0,0,1.0,1,1.0,1,1.0,1,0.3877433644853867,46
947,33,11538,11538,0,0,0,0,1.0,1,1.0,1,1.0,1,0.35886604828388224,44
948,14,11552,11552,0,0,0,0,1.0,1,1.0,1,1.0,1,0.45697070088889424,44
949,20,11572,11572,0,0,0,0,1.0,1,1.0,1,1.0,1,0.4270873629943891,44
950,14,11586,11586,0,0,0,0,1.0,1,1.0,1,1.0,1,0.44813890466195033,43
951,16,11602,11602,0,0,0,0,1.0,1,1.0,1,1.0,1,0.5326971257466242,42
952,18,11620,11620,0,0,0,0,1.0,1,1.0,1,1.0,1,0.3635347862388445,42
953,32,11652,11652,0,0,0,0,1.0,1,1.0,1,1.0,1,0.42962542177703855,41
954,11,11663,11663,0,0,0,0,1.0,1,1.0,1,1.0,1,0.4944200961133536,40
955,19,11682,11682,0,0,0,0,1.0,1,1.0,1,1.0,1,0.5225087098845478,42
956,20,11702,11702,0,0,0,0,1.0,1,1.0,1,1.0,1,0.3543002543072486,43
957,28,11730,11730,0,0,0,0,1.0,1,1.0,1,1.0,1,0.4798479428078558,42
958,16,11746,11746,0,0,0,0,1.0,1,1.0,1,1.0,1,0.4853429156296517,43
959,21,11767,11767,0,0,0,0,1.0,1,1.0,1,1.0,1,0.5479962486743496,45
960,14,11781,11781,0,0,0,0,1.0,1,1.0,1,1.0,1,0.46008067994753005,47
961,13,11794,11794,0,0,0,0,1.0,1,1.0,1,1.0,1,0.44927008411077185,45
962,21,11815,11815,0,0,0,0,1.0,1,1.0,1,1.0,1,0.36732531605052277,45
963,25,11840,11840,0,0,0,0,1.0,1,1.0,1,1.0,1,0.4064107764085187,44
964,21,11861,11861,0,0,0,0,1.0,1,1.0,1,1.0,1,0.42711370164158335,44
965,23,11884,11884,0,0,0,0,1.0,1,1.0,1,1.0,1,0.4104499534170695,45
966,17,11901,11901,0,0,0,0,1.0,1,1.0,1,1.0,1,0.4954607897157396,43
967,16,11917,11917,0,0,0,0,1.0,1,1.0,1,1.0,1,0.5273746603666667,43
968,25,11942,11942,0,0,0,0,1.0,1,1.0,1,1.0,1,0.5259486271130244,43
969,14,11956,11956,0,0,0,0,1.0,1,1.0,1,1.0,1,0.5078699904370085,42
970,13,11969,11969,0,0,0,0,1.0,1,1.0,1,1.0,1,0.5299085667004125,42
971,15,11984,11984,0,0,0,0,1.0,1,1.0,1,1.0,1,0.4775069864545778,42
972,17,12001,12001,0,0,0,0,1.0,1,1.0,1,1.0,1,0.47021904944975584,42
973,9,12010,12010,0,0,0,0,1.0,1,1.0,1,1.0,1,0.46003512914983236,43
974,15,12025,12025,0,0,0,0,1.0,1,1.0,1,1.0,1,0.5448607375113409,43
975,17,12042,12042,0,0,0,0,1.0,1,1.0,1,1.0,1,0.4805269110993397,43
976,26,12068,12068,0,0,0,0,1.0,1,1.0,1,1.0,1,0.42937741310956923,45
977,8,12076,12076,0,0,0,0,1.0,1,1.0,1,1.0,1,0.3666929454225126,44
978,11,12087,12087,0,0,0,0,1.0,1,1.0,1,1.0,1,0.47082161152980767,44
979,15,12102,12102,0,0,0,0,1.0,1,1.0,1,1.0,1,0.35178698993747465,45
980,14,12116,12116,0,0,0,0,1.0,1,1.0,1,1.0,1,0.49799302610370383,45
981,13,12129,12129,0,0,0,0,1.0,1,1.0,1,1.0,1,0.4103090182660662,45
982,14,12143,12143,0,0,0,0,1.0,1,1.0,1,1.0,1,0.5266470379323969,46
983,40,12183,12183,0,0,0,0,1.0,1,1.0,1,1.0,1,0.4963754031822135,45
984,15,12198,12198,0,0,0,0,1.0,1,1.0,1,1.0,1,0.34495697782981316,45
985,22,12220,12220,0,0,0,0,1.0,1,1.0,1,1.0,1,0.3657109849997826,45
986,18,12238,12238,0,0,0,0,1.0,1,1.0,1,1.0,1,0.3410275444490347,44
987,14,12252,12252,0,0,0,0,1.0,1,1.0,1,1.0,1,0.49393247080860425,45
988,11,12263,12263,0,0,0,0,1.0,1,1.0,1,1.0,1,0.4485797476467645,44
989,16,12279,12279,0,0,0,0,1.0,1,1.0,1,1.0,1,0.508616680939874,43
990,13,12292,12292,0,0,0,0,1.0,1,1.0,1,1.0,1,0.3931494810855235,42
991,16,12308,12308,0,0,0,0,1.0,1,1.0,1,1.0,1,0.5186188534928416,42
992,19,12327,12327,0,0,0,0,1.0,1,1.0,1,1.0,1,0.5405214311199472,43
993,23,12350,12350,0,0,0,0,1.0,1,1.0,1,1.0,1,0.5247398456634108,43
994,26,12376,12376,0,0,0,0,1.0,1,1.0,1,1.0,1,0.5565868883937537,43
995,11,12387,12387,0,0,0,0,1.0,1,1.0,1,1.0,1,0.4236466617686198,43
996,26,12413,12413,0,0,0,0,1.0,1,1.0,1,1.0,1,0.600859683454735,44
997,23,12436,12436,0,0,0,0,1.0,1,1.0,1,1.0,1,0.5534053595427811,44
998,16,12452,12452,0,0,0,0,1.0,1,1.0,1,1.0,1,0.51779833790535,45
999,16,12468,12468,0,0,0,0,1.0,1,1.0,1,1.0,1,0.5349904196039531,42
1000,17,12485,12485,0,0,0,0,1.0,1,1.0,1,1.0,1,0.5728726057546765,43
1001,24,12509,12509,0,0,0,0,1.0,1,1.0,1,1.0,1,0.5921373301033307,42
1002,10,12519,12519,0,0,0,0,1.0,1,1.0,1,1.0,1,0.5726823884110446,43
1003,20,12539,12539,0,0,0,0,1.0,1,1.0,1,1.0,1,0.49119395484105793,43
1004,19,12558,12558,0,0,0,0,1.0,1,1.0,1,1.0,1,0.6391635567702852,43
1005,23,12581,12581,0,0,0,0,1.0,1,1.0,1,1.0,1,0.5802983869140814,44
1006,29,12610,12610,0,0,0,0,1.0,1,1.0,1,1.0,1,0.5487194965957372,46
1007,26,12636,12636,0,0,0,0,1.0,1,1.0,1,1.0,1,0.5953588262026,46
1008,26,12662,12662,0,0,0,0,1.0,1,1.0,1,1.0,1,0.4422101690659353,47
1009,26,12688,12688,0,0,0,0,1.0,1,1.0,1,1.0,1,0.5728004481982519,48
1010,18,12706,12706,0,0,0,0,1.0,1,1.0,1,1.0,1,0.5845176746970561,48
1011,22,12728,12728,0,0,0,0,1.0,1,1.0,1,1.0,1,0.3775704290077744,48
1012,13,12741,12741,0,0,0,0,1.0,1,1.0,1,1.0,1,0.498346281976585,49
1013,19,12760,12760,0,0,0,0,1.0,1,1.0,1,1.0,1,0.547648491567661,50
1014,16,12776,12776,0,0,0,0,1.0,1,1.0,1,1.0,1,0.5495406830307895,50
1015,18,12794,12794,0,0,0,0,1.0,1,1.0,1,1.0,1,0.4376877603685789,51
1016,14,12808,12808,0,0,0,0,1.0,1,1.0,1,1.0,1,0.46746594861915464,51
1017,13,12821,12821,0,0,0,0,1.0,1,1.0,1,1.0,1,0.42739146530544314,52
1018,23,12844,12844,0,0,0,0,1.0,1,1.0,1,1.0,1,0.4007303314309081,52
1019,16,12860,12860,0,0,0,0,1.0,1,1.0,1,1.0,1,0.31203025021856484,52
1020,14,12874,12874,0,0,0,0,1.0,1,1.0,1,1.0,1,0.3615708239777675,53
1021,14,12888,12888,0,0,0,0,1.0,1,1.0,1,1.0,1,0.3302557629534202,53
1022,11,12899,12899,0,0,0,0,1.0,1,1.0,1,1.0,1,0.3544443986435776,54
1023,12,12911,12911,0,0,0,0,1.0,1,1.0,1,1.0,1,0.33783472149926475,55
1024,13,12924,12924,0,0,0,0,1.0,1,1.0,1,1.0,1,0.35297031861591444,55
1025,20,12944,12944,0,0,0,0,1.0,1,1.0,1,1.0,1,0.3378566627774336,56
1026,19,12963,12963,0,0,0,0,1.0,1,1.0,1,1.0,1,0.377048451220325,57
1027,15,12978,12978,0,0,0,0,1.0,1,1.0,1,1.0,1,0.3346262734166969,58
1028,13,12991,12991,0,0,0,0,1.0,1,1.0,1,1.0,1,0.39978487006896113,58
1029,15,13006,13006,0,0,0,0,1.0,1,1.0,1,1.0,1,0.3310538380185522,59
1030,17,13023,13023,0,0,0,0,1.0,1,1.0,1,1.0,1,0.36887705103071144,60
1031,12,13035,13035,0,0,0,0,1.0,1,1.0,1,1.0,1,0.3821351273050795,60
1032,14,13049,13049,0,0,0,0,1.0,1,1.0,1,1.0,1,0.32851291303826446,61
1033,23,13072,13072,0,0,0,0,1.0,1,1.0,1,1.0,1,0.3316863631348508,60
1034,12,13084,13084,0,0,0,0,1.0,1,1.0,1,1.0,1,0.34714966412451675,60
1035,11,13095,13095,0,0,0,0,1.0,1,1.0,1,1.0,1,0.3651712837427802,59
1036,14,13109,13109,0,0,0,0,1.0,1,1.0,1,1.0,1,0.331106380938799,60
1037,20,13129,13129,0,0,0,0,1.0,1,1.0,1,1.0,1,0.3176944600450503,59
1038,20,13149,13149,0,0,0,0,1.0,1,1.0,1,1.0,1,0.3893903121953049,60
1039,20,13169,13169,0,0,0,0,1.0,1,1.0,1,1.0,1,0.39467291135823396,60
1040,18,13187,13187,0,0,0,0,1.0,1,1.0,1,1.0,1,0.44851486546864083,58
1041,12,13199,13199,0,0,0,0,1.0,1,1.0,1,1.0,1,0.44076767971223135,56
1042,9,13208,13208,0,0,0,0,1.0,1,1.0,1,1.0,1,0.40140805085010783,55
1043,12,13220,13220,0,0,0,0,1.0,1,1.0,1,1.0,1,0.30626372094665816,55
1044,15,13235,13235,0,0,0,0,1.0,1,1.0,1,1.0,1,0.3533965280340453,52
1045,21,13256,13256,0,0,0,0,1.0,1,1.0,1,1.0,1,0.37789686636320197,52
1046,23,13279,13279,0,0,0,0,1.0,1,1.0,1,1.0,1,0.27947998080408154,53
1047,18,13297,13297,0,0,0,0,1.0,1,1.0,1,1.0,1,0.3174219613206902,54
1048,19,13316,13316,0,0,0,0,1.0,1,1.0,1,1.0,1,0.29851398252294575,56
1049,16,13332,13332,0,0,0,0,1.0,1,1.0,1,1.0,1,0.3497201272848158,55
1050,11,13343,13343,0,0,0,0,1.0,1,1.0,1,1.0,1,0.3831872487394528,56
1051,8,13351,13351,0,0,0,0,1.0,1,1.0,1,1.0,1,0.3970677007522587,55
1052,10,13361,13361,0,0,0,0,1.0,1,1.0,1,1.0,1,0.3191519283983128,56
1053,10,13371,13371,0,0,0,0,1.0,1,1.0,1,1.0,1,0.42186177278739284,56
1054,13,13384,13384,0,0,0,0,1.0,1,1.0,1,1.0,1,0.39522479419443135,57
1055,10,13394,13394,0,0,0,0,1.0,1,1.0,1,1.0,1,0.4353999163885552,58
1056,10,13404,13404,0,0,0,0,1.0,1,1.0,1,1.0,1,0.37125547664765884,59
1057,19,13423,13423,0,0,0,0,1.0,1,1.0,1,1.0,1,0.38269655298584276,60
1058,15,13438,13438,0,0,0,0,1.0,1,1.0,1,1.0,1,0.24030426752944803,60
1059,18,13456,13456,0,0,0,0,1.0,1,1.0,1,1.0,1,0.2519047041882938,60
1060,9,13465,13465,0,0,0,0,1.0,1,1.0,1,1.0,1,0.27856126145980326,60
1061,17,13482,13482,0,0,0,0,1.0,1,1.0,1,1.0,1,0.32004794705365597,59
1062,10,13492,13492,0,0,0,0,1.0,1,1.0,1,1.0,1,0.3332379455793197,59
1063,16,13508,13508,0,0,0,0,1.0,1,1.0,1,1.0,1,0.32659821883132767,58
1064,12,13520,13520,0,0,0,0,1.0,1,1.0,1,1.0,1,0.33273498102535154,58
1065,13,13533,13533,0,0,0,0,1.0,1,1.0,1,1.0,1,0.4727039501920671,60
1066,22,13555,13555,0,0,0,0,1.0,1,1.0,1,1.0,1,0.3757616717101303,58
1067,18,13573,13573,0,0,0,0,1.0,1,1.0,1,1.0,1,0.28329031042344277,59
1068,14,13587,13587,0,0,0,0,1.0,1,1.0,1,1.0,1,0.36701393189232207,59
1069,15,13602,13602,0,0,0,0,1.0,1,1.0,1,1.0,1,0.374021382880039,58
1070,17,13619,13619,0,0,0,0,1.0,1,1.0,1,1.0,1,0.28988290811191425,58
1071,12,13631,13631,0,0,0,0,1.0,1,1.0,1,1.0,1,0.3457729672294283,57
1072,8,13639,13639,0,0,0,0,1.0,1,1.0,1,1.0,1,0.3986902959658582,56
1073,15,13654,13654,0,0,0,0,1.0,1,1.0,1,1.0,1,0.3340285740969194,54
1074,13,13667,13667,0,0,0,0,1.0,1,1.0,1,1.0,1,0.371730503604631,54
1075,18,13685,13685,0,0,0,0,1.0,1,1.0,1,1.0,1,0.3524883283989039,51
1076,21,13706,13706,0,0,0,0,1.0,1,1.0,1,1.0,1,0.37662615769129887,51
1077,16,13722,13722,0,0,0,0,1.0,1,1.0,1,1.0,1,0.35896046470458026,51
1078,19,13741,13741,0,0,0,0,1.0,1,1.0,1,1.0,1,0.36908508112647376,52
1079,14,13755,13755,0,0,0,0,1.0,1,1.0,1,1.0,1,0.37724417878033595,51
1080,11,13766,13766,0,0,0,0,1.0,1,1.0,1,1.0,1,0.3584941587450567,51
1081,15,13781,13781,0,0,0,0,1.0,1,1.0,1,1.0,1,0.34969655939188704,48
1082,9,13790,13790,0,0,0,0,1.0,1,1.0,1,1.0,1,0.3783171224957753,47
1083,13,13803,13803,0,0,0,0,1.0,1,1.0,1,1.0,1,0.36973189107237975,46
1084,22,13825,13825,0,0,0,0,1.0,1,1.0,1,1.0,1,0.30566294220909723,45
1085,15,13840,13840,0,0,0,0,1.0,1,1.0,1,1.0,1,0.34875663950688063,46
1086,23,13863,13863,0,0,0,0,1.0,1,1.0,1,1.0,1,0.2964141958953723,45
1087,12,13875,13875,0,0,0,0,1.0,1,1.0,1,1.0,1,0.30671170215136545,44
1088,11,13886,13886,0,0,0,0,1.0,1,1.0,1,1.0,1,0.36688599537769406,45
1089,11,13897,13897,0,0,0,0,1.0,1,1.0,1,1.0,1,0.4066481263078727,46
1090,28,13925,13925,0,0,0,0,1.0,1,1.0,1,1.0,1,0.3372432632976041,47
1091,16,13941,13941,0,0,0,0,1.0,1,1.0,1,1.0,1,0.26850106762266107,47
1092,23,13964,13964,0,0,0,0,1.0,1,1.0,1,1.0,1,0.3374958748707684,48
1093,29,13993,13993,0,0,0,0,1.0,1,1.0,1,1.0,1,0.295443343970268,48
1094,20,14013,14013,0,0,0,0,1.0,1,1.0,1,1.0,1,0.2504920049197371,48
1095,16,14029,14029,0,0,0,0,1.0,1,1.0,1,1.0,1,0.29606514429439895,49
1096,17,14046,14046,0,0,0,0,1.0,1,1.0,1,1.0,1,0.2698075394726504,49
1097,16,14062,14062,0,0,0,0,1.0,1,1.0,1,1.0,1,0.3246964319135937,50
1098,22,14084,14084,0,0,0,0,1.0,1,1.0,1,1.0,1,0.366427876085132,51
1099,11,14095,14095,0,0,0,0,1.0,1,1.0,1,1.0,1,0.35116427206635664,54
1100,14,14109,14109,0,0,0,0,1.0,1,1.0,1,1.0,1,0.40706075922674395,54
1101,20,14129,14129,0,0,0,0,1.0,1,1.0,1,1.0,1,0.30763089222536855,54
1102,17,14146,14146,0,0,0,0,1.0,1,1.0,1,1.0,1,0.41469144723281487,54
1103,15,14161,14161,0,0,0,0,1.0,1,1.0,1,1.0,1,0.3457475909274468,53
1104,14,14175,14175,0,0,0,0,1.0,1,1.0,1,1.0,1,0.2742373505060984,53
1105,27,14202,14202,0,0,0,0,1.0,1,1.0,1,1.0,1,0.3451060198840593,52
1106,12,14214,14214,0,0,0,0,1.0,1,1.0,1,1.0,1,0.3020252937646689,52
1107,32,14246,14246,0,0,0,0,1.0,1,1.0,1,1.0,1,0.32490338452073386,52
1108,17,14263,14263,0,0,0,0,1.0,1,1.0,1,1.0,1,0.37087912104362747,51
1109,24,14287,14287,0,0,0,0,1.0,1,1.0,1,1.0,1,0.43480457553613205,49
1110,41,14328,14328,0,0,0,0,1.0,1,1.0,1,1.0,1,0.4087323037445274,48
1111,23,14351,14351,0,0,0,0,1.0,1,1.0,1,1.0,1,0.4063784905873166,47
1112,19,14370,14370,0,0,0,0,1.0,1,1.0,1,1.0,1,0.416328800385025,46
1113,20,14390,14390,0,0,0,0,1.0,1,1.0,1,1.0,1,0.47351618411182655,43
1114,12,14402,14402,0,0,0,0,1.0,1,1.0,1,1.0,1,0.4460253526191912,41
1115,26,14428,14428,0,0,0,0,1.0,1,1.0,1,1.0,1,0.5261309782726183,40
1116,14,14442,14442,0,0,0,0,1.0,1,1.0,1,1.0,1,0.4607860748404439,39
1117,19,14461,14461,0,0,0,0,1.0,1,1.0,1,1.0,1,0.3867042114495843,40
1118,27,14488,14488,0,0,0,0,1.0,1,1.0,1,1.0,1,0.49223617077699516,40
1119,25,14513,14513,0,0,0,0,1.0,1,1.0,1,1.0,1,0.35256461969661335,40
1120,20,14533,14533,0,0,0,0,1.0,1,1.0,1,1.0,1,0.49518099233837365,40
1121,9,14542,14542,0,0,0,0,1.0,1,1.0,1,1.0,1,0.37818701773108426,40
1122,15,14557,14557,0,0,0,0,1.0,1,1.0,1,1.0,1,0.47523343459706197,41
1123,12,14569,14569,0,0,0,0,1.0,1,1.0,1,1.0,1,0.3949177468934952,41
1124,9,14578,14578,0,0,0,0,1.0,1,1.0,1,1.0,1,0.3743113794278752,41
1125,9,14587,14587,0,0,0,0,1.0,1,1.0,1,1.0,1,0.3866258423459305,41
1126,11,14598,14598,0,0,0,0,1.0,1,1.0,1,1.0,1,0.34655703703003765,41
1127,6,14604,14604,0,0,0,0,1.0,1,1.0,1,1.0,1,0.36134674019162333,41
1128,10,14614,14614,0,0,0,0,1.0,1,1.0,1,1.0,1,0.43605539687677414,42
1129,11,14625,14625,0,0,0,0,1.0,1,1.0,1,1.0,1,0.36896084186026185,42
1130,6,14631,14631,0,0,0,0,1.0,1,1.0,1,1.0,1,0.4115186930888076,42
1131,8,14639,14639,0,0,0,0,1.0,1,1.0,1,1.0,1,0.4293713658593345,42
1132,15,14654,14654,0,0,0,0,1.0,1,1.0,1,1.0,1,0.30692998797531784,43
1133,15,14669,14669,0,0,0,0,1.0,1,1.0,1,1.0,1,0.3838719184850112,45
1134,8,14677,14677,0,0,0,0,1.0,1,1.0,1,1.0,1,0.35606279475880565,46
1135,7,14684,14684,0,0,0,0,1.0,1,1.0,1,1.0,1,0.4191826214295958,45
1136,7,14691,14691,0,0,0,0,1.0,1,1.0,1,1.0,1,0.43988792757452666,48
1137,9,14700,14700,0,0,0,0,1.0,1,1.0,1,1.0,1,0.404630844166737,49
1138,22,14722,14722,0,0,0,0,1.0,1,1.0,1,1.0,1,0.32739057013666684,49
1139,12,14734,14734,0,0,0,0,1.0,1,1.0,1,1.0,1,0.37017390619536417,49
1140,20,14754,14754,0,0,0,0,1.0,1,1.0,1,1.0,1,0.32514073898534673,49
1141,19,14773,14773,0,0,0,0,1.0,1,1.0,1,1.0,1,0.3103942471757268,48
1142,19,14792,14792,0,0,0,0,1.0,1,1.0,1,1.0,1,0.347623099249478,48
1143,15,14807,14807,0,0,0,0,1.0,1,1.0,1,1.0,1,0.30752702644439794,48
1144,26,14833,14833,0,0,0,0,1.0,1,1.0,1,1.0,1,0.39220541110693324,48
1145,16,14849,14849,0,0,0,0,1.0,1,1.0,1,1.0,1,0.36643183331357343,48
1146,22,14871,14871,0,0,0,0,1.0,1,1.0,1,1.0,1,0.28958811065851875,48
1147,25,14896,14896,0,0,0,0,1.0,1,1.0,1,1.0,1,0.5079650020677187,46
1148,13,14909,14909,0,0,0,0,1.0,1,1.0,1,1.0,1,0.42370716554329235,46
1149,9,14918,14918,0,0,0,0,1.0,1,1.0,1,1.0,1,0.39521276192912863,45
1150,20,14938,14938,0,0,0,0,1.0,1,1.0,1,1.0,1,0.4567580952409747,46
1151,13,14951,14951,0,0,0,0,1.0,1,1.0,1,1.0,1,0.34859096482900187,44
1152,14,14965,14965,0,0,0,0,1.0,1,1.0,1,1.0,1,0.3822932034024656,44
1153,11,14976,14976,0,0,0,0,1.0,1,1.0,1,1.0,1,0.41353595180232944,43
1154,16,14992,14992,0,0,0,0,1.0,1,1.0,1,1.0,1,0.35025135616167696,43
1155,16,15008,15008,0,0,0,0,1.0,1,1.0,1,1.0,1,0.41205793316831674,43
1156,12,15020,15020,0,0,0,0,1.0,1,1.0,1,1.0,1,0.4058341484230392,42
1157,21,15041,15041,0,0,0,0,1.0,1,1.0,1,1.0,1,0.38478864617228514,42
1158,10,15051,15051,0,0,0,0,1.0,1,1.0,1,1.0,1,0.3359003727746536,41
1159,22,15073,15073,0,0,0,0,1.0,1,1.0,1,1.0,1,0.36838207964938724,41
1160,14,15087,15087,0,0,0,0,1.0,1,1.0,1,1.0,1,0.43973436070229444,41
1161,7,15094,15094,0,0,0,0,1.0,1,1.0,1,1.0,1,0.45000641936543423,42
1162,10,15104,15104,0,0,0,0,1.0,1,1.0,1,1.0,1,0.30035541463396137,43
1163,9,15113,15113,0,0,0,0,1.0,1,1.0,1,1.0,1,0.38900204426876267,43
1164,6,15119,15119,0,0,0,0,1.0,1,1.0,1,1.0,1,0.40490016664562134,44
1165,14,15133,15133,0,0,0,0,1.0,1,1.0,1,1.0,1,0.3013166113764775,44
1166,12,15145,15145,0,0,0,0,1.0,1,1.0,1,1.0,1,0.34105774205128975,46
1167,15,15160,15160,0,0,0,0,1.0,1,1.0,1,1.0,1,0.3734399380785775,46
1168,15,15175,15175,0,0,0,0,1.0,1,1.0,1,1.0,1,0.21930400131075461,47
1169,13,15188,15188,0,0,0,0,1.0,1,1.0,1,1.0,1,0.4095299814500347,46
1170,17,15205,15205,0,0,0,0,1.0,1,1.0,1,1.0,1,0.34203390398528766,48
1171,10,15215,15215,0,0,0,0,1.0,1,1.0,1,1.0,1,0.3639505657851408,49
1172,14,15229,15229,0,0,0,0,1.0,1,1.0,1,1.0,1,0.31676179096806467,49
1173,11,15240,15240,0,0,0,0,1.0,1,1.0,1,1.0,1,0.2848275358570885,49
1174,20,15260,15260,0,0,0,0,1.0,1,1.0,1,1.0,1,0.3633746786857742,49
1175,21,15281,15281,0,0,0,0,1.0,1,1.0,1,1.0,1,0.26425265906819306,50
1176,21,15302,15302,0,0,0,0,1.0,1,1.0,1,1.0,1,0.3818751379292946,52
1177,12,15314,15314,0,0,0,0,1.0,1,1.0,1,1.0,1,0.35204118463230627,52
1178,23,15337,15337,0,0,0,0,1.0,1,1.0,1,1.0,1,0.3633636793285139,52
1179,21,15358,15358,0,0,0,0,1.0,1,1.0,1,1.0,1,0.3215397851079783,53
1180,33,15391,15391,0,0,0,0,1.0,1,1.0,1,1.0,1,0.34451794743337727,54
1181,17,15408,15408,0,0,0,0,1.0,1,1.0,1,1.0,1,0.331059966931191,55
1182,21,15429,15429,0,0,0,0,1.0,1,1.0,1,1.0,1,0.26308139157096183,55
1183,40,15469,15469,0,0,0,0,1.0,1,1.0,1,1.0,1,0.2998271467362514,53
1184,18,15487,15487,0,0,0,0,1.0,1,1.0,1,1.0,1,0.32715910366391837,54
1185,19,15506,15506,0,0,0,0,1.0,1,1.0,1,1.0,1,0.273192837193438,53
1186,12,15518,15518,0,0,0,0,1.0,1,1.0,1,1.0,1,0.41169194513779983,54
1187,14,15532,15532,0,0,0,0,1.0,1,1.0,1,1.0,1,0.37670518008297604,55
1188,25,15557,15557,0,0,0,0,1.0,1,1.0,1,1.0,1,0.2958363669154711,55
1189,17,15574,15574,0,0,0,0,1.0,1,1.0,1,1.0,1,0.3058205178983891,54
1190,13,15587,15587,0,0,0,0,1.0,1,1.0,1,1.0,1,0.3962820400031776,55
1191,19,15606,15606,0,0,0,0,1.0,1,1.0,1,1.0,1,0.2964677566111496,54
1192,20,15626,15626,0,0,0,0,1.0,1,1.0,1,1.0,1,0.16756429438217962,52
1193,16,15642,15642,0,0,0,0,1.0,1,1.0,1,1.0,1,0.2842908033920077,53
1194,10,15652,15652,0,0,0,0,1.0,1,1.0,1,1.0,1,0.2817418237521794,53
1195,8,15660,15660,0,0,0,0,1.0,1,1.0,1,1.0,1,0.31495646860109716,54
1196,21,15681,15681,0,0,0,0,1.0,1,1.0,1,1.0,1,0.26399486513833464,56
1197,17,15698,15698,0,0,0,0,1.0,1,1.0,1,1.0,1,0.2393339393373044,56
1198,20,15718,15718,0,0,0,0,1.0,1,1.0,1,1.0,1,0.3961406872681989,58
1199,17,15735,15735,0,0,0,0,1.0,1,1.0,1,1.0,1,0.3962336503875424,58
1200,13,15748,15748,0,0,0,0,1.0,1,1.0,1,1.0,1,0.3460030740504515,58
1201,16,15764,15764,0,0,0,0,1.0,1,1.0,1,1.0,1,0.26551854206260134,58
1202,13,15777,15777,0,0,0,0,1.0,1,1.0,1,1.0,1,0.22816845669869065,60
1203,10,15787,15787,0,0,0,0,1.0,1,1.0,1,1.0,1,0.2612070876034499,58
1204,10,15797,15797,0,0,0,0,1.0,1,1.0,1,1.0,1,0.24821031406791455,59
1205,12,15809,15809,0,0,0,0,1.0,1,1.0,1,1.0,1,0.24029553512686627,59
1206,8,15817,15817,0,0,0,0,1.0,1,1.0,1,1.0,1,0.23637119551275468,58
1207,16,15833,15833,0,0,0,0,1.0,1,1.0,1,1.0,1,0.32373653326576207,60
1208,16,15849,15849,0,0,0,0,1.0,1,1.0,1,1.0,1,0.2407337802711969,60
1209,22,15871,15871,0,0,0,0,1.0,1,1.0,1,1.0,1,0.2949200328451541,61
1210,10,15881,15881,0,0,0,0,1.0,1,1.0,1,1.0,1,0.32033389803011736,61
1211,18,15899,15899,0,0,0,0,1.0,1,1.0,1,1.0,1,0.28538996839176745,63
1212,20,15919,15919,0,0,0,0,1.0,1,1.0,1,1.0,1,0.23327005880204119,63
1213,24,15943,15943,0,0,0,0,1.0,1,1.0,1,1.0,1,0.3316953629669342,63
1214,15,15958,15958,0,0,0,0,1.0,1,1.0,1,1.0,1,0.3028272071594154,62
1215,26,15984,15984,0,0,0,0,1.0,1,1.0,1,1.0,1,0.2717372455171152,63
1216,17,16001,16001,0,0,0,0,1.0,1,1.0,1,1.0,1,0.38105606505149375,64
1217,16,16017,16017,0,0,0,0,1.0,1,1.0,1,1.0,1,0.3045344354328013,65
1218,18,16035,16035,0,0,0,0,1.0,1,1.0,1,1.0,1,0.28546648553617543,64
1219,23,16058,16058,0,0,0,0,1.0,1,1.0,1,1.0,1,0.3121075212338393,65
1220,16,16074,16074,0,0,0,0,1.0,1,1.0,1,1.0,1,0.35376269603041305,64
1221,20,16094,16094,0,0,0,0,1.0,1,1.0,1,1.0,1,0.36261095881562977,65
1222,14,16108,16108,0,0,0,0,1.0,1,1.0,1,1.0,1,0.34042434154605955,66
1223,19,16127,16127,0,0,0,0,1.0,1,1.0,1,1.0,1,0.20885291655078625,64
1224,17,16144,16144,0,0,0,0,1.0,1,1.0,1,1.0,1,0.3546296732144397,66
1225,19,16163,16163,0,0,0,0,1.0,1,1.0,1,1.0,1,0.3219412002110449,66
1226,16,16179,16179,0,0,0,0,1.0,1,1.0,1,1.0,1,0.3941802335198467,68
1227,37,16216,16216,0,0,0,0,1.0,1,1.0,1,1.0,1,0.35583066598403357,64
1228,17,16233,16233,0,0,0,0,1.0,1,1.0,1,1.0,1,0.2938885168227491,62
1229,19,16252,16252,0,0,0,0,1.0,1,1.0,1,1.0,1,0.44355704621598363,61
1230,11,16263,16263,0,0,0,0,1.0,1,1.0,1,1.0,1,0.32001669393384435,58
1231,12,16275,16275,0,0,0,0,1.0,1,1.0,1,1.0,1,0.43663343621152406,57
1232,16,16291,16291,0,0,0,0,1.0,1,1.0,1,1.0,1,0.46219256126270686,53
1233,14,16305,16305,0,0,0,0,1.0,1,1.0,1,1.0,1,0.4048030207057516,53
1234,18,16323,16323,0,0,0,0,1.0,1,1.0,1,1.0,1,0.39167298911929066,54
1235,20,16343,16343,0,0,0,0,1.0,1,1.0,1,1.0,1,0.38911618683732213,55
1236,25,16368,16368,0,0,0,0,1.0,1,1.0,1,1.0,1,0.4049762906604977,55
1237,21,16389,16389,0,0,0,0,1.0,1,1.0,1,1.0,1,0.3830808729673137,55
1238,18,16407,16407,0,0,0,0,1.0,1,1.0,1,1.0,1,0.466837725441398,54
1239,5,16412,16412,0,0,0,0,1.0,1,1.0,1,1.0,1,0.41711723537031725,55
1240,11,16423,16423,0,0,0,0,1.0,1,1.0,1,1.0,1,0.3951537928946864,55
1241,13,16436,16436,0,0,0,0,1.0,1,1.0,1,1.0,1,0.32410904001918117,54
1242,10,16446,16446,0,0,0,0,1.0,1,1.0,1,1.0,1,0.33245446404661655,54
1243,17,16463,16463,0,0,0,0,1.0,1,1.0,1,1.0,1,0.3619199900258289,55
1244,19,16482,16482,0,0,0,0,1.0,1,1.0,1,1.0,1,0.3505334873807679,55
1245,33,16515,16515,0,0,0,0,1.0,1,1.0,1,1.0,1,0.3369544226692742,55
1246,20,16535,16535,0,0,0,0,1.0,1,1.0,1,1.0,1,0.3563836114621265,55
1247,37,16572,16572,0,0,0,0,1.0,1,1.0,1,1.0,1,0.3733427601586925,57
1248,25,16597,16597,0,0,0,0,1.0,1,1.0,1,1.0,1,0.34857866109796837,56
1249,22,16619,16619,0,0,0,0,1.0,1,1.0,1,1.0,1,0.35260775420615237,56
1250,21,16640,16640,0,0,0,0,1.0,1,1.0,1,1.0,1,0.30351935426807763,56
1251,18,16658,16658,0,0,0,0,1.0,1,1.0,1,1.0,1,0.36345516052791976,58
1252,25,16683,16683,0,0,0,0,1.0,1,1.0,1,1.0,1,0.2639577738572396,58
1253,24,16707,16707,0,0,0,0,1.0,1,1.0,1,1.0,1,0.39727142230357726,58
1254,14,16721,16721,0,0,0,0,1.0,1,1.0,1,1.0,1,0.3758292985290277,60
1255,31,16752,16752,0,0,0,0,1.0,1,1.0,1,1.0,1,0.49204587607900546,61
1256,25,16777,16777,0,0,0,0,1.0,1,1.0,1,1.0,1,0.4347160550300563,61
1257,14,16791,16791,0,0,0,0,1.0,1,1.0,1,1.0,1,0.2788591645557501,62
1258,14,16805,16805,0,0,0,0,1.0,1,1.0,1,1.0,1,0.4551161952172709,63
1259,31,16836,16836,0,0,0,0,1.0,1,1.0,1,1.0,1,0.30288299558937076,63
1260,18,16854,16854,0,0,0,0,1.0,1,1.0,1,1.0,1,0.4178232897427872,63
1261,39,16893,16893,0,0,0,0,1.0,1,1.0,1,1.0,1,0.4303852399758213,63
1262,37,16930,16930,0,0,0,0,1.0,1,1.0,1,1.0,1,0.38564292493873853,64
1263,16,16946,16946,0,0,0,0,1.0,1,1.0,1,1.0,1,0.43058069861960735,63
1264,23,16969,16969,0,0,0,0,1.0,1,1.0,1,1.0,1,0.3288658706133282,63
1265,24,16993,16993,0,0,0,0,1.0,1,1.0,1,1.0,1,0.5156401154422816,60
1266,25,17018,17018,0,0,0,0,1.0,1,1.0,1,1.0,1,0.27172990732306834,61
1267,22,17040,17040,0,0,0,0,1.0,1,1.0,1,1.0,1,0.42869574318930537,58
1268,17,17057,17057,0,0,0,0,1.0,1,1.0,1,1.0,1,0.33319825347382814,54
1269,16,17073,17073,0,0,0,0,1.0,1,1.0,1,1.0,1,0.3791665117380771,54
1270,16,17089,17089,0,0,0,0,1.0,1,1.0,1,1.0,1,0.27454762070636773,51
1271,13,17102,17102,0,0,0,0,1.0,1,1.0,1,1.0,1,0.3355324971620189,50
1272,6,17108,17108,0,0,0,0,1.0,1,1.0,1,1.0,1,0.41783837633897275,47
1273,7,17115,17115,0,0,0,0,1.0,1,1.0,1,1.0,1,0.3463129145642864,47
1274,30,17145,17145,0,0,0,0,1.0,1,1.0,1,1.0,1,0.28654277431909003,49
1275,16,17161,17161,0,0,0,0,1.0,1,1.0,1,1.0,1,0.24638899471736378,48
1276,20,17181,17181,0,0,0,0,1.0,1,1.0,1,1.0,1,0.3017171521595226,49
1277,15,17196,17196,0,0,0,0,1.0,1,1.0,1,1.0,1,0.32117944091571826,50
1278,18,17214,17214,0,0,0,0,1.0,1,1.0,1,1.0,1,0.34157436444110995,51
1279,22,17236,17236,0,0,0,0,1.0,1,1.0,1,1.0,1,0.2804821960812523,51
1280,15,17251,17251,0,0,0,0,1.0,1,1.0,1,1.0,1,0.2675713475890362,52
1281,12,17263,17263,0,0,0,0,1.0,1,1.0,1,1.0,1,0.2781187096657637,52
1282,13,17276,17276,0,0,0,0,1.0,1,1.0,1,1.0,1,0.22366550896959683,52
1283,17,17293,17293,0,0,0,0,1.0,1,1.0,1,1.0,1,0.3688032852806026,52
1284,20,17313,17313,0,0,0,0,1.0,1,1.0,1,1.0,1,0.3459212323144478,52
1285,24,17337,17337,0,0,0,0,1.0,1,1.0,1,1.0,1,0.4146147273261051,51
1286,23,17360,17360,0,0,0,0,1.0,1,1.0,1,1.0,1,0.4549399806774723,52
1287,23,17383,17383,0,0,0,0,1.0,1,1.0,1,1.0,1,0.43425451637238704,54
1288,15,17398,17398,0,0,0,0,1.0,1,1.0,1,1.0,1,0.22332981777872143,55
1289,14,17412,17412,0,0,0,0,1.0,1,1.0,1,1.0,1,0.3682658214791876,56
1290,14,17426,17426,0,0,0,0,1.0,1,1.0,1,1.0,1,0.3733233502198542,57
1291,26,17452,17452,0,0,0,0,1.0,1,1.0,1,1.0,1,0.30657409273322656,58
1292,18,17470,17470,0,0,0,0,1.0,1,1.0,1,1.0,1,0.33547611114769416,59
1293,19,17489,17489,0,0,0,0,1.0,1,1.0,1,1.0,1,0.3106072172985465,59
1294,20,17509,17509,0,0,0,0,1.0,1,1.0,1,1.0,1,0.2921369961983339,59
1295,14,17523,17523,0,0,0,0,1.0,1,1.0,1,1.0,1,0.21102946791834917,59
1296,14,17537,17537,0,0,0,0,1.0,1,1.0,1,1.0,1,0.2796917325247313,59
1297,10,17547,17547,0,0,0,0,1.0,1,1.0,1,1.0,1,0.23764536425777255,61
1298,9,17556,17556,0,0,0,0,1.0,1,1.0,1,1.0,1,0.2731972946639018,61
1299,14,17570,17570,0,0,0,0,1.0,1,1.0,1,1.0,1,0.21059807920887347,60
1300,11,17581,17581,0,0,0,0,1.0,1,1.0,1,1.0,1,0.23493871261995494,59
1301,8,17589,17589,0,0,0,0,1.0,1,1.0,1,1.0,1,0.21267246176821367,59
1302,10,17599,17599,0,0,0,0,1.0,1,1.0,1,1.0,1,0.2819927163262379,59
1303,19,17618,17618,0,0,0,0,1.0,1,1.0,1,1.0,1,0.3012816796910756,55
1304,21,17639,17639,0,0,0,0,1.0,1,1.0,1,1.0,1,0.23249205351001218,56
1305,12,17651,17651,0,0,0,0,1.0,1,1.0,1,1.0,1,0.2609148987546702,54
1306,12,17663,17663,0,0,0,0,1.0,1,1.0,1,1.0,1,0.3213500850044556,53
1307,13,17676,17676,0,0,0,0,1.0,1,1.0,1,1.0,1,0.36297978921137686,52
1308,20,17696,17696,0,0,0,0,1.0,1,1.0,1,1.0,1,0.26820428056056356,52
1309,19,17715,17715,0,0,0,0,1.0,1,1.0,1,1.0,1,0.2574907577990198,54
1310,15,17730,17730,0,0,0,0,1.0,1,1.0,1,1.0,1,0.27106780568780753,52
1311,16,17746,17746,0,0,0,0,1.0,1,1.0,1,1.0,1,0.21663192845423845,51
1312,12,17758,17758,0,0,0,0,1.0,1,1.0,1,1.0,1,0.31187677541776254,49
1313,12,17770,17770,0,0,0,0,1.0,1,1.0,1,1.0,1,0.40072195186682963,47
1314,20,17790,17790,0,0,0,0,1.0,1,1.0,1,1.0,1,0.45562880551124524,46
1315,20,17810,17810,0,0,0,0,1.0,1,1.0,1,1.0,1,0.3991904548446889,45
1316,23,17833,17833,0,0,0,0,1.0,1,1.0,1,1.0,1,0.3641569072000493,46
1317,21,17854,17854,0,0,0,0,1.0,1,1.0,1,1.0,1,0.40986787857811824,45
1318,22,17876,17876,0,0,0,0,1.0,1,1.0,1,1.0,1,0.3890998008820608,46
1319,20,17896,17896,0,0,0,0,1.0,1,1.0,1,1.0,1,0.3850218456346324,46
1320,11,17907,17907,0,0,0,0,1.0,1,1.0,1,1.0,1,0.2791381437518279,46
1321,17,17924,17924,0,0,0,0,1.0,1,1.0,1,1.0,1,0.2737305653281731,48
1322,15,17939,17939,0,0,0,0,1.0,1,1.0,1,1.0,1,0.30644128927752234,49
1323,14,17953,17953,0,0,0,0,1.0,1,1.0,1,1.0,1,0.18008655920020206,49
1324,20,17973,17973,0,0,0,0,1.0,1,1.0,1,1.0,1,0.3437627887075232,50
1325,14,17987,17987,0,0,0,0,1.0,1,1.0,1,1.0,1,0.28821029525948794,49
1326,13,18000,18000,0,0,0,0,1.0,1,1.0,1,1.0,1,0.22809976227571827,50
1327,22,18022,18022,0,0,0,0,1.0,1,1.0,1,1.0,1,0.27037831801283946,50
1328,21,18043,18043,0,0,0,0,1.0,1,1.0,1,1.0,1,0.30510790784742947,49
1329,20,18063,18063,0,0,0,0,1.0,1,1.0,1,1.0,1,0.29655777422708113,50
1330,16,18079,18079,0,0,0,0,1.0,1,1.0,1,1.0,1,0.1870842232173201,50
1331,17,18096,18096,0,0,0,0,1.0,1,1.0,1,1.0,1,0.33510899312489945,50
1332,16,18112,18112,0,0,0,0,1.0,1,1.0,1,1.0,1,0.25131025582225003,51
1333,17,18129,18129,0,0,0,0,1.0,1,1.0,1,1.0,1,0.24135432678416324,52
1334,17,18146,18146,0,0,0,0,1.0,1,1.0,1,1.0,1,0.2898097444046428,54
1335,24,18170,18170,0,0,0,0,1.0,1,1.0,1,1.0,1,0.28111041927497743,54
1336,28,18198,18198,0,0,0,0,1.0,1,1.0,1,1.0,1,0.32943477192737175,56
1337,18,18216,18216,0,0,0,0,1.0,1,1.0,1,1.0,1,0.28377574623353363,57
1338,9,18225,18225,0,0,0,0,1.0,1,1.0,1,1.0,1,0.32697808890756663,57
1339,16,18241,18241,0,0,0,0,1.0,1,1.0,1,1.0,1,0.29677903309679915,58
1340,17,18258,18258,0,0,0,0,1.0,1,1.0,1,1.0,1,0.35194529351092635,59
1341,12,18270,18270,0,0,0,0,1.0,1,1.0,1,1.0,1,0.36192421155173554,57
1342,11,18281,18281,0,0,0,0,1.0,1,1.0,1,1.0,1,0.2932298394784033,57
1343,11,18292,18292,0,0,0,0,1.0,1,1.0,1,1.0,1,0.3698830959359092,55
1344,8,18300,18300,0,0,0,0,1.0,1,1.0,1,1.0,1,0.35053877181188786,54
1345,19,18319,18319,0,0,0,0,1.0,1,1.0,1,1.0,1,0.33518984069436275,53
1346,17,18336,18336,0,0,0,0,1.0,1,1.0,1,1.0,1,0.4156812861646384,53
1347,20,18356,18356,0,0,0,0,1.0,1,1.0,1,1.0,1,0.27043986881682414,51
1348,19,18375,18375,0,0,0,0,1.0,1,1.0,1,1.0,1,0.2840773728747548,52
1349,15,18390,18390,0,0,0,0,1.0,1,1.0,1,1.0,1,0.4007756473278805,50
1350,10,18400,18400,0,0,0,0,1.0,1,1.0,1,1.0,1,0.347184753485655,51
1351,13,18413,18413,0,0,0,0,1.0,1,1.0,1,1.0,1,0.3407104969865747,50
1352,25,18438,18438,0,0,0,0,1.0,1,1.0,1,1.0,1,0.4371819241107247,50
1353,30,18468,18468,0,0,0,0,1.0,1,1.0,1,1.0,1,0.3577686576204883,50
1354,29,18497,18497,0,0,0,0,1.0,1,1.0,1,1.0,1,0.417374983347962,51
1355,29,18526,18526,0,0,0,0,1.0,1,1.0,1,1.0,1,0.36820088443060456,53
1356,32,18558,18558,0,0,0,0,1.0,1,1.0,1,1.0,1,0.3654754915033304,52
1357,19,18577,18577,0,0,0,0,1.0,1,1.0,1,1.0,1,0.15944301163130298,52
1358,19,18596,18596,0,0,0,0,1.0,1,1.0,1,1.0,1,0.3365270846090123,53
1359,29,18625,18625,0,0,0,0,1.0,1,1.0,1,1.0,1,0.42393817625759056,54
1360,17,18642,18642,0,0,0,0,1.0,1,1.0,1,1.0,1,0.24062747650588256,55
1361,21,18663,18663,0,0,0,0,1.0,1,1.0,1,1.0,1,0.350026815775458,55
1362,23,18686,18686,0,0,0,0,1.0,1,1.0,1,1.0,1,0.3569775227153689,56
1363,14,18700,18700,0,0,0,0,1.0,1,1.0,1,1.0,1,0.22772324226262514,56
1364,14,18714,18714,0,0,0,0,1.0,1,1.0,1,1.0,1,0.3793420902019411,55
1365,20,18734,18734,0,0,0,0,1.0,1,1.0,1,1.0,1,0.38257255907660087,56
1366,17,18751,18751,0,0,0,0,1.0,1,1.0,1,1.0,1,0.23998475512194312,57
1367,20,18771,18771,0,0,0,0,1.0,1,1.0,1,1.0,1,0.4302612670842469,57
1368,20,18791,18791,0,0,0,0,1.0,1,1.0,1,1.0,1,0.3694707097835436,58
1369,28,18819,18819,0,0,0,0,1.0,1,1.0,1,1.0,1,0.4501212508484452,59
1370,24,18843,18843,0,0,0,0,1.0,1,1.0,1,1.0,1,0.32061593019938117,60
1371,32,18875,18875,0,0,0,0,1.0,1,1.0,1,1.0,1,0.3582159643574202,59
1372,19,18894,18894,0,0,0,0,1.0,1,1.0,1,1.0,1,0.3828170368616379,59
1373,19,18913,18913,0,0,0,0,1.0,1,1.0,1,1.0,1,0.3581493679424814,59
1374,27,18940,18940,0,0,0,0,1.0,1,1.0,1,1.0,1,0.4320868889070586,59
1375,13,18953,18953,0,0,0,0,1.0,1,1.0,1,1.0,1,0.39998209706467,62
1376,10,18963,18963,0,0,0,0,1.0,1,1.0,1,1.0,1,0.43719612679624853,61
1377,11,18974,18974,0,0,0,0,1.0,1,1.0,1,1.0,1,0.3688332995702455,63
1378,13,18987,18987,0,0,0,0,1.0,1,1.0,1,1.0,1,0.3229099641569281,62
1379,14,19001,19001,0,0,0,0,1.0,1,1.0,1,1.0,1,0.40767126002555387,61
1380,21,19022,19022,0,0,0,0,1.0,1,1.0,1,1.0,1,0.4114661851116022,60
1381,16,19038,19038,0,0,0,0,1.0,1,1.0,1,1.0,1,0.3069690910974852,58
1382,18,19056,19056,0,0,0,0,1.0,1,1.0,1,1.0,1,0.3552966597482804,56
1383,29,19085,19085,0,0,0,0,1.0,1,1.0,1,1.0,1,0.4155161338922716,57
1384,21,19106,19106,0,0,0,0,1.0,1,1.0,1,1.0,1,0.28530289828615846,55
1385,20,19126,19126,0,0,0,0,1.0,1,1.0,1,1.0,1,0.4176996377084998,55
1386,19,19145,19145,0,0,0,0,1.0,1,1.0,1,1.0,1,0.4231252043758152,54
1387,16,19161,19161,0,0,0,0,1.0,1,1.0,1,1.0,1,0.39360933198808856,53
1388,27,19188,19188,0,0,0,0,1.0,1,1.0,1,1.0,1,0.3254185915828784,52
1389,19,19207,19207,0,0,0,0,1.0,1,1.0,1,1.0,1,0.4573779285716814,52
1390,20,19227,19227,0,0,0,0,1.0,1,1.0,1,1.0,1,0.3370275226900604,51
1391,21,19248,19248,0,0,0,0,1.0,1,1.0,1,1.0,1,0.4061838982950459,52
1392,13,19261,19261,0,0,0,0,1.0,1,1.0,1,1.0,1,0.4319585611888744,51
1393,11,19272,19272,0,0,0,0,1.0,1,1.0,1,1.0,1,0.4919207659540931,51
1394,25,19297,19297,0,0,0,0,1.0,1,1.0,1,1.0,1,0.4620279496187035,52
1395,16,19313,19313,0,0,0,0,1.0,1,1.0,1,1.0,1,0.27976521997721804,52
1396,22,19335,19335,0,0,0,0,1.0,1,1.0,1,1.0,1,0.4004080647984286,53
1397,30,19365,19365,0,0,0,0,1.0,1,1.0,1,1.0,1,0.3914541293504286,56
1398,21,19386,19386,0,0,0,0,1.0,1,1.0,1,1.0,1,0.4149742828038812,56
1399,23,19409,19409,0,0,0,0,1.0,1,1.0,1,1.0,1,0.3686891870740578,57
1400,41,19450,19450,0,0,0,0,1.0,1,1.0,1,1.0,1,0.4238213748608731,57
1401,18,19468,19468,0,0,0,0,1.0,1,1.0,1,1.0,1,0.3173177180586913,57
1402,21,19489,19489,0,0,0,0,1.0,1,1.0,1,1.0,1,0.4365046851001389,57
1403,31,19520,19520,0,0,0,0,1.0,1,1.0,1,1.0,1,0.425346497966335,56
1404,20,19540,19540,0,0,0,0,1.0,1,1.0,1,1.0,1,0.4849384021206873,58
1405,16,19556,19556,0,0,0,0,1.0,1,1.0,1,1.0,1,0.4950582715293477,58
1406,23,19579,19579,0,0,0,0,1.0,1,1.0,1,1.0,1,0.46698081669705555,58
1407,11,19590,19590,0,0,0,0,1.0,1,1.0,1,1.0,1,0.4423666663722304,57
1408,20,19610,19610,0,0,0,0,1.0,1,1.0,1,1.0,1,0.3000842417470502,58
1409,15,19625,19625,0,0,0,0,1.0,1,1.0,1,1.0,1,0.4612969760162836,57
1410,17,19642,19642,0,0,0,0,1.0,1,1.0,1,1.0,1,0.4741832621669114,57
1411,19,19661,19661,0,0,0,0,1.0,1,1.0,1,1.0,1,0.311159918254025,56
1412,10,19671,19671,0,0,0,0,1.0,1,1.0,1,1.0,1,0.5118511099995953,55
1413,12,19683,19683,0,0,0,0,1.0,1,1.0,1,1.0,1,0.48407985497630146,57
1414,10,19693,19693,0,0,0,0,1.0,1,1.0,1,1.0,1,0.48841715395096996,57
1415,20,19713,19713,0,0,0,0,1.0,1,1.0,1,1.0,1,0.3677375210348039,60
1416,20,19733,19733,0,0,0,0,1.0,1,1.0,1,1.0,1,0.4076331430121259,61
1417,18,19751,19751,0,0,0,0,1.0,1,1.0,1,1.0,1,0.36292991408695957,59
1418,23,19774,19774,0,0,0,0,1.0,1,1.0,1,1.0,1,0.2653032951056281,60
1419,18,19792,19792,0,0,0,0,1.0,1,1.0,1,1.0,1,0.36996923076410293,59
1420,17,19809,19809,0,0,0,0,1.0,1,1.0,1,1.0,1,0.35292069059414555,58
1421,14,19823,19823,0,0,0,0,1.0,1,1.0,1,1.0,1,0.35973680700415606,57
1422,9,19832,19832,0,0,0,0,1.0,1,1.0,1,1.0,1,0.3084952760516393,57
1423,7,19839,19839,0,0,0,0,1.0,1,1.0,1,1.0,1,0.3745280389218617,56
1424,9,19848,19848,0,0,0,0,1.0,1,1.0,1,1.0,1,0.34251397419621205,57
1425,13,19861,19861,0,0,0,0,1.0,1,1.0,1,1.0,1,0.2925640677243204,54
1426,7,19868,19868,0,0,0,0,1.0,1,1.0,1,1.0,1,0.31588002587676933,54
1427,11,19879,19879,0,0,0,0,1.0,1,1.0,1,1.0,1,0.44278273009221975,53
1428,7,19886,19886,0,0,0,0,1.0,1,1.0,1,1.0,1,0.3995931413967901,52
1429,12,19898,19898,0,0,0,0,1.0,1,1.0,1,1.0,1,0.4341991868213497,52
1430,18,19916,19916,0,0,0,0,1.0,1,1.0,1,1.0,1,0.3036051422230125,51
1431,18,19934,19934,0,0,0,0,1.0,1,1.0,1,1.0,1,0.37434931109936964,51
1432,11,19945,19945,0,0,0,0,1.0,1,1.0,1,1.0,1,0.3658758899559398,52
1433,15,19960,19960,0,0,0,0,1.0,1,1.0,1,1.0,1,0.4376726225260483,52
1434,17,19977,19977,0,0,0,0,1.0,1,1.0,1,1.0,1,0.41137076531587907,52
1435,13,19990,19990,0,0,0,0,1.0,1,1.0,1,1.0,1,0.40641871515950084,50
1436,10,20000,20000,0,0,0,0,1.0,1,1.0,1,1.0,1,0.3724838931496469,50
1437,16,20016,20016,0,0,0,0,1.0,1,1.0,1,1.0,1,0.3770650861957961,49
1438,19,20035,20035,0,0,0,0,1.0,1,1.0,1,1.0,1,0.4166741470215437,49
1439,17,20052,20052,0,0,0,0,1.0,1,1.0,1,1.0,1,0.3703978686324248,50
1440,12,20064,20064,0,0,0,0,1.0,1,1.0,1,1.0,1,0.4452429748307826,50
1441,16,20080,20080,0,0,0,0,1.0,1,1.0,1,1.0,1,0.45919536327544785,51
1442,7,20087,20087,0,0,0,0,1.0,1,1.0,1,1.0,1,0.44967177699561606,50
1443,9,20096,20096,0,0,0,0,1.0,1,1.0,1,1.0,1,0.437273994650045,51
1444,12,20108,20108,0,0,0,0,1.0,1,1.0,1,1.0,1,0.5151864976593993,51
1445,12,20120,20120,0,0,0,0,1.0,1,1.0,1,1.0,1,0.40263130275666825,51
1446,11,20131,20131,0,0,0,0,1.0,1,1.0,1,1.0,1,0.44858042486389366,51
1447,13,20144,20144,0,0,0,0,1.0,1,1.0,1,1.0,1,0.42954543917869975,51
1448,16,20160,20160,0,0,0,0,1.0,1,1.0,1,1.0,1,0.44794528543746975,51
1449,14,20174,20174,0,0,0,0,1.0,1,1.0,1,1.0,1,0.4708025272958364,51
1450,12,20186,20186,0,0,0,0,1.0,1,1.0,1,1.0,1,0.37066916921919946,52
1451,12,20198,20198,0,0,0,0,1.0,1,1.0,1,1.0,1,0.4660212597068886,54
1452,12,20210,20210,0,0,0,0,1.0,1,1.0,1,1.0,1,0.45611011188817685,56
1453,19,20229,20229,0,0,0,0,1.0,1,1.0,1,1.0,1,0.44614248106738263,56
1454,30,20259,20259,0,0,0,0,1.0,1,1.0,1,1.0,1,0.39166329207607986,58
1455,26,20285,20285,0,0,0,0,1.0,1,1.0,1,1.0,1,0.513388046999145,55
1456,36,20321,20321,0,0,0,0,1.0,1,1.0,1,1.0,1,0.337230071798643,56
1457,31,20352,20352,0,0,0,0,1.0,1,1.0,1,1.0,1,0.44413741118204364,54
1458,16,20368,20368,0,0,0,0,1.0,1,1.0,1,1.0,1,0.2967620524693135,52
1459,24,20392,20392,0,0,0,0,1.0,1,1.0,1,1.0,1,0.56566474346564,52
1460,41,20433,20433,0,0,0,0,1.0,1,1.0,1,1.0,1,0.5768072291377332,50
1461,36,20469,20469,0,0,0,0,1.0,1,1.0,1,1.0,1,0.5947377439113621,53
1462,14,20483,20483,0,0,0,0,1.0,1,1.0,1,1.0,1,0.48324887057737986,51
1463,17,20500,20500,0,0,0,0,1.0,1,1.0,1,1.0,1,0.31117282701476834,51
1464,22,20522,20522,0,0,0,0,1.0,1,1.0,1,1.0,1,0.5660392381746738,51
1465,18,20540,20540,0,0,0,0,1.0,1,1.0,1,1.0,1,0.4429673110040095,49
1466,18,20558,20558,0,0,0,0,1.0,1,1.0,1,1.0,1,0.4678756405316527,49
1467,14,20572,20572,0,0,0,0,1.0,1,1.0,1,1.0,1,0.3550038002291228,47
1468,17,20589,20589,0,0,0,0,1.0,1,1.0,1,1.0,1,0.47176613212558133,48
1469,10,20599,20599,0,0,0,0,1.0,1,1.0,1,1.0,1,0.38411953140919486,47
1470,9,20608,20608,0,0,0,0,1.0,1,1.0,1,1.0,1,0.3855591113292181,49
1471,9,20617,20617,0,0,0,0,1.0,1,1.0,1,1.0,1,0.464505703027434,48
1472,6,20623,20623,0,0,0,0,1.0,1,1.0,1,1.0,1,0.4429514726659728,48
1473,7,20630,20630,0,0,0,0,1.0,1,1.0,1,1.0,1,0.43814826056990325,49
1474,8,20638,20638,0,0,0,0,1.0,1,1.0,1,1.0,1,0.43636171236403504,49
1475,9,20647,20647,0,0,0,0,1.0,1,1.0,1,1.0,1,0.4674593654609422,49
1476,7,20654,20654,0,0,0,0,1.0,1,1.0,1,1.0,1,0.4125548435209086,51
1477,7,20661,20661,0,0,0,0,1.0,1,1.0,1,1.0,1,0.457727849080663,51
1478,15,20676,20676,0,0,0,0,1.0,1,1.0,1,1.0,1,0.3941256394553536,52
1479,14,20690,20690,0,0,0,0,1.0,1,1.0,1,1.0,1,0.3052691176819937,53
1480,13,20703,20703,0,0,0,0,1.0,1,1.0,1,1.0,1,0.36608060305454976,53
1481,10,20713,20713,0,0,0,0,1.0,1,1.0,1,1.0,1,0.32306172703508396,53
1482,13,20726,20726,0,0,0,0,1.0,1,1.0,1,1.0,1,0.3777156870706421,52
1483,11,20737,20737,0,0,0,0,1.0,1,1.0,1,1.0,1,0.33495466154835374,52
1484,15,20752,20752,0,0,0,0,1.0,1,1.0,1,1.0,1,0.29150199142147215,53
1485,19,20771,20771,0,0,0,0,1.0,1,1.0,1,1.0,1,0.28774756847202365,53
1486,26,20797,20797,0,0,0,0,1.0,1,1.0,1,1.0,1,0.3768119909168645,54
1487,24,20821,20821,0,0,0,0,1.0,1,1.0,1,1.0,1,0.34821089555797996,55
1488,29,20850,20850,0,0,0,0,1.0,1,1.0,1,1.0,1,0.32841564228579495,57
1489,28,20878,20878,0,0,0,0,1.0,1,1.0,1,1.0,1,0.39905693702595685,58
1490,26,20904,20904,0,0,0,0,1.0,1,1.0,1,1.0,1,0.39068386299582986,58
1491,12,20916,20916,0,0,0,0,1.0,1,1.0,1,1.0,1,0.42300593892321303,59
1492,21,20937,20937,0,0,0,0,1.0,1,1.0,1,1.0,1,0.32070486486777156,59
1493,17,20954,20954,0,0,0,0,1.0,1,1.0,1,1.0,1,0.3790101745252849,58
1494,15,20969,20969,0,0,0,0,1.0,1,1.0,1,1.0,1,0.37809179309113045,58
1495,7,20976,20976,0,0,0,0,1.0,1,1.0,1,1.0,1,0.32572487859617694,57
1496,13,20989,20989,0,0,0,0,1.0,1,1.0,1,1.0,1,0.41384911682042896,59
1497,8,20997,20997,0,0,0,0,1.0,1,1.0,1,1.0,1,0.37079125421425496,58
1498,9,21006,21006,0,0,0,0,1.0,1,1.0,1,1.0,1,0.27859650146820997,58
1499,16,21022,21022,0,0,0,0,1.0,1,1.0,1,1.0,1,0.2905238594304891,56
1500,8,21030,21030,0,0,0,0,1.0,1,1.0,1,1.0,1,0.3302643773771484,57
1501,10,21040,21040,0,0,0,0,1.0,1,1.0,1,1.0,1,0.4110340562353762,55
1502,8,21048,21048,0,0,0,0,1.0,1,1.0,1,1.0,1,0.35347135974632327,55
1503,12,21060,21060,0,0,0,0,1.0,1,1.0,1,1.0,1,0.4490651222138327,54
1504,12,21072,21072,0,0,0,0,1.0,1,1.0,1,1.0,1,0.3409717611718533,55
1505,13,21085,21085,0,0,0,0,1.0,1,1.0,1,1.0,1,0.39289401847571365,53
1506,15,21100,21100,0,0,0,0,1.0,1,1.0,1,1.0,1,0.2964866713954344,55
1507,14,21114,21114,0,0,0,0,1.0,1,1.0,1,1.0,1,0.43069009605997716,53
1508,7,21121,21121,0,0,0,0,1.0,1,1.0,1,1.0,1,0.41866350612099656,53
1509,20,21141,21141,0,0,0,0,1.0,1,1.0,1,1.0,1,0.40311713900478,52
1510,12,21153,21153,0,0,0,0,1.0,1,1.0,1,1.0,1,0.3406315478507099,50
1511,10,21163,21163,0,0,0,0,1.0,1,1.0,1,1.0,1,0.43102128621415414,49
1512,12,21175,21175,0,0,0,0,1.0,1,1.0,1,1.0,1,0.47761033132664327,48
1513,8,21183,21183,0,0,0,0,1.0,1,1.0,1,1.0,1,0.47811360502611583,47
1514,10,21193,21193,0,0,0,0,1.0,1,1.0,1,1.0,1,0.3830422883727282,48
1515,19,21212,21212,0,0,0,0,1.0,1,1.0,1,1.0,1,0.3308305877802853,48
1516,14,21226,21226,0,0,0,0,1.0,1,1.0,1,1.0,1,0.43749338874911975,47
1517,23,21249,21249,0,0,0,0,1.0,1,1.0,1,1.0,1,0.392749964772795,48
1518,19,21268,21268,0,0,0,0,1.0,1,1.0,1,1.0,1,0.4090791186947704,48
1519,9,21277,21277,0,0,0,0,1.0,1,1.0,1,1.0,1,0.42581794123906885,47
1520,19,21296,21296,0,0,0,0,1.0,1,1.0,1,1.0,1,0.3750143714459492,48
1521,15,21311,21311,0,0,0,0,1.0,1,1.0,1,1.0,1,0.2895755250130553,49
1522,16,21327,21327,0,0,0,0,1.0,1,1.0,1,1.0,1,0.3556784862574259,48
1523,11,21338,21338,0,0,0,0,1.0,1,1.0,1,1.0,1,0.2357754705035828,49
1524,15,21353,21353,0,0,0,0,1.0,1,1.0,1,1.0,1,0.28914945994513114,49
1525,8,21361,21361,0,0,0,0,1.0,1,1.0,1,1.0,1,0.3373087281198762,51
1526,8,21369,21369,0,0,0,0,1.0,1,1.0,1,1.0,1,0.2787260004122336,52
1527,15,21384,21384,0,0,0,0,1.0,1,1.0,1,1.0,1,0.3216187336080613,54
1528,15,21399,21399,0,0,0,0,1.0,1,1.0,1,1.0,1,0.3379135655579615,54
1529,8,21407,21407,0,0,0,0,1.0,1,1.0,1,1.0,1,0.30626869444382243,54
1530,9,21416,21416,0,0,0,0,1.0,1,1.0,1,1.0,1,0.43294057012314047,54
1531,9,21425,21425,0,0,0,0,1.0,1,1.0,1,1.0,1,0.4267241859405613,54
1532,7,21432,21432,0,0,0,0,1.0,1,1.0,1,1.0,1,0.3585731363356156,54
1533,13,21445,21445,0,0,0,0,1.0,1,1.0,1,1.0,1,0.35600211008396454,54
1534,8,21453,21453,0,0,0,0,1.0,1,1.0,1,1.0,1,0.4368038304533572,54
1535,5,21458,21458,0,0,0,0,1.0,1,1.0,1,1.0,1,0.40296970000426713,54
1536,10,21468,21468,0,0,0,0,1.0,1,1.0,1,1.0,1,0.37292297261119367,55
1537,3,21471,21471,0,0,0,0,1.0,1,1.0,1,1.0,1,0.42512918153200585,53
1538,7,21478,21478,0,0,0,0,1.0,1,1.0,1,1.0,1,0.41083765661508476,54
1539,9,21487,21487,0,0,0,0,1.0,1,1.0,1,1.0,1,0.4172447599718828,54
1540,12,21499,21499,0,0,0,0,1.0,1,1.0,1,1.0,1,0.3852037916553757,54
1541,6,21505,21505,0,0,0,0,1.0,1,1.0,1,1.0,1,0.3519618536089861,54
1542,15,21520,21520,0,0,0,0,1.0,1,1.0,1,1.0,1,0.22429068925890724,57
1543,11,21531,21531,0,0,0,0,1.0,1,1.0,1,1.0,1,0.24933547051784563,55
1544,14,21545,21545,0,0,0,0,1.0,1,1.0,1,1.0,1,0.28265830170111456,54
1545,16,21561,21561,0,0,0,0,1.0,1,1.0,1,1.0,1,0.24146686502438205,54
1546,14,21575,21575,0,0,0,0,1.0,1,1.0,1,1.0,1,0.28113070999461587,53
1547,21,21596,21596,0,0,0,0,1.0,1,1.0,1,1.0,1,0.30011834022994793,53
1548,18,21614,21614,0,0,0,0,1.0,1,1.0,1,1.0,1,0.2479242861656973,54
1549,16,21630,21630,0,0,0,0,1.0,1,1.0,1,1.0,1,0.19852734408381265,52
1550,24,21654,21654,0,0,0,0,1.0,1,1.0,1,1.0,1,0.2255091627840207,52
1551,18,21672,21672,0,0,0,0,1.0,1,1.0,1,1.0,1,0.1844363018263479,52
1552,22,21694,21694,0,0,0,0,1.0,1,1.0,1,1.0,1,0.338059525588865,51
1553,14,21708,21708,0,0,0,0,1.0,1,1.0,1,1.0,1,0.1587768246850404,51
1554,18,21726,21726,0,0,0,0,1.0,1,1.0,1,1.0,1,0.29331348564947685,51
1555,16,21742,21742,0,0,0,0,1.0,1,1.0,1,1.0,1,0.22201772561773095,50
1556,29,21771,21771,0,0,0,0,1.0,1,1.0,1,1.0,1,0.26283870809868354,51
1557,17,21788,21788,0,0,0,0,1.0,1,1.0,1,1.0,1,0.2842095323245901,51
1558,24,21812,21812,0,0,0,0,1.0,1,1.0,1,1.0,1,0.23080793012392128,52
1559,12,21824,21824,0,0,0,0,1.0,1,1.0,1,1.0,1,0.24113175598529468,53
1560,18,21842,21842,0,0,0,0,1.0,1,1.0,1,1.0,1,0.23421229510360114,51
1561,16,21858,21858,0,0,0,0,1.0,1,1.0,1,1.0,1,0.24372413571241483,51
1562,11,21869,21869,0,0,0,0,1.0,1,1.0,1,1.0,1,0.19269789352201042,52
1563,11,21880,21880,0,0,0,0,1.0,1,1.0,1,1.0,1,0.21228145272861326,52
1564,9,21889,21889,0,0,0,0,1.0,1,1.0,1,1.0,1,0.26375259581763205,51
1565,9,21898,21898,0,0,0,0,1.0,1,1.0,1,1.0,1,0.2815973558592589,53
1566,7,21905,21905,0,0,0,0,1.0,1,1.0,1,1.0,1,0.3346100213533847,53
1567,6,21911,21911,0,0,0,0,1.0,1,1.0,1,1.0,1,0.34112634725707747,52
1568,10,21921,21921,0,0,0,0,1.0,1,1.0,1,1.0,1,0.2500917582347689,52
1569,13,21934,21934,0,0,0,0,1.0,1,1.0,1,1.0,1,0.35895993379355473,49
1570,15,21949,21949,0,0,0,0,1.0,1,1.0,1,1.0,1,0.30090996191391023,48
1571,15,21964,21964,0,0,0,0,1.0,1,1.0,1,1.0,1,0.3085784703575473,46
1572,20,21984,21984,0,0,0,0,1.0,1,1.0,1,1.0,1,0.2955201119780393,47
1573,19,22003,22003,0,0,0,0,1.0,1,1.0,1,1.0,1,0.3258604551478482,48
1574,11,22014,22014,0,0,0,0,1.0,1,1.0,1,1.0,1,0.291841793766625,46
1575,17,22031,22031,0,0,0,0,1.0,1,1.0,1,1.0,1,0.34541223135584537,47
1576,9,22040,22040,0,0,0,0,1.0,1,1.0,1,1.0,1,0.4632114030286367,46
1577,10,22050,22050,0,0,0,0,1.0,1,1.0,1,1.0,1,0.4885260129814544,45
1578,7,22057,22057,0,0,0,0,1.0,1,1.0,1,1.0,1,0.4894124533242915,44
1579,3,22060,22060,0,0,0,0,1.0,1,1.0,1,1.0,1,0.459194704328112,43
1580,15,22075,22075,0,0,0,0,1.0,1,1.0,1,1.0,1,0.4564080498926837,43
1581,9,22084,22084,0,0,0,0,1.0,1,1.0,1,1.0,1,0.43656240672333774,42
1582,7,22091,22091,0,0,0,0,1.0,1,1.0,1,1.0,1,0.41358160489638224,42
1583,22,22113,22113,0,0,0,0,1.0,1,1.0,1,1.0,1,0.40575413821077766,43
1584,13,22126,22126,0,0,0,0,1.0,1,1.0,1,1.0,1,0.2869222590646415,41
1585,17,22143,22143,0,0,0,0,1.0,1,1.0,1,1.0,1,0.297175340566159,43
1586,13,22156,22156,0,0,0,0,1.0,1,1.0,1,1.0,1,0.3104015075351447,42
1587,24,22180,22180,0,0,0,0,1.0,1,1.0,1,1.0,1,0.4141824229488045,42
1588,22,22202,22202,0,0,0,0,1.0,1,1.0,1,1.0,1,0.3707569689135784,42
1589,19,22221,22221,0,0,0,0,1.0,1,1.0,1,1.0,1,0.3365202985094019,42
1590,13,22234,22234,0,0,0,0,1.0,1,1.0,1,1.0,1,0.21469809202885012,41
1591,12,22246,22246,0,0,0,0,1.0,1,1.0,1,1.0,1,0.37140473983801936,40
1592,27,22273,22273,0,0,0,0,1.0,1,1.0,1,1.0,1,0.4544566718553358,39
1593,14,22287,22287,0,0,0,0,1.0,1,1.0,1,1.0,1,0.3554641471754912,39
1594,12,22299,22299,0,0,0,0,1.0,1,1.0,1,1.0,1,0.39643667933724,39
1595,19,22318,22318,0,0,0,0,1.0,1,1.0,1,1.0,1,0.25961335493604326,42
1596,21,22339,22339,0,0,0,0,1.0,1,1.0,1,1.0,1,0.3116864322272574,41
1597,18,22357,22357,0,0,0,0,1.0,1,1.0,1,1.0,1,0.2756336553985937,41
1598,9,22366,22366,0,0,0,0,1.0,1,1.0,1,1.0,1,0.2817316837794591,39
1599,27,22393,22393,0,0,0,0,1.0,1,1.0,1,1.0,1,0.3127487398598085,39
1600,17,22410,22410,0,0,0,0,1.0,1,1.0,1,1.0,1,0.22790386112308783,40
1601,15,22425,22425,0,0,0,0,1.0,1,1.0,1,1.0,1,0.2584502587781045,41
1602,17,22442,22442,0,0,0,0,1.0,1,1.0,1,1.0,1,0.22821337977884812,41
1603,17,22459,22459,0,0,0,0,1.0,1,1.0,1,1.0,1,0.22567881765108103,43
1604,14,22473,22473,0,0,0,0,1.0,1,1.0,1,1.0,1,0.1891791527404503,43
1605,16,22489,22489,0,0,0,0,1.0,1,1.0,1,1.0,1,0.20081221269310268,44
1606,11,22500,22500,0,0,0,0,1.0,1,1.0,1,1.0,1,0.2556297872124926,44
1607,5,22505,22505,0,0,0,0,1.0,1,1.0,1,1.0,1,0.29382169467106367,42
1608,12,22517,22517,0,0,0,0,1.0,1,1.0,1,1.0,1,0.3299675026341466,41
1609,7,22524,22524,0,0,0,0,1.0,1,1.0,1,1.0,1,0.3204388375641737,39
1610,11,22535,22535,0,0,0,0,1.0,1,1.0,1,1.0,1,0.34510357001793035,39
1611,14,22549,22549,0,0,0,0,1.0,1,1.0,1,1.0,1,0.3718174122363417,40
1612,8,22557,22557,0,0,0,0,1.0,1,1.0,1,1.0,1,0.35824050917559874,39
1613,15,22572,22572,0,0,0,0,1.0,1,1.0,1,1.0,1,0.4096162537955023,41
1614,11,22583,22583,0,0,0,0,1.0,1,1.0,1,1.0,1,0.3658670003290031,41
1615,19,22602,22602,0,0,0,0,1.0,1,1.0,1,1.0,1,0.35532857241662585,41
1616,20,22622,22622,0,0,0,0,1.0,1,1.0,1,1.0,1,0.36043803540331953,43
1617,13,22635,22635,0,0,0,0,1.0,1,1.0,1,1.0,1,0.38176832834897606,44
1618,10,22645,22645,0,0,0,0,1.0,1,1.0,1,1.0,1,0.3422209914677664,44
1619,18,22663,22663,0,0,0,0,1.0,1,1.0,1,1.0,1,0.3873311933020811,44
1620,8,22671,22671,0,0,0,0,1.0,1,1.0,1,1.0,1,0.4947190852800674,45
1621,6,22677,22677,0,0,0,0,1.0,1,1.0,1,1.0,1,0.4081455949954498,44
1622,13,22690,22690,0,0,0,0,1.0,1,1.0,1,1.0,1,0.5370170100558753,44
1623,13,22703,22703,0,0,0,0,1.0,1,1.0,1,1.0,1,0.4172263899497348,43
1624,16,22719,22719,0,0,0,0,1.0,1,1.0,1,1.0,1,0.3930050557973819,43
1625,14,22733,22733,0,0,0,0,1.0,1,1.0,1,1.0,1,0.5197874069877391,43
1626,21,22754,22754,0,0,0,0,1.0,1,1.0,1,1.0,1,0.5148198786812803,42
1627,19,22773,22773,0,0,0,0,1.0,1,1.0,1,1.0,1,0.5010712396199934,42
1628,11,22784,22784,0,0,0,0,1.0,1,1.0,1,1.0,1,0.41012972485207466,42
1629,10,22794,22794,0,0,0,0,1.0,1,1.0,1,1.0,1,0.4153986162167092,41
1630,15,22809,22809,0,0,0,0,1.0,1,1.0,1,1.0,1,0.3675294673292329,41
1631,7,22816,22816,0,0,0,0,1.0,1,1.0,1,1.0,1,0.38575875427114065,40
1632,7,22823,22823,0,0,0,0,1.0,1,1.0,1,1.0,1,0.4362429755235603,39
1633,9,22832,22832,0,0,0,0,1.0,1,1.0,1,1.0,1,0.39214532028695126,39
1634,14,22846,22846,0,0,0,0,1.0,1,1.0,1,1.0,1,0.2881280982456281,39
1635,16,22862,22862,0,0,0,0,1.0,1,1.0,1,1.0,1,0.19798178963213978,40
1636,12,22874,22874,0,0,0,0,1.0,1,1.0,1,1.0,1,0.28525422831898595,41
1637,8,22882,22882,0,0,0,0,1.0,1,1.0,1,1.0,1,0.3063578023406408,41
1638,15,22897,22897,0,0,0,0,1.0,1,1.0,1,1.0,1,0.3283630995869977,42
1639,13,22910,22910,0,0,0,0,1.0,1,1.0,1,1.0,1,0.3803322529534675,43
1640,14,22924,22924,0,0,0,0,1.0,1,1.0,1,1.0,1,0.20338360951433207,43
1641,9,22933,22933,0,0,0,0,1.0,1,1.0,1,1.0,1,0.22625550100322786,44
1642,9,22942,22942,0,0,0,0,1.0,1,1.0,1,1.0,1,0.325319987017406,45
1643,9,22951,22951,0,0,0,0,1.0,1,1.0,1,1.0,1,0.35986611388092915,44
1644,11,22962,22962,0,0,0,0,1.0,1,1.0,1,1.0,1,0.3655407621503296,45
1645,14,22976,22976,0,0,0,0,1.0,1,1.0,1,1.0,1,0.32754474155572055,44
1646,16,22992,22992,0,0,0,0,1.0,1,1.0,1,1.0,1,0.40773854220406447,43
1647,5,22997,22997,0,0,0,0,1.0,1,1.0,1,1.0,1,0.38521984472516124,43
1648,12,23009,23009,0,0,0,0,1.0,1,1.0,1,1.0,1,0.3713067673243551,42
1649,12,23021,23021,0,0,0,0,1.0,1,1.0,1,1.0,1,0.43407420722236056,41
1650,6,23027,23027,0,0,0,0,1.0,1,1.0,1,1.0,1,0.35269223205400024,41
1651,12,23039,23039,0,0,0,0,1.0,1,1.0,1,1.0,1,0.39285136220150324,40
1652,7,23046,23046,0,0,0,0,1.0,1,1.0,1,1.0,1,0.39821772468508154,39
1653,17,23063,23063,0,0,0,0,1.0,1,1.0,1,1.0,1,0.4107585411135412,39
1654,18,23081,23081,0,0,0,0,1.0,1,1.0,1,1.0,1,0.3005258067411994,39
1655,14,23095,23095,0,0,0,0,1.0,1,1.0,1,1.0,1,0.3268487682583948,40
1656,13,23108,23108,0,0,0,0,1.0,1,1.0,1,1.0,1,0.29267315149952405,40
1657,10,23118,23118,0,0,0,0,1.0,1,1.0,1,1.0,1,0.3027089003748216,40
1658,14,23132,23132,0,0,0,0,1.0,1,1.0,1,1.0,1,0.2781664189316363,40
1659,15,23147,23147,0,0,0,0,1.0,1,1.0,1,1.0,1,0.24426836284074985,40
1660,7,23154,23154,0,0,0,0,1.0,1,1.0,1,1.0,1,0.2761462220853291,41
1661,9,23163,23163,0,0,0,0,1.0,1,1.0,1,1.0,1,0.28768247413060427,42
1662,6,23169,23169,0,0,0,0,1.0,1,1.0,1,1.0,1,0.2642231812044121,44
1663,10,23179,23179,0,0,0,0,1.0,1,1.0,1,1.0,1,0.3030354229036728,43
1664,10,23189,23189,0,0,0,0,1.0,1,1.0,1,1.0,1,0.37160606831532866,42
1665,15,23204,23204,0,0,0,0,1.0,1,1.0,1,1.0,1,0.27523281033284536,42
1666,11,23215,23215,0,0,0,0,1.0,1,1.0,1,1.0,1,0.3463837324881172,43
1667,8,23223,23223,0,0,0,0,1.0,1,1.0,1,1.0,1,0.4452829751117956,40
1668,8,23231,23231,0,0,0,0,1.0,1,1.0,1,1.0,1,0.40619632624866037,40
1669,13,23244,23244,0,0,0,0,1.0,1,1.0,1,1.0,1,0.24700364997888222,40
1670,12,23256,23256,0,0,0,0,1.0,1,1.0,1,1.0,1,0.4363185816695105,39
1671,11,23267,23267,0,0,0,0,1.0,1,1.0,1,1.0,1,0.31961550721848364,39
1672,18,23285,23285,0,0,0,0,1.0,1,1.0,1,1.0,1,0.319988518262966,38
1673,8,23293,23293,0,0,0,0,1.0,1,1.0,1,1.0,1,0.39603462935702044,38
1674,9,23302,23302,0,0,0,0,1.0,1,1.0,1,1.0,1,0.4185727777317014,38
1675,18,23320,23320,0,0,0,0,1.0,1,1.0,1,1.0,1,0.4729069298125664,39
1676,8,23328,23328,0,0,0,0,1.0,1,1.0,1,1.0,1,0.3094921627311669,39
1677,14,23342,23342,0,0,0,0,1.0,1,1.0,1,1.0,1,0.45841161837480776,40
1678,13,23355,23355,0,0,0,0,1.0,1,1.0,1,1.0,1,0.42741886575170185,39
1679,10,23365,23365,0,0,0,0,1.0,1,1.0,1,1.0,1,0.37052697582607996,39
1680,13,23378,23378,0,0,0,0,1.0,1,1.0,1,1.0,1,0.35439295486459804,40
1681,5,23383,23383,0,0,0,0,1.0,1,1.0,1,1.0,1,0.3195354958786515,41
1682,26,23409,23409,0,0,0,0,1.0,1,1.0,1,1.0,1,0.23567113355247774,40
1683,21,23430,23430,0,0,0,0,1.0,1,1.0,1,1.0,1,0.2511641422603357,43
1684,20,23450,23450,0,0,0,0,1.0,1,1.0,1,1.0,1,0.3031123073408396,42
1685,14,23464,23464,0,0,0,0,1.0,1,1.0,1,1.0,1,0.3778146475547468,41
1686,8,23472,23472,0,0,0,0,1.0,1,1.0,1,1.0,1,0.38933415132815136,39
1687,15,23487,23487,0,0,0,0,1.0,1,1.0,1,1.0,1,0.3014464756844649,41
1688,12,23499,23499,0,0,0,0,1.0,1,1.0,1,1.0,1,0.33740571506579536,39
1689,9,23508,23508,0,0,0,0,1.0,1,1.0,1,1.0,1,0.3085476635508463,37
1690,8,23516,23516,0,0,0,0,1.0,1,1.0,1,1.0,1,0.28046211678809296,36
1691,10,23526,23526,0,0,0,0,1.0,1,1.0,1,1.0,1,0.3159672329897512,36
1692,5,23531,23531,0,0,0,0,1.0,1,1.0,1,1.0,1,0.36116306370328477,34
1693,8,23539,23539,0,0,0,0,1.0,1,1.0,1,1.0,1,0.4218492339764544,33
1694,15,23554,23554,0,0,0,0,1.0,1,1.0,1,1.0,1,0.4552824976001069,32
1695,12,23566,23566,0,0,0,0,1.0,1,1.0,1,1.0,1,0.44173701650892067,32
1696,16,23582,23582,0,0,0,0,1.0,1,1.0,1,1.0,1,0.35823809707180354,34
1697,17,23599,23599,0,0,0,0,1.0,1,1.0,1,1.0,1,0.3665156188113003,34
1698,13,23612,23612,0,0,0,0,1.0,1,1.0,1,1.0,1,0.4439162000055893,36
1699,11,23623,23623,0,0,0,0,1.0,1,1.0,1,1.0,1,0.4467096312482871,36
1700,14,23637,23637,0,0,0,0,1.0,1,1.0,1,1.0,1,0.41635578283150926,37
1701,17,23654,23654,0,0,0,0,1.0,1,1.0,1,1.0,1,0.47692467925792253,39
1702,17,23671,23671,0,0,0,0,1.0,1,1.0,1,1.0,1,0.47409755277455273,39
1703,16,23687,23687,0,0,0,0,1.0,1,1.0,1,1.0,1,0.4012493105417965,38
1704,14,23701,23701,0,0,0,0,1.0,1,1.0,1,1.0,1,0.3224519468914726,38
1705,14,23715,23715,0,0,0,0,1.0,1,1.0,1,1.0,1,0.3889749058931812,37
1706,15,23730,23730,0,0,0,0,1.0,1,1.0,1,1.0,1,0.2619446243259612,37
1707,16,23746,23746,0,0,0,0,1.0,1,1.0,1,1.0,1,0.36718183911024493,36
1708,18,23764,23764,0,0,0,0,1.0,1,1.0,1,1.0,1,0.3924025960889333,34
1709,22,23786,23786,0,0,0,0,1.0,1,1.0,1,1.0,1,0.41139032378655016,34
1710,11,23797,23797,0,0,0,0,1.0,1,1.0,1,1.0,1,0.46082358329356166,33
1711,7,23804,23804,0,0,0,0,1.0,1,1.0,1,1.0,1,0.3536552228561903,32
1712,13,23817,23817,0,0,0,0,1.0,1,1.0,1,1.0,1,0.41293164174814984,31
1713,18,23835,23835,0,0,0,0,1.0,1,1.0,1,1.0,1,0.35133552914073496,32
1714,21,23856,23856,0,0,0,0,1.0,1,1.0,1,1.0,1,0.3983608716762259,32
1715,5,23861,23861,0,0,0,0,1.0,1,1.0,1,1.0,1,0.3942857946758989,32
1716,12,23873,23873,0,0,0,0,1.0,1,1.0,1,1.0,1,0.38273429719088115,34
1717,15,23888,23888,0,0,0,0,1.0,1,1.0,1,1.0,1,0.43450861750137865,34
1718,10,23898,23898,0,0,0,0,1.0,1,1.0,1,1.0,1,0.5109491045568125,34
1719,14,23912,23912,0,0,0,0,1.0,1,1.0,1,1.0,1,0.4201922478720571,34
1720,14,23926,23926,0,0,0,0,1.0,1,1.0,1,1.0,1,0.49910735739595663,34
1721,12,23938,23938,0,0,0,0,1.0,1,1.0,1,1.0,1,0.4938446020949915,35
1722,18,23956,23956,0,0,0,0,1.0,1,1.0,1,1.0,1,0.29455405343995933,35
1723,12,23968,23968,0,0,0,0,1.0,1,1.0,1,1.0,1,0.47648706903473914,34
1724,13,23981,23981,0,0,0,0,1.0,1,1.0,1,1.0,1,0.4312638419598284,33
1725,15,23996,23996,0,0,0,0,1.0,1,1.0,1,1.0,1,0.39947066329302255,35
1726,19,24015,24015,0,0,0,0,1.0,1,1.0,1,1.0,1,0.3878941644953711,34
1727,16,24031,24031,0,0,0,0,1.0,1,1.0,1,1.0,1,0.49098699548236,34
1728,13,24044,24044,0,0,0,0,1.0,1,1.0,1,1.0,1,0.5560888947405577,35
1729,18,24062,24062,0,0,0,0,1.0,1,1.0,1,1.0,1,0.5482764190821754,35
1730,13,24075,24075,0,0,0,0,1.0,1,1.0,1,1.0,1,0.46432508323922245,35
1731,17,24092,24092,0,0,0,0,1.0,1,1.0,1,1.0,1,0.5038898260945526,35
1732,15,24107,24107,0,0,0,0,1.0,1,1.0,1,1.0,1,0.5755685756025187,35
1733,10,24117,24117,0,0,0,0,1.0,1,1.0,1,1.0,1,0.3861319051768271,33
1734,22,24139,24139,0,0,0,0,1.0,1,1.0,1,1.0,1,0.4103586983007193,34
1735,16,24155,24155,0,0,0,0,1.0,1,1.0,1,1.0,1,0.37856549193671524,33
1736,17,24172,24172,0,0,0,0,1.0,1,1.0,1,1.0,1,0.2837625465223843,33
1737,10,24182,24182,0,0,0,0,1.0,1,1.0,1,1.0,1,0.26111447528031556,35
1738,17,24199,24199,0,0,0,0,1.0,1,1.0,1,1.0,1,0.3092921042873414,36
1739,16,24215,24215,0,0,0,0,1.0,1,1.0,1,1.0,1,0.2568124893122175,36
1740,11,24226,24226,0,0,0,0,1.0,1,1.0,1,1.0,1,0.2826488262907659,37
1741,10,24236,24236,0,0,0,0,1.0,1,1.0,1,1.0,1,0.2851623583235221,36
1742,12,24248,24248,0,0,0,0,1.0,1,1.0,1,1.0,1,0.2568351337729114,36
1743,9,24257,24257,0,0,0,0,1.0,1,1.0,1,1.0,1,0.23024612205820225,37
1744,4,24261,24261,0,0,0,0,1.0,1,1.0,1,1.0,1,0.28562877546971577,37
1745,7,24268,24268,0,0,0,0,1.0,1,1.0,1,1.0,1,0.33360299486284417,38
1746,9,24277,24277,0,0,0,0,1.0,1,1.0,1,1.0,1,0.3039024876402089,38
1747,8,24285,24285,0,0,0,0,1.0,1,1.0,1,1.0,1,0.31187290171348037,37
1748,14,24299,24299,0,0,0,0,1.0,1,1.0,1,1.0,1,0.45661753070565353,38
1749,8,24307,24307,0,0,0,0,1.0,1,1.0,1,1.0,1,0.4241284957875949,38
1750,23,24330,24330,0,0,0,0,1.0,1,1.0,1,1.0,1,0.429532707478517,39
1751,20,24350,24350,0,0,0,0,1.0,1,1.0,1,1.0,1,0.42981089942838707,41
1752,13,24363,24363,0,0,0,0,1.0,1,1.0,1,1.0,1,0.4440495291588655,41
1753,13,24376,24376,0,0,0,0,1.0,1,1.0,1,1.0,1,0.37314037927741417,41
1754,14,24390,24390,0,0,0,0,1.0,1,1.0,1,1.0,1,0.37680383566099224,40
1755,19,24409,24409,0,0,0,0,1.0,1,1.0,1,1.0,1,0.39043107067166904,41
1756,12,24421,24421,0,0,0,0,1.0,1,1.0,1,1.0,1,0.2960607428662285,41
1757,19,24440,24440,0,0,0,0,1.0,1,1.0,1,1.0,1,0.35553964284047923,40
1758,14,24454,24454,0,0,0,0,1.0,1,1.0,1,1.0,1,0.29412418585395833,41
1759,13,24467,24467,0,0,0,0,1.0,1,1.0,1,1.0,1,0.3828337794171123,38
1760,17,24484,24484,0,0,0,0,1.0,1,1.0,1,1.0,1,0.24452877646324545,38
1761,17,24501,24501,0,0,0,0,1.0,1,1.0,1,1.0,1,0.3997924578073564,37
1762,8,24509,24509,0,0,0,0,1.0,1,1.0,1,1.0,1,0.39586424850763174,37
1763,13,24522,24522,0,0,0,0,1.0,1,1.0,1,1.0,1,0.3591875766135175,37
1764,7,24529,24529,0,0,0,0,1.0,1,1.0,1,1.0,1,0.3680698034485164,36
1765,12,24541,24541,0,0,0,0,1.0,1,1.0,1,1.0,1,0.4721024233588947,36
1766,6,24547,24547,0,0,0,0,1.0,1,1.0,1,1.0,1,0.4294130785598755,37
1767,13,24560,24560,0,0,0,0,1.0,1,1.0,1,1.0,1,0.4854024487275505,37
1768,9,24569,24569,0,0,0,0,1.0,1,1.0,1,1.0,1,0.4494917064524066,37
1769,11,24580,24580,0,0,0,0,1.0,1,1.0,1,1.0,1,0.4629131062715463,38
1770,10,24590,24590,0,0,0,0,1.0,1,1.0,1,1.0,1,0.4640682868136579,39
1771,7,24597,24597,0,0,0,0,1.0,1,1.0,1,1.0,1,0.49309576300802566,39
1772,11,24608,24608,0,0,0,0,1.0,1,1.0,1,1.0,1,0.4598231865573723,39
1773,7,24615,24615,0,0,0,0,1.0,1,1.0,1,1.0,1,0.44609617404514035,41
1774,10,24625,24625,0,0,0,0,1.0,1,1.0,1,1.0,1,0.42357229782204314,41
1775,13,24638,24638,0,0,0,0,1.0,1,1.0,1,1.0,1,0.44886405348361813,42
1776,10,24648,24648,0,0,0,0,1.0,1,1.0,1,1.0,1,0.4263144114401075,43
1777,16,24664,24664,0,0,0,0,1.0,1,1.0,1,1.0,1,0.45933757242434825,43
1778,7,24671,24671,0,0,0,0,1.0,1,1.0,1,1.0,1,0.3434693638363372,44
1779,17,24688,24688,0,0,0,0,1.0,1,1.0,1,1.0,1,0.388107897524797,46
1780,8,24696,24696,0,0,0,0,1.0,1,1.0,1,1.0,1,0.4890574881706992,46
1781,5,24701,24701,0,0,0,0,1.0,1,1.0,1,1.0,1,0.45126189886072954,46
1782,5,24706,24706,0,0,0,0,1.0,1,1.0,1,1.0,1,0.4766750379217904,46
1783,7,24713,24713,0,0,0,0,1.0,1,1.0,1,1.0,1,0.43724291759400985,44
1784,22,24735,24735,0,0,0,0,1.0,1,1.0,1,1.0,1,0.37781730256134055,45
1785,14,24749,24749,0,0,0,0,1.0,1,1.0,1,1.0,1,0.4409137117621517,42
1786,13,24762,24762,0,0,0,0,1.0,1,1.0,1,1.0,1,0.3357564978096884,43
1787,15,24777,24777,0,0,0,0,1.0,1,1.0,1,1.0,1,0.368322663582241,41
1788,14,24791,24791,0,0,0,0,1.0,1,1.0,1,1.0,1,0.3693655099034388,41
1789,18,24809,24809,0,0,0,0,1.0,1,1.0,1,1.0,1,0.253750342487045,41
1790,17,24826,24826,0,0,0,0,1.0,1,1.0,1,1.0,1,0.21127071853432655,41
1791,14,24840,24840,0,0,0,0,1.0,1,1.0,1,1.0,1,0.21935289886201778,40
1792,10,24850,24850,0,0,0,0,1.0,1,1.0,1,1.0,1,0.2976932591594939,40
1793,10,24860,24860,0,0,0,0,1.0,1,1.0,1,1.0,1,0.3251187928267628,41
1794,11,24871,24871,0,0,0,0,1.0,1,1.0,1,1.0,1,0.29819648972345203,41
1795,11,24882,24882,0,0,0,0,1.0,1,1.0,1,1.0,1,0.3275859124889561,40
1796,11,24893,24893,0,0,0,0,1.0,1,1.0,1,1.0,1,0.3801958208998788,40
1797,6,24899,24899,0,0,0,0,1.0,1,1.0,1,1.0,1,0.42566217678466506,37
1798,11,24910,24910,0,0,0,0,1.0,1,1.0,1,1.0,1,0.3395839463699477,37
1799,6,24916,24916,0,0,0,0,1.0,1,1.0,1,1.0,1,0.3455238343437715,36
1800,10,24926,24926,0,0,0,0,1.0,1,1.0,1,1.0,1,0.32586854332250786,36
1801,9,24935,24935,0,0,0,0,1.0,1,1.0,1,1.0,1,0.41362175751294367,34
1802,9,24944,24944,0,0,0,0,1.0,1,1.0,1,1.0,1,0.544666191507993,33
1803,11,24955,24955,0,0,0,0,1.0,1,1.0,1,1.0,1,0.38998920580737667,33
1804,10,24965,24965,0,0,0,0,1.0,1,1.0,1,1.0,1,0.27839127759313304,33
1805,10,24975,24975,0,0,0,0,1.0,1,1.0,1,1.0,1,0.37828470626731026,35
1806,16,24991,24991,0,0,0,0,1.0,1,1.0,1,1.0,1,0.39002190586458074,35
1807,11,25002,25002,0,0,0,0,1.0,1,1.0,1,1.0,1,0.35148090170957375,35
1808,13,25015,25015,0,0,0,0,1.0,1,1.0,1,1.0,1,0.39559270219205794,36
1809,11,25026,25026,0,0,0,0,1.0,1,1.0,1,1.0,1,0.32012123849102153,36
1810,12,25038,25038,0,0,0,0,1.0,1,1.0,1,1.0,1,0.2774433229069138,35
1811,9,25047,25047,0,0,0,0,1.0,1,1.0,1,1.0,1,0.3890713306238915,36
1812,16,25063,25063,0,0,0,0,1.0,1,1.0,1,1.0,1,0.33581267189227937,36
1813,9,25072,25072,0,0,0,0,1.0,1,1.0,1,1.0,1,0.38828272882381276,36
1814,9,25081,25081,0,0,0,0,1.0,1,1.0,1,1.0,1,0.3607843668781383,34
1815,11,25092,25092,0,0,0,0,1.0,1,1.0,1,1.0,1,0.44168735414830607,35
1816,11,25103,25103,0,0,0,0,1.0,1,1.0,1,1.0,1,0.40504935812807624,34
1817,18,25121,25121,0,0,0,0,1.0,1,1.0,1,1.0,1,0.4519308905298249,34
1818,11,25132,25132,0,0,0,0,1.0,1,1.0,1,1.0,1,0.5311816956165188,34
1819,12,25144,25144,0,0,0,0,1.0,1,1.0,1,1.0,1,0.421032784579508,35
1820,16,25160,25160,0,0,0,0,1.0,1,1.0,1,1.0,1,0.3264335232350458,36
1821,5,25165,25165,0,0,0,0,1.0,1,1.0,1,1.0,1,0.3482326942462614,36
1822,10,25175,25175,0,0,0,0,1.0,1,1.0,1,1.0,1,0.3781551849187047,37
1823,7,25182,25182,0,0,0,0,1.0,1,1.0,1,1.0,1,0.36401598160753834,38
1824,6,25188,25188,0,0,0,0,1.0,1,1.0,1,1.0,1,0.3067107518783859,37
1825,10,25198,25198,0,0,0,0,1.0,1,1.0,1,1.0,1,0.31304508568684053,36
1826,12,25210,25210,0,0,0,0,1.0,1,1.0,1,1.0,1,0.24906819203902983,35
1827,10,25220,25220,0,0,0,0,1.0,1,1.0,1,1.0,1,0.34012934100271236,35
1828,11,25231,25231,0,0,0,0,1.0,1,1.0,1,1.0,1,0.29757990889746816,33
1829,11,25242,25242,0,0,0,0,1.0,1,1.0,1,1.0,1,0.3788477015368467,32
1830,10,25252,25252,0,0,0,0,1.0,1,1.0,1,1.0,1,0.36323281549923425,32
1831,8,25260,25260,0,0,0,0,1.0,1,1.0,1,1.0,1,0.5090065911777742,30
1832,8,25268,25268,0,0,0,0,1.0,1,1.0,1,1.0,1,0.44599965837084277,30
1833,10,25278,25278,0,0,0,0,1.0,1,1.0,1,1.0,1,0.5113000902417136,29
1834,8,25286,25286,0,0,0,0,1.0,1,1.0,1,1.0,1,0.30263399277932496,28
1835,11,25297,25297,0,0,0,0,1.0,1,1.0,1,1.0,1,0.3721083080795568,28
1836,8,25305,25305,0,0,0,0,1.0,1,1.0,1,1.0,1,0.42712923366474337,29
1837,8,25313,25313,0,0,0,0,1.0,1,1.0,1,1.0,1,0.3754689661596003,28
1838,5,25318,25318,0,0,0,0,1.0,1,1.0,1,1.0,1,0.4300979893368792,28
1839,10,25328,25328,0,0,0,0,1.0,1,1.0,1,1.0,1,0.35487594886690216,27
1840,11,25339,25339,0,0,0,0,1.0,1,1.0,1,1.0,1,0.42066267524897755,26
1841,10,25349,25349,0,0,0,0,1.0,1,1.0,1,1.0,1,0.39615114472300905,25
1842,8,25357,25357,0,0,0,0,1.0,1,1.0,1,1.0,1,0.30448208715397135,26
1843,4,25361,25361,0,0,0,0,1.0,1,1.0,1,1.0,1,0.2535966082531327,26
1844,12,25373,25373,0,0,0,0,1.0,1,1.0,1,1.0,1,0.3079770449513761,26
1845,6,25379,25379,0,0,0,0,1.0,1,1.0,1,1.0,1,0.3378224102612698,26
1846,6,25385,25385,0,0,0,0,1.0,1,1.0,1,1.0,1,0.4196931000118192,26
1847,14,25399,25399,0,0,0,0,1.0,1,1.0,1,1.0,1,0.34798480585184116,26
1848,3,25402,25402,0,0,0,0,1.0,1,1.0,1,1.0,1,0.38748947347567314,27
1849,5,25407,25407,0,0,0,0,1.0,1,1.0,1,1.0,1,0.3231101503826002,27
1850,5,25412,25412,0,0,0,0,1.0,1,1.0,1,1.0,1,0.39029974569475967,28
1851,4,25416,25416,0,0,0,0,1.0,1,1.0,1,1.0,1,0.3446643104408393,28
1852,9,25425,25425,0,0,0,0,1.0,1,1.0,1,1.0,1,0.35809972632194065,28
1853,4,25429,25429,0,0,0,0,1.0,1,1.0,1,1.0,1,0.42093739049192286,27
1854,7,25436,25436,0,0,0,0,1.0,1,1.0,1,1.0,1,0.4245522929685996,28
1855,5,25441,25441,0,0,0,0,1.0,1,1.0,1,1.0,1,0.3669246453686818,28
1856,8,25449,25449,0,0,0,0,1.0,1,1.0,1,1.0,1,0.3588987866581491,30
1857,7,25456,25456,0,0,0,0,1.0,1,1.0,1,1.0,1,0.3758053531451632,31
1858,5,25461,25461,0,0,0,0,1.0,1,1.0,1,1.0,1,0.41800131333739093,31
1859,4,25465,25465,0,0,0,0,1.0,1,1.0,1,1.0,1,0.45406721381143206,31
1860,0,25465,25465,0,0,0,0,1.0,1,1.0,1,1.0,1,0.45406721381143206,31
1861,2,25467,25467,0,0,0,0,1.0,1,1.0,1,1.0,1,0.45615290857544016,31
1862,3,25470,25470,0,0,0,0,1.0,1,1.0,1,1.0,1,0.43279242735320145,31
1863,9,25479,25479,0,0,0,0,1.0,1,1.0,1,1.0,1,0.45979534391688137,31
1864,3,25482,25482,0,0,0,0,1.0,1,1.0,1,1.0,1,0.40434676759039195,30
1865,6,25488,25488,0,0,0,0,1.0,1,1.0,1,1.0,1,0.3870332846108241,27
1866,3,25491,25491,0,0,0,0,1.0,1,1.0,1,1.0,1,0.357018525986619,28
1867,2,25493,25493,0,0,0,0,1.0,1,1.0,1,1.0,1,0.3728003558070963,26
1868,4,25497,25497,0,0,0,0,1.0,1,1.0,1,1.0,1,0.3793966559257652,26
1869,4,25501,25501,0,0,0,0,1.0,1,1.0,1,1.0,1,0.3606076493933443,25
1870,1,25502,25502,0,0,0,0,1.0,1,1.0,1,1.0,1,0.3485570489469223,25
1871,4,25506,25506,0,0,0,0,1.0,1,1.0,1,1.0,1,0.38175166947230316,26
1872,3,25509,25509,0,0,0,0,1.0,1,1.0,1,1.0,1,0.3784436482216777,25
1873,4,25513,25513,0,0,0,0,1.0,1,1.0,1,1.0,1,0.43841642503922795,23
1874,6,25519,25519,0,0,0,0,1.0,1,1.0,1,1.0,1,0.46609312646353024,23
1875,7,25526,25526,0,0,0,0,1.0,1,1.0,1,1.0,1,0.42093019070894155,21
1876,6,25532,25532,0,0,0,0,1.0,1,1.0,1,1.0,1,0.39706508141325897,24
1877,6,25538,25538,0,0,0,0,1.0,1,1.0,1,1.0,1,0.3344945486709819,24
1878,4,25542,25542,0,0,0,0,1.0,1,1.0,1,1.0,1,0.3656845250487986,26
1879,11,25553,25553,0,0,0,0,1.0,1,1.0,1,1.0,1,0.39515317613995155,26
1880,12,25565,25565,0,0,0,0,1.0,1,1.0,1,1.0,1,0.3501035144143124,26
1881,7,25572,25572,0,0,0,0,1.0,1,1.0,1,1.0,1,0.33715581182704324,26
1882,8,25580,25580,0,0,0,0,1.0,1,1.0,1,1.0,1,0.37418447881405237,25
1883,9,25589,25589,0,0,0,0,1.0,1,1.0,1,1.0,1,0.37271490573534016,25
1884,6,25595,25595,0,0,0,0,1.0,1,1.0,1,1.0,1,0.4213097893370049,25
1885,5,25600,25600,0,0,0,0,1.0,1,1.0,1,1.0,1,0.4006215773689967,25
1886,10,25610,25610,0,0,0,0,1.0,1,1.0,1,1.0,1,0.2935815247416985,26
1887,8,25618,25618,0,0,0,0,1.0,1,1.0,1,1.0,1,0.33435879959659703,26
1888,4,25622,25622,0,0,0,0,1.0,1,1.0,1,1.0,1,0.3087999043140819,27
1889,4,25626,25626,0,0,0,0,1.0,1,1.0,1,1.0,1,0.33960907495048476,28
1890,2,25628,25628,0,0,0,0,1.0,1,1.0,1,1.0,1,0.22585349419445036,28
1891,3,25631,25631,0,0,0,0,1.0,1,1.0,1,1.0,1,0.3250301321710697,29
1892,2,25633,25633,0,0,0,0,1.0,1,1.0,1,1.0,1,0.2702138006930085,29
1893,4,25637,25637,0,0,0,0,1.0,1,1.0,1,1.0,1,0.2963284810371491,29
1894,4,25641,25641,0,0,0,0,1.0,1,1.0,1,1.0,1,0.34852834908169783,29
1895,4,25645,25645,0,0,0,0,1.0,1,1.0,1,1.0,1,0.34456289644190113,31
1896,1,25646,25646,0,0,0,0,1.0,1,1.0,1,1.0,1,0.3308727030655071,31
1897,7,25653,25653,0,0,0,0,1.0,1,1.0,1,1.0,1,0.3243751290536288,31
1898,1,25654,25654,0,0,0,0,1.0,1,1.0,1,1.0,1,0.29167646822416926,31
1899,3,25657,25657,0,0,0,0,1.0,1,1.0,1,1.0,1,0.3164005443517112,32
1900,2,25659,25659,0,0,0,0,1.0,1,1.0,1,1.0,1,0.31097302282386596,32
1901,1,25660,25660,0,0,0,0,1.0,1,1.0,1,1.0,1,0.33851703799447475,32
1902,2,25662,25662,0,0,0,0,1.0,1,1.0,1,1.0,1,0.3626719989901143,32
1903,1,25663,25663,0,0,0,0,1.0,1,1.0,1,1.0,1,0.33245335550484517,32
1904,1,25664,25664,0,0,0,0,1.0,1,1.0,1,1.0,1,0.3458021249915789,34
1905,4,25668,25668,0,0,0,0,1.0,1,1.0,1,1.0,1,0.307034039343557,34
1906,9,25677,25677,0,0,0,0,1.0,1,1.0,1,1.0,1,0.3395756396176716,35
1907,7,25684,25684,0,0,0,0,1.0,1,1.0,1,1.0,1,0.4430836880346656,36
1908,7,25691,25691,0,0,0,0,1.0,1,1.0,1,1.0,1,0.3775135576029505,36
1909,12,25703,25703,0,0,0,0,1.0,1,1.0,1,1.0,1,0.3121477871514497,37
1910,11,25714,25714,0,0,0,0,1.0,1,1.0,1,1.0,1,0.32910974559379214,38
1911,5,25719,25719,0,0,0,0,1.0,1,1.0,1,1.0,1,0.30852851105715345,37
1912,15,25734,25734,0,0,0,0,1.0,1,1.0,1,1.0,1,0.33366721553361406,37
1913,7,25741,25741,0,0,0,0,1.0,1,1.0,1,1.0,1,0.29507573655851316,36
1914,10,25751,25751,0,0,0,0,1.0,1,1.0,1,1.0,1,0.3015053539096147,37
1915,10,25761,25761,0,0,0,0,1.0,1,1.0,1,1.0,1,0.32751866833396265,37
1916,13,25774,25774,0,0,0,0,1.0,1,1.0,1,1.0,1,0.21595362105869803,39
1917,6,25780,25780,0,0,0,0,1.0,1,1.0,1,1.0,1,0.24087560612295708,38
1918,12,25792,25792,0,0,0,0,1.0,1,1.0,1,1.0,1,0.26966730005589096,38
1919,12,25804,25804,0,0,0,0,1.0,1,1.0,1,1.0,1,0.40138959167619354,38
1920,16,25820,25820,0,0,0,0,1.0,1,1.0,1,1.0,1,0.24490345727224902,39
1921,12,25832,25832,0,0,0,0,1.0,1,1.0,1,1.0,1,0.15585708391261507,38
1922,17,25849,25849,0,0,0,0,1.0,1,1.0,1,1.0,1,0.27895025166993337,39
1923,22,25871,25871,0,0,0,0,1.0,1,1.0,1,1.0,1,0.25895987081432775,40
1924,16,25887,25887,0,0,0,0,1.0,1,1.0,1,1.0,1,0.31558437398925093,40
1925,12,25899,25899,0,0,0,0,1.0,1,1.0,1,1.0,1,0.3051659744675652,40
1926,10,25909,25909,0,0,0,0,1.0,1,1.0,1,1.0,1,0.35298010961845794,40
1927,4,25913,25913,0,0,0,0,1.0,1,1.0,1,1.0,1,0.369699292384012,41
1928,7,25920,25920,0,0,0,0,1.0,1,1.0,1,1.0,1,0.4149797050032386,41
1929,8,25928,25928,0,0,0,0,1.0,1,1.0,1,1.0,1,0.3521180538696178,40
1930,5,25933,25933,0,0,0,0,1.0,1,1.0,1,1.0,1,0.41538849272808326,40
1931,6,25939,25939,0,0,0,0,1.0,1,1.0,1,1.0,1,0.4417654955116204,40
1932,2,25941,25941,0,0,0,0,1.0,1,1.0,1,1.0,1,0.4255233468837519,40
1933,5,25946,25946,0,0,0,0,1.0,1,1.0,1,1.0,1,0.4227089582009834,42
1934,6,25952,25952,0,0,0,0,1.0,1,1.0,1,1.0,1,0.40488813393513046,44
1935,11,25963,25963,0,0,0,0,1.0,1,1.0,1,1.0,1,0.33096516375419904,44
1936,6,25969,25969,0,0,0,0,1.0,1,1.0,1,1.0,1,0.3626521419610847,46
1937,16,25985,25985,0,0,0,0,1.0,1,1.0,1,1.0,1,0.2838852505642092,47
1938,6,25991,25991,0,0,0,0,1.0,1,1.0,1,1.0,1,0.21000690015011583,47
1939,8,25999,25999,0,0,0,0,1.0,1,1.0,1,1.0,1,0.2846877458654076,47
1940,13,26012,26012,0,0,0,0,1.0,1,1.0,1,1.0,1,0.28197173354770144,47
1941,16,26028,26028,0,0,0,0,1.0,1,1.0,1,1.0,1,0.21226484628028205,47
1942,10,26038,26038,0,0,0,0,1.0,1,1.0,1,1.0,1,0.2599874854770581,49
1943,13,26051,26051,0,0,0,0,1.0,1,1.0,1,1.0,1,0.30695521260512354,47
1944,17,26068,26068,0,0,0,0,1.0,1,1.0,1,1.0,1,0.2949009994992035,47
1945,15,26083,26083,0,0,0,0,1.0,1,1.0,1,1.0,1,0.36348724546613836,45
1946,10,26093,26093,0,0,0,0,1.0,1,1.0,1,1.0,1,0.38486651298949665,45
1947,22,26115,26115,0,0,0,0,1.0,1,1.0,1,1.0,1,0.28190235568191596,45
1948,11,26126,26126,0,0,0,0,1.0,1,1.0,1,1.0,1,0.3203178157597534,45
1949,10,26136,26136,0,0,0,0,1.0,1,1.0,1,1.0,1,0.31160308007647974,42
1950,15,26151,26151,0,0,0,0,1.0,1,1.0,1,1.0,1,0.2492501116769401,42
1951,12,26163,26163,0,0,0,0,1.0,1,1.0,1,1.0,1,0.30194741599752656,38
1952,9,26172,26172,0,0,0,0,1.0,1,1.0,1,1.0,1,0.3221164449590782,36
1953,13,26185,26185,0,0,0,0,1.0,1,1.0,1,1.0,1,0.3066084639534002,35
1954,14,26199,26199,0,0,0,0,1.0,1,1.0,1,1.0,1,0.37148876937730874,32
1955,13,26212,26212,0,0,0,0,1.0,1,1.0,1,1.0,1,0.3036283916870766,33
1956,16,26228,26228,0,0,0,0,1.0,1,1.0,1,1.0,1,0.2859777834273595,31
1957,11,26239,26239,0,0,0,0,1.0,1,1.0,1,1.0,1,0.3248604775592275,33
1958,18,26257,26257,0,0,0,0,1.0,1,1.0,1,1.0,1,0.3221550881971693,34
1959,13,26270,26270,0,0,0,0,1.0,1,1.0,1,1.0,1,0.3954418175385116,35
1960,14,26284,26284,0,0,0,0,1.0,1,1.0,1,1.0,1,0.37638100952486647,36
1961,10,26294,26294,0,0,0,0,1.0,1,1.0,1,1.0,1,0.22628940946491205,36
1962,10,26304,26304,0,0,0,0,1.0,1,1.0,1,1.0,1,0.2984959079775545,35
1963,9,26313,26313,0,0,0,0,1.0,1,1.0,1,1.0,1,0.314941071166934,36
1964,13,26326,26326,0,0,0,0,1.0,1,1.0,1,1.0,1,0.3571551072767096,35
1965,5,26331,26331,0,0,0,0,1.0,1,1.0,1,1.0,1,0.3035883814504334,36
1966,6,26337,26337,0,0,0,0,1.0,1,1.0,1,1.0,1,0.2701725684956834,36
1967,7,26344,26344,0,0,0,0,1.0,1,1.0,1,1.0,1,0.2984818926386587,36
1968,7,26351,26351,0,0,0,0,1.0,1,1.0,1,1.0,1,0.3080763647479698,37
1969,6,26357,26357,0,0,0,0,1.0,1,1.0,1,1.0,1,0.25821999985084715,37
1970,3,26360,26360,0,0,0,0,1.0,1,1.0,1,1.0,1,0.31651467880790896,38
1971,5,26365,26365,0,0,0,0,1.0,1,1.0,1,1.0,1,0.33126046544020915,37
1972,6,26371,26371,0,0,0,0,1.0,1,1.0,1,1.0,1,0.23057060220532077,37
1973,9,26380,26380,0,0,0,0,1.0,1,1.0,1,1.0,1,0.2824916521616365,37
1974,11,26391,26391,0,0,0,0,1.0,1,1.0,1,1.0,1,0.3643904391456738,38
1975,12,26403,26403,0,0,0,0,1.0,1,1.0,1,1.0,1,0.2774237100828787,37
1976,13,26416,26416,0,0,0,0,1.0,1,1.0,1,1.0,1,0.27145312162343804,39
1977,8,26424,26424,0,0,0,0,1.0,1,1.0,1,1.0,1,0.3176387935302835,42
1978,12,26436,26436,0,0,0,0,1.0,1,1.0,1,1.0,1,0.31211060520911343,42
1979,16,26452,26452,0,0,0,0,1.0,1,1.0,1,1.0,1,0.2862833275160774,42
1980,9,26461,26461,0,0,0,0,1.0,1,1.0,1,1.0,1,0.2975196368978033,43
1981,9,26470,26470,0,0,0,0,1.0,1,1.0,1,1.0,1,0.30848171703668387,44
1982,4,26474,26474,0,0,0,0,1.0,1,1.0,1,1.0,1,0.30921101216247215,44
1983,8,26482,26482,0,0,0,0,1.0,1,1.0,1,1.0,1,0.394696574911026,44
1984,4,26486,26486,0,0,0,0,1.0,1,1.0,1,1.0,1,0.388304498664401,42
1985,7,26493,26493,0,0,0,0,1.0,1,1.0,1,1.0,1,0.41334860766426956,41
1986,15,26508,26508,0,0,0,0,1.0,1,1.0,1,1.0,1,0.4547950108360379,40
1987,10,26518,26518,0,0,0,0,1.0,1,1.0,1,1.0,1,0.4180851672034997,37
1988,19,26537,26537,0,0,0,0,1.0,1,1.0,1,1.0,1,0.39447017022953695,35
1989,9,26546,26546,0,0,0,0,1.0,1,1.0,1,1.0,1,0.4118769856320948,32
1990,17,26563,26563,0,0,0,0,1.0,1,1.0,1,1.0,1,0.43109029941805294,31
1991,5,26568,26568,0,0,0,0,1.0,1,1.0,1,1.0,1,0.4599729723726046,32
1992,10,26578,26578,0,0,0,0,1.0,1,1.0,1,1.0,1,0.3372982447259319,32
1993,8,26586,26586,0,0,0,0,1.0,1,1.0,1,1.0,1,0.4820337947017807,32
1994,12,26598,26598,0,0,0,0,1.0,1,1.0,1,1.0,1,0.3468241613030775,31
1995,12,26610,26610,0,0,0,0,1.0,1,1.0,1,1.0,1,0.42532375933014493,32
1996,13,26623,26623,0,0,0,0,1.0,1,1.0,1,1.0,1,0.4205808837392207,32
1997,13,26636,26636,0,0,0,0,1.0,1,1.0,1,1.0,1,0.47968293559910463,31
1998,10,26646,26646,0,0,0,0,1.0,1,1.0,1,1.0,1,0.3490978625908542,32
1999,12,26658,26658,0,0,0,0,1.0,1,1.0,1,1.0,1,0.4740518610308306,31
2000,8,26666,26666,0,0,0,0,1.0,1,1.0,1,1.0,1,0.5474177728670236,30
2001,18,26684,26684,0,0,0,0,1.0,1,1.0,1,1.0,1,0.5245311122430648,29
2002,14,26698,26698,0,0,0,0,1.0,1,1.0,1,1.0,1,0.35994329841992,31
2003,12,26710,26710,0,0,0,0,1.0,1,1.0,1,1.0,1,0.36395615259846037,33
2004,14,26724,26724,0,0,0,0,1.0,1,1.0,1,1.0,1,0.4402955476376906,34
2005,16,26740,26740,0,0,0,0,1.0,1,1.0,1,1.0,1,0.4927074742417697,35
2006,20,26760,26760,0,0,0,0,1.0,1,1.0,1,1.0,1,0.3870939067668451,36
2007,8,26768,26768,0,0,0,0,1.0,1,1.0,1,1.0,1,0.4065809270744314,36
2008,11,26779,26779,0,0,0,0,1.0,1,1.0,1,1.0,1,0.2750996961894677,36
2009,13,26792,26792,0,0,0,0,1.0,1,1.0,1,1.0,1,0.31369563556788044,37
2010,9,26801,26801,0,0,0,0,1.0,1,1.0,1,1.0,1,0.40343543979782615,37
2011,9,26810,26810,0,0,0,0,1.0,1,1.0,1,1.0,1,0.3280376502045551,37
2012,11,26821,26821,0,0,0,0,1.0,1,1.0,1,1.0,1,0.39032826913204816,37
2013,8,26829,26829,0,0,0,0,1.0,1,1.0,1,1.0,1,0.2740088602392084,39
2014,12,26841,26841,0,0,0,0,1.0,1,1.0,1,1.0,1,0.37519121950575973,39
2015,8,26849,26849,0,0,0,0,1.0,1,1.0,1,1.0,1,0.4386288684237102,39
2016,23,26872,26872,0,0,0,0,1.0,1,1.0,1,1.0,1,0.3265463311182403,41
2017,18,26890,26890,0,0,0,0,1.0,1,1.0,1,1.0,1,0.24542059080610287,41
2018,18,26908,26908,0,0,0,0,1.0,1,1.0,1,1.0,1,0.2190993521627953,42
2019,13,26921,26921,0,0,0,0,1.0,1,1.0,1,1.0,1,0.21012989995542822,43
2020,11,26932,26932,0,0,0,0,1.0,1,1.0,1,1.0,1,0.24706329424744544,43
2021,7,26939,26939,0,0,0,0,1.0,1,1.0,1,1.0,1,0.35751313552744995,43
2022,14,26953,26953,0,0,0,0,1.0,1,1.0,1,1.0,1,0.3920299149130771,44
2023,5,26958,26958,0,0,0,0,1.0,1,1.0,1,1.0,1,0.3626940596849555,42
2024,17,26975,26975,0,0,0,0,1.0,1,1.0,1,1.0,1,0.32347448196101175,41
2025,10,26985,26985,0,0,0,0,1.0,1,1.0,1,1.0,1,0.4309703476138381,39
2026,20,27005,27005,0,0,0,0,1.0,1,1.0,1,1.0,1,0.31878031274954044,39
2027,9,27014,27014,0,0,0,0,1.0,1,1.0,1,1.0,1,0.41379641165490066,38
2028,13,27027,27027,0,0,0,0,1.0,1,1.0,1,1.0,1,0.32172261970307986,37
2029,7,27034,27034,0,0,0,0,1.0,1,1.0,1,1.0,1,0.35757920038615715,35
2030,10,27044,27044,0,0,0,0,1.0,1,1.0,1,1.0,1,0.32786821880290384,32
2031,16,27060,27060,0,0,0,0,1.0,1,1.0,1,1.0,1,0.30079135792254874,34
2032,11,27071,27071,0,0,0,0,1.0,1,1.0,1,1.0,1,0.2937720224466398,35
2033,14,27085,27085,0,0,0,0,1.0,1,1.0,1,1.0,1,0.33145686669088914,35
2034,18,27103,27103,0,0,0,0,1.0,1,1.0,1,1.0,1,0.35659383235688086,35
2035,12,27115,27115,0,0,0,0,1.0,1,1.0,1,1.0,1,0.4386965673127137,36
2036,19,27134,27134,0,0,0,0,1.0,1,1.0,1,1.0,1,0.4175621873652251,35
2037,13,27147,27147,0,0,0,0,1.0,1,1.0,1,1.0,1,0.2982893837565505,36
2038,9,27156,27156,0,0,0,0,1.0,1,1.0,1,1.0,1,0.38644475682009577,38
2039,4,27160,27160,0,0,0,0,1.0,1,1.0,1,1.0,1,0.3749622494832531,38
2040,12,27172,27172,0,0,0,0,1.0,1,1.0,1,1.0,1,0.38542094697732754,37
2041,5,27177,27177,0,0,0,0,1.0,1,1.0,1,1.0,1,0.4587594147202189,38
2042,14,27191,27191,0,0,0,0,1.0,1,1.0,1,1.0,1,0.3737994956206797,38
2043,7,27198,27198,0,0,0,0,1.0,1,1.0,1,1.0,1,0.4509319469277176,38
2044,8,27206,27206,0,0,0,0,1.0,1,1.0,1,1.0,1,0.4950896226835276,39
2045,9,27215,27215,0,0,0,0,1.0,1,1.0,1,1.0,1,0.4308778347797904,40
2046,18,27233,27233,0,0,0,0,1.0,1,1.0,1,1.0,1,0.4619624680344733,41
2047,13,27246,27246,0,0,0,0,1.0,1,1.0,1,1.0,1,0.33800595074460626,41
2048,14,27260,27260,0,0,0,0,1.0,1,1.0,1,1.0,1,0.31842188735871607,43
2049,17,27277,27277,0,0,0,0,1.0,1,1.0,1,1.0,1,0.3533865991476397,43
2050,11,27288,27288,0,0,0,0,1.0,1,1.0,1,1.0,1,0.2149685337607021,43
2051,10,27298,27298,0,0,0,0,1.0,1,1.0,1,1.0,1,0.2507569395678541,43
2052,11,27309,27309,0,0,0,0,1.0,1,1.0,1,1.0,1,0.28053948803237555,44
2053,14,27323,27323,0,0,0,0,1.0,1,1.0,1,1.0,1,0.2726454475964063,43
2054,17,27340,27340,0,0,0,0,1.0,1,1.0,1,1.0,1,0.3527118429952903,44
2055,4,27344,27344,0,0,0,0,1.0,1,1.0,1,1.0,1,0.32013445901099224,43
2056,12,27356,27356,0,0,0,0,1.0,1,1.0,1,1.0,1,0.29766472343165523,44
2057,16,27372,27372,0,0,0,0,1.0,1,1.0,1,1.0,1,0.39092611845892233,44
2058,11,27383,27383,0,0,0,0,1.0,1,1.0,1,1.0,1,0.32278667193980193,44
2059,15,27398,27398,0,0,0,0,1.0,1,1.0,1,1.0,1,0.2876151700206191,45
2060,9,27407,27407,0,0,0,0,1.0,1,1.0,1,1.0,1,0.2535572456404895,46
2061,15,27422,27422,0,0,0,0,1.0,1,1.0,1,1.0,1,0.35126124861046176,48
2062,14,27436,27436,0,0,0,0,1.0,1,1.0,1,1.0,1,0.2679769386556834,48
2063,9,27445,27445,0,0,0,0,1.0,1,1.0,1,1.0,1,0.24331016188870175,45
2064,8,27453,27453,0,0,0,0,1.0,1,1.0,1,1.0,1,0.2835363919011338,44
2065,10,27463,27463,0,0,0,0,1.0,1,1.0,1,1.0,1,0.22375338983245174,42
2066,14,27477,27477,0,0,0,0,1.0,1,1.0,1,1.0,1,0.22956566662386263,42
2067,12,27489,27489,0,0,0,0,1.0,1,1.0,1,1.0,1,0.3598327063615858,38
2068,20,27509,27509,0,0,0,0,1.0,1,1.0,1,1.0,1,0.35373146710131154,37
2069,13,27522,27522,0,0,0,0,1.0,1,1.0,1,1.0,1,0.3572788827510339,35
2070,14,27536,27536,0,0,0,0,1.0,1,1.0,1,1.0,1,0.40183493580063934,35
2071,8,27544,27544,0,0,0,0,1.0,1,1.0,1,1.0,1,0.350453126457063,34
2072,12,27556,27556,0,0,0,0,1.0,1,1.0,1,1.0,1,0.39009710410461734,35
2073,17,27573,27573,0,0,0,0,1.0,1,1.0,1,1.0,1,0.4009532602808937,37
2074,19,27592,27592,0,0,0,0,1.0,1,1.0,1,1.0,1,0.33214984658992447,36
2075,15,27607,27607,0,0,0,0,1.0,1,1.0,1,1.0,1,0.2947881675803282,38
2076,24,27631,27631,0,0,0,0,1.0,1,1.0,1,1.0,1,0.4188835741395547,37
2077,10,27641,27641,0,0,0,0,1.0,1,1.0,1,1.0,1,0.38019260269939714,37
2078,28,27669,27669,0,0,0,0,1.0,1,1.0,1,1.0,1,0.36860055221310717,37
2079,12,27681,27681,0,0,0,0,1.0,1,1.0,1,1.0,1,0.3165229565282489,37
2080,19,27700,27700,0,0,0,0,1.0,1,1.0,1,1.0,1,0.20247355782585702,36
2081,12,27712,27712,0,0,0,0,1.0,1,1.0,1,1.0,1,0.19654146845845086,37
2082,15,27727,27727,0,0,0,0,1.0,1,1.0,1,1.0,1,0.17469795528044801,38
2083,11,27738,27738,0,0,0,0,1.0,1,1.0,1,1.0,1,0.3404184416457942,39
2084,10,27748,27748,0,0,0,0,1.0,1,1.0,1,1.0,1,0.29973816511166723,41
2085,12,27760,27760,0,0,0,0,1.0,1,1.0,1,1.0,1,0.27001536259607023,41
2086,9,27769,27769,0,0,0,0,1.0,1,1.0,1,1.0,1,0.23293071269948168,44
2087,16,27785,27785,0,0,0,0,1.0,1,1.0,1,1.0,1,0.2753034200341647,44
2088,8,27793,27793,0,0,0,0,1.0,1,1.0,1,1.0,1,0.27348307492168444,45
2089,9,27802,27802,0,0,0,0,1.0,1,1.0,1,1.0,1,0.3777095422533487,46
2090,10,27812,27812,0,0,0,0,1.0,1,1.0,1,1.0,1,0.39722083796348473,47
2091,16,27828,27828,0,0,0,0,1.0,1,1.0,1,1.0,1,0.3782084555266473,48
2092,13,27841,27841,0,0,0,0,1.0,1,1.0,1,1.0,1,0.2838364457875265,48
2093,13,27854,27854,0,0,0,0,1.0,1,1.0,1,1.0,1,0.31836179087015876,48
2094,10,27864,27864,0,0,0,0,1.0,1,1.0,1,1.0,1,0.4269313918205758,47
2095,13,27877,27877,0,0,0,0,1.0,1,1.0,1,1.0,1,0.3280332324443622,49
2096,11,27888,27888,0,0,0,0,1.0,1,1.0,1,1.0,1,0.36464012717976513,50
2097,12,27900,27900,0,0,0,0,1.0,1,1.0,1,1.0,1,0.36238636673450814,50
2098,13,27913,27913,0,0,0,0,1.0,1,1.0,1,1.0,1,0.4100326607293223,51
2099,10,27923,27923,0,0,0,0,1.0,1,1.0,1,1.0,1,0.36370122964953966,50
2100,9,27932,27932,0,0,0,0,1.0,1,1.0,1,1.0,1,0.3217407827104441,49
2101,12,27944,27944,0,0,0,0,1.0,1,1.0,1,1.0,1,0.36191798389163754,48
2102,14,27958,27958,0,0,0,0,1.0,1,1.0,1,1.0,1,0.3751191800795643,49
2103,16,27974,27974,0,0,0,0,1.0,1,1.0,1,1.0,1,0.39737479778060647,44
2104,12,27986,27986,0,0,0,0,1.0,1,1.0,1,1.0,1,0.3441996086014536,42
2105,12,27998,27998,0,0,0,0,1.0,1,1.0,1,1.0,1,0.3723897372789529,40
2106,12,28010,28010,0,0,0,0,1.0,1,1.0,1,1.0,1,0.437366741513341,39
2107,13,28023,28023,0,0,0,0,1.0,1,1.0,1,1.0,1,0.4448118333988833,37
2108,9,28032,28032,0,0,0,0,1.0,1,1.0,1,1.0,1,0.3891017038384633,37
2109,14,28046,28046,0,0,0,0,1.0,1,1.0,1,1.0,1,0.451006721258352,36
2110,8,28054,28054,0,0,0,0,1.0,1,1.0,1,1.0,1,0.4703038276517169,35
2111,12,28066,28066,0,0,0,0,1.0,1,1.0,1,1.0,1,0.4779609705750095,35
2112,5,28071,28071,0,0,0,0,1.0,1,1.0,1,1.0,1,0.45951426712059507,35
2113,11,28082,28082,0,0,0,0,1.0,1,1.0,1,1.0,1,0.49940880538008664,35
2114,11,28093,28093,0,0,0,0,1.0,1,1.0,1,1.0,1,0.4863242553813531,36
2115,17,28110,28110,0,0,0,0,1.0,1,1.0,1,1.0,1,0.42638044062970876,37
2116,11,28121,28121,0,0,0,0,1.0,1,1.0,1,1.0,1,0.47521540697202014,39
2117,13,28134,28134,0,0,0,0,1.0,1,1.0,1,1.0,1,0.42900230046031357,39
2118,8,28142,28142,0,0,0,0,1.0,1,1.0,1,1.0,1,0.3988955198419143,41
2119,14,28156,28156,0,0,0,0,1.0,1,1.0,1,1.0,1,0.5158161210333587,42
2120,9,28165,28165,0,0,0,0,1.0,1,1.0,1,1.0,1,0.5202724359085337,42
2121,17,28182,28182,0,0,0,0,1.0,1,1.0,1,1.0,1,0.5582642783345034,42
2122,8,28190,28190,0,0,0,0,1.0,1,1.0,1,1.0,1,0.5090717623693344,43
2123,12,28202,28202,0,0,0,0,1.0,1,1.0,1,1.0,1,0.5469350147072735,42
2124,9,28211,28211,0,0,0,0,1.0,1,1.0,1,1.0,1,0.5434456014434137,42
2125,7,28218,28218,0,0,0,0,1.0,1,1.0,1,1.0,1,0.5451286097589038,41
2126,10,28228,28228,0,0,0,0,1.0,1,1.0,1,1.0,1,0.5153387555803005,41
2127,4,28232,28232,0,0,0,0,1.0,1,1.0,1,1.0,1,0.6291695454010137,41
2128,13,28245,28245,0,0,0,0,1.0,1,1.0,1,1.0,1,0.4893005240254418,42
2129,11,28256,28256,0,0,0,0,1.0,1,1.0,1,1.0,1,0.407252783061883,43
2130,13,28269,28269,0,0,0,0,1.0,1,1.0,1,1.0,1,0.36653043221649306,45
2131,15,28284,28284,0,0,0,0,1.0,1,1.0,1,1.0,1,0.41246346476374846,44
2132,14,28298,28298,0,0,0,0,1.0,1,1.0,1,1.0,1,0.3779412530622162,44
2133,15,28313,28313,0,0,0,0,1.0,1,1.0,1,1.0,1,0.2812785508135147,45
2134,13,28326,28326,0,0,0,0,1.0,1,1.0,1,1.0,1,0.1963047721555044,45
2135,23,28349,28349,0,0,0,0,1.0,1,1.0,1,1.0,1,0.23319730154927534,46
2136,16,28365,28365,0,0,0,0,1.0,1,1.0,1,1.0,1,0.281681238870374,47
2137,15,28380,28380,0,0,0,0,1.0,1,1.0,1,1.0,1,0.21994617877950623,47
2138,12,28392,28392,0,0,0,0,1.0,1,1.0,1,1.0,1,0.2622373937298166,45
2139,6,28398,28398,0,0,0,0,1.0,1,1.0,1,1.0,1,0.19511503563979193,45
2140,16,28414,28414,0,0,0,0,1.0,1,1.0,1,1.0,1,0.2319848065307955,44
2141,11,28425,28425,0,0,0,0,1.0,1,1.0,1,1.0,1,0.23493158241719914,45
2142,13,28438,28438,0,0,0,0,1.0,1,1.0,1,1.0,1,0.22227517768106847,46
2143,19,28457,28457,0,0,0,0,1.0,1,1.0,1,1.0,1,0.22850573947083008,46
2144,17,28474,28474,0,0,0,0,1.0,1,1.0,1,1.0,1,0.2810320242683531,48
2145,14,28488,28488,0,0,0,0,1.0,1,1.0,1,1.0,1,0.21269490209652633,46
2146,18,28506,28506,0,0,0,0,1.0,1,1.0,1,1.0,1,0.292934042057583,45
2147,17,28523,28523,0,0,0,0,1.0,1,1.0,1,1.0,1,0.2031903696985666,44
2148,16,28539,28539,0,0,0,0,1.0,1,1.0,1,1.0,1,0.30523025079857913,44
2149,18,28557,28557,0,0,0,0,1.0,1,1.0,1,1.0,1,0.28380031426420355,42
2150,13,28570,28570,0,0,0,0,1.0,1,1.0,1,1.0,1,0.3107247075735609,40
2151,12,28582,28582,0,0,0,0,1.0,1,1.0,1,1.0,1,0.3781492848728023,39
2152,14,28596,28596,0,0,0,0,1.0,1,1.0,1,1.0,1,0.35546993873735794,40
2153,22,28618,28618,0,0,0,0,1.0,1,1.0,1,1.0,1,0.3204125833575179,42
2154,13,28631,28631,0,0,0,0,1.0,1,1.0,1,1.0,1,0.29133344417912194,42
2155,9,28640,28640,0,0,0,0,1.0,1,1.0,1,1.0,1,0.35452798467303276,41
2156,12,28652,28652,0,0,0,0,1.0,1,1.0,1,1.0,1,0.3308137121054994,40
2157,5,28657,28657,0,0,0,0,1.0,1,1.0,1,1.0,1,0.40967369830785016,40
2158,14,28671,28671,0,0,0,0,1.0,1,1.0,1,1.0,1,0.3519184228557654,38
2159,14,28685,28685,0,0,0,0,1.0,1,1.0,1,1.0,1,0.3443731165875549,38
2160,13,28698,28698,0,0,0,0,1.0,1,1.0,1,1.0,1,0.37240621275080454,38
2161,20,28718,28718,0,0,0,0,1.0,1,1.0,1,1.0,1,0.35069096425126933,38
2162,7,28725,28725,0,0,0,0,1.0,1,1.0,1,1.0,1,0.320762467302981,38
2163,14,28739,28739,0,0,0,0,1.0,1,1.0,1,1.0,1,0.2932441602406232,40
2164,8,28747,28747,0,0,0,0,1.0,1,1.0,1,1.0,1,0.21050460940395718,41
2165,12,28759,28759,0,0,0,0,1.0,1,1.0,1,1.0,1,0.25318679082647344,42
2166,7,28766,28766,0,0,0,0,1.0,1,1.0,1,1.0,1,0.2359037632753576,42
2167,5,28771,28771,0,0,0,0,1.0,1,1.0,1,1.0,1,0.24282735830853497,43
2168,8,28779,28779,0,0,0,0,1.0,1,1.0,1,1.0,1,0.22833069835819367,43
2169,9,28788,28788,0,0,0,0,1.0,1,1.0,1,1.0,1,0.24415743421972128,45
2170,10,28798,28798,0,0,0,0,1.0,1,1.0,1,1.0,1,0.24372494579830586,46
2171,9,28807,28807,0,0,0,0,1.0,1,1.0,1,1.0,1,0.22134119670468727,48
2172,17,28824,28824,0,0,0,0,1.0,1,1.0,1,1.0,1,0.2363298823694614,49
2173,11,28835,28835,0,0,0,0,1.0,1,1.0,1,1.0,1,0.2712972402855912,49
2174,24,28859,28859,0,0,0,0,1.0,1,1.0,1,1.0,1,0.2315824027785589,49
2175,13,28872,28872,0,0,0,0,1.0,1,1.0,1,1.0,1,0.24995444330231867,49
2176,16,28888,28888,0,0,0,0,1.0,1,1.0,1,1.0,1,0.3281027555257218,51
2177,19,28907,28907,0,0,0,0,1.0,1,1.0,1,1.0,1,0.29004397227028683,51
2178,11,28918,28918,0,0,0,0,1.0,1,1.0,1,1.0,1,0.24838407263674797,50
2179,13,28931,28931,0,0,0,0,1.0,1,1.0,1,1.0,1,0.28928402619293037,49
2180,13,28944,28944,0,0,0,0,1.0,1,1.0,1,1.0,1,0.389365217729333,47
2181,11,28955,28955,0,0,0,0,1.0,1,1.0,1,1.0,1,0.4054043628385087,47
2182,13,28968,28968,0,0,0,0,1.0,1,1.0,1,1.0,1,0.40540644472821163,45
2183,17,28985,28985,0,0,0,0,1.0,1,1.0,1,1.0,1,0.3662444105649239,44
2184,15,29000,29000,0,0,0,0,1.0,1,1.0,1,1.0,1,0.3343464463634285,43
2185,13,29013,29013,0,0,0,0,1.0,1,1.0,1,1.0,1,0.2993114266541345,40
2186,12,29025,29025,0,0,0,0,1.0,1,1.0,1,1.0,1,0.42631755023141016,38
2187,17,29042,29042,0,0,0,0,1.0,1,1.0,1,1.0,1,0.39554894820364,35
2188,8,29050,29050,0,0,0,0,1.0,1,1.0,1,1.0,1,0.5121977277734675,34
2189,17,29067,29067,0,0,0,0,1.0,1,1.0,1,1.0,1,0.48313687811465666,31
2190,16,29083,29083,0,0,0,0,1.0,1,1.0,1,1.0,1,0.4377481930175298,29
2191,9,29092,29092,0,0,0,0,1.0,1,1.0,1,1.0,1,0.48150241090082135,28
2192,14,29106,29106,0,0,0,0,1.0,1,1.0,1,1.0,1,0.4935495241646617,29
2193,17,29123,29123,0,0,0,0,1.0,1,1.0,1,1.0,1,0.30512618135177955,28
2194,16,29139,29139,0,0,0,0,1.0,1,1.0,1,1.0,1,0.4680092369395681,27
2195,17,29156,29156,0,0,0,0,1.0,1,1.0,1,1.0,1,0.4320874135217442,27
2196,12,29168,29168,0,0,0,0,1.0,1,1.0,1,1.0,1,0.4558610378154484,27
2197,10,29178,29178,0,0,0,0,1.0,1,1.0,1,1.0,1,0.5108391550672388,27
2198,5,29183,29183,0,0,0,0,1.0,1,1.0,1,1.0,1,0.5486583989011863,28
2199,11,29194,29194,0,0,0,0,1.0,1,1.0,1,1.0,1,0.4910856795124573,29
2200,12,29206,29206,0,0,0,0,1.0,1,1.0,1,1.0,1,0.46974684612054785,31
2201,14,29220,29220,0,0,0,0,1.0,1,1.0,1,1.0,1,0.5548710043150259,32
2202,20,29240,29240,0,0,0,0,1.0,1,1.0,1,1.0,1,0.4703583392074106,31
2203,18,29258,29258,0,0,0,0,1.0,1,1.0,1,1.0,1,0.4352835363889406,32
2204,16,29274,29274,0,0,0,0,1.0,1,1.0,1,1.0,1,0.4597404636553065,32
2205,11,29285,29285,0,0,0,0,1.0,1,1.0,1,1.0,1,0.43392493488281775,33
2206,12,29297,29297,0,0,0,0,1.0,1,1.0,1,1.0,1,0.5045778354315199,32
2207,11,29308,29308,0,0,0,0,1.0,1,1.0,1,1.0,1,0.4398092763623339,33
2208,13,29321,29321,0,0,0,0,1.0,1,1.0,1,1.0,1,0.44325007213113865,35
2209,17,29338,29338,0,0,0,0,1.0,1,1.0,1,1.0,1,0.5090721479192378,36
2210,15,29353,29353,0,0,0,0,1.0,1,1.0,1,1.0,1,0.3525485005895845,35
2211,15,29368,29368,0,0,0,0,1.0,1,1.0,1,1.0,1,0.30466298461146707,36
2212,12,29380,29380,0,0,0,0,1.0,1,1.0,1,1.0,1,0.35314496890158076,37
2213,14,29394,29394,0,0,0,0,1.0,1,1.0,1,1.0,1,0.30458434869365364,37
2214,17,29411,29411,0,0,0,0,1.0,1,1.0,1,1.0,1,0.30208244086881597,39
2215,12,29423,29423,0,0,0,0,1.0,1,1.0,1,1.0,1,0.2945112077173617,36
2216,14,29437,29437,0,0,0,0,1.0,1,1.0,1,1.0,1,0.367871553439105,37
2217,12,29449,29449,0,0,0,0,1.0,1,1.0,1,1.0,1,0.37130338344785585,35
2218,7,29456,29456,0,0,0,0,1.0,1,1.0,1,1.0,1,0.41310720871026996,35
2219,6,29462,29462,0,0,0,0,1.0,1,1.0,1,1.0,1,0.4117210965580246,33
2220,6,29468,29468,0,0,0,0,1.0,1,1.0,1,1.0,1,0.4925673164473289,31
2221,5,29473,29473,0,0,0,0,1.0,1,1.0,1,1.0,1,0.5095915161478808,31
2222,8,29481,29481,0,0,0,0,1.0,1,1.0,1,1.0,1,0.3921310062066064,30
2223,14,29495,29495,0,0,0,0,1.0,1,1.0,1,1.0,1,0.5878322317741809,28
2224,11,29506,29506,0,0,0,0,1.0,1,1.0,1,1.0,1,0.36295003599165127,29
2225,13,29519,29519,0,0,0,0,1.0,1,1.0,1,1.0,1,0.3987446109985351,28
2226,12,29531,29531,0,0,0,0,1.0,1,1.0,1,1.0,1,0.357160675571784,30
2227,19,29550,29550,0,0,0,0,1.0,1,1.0,1,1.0,1,0.4454176774458169,28
2228,14,29564,29564,0,0,0,0,1.0,1,1.0,1,1.0,1,0.36925284387971613,29
2229,14,29578,29578,0,0,0,0,1.0,1,1.0,1,1.0,1,0.45136522567623816,28
2230,12,29590,29590,0,0,0,0,1.0,1,1.0,1,1.0,1,0.34952495261095073,28
2231,7,29597,29597,0,0,0,0,1.0,1,1.0,1,1.0,1,0.4673303948137198,27
2232,8,29605,29605,0,0,0,0,1.0,1,1.0,1,1.0,1,0.4737891372759718,27
2233,11,29616,29616,0,0,0,0,1.0,1,1.0,1,1.0,1,0.38155460273706227,28
2234,6,29622,29622,0,0,0,0,1.0,1,1.0,1,1.0,1,0.44652054275036507,26
2235,8,29630,29630,0,0,0,0,1.0,1,1.0,1,1.0,1,0.3954081095328809,26
2236,13,29643,29643,0,0,0,0,1.0,1,1.0,1,1.0,1,0.23997566306704643,26
2237,10,29653,29653,0,0,0,0,1.0,1,1.0,1,1.0,1,0.4025186363583663,26
2238,11,29664,29664,0,0,0,0,1.0,1,1.0,1,1.0,1,0.4225606133729478,27
2239,8,29672,29672,0,0,0,0,1.0,1,1.0,1,1.0,1,0.37985064853602757,28
2240,18,29690,29690,0,0,0,0,1.0,1,1.0,1,1.0,1,0.40299410048722023,30
2241,10,29700,29700,0,0,0,0,1.0,1,1.0,1,1.0,1,0.3505338565344296,29
2242,14,29714,29714,0,0,0,0,1.0,1,1.0,1,1.0,1,0.3829532823631645,29
2243,4,29718,29718,0,0,0,0,1.0,1,1.0,1,1.0,1,0.43238659069259106,29
2244,7,29725,29725,0,0,0,0,1.0,1,1.0,1,1.0,1,0.4477090493405803,29
2245,5,29730,29730,0,0,0,0,1.0,1,1.0,1,1.0,1,0.4413765560496667,30
2246,11,29741,29741,0,0,0,0,1.0,1,1.0,1,1.0,1,0.4155093723542559,33
2247,12,29753,29753,0,0,0,0,1.0,1,1.0,1,1.0,1,0.3694063547736687,34
2248,11,29764,29764,0,0,0,0,1.0,1,1.0,1,1.0,1,0.36435723699344497,34
2249,4,29768,29768,0,0,0,0,1.0,1,1.0,1,1.0,1,0.47103773992242776,35
2250,8,29776,29776,0,0,0,0,1.0,1,1.0,1,1.0,1,0.5100250217250452,35
2251,8,29784,29784,0,0,0,0,1.0,1,1.0,1,1.0,1,0.4904527425964741,36
2252,12,29796,29796,0,0,0,0,1.0,1,1.0,1,1.0,1,0.3908429741338562,37
2253,21,29817,29817,0,0,0,0,1.0,1,1.0,1,1.0,1,0.35231470454484964,35
2254,7,29824,29824,0,0,0,0,1.0,1,1.0,1,1.0,1,0.3914212545421684,33
2255,13,29837,29837,0,0,0,0,1.0,1,1.0,1,1.0,1,0.4140660027529625,35
2256,13,29850,29850,0,0,0,0,1.0,1,1.0,1,1.0,1,0.48529926443073773,34
2257,20,29870,29870,0,0,0,0,1.0,1,1.0,1,1.0,1,0.3625006384115373,36
2258,14,29884,29884,0,0,0,0,1.0,1,1.0,1,1.0,1,0.4607233463000335,35
2259,8,29892,29892,0,0,0,0,1.0,1,1.0,1,1.0,1,0.3735505789733101,35
2260,12,29904,29904,0,0,0,0,1.0,1,1.0,1,1.0,1,0.4719940601187387,33
2261,13,29917,29917,0,0,0,0,1.0,1,1.0,1,1.0,1,0.4655281855546495,33
2262,7,29924,29924,0,0,0,0,1.0,1,1.0,1,1.0,1,0.4472081371807486,32
2263,9,29933,29933,0,0,0,0,1.0,1,1.0,1,1.0,1,0.42320059376544417,31
2264,10,29943,29943,0,0,0,0,1.0,1,1.0,1,1.0,1,0.41728041389906073,30
2265,11,29954,29954,0,0,0,0,1.0,1,1.0,1,1.0,1,0.4141261368081427,29
2266,9,29963,29963,0,0,0,0,1.0,1,1.0,1,1.0,1,0.28171783075596213,30
2267,12,29975,29975,0,0,0,0,1.0,1,1.0,1,1.0,1,0.28969646976284497,29
2268,20,29995,29995,0,0,0,0,1.0,1,1.0,1,1.0,1,0.305704026758157,30
2269,8,30003,30003,0,0,0,0,1.0,1,1.0,1,1.0,1,0.28614767322872153,31
2270,13,30016,30016,0,0,0,0,1.0,1,1.0,1,1.0,1,0.2670441619753713,31
2271,13,30029,30029,0,0,0,0,1.0,1,1.0,1,1.0,1,0.2605556558581828,31
2272,14,30043,30043,0,0,0,0,1.0,1,1.0,1,1.0,1,0.272636209062792,31
2273,7,30050,30050,0,0,0,0,1.0,1,1.0,1,1.0,1,0.301098568736628,30
2274,13,30063,30063,0,0,0,0,1.0,1,1.0,1,1.0,1,0.35482976726642923,31
2275,15,30078,30078,0,0,0,0,1.0,1,1.0,1,1.0,1,0.24726857877339975,32
2276,8,30086,30086,0,0,0,0,1.0,1,1.0,1,1.0,1,0.3583761081638121,31
2277,8,30094,30094,0,0,0,0,1.0,1,1.0,1,1.0,1,0.3738788425161652,31
2278,9,30103,30103,0,0,0,0,1.0,1,1.0,1,1.0,1,0.41930862938184255,32
2279,7,30110,30110,0,0,0,0,1.0,1,1.0,1,1.0,1,0.4268665415626907,32
2280,7,30117,30117,0,0,0,0,1.0,1,1.0,1,1.0,1,0.42027714398209376,33
2281,7,30124,30124,0,0,0,0,1.0,1,1.0,1,1.0,1,0.4164828696672985,34
2282,12,30136,30136,0,0,0,0,1.0,1,1.0,1,1.0,1,0.3661186119133287,34
2283,12,30148,30148,0,0,0,0,1.0,1,1.0,1,1.0,1,0.3025080226620011,34
2284,8,30156,30156,0,0,0,0,1.0,1,1.0,1,1.0,1,0.2997837687851748,34
2285,19,30175,30175,0,0,0,0,1.0,1,1.0,1,1.0,1,0.30697995744031903,35
2286,9,30184,30184,0,0,0,0,1.0,1,1.0,1,1.0,1,0.3285047370875454,34
2287,12,30196,30196,0,0,0,0,1.0,1,1.0,1,1.0,1,0.3317229608753735,35
2288,8,30204,30204,0,0,0,0,1.0,1,1.0,1,1.0,1,0.4227496276036894,35
2289,9,30213,30213,0,0,0,0,1.0,1,1.0,1,1.0,1,0.3007307275106633,37
2290,10,30223,30223,0,0,0,0,1.0,1,1.0,1,1.0,1,0.30450065929626824,37
2291,12,30235,30235,0,0,0,0,1.0,1,1.0,1,1.0,1,0.27169784678489245,35
2292,8,30243,30243,0,0,0,0,1.0,1,1.0,1,1.0,1,0.2850201239039545,35
2293,1,30244,30244,0,0,0,0,1.0,1,1.0,1,1.0,1,0.3584829405654682,34
2294,7,30251,30251,0,0,0,0,1.0,1,1.0,1,1.0,1,0.34565615332673655,33
2295,9,30260,30260,0,0,0,0,1.0,1,1.0,1,1.0,1,0.39769811950592254,34
2296,4,30264,30264,0,0,0,0,1.0,1,1.0,1,1.0,1,0.40996907342786576,33
2297,11,30275,30275,0,0,0,0,1.0,1,1.0,1,1.0,1,0.45532752137028115,32
2298,7,30282,30282,0,0,0,0,1.0,1,1.0,1,1.0,1,0.39884654977347583,32
2299,6,30288,30288,0,0,0,0,1.0,1,1.0,1,1.0,1,0.4086380311229799,33
2300,10,30298,30298,0,0,0,0,1.0,1,1.0,1,1.0,1,0.3472497332385701,33
2301,5,30303,30303,0,0,0,0,1.0,1,1.0,1,1.0,1,0.4176486570852312,33
2302,9,30312,30312,0,0,0,0,1.0,1,1.0,1,1.0,1,0.48905952136368236,34
2303,5,30317,30317,0,0,0,0,1.0,1,1.0,1,1.0,1,0.4770482900754442,34
2304,6,30323,30323,0,0,0,0,1.0,1,1.0,1,1.0,1,0.5023546346312887,33
2305,6,30329,30329,0,0,0,0,1.0,1,1.0,1,1.0,1,0.4972813584045864,33
2306,9,30338,30338,0,0,0,0,1.0,1,1.0,1,1.0,1,0.5171722231427917,33
2307,10,30348,30348,0,0,0,0,1.0,1,1.0,1,1.0,1,0.37888516428434993,35
2308,9,30357,30357,0,0,0,0,1.0,1,1.0,1,1.0,1,0.41597181446914033,34
2309,8,30365,30365,0,0,0,0,1.0,1,1.0,1,1.0,1,0.40905088679630813,34
2310,8,30373,30373,0,0,0,0,1.0,1,1.0,1,1.0,1,0.49906036239506035,34
2311,8,30381,30381,0,0,0,0,1.0,1,1.0,1,1.0,1,0.35537219936577497,35
2312,10,30391,30391,0,0,0,0,1.0,1,1.0,1,1.0,1,0.3754693964588111,34
2313,17,30408,30408,0,0,0,0,1.0,1,1.0,1,1.0,1,0.4906954458070187,35
2314,5,30413,30413,0,0,0,0,1.0,1,1.0,1,1.0,1,0.5092577671699563,35
2315,23,30436,30436,0,0,0,0,1.0,1,1.0,1,1.0,1,0.5488599903896233,34
2316,10,30446,30446,0,0,0,0,1.0,1,1.0,1,1.0,1,0.48241405085583844,35
2317,13,30459,30459,0,0,0,0,1.0,1,1.0,1,1.0,1,0.4368940828080189,32
2318,12,30471,30471,0,0,0,0,1.0,1,1.0,1,1.0,1,0.4470536151783456,32
2319,5,30476,30476,0,0,0,0,1.0,1,1.0,1,1.0,1,0.39276333465987573,32
2320,10,30486,30486,0,0,0,0,1.0,1,1.0,1,1.0,1,0.4189509387841713,32
2321,12,30498,30498,0,0,0,0,1.0,1,1.0,1,1.0,1,0.37980130950509716,33
2322,6,30504,30504,0,0,0,0,1.0,1,1.0,1,1.0,1,0.49001524837447513,33
2323,4,30508,30508,0,0,0,0,1.0,1,1.0,1,1.0,1,0.39849077249093773,33
2324,9,30517,30517,0,0,0,0,1.0,1,1.0,1,1.0,1,0.3960637116108549,34
2325,9,30526,30526,0,0,0,0,1.0,1,1.0,1,1.0,1,0.40204368061755924,35
2326,10,30536,30536,0,0,0,0,1.0,1,1.0,1,1.0,1,0.379583851236979,35
2327,10,30546,30546,0,0,0,0,1.0,1,1.0,1,1.0,1,0.4015250835209881,36
2328,16,30562,30562,0,0,0,0,1.0,1,1.0,1,1.0,1,0.3363407641175156,37
2329,10,30572,30572,0,0,0,0,1.0,1,1.0,1,1.0,1,0.32009847234907407,37
2330,9,30581,30581,0,0,0,0,1.0,1,1.0,1,1.0,1,0.3451690474141049,38
2331,17,30598,30598,0,0,0,0,1.0,1,1.0,1,1.0,1,0.3610184318194751,40
2332,11,30609,30609,0,0,0,0,1.0,1,1.0,1,1.0,1,0.2969094108262818,40
2333,6,30615,30615,0,0,0,0,1.0,1,1.0,1,1.0,1,0.40883545511008834,41
2334,6,30621,30621,0,0,0,0,1.0,1,1.0,1,1.0,1,0.39886155608317364,41
2335,7,30628,30628,0,0,0,0,1.0,1,1.0,1,1.0,1,0.3728201155126131,41
2336,12,30640,30640,0,0,0,0,1.0,1,1.0,1,1.0,1,0.46478633137033526,41
2337,16,30656,30656,0,0,0,0,1.0,1,1.0,1,1.0,1,0.3748543560688069,42
2338,16,30672,30672,0,0,0,0,1.0,1,1.0,1,1.0,1,0.3925558225933237,43
2339,11,30683,30683,0,0,0,0,1.0,1,1.0,1,1.0,1,0.3263171524717615,43
2340,22,30705,30705,0,0,0,0,1.0,1,1.0,1,1.0,1,0.29957811890198,45
2341,17,30722,30722,0,0,0,0,1.0,1,1.0,1,1.0,1,0.30538915849228193,45
2342,21,30743,30743,0,0,0,0,1.0,1,1.0,1,1.0,1,0.3265553996698336,46
2343,25,30768,30768,0,0,0,0,1.0,1,1.0,1,1.0,1,0.30800088644106316,45
2344,20,30788,30788,0,0,0,0,1.0,1,1.0,1,1.0,1,0.33411505519692736,44
2345,16,30804,30804,0,0,0,0,1.0,1,1.0,1,1.0,1,0.383989640477367,44
2346,19,30823,30823,0,0,0,0,1.0,1,1.0,1,1.0,1,0.41220351277127937,44
2347,11,30834,30834,0,0,0,0,1.0,1,1.0,1,1.0,1,0.3521228399474852,44
2348,19,30853,30853,0,0,0,0,1.0,1,1.0,1,1.0,1,0.24806317944011672,45
2349,13,30866,30866,0,0,0,0,1.0,1,1.0,1,1.0,1,0.395537235455471,46
2350,10,30876,30876,0,0,0,0,1.0,1,1.0,1,1.0,1,0.405606082088665,47
2351,14,30890,30890,0,0,0,0,1.0,1,1.0,1,1.0,1,0.37224725212232307,47
2352,14,30904,30904,0,0,0,0,1.0,1,1.0,1,1.0,1,0.34853334028168914,47
2353,8,30912,30912,0,0,0,0,1.0,1,1.0,1,1.0,1,0.370833267728591,46
2354,16,30928,30928,0,0,0,0,1.0,1,1.0,1,1.0,1,0.4436497030122967,47
2355,11,30939,30939,0,0,0,0,1.0,1,1.0,1,1.0,1,0.374465678865637,47
2356,8,30947,30947,0,0,0,0,1.0,1,1.0,1,1.0,1,0.34225025704966255,47
2357,13,30960,30960,0,0,0,0,1.0,1,1.0,1,1.0,1,0.408207115063034,47
2358,14,30974,30974,0,0,0,0,1.0,1,1.0,1,1.0,1,0.3308880230602359,48
2359,16,30990,30990,0,0,0,0,1.0,1,1.0,1,1.0,1,0.4070636517939325,49
2360,19,31009,31009,0,0,0,0,1.0,1,1.0,1,1.0,1,0.3736346399440541,49
2361,9,31018,31018,0,0,0,0,1.0,1,1.0,1,1.0,1,0.38206474501742993,50
2362,25,31043,31043,0,0,0,0,1.0,1,1.0,1,1.0,1,0.38985326440193,51
2363,19,31062,31062,0,0,0,0,1.0,1,1.0,1,1.0,1,0.3284008137742465,51
2364,16,31078,31078,0,0,0,0,1.0,1,1.0,1,1.0,1,0.3801180835435099,52
2365,24,31102,31102,0,0,0,0,1.0,1,1.0,1,1.0,1,0.34376425633419855,53
2366,28,31130,31130,0,0,0,0,1.0,1,1.0,1,1.0,1,0.3967814902759269,54
2367,18,31148,31148,0,0,0,0,1.0,1,1.0,1,1.0,1,0.47360387281874305,52
2368,16,31164,31164,0,0,0,0,1.0,1,1.0,1,1.0,1,0.42748471267393695,51
2369,14,31178,31178,0,0,0,0,1.0,1,1.0,1,1.0,1,0.44168202212619323,51
2370,19,31197,31197,0,0,0,0,1.0,1,1.0,1,1.0,1,0.3884927433304628,52
2371,8,31205,31205,0,0,0,0,1.0,1,1.0,1,1.0,1,0.33378290257110343,52
2372,11,31216,31216,0,0,0,0,1.0,1,1.0,1,1.0,1,0.3298685976994486,49
2373,13,31229,31229,0,0,0,0,1.0,1,1.0,1,1.0,1,0.28374787058332124,47
2374,11,31240,31240,0,0,0,0,1.0,1,1.0,1,1.0,1,0.3638424331657775,45
2375,9,31249,31249,0,0,0,0,1.0,1,1.0,1,1.0,1,0.3509125667930039,45
2376,12,31261,31261,0,0,0,0,1.0,1,1.0,1,1.0,1,0.3756804082043491,43
2377,10,31271,31271,0,0,0,0,1.0,1,1.0,1,1.0,1,0.3787944998812665,44
2378,19,31290,31290,0,0,0,0,1.0,1,1.0,1,1.0,1,0.32675437724071826,43
2379,8,31298,31298,0,0,0,0,1.0,1,1.0,1,1.0,1,0.2963149941050845,43
2380,7,31305,31305,0,0,0,0,1.0,1,1.0,1,1.0,1,0.4030337303092798,43
2381,8,31313,31313,0,0,0,0,1.0,1,1.0,1,1.0,1,0.3827483814381795,44
2382,5,31318,31318,0,0,0,0,1.0,1,1.0,1,1.0,1,0.4217204406471805,44
2383,11,31329,31329,0,0,0,0,1.0,1,1.0,1,1.0,1,0.32419729874460934,45
2384,9,31338,31338,0,0,0,0,1.0,1,1.0,1,1.0,1,0.32300578189437634,45
2385,11,31349,31349,0,0,0,0,1.0,1,1.0,1,1.0,1,0.3701176757310009,45
2386,8,31357,31357,0,0,0,0,1.0,1,1.0,1,1.0,1,0.24526037801202394,46
2387,15,31372,31372,0,0,0,0,1.0,1,1.0,1,1.0,1,0.38149210100568876,44
2388,7,31379,31379,0,0,0,0,1.0,1,1.0,1,1.0,1,0.34036851703842924,44
2389,19,31398,31398,0,0,0,0,1.0,1,1.0,1,1.0,1,0.29173446247488233,43
2390,21,31419,31419,0,0,0,0,1.0,1,1.0,1,1.0,1,0.4089309363192018,44
2391,13,31432,31432,0,0,0,0,1.0,1,1.0,1,1.0,1,0.41587694534454506,43
2392,19,31451,31451,0,0,0,0,1.0,1,1.0,1,1.0,1,0.40622342938737854,44
2393,21,31472,31472,0,0,0,0,1.0,1,1.0,1,1.0,1,0.3324175424832703,45
2394,21,31493,31493,0,0,0,0,1.0,1,1.0,1,1.0,1,0.33702576410984303,44
2395,15,31508,31508,0,0,0,0,1.0,1,1.0,1,1.0,1,0.35195101932129647,44
2396,18,31526,31526,0,0,0,0,1.0,1,1.0,1,1.0,1,0.3679021828499649,45
2397,27,31553,31553,0,0,0,0,1.0,1,1.0,1,1.0,1,0.3209469370793277,44
2398,15,31568,31568,0,0,0,0,1.0,1,1.0,1,1.0,1,0.3524432726421363,44
2399,15,31583,31583,0,0,0,0,1.0,1,1.0,1,1.0,1,0.3959424145089999,45
2400,6,31589,31589,0,0,0,0,1.0,1,1.0,1,1.0,1,0.34291098100913997,45
2401,15,31604,31604,0,0,0,0,1.0,1,1.0,1,1.0,1,0.24593314921848097,46
2402,10,31614,31614,0,0,0,0,1.0,1,1.0,1,1.0,1,0.3072479117428662,47
2403,12,31626,31626,0,0,0,0,1.0,1,1.0,1,1.0,1,0.2324206070927797,48
2404,10,31636,31636,0,0,0,0,1.0,1,1.0,1,1.0,1,0.253513772204005,47
2405,10,31646,31646,0,0,0,0,1.0,1,1.0,1,1.0,1,0.2859192533317729,45
2406,11,31657,31657,0,0,0,0,1.0,1,1.0,1,1.0,1,0.24501262157456408,45
2407,8,31665,31665,0,0,0,0,1.0,1,1.0,1,1.0,1,0.26726463237414516,42
2408,12,31677,31677,0,0,0,0,1.0,1,1.0,1,1.0,1,0.3491869947184935,41
2409,16,31693,31693,0,0,0,0,1.0,1,1.0,1,1.0,1,0.3755426950469014,41
2410,14,31707,31707,0,0,0,0,1.0,1,1.0,1,1.0,1,0.2238158494118871,40
2411,9,31716,31716,0,0,0,0,1.0,1,1.0,1,1.0,1,0.2835840834658825,40
2412,5,31721,31721,0,0,0,0,1.0,1,1.0,1,1.0,1,0.31754248734795054,38
2413,5,31726,31726,0,0,0,0,1.0,1,1.0,1,1.0,1,0.2774260823392381,38
2414,9,31735,31735,0,0,0,0,1.0,1,1.0,1,1.0,1,0.3098302135684722,36
2415,7,31742,31742,0,0,0,0,1.0,1,1.0,1,1.0,1,0.38741216965372954,36
2416,12,31754,31754,0,0,0,0,1.0,1,1.0,1,1.0,1,0.31343509175005957,35
2417,10,31764,31764,0,0,0,0,1.0,1,1.0,1,1.0,1,0.3758691606406544,33
2418,12,31776,31776,0,0,0,0,1.0,1,1.0,1,1.0,1,0.44650259627679206,33
2419,7,31783,31783,0,0,0,0,1.0,1,1.0,1,1.0,1,0.3848751491516649,33
2420,14,31797,31797,0,0,0,0,1.0,1,1.0,1,1.0,1,0.45425588174223014,34
2421,18,31815,31815,0,0,0,0,1.0,1,1.0,1,1.0,1,0.5045439050353803,34
2422,11,31826,31826,0,0,0,0,1.0,1,1.0,1,1.0,1,0.45604935074614467,35
2423,12,31838,31838,0,0,0,0,1.0,1,1.0,1,1.0,1,0.5089644553427497,36
2424,14,31852,31852,0,0,0,0,1.0,1,1.0,1,1.0,1,0.4563079589047343,35
2425,9,31861,31861,0,0,0,0,1.0,1,1.0,1,1.0,1,0.4482307709137035,33
2426,15,31876,31876,0,0,0,0,1.0,1,1.0,1,1.0,1,0.3891910036400187,34
2427,19,31895,31895,0,0,0,0,1.0,1,1.0,1,1.0,1,0.40979690345628866,34
2428,11,31906,31906,0,0,0,0,1.0,1,1.0,1,1.0,1,0.416580206898449,34
2429,15,31921,31921,0,0,0,0,1.0,1,1.0,1,1.0,1,0.4398880938020356,34
2430,10,31931,31931,0,0,0,0,1.0,1,1.0,1,1.0,1,0.4291181614131459,33
2431,6,31937,31937,0,0,0,0,1.0,1,1.0,1,1.0,1,0.4693913498351129,33
2432,9,31946,31946,0,0,0,0,1.0,1,1.0,1,1.0,1,0.501392918494054,33
2433,8,31954,31954,0,0,0,0,1.0,1,1.0,1,1.0,1,0.43077050521258264,34
2434,11,31965,31965,0,0,0,0,1.0,1,1.0,1,1.0,1,0.28827879889465396,34
2435,7,31972,31972,0,0,0,0,1.0,1,1.0,1,1.0,1,0.3780195602511491,34
2436,10,31982,31982,0,0,0,0,1.0,1,1.0,1,1.0,1,0.35168985632274985,33
2437,7,31989,31989,0,0,0,0,1.0,1,1.0,1,1.0,1,0.3846454989116978,33
2438,6,31995,31995,0,0,0,0,1.0,1,1.0,1,1.0,1,0.39458077899834676,34
2439,7,32002,32002,0,0,0,0,1.0,1,1.0,1,1.0,1,0.45920884962619124,35
2440,7,32009,32009,0,0,0,0,1.0,1,1.0,1,1.0,1,0.49888260932562223,35
2441,7,32016,32016,0,0,0,0,1.0,1,1.0,1,1.0,1,0.415643718672061,35
2442,8,32024,32024,0,0,0,0,1.0,1,1.0,1,1.0,1,0.48119104034717886,35
2443,7,32031,32031,0,0,0,0,1.0,1,1.0,1,1.0,1,0.5078305477370727,35
2444,10,32041,32041,0,0,0,0,1.0,1,1.0,1,1.0,1,0.3979776907918195,34
2445,9,32050,32050,0,0,0,0,1.0,1,1.0,1,1.0,1,0.4042927722587883,33
2446,10,32060,32060,0,0,0,0,1.0,1,1.0,1,1.0,1,0.3905503544735431,30
2447,6,32066,32066,0,0,0,0,1.0,1,1.0,1,1.0,1,0.41004358488675174,29
2448,12,32078,32078,0,0,0,0,1.0,1,1.0,1,1.0,1,0.36101657547012145,27
2449,10,32088,32088,0,0,0,0,1.0,1,1.0,1,1.0,1,0.3439134136187424,26
2450,13,32101,32101,0,0,0,0,1.0,1,1.0,1,1.0,1,0.3280127532055229,28
2451,11,32112,32112,0,0,0,0,1.0,1,1.0,1,1.0,1,0.373918724440299,28
2452,16,32128,32128,0,0,0,0,1.0,1,1.0,1,1.0,1,0.3477076056242932,29
2453,10,32138,32138,0,0,0,0,1.0,1,1.0,1,1.0,1,0.30602915038980977,30
2454,15,32153,32153,0,0,0,0,1.0,1,1.0,1,1.0,1,0.2567564522256462,32
2455,18,32171,32171,0,0,0,0,1.0,1,1.0,1,1.0,1,0.37840532057394255,33
2456,16,32187,32187,0,0,0,0,1.0,1,1.0,1,1.0,1,0.42116573548416786,34
2457,12,32199,32199,0,0,0,0,1.0,1,1.0,1,1.0,1,0.36980284191798124,34
2458,8,32207,32207,0,0,0,0,1.0,1,1.0,1,1.0,1,0.4212528597903295,36
2459,12,32219,32219,0,0,0,0,1.0,1,1.0,1,1.0,1,0.32560761551718637,36
2460,8,32227,32227,0,0,0,0,1.0,1,1.0,1,1.0,1,0.4002971321396395,37
2461,7,32234,32234,0,0,0,0,1.0,1,1.0,1,1.0,1,0.3969064387577486,37
2462,8,32242,32242,0,0,0,0,1.0,1,1.0,1,1.0,1,0.4446755025343406,38
2463,9,32251,32251,0,0,0,0,1.0,1,1.0,1,1.0,1,0.46029180668936903,38
2464,18,32269,32269,0,0,0,0,1.0,1,1.0,1,1.0,1,0.4192537222677746,37
2465,18,32287,32287,0,0,0,0,1.0,1,1.0,1,1.0,1,0.3730925184325402,36
2466,6,32293,32293,0,0,0,0,1.0,1,1.0,1,1.0,1,0.3276063711091715,36
2467,12,32305,32305,0,0,0,0,1.0,1,1.0,1,1.0,1,0.3267297326472082,34
2468,7,32312,32312,0,0,0,0,1.0,1,1.0,1,1.0,1,0.3949941787704831,33
2469,4,32316,32316,0,0,0,0,1.0,1,1.0,1,1.0,1,0.42680704552517584,32
2470,13,32329,32329,0,0,0,0,1.0,1,1.0,1,1.0,1,0.3662547554366527,33
2471,14,32343,32343,0,0,0,0,1.0,1,1.0,1,1.0,1,0.45325917428797796,31
2472,14,32357,32357,0,0,0,0,1.0,1,1.0,1,1.0,1,0.44869133904693054,32
2473,10,32367,32367,0,0,0,0,1.0,1,1.0,1,1.0,1,0.4851237299921979,31
2474,18,32385,32385,0,0,0,0,1.0,1,1.0,1,1.0,1,0.5224595824526576,33
2475,8,32393,32393,0,0,0,0,1.0,1,1.0,1,1.0,1,0.54145318418748,33
2476,11,32404,32404,0,0,0,0,1.0,1,1.0,1,1.0,1,0.44530392264465934,33
2477,14,32418,32418,0,0,0,0,1.0,1,1.0,1,1.0,1,0.33689540744697427,33
2478,16,32434,32434,0,0,0,0,1.0,1,1.0,1,1.0,1,0.332742427271916,33
2479,9,32443,32443,0,0,0,0,1.0,1,1.0,1,1.0,1,0.37767274103472864,33
2480,11,32454,32454,0,0,0,0,1.0,1,1.0,1,1.0,1,0.3258617880769591,34
2481,13,32467,32467,0,0,0,0,1.0,1,1.0,1,1.0,1,0.29209636172254955,33
2482,15,32482,32482,0,0,0,0,1.0,1,1.0,1,1.0,1,0.2714518996595248,34
2483,10,32492,32492,0,0,0,0,1.0,1,1.0,1,1.0,1,0.269158355158673,33
2484,20,32512,32512,0,0,0,0,1.0,1,1.0,1,1.0,1,0.2624201464266031,32
2485,12,32524,32524,0,0,0,0,1.0,1,1.0,1,1.0,1,0.3012002934539683,31
2486,9,32533,32533,0,0,0,0,1.0,1,1.0,1,1.0,1,0.2751102699492479,29
2487,5,32538,32538,0,0,0,0,1.0,1,1.0,1,1.0,1,0.33988751382728255,29
2488,14,32552,32552,0,0,0,0,1.0,1,1.0,1,1.0,1,0.38347179112812435,30
2489,9,32561,32561,0,0,0,0,1.0,1,1.0,1,1.0,1,0.25810630374098625,29
2490,11,32572,32572,0,0,0,0,1.0,1,1.0,1,1.0,1,0.37500766640107336,30
2491,16,32588,32588,0,0,0,0,1.0,1,1.0,1,1.0,1,0.3605783203092537,30
2492,6,32594,32594,0,0,0,0,1.0,1,1.0,1,1.0,1,0.43894433770571006,29
2493,11,32605,32605,0,0,0,0,1.0,1,1.0,1,1.0,1,0.49721015632312715,29
2494,4,32609,32609,0,0,0,0,1.0,1,1.0,1,1.0,1,0.4310951126507537,28
2495,10,32619,32619,0,0,0,0,1.0,1,1.0,1,1.0,1,0.531141401885221,29
2496,6,32625,32625,0,0,0,0,1.0,1,1.0,1,1.0,1,0.5339259258443025,28
2497,3,32628,32628,0,0,0,0,1.0,1,1.0,1,1.0,1,0.42753386446697655,28
2498,14,32642,32642,0,0,0,0,1.0,1,1.0,1,1.0,1,0.2921893611279669,29
2499,15,32657,32657,0,0,0,0,1.0,1,1.0,1,1.0,1,0.36260594781408684,30
2500,10,32667,32667,0,0,0,0,1.0,1,1.0,1,1.0,1,0.3794585983010221,29
2501,17,32684,32684,0,0,0,0,1.0,1,1.0,1,1.0,1,0.3773194804100044,33
2502,17,32701,32701,0,0,0,0,1.0,1,1.0,1,1.0,1,0.2478634404533287,33
2503,15,32716,32716,0,0,0,0,1.0,1,1.0,1,1.0,1,0.31522266395342363,31
2504,15,32731,32731,0,0,0,0,1.0,1,1.0,1,1.0,1,0.22105663606959222,31
2505,6,32737,32737,0,0,0,0,1.0,1,1.0,1,1.0,1,0.27372970023659476,32
2506,7,32744,32744,0,0,0,0,1.0,1,1.0,1,1.0,1,0.21326655208329795,31
2507,5,32749,32749,0,0,0,0,1.0,1,1.0,1,1.0,1,0.24132992963943375,29
2508,9,32758,32758,0,0,0,0,1.0,1,1.0,1,1.0,1,0.23754480198398342,31
2509,5,32763,32763,0,0,0,0,1.0,1,1.0,1,1.0,1,0.2510500520362625,30
2510,3,32766,32766,0,0,0,0,1.0,1,1.0,1,1.0,1,0.2377608477964662,31
2511,6,32772,32772,0,0,0,0,1.0,1,1.0,1,1.0,1,0.29339539922437086,32
2512,11,32783,32783,0,0,0,0,1.0,1,1.0,1,1.0,1,0.3591740780841567,32
2513,13,32796,32796,0,0,0,0,1.0,1,1.0,1,1.0,1,0.36363194587982106,34
2514,13,32809,32809,0,0,0,0,1.0,1,1.0,1,1.0,1,0.37568058766520307,35
2515,14,32823,32823,0,0,0,0,1.0,1,1.0,1,1.0,1,0.39592949940930144,35
2516,10,32833,32833,0,0,0,0,1.0,1,1.0,1,1.0,1,0.4438836705268082,34
2517,12,32845,32845,0,0,0,0,1.0,1,1.0,1,1.0,1,0.3913998722638467,34
2518,19,32864,32864,0,0,0,0,1.0,1,1.0,1,1.0,1,0.3916695348153522,33
2519,12,32876,32876,0,0,0,0,1.0,1,1.0,1,1.0,1,0.4002886658452371,32
2520,12,32888,32888,0,0,0,0,1.0,1,1.0,1,1.0,1,0.36112707946241057,31
2521,9,32897,32897,0,0,0,0,1.0,1,1.0,1,1.0,1,0.3797667164139625,31
2522,9,32906,32906,0,0,0,0,1.0,1,1.0,1,1.0,1,0.39190079585740817,30
2523,10,32916,32916,0,0,0,0,1.0,1,1.0,1,1.0,1,0.35620889181431503,30
2524,8,32924,32924,0,0,0,0,1.0,1,1.0,1,1.0,1,0.4307299632932269,29
2525,10,32934,32934,0,0,0,0,1.0,1,1.0,1,1.0,1,0.45283390054016176,29
2526,13,32947,32947,0,0,0,0,1.0,1,1.0,1,1.0,1,0.5211640625206155,27
2527,5,32952,32952,0,0,0,0,1.0,1,1.0,1,1.0,1,0.49794769585009996,28
2528,5,32957,32957,0,0,0,0,1.0,1,1.0,1,1.0,1,0.4861784726059475,28
2529,4,32961,32961,0,0,0,0,1.0,1,1.0,1,1.0,1,0.4009545928327798,28
2530,7,32968,32968,0,0,0,0,1.0,1,1.0,1,1.0,1,0.39130149104478196,29
2531,5,32973,32973,0,0,0,0,1.0,1,1.0,1,1.0,1,0.4021038299162547,30
2532,11,32984,32984,0,0,0,0,1.0,1,1.0,1,1.0,1,0.28047515324547634,31
2533,11,32995,32995,0,0,0,0,1.0,1,1.0,1,1.0,1,0.2801067520985373,31
2534,13,33008,33008,0,0,0,0,1.0,1,1.0,1,1.0,1,0.3734106871857178,31
2535,8,33016,33016,0,0,0,0,1.0,1,1.0,1,1.0,1,0.3663641249691352,31
2536,8,33024,33024,0,0,0,0,1.0,1,1.0,1,1.0,1,0.3776881788126466,32
2537,5,33029,33029,0,0,0,0,1.0,1,1.0,1,1.0,1,0.266358749585212,33
2538,11,33040,33040,0,0,0,0,1.0,1,1.0,1,1.0,1,0.3537004396300947,35
2539,6,33046,33046,0,0,0,0,1.0,1,1.0,1,1.0,1,0.3996525303563237,37
2540,11,33057,33057,0,0,0,0,1.0,1,1.0,1,1.0,1,0.4201281334955078,38
2541,8,33065,33065,0,0,0,0,1.0,1,1.0,1,1.0,1,0.31002067448089854,39
2542,10,33075,33075,0,0,0,0,1.0,1,1.0,1,1.0,1,0.4280370240510506,38
2543,6,33081,33081,0,0,0,0,1.0,1,1.0,1,1.0,1,0.36806074538447814,41
2544,16,33097,33097,0,0,0,0,1.0,1,1.0,1,1.0,1,0.4280725327826103,39
2545,14,33111,33111,0,0,0,0,1.0,1,1.0,1,1.0,1,0.3917247654716587,40
2546,7,33118,33118,0,0,0,0,1.0,1,1.0,1,1.0,1,0.3572478597591707,38
2547,14,33132,33132,0,0,0,0,1.0,1,1.0,1,1.0,1,0.49324380869866186,38
2548,4,33136,33136,0,0,0,0,1.0,1,1.0,1,1.0,1,0.4942883443285101,35
2549,6,33142,33142,0,0,0,0,1.0,1,1.0,1,1.0,1,0.5487725524071483,35
2550,4,33146,33146,0,0,0,0,1.0,1,1.0,1,1.0,1,0.44762692095729784,33
2551,2,33148,33148,0,0,0,0,1.0,1,1.0,1,1.0,1,0.560402511903657,31
2552,2,33150,33150,0,0,0,0,1.0,1,1.0,1,1.0,1,0.5907214261644944,30
2553,4,33154,33154,0,0,0,0,1.0,1,1.0,1,1.0,1,0.5753806005124366,30
2554,10,33164,33164,0,0,0,0,1.0,1,1.0,1,1.0,1,0.4165492202184329,32
2555,12,33176,33176,0,0,0,0,1.0,1,1.0,1,1.0,1,0.44761217058880226,32
2556,6,33182,33182,0,0,0,0,1.0,1,1.0,1,1.0,1,0.4430214974755686,32
2557,16,33198,33198,0,0,0,0,1.0,1,1.0,1,1.0,1,0.5604801643220074,30
2558,8,33206,33206,0,0,0,0,1.0,1,1.0,1,1.0,1,0.5990833203189947,31
2559,12,33218,33218,0,0,0,0,1.0,1,1.0,1,1.0,1,0.5483056132340174,30
2560,9,33227,33227,0,0,0,0,1.0,1,1.0,1,1.0,1,0.6271536971014445,30
2561,13,33240,33240,0,0,0,0,1.0,1,1.0,1,1.0,1,0.5691578809127119,30
2562,9,33249,33249,0,0,0,0,1.0,1,1.0,1,1.0,1,0.4919500926025591,33
2563,12,33261,33261,0,0,0,0,1.0,1,1.0,1,1.0,1,0.5706843612336505,33
2564,16,33277,33277,0,0,0,0,1.0,1,1.0,1,1.0,1,0.5586017007005385,33
2565,10,33287,33287,0,0,0,0,1.0,1,1.0,1,1.0,1,0.5136186992271504,33
2566,12,33299,33299,0,0,0,0,1.0,1,1.0,1,1.0,1,0.48873351192063563,35
2567,10,33309,33309,0,0,0,0,1.0,1,1.0,1,1.0,1,0.5438054038877761,36
2568,12,33321,33321,0,0,0,0,1.0,1,1.0,1,1.0,1,0.48003365125280867,37
2569,7,33328,33328,0,0,0,0,1.0,1,1.0,1,1.0,1,0.5658176185923011,37
2570,7,33335,33335,0,0,0,0,1.0,1,1.0,1,1.0,1,0.5081379220341465,37
2571,5,33340,33340,0,0,0,0,1.0,1,1.0,1,1.0,1,0.4902251158023915,37
2572,6,33346,33346,0,0,0,0,1.0,1,1.0,1,1.0,1,0.478087205029411,39
2573,6,33352,33352,0,0,0,0,1.0,1,1.0,1,1.0,1,0.5057690640704924,39
2574,3,33355,33355,0,0,0,0,1.0,1,1.0,1,1.0,1,0.4582807356411836,38
2575,7,33362,33362,0,0,0,0,1.0,1,1.0,1,1.0,1,0.6065204437732679,38
2576,11,33373,33373,0,0,0,0,1.0,1,1.0,1,1.0,1,0.5525065113984224,37
2577,6,33379,33379,0,0,0,0,1.0,1,1.0,1,1.0,1,0.6168970123312844,39
2578,7,33386,33386,0,0,0,0,1.0,1,1.0,1,1.0,1,0.5104949693355637,40
2579,8,33394,33394,0,0,0,0,1.0,1,1.0,1,1.0,1,0.48078187134385364,41
2580,13,33407,33407,0,0,0,0,1.0,1,1.0,1,1.0,1,0.5543967371425912,42
2581,14,33421,33421,0,0,0,0,1.0,1,1.0,1,1.0,1,0.4436807015219737,43
2582,17,33438,33438,0,0,0,0,1.0,1,1.0,1,1.0,1,0.4118126464355094,43
2583,18,33456,33456,0,0,0,0,1.0,1,1.0,1,1.0,1,0.31126310991984496,43
2584,22,33478,33478,0,0,0,0,1.0,1,1.0,1,1.0,1,0.3263115421935567,43
2585,16,33494,33494,0,0,0,0,1.0,1,1.0,1,1.0,1,0.1940355334423389,44
2586,21,33515,33515,0,0,0,0,1.0,1,1.0,1,1.0,1,0.2954775722006656,43
2587,21,33536,33536,0,0,0,0,1.0,1,1.0,1,1.0,1,0.2794514706475076,44
2588,8,33544,33544,0,0,0,0,1.0,1,1.0,1,1.0,1,0.21702931270018133,44
2589,18,33562,33562,0,0,0,0,1.0,1,1.0,1,1.0,1,0.3799080401191784,44
2590,17,33579,33579,0,0,0,0,1.0,1,1.0,1,1.0,1,0.36905719203225534,44
2591,8,33587,33587,0,0,0,0,1.0,1,1.0,1,1.0,1,0.3336336433801065,44
2592,12,33599,33599,0,0,0,0,1.0,1,1.0,1,1.0,1,0.3485233389292576,44
2593,6,33605,33605,0,0,0,0,1.0,1,1.0,1,1.0,1,0.4193961287833518,43
2594,16,33621,33621,0,0,0,0,1.0,1,1.0,1,1.0,1,0.32925816206951325,48
2595,15,33636,33636,0,0,0,0,1.0,1,1.0,1,1.0,1,0.3709710461637176,45
2596,13,33649,33649,0,0,0,0,1.0,1,1.0,1,1.0,1,0.29850493020461416,46
2597,10,33659,33659,0,0,0,0,1.0,1,1.0,1,1.0,1,0.42801577302504357,45
2598,15,33674,33674,0,0,0,0,1.0,1,1.0,1,1.0,1,0.46169516439224423,45
2599,8,33682,33682,0,0,0,0,1.0,1,1.0,1,1.0,1,0.4160299595340485,45
2600,13,33695,33695,0,0,0,0,1.0,1,1.0,1,1.0,1,0.4765664641687406,48
2601,14,33709,33709,0,0,0,0,1.0,1,1.0,1,1.0,1,0.489014342659192,47
2602,17,33726,33726,0,0,0,0,1.0,1,1.0,1,1.0,1,0.4594388296811255,48
2603,12,33738,33738,0,0,0,0,1.0,1,1.0,1,1.0,1,0.4339845975350377,48
2604,9,33747,33747,0,0,0,0,1.0,1,1.0,1,1.0,1,0.3314258573403056,47
2605,14,33761,33761,0,0,0,0,1.0,1,1.0,1,1.0,1,0.3789352963877929,47
2606,11,33772,33772,0,0,0,0,1.0,1,1.0,1,1.0,1,0.3066439979550203,46
2607,17,33789,33789,0,0,0,0,1.0,1,1.0,1,1.0,1,0.2609225136292038,45
2608,18,33807,33807,0,0,0,0,1.0,1,1.0,1,1.0,1,0.3108168379943487,45
2609,18,33825,33825,0,0,0,0,1.0,1,1.0,1,1.0,1,0.2533075773816103,44
2610,17,33842,33842,0,0,0,0,1.0,1,1.0,1,1.0,1,0.20783246060638416,45
2611,14,33856,33856,0,0,0,0,1.0,1,1.0,1,1.0,1,0.28224478701771777,46
2612,20,33876,33876,0,0,0,0,1.0,1,1.0,1,1.0,1,0.2883028961873335,47
2613,25,33901,33901,0,0,0,0,1.0,1,1.0,1,1.0,1,0.3077984177739487,48
2614,14,33915,33915,0,0,0,0,1.0,1,1.0,1,1.0,1,0.36325873146249194,48
2615,17,33932,33932,0,0,0,0,1.0,1,1.0,1,1.0,1,0.371966900177742,49
2616,10,33942,33942,0,0,0,0,1.0,1,1.0,1,1.0,1,0.30130850904956763,49
2617,13,33955,33955,0,0,0,0,1.0,1,1.0,1,1.0,1,0.3122876369687848,48
2618,17,33972,33972,0,0,0,0,1.0,1,1.0,1,1.0,1,0.2709126806332255,47
2619,10,33982,33982,0,0,0,0,1.0,1,1.0,1,1.0,1,0.285581330353744,50
2620,10,33992,33992,0,0,0,0,1.0,1,1.0,1,1.0,1,0.30785653836039323,51
2621,14,34006,34006,0,0,0,0,1.0,1,1.0,1,1.0,1,0.24167166848589955,52
2622,9,34015,34015,0,0,0,0,1.0,1,1.0,1,1.0,1,0.30299350403695985,52
2623,8,34023,34023,0,0,0,0,1.0,1,1.0,1,1.0,1,0.32905296864267264,53
2624,17,34040,34040,0,0,0,0,1.0,1,1.0,1,1.0,1,0.3589765694510924,51
2625,8,34048,34048,0,0,0,0,1.0,1,1.0,1,1.0,1,0.3405561841399458,50
2626,13,34061,34061,0,0,0,0,1.0,1,1.0,1,1.0,1,0.27979501481094254,49
2627,10,34071,34071,0,0,0,0,1.0,1,1.0,1,1.0,1,0.3028718309407492,48
2628,9,34080,34080,0,0,0,0,1.0,1,1.0,1,1.0,1,0.3916538492060403,48
2629,12,34092,34092,0,0,0,0,1.0,1,1.0,1,1.0,1,0.35667584953361325,47
2630,11,34103,34103,0,0,0,0,1.0,1,1.0,1,1.0,1,0.45750875977532196,47
2631,12,34115,34115,0,0,0,0,1.0,1,1.0,1,1.0,1,0.4035152373342128,47
2632,11,34126,34126,0,0,0,0,1.0,1,1.0,1,1.0,1,0.34747249439991035,47
2633,16,34142,34142,0,0,0,0,1.0,1,1.0,1,1.0,1,0.3492037591893208,44
2634,19,34161,34161,0,0,0,0,1.0,1,1.0,1,1.0,1,0.30327730921576546,44
2635,20,34181,34181,0,0,0,0,1.0,1,1.0,1,1.0,1,0.40100611592000585,45
2636,20,34201,34201,0,0,0,0,1.0,1,1.0,1,1.0,1,0.28146439193253386,40
2637,16,34217,34217,0,0,0,0,1.0,1,1.0,1,1.0,1,0.3768270954786413,41
2638,13,34230,34230,0,0,0,0,1.0,1,1.0,1,1.0,1,0.31629396772655494,38
2639,13,34243,34243,0,0,0,0,1.0,1,1.0,1,1.0,1,0.3468700037198605,39
2640,17,34260,34260,0,0,0,0,1.0,1,1.0,1,1.0,1,0.36081657858908023,38
2641,14,34274,34274,0,0,0,0,1.0,1,1.0,1,1.0,1,0.33338247813349264,37
2642,11,34285,34285,0,0,0,0,1.0,1,1.0,1,1.0,1,0.38295300181900854,38
2643,8,34293,34293,0,0,0,0,1.0,1,1.0,1,1.0,1,0.34893811233818856,37
2644,6,34299,34299,0,0,0,0,1.0,1,1.0,1,1.0,1,0.3293386158058169,36
2645,14,34313,34313,0,0,0,0,1.0,1,1.0,1,1.0,1,0.36488162092797477,35
2646,9,34322,34322,0,0,0,0,1.0,1,1.0,1,1.0,1,0.36307910153891365,35
2647,7,34329,34329,0,0,0,0,1.0,1,1.0,1,1.0,1,0.364927587320847,35
2648,11,34340,34340,0,0,0,0,1.0,1,1.0,1,1.0,1,0.40551353856205796,36
2649,11,34351,34351,0,0,0,0,1.0,1,1.0,1,1.0,1,0.4764431514825494,37
2650,14,34365,34365,0,0,0,0,1.0,1,1.0,1,1.0,1,0.432807951675912,39
2651,8,34373,34373,0,0,0,0,1.0,1,1.0,1,1.0,1,0.4257432192605089,39
2652,7,34380,34380,0,0,0,0,1.0,1,1.0,1,1.0,1,0.40664935422800996,39
2653,7,34387,34387,0,0,0,0,1.0,1,1.0,1,1.0,1,0.29739698989060254,39
2654,10,34397,34397,0,0,0,0,1.0,1,1.0,1,1.0,1,0.3055082642067108,40
2655,6,34403,34403,0,0,0,0,1.0,1,1.0,1,1.0,1,0.2866476223040824,40
2656,10,34413,34413,0,0,0,0,1.0,1,1.0,1,1.0,1,0.24376718285984453,39
2657,11,34424,34424,0,0,0,0,1.0,1,1.0,1,1.0,1,0.25566902390821333,40
2658,13,34437,34437,0,0,0,0,1.0,1,1.0,1,1.0,1,0.28142135936264384,41
2659,15,34452,34452,0,0,0,0,1.0,1,1.0,1,1.0,1,0.2941408270852892,41
2660,13,34465,34465,0,0,0,0,1.0,1,1.0,1,1.0,1,0.2670658888776713,40
2661,8,34473,34473,0,0,0,0,1.0,1,1.0,1,1.0,1,0.2440238754496455,40
2662,10,34483,34483,0,0,0,0,1.0,1,1.0,1,1.0,1,0.2910306789879347,42
2663,17,34500,34500,0,0,0,0,1.0,1,1.0,1,1.0,1,0.32493212267873955,41
2664,5,34505,34505,0,0,0,0,1.0,1,1.0,1,1.0,1,0.3225735625058505,42
2665,19,34524,34524,0,0,0,0,1.0,1,1.0,1,1.0,1,0.35087604005183953,43
2666,17,34541,34541,0,0,0,0,1.0,1,1.0,1,1.0,1,0.3194965033559043,44
2667,8,34549,34549,0,0,0,0,1.0,1,1.0,1,1.0,1,0.3680282871830709,42
2668,11,34560,34560,0,0,0,0,1.0,1,1.0,1,1.0,1,0.3468861367038139,41
2669,12,34572,34572,0,0,0,0,1.0,1,1.0,1,1.0,1,0.41717822442085795,42
2670,16,34588,34588,0,0,0,0,1.0,1,1.0,1,1.0,1,0.40790833332325205,40
2671,13,34601,34601,0,0,0,0,1.0,1,1.0,1,1.0,1,0.33454246708608265,39
2672,9,34610,34610,0,0,0,0,1.0,1,1.0,1,1.0,1,0.4009452959295626,36
2673,16,34626,34626,0,0,0,0,1.0,1,1.0,1,1.0,1,0.43567034608517163,35
2674,15,34641,34641,0,0,0,0,1.0,1,1.0,1,1.0,1,0.377254641693023,33
2675,15,34656,34656,0,0,0,0,1.0,1,1.0,1,1.0,1,0.3370829487445598,34
2676,14,34670,34670,0,0,0,0,1.0,1,1.0,1,1.0,1,0.5285143335943757,32
2677,14,34684,34684,0,0,0,0,1.0,1,1.0,1,1.0,1,0.4062560469136557,33
2678,7,34691,34691,0,0,0,0,1.0,1,1.0,1,1.0,1,0.4847096280787692,33
2679,14,34705,34705,0,0,0,0,1.0,1,1.0,1,1.0,1,0.537979643391962,32
2680,9,34714,34714,0,0,0,0,1.0,1,1.0,1,1.0,1,0.3895197792114768,32
2681,12,34726,34726,0,0,0,0,1.0,1,1.0,1,1.0,1,0.29497394509552755,32
2682,10,34736,34736,0,0,0,0,1.0,1,1.0,1,1.0,1,0.25829608744026383,33
2683,9,34745,34745,0,0,0,0,1.0,1,1.0,1,1.0,1,0.20042083162266167,32
2684,20,34765,34765,0,0,0,0,1.0,1,1.0,1,1.0,1,0.3064015008701939,31
2685,17,34782,34782,0,0,0,0,1.0,1,1.0,1,1.0,1,0.31864837682549985,31
2686,15,34797,34797,0,0,0,0,1.0,1,1.0,1,1.0,1,0.4353586480737246,30
2687,14,34811,34811,0,0,0,0,1.0,1,1.0,1,1.0,1,0.3534888653322182,30
2688,14,34825,34825,0,0,0,0,1.0,1,1.0,1,1.0,1,0.4047282879963415,30
2689,17,34842,34842,0,0,0,0,1.0,1,1.0,1,1.0,1,0.33779863253754555,31
2690,18,34860,34860,0,0,0,0,1.0,1,1.0,1,1.0,1,0.5594623815218768,31
2691,15,34875,34875,0,0,0,0,1.0,1,1.0,1,1.0,1,0.2881711525682994,32
2692,17,34892,34892,0,0,0,0,1.0,1,1.0,1,1.0,1,0.34268835046530455,32
2693,19,34911,34911,0,0,0,0,1.0,1,1.0,1,1.0,1,0.3362163056863235,33
2694,6,34917,34917,0,0,0,0,1.0,1,1.0,1,1.0,1,0.2687190095148103,34
2695,13,34930,34930,0,0,0,0,1.0,1,1.0,1,1.0,1,0.39598812107678233,35
2696,5,34935,34935,0,0,0,0,1.0,1,1.0,1,1.0,1,0.3498901057813687,35
2697,7,34942,34942,0,0,0,0,1.0,1,1.0,1,1.0,1,0.2754482962684439,35
2698,6,34948,34948,0,0,0,0,1.0,1,1.0,1,1.0,1,0.36243008509244906,36
2699,13,34961,34961,0,0,0,0,1.0,1,1.0,1,1.0,1,0.3184775853626236,36
2700,16,34977,34977,0,0,0,0,1.0,1,1.0,1,1.0,1,0.36783332844408806,37
2701,12,34989,34989,0,0,0,0,1.0,1,1.0,1,1.0,1,0.39918173527531176,37
2702,14,35003,35003,0,0,0,0,1.0,1,1.0,1,1.0,1,0.41866525313428976,37
2703,13,35016,35016,0,0,0,0,1.0,1,1.0,1,1.0,1,0.32943224525637593,38
2704,8,35024,35024,0,0,0,0,1.0,1,1.0,1,1.0,1,0.2699842348100458,37
2705,14,35038,35038,0,0,0,0,1.0,1,1.0,1,1.0,1,0.3231530006795221,36
2706,13,35051,35051,0,0,0,0,1.0,1,1.0,1,1.0,1,0.41997350270052836,36
2707,7,35058,35058,0,0,0,0,1.0,1,1.0,1,1.0,1,0.32593037678906706,35
2708,15,35073,35073,0,0,0,0,1.0,1,1.0,1,1.0,1,0.3291334953217023,36
2709,9,35082,35082,0,0,0,0,1.0,1,1.0,1,1.0,1,0.29999314207648775,32
2710,6,35088,35088,0,0,0,0,1.0,1,1.0,1,1.0,1,0.3870849923043777,29
2711,3,35091,35091,0,0,0,0,1.0,1,1.0,1,1.0,1,0.35182538611696385,29
2712,5,35096,35096,0,0,0,0,1.0,1,1.0,1,1.0,1,0.45190224461752865,28
2713,8,35104,35104,0,0,0,0,1.0,1,1.0,1,1.0,1,0.4035415582830037,28
2714,12,35116,35116,0,0,0,0,1.0,1,1.0,1,1.0,1,0.404342185026122,26
2715,8,35124,35124,0,0,0,0,1.0,1,1.0,1,1.0,1,0.37119053589457646,24
2716,7,35131,35131,0,0,0,0,1.0,1,1.0,1,1.0,1,0.34488694455265356,24
2717,20,35151,35151,0,0,0,0,1.0,1,1.0,1,1.0,1,0.32578031834285925,25
2718,9,35160,35160,0,0,0,0,1.0,1,1.0,1,1.0,1,0.2252442245397274,25
2719,13,35173,35173,0,0,0,0,1.0,1,1.0,1,1.0,1,0.4176939283740423,25
2720,14,35187,35187,0,0,0,0,1.0,1,1.0,1,1.0,1,0.3969768206343393,25
2721,8,35195,35195,0,0,0,0,1.0,1,1.0,1,1.0,1,0.41972458824036335,25
2722,8,35203,35203,0,0,0,0,1.0,1,1.0,1,1.0,1,0.4207424690658227,26
2723,8,35211,35211,0,0,0,0,1.0,1,1.0,1,1.0,1,0.26381901574694827,26
2724,7,35218,35218,0,0,0,0,1.0,1,1.0,1,1.0,1,0.26780023621071514,27
2725,13,35231,35231,0,0,0,0,1.0,1,1.0,1,1.0,1,0.28133386171611074,28
2726,7,35238,35238,0,0,0,0,1.0,1,1.0,1,1.0,1,0.32839467736741335,28
2727,3,35241,35241,0,0,0,0,1.0,1,1.0,1,1.0,1,0.3878836720728131,29
2728,8,35249,35249,0,0,0,0,1.0,1,1.0,1,1.0,1,0.39924635899282956,29
2729,11,35260,35260,0,0,0,0,1.0,1,1.0,1,1.0,1,0.3129240247830247,29
2730,13,35273,35273,0,0,0,0,1.0,1,1.0,1,1.0,1,0.42091462644681227,29
2731,12,35285,35285,0,0,0,0,1.0,1,1.0,1,1.0,1,0.437842708934988,30
2732,9,35294,35294,0,0,0,0,1.0,1,1.0,1,1.0,1,0.3406120358255163,29
2733,11,35305,35305,0,0,0,0,1.0,1,1.0,1,1.0,1,0.3873874437930747,29
2734,11,35316,35316,0,0,0,0,1.0,1,1.0,1,1.0,1,0.37919249209753025,29
2735,7,35323,35323,0,0,0,0,1.0,1,1.0,1,1.0,1,0.3612771481279816,29
2736,9,35332,35332,0,0,0,0,1.0,1,1.0,1,1.0,1,0.33126341271204746,30
2737,6,35338,35338,0,0,0,0,1.0,1,1.0,1,1.0,1,0.3489504866336393,30
2738,6,35344,35344,0,0,0,0,1.0,1,1.0,1,1.0,1,0.2630307922517059,30
2739,4,35348,35348,0,0,0,0,1.0,1,1.0,1,1.0,1,0.21190816183222624,29
2740,6,35354,35354,0,0,0,0,1.0,1,1.0,1,1.0,1,0.33748190518448445,29
2741,2,35356,35356,0,0,0,0,1.0,1,1.0,1,1.0,1,0.33688627142040783,28
2742,2,35358,35358,0,0,0,0,1.0,1,1.0,1,1.0,1,0.34826333258781594,28
2743,2,35360,35360,0,0,0,0,1.0,1,1.0,1,1.0,1,0.4281110883717912,29
2744,3,35363,35363,0,0,0,0,1.0,1,1.0,1,1.0,1,0.3073157331253153,27
2745,1,35364,35364,0,0,0,0,1.0,1,1.0,1,1.0,1,0.23384949372505306,25
2746,3,35367,35367,0,0,0,0,1.0,1,1.0,1,1.0,1,0.2857459539979223,25
2747,4,35371,35371,0,0,0,0,1.0,1,1.0,1,1.0,1,0.2822004046570073,23
2748,4,35375,35375,0,0,0,0,1.0,1,1.0,1,1.0,1,0.31052019442646356,22
2749,3,35378,35378,0,0,0,0,1.0,1,1.0,1,1.0,1,0.3054539087004497,19
2750,6,35384,35384,0,0,0,0,1.0,1,1.0,1,1.0,1,0.3573641177546458,18
2751,2,35386,35386,0,0,0,0,1.0,1,1.0,1,1.0,1,0.5411295360105437,16
2752,2,35388,35388,0,0,0,0,1.0,1,1.0,1,1.0,1,0.40288230314899065,15
2753,2,35390,35390,0,0,0,0,1.0,1,1.0,1,1.0,1,0.5505248974523632,15
2754,4,35394,35394,0,0,0,0,1.0,1,1.0,1,1.0,1,0.5247913256734641,15
2755,4,35398,35398,0,0,0,0,1.0,1,1.0,1,1.0,1,0.5505248974523632,15
2756,3,35401,35401,0,0,0,0,1.0,1,1.0,1,1.0,1,0.35773196871718005,16
2757,6,35407,35407,0,0,0,0,1.0,1,1.0,1,1.0,1,0.3774914146219683,17
2758,5,35412,35412,0,0,0,0,1.0,1,1.0,1,1.0,1,0.39130904488987306,17
2759,2,35414,35414,0,0,0,0,1.0,1,1.0,1,1.0,1,0.4679175287275556,18
2760,3,35417,35417,0,0,0,0,1.0,1,1.0,1,1.0,1,0.34130066409087484,18
2761,4,35421,35421,0,0,0,0,1.0,1,1.0,1,1.0,1,0.5088745345228867,18
2762,11,35432,35432,0,0,0,0,1.0,1,1.0,1,1.0,1,0.31686055953277104,18
2763,6,35438,35438,0,0,0,0,1.0,1,1.0,1,1.0,1,0.501776539697403,17
2764,7,35445,35445,0,0,0,0,1.0,1,1.0,1,1.0,1,0.5259916068231739,17
2765,6,35451,35451,0,0,0,0,1.0,1,1.0,1,1.0,1,0.5729506315262861,18
2766,8,35459,35459,0,0,0,0,1.0,1,1.0,1,1.0,1,0.49985999874421444,18
2767,9,35468,35468,0,0,0,0,1.0,1,1.0,1,1.0,1,0.5430850821148084,18
2768,6,35474,35474,0,0,0,0,1.0,1,1.0,1,1.0,1,0.5559891385542385,18
2769,5,35479,35479,0,0,0,0,1.0,1,1.0,1,1.0,1,0.5324394187809289,18
2770,9,35488,35488,0,0,0,0,1.0,1,1.0,1,1.0,1,0.5816620934349358,18
2771,6,35494,35494,0,0,0,0,1.0,1,1.0,1,1.0,1,0.4793943194527338,18
2772,6,35500,35500,0,0,0,0,1.0,1,1.0,1,1.0,1,0.4664469367211296,18
2773,7,35507,35507,0,0,0,0,1.0,1,1.0,1,1.0,1,0.5105370812822757,18
2774,7,35514,35514,0,0,0,0,1.0,1,1.0,1,1.0,1,0.3854682583199929,20
2775,6,35520,35520,0,0,0,0,1.0,1,1.0,1,1.0,1,0.28712522776080046,21
2776,4,35524,35524,0,0,0,0,1.0,1,1.0,1,1.0,1,0.24821838669438603,21
2777,7,35531,35531,0,0,0,0,1.0,1,1.0,1,1.0,1,0.3064845458606761,22
2778,5,35536,35536,0,0,0,0,1.0,1,1.0,1,1.0,1,0.3116121755648357,24
2779,7,35543,35543,0,0,0,0,1.0,1,1.0,1,1.0,1,0.34446480483971115,24
2780,4,35547,35547,0,0,0,0,1.0,1,1.0,1,1.0,1,0.29345977357094993,24
2781,3,35550,35550,0,0,0,0,1.0,1,1.0,1,1.0,1,0.35224950778903186,24
2782,7,35557,35557,0,0,0,0,1.0,1,1.0,1,1.0,1,0.3274090612510198,24
2783,3,35560,35560,0,0,0,0,1.0,1,1.0,1,1.0,1,0.34988646309797183,24
2784,6,35566,35566,0,0,0,0,1.0,1,1.0,1,1.0,1,0.31779244414537705,24
2785,3,35569,35569,0,0,0,0,1.0,1,1.0,1,1.0,1,0.2579711559906477,22
2786,6,35575,35575,0,0,0,0,1.0,1,1.0,1,1.0,1,0.3058023333509288,22
2787,5,35580,35580,0,0,0,0,1.0,1,1.0,1,1.0,1,0.25073707035733134,21
2788,3,35583,35583,0,0,0,0,1.0,1,1.0,1,1.0,1,0.299005361028835,20
2789,2,35585,35585,0,0,0,0,1.0,1,1.0,1,1.0,1,0.22927101934195432,20
2790,4,35589,35589,0,0,0,0,1.0,1,1.0,1,1.0,1,0.22683165553861565,21
2791,5,35594,35594,0,0,0,0,1.0,1,1.0,1,1.0,1,0.21994041695529495,21
2792,4,35598,35598,0,0,0,0,1.0,1,1.0,1,1.0,1,0.25047185964930724,21
2793,6,35604,35604,0,0,0,0,1.0,1,1.0,1,1.0,1,0.2828463205451197,18
2794,2,35606,35606,0,0,0,0,1.0,1,1.0,1,1.0,1,0.2402423320981079,18
2795,4,35610,35610,0,0,0,0,1.0,1,1.0,1,1.0,1,0.21670805768155144,20
2796,8,35618,35618,0,0,0,0,1.0,1,1.0,1,1.0,1,0.17414685002783584,21
2797,3,35621,35621,0,0,0,0,1.0,1,1.0,1,1.0,1,0.17411112236619194,21
2798,6,35627,35627,0,0,0,0,1.0,1,1.0,1,1.0,1,0.17151798950916844,21
2799,6,35633,35633,0,0,0,0,1.0,1,1.0,1,1.0,1,0.26642193064428726,22
2800,13,35646,35646,0,0,0,0,1.0,1,1.0,1,1.0,1,0.23935177641930003,22
2801,5,35651,35651,0,0,0,0,1.0,1,1.0,1,1.0,1,0.24105758925015985,22
2802,8,35659,35659,0,0,0,0,1.0,1,1.0,1,1.0,1,0.19032458114280876,22
2803,1,35660,35660,0,0,0,0,1.0,1,1.0,1,1.0,1,0.22269167413491792,22
2804,5,35665,35665,0,0,0,0,1.0,1,1.0,1,1.0,1,0.23698722284823157,23
2805,4,35669,35669,0,0,0,0,1.0,1,1.0,1,1.0,1,0.2795408764121478,23
2806,3,35672,35672,0,0,0,0,1.0,1,1.0,1,1.0,1,0.3169187851541739,23
2807,4,35676,35676,0,0,0,0,1.0,1,1.0,1,1.0,1,0.38125465707269335,24
2808,3,35679,35679,0,0,0,0,1.0,1,1.0,1,1.0,1,0.3609402482192174,24
2809,7,35686,35686,0,0,0,0,1.0,1,1.0,1,1.0,1,0.2908854523339111,25
2810,5,35691,35691,0,0,0,0,1.0,1,1.0,1,1.0,1,0.3283207438506886,24
2811,10,35701,35701,0,0,0,0,1.0,1,1.0,1,1.0,1,0.36139272632318203,26
2812,10,35711,35711,0,0,0,0,1.0,1,1.0,1,1.0,1,0.3284449239215901,26
2813,5,35716,35716,0,0,0,0,1.0,1,1.0,1,1.0,1,0.3382693754664813,27
2814,19,35735,35735,0,0,0,0,1.0,1,1.0,1,1.0,1,0.3784455771830218,29
2815,11,35746,35746,0,0,0,0,1.0,1,1.0,1,1.0,1,0.3329521062475752,29
2816,7,35753,35753,0,0,0,0,1.0,1,1.0,1,1.0,1,0.3035803653327368,29
2817,10,35763,35763,0,0,0,0,1.0,1,1.0,1,1.0,1,0.33936756692232195,29
2818,10,35773,35773,0,0,0,0,1.0,1,1.0,1,1.0,1,0.36209201820402453,29
2819,10,35783,35783,0,0,0,0,1.0,1,1.0,1,1.0,1,0.4018098762335275,30
2820,12,35795,35795,0,0,0,0,1.0,1,1.0,1,1.0,1,0.305864522707496,30
2821,15,35810,35810,0,0,0,0,1.0,1,1.0,1,1.0,1,0.3015861945859112,31
2822,10,35820,35820,0,0,0,0,1.0,1,1.0,1,1.0,1,0.34073771129979785,30
2823,12,35832,35832,0,0,0,0,1.0,1,1.0,1,1.0,1,0.3194717627717184,27
2824,12,35844,35844,0,0,0,0,1.0,1,1.0,1,1.0,1,0.43629838339016,28
2825,15,35859,35859,0,0,0,0,1.0,1,1.0,1,1.0,1,0.2981989697308272,28
2826,14,35873,35873,0,0,0,0,1.0,1,1.0,1,1.0,1,0.2982374023290375,27
2827,12,35885,35885,0,0,0,0,1.0,1,1.0,1,1.0,1,0.2763491473593922,28
2828,15,35900,35900,0,0,0,0,1.0,1,1.0,1,1.0,1,0.2972396875338235,28
2829,10,35910,35910,0,0,0,0,1.0,1,1.0,1,1.0,1,0.3451605426993059,27
2830,6,35916,35916,0,0,0,0,1.0,1,1.0,1,1.0,1,0.20871185103018824,27
2831,5,35921,35921,0,0,0,0,1.0,1,1.0,1,1.0,1,0.37588823736578664,27
2832,9,35930,35930,0,0,0,0,1.0,1,1.0,1,1.0,1,0.3253864080887067,27
2833,8,35938,35938,0,0,0,0,1.0,1,1.0,1,1.0,1,0.349581474701117,26
2834,13,35951,35951,0,0,0,0,1.0,1,1.0,1,1.0,1,0.48539815468262965,26
2835,5,35956,35956,0,0,0,0,1.0,1,1.0,1,1.0,1,0.32110269737541053,25
2836,10,35966,35966,0,0,0,0,1.0,1,1.0,1,1.0,1,0.4092011190598591,27
2837,12,35978,35978,0,0,0,0,1.0,1,1.0,1,1.0,1,0.5364601430885942,27
2838,13,35991,35991,0,0,0,0,1.0,1,1.0,1,1.0,1,0.4770473624748675,27
2839,16,36007,36007,0,0,0,0,1.0,1,1.0,1,1.0,1,0.3681804365490148,29
2840,13,36020,36020,0,0,0,0,1.0,1,1.0,1,1.0,1,0.4071364535889775,29
2841,14,36034,36034,0,0,0,0,1.0,1,1.0,1,1.0,1,0.34488107368048526,31
2842,18,36052,36052,0,0,0,0,1.0,1,1.0,1,1.0,1,0.36804073442496044,31
2843,14,36066,36066,0,0,0,0,1.0,1,1.0,1,1.0,1,0.28126490252649505,32
2844,14,36080,36080,0,0,0,0,1.0,1,1.0,1,1.0,1,0.2970286150849927,33
2845,14,36094,36094,0,0,0,0,1.0,1,1.0,1,1.0,1,0.2557479394637479,32
2846,8,36102,36102,0,0,0,0,1.0,1,1.0,1,1.0,1,0.3207340626589678,33
2847,6,36108,36108,0,0,0,0,1.0,1,1.0,1,1.0,1,0.3594128390955603,32
2848,8,36116,36116,0,0,0,0,1.0,1,1.0,1,1.0,1,0.3036309247294307,33
2849,8,36124,36124,0,0,0,0,1.0,1,1.0,1,1.0,1,0.39482503743649044,34
2850,7,36131,36131,0,0,0,0,1.0,1,1.0,1,1.0,1,0.3080940151216228,34
2851,7,36138,36138,0,0,0,0,1.0,1,1.0,1,1.0,1,0.2570309503175629,34
2852,8,36146,36146,0,0,0,0,1.0,1,1.0,1,1.0,1,0.2769739876010976,35
2853,10,36156,36156,0,0,0,0,1.0,1,1.0,1,1.0,1,0.3292545618161134,36
2854,13,36169,36169,0,0,0,0,1.0,1,1.0,1,1.0,1,0.38060464427223295,37
2855,13,36182,36182,0,0,0,0,1.0,1,1.0,1,1.0,1,0.4466767680978097,38
2856,11,36193,36193,0,0,0,0,1.0,1,1.0,1,1.0,1,0.35959856803680934,38
2857,10,36203,36203,0,0,0,0,1.0,1,1.0,1,1.0,1,0.3448361968332807,39
2858,13,36216,36216,0,0,0,0,1.0,1,1.0,1,1.0,1,0.3998620585537677,40
2859,16,36232,36232,0,0,0,0,1.0,1,1.0,1,1.0,1,0.3448404024859611,40
2860,11,36243,36243,0,0,0,0,1.0,1,1.0,1,1.0,1,0.32731430529166583,40
2861,13,36256,36256,0,0,0,0,1.0,1,1.0,1,1.0,1,0.4005745111344926,38
2862,14,36270,36270,0,0,0,0,1.0,1,1.0,1,1.0,1,0.3493690302037455,38
2863,13,36283,36283,0,0,0,0,1.0,1,1.0,1,1.0,1,0.43661423843207475,38
2864,15,36298,36298,0,0,0,0,1.0,1,1.0,1,1.0,1,0.37606981651545934,36
2865,12,36310,36310,0,0,0,0,1.0,1,1.0,1,1.0,1,0.35112104953952294,34
2866,10,36320,36320,0,0,0,0,1.0,1,1.0,1,1.0,1,0.5519441191301896,31
2867,6,36326,36326,0,0,0,0,1.0,1,1.0,1,1.0,1,0.45374771391628543,30
2868,7,36333,36333,0,0,0,0,1.0,1,1.0,1,1.0,1,0.5426751617224486,27
2869,9,36342,36342,0,0,0,0,1.0,1,1.0,1,1.0,1,0.48997331544060924,27
2870,12,36354,36354,0,0,0,0,1.0,1,1.0,1,1.0,1,0.6462917059015911,25
2871,6,36360,36360,0,0,0,0,1.0,1,1.0,1,1.0,1,0.5240241017645764,25
2872,9,36369,36369,0,0,0,0,1.0,1,1.0,1,1.0,1,0.39716828854976644,23
2873,16,36385,36385,0,0,0,0,1.0,1,1.0,1,1.0,1,0.48031939208415436,24
2874,16,36401,36401,0,0,0,0,1.0,1,1.0,1,1.0,1,0.4314698602738996,24
2875,12,36413,36413,0,0,0,0,1.0,1,1.0,1,1.0,1,0.43794682166628596,23
2876,8,36421,36421,0,0,0,0,1.0,1,1.0,1,1.0,1,0.42465511032219916,24
2877,15,36436,36436,0,0,0,0,1.0,1,1.0,1,1.0,1,0.48307679990109265,24
2878,15,36451,36451,0,0,0,0,1.0,1,1.0,1,1.0,1,0.4578506641366858,24
2879,15,36466,36466,0,0,0,0,1.0,1,1.0,1,1.0,1,0.5367655423056167,25
2880,14,36480,36480,0,0,0,0,1.0,1,1.0,1,1.0,1,0.38329909567765735,26
2881,20,36500,36500,0,0,0,0,1.0,1,1.0,1,1.0,1,0.587466317166733,26
2882,11,36511,36511,0,0,0,0,1.0,1,1.0,1,1.0,1,0.49278195596575697,27
2883,13,36524,36524,0,0,0,0,1.0,1,1.0,1,1.0,1,0.5383983393572064,28
2884,15,36539,36539,0,0,0,0,1.0,1,1.0,1,1.0,1,0.4938189783708956,29
2885,19,36558,36558,0,0,0,0,1.0,1,1.0,1,1.0,1,0.41630655624253365,31
2886,9,36567,36567,0,0,0,0,1.0,1,1.0,1,1.0,1,0.44066692396130963,31
2887,20,36587,36587,0,0,0,0,1.0,1,1.0,1,1.0,1,0.4378241876388965,33
2888,21,36608,36608,0,0,0,0,1.0,1,1.0,1,1.0,1,0.39391232666616177,34
2889,27,36635,36635,0,0,0,0,1.0,1,1.0,1,1.0,1,0.38710245386364667,35
2890,22,36657,36657,0,0,0,0,1.0,1,1.0,1,1.0,1,0.5089995747026476,35
2891,26,36683,36683,0,0,0,0,1.0,1,1.0,1,1.0,1,0.6104915998127959,35
2892,19,36702,36702,0,0,0,0,1.0,1,1.0,1,1.0,1,0.5811665674900467,35
2893,15,36717,36717,0,0,0,0,1.0,1,1.0,1,1.0,1,0.5151568342080912,37
2894,10,36727,36727,0,0,0,0,1.0,1,1.0,1,1.0,1,0.5183391894758096,37
2895,14,36741,36741,0,0,0,0,1.0,1,1.0,1,1.0,1,0.5196627889561327,37
2896,18,36759,36759,0,0,0,0,1.0,1,1.0,1,1.0,1,0.5088411923464026,38
2897,14,36773,36773,0,0,0,0,1.0,1,1.0,1,1.0,1,0.5383898299836386,37
2898,11,36784,36784,0,0,0,0,1.0,1,1.0,1,1.0,1,0.5575032005715137,38
2899,15,36799,36799,0,0,0,0,1.0,1,1.0,1,1.0,1,0.49317030936750067,37
2900,13,36812,36812,0,0,0,0,1.0,1,1.0,1,1.0,1,0.496189607657125,36
2901,18,36830,36830,0,0,0,0,1.0,1,1.0,1,1.0,1,0.3576225353553525,37
2902,13,36843,36843,0,0,0,0,1.0,1,1.0,1,1.0,1,0.5606732320801695,35
2903,12,36855,36855,0,0,0,0,1.0,1,1.0,1,1.0,1,0.5563336841069982,35
2904,28,36883,36883,0,0,0,0,1.0,1,1.0,1,1.0,1,0.5136283456078091,33
2905,15,36898,36898,0,0,0,0,1.0,1,1.0,1,1.0,1,0.5817733082968561,34
2906,13,36911,36911,0,0,0,0,1.0,1,1.0,1,1.0,1,0.6310256219928174,34
2907,15,36926,36926,0,0,0,0,1.0,1,1.0,1,1.0,1,0.5723174724828227,35
2908,17,36943,36943,0,0,0,0,1.0,1,1.0,1,1.0,1,0.5225076640655141,36
2909,14,36957,36957,0,0,0,0,1.0,1,1.0,1,1.0,1,0.6143291538850288,38
2910,23,36980,36980,0,0,0,0,1.0,1,1.0,1,1.0,1,0.533422638877617,38
2911,10,36990,36990,0,0,0,0,1.0,1,1.0,1,1.0,1,0.5212366896613336,37
2912,10,37000,37000,0,0,0,0,1.0,1,1.0,1,1.0,1,0.608585978201236,37
2913,26,37026,37026,0,0,0,0,1.0,1,1.0,1,1.0,1,0.46768881998918793,38
2914,20,37046,37046,0,0,0,0,1.0,1,1.0,1,1.0,1,0.5142145409222284,38
2915,14,37060,37060,0,0,0,0,1.0,1,1.0,1,1.0,1,0.4854066986479258,39
2916,18,37078,37078,0,0,0,0,1.0,1,1.0,1,1.0,1,0.3392773688676601,40
2917,13,37091,37091,0,0,0,0,1.0,1,1.0,1,1.0,1,0.38088388525651845,41
2918,9,37100,37100,0,0,0,0,1.0,1,1.0,1,1.0,1,0.45809454634976904,41
2919,10,37110,37110,0,0,0,0,1.0,1,1.0,1,1.0,1,0.4660939669332097,41
2920,10,37120,37120,0,0,0,0,1.0,1,1.0,1,1.0,1,0.466753638843721,43
2921,12,37132,37132,0,0,0,0,1.0,1,1.0,1,1.0,1,0.5182607079926532,42
2922,16,37148,37148,0,0,0,0,1.0,1,1.0,1,1.0,1,0.44300529963679963,43
2923,15,37163,37163,0,0,0,0,1.0,1,1.0,1,1.0,1,0.3986211485901586,44
2924,16,37179,37179,0,0,0,0,1.0,1,1.0,1,1.0,1,0.33971655814519375,45
2925,8,37187,37187,0,0,0,0,1.0,1,1.0,1,1.0,1,0.38979191866267693,45
2926,13,37200,37200,0,0,0,0,1.0,1,1.0,1,1.0,1,0.3197340927415917,47
2927,17,37217,37217,0,0,0,0,1.0,1,1.0,1,1.0,1,0.36550484461030786,47
2928,7,37224,37224,0,0,0,0,1.0,1,1.0,1,1.0,1,0.32504470229763793,48
2929,9,37233,37233,0,0,0,0,1.0,1,1.0,1,1.0,1,0.3866451966275087,48
2930,13,37246,37246,0,0,0,0,1.0,1,1.0,1,1.0,1,0.4472823168286364,50
2931,9,37255,37255,0,0,0,0,1.0,1,1.0,1,1.0,1,0.34598520852811204,51
2932,9,37264,37264,0,0,0,0,1.0,1,1.0,1,1.0,1,0.3612224918319459,51
2933,11,37275,37275,0,0,0,0,1.0,1,1.0,1,1.0,1,0.34137123156814436,52
2934,16,37291,37291,0,0,0,0,1.0,1,1.0,1,1.0,1,0.43900198848800454,52
2935,7,37298,37298,0,0,0,0,1.0,1,1.0,1,1.0,1,0.46600881166086455,51
2936,11,37309,37309,0,0,0,0,1.0,1,1.0,1,1.0,1,0.3875898894719497,49
2937,15,37324,37324,0,0,0,0,1.0,1,1.0,1,1.0,1,0.35297316008038354,50
2938,10,37334,37334,0,0,0,0,1.0,1,1.0,1,1.0,1,0.4013066642609589,50
2939,6,37340,37340,0,0,0,0,1.0,1,1.0,1,1.0,1,0.39954116840090786,51
2940,13,37353,37353,0,0,0,0,1.0,1,1.0,1,1.0,1,0.3431188005120212,52
2941,15,37368,37368,0,0,0,0,1.0,1,1.0,1,1.0,1,0.4128969038466927,53
2942,8,37376,37376,0,0,0,0,1.0,1,1.0,1,1.0,1,0.4198877891030514,52
2943,14,37390,37390,0,0,0,0,1.0,1,1.0,1,1.0,1,0.39985682805435696,51
2944,13,37403,37403,0,0,0,0,1.0,1,1.0,1,1.0,1,0.41030469199899944,52
2945,22,37425,37425,0,0,0,0,1.0,1,1.0,1,1.0,1,0.4034498178136397,50
2946,27,37452,37452,0,0,0,0,1.0,1,1.0,1,1.0,1,0.4652010524686336,51
2947,20,37472,37472,0,0,0,0,1.0,1,1.0,1,1.0,1,0.4636604665827665,50
2948,16,37488,37488,0,0,0,0,1.0,1,1.0,1,1.0,1,0.5196853614145955,50
2949,21,37509,37509,0,0,0,0,1.0,1,1.0,1,1.0,1,0.47811358789525377,49
2950,11,37520,37520,0,0,0,0,1.0,1,1.0,1,1.0,1,0.5568798287796642,48
2951,11,37531,37531,0,0,0,0,1.0,1,1.0,1,1.0,1,0.5710202823904006,48
2952,20,37551,37551,0,0,0,0,1.0,1,1.0,1,1.0,1,0.5692128088124926,46
2953,21,37572,37572,0,0,0,0,1.0,1,1.0,1,1.0,1,0.5737063786681253,46
2954,15,37587,37587,0,0,0,0,1.0,1,1.0,1,1.0,1,0.5401268613885072,48
2955,20,37607,37607,0,0,0,0,1.0,1,1.0,1,1.0,1,0.4472918428022276,48
2956,17,37624,37624,0,0,0,0,1.0,1,1.0,1,1.0,1,0.44264566782725817,47
2957,17,37641,37641,0,0,0,0,1.0,1,1.0,1,1.0,1,0.3674263223450241,48
2958,20,37661,37661,0,0,0,0,1.0,1,1.0,1,1.0,1,0.4134837703784467,49
2959,13,37674,37674,0,0,0,0,1.0,1,1.0,1,1.0,1,0.2855441139124994,49
2960,17,37691,37691,0,0,0,0,1.0,1,1.0,1,1.0,1,0.3868224389791872,49
2961,26,37717,37717,0,0,0,0,1.0,1,1.0,1,1.0,1,0.3609145165947962,51
2962,11,37728,37728,0,0,0,0,1.0,1,1.0,1,1.0,1,0.3885194471223351,51
2963,12,37740,37740,0,0,0,0,1.0,1,1.0,1,1.0,1,0.4624424294816982,51
2964,8,37748,37748,0,0,0,0,1.0,1,1.0,1,1.0,1,0.3788163440679851,52
2965,6,37754,37754,0,0,0,0,1.0,1,1.0,1,1.0,1,0.4229823041352846,53
2966,14,37768,37768,0,0,0,0,1.0,1,1.0,1,1.0,1,0.43589663038207604,53
2967,10,37778,37778,0,0,0,0,1.0,1,1.0,1,1.0,1,0.4254489426770816,53
2968,8,37786,37786,0,0,0,0,1.0,1,1.0,1,1.0,1,0.4624603584679323,54
2969,5,37791,37791,0,0,0,0,1.0,1,1.0,1,1.0,1,0.49735299075022815,55
2970,9,37800,37800,0,0,0,0,1.0,1,1.0,1,1.0,1,0.4315810136868715,55
2971,9,37809,37809,0,0,0,0,1.0,1,1.0,1,1.0,1,0.5020640488456584,55
2972,8,37817,37817,0,0,0,0,1.0,1,1.0,1,1.0,1,0.5628326729603711,55
2973,3,37820,37820,0,0,0,0,1.0,1,1.0,1,1.0,1,0.5567729420100198,55
2974,14,37834,37834,0,0,0,0,1.0,1,1.0,1,1.0,1,0.47701448569189997,56
2975,12,37846,37846,0,0,0,0,1.0,1,1.0,1,1.0,1,0.5393381901325954,55
2976,9,37855,37855,0,0,0,0,1.0,1,1.0,1,1.0,1,0.484905730891184,57
2977,13,37868,37868,0,0,0,0,1.0,1,1.0,1,1.0,1,0.5111512002918082,59
2978,12,37880,37880,0,0,0,0,1.0,1,1.0,1,1.0,1,0.40355408723353897,59
2979,9,37889,37889,0,0,0,0,1.0,1,1.0,1,1.0,1,0.4063478262646428,59
2980,24,37913,37913,0,0,0,0,1.0,1,1.0,1,1.0,1,0.4324612520228668,59
2981,12,37925,37925,0,0,0,0,1.0,1,1.0,1,1.0,1,0.36440663963420417,59
2982,15,37940,37940,0,0,0,0,1.0,1,1.0,1,1.0,1,0.3783864958809019,61
2983,25,37965,37965,0,0,0,0,1.0,1,1.0,1,1.0,1,0.24784713582985457,61
2984,31,37996,37996,0,0,0,0,1.0,1,1.0,1,1.0,1,0.2583141735842501,61
2985,24,38020,38020,0,0,0,0,1.0,1,1.0,1,1.0,1,0.35274609063153717,57
2986,19,38039,38039,0,0,0,0,1.0,1,1.0,1,1.0,1,0.3016911071569524,58
2987,21,38060,38060,0,0,0,0,1.0,1,1.0,1,1.0,1,0.27336578411084866,56
2988,16,38076,38076,0,0,0,0,1.0,1,1.0,1,1.0,1,0.34696114705974246,55
2989,15,38091,38091,0,0,0,0,1.0,1,1.0,1,1.0,1,0.31299705084646023,53
2990,18,38109,38109,0,0,0,0,1.0,1,1.0,1,1.0,1,0.26654525381813615,52
2991,16,38125,38125,0,0,0,0,1.0,1,1.0,1,1.0,1,0.32975926764263563,54
2992,17,38142,38142,0,0,0,0,1.0,1,1.0,1,1.0,1,0.322539022882925,55
2993,7,38149,38149,0,0,0,0,1.0,1,1.0,1,1.0,1,0.3640213754879994,53
2994,4,38153,38153,0,0,0,0,1.0,1,1.0,1,1.0,1,0.30777860028476145,53
2995,11,38164,38164,0,0,0,0,1.0,1,1.0,1,1.0,1,0.37417097258983467,51
2996,9,38173,38173,0,0,0,0,1.0,1,1.0,1,1.0,1,0.4040026116835614,52
2997,8,38181,38181,0,0,0,0,1.0,1,1.0,1,1.0,1,0.3421777739476986,50
2998,8,38189,38189,0,0,0,0,1.0,1,1.0,1,1.0,1,0.40495907891713023,51
2999,14,38203,38203,0,0,0,0,1.0,1,1.0,1,1.0,1,0.40292975507117945,48
3000,8,38211,38211,0,0,0,0,1.0,1,1.0,1,1.0,1,0.4138356285404265,48
3001,11,38222,38222,0,0,0,0,1.0,1,1.0,1,1.0,1,0.44016409999116257,49
3002,11,38233,38233,0,0,0,0,1.0,1,1.0,1,1.0,1,0.48091803396402966,50
3003,7,38240,38240,0,0,0,0,1.0,1,1.0,1,1.0,1,0.4725857239731378,50
3004,9,38249,38249,0,0,0,0,1.0,1,1.0,1,1.0,1,0.4446310289345379,51
3005,10,38259,38259,0,0,0,0,1.0,1,1.0,1,1.0,1,0.3708158031523012,50
3006,10,38269,38269,0,0,0,0,1.0,1,1.0,1,1.0,1,0.35698352598875444,51
3007,8,38277,38277,0,0,0,0,1.0,1,1.0,1,1.0,1,0.39851927945644855,51
3008,25,38302,38302,0,0,0,0,1.0,1,1.0,1,1.0,1,0.373250571492047,53
3009,15,38317,38317,0,0,0,0,1.0,1,1.0,1,1.0,1,0.2676643296599528,52
3010,12,38329,38329,0,0,0,0,1.0,1,1.0,1,1.0,1,0.21542279963479327,52
3011,14,38343,38343,0,0,0,0,1.0,1,1.0,1,1.0,1,0.3330925986432984,51
3012,18,38361,38361,0,0,0,0,1.0,1,1.0,1,1.0,1,0.2498899176333204,54
3013,25,38386,38386,0,0,0,0,1.0,1,1.0,1,1.0,1,0.33431873368990095,52
3014,15,38401,38401,0,0,0,0,1.0,1,1.0,1,1.0,1,0.2539787238289831,51
3015,17,38418,38418,0,0,0,0,1.0,1,1.0,1,1.0,1,0.31736147525409,50
3016,18,38436,38436,0,0,0,0,1.0,1,1.0,1,1.0,1,0.3302341797798472,50
3017,15,38451,38451,0,0,0,0,1.0,1,1.0,1,1.0,1,0.3057294625304055,48
3018,9,38460,38460,0,0,0,0,1.0,1,1.0,1,1.0,1,0.38189008603802704,48
3019,21,38481,38481,0,0,0,0,1.0,1,1.0,1,1.0,1,0.376834953858183,47
3020,16,38497,38497,0,0,0,0,1.0,1,1.0,1,1.0,1,0.33598262191699596,47
3021,19,38516,38516,0,0,0,0,1.0,1,1.0,1,1.0,1,0.3609797345204558,46
3022,20,38536,38536,0,0,0,0,1.0,1,1.0,1,1.0,1,0.4197416896717114,45
3023,19,38555,38555,0,0,0,0,1.0,1,1.0,1,1.0,1,0.4833405078677077,41
3024,19,38574,38574,0,0,0,0,1.0,1,1.0,1,1.0,1,0.295211987255705,43
3025,19,38593,38593,0,0,0,0,1.0,1,1.0,1,1.0,1,0.4400819310817064,39
3026,15,38608,38608,0,0,0,0,1.0,1,1.0,1,1.0,1,0.34935505286537644,38
3027,21,38629,38629,0,0,0,0,1.0,1,1.0,1,1.0,1,0.4510516400994276,38
3028,18,38647,38647,0,0,0,0,1.0,1,1.0,1,1.0,1,0.4476064198981313,38
3029,9,38656,38656,0,0,0,0,1.0,1,1.0,1,1.0,1,0.37317054116098874,37
3030,13,38669,38669,0,0,0,0,1.0,1,1.0,1,1.0,1,0.49213619100908135,38
3031,14,38683,38683,0,0,0,0,1.0,1,1.0,1,1.0,1,0.396746750828159,39
3032,9,38692,38692,0,0,0,0,1.0,1,1.0,1,1.0,1,0.42087156435845796,39
3033,11,38703,38703,0,0,0,0,1.0,1,1.0,1,1.0,1,0.5209769649526417,39
3034,4,38707,38707,0,0,0,0,1.0,1,1.0,1,1.0,1,0.4961181618242943,38
3035,7,38714,38714,0,0,0,0,1.0,1,1.0,1,1.0,1,0.42342237659761633,39
3036,17,38731,38731,0,0,0,0,1.0,1,1.0,1,1.0,1,0.5216646972891809,39
3037,14,38745,38745,0,0,0,0,1.0,1,1.0,1,1.0,1,0.37203723525016613,39
3038,13,38758,38758,0,0,0,0,1.0,1,1.0,1,1.0,1,0.4164537839837812,40
3039,12,38770,38770,0,0,0,0,1.0,1,1.0,1,1.0,1,0.40417474744190574,41
3040,16,38786,38786,0,0,0,0,1.0,1,1.0,1,1.0,1,0.3370249332017665,42
3041,19,38805,38805,0,0,0,0,1.0,1,1.0,1,1.0,1,0.4094740192878608,43
3042,19,38824,38824,0,0,0,0,1.0,1,1.0,1,1.0,1,0.4301029041400731,45
3043,17,38841,38841,0,0,0,0,1.0,1,1.0,1,1.0,1,0.38844062068072194,45
3044,15,38856,38856,0,0,0,0,1.0,1,1.0,1,1.0,1,0.29506597583120164,45
3045,17,38873,38873,0,0,0,0,1.0,1,1.0,1,1.0,1,0.32450055713143783,45
3046,15,38888,38888,0,0,0,0,1.0,1,1.0,1,1.0,1,0.3914632913012391,46
3047,11,38899,38899,0,0,0,0,1.0,1,1.0,1,1.0,1,0.44047177079882205,46
3048,18,38917,38917,0,0,0,0,1.0,1,1.0,1,1.0,1,0.3949344890406114,49
3049,10,38927,38927,0,0,0,0,1.0,1,1.0,1,1.0,1,0.42215902770573405,50
3050,28,38955,38955,0,0,0,0,1.0,1,1.0,1,1.0,1,0.3872722629885425,50
3051,9,38964,38964,0,0,0,0,1.0,1,1.0,1,1.0,1,0.3842477210163852,50
3052,14,38978,38978,0,0,0,0,1.0,1,1.0,1,1.0,1,0.3724103172620575,50
3053,10,38988,38988,0,0,0,0,1.0,1,1.0,1,1.0,1,0.42642995917649656,49
3054,21,39009,39009,0,0,0,0,1.0,1,1.0,1,1.0,1,0.5083864548759311,47
3055,14,39023,39023,0,0,0,0,1.0,1,1.0,1,1.0,1,0.34893928468104596,48
3056,18,39041,39041,0,0,0,0,1.0,1,1.0,1,1.0,1,0.3505915170873847,47
3057,6,39047,39047,0,0,0,0,1.0,1,1.0,1,1.0,1,0.375637252452013,48
3058,12,39059,39059,0,0,0,0,1.0,1,1.0,1,1.0,1,0.36656619364663334,46
3059,12,39071,39071,0,0,0,0,1.0,1,1.0,1,1.0,1,0.2846352042743748,44
3060,14,39085,39085,0,0,0,0,1.0,1,1.0,1,1.0,1,0.32393908095080964,44
3061,12,39097,39097,0,0,0,0,1.0,1,1.0,1,1.0,1,0.3339048835972207,42
3062,9,39106,39106,0,0,0,0,1.0,1,1.0,1,1.0,1,0.28099987303731727,42
3063,12,39118,39118,0,0,0,0,1.0,1,1.0,1,1.0,1,0.20637122601836663,41
3064,13,39131,39131,0,0,0,0,1.0,1,1.0,1,1.0,1,0.24147961504355617,42
3065,7,39138,39138,0,0,0,0,1.0,1,1.0,1,1.0,1,0.24008872645051926,40
3066,14,39152,39152,0,0,0,0,1.0,1,1.0,1,1.0,1,0.2788647343783697,42
3067,17,39169,39169,0,0,0,0,1.0,1,1.0,1,1.0,1,0.17227032908754916,40
3068,9,39178,39178,0,0,0,0,1.0,1,1.0,1,1.0,1,0.36161055553423965,39
3069,9,39187,39187,0,0,0,0,1.0,1,1.0,1,1.0,1,0.30248824346854536,38
3070,18,39205,39205,0,0,0,0,1.0,1,1.0,1,1.0,1,0.2684284941328039,39
3071,9,39214,39214,0,0,0,0,1.0,1,1.0,1,1.0,1,0.20946143465674877,39
3072,9,39223,39223,0,0,0,0,1.0,1,1.0,1,1.0,1,0.2514694665391949,40
3073,12,39235,39235,0,0,0,0,1.0,1,1.0,1,1.0,1,0.21198955810683126,38
3074,15,39250,39250,0,0,0,0,1.0,1,1.0,1,1.0,1,0.23875001396204287,38
3075,11,39261,39261,0,0,0,0,1.0,1,1.0,1,1.0,1,0.20914206073706934,41
3076,14,39275,39275,0,0,0,0,1.0,1,1.0,1,1.0,1,0.18384747850575062,42
3077,16,39291,39291,0,0,0,0,1.0,1,1.0,1,1.0,1,0.26417750764563325,42
3078,12,39303,39303,0,0,0,0,1.0,1,1.0,1,1.0,1,0.2581187380379519,42
3079,12,39315,39315,0,0,0,0,1.0,1,1.0,1,1.0,1,0.2614070393838307,42
3080,6,39321,39321,0,0,0,0,1.0,1,1.0,1,1.0,1,0.32090266808624474,43
3081,16,39337,39337,0,0,0,0,1.0,1,1.0,1,1.0,1,0.2093102527211629,44
3082,10,39347,39347,0,0,0,0,1.0,1,1.0,1,1.0,1,0.3217029865595098,45
3083,7,39354,39354,0,0,0,0,1.0,1,1.0,1,1.0,1,0.2043772965019693,45
3084,6,39360,39360,0,0,0,0,1.0,1,1.0,1,1.0,1,0.2785990612730625,45
3085,13,39373,39373,0,0,0,0,1.0,1,1.0,1,1.0,1,0.2641682158328084,46
3086,9,39382,39382,0,0,0,0,1.0,1,1.0,1,1.0,1,0.27831605454576874,46
3087,5,39387,39387,0,0,0,0,1.0,1,1.0,1,1.0,1,0.26944791370992516,47
3088,4,39391,39391,0,0,0,0,1.0,1,1.0,1,1.0,1,0.32112660521994035,48
3089,6,39397,39397,0,0,0,0,1.0,1,1.0,1,1.0,1,0.3147388148568571,46
3090,11,39408,39408,0,0,0,0,1.0,1,1.0,1,1.0,1,0.29075365316308094,46
3091,18,39426,39426,0,0,0,0,1.0,1,1.0,1,1.0,1,0.3458128781285537,46
3092,15,39441,39441,0,0,0,0,1.0,1,1.0,1,1.0,1,0.29719549474368817,47
3093,10,39451,39451,0,0,0,0,1.0,1,1.0,1,1.0,1,0.3612608919563487,47
3094,18,39469,39469,0,0,0,0,1.0,1,1.0,1,1.0,1,0.334553073897399,45
3095,16,39485,39485,0,0,0,0,1.0,1,1.0,1,1.0,1,0.35024652490609937,46
3096,15,39500,39500,0,0,0,0,1.0,1,1.0,1,1.0,1,0.38230368946190074,46
3097,12,39512,39512,0,0,0,0,1.0,1,1.0,1,1.0,1,0.31623886594442313,47
3098,11,39523,39523,0,0,0,0,1.0,1,1.0,1,1.0,1,0.34170188292255466,47
3099,16,39539,39539,0,0,0,0,1.0,1,1.0,1,1.0,1,0.36249531813729535,47
3100,10,39549,39549,0,0,0,0,1.0,1,1.0,1,1.0,1,0.3239062844852766,47
3101,11,39560,39560,0,0,0,0,1.0,1,1.0,1,1.0,1,0.31930667974796734,48
3102,8,39568,39568,0,0,0,0,1.0,1,1.0,1,1.0,1,0.3033878180407694,48
3103,8,39576,39576,0,0,0,0,1.0,1,1.0,1,1.0,1,0.3079146166872549,49
3104,15,39591,39591,0,0,0,0,1.0,1,1.0,1,1.0,1,0.2764023614337737,48
3105,17,39608,39608,0,0,0,0,1.0,1,1.0,1,1.0,1,0.1989682856195719,45
3106,11,39619,39619,0,0,0,0,1.0,1,1.0,1,1.0,1,0.19805977186638074,46
3107,15,39634,39634,0,0,0,0,1.0,1,1.0,1,1.0,1,0.22009583898661245,44
3108,8,39642,39642,0,0,0,0,1.0,1,1.0,1,1.0,1,0.22430302751066575,45
3109,11,39653,39653,0,0,0,0,1.0,1,1.0,1,1.0,1,0.2105982280124908,44
3110,11,39664,39664,0,0,0,0,1.0,1,1.0,1,1.0,1,0.25001592216640295,46
3111,18,39682,39682,0,0,0,0,1.0,1,1.0,1,1.0,1,0.30277620558975643,46
3112,15,39697,39697,0,0,0,0,1.0,1,1.0,1,1.0,1,0.29461588581680315,47
3113,16,39713,39713,0,0,0,0,1.0,1,1.0,1,1.0,1,0.2785450670739628,48
3114,11,39724,39724,0,0,0,0,1.0,1,1.0,1,1.0,1,0.27986049139909086,48
3115,11,39735,39735,0,0,0,0,1.0,1,1.0,1,1.0,1,0.3359091645128222,49
3116,4,39739,39739,0,0,0,0,1.0,1,1.0,1,1.0,1,0.3141031088879469,48
3117,16,39755,39755,0,0,0,0,1.0,1,1.0,1,1.0,1,0.3097750512326865,49
3118,18,39773,39773,0,0,0,0,1.0,1,1.0,1,1.0,1,0.35838221156078437,50
3119,9,39782,39782,0,0,0,0,1.0,1,1.0,1,1.0,1,0.3612045411863894,50
3120,19,39801,39801,0,0,0,0,1.0,1,1.0,1,1.0,1,0.3518642060059252,50
3121,19,39820,39820,0,0,0,0,1.0,1,1.0,1,1.0,1,0.31118855842344445,50
3122,21,39841,39841,0,0,0,0,1.0,1,1.0,1,1.0,1,0.2969629335237156,50
3123,15,39856,39856,0,0,0,0,1.0,1,1.0,1,1.0,1,0.34664657732536514,51
3124,15,39871,39871,0,0,0,0,1.0,1,1.0,1,1.0,1,0.3759390340889629,51
3125,21,39892,39892,0,0,0,0,1.0,1,1.0,1,1.0,1,0.3222559090260041,51
3126,26,39918,39918,0,0,0,0,1.0,1,1.0,1,1.0,1,0.23963887983839166,54
3127,21,39939,39939,0,0,0,0,1.0,1,1.0,1,1.0,1,0.3682462561289721,53
3128,16,39955,39955,0,0,0,0,1.0,1,1.0,1,1.0,1,0.3327010954457733,52
3129,13,39968,39968,0,0,0,0,1.0,1,1.0,1,1.0,1,0.4049488429728687,51
3130,17,39985,39985,0,0,0,0,1.0,1,1.0,1,1.0,1,0.3157866665104621,50
3131,11,39996,39996,0,0,0,0,1.0,1,1.0,1,1.0,1,0.40436493909031984,50
3132,6,40002,40002,0,0,0,0,1.0,1,1.0,1,1.0,1,0.36994563299813515,49
3133,12,40014,40014,0,0,0,0,1.0,1,1.0,1,1.0,1,0.32428185191903947,49
3134,13,40027,40027,0,0,0,0,1.0,1,1.0,1,1.0,1,0.30678697687143835,46
3135,15,40042,40042,0,0,0,0,1.0,1,1.0,1,1.0,1,0.3241857966232054,47
3136,19,40061,40061,0,0,0,0,1.0,1,1.0,1,1.0,1,0.31745547639800065,46
3137,13,40074,40074,0,0,0,0,1.0,1,1.0,1,1.0,1,0.41712224530303493,49
3138,7,40081,40081,0,0,0,0,1.0,1,1.0,1,1.0,1,0.39794488914302806,49
3139,15,40096,40096,0,0,0,0,1.0,1,1.0,1,1.0,1,0.3315218450822287,50
3140,12,40108,40108,0,0,0,0,1.0,1,1.0,1,1.0,1,0.27981185498793376,51
3141,12,40120,40120,0,0,0,0,1.0,1,1.0,1,1.0,1,0.4034448327792093,50
3142,11,40131,40131,0,0,0,0,1.0,1,1.0,1,1.0,1,0.3549691483862337,50
3143,2,40133,40133,0,0,0,0,1.0,1,1.0,1,1.0,1,0.368134952361067,49
3144,15,40148,40148,0,0,0,0,1.0,1,1.0,1,1.0,1,0.34178223554660375,49
3145,17,40165,40165,0,0,0,0,1.0,1,1.0,1,1.0,1,0.34524725031045533,48
3146,19,40184,40184,0,0,0,0,1.0,1,1.0,1,1.0,1,0.3715207202832396,49
3147,17,40201,40201,0,0,0,0,1.0,1,1.0,1,1.0,1,0.4082517781072926,48
3148,12,40213,40213,0,0,0,0,1.0,1,1.0,1,1.0,1,0.3676660169315381,48
3149,14,40227,40227,0,0,0,0,1.0,1,1.0,1,1.0,1,0.42173678029832473,47
3150,16,40243,40243,0,0,0,0,1.0,1,1.0,1,1.0,1,0.520309765082085,47
3151,17,40260,40260,0,0,0,0,1.0,1,1.0,1,1.0,1,0.4413431642773081,48
3152,22,40282,40282,0,0,0,0,1.0,1,1.0,1,1.0,1,0.2973963973166961,47
3153,18,40300,40300,0,0,0,0,1.0,1,1.0,1,1.0,1,0.4176812928120826,47
3154,13,40313,40313,0,0,0,0,1.0,1,1.0,1,1.0,1,0.4055826701264805,48
3155,10,40323,40323,0,0,0,0,1.0,1,1.0,1,1.0,1,0.31284037942428344,48
3156,11,40334,40334,0,0,0,0,1.0,1,1.0,1,1.0,1,0.2785865910879723,48
3157,15,40349,40349,0,0,0,0,1.0,1,1.0,1,1.0,1,0.37722055741493715,48
3158,10,40359,40359,0,0,0,0,1.0,1,1.0,1,1.0,1,0.33701412441074124,48
3159,15,40374,40374,0,0,0,0,1.0,1,1.0,1,1.0,1,0.2944881246448934,49
3160,13,40387,40387,0,0,0,0,1.0,1,1.0,1,1.0,1,0.3097604186516357,51
3161,10,40397,40397,0,0,0,0,1.0,1,1.0,1,1.0,1,0.3660381312069319,52
3162,12,40409,40409,0,0,0,0,1.0,1,1.0,1,1.0,1,0.336572291190115,51
3163,11,40420,40420,0,0,0,0,1.0,1,1.0,1,1.0,1,0.3850370498717012,51
3164,9,40429,40429,0,0,0,0,1.0,1,1.0,1,1.0,1,0.3635791959124664,52
3165,16,40445,40445,0,0,0,0,1.0,1,1.0,1,1.0,1,0.36733684128764,50
3166,15,40460,40460,0,0,0,0,1.0,1,1.0,1,1.0,1,0.36319577883840093,50
3167,8,40468,40468,0,0,0,0,1.0,1,1.0,1,1.0,1,0.33954447507638924,49
3168,11,40479,40479,0,0,0,0,1.0,1,1.0,1,1.0,1,0.35722917979679736,47
3169,9,40488,40488,0,0,0,0,1.0,1,1.0,1,1.0,1,0.3638955947890072,48
3170,9,40497,40497,0,0,0,0,1.0,1,1.0,1,1.0,1,0.3091180651350236,47
3171,7,40504,40504,0,0,0,0,1.0,1,1.0,1,1.0,1,0.3714091372397793,47
3172,14,40518,40518,0,0,0,0,1.0,1,1.0,1,1.0,1,0.3445536441045662,46
3173,9,40527,40527,0,0,0,0,1.0,1,1.0,1,1.0,1,0.3496792398815324,45
3174,18,40545,40545,0,0,0,0,1.0,1,1.0,1,1.0,1,0.3400311888030456,43
3175,10,40555,40555,0,0,0,0,1.0,1,1.0,1,1.0,1,0.26304189264847727,43
3176,6,40561,40561,0,0,0,0,1.0,1,1.0,1,1.0,1,0.367384340006427,44
3177,13,40574,40574,0,0,0,0,1.0,1,1.0,1,1.0,1,0.3979636315357458,44
3178,20,40594,40594,0,0,0,0,1.0,1,1.0,1,1.0,1,0.23143759729978142,47
3179,21,40615,40615,0,0,0,0,1.0,1,1.0,1,1.0,1,0.392732211240104,48
3180,19,40634,40634,0,0,0,0,1.0,1,1.0,1,1.0,1,0.21633872959797615,48
3181,12,40646,40646,0,0,0,0,1.0,1,1.0,1,1.0,1,0.37490088206821987,48
3182,13,40659,40659,0,0,0,0,1.0,1,1.0,1,1.0,1,0.4115211428929836,51
3183,7,40666,40666,0,0,0,0,1.0,1,1.0,1,1.0,1,0.37649909073054416,50
3184,22,40688,40688,0,0,0,0,1.0,1,1.0,1,1.0,1,0.34545762166723193,50
3185,12,40700,40700,0,0,0,0,1.0,1,1.0,1,1.0,1,0.33867442459740693,48
3186,15,40715,40715,0,0,0,0,1.0,1,1.0,1,1.0,1,0.3423553897158807,48
3187,10,40725,40725,0,0,0,0,1.0,1,1.0,1,1.0,1,0.33591352537620134,48
3188,13,40738,40738,0,0,0,0,1.0,1,1.0,1,1.0,1,0.344518126641039,48
3189,9,40747,40747,0,0,0,0,1.0,1,1.0,1,1.0,1,0.32337100118433343,49
3190,8,40755,40755,0,0,0,0,1.0,1,1.0,1,1.0,1,0.3543387912578719,51
3191,10,40765,40765,0,0,0,0,1.0,1,1.0,1,1.0,1,0.37567999393132095,52
3192,6,40771,40771,0,0,0,0,1.0,1,1.0,1,1.0,1,0.44636797073679974,52
3193,10,40781,40781,0,0,0,0,1.0,1,1.0,1,1.0,1,0.3560155012804999,52
3194,13,40794,40794,0,0,0,0,1.0,1,1.0,1,1.0,1,0.33765304256564,54
3195,10,40804,40804,0,0,0,0,1.0,1,1.0,1,1.0,1,0.36422385291417875,54
3196,20,40824,40824,0,0,0,0,1.0,1,1.0,1,1.0,1,0.3198052241834694,54
3197,11,40835,40835,0,0,0,0,1.0,1,1.0,1,1.0,1,0.2931822140890977,54
3198,18,40853,40853,0,0,0,0,1.0,1,1.0,1,1.0,1,0.31128125775200494,54
3199,14,40867,40867,0,0,0,0,1.0,1,1.0,1,1.0,1,0.29052893232079996,56
3200,9,40876,40876,0,0,0,0,1.0,1,1.0,1,1.0,1,0.19433708779782216,56
3201,12,40888,40888,0,0,0,0,1.0,1,1.0,1,1.0,1,0.2697742113071899,56
3202,11,40899,40899,0,0,0,0,1.0,1,1.0,1,1.0,1,0.2677327376825023,57
3203,11,40910,40910,0,0,0,0,1.0,1,1.0,1,1.0,1,0.33068668274195967,56
3204,17,40927,40927,0,0,0,0,1.0,1,1.0,1,1.0,1,0.2966316148374707,55
3205,9,40936,40936,0,0,0,0,1.0,1,1.0,1,1.0,1,0.30313722017156003,54
3206,14,40950,40950,0,0,0,0,1.0,1,1.0,1,1.0,1,0.3170771406803832,56
3207,11,40961,40961,0,0,0,0,1.0,1,1.0,1,1.0,1,0.3045848591060301,54
3208,15,40976,40976,0,0,0,0,1.0,1,1.0,1,1.0,1,0.33945576588317916,53
3209,11,40987,40987,0,0,0,0,1.0,1,1.0,1,1.0,1,0.34419648428236344,54
3210,4,40991,40991,0,0,0,0,1.0,1,1.0,1,1.0,1,0.3810757601049943,53
3211,4,40995,40995,0,0,0,0,1.0,1,1.0,1,1.0,1,0.43135836018638496,53
3212,5,41000,41000,0,0,0,0,1.0,1,1.0,1,1.0,1,0.3936243234913706,54
3213,8,41008,41008,0,0,0,0,1.0,1,1.0,1,1.0,1,0.39246642154075023,54
3214,14,41022,41022,0,0,0,0,1.0,1,1.0,1,1.0,1,0.4289890045939647,55
3215,12,41034,41034,0,0,0,0,1.0,1,1.0,1,1.0,1,0.41182553432785945,55
3216,7,41041,41041,0,0,0,0,1.0,1,1.0,1,1.0,1,0.4070068771094668,55
3217,5,41046,41046,0,0,0,0,1.0,1,1.0,1,1.0,1,0.4189292314233711,54
3218,4,41050,41050,0,0,0,0,1.0,1,1.0,1,1.0,1,0.4239862579085828,54
3219,11,41061,41061,0,0,0,0,1.0,1,1.0,1,1.0,1,0.4192547747608566,55
3220,7,41068,41068,0,0,0,0,1.0,1,1.0,1,1.0,1,0.45407820900500606,56
3221,6,41074,41074,0,0,0,0,1.0,1,1.0,1,1.0,1,0.42807722536301684,57
3222,9,41083,41083,0,0,0,0,1.0,1,1.0,1,1.0,1,0.4433478083189968,57
3223,14,41097,41097,0,0,0,0,1.0,1,1.0,1,1.0,1,0.4732414260635847,56
3224,16,41113,41113,0,0,0,0,1.0,1,1.0,1,1.0,1,0.4430890431431804,58
3225,13,41126,41126,0,0,0,0,1.0,1,1.0,1,1.0,1,0.4240062566199522,55
3226,19,41145,41145,0,0,0,0,1.0,1,1.0,1,1.0,1,0.44491869944414575,54
3227,16,41161,41161,0,0,0,0,1.0,1,1.0,1,1.0,1,0.3777250541761614,53
3228,13,41174,41174,0,0,0,0,1.0,1,1.0,1,1.0,1,0.4703659557308143,52
3229,18,41192,41192,0,0,0,0,1.0,1,1.0,1,1.0,1,0.35222423465939123,52
3230,15,41207,41207,0,0,0,0,1.0,1,1.0,1,1.0,1,0.4496213249488023,50
3231,13,41220,41220,0,0,0,0,1.0,1,1.0,1,1.0,1,0.38586013859532126,50
3232,9,41229,41229,0,0,0,0,1.0,1,1.0,1,1.0,1,0.41192583546399913,50
3233,9,41238,41238,0,0,0,0,1.0,1,1.0,1,1.0,1,0.49482353347925834,50
3234,13,41251,41251,0,0,0,0,1.0,1,1.0,1,1.0,1,0.4597669982416202,49
3235,10,41261,41261,0,0,0,0,1.0,1,1.0,1,1.0,1,0.5034740722809934,49
3236,12,41273,41273,0,0,0,0,1.0,1,1.0,1,1.0,1,0.48133448979075755,51
3237,12,41285,41285,0,0,0,0,1.0,1,1.0,1,1.0,1,0.4611468218828955,53
3238,8,41293,41293,0,0,0,0,1.0,1,1.0,1,1.0,1,0.483724595770964,53
3239,13,41306,41306,0,0,0,0,1.0,1,1.0,1,1.0,1,0.5094058585090685,53
3240,13,41319,41319,0,0,0,0,1.0,1,1.0,1,1.0,1,0.5067116001668659,53
3241,18,41337,41337,0,0,0,0,1.0,1,1.0,1,1.0,1,0.5371779113872002,53
3242,15,41352,41352,0,0,0,0,1.0,1,1.0,1,1.0,1,0.4862530395128065,53
3243,19,41371,41371,0,0,0,0,1.0,1,1.0,1,1.0,1,0.4448156522397945,56
3244,13,41384,41384,0,0,0,0,1.0,1,1.0,1,1.0,1,0.47401009866545796,57
3245,20,41404,41404,0,0,0,0,1.0,1,1.0,1,1.0,1,0.4107841266819282,59
3246,12,41416,41416,0,0,0,0,1.0,1,1.0,1,1.0,1,0.3960530057553014,59
3247,13,41429,41429,0,0,0,0,1.0,1,1.0,1,1.0,1,0.36747653204015585,59
3248,10,41439,41439,0,0,0,0,1.0,1,1.0,1,1.0,1,0.3195550298292549,59
3249,17,41456,41456,0,0,0,0,1.0,1,1.0,1,1.0,1,0.4136288112385833,58
3250,13,41469,41469,0,0,0,0,1.0,1,1.0,1,1.0,1,0.42188196741744177,58
3251,13,41482,41482,0,0,0,0,1.0,1,1.0,1,1.0,1,0.3961948351573203,57
3252,10,41492,41492,0,0,0,0,1.0,1,1.0,1,1.0,1,0.4904570143967944,57
3253,15,41507,41507,0,0,0,0,1.0,1,1.0,1,1.0,1,0.37150546464232886,56
3254,12,41519,41519,0,0,0,0,1.0,1,1.0,1,1.0,1,0.4829646322486594,57
3255,15,41534,41534,0,0,0,0,1.0,1,1.0,1,1.0,1,0.43230436735025785,57
3256,11,41545,41545,0,0,0,0,1.0,1,1.0,1,1.0,1,0.30528957914087823,57
3257,18,41563,41563,0,0,0,0,1.0,1,1.0,1,1.0,1,0.3331834933751352,57
3258,24,41587,41587,0,0,0,0,1.0,1,1.0,1,1.0,1,0.2779112963098012,58
3259,16,41603,41603,0,0,0,0,1.0,1,1.0,1,1.0,1,0.3025548427729789,59
3260,19,41622,41622,0,0,0,0,1.0,1,1.0,1,1.0,1,0.23701714396502183,60
3261,23,41645,41645,0,0,0,0,1.0,1,1.0,1,1.0,1,0.2887770783652483,60
3262,18,41663,41663,0,0,0,0,1.0,1,1.0,1,1.0,1,0.2704767833487425,61
3263,23,41686,41686,0,0,0,0,1.0,1,1.0,1,1.0,1,0.2992027117983978,62
3264,18,41704,41704,0,0,0,0,1.0,1,1.0,1,1.0,1,0.316820155200677,60
3265,14,41718,41718,0,0,0,0,1.0,1,1.0,1,1.0,1,0.32138236822065547,58
3266,18,41736,41736,0,0,0,0,1.0,1,1.0,1,1.0,1,0.38134790819660663,59
3267,15,41751,41751,0,0,0,0,1.0,1,1.0,1,1.0,1,0.3325859921861241,60
3268,13,41764,41764,0,0,0,0,1.0,1,1.0,1,1.0,1,0.3849449219517926,58
3269,16,41780,41780,0,0,0,0,1.0,1,1.0,1,1.0,1,0.4027747968705773,57
3270,15,41795,41795,0,0,0,0,1.0,1,1.0,1,1.0,1,0.3917940537079402,56
3271,18,41813,41813,0,0,0,0,1.0,1,1.0,1,1.0,1,0.45732742894030765,55
3272,9,41822,41822,0,0,0,0,1.0,1,1.0,1,1.0,1,0.471334605018374,55
3273,15,41837,41837,0,0,0,0,1.0,1,1.0,1,1.0,1,0.4187830557937602,55
3274,14,41851,41851,0,0,0,0,1.0,1,1.0,1,1.0,1,0.433452297380048,55
3275,14,41865,41865,0,0,0,0,1.0,1,1.0,1,1.0,1,0.45036856447051216,55
3276,9,41874,41874,0,0,0,0,1.0,1,1.0,1,1.0,1,0.4379046246030035,55
3277,18,41892,41892,0,0,0,0,1.0,1,1.0,1,1.0,1,0.46636461174996907,57
3278,8,41900,41900,0,0,0,0,1.0,1,1.0,1,1.0,1,0.41527020793745983,56
3279,10,41910,41910,0,0,0,0,1.0,1,1.0,1,1.0,1,0.45498326595685284,54
3280,22,41932,41932,0,0,0,0,1.0,1,1.0,1,1.0,1,0.48622842088128426,53
3281,10,41942,41942,0,0,0,0,1.0,1,1.0,1,1.0,1,0.3809333436712974,52
3282,13,41955,41955,0,0,0,0,1.0,1,1.0,1,1.0,1,0.3462721807615789,50
3283,9,41964,41964,0,0,0,0,1.0,1,1.0,1,1.0,1,0.4097662556746704,50
3284,13,41977,41977,0,0,0,0,1.0,1,1.0,1,1.0,1,0.2177496341569595,47
3285,13,41990,41990,0,0,0,0,1.0,1,1.0,1,1.0,1,0.2164637957872463,48
3286,23,42013,42013,0,0,0,0,1.0,1,1.0,1,1.0,1,0.27398608892554316,46
3287,20,42033,42033,0,0,0,0,1.0,1,1.0,1,1.0,1,0.22776131689408427,46
3288,15,42048,42048,0,0,0,0,1.0,1,1.0,1,1.0,1,0.2672300844892856,46
3289,15,42063,42063,0,0,0,0,1.0,1,1.0,1,1.0,1,0.2012186998054774,48
3290,18,42081,42081,0,0,0,0,1.0,1,1.0,1,1.0,1,0.2060185344941245,48
3291,13,42094,42094,0,0,0,0,1.0,1,1.0,1,1.0,1,0.23803996438262964,50
3292,16,42110,42110,0,0,0,0,1.0,1,1.0,1,1.0,1,0.17142483468398403,50
3293,18,42128,42128,0,0,0,0,1.0,1,1.0,1,1.0,1,0.24704167277184352,51
3294,16,42144,42144,0,0,0,0,1.0,1,1.0,1,1.0,1,0.23334168361460286,50
3295,12,42156,42156,0,0,0,0,1.0,1,1.0,1,1.0,1,0.2957417554437287,50
3296,9,42165,42165,0,0,0,0,1.0,1,1.0,1,1.0,1,0.3046384273232218,50
3297,15,42180,42180,0,0,0,0,1.0,1,1.0,1,1.0,1,0.2702832055533809,51
3298,16,42196,42196,0,0,0,0,1.0,1,1.0,1,1.0,1,0.3258393759933036,52
3299,16,42212,42212,0,0,0,0,1.0,1,1.0,1,1.0,1,0.2591048760951246,53
3300,16,42228,42228,0,0,0,0,1.0,1,1.0,1,1.0,1,0.27909161072602306,53
3301,20,42248,42248,0,0,0,0,1.0,1,1.0,1,1.0,1,0.3200139492587854,53
3302,6,42254,42254,0,0,0,0,1.0,1,1.0,1,1.0,1,0.325798163978833,53
3303,9,42263,42263,0,0,0,0,1.0,1,1.0,1,1.0,1,0.34546610837280095,52
3304,12,42275,42275,0,0,0,0,1.0,1,1.0,1,1.0,1,0.2689097540265585,52
3305,13,42288,42288,0,0,0,0,1.0,1,1.0,1,1.0,1,0.2801514946959751,51
3306,7,42295,42295,0,0,0,0,1.0,1,1.0,1,1.0,1,0.24769220945122353,51
3307,15,42310,42310,0,0,0,0,1.0,1,1.0,1,1.0,1,0.24395952012587413,48
3308,17,42327,42327,0,0,0,0,1.0,1,1.0,1,1.0,1,0.26607917147756105,48
3309,17,42344,42344,0,0,0,0,1.0,1,1.0,1,1.0,1,0.2957624149030191,48
3310,14,42358,42358,0,0,0,0,1.0,1,1.0,1,1.0,1,0.30813873589668084,47
3311,14,42372,42372,0,0,0,0,1.0,1,1.0,1,1.0,1,0.3818282427219119,49
3312,18,42390,42390,0,0,0,0,1.0,1,1.0,1,1.0,1,0.2698438231733348,48
3313,14,42404,42404,0,0,0,0,1.0,1,1.0,1,1.0,1,0.33072532636525453,49
3314,8,42412,42412,0,0,0,0,1.0,1,1.0,1,1.0,1,0.2941233956836569,47
3315,11,42423,42423,0,0,0,0,1.0,1,1.0,1,1.0,1,0.406467811377898,47
3316,10,42433,42433,0,0,0,0,1.0,1,1.0,1,1.0,1,0.3925669430614155,47
3317,6,42439,42439,0,0,0,0,1.0,1,1.0,1,1.0,1,0.352267174198461,46
3318,23,42462,42462,0,0,0,0,1.0,1,1.0,1,1.0,1,0.31948579302228275,45
3319,12,42474,42474,0,0,0,0,1.0,1,1.0,1,1.0,1,0.24159413137115046,44
3320,15,42489,42489,0,0,0,0,1.0,1,1.0,1,1.0,1,0.30515776132628447,43
3321,13,42502,42502,0,0,0,0,1.0,1,1.0,1,1.0,1,0.39477620437988714,43
3322,16,42518,42518,0,0,0,0,1.0,1,1.0,1,1.0,1,0.4106003706919582,40
3323,18,42536,42536,0,0,0,0,1.0,1,1.0,1,1.0,1,0.3899705659145705,40
3324,18,42554,42554,0,0,0,0,1.0,1,1.0,1,1.0,1,0.36334024415651095,40
3325,17,42571,42571,0,0,0,0,1.0,1,1.0,1,1.0,1,0.42682402115774754,40
3326,14,42585,42585,0,0,0,0,1.0,1,1.0,1,1.0,1,0.3259292675391893,41
3327,21,42606,42606,0,0,0,0,1.0,1,1.0,1,1.0,1,0.44249801269265604,39
3328,22,42628,42628,0,0,0,0,1.0,1,1.0,1,1.0,1,0.3745999293744443,41
3329,20,42648,42648,0,0,0,0,1.0,1,1.0,1,1.0,1,0.5007724546294744,39
3330,12,42660,42660,0,0,0,0,1.0,1,1.0,1,1.0,1,0.2870158428521891,40
3331,15,42675,42675,0,0,0,0,1.0,1,1.0,1,1.0,1,0.4431575612538221,38
3332,11,42686,42686,0,0,0,0,1.0,1,1.0,1,1.0,1,0.37957138604498464,38
3333,21,42707,42707,0,0,0,0,1.0,1,1.0,1,1.0,1,0.3478427145610899,38
3334,8,42715,42715,0,0,0,0,1.0,1,1.0,1,1.0,1,0.463692478154921,40
3335,25,42740,42740,0,0,0,0,1.0,1,1.0,1,1.0,1,0.2631435145443125,40
3336,13,42753,42753,0,0,0,0,1.0,1,1.0,1,1.0,1,0.40692504834928517,39
3337,12,42765,42765,0,0,0,0,1.0,1,1.0,1,1.0,1,0.3705863089205543,40
3338,22,42787,42787,0,0,0,0,1.0,1,1.0,1,1.0,1,0.3910248015397912,41
3339,18,42805,42805,0,0,0,0,1.0,1,1.0,1,1.0,1,0.43035867557796553,42
3340,15,42820,42820,0,0,0,0,1.0,1,1.0,1,1.0,1,0.4352836995631618,43
3341,12,42832,42832,0,0,0,0,1.0,1,1.0,1,1.0,1,0.360135059987428,43
3342,24,42856,42856,0,0,0,0,1.0,1,1.0,1,1.0,1,0.4113618364996202,44
3343,9,42865,42865,0,0,0,0,1.0,1,1.0,1,1.0,1,0.3876029001147546,44
3344,11,42876,42876,0,0,0,0,1.0,1,1.0,1,1.0,1,0.44093956315164656,44
3345,14,42890,42890,0,0,0,0,1.0,1,1.0,1,1.0,1,0.4846670830987922,43
3346,7,42897,42897,0,0,0,0,1.0,1,1.0,1,1.0,1,0.5218441669161696,42
3347,8,42905,42905,0,0,0,0,1.0,1,1.0,1,1.0,1,0.4564114671986091,44
3348,14,42919,42919,0,0,0,0,1.0,1,1.0,1,1.0,1,0.4054387156307847,45
3349,13,42932,42932,0,0,0,0,1.0,1,1.0,1,1.0,1,0.5034380317224171,45
3350,22,42954,42954,0,0,0,0,1.0,1,1.0,1,1.0,1,0.4125652044368815,46
3351,17,42971,42971,0,0,0,0,1.0,1,1.0,1,1.0,1,0.42696956564727456,47
3352,29,43000,43000,0,0,0,0,1.0,1,1.0,1,1.0,1,0.44604138111654934,47
3353,21,43021,43021,0,0,0,0,1.0,1,1.0,1,1.0,1,0.5730013675056641,48
3354,20,43041,43041,0,0,0,0,1.0,1,1.0,1,1.0,1,0.523726223734541,48
3355,19,43060,43060,0,0,0,0,1.0,1,1.0,1,1.0,1,0.5016097184492315,48
3356,27,43087,43087,0,0,0,0,1.0,1,1.0,1,1.0,1,0.35281631304847655,48
3357,20,43107,43107,0,0,0,0,1.0,1,1.0,1,1.0,1,0.40448697962159613,47
3358,25,43132,43132,0,0,0,0,1.0,1,1.0,1,1.0,1,0.40451508917484247,46
3359,18,43150,43150,0,0,0,0,1.0,1,1.0,1,1.0,1,0.4882323360050144,45
3360,11,43161,43161,0,0,0,0,1.0,1,1.0,1,1.0,1,0.5042788175160171,44
3361,21,43182,43182,0,0,0,0,1.0,1,1.0,1,1.0,1,0.49397746930494996,43
3362,15,43197,43197,0,0,0,0,1.0,1,1.0,1,1.0,1,0.40258194423161175,42
3363,17,43214,43214,0,0,0,0,1.0,1,1.0,1,1.0,1,0.433869376868938,41
3364,18,43232,43232,0,0,0,0,1.0,1,1.0,1,1.0,1,0.20990446060402973,41
3365,19,43251,43251,0,0,0,0,1.0,1,1.0,1,1.0,1,0.2537690008243883,41
3366,19,43270,43270,0,0,0,0,1.0,1,1.0,1,1.0,1,0.2901840648830027,40
3367,12,43282,43282,0,0,0,0,1.0,1,1.0,1,1.0,1,0.2585767575570402,39
3368,12,43294,43294,0,0,0,0,1.0,1,1.0,1,1.0,1,0.3319658649298809,39
3369,8,43302,43302,0,0,0,0,1.0,1,1.0,1,1.0,1,0.38844421679855956,40
3370,15,43317,43317,0,0,0,0,1.0,1,1.0,1,1.0,1,0.27648233445539266,41
3371,10,43327,43327,0,0,0,0,1.0,1,1.0,1,1.0,1,0.3242082133710898,41
3372,16,43343,43343,0,0,0,0,1.0,1,1.0,1,1.0,1,0.29658722881034993,40
3373,10,43353,43353,0,0,0,0,1.0,1,1.0,1,1.0,1,0.4090018499266102,41
3374,15,43368,43368,0,0,0,0,1.0,1,1.0,1,1.0,1,0.27832064145297664,42
3375,13,43381,43381,0,0,0,0,1.0,1,1.0,1,1.0,1,0.26221090734434627,44
3376,14,43395,43395,0,0,0,0,1.0,1,1.0,1,1.0,1,0.21303930100038135,46
3377,10,43405,43405,0,0,0,0,1.0,1,1.0,1,1.0,1,0.34849942388097443,47
3378,11,43416,43416,0,0,0,0,1.0,1,1.0,1,1.0,1,0.2744649529704625,48
3379,7,43423,43423,0,0,0,0,1.0,1,1.0,1,1.0,1,0.21939108650926634,48
3380,12,43435,43435,0,0,0,0,1.0,1,1.0,1,1.0,1,0.2182970370539767,48
3381,10,43445,43445,0,0,0,0,1.0,1,1.0,1,1.0,1,0.26963235239278727,48
3382,18,43463,43463,0,0,0,0,1.0,1,1.0,1,1.0,1,0.3074818882161295,49
3383,13,43476,43476,0,0,0,0,1.0,1,1.0,1,1.0,1,0.26349071768232574,47
3384,10,43486,43486,0,0,0,0,1.0,1,1.0,1,1.0,1,0.26529730677052105,48
3385,15,43501,43501,0,0,0,0,1.0,1,1.0,1,1.0,1,0.21363713948915042,47
3386,14,43515,43515,0,0,0,0,1.0,1,1.0,1,1.0,1,0.1745312582443417,49
3387,18,43533,43533,0,0,0,0,1.0,1,1.0,1,1.0,1,0.2948706887835755,48
3388,13,43546,43546,0,0,0,0,1.0,1,1.0,1,1.0,1,0.33787865238039555,48
3389,13,43559,43559,0,0,0,0,1.0,1,1.0,1,1.0,1,0.25021960262154347,50
3390,17,43576,43576,0,0,0,0,1.0,1,1.0,1,1.0,1,0.2568297614938058,51
3391,20,43596,43596,0,0,0,0,1.0,1,1.0,1,1.0,1,0.3051805214925486,51
3392,19,43615,43615,0,0,0,0,1.0,1,1.0,1,1.0,1,0.185997749990278,52
3393,31,43646,43646,0,0,0,0,1.0,1,1.0,1,1.0,1,0.2811399036109931,52
3394,20,43666,43666,0,0,0,0,1.0,1,1.0,1,1.0,1,0.32343543240009254,52
3395,15,43681,43681,0,0,0,0,1.0,1,1.0,1,1.0,1,0.26839850865912657,50
3396,22,43703,43703,0,0,0,0,1.0,1,1.0,1,1.0,1,0.24833991149614038,49
3397,31,43734,43734,0,0,0,0,1.0,1,1.0,1,1.0,1,0.22465960410328603,49
3398,21,43755,43755,0,0,0,0,1.0,1,1.0,1,1.0,1,0.23556584836280503,48
3399,13,43768,43768,0,0,0,0,1.0,1,1.0,1,1.0,1,0.26517361579409104,49
3400,14,43782,43782,0,0,0,0,1.0,1,1.0,1,1.0,1,0.2646090673307218,50
3401,19,43801,43801,0,0,0,0,1.0,1,1.0,1,1.0,1,0.3350343198500184,51
3402,22,43823,43823,0,0,0,0,1.0,1,1.0,1,1.0,1,0.35040860471736707,51
3403,14,43837,43837,0,0,0,0,1.0,1,1.0,1,1.0,1,0.3389741935282039,51
3404,25,43862,43862,0,0,0,0,1.0,1,1.0,1,1.0,1,0.3488137948920341,51
3405,14,43876,43876,0,0,0,0,1.0,1,1.0,1,1.0,1,0.35737932314955634,51
3406,11,43887,43887,0,0,0,0,1.0,1,1.0,1,1.0,1,0.3661004166920665,51
3407,17,43904,43904,0,0,0,0,1.0,1,1.0,1,1.0,1,0.3251134075763734,52
3408,18,43922,43922,0,0,0,0,1.0,1,1.0,1,1.0,1,0.44993878691353806,53
3409,25,43947,43947,0,0,0,0,1.0,1,1.0,1,1.0,1,0.3588463796579291,54
3410,20,43967,43967,0,0,0,0,1.0,1,1.0,1,1.0,1,0.483352172924779,54
3411,12,43979,43979,0,0,0,0,1.0,1,1.0,1,1.0,1,0.44122928345753376,54
3412,26,44005,44005,0,0,0,0,1.0,1,1.0,1,1.0,1,0.48183521828443976,55
3413,26,44031,44031,0,0,0,0,1.0,1,1.0,1,1.0,1,0.3231883347445436,55
3414,16,44047,44047,0,0,0,0,1.0,1,1.0,1,1.0,1,0.2725164220889195,55
3415,26,44073,44073,0,0,0,0,1.0,1,1.0,1,1.0,1,0.33021981925395644,56
3416,26,44099,44099,0,0,0,0,1.0,1,1.0,1,1.0,1,0.2785607619668309,55
3417,24,44123,44123,0,0,0,0,1.0,1,1.0,1,1.0,1,0.2505300856514455,56
3418,19,44142,44142,0,0,0,0,1.0,1,1.0,1,1.0,1,0.2335954221374462,55
3419,21,44163,44163,0,0,0,0,1.0,1,1.0,1,1.0,1,0.26546056802898754,56
3420,19,44182,44182,0,0,0,0,1.0,1,1.0,1,1.0,1,0.23896017846474993,55
3421,19,44201,44201,0,0,0,0,1.0,1,1.0,1,1.0,1,0.23830317873503046,57
3422,18,44219,44219,0,0,0,0,1.0,1,1.0,1,1.0,1,0.25302454144376046,56
3423,21,44240,44240,0,0,0,0,1.0,1,1.0,1,1.0,1,0.26004804455285857,56
3424,18,44258,44258,0,0,0,0,1.0,1,1.0,1,1.0,1,0.23586921562939786,56
3425,17,44275,44275,0,0,0,0,1.0,1,1.0,1,1.0,1,0.40005564813257366,56
3426,27,44302,44302,0,0,0,0,1.0,1,1.0,1,1.0,1,0.2336874125301987,55
3427,34,44336,44336,0,0,0,0,1.0,1,1.0,1,1.0,1,0.4146902877485074,55
3428,14,44350,44350,0,0,0,0,1.0,1,1.0,1,1.0,1,0.2408357487602575,55
3429,15,44365,44365,0,0,0,0,1.0,1,1.0,1,1.0,1,0.39103546372807296,54
3430,21,44386,44386,0,0,0,0,1.0,1,1.0,1,1.0,1,0.33731246025849904,56
3431,16,44402,44402,0,0,0,0,1.0,1,1.0,1,1.0,1,0.32230998274129335,54
3432,26,44428,44428,0,0,0,0,1.0,1,1.0,1,1.0,1,0.333522283190249,56
3433,20,44448,44448,0,0,0,0,1.0,1,1.0,1,1.0,1,0.3426646416842657,53
3434,26,44474,44474,0,0,0,0,1.0,1,1.0,1,1.0,1,0.40707173749092046,51
3435,23,44497,44497,0,0,0,0,1.0,1,1.0,1,1.0,1,0.4266928860451619,51
3436,24,44521,44521,0,0,0,0,1.0,1,1.0,1,1.0,1,0.295770563638906,51
3437,24,44545,44545,0,0,0,0,1.0,1,1.0,1,1.0,1,0.4911832173992215,53
3438,17,44562,44562,0,0,0,0,1.0,1,1.0,1,1.0,1,0.43314765619771073,52
3439,18,44580,44580,0,0,0,0,1.0,1,1.0,1,1.0,1,0.39164020250263915,54
3440,23,44603,44603,0,0,0,0,1.0,1,1.0,1,1.0,1,0.37109321348561625,52
3441,10,44613,44613,0,0,0,0,1.0,1,1.0,1,1.0,1,0.3659672558073967,53
3442,17,44630,44630,0,0,0,0,1.0,1,1.0,1,1.0,1,0.36066634334827524,53
3443,12,44642,44642,0,0,0,0,1.0,1,1.0,1,1.0,1,0.38528745340926623,53
3444,13,44655,44655,0,0,0,0,1.0,1,1.0,1,1.0,1,0.37281092066970284,52
3445,14,44669,44669,0,0,0,0,1.0,1,1.0,1,1.0,1,0.2487640432122504,53
3446,13,44682,44682,0,0,0,0,1.0,1,1.0,1,1.0,1,0.2887213573398814,53
3447,19,44701,44701,0,0,0,0,1.0,1,1.0,1,1.0,1,0.293271601698391,53
3448,13,44714,44714,0,0,0,0,1.0,1,1.0,1,1.0,1,0.26630838708002025,52
3449,17,44731,44731,0,0,0,0,1.0,1,1.0,1,1.0,1,0.2985640692437995,52
3450,8,44739,44739,0,0,0,0,1.0,1,1.0,1,1.0,1,0.24357055532653094,52
3451,15,44754,44754,0,0,0,0,1.0,1,1.0,1,1.0,1,0.2862798506907539,54
3452,10,44764,44764,0,0,0,0,1.0,1,1.0,1,1.0,1,0.26302404313273103,54
3453,21,44785,44785,0,0,0,0,1.0,1,1.0,1,1.0,1,0.2555852819603517,54
3454,17,44802,44802,0,0,0,0,1.0,1,1.0,1,1.0,1,0.36395662961501896,57
3455,18,44820,44820,0,0,0,0,1.0,1,1.0,1,1.0,1,0.32289613645560855,57
3456,15,44835,44835,0,0,0,0,1.0,1,1.0,1,1.0,1,0.3565529623217407,58
3457,26,44861,44861,0,0,0,0,1.0,1,1.0,1,1.0,1,0.39145885888950444,57
3458,26,44887,44887,0,0,0,0,1.0,1,1.0,1,1.0,1,0.43757598535836156,57
3459,21,44908,44908,0,0,0,0,1.0,1,1.0,1,1.0,1,0.43999567265592354,57
3460,14,44922,44922,0,0,0,0,1.0,1,1.0,1,1.0,1,0.3911716571669787,58
3461,28,44950,44950,0,0,0,0,1.0,1,1.0,1,1.0,1,0.391843133127792,59
3462,22,44972,44972,0,0,0,0,1.0,1,1.0,1,1.0,1,0.4444895932126179,59
3463,13,44985,44985,0,0,0,0,1.0,1,1.0,1,1.0,1,0.3296518672831674,59
3464,16,45001,45001,0,0,0,0,1.0,1,1.0,1,1.0,1,0.39212220780293205,59
3465,18,45019,45019,0,0,0,0,1.0,1,1.0,1,1.0,1,0.3179077332479694,57
3466,12,45031,45031,0,0,0,0,1.0,1,1.0,1,1.0,1,0.30489333755502807,57
3467,17,45048,45048,0,0,0,0,1.0,1,1.0,1,1.0,1,0.28844675716509083,57
3468,18,45066,45066,0,0,0,0,1.0,1,1.0,1,1.0,1,0.3044679404508832,57
3469,14,45080,45080,0,0,0,0,1.0,1,1.0,1,1.0,1,0.31440786919627295,53
3470,10,45090,45090,0,0,0,0,1.0,1,1.0,1,1.0,1,0.2774004840227167,50
3471,10,45100,45100,0,0,0,0,1.0,1,1.0,1,1.0,1,0.32121809656527706,49
3472,18,45118,45118,0,0,0,0,1.0,1,1.0,1,1.0,1,0.22284915752345277,47
3473,5,45123,45123,0,0,0,0,1.0,1,1.0,1,1.0,1,0.35345798523857186,45
3474,21,45144,45144,0,0,0,0,1.0,1,1.0,1,1.0,1,0.31781885290315376,42
3475,13,45157,45157,0,0,0,0,1.0,1,1.0,1,1.0,1,0.3571370857136747,43
3476,13,45170,45170,0,0,0,0,1.0,1,1.0,1,1.0,1,0.287883241135024,41
3477,19,45189,45189,0,0,0,0,1.0,1,1.0,1,1.0,1,0.3758679548452385,42
3478,19,45208,45208,0,0,0,0,1.0,1,1.0,1,1.0,1,0.3009432425806048,40
3479,18,45226,45226,0,0,0,0,1.0,1,1.0,1,1.0,1,0.3264031594615564,40
3480,19,45245,45245,0,0,0,0,1.0,1,1.0,1,1.0,1,0.24776095663009295,40
3481,17,45262,45262,0,0,0,0,1.0,1,1.0,1,1.0,1,0.2218017269444261,40
3482,10,45272,45272,0,0,0,0,1.0,1,1.0,1,1.0,1,0.23888818394577907,40
3483,14,45286,45286,0,0,0,0,1.0,1,1.0,1,1.0,1,0.42225777613430393,39
3484,12,45298,45298,0,0,0,0,1.0,1,1.0,1,1.0,1,0.38961181665089656,39
3485,6,45304,45304,0,0,0,0,1.0,1,1.0,1,1.0,1,0.23060766734530982,40
3486,17,45321,45321,0,0,0,0,1.0,1,1.0,1,1.0,1,0.29314609288825344,41
3487,18,45339,45339,0,0,0,0,1.0,1,1.0,1,1.0,1,0.4544414299652822,41
3488,15,45354,45354,0,0,0,0,1.0,1,1.0,1,1.0,1,0.43543294019925927,42
3489,15,45369,45369,0,0,0,0,1.0,1,1.0,1,1.0,1,0.3941422154866567,44
3490,17,45386,45386,0,0,0,0,1.0,1,1.0,1,1.0,1,0.261107835723543,44
3491,28,45414,45414,0,0,0,0,1.0,1,1.0,1,1.0,1,0.3703636166809312,45
3492,27,45441,45441,0,0,0,0,1.0,1,1.0,1,1.0,1,0.3910096501492784,45
3493,21,45462,45462,0,0,0,0,1.0,1,1.0,1,1.0,1,0.41763006056125873,45
3494,16,45478,45478,0,0,0,0,1.0,1,1.0,1,1.0,1,0.42324298772964364,45
3495,12,45490,45490,0,0,0,0,1.0,1,1.0,1,1.0,1,0.36513177663936275,45
3496,18,45508,45508,0,0,0,0,1.0,1,1.0,1,1.0,1,0.4517236080588872,46
3497,31,45539,45539,0,0,0,0,1.0,1,1.0,1,1.0,1,0.44162720418914275,47
3498,38,45577,45577,0,0,0,0,1.0,1,1.0,1,1.0,1,0.38407775145729417,48
3499,11,45588,45588,0,0,0,0,1.0,1,1.0,1,1.0,1,0.41305215259437233,47
3500,12,45600,45600,0,0,0,0,1.0,1,1.0,1,1.0,1,0.4120766939354666,50
3501,13,45613,45613,0,0,0,0,1.0,1,1.0,1,1.0,1,0.3578891772354795,50
3502,25,45638,45638,0,0,0,0,1.0,1,1.0,1,1.0,1,0.45342666087207706,50
3503,16,45654,45654,0,0,0,0,1.0,1,1.0,1,1.0,1,0.40468261052130494,50
3504,23,45677,45677,0,0,0,0,1.0,1,1.0,1,1.0,1,0.5010569500395041,47
3505,23,45700,45700,0,0,0,0,1.0,1,1.0,1,1.0,1,0.5267027829088945,48
3506,16,45716,45716,0,0,0,0,1.0,1,1.0,1,1.0,1,0.4987683402326749,49
3507,12,45728,45728,0,0,0,0,1.0,1,1.0,1,1.0,1,0.5571550166366,46
3508,28,45756,45756,0,0,0,0,1.0,1,1.0,1,1.0,1,0.5138841165041931,47
3509,10,45766,45766,0,0,0,0,1.0,1,1.0,1,1.0,1,0.5832365480937972,44
3510,11,45777,45777,0,0,0,0,1.0,1,1.0,1,1.0,1,0.4190240911316694,45
3511,18,45795,45795,0,0,0,0,1.0,1,1.0,1,1.0,1,0.5353439692518526,44
3512,19,45814,45814,0,0,0,0,1.0,1,1.0,1,1.0,1,0.47976014698934516,42
3513,16,45830,45830,0,0,0,0,1.0,1,1.0,1,1.0,1,0.4733565712384211,42
3514,6,45836,45836,0,0,0,0,1.0,1,1.0,1,1.0,1,0.4611307254593756,42
3515,13,45849,45849,0,0,0,0,1.0,1,1.0,1,1.0,1,0.4687600052985934,42
3516,14,45863,45863,0,0,0,0,1.0,1,1.0,1,1.0,1,0.3748567459373454,41
3517,11,45874,45874,0,0,0,0,1.0,1,1.0,1,1.0,1,0.4150150313579789,44
3518,17,45891,45891,0,0,0,0,1.0,1,1.0,1,1.0,1,0.5536897673181594,43
3519,12,45903,45903,0,0,0,0,1.0,1,1.0,1,1.0,1,0.48410524257596493,44
3520,19,45922,45922,0,0,0,0,1.0,1,1.0,1,1.0,1,0.478632672712749,45
3521,11,45933,45933,0,0,0,0,1.0,1,1.0,1,1.0,1,0.44295148444479115,45
3522,13,45946,45946,0,0,0,0,1.0,1,1.0,1,1.0,1,0.45483438928957387,46
3523,24,45970,45970,0,0,0,0,1.0,1,1.0,1,1.0,1,0.521559311202531,46
3524,15,45985,45985,0,0,0,0,1.0,1,1.0,1,1.0,1,0.4729178862987095,47
3525,27,46012,46012,0,0,0,0,1.0,1,1.0,1,1.0,1,0.4461460373718283,48
3526,16,46028,46028,0,0,0,0,1.0,1,1.0,1,1.0,1,0.5102696146753265,49
3527,15,46043,46043,0,0,0,0,1.0,1,1.0,1,1.0,1,0.4517146914347736,49
3528,21,46064,46064,0,0,0,0,1.0,1,1.0,1,1.0,1,0.3798237578870151,51
3529,17,46081,46081,0,0,0,0,1.0,1,1.0,1,1.0,1,0.47686343821480975,51
3530,21,46102,46102,0,0,0,0,1.0,1,1.0,1,1.0,1,0.4510471014143639,52
3531,15,46117,46117,0,0,0,0,1.0,1,1.0,1,1.0,1,0.3792073837689798,52
3532,27,46144,46144,0,0,0,0,1.0,1,1.0,1,1.0,1,0.46627967213779176,52
3533,20,46164,46164,0,0,0,0,1.0,1,1.0,1,1.0,1,0.5001492779789706,52
3534,20,46184,46184,0,0,0,0,1.0,1,1.0,1,1.0,1,0.4934039057755991,52
3535,32,46216,46216,0,0,0,0,1.0,1,1.0,1,1.0,1,0.3605832009754331,52
3536,22,46238,46238,0,0,0,0,1.0,1,1.0,1,1.0,1,0.44716197877793573,54
3537,32,46270,46270,0,0,0,0,1.0,1,1.0,1,1.0,1,0.40998121375836677,55
3538,18,46288,46288,0,0,0,0,1.0,1,1.0,1,1.0,1,0.4750983729653766,55
3539,15,46303,46303,0,0,0,0,1.0,1,1.0,1,1.0,1,0.5042174439496857,58
3540,16,46319,46319,0,0,0,0,1.0,1,1.0,1,1.0,1,0.35723928128145493,59
3541,18,46337,46337,0,0,0,0,1.0,1,1.0,1,1.0,1,0.446053566054242,59
3542,23,46360,46360,0,0,0,0,1.0,1,1.0,1,1.0,1,0.4608927478019451,61
3543,16,46376,46376,0,0,0,0,1.0,1,1.0,1,1.0,1,0.34206680532928896,62
3544,26,46402,46402,0,0,0,0,1.0,1,1.0,1,1.0,1,0.4629216122436339,59
3545,23,46425,46425,0,0,0,0,1.0,1,1.0,1,1.0,1,0.49321305281026667,59
3546,23,46448,46448,0,0,0,0,1.0,1,1.0,1,1.0,1,0.4720263480601256,57
3547,16,46464,46464,0,0,0,0,1.0,1,1.0,1,1.0,1,0.542225016532817,53
3548,20,46484,46484,0,0,0,0,1.0,1,1.0,1,1.0,1,0.4064196157135614,53
3549,29,46513,46513,0,0,0,0,1.0,1,1.0,1,1.0,1,0.4568910052390085,52
3550,18,46531,46531,0,0,0,0,1.0,1,1.0,1,1.0,1,0.5389289239984824,51
3551,13,46544,46544,0,0,0,0,1.0,1,1.0,1,1.0,1,0.6112423420532724,51
3552,26,46570,46570,0,0,0,0,1.0,1,1.0,1,1.0,1,0.5682526640715317,51
3553,16,46586,46586,0,0,0,0,1.0,1,1.0,1,1.0,1,0.6178567755584016,49
3554,21,46607,46607,0,0,0,0,1.0,1,1.0,1,1.0,1,0.5733872920975001,49
3555,19,46626,46626,0,0,0,0,1.0,1,1.0,1,1.0,1,0.5296848509251026,51
3556,31,46657,46657,0,0,0,0,1.0,1,1.0,1,1.0,1,0.5019558210880242,51
3557,26,46683,46683,0,0,0,0,1.0,1,1.0,1,1.0,1,0.4743917369763232,52
3558,27,46710,46710,0,0,0,0,1.0,1,1.0,1,1.0,1,0.4459158944740795,52
3559,25,46735,46735,0,0,0,0,1.0,1,1.0,1,1.0,1,0.5283445443103253,52
3560,21,46756,46756,0,0,0,0,1.0,1,1.0,1,1.0,1,0.5935461310890916,53
3561,27,46783,46783,0,0,0,0,1.0,1,1.0,1,1.0,1,0.49920539677625253,54
3562,23,46806,46806,0,0,0,0,1.0,1,1.0,1,1.0,1,0.5198106930592468,54
3563,28,46834,46834,0,0,0,0,1.0,1,1.0,1,1.0,1,0.5415520401046506,55
3564,14,46848,46848,0,0,0,0,1.0,1,1.0,1,1.0,1,0.5236881389600904,57
3565,17,46865,46865,0,0,0,0,1.0,1,1.0,1,1.0,1,0.527378439002663,56
3566,16,46881,46881,0,0,0,0,1.0,1,1.0,1,1.0,1,0.564234225810184,57
3567,17,46898,46898,0,0,0,0,1.0,1,1.0,1,1.0,1,0.5939416091145538,57
3568,18,46916,46916,0,0,0,0,1.0,1,1.0,1,1.0,1,0.46987106785874355,57
3569,24,46940,46940,0,0,0,0,1.0,1,1.0,1,1.0,1,0.5103777788125026,57
3570,16,46956,46956,0,0,0,0,1.0,1,1.0,1,1.0,1,0.48456633548827394,59
3571,25,46981,46981,0,0,0,0,1.0,1,1.0,1,1.0,1,0.42958128590477834,60
3572,15,46996,46996,0,0,0,0,1.0,1,1.0,1,1.0,1,0.42185011270234324,61
3573,24,47020,47020,0,0,0,0,1.0,1,1.0,1,1.0,1,0.40953773317717845,62
3574,17,47037,47037,0,0,0,0,1.0,1,1.0,1,1.0,1,0.4174781299458641,63
3575,18,47055,47055,0,0,0,0,1.0,1,1.0,1,1.0,1,0.4627432446854495,63
3576,11,47066,47066,0,0,0,0,1.0,1,1.0,1,1.0,1,0.38711115432683113,63
3577,15,47081,47081,0,0,0,0,1.0,1,1.0,1,1.0,1,0.37224473870388813,64
3578,10,47091,47091,0,0,0,0,1.0,1,1.0,1,1.0,1,0.369294895075511,64
3579,8,47099,47099,0,0,0,0,1.0,1,1.0,1,1.0,1,0.3764685623143203,64
3580,16,47115,47115,0,0,0,0,1.0,1,1.0,1,1.0,1,0.36423907506161046,65
3581,13,47128,47128,0,0,0,0,1.0,1,1.0,1,1.0,1,0.4080080041592654,68
3582,13,47141,47141,0,0,0,0,1.0,1,1.0,1,1.0,1,0.3703731403805352,68
3583,14,47155,47155,0,0,0,0,1.0,1,1.0,1,1.0,1,0.4348411579102517,65
3584,26,47181,47181,0,0,0,0,1.0,1,1.0,1,1.0,1,0.45187430751037216,64
3585,15,47196,47196,0,0,0,0,1.0,1,1.0,1,1.0,1,0.4132672095904459,64
3586,21,47217,47217,0,0,0,0,1.0,1,1.0,1,1.0,1,0.30947906210840703,65
3587,30,47247,47247,0,0,0,0,1.0,1,1.0,1,1.0,1,0.4039712778283483,64
3588,20,47267,47267,0,0,0,0,1.0,1,1.0,1,1.0,1,0.38492981792990355,62
3589,22,47289,47289,0,0,0,0,1.0,1,1.0,1,1.0,1,0.2276510005154996,63
3590,18,47307,47307,0,0,0,0,1.0,1,1.0,1,1.0,1,0.35516032412338056,63
3591,22,47329,47329,0,0,0,0,1.0,1,1.0,1,1.0,1,0.3932185389815951,62
3592,8,47337,47337,0,0,0,0,1.0,1,1.0,1,1.0,1,0.29896292604881985,59
3593,15,47352,47352,0,0,0,0,1.0,1,1.0,1,1.0,1,0.37180906005982584,58
3594,20,47372,47372,0,0,0,0,1.0,1,1.0,1,1.0,1,0.4214526192117076,57
3595,18,47390,47390,0,0,0,0,1.0,1,1.0,1,1.0,1,0.34163154276117985,59
3596,24,47414,47414,0,0,0,0,1.0,1,1.0,1,1.0,1,0.43094779533002275,57
3597,24,47438,47438,0,0,0,0,1.0,1,1.0,1,1.0,1,0.4002752506972772,57
3598,16,47454,47454,0,0,0,0,1.0,1,1.0,1,1.0,1,0.34497473654243777,57
3599,22,47476,47476,0,0,0,0,1.0,1,1.0,1,1.0,1,0.3754192814422764,58
3600,15,47491,47491,0,0,0,0,1.0,1,1.0,1,1.0,1,0.3083908826761259,58
3601,19,47510,47510,0,0,0,0,1.0,1,1.0,1,1.0,1,0.33625382638015083,58
3602,16,47526,47526,0,0,0,0,1.0,1,1.0,1,1.0,1,0.3550850051119476,60
3603,18,47544,47544,0,0,0,0,1.0,1,1.0,1,1.0,1,0.3506935163375696,60
3604,14,47558,47558,0,0,0,0,1.0,1,1.0,1,1.0,1,0.28982612627411514,60
3605,19,47577,47577,0,0,0,0,1.0,1,1.0,1,1.0,1,0.335367116752483,61
3606,9,47586,47586,0,0,0,0,1.0,1,1.0,1,1.0,1,0.28254139165956194,63
3607,16,47602,47602,0,0,0,0,1.0,1,1.0,1,1.0,1,0.26432410719251237,63
3608,21,47623,47623,0,0,0,0,1.0,1,1.0,1,1.0,1,0.2552830788898855,64
3609,20,47643,47643,0,0,0,0,1.0,1,1.0,1,1.0,1,0.26724389640269863,66
3610,16,47659,47659,0,0,0,0,1.0,1,1.0,1,1.0,1,0.2807681115786903,67
3611,18,47677,47677,0,0,0,0,1.0,1,1.0,1,1.0,1,0.22114669807504866,67
3612,14,47691,47691,0,0,0,0,1.0,1,1.0,1,1.0,1,0.2736492920380728,66
3613,12,47703,47703,0,0,0,0,1.0,1,1.0,1,1.0,1,0.3029431162078862,66
3614,11,47714,47714,0,0,0,0,1.0,1,1.0,1,1.0,1,0.3106693336719941,65
3615,5,47719,47719,0,0,0,0,1.0,1,1.0,1,1.0,1,0.3448660324141988,65
3616,7,47726,47726,0,0,0,0,1.0,1,1.0,1,1.0,1,0.36578845500764856,65
3617,13,47739,47739,0,0,0,0,1.0,1,1.0,1,1.0,1,0.4394228324245461,66
3618,9,47748,47748,0,0,0,0,1.0,1,1.0,1,1.0,1,0.3709741278641628,66
3619,5,47753,47753,0,0,0,0,1.0,1,1.0,1,1.0,1,0.338837575633425,65
3620,14,47767,47767,0,0,0,0,1.0,1,1.0,1,1.0,1,0.35264381867646566,66
3621,14,47781,47781,0,0,0,0,1.0,1,1.0,1,1.0,1,0.4111238344450996,65
3622,12,47793,47793,0,0,0,0,1.0,1,1.0,1,1.0,1,0.36096272515355987,65
3623,14,47807,47807,0,0,0,0,1.0,1,1.0,1,1.0,1,0.3272657885937478,62
3624,19,47826,47826,0,0,0,0,1.0,1,1.0,1,1.0,1,0.3419050611198353,62
3625,17,47843,47843,0,0,0,0,1.0,1,1.0,1,1.0,1,0.2984895667222701,61
3626,18,47861,47861,0,0,0,0,1.0,1,1.0,1,1.0,1,0.28645541903007926,58
3627,18,47879,47879,0,0,0,0,1.0,1,1.0,1,1.0,1,0.16279043518910413,58
3628,19,47898,47898,0,0,0,0,1.0,1,1.0,1,1.0,1,0.2974820009578249,57
3629,20,47918,47918,0,0,0,0,1.0,1,1.0,1,1.0,1,0.21667726338340723,57
3630,21,47939,47939,0,0,0,0,1.0,1,1.0,1,1.0,1,0.31042396398577754,56
3631,14,47953,47953,0,0,0,0,1.0,1,1.0,1,1.0,1,0.23635462933180992,54
3632,15,47968,47968,0,0,0,0,1.0,1,1.0,1,1.0,1,0.22504626802048777,52
3633,16,47984,47984,0,0,0,0,1.0,1,1.0,1,1.0,1,0.19790748671826353,52
3634,10,47994,47994,0,0,0,0,1.0,1,1.0,1,1.0,1,0.22536515088578674,49
3635,19,48013,48013,0,0,0,0,1.0,1,1.0,1,1.0,1,0.18260672710941372,47
3636,14,48027,48027,0,0,0,0,1.0,1,1.0,1,1.0,1,0.14445294812159937,48
3637,16,48043,48043,0,0,0,0,1.0,1,1.0,1,1.0,1,0.29766760632314465,49
3638,18,48061,48061,0,0,0,0,1.0,1,1.0,1,1.0,1,0.2767099114168487,50
3639,15,48076,48076,0,0,0,0,1.0,1,1.0,1,1.0,1,0.29822370608999027,52
3640,12,48088,48088,0,0,0,0,1.0,1,1.0,1,1.0,1,0.33624292681553736,52
3641,8,48096,48096,0,0,0,0,1.0,1,1.0,1,1.0,1,0.2680127067307888,52
3642,8,48104,48104,0,0,0,0,1.0,1,1.0,1,1.0,1,0.3128982783857353,52
3643,9,48113,48113,0,0,0,0,1.0,1,1.0,1,1.0,1,0.31500390909037823,52
3644,9,48122,48122,0,0,0,0,1.0,1,1.0,1,1.0,1,0.28961005215156754,52
3645,12,48134,48134,0,0,0,0,1.0,1,1.0,1,1.0,1,0.30169434234841613,53
3646,12,48146,48146,0,0,0,0,1.0,1,1.0,1,1.0,1,0.2827717063272262,53
3647,15,48161,48161,0,0,0,0,1.0,1,1.0,1,1.0,1,0.2954002995007262,55
3648,15,48176,48176,0,0,0,0,1.0,1,1.0,1,1.0,1,0.3065754310179455,57
3649,18,48194,48194,0,0,0,0,1.0,1,1.0,1,1.0,1,0.25050172253670083,57
3650,7,48201,48201,0,0,0,0,1.0,1,1.0,1,1.0,1,0.2539799767875586,59
3651,19,48220,48220,0,0,0,0,1.0,1,1.0,1,1.0,1,0.32557554310737435,59
3652,6,48226,48226,0,0,0,0,1.0,1,1.0,1,1.0,1,0.2808429822009248,59
3653,6,48232,48232,0,0,0,0,1.0,1,1.0,1,1.0,1,0.2944499946823434,59
3654,8,48240,48240,0,0,0,0,1.0,1,1.0,1,1.0,1,0.2666703618959574,59
3655,8,48248,48248,0,0,0,0,1.0,1,1.0,1,1.0,1,0.21099123901207203,62
3656,10,48258,48258,0,0,0,0,1.0,1,1.0,1,1.0,1,0.24476981289278912,62
3657,11,48269,48269,0,0,0,0,1.0,1,1.0,1,1.0,1,0.22355817814352694,63
3658,9,48278,48278,0,0,0,0,1.0,1,1.0,1,1.0,1,0.21679441531660937,63
3659,21,48299,48299,0,0,0,0,1.0,1,1.0,1,1.0,1,0.23087012646221988,62
3660,20,48319,48319,0,0,0,0,1.0,1,1.0,1,1.0,1,0.20943434624290216,62
3661,17,48336,48336,0,0,0,0,1.0,1,1.0,1,1.0,1,0.24677228407289686,61
3662,23,48359,48359,0,0,0,0,1.0,1,1.0,1,1.0,1,0.3045114703627043,60
3663,21,48380,48380,0,0,0,0,1.0,1,1.0,1,1.0,1,0.24384717135861378,61
3664,28,48408,48408,0,0,0,0,1.0,1,1.0,1,1.0,1,0.22737741367534825,58
3665,18,48426,48426,0,0,0,0,1.0,1,1.0,1,1.0,1,0.22916840067001895,58
3666,17,48443,48443,0,0,0,0,1.0,1,1.0,1,1.0,1,0.21340025933904708,58
3667,24,48467,48467,0,0,0,0,1.0,1,1.0,1,1.0,1,0.2929092023170191,58
3668,34,48501,48501,0,0,0,0,1.0,1,1.0,1,1.0,1,0.2862690617454908,58
3669,15,48516,48516,0,0,0,0,1.0,1,1.0,1,1.0,1,0.31358740505114324,57
3670,19,48535,48535,0,0,0,0,1.0,1,1.0,1,1.0,1,0.28622088361920645,56
3671,11,48546,48546,0,0,0,0,1.0,1,1.0,1,1.0,1,0.2787936094094889,57
3672,18,48564,48564,0,0,0,0,1.0,1,1.0,1,1.0,1,0.24657503158513694,57
3673,13,48577,48577,0,0,0,0,1.0,1,1.0,1,1.0,1,0.30841399474263687,58
3674,14,48591,48591,0,0,0,0,1.0,1,1.0,1,1.0,1,0.26476187185072786,57
3675,11,48602,48602,0,0,0,0,1.0,1,1.0,1,1.0,1,0.28234749027797285,58
3676,7,48609,48609,0,0,0,0,1.0,1,1.0,1,1.0,1,0.25598982632484246,59
3677,12,48621,48621,0,0,0,0,1.0,1,1.0,1,1.0,1,0.24160195264718454,60
3678,16,48637,48637,0,0,0,0,1.0,1,1.0,1,1.0,1,0.2586516163711823,62
3679,20,48657,48657,0,0,0,0,1.0,1,1.0,1,1.0,1,0.31809569981202795,62
3680,13,48670,48670,0,0,0,0,1.0,1,1.0,1,1.0,1,0.3037893638381184,63
3681,10,48680,48680,0,0,0,0,1.0,1,1.0,1,1.0,1,0.2743984275609309,64
3682,7,48687,48687,0,0,0,0,1.0,1,1.0,1,1.0,1,0.22505891250339477,64
3683,12,48699,48699,0,0,0,0,1.0,1,1.0,1,1.0,1,0.29067337367959917,64
3684,6,48705,48705,0,0,0,0,1.0,1,1.0,1,1.0,1,0.2953024684796581,64
3685,7,48712,48712,0,0,0,0,1.0,1,1.0,1,1.0,1,0.2620429338663975,64
3686,10,48722,48722,0,0,0,0,1.0,1,1.0,1,1.0,1,0.28746485330198573,65
3687,3,48725,48725,0,0,0,0,1.0,1,1.0,1,1.0,1,0.2966258619525686,65
3688,11,48736,48736,0,0,0,0,1.0,1,1.0,1,1.0,1,0.2526156033791413,66
3689,7,48743,48743,0,0,0,0,1.0,1,1.0,1,1.0,1,0.349068548159664,66
3690,18,48761,48761,0,0,0,0,1.0,1,1.0,1,1.0,1,0.2903626569047215,67
3691,12,48773,48773,0,0,0,0,1.0,1,1.0,1,1.0,1,0.3047912704110942,68
3692,14,48787,48787,0,0,0,0,1.0,1,1.0,1,1.0,1,0.2799158851259546,69
3693,23,48810,48810,0,0,0,0,1.0,1,1.0,1,1.0,1,0.292444387988811,69
3694,22,48832,48832,0,0,0,0,1.0,1,1.0,1,1.0,1,0.320219315333606,70
3695,18,48850,48850,0,0,0,0,1.0,1,1.0,1,1.0,1,0.24133993710541662,70
3696,17,48867,48867,0,0,0,0,1.0,1,1.0,1,1.0,1,0.32782921466921955,71
3697,25,48892,48892,0,0,0,0,1.0,1,1.0,1,1.0,1,0.3086906162367559,70
3698,26,48918,48918,0,0,0,0,1.0,1,1.0,1,1.0,1,0.26399036309217705,70
3699,32,48950,48950,0,0,0,0,1.0,1,1.0,1,1.0,1,0.33070697741512667,70
3700,24,48974,48974,0,0,0,0,1.0,1,1.0,1,1.0,1,0.32057785159316604,68
3701,34,49008,49008,0,0,0,0,1.0,1,1.0,1,1.0,1,0.3959393718479603,69
3702,14,49022,49022,0,0,0,0,1.0,1,1.0,1,1.0,1,0.39729107972490135,69
3703,27,49049,49049,0,0,0,0,1.0,1,1.0,1,1.0,1,0.335807176952644,70
3704,25,49074,49074,0,0,0,0,1.0,1,1.0,1,1.0,1,0.4822034760782406,69
3705,15,49089,49089,0,0,0,0,1.0,1,1.0,1,1.0,1,0.36122477386528623,69
3706,19,49108,49108,0,0,0,0,1.0,1,1.0,1,1.0,1,0.36885264353931885,69
3707,16,49124,49124,0,0,0,0,1.0,1,1.0,1,1.0,1,0.3470618300185519,67
3708,24,49148,49148,0,0,0,0,1.0,1,1.0,1,1.0,1,0.4264673043768987,67
3709,16,49164,49164,0,0,0,0,1.0,1,1.0,1,1.0,1,0.3359695400844052,67
3710,34,49198,49198,0,0,0,0,1.0,1,1.0,1,1.0,1,0.4075800378811992,67
3711,32,49230,49230,0,0,0,0,1.0,1,1.0,1,1.0,1,0.4311424434915437,68
3712,16,49246,49246,0,0,0,0,1.0,1,1.0,1,1.0,1,0.45254487192498516,68
3713,33,49279,49279,0,0,0,0,1.0,1,1.0,1,1.0,1,0.32867780068858443,68
3714,21,49300,49300,0,0,0,0,1.0,1,1.0,1,1.0,1,0.4236390670507234,67
3715,15,49315,49315,0,0,0,0,1.0,1,1.0,1,1.0,1,0.32542589534626504,68
3716,15,49330,49330,0,0,0,0,1.0,1,1.0,1,1.0,1,0.3394107170449494,67
3717,16,49346,49346,0,0,0,0,1.0,1,1.0,1,1.0,1,0.35851337763159136,68
3718,24,49370,49370,0,0,0,0,1.0,1,1.0,1,1.0,1,0.35288924980532904,68
3719,38,49408,49408,0,0,0,0,1.0,1,1.0,1,1.0,1,0.3169101966416711,68
3720,18,49426,49426,0,0,0,0,1.0,1,1.0,1,1.0,1,0.31719038923470644,68
3721,31,49457,49457,0,0,0,0,1.0,1,1.0,1,1.0,1,0.32972565296806794,70
3722,30,49487,49487,0,0,0,0,1.0,1,1.0,1,1.0,1,0.30306922588769136,71
3723,31,49518,49518,0,0,0,0,1.0,1,1.0,1,1.0,1,0.31946284880788106,71
3724,31,49549,49549,0,0,0,0,1.0,1,1.0,1,1.0,1,0.34346125067995265,72
3725,24,49573,49573,0,0,0,0,1.0,1,1.0,1,1.0,1,0.3258283337870922,72
3726,29,49602,49602,0,0,0,0,1.0,1,1.0,1,1.0,1,0.2565622018775213,71
3727,15,49617,49617,0,0,0,0,1.0,1,1.0,1,1.0,1,0.44115861244794846,71
3728,29,49646,49646,0,0,0,0,1.0,1,1.0,1,1.0,1,0.34655328295048093,70
3729,24,49670,49670,0,0,0,0,1.0,1,1.0,1,1.0,1,0.36485925189087426,70
3730,27,49697,49697,0,0,0,0,1.0,1,1.0,1,1.0,1,0.3543873843884447,71
3731,10,49707,49707,0,0,0,0,1.0,1,1.0,1,1.0,1,0.32739878884411183,71
3732,11,49718,49718,0,0,0,0,1.0,1,1.0,1,1.0,1,0.3209323486566116,72
3733,12,49730,49730,0,0,0,0,1.0,1,1.0,1,1.0,1,0.3572757364199099,73
3734,18,49748,49748,0,0,0,0,1.0,1,1.0,1,1.0,1,0.3313660192679792,74
3735,19,49767,49767,0,0,0,0,1.0,1,1.0,1,1.0,1,0.3766299504067759,72
3736,15,49782,49782,0,0,0,0,1.0,1,1.0,1,1.0,1,0.3513020360496207,72
3737,16,49798,49798,0,0,0,0,1.0,1,1.0,1,1.0,1,0.3285036951216314,73
3738,9,49807,49807,0,0,0,0,1.0,1,1.0,1,1.0,1,0.33775361767034745,72
3739,17,49824,49824,0,0,0,0,1.0,1,1.0,1,1.0,1,0.37867934847770396,73
3740,13,49837,49837,0,0,0,0,1.0,1,1.0,1,1.0,1,0.34405263635191713,70
3741,19,49856,49856,0,0,0,0,1.0,1,1.0,1,1.0,1,0.34401756067912315,70
3742,14,49870,49870,0,0,0,0,1.0,1,1.0,1,1.0,1,0.3027331119593337,70
3743,17,49887,49887,0,0,0,0,1.0,1,1.0,1,1.0,1,0.3413346454013309,69
3744,22,49909,49909,0,0,0,0,1.0,1,1.0,1,1.0,1,0.347233031345349,69
3745,20,49929,49929,0,0,0,0,1.0,1,1.0,1,1.0,1,0.24243058859171668,68
3746,18,49947,49947,0,0,0,0,1.0,1,1.0,1,1.0,1,0.30915108263076163,66
3747,18,49965,49965,0,0,0,0,1.0,1,1.0,1,1.0,1,0.3196625470676007,66
3748,21,49986,49986,0,0,0,0,1.0,1,1.0,1,1.0,1,0.33348998289071996,65
3749,11,49997,49997,0,0,0,0,1.0,1,1.0,1,1.0,1,0.30399271644453935,64
3750,15,50012,50012,0,0,0,0,1.0,1,1.0,1,1.0,1,0.3704321142000529,63
3751,15,50027,50027,0,0,0,0,1.0,1,1.0,1,1.0,1,0.36920200682174553,64
3752,17,50044,50044,0,0,0,0,1.0,1,1.0,1,1.0,1,0.3487701364381385,64
3753,27,50071,50071,0,0,0,0,1.0,1,1.0,1,1.0,1,0.32113932670272827,65
3754,17,50088,50088,0,0,0,0,1.0,1,1.0,1,1.0,1,0.30844507174589053,65
3755,12,50100,50100,0,0,0,0,1.0,1,1.0,1,1.0,1,0.368814322527684,65
3756,28,50128,50128,0,0,0,0,1.0,1,1.0,1,1.0,1,0.3635580870382936,65
3757,15,50143,50143,0,0,0,0,1.0,1,1.0,1,1.0,1,0.3345962800166097,65
3758,10,50153,50153,0,0,0,0,1.0,1,1.0,1,1.0,1,0.3403417868628549,64
3759,19,50172,50172,0,0,0,0,1.0,1,1.0,1,1.0,1,0.3039400908795588,64
3760,14,50186,50186,0,0,0,0,1.0,1,1.0,1,1.0,1,0.3983317267805141,63
3761,13,50199,50199,0,0,0,0,1.0,1,1.0,1,1.0,1,0.35317500294609055,63
3762,20,50219,50219,0,0,0,0,1.0,1,1.0,1,1.0,1,0.3906004242090299,65
3763,16,50235,50235,0,0,0,0,1.0,1,1.0,1,1.0,1,0.3636986227763348,65
3764,29,50264,50264,0,0,0,0,1.0,1,1.0,1,1.0,1,0.3390944977445282,66
3765,26,50290,50290,0,0,0,0,1.0,1,1.0,1,1.0,1,0.30672078037267136,67
3766,21,50311,50311,0,0,0,0,1.0,1,1.0,1,1.0,1,0.3889197625230808,67
3767,14,50325,50325,0,0,0,0,1.0,1,1.0,1,1.0,1,0.38831357809872297,68
3768,25,50350,50350,0,0,0,0,1.0,1,1.0,1,1.0,1,0.39689967342688753,67
3769,24,50374,50374,0,0,0,0,1.0,1,1.0,1,1.0,1,0.30869445042557914,69
3770,21,50395,50395,0,0,0,0,1.0,1,1.0,1,1.0,1,0.3848750241527368,69
3771,34,50429,50429,0,0,0,0,1.0,1,1.0,1,1.0,1,0.2925952787890836,69
3772,33,50462,50462,0,0,0,0,1.0,1,1.0,1,1.0,1,0.37072957486926394,70
3773,20,50482,50482,0,0,0,0,1.0,1,1.0,1,1.0,1,0.3492677300658348,68
3774,26,50508,50508,0,0,0,0,1.0,1,1.0,1,1.0,1,0.32740099438362136,68
3775,21,50529,50529,0,0,0,0,1.0,1,1.0,1,1.0,1,0.34323216230521797,68
3776,29,50558,50558,0,0,0,0,1.0,1,1.0,1,1.0,1,0.37775820513029995,66
3777,32,50590,50590,0,0,0,0,1.0,1,1.0,1,1.0,1,0.4277991419294793,65
3778,32,50622,50622,0,0,0,0,1.0,1,1.0,1,1.0,1,0.3510607029939031,65
3779,16,50638,50638,0,0,0,0,1.0,1,1.0,1,1.0,1,0.3444519597169647,65
3780,21,50659,50659,0,0,0,0,1.0,1,1.0,1,1.0,1,0.4061673155882497,64
3781,19,50678,50678,0,0,0,0,1.0,1,1.0,1,1.0,1,0.33663924522414485,64
3782,18,50696,50696,0,0,0,0,1.0,1,1.0,1,1.0,1,0.3402546319361472,67
3783,16,50712,50712,0,0,0,0,1.0,1,1.0,1,1.0,1,0.39797528672310467,65
3784,15,50727,50727,0,0,0,0,1.0,1,1.0,1,1.0,1,0.34915081107377016,65
3785,17,50744,50744,0,0,0,0,1.0,1,1.0,1,1.0,1,0.4108912780345503,63
3786,17,50761,50761,0,0,0,0,1.0,1,1.0,1,1.0,1,0.354901801494229,66
3787,16,50777,50777,0,0,0,0,1.0,1,1.0,1,1.0,1,0.33735942207378883,65
3788,14,50791,50791,0,0,0,0,1.0,1,1.0,1,1.0,1,0.358340506049963,65
3789,16,50807,50807,0,0,0,0,1.0,1,1.0,1,1.0,1,0.38125463896785317,65
3790,18,50825,50825,0,0,0,0,1.0,1,1.0,1,1.0,1,0.30735443321831035,64
3791,15,50840,50840,0,0,0,0,1.0,1,1.0,1,1.0,1,0.36183258567618104,64
3792,13,50853,50853,0,0,0,0,1.0,1,1.0,1,1.0,1,0.37683214810578336,65
3793,19,50872,50872,0,0,0,0,1.0,1,1.0,1,1.0,1,0.35563286396431343,68
3794,16,50888,50888,0,0,0,0,1.0,1,1.0,1,1.0,1,0.3345961939716999,68
3795,15,50903,50903,0,0,0,0,1.0,1,1.0,1,1.0,1,0.34509520142635147,69
3796,32,50935,50935,0,0,0,0,1.0,1,1.0,1,1.0,1,0.42802157112930633,69
3797,24,50959,50959,0,0,0,0,1.0,1,1.0,1,1.0,1,0.40465220897974963,70
3798,21,50980,50980,0,0,0,0,1.0,1,1.0,1,1.0,1,0.3931617772781638,70
3799,25,51005,51005,0,0,0,0,1.0,1,1.0,1,1.0,1,0.34569201004776967,69
3800,31,51036,51036,0,0,0,0,1.0,1,1.0,1,1.0,1,0.3679765120351435,69
3801,18,51054,51054,0,0,0,0,1.0,1,1.0,1,1.0,1,0.4248197266209642,67
3802,31,51085,51085,0,0,0,0,1.0,1,1.0,1,1.0,1,0.3766625493541352,67
3803,19,51104,51104,0,0,0,0,1.0,1,1.0,1,1.0,1,0.390147373124559,69
3804,29,51133,51133,0,0,0,0,1.0,1,1.0,1,1.0,1,0.3680010750483621,70
3805,31,51164,51164,0,0,0,0,1.0,1,1.0,1,1.0,1,0.3154722348829017,71
3806,28,51192,51192,0,0,0,0,1.0,1,1.0,1,1.0,1,0.3212881095227544,71
3807,29,51221,51221,0,0,0,0,1.0,1,1.0,1,1.0,1,0.2910855996825817,72
3808,15,51236,51236,0,0,0,0,1.0,1,1.0,1,1.0,1,0.22704581768382143,72
3809,13,51249,51249,0,0,0,0,1.0,1,1.0,1,1.0,1,0.29618259294978466,72
3810,14,51263,51263,0,0,0,0,1.0,1,1.0,1,1.0,1,0.28248273420145276,72
3811,15,51278,51278,0,0,0,0,1.0,1,1.0,1,1.0,1,0.2882107183286813,71
3812,12,51290,51290,0,0,0,0,1.0,1,1.0,1,1.0,1,0.2787588002153182,72
3813,13,51303,51303,0,0,0,0,1.0,1,1.0,1,1.0,1,0.2591271982953499,71
3814,16,51319,51319,0,0,0,0,1.0,1,1.0,1,1.0,1,0.30791997586969005,72
3815,17,51336,51336,0,0,0,0,1.0,1,1.0,1,1.0,1,0.2738482348501024,71
3816,13,51349,51349,0,0,0,0,1.0,1,1.0,1,1.0,1,0.30305967846705406,69
3817,16,51365,51365,0,0,0,0,1.0,1,1.0,1,1.0,1,0.34346878203379455,72
3818,27,51392,51392,0,0,0,0,1.0,1,1.0,1,1.0,1,0.35584764121388246,72
3819,12,51404,51404,0,0,0,0,1.0,1,1.0,1,1.0,1,0.3834807805344938,72
3820,16,51420,51420,0,0,0,0,1.0,1,1.0,1,1.0,1,0.3392641550997178,72
3821,16,51436,51436,0,0,0,0,1.0,1,1.0,1,1.0,1,0.3270107192723387,72
3822,13,51449,51449,0,0,0,0,1.0,1,1.0,1,1.0,1,0.30684039018313825,69
3823,21,51470,51470,0,0,0,0,1.0,1,1.0,1,1.0,1,0.34649974014863455,69
3824,15,51485,51485,0,0,0,0,1.0,1,1.0,1,1.0,1,0.3475014886132708,65
3825,12,51497,51497,0,0,0,0,1.0,1,1.0,1,1.0,1,0.3673506667726373,64
3826,24,51521,51521,0,0,0,0,1.0,1,1.0,1,1.0,1,0.3709242237824535,65
3827,26,51547,51547,0,0,0,0,1.0,1,1.0,1,1.0,1,0.29681238357749806,64
3828,16,51563,51563,0,0,0,0,1.0,1,1.0,1,1.0,1,0.3462102831938736,65
3829,30,51593,51593,0,0,0,0,1.0,1,1.0,1,1.0,1,0.2769126908987229,65
3830,34,51627,51627,0,0,0,0,1.0,1,1.0,1,1.0,1,0.31202448306260183,64
3831,47,51674,51674,0,0,0,0,1.0,1,1.0,1,1.0,1,0.3535487413295578,63
3832,28,51702,51702,0,0,0,0,1.0,1,1.0,1,1.0,1,0.4176339423958804,64
3833,25,51727,51727,0,0,0,0,1.0,1,1.0,1,1.0,1,0.44462594433745595,64
3834,21,51748,51748,0,0,0,0,1.0,1,1.0,1,1.0,1,0.38579346172514484,63
3835,20,51768,51768,0,0,0,0,1.0,1,1.0,1,1.0,1,0.35608727801716755,63
3836,34,51802,51802,0,0,0,0,1.0,1,1.0,1,1.0,1,0.340354147894474,63
3837,22,51824,51824,0,0,0,0,1.0,1,1.0,1,1.0,1,0.27262782137367203,62
3838,28,51852,51852,0,0,0,0,1.0,1,1.0,1,1.0,1,0.3155167417145133,62
3839,24,51876,51876,0,0,0,0,1.0,1,1.0,1,1.0,1,0.3693848811190699,60
3840,14,51890,51890,0,0,0,0,1.0,1,1.0,1,1.0,1,0.3017444097604222,62
3841,13,51903,51903,0,0,0,0,1.0,1,1.0,1,1.0,1,0.34817748084259914,62
3842,27,51930,51930,0,0,0,0,1.0,1,1.0,1,1.0,1,0.27401576559174257,63
3843,19,51949,51949,0,0,0,0,1.0,1,1.0,1,1.0,1,0.32447110184808264,64
3844,17,51966,51966,0,0,0,0,1.0,1,1.0,1,1.0,1,0.2816417753787706,65
3845,28,51994,51994,0,0,0,0,1.0,1,1.0,1,1.0,1,0.3310553689855102,66
3846,20,52014,52014,0,0,0,0,1.0,1,1.0,1,1.0,1,0.34229166050313314,67
3847,23,52037,52037,0,0,0,0,1.0,1,1.0,1,1.0,1,0.27026806834153316,67
3848,28,52065,52065,0,0,0,0,1.0,1,1.0,1,1.0,1,0.27133866835707393,67
3849,16,52081,52081,0,0,0,0,1.0,1,1.0,1,1.0,1,0.258883028860487,67
3850,15,52096,52096,0,0,0,0,1.0,1,1.0,1,1.0,1,0.2784144866682887,68
3851,14,52110,52110,0,0,0,0,1.0,1,1.0,1,1.0,1,0.2940782992846265,68
3852,24,52134,52134,0,0,0,0,1.0,1,1.0,1,1.0,1,0.3156965321120613,70
3853,13,52147,52147,0,0,0,0,1.0,1,1.0,1,1.0,1,0.3315707747562659,70
3854,16,52163,52163,0,0,0,0,1.0,1,1.0,1,1.0,1,0.34985955830546844,70
3855,16,52179,52179,0,0,0,0,1.0,1,1.0,1,1.0,1,0.33531706675639483,69
3856,25,52204,52204,0,0,0,0,1.0,1,1.0,1,1.0,1,0.32194547624200953,70
3857,9,52213,52213,0,0,0,0,1.0,1,1.0,1,1.0,1,0.3348911471888575,68
3858,21,52234,52234,0,0,0,0,1.0,1,1.0,1,1.0,1,0.3369391112238782,67
3859,18,52252,52252,0,0,0,0,1.0,1,1.0,1,1.0,1,0.3323703623550475,66
3860,15,52267,52267,0,0,0,0,1.0,1,1.0,1,1.0,1,0.3834258508967625,66
3861,22,52289,52289,0,0,0,0,1.0,1,1.0,1,1.0,1,0.3699270397012307,66
3862,22,52311,52311,0,0,0,0,1.0,1,1.0,1,1.0,1,0.3581262984773323,66
3863,35,52346,52346,0,0,0,0,1.0,1,1.0,1,1.0,1,0.38863292812563927,63
3864,15,52361,52361,0,0,0,0,1.0,1,1.0,1,1.0,1,0.3979365669452349,63
3865,38,52399,52399,0,0,0,0,1.0,1,1.0,1,1.0,1,0.4342348966452263,61
3866,19,52418,52418,0,0,0,0,1.0,1,1.0,1,1.0,1,0.40417733901669317,61
3867,21,52439,52439,0,0,0,0,1.0,1,1.0,1,1.0,1,0.3182436511180576,60
3868,20,52459,52459,0,0,0,0,1.0,1,1.0,1,1.0,1,0.3703531102871869,59
3869,18,52477,52477,0,0,0,0,1.0,1,1.0,1,1.0,1,0.40363548273482336,61
3870,32,52509,52509,0,0,0,0,1.0,1,1.0,1,1.0,1,0.37349959115202835,61
3871,21,52530,52530,0,0,0,0,1.0,1,1.0,1,1.0,1,0.22477887412019146,64
3872,22,52552,52552,0,0,0,0,1.0,1,1.0,1,1.0,1,0.319297933197548,63
3873,26,52578,52578,0,0,0,0,1.0,1,1.0,1,1.0,1,0.31166009673735545,62
3874,30,52608,52608,0,0,0,0,1.0,1,1.0,1,1.0,1,0.21487067365231596,63
3875,19,52627,52627,0,0,0,0,1.0,1,1.0,1,1.0,1,0.357334049397751,61
3876,13,52640,52640,0,0,0,0,1.0,1,1.0,1,1.0,1,0.3069066134530474,62
3877,21,52661,52661,0,0,0,0,1.0,1,1.0,1,1.0,1,0.41924594593766357,63
3878,15,52676,52676,0,0,0,0,1.0,1,1.0,1,1.0,1,0.21986935988715234,63
3879,20,52696,52696,0,0,0,0,1.0,1,1.0,1,1.0,1,0.34120820165453636,63
3880,23,52719,52719,0,0,0,0,1.0,1,1.0,1,1.0,1,0.31365851639904696,65
3881,30,52749,52749,0,0,0,0,1.0,1,1.0,1,1.0,1,0.4053514184835191,65
3882,26,52775,52775,0,0,0,0,1.0,1,1.0,1,1.0,1,0.3203967489111635,66
3883,23,52798,52798,0,0,0,0,1.0,1,1.0,1,1.0,1,0.43147697496407894,66
3884,28,52826,52826,0,0,0,0,1.0,1,1.0,1,1.0,1,0.36315907207270837,66
3885,13,52839,52839,0,0,0,0,1.0,1,1.0,1,1.0,1,0.37408010151209314,66
3886,19,52858,52858,0,0,0,0,1.0,1,1.0,1,1.0,1,0.4560886950337287,65
3887,31,52889,52889,0,0,0,0,1.0,1,1.0,1,1.0,1,0.36687280140792655,65
3888,33,52922,52922,0,0,0,0,1.0,1,1.0,1,1.0,1,0.3923328894334069,66
3889,25,52947,52947,0,0,0,0,1.0,1,1.0,1,1.0,1,0.37650130187869785,64
3890,18,52965,52965,0,0,0,0,1.0,1,1.0,1,1.0,1,0.375650846444672,63
3891,24,52989,52989,0,0,0,0,1.0,1,1.0,1,1.0,1,0.35614221150510605,66
3892,40,53029,53029,0,0,0,0,1.0,1,1.0,1,1.0,1,0.32486667106270334,67
3893,21,53050,53050,0,0,0,0,1.0,1,1.0,1,1.0,1,0.30229121544806653,66
3894,30,53080,53080,0,0,0,0,1.0,1,1.0,1,1.0,1,0.29248055480432195,67
3895,23,53103,53103,0,0,0,0,1.0,1,1.0,1,1.0,1,0.3392834665918292,66
3896,38,53141,53141,0,0,0,0,1.0,1,1.0,1,1.0,1,0.41465372727028327,66
3897,36,53177,53177,0,0,0,0,1.0,1,1.0,1,1.0,1,0.3132498726644736,65
3898,28,53205,53205,0,0,0,0,1.0,1,1.0,1,1.0,1,0.42082529919090234,65
3899,22,53227,53227,0,0,0,0,1.0,1,1.0,1,1.0,1,0.3930019896619699,64
3900,25,53252,53252,0,0,0,0,1.0,1,1.0,1,1.0,1,0.23201686493695275,63
3901,32,53284,53284,0,0,0,0,1.0,1,1.0,1,1.0,1,0.4127266012111977,63
3902,26,53310,53310,0,0,0,0,1.0,1,1.0,1,1.0,1,0.3065483367822964,64
3903,30,53340,53340,0,0,0,0,1.0,1,1.0,1,1.0,1,0.3220343615531963,64
3904,35,53375,53375,0,0,0,0,1.0,1,1.0,1,1.0,1,0.32680129475672987,63
3905,41,53416,53416,0,0,0,0,1.0,1,1.0,1,1.0,1,0.28615118865886247,63
3906,34,53450,53450,0,0,0,0,1.0,1,1.0,1,1.0,1,0.2796470016614483,64
3907,24,53474,53474,0,0,0,0,1.0,1,1.0,1,1.0,1,0.31315741445971695,64
3908,25,53499,53499,0,0,0,0,1.0,1,1.0,1,1.0,1,0.30824653264914176,63
3909,34,53533,53533,0,0,0,0,1.0,1,1.0,1,1.0,1,0.35456760567172907,62
3910,27,53560,53560,0,0,0,0,1.0,1,1.0,1,1.0,1,0.34054186590672914,62
3911,27,53587,53587,0,0,0,0,1.0,1,1.0,1,1.0,1,0.37242881984072773,64
3912,35,53622,53622,0,0,0,0,1.0,1,1.0,1,1.0,1,0.3662003616562057,64
3913,17,53639,53639,0,0,0,0,1.0,1,1.0,1,1.0,1,0.38282464366022206,65
3914,43,53682,53682,0,0,0,0,1.0,1,1.0,1,1.0,1,0.47375350304724745,65
3915,15,53697,53697,0,0,0,0,1.0,1,1.0,1,1.0,1,0.38524082471324367,66
3916,24,53721,53721,0,0,0,0,1.0,1,1.0,1,1.0,1,0.4333736002608487,66
3917,35,53756,53756,0,0,0,0,1.0,1,1.0,1,1.0,1,0.4270318974752377,66
3918,22,53778,53778,0,0,0,0,1.0,1,1.0,1,1.0,1,0.420749722906159,67
3919,21,53799,53799,0,0,0,0,1.0,1,1.0,1,1.0,1,0.33890908087453564,68
3920,33,53832,53832,0,0,0,0,1.0,1,1.0,1,1.0,1,0.4157399345065381,69
3921,26,53858,53858,0,0,0,0,1.0,1,1.0,1,1.0,1,0.3270975777242696,68
3922,30,53888,53888,0,0,0,0,1.0,1,1.0,1,1.0,1,0.35209987353224315,68
3923,25,53913,53913,0,0,0,0,1.0,1,1.0,1,1.0,1,0.41974042937913847,69
3924,36,53949,53949,0,0,0,0,1.0,1,1.0,1,1.0,1,0.384791191402448,69
3925,23,53972,53972,0,0,0,0,1.0,1,1.0,1,1.0,1,0.4433868624249826,67
3926,37,54009,54009,0,0,0,0,1.0,1,1.0,1,1.0,1,0.36453396021579915,67
3927,29,54038,54038,0,0,0,0,1.0,1,1.0,1,1.0,1,0.45502098050117906,65
3928,27,54065,54065,0,0,0,0,1.0,1,1.0,1,1.0,1,0.31848441694026014,65
3929,35,54100,54100,0,0,0,0,1.0,1,1.0,1,1.0,1,0.39617288414659274,64
3930,38,54138,54138,0,0,0,0,1.0,1,1.0,1,1.0,1,0.4001645133454515,64
3931,55,54193,54193,0,0,0,0,1.0,1,1.0,1,1.0,1,0.3993205987230503,62
3932,30,54223,54223,0,0,0,0,1.0,1,1.0,1,1.0,1,0.3485890641583063,62
3933,35,54258,54258,0,0,0,0,1.0,1,1.0,1,1.0,1,0.4150956238318147,62
3934,16,54274,54274,0,0,0,0,1.0,1,1.0,1,1.0,1,0.40339810524272135,61
3935,28,54302,54302,0,0,0,0,1.0,1,1.0,1,1.0,1,0.3627323986220715,64
3936,29,54331,54331,0,0,0,0,1.0,1,1.0,1,1.0,1,0.3900304933643765,65
3937,24,54355,54355,0,0,0,0,1.0,1,1.0,1,1.0,1,0.3396622043107735,66
3938,23,54378,54378,0,0,0,0,1.0,1,1.0,1,1.0,1,0.41054916786799694,66
3939,27,54405,54405,0,0,0,0,1.0,1,1.0,1,1.0,1,0.37359254506466316,67
3940,23,54428,54428,0,0,0,0,1.0,1,1.0,1,1.0,1,0.40066247215248085,69
3941,19,54447,54447,0,0,0,0,1.0,1,1.0,1,1.0,1,0.32715368402134515,69
3942,26,54473,54473,0,0,0,0,1.0,1,1.0,1,1.0,1,0.2842406700778259,69
3943,38,54511,54511,0,0,0,0,1.0,1,1.0,1,1.0,1,0.36892719012672825,68
3944,30,54541,54541,0,0,0,0,1.0,1,1.0,1,1.0,1,0.3528874777901006,68
3945,25,54566,54566,0,0,0,0,1.0,1,1.0,1,1.0,1,0.2766580345050415,67
3946,39,54605,54605,0,0,0,0,1.0,1,1.0,1,1.0,1,0.3902016596248267,67
3947,16,54621,54621,0,0,0,0,1.0,1,1.0,1,1.0,1,0.41732672920575653,66
3948,29,54650,54650,0,0,0,0,1.0,1,1.0,1,1.0,1,0.36358081514463236,67
3949,19,54669,54669,0,0,0,0,1.0,1,1.0,1,1.0,1,0.37880735826265893,66
3950,33,54702,54702,0,0,0,0,1.0,1,1.0,1,1.0,1,0.3727908950929526,65
3951,26,54728,54728,0,0,0,0,1.0,1,1.0,1,1.0,1,0.3814004255254143,65
3952,28,54756,54756,0,0,0,0,1.0,1,1.0,1,1.0,1,0.3782885186021269,65
3953,17,54773,54773,0,0,0,0,1.0,1,1.0,1,1.0,1,0.3846508799371926,65
3954,27,54800,54800,0,0,0,0,1.0,1,1.0,1,1.0,1,0.37898870286595693,64
3955,19,54819,54819,0,0,0,0,1.0,1,1.0,1,1.0,1,0.33133626891660073,64
3956,21,54840,54840,0,0,0,0,1.0,1,1.0,1,1.0,1,0.4395290962098339,63
3957,15,54855,54855,0,0,0,0,1.0,1,1.0,1,1.0,1,0.42323954488359533,63
3958,20,54875,54875,0,0,0,0,1.0,1,1.0,1,1.0,1,0.40064404733518744,63
3959,33,54908,54908,0,0,0,0,1.0,1,1.0,1,1.0,1,0.4674830968780066,62
3960,24,54932,54932,0,0,0,0,1.0,1,1.0,1,1.0,1,0.4010090264250625,62
3961,32,54964,54964,0,0,0,0,1.0,1,1.0,1,1.0,1,0.4503568747152019,64
3962,15,54979,54979,0,0,0,0,1.0,1,1.0,1,1.0,1,0.42818400598348205,64
3963,26,55005,55005,0,0,0,0,1.0,1,1.0,1,1.0,1,0.39466201881901614,62
3964,13,55018,55018,0,0,0,0,1.0,1,1.0,1,1.0,1,0.38437214214235643,63
3965,33,55051,55051,0,0,0,0,1.0,1,1.0,1,1.0,1,0.4305218525918817,63
3966,16,55067,55067,0,0,0,0,1.0,1,1.0,1,1.0,1,0.33945441714430286,62
3967,22,55089,55089,0,0,0,0,1.0,1,1.0,1,1.0,1,0.3494453307431698,64
3968,21,55110,55110,0,0,0,0,1.0,1,1.0,1,1.0,1,0.4029912898747242,63
3969,16,55126,55126,0,0,0,0,1.0,1,1.0,1,1.0,1,0.4226698702851811,63
3970,29,55155,55155,0,0,0,0,1.0,1,1.0,1,1.0,1,0.4264801819128224,65
3971,22,55177,55177,0,0,0,0,1.0,1,1.0,1,1.0,1,0.3868171431341569,65
3972,22,55199,55199,0,0,0,0,1.0,1,1.0,1,1.0,1,0.3881618963842335,66
3973,24,55223,55223,0,0,0,0,1.0,1,1.0,1,1.0,1,0.3825181424014159,66
3974,27,55250,55250,0,0,0,0,1.0,1,1.0,1,1.0,1,0.31926823215427397,66
3975,27,55277,55277,0,0,0,0,1.0,1,1.0,1,1.0,1,0.3943988665629902,66
3976,15,55292,55292,0,0,0,0,1.0,1,1.0,1,1.0,1,0.37498574324390127,66
3977,30,55322,55322,0,0,0,0,1.0,1,1.0,1,1.0,1,0.35865592212118036,64
3978,37,55359,55359,0,0,0,0,1.0,1,1.0,1,1.0,1,0.4344968653498864,63
3979,15,55374,55374,0,0,0,0,1.0,1,1.0,1,1.0,1,0.2954235581588526,63
3980,32,55406,55406,0,0,0,0,1.0,1,1.0,1,1.0,1,0.3541837467147773,63
3981,21,55427,55427,0,0,0,0,1.0,1,1.0,1,1.0,1,0.3968287521723584,64
3982,37,55464,55464,0,0,0,0,1.0,1,1.0,1,1.0,1,0.37475800817548427,65
3983,32,55496,55496,0,0,0,0,1.0,1,1.0,1,1.0,1,0.3476410663977156,64
3984,19,55515,55515,0,0,0,0,1.0,1,1.0,1,1.0,1,0.3712934798586279,65
3985,21,55536,55536,0,0,0,0,1.0,1,1.0,1,1.0,1,0.36265996157391195,64
3986,18,55554,55554,0,0,0,0,1.0,1,1.0,1,1.0,1,0.32856310094268687,63
3987,17,55571,55571,0,0,0,0,1.0,1,1.0,1,1.0,1,0.4005560055815584,63
3988,27,55598,55598,0,0,0,0,1.0,1,1.0,1,1.0,1,0.3112673432593464,63
3989,16,55614,55614,0,0,0,0,1.0,1,1.0,1,1.0,1,0.33880496786138814,63
3990,14,55628,55628,0,0,0,0,1.0,1,1.0,1,1.0,1,0.35596298339520205,62
3991,18,55646,55646,0,0,0,0,1.0,1,1.0,1,1.0,1,0.2782814655099725,62
3992,29,55675,55675,0,0,0,0,1.0,1,1.0,1,1.0,1,0.31762455674860307,65
3993,13,55688,55688,0,0,0,0,1.0,1,1.0,1,1.0,1,0.3687435115088693,65
3994,22,55710,55710,0,0,0,0,1.0,1,1.0,1,1.0,1,0.37373870599843334,64
3995,44,55754,55754,0,0,0,0,1.0,1,1.0,1,1.0,1,0.26235028478483363,64
3996,19,55773,55773,0,0,0,0,1.0,1,1.0,1,1.0,1,0.3729005235752881,67
3997,29,55802,55802,0,0,0,0,1.0,1,1.0,1,1.0,1,0.3607416889965423,69
3998,20,55822,55822,0,0,0,0,1.0,1,1.0,1,1.0,1,0.3350178159313467,69
3999,29,55851,55851,0,0,0,0,1.0,1,1.0,1,1.0,1,0.3773201372452188,69
4000,18,55869,55869,0,0,0,0,1.0,1,1.0,1,1.0,1,0.3033599855651103,69
4001,28,55897,55897,0,0,0,0,1.0,1,1.0,1,1.0,1,0.3260864399134978,68
4002,32,55929,55929,0,0,0,0,1.0,1,1.0,1,1.0,1,0.3418303343512797,68
4003,23,55952,55952,0,0,0,0,1.0,1,1.0,1,1.0,1,0.3099615395195492,68
4004,24,55976,55976,0,0,0,0,1.0,1,1.0,1,1.0,1,0.34325992768964864,67
4005,16,55992,55992,0,0,0,0,1.0,1,1.0,1,1.0,1,0.4006976246400284,67
4006,25,56017,56017,0,0,0,0,1.0,1,1.0,1,1.0,1,0.4221686080123702,67
4007,39,56056,56056,0,0,0,0,1.0,1,1.0,1,1.0,1,0.37966324628971737,67
4008,26,56082,56082,0,0,0,0,1.0,1,1.0,1,1.0,1,0.45556816277056,67
4009,21,56103,56103,0,0,0,0,1.0,1,1.0,1,1.0,1,0.3731059463781135,67
4010,44,56147,56147,0,0,0,0,1.0,1,1.0,1,1.0,1,0.4658322231195477,66
4011,22,56169,56169,0,0,0,0,1.0,1,1.0,1,1.0,1,0.3073885857579037,66
4012,25,56194,56194,0,0,0,0,1.0,1,1.0,1,1.0,1,0.3889957281240734,66
4013,25,56219,56219,0,0,0,0,1.0,1,1.0,1,1.0,1,0.3976237270483651,66
4014,26,56245,56245,0,0,0,0,1.0,1,1.0,1,1.0,1,0.31940288983441006,66
4015,28,56273,56273,0,0,0,0,1.0,1,1.0,1,1.0,1,0.31815848533869273,64
4016,16,56289,56289,0,0,0,0,1.0,1,1.0,1,1.0,1,0.4232098687921139,64
4017,18,56307,56307,0,0,0,0,1.0,1,1.0,1,1.0,1,0.4158857933687743,66
4018,17,56324,56324,0,0,0,0,1.0,1,1.0,1,1.0,1,0.3856613985268885,67
4019,23,56347,56347,0,0,0,0,1.0,1,1.0,1,1.0,1,0.38731891490015874,67
4020,23,56370,56370,0,0,0,0,1.0,1,1.0,1,1.0,1,0.3593675863094095,66
4021,25,56395,56395,0,0,0,0,1.0,1,1.0,1,1.0,1,0.35781692805045173,66
4022,23,56418,56418,0,0,0,0,1.0,1,1.0,1,1.0,1,0.4044097383991658,66
4023,12,56430,56430,0,0,0,0,1.0,1,1.0,1,1.0,1,0.3791613538910866,66
4024,25,56455,56455,0,0,0,0,1.0,1,1.0,1,1.0,1,0.3995785468125926,66
4025,36,56491,56491,0,0,0,0,1.0,1,1.0,1,1.0,1,0.3730197587519216,66
4026,24,56515,56515,0,0,0,0,1.0,1,1.0,1,1.0,1,0.39128677743719775,66
4027,15,56530,56530,0,0,0,0,1.0,1,1.0,1,1.0,1,0.42614103672006165,64
4028,27,56557,56557,0,0,0,0,1.0,1,1.0,1,1.0,1,0.34983660662133265,63
4029,19,56576,56576,0,0,0,0,1.0,1,1.0,1,1.0,1,0.40471123975551926,62
4030,24,56600,56600,0,0,0,0,1.0,1,1.0,1,1.0,1,0.45864537923884346,63
4031,20,56620,56620,0,0,0,0,1.0,1,1.0,1,1.0,1,0.43608437375456643,62
4032,17,56637,56637,0,0,0,0,1.0,1,1.0,1,1.0,1,0.44855184768062767,62
4033,12,56649,56649,0,0,0,0,1.0,1,1.0,1,1.0,1,0.44542598196687666,61
4034,19,56668,56668,0,0,0,0,1.0,1,1.0,1,1.0,1,0.4535716049750336,60
4035,19,56687,56687,0,0,0,0,1.0,1,1.0,1,1.0,1,0.4508017536820252,59
4036,19,56706,56706,0,0,0,0,1.0,1,1.0,1,1.0,1,0.45419223077875354,58
4037,14,56720,56720,0,0,0,0,1.0,1,1.0,1,1.0,1,0.457296080580464,59
4038,15,56735,56735,0,0,0,0,1.0,1,1.0,1,1.0,1,0.47987579528139723,58
4039,14,56749,56749,0,0,0,0,1.0,1,1.0,1,1.0,1,0.5490610011504096,56
4040,22,56771,56771,0,0,0,0,1.0,1,1.0,1,1.0,1,0.43770191259087604,55
4041,20,56791,56791,0,0,0,0,1.0,1,1.0,1,1.0,1,0.5071000657718125,54
4042,14,56805,56805,0,0,0,0,1.0,1,1.0,1,1.0,1,0.4534580531076767,56
4043,21,56826,56826,0,0,0,0,1.0,1,1.0,1,1.0,1,0.5298480947087219,56
4044,14,56840,56840,0,0,0,0,1.0,1,1.0,1,1.0,1,0.4377385612595537,56
4045,20,56860,56860,0,0,0,0,1.0,1,1.0,1,1.0,1,0.4668052225904243,57
4046,20,56880,56880,0,0,0,0,1.0,1,1.0,1,1.0,1,0.508220379175842,59
4047,22,56902,56902,0,0,0,0,1.0,1,1.0,1,1.0,1,0.46986962254158005,59
4048,20,56922,56922,0,0,0,0,1.0,1,1.0,1,1.0,1,0.432529206534775,59
4049,17,56939,56939,0,0,0,0,1.0,1,1.0,1,1.0,1,0.43663678954410146,60
4050,21,56960,56960,0,0,0,0,1.0,1,1.0,1,1.0,1,0.5706977924461015,60
4051,14,56974,56974,0,0,0,0,1.0,1,1.0,1,1.0,1,0.5185755784752752,60
4052,13,56987,56987,0,0,0,0,1.0,1,1.0,1,1.0,1,0.42853489977688247,60
4053,19,57006,57006,0,0,0,0,1.0,1,1.0,1,1.0,1,0.47266814952790515,60
4054,14,57020,57020,0,0,0,0,1.0,1,1.0,1,1.0,1,0.5137180119034891,61
4055,16,57036,57036,0,0,0,0,1.0,1,1.0,1,1.0,1,0.38743912902944744,61
4056,21,57057,57057,0,0,0,0,1.0,1,1.0,1,1.0,1,0.5089670754727059,62
4057,32,57089,57089,0,0,0,0,1.0,1,1.0,1,1.0,1,0.4670031928443825,63
4058,27,57116,57116,0,0,0,0,1.0,1,1.0,1,1.0,1,0.4382383726079104,64
4059,18,57134,57134,0,0,0,0,1.0,1,1.0,1,1.0,1,0.49172595280037473,63
4060,17,57151,57151,0,0,0,0,1.0,1,1.0,1,1.0,1,0.3869508787736754,63
4061,12,57163,57163,0,0,0,0,1.0,1,1.0,1,1.0,1,0.4667389412929758,63
4062,16,57179,57179,0,0,0,0,1.0,1,1.0,1,1.0,1,0.4772246731545486,65
4063,18,57197,57197,0,0,0,0,1.0,1,1.0,1,1.0,1,0.4434763674259109,64
4064,27,57224,57224,0,0,0,0,1.0,1,1.0,1,1.0,1,0.41846343639965483,65
4065,29,57253,57253,0,0,0,0,1.0,1,1.0,1,1.0,1,0.5398167123774849,64
4066,19,57272,57272,0,0,0,0,1.0,1,1.0,1,1.0,1,0.3917100003452931,64
4067,28,57300,57300,0,0,0,0,1.0,1,1.0,1,1.0,1,0.37915725006665896,63
4068,20,57320,57320,0,0,0,0,1.0,1,1.0,1,1.0,1,0.38779284500714495,64
4069,37,57357,57357,0,0,0,0,1.0,1,1.0,1,1.0,1,0.32432608978703464,62
4070,19,57376,57376,0,0,0,0,1.0,1,1.0,1,1.0,1,0.2967510089222311,61
4071,32,57408,57408,0,0,0,0,1.0,1,1.0,1,1.0,1,0.3481933156464603,61
4072,29,57437,57437,0,0,0,0,1.0,1,1.0,1,1.0,1,0.2346579728954843,60
4073,18,57455,57455,0,0,0,0,1.0,1,1.0,1,1.0,1,0.3669782121360952,60
4074,13,57468,57468,0,0,0,0,1.0,1,1.0,1,1.0,1,0.37368970842863075,60
4075,17,57485,57485,0,0,0,0,1.0,1,1.0,1,1.0,1,0.3617033990151089,59
4076,29,57514,57514,0,0,0,0,1.0,1,1.0,1,1.0,1,0.40179191835631894,60
4077,31,57545,57545,0,0,0,0,1.0,1,1.0,1,1.0,1,0.3974667305532254,61
4078,14,57559,57559,0,0,0,0,1.0,1,1.0,1,1.0,1,0.37102259582817504,60
4079,12,57571,57571,0,0,0,0,1.0,1,1.0,1,1.0,1,0.33299986017929073,58
4080,15,57586,57586,0,0,0,0,1.0,1,1.0,1,1.0,1,0.37862384224611245,56
4081,30,57616,57616,0,0,0,0,1.0,1,1.0,1,1.0,1,0.4590171034551342,56
4082,20,57636,57636,0,0,0,0,1.0,1,1.0,1,1.0,1,0.4768400688459982,55
4083,28,57664,57664,0,0,0,0,1.0,1,1.0,1,1.0,1,0.40336953826375627,55
4084,15,57679,57679,0,0,0,0,1.0,1,1.0,1,1.0,1,0.483407017872896,55
4085,21,57700,57700,0,0,0,0,1.0,1,1.0,1,1.0,1,0.38645002977964227,56
4086,21,57721,57721,0,0,0,0,1.0,1,1.0,1,1.0,1,0.32977953794663845,57
4087,15,57736,57736,0,0,0,0,1.0,1,1.0,1,1.0,1,0.3946258762978797,57
4088,25,57761,57761,0,0,0,0,1.0,1,1.0,1,1.0,1,0.32367013101612246,57
4089,10,57771,57771,0,0,0,0,1.0,1,1.0,1,1.0,1,0.40156159120491314,56
4090,13,57784,57784,0,0,0,0,1.0,1,1.0,1,1.0,1,0.29731095235474453,56
4091,19,57803,57803,0,0,0,0,1.0,1,1.0,1,1.0,1,0.40740148702899975,56
4092,16,57819,57819,0,0,0,0,1.0,1,1.0,1,1.0,1,0.34190703733987426,57
4093,25,57844,57844,0,0,0,0,1.0,1,1.0,1,1.0,1,0.4252641528427547,58
4094,32,57876,57876,0,0,0,0,1.0,1,1.0,1,1.0,1,0.28112788638890457,57
4095,26,57902,57902,0,0,0,0,1.0,1,1.0,1,1.0,1,0.28311534897896207,57
4096,32,57934,57934,0,0,0,0,1.0,1,1.0,1,1.0,1,0.3550588184361451,59
4097,20,57954,57954,0,0,0,0,1.0,1,1.0,1,1.0,1,0.290937911152335,59
4098,25,57979,57979,0,0,0,0,1.0,1,1.0,1,1.0,1,0.28752146727665634,59
4099,17,57996,57996,0,0,0,0,1.0,1,1.0,1,1.0,1,0.32345248791186854,60
4100,18,58014,58014,0,0,0,0,1.0,1,1.0,1,1.0,1,0.3674556617595046,60
4101,17,58031,58031,0,0,0,0,1.0,1,1.0,1,1.0,1,0.27744549774923205,60
4102,11,58042,58042,0,0,0,0,1.0,1,1.0,1,1.0,1,0.35049958559472716,60
4103,27,58069,58069,0,0,0,0,1.0,1,1.0,1,1.0,1,0.28272549009151504,58
4104,17,58086,58086,0,0,0,0,1.0,1,1.0,1,1.0,1,0.35935690390697395,60
4105,18,58104,58104,0,0,0,0,1.0,1,1.0,1,1.0,1,0.3150413516662799,59
4106,22,58126,58126,0,0,0,0,1.0,1,1.0,1,1.0,1,0.39224417033276415,61
4107,23,58149,58149,0,0,0,0,1.0,1,1.0,1,1.0,1,0.3848624101522261,59
4108,19,58168,58168,0,0,0,0,1.0,1,1.0,1,1.0,1,0.3738331230632497,60
4109,26,58194,58194,0,0,0,0,1.0,1,1.0,1,1.0,1,0.3263511466886739,59
4110,26,58220,58220,0,0,0,0,1.0,1,1.0,1,1.0,1,0.37067500317175,60
4111,17,58237,58237,0,0,0,0,1.0,1,1.0,1,1.0,1,0.3647673227766651,61
4112,12,58249,58249,0,0,0,0,1.0,1,1.0,1,1.0,1,0.29120940749438223,60
4113,24,58273,58273,0,0,0,0,1.0,1,1.0,1,1.0,1,0.3453750919858516,61
4114,19,58292,58292,0,0,0,0,1.0,1,1.0,1,1.0,1,0.3436251550564392,62
4115,23,58315,58315,0,0,0,0,1.0,1,1.0,1,1.0,1,0.4106480140927437,60
4116,13,58328,58328,0,0,0,0,1.0,1,1.0,1,1.0,1,0.3483757321000706,59
4117,21,58349,58349,0,0,0,0,1.0,1,1.0,1,1.0,1,0.32508211949074156,56
4118,20,58369,58369,0,0,0,0,1.0,1,1.0,1,1.0,1,0.416848653717791,55
4119,28,58397,58397,0,0,0,0,1.0,1,1.0,1,1.0,1,0.32935816596166634,53
4120,20,58417,58417,0,0,0,0,1.0,1,1.0,1,1.0,1,0.3958080334532867,52
4121,21,58438,58438,0,0,0,0,1.0,1,1.0,1,1.0,1,0.22045964648632957,53
4122,14,58452,58452,0,0,0,0,1.0,1,1.0,1,1.0,1,0.3265664803549109,52
4123,16,58468,58468,0,0,0,0,1.0,1,1.0,1,1.0,1,0.17587985529664277,51
4124,25,58493,58493,0,0,0,0,1.0,1,1.0,1,1.0,1,0.2930140463565262,51
4125,23,58516,58516,0,0,0,0,1.0,1,1.0,1,1.0,1,0.3051148061819565,50
4126,26,58542,58542,0,0,0,0,1.0,1,1.0,1,1.0,1,0.2687220451733767,50
4127,20,58562,58562,0,0,0,0,1.0,1,1.0,1,1.0,1,0.2681005115026086,49
4128,22,58584,58584,0,0,0,0,1.0,1,1.0,1,1.0,1,0.3123453674102992,49
4129,17,58601,58601,0,0,0,0,1.0,1,1.0,1,1.0,1,0.2524252232496808,49
4130,16,58617,58617,0,0,0,0,1.0,1,1.0,1,1.0,1,0.3794007127308008,50
4131,20,58637,58637,0,0,0,0,1.0,1,1.0,1,1.0,1,0.34962523120550715,50
4132,26,58663,58663,0,0,0,0,1.0,1,1.0,1,1.0,1,0.3643380269384202,50
4133,21,58684,58684,0,0,0,0,1.0,1,1.0,1,1.0,1,0.34593684260047086,51
4134,21,58705,58705,0,0,0,0,1.0,1,1.0,1,1.0,1,0.2943633204434737,53
4135,19,58724,58724,0,0,0,0,1.0,1,1.0,1,1.0,1,0.3921244433679405,54
4136,18,58742,58742,0,0,0,0,1.0,1,1.0,1,1.0,1,0.3924700175293446,54
4137,16,58758,58758,0,0,0,0,1.0,1,1.0,1,1.0,1,0.37726557161531116,55
4138,30,58788,58788,0,0,0,0,1.0,1,1.0,1,1.0,1,0.4462989943286768,54
4139,22,58810,58810,0,0,0,0,1.0,1,1.0,1,1.0,1,0.4254722633227803,54
4140,20,58830,58830,0,0,0,0,1.0,1,1.0,1,1.0,1,0.4592803531703863,55
4141,22,58852,58852,0,0,0,0,1.0,1,1.0,1,1.0,1,0.45125208283307666,55
4142,21,58873,58873,0,0,0,0,1.0,1,1.0,1,1.0,1,0.4695763595683392,55
4143,22,58895,58895,0,0,0,0,1.0,1,1.0,1,1.0,1,0.5011145037883957,53
4144,21,58916,58916,0,0,0,0,1.0,1,1.0,1,1.0,1,0.4074665715567456,52
4145,27,58943,58943,0,0,0,0,1.0,1,1.0,1,1.0,1,0.4141345553921865,51
4146,18,58961,58961,0,0,0,0,1.0,1,1.0,1,1.0,1,0.3699999002269549,51
4147,16,58977,58977,0,0,0,0,1.0,1,1.0,1,1.0,1,0.4108201896328112,50
4148,18,58995,58995,0,0,0,0,1.0,1,1.0,1,1.0,1,0.3984353692988227,52
4149,16,59011,59011,0,0,0,0,1.0,1,1.0,1,1.0,1,0.3051283815940993,53
4150,11,59022,59022,0,0,0,0,1.0,1,1.0,1,1.0,1,0.389934065525337,53
4151,14,59036,59036,0,0,0,0,1.0,1,1.0,1,1.0,1,0.31508491926033094,53
4152,11,59047,59047,0,0,0,0,1.0,1,1.0,1,1.0,1,0.3107303877766625,54
4153,15,59062,59062,0,0,0,0,1.0,1,1.0,1,1.0,1,0.37791739869906943,51
4154,14,59076,59076,0,0,0,0,1.0,1,1.0,1,1.0,1,0.26640862645534324,51
4155,13,59089,59089,0,0,0,0,1.0,1,1.0,1,1.0,1,0.3293132736635891,51
4156,21,59110,59110,0,0,0,0,1.0,1,1.0,1,1.0,1,0.2777060165490289,52
4157,20,59130,59130,0,0,0,0,1.0,1,1.0,1,1.0,1,0.23650308123332453,52
4158,25,59155,59155,0,0,0,0,1.0,1,1.0,1,1.0,1,0.2974431443813171,52
4159,23,59178,59178,0,0,0,0,1.0,1,1.0,1,1.0,1,0.2843826355680328,52
4160,24,59202,59202,0,0,0,0,1.0,1,1.0,1,1.0,1,0.23486706072510474,50
4161,25,59227,59227,0,0,0,0,1.0,1,1.0,1,1.0,1,0.358286933746864,50
4162,31,59258,59258,0,0,0,0,1.0,1,1.0,1,1.0,1,0.3465133675036352,51
4163,24,59282,59282,0,0,0,0,1.0,1,1.0,1,1.0,1,0.38074730497783604,48
4164,18,59300,59300,0,0,0,0,1.0,1,1.0,1,1.0,1,0.22877179330112807,50
4165,24,59324,59324,0,0,0,0,1.0,1,1.0,1,1.0,1,0.458591958225435,49
4166,27,59351,59351,0,0,0,0,1.0,1,1.0,1,1.0,1,0.3599826611130745,50
4167,12,59363,59363,0,0,0,0,1.0,1,1.0,1,1.0,1,0.4669758623776811,50
4168,28,59391,59391,0,0,0,0,1.0,1,1.0,1,1.0,1,0.3619781987311082,50
4169,16,59407,59407,0,0,0,0,1.0,1,1.0,1,1.0,1,0.40671272941442965,51
4170,11,59418,59418,0,0,0,0,1.0,1,1.0,1,1.0,1,0.3988668197394051,50
4171,10,59428,59428,0,0,0,0,1.0,1,1.0,1,1.0,1,0.37971291023877246,50
4172,11,59439,59439,0,0,0,0,1.0,1,1.0,1,1.0,1,0.4218876181053319,49
4173,15,59454,59454,0,0,0,0,1.0,1,1.0,1,1.0,1,0.4193628559197036,48
4174,13,59467,59467,0,0,0,0,1.0,1,1.0,1,1.0,1,0.40215922455950975,48
4175,14,59481,59481,0,0,0,0,1.0,1,1.0,1,1.0,1,0.4340552767710776,48
4176,20,59501,59501,0,0,0,0,1.0,1,1.0,1,1.0,1,0.35566922716301946,50
4177,17,59518,59518,0,0,0,0,1.0,1,1.0,1,1.0,1,0.35024872580684935,52
4178,9,59527,59527,0,0,0,0,1.0,1,1.0,1,1.0,1,0.3670990828025065,53
4179,15,59542,59542,0,0,0,0,1.0,1,1.0,1,1.0,1,0.34701055183315155,54
4180,13,59555,59555,0,0,0,0,1.0,1,1.0,1,1.0,1,0.3840846403445719,55
4181,12,59567,59567,0,0,0,0,1.0,1,1.0,1,1.0,1,0.3336459081572214,56
4182,12,59579,59579,0,0,0,0,1.0,1,1.0,1,1.0,1,0.2825276591317233,56
4183,12,59591,59591,0,0,0,0,1.0,1,1.0,1,1.0,1,0.3308744007557144,57
4184,20,59611,59611,0,0,0,0,1.0,1,1.0,1,1.0,1,0.36682621626716216,57
4185,21,59632,59632,0,0,0,0,1.0,1,1.0,1,1.0,1,0.2619655642687818,54
4186,21,59653,59653,0,0,0,0,1.0,1,1.0,1,1.0,1,0.2676556132620951,55
4187,15,59668,59668,0,0,0,0,1.0,1,1.0,1,1.0,1,0.32295247074624406,53
4188,20,59688,59688,0,0,0,0,1.0,1,1.0,1,1.0,1,0.3095599672866792,53
4189,29,59717,59717,0,0,0,0,1.0,1,1.0,1,1.0,1,0.2948996508116557,53
4190,23,59740,59740,0,0,0,0,1.0,1,1.0,1,1.0,1,0.3125262801551255,53
4191,16,59756,59756,0,0,0,0,1.0,1,1.0,1,1.0,1,0.399939476223523,51
4192,25,59781,59781,0,0,0,0,1.0,1,1.0,1,1.0,1,0.2049162072384868,51
4193,24,59805,59805,0,0,0,0,1.0,1,1.0,1,1.0,1,0.3674082539093836,50
4194,12,59817,59817,0,0,0,0,1.0,1,1.0,1,1.0,1,0.3270095336267598,50
4195,16,59833,59833,0,0,0,0,1.0,1,1.0,1,1.0,1,0.2074934023424622,50
4196,30,59863,59863,0,0,0,0,1.0,1,1.0,1,1.0,1,0.2732229094647588,51
4197,20,59883,59883,0,0,0,0,1.0,1,1.0,1,1.0,1,0.2701483467094635,50
4198,14,59897,59897,0,0,0,0,1.0,1,1.0,1,1.0,1,0.35120484820734565,48
4199,18,59915,59915,0,0,0,0,1.0,1,1.0,1,1.0,1,0.359611427098325,48
4200,15,59930,59930,0,0,0,0,1.0,1,1.0,1,1.0,1,0.33745809590226883,48
4201,17,59947,59947,0,0,0,0,1.0,1,1.0,1,1.0,1,0.4300781063924061,47
4202,13,59960,59960,0,0,0,0,1.0,1,1.0,1,1.0,1,0.4403463649835452,47
4203,29,59989,59989,0,0,0,0,1.0,1,1.0,1,1.0,1,0.3948881331591855,47
4204,35,60024,60024,0,0,0,0,1.0,1,1.0,1,1.0,1,0.4325174789400463,48
4205,19,60043,60043,0,0,0,0,1.0,1,1.0,1,1.0,1,0.39524197159310276,49
4206,12,60055,60055,0,0,0,0,1.0,1,1.0,1,1.0,1,0.3731879243769874,49
4207,15,60070,60070,0,0,0,0,1.0,1,1.0,1,1.0,1,0.3873062546684197,48
4208,13,60083,60083,0,0,0,0,1.0,1,1.0,1,1.0,1,0.3883848229850562,49
4209,15,60098,60098,0,0,0,0,1.0,1,1.0,1,1.0,1,0.42413268907833607,51
4210,10,60108,60108,0,0,0,0,1.0,1,1.0,1,1.0,1,0.42367563435607203,52
4211,16,60124,60124,0,0,0,0,1.0,1,1.0,1,1.0,1,0.3981518548356777,53
4212,17,60141,60141,0,0,0,0,1.0,1,1.0,1,1.0,1,0.42438502256849514,53
4213,13,60154,60154,0,0,0,0,1.0,1,1.0,1,1.0,1,0.34519816173363843,54
4214,17,60171,60171,0,0,0,0,1.0,1,1.0,1,1.0,1,0.41049224527950884,54
4215,21,60192,60192,0,0,0,0,1.0,1,1.0,1,1.0,1,0.3786615660432604,54
4216,12,60204,60204,0,0,0,0,1.0,1,1.0,1,1.0,1,0.44996005115527554,53
4217,21,60225,60225,0,0,0,0,1.0,1,1.0,1,1.0,1,0.35967784739921327,54
4218,15,60240,60240,0,0,0,0,1.0,1,1.0,1,1.0,1,0.4640694082301452,53
4219,17,60257,60257,0,0,0,0,1.0,1,1.0,1,1.0,1,0.40724521892452503,53
4220,13,60270,60270,0,0,0,0,1.0,1,1.0,1,1.0,1,0.39357521402589307,53
4221,21,60291,60291,0,0,0,0,1.0,1,1.0,1,1.0,1,0.4464866873846935,54
4222,11,60302,60302,0,0,0,0,1.0,1,1.0,1,1.0,1,0.41246758978008025,55
4223,14,60316,60316,0,0,0,0,1.0,1,1.0,1,1.0,1,0.4033950763319097,56
4224,20,60336,60336,0,0,0,0,1.0,1,1.0,1,1.0,1,0.3635828288587812,55
4225,27,60363,60363,0,0,0,0,1.0,1,1.0,1,1.0,1,0.3746149692986167,53
4226,15,60378,60378,0,0,0,0,1.0,1,1.0,1,1.0,1,0.41318102566696296,54
4227,19,60397,60397,0,0,0,0,1.0,1,1.0,1,1.0,1,0.5090110007289889,52
4228,22,60419,60419,0,0,0,0,1.0,1,1.0,1,1.0,1,0.40760858949545214,51
4229,20,60439,60439,0,0,0,0,1.0,1,1.0,1,1.0,1,0.4838292959039419,48
4230,15,60454,60454,0,0,0,0,1.0,1,1.0,1,1.0,1,0.49697138765040405,48
4231,18,60472,60472,0,0,0,0,1.0,1,1.0,1,1.0,1,0.4034330085550395,48
4232,25,60497,60497,0,0,0,0,1.0,1,1.0,1,1.0,1,0.4880678230589236,48
4233,23,60520,60520,0,0,0,0,1.0,1,1.0,1,1.0,1,0.47314935720380163,48
4234,17,60537,60537,0,0,0,0,1.0,1,1.0,1,1.0,1,0.39136310151220366,49
4235,24,60561,60561,0,0,0,0,1.0,1,1.0,1,1.0,1,0.5615651525993557,47
4236,26,60587,60587,0,0,0,0,1.0,1,1.0,1,1.0,1,0.5100628442954764,47
4237,26,60613,60613,0,0,0,0,1.0,1,1.0,1,1.0,1,0.46397126534466326,48
4238,25,60638,60638,0,0,0,0,1.0,1,1.0,1,1.0,1,0.48076525623876376,47
4239,20,60658,60658,0,0,0,0,1.0,1,1.0,1,1.0,1,0.44969585447105465,48
4240,16,60674,60674,0,0,0,0,1.0,1,1.0,1,1.0,1,0.5797000903900122,47
4241,18,60692,60692,0,0,0,0,1.0,1,1.0,1,1.0,1,0.49459344756333234,49
4242,9,60701,60701,0,0,0,0,1.0,1,1.0,1,1.0,1,0.4952042420460228,49
4243,11,60712,60712,0,0,0,0,1.0,1,1.0,1,1.0,1,0.3697799283556493,50
4244,18,60730,60730,0,0,0,0,1.0,1,1.0,1,1.0,1,0.4162250488017486,51
4245,19,60749,60749,0,0,0,0,1.0,1,1.0,1,1.0,1,0.4731839206735084,51
4246,18,60767,60767,0,0,0,0,1.0,1,1.0,1,1.0,1,0.36521287790647855,51
4247,15,60782,60782,0,0,0,0,1.0,1,1.0,1,1.0,1,0.40445571918755674,52
4248,23,60805,60805,0,0,0,0,1.0,1,1.0,1,1.0,1,0.4106401721060187,52
4249,18,60823,60823,0,0,0,0,1.0,1,1.0,1,1.0,1,0.3275120745568451,52
4250,26,60849,60849,0,0,0,0,1.0,1,1.0,1,1.0,1,0.2943256541463897,52
4251,32,60881,60881,0,0,0,0,1.0,1,1.0,1,1.0,1,0.2801308408424724,53
4252,34,60915,60915,0,0,0,0,1.0,1,1.0,1,1.0,1,0.25182951602537007,53
4253,25,60940,60940,0,0,0,0,1.0,1,1.0,1,1.0,1,0.302091430947074,54
4254,18,60958,60958,0,0,0,0,1.0,1,1.0,1,1.0,1,0.21878892013611234,54
4255,21,60979,60979,0,0,0,0,1.0,1,1.0,1,1.0,1,0.36365386216151985,55
4256,17,60996,60996,0,0,0,0,1.0,1,1.0,1,1.0,1,0.3173193194403703,57
4257,16,61012,61012,0,0,0,0,1.0,1,1.0,1,1.0,1,0.2134631200433497,57
4258,17,61029,61029,0,0,0,0,1.0,1,1.0,1,1.0,1,0.28373106976163476,57
4259,21,61050,61050,0,0,0,0,1.0,1,1.0,1,1.0,1,0.34546806592589774,57
4260,16,61066,61066,0,0,0,0,1.0,1,1.0,1,1.0,1,0.37220624698339194,58
4261,15,61081,61081,0,0,0,0,1.0,1,1.0,1,1.0,1,0.2942565270436372,59
4262,15,61096,61096,0,0,0,0,1.0,1,1.0,1,1.0,1,0.4178925380804236,60
4263,26,61122,61122,0,0,0,0,1.0,1,1.0,1,1.0,1,0.33366806211982725,59
4264,22,61144,61144,0,0,0,0,1.0,1,1.0,1,1.0,1,0.32178337034193266,58
4265,28,61172,61172,0,0,0,0,1.0,1,1.0,1,1.0,1,0.4531186541902018,58
4266,24,61196,61196,0,0,0,0,1.0,1,1.0,1,1.0,1,0.4560763945211371,58
4267,23,61219,61219,0,0,0,0,1.0,1,1.0,1,1.0,1,0.45210355961852877,55
4268,11,61230,61230,0,0,0,0,1.0,1,1.0,1,1.0,1,0.4293914832127925,55
4269,17,61247,61247,0,0,0,0,1.0,1,1.0,1,1.0,1,0.4601880120133366,50
4270,23,61270,61270,0,0,0,0,1.0,1,1.0,1,1.0,1,0.3853020621199489,47
4271,14,61284,61284,0,0,0,0,1.0,1,1.0,1,1.0,1,0.5075955054349037,47
4272,15,61299,61299,0,0,0,0,1.0,1,1.0,1,1.0,1,0.4181595572861376,46
4273,12,61311,61311,0,0,0,0,1.0,1,1.0,1,1.0,1,0.3799061154425836,47
4274,19,61330,61330,0,0,0,0,1.0,1,1.0,1,1.0,1,0.3066235321498073,45
4275,14,61344,61344,0,0,0,0,1.0,1,1.0,1,1.0,1,0.20985582899374983,44
4276,16,61360,61360,0,0,0,0,1.0,1,1.0,1,1.0,1,0.2816184193613852,43
4277,10,61370,61370,0,0,0,0,1.0,1,1.0,1,1.0,1,0.23288350059859053,42
4278,16,61386,61386,0,0,0,0,1.0,1,1.0,1,1.0,1,0.17790432333593675,43
4279,14,61400,61400,0,0,0,0,1.0,1,1.0,1,1.0,1,0.22820191257750186,42
4280,12,61412,61412,0,0,0,0,1.0,1,1.0,1,1.0,1,0.1591328581385378,44
4281,23,61435,61435,0,0,0,0,1.0,1,1.0,1,1.0,1,0.23608093879446349,44
4282,17,61452,61452,0,0,0,0,1.0,1,1.0,1,1.0,1,0.22193184934704002,44
4283,24,61476,61476,0,0,0,0,1.0,1,1.0,1,1.0,1,0.24146241628711812,45
4284,18,61494,61494,0,0,0,0,1.0,1,1.0,1,1.0,1,0.22898978851443122,45
4285,10,61504,61504,0,0,0,0,1.0,1,1.0,1,1.0,1,0.25792091483703533,47
4286,12,61516,61516,0,0,0,0,1.0,1,1.0,1,1.0,1,0.26172051377704386,47
4287,19,61535,61535,0,0,0,0,1.0,1,1.0,1,1.0,1,0.3054977370627976,49
4288,22,61557,61557,0,0,0,0,1.0,1,1.0,1,1.0,1,0.26450277680474893,49
4289,16,61573,61573,0,0,0,0,1.0,1,1.0,1,1.0,1,0.2809310738781367,50
4290,20,61593,61593,0,0,0,0,1.0,1,1.0,1,1.0,1,0.2754646649428264,51
4291,18,61611,61611,0,0,0,0,1.0,1,1.0,1,1.0,1,0.24926604213188264,50
4292,13,61624,61624,0,0,0,0,1.0,1,1.0,1,1.0,1,0.30937455664755464,51
4293,22,61646,61646,0,0,0,0,1.0,1,1.0,1,1.0,1,0.283211628467698,51
4294,14,61660,61660,0,0,0,0,1.0,1,1.0,1,1.0,1,0.24959747349643543,50
4295,18,61678,61678,0,0,0,0,1.0,1,1.0,1,1.0,1,0.3788389578736051,50
4296,19,61697,61697,0,0,0,0,1.0,1,1.0,1,1.0,1,0.33552727634317875,49
4297,15,61712,61712,0,0,0,0,1.0,1,1.0,1,1.0,1,0.336299049176169,49
4298,11,61723,61723,0,0,0,0,1.0,1,1.0,1,1.0,1,0.3405054174757893,49
4299,12,61735,61735,0,0,0,0,1.0,1,1.0,1,1.0,1,0.28479934564719755,48
4300,12,61747,61747,0,0,0,0,1.0,1,1.0,1,1.0,1,0.25107964661721416,49
4301,12,61759,61759,0,0,0,0,1.0,1,1.0,1,1.0,1,0.28807094391069415,50
4302,16,61775,61775,0,0,0,0,1.0,1,1.0,1,1.0,1,0.25459415087981646,51
4303,13,61788,61788,0,0,0,0,1.0,1,1.0,1,1.0,1,0.30187427174150305,51
4304,11,61799,61799,0,0,0,0,1.0,1,1.0,1,1.0,1,0.3152323242862464,51
4305,12,61811,61811,0,0,0,0,1.0,1,1.0,1,1.0,1,0.2522346971891481,49
4306,12,61823,61823,0,0,0,0,1.0,1,1.0,1,1.0,1,0.25963843220543587,49
4307,8,61831,61831,0,0,0,0,1.0,1,1.0,1,1.0,1,0.16799262007239185,46
4308,6,61837,61837,0,0,0,0,1.0,1,1.0,1,1.0,1,0.26453377477821144,44
4309,9,61846,61846,0,0,0,0,1.0,1,1.0,1,1.0,1,0.24007438259970207,44
4310,10,61856,61856,0,0,0,0,1.0,1,1.0,1,1.0,1,0.3245233955492048,42
4311,10,61866,61866,0,0,0,0,1.0,1,1.0,1,1.0,1,0.25193668009918146,42
4312,7,61873,61873,0,0,0,0,1.0,1,1.0,1,1.0,1,0.26074533697752245,40
4313,18,61891,61891,0,0,0,0,1.0,1,1.0,1,1.0,1,0.3659418034970588,40
4314,13,61904,61904,0,0,0,0,1.0,1,1.0,1,1.0,1,0.4082868705385537,36
4315,14,61918,61918,0,0,0,0,1.0,1,1.0,1,1.0,1,0.3770907574765295,37
4316,8,61926,61926,0,0,0,0,1.0,1,1.0,1,1.0,1,0.3596166831703949,37
4317,10,61936,61936,0,0,0,0,1.0,1,1.0,1,1.0,1,0.34475093624360564,36
4318,8,61944,61944,0,0,0,0,1.0,1,1.0,1,1.0,1,0.35829669770753925,34
4319,12,61956,61956,0,0,0,0,1.0,1,1.0,1,1.0,1,0.3135002829683112,34
4320,13,61969,61969,0,0,0,0,1.0,1,1.0,1,1.0,1,0.4792060082776704,34
4321,12,61981,61981,0,0,0,0,1.0,1,1.0,1,1.0,1,0.33659286608808137,35
4322,11,61992,61992,0,0,0,0,1.0,1,1.0,1,1.0,1,0.39603287562223816,35
4323,13,62005,62005,0,0,0,0,1.0,1,1.0,1,1.0,1,0.3119884241293625,35
4324,17,62022,62022,0,0,0,0,1.0,1,1.0,1,1.0,1,0.3422550163227999,34
4325,15,62037,62037,0,0,0,0,1.0,1,1.0,1,1.0,1,0.2349579508303885,34
4326,15,62052,62052,0,0,0,0,1.0,1,1.0,1,1.0,1,0.3741105726826626,36
4327,14,62066,62066,0,0,0,0,1.0,1,1.0,1,1.0,1,0.31205423767941015,35
4328,15,62081,62081,0,0,0,0,1.0,1,1.0,1,1.0,1,0.30002527018009245,35
4329,19,62100,62100,0,0,0,0,1.0,1,1.0,1,1.0,1,0.3913779045419526,38
4330,17,62117,62117,0,0,0,0,1.0,1,1.0,1,1.0,1,0.25887090130028406,38
4331,14,62131,62131,0,0,0,0,1.0,1,1.0,1,1.0,1,0.3883382572462269,39
4332,18,62149,62149,0,0,0,0,1.0,1,1.0,1,1.0,1,0.37534181352097007,40
4333,6,62155,62155,0,0,0,0,1.0,1,1.0,1,1.0,1,0.4194808200186447,41
4334,9,62164,62164,0,0,0,0,1.0,1,1.0,1,1.0,1,0.28627465988817896,41
4335,4,62168,62168,0,0,0,0,1.0,1,1.0,1,1.0,1,0.32087102821248636,42
4336,8,62176,62176,0,0,0,0,1.0,1,1.0,1,1.0,1,0.2784066439130714,43
4337,10,62186,62186,0,0,0,0,1.0,1,1.0,1,1.0,1,0.3191997736331077,44
4338,7,62193,62193,0,0,0,0,1.0,1,1.0,1,1.0,1,0.2683963695939204,44
4339,10,62203,62203,0,0,0,0,1.0,1,1.0,1,1.0,1,0.3765675618063893,46
4340,12,62215,62215,0,0,0,0,1.0,1,1.0,1,1.0,1,0.31745804792353965,47
4341,11,62226,62226,0,0,0,0,1.0,1,1.0,1,1.0,1,0.36063584711887825,47
4342,14,62240,62240,0,0,0,0,1.0,1,1.0,1,1.0,1,0.383601382087306,47
4343,15,62255,62255,0,0,0,0,1.0,1,1.0,1,1.0,1,0.5022903519414339,42
4344,12,62267,62267,0,0,0,0,1.0,1,1.0,1,1.0,1,0.4574349211635681,42
4345,13,62280,62280,0,0,0,0,1.0,1,1.0,1,1.0,1,0.5304849458853174,39
4346,10,62290,62290,0,0,0,0,1.0,1,1.0,1,1.0,1,0.5669187161653847,37
4347,9,62299,62299,0,0,0,0,1.0,1,1.0,1,1.0,1,0.5631088856454025,37
4348,15,62314,62314,0,0,0,0,1.0,1,1.0,1,1.0,1,0.4644236784271398,38
4349,6,62320,62320,0,0,0,0,1.0,1,1.0,1,1.0,1,0.44688922159969646,36
4350,10,62330,62330,0,0,0,0,1.0,1,1.0,1,1.0,1,0.44483236155649114,37
4351,7,62337,62337,0,0,0,0,1.0,1,1.0,1,1.0,1,0.4542968140281004,35
4352,12,62349,62349,0,0,0,0,1.0,1,1.0,1,1.0,1,0.4642371597630659,34
4353,13,62362,62362,0,0,0,0,1.0,1,1.0,1,1.0,1,0.5103956611165431,34
4354,9,62371,62371,0,0,0,0,1.0,1,1.0,1,1.0,1,0.5954350456737725,32
4355,18,62389,62389,0,0,0,0,1.0,1,1.0,1,1.0,1,0.3309571439326042,32
4356,14,62403,62403,0,0,0,0,1.0,1,1.0,1,1.0,1,0.41214060624935267,34
4357,16,62419,62419,0,0,0,0,1.0,1,1.0,1,1.0,1,0.2952836939290237,35
4358,16,62435,62435,0,0,0,0,1.0,1,1.0,1,1.0,1,0.3356154859505357,35
4359,14,62449,62449,0,0,0,0,1.0,1,1.0,1,1.0,1,0.376161769091945,37
4360,10,62459,62459,0,0,0,0,1.0,1,1.0,1,1.0,1,0.37899655885757194,38
4361,16,62475,62475,0,0,0,0,1.0,1,1.0,1,1.0,1,0.3018657862262348,39
4362,14,62489,62489,0,0,0,0,1.0,1,1.0,1,1.0,1,0.352923958751984,38
4363,9,62498,62498,0,0,0,0,1.0,1,1.0,1,1.0,1,0.3011614252675934,38
4364,12,62510,62510,0,0,0,0,1.0,1,1.0,1,1.0,1,0.32977782302596925,39
4365,15,62525,62525,0,0,0,0,1.0,1,1.0,1,1.0,1,0.3209349231990994,39
4366,9,62534,62534,0,0,0,0,1.0,1,1.0,1,1.0,1,0.3955480068848693,39
4367,5,62539,62539,0,0,0,0,1.0,1,1.0,1,1.0,1,0.43138191172807205,41
4368,10,62549,62549,0,0,0,0,1.0,1,1.0,1,1.0,1,0.4512241568059214,41
4369,13,62562,62562,0,0,0,0,1.0,1,1.0,1,1.0,1,0.3677388660807103,42
4370,5,62567,62567,0,0,0,0,1.0,1,1.0,1,1.0,1,0.36805576096462694,42
4371,8,62575,62575,0,0,0,0,1.0,1,1.0,1,1.0,1,0.36975975141787437,43
4372,8,62583,62583,0,0,0,0,1.0,1,1.0,1,1.0,1,0.35882850540020106,43
4373,12,62595,62595,0,0,0,0,1.0,1,1.0,1,1.0,1,0.3398178822908602,43
4374,10,62605,62605,0,0,0,0,1.0,1,1.0,1,1.0,1,0.3785854518371679,44
4375,11,62616,62616,0,0,0,0,1.0,1,1.0,1,1.0,1,0.3364190136834821,45
4376,10,62626,62626,0,0,0,0,1.0,1,1.0,1,1.0,1,0.31058062921743224,46
4377,10,62636,62636,0,0,0,0,1.0,1,1.0,1,1.0,1,0.369931796658552,47
4378,5,62641,62641,0,0,0,0,1.0,1,1.0,1,1.0,1,0.36780148491267733,49
4379,9,62650,62650,0,0,0,0,1.0,1,1.0,1,1.0,1,0.33911983669261153,51
4380,4,62654,62654,0,0,0,0,1.0,1,1.0,1,1.0,1,0.3389165515793747,50
4381,5,62659,62659,0,0,0,0,1.0,1,1.0,1,1.0,1,0.3203042741055974,49
4382,10,62669,62669,0,0,0,0,1.0,1,1.0,1,1.0,1,0.3765227659796186,47
4383,8,62677,62677,0,0,0,0,1.0,1,1.0,1,1.0,1,0.39572302897848316,47
4384,11,62688,62688,0,0,0,0,1.0,1,1.0,1,1.0,1,0.443805675394089,44
4385,14,62702,62702,0,0,0,0,1.0,1,1.0,1,1.0,1,0.33647430090939645,42
4386,5,62707,62707,0,0,0,0,1.0,1,1.0,1,1.0,1,0.38913849913065324,41
4387,8,62715,62715,0,0,0,0,1.0,1,1.0,1,1.0,1,0.31199230018705604,39
4388,19,62734,62734,0,0,0,0,1.0,1,1.0,1,1.0,1,0.3698011799158179,39
4389,12,62746,62746,0,0,0,0,1.0,1,1.0,1,1.0,1,0.4759981254532361,38
4390,7,62753,62753,0,0,0,0,1.0,1,1.0,1,1.0,1,0.366632111669613,38
4391,7,62760,62760,0,0,0,0,1.0,1,1.0,1,1.0,1,0.3822746183584655,39
4392,9,62769,62769,0,0,0,0,1.0,1,1.0,1,1.0,1,0.3267729276019564,39
4393,4,62773,62773,0,0,0,0,1.0,1,1.0,1,1.0,1,0.36204307613725345,40
4394,8,62781,62781,0,0,0,0,1.0,1,1.0,1,1.0,1,0.2905259803028308,39
4395,5,62786,62786,0,0,0,0,1.0,1,1.0,1,1.0,1,0.31914094526642545,39
4396,6,62792,62792,0,0,0,0,1.0,1,1.0,1,1.0,1,0.3987190254975796,39
4397,8,62800,62800,0,0,0,0,1.0,1,1.0,1,1.0,1,0.3610461920319526,38
4398,9,62809,62809,0,0,0,0,1.0,1,1.0,1,1.0,1,0.39904274742944523,39
4399,11,62820,62820,0,0,0,0,1.0,1,1.0,1,1.0,1,0.43781736950126915,42
4400,17,62837,62837,0,0,0,0,1.0,1,1.0,1,1.0,1,0.32381373158964877,43
4401,7,62844,62844,0,0,0,0,1.0,1,1.0,1,1.0,1,0.4069748943866807,44
4402,11,62855,62855,0,0,0,0,1.0,1,1.0,1,1.0,1,0.3523776684098022,44
4403,14,62869,62869,0,0,0,0,1.0,1,1.0,1,1.0,1,0.3090883346876516,45
4404,19,62888,62888,0,0,0,0,1.0,1,1.0,1,1.0,1,0.3024638439188008,45
4405,10,62898,62898,0,0,0,0,1.0,1,1.0,1,1.0,1,0.30038378295825024,46
4406,12,62910,62910,0,0,0,0,1.0,1,1.0,1,1.0,1,0.3582602045966587,46
4407,7,62917,62917,0,0,0,0,1.0,1,1.0,1,1.0,1,0.3312293862742951,46
4408,7,62924,62924,0,0,0,0,1.0,1,1.0,1,1.0,1,0.38247445028635574,47
4409,6,62930,62930,0,0,0,0,1.0,1,1.0,1,1.0,1,0.30254497536734365,48
4410,8,62938,62938,0,0,0,0,1.0,1,1.0,1,1.0,1,0.31145912985909924,48
4411,12,62950,62950,0,0,0,0,1.0,1,1.0,1,1.0,1,0.31350756443824435,50
4412,9,62959,62959,0,0,0,0,1.0,1,1.0,1,1.0,1,0.2690087375740754,50
4413,6,62965,62965,0,0,0,0,1.0,1,1.0,1,1.0,1,0.33032081810840697,50
4414,13,62978,62978,0,0,0,0,1.0,1,1.0,1,1.0,1,0.3062550674799792,51
4415,12,62990,62990,0,0,0,0,1.0,1,1.0,1,1.0,1,0.23332127971266522,51
4416,8,62998,62998,0,0,0,0,1.0,1,1.0,1,1.0,1,0.26954892188723933,51
4417,9,63007,63007,0,0,0,0,1.0,1,1.0,1,1.0,1,0.25325006016625373,51
4418,11,63018,63018,0,0,0,0,1.0,1,1.0,1,1.0,1,0.2705485122096202,51
4419,13,63031,63031,0,0,0,0,1.0,1,1.0,1,1.0,1,0.3002538266589684,50
4420,15,63046,63046,0,0,0,0,1.0,1,1.0,1,1.0,1,0.2989535188070341,50
4421,12,63058,63058,0,0,0,0,1.0,1,1.0,1,1.0,1,0.24651022507506226,52
4422,13,63071,63071,0,0,0,0,1.0,1,1.0,1,1.0,1,0.1986630335940785,51
4423,19,63090,63090,0,0,0,0,1.0,1,1.0,1,1.0,1,0.2168027623185329,51
4424,18,63108,63108,0,0,0,0,1.0,1,1.0,1,1.0,1,0.2643279940793956,53
4425,22,63130,63130,0,0,0,0,1.0,1,1.0,1,1.0,1,0.30312786729974733,54
4426,16,63146,63146,0,0,0,0,1.0,1,1.0,1,1.0,1,0.2478847349008601,55
4427,22,63168,63168,0,0,0,0,1.0,1,1.0,1,1.0,1,0.23122906286103118,55
4428,8,63176,63176,0,0,0,0,1.0,1,1.0,1,1.0,1,0.24170035098061357,55
4429,23,63199,63199,0,0,0,0,1.0,1,1.0,1,1.0,1,0.2279119180885474,56
4430,15,63214,63214,0,0,0,0,1.0,1,1.0,1,1.0,1,0.3401038417367206,55
4431,21,63235,63235,0,0,0,0,1.0,1,1.0,1,1.0,1,0.26930163387533873,56
4432,20,63255,63255,0,0,0,0,1.0,1,1.0,1,1.0,1,0.2779283569862691,56
4433,21,63276,63276,0,0,0,0,1.0,1,1.0,1,1.0,1,0.19336752253160433,57
4434,14,63290,63290,0,0,0,0,1.0,1,1.0,1,1.0,1,0.21816282106892293,56
4435,19,63309,63309,0,0,0,0,1.0,1,1.0,1,1.0,1,0.29818693520329026,56
4436,28,63337,63337,0,0,0,0,1.0,1,1.0,1,1.0,1,0.15665687305485396,55
4437,19,63356,63356,0,0,0,0,1.0,1,1.0,1,1.0,1,0.2491026954078609,54
4438,22,63378,63378,0,0,0,0,1.0,1,1.0,1,1.0,1,0.29110858530595374,54
4439,21,63399,63399,0,0,0,0,1.0,1,1.0,1,1.0,1,0.36305517373213114,55
4440,17,63416,63416,0,0,0,0,1.0,1,1.0,1,1.0,1,0.3503965705012205,55
4441,22,63438,63438,0,0,0,0,1.0,1,1.0,1,1.0,1,0.3329242959109012,59
4442,12,63450,63450,0,0,0,0,1.0,1,1.0,1,1.0,1,0.35242364707942986,61
4443,31,63481,63481,0,0,0,0,1.0,1,1.0,1,1.0,1,0.3400388235121341,60
4444,19,63500,63500,0,0,0,0,1.0,1,1.0,1,1.0,1,0.34436759568512715,61
4445,21,63521,63521,0,0,0,0,1.0,1,1.0,1,1.0,1,0.32324778040962554,61
4446,17,63538,63538,0,0,0,0,1.0,1,1.0,1,1.0,1,0.29386398097382377,62
4447,30,63568,63568,0,0,0,0,1.0,1,1.0,1,1.0,1,0.35533751868719543,63
4448,16,63584,63584,0,0,0,0,1.0,1,1.0,1,1.0,1,0.34048875904590503,63
4449,17,63601,63601,0,0,0,0,1.0,1,1.0,1,1.0,1,0.3794980739401439,63
4450,11,63612,63612,0,0,0,0,1.0,1,1.0,1,1.0,1,0.34701100856630657,62
4451,16,63628,63628,0,0,0,0,1.0,1,1.0,1,1.0,1,0.342425595777831,63
4452,10,63638,63638,0,0,0,0,1.0,1,1.0,1,1.0,1,0.4134031026923688,64
4453,15,63653,63653,0,0,0,0,1.0,1,1.0,1,1.0,1,0.3412387329595232,65
4454,13,63666,63666,0,0,0,0,1.0,1,1.0,1,1.0,1,0.33418356050041337,66
4455,22,63688,63688,0,0,0,0,1.0,1,1.0,1,1.0,1,0.33099246849015806,67
4456,17,63705,63705,0,0,0,0,1.0,1,1.0,1,1.0,1,0.33261987069955395,67
4457,11,63716,63716,0,0,0,0,1.0,1,1.0,1,1.0,1,0.3447539396601019,65
4458,14,63730,63730,0,0,0,0,1.0,1,1.0,1,1.0,1,0.2701383091566312,65
4459,19,63749,63749,0,0,0,0,1.0,1,1.0,1,1.0,1,0.3519527588158015,64
4460,16,63765,63765,0,0,0,0,1.0,1,1.0,1,1.0,1,0.25837546623803587,63
4461,16,63781,63781,0,0,0,0,1.0,1,1.0,1,1.0,1,0.31862455082452196,62
4462,16,63797,63797,0,0,0,0,1.0,1,1.0,1,1.0,1,0.4218675055324389,61
4463,24,63821,63821,0,0,0,0,1.0,1,1.0,1,1.0,1,0.3464192062385273,61
4464,12,63833,63833,0,0,0,0,1.0,1,1.0,1,1.0,1,0.40752252808327677,58
4465,15,63848,63848,0,0,0,0,1.0,1,1.0,1,1.0,1,0.3592169957802504,57
4466,29,63877,63877,0,0,0,0,1.0,1,1.0,1,1.0,1,0.3106002631110147,54
4467,17,63894,63894,0,0,0,0,1.0,1,1.0,1,1.0,1,0.30565220645015445,52
4468,18,63912,63912,0,0,0,0,1.0,1,1.0,1,1.0,1,0.3297732716450671,52
4469,18,63930,63930,0,0,0,0,1.0,1,1.0,1,1.0,1,0.27886935730800994,51
4470,15,63945,63945,0,0,0,0,1.0,1,1.0,1,1.0,1,0.3300882038486501,51
4471,17,63962,63962,0,0,0,0,1.0,1,1.0,1,1.0,1,0.29503745531450537,50
4472,21,63983,63983,0,0,0,0,1.0,1,1.0,1,1.0,1,0.38112765599383736,48
4473,34,64017,64017,0,0,0,0,1.0,1,1.0,1,1.0,1,0.38390763414309703,47
4474,29,64046,64046,0,0,0,0,1.0,1,1.0,1,1.0,1,0.431904586971116,49
4475,22,64068,64068,0,0,0,0,1.0,1,1.0,1,1.0,1,0.39886808830768566,47
4476,23,64091,64091,0,0,0,0,1.0,1,1.0,1,1.0,1,0.3559596639827897,49
4477,19,64110,64110,0,0,0,0,1.0,1,1.0,1,1.0,1,0.29259616814896866,48
4478,18,64128,64128,0,0,0,0,1.0,1,1.0,1,1.0,1,0.46248321243564483,48
4479,10,64138,64138,0,0,0,0,1.0,1,1.0,1,1.0,1,0.406964252266245,48
4480,9,64147,64147,0,0,0,0,1.0,1,1.0,1,1.0,1,0.47067602757958743,49
4481,13,64160,64160,0,0,0,0,1.0,1,1.0,1,1.0,1,0.48619300351660266,49
4482,16,64176,64176,0,0,0,0,1.0,1,1.0,1,1.0,1,0.4760421737519815,49
4483,12,64188,64188,0,0,0,0,1.0,1,1.0,1,1.0,1,0.39256472489905314,50
4484,16,64204,64204,0,0,0,0,1.0,1,1.0,1,1.0,1,0.4316193914613517,52
4485,11,64215,64215,0,0,0,0,1.0,1,1.0,1,1.0,1,0.40125087393802217,53
4486,16,64231,64231,0,0,0,0,1.0,1,1.0,1,1.0,1,0.35378245035005085,55
4487,18,64249,64249,0,0,0,0,1.0,1,1.0,1,1.0,1,0.4024143146994118,55
4488,17,64266,64266,0,0,0,0,1.0,1,1.0,1,1.0,1,0.41195325404259187,54
4489,19,64285,64285,0,0,0,0,1.0,1,1.0,1,1.0,1,0.4917490414085515,53
4490,18,64303,64303,0,0,0,0,1.0,1,1.0,1,1.0,1,0.4133911729002323,53
4491,9,64312,64312,0,0,0,0,1.0,1,1.0,1,1.0,1,0.4315234341238287,52
4492,16,64328,64328,0,0,0,0,1.0,1,1.0,1,1.0,1,0.44082404791987645,52
4493,15,64343,64343,0,0,0,0,1.0,1,1.0,1,1.0,1,0.34301015018793757,52
4494,13,64356,64356,0,0,0,0,1.0,1,1.0,1,1.0,1,0.3537473196184887,53
4495,23,64379,64379,0,0,0,0,1.0,1,1.0,1,1.0,1,0.37258599016927324,50
4496,13,64392,64392,0,0,0,0,1.0,1,1.0,1,1.0,1,0.2889030846407525,51
4497,15,64407,64407,0,0,0,0,1.0,1,1.0,1,1.0,1,0.27573322897974384,50
4498,20,64427,64427,0,0,0,0,1.0,1,1.0,1,1.0,1,0.34299842905009625,49
4499,13,64440,64440,0,0,0,0,1.0,1,1.0,1,1.0,1,0.3044507239122261,48
4500,17,64457,64457,0,0,0,0,1.0,1,1.0,1,1.0,1,0.29189719839524303,48
4501,19,64476,64476,0,0,0,0,1.0,1,1.0,1,1.0,1,0.27652798440864657,48
4502,11,64487,64487,0,0,0,0,1.0,1,1.0,1,1.0,1,0.3208500724005557,49
4503,15,64502,64502,0,0,0,0,1.0,1,1.0,1,1.0,1,0.3633077484446181,49
4504,14,64516,64516,0,0,0,0,1.0,1,1.0,1,1.0,1,0.29474457528936643,45
4505,27,64543,64543,0,0,0,0,1.0,1,1.0,1,1.0,1,0.3867477327313349,46
4506,11,64554,64554,0,0,0,0,1.0,1,1.0,1,1.0,1,0.291377234916004,45
4507,18,64572,64572,0,0,0,0,1.0,1,1.0,1,1.0,1,0.3525835001358137,45
4508,14,64586,64586,0,0,0,0,1.0,1,1.0,1,1.0,1,0.2608393392464375,43
4509,11,64597,64597,0,0,0,0,1.0,1,1.0,1,1.0,1,0.2533584098992938,41
4510,12,64609,64609,0,0,0,0,1.0,1,1.0,1,1.0,1,0.32564748451736203,42
4511,9,64618,64618,0,0,0,0,1.0,1,1.0,1,1.0,1,0.27572208076970445,41
4512,9,64627,64627,0,0,0,0,1.0,1,1.0,1,1.0,1,0.32017483788771306,41
4513,9,64636,64636,0,0,0,0,1.0,1,1.0,1,1.0,1,0.2603259824087684,41
4514,16,64652,64652,0,0,0,0,1.0,1,1.0,1,1.0,1,0.2979510607280517,42
4515,10,64662,64662,0,0,0,0,1.0,1,1.0,1,1.0,1,0.347950806372562,41
4516,12,64674,64674,0,0,0,0,1.0,1,1.0,1,1.0,1,0.4280881880137918,42
4517,10,64684,64684,0,0,0,0,1.0,1,1.0,1,1.0,1,0.3160775441417107,43
4518,10,64694,64694,0,0,0,0,1.0,1,1.0,1,1.0,1,0.3639879960459172,42
4519,8,64702,64702,0,0,0,0,1.0,1,1.0,1,1.0,1,0.33795705008919913,42
4520,15,64717,64717,0,0,0,0,1.0,1,1.0,1,1.0,1,0.3134346043104377,42
4521,10,64727,64727,0,0,0,0,1.0,1,1.0,1,1.0,1,0.29822055909944983,42
4522,18,64745,64745,0,0,0,0,1.0,1,1.0,1,1.0,1,0.3389477033739082,42
4523,13,64758,64758,0,0,0,0,1.0,1,1.0,1,1.0,1,0.3294919986103854,42
4524,12,64770,64770,0,0,0,0,1.0,1,1.0,1,1.0,1,0.2576346239362663,43
4525,15,64785,64785,0,0,0,0,1.0,1,1.0,1,1.0,1,0.26959132455443297,46
4526,16,64801,64801,0,0,0,0,1.0,1,1.0,1,1.0,1,0.26540197081519074,46
4527,16,64817,64817,0,0,0,0,1.0,1,1.0,1,1.0,1,0.26982722723087843,47
4528,18,64835,64835,0,0,0,0,1.0,1,1.0,1,1.0,1,0.3123959060081872,49
4529,15,64850,64850,0,0,0,0,1.0,1,1.0,1,1.0,1,0.3746136990955971,50
4530,15,64865,64865,0,0,0,0,1.0,1,1.0,1,1.0,1,0.3247456806741495,51
4531,7,64872,64872,0,0,0,0,1.0,1,1.0,1,1.0,1,0.33848311647057233,51
4532,16,64888,64888,0,0,0,0,1.0,1,1.0,1,1.0,1,0.2949661450328123,51
4533,9,64897,64897,0,0,0,0,1.0,1,1.0,1,1.0,1,0.41856532446062233,50
4534,17,64914,64914,0,0,0,0,1.0,1,1.0,1,1.0,1,0.2252220227669756,51
4535,15,64929,64929,0,0,0,0,1.0,1,1.0,1,1.0,1,0.33643142840495877,50
4536,20,64949,64949,0,0,0,0,1.0,1,1.0,1,1.0,1,0.4004497546021735,48
4537,14,64963,64963,0,0,0,0,1.0,1,1.0,1,1.0,1,0.4003866242667675,49
4538,14,64977,64977,0,0,0,0,1.0,1,1.0,1,1.0,1,0.3962741764488325,48
4539,12,64989,64989,0,0,0,0,1.0,1,1.0,1,1.0,1,0.332444425456886,50
4540,17,65006,65006,0,0,0,0,1.0,1,1.0,1,1.0,1,0.40517129542233227,49
4541,13,65019,65019,0,0,0,0,1.0,1,1.0,1,1.0,1,0.44233035958393285,49
4542,14,65033,65033,0,0,0,0,1.0,1,1.0,1,1.0,1,0.3925251650113337,47
4543,8,65041,65041,0,0,0,0,1.0,1,1.0,1,1.0,1,0.4673617723883175,45
4544,7,65048,65048,0,0,0,0,1.0,1,1.0,1,1.0,1,0.4255869369531392,45
4545,10,65058,65058,0,0,0,0,1.0,1,1.0,1,1.0,1,0.42484498856045183,43
4546,7,65065,65065,0,0,0,0,1.0,1,1.0,1,1.0,1,0.4643916422878743,43
4547,9,65074,65074,0,0,0,0,1.0,1,1.0,1,1.0,1,0.48488921163089266,41
4548,14,65088,65088,0,0,0,0,1.0,1,1.0,1,1.0,1,0.47431411791585243,42
4549,16,65104,65104,0,0,0,0,1.0,1,1.0,1,1.0,1,0.3645909871943033,41
4550,11,65115,65115,0,0,0,0,1.0,1,1.0,1,1.0,1,0.3677941036453323,41
4551,12,65127,65127,0,0,0,0,1.0,1,1.0,1,1.0,1,0.42733011940044946,39
4552,8,65135,65135,0,0,0,0,1.0,1,1.0,1,1.0,1,0.3300309102691889,38
4553,13,65148,65148,0,0,0,0,1.0,1,1.0,1,1.0,1,0.4149433019871078,39
4554,10,65158,65158,0,0,0,0,1.0,1,1.0,1,1.0,1,0.4451105247543309,38
4555,7,65165,65165,0,0,0,0,1.0,1,1.0,1,1.0,1,0.3868198061293459,37
4556,12,65177,65177,0,0,0,0,1.0,1,1.0,1,1.0,1,0.43875890356311853,36
4557,7,65184,65184,0,0,0,0,1.0,1,1.0,1,1.0,1,0.36222101973271725,38
4558,11,65195,65195,0,0,0,0,1.0,1,1.0,1,1.0,1,0.3273360061703001,39
4559,13,65208,65208,0,0,0,0,1.0,1,1.0,1,1.0,1,0.4398034485533543,38
4560,7,65215,65215,0,0,0,0,1.0,1,1.0,1,1.0,1,0.37909305555867007,41
4561,7,65222,65222,0,0,0,0,1.0,1,1.0,1,1.0,1,0.4274465591673922,41
4562,12,65234,65234,0,0,0,0,1.0,1,1.0,1,1.0,1,0.35975701569224267,43
4563,12,65246,65246,0,0,0,0,1.0,1,1.0,1,1.0,1,0.3343871257508812,42
4564,12,65258,65258,0,0,0,0,1.0,1,1.0,1,1.0,1,0.3606739951287375,43
4565,17,65275,65275,0,0,0,0,1.0,1,1.0,1,1.0,1,0.31698919850107554,44
4566,13,65288,65288,0,0,0,0,1.0,1,1.0,1,1.0,1,0.241306840537349,45
4567,24,65312,65312,0,0,0,0,1.0,1,1.0,1,1.0,1,0.32735673241075514,47
4568,23,65335,65335,0,0,0,0,1.0,1,1.0,1,1.0,1,0.28853297517673887,47
4569,16,65351,65351,0,0,0,0,1.0,1,1.0,1,1.0,1,0.26686268743483643,49
4570,20,65371,65371,0,0,0,0,1.0,1,1.0,1,1.0,1,0.31508872129714943,49
4571,12,65383,65383,0,0,0,0,1.0,1,1.0,1,1.0,1,0.30429934176904105,48
4572,26,65409,65409,0,0,0,0,1.0,1,1.0,1,1.0,1,0.36668867608026795,48
4573,21,65430,65430,0,0,0,0,1.0,1,1.0,1,1.0,1,0.3454495363695089,48
4574,15,65445,65445,0,0,0,0,1.0,1,1.0,1,1.0,1,0.3412763749249951,50
4575,22,65467,65467,0,0,0,0,1.0,1,1.0,1,1.0,1,0.3704422487671665,51
4576,13,65480,65480,0,0,0,0,1.0,1,1.0,1,1.0,1,0.3955254457714628,48
4577,19,65499,65499,0,0,0,0,1.0,1,1.0,1,1.0,1,0.41408566661293533,47
4578,15,65514,65514,0,0,0,0,1.0,1,1.0,1,1.0,1,0.4078491628101779,46
4579,21,65535,65535,0,0,0,0,1.0,1,1.0,1,1.0,1,0.37868175886725364,46
4580,18,65553,65553,0,0,0,0,1.0,1,1.0,1,1.0,1,0.3416938153127077,47
4581,9,65562,65562,0,0,0,0,1.0,1,1.0,1,1.0,1,0.35576365162847273,47
4582,12,65574,65574,0,0,0,0,1.0,1,1.0,1,1.0,1,0.39855230755688814,48
4583,9,65583,65583,0,0,0,0,1.0,1,1.0,1,1.0,1,0.3496927106344456,48
4584,15,65598,65598,0,0,0,0,1.0,1,1.0,1,1.0,1,0.3669022781023696,50
4585,12,65610,65610,0,0,0,0,1.0,1,1.0,1,1.0,1,0.40132379974944443,50
4586,8,65618,65618,0,0,0,0,1.0,1,1.0,1,1.0,1,0.3088937520696798,50
4587,14,65632,65632,0,0,0,0,1.0,1,1.0,1,1.0,1,0.340489219193118,50
4588,14,65646,65646,0,0,0,0,1.0,1,1.0,1,1.0,1,0.334418868271357,50
4589,16,65662,65662,0,0,0,0,1.0,1,1.0,1,1.0,1,0.3725677977970798,52
4590,15,65677,65677,0,0,0,0,1.0,1,1.0,1,1.0,1,0.3950092256567685,52
4591,14,65691,65691,0,0,0,0,1.0,1,1.0,1,1.0,1,0.3680197566506536,53
4592,14,65705,65705,0,0,0,0,1.0,1,1.0,1,1.0,1,0.34182010950603786,54
4593,10,65715,65715,0,0,0,0,1.0,1,1.0,1,1.0,1,0.3058499758055581,56
4594,23,65738,65738,0,0,0,0,1.0,1,1.0,1,1.0,1,0.31638068074239584,57
4595,25,65763,65763,0,0,0,0,1.0,1,1.0,1,1.0,1,0.29656462700527453,56
4596,22,65785,65785,0,0,0,0,1.0,1,1.0,1,1.0,1,0.2784100093859101,56
4597,15,65800,65800,0,0,0,0,1.0,1,1.0,1,1.0,1,0.33359737375671283,56
4598,12,65812,65812,0,0,0,0,1.0,1,1.0,1,1.0,1,0.2473441874765423,57
4599,14,65826,65826,0,0,0,0,1.0,1,1.0,1,1.0,1,0.32269580589693064,59
4600,19,65845,65845,0,0,0,0,1.0,1,1.0,1,1.0,1,0.3120543559940368,60
4601,22,65867,65867,0,0,0,0,1.0,1,1.0,1,1.0,1,0.3105159748956357,60
4602,17,65884,65884,0,0,0,0,1.0,1,1.0,1,1.0,1,0.326945860802261,62
4603,13,65897,65897,0,0,0,0,1.0,1,1.0,1,1.0,1,0.4003747420812151,62
4604,19,65916,65916,0,0,0,0,1.0,1,1.0,1,1.0,1,0.31292721687569075,63
4605,14,65930,65930,0,0,0,0,1.0,1,1.0,1,1.0,1,0.3347223299660204,63
4606,12,65942,65942,0,0,0,0,1.0,1,1.0,1,1.0,1,0.3142575929579628,64
4607,25,65967,65967,0,0,0,0,1.0,1,1.0,1,1.0,1,0.340424668382487,65
4608,17,65984,65984,0,0,0,0,1.0,1,1.0,1,1.0,1,0.38151157827691523,66
4609,21,66005,66005,0,0,0,0,1.0,1,1.0,1,1.0,1,0.3450242704196028,65
4610,14,66019,66019,0,0,0,0,1.0,1,1.0,1,1.0,1,0.38806362821688567,63
4611,28,66047,66047,0,0,0,0,1.0,1,1.0,1,1.0,1,0.33281979609537654,64
4612,29,66076,66076,0,0,0,0,1.0,1,1.0,1,1.0,1,0.33501344037723435,62
4613,24,66100,66100,0,0,0,0,1.0,1,1.0,1,1.0,1,0.3637478280982487,63
4614,20,66120,66120,0,0,0,0,1.0,1,1.0,1,1.0,1,0.35053980856821865,61
4615,27,66147,66147,0,0,0,0,1.0,1,1.0,1,1.0,1,0.4604053450978024,59
4616,16,66163,66163,0,0,0,0,1.0,1,1.0,1,1.0,1,0.37111673639720294,58
4617,17,66180,66180,0,0,0,0,1.0,1,1.0,1,1.0,1,0.4620898319680926,58
4618,30,66210,66210,0,0,0,0,1.0,1,1.0,1,1.0,1,0.3820572011205778,57
4619,21,66231,66231,0,0,0,0,1.0,1,1.0,1,1.0,1,0.3961256402151549,57
4620,22,66253,66253,0,0,0,0,1.0,1,1.0,1,1.0,1,0.4646619290919618,57
4621,32,66285,66285,0,0,0,0,1.0,1,1.0,1,1.0,1,0.3372398407626815,59
4622,34,66319,66319,0,0,0,0,1.0,1,1.0,1,1.0,1,0.4284681032490296,60
4623,24,66343,66343,0,0,0,0,1.0,1,1.0,1,1.0,1,0.3906280350432969,59
4624,36,66379,66379,0,0,0,0,1.0,1,1.0,1,1.0,1,0.41251860534910656,59
4625,23,66402,66402,0,0,0,0,1.0,1,1.0,1,1.0,1,0.2913348177422214,57
4626,30,66432,66432,0,0,0,0,1.0,1,1.0,1,1.0,1,0.4888363244150245,56
4627,18,66450,66450,0,0,0,0,1.0,1,1.0,1,1.0,1,0.4219250857370504,56
4628,28,66478,66478,0,0,0,0,1.0,1,1.0,1,1.0,1,0.41007707138386296,56
4629,21,66499,66499,0,0,0,0,1.0,1,1.0,1,1.0,1,0.48620562553532876,56
4630,19,66518,66518,0,0,0,0,1.0,1,1.0,1,1.0,1,0.4221059751552021,57
4631,25,66543,66543,0,0,0,0,1.0,1,1.0,1,1.0,1,0.4401857632350669,56
4632,25,66568,66568,0,0,0,0,1.0,1,1.0,1,1.0,1,0.49379133900621464,57
4633,15,66583,66583,0,0,0,0,1.0,1,1.0,1,1.0,1,0.4184765396597851,58
4634,28,66611,66611,0,0,0,0,1.0,1,1.0,1,1.0,1,0.4474464879280937,58
4635,20,66631,66631,0,0,0,0,1.0,1,1.0,1,1.0,1,0.4541266215951757,59
4636,27,66658,66658,0,0,0,0,1.0,1,1.0,1,1.0,1,0.40186281183286054,60
4637,23,66681,66681,0,0,0,0,1.0,1,1.0,1,1.0,1,0.4463338791302662,60
4638,46,66727,66727,0,0,0,0,1.0,1,1.0,1,1.0,1,0.48883579664138166,61
4639,33,66760,66760,0,0,0,0,1.0,1,1.0,1,1.0,1,0.39931371043518565,62
4640,25,66785,66785,0,0,0,0,1.0,1,1.0,1,1.0,1,0.5165061813042117,63
4641,32,66817,66817,0,0,0,0,1.0,1,1.0,1,1.0,1,0.4601482854114809,63
4642,39,66856,66856,0,0,0,0,1.0,1,1.0,1,1.0,1,0.4204147468284062,62
4643,21,66877,66877,0,0,0,0,1.0,1,1.0,1,1.0,1,0.39911802689196146,63
4644,20,66897,66897,0,0,0,0,1.0,1,1.0,1,1.0,1,0.5140838422353853,62
4645,19,66916,66916,0,0,0,0,1.0,1,1.0,1,1.0,1,0.4125103614770349,63
4646,26,66942,66942,0,0,0,0,1.0,1,1.0,1,1.0,1,0.4666089368242652,63
4647,29,66971,66971,0,0,0,0,1.0,1,1.0,1,1.0,1,0.4386253652971354,62
4648,42,67013,67013,0,0,0,0,1.0,1,1.0,1,1.0,1,0.41489157559536205,63
4649,31,67044,67044,0,0,0,0,1.0,1,1.0,1,1.0,1,0.47898551460503874,61
4650,40,67084,67084,0,0,0,0,1.0,1,1.0,1,1.0,1,0.3102409345754162,63
4651,41,67125,67125,0,0,0,0,1.0,1,1.0,1,1.0,1,0.3824819851379308,62
4652,38,67163,67163,0,0,0,0,1.0,1,1.0,1,1.0,1,0.42303194050726517,59
4653,38,67201,67201,0,0,0,0,1.0,1,1.0,1,1.0,1,0.33768902731479905,60
4654,37,67238,67238,0,0,0,0,1.0,1,1.0,1,1.0,1,0.4092091968132607,60
4655,25,67263,67263,0,0,0,0,1.0,1,1.0,1,1.0,1,0.41733608195484745,60
4656,22,67285,67285,0,0,0,0,1.0,1,1.0,1,1.0,1,0.46771592878580426,61
4657,23,67308,67308,0,0,0,0,1.0,1,1.0,1,1.0,1,0.38943242233838304,62
4658,20,67328,67328,0,0,0,0,1.0,1,1.0,1,1.0,1,0.43973586144779103,62
4659,12,67340,67340,0,0,0,0,1.0,1,1.0,1,1.0,1,0.3773255253997484,61
4660,15,67355,67355,0,0,0,0,1.0,1,1.0,1,1.0,1,0.3745781291704409,61
4661,17,67372,67372,0,0,0,0,1.0,1,1.0,1,1.0,1,0.39856348180719886,61
4662,20,67392,67392,0,0,0,0,1.0,1,1.0,1,1.0,1,0.48252452482897473,62
4663,16,67408,67408,0,0,0,0,1.0,1,1.0,1,1.0,1,0.41594901139714346,61
4664,24,67432,67432,0,0,0,0,1.0,1,1.0,1,1.0,1,0.32881216729433305,62
4665,23,67455,67455,0,0,0,0,1.0,1,1.0,1,1.0,1,0.4138509041624737,61
4666,24,67479,67479,0,0,0,0,1.0,1,1.0,1,1.0,1,0.3479580678807705,61
4667,26,67505,67505,0,0,0,0,1.0,1,1.0,1,1.0,1,0.3107592222835004,59
4668,24,67529,67529,0,0,0,0,1.0,1,1.0,1,1.0,1,0.3987308305325591,59
4669,42,67571,67571,0,0,0,0,1.0,1,1.0,1,1.0,1,0.3587612010721213,58
4670,20,67591,67591,0,0,0,0,1.0,1,1.0,1,1.0,1,0.339487097268586,57
4671,18,67609,67609,0,0,0,0,1.0,1,1.0,1,1.0,1,0.43507102164403827,55
4672,17,67626,67626,0,0,0,0,1.0,1,1.0,1,1.0,1,0.3796615812349799,56
4673,23,67649,67649,0,0,0,0,1.0,1,1.0,1,1.0,1,0.3510438061499701,58
4674,18,67667,67667,0,0,0,0,1.0,1,1.0,1,1.0,1,0.33625791067211186,58
4675,23,67690,67690,0,0,0,0,1.0,1,1.0,1,1.0,1,0.32929087237778787,57
4676,28,67718,67718,0,0,0,0,1.0,1,1.0,1,1.0,1,0.36312605294804906,58
4677,22,67740,67740,0,0,0,0,1.0,1,1.0,1,1.0,1,0.34238608595121517,57
4678,39,67779,67779,0,0,0,0,1.0,1,1.0,1,1.0,1,0.3608500722636613,57
4679,19,67798,67798,0,0,0,0,1.0,1,1.0,1,1.0,1,0.40834572982176753,57
4680,19,67817,67817,0,0,0,0,1.0,1,1.0,1,1.0,1,0.29986749109172706,59
4681,24,67841,67841,0,0,0,0,1.0,1,1.0,1,1.0,1,0.3438334796096982,60
4682,23,67864,67864,0,0,0,0,1.0,1,1.0,1,1.0,1,0.36525585773958563,60
4683,42,67906,67906,0,0,0,0,1.0,1,1.0,1,1.0,1,0.27357687781205,60
4684,26,67932,67932,0,0,0,0,1.0,1,1.0,1,1.0,1,0.3401260108260302,60
4685,27,67959,67959,0,0,0,0,1.0,1,1.0,1,1.0,1,0.32440464488495946,59
4686,21,67980,67980,0,0,0,0,1.0,1,1.0,1,1.0,1,0.2763377082581132,60
4687,18,67998,67998,0,0,0,0,1.0,1,1.0,1,1.0,1,0.33831763206791804,59
4688,18,68016,68016,0,0,0,0,1.0,1,1.0,1,1.0,1,0.2969838232779884,59
4689,20,68036,68036,0,0,0,0,1.0,1,1.0,1,1.0,1,0.3578195592636202,59
4690,15,68051,68051,0,0,0,0,1.0,1,1.0,1,1.0,1,0.2950487378408346,58
4691,18,68069,68069,0,0,0,0,1.0,1,1.0,1,1.0,1,0.2832749968566637,57
4692,20,68089,68089,0,0,0,0,1.0,1,1.0,1,1.0,1,0.3046143072480838,58
4693,15,68104,68104,0,0,0,0,1.0,1,1.0,1,1.0,1,0.32313541303715654,57
4694,20,68124,68124,0,0,0,0,1.0,1,1.0,1,1.0,1,0.23377989661468115,57
4695,16,68140,68140,0,0,0,0,1.0,1,1.0,1,1.0,1,0.34020086150792733,56
4696,20,68160,68160,0,0,0,0,1.0,1,1.0,1,1.0,1,0.3433337919938589,57
4697,22,68182,68182,0,0,0,0,1.0,1,1.0,1,1.0,1,0.2690962140137338,58
4698,19,68201,68201,0,0,0,0,1.0,1,1.0,1,1.0,1,0.33601935349951834,59
4699,16,68217,68217,0,0,0,0,1.0,1,1.0,1,1.0,1,0.3523093989788951,58
4700,25,68242,68242,0,0,0,0,1.0,1,1.0,1,1.0,1,0.33666883533295194,59
4701,28,68270,68270,0,0,0,0,1.0,1,1.0,1,1.0,1,0.38056864750871416,60
4702,19,68289,68289,0,0,0,0,1.0,1,1.0,1,1.0,1,0.31575696075796345,61
4703,21,68310,68310,0,0,0,0,1.0,1,1.0,1,1.0,1,0.3797785122950936,59
4704,15,68325,68325,0,0,0,0,1.0,1,1.0,1,1.0,1,0.41205098299820825,58
4705,24,68349,68349,0,0,0,0,1.0,1,1.0,1,1.0,1,0.39983024445233395,58
4706,27,68376,68376,0,0,0,0,1.0,1,1.0,1,1.0,1,0.35242685442542404,60
4707,19,68395,68395,0,0,0,0,1.0,1,1.0,1,1.0,1,0.4086924282730999,57
4708,23,68418,68418,0,0,0,0,1.0,1,1.0,1,1.0,1,0.29312492653515687,57
4709,15,68433,68433,0,0,0,0,1.0,1,1.0,1,1.0,1,0.44032830424779806,55
4710,22,68455,68455,0,0,0,0,1.0,1,1.0,1,1.0,1,0.3270823194795647,53
4711,23,68478,68478,0,0,0,0,1.0,1,1.0,1,1.0,1,0.4525367676099619,52
4712,11,68489,68489,0,0,0,0,1.0,1,1.0,1,1.0,1,0.4934488187057665,52
4713,29,68518,68518,0,0,0,0,1.0,1,1.0,1,1.0,1,0.4359273373898359,51
4714,10,68528,68528,0,0,0,0,1.0,1,1.0,1,1.0,1,0.43972806313240936,50
4715,27,68555,68555,0,0,0,0,1.0,1,1.0,1,1.0,1,0.4376488579779903,50
4716,14,68569,68569,0,0,0,0,1.0,1,1.0,1,1.0,1,0.4763525726396097,49
4717,10,68579,68579,0,0,0,0,1.0,1,1.0,1,1.0,1,0.3717986868957928,49
4718,11,68590,68590,0,0,0,0,1.0,1,1.0,1,1.0,1,0.3985900031933785,50
4719,14,68604,68604,0,0,0,0,1.0,1,1.0,1,1.0,1,0.41839449375294074,49
4720,11,68615,68615,0,0,0,0,1.0,1,1.0,1,1.0,1,0.3639595631389651,49
4721,14,68629,68629,0,0,0,0,1.0,1,1.0,1,1.0,1,0.37904093658177085,50
4722,30,68659,68659,0,0,0,0,1.0,1,1.0,1,1.0,1,0.392554115941442,51
4723,9,68668,68668,0,0,0,0,1.0,1,1.0,1,1.0,1,0.3960318522930858,50
4724,20,68688,68688,0,0,0,0,1.0,1,1.0,1,1.0,1,0.4362366381231454,50
4725,16,68704,68704,0,0,0,0,1.0,1,1.0,1,1.0,1,0.4692784842071564,52
4726,21,68725,68725,0,0,0,0,1.0,1,1.0,1,1.0,1,0.46891892552556935,51
4727,19,68744,68744,0,0,0,0,1.0,1,1.0,1,1.0,1,0.41706837928670815,52
4728,10,68754,68754,0,0,0,0,1.0,1,1.0,1,1.0,1,0.34250667433335064,52
4729,17,68771,68771,0,0,0,0,1.0,1,1.0,1,1.0,1,0.38165686572331137,52
4730,21,68792,68792,0,0,0,0,1.0,1,1.0,1,1.0,1,0.3232167586191747,50
4731,17,68809,68809,0,0,0,0,1.0,1,1.0,1,1.0,1,0.3957346583030983,51
4732,15,68824,68824,0,0,0,0,1.0,1,1.0,1,1.0,1,0.3825519657860965,52
4733,18,68842,68842,0,0,0,0,1.0,1,1.0,1,1.0,1,0.4442746543924094,53
4734,24,68866,68866,0,0,0,0,1.0,1,1.0,1,1.0,1,0.4085874194838811,53
4735,14,68880,68880,0,0,0,0,1.0,1,1.0,1,1.0,1,0.4212205893282892,53
4736,19,68899,68899,0,0,0,0,1.0,1,1.0,1,1.0,1,0.4020846305873123,55
4737,27,68926,68926,0,0,0,0,1.0,1,1.0,1,1.0,1,0.4574855029484841,57
4738,29,68955,68955,0,0,0,0,1.0,1,1.0,1,1.0,1,0.3306198682871617,57
4739,16,68971,68971,0,0,0,0,1.0,1,1.0,1,1.0,1,0.47813553631688066,57
4740,12,68983,68983,0,0,0,0,1.0,1,1.0,1,1.0,1,0.43485322557146444,57
4741,22,69005,69005,0,0,0,0,1.0,1,1.0,1,1.0,1,0.3951893408364864,58
4742,20,69025,69025,0,0,0,0,1.0,1,1.0,1,1.0,1,0.36875420092335487,58
4743,25,69050,69050,0,0,0,0,1.0,1,1.0,1,1.0,1,0.5359875384753083,56
4744,16,69066,69066,0,0,0,0,1.0,1,1.0,1,1.0,1,0.4902634921585053,57
4745,20,69086,69086,0,0,0,0,1.0,1,1.0,1,1.0,1,0.43364680892698965,56
4746,26,69112,69112,0,0,0,0,1.0,1,1.0,1,1.0,1,0.4528125157966567,56
4747,22,69134,69134,0,0,0,0,1.0,1,1.0,1,1.0,1,0.3995282606619325,55
4748,15,69149,69149,0,0,0,0,1.0,1,1.0,1,1.0,1,0.41754881578238817,55
4749,9,69158,69158,0,0,0,0,1.0,1,1.0,1,1.0,1,0.31076787511043896,54
4750,12,69170,69170,0,0,0,0,1.0,1,1.0,1,1.0,1,0.36957530816146206,53
4751,14,69184,69184,0,0,0,0,1.0,1,1.0,1,1.0,1,0.4799871275784516,53
4752,11,69195,69195,0,0,0,0,1.0,1,1.0,1,1.0,1,0.438032268397192,53
4753,12,69207,69207,0,0,0,0,1.0,1,1.0,1,1.0,1,0.5439447887033011,52
4754,21,69228,69228,0,0,0,0,1.0,1,1.0,1,1.0,1,0.39130103681352163,52
4755,21,69249,69249,0,0,0,0,1.0,1,1.0,1,1.0,1,0.43648627762553577,51
4756,19,69268,69268,0,0,0,0,1.0,1,1.0,1,1.0,1,0.4429415256150636,52
4757,18,69286,69286,0,0,0,0,1.0,1,1.0,1,1.0,1,0.47825341258304155,51
4758,18,69304,69304,0,0,0,0,1.0,1,1.0,1,1.0,1,0.454568568824396,51
4759,17,69321,69321,0,0,0,0,1.0,1,1.0,1,1.0,1,0.3152168850224724,51
4760,21,69342,69342,0,0,0,0,1.0,1,1.0,1,1.0,1,0.28870938058422785,52
4761,23,69365,69365,0,0,0,0,1.0,1,1.0,1,1.0,1,0.3350926288226201,50
4762,14,69379,69379,0,0,0,0,1.0,1,1.0,1,1.0,1,0.26814480550525527,51
4763,15,69394,69394,0,0,0,0,1.0,1,1.0,1,1.0,1,0.2767045302366311,51
4764,15,69409,69409,0,0,0,0,1.0,1,1.0,1,1.0,1,0.2933019272640109,53
4765,14,69423,69423,0,0,0,0,1.0,1,1.0,1,1.0,1,0.3459663702843809,53
4766,14,69437,69437,0,0,0,0,1.0,1,1.0,1,1.0,1,0.34756307609141823,55
4767,17,69454,69454,0,0,0,0,1.0,1,1.0,1,1.0,1,0.24388421095313775,56
4768,20,69474,69474,0,0,0,0,1.0,1,1.0,1,1.0,1,0.32744460060507485,56
4769,19,69493,69493,0,0,0,0,1.0,1,1.0,1,1.0,1,0.2869861965722955,56
4770,13,69506,69506,0,0,0,0,1.0,1,1.0,1,1.0,1,0.3924033243881802,56
4771,10,69516,69516,0,0,0,0,1.0,1,1.0,1,1.0,1,0.44018311288598627,55
4772,17,69533,69533,0,0,0,0,1.0,1,1.0,1,1.0,1,0.37677319001277176,56
4773,14,69547,69547,0,0,0,0,1.0,1,1.0,1,1.0,1,0.4478235127224865,56
4774,13,69560,69560,0,0,0,0,1.0,1,1.0,1,1.0,1,0.33121633866954925,58
4775,18,69578,69578,0,0,0,0,1.0,1,1.0,1,1.0,1,0.36670479071634604,59
4776,25,69603,69603,0,0,0,0,1.0,1,1.0,1,1.0,1,0.4022246256334597,59
4777,20,69623,69623,0,0,0,0,1.0,1,1.0,1,1.0,1,0.3887579870630724,60
4778,16,69639,69639,0,0,0,0,1.0,1,1.0,1,1.0,1,0.3528069523671225,60
4779,15,69654,69654,0,0,0,0,1.0,1,1.0,1,1.0,1,0.4095763254445441,61
4780,14,69668,69668,0,0,0,0,1.0,1,1.0,1,1.0,1,0.31882375310495087,63
4781,14,69682,69682,0,0,0,0,1.0,1,1.0,1,1.0,1,0.26386713145684165,62
4782,13,69695,69695,0,0,0,0,1.0,1,1.0,1,1.0,1,0.3121291598323538,63
4783,13,69708,69708,0,0,0,0,1.0,1,1.0,1,1.0,1,0.23778715680464022,62
4784,17,69725,69725,0,0,0,0,1.0,1,1.0,1,1.0,1,0.18628817240838635,62
4785,19,69744,69744,0,0,0,0,1.0,1,1.0,1,1.0,1,0.17822639378591276,62
4786,25,69769,69769,0,0,0,0,1.0,1,1.0,1,1.0,1,0.20455311109141971,63
4787,20,69789,69789,0,0,0,0,1.0,1,1.0,1,1.0,1,0.15607485802620683,62
4788,14,69803,69803,0,0,0,0,1.0,1,1.0,1,1.0,1,0.17857611873495008,62
4789,24,69827,69827,0,0,0,0,1.0,1,1.0,1,1.0,1,0.11557749103124211,60
4790,19,69846,69846,0,0,0,0,1.0,1,1.0,1,1.0,1,0.1363308910617948,61
4791,13,69859,69859,0,0,0,0,1.0,1,1.0,1,1.0,1,0.1631928763417224,60
4792,10,69869,69869,0,0,0,0,1.0,1,1.0,1,1.0,1,0.13896750179054362,60
4793,9,69878,69878,0,0,0,0,1.0,1,1.0,1,1.0,1,0.190969549164252,61
4794,9,69887,69887,0,0,0,0,1.0,1,1.0,1,1.0,1,0.26530184684341235,59
4795,13,69900,69900,0,0,0,0,1.0,1,1.0,1,1.0,1,0.2666413943035886,61
4796,11,69911,69911,0,0,0,0,1.0,1,1.0,1,1.0,1,0.25079445222148244,59
4797,13,69924,69924,0,0,0,0,1.0,1,1.0,1,1.0,1,0.2602363534710534,58
4798,8,69932,69932,0,0,0,0,1.0,1,1.0,1,1.0,1,0.2793715261032424,59
4799,9,69941,69941,0,0,0,0,1.0,1,1.0,1,1.0,1,0.32407119362423426,57
4800,11,69952,69952,0,0,0,0,1.0,1,1.0,1,1.0,1,0.33819926790846966,58
4801,17,69969,69969,0,0,0,0,1.0,1,1.0,1,1.0,1,0.30970502807031697,57
4802,10,69979,69979,0,0,0,0,1.0,1,1.0,1,1.0,1,0.3586162958926495,57
4803,12,69991,69991,0,0,0,0,1.0,1,1.0,1,1.0,1,0.28397681399286157,56
4804,20,70011,70011,0,0,0,0,1.0,1,1.0,1,1.0,1,0.2838980715136401,54
4805,14,70025,70025,0,0,0,0,1.0,1,1.0,1,1.0,1,0.3229859547096636,56
4806,12,70037,70037,0,0,0,0,1.0,1,1.0,1,1.0,1,0.34408992085529494,55
4807,23,70060,70060,0,0,0,0,1.0,1,1.0,1,1.0,1,0.32240574640485514,54
4808,16,70076,70076,0,0,0,0,1.0,1,1.0,1,1.0,1,0.32386889923664824,53
4809,19,70095,70095,0,0,0,0,1.0,1,1.0,1,1.0,1,0.3223037678339614,53
4810,18,70113,70113,0,0,0,0,1.0,1,1.0,1,1.0,1,0.3257570807559671,51
4811,20,70133,70133,0,0,0,0,1.0,1,1.0,1,1.0,1,0.34024286428863787,52
4812,19,70152,70152,0,0,0,0,1.0,1,1.0,1,1.0,1,0.3077536260616406,52
4813,15,70167,70167,0,0,0,0,1.0,1,1.0,1,1.0,1,0.25230347522908997,52
4814,15,70182,70182,0,0,0,0,1.0,1,1.0,1,1.0,1,0.2461061941082001,53
4815,12,70194,70194,0,0,0,0,1.0,1,1.0,1,1.0,1,0.272716875945521,54
4816,17,70211,70211,0,0,0,0,1.0,1,1.0,1,1.0,1,0.2373040646751118,54
4817,12,70223,70223,0,0,0,0,1.0,1,1.0,1,1.0,1,0.22591851329040985,55
4818,10,70233,70233,0,0,0,0,1.0,1,1.0,1,1.0,1,0.29111798782607484,55
4819,10,70243,70243,0,0,0,0,1.0,1,1.0,1,1.0,1,0.2615953390154745,55
4820,11,70254,70254,0,0,0,0,1.0,1,1.0,1,1.0,1,0.30174439208047493,55
4821,12,70266,70266,0,0,0,0,1.0,1,1.0,1,1.0,1,0.40092467856403485,55
4822,10,70276,70276,0,0,0,0,1.0,1,1.0,1,1.0,1,0.39857132402556794,54
4823,8,70284,70284,0,0,0,0,1.0,1,1.0,1,1.0,1,0.35857058485540105,54
4824,8,70292,70292,0,0,0,0,1.0,1,1.0,1,1.0,1,0.3901593435228218,55
4825,7,70299,70299,0,0,0,0,1.0,1,1.0,1,1.0,1,0.3947442386977883,53
4826,9,70308,70308,0,0,0,0,1.0,1,1.0,1,1.0,1,0.31497083568428147,54
4827,14,70322,70322,0,0,0,0,1.0,1,1.0,1,1.0,1,0.4613639178781955,53
4828,12,70334,70334,0,0,0,0,1.0,1,1.0,1,1.0,1,0.3843633735443786,54
4829,8,70342,70342,0,0,0,0,1.0,1,1.0,1,1.0,1,0.37295374715039603,54
4830,11,70353,70353,0,0,0,0,1.0,1,1.0,1,1.0,1,0.3479981290206764,53
4831,8,70361,70361,0,0,0,0,1.0,1,1.0,1,1.0,1,0.36608871074992516,52
4832,6,70367,70367,0,0,0,0,1.0,1,1.0,1,1.0,1,0.35202145241635335,50
4833,9,70376,70376,0,0,0,0,1.0,1,1.0,1,1.0,1,0.4375324297860979,51
4834,10,70386,70386,0,0,0,0,1.0,1,1.0,1,1.0,1,0.3790601113532978,51
4835,16,70402,70402,0,0,0,0,1.0,1,1.0,1,1.0,1,0.3280135805114279,50
4836,13,70415,70415,0,0,0,0,1.0,1,1.0,1,1.0,1,0.32173941976464765,50
4837,20,70435,70435,0,0,0,0,1.0,1,1.0,1,1.0,1,0.28476452926541435,46
4838,23,70458,70458,0,0,0,0,1.0,1,1.0,1,1.0,1,0.2585944571114551,47
4839,13,70471,70471,0,0,0,0,1.0,1,1.0,1,1.0,1,0.3392161959369201,45
4840,18,70489,70489,0,0,0,0,1.0,1,1.0,1,1.0,1,0.37513552939190603,45
4841,9,70498,70498,0,0,0,0,1.0,1,1.0,1,1.0,1,0.3827928050695029,43
4842,11,70509,70509,0,0,0,0,1.0,1,1.0,1,1.0,1,0.4154326894686101,43
4843,13,70522,70522,0,0,0,0,1.0,1,1.0,1,1.0,1,0.34785290160630705,44
4844,16,70538,70538,0,0,0,0,1.0,1,1.0,1,1.0,1,0.33260147166629195,43
4845,20,70558,70558,0,0,0,0,1.0,1,1.0,1,1.0,1,0.4129317296424243,44
4846,10,70568,70568,0,0,0,0,1.0,1,1.0,1,1.0,1,0.39356568296212857,43
4847,14,70582,70582,0,0,0,0,1.0,1,1.0,1,1.0,1,0.3414287755236372,42
4848,14,70596,70596,0,0,0,0,1.0,1,1.0,1,1.0,1,0.35671131358199004,41
4849,12,70608,70608,0,0,0,0,1.0,1,1.0,1,1.0,1,0.3538706517783549,41
4850,11,70619,70619,0,0,0,0,1.0,1,1.0,1,1.0,1,0.3456036581000951,41
4851,21,70640,70640,0,0,0,0,1.0,1,1.0,1,1.0,1,0.428973389018337,41
4852,10,70650,70650,0,0,0,0,1.0,1,1.0,1,1.0,1,0.4661970167314724,43
4853,13,70663,70663,0,0,0,0,1.0,1,1.0,1,1.0,1,0.3995382897088051,44
4854,11,70674,70674,0,0,0,0,1.0,1,1.0,1,1.0,1,0.3196998490577338,45
4855,8,70682,70682,0,0,0,0,1.0,1,1.0,1,1.0,1,0.46478365040686315,44
4856,13,70695,70695,0,0,0,0,1.0,1,1.0,1,1.0,1,0.3967047816398505,44
4857,15,70710,70710,0,0,0,0,1.0,1,1.0,1,1.0,1,0.524471523365221,44
4858,7,70717,70717,0,0,0,0,1.0,1,1.0,1,1.0,1,0.38696116770546385,45
4859,21,70738,70738,0,0,0,0,1.0,1,1.0,1,1.0,1,0.4983481030636936,46
4860,6,70744,70744,0,0,0,0,1.0,1,1.0,1,1.0,1,0.38051450125354835,46
4861,6,70750,70750,0,0,0,0,1.0,1,1.0,1,1.0,1,0.4288814274834911,46
4862,15,70765,70765,0,0,0,0,1.0,1,1.0,1,1.0,1,0.4236343866288548,47
4863,14,70779,70779,0,0,0,0,1.0,1,1.0,1,1.0,1,0.40506622807177495,47
4864,9,70788,70788,0,0,0,0,1.0,1,1.0,1,1.0,1,0.3586333466992176,47
4865,16,70804,70804,0,0,0,0,1.0,1,1.0,1,1.0,1,0.31737964697366555,48
4866,14,70818,70818,0,0,0,0,1.0,1,1.0,1,1.0,1,0.3448128783922873,49
4867,13,70831,70831,0,0,0,0,1.0,1,1.0,1,1.0,1,0.33097005817925657,50
4868,20,70851,70851,0,0,0,0,1.0,1,1.0,1,1.0,1,0.3246195409607803,50
4869,10,70861,70861,0,0,0,0,1.0,1,1.0,1,1.0,1,0.27804764213748034,50
4870,15,70876,70876,0,0,0,0,1.0,1,1.0,1,1.0,1,0.2800482833864374,52
4871,12,70888,70888,0,0,0,0,1.0,1,1.0,1,1.0,1,0.3133355804034,52
4872,9,70897,70897,0,0,0,0,1.0,1,1.0,1,1.0,1,0.31293146952261625,53
4873,15,70912,70912,0,0,0,0,1.0,1,1.0,1,1.0,1,0.39735314185182596,55
4874,19,70931,70931,0,0,0,0,1.0,1,1.0,1,1.0,1,0.3080596173400249,56
4875,10,70941,70941,0,0,0,0,1.0,1,1.0,1,1.0,1,0.32264331552131525,55
4876,14,70955,70955,0,0,0,0,1.0,1,1.0,1,1.0,1,0.32741673703693563,55
4877,14,70969,70969,0,0,0,0,1.0,1,1.0,1,1.0,1,0.3596839933200098,54
4878,10,70979,70979,0,0,0,0,1.0,1,1.0,1,1.0,1,0.3470524680898367,53
4879,22,71001,71001,0,0,0,0,1.0,1,1.0,1,1.0,1,0.3321764557900158,54
4880,10,71011,71011,0,0,0,0,1.0,1,1.0,1,1.0,1,0.34439123321199927,54
4881,21,71032,71032,0,0,0,0,1.0,1,1.0,1,1.0,1,0.29015662106564455,53
4882,14,71046,71046,0,0,0,0,1.0,1,1.0,1,1.0,1,0.345620015898451,53
4883,15,71061,71061,0,0,0,0,1.0,1,1.0,1,1.0,1,0.3468230998192718,53
4884,11,71072,71072,0,0,0,0,1.0,1,1.0,1,1.0,1,0.39278477146263535,51
4885,9,71081,71081,0,0,0,0,1.0,1,1.0,1,1.0,1,0.3577141833526394,50
4886,15,71096,71096,0,0,0,0,1.0,1,1.0,1,1.0,1,0.425602008244296,48
4887,5,71101,71101,0,0,0,0,1.0,1,1.0,1,1.0,1,0.4197738428958921,48
4888,11,71112,71112,0,0,0,0,1.0,1,1.0,1,1.0,1,0.4023833350588492,48
4889,8,71120,71120,0,0,0,0,1.0,1,1.0,1,1.0,1,0.3016628047631761,48
4890,10,71130,71130,0,0,0,0,1.0,1,1.0,1,1.0,1,0.4147525430115341,49
4891,13,71143,71143,0,0,0,0,1.0,1,1.0,1,1.0,1,0.34081612108966075,50
4892,8,71151,71151,0,0,0,0,1.0,1,1.0,1,1.0,1,0.23338387751822576,49
4893,22,71173,71173,0,0,0,0,1.0,1,1.0,1,1.0,1,0.3866998901690459,50
4894,13,71186,71186,0,0,0,0,1.0,1,1.0,1,1.0,1,0.241842875882994,51
4895,19,71205,71205,0,0,0,0,1.0,1,1.0,1,1.0,1,0.28839707425022604,52
4896,26,71231,71231,0,0,0,0,1.0,1,1.0,1,1.0,1,0.2517768717731548,53
4897,10,71241,71241,0,0,0,0,1.0,1,1.0,1,1.0,1,0.2679492781089364,53
4898,29,71270,71270,0,0,0,0,1.0,1,1.0,1,1.0,1,0.2929308277022699,53
4899,18,71288,71288,0,0,0,0,1.0,1,1.0,1,1.0,1,0.18616075889682135,55
4900,15,71303,71303,0,0,0,0,1.0,1,1.0,1,1.0,1,0.2977701200994879,55
4901,17,71320,71320,0,0,0,0,1.0,1,1.0,1,1.0,1,0.328780236878344,56
4902,26,71346,71346,0,0,0,0,1.0,1,1.0,1,1.0,1,0.24193194689580952,58
4903,33,71379,71379,0,0,0,0,1.0,1,1.0,1,1.0,1,0.3363395698883286,58
4904,22,71401,71401,0,0,0,0,1.0,1,1.0,1,1.0,1,0.30745191164156227,57
4905,18,71419,71419,0,0,0,0,1.0,1,1.0,1,1.0,1,0.30142882974428026,54
4906,13,71432,71432,0,0,0,0,1.0,1,1.0,1,1.0,1,0.385241230888906,55
4907,21,71453,71453,0,0,0,0,1.0,1,1.0,1,1.0,1,0.4058043949761944,52
4908,22,71475,71475,0,0,0,0,1.0,1,1.0,1,1.0,1,0.3922307159180649,53
4909,12,71487,71487,0,0,0,0,1.0,1,1.0,1,1.0,1,0.39314565686426656,52
4910,21,71508,71508,0,0,0,0,1.0,1,1.0,1,1.0,1,0.4404561978000661,53
4911,19,71527,71527,0,0,0,0,1.0,1,1.0,1,1.0,1,0.4652182193366549,55
4912,15,71542,71542,0,0,0,0,1.0,1,1.0,1,1.0,1,0.4558638068792607,54
4913,23,71565,71565,0,0,0,0,1.0,1,1.0,1,1.0,1,0.39898042050180654,53
4914,23,71588,71588,0,0,0,0,1.0,1,1.0,1,1.0,1,0.4073945744388365,53
4915,24,71612,71612,0,0,0,0,1.0,1,1.0,1,1.0,1,0.3386510119012069,54
4916,20,71632,71632,0,0,0,0,1.0,1,1.0,1,1.0,1,0.3481969639969864,52
4917,18,71650,71650,0,0,0,0,1.0,1,1.0,1,1.0,1,0.3254803910651892,52
4918,14,71664,71664,0,0,0,0,1.0,1,1.0,1,1.0,1,0.3715975281329745,51
4919,16,71680,71680,0,0,0,0,1.0,1,1.0,1,1.0,1,0.39917174350196055,50
4920,17,71697,71697,0,0,0,0,1.0,1,1.0,1,1.0,1,0.3212897449658956,51
4921,11,71708,71708,0,0,0,0,1.0,1,1.0,1,1.0,1,0.27181571359920326,51
4922,19,71727,71727,0,0,0,0,1.0,1,1.0,1,1.0,1,0.2316950348658914,53
4923,21,71748,71748,0,0,0,0,1.0,1,1.0,1,1.0,1,0.346491782195457,53
4924,14,71762,71762,0,0,0,0,1.0,1,1.0,1,1.0,1,0.29525020811273545,55
4925,23,71785,71785,0,0,0,0,1.0,1,1.0,1,1.0,1,0.2593331592899915,56
4926,16,71801,71801,0,0,0,0,1.0,1,1.0,1,1.0,1,0.23742515392604624,55
4927,11,71812,71812,0,0,0,0,1.0,1,1.0,1,1.0,1,0.3192159486414866,55
4928,13,71825,71825,0,0,0,0,1.0,1,1.0,1,1.0,1,0.2649260042807173,55
4929,15,71840,71840,0,0,0,0,1.0,1,1.0,1,1.0,1,0.191632448392003,56
4930,13,71853,71853,0,0,0,0,1.0,1,1.0,1,1.0,1,0.26936255940147585,58
4931,15,71868,71868,0,0,0,0,1.0,1,1.0,1,1.0,1,0.27119931948805326,59
4932,17,71885,71885,0,0,0,0,1.0,1,1.0,1,1.0,1,0.3034468749087315,60
4933,11,71896,71896,0,0,0,0,1.0,1,1.0,1,1.0,1,0.24984099598577234,60
4934,10,71906,71906,0,0,0,0,1.0,1,1.0,1,1.0,1,0.29370046524353216,60
4935,11,71917,71917,0,0,0,0,1.0,1,1.0,1,1.0,1,0.2881333796036518,60
4936,17,71934,71934,0,0,0,0,1.0,1,1.0,1,1.0,1,0.3161308514039185,61
4937,15,71949,71949,0,0,0,0,1.0,1,1.0,1,1.0,1,0.40275059748333036,62
4938,14,71963,71963,0,0,0,0,1.0,1,1.0,1,1.0,1,0.33558575323502376,62
4939,13,71976,71976,0,0,0,0,1.0,1,1.0,1,1.0,1,0.37394521512507767,64
4940,13,71989,71989,0,0,0,0,1.0,1,1.0,1,1.0,1,0.4010995649892529,67
4941,16,72005,72005,0,0,0,0,1.0,1,1.0,1,1.0,1,0.39860747215882353,66
4942,13,72018,72018,0,0,0,0,1.0,1,1.0,1,1.0,1,0.3491046952906965,67
4943,20,72038,72038,0,0,0,0,1.0,1,1.0,1,1.0,1,0.35576634503900184,65
4944,17,72055,72055,0,0,0,0,1.0,1,1.0,1,1.0,1,0.3396661828233754,65
4945,8,72063,72063,0,0,0,0,1.0,1,1.0,1,1.0,1,0.3338356829236233,62
4946,13,72076,72076,0,0,0,0,1.0,1,1.0,1,1.0,1,0.304432551454929,61
4947,20,72096,72096,0,0,0,0,1.0,1,1.0,1,1.0,1,0.37280362038889486,59
4948,21,72117,72117,0,0,0,0,1.0,1,1.0,1,1.0,1,0.3175247718489637,59
4949,15,72132,72132,0,0,0,0,1.0,1,1.0,1,1.0,1,0.3762838943136045,57
4950,29,72161,72161,0,0,0,0,1.0,1,1.0,1,1.0,1,0.3348770929756587,58
4951,13,72174,72174,0,0,0,0,1.0,1,1.0,1,1.0,1,0.30562831940482044,55
4952,23,72197,72197,0,0,0,0,1.0,1,1.0,1,1.0,1,0.33182794241382746,53
4953,37,72234,72234,0,0,0,0,1.0,1,1.0,1,1.0,1,0.2433219262500895,54
4954,19,72253,72253,0,0,0,0,1.0,1,1.0,1,1.0,1,0.3201432097276923,52
4955,25,72278,72278,0,0,0,0,1.0,1,1.0,1,1.0,1,0.22194108034784701,51
4956,17,72295,72295,0,0,0,0,1.0,1,1.0,1,1.0,1,0.28673686216298366,47
4957,19,72314,72314,0,0,0,0,1.0,1,1.0,1,1.0,1,0.31266643082373646,48
4958,13,72327,72327,0,0,0,0,1.0,1,1.0,1,1.0,1,0.2728968482593407,47
4959,17,72344,72344,0,0,0,0,1.0,1,1.0,1,1.0,1,0.2637726516443714,47
4960,15,72359,72359,0,0,0,0,1.0,1,1.0,1,1.0,1,0.35147610909461013,48
4961,15,72374,72374,0,0,0,0,1.0,1,1.0,1,1.0,1,0.3126557257832507,49
4962,16,72390,72390,0,0,0,0,1.0,1,1.0,1,1.0,1,0.45606943356086077,49
4963,13,72403,72403,0,0,0,0,1.0,1,1.0,1,1.0,1,0.4028961554189269,51
4964,23,72426,72426,0,0,0,0,1.0,1,1.0,1,1.0,1,0.4659983979808523,51
4965,19,72445,72445,0,0,0,0,1.0,1,1.0,1,1.0,1,0.46175712176792594,51
4966,24,72469,72469,0,0,0,0,1.0,1,1.0,1,1.0,1,0.271619177024122,51
4967,8,72477,72477,0,0,0,0,1.0,1,1.0,1,1.0,1,0.3223909632907961,51
4968,12,72489,72489,0,0,0,0,1.0,1,1.0,1,1.0,1,0.24619706288019474,52
4969,14,72503,72503,0,0,0,0,1.0,1,1.0,1,1.0,1,0.23722031309595043,53
4970,16,72519,72519,0,0,0,0,1.0,1,1.0,1,1.0,1,0.2578663279766622,54
4971,14,72533,72533,0,0,0,0,1.0,1,1.0,1,1.0,1,0.24064460972662,55
4972,18,72551,72551,0,0,0,0,1.0,1,1.0,1,1.0,1,0.3194729210723474,56
4973,11,72562,72562,0,0,0,0,1.0,1,1.0,1,1.0,1,0.2944977671827653,57
4974,17,72579,72579,0,0,0,0,1.0,1,1.0,1,1.0,1,0.35319769285717595,56
4975,13,72592,72592,0,0,0,0,1.0,1,1.0,1,1.0,1,0.28668554028963866,57
4976,10,72602,72602,0,0,0,0,1.0,1,1.0,1,1.0,1,0.2785167189806887,57
4977,13,72615,72615,0,0,0,0,1.0,1,1.0,1,1.0,1,0.28256467816400144,57
4978,13,72628,72628,0,0,0,0,1.0,1,1.0,1,1.0,1,0.2740131992537231,58
4979,15,72643,72643,0,0,0,0,1.0,1,1.0,1,1.0,1,0.32995943710833203,58
4980,10,72653,72653,0,0,0,0,1.0,1,1.0,1,1.0,1,0.31870368993586023,59
4981,18,72671,72671,0,0,0,0,1.0,1,1.0,1,1.0,1,0.33429662064064836,60
4982,20,72691,72691,0,0,0,0,1.0,1,1.0,1,1.0,1,0.35808703556489413,61
4983,15,72706,72706,0,0,0,0,1.0,1,1.0,1,1.0,1,0.33074413516390977,61
4984,15,72721,72721,0,0,0,0,1.0,1,1.0,1,1.0,1,0.26921540343318473,59
4985,24,72745,72745,0,0,0,0,1.0,1,1.0,1,1.0,1,0.37937030670169636,58
4986,16,72761,72761,0,0,0,0,1.0,1,1.0,1,1.0,1,0.3858837848243024,59
4987,24,72785,72785,0,0,0,0,1.0,1,1.0,1,1.0,1,0.4121875678167406,58
4988,13,72798,72798,0,0,0,0,1.0,1,1.0,1,1.0,1,0.4105760441218754,57
4989,13,72811,72811,0,0,0,0,1.0,1,1.0,1,1.0,1,0.2982572800629608,54
4990,16,72827,72827,0,0,0,0,1.0,1,1.0,1,1.0,1,0.4093280187360445,53
4991,11,72838,72838,0,0,0,0,1.0,1,1.0,1,1.0,1,0.4143043330398817,52
4992,26,72864,72864,0,0,0,0,1.0,1,1.0,1,1.0,1,0.3242596360577907,48
4993,18,72882,72882,0,0,0,0,1.0,1,1.0,1,1.0,1,0.44009285604693604,48
4994,26,72908,72908,0,0,0,0,1.0,1,1.0,1,1.0,1,0.44323643297465665,45
4995,25,72933,72933,0,0,0,0,1.0,1,1.0,1,1.0,1,0.4966804832763733,45
4996,21,72954,72954,0,0,0,0,1.0,1,1.0,1,1.0,1,0.49064307403830787,45
4997,31,72985,72985,0,0,0,0,1.0,1,1.0,1,1.0,1,0.41016030182455115,42
4998,23,73008,73008,0,0,0,0,1.0,1,1.0,1,1.0,1,0.31531479057195194,44
4999,19,73027,73027,0,0,0,0,1.0,1,1.0,1,1.0,1,0.43396518194243644,44
5000,21,73048,73048,0,0,0,0,1.0,1,1.0,1,1.0,1,0.4919461599178545,42
5001,12,73060,73060,0,0,0,0,1.0,1,1.0,1,1.0,1,0.388664709032019,42
5002,21,73081,73081,0,0,0,0,1.0,1,1.0,1,1.0,1,0.4127951474255964,41
5003,18,73099,73099,0,0,0,0,1.0,1,1.0,1,1.0,1,0.4727770163719684,41
5004,16,73115,73115,0,0,0,0,1.0,1,1.0,1,1.0,1,0.5310617088699825,41
5005,32,73147,73147,0,0,0,0,1.0,1,1.0,1,1.0,1,0.5451474993122467,41
5006,31,73178,73178,0,0,0,0,1.0,1,1.0,1,1.0,1,0.3617825090367643,42
5007,11,73189,73189,0,0,0,0,1.0,1,1.0,1,1.0,1,0.4991540078358296,43
5008,12,73201,73201,0,0,0,0,1.0,1,1.0,1,1.0,1,0.3974386344876914,46
5009,14,73215,73215,0,0,0,0,1.0,1,1.0,1,1.0,1,0.5148909616137568,46
5010,14,73229,73229,0,0,0,0,1.0,1,1.0,1,1.0,1,0.3735617288757026,46
5011,22,73251,73251,0,0,0,0,1.0,1,1.0,1,1.0,1,0.5144616833285123,47
5012,14,73265,73265,0,0,0,0,1.0,1,1.0,1,1.0,1,0.5430722484261813,48
5013,12,73277,73277,0,0,0,0,1.0,1,1.0,1,1.0,1,0.44057632450226464,48
5014,26,73303,73303,0,0,0,0,1.0,1,1.0,1,1.0,1,0.5073816544059635,49
5015,18,73321,73321,0,0,0,0,1.0,1,1.0,1,1.0,1,0.388431044919949,50
5016,22,73343,73343,0,0,0,0,1.0,1,1.0,1,1.0,1,0.3839674833391384,51
5017,18,73361,73361,0,0,0,0,1.0,1,1.0,1,1.0,1,0.41292423528451894,51
5018,15,73376,73376,0,0,0,0,1.0,1,1.0,1,1.0,1,0.31626805202359903,51
5019,13,73389,73389,0,0,0,0,1.0,1,1.0,1,1.0,1,0.3754598813765479,51
5020,22,73411,73411,0,0,0,0,1.0,1,1.0,1,1.0,1,0.40678637542311114,51
5021,9,73420,73420,0,0,0,0,1.0,1,1.0,1,1.0,1,0.34575515243545246,52
5022,9,73429,73429,0,0,0,0,1.0,1,1.0,1,1.0,1,0.42967964268317127,52
5023,13,73442,73442,0,0,0,0,1.0,1,1.0,1,1.0,1,0.32997561902011674,52
5024,12,73454,73454,0,0,0,0,1.0,1,1.0,1,1.0,1,0.4085147003731863,51
5025,16,73470,73470,0,0,0,0,1.0,1,1.0,1,1.0,1,0.35877825627974214,50
5026,21,73491,73491,0,0,0,0,1.0,1,1.0,1,1.0,1,0.4002237003159358,49
5027,18,73509,73509,0,0,0,0,1.0,1,1.0,1,1.0,1,0.36452130239596026,47
5028,12,73521,73521,0,0,0,0,1.0,1,1.0,1,1.0,1,0.38880022352624427,47
5029,26,73547,73547,0,0,0,0,1.0,1,1.0,1,1.0,1,0.3351771188554736,46
5030,18,73565,73565,0,0,0,0,1.0,1,1.0,1,1.0,1,0.44140435285370805,48
5031,17,73582,73582,0,0,0,0,1.0,1,1.0,1,1.0,1,0.3232900996225251,46
5032,18,73600,73600,0,0,0,0,1.0,1,1.0,1,1.0,1,0.4328550763592374,46
5033,23,73623,73623,0,0,0,0,1.0,1,1.0,1,1.0,1,0.40246905998746324,47
5034,15,73638,73638,0,0,0,0,1.0,1,1.0,1,1.0,1,0.4110036246642446,48
5035,21,73659,73659,0,0,0,0,1.0,1,1.0,1,1.0,1,0.4769226495290818,47
5036,12,73671,73671,0,0,0,0,1.0,1,1.0,1,1.0,1,0.5543641904507343,47
5037,18,73689,73689,0,0,0,0,1.0,1,1.0,1,1.0,1,0.49734642031446197,47
5038,25,73714,73714,0,0,0,0,1.0,1,1.0,1,1.0,1,0.3959118781924827,48
5039,9,73723,73723,0,0,0,0,1.0,1,1.0,1,1.0,1,0.48237556342345683,47
5040,10,73733,73733,0,0,0,0,1.0,1,1.0,1,1.0,1,0.5583158597054262,48
5041,20,73753,73753,0,0,0,0,1.0,1,1.0,1,1.0,1,0.4030694944063613,49
5042,19,73772,73772,0,0,0,0,1.0,1,1.0,1,1.0,1,0.49164265771584115,50
5043,27,73799,73799,0,0,0,0,1.0,1,1.0,1,1.0,1,0.3530692343462552,51
5044,21,73820,73820,0,0,0,0,1.0,1,1.0,1,1.0,1,0.443858626155721,51
5045,19,73839,73839,0,0,0,0,1.0,1,1.0,1,1.0,1,0.3024504341553558,51
5046,29,73868,73868,0,0,0,0,1.0,1,1.0,1,1.0,1,0.39510901987029984,52
5047,8,73876,73876,0,0,0,0,1.0,1,1.0,1,1.0,1,0.3796010986256805,52
5048,24,73900,73900,0,0,0,0,1.0,1,1.0,1,1.0,1,0.4559437474786134,52
5049,12,73912,73912,0,0,0,0,1.0,1,1.0,1,1.0,1,0.4574528149476481,52
5050,12,73924,73924,0,0,0,0,1.0,1,1.0,1,1.0,1,0.4324738935295736,55
5051,26,73950,73950,0,0,0,0,1.0,1,1.0,1,1.0,1,0.4708101165725143,55
5052,17,73967,73967,0,0,0,0,1.0,1,1.0,1,1.0,1,0.45762212267652275,55
5053,31,73998,73998,0,0,0,0,1.0,1,1.0,1,1.0,1,0.39310291392962954,54
5054,12,74010,74010,0,0,0,0,1.0,1,1.0,1,1.0,1,0.4212772658501512,54
5055,14,74024,74024,0,0,0,0,1.0,1,1.0,1,1.0,1,0.44935596133756267,54
5056,16,74040,74040,0,0,0,0,1.0,1,1.0,1,1.0,1,0.43090457987824304,55
5057,20,74060,74060,0,0,0,0,1.0,1,1.0,1,1.0,1,0.26519048545686574,56
5058,39,74099,74099,0,0,0,0,1.0,1,1.0,1,1.0,1,0.42011859738395546,58
5059,28,74127,74127,0,0,0,0,1.0,1,1.0,1,1.0,1,0.29978132011204484,58
5060,17,74144,74144,0,0,0,0,1.0,1,1.0,1,1.0,1,0.3459458347771572,59
5061,22,74166,74166,0,0,0,0,1.0,1,1.0,1,1.0,1,0.3796772364731538,58
5062,27,74193,74193,0,0,0,0,1.0,1,1.0,1,1.0,1,0.314162421828224,58
5063,20,74213,74213,0,0,0,0,1.0,1,1.0,1,1.0,1,0.36543410276003846,57
5064,26,74239,74239,0,0,0,0,1.0,1,1.0,1,1.0,1,0.35887354617097483,57
5065,15,74254,74254,0,0,0,0,1.0,1,1.0,1,1.0,1,0.4525949867347641,56
5066,16,74270,74270,0,0,0,0,1.0,1,1.0,1,1.0,1,0.5103902448394237,55
5067,20,74290,74290,0,0,0,0,1.0,1,1.0,1,1.0,1,0.5223041103911107,54
5068,15,74305,74305,0,0,0,0,1.0,1,1.0,1,1.0,1,0.5383512869071209,54
5069,12,74317,74317,0,0,0,0,1.0,1,1.0,1,1.0,1,0.5193262497623449,53
5070,23,74340,74340,0,0,0,0,1.0,1,1.0,1,1.0,1,0.43072157206013745,53
5071,10,74350,74350,0,0,0,0,1.0,1,1.0,1,1.0,1,0.3418505398864123,53
5072,15,74365,74365,0,0,0,0,1.0,1,1.0,1,1.0,1,0.4824419233148726,53
5073,11,74376,74376,0,0,0,0,1.0,1,1.0,1,1.0,1,0.526286117398348,53
5074,7,74383,74383,0,0,0,0,1.0,1,1.0,1,1.0,1,0.4108625958615844,52
5075,17,74400,74400,0,0,0,0,1.0,1,1.0,1,1.0,1,0.49508855912081434,52
5076,10,74410,74410,0,0,0,0,1.0,1,1.0,1,1.0,1,0.37429642948389025,55
5077,14,74424,74424,0,0,0,0,1.0,1,1.0,1,1.0,1,0.4438976715391503,55
5078,11,74435,74435,0,0,0,0,1.0,1,1.0,1,1.0,1,0.41528842554861634,55
5079,14,74449,74449,0,0,0,0,1.0,1,1.0,1,1.0,1,0.41921176538421884,54
5080,6,74455,74455,0,0,0,0,1.0,1,1.0,1,1.0,1,0.4317594823361653,55
5081,9,74464,74464,0,0,0,0,1.0,1,1.0,1,1.0,1,0.46370833442485593,57
5082,17,74481,74481,0,0,0,0,1.0,1,1.0,1,1.0,1,0.3671930771487123,57
5083,15,74496,74496,0,0,0,0,1.0,1,1.0,1,1.0,1,0.33181275180472586,58
5084,22,74518,74518,0,0,0,0,1.0,1,1.0,1,1.0,1,0.41309193466637534,58
5085,23,74541,74541,0,0,0,0,1.0,1,1.0,1,1.0,1,0.21821059961258185,59
5086,18,74559,74559,0,0,0,0,1.0,1,1.0,1,1.0,1,0.23530755425519476,60
5087,34,74593,74593,0,0,0,0,1.0,1,1.0,1,1.0,1,0.30852742135471944,61
5088,35,74628,74628,0,0,0,0,1.0,1,1.0,1,1.0,1,0.342510541513577,62
5089,18,74646,74646,0,0,0,0,1.0,1,1.0,1,1.0,1,0.42729392466878274,63
5090,34,74680,74680,0,0,0,0,1.0,1,1.0,1,1.0,1,0.31339937062960366,63
5091,23,74703,74703,0,0,0,0,1.0,1,1.0,1,1.0,1,0.3628107467048117,63
5092,18,74721,74721,0,0,0,0,1.0,1,1.0,1,1.0,1,0.39711911809258454,63
5093,16,74737,74737,0,0,0,0,1.0,1,1.0,1,1.0,1,0.2822226653125549,63
5094,19,74756,74756,0,0,0,0,1.0,1,1.0,1,1.0,1,0.34436892597056307,64
5095,18,74774,74774,0,0,0,0,1.0,1,1.0,1,1.0,1,0.2972976223275465,64
5096,24,74798,74798,0,0,0,0,1.0,1,1.0,1,1.0,1,0.36687300441316273,67
5097,17,74815,74815,0,0,0,0,1.0,1,1.0,1,1.0,1,0.4122391187925986,67
5098,24,74839,74839,0,0,0,0,1.0,1,1.0,1,1.0,1,0.3967507428722087,68
5099,19,74858,74858,0,0,0,0,1.0,1,1.0,1,1.0,1,0.34454111252875264,70
5100,13,74871,74871,0,0,0,0,1.0,1,1.0,1,1.0,1,0.4093639596032922,71
5101,11,74882,74882,0,0,0,0,1.0,1,1.0,1,1.0,1,0.3532534867995904,71
5102,10,74892,74892,0,0,0,0,1.0,1,1.0,1,1.0,1,0.3639794316735592,70
5103,6,74898,74898,0,0,0,0,1.0,1,1.0,1,1.0,1,0.39013907804361636,67
5104,19,74917,74917,0,0,0,0,1.0,1,1.0,1,1.0,1,0.36978881837057254,67
5105,8,74925,74925,0,0,0,0,1.0,1,1.0,1,1.0,1,0.3498639126836451,63
5106,15,74940,74940,0,0,0,0,1.0,1,1.0,1,1.0,1,0.36322839092735265,63
5107,12,74952,74952,0,0,0,0,1.0,1,1.0,1,1.0,1,0.3346316410725295,60
5108,15,74967,74967,0,0,0,0,1.0,1,1.0,1,1.0,1,0.37233559258060245,56
5109,14,74981,74981,0,0,0,0,1.0,1,1.0,1,1.0,1,0.40298629452710594,56
5110,11,74992,74992,0,0,0,0,1.0,1,1.0,1,1.0,1,0.2980330071576737,52
5111,15,75007,75007,0,0,0,0,1.0,1,1.0,1,1.0,1,0.4814611607530965,51
5112,7,75014,75014,0,0,0,0,1.0,1,1.0,1,1.0,1,0.3722080496882125,50
5113,17,75031,75031,0,0,0,0,1.0,1,1.0,1,1.0,1,0.4119484898166065,48
5114,13,75044,75044,0,0,0,0,1.0,1,1.0,1,1.0,1,0.30444075037379564,46
5115,11,75055,75055,0,0,0,0,1.0,1,1.0,1,1.0,1,0.4411855753256495,44
5116,24,75079,75079,0,0,0,0,1.0,1,1.0,1,1.0,1,0.3384543296987759,44
5117,15,75094,75094,0,0,0,0,1.0,1,1.0,1,1.0,1,0.4463509395005166,46
5118,18,75112,75112,0,0,0,0,1.0,1,1.0,1,1.0,1,0.4397451893938728,46
5119,19,75131,75131,0,0,0,0,1.0,1,1.0,1,1.0,1,0.29186553276423804,46
5120,18,75149,75149,0,0,0,0,1.0,1,1.0,1,1.0,1,0.3539120376448012,46
5121,15,75164,75164,0,0,0,0,1.0,1,1.0,1,1.0,1,0.23828840854808128,46
5122,15,75179,75179,0,0,0,0,1.0,1,1.0,1,1.0,1,0.29355081785191145,46
5123,18,75197,75197,0,0,0,0,1.0,1,1.0,1,1.0,1,0.28046671501062004,45
5124,15,75212,75212,0,0,0,0,1.0,1,1.0,1,1.0,1,0.2191591540223978,47
5125,23,75235,75235,0,0,0,0,1.0,1,1.0,1,1.0,1,0.26936914981673865,50
5126,14,75249,75249,0,0,0,0,1.0,1,1.0,1,1.0,1,0.2979098030120283,50
5127,24,75273,75273,0,0,0,0,1.0,1,1.0,1,1.0,1,0.2880014771826801,52
5128,18,75291,75291,0,0,0,0,1.0,1,1.0,1,1.0,1,0.282236105748018,53
5129,21,75312,75312,0,0,0,0,1.0,1,1.0,1,1.0,1,0.35008532719427093,55
5130,16,75328,75328,0,0,0,0,1.0,1,1.0,1,1.0,1,0.21917126740485146,55
5131,10,75338,75338,0,0,0,0,1.0,1,1.0,1,1.0,1,0.31922858774341684,54
5132,11,75349,75349,0,0,0,0,1.0,1,1.0,1,1.0,1,0.3015241911082289,54
5133,12,75361,75361,0,0,0,0,1.0,1,1.0,1,1.0,1,0.32745845608748214,54
5134,11,75372,75372,0,0,0,0,1.0,1,1.0,1,1.0,1,0.28646789684589596,53
5135,16,75388,75388,0,0,0,0,1.0,1,1.0,1,1.0,1,0.2859126720387224,54
5136,18,75406,75406,0,0,0,0,1.0,1,1.0,1,1.0,1,0.3399322521983981,54
5137,11,75417,75417,0,0,0,0,1.0,1,1.0,1,1.0,1,0.2966802236446214,54
5138,11,75428,75428,0,0,0,0,1.0,1,1.0,1,1.0,1,0.3963178102985536,54
5139,7,75435,75435,0,0,0,0,1.0,1,1.0,1,1.0,1,0.4178846839831982,55
5140,18,75453,75453,0,0,0,0,1.0,1,1.0,1,1.0,1,0.3582675385280262,55
5141,16,75469,75469,0,0,0,0,1.0,1,1.0,1,1.0,1,0.36336200469784136,53
5142,13,75482,75482,0,0,0,0,1.0,1,1.0,1,1.0,1,0.35899024878760866,54
5143,14,75496,75496,0,0,0,0,1.0,1,1.0,1,1.0,1,0.30158272753619864,52
5144,8,75504,75504,0,0,0,0,1.0,1,1.0,1,1.0,1,0.3632813290368264,50
5145,14,75518,75518,0,0,0,0,1.0,1,1.0,1,1.0,1,0.3780555638008729,49
5146,14,75532,75532,0,0,0,0,1.0,1,1.0,1,1.0,1,0.3107709339482603,49
5147,19,75551,75551,0,0,0,0,1.0,1,1.0,1,1.0,1,0.43352932092639074,46
5148,14,75565,75565,0,0,0,0,1.0,1,1.0,1,1.0,1,0.3591259102445577,46
5149,8,75573,75573,0,0,0,0,1.0,1,1.0,1,1.0,1,0.3465707747226121,45
5150,15,75588,75588,0,0,0,0,1.0,1,1.0,1,1.0,1,0.3298426094453314,47
5151,21,75609,75609,0,0,0,0,1.0,1,1.0,1,1.0,1,0.20886811972176475,46
5152,15,75624,75624,0,0,0,0,1.0,1,1.0,1,1.0,1,0.3289211055088394,46
5153,15,75639,75639,0,0,0,0,1.0,1,1.0,1,1.0,1,0.3638022869694662,45
5154,23,75662,75662,0,0,0,0,1.0,1,1.0,1,1.0,1,0.28996809076532554,47
5155,17,75679,75679,0,0,0,0,1.0,1,1.0,1,1.0,1,0.4161577713767373,47
5156,16,75695,75695,0,0,0,0,1.0,1,1.0,1,1.0,1,0.37169520544163415,47
5157,30,75725,75725,0,0,0,0,1.0,1,1.0,1,1.0,1,0.34278924470850664,46
5158,29,75754,75754,0,0,0,0,1.0,1,1.0,1,1.0,1,0.22812954506933147,47
5159,20,75774,75774,0,0,0,0,1.0,1,1.0,1,1.0,1,0.29593822690151866,49
5160,15,75789,75789,0,0,0,0,1.0,1,1.0,1,1.0,1,0.38543309162131734,48
5161,20,75809,75809,0,0,0,0,1.0,1,1.0,1,1.0,1,0.23558108394264368,48
5162,16,75825,75825,0,0,0,0,1.0,1,1.0,1,1.0,1,0.4161574273688884,49
5163,21,75846,75846,0,0,0,0,1.0,1,1.0,1,1.0,1,0.3398519148097592,51
5164,22,75868,75868,0,0,0,0,1.0,1,1.0,1,1.0,1,0.4382036062544746,51
5165,24,75892,75892,0,0,0,0,1.0,1,1.0,1,1.0,1,0.37146655554462393,52
5166,24,75916,75916,0,0,0,0,1.0,1,1.0,1,1.0,1,0.3857243650021767,52
5167,21,75937,75937,0,0,0,0,1.0,1,1.0,1,1.0,1,0.32340668695322444,52
5168,21,75958,75958,0,0,0,0,1.0,1,1.0,1,1.0,1,0.1698162218769864,52
5169,17,75975,75975,0,0,0,0,1.0,1,1.0,1,1.0,1,0.3925963741530801,53
5170,14,75989,75989,0,0,0,0,1.0,1,1.0,1,1.0,1,0.3117594801075742,53
5171,7,75996,75996,0,0,0,0,1.0,1,1.0,1,1.0,1,0.2513978254413155,52
5172,9,76005,76005,0,0,0,0,1.0,1,1.0,1,1.0,1,0.2807958521848246,53
5173,9,76014,76014,0,0,0,0,1.0,1,1.0,1,1.0,1,0.2686426090262085,54
5174,11,76025,76025,0,0,0,0,1.0,1,1.0,1,1.0,1,0.3488015351348627,56
5175,18,76043,76043,0,0,0,0,1.0,1,1.0,1,1.0,1,0.2556229167010222,58
5176,14,76057,76057,0,0,0,0,1.0,1,1.0,1,1.0,1,0.28945843869088395,58
5177,18,76075,76075,0,0,0,0,1.0,1,1.0,1,1.0,1,0.2722874054919635,59
5178,18,76093,76093,0,0,0,0,1.0,1,1.0,1,1.0,1,0.25852463784225294,57
5179,10,76103,76103,0,0,0,0,1.0,1,1.0,1,1.0,1,0.266530638985804,58
5180,14,76117,76117,0,0,0,0,1.0,1,1.0,1,1.0,1,0.2920949122381924,56
5181,17,76134,76134,0,0,0,0,1.0,1,1.0,1,1.0,1,0.18644894308151128,57
5182,10,76144,76144,0,0,0,0,1.0,1,1.0,1,1.0,1,0.2927972418140272,56
5183,11,76155,76155,0,0,0,0,1.0,1,1.0,1,1.0,1,0.2483316823645051,57
5184,12,76167,76167,0,0,0,0,1.0,1,1.0,1,1.0,1,0.309039182478112,56
5185,9,76176,76176,0,0,0,0,1.0,1,1.0,1,1.0,1,0.29213607236987443,56
5186,11,76187,76187,0,0,0,0,1.0,1,1.0,1,1.0,1,0.32734279330596755,54
5187,21,76208,76208,0,0,0,0,1.0,1,1.0,1,1.0,1,0.23087649761832862,51
5188,18,76226,76226,0,0,0,0,1.0,1,1.0,1,1.0,1,0.274625987052549,50
5189,20,76246,76246,0,0,0,0,1.0,1,1.0,1,1.0,1,0.22048917437639148,49
5190,22,76268,76268,0,0,0,0,1.0,1,1.0,1,1.0,1,0.3478829765616986,50
5191,13,76281,76281,0,0,0,0,1.0,1,1.0,1,1.0,1,0.29565919573747623,50
5192,13,76294,76294,0,0,0,0,1.0,1,1.0,1,1.0,1,0.36766424703954675,49
5193,24,76318,76318,0,0,0,0,1.0,1,1.0,1,1.0,1,0.39377791481312996,50
5194,18,76336,76336,0,0,0,0,1.0,1,1.0,1,1.0,1,0.3539931454732491,51
5195,14,76350,76350,0,0,0,0,1.0,1,1.0,1,1.0,1,0.42411002455638624,51
5196,28,76378,76378,0,0,0,0,1.0,1,1.0,1,1.0,1,0.4209783073659343,51
5197,11,76389,76389,0,0,0,0,1.0,1,1.0,1,1.0,1,0.4607660628461585,51
5198,16,76405,76405,0,0,0,0,1.0,1,1.0,1,1.0,1,0.3859097925750431,51
5199,14,76419,76419,0,0,0,0,1.0,1,1.0,1,1.0,1,0.3620233183089938,54
5200,16,76435,76435,0,0,0,0,1.0,1,1.0,1,1.0,1,0.3064156484581283,54
5201,31,76466,76466,0,0,0,0,1.0,1,1.0,1,1.0,1,0.354932471686125,55
5202,22,76488,76488,0,0,0,0,1.0,1,1.0,1,1.0,1,0.4372131860463937,56
5203,25,76513,76513,0,0,0,0,1.0,1,1.0,1,1.0,1,0.34880219255544653,56
5204,23,76536,76536,0,0,0,0,1.0,1,1.0,1,1.0,1,0.4508580004386836,58
5205,20,76556,76556,0,0,0,0,1.0,1,1.0,1,1.0,1,0.4191260898352058,58
5206,18,76574,76574,0,0,0,0,1.0,1,1.0,1,1.0,1,0.4225872021753643,58
5207,19,76593,76593,0,0,0,0,1.0,1,1.0,1,1.0,1,0.48623909643239355,59
5208,19,76612,76612,0,0,0,0,1.0,1,1.0,1,1.0,1,0.3751911583260609,58
5209,24,76636,76636,0,0,0,0,1.0,1,1.0,1,1.0,1,0.48472171280275717,58
5210,15,76651,76651,0,0,0,0,1.0,1,1.0,1,1.0,1,0.47910116599246216,57
5211,26,76677,76677,0,0,0,0,1.0,1,1.0,1,1.0,1,0.4272210379556327,57
5212,14,76691,76691,0,0,0,0,1.0,1,1.0,1,1.0,1,0.4050646995357742,59
5213,17,76708,76708,0,0,0,0,1.0,1,1.0,1,1.0,1,0.4536806869083659,59
5214,27,76735,76735,0,0,0,0,1.0,1,1.0,1,1.0,1,0.26726689797474945,59
5215,24,76759,76759,0,0,0,0,1.0,1,1.0,1,1.0,1,0.3527274667709218,58
5216,13,76772,76772,0,0,0,0,1.0,1,1.0,1,1.0,1,0.3409649960799726,59
5217,15,76787,76787,0,0,0,0,1.0,1,1.0,1,1.0,1,0.4062936580212608,58
5218,24,76811,76811,0,0,0,0,1.0,1,1.0,1,1.0,1,0.23850805260244945,58
5219,19,76830,76830,0,0,0,0,1.0,1,1.0,1,1.0,1,0.34900668406430263,57
5220,9,76839,76839,0,0,0,0,1.0,1,1.0,1,1.0,1,0.31493767338598483,56
5221,23,76862,76862,0,0,0,0,1.0,1,1.0,1,1.0,1,0.3704509945981874,58
5222,15,76877,76877,0,0,0,0,1.0,1,1.0,1,1.0,1,0.4707271668903585,56
5223,18,76895,76895,0,0,0,0,1.0,1,1.0,1,1.0,1,0.43798387193475596,55
5224,13,76908,76908,0,0,0,0,1.0,1,1.0,1,1.0,1,0.4356645096345671,56
5225,10,76918,76918,0,0,0,0,1.0,1,1.0,1,1.0,1,0.3709090978971936,55
5226,8,76926,76926,0,0,0,0,1.0,1,1.0,1,1.0,1,0.46570162974025703,55
5227,18,76944,76944,0,0,0,0,1.0,1,1.0,1,1.0,1,0.4272316811736811,53
5228,21,76965,76965,0,0,0,0,1.0,1,1.0,1,1.0,1,0.4726983266932604,51
5229,12,76977,76977,0,0,0,0,1.0,1,1.0,1,1.0,1,0.45051614805172585,51
5230,22,76999,76999,0,0,0,0,1.0,1,1.0,1,1.0,1,0.44950347392434287,51
5231,15,77014,77014,0,0,0,0,1.0,1,1.0,1,1.0,1,0.42890048905441347,52
5232,27,77041,77041,0,0,0,0,1.0,1,1.0,1,1.0,1,0.45161499418294254,52
5233,21,77062,77062,0,0,0,0,1.0,1,1.0,1,1.0,1,0.4095750915637031,53
5234,21,77083,77083,0,0,0,0,1.0,1,1.0,1,1.0,1,0.3917985867967437,53
5235,15,77098,77098,0,0,0,0,1.0,1,1.0,1,1.0,1,0.39005023454459486,53
5236,24,77122,77122,0,0,0,0,1.0,1,1.0,1,1.0,1,0.382937246963613,52
5237,35,77157,77157,0,0,0,0,1.0,1,1.0,1,1.0,1,0.3462789243592341,52
5238,27,77184,77184,0,0,0,0,1.0,1,1.0,1,1.0,1,0.3950294085560712,52
5239,14,77198,77198,0,0,0,0,1.0,1,1.0,1,1.0,1,0.36455302860427474,51
5240,24,77222,77222,0,0,0,0,1.0,1,1.0,1,1.0,1,0.3930588455090173,53
5241,19,77241,77241,0,0,0,0,1.0,1,1.0,1,1.0,1,0.3281281280153357,53
5242,21,77262,77262,0,0,0,0,1.0,1,1.0,1,1.0,1,0.33029645849789974,51
5243,23,77285,77285,0,0,0,0,1.0,1,1.0,1,1.0,1,0.30403515974669243,51
5244,24,77309,77309,0,0,0,0,1.0,1,1.0,1,1.0,1,0.25835834429719473,52
5245,25,77334,77334,0,0,0,0,1.0,1,1.0,1,1.0,1,0.28907779198862876,53
5246,9,77343,77343,0,0,0,0,1.0,1,1.0,1,1.0,1,0.3324020701824309,53
5247,15,77358,77358,0,0,0,0,1.0,1,1.0,1,1.0,1,0.3116599558484331,54
5248,13,77371,77371,0,0,0,0,1.0,1,1.0,1,1.0,1,0.32885989989237113,54
5249,19,77390,77390,0,0,0,0,1.0,1,1.0,1,1.0,1,0.32781347673250155,55
5250,14,77404,77404,0,0,0,0,1.0,1,1.0,1,1.0,1,0.3224407808342136,57
5251,15,77419,77419,0,0,0,0,1.0,1,1.0,1,1.0,1,0.2700489354039896,58
5252,10,77429,77429,0,0,0,0,1.0,1,1.0,1,1.0,1,0.3477113008474603,58
5253,13,77442,77442,0,0,0,0,1.0,1,1.0,1,1.0,1,0.33853288790877234,58
5254,15,77457,77457,0,0,0,0,1.0,1,1.0,1,1.0,1,0.38983739697572917,59
5255,15,77472,77472,0,0,0,0,1.0,1,1.0,1,1.0,1,0.3389230277980128,58
5256,14,77486,77486,0,0,0,0,1.0,1,1.0,1,1.0,1,0.41135403391074166,58
5257,14,77500,77500,0,0,0,0,1.0,1,1.0,1,1.0,1,0.32809720556334504,57
5258,10,77510,77510,0,0,0,0,1.0,1,1.0,1,1.0,1,0.4595730297452296,55
5259,14,77524,77524,0,0,0,0,1.0,1,1.0,1,1.0,1,0.4130899450317944,56
5260,14,77538,77538,0,0,0,0,1.0,1,1.0,1,1.0,1,0.3838724202248686,55
5261,11,77549,77549,0,0,0,0,1.0,1,1.0,1,1.0,1,0.4168391739805822,54
5262,13,77562,77562,0,0,0,0,1.0,1,1.0,1,1.0,1,0.38096271334455545,54
5263,12,77574,77574,0,0,0,0,1.0,1,1.0,1,1.0,1,0.3489331995604788,55
5264,17,77591,77591,0,0,0,0,1.0,1,1.0,1,1.0,1,0.36416870911466137,53
5265,10,77601,77601,0,0,0,0,1.0,1,1.0,1,1.0,1,0.3175381042902795,52
5266,10,77611,77611,0,0,0,0,1.0,1,1.0,1,1.0,1,0.4364025446926254,49
5267,15,77626,77626,0,0,0,0,1.0,1,1.0,1,1.0,1,0.3540517393011243,49
5268,12,77638,77638,0,0,0,0,1.0,1,1.0,1,1.0,1,0.3471258748036909,46
5269,15,77653,77653,0,0,0,0,1.0,1,1.0,1,1.0,1,0.31592999017226747,45
5270,14,77667,77667,0,0,0,0,1.0,1,1.0,1,1.0,1,0.28593097102158405,46
5271,14,77681,77681,0,0,0,0,1.0,1,1.0,1,1.0,1,0.31637140379492634,46
5272,18,77699,77699,0,0,0,0,1.0,1,1.0,1,1.0,1,0.3030692462164396,45
5273,15,77714,77714,0,0,0,0,1.0,1,1.0,1,1.0,1,0.29332087365190174,45
5274,14,77728,77728,0,0,0,0,1.0,1,1.0,1,1.0,1,0.3188144095669423,45
5275,18,77746,77746,0,0,0,0,1.0,1,1.0,1,1.0,1,0.34783218271294636,46
5276,15,77761,77761,0,0,0,0,1.0,1,1.0,1,1.0,1,0.3144789909492498,45
5277,16,77777,77777,0,0,0,0,1.0,1,1.0,1,1.0,1,0.32603660002876933,45
5278,25,77802,77802,0,0,0,0,1.0,1,1.0,1,1.0,1,0.38296827708125225,44
5279,19,77821,77821,0,0,0,0,1.0,1,1.0,1,1.0,1,0.4195282767864045,45
5280,19,77840,77840,0,0,0,0,1.0,1,1.0,1,1.0,1,0.29188231994277386,46
5281,9,77849,77849,0,0,0,0,1.0,1,1.0,1,1.0,1,0.42426549531956137,46
5282,16,77865,77865,0,0,0,0,1.0,1,1.0,1,1.0,1,0.39423332991773086,47
5283,13,77878,77878,0,0,0,0,1.0,1,1.0,1,1.0,1,0.35608933853628927,48
5284,10,77888,77888,0,0,0,0,1.0,1,1.0,1,1.0,1,0.4014061304232108,48
5285,13,77901,77901,0,0,0,0,1.0,1,1.0,1,1.0,1,0.4658884919687702,48
5286,21,77922,77922,0,0,0,0,1.0,1,1.0,1,1.0,1,0.3203520791704264,50
5287,15,77937,77937,0,0,0,0,1.0,1,1.0,1,1.0,1,0.37764555061093935,50
5288,18,77955,77955,0,0,0,0,1.0,1,1.0,1,1.0,1,0.3770602922037996,51
5289,12,77967,77967,0,0,0,0,1.0,1,1.0,1,1.0,1,0.4196703187370697,51
5290,14,77981,77981,0,0,0,0,1.0,1,1.0,1,1.0,1,0.41374945422578663,52
5291,9,77990,77990,0,0,0,0,1.0,1,1.0,1,1.0,1,0.39703121124007046,52
5292,11,78001,78001,0,0,0,0,1.0,1,1.0,1,1.0,1,0.4505877690672864,53
5293,14,78015,78015,0,0,0,0,1.0,1,1.0,1,1.0,1,0.48508530709905656,51
5294,12,78027,78027,0,0,0,0,1.0,1,1.0,1,1.0,1,0.45769859115976286,50
5295,17,78044,78044,0,0,0,0,1.0,1,1.0,1,1.0,1,0.39568149144940434,49
5296,19,78063,78063,0,0,0,0,1.0,1,1.0,1,1.0,1,0.5095246616354551,48
5297,19,78082,78082,0,0,0,0,1.0,1,1.0,1,1.0,1,0.4676170827316443,46
5298,28,78110,78110,0,0,0,0,1.0,1,1.0,1,1.0,1,0.44282145268810696,46
5299,17,78127,78127,0,0,0,0,1.0,1,1.0,1,1.0,1,0.51979012374503,47
5300,22,78149,78149,0,0,0,0,1.0,1,1.0,1,1.0,1,0.4427145398761231,48
5301,32,78181,78181,0,0,0,0,1.0,1,1.0,1,1.0,1,0.33726602367812,48
5302,26,78207,78207,0,0,0,0,1.0,1,1.0,1,1.0,1,0.4885162815880777,49
5303,11,78218,78218,0,0,0,0,1.0,1,1.0,1,1.0,1,0.4644287939900819,48
5304,18,78236,78236,0,0,0,0,1.0,1,1.0,1,1.0,1,0.44167373715698616,48
5305,12,78248,78248,0,0,0,0,1.0,1,1.0,1,1.0,1,0.44984957527680064,47
5306,23,78271,78271,0,0,0,0,1.0,1,1.0,1,1.0,1,0.30137260634466356,48
5307,16,78287,78287,0,0,0,0,1.0,1,1.0,1,1.0,1,0.48706620964955294,48
5308,13,78300,78300,0,0,0,0,1.0,1,1.0,1,1.0,1,0.3589214639495507,47
5309,19,78319,78319,0,0,0,0,1.0,1,1.0,1,1.0,1,0.4386319190697015,46
5310,28,78347,78347,0,0,0,0,1.0,1,1.0,1,1.0,1,0.43674544750983396,46
5311,22,78369,78369,0,0,0,0,1.0,1,1.0,1,1.0,1,0.409800506488546,46
5312,32,78401,78401,0,0,0,0,1.0,1,1.0,1,1.0,1,0.45949710930057003,46
5313,30,78431,78431,0,0,0,0,1.0,1,1.0,1,1.0,1,0.3683915332180681,46
5314,27,78458,78458,0,0,0,0,1.0,1,1.0,1,1.0,1,0.4025306529356154,46
5315,26,78484,78484,0,0,0,0,1.0,1,1.0,1,1.0,1,0.38144621505876697,47
5316,30,78514,78514,0,0,0,0,1.0,1,1.0,1,1.0,1,0.3405059594443557,48
5317,24,78538,78538,0,0,0,0,1.0,1,1.0,1,1.0,1,0.2452179428334263,49
5318,25,78563,78563,0,0,0,0,1.0,1,1.0,1,1.0,1,0.3314216973019299,49
5319,8,78571,78571,0,0,0,0,1.0,1,1.0,1,1.0,1,0.3485883979164272,50
5320,16,78587,78587,0,0,0,0,1.0,1,1.0,1,1.0,1,0.3095400119247616,51
5321,15,78602,78602,0,0,0,0,1.0,1,1.0,1,1.0,1,0.34088946397943126,52
5322,15,78617,78617,0,0,0,0,1.0,1,1.0,1,1.0,1,0.23040102257800849,53
5323,12,78629,78629,0,0,0,0,1.0,1,1.0,1,1.0,1,0.3335675001811345,53
5324,12,78641,78641,0,0,0,0,1.0,1,1.0,1,1.0,1,0.29476461892188927,55
5325,18,78659,78659,0,0,0,0,1.0,1,1.0,1,1.0,1,0.3358629128480888,55
5326,17,78676,78676,0,0,0,0,1.0,1,1.0,1,1.0,1,0.2553420899905276,55
5327,9,78685,78685,0,0,0,0,1.0,1,1.0,1,1.0,1,0.258657169375788,56
5328,11,78696,78696,0,0,0,0,1.0,1,1.0,1,1.0,1,0.27497056637439954,57
5329,10,78706,78706,0,0,0,0,1.0,1,1.0,1,1.0,1,0.26169562769249294,57
5330,13,78719,78719,0,0,0,0,1.0,1,1.0,1,1.0,1,0.3225945907004492,56
5331,14,78733,78733,0,0,0,0,1.0,1,1.0,1,1.0,1,0.3072540014701884,57
5332,14,78747,78747,0,0,0,0,1.0,1,1.0,1,1.0,1,0.31073336516727046,58
5333,9,78756,78756,0,0,0,0,1.0,1,1.0,1,1.0,1,0.2705382901927888,59
5334,18,78774,78774,0,0,0,0,1.0,1,1.0,1,1.0,1,0.25167103569534083,59
5335,22,78796,78796,0,0,0,0,1.0,1,1.0,1,1.0,1,0.2967111142355238,58
5336,18,78814,78814,0,0,0,0,1.0,1,1.0,1,1.0,1,0.2674275301970442,59
5337,13,78827,78827,0,0,0,0,1.0,1,1.0,1,1.0,1,0.2807253735092215,60
5338,15,78842,78842,0,0,0,0,1.0,1,1.0,1,1.0,1,0.22889829967016978,60
5339,13,78855,78855,0,0,0,0,1.0,1,1.0,1,1.0,1,0.3094198978515901,60
5340,24,78879,78879,0,0,0,0,1.0,1,1.0,1,1.0,1,0.3194944867330903,60
5341,14,78893,78893,0,0,0,0,1.0,1,1.0,1,1.0,1,0.3240374736664582,61
5342,13,78906,78906,0,0,0,0,1.0,1,1.0,1,1.0,1,0.24368954427835468,59
5343,22,78928,78928,0,0,0,0,1.0,1,1.0,1,1.0,1,0.2361153260173086,58
5344,17,78945,78945,0,0,0,0,1.0,1,1.0,1,1.0,1,0.25636370776005063,58
5345,21,78966,78966,0,0,0,0,1.0,1,1.0,1,1.0,1,0.27463614047683693,54
5346,13,78979,78979,0,0,0,0,1.0,1,1.0,1,1.0,1,0.2532904392800537,54
5347,29,79008,79008,0,0,0,0,1.0,1,1.0,1,1.0,1,0.2799311224336032,54
5348,17,79025,79025,0,0,0,0,1.0,1,1.0,1,1.0,1,0.2851819740736351,55
5349,27,79052,79052,0,0,0,0,1.0,1,1.0,1,1.0,1,0.3524053841217351,56
5350,19,79071,79071,0,0,0,0,1.0,1,1.0,1,1.0,1,0.2677651645074659,56
5351,13,79084,79084,0,0,0,0,1.0,1,1.0,1,1.0,1,0.3405687579596784,57
5352,12,79096,79096,0,0,0,0,1.0,1,1.0,1,1.0,1,0.3303030449330777,57
5353,7,79103,79103,0,0,0,0,1.0,1,1.0,1,1.0,1,0.33773609385761905,57
5354,25,79128,79128,0,0,0,0,1.0,1,1.0,1,1.0,1,0.4026031548176093,56
5355,26,79154,79154,0,0,0,0,1.0,1,1.0,1,1.0,1,0.3396329510779726,57
5356,19,79173,79173,0,0,0,0,1.0,1,1.0,1,1.0,1,0.38472027651889296,56
5357,23,79196,79196,0,0,0,0,1.0,1,1.0,1,1.0,1,0.37496890369036256,56
5358,28,79224,79224,0,0,0,0,1.0,1,1.0,1,1.0,1,0.3471766541969073,57
5359,26,79250,79250,0,0,0,0,1.0,1,1.0,1,1.0,1,0.45024124530282883,57
5360,21,79271,79271,0,0,0,0,1.0,1,1.0,1,1.0,1,0.4742396831546251,55
5361,32,79303,79303,0,0,0,0,1.0,1,1.0,1,1.0,1,0.5190945001697754,56
5362,24,79327,79327,0,0,0,0,1.0,1,1.0,1,1.0,1,0.4106062268207138,57
5363,31,79358,79358,0,0,0,0,1.0,1,1.0,1,1.0,1,0.4666826210217559,57
5364,21,79379,79379,0,0,0,0,1.0,1,1.0,1,1.0,1,0.450558311029674,58
5365,34,79413,79413,0,0,0,0,1.0,1,1.0,1,1.0,1,0.4366552108954959,59
5366,24,79437,79437,0,0,0,0,1.0,1,1.0,1,1.0,1,0.3601702833871496,60
5367,34,79471,79471,0,0,0,0,1.0,1,1.0,1,1.0,1,0.34961045175401323,60
5368,25,79496,79496,0,0,0,0,1.0,1,1.0,1,1.0,1,0.31209615151233333,58
5369,34,79530,79530,0,0,0,0,1.0,1,1.0,1,1.0,1,0.31658147367015954,58
5370,24,79554,79554,0,0,0,0,1.0,1,1.0,1,1.0,1,0.34410167174565254,57
5371,26,79580,79580,0,0,0,0,1.0,1,1.0,1,1.0,1,0.2769069844372682,56
5372,18,79598,79598,0,0,0,0,1.0,1,1.0,1,1.0,1,0.2710569923695414,55
5373,21,79619,79619,0,0,0,0,1.0,1,1.0,1,1.0,1,0.3474714362227594,54
5374,22,79641,79641,0,0,0,0,1.0,1,1.0,1,1.0,1,0.3094265067933884,53
5375,36,79677,79677,0,0,0,0,1.0,1,1.0,1,1.0,1,0.35854094500905054,52
5376,21,79698,79698,0,0,0,0,1.0,1,1.0,1,1.0,1,0.25161259998957064,52
5377,16,79714,79714,0,0,0,0,1.0,1,1.0,1,1.0,1,0.3560581809842905,51
5378,19,79733,79733,0,0,0,0,1.0,1,1.0,1,1.0,1,0.2890524046861263,52
5379,15,79748,79748,0,0,0,0,1.0,1,1.0,1,1.0,1,0.22865458915588718,50
5380,8,79756,79756,0,0,0,0,1.0,1,1.0,1,1.0,1,0.27997462990202837,51
5381,6,79762,79762,0,0,0,0,1.0,1,1.0,1,1.0,1,0.26169985272826063,50
5382,8,79770,79770,0,0,0,0,1.0,1,1.0,1,1.0,1,0.38232919790843534,48
5383,21,79791,79791,0,0,0,0,1.0,1,1.0,1,1.0,1,0.33677643394566337,48
5384,15,79806,79806,0,0,0,0,1.0,1,1.0,1,1.0,1,0.3420318794550602,48
5385,16,79822,79822,0,0,0,0,1.0,1,1.0,1,1.0,1,0.40165747908187205,47
5386,15,79837,79837,0,0,0,0,1.0,1,1.0,1,1.0,1,0.308171831366923,48
5387,10,79847,79847,0,0,0,0,1.0,1,1.0,1,1.0,1,0.3763070139014393,48
5388,25,79872,79872,0,0,0,0,1.0,1,1.0,1,1.0,1,0.2693498233417449,48
5389,11,79883,79883,0,0,0,0,1.0,1,1.0,1,1.0,1,0.26069939119229046,50
5390,13,79896,79896,0,0,0,0,1.0,1,1.0,1,1.0,1,0.36130904258804913,52
5391,12,79908,79908,0,0,0,0,1.0,1,1.0,1,1.0,1,0.4003443134459149,52
5392,15,79923,79923,0,0,0,0,1.0,1,1.0,1,1.0,1,0.3877124829542568,51
5393,11,79934,79934,0,0,0,0,1.0,1,1.0,1,1.0,1,0.4526598859048341,50
5394,16,79950,79950,0,0,0,0,1.0,1,1.0,1,1.0,1,0.34335344132996254,50
5395,10,79960,79960,0,0,0,0,1.0,1,1.0,1,1.0,1,0.34975885416542135,49
5396,17,79977,79977,0,0,0,0,1.0,1,1.0,1,1.0,1,0.35099899476205215,48
5397,12,79989,79989,0,0,0,0,1.0,1,1.0,1,1.0,1,0.21381237116227045,48
5398,14,80003,80003,0,0,0,0,1.0,1,1.0,1,1.0,1,0.3283161315502515,46
5399,13,80016,80016,0,0,0,0,1.0,1,1.0,1,1.0,1,0.24185603798035651,46
5400,11,80027,80027,0,0,0,0,1.0,1,1.0,1,1.0,1,0.23450217543118865,48
5401,10,80037,80037,0,0,0,0,1.0,1,1.0,1,1.0,1,0.1826194843756439,49
5402,0,80037,80037,0,0,0,0,1.0,1,1.0,1,1.0,1,0.0,0
