,SuccessfulHandoverCount,TotalSuccessfulHandoverCount,TotalSuccessfulHandoverCountRange,TotalSuccessfulHandoverCountLoadBalancing,TotalSuccessfulHandoverCountOverload,FailedHandoverCount,TotalFailedHandoverCount,AvgQoS,MinQoS,AvgQoS_LoadBased,MinQoS_LoadBased,AvgQoS_RangeBased,MinQoS_RangeBased,GiniLoad,VehicleCount
0,0,0,0,0,0,0,0,1.0,1,1.0,1,1.0,1,0.0,0
1,16,16,0,16,0,0,0,1.0,1,1.0,1,1.0,1,0.29816839317586874,30
2,13,29,0,29,0,0,0,1.0,1,1.0,1,1.0,1,0.31201973957963103,32
3,0,29,0,29,0,0,0,1.0,1,1.0,1,1.0,1,0.2971209386808541,33
4,0,29,0,29,0,0,0,1.0,1,1.0,1,1.0,1,0.2992660075592378,34
5,0,29,0,29,0,0,0,1.0,1,1.0,1,1.0,1,0.2781683250866293,36
6,1,30,0,30,0,0,0,1.0,1,1.0,1,1.0,1,0.2514022828550751,38
7,1,31,0,31,0,0,0,1.0,1,1.0,1,1.0,1,0.23371143417304485,40
8,0,31,0,31,0,0,0,1.0,1,1.0,1,1.0,1,0.23371143417304485,40
9,0,31,0,31,0,0,0,1.0,1,1.0,1,1.0,1,0.23371143417304485,40
10,1,32,1,31,0,0,0,1.0,1,1.0,1,1.0,1,0.2549106949232253,41
11,2,34,2,32,0,0,0,1.0,1,1.0,1,1.0,1,0.20710523357897942,40
12,2,36,3,33,0,0,0,1.0,1,1.0,1,1.0,1,0.22162958725542384,39
13,2,38,5,33,0,0,0,1.0,1,1.0,1,1.0,1,0.2573184097134206,37
14,1,39,5,34,0,0,0,1.0,1,1.0,1,1.0,1,0.2666256813605722,35
15,0,39,5,34,0,0,0,1.0,1,1.0,1,1.0,1,0.2789726922407898,36
16,2,41,7,34,0,0,0,1.0,1,1.0,1,1.0,1,0.27754498432572705,34
17,1,42,7,35,0,0,0,1.0,1,1.0,1,1.0,1,0.2854920796251833,33
18,1,43,7,36,0,0,0,1.0,1,1.0,1,1.0,1,0.2701411899770698,34
19,1,44,8,36,0,0,0,1.0,1,1.0,1,1.0,1,0.29642195407216015,34
20,0,44,8,36,0,0,0,1.0,1,1.0,1,1.0,1,0.27623187786197806,34
21,3,47,9,38,0,0,0,1.0,1,1.0,1,1.0,1,0.28038962916832433,36
22,1,48,9,39,0,0,0,1.0,1,1.0,1,1.0,1,0.25348302957679536,35
23,5,53,11,42,0,0,0,1.0,1,1.0,1,1.0,1,0.22775833201516377,35
24,2,55,13,42,0,0,0,1.0,1,1.0,1,1.0,1,0.217012937543668,35
25,5,60,17,43,0,0,0,1.0,1,1.0,1,1.0,1,0.31607056184982324,35
26,4,64,19,45,0,0,0,1.0,1,1.0,1,1.0,1,0.28493837326760935,36
27,2,66,21,45,0,0,0,1.0,1,1.0,1,1.0,1,0.24155882754546648,34
28,0,66,21,45,0,0,0,1.0,1,1.0,1,1.0,1,0.23977053617520017,35
29,1,67,21,46,0,0,0,1.0,1,1.0,1,1.0,1,0.1837277270399737,33
30,1,68,22,46,0,0,0,1.0,1,1.0,1,1.0,1,0.21604285514621258,33
31,1,69,23,46,0,0,0,1.0,1,1.0,1,1.0,1,0.28883328974255185,33
32,1,70,24,46,0,0,0,1.0,1,1.0,1,1.0,1,0.3492012533322701,32
33,1,71,24,47,0,0,0,1.0,1,1.0,1,1.0,1,0.3254726844498005,33
34,3,74,25,49,0,0,0,1.0,1,1.0,1,1.0,1,0.30871390004877536,33
35,0,74,25,49,0,0,0,1.0,1,1.0,1,1.0,1,0.2927517523852543,35
36,1,75,25,50,0,0,0,1.0,1,1.0,1,1.0,1,0.2993215326392687,36
37,2,77,26,51,0,0,0,1.0,1,1.0,1,1.0,1,0.25004223484399046,37
38,1,78,26,52,0,0,0,1.0,1,1.0,1,1.0,1,0.24047992083508846,36
39,1,79,26,53,0,0,0,1.0,1,1.0,1,1.0,1,0.26403740955774646,38
40,1,80,26,54,0,0,0,1.0,1,1.0,1,1.0,1,0.2682299831142338,40
41,1,81,26,55,0,0,0,1.0,1,1.0,1,1.0,1,0.23596318585874484,40
42,3,84,29,55,0,0,0,1.0,1,1.0,1,1.0,1,0.2643364176444626,40
43,3,87,30,57,0,0,0,1.0,1,1.0,1,1.0,1,0.2640159282579491,43
44,1,88,30,58,0,0,0,1.0,1,1.0,1,1.0,1,0.24742092041119518,43
45,1,89,30,59,0,0,0,1.0,1,1.0,1,1.0,1,0.21769491510559566,44
46,1,90,31,59,0,0,0,1.0,1,1.0,1,1.0,1,0.2277099552512684,44
47,0,90,31,59,0,0,0,1.0,1,1.0,1,1.0,1,0.2277099552512684,44
48,3,93,33,60,0,0,0,1.0,1,1.0,1,1.0,1,0.24731201603313815,44
49,0,93,33,60,0,0,0,1.0,1,1.0,1,1.0,1,0.2034521706202392,41
50,0,93,33,60,0,0,0,1.0,1,1.0,1,1.0,1,0.2263916422975262,40
51,0,93,33,60,0,0,0,1.0,1,1.0,1,1.0,1,0.23783234224583327,38
52,1,94,34,60,0,0,0,1.0,1,1.0,1,1.0,1,0.33052708955204363,37
53,0,94,34,60,0,0,0,1.0,1,1.0,1,1.0,1,0.33699752325070204,38
54,4,98,36,62,0,0,0,1.0,1,1.0,1,1.0,1,0.33197088826245347,38
55,3,101,37,64,0,0,0,1.0,1,1.0,1,1.0,1,0.33002130734200996,38
56,1,102,38,64,0,0,0,1.0,1,1.0,1,1.0,1,0.310704693516648,38
57,1,103,39,64,0,0,0,1.0,1,1.0,1,1.0,1,0.29752031624336794,38
58,3,106,42,64,0,0,0,1.0,1,1.0,1,1.0,1,0.3374905474853474,38
59,2,108,42,66,0,0,0,1.0,1,1.0,1,1.0,1,0.2885925257319404,40
60,1,109,43,66,0,0,0,1.0,1,1.0,1,1.0,1,0.2941134791906589,40
61,0,109,43,66,0,0,0,1.0,1,1.0,1,1.0,1,0.28992939035484255,40
62,3,112,44,68,0,0,0,1.0,1,1.0,1,1.0,1,0.2866142092742189,42
63,2,114,45,69,0,0,0,1.0,1,1.0,1,1.0,1,0.27798795681393357,40
64,0,114,45,69,0,0,0,1.0,1,1.0,1,1.0,1,0.27330839325109313,41
65,2,116,46,70,0,0,0,1.0,1,1.0,1,1.0,1,0.28131944001180775,41
66,1,117,47,70,0,0,0,1.0,1,1.0,1,1.0,1,0.3040144457257401,41
67,2,119,47,72,0,0,0,1.0,1,1.0,1,1.0,1,0.26661077614734224,41
68,1,120,48,72,0,0,0,1.0,1,1.0,1,1.0,1,0.27282152798851156,41
69,2,122,49,73,0,0,0,1.0,1,1.0,1,1.0,1,0.2598320233374242,41
70,1,123,49,74,0,0,0,1.0,1,1.0,1,1.0,1,0.26623943154126184,42
71,1,124,50,74,0,0,0,1.0,1,1.0,1,1.0,1,0.2593717591668347,44
72,0,124,50,74,0,0,0,1.0,1,1.0,1,1.0,1,0.2593717591668347,44
73,3,127,50,77,0,0,0,1.0,1,1.0,1,1.0,1,0.21773991569325765,46
74,0,127,50,77,0,0,0,1.0,1,1.0,1,1.0,1,0.24682566084115404,44
75,2,129,51,78,0,0,0,1.0,1,1.0,1,1.0,1,0.18743009494624005,44
76,4,133,53,80,0,0,0,1.0,1,1.0,1,1.0,1,0.25815559837129803,45
77,3,136,53,83,0,0,0,1.0,1,1.0,1,1.0,1,0.1806688023406874,44
78,1,137,54,83,0,0,0,1.0,1,1.0,1,1.0,1,0.2407678749227145,44
79,2,139,54,85,0,0,0,1.0,1,1.0,1,1.0,1,0.22214134084255255,43
80,1,140,55,85,0,0,0,1.0,1,1.0,1,1.0,1,0.2137863460166577,43
81,3,143,58,85,0,0,0,1.0,1,1.0,1,1.0,1,0.2868653875939246,44
82,1,144,59,85,0,0,0,1.0,1,1.0,1,1.0,1,0.2906169017288138,45
83,3,147,61,86,0,0,0,1.0,1,1.0,1,1.0,1,0.3026536689608807,45
84,0,147,61,86,0,0,0,1.0,1,1.0,1,1.0,1,0.3026536689608807,45
85,1,148,62,86,0,0,0,1.0,1,1.0,1,1.0,1,0.3049807728339716,45
86,1,149,62,87,0,0,0,1.0,1,1.0,1,1.0,1,0.25802806501337117,45
87,0,149,62,87,0,0,0,1.0,1,1.0,1,1.0,1,0.27799235807286077,44
88,1,150,62,88,0,0,0,1.0,1,1.0,1,1.0,1,0.26298197185509026,45
89,0,150,62,88,0,0,0,1.0,1,1.0,1,1.0,1,0.27611332588431603,46
90,0,150,62,88,0,0,0,1.0,1,1.0,1,1.0,1,0.3024190531319879,44
91,1,151,63,88,0,0,0,1.0,1,1.0,1,1.0,1,0.3012179066640807,45
92,0,151,63,88,0,0,0,1.0,1,1.0,1,1.0,1,0.3127948977566314,46
93,0,151,63,88,0,0,0,1.0,1,1.0,1,1.0,1,0.3127948977566314,46
94,0,151,63,88,0,0,0,1.0,1,1.0,1,1.0,1,0.3127948977566314,46
95,1,152,63,89,0,0,0,1.0,1,1.0,1,1.0,1,0.3154468235500562,46
96,1,153,64,89,0,0,0,1.0,1,1.0,1,1.0,1,0.3259175739917655,46
97,1,154,64,90,0,0,0,1.0,1,1.0,1,1.0,1,0.3144912016185812,47
98,1,155,65,90,0,0,0,1.0,1,1.0,1,1.0,1,0.33201766903720853,47
99,3,158,66,92,0,0,0,1.0,1,1.0,1,1.0,1,0.32963369471746273,46
100,2,160,67,93,0,0,0,1.0,1,1.0,1,1.0,1,0.33411205151787754,48
101,3,163,68,95,0,0,0,1.0,1,1.0,1,1.0,1,0.31313351090984654,49
102,1,164,69,95,0,0,0,1.0,1,1.0,1,1.0,1,0.3204211028533549,49
103,4,168,70,98,0,0,0,1.0,1,1.0,1,1.0,1,0.2570753652074218,48
104,4,172,72,100,0,0,0,1.0,1,1.0,1,1.0,1,0.2761748625221967,49
105,4,176,74,102,0,0,0,1.0,1,1.0,1,1.0,1,0.2474219603376365,48
106,1,177,75,102,0,0,0,1.0,1,1.0,1,1.0,1,0.24874166421770066,48
107,1,178,76,102,0,0,0,1.0,1,1.0,1,1.0,1,0.260670248779295,47
108,1,179,76,103,0,0,0,1.0,1,1.0,1,1.0,1,0.24428255302460106,47
109,4,183,78,105,0,0,0,1.0,1,1.0,1,1.0,1,0.2665380126514438,47
110,3,186,79,107,0,0,0,1.0,1,1.0,1,1.0,1,0.25329839850706853,47
111,7,193,82,111,0,0,0,1.0,1,1.0,1,1.0,1,0.15001306651534205,46
112,4,197,85,112,0,0,0,1.0,1,1.0,1,1.0,1,0.13230668218354666,46
113,1,198,86,112,0,0,0,1.0,1,1.0,1,1.0,1,0.1471005887151143,45
114,0,198,86,112,0,0,0,1.0,1,1.0,1,1.0,1,0.1436344626199063,46
115,1,199,87,112,0,0,0,1.0,1,1.0,1,1.0,1,0.17850031660306448,47
116,0,199,87,112,0,0,0,1.0,1,1.0,1,1.0,1,0.16456387107859619,48
117,3,202,90,112,0,0,0,1.0,1,1.0,1,1.0,1,0.19519921552637842,48
118,0,202,90,112,0,0,0,1.0,1,1.0,1,1.0,1,0.19455726814657656,49
119,1,203,91,112,0,0,0,1.0,1,1.0,1,1.0,1,0.2112531707086617,50
120,0,203,91,112,0,0,0,1.0,1,1.0,1,1.0,1,0.2115908818773274,51
121,0,203,91,112,0,0,0,1.0,1,1.0,1,1.0,1,0.2115908818773274,51
122,2,205,92,113,0,0,0,1.0,1,1.0,1,1.0,1,0.1531138495934511,51
123,0,205,92,113,0,0,0,1.0,1,1.0,1,1.0,1,0.1531138495934511,51
124,0,205,92,113,0,0,0,1.0,1,1.0,1,1.0,1,0.1531138495934511,51
125,0,205,92,113,0,0,0,1.0,1,1.0,1,1.0,1,0.20493048221754667,50
126,3,208,94,114,0,0,0,1.0,1,1.0,1,1.0,1,0.21643633053783545,52
127,3,211,94,117,0,0,0,1.0,1,1.0,1,1.0,1,0.18873452308032632,50
128,1,212,94,118,0,0,0,1.0,1,1.0,1,1.0,1,0.1678840247042629,50
129,0,212,94,118,0,0,0,1.0,1,1.0,1,1.0,1,0.19076844332890552,52
130,0,212,94,118,0,0,0,1.0,1,1.0,1,1.0,1,0.19076844332890552,52
131,3,215,95,120,0,0,0,1.0,1,1.0,1,1.0,1,0.16624401090108448,54
132,1,216,96,120,0,0,0,1.0,1,1.0,1,1.0,1,0.17532632800844092,54
133,4,220,97,123,0,0,0,1.0,1,1.0,1,1.0,1,0.14588375528197955,52
134,0,220,97,123,0,0,0,1.0,1,1.0,1,1.0,1,0.1593694304869857,52
135,4,224,101,123,0,0,0,1.0,1,1.0,1,1.0,1,0.1792191970205739,51
136,2,226,102,124,0,0,0,1.0,1,1.0,1,1.0,1,0.16902674408973933,51
137,2,228,103,125,0,0,0,1.0,1,1.0,1,1.0,1,0.13871020366819561,50
138,1,229,104,125,0,0,0,1.0,1,1.0,1,1.0,1,0.15791756564647608,52
139,6,235,106,129,0,0,0,1.0,1,1.0,1,1.0,1,0.15738524897848044,51
140,1,236,107,129,0,0,0,1.0,1,1.0,1,1.0,1,0.1544731251361917,51
141,2,238,108,130,0,0,0,1.0,1,1.0,1,1.0,1,0.16427773559663925,50
142,2,240,110,130,0,0,0,1.0,1,1.0,1,1.0,1,0.14760113419754134,51
143,2,242,110,132,0,0,0,1.0,1,1.0,1,1.0,1,0.15435473183758522,48
144,2,244,112,132,0,0,0,1.0,1,1.0,1,1.0,1,0.16883780755422573,49
145,4,248,116,132,0,0,0,1.0,1,1.0,1,1.0,1,0.12317843267855272,47
146,2,250,118,132,0,0,0,1.0,1,1.0,1,1.0,1,0.15013045570927147,49
147,0,250,118,132,0,0,0,1.0,1,1.0,1,1.0,1,0.12868913904371068,46
148,1,251,119,132,0,0,0,1.0,1,1.0,1,1.0,1,0.1093445491787182,47
149,1,252,120,132,0,0,0,1.0,1,1.0,1,1.0,1,0.08488631112943315,46
150,0,252,120,132,0,0,0,1.0,1,1.0,1,1.0,1,0.08046014430683937,47
151,1,253,121,132,0,0,0,1.0,1,1.0,1,1.0,1,0.12770181627567678,46
152,0,253,121,132,0,0,0,1.0,1,1.0,1,1.0,1,0.1477498003886544,45
153,0,253,121,132,0,0,0,1.0,1,1.0,1,1.0,1,0.1610057991473651,46
154,0,253,121,132,0,0,0,1.0,1,1.0,1,1.0,1,0.17463580460388184,44
155,3,256,124,132,0,0,0,1.0,1,1.0,1,1.0,1,0.22070074633056466,45
156,4,260,126,134,0,0,0,1.0,1,1.0,1,1.0,1,0.2507649602461349,43
157,1,261,126,135,0,0,0,1.0,1,1.0,1,1.0,1,0.2211066740306323,42
158,2,263,126,137,0,0,0,1.0,1,1.0,1,1.0,1,0.20066565187176721,43
159,1,264,127,137,0,0,0,1.0,1,1.0,1,1.0,1,0.2598107624562755,44
160,2,266,128,138,0,0,0,1.0,1,1.0,1,1.0,1,0.2603291874360431,44
161,5,271,131,140,0,0,0,1.0,1,1.0,1,1.0,1,0.2628183684091727,44
162,5,276,132,144,0,0,0,1.0,1,1.0,1,1.0,1,0.2039226167869841,44
163,8,284,138,146,0,0,0,1.0,1,1.0,1,1.0,1,0.24374211374448657,44
164,3,287,140,147,0,0,0,1.0,1,1.0,1,1.0,1,0.282652285945468,44
165,5,292,141,151,0,0,0,1.0,1,1.0,1,1.0,1,0.18615942441515887,43
166,0,292,141,151,0,0,0,1.0,1,1.0,1,1.0,1,0.2044284541077773,43
167,1,293,142,151,0,0,0,1.0,1,1.0,1,1.0,1,0.19592941325471586,42
168,0,293,142,151,0,0,0,1.0,1,1.0,1,1.0,1,0.15662048219567395,40
169,0,293,142,151,0,0,0,1.0,1,1.0,1,1.0,1,0.14786006061323068,41
170,0,293,142,151,0,0,0,1.0,1,1.0,1,1.0,1,0.18221776072067983,39
171,1,294,142,152,0,0,0,1.0,1,1.0,1,1.0,1,0.14744832766682006,39
172,0,294,142,152,0,0,0,1.0,1,1.0,1,1.0,1,0.16188161035084003,38
173,2,296,144,152,0,0,0,1.0,1,1.0,1,1.0,1,0.24891056475029463,38
174,1,297,144,153,0,0,0,1.0,1,1.0,1,1.0,1,0.20327596295393546,37
175,2,299,146,153,0,0,0,1.0,1,1.0,1,1.0,1,0.2604047970134744,36
176,1,300,147,153,0,0,0,1.0,1,1.0,1,1.0,1,0.2930725749579404,36
177,1,301,148,153,0,0,0,1.0,1,1.0,1,1.0,1,0.29837882893523143,38
178,1,302,149,153,0,0,0,1.0,1,1.0,1,1.0,1,0.33631122059539,39
179,4,306,149,157,0,0,0,1.0,1,1.0,1,1.0,1,0.252774333266027,40
180,1,307,150,157,0,0,0,1.0,1,1.0,1,1.0,1,0.23950877464632292,40
181,0,307,150,157,0,0,0,1.0,1,1.0,1,1.0,1,0.2622148919438074,39
182,1,308,151,157,0,0,0,1.0,1,1.0,1,1.0,1,0.2676958695516926,40
183,1,309,152,157,0,0,0,1.0,1,1.0,1,1.0,1,0.314068210415187,40
184,0,309,152,157,0,0,0,1.0,1,1.0,1,1.0,1,0.3153413981953434,38
185,2,311,153,158,0,0,0,1.0,1,1.0,1,1.0,1,0.3155875335725979,38
186,3,314,154,160,0,0,0,1.0,1,1.0,1,1.0,1,0.2609508175660524,37
187,3,317,156,161,0,0,0,1.0,1,1.0,1,1.0,1,0.26960781862766414,36
188,5,322,159,163,0,0,0,1.0,1,1.0,1,1.0,1,0.20775399626284963,36
189,1,323,159,164,0,0,0,1.0,1,1.0,1,1.0,1,0.19106639862221433,36
190,1,324,159,165,0,0,0,1.0,1,1.0,1,1.0,1,0.19891111974651943,36
191,1,325,160,165,0,0,0,1.0,1,1.0,1,1.0,1,0.20776846821115807,37
192,1,326,161,165,0,0,0,1.0,1,1.0,1,1.0,1,0.19170525460221619,37
193,2,328,162,166,0,0,0,1.0,1,1.0,1,1.0,1,0.18445862590334855,38
194,0,328,162,166,0,0,0,1.0,1,1.0,1,1.0,1,0.201521456020781,39
195,3,331,164,167,0,0,0,1.0,1,1.0,1,1.0,1,0.2020085212670871,40
196,0,331,164,167,0,0,0,1.0,1,1.0,1,1.0,1,0.2020085212670871,40
197,0,331,164,167,0,0,0,1.0,1,1.0,1,1.0,1,0.23853536339579245,40
198,2,333,165,168,0,0,0,1.0,1,1.0,1,1.0,1,0.23871096449628507,40
199,1,334,166,168,0,0,0,1.0,1,1.0,1,1.0,1,0.24293368485788888,40
200,0,334,166,168,0,0,0,1.0,1,1.0,1,1.0,1,0.24293368485788888,40
201,2,336,167,169,0,0,0,1.0,1,1.0,1,1.0,1,0.214154415019346,39
202,0,336,167,169,0,0,0,1.0,1,1.0,1,1.0,1,0.19261848494818304,40
203,2,338,169,169,0,0,0,1.0,1,1.0,1,1.0,1,0.1936002827255411,39
204,1,339,170,169,0,0,0,1.0,1,1.0,1,1.0,1,0.19516487649855327,38
205,1,340,171,169,0,0,0,1.0,1,1.0,1,1.0,1,0.1852547250727126,37
206,0,340,171,169,0,0,0,1.0,1,1.0,1,1.0,1,0.21986917044380525,36
207,2,342,171,171,0,0,0,1.0,1,1.0,1,1.0,1,0.1760285023245482,37
208,0,342,171,171,0,0,0,1.0,1,1.0,1,1.0,1,0.2044806984979926,36
209,1,343,172,171,0,0,0,1.0,1,1.0,1,1.0,1,0.23929661198013688,36
210,2,345,174,171,0,0,0,1.0,1,1.0,1,1.0,1,0.28164055288994805,36
211,1,346,174,172,0,0,0,1.0,1,1.0,1,1.0,1,0.2937565210113172,34
212,2,348,175,173,0,0,0,1.0,1,1.0,1,1.0,1,0.2997709938811252,34
213,1,349,175,174,0,0,0,1.0,1,1.0,1,1.0,1,0.3129122166965769,36
214,0,349,175,174,0,0,0,1.0,1,1.0,1,1.0,1,0.29840810240267085,35
215,2,351,177,174,0,0,0,1.0,1,1.0,1,1.0,1,0.2979074211725724,35
216,3,354,177,177,0,0,0,1.0,1,1.0,1,1.0,1,0.2495058019882313,37
217,4,358,178,180,0,0,0,1.0,1,1.0,1,1.0,1,0.22647085407031306,37
218,5,363,182,181,0,0,0,1.0,1,1.0,1,1.0,1,0.20983454106171345,37
219,4,367,183,184,0,0,0,1.0,1,1.0,1,1.0,1,0.16718967725794748,37
220,0,367,183,184,0,0,0,1.0,1,1.0,1,1.0,1,0.18108249649991673,38
221,3,370,185,185,0,0,0,1.0,1,1.0,1,1.0,1,0.11847709256987475,39
222,1,371,186,185,0,0,0,1.0,1,1.0,1,1.0,1,0.14101815509736726,39
223,1,372,186,186,0,0,0,1.0,1,1.0,1,1.0,1,0.1307876267085786,40
224,0,372,186,186,0,0,0,1.0,1,1.0,1,1.0,1,0.1278919373654664,40
225,2,374,187,187,0,0,0,1.0,1,1.0,1,1.0,1,0.10073784587815904,39
226,2,376,189,187,0,0,0,1.0,1,1.0,1,1.0,1,0.1665582232855474,39
227,2,378,191,187,0,0,0,1.0,1,1.0,1,1.0,1,0.2385168950874676,39
228,2,380,193,187,0,0,0,1.0,1,1.0,1,1.0,1,0.2603995934536275,38
229,4,384,194,190,0,0,0,1.0,1,1.0,1,1.0,1,0.23349376836039928,39
230,3,387,195,192,0,0,0,1.0,1,1.0,1,1.0,1,0.1582528134887962,38
231,1,388,196,192,0,0,0,1.0,1,1.0,1,1.0,1,0.15384291251963297,38
232,2,390,198,192,0,0,0,1.0,1,1.0,1,1.0,1,0.18475176085550898,37
233,2,392,199,193,0,0,0,1.0,1,1.0,1,1.0,1,0.18040647635781976,36
234,1,393,200,193,0,0,0,1.0,1,1.0,1,1.0,1,0.19330775521480933,34
235,2,395,202,193,0,0,0,1.0,1,1.0,1,1.0,1,0.32093472420682884,34
236,1,396,202,194,0,0,0,1.0,1,1.0,1,1.0,1,0.3059126069229312,33
237,1,397,202,195,0,0,0,1.0,1,1.0,1,1.0,1,0.29711679885349895,32
238,1,398,203,195,0,0,0,1.0,1,1.0,1,1.0,1,0.33901574616506497,32
239,1,399,204,195,0,0,0,1.0,1,1.0,1,1.0,1,0.3166332068143562,31
240,2,401,204,197,0,0,0,1.0,1,1.0,1,1.0,1,0.26500513377226304,28
241,2,403,206,197,0,0,0,1.0,1,1.0,1,1.0,1,0.3608596878609906,27
242,4,407,207,200,0,0,0,1.0,1,1.0,1,1.0,1,0.31433539780894143,29
243,2,409,208,201,0,0,0,1.0,1,1.0,1,1.0,1,0.27871614303169634,28
244,0,409,208,201,0,0,0,1.0,1,1.0,1,1.0,1,0.28716221534525344,28
245,1,410,209,201,0,0,0,1.0,1,1.0,1,1.0,1,0.2742249925674314,27
246,3,413,211,202,0,0,0,1.0,1,1.0,1,1.0,1,0.24178515539238019,25
247,0,413,211,202,0,0,0,1.0,1,1.0,1,1.0,1,0.25385960350501474,26
248,0,413,211,202,0,0,0,1.0,1,1.0,1,1.0,1,0.25129927984217065,27
249,1,414,212,202,0,0,0,1.0,1,1.0,1,1.0,1,0.27545634070303265,26
250,0,414,212,202,0,0,0,1.0,1,1.0,1,1.0,1,0.29727288009748426,27
251,0,414,212,202,0,0,0,1.0,1,1.0,1,1.0,1,0.3129844774698504,28
252,1,415,213,202,0,0,0,1.0,1,1.0,1,1.0,1,0.32466898223422713,28
253,1,416,213,203,0,0,0,1.0,1,1.0,1,1.0,1,0.28963102069160385,28
254,0,416,213,203,0,0,0,1.0,1,1.0,1,1.0,1,0.3166419437269786,29
255,2,418,214,204,0,0,0,1.0,1,1.0,1,1.0,1,0.34914513364258587,30
256,3,421,216,205,0,0,0,1.0,1,1.0,1,1.0,1,0.35690293398832035,30
257,4,425,217,208,0,0,0,1.0,1,1.0,1,1.0,1,0.3627236127283077,32
258,2,427,219,208,0,0,0,1.0,1,1.0,1,1.0,1,0.3594690537349551,32
259,2,429,219,210,0,0,0,1.0,1,1.0,1,1.0,1,0.3301290046058454,32
260,1,430,220,210,0,0,0,1.0,1,1.0,1,1.0,1,0.286943607970563,34
261,0,430,220,210,0,0,0,1.0,1,1.0,1,1.0,1,0.3015073549386469,35
262,2,432,222,210,0,0,0,1.0,1,1.0,1,1.0,1,0.37943189040359443,36
263,0,432,222,210,0,0,0,1.0,1,1.0,1,1.0,1,0.357951753318238,34
264,0,432,222,210,0,0,0,1.0,1,1.0,1,1.0,1,0.357951753318238,34
265,0,432,222,210,0,0,0,1.0,1,1.0,1,1.0,1,0.39203161882884324,33
266,2,434,223,211,0,0,0,1.0,1,1.0,1,1.0,1,0.3759023319146442,34
267,2,436,223,213,0,0,0,1.0,1,1.0,1,1.0,1,0.3381490902173838,33
268,1,437,223,214,0,0,0,1.0,1,1.0,1,1.0,1,0.33653187558556424,34
269,0,437,223,214,0,0,0,1.0,1,1.0,1,1.0,1,0.33653187558556424,34
270,1,438,223,215,0,0,0,1.0,1,1.0,1,1.0,1,0.34001511356326874,36
271,0,438,223,215,0,0,0,1.0,1,1.0,1,1.0,1,0.34001511356326874,36
272,0,438,223,215,0,0,0,1.0,1,1.0,1,1.0,1,0.3467776527294507,38
273,0,438,223,215,0,0,0,1.0,1,1.0,1,1.0,1,0.3467776527294507,38
274,1,439,224,215,0,0,0,1.0,1,1.0,1,1.0,1,0.36872810089915864,38
275,1,440,224,216,0,0,0,1.0,1,1.0,1,1.0,1,0.34870474250436784,38
276,1,441,224,217,0,0,0,1.0,1,1.0,1,1.0,1,0.36577108475879627,39
277,1,442,224,218,0,0,0,1.0,1,1.0,1,1.0,1,0.3239324572494724,38
278,0,442,224,218,0,0,0,1.0,1,1.0,1,1.0,1,0.30455581111731833,38
279,1,443,225,218,0,0,0,1.0,1,1.0,1,1.0,1,0.3089167975631741,38
280,0,443,225,218,0,0,0,1.0,1,1.0,1,1.0,1,0.3127828235847254,38
281,0,443,225,218,0,0,0,1.0,1,1.0,1,1.0,1,0.3116562022578744,38
282,2,445,226,219,0,0,0,1.0,1,1.0,1,1.0,1,0.32203910272310987,38
283,4,449,228,221,0,0,0,1.0,1,1.0,1,1.0,1,0.3483184719076234,38
284,1,450,228,222,0,0,0,1.0,1,1.0,1,1.0,1,0.31331619152511797,39
285,1,451,228,223,0,0,0,1.0,1,1.0,1,1.0,1,0.2873787225663547,39
286,0,451,228,223,0,0,0,1.0,1,1.0,1,1.0,1,0.2873787225663547,39
287,3,454,228,226,0,0,0,1.0,1,1.0,1,1.0,1,0.23828694198313966,39
288,1,455,228,227,0,0,0,1.0,1,1.0,1,1.0,1,0.1798467334155106,39
289,1,456,229,227,0,0,0,1.0,1,1.0,1,1.0,1,0.22687744895201983,39
290,0,456,229,227,0,0,0,1.0,1,1.0,1,1.0,1,0.2271717371505465,39
291,1,457,229,228,0,0,0,1.0,1,1.0,1,1.0,1,0.20882516189341532,39
292,0,457,229,228,0,0,0,1.0,1,1.0,1,1.0,1,0.21805391877454006,40
293,4,461,232,229,0,0,0,1.0,1,1.0,1,1.0,1,0.18250026643050787,41
294,2,463,233,230,0,0,0,1.0,1,1.0,1,1.0,1,0.13875888170453937,40
295,2,465,234,231,0,0,0,1.0,1,1.0,1,1.0,1,0.1553380695661239,42
296,3,468,237,231,0,0,0,1.0,1,1.0,1,1.0,1,0.22084551480614498,42
297,5,473,239,234,0,0,0,1.0,1,1.0,1,1.0,1,0.16416523946726938,43
298,2,475,240,235,0,0,0,1.0,1,1.0,1,1.0,1,0.19722900803465268,44
299,4,479,241,238,0,0,0,1.0,1,1.0,1,1.0,1,0.14121987335728492,44
300,2,481,241,240,0,0,0,1.0,1,1.0,1,1.0,1,0.08466940733215096,45
301,1,482,242,240,0,0,0,1.0,1,1.0,1,1.0,1,0.12287354175312383,47
302,2,484,243,241,0,0,0,1.0,1,1.0,1,1.0,1,0.12819157080910173,46
303,1,485,244,241,0,0,0,1.0,1,1.0,1,1.0,1,0.13597005829407371,45
304,3,488,247,241,0,0,0,1.0,1,1.0,1,1.0,1,0.18811925475494556,45
305,0,488,247,241,0,0,0,1.0,1,1.0,1,1.0,1,0.18077293822631832,43
306,2,490,248,242,0,0,0,1.0,1,1.0,1,1.0,1,0.21986847507023385,44
307,4,494,249,245,0,0,0,1.0,1,1.0,1,1.0,1,0.1845101454789195,42
308,2,496,251,245,0,0,0,1.0,1,1.0,1,1.0,1,0.1830751524312682,41
309,0,496,251,245,0,0,0,1.0,1,1.0,1,1.0,1,0.19454686545525107,42
310,0,496,251,245,0,0,0,1.0,1,1.0,1,1.0,1,0.2000568233157864,41
311,0,496,251,245,0,0,0,1.0,1,1.0,1,1.0,1,0.2000568233157864,41
312,1,497,251,246,0,0,0,1.0,1,1.0,1,1.0,1,0.16565550509938223,44
313,0,497,251,246,0,0,0,1.0,1,1.0,1,1.0,1,0.17439737594833143,43
314,0,497,251,246,0,0,0,1.0,1,1.0,1,1.0,1,0.17439737594833143,43
315,0,497,251,246,0,0,0,1.0,1,1.0,1,1.0,1,0.1454453426639621,43
316,1,498,252,246,0,0,0,1.0,1,1.0,1,1.0,1,0.17905534729358213,43
317,0,498,252,246,0,0,0,1.0,1,1.0,1,1.0,1,0.1920187471611632,44
318,3,501,254,247,0,0,0,1.0,1,1.0,1,1.0,1,0.2628497305297629,45
319,3,504,254,250,0,0,0,1.0,1,1.0,1,1.0,1,0.21979672415725943,46
320,2,506,254,252,0,0,0,1.0,1,1.0,1,1.0,1,0.21015755451190238,45
321,0,506,254,252,0,0,0,1.0,1,1.0,1,1.0,1,0.19477263923419294,44
322,0,506,254,252,0,0,0,1.0,1,1.0,1,1.0,1,0.19102074587766432,42
323,4,510,256,254,0,0,0,1.0,1,1.0,1,1.0,1,0.16481091649194343,42
324,0,510,256,254,0,0,0,1.0,1,1.0,1,1.0,1,0.17557626242477586,43
325,2,512,258,254,0,0,0,1.0,1,1.0,1,1.0,1,0.2381433089349935,43
326,1,513,258,255,0,0,0,1.0,1,1.0,1,1.0,1,0.2150547996920002,43
327,5,518,260,258,0,0,0,1.0,1,1.0,1,1.0,1,0.21813951084035624,44
328,0,518,260,258,0,0,0,1.0,1,1.0,1,1.0,1,0.21813951084035624,44
329,0,518,260,258,0,0,0,1.0,1,1.0,1,1.0,1,0.20071092659751866,45
330,0,518,260,258,0,0,0,1.0,1,1.0,1,1.0,1,0.20304463860456776,46
331,0,518,260,258,0,0,0,1.0,1,1.0,1,1.0,1,0.20304463860456776,46
332,1,519,260,259,0,0,0,1.0,1,1.0,1,1.0,1,0.15455993867934054,47
333,0,519,260,259,0,0,0,1.0,1,1.0,1,1.0,1,0.16831924787277042,48
334,0,519,260,259,0,0,0,1.0,1,1.0,1,1.0,1,0.16831924787277042,48
335,1,520,261,259,0,0,0,1.0,1,1.0,1,1.0,1,0.1628947250400995,49
336,1,521,261,260,0,0,0,1.0,1,1.0,1,1.0,1,0.16494884799931347,50
337,2,523,262,261,0,0,0,1.0,1,1.0,1,1.0,1,0.172003666272399,51
338,1,524,263,261,0,0,0,1.0,1,1.0,1,1.0,1,0.20319048996889427,51
339,4,528,264,264,0,0,0,1.0,1,1.0,1,1.0,1,0.19728753380054787,51
340,1,529,265,264,0,0,0,1.0,1,1.0,1,1.0,1,0.21951932065183818,51
341,3,532,265,267,0,0,0,1.0,1,1.0,1,1.0,1,0.1697598034908462,51
342,1,533,266,267,0,0,0,1.0,1,1.0,1,1.0,1,0.19669615451535824,51
343,1,534,266,268,0,0,0,1.0,1,1.0,1,1.0,1,0.1950330650367825,51
344,0,534,266,268,0,0,0,1.0,1,1.0,1,1.0,1,0.19461940088372667,50
345,0,534,266,268,0,0,0,1.0,1,1.0,1,1.0,1,0.19461940088372667,50
346,3,537,268,269,0,0,0,1.0,1,1.0,1,1.0,1,0.24880147478029688,50
347,3,540,268,272,0,0,0,1.0,1,1.0,1,1.0,1,0.19717630758117044,51
348,1,541,269,272,0,0,0,1.0,1,1.0,1,1.0,1,0.21819474498248992,52
349,3,544,272,272,0,0,0,1.0,1,1.0,1,1.0,1,0.22968519939564416,54
350,3,547,272,275,0,0,0,1.0,1,1.0,1,1.0,1,0.22537781313252087,54
351,4,551,275,276,0,0,0,1.0,1,1.0,1,1.0,1,0.22573676144468247,54
352,5,556,276,280,0,0,0,1.0,1,1.0,1,1.0,1,0.2037690540005971,56
353,3,559,277,282,0,0,0,1.0,1,1.0,1,1.0,1,0.15290314406617972,54
354,0,559,277,282,0,0,0,1.0,1,1.0,1,1.0,1,0.1680431506886699,53
355,1,560,278,282,0,0,0,1.0,1,1.0,1,1.0,1,0.1612992932111541,54
356,1,561,279,282,0,0,0,1.0,1,1.0,1,1.0,1,0.18138969699353397,54
357,4,565,283,282,0,0,0,1.0,1,1.0,1,1.0,1,0.2259213117587028,53
358,0,565,283,282,0,0,0,1.0,1,1.0,1,1.0,1,0.23901604477144286,49
359,0,565,283,282,0,0,0,1.0,1,1.0,1,1.0,1,0.255856086103214,48
360,0,565,283,282,0,0,0,1.0,1,1.0,1,1.0,1,0.2741776262703343,47
361,1,566,283,283,0,0,0,1.0,1,1.0,1,1.0,1,0.24917169652470386,46
362,0,566,283,283,0,0,0,1.0,1,1.0,1,1.0,1,0.2514740398886719,46
363,2,568,284,284,0,0,0,1.0,1,1.0,1,1.0,1,0.2212050720805831,47
364,0,568,284,284,0,0,0,1.0,1,1.0,1,1.0,1,0.2212050720805831,47
365,0,568,284,284,0,0,0,1.0,1,1.0,1,1.0,1,0.2212050720805831,47
366,3,571,286,285,0,0,0,1.0,1,1.0,1,1.0,1,0.2668383477148251,50
367,0,571,286,285,0,0,0,1.0,1,1.0,1,1.0,1,0.2668383477148251,50
368,1,572,286,286,0,0,0,1.0,1,1.0,1,1.0,1,0.24123618209188133,51
369,1,573,286,287,0,0,0,1.0,1,1.0,1,1.0,1,0.23783039656975455,51
370,2,575,286,289,0,0,0,1.0,1,1.0,1,1.0,1,0.2102585529762128,51
371,2,577,286,291,0,0,0,1.0,1,1.0,1,1.0,1,0.212132817418974,52
372,0,577,286,291,0,0,0,1.0,1,1.0,1,1.0,1,0.21325384913998466,53
373,2,579,288,291,0,0,0,1.0,1,1.0,1,1.0,1,0.21228776236856853,53
374,2,581,289,292,0,0,0,1.0,1,1.0,1,1.0,1,0.23670169601266536,53
375,5,586,292,294,0,0,0,1.0,1,1.0,1,1.0,1,0.1879761999463925,53
376,1,587,293,294,0,0,0,1.0,1,1.0,1,1.0,1,0.18228114503690343,53
377,3,590,295,295,0,0,0,1.0,1,1.0,1,1.0,1,0.16883626833614457,53
378,1,591,296,295,0,0,0,1.0,1,1.0,1,1.0,1,0.16142861720594437,53
379,1,592,297,295,0,0,0,1.0,1,1.0,1,1.0,1,0.17144744652879026,54
380,1,593,298,295,0,0,0,1.0,1,1.0,1,1.0,1,0.16627717370759815,54
381,1,594,299,295,0,0,0,1.0,1,1.0,1,1.0,1,0.18180499538027922,54
382,2,596,301,295,0,0,0,1.0,1,1.0,1,1.0,1,0.19218293320503174,55
383,2,598,302,296,0,0,0,1.0,1,1.0,1,1.0,1,0.17756447656118146,55
384,1,599,303,296,0,0,0,1.0,1,1.0,1,1.0,1,0.202168701297302,54
385,3,602,303,299,0,0,0,1.0,1,1.0,1,1.0,1,0.1719357272621571,52
386,2,604,304,300,0,0,0,1.0,1,1.0,1,1.0,1,0.15605590170243647,52
387,2,606,305,301,0,0,0,1.0,1,1.0,1,1.0,1,0.17781566232981758,50
388,3,609,306,303,0,0,0,1.0,1,1.0,1,1.0,1,0.16858429612517692,52
389,1,610,306,304,0,0,0,1.0,1,1.0,1,1.0,1,0.16885529781520434,51
390,1,611,307,304,0,0,0,1.0,1,1.0,1,1.0,1,0.18298495093461867,50
391,4,615,309,306,0,0,0,1.0,1,1.0,1,1.0,1,0.17994853412934084,49
392,2,617,311,306,0,0,0,1.0,1,1.0,1,1.0,1,0.2177844891688882,47
393,5,622,313,309,0,0,0,1.0,1,1.0,1,1.0,1,0.21624604440291242,47
394,3,625,315,310,0,0,0,1.0,1,1.0,1,1.0,1,0.22296968146477397,48
395,5,630,317,313,0,0,0,1.0,1,1.0,1,1.0,1,0.2676590977978716,46
396,2,632,318,314,0,0,0,1.0,1,1.0,1,1.0,1,0.29014280989533076,43
397,1,633,318,315,0,0,0,1.0,1,1.0,1,1.0,1,0.288192158225783,42
398,1,634,319,315,0,0,0,1.0,1,1.0,1,1.0,1,0.3314547598088693,40
399,2,636,319,317,0,0,0,1.0,1,1.0,1,1.0,1,0.2749306566297487,39
400,2,638,320,318,0,0,0,1.0,1,1.0,1,1.0,1,0.23142909233184306,38
401,1,639,320,319,0,0,0,1.0,1,1.0,1,1.0,1,0.24537543460983238,37
402,0,639,320,319,0,0,0,1.0,1,1.0,1,1.0,1,0.23878950340539148,36
403,1,640,321,319,0,0,0,1.0,1,1.0,1,1.0,1,0.1956250141834654,38
404,2,642,323,319,0,0,0,1.0,1,1.0,1,1.0,1,0.23905404944605324,39
405,3,645,323,322,0,0,0,1.0,1,1.0,1,1.0,1,0.1697811963050683,40
406,1,646,323,323,0,0,0,1.0,1,1.0,1,1.0,1,0.13666929055441987,41
407,0,646,323,323,0,0,0,1.0,1,1.0,1,1.0,1,0.1267989114261826,42
408,0,646,323,323,0,0,0,1.0,1,1.0,1,1.0,1,0.12582731083435547,43
409,1,647,324,323,0,0,0,1.0,1,1.0,1,1.0,1,0.16799017043016135,44
410,0,647,324,323,0,0,0,1.0,1,1.0,1,1.0,1,0.1841273570372073,46
411,1,648,325,323,0,0,0,1.0,1,1.0,1,1.0,1,0.2095823627467653,46
412,1,649,325,324,0,0,0,1.0,1,1.0,1,1.0,1,0.21660113085284194,47
413,2,651,326,325,0,0,0,1.0,1,1.0,1,1.0,1,0.2430449237064019,47
414,0,651,326,325,0,0,0,1.0,1,1.0,1,1.0,1,0.2430449237064019,47
415,2,653,326,327,0,0,0,1.0,1,1.0,1,1.0,1,0.2347126888178305,48
416,0,653,326,327,0,0,0,1.0,1,1.0,1,1.0,1,0.23892622457932888,49
417,1,654,326,328,0,0,0,1.0,1,1.0,1,1.0,1,0.21892397390889995,49
418,1,655,326,329,0,0,0,1.0,1,1.0,1,1.0,1,0.21729890397973436,50
419,2,657,326,331,0,0,0,1.0,1,1.0,1,1.0,1,0.19153900235156665,50
420,1,658,327,331,0,0,0,1.0,1,1.0,1,1.0,1,0.18479095255806957,50
421,0,658,327,331,0,0,0,1.0,1,1.0,1,1.0,1,0.18479095255806957,50
422,0,658,327,331,0,0,0,1.0,1,1.0,1,1.0,1,0.20849484663525544,50
423,3,661,330,331,0,0,0,1.0,1,1.0,1,1.0,1,0.24249640660015884,51
424,1,662,330,332,0,0,0,1.0,1,1.0,1,1.0,1,0.22824807753738185,49
425,1,663,331,332,0,0,0,1.0,1,1.0,1,1.0,1,0.2424840002875161,48
426,2,665,331,334,0,0,0,1.0,1,1.0,1,1.0,1,0.21760041330677268,50
427,5,670,334,336,0,0,0,1.0,1,1.0,1,1.0,1,0.2545117873677819,48
428,5,675,337,338,0,0,0,1.0,1,1.0,1,1.0,1,0.3173269433768374,49
429,5,680,337,343,0,0,0,1.0,1,1.0,1,1.0,1,0.2681561000432477,45
430,4,684,339,345,0,0,0,1.0,1,1.0,1,1.0,1,0.24531820244540503,44
431,1,685,339,346,0,0,0,1.0,1,1.0,1,1.0,1,0.23624269369495238,42
432,0,685,339,346,0,0,0,1.0,1,1.0,1,1.0,1,0.24681151995942796,40
433,1,686,340,346,0,0,0,1.0,1,1.0,1,1.0,1,0.2694147208462194,39
434,3,689,342,347,0,0,0,1.0,1,1.0,1,1.0,1,0.21952784988394192,39
435,3,692,345,347,0,0,0,1.0,1,1.0,1,1.0,1,0.32409819193729983,38
436,1,693,345,348,0,0,0,1.0,1,1.0,1,1.0,1,0.29171294758017763,38
437,3,696,346,350,0,0,0,1.0,1,1.0,1,1.0,1,0.2631104271310313,39
438,0,696,346,350,0,0,0,1.0,1,1.0,1,1.0,1,0.25809578806054323,38
439,1,697,346,351,0,0,0,1.0,1,1.0,1,1.0,1,0.26324734252581533,39
440,0,697,346,351,0,0,0,1.0,1,1.0,1,1.0,1,0.26324734252581533,39
441,4,701,347,354,0,0,0,1.0,1,1.0,1,1.0,1,0.15398835542935252,41
442,0,701,347,354,0,0,0,1.0,1,1.0,1,1.0,1,0.16601134326587813,42
443,0,701,347,354,0,0,0,1.0,1,1.0,1,1.0,1,0.16601134326587813,42
444,0,701,347,354,0,0,0,1.0,1,1.0,1,1.0,1,0.16598717082685766,43
445,2,703,349,354,0,0,0,1.0,1,1.0,1,1.0,1,0.182451614187978,44
446,0,703,349,354,0,0,0,1.0,1,1.0,1,1.0,1,0.19444869497892975,44
447,3,706,350,356,0,0,0,1.0,1,1.0,1,1.0,1,0.20878145473034207,47
448,2,708,351,357,0,0,0,1.0,1,1.0,1,1.0,1,0.24293942138361257,46
449,1,709,351,358,0,0,0,1.0,1,1.0,1,1.0,1,0.2247548363816109,46
450,0,709,351,358,0,0,0,1.0,1,1.0,1,1.0,1,0.25853805752805875,46
451,1,710,352,358,0,0,0,1.0,1,1.0,1,1.0,1,0.2795379326113379,47
452,1,711,352,359,0,0,0,1.0,1,1.0,1,1.0,1,0.2888352390524611,47
453,0,711,352,359,0,0,0,1.0,1,1.0,1,1.0,1,0.2888352390524611,47
454,2,713,352,361,0,0,0,1.0,1,1.0,1,1.0,1,0.2333925589751804,46
455,5,718,353,365,0,0,0,1.0,1,1.0,1,1.0,1,0.18560327765246484,47
456,1,719,353,366,0,0,0,1.0,1,1.0,1,1.0,1,0.15553725782338645,49
457,1,720,354,366,0,0,0,1.0,1,1.0,1,1.0,1,0.18168395169472706,50
458,0,720,354,366,0,0,0,1.0,1,1.0,1,1.0,1,0.18168395169472706,50
459,1,721,354,367,0,0,0,1.0,1,1.0,1,1.0,1,0.14661479655809653,52
460,2,723,354,369,0,0,0,1.0,1,1.0,1,1.0,1,0.14921574601906404,53
461,1,724,354,370,0,0,0,1.0,1,1.0,1,1.0,1,0.15419458380219464,54
462,0,724,354,370,0,0,0,1.0,1,1.0,1,1.0,1,0.15419458380219464,54
463,4,728,356,372,0,0,0,1.0,1,1.0,1,1.0,1,0.15341172263089575,55
464,3,731,358,373,0,0,0,1.0,1,1.0,1,1.0,1,0.16953107932013123,56
465,1,732,358,374,0,0,0,1.0,1,1.0,1,1.0,1,0.14965642366300128,54
466,1,733,359,374,0,0,0,1.0,1,1.0,1,1.0,1,0.1590064886883237,54
467,4,737,362,375,0,0,0,1.0,1,1.0,1,1.0,1,0.14402688185267182,51
468,5,742,365,377,0,0,0,1.0,1,1.0,1,1.0,1,0.12071238999748632,51
469,2,744,366,378,0,0,0,1.0,1,1.0,1,1.0,1,0.15395041371494092,48
470,3,747,369,378,0,0,0,1.0,1,1.0,1,1.0,1,0.2013347067824171,47
471,4,751,372,379,0,0,0,1.0,1,1.0,1,1.0,1,0.23054771991241135,44
472,7,758,376,382,0,0,0,1.0,1,1.0,1,1.0,1,0.2625042020583098,43
473,4,762,376,386,0,0,0,1.0,1,1.0,1,1.0,1,0.13652158129449532,41
474,0,762,376,386,0,0,0,1.0,1,1.0,1,1.0,1,0.18784745391796773,39
475,3,765,376,389,0,0,0,1.0,1,1.0,1,1.0,1,0.13103679630033024,40
476,1,766,377,389,0,0,0,1.0,1,1.0,1,1.0,1,0.14086932498708962,38
477,3,769,379,390,0,0,0,1.0,1,1.0,1,1.0,1,0.23900326815455875,35
478,0,769,379,390,0,0,0,1.0,1,1.0,1,1.0,1,0.24325040965691053,35
479,1,770,380,390,0,0,0,1.0,1,1.0,1,1.0,1,0.2788006184224574,32
480,0,770,380,390,0,0,0,1.0,1,1.0,1,1.0,1,0.30163254434529646,32
481,0,770,380,390,0,0,0,1.0,1,1.0,1,1.0,1,0.29242958653402223,33
482,2,772,382,390,0,0,0,1.0,1,1.0,1,1.0,1,0.3552467908325611,34
483,0,772,382,390,0,0,0,1.0,1,1.0,1,1.0,1,0.3542014713232899,32
484,0,772,382,390,0,0,0,1.0,1,1.0,1,1.0,1,0.3374383000135752,33
485,3,775,384,391,0,0,0,1.0,1,1.0,1,1.0,1,0.3114379687983809,34
486,2,777,384,393,0,0,0,1.0,1,1.0,1,1.0,1,0.2877693538579909,36
487,2,779,384,395,0,0,0,1.0,1,1.0,1,1.0,1,0.23364840092451217,36
488,3,782,385,397,0,0,0,1.0,1,1.0,1,1.0,1,0.20835716561144818,37
489,4,786,387,399,0,0,0,1.0,1,1.0,1,1.0,1,0.23479544067945665,38
490,0,786,387,399,0,0,0,1.0,1,1.0,1,1.0,1,0.23479544067945665,38
491,1,787,387,400,0,0,0,1.0,1,1.0,1,1.0,1,0.2115351660368091,37
492,2,789,388,401,0,0,0,1.0,1,1.0,1,1.0,1,0.22967983069151007,37
493,0,789,388,401,0,0,0,1.0,1,1.0,1,1.0,1,0.22967983069151007,37
494,4,793,390,403,0,0,0,1.0,1,1.0,1,1.0,1,0.2384612012713424,39
495,0,793,390,403,0,0,0,1.0,1,1.0,1,1.0,1,0.24212136311606267,40
496,1,794,390,404,0,0,0,1.0,1,1.0,1,1.0,1,0.21827956821225722,40
497,1,795,390,405,0,0,0,1.0,1,1.0,1,1.0,1,0.17201696120907725,43
498,1,796,390,406,0,0,0,1.0,1,1.0,1,1.0,1,0.1392986428795608,43
499,0,796,390,406,0,0,0,1.0,1,1.0,1,1.0,1,0.14897463477736336,44
500,1,797,391,406,0,0,0,1.0,1,1.0,1,1.0,1,0.16163843040419865,45
501,1,798,391,407,0,0,0,1.0,1,1.0,1,1.0,1,0.14830253507647012,45
502,3,801,393,408,0,0,0,1.0,1,1.0,1,1.0,1,0.16148887610162904,45
503,1,802,394,408,0,0,0,1.0,1,1.0,1,1.0,1,0.16954350725272285,46
504,3,805,396,409,0,0,0,1.0,1,1.0,1,1.0,1,0.2199660482796641,47
505,1,806,396,410,0,0,0,1.0,1,1.0,1,1.0,1,0.21067863435571182,42
506,1,807,397,410,0,0,0,1.0,1,1.0,1,1.0,1,0.27012424768304616,41
507,0,807,397,410,0,0,0,1.0,1,1.0,1,1.0,1,0.26271463938637357,38
508,4,811,400,411,0,0,0,1.0,1,1.0,1,1.0,1,0.37467977090308763,38
509,0,811,400,411,0,0,0,1.0,1,1.0,1,1.0,1,0.3597522873909575,37
510,0,811,400,411,0,0,0,1.0,1,1.0,1,1.0,1,0.3671904349684865,36
511,2,813,401,412,0,0,0,1.0,1,1.0,1,1.0,1,0.3874349337404242,34
512,0,813,401,412,0,0,0,1.0,1,1.0,1,1.0,1,0.3624318801977109,32
513,0,813,401,412,0,0,0,1.0,1,1.0,1,1.0,1,0.3624318801977109,32
514,1,814,401,413,0,0,0,1.0,1,1.0,1,1.0,1,0.3462963804892205,35
515,0,814,401,413,0,0,0,1.0,1,1.0,1,1.0,1,0.3462963804892205,35
516,3,817,401,416,0,0,0,1.0,1,1.0,1,1.0,1,0.3093388771952549,36
517,1,818,401,417,0,0,0,1.0,1,1.0,1,1.0,1,0.2987037105797478,36
518,5,823,401,422,0,0,0,1.0,1,1.0,1,1.0,1,0.2677648918091155,39
519,1,824,402,422,0,0,0,1.0,1,1.0,1,1.0,1,0.25578112780241635,39
520,2,826,403,423,0,0,0,1.0,1,1.0,1,1.0,1,0.27442464625820717,39
521,1,827,403,424,0,0,0,1.0,1,1.0,1,1.0,1,0.245497049057306,40
522,0,827,403,424,0,0,0,1.0,1,1.0,1,1.0,1,0.245497049057306,40
523,1,828,403,425,0,0,0,1.0,1,1.0,1,1.0,1,0.24732295024121992,41
524,1,829,403,426,0,0,0,1.0,1,1.0,1,1.0,1,0.2301796851220518,41
525,2,831,405,426,0,0,0,1.0,1,1.0,1,1.0,1,0.24796794642230835,40
526,2,833,406,427,0,0,0,1.0,1,1.0,1,1.0,1,0.2688361717046688,40
527,3,836,407,429,0,0,0,1.0,1,1.0,1,1.0,1,0.26557701895471575,40
528,1,837,408,429,0,0,0,1.0,1,1.0,1,1.0,1,0.24711228001757848,40
529,1,838,408,430,0,0,0,1.0,1,1.0,1,1.0,1,0.2504439596053816,39
530,0,838,408,430,0,0,0,1.0,1,1.0,1,1.0,1,0.2504439596053816,39
531,1,839,409,430,0,0,0,1.0,1,1.0,1,1.0,1,0.24357069941197534,39
532,0,839,409,430,0,0,0,1.0,1,1.0,1,1.0,1,0.2508834855202231,40
533,1,840,410,430,0,0,0,1.0,1,1.0,1,1.0,1,0.3060621339964947,40
534,2,842,410,432,0,0,0,1.0,1,1.0,1,1.0,1,0.3015066400184082,42
535,2,844,410,434,0,0,0,1.0,1,1.0,1,1.0,1,0.30022729877973736,42
536,0,844,410,434,0,0,0,1.0,1,1.0,1,1.0,1,0.3066260508733263,43
537,1,845,410,435,0,0,0,1.0,1,1.0,1,1.0,1,0.26238237487732974,43
538,1,846,411,435,0,0,0,1.0,1,1.0,1,1.0,1,0.28970657392576266,44
539,1,847,411,436,0,0,0,1.0,1,1.0,1,1.0,1,0.2735888928500921,44
540,0,847,411,436,0,0,0,1.0,1,1.0,1,1.0,1,0.2735888928500921,44
541,1,848,412,436,0,0,0,1.0,1,1.0,1,1.0,1,0.2646351429812971,45
542,3,851,413,438,0,0,0,1.0,1,1.0,1,1.0,1,0.24055986672652643,46
543,2,853,415,438,0,0,0,1.0,1,1.0,1,1.0,1,0.29328855892400796,43
544,2,855,417,438,0,0,0,1.0,1,1.0,1,1.0,1,0.3432009992034281,42
545,3,858,419,439,0,0,0,1.0,1,1.0,1,1.0,1,0.28845001191431224,43
546,2,860,421,439,0,0,0,1.0,1,1.0,1,1.0,1,0.32347408518885623,41
547,3,863,421,442,0,0,0,1.0,1,1.0,1,1.0,1,0.23993646638069707,40
548,3,866,424,442,0,0,0,1.0,1,1.0,1,1.0,1,0.27904636069604455,40
549,2,868,426,442,0,0,0,1.0,1,1.0,1,1.0,1,0.3164915547727363,39
550,2,870,427,443,0,0,0,1.0,1,1.0,1,1.0,1,0.3310198505221455,38
551,3,873,429,444,0,0,0,1.0,1,1.0,1,1.0,1,0.36277727572549057,38
552,3,876,430,446,0,0,0,1.0,1,1.0,1,1.0,1,0.38744068444710117,39
553,0,876,430,446,0,0,0,1.0,1,1.0,1,1.0,1,0.38128423372567216,38
554,4,880,431,449,0,0,0,1.0,1,1.0,1,1.0,1,0.3367089952998267,39
555,0,880,431,449,0,0,0,1.0,1,1.0,1,1.0,1,0.3342935610426246,39
556,3,883,432,451,0,0,0,1.0,1,1.0,1,1.0,1,0.3114823907842436,40
557,1,884,432,452,0,0,0,1.0,1,1.0,1,1.0,1,0.30847749231583815,40
558,0,884,432,452,0,0,0,1.0,1,1.0,1,1.0,1,0.30847749231583815,40
559,2,886,433,453,0,0,0,1.0,1,1.0,1,1.0,1,0.2735965993370811,40
560,2,888,433,455,0,0,0,1.0,1,1.0,1,1.0,1,0.2371047446754363,41
561,2,890,434,456,0,0,0,1.0,1,1.0,1,1.0,1,0.22947644466461803,42
562,1,891,435,456,0,0,0,1.0,1,1.0,1,1.0,1,0.2511706416354947,42
563,1,892,436,456,0,0,0,1.0,1,1.0,1,1.0,1,0.28529853026663676,42
564,2,894,436,458,0,0,0,1.0,1,1.0,1,1.0,1,0.276992850926998,43
565,3,897,438,459,0,0,0,1.0,1,1.0,1,1.0,1,0.30505582742675774,44
566,2,899,438,461,0,0,0,1.0,1,1.0,1,1.0,1,0.27603860787602214,45
567,0,899,438,461,0,0,0,1.0,1,1.0,1,1.0,1,0.27603860787602214,45
568,3,902,438,464,0,0,0,1.0,1,1.0,1,1.0,1,0.19193407247210983,46
569,1,903,439,464,0,0,0,1.0,1,1.0,1,1.0,1,0.18553003089274636,47
570,2,905,440,465,0,0,0,1.0,1,1.0,1,1.0,1,0.2037773158928467,48
571,1,906,441,465,0,0,0,1.0,1,1.0,1,1.0,1,0.23092411834946142,48
572,0,906,441,465,0,0,0,1.0,1,1.0,1,1.0,1,0.22619596715007723,47
573,0,906,441,465,0,0,0,1.0,1,1.0,1,1.0,1,0.227333604385204,49
574,0,906,441,465,0,0,0,1.0,1,1.0,1,1.0,1,0.227333604385204,49
575,3,909,441,468,0,0,0,1.0,1,1.0,1,1.0,1,0.16333549573284545,50
576,0,909,441,468,0,0,0,1.0,1,1.0,1,1.0,1,0.17876862298726912,51
577,0,909,441,468,0,0,0,1.0,1,1.0,1,1.0,1,0.17876862298726912,51
578,0,909,441,468,0,0,0,1.0,1,1.0,1,1.0,1,0.17876862298726912,51
579,2,911,443,468,0,0,0,1.0,1,1.0,1,1.0,1,0.20996676732200123,52
580,1,912,443,469,0,0,0,1.0,1,1.0,1,1.0,1,0.23003237013735525,52
581,1,913,443,470,0,0,0,1.0,1,1.0,1,1.0,1,0.21445665487987792,52
582,3,916,443,473,0,0,0,1.0,1,1.0,1,1.0,1,0.19232080997561202,53
583,2,918,445,473,0,0,0,1.0,1,1.0,1,1.0,1,0.22869849437393883,51
584,7,925,449,476,0,0,0,1.0,1,1.0,1,1.0,1,0.22990386789575065,51
585,4,929,452,477,0,0,0,1.0,1,1.0,1,1.0,1,0.2382195922817532,49
586,5,934,456,478,0,0,0,1.0,1,1.0,1,1.0,1,0.2208558091063693,49
587,1,935,457,478,0,0,0,1.0,1,1.0,1,1.0,1,0.22183751825772463,48
588,2,937,459,478,0,0,0,1.0,1,1.0,1,1.0,1,0.22719565437591313,46
589,2,939,460,479,0,0,0,1.0,1,1.0,1,1.0,1,0.2214826122807932,48
590,2,941,461,480,0,0,0,1.0,1,1.0,1,1.0,1,0.21576250427635404,47
591,3,944,462,482,0,0,0,1.0,1,1.0,1,1.0,1,0.22439678734117322,48
592,0,944,462,482,0,0,0,1.0,1,1.0,1,1.0,1,0.20649892452901206,47
593,1,945,463,482,0,0,0,1.0,1,1.0,1,1.0,1,0.22872869214682093,45
594,1,946,464,482,0,0,0,1.0,1,1.0,1,1.0,1,0.22390201377662527,44
595,4,950,467,483,0,0,0,1.0,1,1.0,1,1.0,1,0.24265052330112793,43
596,5,955,469,486,0,0,0,1.0,1,1.0,1,1.0,1,0.27709526122039313,44
597,2,957,469,488,0,0,0,1.0,1,1.0,1,1.0,1,0.25869488916491484,43
598,1,958,470,488,0,0,0,1.0,1,1.0,1,1.0,1,0.24899198547857862,45
599,2,960,471,489,0,0,0,1.0,1,1.0,1,1.0,1,0.22976322465122379,44
600,0,960,471,489,0,0,0,1.0,1,1.0,1,1.0,1,0.22976322465122379,44
601,0,960,471,489,0,0,0,1.0,1,1.0,1,1.0,1,0.23833207972430862,45
602,2,962,473,489,0,0,0,1.0,1,1.0,1,1.0,1,0.2917980747705474,46
603,2,964,473,491,0,0,0,1.0,1,1.0,1,1.0,1,0.23665768637814893,46
604,3,967,475,492,0,0,0,1.0,1,1.0,1,1.0,1,0.24764324886279673,47
605,1,968,475,493,0,0,0,1.0,1,1.0,1,1.0,1,0.22838332009332515,47
606,0,968,475,493,0,0,0,1.0,1,1.0,1,1.0,1,0.23947745685023408,47
607,0,968,475,493,0,0,0,1.0,1,1.0,1,1.0,1,0.23982091183851365,48
608,0,968,475,493,0,0,0,1.0,1,1.0,1,1.0,1,0.26581559277541206,47
609,3,971,475,496,0,0,0,1.0,1,1.0,1,1.0,1,0.2092897786647619,48
610,1,972,475,497,0,0,0,1.0,1,1.0,1,1.0,1,0.19423760334695234,48
611,3,975,477,498,0,0,0,1.0,1,1.0,1,1.0,1,0.17309734707773727,49
612,0,975,477,498,0,0,0,1.0,1,1.0,1,1.0,1,0.20540454320849072,50
613,3,978,478,500,0,0,0,1.0,1,1.0,1,1.0,1,0.18111847453377758,50
614,0,978,478,500,0,0,0,1.0,1,1.0,1,1.0,1,0.18111847453377758,50
615,2,980,479,501,0,0,0,1.0,1,1.0,1,1.0,1,0.18105191011462762,50
616,2,982,480,502,0,0,0,1.0,1,1.0,1,1.0,1,0.17901460130537536,50
617,4,986,481,505,0,0,0,1.0,1,1.0,1,1.0,1,0.16249598599176093,52
618,0,986,481,505,0,0,0,1.0,1,1.0,1,1.0,1,0.16249598599176093,52
619,2,988,482,506,0,0,0,1.0,1,1.0,1,1.0,1,0.17433665646224095,50
620,0,988,482,506,0,0,0,1.0,1,1.0,1,1.0,1,0.16936021344647134,50
621,1,989,483,506,0,0,0,1.0,1,1.0,1,1.0,1,0.18318147294440185,49
622,0,989,483,506,0,0,0,1.0,1,1.0,1,1.0,1,0.1808746731548388,49
623,3,992,485,507,0,0,0,1.0,1,1.0,1,1.0,1,0.21703829933198465,48
624,4,996,487,509,0,0,0,1.0,1,1.0,1,1.0,1,0.24132560815480503,46
625,3,999,488,511,0,0,0,1.0,1,1.0,1,1.0,1,0.19838830581323147,45
626,3,1002,491,511,0,0,0,1.0,1,1.0,1,1.0,1,0.2629100702908613,44
627,5,1007,493,514,0,0,0,1.0,1,1.0,1,1.0,1,0.19890049752728073,44
628,2,1009,494,515,0,0,0,1.0,1,1.0,1,1.0,1,0.20412547666083117,44
629,0,1009,494,515,0,0,0,1.0,1,1.0,1,1.0,1,0.2179942046735328,41
630,1,1010,495,515,0,0,0,1.0,1,1.0,1,1.0,1,0.24517537161028824,40
631,2,1012,496,516,0,0,0,1.0,1,1.0,1,1.0,1,0.27917372012924097,38
632,4,1016,499,517,0,0,0,1.0,1,1.0,1,1.0,1,0.30387192540588537,38
633,1,1017,500,517,0,0,0,1.0,1,1.0,1,1.0,1,0.326938718996536,36
634,1,1018,501,517,0,0,0,1.0,1,1.0,1,1.0,1,0.3426240293604949,35
635,0,1018,501,517,0,0,0,1.0,1,1.0,1,1.0,1,0.3426240293604949,35
636,0,1018,501,517,0,0,0,1.0,1,1.0,1,1.0,1,0.3479731273522288,36
637,0,1018,501,517,0,0,0,1.0,1,1.0,1,1.0,1,0.3459492632096707,35
638,3,1021,503,518,0,0,0,1.0,1,1.0,1,1.0,1,0.3442938887764298,34
639,1,1022,504,518,0,0,0,1.0,1,1.0,1,1.0,1,0.32550494960989274,36
640,5,1027,505,522,0,0,0,1.0,1,1.0,1,1.0,1,0.2937343169290589,37
641,0,1027,505,522,0,0,0,1.0,1,1.0,1,1.0,1,0.2937343169290589,37
642,0,1027,505,522,0,0,0,1.0,1,1.0,1,1.0,1,0.26656991267103464,38
643,2,1029,505,524,0,0,0,1.0,1,1.0,1,1.0,1,0.21344113955120003,39
644,1,1030,506,524,0,0,0,1.0,1,1.0,1,1.0,1,0.2515619538076547,39
645,1,1031,506,525,0,0,0,1.0,1,1.0,1,1.0,1,0.23881636726085487,39
646,2,1033,507,526,0,0,0,1.0,1,1.0,1,1.0,1,0.29555016957120156,40
647,2,1035,507,528,0,0,0,1.0,1,1.0,1,1.0,1,0.25348631103996255,40
648,1,1036,508,528,0,0,0,1.0,1,1.0,1,1.0,1,0.25834559780363237,40
649,1,1037,508,529,0,0,0,1.0,1,1.0,1,1.0,1,0.2523216501571446,40
650,4,1041,510,531,0,0,0,1.0,1,1.0,1,1.0,1,0.2502962425590415,41
651,1,1042,511,531,0,0,0,1.0,1,1.0,1,1.0,1,0.24470563188473599,42
652,1,1043,511,532,0,0,0,1.0,1,1.0,1,1.0,1,0.25005844668874966,41
653,1,1044,511,533,0,0,0,1.0,1,1.0,1,1.0,1,0.23855837917961398,41
654,1,1045,511,534,0,0,0,1.0,1,1.0,1,1.0,1,0.23763759047552666,42
655,2,1047,511,536,0,0,0,1.0,1,1.0,1,1.0,1,0.2077390616562427,45
656,3,1050,514,536,0,0,0,1.0,1,1.0,1,1.0,1,0.31770678626518634,45
657,3,1053,514,539,0,0,0,1.0,1,1.0,1,1.0,1,0.2006108135277234,43
658,3,1056,517,539,0,0,0,1.0,1,1.0,1,1.0,1,0.27943997279525107,43
659,0,1056,517,539,0,0,0,1.0,1,1.0,1,1.0,1,0.28019667017134786,43
660,2,1058,519,539,0,0,0,1.0,1,1.0,1,1.0,1,0.3460894980421507,43
661,0,1058,519,539,0,0,0,1.0,1,1.0,1,1.0,1,0.35656083949794465,41
662,3,1061,520,541,0,0,0,1.0,1,1.0,1,1.0,1,0.3871151793279257,40
663,3,1064,522,542,0,0,0,1.0,1,1.0,1,1.0,1,0.3835230201007958,39
664,3,1067,524,543,0,0,0,1.0,1,1.0,1,1.0,1,0.42645206135490354,36
665,4,1071,525,546,0,0,0,1.0,1,1.0,1,1.0,1,0.3633773318730843,36
666,4,1075,527,548,0,0,0,1.0,1,1.0,1,1.0,1,0.323143682188192,36
667,2,1077,527,550,0,0,0,1.0,1,1.0,1,1.0,1,0.2756097794035259,35
668,0,1077,527,550,0,0,0,1.0,1,1.0,1,1.0,1,0.2875951963643219,34
669,2,1079,528,551,0,0,0,1.0,1,1.0,1,1.0,1,0.30454713984645365,34
670,2,1081,529,552,0,0,0,1.0,1,1.0,1,1.0,1,0.33680922438273614,32
671,2,1083,530,553,0,0,0,1.0,1,1.0,1,1.0,1,0.30338543505684706,33
672,1,1084,530,554,0,0,0,1.0,1,1.0,1,1.0,1,0.3168031013364867,32
673,4,1088,531,557,0,0,0,1.0,1,1.0,1,1.0,1,0.228108712979513,32
674,0,1088,531,557,0,0,0,1.0,1,1.0,1,1.0,1,0.2527173738920529,32
675,5,1093,533,560,0,0,0,1.0,1,1.0,1,1.0,1,0.23568898785664616,34
676,0,1093,533,560,0,0,0,1.0,1,1.0,1,1.0,1,0.24812335653423898,35
677,2,1095,534,561,0,0,0,1.0,1,1.0,1,1.0,1,0.2231108415503108,35
678,0,1095,534,561,0,0,0,1.0,1,1.0,1,1.0,1,0.2231108415503108,35
679,5,1100,536,564,0,0,0,1.0,1,1.0,1,1.0,1,0.1703225605287973,36
680,0,1100,536,564,0,0,0,1.0,1,1.0,1,1.0,1,0.16592924515994062,37
681,0,1100,536,564,0,0,0,1.0,1,1.0,1,1.0,1,0.16592924515994062,37
682,1,1101,537,564,0,0,0,1.0,1,1.0,1,1.0,1,0.19449424462300346,37
683,1,1102,537,565,0,0,0,1.0,1,1.0,1,1.0,1,0.16164228444176554,38
684,1,1103,538,565,0,0,0,1.0,1,1.0,1,1.0,1,0.20439897025703083,39
685,0,1103,538,565,0,0,0,1.0,1,1.0,1,1.0,1,0.19501027055040607,38
686,0,1103,538,565,0,0,0,1.0,1,1.0,1,1.0,1,0.1868207919680819,37
687,3,1106,539,567,0,0,0,1.0,1,1.0,1,1.0,1,0.21167970310601672,38
688,0,1106,539,567,0,0,0,1.0,1,1.0,1,1.0,1,0.24872266689107475,37
689,1,1107,540,567,0,0,0,1.0,1,1.0,1,1.0,1,0.29012919328307746,39
690,1,1108,540,568,0,0,0,1.0,1,1.0,1,1.0,1,0.259303794285243,38
691,1,1109,541,568,0,0,0,1.0,1,1.0,1,1.0,1,0.2573875327218478,38
692,2,1111,543,568,0,0,0,1.0,1,1.0,1,1.0,1,0.28062136415594413,38
693,2,1113,545,568,0,0,0,1.0,1,1.0,1,1.0,1,0.3102867007353917,40
694,4,1117,547,570,0,0,0,1.0,1,1.0,1,1.0,1,0.322669263088702,42
695,1,1118,547,571,0,0,0,1.0,1,1.0,1,1.0,1,0.27947364651626677,40
696,4,1122,549,573,0,0,0,1.0,1,1.0,1,1.0,1,0.26568113205325355,39
697,2,1124,549,575,0,0,0,1.0,1,1.0,1,1.0,1,0.2358483132469326,39
698,1,1125,550,575,0,0,0,1.0,1,1.0,1,1.0,1,0.2318294784998973,37
699,1,1126,550,576,0,0,0,1.0,1,1.0,1,1.0,1,0.18291361823305446,37
700,2,1128,551,577,0,0,0,1.0,1,1.0,1,1.0,1,0.20672806280438666,37
701,3,1131,553,578,0,0,0,1.0,1,1.0,1,1.0,1,0.2110200949644919,37
702,0,1131,553,578,0,0,0,1.0,1,1.0,1,1.0,1,0.21995353671057888,38
703,3,1134,555,579,0,0,0,1.0,1,1.0,1,1.0,1,0.22828952745100212,36
704,1,1135,556,579,0,0,0,1.0,1,1.0,1,1.0,1,0.2358524921941144,36
705,3,1138,559,579,0,0,0,1.0,1,1.0,1,1.0,1,0.2358331700463372,36
706,4,1142,562,580,0,0,0,1.0,1,1.0,1,1.0,1,0.23505326752249545,35
707,2,1144,563,581,0,0,0,1.0,1,1.0,1,1.0,1,0.2538595628549197,36
708,3,1147,565,582,0,0,0,1.0,1,1.0,1,1.0,1,0.2724569056792256,36
709,1,1148,566,582,0,0,0,1.0,1,1.0,1,1.0,1,0.21680560806900795,34
710,0,1148,566,582,0,0,0,1.0,1,1.0,1,1.0,1,0.21680560806900795,34
711,0,1148,566,582,0,0,0,1.0,1,1.0,1,1.0,1,0.21076480949587212,34
712,2,1150,568,582,0,0,0,1.0,1,1.0,1,1.0,1,0.2749804525930934,35
713,3,1153,569,584,0,0,0,1.0,1,1.0,1,1.0,1,0.25268481602708504,34
714,1,1154,570,584,0,0,0,1.0,1,1.0,1,1.0,1,0.24773773391987983,34
715,1,1155,571,584,0,0,0,1.0,1,1.0,1,1.0,1,0.30452812065055646,35
716,1,1156,572,584,0,0,0,1.0,1,1.0,1,1.0,1,0.3323131841799809,33
717,4,1160,574,586,0,0,0,1.0,1,1.0,1,1.0,1,0.34584811844754737,33
718,1,1161,574,587,0,0,0,1.0,1,1.0,1,1.0,1,0.3156999217111435,32
719,1,1162,574,588,0,0,0,1.0,1,1.0,1,1.0,1,0.30012117295327245,32
720,2,1164,575,589,0,0,0,1.0,1,1.0,1,1.0,1,0.27703879526894803,33
721,2,1166,576,590,0,0,0,1.0,1,1.0,1,1.0,1,0.26689704072114034,33
722,3,1169,577,592,0,0,0,1.0,1,1.0,1,1.0,1,0.28457038179442545,34
723,1,1170,577,593,0,0,0,1.0,1,1.0,1,1.0,1,0.25459829738123807,34
724,3,1173,577,596,0,0,0,1.0,1,1.0,1,1.0,1,0.20498198569956141,36
725,1,1174,577,597,0,0,0,1.0,1,1.0,1,1.0,1,0.17443555355865709,36
726,0,1174,577,597,0,0,0,1.0,1,1.0,1,1.0,1,0.17443555355865709,36
727,0,1174,577,597,0,0,0,1.0,1,1.0,1,1.0,1,0.17443555355865709,36
728,2,1176,578,598,0,0,0,1.0,1,1.0,1,1.0,1,0.1750191119031203,37
729,1,1177,578,599,0,0,0,1.0,1,1.0,1,1.0,1,0.1497290037109788,37
730,0,1177,578,599,0,0,0,1.0,1,1.0,1,1.0,1,0.16390332285099185,38
731,0,1177,578,599,0,0,0,1.0,1,1.0,1,1.0,1,0.18455313684738836,39
732,2,1179,579,600,0,0,0,1.0,1,1.0,1,1.0,1,0.21085446075964828,41
733,0,1179,579,600,0,0,0,1.0,1,1.0,1,1.0,1,0.17177467848098907,39
734,2,1181,580,601,0,0,0,1.0,1,1.0,1,1.0,1,0.17080134795310917,39
735,1,1182,581,601,0,0,0,1.0,1,1.0,1,1.0,1,0.2235662769144751,39
736,0,1182,581,601,0,0,0,1.0,1,1.0,1,1.0,1,0.22909475149976216,38
737,1,1183,582,601,0,0,0,1.0,1,1.0,1,1.0,1,0.2632423432973943,39
738,0,1183,582,601,0,0,0,1.0,1,1.0,1,1.0,1,0.2622945357248215,37
739,1,1184,583,601,0,0,0,1.0,1,1.0,1,1.0,1,0.29720012110440264,37
740,0,1184,583,601,0,0,0,1.0,1,1.0,1,1.0,1,0.31320644582790297,35
741,1,1185,583,602,0,0,0,1.0,1,1.0,1,1.0,1,0.3009804427246315,33
742,1,1186,584,602,0,0,0,1.0,1,1.0,1,1.0,1,0.3314650414652338,35
743,3,1189,586,603,0,0,0,1.0,1,1.0,1,1.0,1,0.34560622218157716,35
744,4,1193,589,604,0,0,0,1.0,1,1.0,1,1.0,1,0.2721909870204049,34
745,1,1194,590,604,0,0,0,1.0,1,1.0,1,1.0,1,0.29197015568644014,34
746,3,1197,593,604,0,0,0,1.0,1,1.0,1,1.0,1,0.263086494639519,33
747,1,1198,594,604,0,0,0,1.0,1,1.0,1,1.0,1,0.24612791026337374,32
748,1,1199,594,605,0,0,0,1.0,1,1.0,1,1.0,1,0.22944055019106685,33
749,0,1199,594,605,0,0,0,1.0,1,1.0,1,1.0,1,0.22944055019106685,33
750,1,1200,595,605,0,0,0,1.0,1,1.0,1,1.0,1,0.2565907547961553,34
751,0,1200,595,605,0,0,0,1.0,1,1.0,1,1.0,1,0.2696603812058162,36
752,4,1204,598,606,0,0,0,1.0,1,1.0,1,1.0,1,0.2571488950273415,35
753,1,1205,599,606,0,0,0,1.0,1,1.0,1,1.0,1,0.2872960456146695,37
754,2,1207,601,606,0,0,0,1.0,1,1.0,1,1.0,1,0.3300666136598363,37
755,4,1211,602,609,0,0,0,1.0,1,1.0,1,1.0,1,0.2840106673279522,35
756,1,1212,603,609,0,0,0,1.0,1,1.0,1,1.0,1,0.34067493781227426,36
757,2,1214,603,611,0,0,0,1.0,1,1.0,1,1.0,1,0.30121569874818577,35
758,0,1214,603,611,0,0,0,1.0,1,1.0,1,1.0,1,0.313469349896061,36
759,0,1214,603,611,0,0,0,1.0,1,1.0,1,1.0,1,0.3165098623697441,37
760,2,1216,603,613,0,0,0,1.0,1,1.0,1,1.0,1,0.30641100916859715,36
761,0,1216,603,613,0,0,0,1.0,1,1.0,1,1.0,1,0.30641100916859715,36
762,0,1216,603,613,0,0,0,1.0,1,1.0,1,1.0,1,0.3151362070497006,37
763,1,1217,603,614,0,0,0,1.0,1,1.0,1,1.0,1,0.31027228940942553,38
764,0,1217,603,614,0,0,0,1.0,1,1.0,1,1.0,1,0.31027228940942553,38
765,0,1217,603,614,0,0,0,1.0,1,1.0,1,1.0,1,0.31027228940942553,38
766,0,1217,603,614,0,0,0,1.0,1,1.0,1,1.0,1,0.3014401647410227,40
767,0,1217,603,614,0,0,0,1.0,1,1.0,1,1.0,1,0.314356834440341,41
768,2,1219,604,615,0,0,0,1.0,1,1.0,1,1.0,1,0.3178728525361306,41
769,3,1222,604,618,0,0,0,1.0,1,1.0,1,1.0,1,0.2849905207191304,42
770,2,1224,605,619,0,0,0,1.0,1,1.0,1,1.0,1,0.29577892627520397,41
771,0,1224,605,619,0,0,0,1.0,1,1.0,1,1.0,1,0.2865306960502546,41
772,4,1228,607,621,0,0,0,1.0,1,1.0,1,1.0,1,0.24593526882945474,41
773,2,1230,607,623,0,0,0,1.0,1,1.0,1,1.0,1,0.21264070264397603,41
774,2,1232,609,623,0,0,0,1.0,1,1.0,1,1.0,1,0.21334998200108615,42
775,1,1233,609,624,0,0,0,1.0,1,1.0,1,1.0,1,0.19466275072591566,42
776,0,1233,609,624,0,0,0,1.0,1,1.0,1,1.0,1,0.19466275072591566,42
777,0,1233,609,624,0,0,0,1.0,1,1.0,1,1.0,1,0.19466275072591566,42
778,1,1234,609,625,0,0,0,1.0,1,1.0,1,1.0,1,0.21068039478273495,44
779,0,1234,609,625,0,0,0,1.0,1,1.0,1,1.0,1,0.21068039478273495,44
780,1,1235,609,626,0,0,0,1.0,1,1.0,1,1.0,1,0.1813985441523697,44
781,1,1236,609,627,0,0,0,1.0,1,1.0,1,1.0,1,0.17453193206946022,46
782,2,1238,611,627,0,0,0,1.0,1,1.0,1,1.0,1,0.20779642577455842,45
783,2,1240,612,628,0,0,0,1.0,1,1.0,1,1.0,1,0.2352901796297219,44
784,1,1241,613,628,0,0,0,1.0,1,1.0,1,1.0,1,0.2767166540086663,44
785,1,1242,614,628,0,0,0,1.0,1,1.0,1,1.0,1,0.2739791356018276,43
786,0,1242,614,628,0,0,0,1.0,1,1.0,1,1.0,1,0.2739791356018276,43
787,0,1242,614,628,0,0,0,1.0,1,1.0,1,1.0,1,0.2739791356018276,43
788,6,1248,616,632,0,0,0,1.0,1,1.0,1,1.0,1,0.21826451362156848,45
789,1,1249,617,632,0,0,0,1.0,1,1.0,1,1.0,1,0.21179294988780337,46
790,0,1249,617,632,0,0,0,1.0,1,1.0,1,1.0,1,0.24261692701461196,45
791,1,1250,617,633,0,0,0,1.0,1,1.0,1,1.0,1,0.2373243776102542,46
792,0,1250,617,633,0,0,0,1.0,1,1.0,1,1.0,1,0.26041166576124825,46
793,3,1253,617,636,0,0,0,1.0,1,1.0,1,1.0,1,0.1999643480540207,46
794,0,1253,617,636,0,0,0,1.0,1,1.0,1,1.0,1,0.22654584440118072,47
795,1,1254,617,637,0,0,0,1.0,1,1.0,1,1.0,1,0.20296223234773622,47
796,1,1255,618,637,0,0,0,1.0,1,1.0,1,1.0,1,0.23590312496425264,46
797,5,1260,621,639,0,0,0,1.0,1,1.0,1,1.0,1,0.2554128804810191,47
798,4,1264,623,641,0,0,0,1.0,1,1.0,1,1.0,1,0.24936440041909302,48
799,2,1266,623,643,0,0,0,1.0,1,1.0,1,1.0,1,0.19548768877771308,48
800,1,1267,624,643,0,0,0,1.0,1,1.0,1,1.0,1,0.22879643624140117,48
801,4,1271,625,646,0,0,0,1.0,1,1.0,1,1.0,1,0.19620990801370194,49
802,0,1271,625,646,0,0,0,1.0,1,1.0,1,1.0,1,0.18391417304710764,50
803,1,1272,625,647,0,0,0,1.0,1,1.0,1,1.0,1,0.15434584556095995,49
804,1,1273,626,647,0,0,0,1.0,1,1.0,1,1.0,1,0.15029102087433074,50
805,0,1273,626,647,0,0,0,1.0,1,1.0,1,1.0,1,0.15029102087433074,50
806,1,1274,626,648,0,0,0,1.0,1,1.0,1,1.0,1,0.1279614768029498,50
807,2,1276,626,650,0,0,0,1.0,1,1.0,1,1.0,1,0.10196191753999773,51
808,1,1277,627,650,0,0,0,1.0,1,1.0,1,1.0,1,0.12895185145534888,51
809,1,1278,628,650,0,0,0,1.0,1,1.0,1,1.0,1,0.1397156422241429,51
810,2,1280,628,652,0,0,0,1.0,1,1.0,1,1.0,1,0.1175598271114563,52
811,1,1281,629,652,0,0,0,1.0,1,1.0,1,1.0,1,0.14224187301799854,50
812,2,1283,630,653,0,0,0,1.0,1,1.0,1,1.0,1,0.15487743164395673,48
813,2,1285,631,654,0,0,0,1.0,1,1.0,1,1.0,1,0.17504074240839373,49
814,0,1285,631,654,0,0,0,1.0,1,1.0,1,1.0,1,0.18903682679841302,48
815,4,1289,634,655,0,0,0,1.0,1,1.0,1,1.0,1,0.17919098114978513,48
816,1,1290,635,655,0,0,0,1.0,1,1.0,1,1.0,1,0.20487270846156136,46
817,1,1291,635,656,0,0,0,1.0,1,1.0,1,1.0,1,0.22857227123647186,44
818,0,1291,635,656,0,0,0,1.0,1,1.0,1,1.0,1,0.20471979425097775,46
819,0,1291,635,656,0,0,0,1.0,1,1.0,1,1.0,1,0.23903919388209413,44
820,0,1291,635,656,0,0,0,1.0,1,1.0,1,1.0,1,0.26751589712680585,44
821,0,1291,635,656,0,0,0,1.0,1,1.0,1,1.0,1,0.26751589712680585,44
822,3,1294,637,657,0,0,0,1.0,1,1.0,1,1.0,1,0.27785793064144354,44
823,5,1299,638,661,0,0,0,1.0,1,1.0,1,1.0,1,0.16911346770579028,42
824,2,1301,640,661,0,0,0,1.0,1,1.0,1,1.0,1,0.1921459549111036,42
825,1,1302,641,661,0,0,0,1.0,1,1.0,1,1.0,1,0.1879687979127098,40
826,3,1305,644,661,0,0,0,1.0,1,1.0,1,1.0,1,0.21750779448508095,41
827,1,1306,645,661,0,0,0,1.0,1,1.0,1,1.0,1,0.21864955867084118,40
828,4,1310,648,662,0,0,0,1.0,1,1.0,1,1.0,1,0.1892119977194533,40
829,5,1315,650,665,0,0,0,1.0,1,1.0,1,1.0,1,0.18370161948771552,42
830,4,1319,652,667,0,0,0,1.0,1,1.0,1,1.0,1,0.21301921983051042,42
831,4,1323,653,670,0,0,0,1.0,1,1.0,1,1.0,1,0.18515954496592474,43
832,0,1323,653,670,0,0,0,1.0,1,1.0,1,1.0,1,0.17334930460080047,42
833,1,1324,654,670,0,0,0,1.0,1,1.0,1,1.0,1,0.20732566876691386,41
834,2,1326,655,671,0,0,0,1.0,1,1.0,1,1.0,1,0.2040591244972257,41
835,2,1328,656,672,0,0,0,1.0,1,1.0,1,1.0,1,0.22175824697764318,41
836,0,1328,656,672,0,0,0,1.0,1,1.0,1,1.0,1,0.21949206480552552,40
837,0,1328,656,672,0,0,0,1.0,1,1.0,1,1.0,1,0.21974171370965168,41
838,1,1329,657,672,0,0,0,1.0,1,1.0,1,1.0,1,0.24101675269678421,41
839,2,1331,658,673,0,0,0,1.0,1,1.0,1,1.0,1,0.22937226259105112,41
840,4,1335,661,674,0,0,0,1.0,1,1.0,1,1.0,1,0.26190466441057536,42
841,3,1338,662,676,0,0,0,1.0,1,1.0,1,1.0,1,0.1713876603180075,42
842,1,1339,662,677,0,0,0,1.0,1,1.0,1,1.0,1,0.14612541044450847,42
843,2,1341,664,677,0,0,0,1.0,1,1.0,1,1.0,1,0.1817104774846667,42
844,0,1341,664,677,0,0,0,1.0,1,1.0,1,1.0,1,0.2029152200609441,42
845,1,1342,664,678,0,0,0,1.0,1,1.0,1,1.0,1,0.25556811987463735,44
846,1,1343,664,679,0,0,0,1.0,1,1.0,1,1.0,1,0.2266211934035076,44
847,1,1344,665,679,0,0,0,1.0,1,1.0,1,1.0,1,0.22468806228785138,42
848,0,1344,665,679,0,0,0,1.0,1,1.0,1,1.0,1,0.26120779604919336,43
849,1,1345,665,680,0,0,0,1.0,1,1.0,1,1.0,1,0.24003962828015232,43
850,4,1349,666,683,0,0,0,1.0,1,1.0,1,1.0,1,0.266950339828424,41
851,3,1352,667,685,0,0,0,1.0,1,1.0,1,1.0,1,0.18841510103008122,40
852,0,1352,667,685,0,0,0,1.0,1,1.0,1,1.0,1,0.18841510103008122,40
853,1,1353,668,685,0,0,0,1.0,1,1.0,1,1.0,1,0.19402868504276477,40
854,2,1355,669,686,0,0,0,1.0,1,1.0,1,1.0,1,0.18743316823376052,40
855,1,1356,670,686,0,0,0,1.0,1,1.0,1,1.0,1,0.19203865405409912,41
856,1,1357,671,686,0,0,0,1.0,1,1.0,1,1.0,1,0.20435006092964778,41
857,1,1358,672,686,0,0,0,1.0,1,1.0,1,1.0,1,0.21579581202595105,42
858,1,1359,672,687,0,0,0,1.0,1,1.0,1,1.0,1,0.1831836658139953,43
859,0,1359,672,687,0,0,0,1.0,1,1.0,1,1.0,1,0.1831836658139953,43
860,1,1360,673,687,0,0,0,1.0,1,1.0,1,1.0,1,0.18429407410852067,44
861,1,1361,674,687,0,0,0,1.0,1,1.0,1,1.0,1,0.1978750070568839,44
862,1,1362,675,687,0,0,0,1.0,1,1.0,1,1.0,1,0.2036910145868852,44
863,4,1366,678,688,0,0,0,1.0,1,1.0,1,1.0,1,0.24936900544304472,44
864,5,1371,680,691,0,0,0,1.0,1,1.0,1,1.0,1,0.23015253064917268,44
865,2,1373,682,691,0,0,0,1.0,1,1.0,1,1.0,1,0.2201491781276784,43
866,5,1378,685,693,0,0,0,1.0,1,1.0,1,1.0,1,0.2823641019470075,45
867,3,1381,685,696,0,0,0,1.0,1,1.0,1,1.0,1,0.2128569584602171,44
868,4,1385,686,699,0,0,0,1.0,1,1.0,1,1.0,1,0.24621259421291197,45
869,7,1392,689,703,0,0,0,1.0,1,1.0,1,1.0,1,0.1622563526382632,44
870,1,1393,689,704,0,0,0,1.0,1,1.0,1,1.0,1,0.13824400276725154,44
871,2,1395,690,705,0,0,0,1.0,1,1.0,1,1.0,1,0.17846835312044868,43
872,1,1396,690,706,0,0,0,1.0,1,1.0,1,1.0,1,0.14209109045878313,43
873,1,1397,691,706,0,0,0,1.0,1,1.0,1,1.0,1,0.18909650822939028,43
874,5,1402,694,708,0,0,0,1.0,1,1.0,1,1.0,1,0.20891768310411096,46
875,4,1406,695,711,0,0,0,1.0,1,1.0,1,1.0,1,0.12595721015053882,43
876,1,1407,695,712,0,0,0,1.0,1,1.0,1,1.0,1,0.10800511175678724,44
877,0,1407,695,712,0,0,0,1.0,1,1.0,1,1.0,1,0.14508929284793978,44
878,1,1408,696,712,0,0,0,1.0,1,1.0,1,1.0,1,0.1777934291421855,44
879,2,1410,696,714,0,0,0,1.0,1,1.0,1,1.0,1,0.12892530437525615,44
880,3,1413,698,715,0,0,0,1.0,1,1.0,1,1.0,1,0.17161190919101052,44
881,0,1413,698,715,0,0,0,1.0,1,1.0,1,1.0,1,0.15687070881853954,43
882,1,1414,699,715,0,0,0,1.0,1,1.0,1,1.0,1,0.1666065030498068,45
883,1,1415,699,716,0,0,0,1.0,1,1.0,1,1.0,1,0.15653098902960477,45
884,1,1416,700,716,0,0,0,1.0,1,1.0,1,1.0,1,0.16740489234327155,45
885,2,1418,701,717,0,0,0,1.0,1,1.0,1,1.0,1,0.11527656144803304,43
886,1,1419,702,717,0,0,0,1.0,1,1.0,1,1.0,1,0.2257980330164066,43
887,3,1422,703,719,0,0,0,1.0,1,1.0,1,1.0,1,0.16171840399392606,41
888,1,1423,703,720,0,0,0,1.0,1,1.0,1,1.0,1,0.21837047584532404,40
889,0,1423,703,720,0,0,0,1.0,1,1.0,1,1.0,1,0.21837047584532404,40
890,1,1424,704,720,0,0,0,1.0,1,1.0,1,1.0,1,0.18362772893487847,38
891,1,1425,705,720,0,0,0,1.0,1,1.0,1,1.0,1,0.18393864150819475,39
892,2,1427,707,720,0,0,0,1.0,1,1.0,1,1.0,1,0.24678082816910518,39
893,1,1428,708,720,0,0,0,1.0,1,1.0,1,1.0,1,0.21619335305919457,37
894,0,1428,708,720,0,0,0,1.0,1,1.0,1,1.0,1,0.2391117882829112,36
895,0,1428,708,720,0,0,0,1.0,1,1.0,1,1.0,1,0.2558426147257061,37
896,2,1430,710,720,0,0,0,1.0,1,1.0,1,1.0,1,0.2744011480674418,36
897,1,1431,711,720,0,0,0,1.0,1,1.0,1,1.0,1,0.2720063194541214,36
898,0,1431,711,720,0,0,0,1.0,1,1.0,1,1.0,1,0.28584305676683996,35
899,2,1433,713,720,0,0,0,1.0,1,1.0,1,1.0,1,0.28618818267544166,35
900,1,1434,714,720,0,0,0,1.0,1,1.0,1,1.0,1,0.3256949979249986,36
901,2,1436,715,721,0,0,0,1.0,1,1.0,1,1.0,1,0.31469694449795826,36
902,3,1439,718,721,0,0,0,1.0,1,1.0,1,1.0,1,0.36845304400132395,36
903,3,1442,719,723,0,0,0,1.0,1,1.0,1,1.0,1,0.31635336345634496,35
904,5,1447,723,724,0,0,0,1.0,1,1.0,1,1.0,1,0.30314375395944043,37
905,5,1452,725,727,0,0,0,1.0,1,1.0,1,1.0,1,0.25975136289498807,36
906,2,1454,725,729,0,0,0,1.0,1,1.0,1,1.0,1,0.22428544628171806,37
907,1,1455,726,729,0,0,0,1.0,1,1.0,1,1.0,1,0.22331996948418315,37
908,2,1457,728,729,0,0,0,1.0,1,1.0,1,1.0,1,0.25995581279354024,36
909,3,1460,728,732,0,0,0,1.0,1,1.0,1,1.0,1,0.16517537170247068,36
910,1,1461,729,732,0,0,0,1.0,1,1.0,1,1.0,1,0.18860577606247794,37
911,2,1463,730,733,0,0,0,1.0,1,1.0,1,1.0,1,0.22869668079185862,36
912,1,1464,731,733,0,0,0,1.0,1,1.0,1,1.0,1,0.21942382344744463,34
913,2,1466,733,733,0,0,0,1.0,1,1.0,1,1.0,1,0.20698127299637525,34
914,1,1467,734,733,0,0,0,1.0,1,1.0,1,1.0,1,0.23980597450176286,33
915,1,1468,734,734,0,0,0,1.0,1,1.0,1,1.0,1,0.22268485031553525,33
916,0,1468,734,734,0,0,0,1.0,1,1.0,1,1.0,1,0.24272435836433554,34
917,0,1468,734,734,0,0,0,1.0,1,1.0,1,1.0,1,0.24272435836433554,34
918,1,1469,735,734,0,0,0,1.0,1,1.0,1,1.0,1,0.22581744280400262,36
919,0,1469,735,734,0,0,0,1.0,1,1.0,1,1.0,1,0.22581744280400262,36
920,1,1470,736,734,0,0,0,1.0,1,1.0,1,1.0,1,0.20166392223455737,37
921,1,1471,736,735,0,0,0,1.0,1,1.0,1,1.0,1,0.17367475289176662,37
922,1,1472,737,735,0,0,0,1.0,1,1.0,1,1.0,1,0.16567798405431314,38
923,1,1473,738,735,0,0,0,1.0,1,1.0,1,1.0,1,0.1670224499588296,36
924,1,1474,738,736,0,0,0,1.0,1,1.0,1,1.0,1,0.16391224725533116,35
925,4,1478,740,738,0,0,0,1.0,1,1.0,1,1.0,1,0.26858927543176575,35
926,3,1481,742,739,0,0,0,1.0,1,1.0,1,1.0,1,0.2794694525750476,34
927,1,1482,742,740,0,0,0,1.0,1,1.0,1,1.0,1,0.2804972085662611,32
928,1,1483,743,740,0,0,0,1.0,1,1.0,1,1.0,1,0.304452902648929,32
929,1,1484,743,741,0,0,0,1.0,1,1.0,1,1.0,1,0.25261841683724556,31
930,0,1484,743,741,0,0,0,1.0,1,1.0,1,1.0,1,0.28676912629786355,30
931,1,1485,744,741,0,0,0,1.0,1,1.0,1,1.0,1,0.3399568449838255,29
932,3,1488,746,742,0,0,0,1.0,1,1.0,1,1.0,1,0.30971312049982935,29
933,1,1489,746,743,0,0,0,1.0,1,1.0,1,1.0,1,0.2815055355819813,29
934,1,1490,747,743,0,0,0,1.0,1,1.0,1,1.0,1,0.29297148011271423,29
935,1,1491,747,744,0,0,0,1.0,1,1.0,1,1.0,1,0.31767183211262184,31
936,1,1492,748,744,0,0,0,1.0,1,1.0,1,1.0,1,0.34861432869450515,31
937,3,1495,749,746,0,0,0,1.0,1,1.0,1,1.0,1,0.33317643893315374,34
938,2,1497,749,748,0,0,0,1.0,1,1.0,1,1.0,1,0.28905335762002826,33
939,6,1503,749,754,0,0,0,1.0,1,1.0,1,1.0,1,0.21676096455635332,36
940,0,1503,749,754,0,0,0,1.0,1,1.0,1,1.0,1,0.2194208442898879,36
941,2,1505,751,754,0,0,0,1.0,1,1.0,1,1.0,1,0.2700993978489809,36
942,1,1506,752,754,0,0,0,1.0,1,1.0,1,1.0,1,0.27712050851117104,36
943,2,1508,753,755,0,0,0,1.0,1,1.0,1,1.0,1,0.25849353698255123,35
944,3,1511,755,756,0,0,0,1.0,1,1.0,1,1.0,1,0.2527165646334549,35
945,0,1511,755,756,0,0,0,1.0,1,1.0,1,1.0,1,0.22499860232478439,33
946,5,1516,757,759,0,0,0,1.0,1,1.0,1,1.0,1,0.2915892204689132,36
947,0,1516,757,759,0,0,0,1.0,1,1.0,1,1.0,1,0.26184018151512006,34
948,1,1517,758,759,0,0,0,1.0,1,1.0,1,1.0,1,0.2803064967375843,33
949,0,1517,758,759,0,0,0,1.0,1,1.0,1,1.0,1,0.3072159652119015,34
950,0,1517,758,759,0,0,0,1.0,1,1.0,1,1.0,1,0.3267458879616094,33
951,0,1517,758,759,0,0,0,1.0,1,1.0,1,1.0,1,0.3267458879616094,33
952,0,1517,758,759,0,0,0,1.0,1,1.0,1,1.0,1,0.3318233498082952,32
953,0,1517,758,759,0,0,0,1.0,1,1.0,1,1.0,1,0.3318233498082952,32
954,1,1518,759,759,0,0,0,1.0,1,1.0,1,1.0,1,0.33314950060572135,31
955,1,1519,759,760,0,0,0,1.0,1,1.0,1,1.0,1,0.3185108588382486,32
956,1,1520,760,760,0,0,0,1.0,1,1.0,1,1.0,1,0.2942647185352267,32
957,0,1520,760,760,0,0,0,1.0,1,1.0,1,1.0,1,0.29692740552662505,33
958,0,1520,760,760,0,0,0,1.0,1,1.0,1,1.0,1,0.30003759269901487,35
959,1,1521,761,760,0,0,0,1.0,1,1.0,1,1.0,1,0.3194910952351485,36
960,2,1523,761,762,0,0,0,1.0,1,1.0,1,1.0,1,0.31004772352217536,38
961,2,1525,763,762,0,0,0,1.0,1,1.0,1,1.0,1,0.3888801619585561,37
962,2,1527,764,763,0,0,0,1.0,1,1.0,1,1.0,1,0.36459824739890057,35
963,1,1528,764,764,0,0,0,1.0,1,1.0,1,1.0,1,0.3285268771280155,35
964,1,1529,764,765,0,0,0,1.0,1,1.0,1,1.0,1,0.32851881036440933,34
965,1,1530,764,766,0,0,0,1.0,1,1.0,1,1.0,1,0.31650559239327836,35
966,1,1531,765,766,0,0,0,1.0,1,1.0,1,1.0,1,0.2947949082090991,34
967,1,1532,765,767,0,0,0,1.0,1,1.0,1,1.0,1,0.27139957290447597,35
968,1,1533,766,767,0,0,0,1.0,1,1.0,1,1.0,1,0.28055312165847374,36
969,1,1534,766,768,0,0,0,1.0,1,1.0,1,1.0,1,0.28512917289018885,35
970,0,1534,766,768,0,0,0,1.0,1,1.0,1,1.0,1,0.3159721356225604,34
971,0,1534,766,768,0,0,0,1.0,1,1.0,1,1.0,1,0.3257284709920772,35
972,1,1535,767,768,0,0,0,1.0,1,1.0,1,1.0,1,0.31943275147893624,35
973,2,1537,767,770,0,0,0,1.0,1,1.0,1,1.0,1,0.29584560632799634,36
974,0,1537,767,770,0,0,0,1.0,1,1.0,1,1.0,1,0.3222827227103086,35
975,0,1537,767,770,0,0,0,1.0,1,1.0,1,1.0,1,0.3035251296528341,36
976,0,1537,767,770,0,0,0,1.0,1,1.0,1,1.0,1,0.3214576932771674,38
977,1,1538,768,770,0,0,0,1.0,1,1.0,1,1.0,1,0.3291405041627982,38
978,0,1538,768,770,0,0,0,1.0,1,1.0,1,1.0,1,0.3291405041627982,38
979,0,1538,768,770,0,0,0,1.0,1,1.0,1,1.0,1,0.3373499561306537,39
980,2,1540,770,770,0,0,0,1.0,1,1.0,1,1.0,1,0.38571582585824715,39
981,4,1544,771,773,0,0,0,1.0,1,1.0,1,1.0,1,0.3398469969970444,40
982,7,1551,774,777,0,0,0,1.0,1,1.0,1,1.0,1,0.3614306149641207,40
983,1,1552,774,778,0,0,0,1.0,1,1.0,1,1.0,1,0.3150144682341411,38
984,2,1554,775,779,0,0,0,1.0,1,1.0,1,1.0,1,0.31859402461758174,39
985,3,1557,778,779,0,0,0,1.0,1,1.0,1,1.0,1,0.39000899821221896,38
986,4,1561,780,781,0,0,0,1.0,1,1.0,1,1.0,1,0.409231935438332,38
987,3,1564,781,783,0,0,0,1.0,1,1.0,1,1.0,1,0.3432441108578553,38
988,0,1564,781,783,0,0,0,1.0,1,1.0,1,1.0,1,0.3432441108578553,38
989,3,1567,781,786,0,0,0,1.0,1,1.0,1,1.0,1,0.2852915310729233,38
990,0,1567,781,786,0,0,0,1.0,1,1.0,1,1.0,1,0.2852915310729233,38
991,3,1570,782,788,0,0,0,1.0,1,1.0,1,1.0,1,0.28959220622081294,40
992,1,1571,783,788,0,0,0,1.0,1,1.0,1,1.0,1,0.31509960059262493,39
993,1,1572,784,788,0,0,0,1.0,1,1.0,1,1.0,1,0.32158981089248384,38
994,1,1573,784,789,0,0,0,1.0,1,1.0,1,1.0,1,0.31754226647836015,39
995,0,1573,784,789,0,0,0,1.0,1,1.0,1,1.0,1,0.31657450303357615,41
996,0,1573,784,789,0,0,0,1.0,1,1.0,1,1.0,1,0.32620177632545655,40
997,0,1573,784,789,0,0,0,1.0,1,1.0,1,1.0,1,0.3432725858809341,41
998,0,1573,784,789,0,0,0,1.0,1,1.0,1,1.0,1,0.3725131636565539,40
999,1,1574,784,790,0,0,0,1.0,1,1.0,1,1.0,1,0.3930080748996382,40
1000,0,1574,784,790,0,0,0,1.0,1,1.0,1,1.0,1,0.3930080748996382,40
1001,2,1576,784,792,0,0,0,1.0,1,1.0,1,1.0,1,0.3604932060006367,39
1002,0,1576,784,792,0,0,0,1.0,1,1.0,1,1.0,1,0.3604932060006367,39
1003,2,1578,784,794,0,0,0,1.0,1,1.0,1,1.0,1,0.3359300705876065,39
1004,1,1579,784,795,0,0,0,1.0,1,1.0,1,1.0,1,0.3198442536829422,39
1005,0,1579,784,795,0,0,0,1.0,1,1.0,1,1.0,1,0.32947338333335563,40
1006,0,1579,784,795,0,0,0,1.0,1,1.0,1,1.0,1,0.324228817114752,41
1007,3,1582,784,798,0,0,0,1.0,1,1.0,1,1.0,1,0.2772083360738801,42
1008,0,1582,784,798,0,0,0,1.0,1,1.0,1,1.0,1,0.28924828045035106,43
1009,1,1583,784,799,0,0,0,1.0,1,1.0,1,1.0,1,0.2912723683399906,44
1010,1,1584,785,799,0,0,0,1.0,1,1.0,1,1.0,1,0.272220565143543,44
1011,1,1585,785,800,0,0,0,1.0,1,1.0,1,1.0,1,0.2408553885137561,44
1012,3,1588,787,801,0,0,0,1.0,1,1.0,1,1.0,1,0.24305622236593907,46
1013,0,1588,787,801,0,0,0,1.0,1,1.0,1,1.0,1,0.24305622236593907,46
1014,2,1590,788,802,0,0,0,1.0,1,1.0,1,1.0,1,0.24565763980520064,46
1015,0,1590,788,802,0,0,0,1.0,1,1.0,1,1.0,1,0.24565763980520064,46
1016,2,1592,789,803,0,0,0,1.0,1,1.0,1,1.0,1,0.25401140681263523,47
1017,1,1593,789,804,0,0,0,1.0,1,1.0,1,1.0,1,0.24053819001681268,47
1018,4,1597,790,807,0,0,0,1.0,1,1.0,1,1.0,1,0.20127333144999762,48
1019,1,1598,790,808,0,0,0,1.0,1,1.0,1,1.0,1,0.2032445064519569,49
1020,1,1599,790,809,0,0,0,1.0,1,1.0,1,1.0,1,0.1865265000335343,51
1021,1,1600,790,810,0,0,0,1.0,1,1.0,1,1.0,1,0.18318631003271635,51
1022,1,1601,791,810,0,0,0,1.0,1,1.0,1,1.0,1,0.19212709287915927,52
1023,3,1604,791,813,0,0,0,1.0,1,1.0,1,1.0,1,0.13210874698671735,52
1024,1,1605,792,813,0,0,0,1.0,1,1.0,1,1.0,1,0.1564539854053625,52
1025,2,1607,792,815,0,0,0,1.0,1,1.0,1,1.0,1,0.1441595578336402,54
1026,0,1607,792,815,0,0,0,1.0,1,1.0,1,1.0,1,0.1441595578336402,54
1027,0,1607,792,815,0,0,0,1.0,1,1.0,1,1.0,1,0.14179732193422145,55
1028,3,1610,794,816,0,0,0,1.0,1,1.0,1,1.0,1,0.1696623710983565,56
1029,0,1610,794,816,0,0,0,1.0,1,1.0,1,1.0,1,0.1696623710983565,56
1030,3,1613,794,819,0,0,0,1.0,1,1.0,1,1.0,1,0.15895836707943076,57
1031,1,1614,794,820,0,0,0,1.0,1,1.0,1,1.0,1,0.14113603588065884,58
1032,2,1616,796,820,0,0,0,1.0,1,1.0,1,1.0,1,0.15840860913830723,58
1033,0,1616,796,820,0,0,0,1.0,1,1.0,1,1.0,1,0.14916147367741212,57
1034,5,1621,801,820,0,0,0,1.0,1,1.0,1,1.0,1,0.19839647634760674,57
1035,4,1625,803,822,0,0,0,1.0,1,1.0,1,1.0,1,0.18665848838331403,57
1036,3,1628,804,824,0,0,0,1.0,1,1.0,1,1.0,1,0.16312628394961748,59
1037,2,1630,806,824,0,0,0,1.0,1,1.0,1,1.0,1,0.19345058376024998,57
1038,6,1636,808,828,0,0,0,1.0,1,1.0,1,1.0,1,0.22194951689020584,59
1039,3,1639,811,828,0,0,0,1.0,1,1.0,1,1.0,1,0.21759921783073893,57
1040,4,1643,812,831,0,0,0,1.0,1,1.0,1,1.0,1,0.25010243112559416,56
1041,2,1645,814,831,0,0,0,1.0,1,1.0,1,1.0,1,0.2572334209486571,54
1042,0,1645,814,831,0,0,0,1.0,1,1.0,1,1.0,1,0.22382265248331157,52
1043,0,1645,814,831,0,0,0,1.0,1,1.0,1,1.0,1,0.22382265248331157,52
1044,1,1646,814,832,0,0,0,1.0,1,1.0,1,1.0,1,0.17261392660305236,50
1045,2,1648,815,833,0,0,0,1.0,1,1.0,1,1.0,1,0.17702172838695981,51
1046,2,1650,816,834,0,0,0,1.0,1,1.0,1,1.0,1,0.16282706541903638,50
1047,0,1650,816,834,0,0,0,1.0,1,1.0,1,1.0,1,0.15543342417861714,50
1048,1,1651,817,834,0,0,0,1.0,1,1.0,1,1.0,1,0.1884186084186157,50
1049,3,1654,819,835,0,0,0,1.0,1,1.0,1,1.0,1,0.19859175636214524,50
1050,0,1654,819,835,0,0,0,1.0,1,1.0,1,1.0,1,0.19859175636214524,50
1051,1,1655,819,836,0,0,0,1.0,1,1.0,1,1.0,1,0.1772811622467137,50
1052,1,1656,820,836,0,0,0,1.0,1,1.0,1,1.0,1,0.1910128945499795,51
1053,1,1657,820,837,0,0,0,1.0,1,1.0,1,1.0,1,0.17399060816815443,51
1054,0,1657,820,837,0,0,0,1.0,1,1.0,1,1.0,1,0.16424593547267588,53
1055,2,1659,820,839,0,0,0,1.0,1,1.0,1,1.0,1,0.15225494544832863,54
1056,0,1659,820,839,0,0,0,1.0,1,1.0,1,1.0,1,0.17427863732113166,54
1057,2,1661,821,840,0,0,0,1.0,1,1.0,1,1.0,1,0.18468090489821506,55
1058,0,1661,821,840,0,0,0,1.0,1,1.0,1,1.0,1,0.1865676379387059,54
1059,1,1662,822,840,0,0,0,1.0,1,1.0,1,1.0,1,0.1982137834303211,53
1060,0,1662,822,840,0,0,0,1.0,1,1.0,1,1.0,1,0.1982137834303211,53
1061,3,1665,825,840,0,0,0,1.0,1,1.0,1,1.0,1,0.20515610146130736,53
1062,4,1669,829,840,0,0,0,1.0,1,1.0,1,1.0,1,0.231616357953322,54
1063,4,1673,829,844,0,0,0,1.0,1,1.0,1,1.0,1,0.21792391488994228,53
1064,3,1676,831,845,0,0,0,1.0,1,1.0,1,1.0,1,0.205967509479533,55
1065,3,1679,832,847,0,0,0,1.0,1,1.0,1,1.0,1,0.20895733688394066,54
1066,3,1682,832,850,0,0,0,1.0,1,1.0,1,1.0,1,0.18671392439721285,55
1067,3,1685,833,852,0,0,0,1.0,1,1.0,1,1.0,1,0.17678376574909385,55
1068,0,1685,833,852,0,0,0,1.0,1,1.0,1,1.0,1,0.1871577943535454,55
1069,2,1687,833,854,0,0,0,1.0,1,1.0,1,1.0,1,0.19205860888701837,55
1070,0,1687,833,854,0,0,0,1.0,1,1.0,1,1.0,1,0.20483178926005444,54
1071,1,1688,834,854,0,0,0,1.0,1,1.0,1,1.0,1,0.22004635917558615,55
1072,0,1688,834,854,0,0,0,1.0,1,1.0,1,1.0,1,0.20961003238949547,54
1073,2,1690,836,854,0,0,0,1.0,1,1.0,1,1.0,1,0.21122154708762444,54
1074,1,1691,836,855,0,0,0,1.0,1,1.0,1,1.0,1,0.2088716435364391,52
1075,3,1694,837,857,0,0,0,1.0,1,1.0,1,1.0,1,0.19627771060144186,51
1076,4,1698,838,860,0,0,0,1.0,1,1.0,1,1.0,1,0.14588540540427702,52
1077,3,1701,841,860,0,0,0,1.0,1,1.0,1,1.0,1,0.15990876934713802,49
1078,1,1702,842,860,0,0,0,1.0,1,1.0,1,1.0,1,0.2012361028208337,48
1079,3,1705,844,861,0,0,0,1.0,1,1.0,1,1.0,1,0.19787596143503242,47
1080,1,1706,845,861,0,0,0,1.0,1,1.0,1,1.0,1,0.24314538333299296,47
1081,1,1707,846,861,0,0,0,1.0,1,1.0,1,1.0,1,0.2604106864057385,45
1082,2,1709,848,861,0,0,0,1.0,1,1.0,1,1.0,1,0.33644816856403603,42
1083,4,1713,849,864,0,0,0,1.0,1,1.0,1,1.0,1,0.317550192182485,42
1084,1,1714,849,865,0,0,0,1.0,1,1.0,1,1.0,1,0.2996238200069258,40
1085,2,1716,849,867,0,0,0,1.0,1,1.0,1,1.0,1,0.25590069335317206,43
1086,2,1718,850,868,0,0,0,1.0,1,1.0,1,1.0,1,0.259254851895781,41
1087,2,1720,850,870,0,0,0,1.0,1,1.0,1,1.0,1,0.24261473692303406,41
1088,0,1720,850,870,0,0,0,1.0,1,1.0,1,1.0,1,0.24261473692303406,41
1089,3,1723,852,871,0,0,0,1.0,1,1.0,1,1.0,1,0.2205222851627923,42
1090,0,1723,852,871,0,0,0,1.0,1,1.0,1,1.0,1,0.22970520222640917,43
1091,1,1724,853,871,0,0,0,1.0,1,1.0,1,1.0,1,0.26277363254788155,43
1092,2,1726,854,872,0,0,0,1.0,1,1.0,1,1.0,1,0.22680382386132686,43
1093,1,1727,855,872,0,0,0,1.0,1,1.0,1,1.0,1,0.23067494897204827,43
1094,1,1728,855,873,0,0,0,1.0,1,1.0,1,1.0,1,0.21418433417151278,43
1095,0,1728,855,873,0,0,0,1.0,1,1.0,1,1.0,1,0.23047744180305293,44
1096,2,1730,857,873,0,0,0,1.0,1,1.0,1,1.0,1,0.26121965591354573,44
1097,4,1734,859,875,0,0,0,1.0,1,1.0,1,1.0,1,0.30837514241597436,45
1098,1,1735,859,876,0,0,0,1.0,1,1.0,1,1.0,1,0.29260522515618614,46
1099,2,1737,860,877,0,0,0,1.0,1,1.0,1,1.0,1,0.31014193275754015,48
1100,3,1740,861,879,0,0,0,1.0,1,1.0,1,1.0,1,0.28299626602351335,49
1101,3,1743,862,881,0,0,0,1.0,1,1.0,1,1.0,1,0.2747710565560661,49
1102,3,1746,864,882,0,0,0,1.0,1,1.0,1,1.0,1,0.267509428214093,50
1103,4,1750,865,885,0,0,0,1.0,1,1.0,1,1.0,1,0.20703181758097414,48
1104,1,1751,866,885,0,0,0,1.0,1,1.0,1,1.0,1,0.18818238642340673,50
1105,1,1752,867,885,0,0,0,1.0,1,1.0,1,1.0,1,0.159966573778966,48
1106,2,1754,868,886,0,0,0,1.0,1,1.0,1,1.0,1,0.16655325168629928,48
1107,2,1756,868,888,0,0,0,1.0,1,1.0,1,1.0,1,0.1691877134967233,47
1108,1,1757,869,888,0,0,0,1.0,1,1.0,1,1.0,1,0.19076958976237404,47
1109,4,1761,872,889,0,0,0,1.0,1,1.0,1,1.0,1,0.22655872157629492,46
1110,2,1763,873,890,0,0,0,1.0,1,1.0,1,1.0,1,0.2630652376235958,43
1111,5,1768,874,894,0,0,0,1.0,1,1.0,1,1.0,1,0.22051472262148789,44
1112,4,1772,877,895,0,0,0,1.0,1,1.0,1,1.0,1,0.26752072627345447,43
1113,4,1776,878,898,0,0,0,1.0,1,1.0,1,1.0,1,0.26094719737786387,39
1114,0,1776,878,898,0,0,0,1.0,1,1.0,1,1.0,1,0.26094719737786387,39
1115,3,1779,880,899,0,0,0,1.0,1,1.0,1,1.0,1,0.21470759501691258,37
1116,3,1782,882,900,0,0,0,1.0,1,1.0,1,1.0,1,0.20522907977465948,37
1117,2,1784,883,901,0,0,0,1.0,1,1.0,1,1.0,1,0.24109020306422171,36
1118,0,1784,883,901,0,0,0,1.0,1,1.0,1,1.0,1,0.24105398073961035,36
1119,0,1784,883,901,0,0,0,1.0,1,1.0,1,1.0,1,0.24105398073961035,36
1120,0,1784,883,901,0,0,0,1.0,1,1.0,1,1.0,1,0.24105398073961035,36
1121,0,1784,883,901,0,0,0,1.0,1,1.0,1,1.0,1,0.24105398073961035,36
1122,0,1784,883,901,0,0,0,1.0,1,1.0,1,1.0,1,0.20865537476485987,37
1123,0,1784,883,901,0,0,0,1.0,1,1.0,1,1.0,1,0.20865537476485987,37
1124,0,1784,883,901,0,0,0,1.0,1,1.0,1,1.0,1,0.20865537476485987,37
1125,2,1786,885,901,0,0,0,1.0,1,1.0,1,1.0,1,0.28359513159107635,38
1126,2,1788,886,902,0,0,0,1.0,1,1.0,1,1.0,1,0.24692424987342942,38
1127,3,1791,887,904,0,0,0,1.0,1,1.0,1,1.0,1,0.26481065513425933,39
1128,0,1791,887,904,0,0,0,1.0,1,1.0,1,1.0,1,0.26481065513425933,39
1129,0,1791,887,904,0,0,0,1.0,1,1.0,1,1.0,1,0.26481065513425933,39
1130,1,1792,888,904,0,0,0,1.0,1,1.0,1,1.0,1,0.2801755341281076,39
1131,1,1793,889,904,0,0,0,1.0,1,1.0,1,1.0,1,0.24666494260061686,39
1132,1,1794,890,904,0,0,0,1.0,1,1.0,1,1.0,1,0.25215986139223256,39
1133,1,1795,891,904,0,0,0,1.0,1,1.0,1,1.0,1,0.2331903924778135,42
1134,0,1795,891,904,0,0,0,1.0,1,1.0,1,1.0,1,0.2331903924778135,42
1135,3,1798,892,906,0,0,0,1.0,1,1.0,1,1.0,1,0.28900356025076596,44
1136,4,1802,893,909,0,0,0,1.0,1,1.0,1,1.0,1,0.29313081852842476,46
1137,1,1803,893,910,0,0,0,1.0,1,1.0,1,1.0,1,0.2610232595419311,45
1138,2,1805,895,910,0,0,0,1.0,1,1.0,1,1.0,1,0.30867646726194076,46
1139,3,1808,895,913,0,0,0,1.0,1,1.0,1,1.0,1,0.27896915306710734,47
1140,0,1808,895,913,0,0,0,1.0,1,1.0,1,1.0,1,0.29598903192886483,46
1141,4,1812,895,917,0,0,0,1.0,1,1.0,1,1.0,1,0.2328906678744256,45
1142,0,1812,895,917,0,0,0,1.0,1,1.0,1,1.0,1,0.2328906678744256,45
1143,3,1815,897,918,0,0,0,1.0,1,1.0,1,1.0,1,0.2321525544183199,43
1144,4,1819,900,919,0,0,0,1.0,1,1.0,1,1.0,1,0.2005822763491321,45
1145,4,1823,903,920,0,0,0,1.0,1,1.0,1,1.0,1,0.22996298273696855,44
1146,4,1827,904,923,0,0,0,1.0,1,1.0,1,1.0,1,0.1853507906181724,45
1147,2,1829,906,923,0,0,0,1.0,1,1.0,1,1.0,1,0.21391296915413627,44
1148,3,1832,909,923,0,0,0,1.0,1,1.0,1,1.0,1,0.2428010528482974,43
1149,4,1836,910,926,0,0,0,1.0,1,1.0,1,1.0,1,0.221944903968328,42
1150,3,1839,911,928,0,0,0,1.0,1,1.0,1,1.0,1,0.22567232609014984,45
1151,1,1840,912,928,0,0,0,1.0,1,1.0,1,1.0,1,0.26608972144712834,40
1152,1,1841,913,928,0,0,0,1.0,1,1.0,1,1.0,1,0.2517144544123642,41
1153,2,1843,914,929,0,0,0,1.0,1,1.0,1,1.0,1,0.24855910420899122,38
1154,1,1844,915,929,0,0,0,1.0,1,1.0,1,1.0,1,0.22844469950353757,37
1155,1,1845,916,929,0,0,0,1.0,1,1.0,1,1.0,1,0.24080532527471368,38
1156,1,1846,917,929,0,0,0,1.0,1,1.0,1,1.0,1,0.28501039107273324,38
1157,1,1847,917,930,0,0,0,1.0,1,1.0,1,1.0,1,0.2891656583798483,37
1158,1,1848,917,931,0,0,0,1.0,1,1.0,1,1.0,1,0.2922118224871207,36
1159,0,1848,917,931,0,0,0,1.0,1,1.0,1,1.0,1,0.2837593294601606,35
1160,0,1848,917,931,0,0,0,1.0,1,1.0,1,1.0,1,0.2837593294601606,35
1161,0,1848,917,931,0,0,0,1.0,1,1.0,1,1.0,1,0.2931040515315604,36
1162,0,1848,917,931,0,0,0,1.0,1,1.0,1,1.0,1,0.2917428706544007,37
1163,0,1848,917,931,0,0,0,1.0,1,1.0,1,1.0,1,0.2917428706544007,37
1164,0,1848,917,931,0,0,0,1.0,1,1.0,1,1.0,1,0.2785539606248399,38
1165,2,1850,917,933,0,0,0,1.0,1,1.0,1,1.0,1,0.251843536324411,38
1166,0,1850,917,933,0,0,0,1.0,1,1.0,1,1.0,1,0.28088044411372776,40
1167,4,1854,919,935,0,0,0,1.0,1,1.0,1,1.0,1,0.2627976393451874,40
1168,3,1857,920,937,0,0,0,1.0,1,1.0,1,1.0,1,0.1986011371343749,40
1169,1,1858,920,938,0,0,0,1.0,1,1.0,1,1.0,1,0.22219966845745828,41
1170,2,1860,922,938,0,0,0,1.0,1,1.0,1,1.0,1,0.20876757357831932,41
1171,3,1863,923,940,0,0,0,1.0,1,1.0,1,1.0,1,0.19851136224798677,43
1172,1,1864,924,940,0,0,0,1.0,1,1.0,1,1.0,1,0.18944139906248558,43
1173,1,1865,924,941,0,0,0,1.0,1,1.0,1,1.0,1,0.17635169224661706,43
1174,0,1865,924,941,0,0,0,1.0,1,1.0,1,1.0,1,0.17635169224661706,43
1175,0,1865,924,941,0,0,0,1.0,1,1.0,1,1.0,1,0.19110032663153426,44
1176,1,1866,925,941,0,0,0,1.0,1,1.0,1,1.0,1,0.19160013725033967,45
1177,1,1867,926,941,0,0,0,1.0,1,1.0,1,1.0,1,0.21677725512499582,45
1178,1,1868,927,941,0,0,0,1.0,1,1.0,1,1.0,1,0.21238566199815367,45
1179,0,1868,927,941,0,0,0,1.0,1,1.0,1,1.0,1,0.23478884521494045,46
1180,0,1868,927,941,0,0,0,1.0,1,1.0,1,1.0,1,0.216981910585892,47
1181,1,1869,927,942,0,0,0,1.0,1,1.0,1,1.0,1,0.22334782767964434,48
1182,2,1871,929,942,0,0,0,1.0,1,1.0,1,1.0,1,0.24185952093275007,48
1183,2,1873,930,943,0,0,0,1.0,1,1.0,1,1.0,1,0.266434640814247,46
1184,4,1877,932,945,0,0,0,1.0,1,1.0,1,1.0,1,0.2614053756583232,47
1185,3,1880,933,947,0,0,0,1.0,1,1.0,1,1.0,1,0.2699338811670677,44
1186,0,1880,933,947,0,0,0,1.0,1,1.0,1,1.0,1,0.29531624189773187,47
1187,6,1886,933,953,0,0,0,1.0,1,1.0,1,1.0,1,0.2209575587499302,49
1188,0,1886,933,953,0,0,0,1.0,1,1.0,1,1.0,1,0.22367172347423578,50
1189,0,1886,933,953,0,0,0,1.0,1,1.0,1,1.0,1,0.22671919271319596,48
1190,1,1887,934,953,0,0,0,1.0,1,1.0,1,1.0,1,0.2860032732798489,48
1191,2,1889,934,955,0,0,0,1.0,1,1.0,1,1.0,1,0.2519022618725913,46
1192,0,1889,934,955,0,0,0,1.0,1,1.0,1,1.0,1,0.2519022618725913,46
1193,1,1890,934,956,0,0,0,1.0,1,1.0,1,1.0,1,0.2562009714739097,45
1194,0,1890,934,956,0,0,0,1.0,1,1.0,1,1.0,1,0.2562009714739097,45
1195,2,1892,934,958,0,0,0,1.0,1,1.0,1,1.0,1,0.22863087759363385,47
1196,1,1893,935,958,0,0,0,1.0,1,1.0,1,1.0,1,0.21732193268320815,48
1197,1,1894,935,959,0,0,0,1.0,1,1.0,1,1.0,1,0.1981326812123588,49
1198,1,1895,936,959,0,0,0,1.0,1,1.0,1,1.0,1,0.19455690748739712,49
1199,1,1896,936,960,0,0,0,1.0,1,1.0,1,1.0,1,0.17904080038577114,50
1200,1,1897,937,960,0,0,0,1.0,1,1.0,1,1.0,1,0.1849502732896326,50
1201,0,1897,937,960,0,0,0,1.0,1,1.0,1,1.0,1,0.1849502732896326,50
1202,1,1898,938,960,0,0,0,1.0,1,1.0,1,1.0,1,0.19783578580370542,51
1203,0,1898,938,960,0,0,0,1.0,1,1.0,1,1.0,1,0.18862222140886492,52
1204,0,1898,938,960,0,0,0,1.0,1,1.0,1,1.0,1,0.18862222140886492,52
1205,3,1901,939,962,0,0,0,1.0,1,1.0,1,1.0,1,0.21762679347706657,53
1206,0,1901,939,962,0,0,0,1.0,1,1.0,1,1.0,1,0.21762679347706657,53
1207,1,1902,939,963,0,0,0,1.0,1,1.0,1,1.0,1,0.22343688226387368,55
1208,1,1903,939,964,0,0,0,1.0,1,1.0,1,1.0,1,0.217251045185365,56
1209,0,1903,939,964,0,0,0,1.0,1,1.0,1,1.0,1,0.22806390043029645,55
1210,1,1904,940,964,0,0,0,1.0,1,1.0,1,1.0,1,0.22263224885135519,55
1211,1,1905,940,965,0,0,0,1.0,1,1.0,1,1.0,1,0.19623760185689923,57
1212,1,1906,941,965,0,0,0,1.0,1,1.0,1,1.0,1,0.19660189422351912,57
1213,2,1908,942,966,0,0,0,1.0,1,1.0,1,1.0,1,0.16936680292067077,57
1214,4,1912,945,967,0,0,0,1.0,1,1.0,1,1.0,1,0.23123796748641448,57
1215,4,1916,945,971,0,0,0,1.0,1,1.0,1,1.0,1,0.1931407751827942,59
1216,2,1918,946,972,0,0,0,1.0,1,1.0,1,1.0,1,0.19172518719408835,61
1217,1,1919,946,973,0,0,0,1.0,1,1.0,1,1.0,1,0.1811047648317294,61
1218,1,1920,947,973,0,0,0,1.0,1,1.0,1,1.0,1,0.21216621870472377,61
1219,1,1921,948,973,0,0,0,1.0,1,1.0,1,1.0,1,0.21302806489722137,61
1220,3,1924,949,975,0,0,0,1.0,1,1.0,1,1.0,1,0.210517282250847,60
1221,1,1925,949,976,0,0,0,1.0,1,1.0,1,1.0,1,0.2138990204952129,61
1222,1,1926,949,977,0,0,0,1.0,1,1.0,1,1.0,1,0.1851363487052148,61
1223,0,1926,949,977,0,0,0,1.0,1,1.0,1,1.0,1,0.19726775041656675,59
1224,4,1930,953,977,0,0,0,1.0,1,1.0,1,1.0,1,0.20804899054375908,60
1225,6,1936,954,982,0,0,0,1.0,1,1.0,1,1.0,1,0.1792349022831443,60
1226,2,1938,955,983,0,0,0,1.0,1,1.0,1,1.0,1,0.17792355965765447,61
1227,2,1940,956,984,0,0,0,1.0,1,1.0,1,1.0,1,0.1597180494392891,59
1228,1,1941,957,984,0,0,0,1.0,1,1.0,1,1.0,1,0.16207367054731103,58
1229,4,1945,959,986,0,0,0,1.0,1,1.0,1,1.0,1,0.14021424830378515,57
1230,2,1947,961,986,0,0,0,1.0,1,1.0,1,1.0,1,0.1440984923244282,55
1231,4,1951,963,988,0,0,0,1.0,1,1.0,1,1.0,1,0.1607443475422385,54
1232,2,1953,965,988,0,0,0,1.0,1,1.0,1,1.0,1,0.18117456683763417,51
1233,2,1955,967,988,0,0,0,1.0,1,1.0,1,1.0,1,0.19924502847890274,49
1234,2,1957,969,988,0,0,0,1.0,1,1.0,1,1.0,1,0.22693590913689224,49
1235,2,1959,970,989,0,0,0,1.0,1,1.0,1,1.0,1,0.22307042719559408,48
1236,2,1961,970,991,0,0,0,1.0,1,1.0,1,1.0,1,0.21661794015458277,49
1237,2,1963,971,992,0,0,0,1.0,1,1.0,1,1.0,1,0.23939782810390384,48
1238,0,1963,971,992,0,0,0,1.0,1,1.0,1,1.0,1,0.2324704287316408,47
1239,0,1963,971,992,0,0,0,1.0,1,1.0,1,1.0,1,0.2225808671623539,48
1240,2,1965,972,993,0,0,0,1.0,1,1.0,1,1.0,1,0.22245191106817722,49
1241,0,1965,972,993,0,0,0,1.0,1,1.0,1,1.0,1,0.22245191106817722,49
1242,0,1965,972,993,0,0,0,1.0,1,1.0,1,1.0,1,0.22460205844818065,49
1243,1,1966,972,994,0,0,0,1.0,1,1.0,1,1.0,1,0.21402718213203747,50
1244,1,1967,973,994,0,0,0,1.0,1,1.0,1,1.0,1,0.27445381831229,50
1245,5,1972,973,999,0,0,0,1.0,1,1.0,1,1.0,1,0.22609923839001664,51
1246,1,1973,974,999,0,0,0,1.0,1,1.0,1,1.0,1,0.24868077303285555,52
1247,1,1974,974,1000,0,0,0,1.0,1,1.0,1,1.0,1,0.24065274163569242,52
1248,0,1974,974,1000,0,0,0,1.0,1,1.0,1,1.0,1,0.2538488258507902,51
1249,3,1977,976,1001,0,0,0,1.0,1,1.0,1,1.0,1,0.2376761807522349,51
1250,4,1981,979,1002,0,0,0,1.0,1,1.0,1,1.0,1,0.22532845601959622,51
1251,4,1985,979,1006,0,0,0,1.0,1,1.0,1,1.0,1,0.19488098426910233,53
1252,2,1987,981,1006,0,0,0,1.0,1,1.0,1,1.0,1,0.17561370397908105,52
1253,0,1987,981,1006,0,0,0,1.0,1,1.0,1,1.0,1,0.17561370397908105,52
1254,0,1987,981,1006,0,0,0,1.0,1,1.0,1,1.0,1,0.1659777516973885,53
1255,1,1988,982,1006,0,0,0,1.0,1,1.0,1,1.0,1,0.18803028036221603,55
1256,0,1988,982,1006,0,0,0,1.0,1,1.0,1,1.0,1,0.18803028036221603,55
1257,2,1990,982,1008,0,0,0,1.0,1,1.0,1,1.0,1,0.18119888380967317,57
1258,0,1990,982,1008,0,0,0,1.0,1,1.0,1,1.0,1,0.18164016081114792,57
1259,0,1990,982,1008,0,0,0,1.0,1,1.0,1,1.0,1,0.18164016081114792,57
1260,0,1990,982,1008,0,0,0,1.0,1,1.0,1,1.0,1,0.18609367671379648,56
1261,0,1990,982,1008,0,0,0,1.0,1,1.0,1,1.0,1,0.18936933238982423,57
1262,4,1994,983,1011,0,0,0,1.0,1,1.0,1,1.0,1,0.17386279267550878,58
1263,4,1998,985,1013,0,0,0,1.0,1,1.0,1,1.0,1,0.17538721544215777,58
1264,2,2000,986,1014,0,0,0,1.0,1,1.0,1,1.0,1,0.17036768687141396,57
1265,6,2006,989,1017,0,0,0,1.0,1,1.0,1,1.0,1,0.17239514686746898,56
1266,5,2011,992,1019,0,0,0,1.0,1,1.0,1,1.0,1,0.23749281878224165,55
1267,2,2013,993,1020,0,0,0,1.0,1,1.0,1,1.0,1,0.2154608173757164,53
1268,1,2014,994,1020,0,0,0,1.0,1,1.0,1,1.0,1,0.24335248282638058,52
1269,1,2015,995,1020,0,0,0,1.0,1,1.0,1,1.0,1,0.22709428796083614,51
1270,0,2015,995,1020,0,0,0,1.0,1,1.0,1,1.0,1,0.2135761645227767,47
1271,1,2016,996,1020,0,0,0,1.0,1,1.0,1,1.0,1,0.2277741479604096,46
1272,0,2016,996,1020,0,0,0,1.0,1,1.0,1,1.0,1,0.20866683561696364,43
1273,2,2018,998,1020,0,0,0,1.0,1,1.0,1,1.0,1,0.21436013925001668,44
1274,3,2021,1000,1021,0,0,0,1.0,1,1.0,1,1.0,1,0.2569588733774185,44
1275,7,2028,1002,1026,0,0,0,1.0,1,1.0,1,1.0,1,0.19130549139966477,45
1276,2,2030,1002,1028,0,0,0,1.0,1,1.0,1,1.0,1,0.1701933807594236,43
1277,2,2032,1004,1028,0,0,0,1.0,1,1.0,1,1.0,1,0.18870997570550707,44
1278,4,2036,1007,1029,0,0,0,1.0,1,1.0,1,1.0,1,0.22586675441258103,45
1279,2,2038,1007,1031,0,0,0,1.0,1,1.0,1,1.0,1,0.16291619927843384,47
1280,1,2039,1008,1031,0,0,0,1.0,1,1.0,1,1.0,1,0.16532513642300656,47
1281,1,2040,1009,1031,0,0,0,1.0,1,1.0,1,1.0,1,0.163872015996059,47
1282,1,2041,1010,1031,0,0,0,1.0,1,1.0,1,1.0,1,0.18404207358611185,46
1283,1,2042,1011,1031,0,0,0,1.0,1,1.0,1,1.0,1,0.18999105450333476,46
1284,2,2044,1011,1033,0,0,0,1.0,1,1.0,1,1.0,1,0.1596084805934435,46
1285,1,2045,1011,1034,0,0,0,1.0,1,1.0,1,1.0,1,0.16846165558523118,46
1286,0,2045,1011,1034,0,0,0,1.0,1,1.0,1,1.0,1,0.16468888775769125,45
1287,3,2048,1012,1036,0,0,0,1.0,1,1.0,1,1.0,1,0.18977467800781037,49
1288,0,2048,1012,1036,0,0,0,1.0,1,1.0,1,1.0,1,0.18977467800781037,49
1289,2,2050,1012,1038,0,0,0,1.0,1,1.0,1,1.0,1,0.1684298038056383,52
1290,0,2050,1012,1038,0,0,0,1.0,1,1.0,1,1.0,1,0.1684298038056383,52
1291,0,2050,1012,1038,0,0,0,1.0,1,1.0,1,1.0,1,0.1684298038056383,52
1292,0,2050,1012,1038,0,0,0,1.0,1,1.0,1,1.0,1,0.17091101023093463,53
1293,1,2051,1013,1038,0,0,0,1.0,1,1.0,1,1.0,1,0.1738457634542186,53
1294,0,2051,1013,1038,0,0,0,1.0,1,1.0,1,1.0,1,0.1738457634542186,53
1295,1,2052,1013,1039,0,0,0,1.0,1,1.0,1,1.0,1,0.17085362554295996,54
1296,2,2054,1013,1041,0,0,0,1.0,1,1.0,1,1.0,1,0.14239240400359862,55
1297,1,2055,1013,1042,0,0,0,1.0,1,1.0,1,1.0,1,0.1529374382602112,54
1298,0,2055,1013,1042,0,0,0,1.0,1,1.0,1,1.0,1,0.16632853226401823,55
1299,1,2056,1013,1043,0,0,0,1.0,1,1.0,1,1.0,1,0.17050533884244023,54
1300,2,2058,1014,1044,0,0,0,1.0,1,1.0,1,1.0,1,0.17428025088937962,55
1301,0,2058,1014,1044,0,0,0,1.0,1,1.0,1,1.0,1,0.17679236742639115,54
1302,2,2060,1016,1044,0,0,0,1.0,1,1.0,1,1.0,1,0.19196982284987207,54
1303,7,2067,1019,1048,0,0,0,1.0,1,1.0,1,1.0,1,0.24468192846546924,50
1304,7,2074,1025,1049,0,0,0,1.0,1,1.0,1,1.0,1,0.23713115939462556,51
1305,2,2076,1027,1049,0,0,0,1.0,1,1.0,1,1.0,1,0.24976772012226178,48
1306,7,2083,1031,1052,0,0,0,1.0,1,1.0,1,1.0,1,0.31933651173405353,48
1307,3,2086,1031,1055,0,0,0,1.0,1,1.0,1,1.0,1,0.20998336777561896,48
1308,2,2088,1032,1056,0,0,0,1.0,1,1.0,1,1.0,1,0.2224282433505313,46
1309,3,2091,1034,1057,0,0,0,1.0,1,1.0,1,1.0,1,0.22590838201035998,47
1310,0,2091,1034,1057,0,0,0,1.0,1,1.0,1,1.0,1,0.20335039185855353,46
1311,2,2093,1036,1057,0,0,0,1.0,1,1.0,1,1.0,1,0.2623910063976918,46
1312,1,2094,1037,1057,0,0,0,1.0,1,1.0,1,1.0,1,0.2775194817223943,45
1313,1,2095,1037,1058,0,0,0,1.0,1,1.0,1,1.0,1,0.2842026539479924,44
1314,1,2096,1037,1059,0,0,0,1.0,1,1.0,1,1.0,1,0.2740761470782724,42
1315,0,2096,1037,1059,0,0,0,1.0,1,1.0,1,1.0,1,0.33060656223657087,40
1316,1,2097,1037,1060,0,0,0,1.0,1,1.0,1,1.0,1,0.29441612822318397,42
1317,1,2098,1037,1061,0,0,0,1.0,1,1.0,1,1.0,1,0.284296126472614,42
1318,0,2098,1037,1061,0,0,0,1.0,1,1.0,1,1.0,1,0.284296126472614,42
1319,2,2100,1038,1062,0,0,0,1.0,1,1.0,1,1.0,1,0.2392071752492033,42
1320,1,2101,1038,1063,0,0,0,1.0,1,1.0,1,1.0,1,0.23449077945898206,42
1321,0,2101,1038,1063,0,0,0,1.0,1,1.0,1,1.0,1,0.23507570068564462,45
1322,0,2101,1038,1063,0,0,0,1.0,1,1.0,1,1.0,1,0.23507570068564462,45
1323,2,2103,1039,1064,0,0,0,1.0,1,1.0,1,1.0,1,0.225626902697279,46
1324,1,2104,1039,1065,0,0,0,1.0,1,1.0,1,1.0,1,0.23082781972519936,45
1325,3,2107,1040,1067,0,0,0,1.0,1,1.0,1,1.0,1,0.2298309371315014,46
1326,1,2108,1041,1067,0,0,0,1.0,1,1.0,1,1.0,1,0.2551317827800194,45
1327,0,2108,1041,1067,0,0,0,1.0,1,1.0,1,1.0,1,0.2798243539649878,46
1328,0,2108,1041,1067,0,0,0,1.0,1,1.0,1,1.0,1,0.28191245907160734,47
1329,1,2109,1042,1067,0,0,0,1.0,1,1.0,1,1.0,1,0.28809794219372314,47
1330,0,2109,1042,1067,0,0,0,1.0,1,1.0,1,1.0,1,0.3090718218572429,46
1331,4,2113,1044,1069,0,0,0,1.0,1,1.0,1,1.0,1,0.2677663763702427,46
1332,4,2117,1046,1071,0,0,0,1.0,1,1.0,1,1.0,1,0.2851250833429191,49
1333,2,2119,1046,1073,0,0,0,1.0,1,1.0,1,1.0,1,0.2845272196931749,50
1334,0,2119,1046,1073,0,0,0,1.0,1,1.0,1,1.0,1,0.2845272196931749,50
1335,1,2120,1046,1074,0,0,0,1.0,1,1.0,1,1.0,1,0.3041748985730263,52
1336,0,2120,1046,1074,0,0,0,1.0,1,1.0,1,1.0,1,0.29041885777155024,53
1337,3,2123,1047,1076,0,0,0,1.0,1,1.0,1,1.0,1,0.2963177113005577,54
1338,1,2124,1047,1077,0,0,0,1.0,1,1.0,1,1.0,1,0.28496592922097347,54
1339,2,2126,1048,1078,0,0,0,1.0,1,1.0,1,1.0,1,0.2913780213379803,54
1340,2,2128,1048,1080,0,0,0,1.0,1,1.0,1,1.0,1,0.2565338763209786,53
1341,0,2128,1048,1080,0,0,0,1.0,1,1.0,1,1.0,1,0.27341015652173734,53
1342,1,2129,1049,1080,0,0,0,1.0,1,1.0,1,1.0,1,0.3117960187921021,52
1343,2,2131,1050,1081,0,0,0,1.0,1,1.0,1,1.0,1,0.3221771529617377,50
1344,4,2135,1053,1082,0,0,0,1.0,1,1.0,1,1.0,1,0.33878071728404535,51
1345,1,2136,1053,1083,0,0,0,1.0,1,1.0,1,1.0,1,0.32324205013310753,50
1346,1,2137,1054,1083,0,0,0,1.0,1,1.0,1,1.0,1,0.32100877181830384,50
1347,3,2140,1054,1086,0,0,0,1.0,1,1.0,1,1.0,1,0.2915329505987727,48
1348,1,2141,1054,1087,0,0,0,1.0,1,1.0,1,1.0,1,0.27749391441999227,49
1349,1,2142,1054,1088,0,0,0,1.0,1,1.0,1,1.0,1,0.26220360411250876,48
1350,1,2143,1055,1088,0,0,0,1.0,1,1.0,1,1.0,1,0.29583887429664196,49
1351,0,2143,1055,1088,0,0,0,1.0,1,1.0,1,1.0,1,0.2823342965060153,48
1352,2,2145,1056,1089,0,0,0,1.0,1,1.0,1,1.0,1,0.2745463638979042,49
1353,3,2148,1056,1092,0,0,0,1.0,1,1.0,1,1.0,1,0.21413642204005412,49
1354,3,2151,1057,1094,0,0,0,1.0,1,1.0,1,1.0,1,0.20337922400692598,49
1355,1,2152,1057,1095,0,0,0,1.0,1,1.0,1,1.0,1,0.18245177555008987,50
1356,1,2153,1058,1095,0,0,0,1.0,1,1.0,1,1.0,1,0.20264493514208032,50
1357,6,2159,1062,1097,0,0,0,1.0,1,1.0,1,1.0,1,0.20018247175869291,50
1358,3,2162,1063,1099,0,0,0,1.0,1,1.0,1,1.0,1,0.19693068337536562,51
1359,3,2165,1064,1101,0,0,0,1.0,1,1.0,1,1.0,1,0.20674131644200994,53
1360,0,2165,1064,1101,0,0,0,1.0,1,1.0,1,1.0,1,0.20699611042321248,54
1361,1,2166,1064,1102,0,0,0,1.0,1,1.0,1,1.0,1,0.1840306648514561,54
1362,0,2166,1064,1102,0,0,0,1.0,1,1.0,1,1.0,1,0.17206449487792902,55
1363,1,2167,1064,1103,0,0,0,1.0,1,1.0,1,1.0,1,0.15507560992772196,55
1364,0,2167,1064,1103,0,0,0,1.0,1,1.0,1,1.0,1,0.1637200410224771,55
1365,2,2169,1064,1105,0,0,0,1.0,1,1.0,1,1.0,1,0.1573540545785955,56
1366,0,2169,1064,1105,0,0,0,1.0,1,1.0,1,1.0,1,0.1573540545785955,56
1367,1,2170,1065,1105,0,0,0,1.0,1,1.0,1,1.0,1,0.1705957849309679,56
1368,3,2173,1066,1107,0,0,0,1.0,1,1.0,1,1.0,1,0.19247258674013484,58
1369,3,2176,1066,1110,0,0,0,1.0,1,1.0,1,1.0,1,0.14822484538763742,59
1370,1,2177,1067,1110,0,0,0,1.0,1,1.0,1,1.0,1,0.14380694528988808,59
1371,1,2178,1067,1111,0,0,0,1.0,1,1.0,1,1.0,1,0.12525584452529817,59
1372,4,2182,1069,1113,0,0,0,1.0,1,1.0,1,1.0,1,0.11395648081304813,59
1373,0,2182,1069,1113,0,0,0,1.0,1,1.0,1,1.0,1,0.11395648081304813,59
1374,1,2183,1070,1113,0,0,0,1.0,1,1.0,1,1.0,1,0.13236637738909832,60
1375,1,2184,1070,1114,0,0,0,1.0,1,1.0,1,1.0,1,0.11690694416981634,61
1376,2,2186,1070,1116,0,0,0,1.0,1,1.0,1,1.0,1,0.13761643191476475,61
1377,3,2189,1072,1117,0,0,0,1.0,1,1.0,1,1.0,1,0.12576874331125357,61
1378,2,2191,1074,1117,0,0,0,1.0,1,1.0,1,1.0,1,0.1977575119065723,61
1379,2,2193,1075,1118,0,0,0,1.0,1,1.0,1,1.0,1,0.2159695341200182,60
1380,4,2197,1076,1121,0,0,0,1.0,1,1.0,1,1.0,1,0.2140036416794501,60
1381,3,2200,1077,1123,0,0,0,1.0,1,1.0,1,1.0,1,0.2069227022104799,58
1382,4,2204,1079,1125,0,0,0,1.0,1,1.0,1,1.0,1,0.21062572388493317,58
1383,5,2209,1081,1128,0,0,0,1.0,1,1.0,1,1.0,1,0.18763609257071118,57
1384,3,2212,1083,1129,0,0,0,1.0,1,1.0,1,1.0,1,0.1961512425801642,54
1385,2,2214,1084,1130,0,0,0,1.0,1,1.0,1,1.0,1,0.19381170026755024,52
1386,3,2217,1085,1132,0,0,0,1.0,1,1.0,1,1.0,1,0.17494821691030177,51
1387,6,2223,1086,1137,0,0,0,1.0,1,1.0,1,1.0,1,0.15132213517116896,51
1388,4,2227,1090,1137,0,0,0,1.0,1,1.0,1,1.0,1,0.21733606255308868,52
1389,3,2230,1090,1140,0,0,0,1.0,1,1.0,1,1.0,1,0.1574950155271886,50
1390,0,2230,1090,1140,0,0,0,1.0,1,1.0,1,1.0,1,0.16085596812981995,51
1391,1,2231,1090,1141,0,0,0,1.0,1,1.0,1,1.0,1,0.14971185425913835,50
1392,1,2232,1091,1141,0,0,0,1.0,1,1.0,1,1.0,1,0.17078479874465582,50
1393,2,2234,1091,1143,0,0,0,1.0,1,1.0,1,1.0,1,0.13812984997157604,49
1394,2,2236,1093,1143,0,0,0,1.0,1,1.0,1,1.0,1,0.1797127728264865,50
1395,0,2236,1093,1143,0,0,0,1.0,1,1.0,1,1.0,1,0.17771634935521782,51
1396,2,2238,1093,1145,0,0,0,1.0,1,1.0,1,1.0,1,0.17456427600614877,52
1397,0,2238,1093,1145,0,0,0,1.0,1,1.0,1,1.0,1,0.17456427600614877,52
1398,2,2240,1095,1145,0,0,0,1.0,1,1.0,1,1.0,1,0.1719160552855775,53
1399,2,2242,1096,1146,0,0,0,1.0,1,1.0,1,1.0,1,0.18538928553957126,54
1400,1,2243,1097,1146,0,0,0,1.0,1,1.0,1,1.0,1,0.2051495020699063,54
1401,2,2245,1099,1146,0,0,0,1.0,1,1.0,1,1.0,1,0.19631819802335354,54
1402,2,2247,1101,1146,0,0,0,1.0,1,1.0,1,1.0,1,0.20785264278688675,53
1403,1,2248,1101,1147,0,0,0,1.0,1,1.0,1,1.0,1,0.21941444992457015,52
1404,0,2248,1101,1147,0,0,0,1.0,1,1.0,1,1.0,1,0.22762650042425278,53
1405,1,2249,1102,1147,0,0,0,1.0,1,1.0,1,1.0,1,0.27471018445146667,52
1406,1,2250,1102,1148,0,0,0,1.0,1,1.0,1,1.0,1,0.2493078272072306,53
1407,0,2250,1102,1148,0,0,0,1.0,1,1.0,1,1.0,1,0.2585386987469937,54
1408,0,2250,1102,1148,0,0,0,1.0,1,1.0,1,1.0,1,0.2795107759319994,53
1409,2,2252,1102,1150,0,0,0,1.0,1,1.0,1,1.0,1,0.2621099124842503,55
1410,0,2252,1102,1150,0,0,0,1.0,1,1.0,1,1.0,1,0.26289508403828954,54
1411,0,2252,1102,1150,0,0,0,1.0,1,1.0,1,1.0,1,0.26289508403828954,54
1412,0,2252,1102,1150,0,0,0,1.0,1,1.0,1,1.0,1,0.2670819318652039,53
1413,0,2252,1102,1150,0,0,0,1.0,1,1.0,1,1.0,1,0.26170519912693246,54
1414,2,2254,1102,1152,0,0,0,1.0,1,1.0,1,1.0,1,0.2548545294779231,55
1415,2,2256,1102,1154,0,0,0,1.0,1,1.0,1,1.0,1,0.22690692238469568,57
1416,3,2259,1103,1156,0,0,0,1.0,1,1.0,1,1.0,1,0.24519182185324842,59
1417,1,2260,1103,1157,0,0,0,1.0,1,1.0,1,1.0,1,0.22558728204338613,58
1418,2,2262,1104,1158,0,0,0,1.0,1,1.0,1,1.0,1,0.21039304799972575,57
1419,1,2263,1105,1158,0,0,0,1.0,1,1.0,1,1.0,1,0.23286707438219517,56
1420,1,2264,1105,1159,0,0,0,1.0,1,1.0,1,1.0,1,0.26869444315186786,54
1421,3,2267,1106,1161,0,0,0,1.0,1,1.0,1,1.0,1,0.23551473641132595,55
1422,1,2268,1107,1161,0,0,0,1.0,1,1.0,1,1.0,1,0.20838612458844633,52
1423,2,2270,1109,1161,0,0,0,1.0,1,1.0,1,1.0,1,0.2506045997670935,52
1424,3,2273,1112,1161,0,0,0,1.0,1,1.0,1,1.0,1,0.29072843309105195,51
1425,6,2279,1112,1167,0,0,0,1.0,1,1.0,1,1.0,1,0.21634217663777366,50
1426,2,2281,1113,1168,0,0,0,1.0,1,1.0,1,1.0,1,0.24194743291533102,50
1427,2,2283,1113,1170,0,0,0,1.0,1,1.0,1,1.0,1,0.21830788779134475,48
1428,4,2287,1116,1171,0,0,0,1.0,1,1.0,1,1.0,1,0.21374856552583724,48
1429,0,2287,1116,1171,0,0,0,1.0,1,1.0,1,1.0,1,0.2183902302441367,48
1430,1,2288,1117,1171,0,0,0,1.0,1,1.0,1,1.0,1,0.2249265892961129,48
1431,1,2289,1117,1172,0,0,0,1.0,1,1.0,1,1.0,1,0.21158437619244497,48
1432,2,2291,1117,1174,0,0,0,1.0,1,1.0,1,1.0,1,0.16418681315050979,50
1433,2,2293,1118,1175,0,0,0,1.0,1,1.0,1,1.0,1,0.18233606979341171,51
1434,1,2294,1119,1175,0,0,0,1.0,1,1.0,1,1.0,1,0.17046527325989286,51
1435,4,2298,1121,1177,0,0,0,1.0,1,1.0,1,1.0,1,0.16430010975188367,50
1436,1,2299,1122,1177,0,0,0,1.0,1,1.0,1,1.0,1,0.17302823304083761,51
1437,0,2299,1122,1177,0,0,0,1.0,1,1.0,1,1.0,1,0.17302823304083761,51
1438,1,2300,1123,1177,0,0,0,1.0,1,1.0,1,1.0,1,0.19299611116747045,51
1439,3,2303,1125,1178,0,0,0,1.0,1,1.0,1,1.0,1,0.20656348291476204,50
1440,4,2307,1126,1181,0,0,0,1.0,1,1.0,1,1.0,1,0.21039594595489713,51
1441,0,2307,1126,1181,0,0,0,1.0,1,1.0,1,1.0,1,0.21039594595489713,51
1442,3,2310,1128,1182,0,0,0,1.0,1,1.0,1,1.0,1,0.22605028083675227,52
1443,4,2314,1128,1186,0,0,0,1.0,1,1.0,1,1.0,1,0.19941708494883523,53
1444,4,2318,1129,1189,0,0,0,1.0,1,1.0,1,1.0,1,0.17116444289440008,54
1445,1,2319,1129,1190,0,0,0,1.0,1,1.0,1,1.0,1,0.1491528020594347,54
1446,0,2319,1129,1190,0,0,0,1.0,1,1.0,1,1.0,1,0.16280577737602617,54
1447,0,2319,1129,1190,0,0,0,1.0,1,1.0,1,1.0,1,0.15348645577111328,55
1448,1,2320,1129,1191,0,0,0,1.0,1,1.0,1,1.0,1,0.14020054549366293,55
1449,1,2321,1130,1191,0,0,0,1.0,1,1.0,1,1.0,1,0.15425136258689653,55
1450,0,2321,1130,1191,0,0,0,1.0,1,1.0,1,1.0,1,0.1579046460968298,57
1451,1,2322,1130,1192,0,0,0,1.0,1,1.0,1,1.0,1,0.13381086575387705,57
1452,0,2322,1130,1192,0,0,0,1.0,1,1.0,1,1.0,1,0.13381086575387705,57
1453,1,2323,1131,1192,0,0,0,1.0,1,1.0,1,1.0,1,0.1591390818199543,57
1454,4,2327,1134,1193,0,0,0,1.0,1,1.0,1,1.0,1,0.19197762265138937,58
1455,4,2331,1135,1196,0,0,0,1.0,1,1.0,1,1.0,1,0.17506874771168038,56
1456,1,2332,1136,1196,0,0,0,1.0,1,1.0,1,1.0,1,0.16629043511994113,55
1457,0,2332,1136,1196,0,0,0,1.0,1,1.0,1,1.0,1,0.18877090315001,54
1458,2,2334,1138,1196,0,0,0,1.0,1,1.0,1,1.0,1,0.2147864525417902,53
1459,3,2337,1138,1199,0,0,0,1.0,1,1.0,1,1.0,1,0.14688137186113953,52
1460,1,2338,1138,1200,0,0,0,1.0,1,1.0,1,1.0,1,0.11865695932240411,51
1461,1,2339,1139,1200,0,0,0,1.0,1,1.0,1,1.0,1,0.1441325830030944,51
1462,6,2345,1143,1202,0,0,0,1.0,1,1.0,1,1.0,1,0.15938401233178567,51
1463,4,2349,1145,1204,0,0,0,1.0,1,1.0,1,1.0,1,0.18649704809857856,52
1464,4,2353,1148,1205,0,0,0,1.0,1,1.0,1,1.0,1,0.2269584385124648,52
1465,2,2355,1149,1206,0,0,0,1.0,1,1.0,1,1.0,1,0.21209114542564717,51
1466,6,2361,1152,1209,0,0,0,1.0,1,1.0,1,1.0,1,0.17228978913284407,50
1467,3,2364,1154,1210,0,0,0,1.0,1,1.0,1,1.0,1,0.16752223132039878,48
1468,2,2366,1156,1210,0,0,0,1.0,1,1.0,1,1.0,1,0.1664388982155578,48
1469,2,2368,1156,1212,0,0,0,1.0,1,1.0,1,1.0,1,0.14535024362713592,48
1470,2,2370,1157,1213,0,0,0,1.0,1,1.0,1,1.0,1,0.1367433713333799,48
1471,2,2372,1159,1213,0,0,0,1.0,1,1.0,1,1.0,1,0.14145436137259876,45
1472,1,2373,1160,1213,0,0,0,1.0,1,1.0,1,1.0,1,0.13241081178478217,45
1473,2,2375,1161,1214,0,0,0,1.0,1,1.0,1,1.0,1,0.1494871171136464,46
1474,0,2375,1161,1214,0,0,0,1.0,1,1.0,1,1.0,1,0.15200708237535188,46
1475,0,2375,1161,1214,0,0,0,1.0,1,1.0,1,1.0,1,0.15200708237535188,46
1476,1,2376,1161,1215,0,0,0,1.0,1,1.0,1,1.0,1,0.15806117221515162,47
1477,1,2377,1161,1216,0,0,0,1.0,1,1.0,1,1.0,1,0.1288163795064551,47
1478,2,2379,1162,1217,0,0,0,1.0,1,1.0,1,1.0,1,0.16626369331927032,47
1479,0,2379,1162,1217,0,0,0,1.0,1,1.0,1,1.0,1,0.1739419465201332,48
1480,1,2380,1163,1217,0,0,0,1.0,1,1.0,1,1.0,1,0.18569953994336028,47
1481,1,2381,1164,1217,0,0,0,1.0,1,1.0,1,1.0,1,0.2116115730016257,47
1482,4,2385,1166,1219,0,0,0,1.0,1,1.0,1,1.0,1,0.18355275526096673,46
1483,3,2388,1167,1221,0,0,0,1.0,1,1.0,1,1.0,1,0.19617457200823843,47
1484,0,2388,1167,1221,0,0,0,1.0,1,1.0,1,1.0,1,0.20342304772964118,47
1485,3,2391,1167,1224,0,0,0,1.0,1,1.0,1,1.0,1,0.19315218215417498,47
1486,0,2391,1167,1224,0,0,0,1.0,1,1.0,1,1.0,1,0.19028456938420701,49
1487,5,2396,1171,1225,0,0,0,1.0,1,1.0,1,1.0,1,0.16305891898473993,49
1488,1,2397,1172,1225,0,0,0,1.0,1,1.0,1,1.0,1,0.17459157610069972,51
1489,3,2400,1173,1227,0,0,0,1.0,1,1.0,1,1.0,1,0.1820437233513868,52
1490,0,2400,1173,1227,0,0,0,1.0,1,1.0,1,1.0,1,0.1820437233513868,52
1491,3,2403,1176,1227,0,0,0,1.0,1,1.0,1,1.0,1,0.20336091114221336,53
1492,8,2411,1180,1231,0,0,0,1.0,1,1.0,1,1.0,1,0.18707380842248342,53
1493,1,2412,1180,1232,0,0,0,1.0,1,1.0,1,1.0,1,0.13445985459728207,52
1494,2,2414,1182,1232,0,0,0,1.0,1,1.0,1,1.0,1,0.14333530530227584,50
1495,3,2417,1184,1233,0,0,0,1.0,1,1.0,1,1.0,1,0.10229801485725737,50
1496,1,2418,1185,1233,0,0,0,1.0,1,1.0,1,1.0,1,0.15434410730775722,52
1497,1,2419,1186,1233,0,0,0,1.0,1,1.0,1,1.0,1,0.1730634495102663,51
1498,1,2420,1187,1233,0,0,0,1.0,1,1.0,1,1.0,1,0.1864595802589112,50
1499,1,2421,1187,1234,0,0,0,1.0,1,1.0,1,1.0,1,0.14998899790564144,50
1500,3,2424,1189,1235,0,0,0,1.0,1,1.0,1,1.0,1,0.17921765886372037,49
1501,1,2425,1189,1236,0,0,0,1.0,1,1.0,1,1.0,1,0.15278374467156852,47
1502,3,2428,1192,1236,0,0,0,1.0,1,1.0,1,1.0,1,0.21593727457891232,47
1503,2,2430,1193,1237,0,0,0,1.0,1,1.0,1,1.0,1,0.17536170906541157,47
1504,2,2432,1195,1237,0,0,0,1.0,1,1.0,1,1.0,1,0.18474616053199555,48
1505,3,2435,1197,1238,0,0,0,1.0,1,1.0,1,1.0,1,0.17270802526400753,47
1506,2,2437,1199,1238,0,0,0,1.0,1,1.0,1,1.0,1,0.19164629302789105,47
1507,4,2441,1202,1239,0,0,0,1.0,1,1.0,1,1.0,1,0.21159969063514852,45
1508,1,2442,1203,1239,0,0,0,1.0,1,1.0,1,1.0,1,0.2077491546336328,45
1509,3,2445,1206,1239,0,0,0,1.0,1,1.0,1,1.0,1,0.24643922871906787,44
1510,2,2447,1208,1239,0,0,0,1.0,1,1.0,1,1.0,1,0.2991003496415582,42
1511,2,2449,1208,1241,0,0,0,1.0,1,1.0,1,1.0,1,0.26083940495674635,40
1512,4,2453,1212,1241,0,0,0,1.0,1,1.0,1,1.0,1,0.35109362042852077,39
1513,3,2456,1212,1244,0,0,0,1.0,1,1.0,1,1.0,1,0.27480293803367756,39
1514,1,2457,1212,1245,0,0,0,1.0,1,1.0,1,1.0,1,0.2466623423663958,38
1515,1,2458,1213,1245,0,0,0,1.0,1,1.0,1,1.0,1,0.27020666699639695,39
1516,3,2461,1213,1248,0,0,0,1.0,1,1.0,1,1.0,1,0.2131240727216189,39
1517,2,2463,1214,1249,0,0,0,1.0,1,1.0,1,1.0,1,0.2120500277664239,39
1518,1,2464,1215,1249,0,0,0,1.0,1,1.0,1,1.0,1,0.23741154020057745,39
1519,0,2464,1215,1249,0,0,0,1.0,1,1.0,1,1.0,1,0.23741154020057745,39
1520,3,2467,1216,1251,0,0,0,1.0,1,1.0,1,1.0,1,0.22383311682965698,39
1521,2,2469,1217,1252,0,0,0,1.0,1,1.0,1,1.0,1,0.24010734852763613,40
1522,1,2470,1218,1252,0,0,0,1.0,1,1.0,1,1.0,1,0.2608242150488319,40
1523,2,2472,1218,1254,0,0,0,1.0,1,1.0,1,1.0,1,0.24076154470307284,41
1524,1,2473,1219,1254,0,0,0,1.0,1,1.0,1,1.0,1,0.27773026677021595,42
1525,4,2477,1220,1257,0,0,0,1.0,1,1.0,1,1.0,1,0.21641637860682875,45
1526,1,2478,1220,1258,0,0,0,1.0,1,1.0,1,1.0,1,0.22137558605411903,46
1527,0,2478,1220,1258,0,0,0,1.0,1,1.0,1,1.0,1,0.22137558605411903,46
1528,0,2478,1220,1258,0,0,0,1.0,1,1.0,1,1.0,1,0.2261785573132852,47
1529,0,2478,1220,1258,0,0,0,1.0,1,1.0,1,1.0,1,0.2261785573132852,47
1530,0,2478,1220,1258,0,0,0,1.0,1,1.0,1,1.0,1,0.23910342110381438,48
1531,1,2479,1220,1259,0,0,0,1.0,1,1.0,1,1.0,1,0.21333792175744057,46
1532,1,2480,1220,1260,0,0,0,1.0,1,1.0,1,1.0,1,0.17333675515856042,47
1533,0,2480,1220,1260,0,0,0,1.0,1,1.0,1,1.0,1,0.17752849217562602,46
1534,1,2481,1221,1260,0,0,0,1.0,1,1.0,1,1.0,1,0.15679926501949107,47
1535,1,2482,1222,1260,0,0,0,1.0,1,1.0,1,1.0,1,0.1540095179357793,47
1536,0,2482,1222,1260,0,0,0,1.0,1,1.0,1,1.0,1,0.1634234492554656,48
1537,0,2482,1222,1260,0,0,0,1.0,1,1.0,1,1.0,1,0.16660113594712722,46
1538,1,2483,1223,1260,0,0,0,1.0,1,1.0,1,1.0,1,0.1915157042312557,47
1539,1,2484,1223,1261,0,0,0,1.0,1,1.0,1,1.0,1,0.19340128064709528,47
1540,1,2485,1224,1261,0,0,0,1.0,1,1.0,1,1.0,1,0.2082962965909649,47
1541,0,2485,1224,1261,0,0,0,1.0,1,1.0,1,1.0,1,0.20771361770276112,47
1542,3,2488,1226,1262,0,0,0,1.0,1,1.0,1,1.0,1,0.25542621445856506,50
1543,3,2491,1229,1262,0,0,0,1.0,1,1.0,1,1.0,1,0.2738690884148223,47
1544,4,2495,1233,1262,0,0,0,1.0,1,1.0,1,1.0,1,0.3315573499822363,48
1545,7,2502,1234,1268,0,0,0,1.0,1,1.0,1,1.0,1,0.21117268165500286,47
1546,2,2504,1234,1270,0,0,0,1.0,1,1.0,1,1.0,1,0.1810261112073468,47
1547,1,2505,1235,1270,0,0,0,1.0,1,1.0,1,1.0,1,0.20821570097999292,47
1548,4,2509,1239,1270,0,0,0,1.0,1,1.0,1,1.0,1,0.23049786452252521,47
1549,6,2515,1244,1271,0,0,0,1.0,1,1.0,1,1.0,1,0.22368054784392197,46
1550,3,2518,1245,1273,0,0,0,1.0,1,1.0,1,1.0,1,0.20762866072588712,44
1551,5,2523,1248,1275,0,0,0,1.0,1,1.0,1,1.0,1,0.21622187468623807,45
1552,3,2526,1251,1275,0,0,0,1.0,1,1.0,1,1.0,1,0.1783751174909247,43
1553,2,2528,1252,1276,0,0,0,1.0,1,1.0,1,1.0,1,0.16029399394551905,43
1554,1,2529,1253,1276,0,0,0,1.0,1,1.0,1,1.0,1,0.1738405781866916,41
1555,2,2531,1254,1277,0,0,0,1.0,1,1.0,1,1.0,1,0.22740854896800708,44
1556,2,2533,1255,1278,0,0,0,1.0,1,1.0,1,1.0,1,0.19804592625513232,45
1557,0,2533,1255,1278,0,0,0,1.0,1,1.0,1,1.0,1,0.19804592625513232,45
1558,2,2535,1255,1280,0,0,0,1.0,1,1.0,1,1.0,1,0.1763131937642203,46
1559,0,2535,1255,1280,0,0,0,1.0,1,1.0,1,1.0,1,0.17283059920277347,47
1560,2,2537,1257,1280,0,0,0,1.0,1,1.0,1,1.0,1,0.11799110590315685,46
1561,0,2537,1257,1280,0,0,0,1.0,1,1.0,1,1.0,1,0.11484284348035094,47
1562,0,2537,1257,1280,0,0,0,1.0,1,1.0,1,1.0,1,0.12450854343242689,47
1563,1,2538,1258,1280,0,0,0,1.0,1,1.0,1,1.0,1,0.14357066952569758,47
1564,0,2538,1258,1280,0,0,0,1.0,1,1.0,1,1.0,1,0.14357066952569758,47
1565,1,2539,1258,1281,0,0,0,1.0,1,1.0,1,1.0,1,0.17674545875919756,48
1566,0,2539,1258,1281,0,0,0,1.0,1,1.0,1,1.0,1,0.17674545875919756,48
1567,2,2541,1259,1282,0,0,0,1.0,1,1.0,1,1.0,1,0.20102637718133246,48
1568,4,2545,1262,1283,0,0,0,1.0,1,1.0,1,1.0,1,0.2486105455032514,48
1569,0,2545,1262,1283,0,0,0,1.0,1,1.0,1,1.0,1,0.2174953438270814,45
1570,0,2545,1262,1283,0,0,0,1.0,1,1.0,1,1.0,1,0.2065137346442874,44
1571,4,2549,1265,1284,0,0,0,1.0,1,1.0,1,1.0,1,0.2128965566823731,42
1572,4,2553,1265,1288,0,0,0,1.0,1,1.0,1,1.0,1,0.2161004222916465,43
1573,3,2556,1266,1290,0,0,0,1.0,1,1.0,1,1.0,1,0.21246084032896537,43
1574,3,2559,1269,1290,0,0,0,1.0,1,1.0,1,1.0,1,0.19531906545638938,42
1575,2,2561,1270,1291,0,0,0,1.0,1,1.0,1,1.0,1,0.1961376472521381,43
1576,3,2564,1273,1291,0,0,0,1.0,1,1.0,1,1.0,1,0.18255580997088425,41
1577,2,2566,1274,1292,0,0,0,1.0,1,1.0,1,1.0,1,0.22668032383205783,40
1578,0,2566,1274,1292,0,0,0,1.0,1,1.0,1,1.0,1,0.21134667097666787,40
1579,0,2566,1274,1292,0,0,0,1.0,1,1.0,1,1.0,1,0.21035266798788493,40
1580,1,2567,1275,1292,0,0,0,1.0,1,1.0,1,1.0,1,0.21351403218323503,40
1581,2,2569,1276,1293,0,0,0,1.0,1,1.0,1,1.0,1,0.21959626224819184,40
1582,7,2576,1280,1296,0,0,0,1.0,1,1.0,1,1.0,1,0.1978467915310634,40
1583,1,2577,1281,1296,0,0,0,1.0,1,1.0,1,1.0,1,0.21363793056372882,38
1584,2,2579,1283,1296,0,0,0,1.0,1,1.0,1,1.0,1,0.2044729532957066,39
1585,3,2582,1286,1296,0,0,0,1.0,1,1.0,1,1.0,1,0.19568270641171723,38
1586,3,2585,1289,1296,0,0,0,1.0,1,1.0,1,1.0,1,0.23886578320424728,38
1587,2,2587,1290,1297,0,0,0,1.0,1,1.0,1,1.0,1,0.1810734848891328,37
1588,6,2593,1293,1300,0,0,0,1.0,1,1.0,1,1.0,1,0.20268150837146204,39
1589,2,2595,1295,1300,0,0,0,1.0,1,1.0,1,1.0,1,0.23188957690069442,37
1590,1,2596,1296,1300,0,0,0,1.0,1,1.0,1,1.0,1,0.24110419469800362,37
1591,0,2596,1296,1300,0,0,0,1.0,1,1.0,1,1.0,1,0.27487942325157166,36
1592,2,2598,1296,1302,0,0,0,1.0,1,1.0,1,1.0,1,0.2558412499104309,34
1593,1,2599,1297,1302,0,0,0,1.0,1,1.0,1,1.0,1,0.31693936591697786,33
1594,0,2599,1297,1302,0,0,0,1.0,1,1.0,1,1.0,1,0.3352834247250212,31
1595,3,2602,1298,1304,0,0,0,1.0,1,1.0,1,1.0,1,0.28250281027892554,34
1596,1,2603,1298,1305,0,0,0,1.0,1,1.0,1,1.0,1,0.25806031699982707,33
1597,0,2603,1298,1305,0,0,0,1.0,1,1.0,1,1.0,1,0.25806031699982707,33
1598,1,2604,1298,1306,0,0,0,1.0,1,1.0,1,1.0,1,0.20196955330053837,33
1599,1,2605,1298,1307,0,0,0,1.0,1,1.0,1,1.0,1,0.1858023450068693,33
1600,0,2605,1298,1307,0,0,0,1.0,1,1.0,1,1.0,1,0.20163392633846527,34
1601,3,2608,1300,1308,0,0,0,1.0,1,1.0,1,1.0,1,0.24048907429096084,35
1602,0,2608,1300,1308,0,0,0,1.0,1,1.0,1,1.0,1,0.21720198516332226,36
1603,2,2610,1301,1309,0,0,0,1.0,1,1.0,1,1.0,1,0.25909418776395693,38
1604,1,2611,1302,1309,0,0,0,1.0,1,1.0,1,1.0,1,0.24329771984686824,38
1605,1,2612,1302,1310,0,0,0,1.0,1,1.0,1,1.0,1,0.22505455722190773,38
1606,6,2618,1305,1313,0,0,0,1.0,1,1.0,1,1.0,1,0.23685186959664697,39
1607,1,2619,1306,1313,0,0,0,1.0,1,1.0,1,1.0,1,0.2708771374908119,37
1608,2,2621,1307,1314,0,0,0,1.0,1,1.0,1,1.0,1,0.2925983948241259,36
1609,1,2622,1307,1315,0,0,0,1.0,1,1.0,1,1.0,1,0.22150175229626698,34
1610,2,2624,1308,1316,0,0,0,1.0,1,1.0,1,1.0,1,0.21945270387120153,34
1611,4,2628,1311,1317,0,0,0,1.0,1,1.0,1,1.0,1,0.2307470763806178,35
1612,0,2628,1311,1317,0,0,0,1.0,1,1.0,1,1.0,1,0.262530448584673,33
1613,5,2633,1312,1321,0,0,0,1.0,1,1.0,1,1.0,1,0.19764753678266353,34
1614,1,2634,1313,1321,0,0,0,1.0,1,1.0,1,1.0,1,0.21389467604206444,35
1615,1,2635,1313,1322,0,0,0,1.0,1,1.0,1,1.0,1,0.18553055956855893,35
1616,0,2635,1313,1322,0,0,0,1.0,1,1.0,1,1.0,1,0.17483645836541026,37
1617,1,2636,1314,1322,0,0,0,1.0,1,1.0,1,1.0,1,0.21268405147086375,38
1618,1,2637,1315,1322,0,0,0,1.0,1,1.0,1,1.0,1,0.2239736219356355,38
1619,1,2638,1316,1322,0,0,0,1.0,1,1.0,1,1.0,1,0.22396701100696415,38
1620,2,2640,1317,1323,0,0,0,1.0,1,1.0,1,1.0,1,0.2140387667032949,39
1621,1,2641,1318,1323,0,0,0,1.0,1,1.0,1,1.0,1,0.1985520940527721,37
1622,1,2642,1319,1323,0,0,0,1.0,1,1.0,1,1.0,1,0.24776502219060614,37
1623,2,2644,1321,1323,0,0,0,1.0,1,1.0,1,1.0,1,0.28036970331868255,37
1624,2,2646,1322,1324,0,0,0,1.0,1,1.0,1,1.0,1,0.2722355549855377,37
1625,0,2646,1322,1324,0,0,0,1.0,1,1.0,1,1.0,1,0.3007190560195394,35
1626,2,2648,1323,1325,0,0,0,1.0,1,1.0,1,1.0,1,0.31511666608961875,35
1627,0,2648,1323,1325,0,0,0,1.0,1,1.0,1,1.0,1,0.3011448247940168,34
1628,4,2652,1325,1327,0,0,0,1.0,1,1.0,1,1.0,1,0.30459237174192644,35
1629,3,2655,1328,1327,0,0,0,1.0,1,1.0,1,1.0,1,0.31864614014755416,34
1630,0,2655,1328,1327,0,0,0,1.0,1,1.0,1,1.0,1,0.2971712414460327,32
1631,2,2657,1328,1329,0,0,0,1.0,1,1.0,1,1.0,1,0.2878130907883899,33
1632,0,2657,1328,1329,0,0,0,1.0,1,1.0,1,1.0,1,0.28766125747839294,32
1633,0,2657,1328,1329,0,0,0,1.0,1,1.0,1,1.0,1,0.28076708323958494,31
1634,1,2658,1329,1329,0,0,0,1.0,1,1.0,1,1.0,1,0.3355229559743861,31
1635,0,2658,1329,1329,0,0,0,1.0,1,1.0,1,1.0,1,0.3437864623551146,31
1636,3,2661,1330,1331,0,0,0,1.0,1,1.0,1,1.0,1,0.30485630939405206,33
1637,1,2662,1330,1332,0,0,0,1.0,1,1.0,1,1.0,1,0.289328798898755,33
1638,0,2662,1330,1332,0,0,0,1.0,1,1.0,1,1.0,1,0.3058245610114618,36
1639,0,2662,1330,1332,0,0,0,1.0,1,1.0,1,1.0,1,0.3058245610114618,36
1640,1,2663,1331,1332,0,0,0,1.0,1,1.0,1,1.0,1,0.3284802102112859,36
1641,2,2665,1332,1333,0,0,0,1.0,1,1.0,1,1.0,1,0.30230713613856003,38
1642,1,2666,1333,1333,0,0,0,1.0,1,1.0,1,1.0,1,0.29310056348314,37
1643,2,2668,1335,1333,0,0,0,1.0,1,1.0,1,1.0,1,0.30769526730951896,37
1644,3,2671,1337,1334,0,0,0,1.0,1,1.0,1,1.0,1,0.3734898567519141,38
1645,1,2672,1337,1335,0,0,0,1.0,1,1.0,1,1.0,1,0.36436259408412336,36
1646,0,2672,1337,1335,0,0,0,1.0,1,1.0,1,1.0,1,0.3757145448515124,37
1647,1,2673,1338,1335,0,0,0,1.0,1,1.0,1,1.0,1,0.44173128749226753,35
1648,6,2679,1338,1341,0,0,0,1.0,1,1.0,1,1.0,1,0.3420334462616396,38
1649,1,2680,1339,1341,0,0,0,1.0,1,1.0,1,1.0,1,0.35774638503070644,35
1650,0,2680,1339,1341,0,0,0,1.0,1,1.0,1,1.0,1,0.3712597520959485,34
1651,1,2681,1339,1342,0,0,0,1.0,1,1.0,1,1.0,1,0.3943221246225262,32
1652,2,2683,1339,1344,0,0,0,1.0,1,1.0,1,1.0,1,0.33102782262462777,33
1653,0,2683,1339,1344,0,0,0,1.0,1,1.0,1,1.0,1,0.33102782262462777,33
1654,0,2683,1339,1344,0,0,0,1.0,1,1.0,1,1.0,1,0.34719884132443124,34
1655,2,2685,1339,1346,0,0,0,1.0,1,1.0,1,1.0,1,0.26887641543815144,35
1656,1,2686,1339,1347,0,0,0,1.0,1,1.0,1,1.0,1,0.24341527762744994,35
1657,0,2686,1339,1347,0,0,0,1.0,1,1.0,1,1.0,1,0.2557359841924394,36
1658,2,2688,1341,1347,0,0,0,1.0,1,1.0,1,1.0,1,0.23023095675801017,36
1659,1,2689,1341,1348,0,0,0,1.0,1,1.0,1,1.0,1,0.18653085166778338,36
1660,5,2694,1345,1349,0,0,0,1.0,1,1.0,1,1.0,1,0.18761552752561259,38
1661,0,2694,1345,1349,0,0,0,1.0,1,1.0,1,1.0,1,0.18761552752561259,38
1662,3,2697,1348,1349,0,0,0,1.0,1,1.0,1,1.0,1,0.22663540815304717,39
1663,1,2698,1349,1349,0,0,0,1.0,1,1.0,1,1.0,1,0.26683378282005665,40
1664,2,2700,1349,1351,0,0,0,1.0,1,1.0,1,1.0,1,0.2702058024387689,39
1665,4,2704,1350,1354,0,0,0,1.0,1,1.0,1,1.0,1,0.213667045206499,40
1666,0,2704,1350,1354,0,0,0,1.0,1,1.0,1,1.0,1,0.251094280565706,40
1667,3,2707,1351,1356,0,0,0,1.0,1,1.0,1,1.0,1,0.23036257495276544,40
1668,3,2710,1353,1357,0,0,0,1.0,1,1.0,1,1.0,1,0.19078761423590895,41
1669,0,2710,1353,1357,0,0,0,1.0,1,1.0,1,1.0,1,0.17368626769134857,40
1670,2,2712,1355,1357,0,0,0,1.0,1,1.0,1,1.0,1,0.18791396433637303,40
1671,2,2714,1356,1358,0,0,0,1.0,1,1.0,1,1.0,1,0.1863409152145686,41
1672,1,2715,1357,1358,0,0,0,1.0,1,1.0,1,1.0,1,0.2329742306686813,40
1673,0,2715,1357,1358,0,0,0,1.0,1,1.0,1,1.0,1,0.22857940067303506,39
1674,2,2717,1357,1360,0,0,0,1.0,1,1.0,1,1.0,1,0.20670520411175267,40
1675,0,2717,1357,1360,0,0,0,1.0,1,1.0,1,1.0,1,0.21487630020089152,38
1676,1,2718,1358,1360,0,0,0,1.0,1,1.0,1,1.0,1,0.2418631577330385,39
1677,0,2718,1358,1360,0,0,0,1.0,1,1.0,1,1.0,1,0.2421479110450729,39
1678,0,2718,1358,1360,0,0,0,1.0,1,1.0,1,1.0,1,0.2421479110450729,39
1679,1,2719,1359,1360,0,0,0,1.0,1,1.0,1,1.0,1,0.24922546229278655,39
1680,4,2723,1360,1363,0,0,0,1.0,1,1.0,1,1.0,1,0.22695591395612078,41
1681,1,2724,1360,1364,0,0,0,1.0,1,1.0,1,1.0,1,0.1988501112668428,41
1682,3,2727,1361,1366,0,0,0,1.0,1,1.0,1,1.0,1,0.21859093445789224,43
1683,3,2730,1364,1366,0,0,0,1.0,1,1.0,1,1.0,1,0.2309606237724707,43
1684,1,2731,1365,1366,0,0,0,1.0,1,1.0,1,1.0,1,0.23648026957100174,42
1685,2,2733,1366,1367,0,0,0,1.0,1,1.0,1,1.0,1,0.23050893703800399,41
1686,5,2738,1368,1370,0,0,0,1.0,1,1.0,1,1.0,1,0.25148823042426344,41
1687,1,2739,1368,1371,0,0,0,1.0,1,1.0,1,1.0,1,0.21341369849899178,40
1688,2,2741,1370,1371,0,0,0,1.0,1,1.0,1,1.0,1,0.21811636502663934,39
1689,3,2744,1372,1372,0,0,0,1.0,1,1.0,1,1.0,1,0.23545628444792227,38
1690,1,2745,1373,1372,0,0,0,1.0,1,1.0,1,1.0,1,0.23624329551797735,38
1691,2,2747,1373,1374,0,0,0,1.0,1,1.0,1,1.0,1,0.23643899368792487,36
1692,0,2747,1373,1374,0,0,0,1.0,1,1.0,1,1.0,1,0.20162962880429305,36
1693,1,2748,1374,1374,0,0,0,1.0,1,1.0,1,1.0,1,0.21357258374253782,35
1694,1,2749,1375,1374,0,0,0,1.0,1,1.0,1,1.0,1,0.22766608483755588,33
1695,0,2749,1375,1374,0,0,0,1.0,1,1.0,1,1.0,1,0.24614828921805523,34
1696,1,2750,1376,1374,0,0,0,1.0,1,1.0,1,1.0,1,0.29413803021536056,35
1697,2,2752,1377,1375,0,0,0,1.0,1,1.0,1,1.0,1,0.29950236906146077,36
1698,4,2756,1379,1377,0,0,0,1.0,1,1.0,1,1.0,1,0.2900749767806517,38
1699,2,2758,1380,1378,0,0,0,1.0,1,1.0,1,1.0,1,0.3016928833781981,38
1700,2,2760,1380,1380,0,0,0,1.0,1,1.0,1,1.0,1,0.2889323425454163,39
1701,1,2761,1380,1381,0,0,0,1.0,1,1.0,1,1.0,1,0.2653957192403997,40
1702,4,2765,1383,1382,0,0,0,1.0,1,1.0,1,1.0,1,0.330440504453207,41
1703,1,2766,1383,1383,0,0,0,1.0,1,1.0,1,1.0,1,0.31683817561686206,41
1704,4,2770,1385,1385,0,0,0,1.0,1,1.0,1,1.0,1,0.27902468971064764,41
1705,1,2771,1386,1385,0,0,0,1.0,1,1.0,1,1.0,1,0.23886916905519778,40
1706,0,2771,1386,1385,0,0,0,1.0,1,1.0,1,1.0,1,0.23886916905519778,40
1707,2,2773,1387,1386,0,0,0,1.0,1,1.0,1,1.0,1,0.22588767076775873,39
1708,0,2773,1387,1386,0,0,0,1.0,1,1.0,1,1.0,1,0.22588767076775873,39
1709,1,2774,1388,1386,0,0,0,1.0,1,1.0,1,1.0,1,0.2495576371023648,38
1710,5,2779,1392,1387,0,0,0,1.0,1,1.0,1,1.0,1,0.2661539310736566,39
1711,2,2781,1392,1389,0,0,0,1.0,1,1.0,1,1.0,1,0.24548812636348347,38
1712,3,2784,1394,1390,0,0,0,1.0,1,1.0,1,1.0,1,0.23829319014748943,38
1713,0,2784,1394,1390,0,0,0,1.0,1,1.0,1,1.0,1,0.2382781678123166,37
1714,0,2784,1394,1390,0,0,0,1.0,1,1.0,1,1.0,1,0.2537675659649986,38
1715,1,2785,1394,1391,0,0,0,1.0,1,1.0,1,1.0,1,0.2546287679323327,40
1716,0,2785,1394,1391,0,0,0,1.0,1,1.0,1,1.0,1,0.25573377908093753,39
1717,0,2785,1394,1391,0,0,0,1.0,1,1.0,1,1.0,1,0.2493422197020967,38
1718,3,2788,1394,1394,0,0,0,1.0,1,1.0,1,1.0,1,0.23774387319903623,38
1719,1,2789,1395,1394,0,0,0,1.0,1,1.0,1,1.0,1,0.2558286549144068,38
1720,0,2789,1395,1394,0,0,0,1.0,1,1.0,1,1.0,1,0.25868259529357784,41
1721,0,2789,1395,1394,0,0,0,1.0,1,1.0,1,1.0,1,0.23007163445138226,39
1722,1,2790,1396,1394,0,0,0,1.0,1,1.0,1,1.0,1,0.25641672499240886,40
1723,1,2791,1397,1394,0,0,0,1.0,1,1.0,1,1.0,1,0.25686110122867095,38
1724,1,2792,1398,1394,0,0,0,1.0,1,1.0,1,1.0,1,0.2966556311424979,37
1725,2,2794,1398,1396,0,0,0,1.0,1,1.0,1,1.0,1,0.2440123569481318,38
1726,2,2796,1399,1397,0,0,0,1.0,1,1.0,1,1.0,1,0.2774076037450308,37
1727,2,2798,1399,1399,0,0,0,1.0,1,1.0,1,1.0,1,0.21755019936646924,37
1728,0,2798,1399,1399,0,0,0,1.0,1,1.0,1,1.0,1,0.22656135213709516,35
1729,1,2799,1400,1399,0,0,0,1.0,1,1.0,1,1.0,1,0.22786184443322272,37
1730,1,2800,1401,1399,0,0,0,1.0,1,1.0,1,1.0,1,0.30483875241193203,37
1731,2,2802,1402,1400,0,0,0,1.0,1,1.0,1,1.0,1,0.30953109340928137,37
1732,3,2805,1402,1403,0,0,0,1.0,1,1.0,1,1.0,1,0.2832980251641796,37
1733,2,2807,1404,1403,0,0,0,1.0,1,1.0,1,1.0,1,0.2781965281013487,36
1734,2,2809,1404,1405,0,0,0,1.0,1,1.0,1,1.0,1,0.2553667209947734,35
1735,1,2810,1405,1405,0,0,0,1.0,1,1.0,1,1.0,1,0.24588478605103542,34
1736,1,2811,1405,1406,0,0,0,1.0,1,1.0,1,1.0,1,0.23815697040976658,35
1737,2,2813,1407,1406,0,0,0,1.0,1,1.0,1,1.0,1,0.24393393737885813,36
1738,1,2814,1408,1406,0,0,0,1.0,1,1.0,1,1.0,1,0.3031143710496088,37
1739,2,2816,1409,1407,0,0,0,1.0,1,1.0,1,1.0,1,0.26605564313546604,38
1740,2,2818,1409,1409,0,0,0,1.0,1,1.0,1,1.0,1,0.2372299085360661,37
1741,1,2819,1409,1410,0,0,0,1.0,1,1.0,1,1.0,1,0.24923413386042115,38
1742,3,2822,1411,1411,0,0,0,1.0,1,1.0,1,1.0,1,0.2825129500512344,39
1743,2,2824,1412,1412,0,0,0,1.0,1,1.0,1,1.0,1,0.2780106627772037,37
1744,6,2830,1416,1414,0,0,0,1.0,1,1.0,1,1.0,1,0.30450160959209693,38
1745,2,2832,1416,1416,0,0,0,1.0,1,1.0,1,1.0,1,0.26616488014224876,37
1746,1,2833,1416,1417,0,0,0,1.0,1,1.0,1,1.0,1,0.23905665986907487,38
1747,3,2836,1417,1419,0,0,0,1.0,1,1.0,1,1.0,1,0.22990263826167862,38
1748,2,2838,1418,1420,0,0,0,1.0,1,1.0,1,1.0,1,0.23776822215946647,38
1749,1,2839,1418,1421,0,0,0,1.0,1,1.0,1,1.0,1,0.20152354689012916,37
1750,2,2841,1418,1423,0,0,0,1.0,1,1.0,1,1.0,1,0.19395558116652484,39
1751,0,2841,1418,1423,0,0,0,1.0,1,1.0,1,1.0,1,0.20105761647194634,38
1752,1,2842,1419,1423,0,0,0,1.0,1,1.0,1,1.0,1,0.17737881816342665,39
1753,0,2842,1419,1423,0,0,0,1.0,1,1.0,1,1.0,1,0.18020325260309686,40
1754,2,2844,1420,1424,0,0,0,1.0,1,1.0,1,1.0,1,0.22349651059411024,41
1755,2,2846,1420,1426,0,0,0,1.0,1,1.0,1,1.0,1,0.1888996385081055,41
1756,1,2847,1421,1426,0,0,0,1.0,1,1.0,1,1.0,1,0.2185429616983385,42
1757,2,2849,1421,1428,0,0,0,1.0,1,1.0,1,1.0,1,0.19979088674401738,42
1758,1,2850,1422,1428,0,0,0,1.0,1,1.0,1,1.0,1,0.21841987871267807,42
1759,0,2850,1422,1428,0,0,0,1.0,1,1.0,1,1.0,1,0.24012588889435518,39
1760,1,2851,1423,1428,0,0,0,1.0,1,1.0,1,1.0,1,0.3103997620210504,39
1761,6,2857,1425,1432,0,0,0,1.0,1,1.0,1,1.0,1,0.239513087946753,38
1762,0,2857,1425,1432,0,0,0,1.0,1,1.0,1,1.0,1,0.2374850460234748,37
1763,1,2858,1426,1432,0,0,0,1.0,1,1.0,1,1.0,1,0.26431239967596276,37
1764,1,2859,1427,1432,0,0,0,1.0,1,1.0,1,1.0,1,0.2322543543478948,36
1765,3,2862,1429,1433,0,0,0,1.0,1,1.0,1,1.0,1,0.2044973560875809,37
1766,2,2864,1429,1435,0,0,0,1.0,1,1.0,1,1.0,1,0.15788715244858184,36
1767,1,2865,1430,1435,0,0,0,1.0,1,1.0,1,1.0,1,0.18611776520814674,36
1768,0,2865,1430,1435,0,0,0,1.0,1,1.0,1,1.0,1,0.18611776520814674,36
1769,2,2867,1431,1436,0,0,0,1.0,1,1.0,1,1.0,1,0.16767843392538595,38
1770,2,2869,1432,1437,0,0,0,1.0,1,1.0,1,1.0,1,0.1744074328351855,38
1771,0,2869,1432,1437,0,0,0,1.0,1,1.0,1,1.0,1,0.1744074328351855,38
1772,1,2870,1433,1437,0,0,0,1.0,1,1.0,1,1.0,1,0.17421543856014335,40
1773,1,2871,1434,1437,0,0,0,1.0,1,1.0,1,1.0,1,0.21086152770778935,40
1774,1,2872,1434,1438,0,0,0,1.0,1,1.0,1,1.0,1,0.18283339034569243,40
1775,1,2873,1434,1439,0,0,0,1.0,1,1.0,1,1.0,1,0.18154889411827385,41
1776,1,2874,1435,1439,0,0,0,1.0,1,1.0,1,1.0,1,0.1822252595725049,43
1777,0,2874,1435,1439,0,0,0,1.0,1,1.0,1,1.0,1,0.1926998101238842,44
1778,2,2876,1437,1439,0,0,0,1.0,1,1.0,1,1.0,1,0.24240064115220103,44
1779,1,2877,1437,1440,0,0,0,1.0,1,1.0,1,1.0,1,0.21664272195130854,44
1780,2,2879,1438,1441,0,0,0,1.0,1,1.0,1,1.0,1,0.22460428017690132,46
1781,3,2882,1439,1443,0,0,0,1.0,1,1.0,1,1.0,1,0.185976230631654,46
1782,3,2885,1441,1444,0,0,0,1.0,1,1.0,1,1.0,1,0.22446036883467724,45
1783,0,2885,1441,1444,0,0,0,1.0,1,1.0,1,1.0,1,0.21754337350234534,44
1784,1,2886,1442,1444,0,0,0,1.0,1,1.0,1,1.0,1,0.2508979361978574,44
1785,3,2889,1444,1445,0,0,0,1.0,1,1.0,1,1.0,1,0.23441287372492622,42
1786,2,2891,1445,1446,0,0,0,1.0,1,1.0,1,1.0,1,0.24551525873741126,42
1787,1,2892,1445,1447,0,0,0,1.0,1,1.0,1,1.0,1,0.23390490786969953,41
1788,4,2896,1447,1449,0,0,0,1.0,1,1.0,1,1.0,1,0.2147876994658769,41
1789,2,2898,1449,1449,0,0,0,1.0,1,1.0,1,1.0,1,0.22207783352897467,41
1790,2,2900,1451,1449,0,0,0,1.0,1,1.0,1,1.0,1,0.27336983496071504,41
1791,3,2903,1453,1450,0,0,0,1.0,1,1.0,1,1.0,1,0.25800756340765496,41
1792,2,2905,1454,1451,0,0,0,1.0,1,1.0,1,1.0,1,0.21545771351673215,43
1793,2,2907,1455,1452,0,0,0,1.0,1,1.0,1,1.0,1,0.15753038764059363,43
1794,2,2909,1457,1452,0,0,0,1.0,1,1.0,1,1.0,1,0.17701656997857476,41
1795,3,2912,1459,1453,0,0,0,1.0,1,1.0,1,1.0,1,0.22522206089726066,41
1796,3,2915,1460,1455,0,0,0,1.0,1,1.0,1,1.0,1,0.22713182052011935,40
1797,3,2918,1461,1457,0,0,0,1.0,1,1.0,1,1.0,1,0.24417667550899258,38
1798,0,2918,1461,1457,0,0,0,1.0,1,1.0,1,1.0,1,0.24417667550899258,38
1799,1,2919,1462,1457,0,0,0,1.0,1,1.0,1,1.0,1,0.2696381930550899,37
1800,2,2921,1463,1458,0,0,0,1.0,1,1.0,1,1.0,1,0.28509188519378953,35
1801,0,2921,1463,1458,0,0,0,1.0,1,1.0,1,1.0,1,0.28031579023607645,34
1802,0,2921,1463,1458,0,0,0,1.0,1,1.0,1,1.0,1,0.2759926204793551,33
1803,3,2924,1465,1459,0,0,0,1.0,1,1.0,1,1.0,1,0.27535585091704357,33
1804,1,2925,1466,1459,0,0,0,1.0,1,1.0,1,1.0,1,0.2848367672878592,33
1805,1,2926,1466,1460,0,0,0,1.0,1,1.0,1,1.0,1,0.26571458487891925,35
1806,1,2927,1466,1461,0,0,0,1.0,1,1.0,1,1.0,1,0.23237465600729793,36
1807,0,2927,1466,1461,0,0,0,1.0,1,1.0,1,1.0,1,0.25514216504563036,35
1808,2,2929,1467,1462,0,0,0,1.0,1,1.0,1,1.0,1,0.28415173477204686,37
1809,3,2932,1467,1465,0,0,0,1.0,1,1.0,1,1.0,1,0.281222408362196,35
1810,1,2933,1468,1465,0,0,0,1.0,1,1.0,1,1.0,1,0.27613300110307937,36
1811,0,2933,1468,1465,0,0,0,1.0,1,1.0,1,1.0,1,0.2777906729442411,34
1812,0,2933,1468,1465,0,0,0,1.0,1,1.0,1,1.0,1,0.2978680424791075,36
1813,1,2934,1468,1466,0,0,0,1.0,1,1.0,1,1.0,1,0.30593534471646566,35
1814,1,2935,1468,1467,0,0,0,1.0,1,1.0,1,1.0,1,0.3081526857356623,36
1815,1,2936,1468,1468,0,0,0,1.0,1,1.0,1,1.0,1,0.289355257996624,35
1816,1,2937,1469,1468,0,0,0,1.0,1,1.0,1,1.0,1,0.27587106243427145,35
1817,1,2938,1470,1468,0,0,0,1.0,1,1.0,1,1.0,1,0.2661452492930472,35
1818,3,2941,1473,1468,0,0,0,1.0,1,1.0,1,1.0,1,0.22890168925471768,36
1819,2,2943,1475,1468,0,0,0,1.0,1,1.0,1,1.0,1,0.22712477484557195,37
1820,2,2945,1475,1470,0,0,0,1.0,1,1.0,1,1.0,1,0.1708371943440249,37
1821,0,2945,1475,1470,0,0,0,1.0,1,1.0,1,1.0,1,0.1735847504312328,38
1822,6,2951,1479,1472,0,0,0,1.0,1,1.0,1,1.0,1,0.2629429215155133,37
1823,3,2954,1481,1473,0,0,0,1.0,1,1.0,1,1.0,1,0.2747965406917853,36
1824,1,2955,1482,1473,0,0,0,1.0,1,1.0,1,1.0,1,0.25680810646234675,36
1825,1,2956,1483,1473,0,0,0,1.0,1,1.0,1,1.0,1,0.26039361929930016,34
1826,3,2959,1485,1474,0,0,0,1.0,1,1.0,1,1.0,1,0.20959545457639592,35
1827,2,2961,1486,1475,0,0,0,1.0,1,1.0,1,1.0,1,0.20550613345390967,34
1828,2,2963,1488,1475,0,0,0,1.0,1,1.0,1,1.0,1,0.2146574242803909,33
1829,1,2964,1489,1475,0,0,0,1.0,1,1.0,1,1.0,1,0.20467363631598456,31
1830,0,2964,1489,1475,0,0,0,1.0,1,1.0,1,1.0,1,0.20270550463467654,31
1831,1,2965,1490,1475,0,0,0,1.0,1,1.0,1,1.0,1,0.20062102233054166,30
1832,0,2965,1490,1475,0,0,0,1.0,1,1.0,1,1.0,1,0.19537575267389648,29
1833,4,2969,1494,1475,0,0,0,1.0,1,1.0,1,1.0,1,0.3629622250935226,28
1834,4,2973,1495,1478,0,0,0,1.0,1,1.0,1,1.0,1,0.3296067483518065,27
1835,4,2977,1498,1479,0,0,0,1.0,1,1.0,1,1.0,1,0.3665404529688383,26
1836,1,2978,1498,1480,0,0,0,1.0,1,1.0,1,1.0,1,0.39352438944632323,26
1837,4,2982,1498,1484,0,0,0,1.0,1,1.0,1,1.0,1,0.27088719780523,25
1838,0,2982,1498,1484,0,0,0,1.0,1,1.0,1,1.0,1,0.255801688265176,25
1839,0,2982,1498,1484,0,0,0,1.0,1,1.0,1,1.0,1,0.3086955942454522,24
1840,2,2984,1499,1485,0,0,0,1.0,1,1.0,1,1.0,1,0.40005896311528855,23
1841,2,2986,1499,1487,0,0,0,1.0,1,1.0,1,1.0,1,0.3136379162008661,22
1842,1,2987,1500,1487,0,0,0,1.0,1,1.0,1,1.0,1,0.35341233425983526,23
1843,1,2988,1501,1487,0,0,0,1.0,1,1.0,1,1.0,1,0.34648915682851467,23
1844,0,2988,1501,1487,0,0,0,1.0,1,1.0,1,1.0,1,0.34648915682851467,23
1845,2,2990,1503,1487,0,0,0,1.0,1,1.0,1,1.0,1,0.37243508446570694,23
1846,1,2991,1503,1488,0,0,0,1.0,1,1.0,1,1.0,1,0.3390028640102596,23
1847,0,2991,1503,1488,0,0,0,1.0,1,1.0,1,1.0,1,0.35790369676580247,24
1848,0,2991,1503,1488,0,0,0,1.0,1,1.0,1,1.0,1,0.35790369676580247,24
1849,0,2991,1503,1488,0,0,0,1.0,1,1.0,1,1.0,1,0.38054843272203775,25
1850,0,2991,1503,1488,0,0,0,1.0,1,1.0,1,1.0,1,0.38054843272203775,25
1851,0,2991,1503,1488,0,0,0,1.0,1,1.0,1,1.0,1,0.38054843272203775,25
1852,0,2991,1503,1488,0,0,0,1.0,1,1.0,1,1.0,1,0.38054843272203775,25
1853,0,2991,1503,1488,0,0,0,1.0,1,1.0,1,1.0,1,0.39902486903106277,25
1854,0,2991,1503,1488,0,0,0,1.0,1,1.0,1,1.0,1,0.39902486903106277,25
1855,0,2991,1503,1488,0,0,0,1.0,1,1.0,1,1.0,1,0.40890303633834557,26
1856,1,2992,1504,1488,0,0,0,1.0,1,1.0,1,1.0,1,0.36378269082119025,27
1857,0,2992,1504,1488,0,0,0,1.0,1,1.0,1,1.0,1,0.3510485010953419,28
1858,3,2995,1506,1489,0,0,0,1.0,1,1.0,1,1.0,1,0.3515000490928178,28
1859,4,2999,1508,1491,0,0,0,1.0,1,1.0,1,1.0,1,0.3544000884934076,28
1860,0,2999,1508,1491,0,0,0,1.0,1,1.0,1,1.0,1,0.3544000884934076,28
1861,0,2999,1508,1491,0,0,0,1.0,1,1.0,1,1.0,1,0.3544000884934076,28
1862,0,2999,1508,1491,0,0,0,1.0,1,1.0,1,1.0,1,0.3544000884934076,28
1863,1,3000,1509,1491,0,0,0,1.0,1,1.0,1,1.0,1,0.36803424891057074,29
1864,1,3001,1510,1491,0,0,0,1.0,1,1.0,1,1.0,1,0.3531507465853049,27
1865,2,3003,1511,1492,0,0,0,1.0,1,1.0,1,1.0,1,0.37502460746414534,26
1866,1,3004,1512,1492,0,0,0,1.0,1,1.0,1,1.0,1,0.4131382361450689,26
1867,0,3004,1512,1492,0,0,0,1.0,1,1.0,1,1.0,1,0.4131382361450689,26
1868,1,3005,1512,1493,0,0,0,1.0,1,1.0,1,1.0,1,0.36815677777152883,26
1869,1,3006,1512,1494,0,0,0,1.0,1,1.0,1,1.0,1,0.3503353971996653,26
1870,0,3006,1512,1494,0,0,0,1.0,1,1.0,1,1.0,1,0.3687372051695262,27
1871,1,3007,1513,1494,0,0,0,1.0,1,1.0,1,1.0,1,0.37556449371887085,27
1872,0,3007,1513,1494,0,0,0,1.0,1,1.0,1,1.0,1,0.36728561565154577,25
1873,1,3008,1513,1495,0,0,0,1.0,1,1.0,1,1.0,1,0.3080033584586235,25
1874,1,3009,1513,1496,0,0,0,1.0,1,1.0,1,1.0,1,0.3500557256094804,25
1875,1,3010,1513,1497,0,0,0,1.0,1,1.0,1,1.0,1,0.3092606155787854,25
1876,0,3010,1513,1497,0,0,0,1.0,1,1.0,1,1.0,1,0.3075182304186324,26
1877,0,3010,1513,1497,0,0,0,1.0,1,1.0,1,1.0,1,0.29464292463129677,27
1878,2,3012,1515,1497,0,0,0,1.0,1,1.0,1,1.0,1,0.3128347551897002,28
1879,1,3013,1515,1498,0,0,0,1.0,1,1.0,1,1.0,1,0.26760406729543385,29
1880,0,3013,1515,1498,0,0,0,1.0,1,1.0,1,1.0,1,0.26760406729543385,29
1881,0,3013,1515,1498,0,0,0,1.0,1,1.0,1,1.0,1,0.26760406729543385,29
1882,0,3013,1515,1498,0,0,0,1.0,1,1.0,1,1.0,1,0.2583697527166458,28
1883,0,3013,1515,1498,0,0,0,1.0,1,1.0,1,1.0,1,0.2583697527166458,28
1884,1,3014,1516,1498,0,0,0,1.0,1,1.0,1,1.0,1,0.26564031293173374,28
1885,0,3014,1516,1498,0,0,0,1.0,1,1.0,1,1.0,1,0.26564031293173374,28
1886,0,3014,1516,1498,0,0,0,1.0,1,1.0,1,1.0,1,0.26156695691978205,29
1887,0,3014,1516,1498,0,0,0,1.0,1,1.0,1,1.0,1,0.26156695691978205,29
1888,0,3014,1516,1498,0,0,0,1.0,1,1.0,1,1.0,1,0.2946484762291318,31
1889,0,3014,1516,1498,0,0,0,1.0,1,1.0,1,1.0,1,0.2946484762291318,31
1890,1,3015,1517,1498,0,0,0,1.0,1,1.0,1,1.0,1,0.3105476943996127,31
1891,1,3016,1517,1499,0,0,0,1.0,1,1.0,1,1.0,1,0.31534144031829775,32
1892,0,3016,1517,1499,0,0,0,1.0,1,1.0,1,1.0,1,0.31534144031829775,32
1893,0,3016,1517,1499,0,0,0,1.0,1,1.0,1,1.0,1,0.31534144031829775,32
1894,0,3016,1517,1499,0,0,0,1.0,1,1.0,1,1.0,1,0.3054084729660124,33
1895,2,3018,1518,1500,0,0,0,1.0,1,1.0,1,1.0,1,0.2840641414437278,35
1896,0,3018,1518,1500,0,0,0,1.0,1,1.0,1,1.0,1,0.3115353545773891,34
1897,1,3019,1518,1501,0,0,0,1.0,1,1.0,1,1.0,1,0.2937406037070819,34
1898,0,3019,1518,1501,0,0,0,1.0,1,1.0,1,1.0,1,0.2937406037070819,34
1899,1,3020,1518,1502,0,0,0,1.0,1,1.0,1,1.0,1,0.2840292800124154,34
1900,2,3022,1518,1504,0,0,0,1.0,1,1.0,1,1.0,1,0.23164922641637137,35
1901,1,3023,1518,1505,0,0,0,1.0,1,1.0,1,1.0,1,0.20129787923217762,35
1902,0,3023,1518,1505,0,0,0,1.0,1,1.0,1,1.0,1,0.20129787923217762,35
1903,0,3023,1518,1505,0,0,0,1.0,1,1.0,1,1.0,1,0.20129787923217762,35
1904,0,3023,1518,1505,0,0,0,1.0,1,1.0,1,1.0,1,0.20129787923217762,35
1905,0,3023,1518,1505,0,0,0,1.0,1,1.0,1,1.0,1,0.1905036489577589,37
1906,0,3023,1518,1505,0,0,0,1.0,1,1.0,1,1.0,1,0.1905036489577589,37
1907,1,3024,1518,1506,0,0,0,1.0,1,1.0,1,1.0,1,0.1729541033895153,39
1908,0,3024,1518,1506,0,0,0,1.0,1,1.0,1,1.0,1,0.1729541033895153,39
1909,0,3024,1518,1506,0,0,0,1.0,1,1.0,1,1.0,1,0.18988311030156005,41
1910,0,3024,1518,1506,0,0,0,1.0,1,1.0,1,1.0,1,0.18988311030156005,41
1911,0,3024,1518,1506,0,0,0,1.0,1,1.0,1,1.0,1,0.22491249290799262,40
1912,3,3027,1521,1506,0,0,0,1.0,1,1.0,1,1.0,1,0.25969040865556087,39
1913,4,3031,1523,1508,0,0,0,1.0,1,1.0,1,1.0,1,0.2527101811183429,40
1914,1,3032,1524,1508,0,0,0,1.0,1,1.0,1,1.0,1,0.26042528811925,41
1915,5,3037,1526,1511,0,0,0,1.0,1,1.0,1,1.0,1,0.24238510120483014,42
1916,2,3039,1527,1512,0,0,0,1.0,1,1.0,1,1.0,1,0.2136765101204753,42
1917,1,3040,1528,1512,0,0,0,1.0,1,1.0,1,1.0,1,0.22886936580362968,41
1918,2,3042,1530,1512,0,0,0,1.0,1,1.0,1,1.0,1,0.23143303937138962,38
1919,2,3044,1531,1513,0,0,0,1.0,1,1.0,1,1.0,1,0.2714290521170414,38
1920,0,3044,1531,1513,0,0,0,1.0,1,1.0,1,1.0,1,0.294706374791286,38
1921,1,3045,1531,1514,0,0,0,1.0,1,1.0,1,1.0,1,0.24323650314390305,39
1922,0,3045,1531,1514,0,0,0,1.0,1,1.0,1,1.0,1,0.23436094899731702,40
1923,1,3046,1532,1514,0,0,0,1.0,1,1.0,1,1.0,1,0.22254103728343164,41
1924,4,3050,1535,1515,0,0,0,1.0,1,1.0,1,1.0,1,0.28504160871673984,41
1925,2,3052,1535,1517,0,0,0,1.0,1,1.0,1,1.0,1,0.20568352425387115,41
1926,0,3052,1535,1517,0,0,0,1.0,1,1.0,1,1.0,1,0.20568352425387115,41
1927,1,3053,1535,1518,0,0,0,1.0,1,1.0,1,1.0,1,0.1997049383952551,41
1928,2,3055,1537,1518,0,0,0,1.0,1,1.0,1,1.0,1,0.20103050713346188,42
1929,0,3055,1537,1518,0,0,0,1.0,1,1.0,1,1.0,1,0.2058286474800911,41
1930,0,3055,1537,1518,0,0,0,1.0,1,1.0,1,1.0,1,0.2058286474800911,41
1931,0,3055,1537,1518,0,0,0,1.0,1,1.0,1,1.0,1,0.2058286474800911,41
1932,0,3055,1537,1518,0,0,0,1.0,1,1.0,1,1.0,1,0.2058286474800911,41
1933,1,3056,1538,1518,0,0,0,1.0,1,1.0,1,1.0,1,0.25231961536134156,43
1934,0,3056,1538,1518,0,0,0,1.0,1,1.0,1,1.0,1,0.26171877224368173,44
1935,0,3056,1538,1518,0,0,0,1.0,1,1.0,1,1.0,1,0.24637025950540403,45
1936,2,3058,1538,1520,0,0,0,1.0,1,1.0,1,1.0,1,0.20288800965405113,48
1937,3,3061,1540,1521,0,0,0,1.0,1,1.0,1,1.0,1,0.21017058856439244,48
1938,1,3062,1541,1521,0,0,0,1.0,1,1.0,1,1.0,1,0.21401616683926034,48
1939,0,3062,1541,1521,0,0,0,1.0,1,1.0,1,1.0,1,0.21401616683926034,48
1940,0,3062,1541,1521,0,0,0,1.0,1,1.0,1,1.0,1,0.21401616683926034,48
1941,0,3062,1541,1521,0,0,0,1.0,1,1.0,1,1.0,1,0.21401616683926034,48
1942,3,3065,1542,1523,0,0,0,1.0,1,1.0,1,1.0,1,0.24057549647842655,49
1943,0,3065,1542,1523,0,0,0,1.0,1,1.0,1,1.0,1,0.23653104201661732,48
1944,4,3069,1545,1524,0,0,0,1.0,1,1.0,1,1.0,1,0.2811722476528512,47
1945,5,3074,1546,1528,0,0,0,1.0,1,1.0,1,1.0,1,0.24722559267024322,46
1946,3,3077,1547,1530,0,0,0,1.0,1,1.0,1,1.0,1,0.26641219421565665,46
1947,5,3082,1550,1532,0,0,0,1.0,1,1.0,1,1.0,1,0.32803645416999894,45
1948,2,3084,1550,1534,0,0,0,1.0,1,1.0,1,1.0,1,0.2726479399610932,46
1949,2,3086,1551,1535,0,0,0,1.0,1,1.0,1,1.0,1,0.29055032060973957,42
1950,0,3086,1551,1535,0,0,0,1.0,1,1.0,1,1.0,1,0.28731684362204835,40
1951,3,3089,1552,1537,0,0,0,1.0,1,1.0,1,1.0,1,0.3291427568577803,39
1952,1,3090,1553,1537,0,0,0,1.0,1,1.0,1,1.0,1,0.3670820315244484,35
1953,6,3096,1556,1540,0,0,0,1.0,1,1.0,1,1.0,1,0.31031472854509023,36
1954,1,3097,1557,1540,0,0,0,1.0,1,1.0,1,1.0,1,0.32942109570530054,34
1955,1,3098,1557,1541,0,0,0,1.0,1,1.0,1,1.0,1,0.32605509939469124,35
1956,7,3105,1559,1546,0,0,0,1.0,1,1.0,1,1.0,1,0.2514861863767527,37
1957,1,3106,1559,1547,0,0,0,1.0,1,1.0,1,1.0,1,0.23423341465268335,37
1958,0,3106,1559,1547,0,0,0,1.0,1,1.0,1,1.0,1,0.2312915939901613,39
1959,0,3106,1559,1547,0,0,0,1.0,1,1.0,1,1.0,1,0.24530971624378542,41
1960,1,3107,1560,1547,0,0,0,1.0,1,1.0,1,1.0,1,0.250223719672069,40
1961,1,3108,1560,1548,0,0,0,1.0,1,1.0,1,1.0,1,0.22957688398342016,41
1962,1,3109,1561,1548,0,0,0,1.0,1,1.0,1,1.0,1,0.28605811595679026,40
1963,2,3111,1561,1550,0,0,0,1.0,1,1.0,1,1.0,1,0.2805157227015918,41
1964,1,3112,1562,1550,0,0,0,1.0,1,1.0,1,1.0,1,0.2910634942405536,40
1965,1,3113,1562,1551,0,0,0,1.0,1,1.0,1,1.0,1,0.26363144249212755,41
1966,0,3113,1562,1551,0,0,0,1.0,1,1.0,1,1.0,1,0.26363144249212755,41
1967,1,3114,1563,1551,0,0,0,1.0,1,1.0,1,1.0,1,0.29480985481365385,42
1968,1,3115,1563,1552,0,0,0,1.0,1,1.0,1,1.0,1,0.2915941223532956,42
1969,2,3117,1563,1554,0,0,0,1.0,1,1.0,1,1.0,1,0.23523189007444273,43
1970,0,3117,1563,1554,0,0,0,1.0,1,1.0,1,1.0,1,0.25649763465106645,42
1971,0,3117,1563,1554,0,0,0,1.0,1,1.0,1,1.0,1,0.25649763465106645,42
1972,0,3117,1563,1554,0,0,0,1.0,1,1.0,1,1.0,1,0.25649763465106645,42
1973,1,3118,1563,1555,0,0,0,1.0,1,1.0,1,1.0,1,0.25361936683230263,43
1974,1,3119,1564,1555,0,0,0,1.0,1,1.0,1,1.0,1,0.2828659218100577,43
1975,2,3121,1564,1557,0,0,0,1.0,1,1.0,1,1.0,1,0.258809278431108,43
1976,1,3122,1565,1557,0,0,0,1.0,1,1.0,1,1.0,1,0.24907906522079892,43
1977,2,3124,1565,1559,0,0,0,1.0,1,1.0,1,1.0,1,0.26936290151503806,48
1978,4,3128,1568,1560,0,0,0,1.0,1,1.0,1,1.0,1,0.2824515809733586,48
1979,2,3130,1568,1562,0,0,0,1.0,1,1.0,1,1.0,1,0.2654731046220665,49
1980,2,3132,1568,1564,0,0,0,1.0,1,1.0,1,1.0,1,0.2456897392627375,50
1981,1,3133,1568,1565,0,0,0,1.0,1,1.0,1,1.0,1,0.23427197006284253,50
1982,2,3135,1570,1565,0,0,0,1.0,1,1.0,1,1.0,1,0.21788690502052852,50
1983,4,3139,1572,1567,0,0,0,1.0,1,1.0,1,1.0,1,0.18369005527015758,49
1984,2,3141,1574,1567,0,0,0,1.0,1,1.0,1,1.0,1,0.22717118757276422,48
1985,0,3141,1574,1567,0,0,0,1.0,1,1.0,1,1.0,1,0.20681103089598957,46
1986,1,3142,1574,1568,0,0,0,1.0,1,1.0,1,1.0,1,0.19661265488169383,46
1987,3,3145,1576,1569,0,0,0,1.0,1,1.0,1,1.0,1,0.21754098344180894,42
1988,1,3146,1576,1570,0,0,0,1.0,1,1.0,1,1.0,1,0.17542837717760545,40
1989,2,3148,1578,1570,0,0,0,1.0,1,1.0,1,1.0,1,0.185072986509103,38
1990,0,3148,1578,1570,0,0,0,1.0,1,1.0,1,1.0,1,0.16959586572082486,38
1991,2,3150,1580,1570,0,0,0,1.0,1,1.0,1,1.0,1,0.23921873597077875,38
1992,0,3150,1580,1570,0,0,0,1.0,1,1.0,1,1.0,1,0.25690004376402276,39
1993,3,3153,1582,1571,0,0,0,1.0,1,1.0,1,1.0,1,0.3449579383836899,38
1994,2,3155,1583,1572,0,0,0,1.0,1,1.0,1,1.0,1,0.3074131266159418,37
1995,3,3158,1584,1574,0,0,0,1.0,1,1.0,1,1.0,1,0.27976992074017587,37
1996,1,3159,1584,1575,0,0,0,1.0,1,1.0,1,1.0,1,0.2547889040568271,37
1997,1,3160,1584,1576,0,0,0,1.0,1,1.0,1,1.0,1,0.2613566929043842,35
1998,1,3161,1585,1576,0,0,0,1.0,1,1.0,1,1.0,1,0.29362516757659507,34
1999,1,3162,1586,1576,0,0,0,1.0,1,1.0,1,1.0,1,0.2712626765624854,35
2000,0,3162,1586,1576,0,0,0,1.0,1,1.0,1,1.0,1,0.2973450474601992,34
2001,0,3162,1586,1576,0,0,0,1.0,1,1.0,1,1.0,1,0.3218718070380588,35
2002,3,3165,1587,1578,0,0,0,1.0,1,1.0,1,1.0,1,0.29229730457322217,36
2003,2,3167,1587,1580,0,0,0,1.0,1,1.0,1,1.0,1,0.2790847721406322,37
2004,3,3170,1589,1581,0,0,0,1.0,1,1.0,1,1.0,1,0.27021774756748035,38
2005,1,3171,1590,1581,0,0,0,1.0,1,1.0,1,1.0,1,0.2608971906288999,38
2006,0,3171,1590,1581,0,0,0,1.0,1,1.0,1,1.0,1,0.2608971906288999,38
2007,2,3173,1591,1582,0,0,0,1.0,1,1.0,1,1.0,1,0.2335192094262032,40
2008,1,3174,1592,1582,0,0,0,1.0,1,1.0,1,1.0,1,0.22162080121096653,40
2009,3,3177,1594,1583,0,0,0,1.0,1,1.0,1,1.0,1,0.2099733707827997,41
2010,0,3177,1594,1583,0,0,0,1.0,1,1.0,1,1.0,1,0.2099733707827997,41
2011,0,3177,1594,1583,0,0,0,1.0,1,1.0,1,1.0,1,0.2099733707827997,41
2012,0,3177,1594,1583,0,0,0,1.0,1,1.0,1,1.0,1,0.2099733707827997,41
2013,0,3177,1594,1583,0,0,0,1.0,1,1.0,1,1.0,1,0.23382543932377695,43
2014,0,3177,1594,1583,0,0,0,1.0,1,1.0,1,1.0,1,0.25385133164517,43
2015,1,3178,1595,1583,0,0,0,1.0,1,1.0,1,1.0,1,0.24682672953889317,43
2016,3,3181,1596,1585,0,0,0,1.0,1,1.0,1,1.0,1,0.23951763447650712,44
2017,0,3181,1596,1585,0,0,0,1.0,1,1.0,1,1.0,1,0.23909308642953458,45
2018,3,3184,1599,1585,0,0,0,1.0,1,1.0,1,1.0,1,0.2231931374333648,46
2019,0,3184,1599,1585,0,0,0,1.0,1,1.0,1,1.0,1,0.21171718172438742,47
2020,1,3185,1599,1586,0,0,0,1.0,1,1.0,1,1.0,1,0.17457269068657083,47
2021,3,3188,1601,1587,0,0,0,1.0,1,1.0,1,1.0,1,0.17842609525360692,47
2022,2,3190,1602,1588,0,0,0,1.0,1,1.0,1,1.0,1,0.1925743343432892,48
2023,4,3194,1604,1590,0,0,0,1.0,1,1.0,1,1.0,1,0.20416687304537495,48
2024,3,3197,1607,1590,0,0,0,1.0,1,1.0,1,1.0,1,0.20110691040030945,45
2025,2,3199,1609,1590,0,0,0,1.0,1,1.0,1,1.0,1,0.23004093165022535,42
2026,4,3203,1612,1591,0,0,0,1.0,1,1.0,1,1.0,1,0.2368694288044656,44
2027,2,3205,1613,1592,0,0,0,1.0,1,1.0,1,1.0,1,0.23443066736863424,40
2028,2,3207,1614,1593,0,0,0,1.0,1,1.0,1,1.0,1,0.28438700776459525,39
2029,0,3207,1614,1593,0,0,0,1.0,1,1.0,1,1.0,1,0.31017614728072573,37
2030,2,3209,1615,1594,0,0,0,1.0,1,1.0,1,1.0,1,0.34777565425803664,34
2031,2,3211,1615,1596,0,0,0,1.0,1,1.0,1,1.0,1,0.3006079709128471,35
2032,2,3213,1616,1597,0,0,0,1.0,1,1.0,1,1.0,1,0.28046679831736093,34
2033,5,3218,1618,1600,0,0,0,1.0,1,1.0,1,1.0,1,0.2463563432906415,36
2034,1,3219,1619,1600,0,0,0,1.0,1,1.0,1,1.0,1,0.28991328585013115,34
2035,4,3223,1620,1603,0,0,0,1.0,1,1.0,1,1.0,1,0.24343666175614195,35
2036,1,3224,1621,1603,0,0,0,1.0,1,1.0,1,1.0,1,0.24541555932758755,34
2037,1,3225,1621,1604,0,0,0,1.0,1,1.0,1,1.0,1,0.2271732339146077,35
2038,0,3225,1621,1604,0,0,0,1.0,1,1.0,1,1.0,1,0.21944095362556118,36
2039,1,3226,1622,1604,0,0,0,1.0,1,1.0,1,1.0,1,0.22861577442263184,38
2040,0,3226,1622,1604,0,0,0,1.0,1,1.0,1,1.0,1,0.22861577442263184,38
2041,0,3226,1622,1604,0,0,0,1.0,1,1.0,1,1.0,1,0.22580120933999664,39
2042,0,3226,1622,1604,0,0,0,1.0,1,1.0,1,1.0,1,0.22580120933999664,39
2043,1,3227,1622,1605,0,0,0,1.0,1,1.0,1,1.0,1,0.18287595693262343,39
2044,0,3227,1622,1605,0,0,0,1.0,1,1.0,1,1.0,1,0.18287595693262343,39
2045,1,3228,1622,1606,0,0,0,1.0,1,1.0,1,1.0,1,0.17041212527361335,41
2046,0,3228,1622,1606,0,0,0,1.0,1,1.0,1,1.0,1,0.1901511078684139,42
2047,0,3228,1622,1606,0,0,0,1.0,1,1.0,1,1.0,1,0.1901511078684139,42
2048,1,3229,1623,1606,0,0,0,1.0,1,1.0,1,1.0,1,0.21907102558064315,43
2049,3,3232,1624,1608,0,0,0,1.0,1,1.0,1,1.0,1,0.21631428336184724,44
2050,1,3233,1624,1609,0,0,0,1.0,1,1.0,1,1.0,1,0.19556797971533915,44
2051,4,3237,1625,1612,0,0,0,1.0,1,1.0,1,1.0,1,0.21693281079252882,45
2052,0,3237,1625,1612,0,0,0,1.0,1,1.0,1,1.0,1,0.21693281079252882,45
2053,3,3240,1626,1614,0,0,0,1.0,1,1.0,1,1.0,1,0.2011554448497113,45
2054,1,3241,1627,1614,0,0,0,1.0,1,1.0,1,1.0,1,0.21638168677161546,46
2055,2,3243,1627,1616,0,0,0,1.0,1,1.0,1,1.0,1,0.1746431362564719,46
2056,1,3244,1627,1617,0,0,0,1.0,1,1.0,1,1.0,1,0.16554772456028471,46
2057,4,3248,1631,1617,0,0,0,1.0,1,1.0,1,1.0,1,0.1591213296538553,47
2058,2,3250,1633,1617,0,0,0,1.0,1,1.0,1,1.0,1,0.21435566836608425,47
2059,3,3253,1634,1619,0,0,0,1.0,1,1.0,1,1.0,1,0.18511157174069592,48
2060,4,3257,1635,1622,0,0,0,1.0,1,1.0,1,1.0,1,0.1733137156168233,50
2061,2,3259,1636,1623,0,0,0,1.0,1,1.0,1,1.0,1,0.1371407216590111,51
2062,2,3261,1638,1623,0,0,0,1.0,1,1.0,1,1.0,1,0.17653481970558937,49
2063,2,3263,1639,1624,0,0,0,1.0,1,1.0,1,1.0,1,0.163554433929184,48
2064,2,3265,1640,1625,0,0,0,1.0,1,1.0,1,1.0,1,0.1705934925307359,45
2065,1,3266,1640,1626,0,0,0,1.0,1,1.0,1,1.0,1,0.16529191438738286,44
2066,0,3266,1640,1626,0,0,0,1.0,1,1.0,1,1.0,1,0.18858292358962808,42
2067,4,3270,1641,1629,0,0,0,1.0,1,1.0,1,1.0,1,0.15668711619086578,41
2068,1,3271,1642,1629,0,0,0,1.0,1,1.0,1,1.0,1,0.16297228759625987,40
2069,1,3272,1643,1629,0,0,0,1.0,1,1.0,1,1.0,1,0.19588405653486263,40
2070,2,3274,1643,1631,0,0,0,1.0,1,1.0,1,1.0,1,0.1557525355197959,40
2071,1,3275,1644,1631,0,0,0,1.0,1,1.0,1,1.0,1,0.17639295154523363,40
2072,2,3277,1644,1633,0,0,0,1.0,1,1.0,1,1.0,1,0.17211058606584972,41
2073,1,3278,1645,1633,0,0,0,1.0,1,1.0,1,1.0,1,0.19972640923102988,41
2074,2,3280,1645,1635,0,0,0,1.0,1,1.0,1,1.0,1,0.14537144952295128,41
2075,1,3281,1646,1635,0,0,0,1.0,1,1.0,1,1.0,1,0.1573220882133616,41
2076,3,3284,1648,1636,0,0,0,1.0,1,1.0,1,1.0,1,0.15263062756656753,41
2077,0,3284,1648,1636,0,0,0,1.0,1,1.0,1,1.0,1,0.14946512606495954,40
2078,1,3285,1649,1636,0,0,0,1.0,1,1.0,1,1.0,1,0.1696049206541022,40
2079,1,3286,1649,1637,0,0,0,1.0,1,1.0,1,1.0,1,0.1422863137356997,39
2080,0,3286,1649,1637,0,0,0,1.0,1,1.0,1,1.0,1,0.16893465724329165,38
2081,1,3287,1650,1637,0,0,0,1.0,1,1.0,1,1.0,1,0.18409898848925638,40
2082,1,3288,1651,1637,0,0,0,1.0,1,1.0,1,1.0,1,0.2516312313630686,41
2083,4,3292,1653,1639,0,0,0,1.0,1,1.0,1,1.0,1,0.1922769703209482,40
2084,4,3296,1656,1640,0,0,0,1.0,1,1.0,1,1.0,1,0.19553541292392299,42
2085,0,3296,1656,1640,0,0,0,1.0,1,1.0,1,1.0,1,0.19553541292392299,42
2086,1,3297,1657,1640,0,0,0,1.0,1,1.0,1,1.0,1,0.18586334310983377,43
2087,1,3298,1658,1640,0,0,0,1.0,1,1.0,1,1.0,1,0.20360448304376647,45
2088,3,3301,1660,1641,0,0,0,1.0,1,1.0,1,1.0,1,0.2062837892758399,46
2089,1,3302,1660,1642,0,0,0,1.0,1,1.0,1,1.0,1,0.17702799834810953,47
2090,0,3302,1660,1642,0,0,0,1.0,1,1.0,1,1.0,1,0.2061009382564216,49
2091,0,3302,1660,1642,0,0,0,1.0,1,1.0,1,1.0,1,0.2061009382564216,49
2092,0,3302,1660,1642,0,0,0,1.0,1,1.0,1,1.0,1,0.2061009382564216,49
2093,2,3304,1661,1643,0,0,0,1.0,1,1.0,1,1.0,1,0.20606042877097205,49
2094,0,3304,1661,1643,0,0,0,1.0,1,1.0,1,1.0,1,0.20606042877097205,49
2095,1,3305,1661,1644,0,0,0,1.0,1,1.0,1,1.0,1,0.19257451775787984,49
2096,1,3306,1661,1645,0,0,0,1.0,1,1.0,1,1.0,1,0.1874208830257062,51
2097,1,3307,1661,1646,0,0,0,1.0,1,1.0,1,1.0,1,0.16976348770620078,51
2098,1,3308,1662,1646,0,0,0,1.0,1,1.0,1,1.0,1,0.190030531643115,52
2099,4,3312,1663,1649,0,0,0,1.0,1,1.0,1,1.0,1,0.1599910066405027,51
2100,3,3315,1665,1650,0,0,0,1.0,1,1.0,1,1.0,1,0.1705024284298821,51
2101,1,3316,1665,1651,0,0,0,1.0,1,1.0,1,1.0,1,0.19285384948331236,48
2102,2,3318,1667,1651,0,0,0,1.0,1,1.0,1,1.0,1,0.24140735875665373,49
2103,5,3323,1671,1652,0,0,0,1.0,1,1.0,1,1.0,1,0.30329259999061636,48
2104,1,3324,1671,1653,0,0,0,1.0,1,1.0,1,1.0,1,0.3032523768448357,43
2105,4,3328,1672,1656,0,0,0,1.0,1,1.0,1,1.0,1,0.3070971780928855,42
2106,3,3331,1674,1657,0,0,0,1.0,1,1.0,1,1.0,1,0.2903779403673854,40
2107,1,3332,1674,1658,0,0,0,1.0,1,1.0,1,1.0,1,0.2813942815795746,39
2108,2,3334,1676,1658,0,0,0,1.0,1,1.0,1,1.0,1,0.29201399965483105,38
2109,2,3336,1677,1659,0,0,0,1.0,1,1.0,1,1.0,1,0.2887087002379647,37
2110,3,3339,1679,1660,0,0,0,1.0,1,1.0,1,1.0,1,0.3283761068303746,38
2111,2,3341,1680,1661,0,0,0,1.0,1,1.0,1,1.0,1,0.34066247614137674,37
2112,3,3344,1681,1663,0,0,0,1.0,1,1.0,1,1.0,1,0.28373125984937114,36
2113,2,3346,1682,1664,0,0,0,1.0,1,1.0,1,1.0,1,0.3419134915564271,36
2114,1,3347,1682,1665,0,0,0,1.0,1,1.0,1,1.0,1,0.3011292726850517,36
2115,0,3347,1682,1665,0,0,0,1.0,1,1.0,1,1.0,1,0.2884954076520329,35
2116,0,3347,1682,1665,0,0,0,1.0,1,1.0,1,1.0,1,0.2993841955111794,37
2117,0,3347,1682,1665,0,0,0,1.0,1,1.0,1,1.0,1,0.26469512602153206,38
2118,1,3348,1682,1666,0,0,0,1.0,1,1.0,1,1.0,1,0.25728742169734475,40
2119,0,3348,1682,1666,0,0,0,1.0,1,1.0,1,1.0,1,0.25728742169734475,40
2120,1,3349,1683,1666,0,0,0,1.0,1,1.0,1,1.0,1,0.2963808528817157,41
2121,0,3349,1683,1666,0,0,0,1.0,1,1.0,1,1.0,1,0.2963808528817157,41
2122,1,3350,1684,1666,0,0,0,1.0,1,1.0,1,1.0,1,0.3198960230592832,42
2123,0,3350,1684,1666,0,0,0,1.0,1,1.0,1,1.0,1,0.30936083363595374,43
2124,0,3350,1684,1666,0,0,0,1.0,1,1.0,1,1.0,1,0.33802219434696823,41
2125,0,3350,1684,1666,0,0,0,1.0,1,1.0,1,1.0,1,0.33802219434696823,41
2126,0,3350,1684,1666,0,0,0,1.0,1,1.0,1,1.0,1,0.3639173972036008,40
2127,0,3350,1684,1666,0,0,0,1.0,1,1.0,1,1.0,1,0.3639173972036008,40
2128,0,3350,1684,1666,0,0,0,1.0,1,1.0,1,1.0,1,0.37934884049948303,41
2129,0,3350,1684,1666,0,0,0,1.0,1,1.0,1,1.0,1,0.371690902748638,42
2130,3,3353,1684,1669,0,0,0,1.0,1,1.0,1,1.0,1,0.3460403799173608,45
2131,1,3354,1684,1670,0,0,0,1.0,1,1.0,1,1.0,1,0.33079995500168585,45
2132,3,3357,1684,1673,0,0,0,1.0,1,1.0,1,1.0,1,0.29502826515479164,46
2133,3,3360,1685,1675,0,0,0,1.0,1,1.0,1,1.0,1,0.2923057288539856,46
2134,2,3362,1685,1677,0,0,0,1.0,1,1.0,1,1.0,1,0.27598221398959843,47
2135,2,3364,1685,1679,0,0,0,1.0,1,1.0,1,1.0,1,0.24649024968093755,47
2136,0,3364,1685,1679,0,0,0,1.0,1,1.0,1,1.0,1,0.24649024968093755,47
2137,5,3369,1686,1683,0,0,0,1.0,1,1.0,1,1.0,1,0.17619717445999145,49
2138,2,3371,1686,1685,0,0,0,1.0,1,1.0,1,1.0,1,0.1403889009650696,49
2139,2,3373,1687,1686,0,0,0,1.0,1,1.0,1,1.0,1,0.11748257614035815,47
2140,5,3378,1689,1689,0,0,0,1.0,1,1.0,1,1.0,1,0.13986751473535783,48
2141,1,3379,1690,1689,0,0,0,1.0,1,1.0,1,1.0,1,0.14705726690874377,47
2142,0,3379,1690,1689,0,0,0,1.0,1,1.0,1,1.0,1,0.14705726690874377,47
2143,2,3381,1691,1690,0,0,0,1.0,1,1.0,1,1.0,1,0.1318864618558999,48
2144,4,3385,1695,1690,0,0,0,1.0,1,1.0,1,1.0,1,0.2277778047441804,48
2145,4,3389,1697,1692,0,0,0,1.0,1,1.0,1,1.0,1,0.1722347161645348,46
2146,2,3391,1697,1694,0,0,0,1.0,1,1.0,1,1.0,1,0.15159834656534024,47
2147,4,3395,1701,1694,0,0,0,1.0,1,1.0,1,1.0,1,0.16818503839557816,48
2148,0,3395,1701,1694,0,0,0,1.0,1,1.0,1,1.0,1,0.16268328422332154,46
2149,6,3401,1705,1696,0,0,0,1.0,1,1.0,1,1.0,1,0.1920401247688748,46
2150,1,3402,1706,1696,0,0,0,1.0,1,1.0,1,1.0,1,0.1913929426898573,46
2151,0,3402,1706,1696,0,0,0,1.0,1,1.0,1,1.0,1,0.22619907621223606,44
2152,3,3405,1707,1698,0,0,0,1.0,1,1.0,1,1.0,1,0.2440252413108953,45
2153,3,3408,1708,1700,0,0,0,1.0,1,1.0,1,1.0,1,0.24367920066357152,48
2154,0,3408,1708,1700,0,0,0,1.0,1,1.0,1,1.0,1,0.27361003775676734,47
2155,4,3412,1710,1702,0,0,0,1.0,1,1.0,1,1.0,1,0.29933810227021546,48
2156,1,3413,1711,1702,0,0,0,1.0,1,1.0,1,1.0,1,0.3248564970478095,45
2157,2,3415,1711,1704,0,0,0,1.0,1,1.0,1,1.0,1,0.30753706511791534,43
2158,3,3418,1712,1706,0,0,0,1.0,1,1.0,1,1.0,1,0.25388576560490095,43
2159,3,3421,1714,1707,0,0,0,1.0,1,1.0,1,1.0,1,0.28807750434390805,43
2160,0,3421,1714,1707,0,0,0,1.0,1,1.0,1,1.0,1,0.26370381563656276,41
2161,2,3423,1714,1709,0,0,0,1.0,1,1.0,1,1.0,1,0.22068932276675804,41
2162,5,3428,1717,1711,0,0,0,1.0,1,1.0,1,1.0,1,0.1497136373981362,42
2163,3,3431,1718,1713,0,0,0,1.0,1,1.0,1,1.0,1,0.13678050061736535,43
2164,2,3433,1720,1713,0,0,0,1.0,1,1.0,1,1.0,1,0.21573282156409687,44
2165,1,3434,1720,1714,0,0,0,1.0,1,1.0,1,1.0,1,0.1936005774489742,44
2166,0,3434,1720,1714,0,0,0,1.0,1,1.0,1,1.0,1,0.19104770799089021,46
2167,1,3435,1721,1714,0,0,0,1.0,1,1.0,1,1.0,1,0.22767681864197237,46
2168,0,3435,1721,1714,0,0,0,1.0,1,1.0,1,1.0,1,0.21376668532471033,45
2169,4,3439,1722,1717,0,0,0,1.0,1,1.0,1,1.0,1,0.1589341714699433,49
2170,1,3440,1722,1718,0,0,0,1.0,1,1.0,1,1.0,1,0.149994707477818,49
2171,2,3442,1723,1719,0,0,0,1.0,1,1.0,1,1.0,1,0.15734370348689658,51
2172,1,3443,1723,1720,0,0,0,1.0,1,1.0,1,1.0,1,0.14189051266573258,52
2173,0,3443,1723,1720,0,0,0,1.0,1,1.0,1,1.0,1,0.14189051266573258,52
2174,1,3444,1724,1720,0,0,0,1.0,1,1.0,1,1.0,1,0.15699975307120492,52
2175,2,3446,1724,1722,0,0,0,1.0,1,1.0,1,1.0,1,0.13081266314027287,53
2176,3,3449,1725,1724,0,0,0,1.0,1,1.0,1,1.0,1,0.10376279013141888,54
2177,2,3451,1727,1724,0,0,0,1.0,1,1.0,1,1.0,1,0.14296703263691984,55
2178,2,3453,1728,1725,0,0,0,1.0,1,1.0,1,1.0,1,0.11484706309264749,54
2179,1,3454,1729,1725,0,0,0,1.0,1,1.0,1,1.0,1,0.15365656755268534,52
2180,2,3456,1731,1725,0,0,0,1.0,1,1.0,1,1.0,1,0.18212142423944033,51
2181,1,3457,1731,1726,0,0,0,1.0,1,1.0,1,1.0,1,0.17426576078890635,49
2182,5,3462,1735,1727,0,0,0,1.0,1,1.0,1,1.0,1,0.23850462218639193,49
2183,4,3466,1738,1728,0,0,0,1.0,1,1.0,1,1.0,1,0.24631726908812204,46
2184,3,3469,1739,1730,0,0,0,1.0,1,1.0,1,1.0,1,0.22905299132859117,45
2185,3,3472,1740,1732,0,0,0,1.0,1,1.0,1,1.0,1,0.21708398819381997,44
2186,1,3473,1741,1732,0,0,0,1.0,1,1.0,1,1.0,1,0.2605779964779288,42
2187,7,3480,1744,1736,0,0,0,1.0,1,1.0,1,1.0,1,0.2540118724266842,40
2188,6,3486,1748,1738,0,0,0,1.0,1,1.0,1,1.0,1,0.17248054948027972,38
2189,0,3486,1748,1738,0,0,0,1.0,1,1.0,1,1.0,1,0.158952503186509,36
2190,4,3490,1750,1740,0,0,0,1.0,1,1.0,1,1.0,1,0.23364602788348485,34
2191,5,3495,1752,1743,0,0,0,1.0,1,1.0,1,1.0,1,0.10538020871131693,34
2192,3,3498,1755,1743,0,0,0,1.0,1,1.0,1,1.0,1,0.13610095460843952,33
2193,0,3498,1755,1743,0,0,0,1.0,1,1.0,1,1.0,1,0.15835904466244843,32
2194,0,3498,1755,1743,0,0,0,1.0,1,1.0,1,1.0,1,0.15835904466244843,32
2195,0,3498,1755,1743,0,0,0,1.0,1,1.0,1,1.0,1,0.16058164059065733,31
2196,1,3499,1756,1743,0,0,0,1.0,1,1.0,1,1.0,1,0.15568241299514832,32
2197,1,3500,1757,1743,0,0,0,1.0,1,1.0,1,1.0,1,0.16437705675890826,31
2198,0,3500,1757,1743,0,0,0,1.0,1,1.0,1,1.0,1,0.16437705675890826,31
2199,1,3501,1758,1743,0,0,0,1.0,1,1.0,1,1.0,1,0.15736976307267395,32
2200,1,3502,1758,1744,0,0,0,1.0,1,1.0,1,1.0,1,0.17678654024930265,35
2201,0,3502,1758,1744,0,0,0,1.0,1,1.0,1,1.0,1,0.17443674480579116,36
2202,1,3503,1759,1744,0,0,0,1.0,1,1.0,1,1.0,1,0.15717206247942464,36
2203,0,3503,1759,1744,0,0,0,1.0,1,1.0,1,1.0,1,0.1710667379801728,37
2204,1,3504,1760,1744,0,0,0,1.0,1,1.0,1,1.0,1,0.22467329715948284,36
2205,1,3505,1760,1745,0,0,0,1.0,1,1.0,1,1.0,1,0.1897999055207724,37
2206,2,3507,1762,1745,0,0,0,1.0,1,1.0,1,1.0,1,0.26617976947575966,35
2207,2,3509,1763,1746,0,0,0,1.0,1,1.0,1,1.0,1,0.26895204165875913,37
2208,1,3510,1764,1746,0,0,0,1.0,1,1.0,1,1.0,1,0.27913123803448797,36
2209,3,3513,1765,1748,0,0,0,1.0,1,1.0,1,1.0,1,0.24646020598263102,35
2210,1,3514,1765,1749,0,0,0,1.0,1,1.0,1,1.0,1,0.2396209583908519,38
2211,0,3514,1765,1749,0,0,0,1.0,1,1.0,1,1.0,1,0.26506194707198383,37
2212,2,3516,1765,1751,0,0,0,1.0,1,1.0,1,1.0,1,0.22271751874885506,38
2213,1,3517,1766,1751,0,0,0,1.0,1,1.0,1,1.0,1,0.2181762250723297,38
2214,0,3517,1766,1751,0,0,0,1.0,1,1.0,1,1.0,1,0.21794699470343995,39
2215,1,3518,1767,1751,0,0,0,1.0,1,1.0,1,1.0,1,0.2495709150498999,39
2216,1,3519,1768,1751,0,0,0,1.0,1,1.0,1,1.0,1,0.27772157936573416,39
2217,2,3521,1769,1752,0,0,0,1.0,1,1.0,1,1.0,1,0.20917863003464007,38
2218,2,3523,1771,1752,0,0,0,1.0,1,1.0,1,1.0,1,0.20481538018576456,37
2219,1,3524,1772,1752,0,0,0,1.0,1,1.0,1,1.0,1,0.20796271958733467,36
2220,0,3524,1772,1752,0,0,0,1.0,1,1.0,1,1.0,1,0.24869516832419536,34
2221,1,3525,1773,1752,0,0,0,1.0,1,1.0,1,1.0,1,0.25080254480327724,35
2222,0,3525,1773,1752,0,0,0,1.0,1,1.0,1,1.0,1,0.27278532135206746,33
2223,6,3531,1774,1757,0,0,0,1.0,1,1.0,1,1.0,1,0.13377508536081767,34
2224,1,3532,1775,1757,0,0,0,1.0,1,1.0,1,1.0,1,0.1430938656027888,32
2225,3,3535,1778,1757,0,0,0,1.0,1,1.0,1,1.0,1,0.2417267330195094,33
2226,2,3537,1780,1757,0,0,0,1.0,1,1.0,1,1.0,1,0.318921752030544,32
2227,1,3538,1780,1758,0,0,0,1.0,1,1.0,1,1.0,1,0.226880520546197,31
2228,1,3539,1781,1758,0,0,0,1.0,1,1.0,1,1.0,1,0.21938965317688378,32
2229,0,3539,1781,1758,0,0,0,1.0,1,1.0,1,1.0,1,0.21938965317688378,32
2230,1,3540,1782,1758,0,0,0,1.0,1,1.0,1,1.0,1,0.21679537333287677,31
2231,0,3540,1782,1758,0,0,0,1.0,1,1.0,1,1.0,1,0.19650085344544221,32
2232,3,3543,1783,1760,0,0,0,1.0,1,1.0,1,1.0,1,0.18222086898777995,32
2233,1,3544,1783,1761,0,0,0,1.0,1,1.0,1,1.0,1,0.16532103379151145,31
2234,1,3545,1784,1761,0,0,0,1.0,1,1.0,1,1.0,1,0.23724887658730898,32
2235,1,3546,1784,1762,0,0,0,1.0,1,1.0,1,1.0,1,0.2500674217883049,31
2236,2,3548,1786,1762,0,0,0,1.0,1,1.0,1,1.0,1,0.3099292047562833,31
2237,0,3548,1786,1762,0,0,0,1.0,1,1.0,1,1.0,1,0.3099292047562833,31
2238,4,3552,1787,1765,0,0,0,1.0,1,1.0,1,1.0,1,0.2715993225650872,31
2239,0,3552,1787,1765,0,0,0,1.0,1,1.0,1,1.0,1,0.2715993225650872,31
2240,3,3555,1789,1766,0,0,0,1.0,1,1.0,1,1.0,1,0.25245835594923455,32
2241,1,3556,1790,1766,0,0,0,1.0,1,1.0,1,1.0,1,0.2773020665263896,32
2242,4,3560,1792,1768,0,0,0,1.0,1,1.0,1,1.0,1,0.21831893269793148,34
2243,0,3560,1792,1768,0,0,0,1.0,1,1.0,1,1.0,1,0.21831893269793148,34
2244,0,3560,1792,1768,0,0,0,1.0,1,1.0,1,1.0,1,0.23087540705824475,36
2245,0,3560,1792,1768,0,0,0,1.0,1,1.0,1,1.0,1,0.23087540705824475,36
2246,3,3563,1792,1771,0,0,0,1.0,1,1.0,1,1.0,1,0.17520097099477214,39
2247,0,3563,1792,1771,0,0,0,1.0,1,1.0,1,1.0,1,0.1771821995673864,40
2248,0,3563,1792,1771,0,0,0,1.0,1,1.0,1,1.0,1,0.1771821995673864,40
2249,0,3563,1792,1771,0,0,0,1.0,1,1.0,1,1.0,1,0.17362826296766917,41
2250,0,3563,1792,1771,0,0,0,1.0,1,1.0,1,1.0,1,0.17362826296766917,41
2251,0,3563,1792,1771,0,0,0,1.0,1,1.0,1,1.0,1,0.19346810290267252,42
2252,1,3564,1793,1771,0,0,0,1.0,1,1.0,1,1.0,1,0.2039988460131206,41
2253,0,3564,1793,1771,0,0,0,1.0,1,1.0,1,1.0,1,0.1902447492702385,40
2254,1,3565,1794,1771,0,0,0,1.0,1,1.0,1,1.0,1,0.22622566946483325,39
2255,2,3567,1794,1773,0,0,0,1.0,1,1.0,1,1.0,1,0.2502980566857519,39
2256,4,3571,1798,1773,0,0,0,1.0,1,1.0,1,1.0,1,0.2976925269284259,40
2257,5,3576,1800,1776,0,0,0,1.0,1,1.0,1,1.0,1,0.2703900880309662,40
2258,2,3578,1802,1776,0,0,0,1.0,1,1.0,1,1.0,1,0.24540534299815514,39
2259,3,3581,1804,1777,0,0,0,1.0,1,1.0,1,1.0,1,0.24265856726130527,41
2260,0,3581,1804,1777,0,0,0,1.0,1,1.0,1,1.0,1,0.22949899540076305,38
2261,1,3582,1805,1777,0,0,0,1.0,1,1.0,1,1.0,1,0.2428948153793181,38
2262,0,3582,1805,1777,0,0,0,1.0,1,1.0,1,1.0,1,0.25568225780097725,36
2263,4,3586,1808,1778,0,0,0,1.0,1,1.0,1,1.0,1,0.23479903694495957,35
2264,3,3589,1811,1778,0,0,0,1.0,1,1.0,1,1.0,1,0.33911025750675683,33
2265,5,3594,1813,1781,0,0,0,1.0,1,1.0,1,1.0,1,0.35378015270323243,33
2266,5,3599,1815,1784,0,0,0,1.0,1,1.0,1,1.0,1,0.30356877237115243,33
2267,4,3603,1817,1786,0,0,0,1.0,1,1.0,1,1.0,1,0.2622226344170637,33
2268,6,3609,1818,1791,0,0,0,1.0,1,1.0,1,1.0,1,0.17613780662762954,35
2269,2,3611,1819,1792,0,0,0,1.0,1,1.0,1,1.0,1,0.15839537523719865,36
2270,0,3611,1819,1792,0,0,0,1.0,1,1.0,1,1.0,1,0.16613469749790127,34
2271,3,3614,1822,1792,0,0,0,1.0,1,1.0,1,1.0,1,0.2605471430384095,34
2272,3,3617,1823,1794,0,0,0,1.0,1,1.0,1,1.0,1,0.21566026403329808,33
2273,1,3618,1824,1794,0,0,0,1.0,1,1.0,1,1.0,1,0.21837198173236508,32
2274,0,3618,1824,1794,0,0,0,1.0,1,1.0,1,1.0,1,0.21837198173236508,32
2275,1,3619,1824,1795,0,0,0,1.0,1,1.0,1,1.0,1,0.22391740465971868,32
2276,0,3619,1824,1795,0,0,0,1.0,1,1.0,1,1.0,1,0.2044454521089617,31
2277,1,3620,1825,1795,0,0,0,1.0,1,1.0,1,1.0,1,0.2113984715570023,30
2278,0,3620,1825,1795,0,0,0,1.0,1,1.0,1,1.0,1,0.21248405946682392,33
2279,0,3620,1825,1795,0,0,0,1.0,1,1.0,1,1.0,1,0.21248405946682392,33
2280,3,3623,1825,1798,0,0,0,1.0,1,1.0,1,1.0,1,0.1606692422457413,35
2281,1,3624,1825,1799,0,0,0,1.0,1,1.0,1,1.0,1,0.15836822945435586,36
2282,0,3624,1825,1799,0,0,0,1.0,1,1.0,1,1.0,1,0.15836822945435586,36
2283,1,3625,1826,1799,0,0,0,1.0,1,1.0,1,1.0,1,0.17685417940841583,36
2284,1,3626,1827,1799,0,0,0,1.0,1,1.0,1,1.0,1,0.1916286839430438,36
2285,1,3627,1827,1800,0,0,0,1.0,1,1.0,1,1.0,1,0.15807257821210946,37
2286,1,3628,1828,1800,0,0,0,1.0,1,1.0,1,1.0,1,0.18619212270536684,38
2287,0,3628,1828,1800,0,0,0,1.0,1,1.0,1,1.0,1,0.17144601678303995,38
2288,2,3630,1830,1800,0,0,0,1.0,1,1.0,1,1.0,1,0.26951412450067114,40
2289,2,3632,1830,1802,0,0,0,1.0,1,1.0,1,1.0,1,0.21968594806879452,40
2290,1,3633,1831,1802,0,0,0,1.0,1,1.0,1,1.0,1,0.2567583346627219,39
2291,1,3634,1832,1802,0,0,0,1.0,1,1.0,1,1.0,1,0.24911984076092772,37
2292,3,3637,1834,1803,0,0,0,1.0,1,1.0,1,1.0,1,0.3545617610940547,35
2293,5,3642,1837,1805,0,0,0,1.0,1,1.0,1,1.0,1,0.39158958985471753,35
2294,1,3643,1837,1806,0,0,0,1.0,1,1.0,1,1.0,1,0.3635073230730007,35
2295,3,3646,1837,1809,0,0,0,1.0,1,1.0,1,1.0,1,0.28905978268610416,36
2296,0,3646,1837,1809,0,0,0,1.0,1,1.0,1,1.0,1,0.280066727930355,34
2297,0,3646,1837,1809,0,0,0,1.0,1,1.0,1,1.0,1,0.2959603938806573,35
2298,0,3646,1837,1809,0,0,0,1.0,1,1.0,1,1.0,1,0.29936107294174386,34
2299,2,3648,1839,1809,0,0,0,1.0,1,1.0,1,1.0,1,0.29506913649164335,35
2300,1,3649,1840,1809,0,0,0,1.0,1,1.0,1,1.0,1,0.3038487461362461,35
2301,0,3649,1840,1809,0,0,0,1.0,1,1.0,1,1.0,1,0.3038487461362461,35
2302,4,3653,1843,1810,0,0,0,1.0,1,1.0,1,1.0,1,0.3666539064796473,37
2303,1,3654,1844,1810,0,0,0,1.0,1,1.0,1,1.0,1,0.2958943326467912,35
2304,2,3656,1845,1811,0,0,0,1.0,1,1.0,1,1.0,1,0.3286141995459193,36
2305,1,3657,1845,1812,0,0,0,1.0,1,1.0,1,1.0,1,0.33064331059026664,34
2306,1,3658,1845,1813,0,0,0,1.0,1,1.0,1,1.0,1,0.3084232102514834,35
2307,2,3660,1845,1815,0,0,0,1.0,1,1.0,1,1.0,1,0.2657542766296588,35
2308,0,3660,1845,1815,0,0,0,1.0,1,1.0,1,1.0,1,0.2657542766296588,35
2309,0,3660,1845,1815,0,0,0,1.0,1,1.0,1,1.0,1,0.2745886399775851,34
2310,1,3661,1845,1816,0,0,0,1.0,1,1.0,1,1.0,1,0.2605520205721957,36
2311,1,3662,1845,1817,0,0,0,1.0,1,1.0,1,1.0,1,0.2506620564146882,38
2312,2,3664,1847,1817,0,0,0,1.0,1,1.0,1,1.0,1,0.30946578778037714,39
2313,5,3669,1849,1820,0,0,0,1.0,1,1.0,1,1.0,1,0.21450719992413148,39
2314,2,3671,1849,1822,0,0,0,1.0,1,1.0,1,1.0,1,0.19925067714496864,39
2315,6,3677,1851,1826,0,0,0,1.0,1,1.0,1,1.0,1,0.14724633234141107,40
2316,0,3677,1851,1826,0,0,0,1.0,1,1.0,1,1.0,1,0.14724633234141107,40
2317,1,3678,1852,1826,0,0,0,1.0,1,1.0,1,1.0,1,0.2052091821363234,41
2318,1,3679,1853,1826,0,0,0,1.0,1,1.0,1,1.0,1,0.2097770478347403,41
2319,1,3680,1853,1827,0,0,0,1.0,1,1.0,1,1.0,1,0.19593436003891626,41
2320,0,3680,1853,1827,0,0,0,1.0,1,1.0,1,1.0,1,0.2169152164600743,42
2321,0,3680,1853,1827,0,0,0,1.0,1,1.0,1,1.0,1,0.1961381746603131,43
2322,0,3680,1853,1827,0,0,0,1.0,1,1.0,1,1.0,1,0.19318547170720013,42
2323,1,3681,1854,1827,0,0,0,1.0,1,1.0,1,1.0,1,0.24128006934693755,43
2324,4,3685,1854,1831,0,0,0,1.0,1,1.0,1,1.0,1,0.2241518475682281,44
2325,1,3686,1854,1832,0,0,0,1.0,1,1.0,1,1.0,1,0.20419823992395175,44
2326,0,3686,1854,1832,0,0,0,1.0,1,1.0,1,1.0,1,0.19113004952299814,45
2327,0,3686,1854,1832,0,0,0,1.0,1,1.0,1,1.0,1,0.19113004952299814,45
2328,0,3686,1854,1832,0,0,0,1.0,1,1.0,1,1.0,1,0.19890150002211757,46
2329,1,3687,1855,1832,0,0,0,1.0,1,1.0,1,1.0,1,0.2119363835669396,45
2330,1,3688,1855,1833,0,0,0,1.0,1,1.0,1,1.0,1,0.20319909892918483,47
2331,0,3688,1855,1833,0,0,0,1.0,1,1.0,1,1.0,1,0.20369763708937208,48
2332,0,3688,1855,1833,0,0,0,1.0,1,1.0,1,1.0,1,0.20369763708937208,48
2333,1,3689,1856,1833,0,0,0,1.0,1,1.0,1,1.0,1,0.23717666409497226,49
2334,1,3690,1857,1833,0,0,0,1.0,1,1.0,1,1.0,1,0.27282720686251183,47
2335,2,3692,1858,1834,0,0,0,1.0,1,1.0,1,1.0,1,0.3035712407903543,46
2336,3,3695,1858,1837,0,0,0,1.0,1,1.0,1,1.0,1,0.28438434728839523,46
2337,2,3697,1858,1839,0,0,0,1.0,1,1.0,1,1.0,1,0.22984871889087746,45
2338,2,3699,1859,1840,0,0,0,1.0,1,1.0,1,1.0,1,0.2018525613555992,44
2339,1,3700,1860,1840,0,0,0,1.0,1,1.0,1,1.0,1,0.19003846271127697,45
2340,1,3701,1861,1840,0,0,0,1.0,1,1.0,1,1.0,1,0.20450581088341718,44
2341,3,3704,1861,1843,0,0,0,1.0,1,1.0,1,1.0,1,0.1772131409002203,45
2342,1,3705,1862,1843,0,0,0,1.0,1,1.0,1,1.0,1,0.18438561147023724,47
2343,1,3706,1863,1843,0,0,0,1.0,1,1.0,1,1.0,1,0.1890963902253675,46
2344,1,3707,1863,1844,0,0,0,1.0,1,1.0,1,1.0,1,0.20553095020047377,46
2345,2,3709,1863,1846,0,0,0,1.0,1,1.0,1,1.0,1,0.17760971545758972,45
2346,0,3709,1863,1846,0,0,0,1.0,1,1.0,1,1.0,1,0.1647221931041792,46
2347,0,3709,1863,1846,0,0,0,1.0,1,1.0,1,1.0,1,0.1822417363322004,47
2348,1,3710,1864,1846,0,0,0,1.0,1,1.0,1,1.0,1,0.20400552604701008,49
2349,3,3713,1865,1848,0,0,0,1.0,1,1.0,1,1.0,1,0.2089247120884557,49
2350,4,3717,1866,1851,0,0,0,1.0,1,1.0,1,1.0,1,0.18820008608863603,50
2351,1,3718,1867,1851,0,0,0,1.0,1,1.0,1,1.0,1,0.20281586000683774,50
2352,1,3719,1867,1852,0,0,0,1.0,1,1.0,1,1.0,1,0.19544545020704734,51
2353,0,3719,1867,1852,0,0,0,1.0,1,1.0,1,1.0,1,0.19544545020704734,51
2354,0,3719,1867,1852,0,0,0,1.0,1,1.0,1,1.0,1,0.21372648262934477,51
2355,2,3721,1868,1853,0,0,0,1.0,1,1.0,1,1.0,1,0.22084772541527461,50
2356,0,3721,1868,1853,0,0,0,1.0,1,1.0,1,1.0,1,0.22084772541527461,50
2357,0,3721,1868,1853,0,0,0,1.0,1,1.0,1,1.0,1,0.2188722956933573,49
2358,3,3724,1868,1856,0,0,0,1.0,1,1.0,1,1.0,1,0.1965900095539041,51
2359,1,3725,1868,1857,0,0,0,1.0,1,1.0,1,1.0,1,0.16381003983645073,51
2360,2,3727,1870,1857,0,0,0,1.0,1,1.0,1,1.0,1,0.2214665738647807,51
2361,2,3729,1871,1858,0,0,0,1.0,1,1.0,1,1.0,1,0.25049467229131267,52
2362,3,3732,1871,1861,0,0,0,1.0,1,1.0,1,1.0,1,0.20204799138450702,53
2363,2,3734,1872,1862,0,0,0,1.0,1,1.0,1,1.0,1,0.19507890426141344,54
2364,3,3737,1872,1865,0,0,0,1.0,1,1.0,1,1.0,1,0.1590818002985126,55
2365,2,3739,1873,1866,0,0,0,1.0,1,1.0,1,1.0,1,0.16973128921822397,53
2366,2,3741,1874,1867,0,0,0,1.0,1,1.0,1,1.0,1,0.15465404963798293,53
2367,2,3743,1876,1867,0,0,0,1.0,1,1.0,1,1.0,1,0.1989986154614224,51
2368,3,3746,1878,1868,0,0,0,1.0,1,1.0,1,1.0,1,0.19081337593544426,50
2369,2,3748,1880,1868,0,0,0,1.0,1,1.0,1,1.0,1,0.2363477027620982,47
2370,1,3749,1880,1869,0,0,0,1.0,1,1.0,1,1.0,1,0.24989661255644458,48
2371,4,3753,1881,1872,0,0,0,1.0,1,1.0,1,1.0,1,0.22770923173998836,49
2372,0,3753,1881,1872,0,0,0,1.0,1,1.0,1,1.0,1,0.22352935681977662,48
2373,0,3753,1881,1872,0,0,0,1.0,1,1.0,1,1.0,1,0.23212420403873568,49
2374,0,3753,1881,1872,0,0,0,1.0,1,1.0,1,1.0,1,0.23699495818536048,50
2375,1,3754,1882,1872,0,0,0,1.0,1,1.0,1,1.0,1,0.26099736840865817,50
2376,1,3755,1882,1873,0,0,0,1.0,1,1.0,1,1.0,1,0.24871898387719915,50
2377,1,3756,1882,1874,0,0,0,1.0,1,1.0,1,1.0,1,0.2330445527936228,49
2378,0,3756,1882,1874,0,0,0,1.0,1,1.0,1,1.0,1,0.2330445527936228,49
2379,1,3757,1883,1874,0,0,0,1.0,1,1.0,1,1.0,1,0.267653150222882,50
2380,1,3758,1884,1874,0,0,0,1.0,1,1.0,1,1.0,1,0.290223855209945,50
2381,2,3760,1885,1875,0,0,0,1.0,1,1.0,1,1.0,1,0.30560025063616436,51
2382,3,3763,1886,1877,0,0,0,1.0,1,1.0,1,1.0,1,0.2788755256124653,51
2383,4,3767,1887,1880,0,0,0,1.0,1,1.0,1,1.0,1,0.2600379917348379,52
2384,1,3768,1888,1880,0,0,0,1.0,1,1.0,1,1.0,1,0.24187387017460404,52
2385,3,3771,1890,1881,0,0,0,1.0,1,1.0,1,1.0,1,0.26798567642015353,51
2386,4,3775,1891,1884,0,0,0,1.0,1,1.0,1,1.0,1,0.24525573414622828,52
2387,0,3775,1891,1884,0,0,0,1.0,1,1.0,1,1.0,1,0.26693588256561246,49
2388,2,3777,1892,1885,0,0,0,1.0,1,1.0,1,1.0,1,0.2566030929395886,48
2389,3,3780,1894,1886,0,0,0,1.0,1,1.0,1,1.0,1,0.2707447971117088,48
2390,2,3782,1895,1887,0,0,0,1.0,1,1.0,1,1.0,1,0.26223632257800056,49
2391,0,3782,1895,1887,0,0,0,1.0,1,1.0,1,1.0,1,0.2592354649817417,48
2392,3,3785,1898,1887,0,0,0,1.0,1,1.0,1,1.0,1,0.25511457132579396,49
2393,6,3791,1899,1892,0,0,0,1.0,1,1.0,1,1.0,1,0.21103013818367217,50
2394,2,3793,1900,1893,0,0,0,1.0,1,1.0,1,1.0,1,0.23082559023756097,50
2395,1,3794,1901,1893,0,0,0,1.0,1,1.0,1,1.0,1,0.2238252660415607,49
2396,3,3797,1902,1895,0,0,0,1.0,1,1.0,1,1.0,1,0.18759170269179407,50
2397,4,3801,1905,1896,0,0,0,1.0,1,1.0,1,1.0,1,0.21016210512613281,51
2398,1,3802,1906,1896,0,0,0,1.0,1,1.0,1,1.0,1,0.2061756534012216,49
2399,1,3803,1906,1897,0,0,0,1.0,1,1.0,1,1.0,1,0.18593453511379415,50
2400,0,3803,1906,1897,0,0,0,1.0,1,1.0,1,1.0,1,0.1984498766144398,51
2401,0,3803,1906,1897,0,0,0,1.0,1,1.0,1,1.0,1,0.20930802110905944,50
2402,0,3803,1906,1897,0,0,0,1.0,1,1.0,1,1.0,1,0.2123379096458925,51
2403,1,3804,1906,1898,0,0,0,1.0,1,1.0,1,1.0,1,0.19195626930957005,52
2404,2,3806,1906,1900,0,0,0,1.0,1,1.0,1,1.0,1,0.1662871935519947,53
2405,0,3806,1906,1900,0,0,0,1.0,1,1.0,1,1.0,1,0.1691021625778794,52
2406,2,3808,1908,1900,0,0,0,1.0,1,1.0,1,1.0,1,0.18659601553627483,52
2407,0,3808,1908,1900,0,0,0,1.0,1,1.0,1,1.0,1,0.21547326148118523,51
2408,2,3810,1909,1901,0,0,0,1.0,1,1.0,1,1.0,1,0.2137134851161778,50
2409,0,3810,1909,1901,0,0,0,1.0,1,1.0,1,1.0,1,0.2216413365276899,50
2410,1,3811,1910,1901,0,0,0,1.0,1,1.0,1,1.0,1,0.26097622169569257,49
2411,2,3813,1910,1903,0,0,0,1.0,1,1.0,1,1.0,1,0.2570391260602807,48
2412,1,3814,1910,1904,0,0,0,1.0,1,1.0,1,1.0,1,0.267046058875638,47
2413,1,3815,1910,1905,0,0,0,1.0,1,1.0,1,1.0,1,0.2457957085369619,47
2414,1,3816,1911,1905,0,0,0,1.0,1,1.0,1,1.0,1,0.2865768515245346,47
2415,1,3817,1912,1905,0,0,0,1.0,1,1.0,1,1.0,1,0.30905693255704636,46
2416,1,3818,1912,1906,0,0,0,1.0,1,1.0,1,1.0,1,0.2826669919352807,47
2417,1,3819,1912,1907,0,0,0,1.0,1,1.0,1,1.0,1,0.2782963428404418,46
2418,4,3823,1913,1910,0,0,0,1.0,1,1.0,1,1.0,1,0.2579163306820367,48
2419,2,3825,1914,1911,0,0,0,1.0,1,1.0,1,1.0,1,0.25090255455758464,47
2420,2,3827,1915,1912,0,0,0,1.0,1,1.0,1,1.0,1,0.2328336812230431,49
2421,2,3829,1916,1913,0,0,0,1.0,1,1.0,1,1.0,1,0.22277826433366818,50
2422,3,3832,1918,1914,0,0,0,1.0,1,1.0,1,1.0,1,0.19752538312184328,50
2423,2,3834,1918,1916,0,0,0,1.0,1,1.0,1,1.0,1,0.18185053507137608,51
2424,2,3836,1920,1916,0,0,0,1.0,1,1.0,1,1.0,1,0.17465479089858474,50
2425,0,3836,1920,1916,0,0,0,1.0,1,1.0,1,1.0,1,0.17732599327860035,48
2426,5,3841,1924,1917,0,0,0,1.0,1,1.0,1,1.0,1,0.209951510554316,51
2427,3,3844,1926,1918,0,0,0,1.0,1,1.0,1,1.0,1,0.20288757969979188,50
2428,1,3845,1926,1919,0,0,0,1.0,1,1.0,1,1.0,1,0.1642439847110076,49
2429,2,3847,1927,1920,0,0,0,1.0,1,1.0,1,1.0,1,0.1782856125458887,49
2430,0,3847,1927,1920,0,0,0,1.0,1,1.0,1,1.0,1,0.19918199030137052,46
2431,1,3848,1928,1920,0,0,0,1.0,1,1.0,1,1.0,1,0.2222088346083869,45
2432,2,3850,1929,1921,0,0,0,1.0,1,1.0,1,1.0,1,0.28228556560273915,44
2433,2,3852,1930,1922,0,0,0,1.0,1,1.0,1,1.0,1,0.24362960718128313,45
2434,1,3853,1931,1922,0,0,0,1.0,1,1.0,1,1.0,1,0.262229640582616,44
2435,2,3855,1931,1924,0,0,0,1.0,1,1.0,1,1.0,1,0.22076487702029188,44
2436,2,3857,1931,1926,0,0,0,1.0,1,1.0,1,1.0,1,0.1663876653910633,44
2437,2,3859,1932,1927,0,0,0,1.0,1,1.0,1,1.0,1,0.19094478970019066,45
2438,1,3860,1933,1927,0,0,0,1.0,1,1.0,1,1.0,1,0.23546535119068526,45
2439,3,3863,1934,1929,0,0,0,1.0,1,1.0,1,1.0,1,0.19552544358518703,46
2440,0,3863,1934,1929,0,0,0,1.0,1,1.0,1,1.0,1,0.20990188048985145,45
2441,3,3866,1935,1931,0,0,0,1.0,1,1.0,1,1.0,1,0.1916019153491971,45
2442,0,3866,1935,1931,0,0,0,1.0,1,1.0,1,1.0,1,0.1837630987181762,46
2443,0,3866,1935,1931,0,0,0,1.0,1,1.0,1,1.0,1,0.2295490587946106,45
2444,5,3871,1938,1933,0,0,0,1.0,1,1.0,1,1.0,1,0.29805329907022793,46
2445,1,3872,1939,1933,0,0,0,1.0,1,1.0,1,1.0,1,0.33897224271760457,44
2446,1,3873,1940,1933,0,0,0,1.0,1,1.0,1,1.0,1,0.3346785458140301,44
2447,4,3877,1942,1935,0,0,0,1.0,1,1.0,1,1.0,1,0.2919219050698091,42
2448,4,3881,1945,1936,0,0,0,1.0,1,1.0,1,1.0,1,0.26195186527490594,41
2449,1,3882,1946,1936,0,0,0,1.0,1,1.0,1,1.0,1,0.2607147218804126,40
2450,4,3886,1950,1936,0,0,0,1.0,1,1.0,1,1.0,1,0.256013836192881,42
2451,1,3887,1950,1937,0,0,0,1.0,1,1.0,1,1.0,1,0.2103425806943087,43
2452,0,3887,1950,1937,0,0,0,1.0,1,1.0,1,1.0,1,0.2103425806943087,43
2453,1,3888,1950,1938,0,0,0,1.0,1,1.0,1,1.0,1,0.21912292401871472,45
2454,3,3891,1952,1939,0,0,0,1.0,1,1.0,1,1.0,1,0.2557320185747773,47
2455,0,3891,1952,1939,0,0,0,1.0,1,1.0,1,1.0,1,0.2520396821708536,48
2456,1,3892,1953,1939,0,0,0,1.0,1,1.0,1,1.0,1,0.2890467305900581,49
2457,1,3893,1954,1939,0,0,0,1.0,1,1.0,1,1.0,1,0.34346826589434987,48
2458,3,3896,1955,1941,0,0,0,1.0,1,1.0,1,1.0,1,0.30018446927990766,49
2459,2,3898,1955,1943,0,0,0,1.0,1,1.0,1,1.0,1,0.2807267335642471,49
2460,2,3900,1957,1943,0,0,0,1.0,1,1.0,1,1.0,1,0.3137050032565679,50
2461,2,3902,1957,1945,0,0,0,1.0,1,1.0,1,1.0,1,0.29610263007981413,50
2462,6,3908,1959,1949,0,0,0,1.0,1,1.0,1,1.0,1,0.2573042247053037,51
2463,2,3910,1959,1951,0,0,0,1.0,1,1.0,1,1.0,1,0.24022229974914633,51
2464,2,3912,1961,1951,0,0,0,1.0,1,1.0,1,1.0,1,0.22773773919362728,50
2465,0,3912,1961,1951,0,0,0,1.0,1,1.0,1,1.0,1,0.23131454878629637,49
2466,2,3914,1962,1952,0,0,0,1.0,1,1.0,1,1.0,1,0.23143961139943783,49
2467,1,3915,1962,1953,0,0,0,1.0,1,1.0,1,1.0,1,0.2243934310485921,48
2468,1,3916,1963,1953,0,0,0,1.0,1,1.0,1,1.0,1,0.236689400111179,47
2469,2,3918,1964,1954,0,0,0,1.0,1,1.0,1,1.0,1,0.20549841414403605,46
2470,1,3919,1965,1954,0,0,0,1.0,1,1.0,1,1.0,1,0.2181297290175069,44
2471,3,3922,1966,1956,0,0,0,1.0,1,1.0,1,1.0,1,0.20681291471442204,44
2472,2,3924,1966,1958,0,0,0,1.0,1,1.0,1,1.0,1,0.22975689124729493,44
2473,2,3926,1967,1959,0,0,0,1.0,1,1.0,1,1.0,1,0.22780536762642967,43
2474,3,3929,1969,1960,0,0,0,1.0,1,1.0,1,1.0,1,0.25676433040476376,44
2475,6,3935,1970,1965,0,0,0,1.0,1,1.0,1,1.0,1,0.16160628490393578,46
2476,0,3935,1970,1965,0,0,0,1.0,1,1.0,1,1.0,1,0.16160628490393578,46
2477,0,3935,1970,1965,0,0,0,1.0,1,1.0,1,1.0,1,0.16160628490393578,46
2478,0,3935,1970,1965,0,0,0,1.0,1,1.0,1,1.0,1,0.16160628490393578,46
2479,1,3936,1971,1965,0,0,0,1.0,1,1.0,1,1.0,1,0.16617486083118166,46
2480,1,3937,1972,1965,0,0,0,1.0,1,1.0,1,1.0,1,0.19756878463321448,47
2481,1,3938,1973,1965,0,0,0,1.0,1,1.0,1,1.0,1,0.1923418428589832,47
2482,1,3939,1974,1965,0,0,0,1.0,1,1.0,1,1.0,1,0.19998470657643136,45
2483,2,3941,1974,1967,0,0,0,1.0,1,1.0,1,1.0,1,0.17569814043296894,45
2484,1,3942,1975,1967,0,0,0,1.0,1,1.0,1,1.0,1,0.21755677520746197,46
2485,2,3944,1976,1968,0,0,0,1.0,1,1.0,1,1.0,1,0.19354488038171036,44
2486,1,3945,1976,1969,0,0,0,1.0,1,1.0,1,1.0,1,0.15481530473079416,43
2487,1,3946,1977,1969,0,0,0,1.0,1,1.0,1,1.0,1,0.19741952400498763,44
2488,3,3949,1978,1971,0,0,0,1.0,1,1.0,1,1.0,1,0.1727314734320689,45
2489,0,3949,1978,1971,0,0,0,1.0,1,1.0,1,1.0,1,0.18796857801999345,44
2490,2,3951,1980,1971,0,0,0,1.0,1,1.0,1,1.0,1,0.2259145220872598,44
2491,2,3953,1981,1972,0,0,0,1.0,1,1.0,1,1.0,1,0.20115548822645,44
2492,1,3954,1982,1972,0,0,0,1.0,1,1.0,1,1.0,1,0.234261859751297,44
2493,0,3954,1982,1972,0,0,0,1.0,1,1.0,1,1.0,1,0.2538600979155343,42
2494,1,3955,1983,1972,0,0,0,1.0,1,1.0,1,1.0,1,0.26611975476550276,42
2495,2,3957,1983,1974,0,0,0,1.0,1,1.0,1,1.0,1,0.2277009586331647,42
2496,2,3959,1984,1975,0,0,0,1.0,1,1.0,1,1.0,1,0.22533328689745946,42
2497,1,3960,1984,1976,0,0,0,1.0,1,1.0,1,1.0,1,0.24239195056273868,44
2498,1,3961,1985,1976,0,0,0,1.0,1,1.0,1,1.0,1,0.2632824065969415,43
2499,1,3962,1986,1976,0,0,0,1.0,1,1.0,1,1.0,1,0.240903284662296,43
2500,3,3965,1988,1977,0,0,0,1.0,1,1.0,1,1.0,1,0.21884611485749908,44
2501,4,3969,1989,1980,0,0,0,1.0,1,1.0,1,1.0,1,0.15405877121778272,46
2502,0,3969,1989,1980,0,0,0,1.0,1,1.0,1,1.0,1,0.1690516121119771,47
2503,3,3972,1990,1982,0,0,0,1.0,1,1.0,1,1.0,1,0.1786948473454571,47
2504,2,3974,1991,1983,0,0,0,1.0,1,1.0,1,1.0,1,0.19771181272453586,46
2505,3,3977,1994,1983,0,0,0,1.0,1,1.0,1,1.0,1,0.19836549634004452,46
2506,1,3978,1995,1983,0,0,0,1.0,1,1.0,1,1.0,1,0.20750158384764272,45
2507,4,3982,1997,1985,0,0,0,1.0,1,1.0,1,1.0,1,0.1900598034447783,45
2508,2,3984,1998,1986,0,0,0,1.0,1,1.0,1,1.0,1,0.19929107906424653,46
2509,3,3987,1999,1988,0,0,0,1.0,1,1.0,1,1.0,1,0.20020152998729884,45
2510,2,3989,2001,1988,0,0,0,1.0,1,1.0,1,1.0,1,0.22891862155102063,46
2511,2,3991,2001,1990,0,0,0,1.0,1,1.0,1,1.0,1,0.17601314316403066,47
2512,0,3991,2001,1990,0,0,0,1.0,1,1.0,1,1.0,1,0.16504562241590295,47
2513,1,3992,2002,1990,0,0,0,1.0,1,1.0,1,1.0,1,0.1688143841012922,48
2514,3,3995,2004,1991,0,0,0,1.0,1,1.0,1,1.0,1,0.21120455942328156,48
2515,2,3997,2004,1993,0,0,0,1.0,1,1.0,1,1.0,1,0.1614138562300793,49
2516,1,3998,2005,1993,0,0,0,1.0,1,1.0,1,1.0,1,0.18046566713913925,49
2517,2,4000,2006,1994,0,0,0,1.0,1,1.0,1,1.0,1,0.18459014511215133,49
2518,1,4001,2007,1994,0,0,0,1.0,1,1.0,1,1.0,1,0.21539488327878523,48
2519,1,4002,2008,1994,0,0,0,1.0,1,1.0,1,1.0,1,0.2486228781050742,48
2520,2,4004,2009,1995,0,0,0,1.0,1,1.0,1,1.0,1,0.2907793462713307,46
2521,5,4009,2011,1998,0,0,0,1.0,1,1.0,1,1.0,1,0.2800575198595508,47
2522,1,4010,2012,1998,0,0,0,1.0,1,1.0,1,1.0,1,0.3226081468349509,45
2523,3,4013,2013,2000,0,0,0,1.0,1,1.0,1,1.0,1,0.3387965396078454,44
2524,0,4013,2013,2000,0,0,0,1.0,1,1.0,1,1.0,1,0.3138376299845306,42
2525,5,4018,2014,2004,0,0,0,1.0,1,1.0,1,1.0,1,0.2911286682092105,42
2526,0,4018,2014,2004,0,0,0,1.0,1,1.0,1,1.0,1,0.2898313021974613,41
2527,0,4018,2014,2004,0,0,0,1.0,1,1.0,1,1.0,1,0.2898313021974613,41
2528,0,4018,2014,2004,0,0,0,1.0,1,1.0,1,1.0,1,0.3091756943219544,41
2529,1,4019,2015,2004,0,0,0,1.0,1,1.0,1,1.0,1,0.3268910256118062,42
2530,0,4019,2015,2004,0,0,0,1.0,1,1.0,1,1.0,1,0.3377853856035871,41
2531,1,4020,2015,2005,0,0,0,1.0,1,1.0,1,1.0,1,0.30676532122824957,41
2532,0,4020,2015,2005,0,0,0,1.0,1,1.0,1,1.0,1,0.32918484115258695,43
2533,0,4020,2015,2005,0,0,0,1.0,1,1.0,1,1.0,1,0.32918484115258695,43
2534,0,4020,2015,2005,0,0,0,1.0,1,1.0,1,1.0,1,0.32918484115258695,43
2535,2,4022,2016,2006,0,0,0,1.0,1,1.0,1,1.0,1,0.3478746900143315,44
2536,0,4022,2016,2006,0,0,0,1.0,1,1.0,1,1.0,1,0.3478746900143315,44
2537,1,4023,2016,2007,0,0,0,1.0,1,1.0,1,1.0,1,0.3496113391032861,45
2538,1,4024,2016,2008,0,0,0,1.0,1,1.0,1,1.0,1,0.33317687154739434,48
2539,2,4026,2017,2009,0,0,0,1.0,1,1.0,1,1.0,1,0.305287100703162,48
2540,1,4027,2017,2010,0,0,0,1.0,1,1.0,1,1.0,1,0.3113139695050935,50
2541,4,4031,2018,2013,0,0,0,1.0,1,1.0,1,1.0,1,0.2572777519425961,52
2542,6,4037,2022,2015,0,0,0,1.0,1,1.0,1,1.0,1,0.31060242632672025,52
2543,4,4041,2024,2017,0,0,0,1.0,1,1.0,1,1.0,1,0.30395703979962085,51
2544,6,4047,2029,2018,0,0,0,1.0,1,1.0,1,1.0,1,0.3359094669014423,51
2545,8,4055,2029,2026,0,0,0,1.0,1,1.0,1,1.0,1,0.24642367607906354,50
2546,1,4056,2030,2026,0,0,0,1.0,1,1.0,1,1.0,1,0.262031435301444,50
2547,1,4057,2030,2027,0,0,0,1.0,1,1.0,1,1.0,1,0.24321380082628308,47
2548,0,4057,2030,2027,0,0,0,1.0,1,1.0,1,1.0,1,0.23114033852803095,46
2549,2,4059,2031,2028,0,0,0,1.0,1,1.0,1,1.0,1,0.24338997383308802,46
2550,2,4061,2033,2028,0,0,0,1.0,1,1.0,1,1.0,1,0.2604596950578141,44
2551,1,4062,2033,2029,0,0,0,1.0,1,1.0,1,1.0,1,0.23252374401386613,43
2552,0,4062,2033,2029,0,0,0,1.0,1,1.0,1,1.0,1,0.25554821312227505,43
2553,0,4062,2033,2029,0,0,0,1.0,1,1.0,1,1.0,1,0.26270730079024246,44
2554,2,4064,2035,2029,0,0,0,1.0,1,1.0,1,1.0,1,0.27566589356979615,45
2555,3,4067,2036,2031,0,0,0,1.0,1,1.0,1,1.0,1,0.28933373250860567,44
2556,3,4070,2036,2034,0,0,0,1.0,1,1.0,1,1.0,1,0.24092611992128368,44
2557,2,4072,2037,2035,0,0,0,1.0,1,1.0,1,1.0,1,0.24205028205452114,41
2558,0,4072,2037,2035,0,0,0,1.0,1,1.0,1,1.0,1,0.2491940561416732,40
2559,2,4074,2037,2037,0,0,0,1.0,1,1.0,1,1.0,1,0.2313468606511756,41
2560,0,4074,2037,2037,0,0,0,1.0,1,1.0,1,1.0,1,0.2313468606511756,41
2561,1,4075,2037,2038,0,0,0,1.0,1,1.0,1,1.0,1,0.23519584097998236,43
2562,0,4075,2037,2038,0,0,0,1.0,1,1.0,1,1.0,1,0.25095625224566165,44
2563,2,4077,2037,2040,0,0,0,1.0,1,1.0,1,1.0,1,0.22450996737739884,44
2564,1,4078,2038,2040,0,0,0,1.0,1,1.0,1,1.0,1,0.24123632484910182,44
2565,0,4078,2038,2040,0,0,0,1.0,1,1.0,1,1.0,1,0.24160481181975807,45
2566,3,4081,2040,2041,0,0,0,1.0,1,1.0,1,1.0,1,0.25412556933974234,46
2567,3,4084,2041,2043,0,0,0,1.0,1,1.0,1,1.0,1,0.23942911335084607,48
2568,1,4085,2042,2043,0,0,0,1.0,1,1.0,1,1.0,1,0.25682034341011295,48
2569,1,4086,2042,2044,0,0,0,1.0,1,1.0,1,1.0,1,0.26169234243884665,49
2570,0,4086,2042,2044,0,0,0,1.0,1,1.0,1,1.0,1,0.27931013881012307,48
2571,0,4086,2042,2044,0,0,0,1.0,1,1.0,1,1.0,1,0.27931013881012307,48
2572,1,4087,2042,2045,0,0,0,1.0,1,1.0,1,1.0,1,0.24647660377580657,49
2573,2,4089,2042,2047,0,0,0,1.0,1,1.0,1,1.0,1,0.2278208040401699,50
2574,2,4091,2043,2048,0,0,0,1.0,1,1.0,1,1.0,1,0.22746485737550948,49
2575,0,4091,2043,2048,0,0,0,1.0,1,1.0,1,1.0,1,0.2327869553069737,48
2576,0,4091,2043,2048,0,0,0,1.0,1,1.0,1,1.0,1,0.2327869553069737,48
2577,2,4093,2043,2050,0,0,0,1.0,1,1.0,1,1.0,1,0.21682683897012842,50
2578,0,4093,2043,2050,0,0,0,1.0,1,1.0,1,1.0,1,0.21682683897012842,50
2579,3,4096,2044,2052,0,0,0,1.0,1,1.0,1,1.0,1,0.19140567301265268,51
2580,1,4097,2045,2052,0,0,0,1.0,1,1.0,1,1.0,1,0.2146160450278594,52
2581,1,4098,2045,2053,0,0,0,1.0,1,1.0,1,1.0,1,0.21687387383381865,51
2582,1,4099,2046,2053,0,0,0,1.0,1,1.0,1,1.0,1,0.2328600414559904,51
2583,4,4103,2048,2055,0,0,0,1.0,1,1.0,1,1.0,1,0.2194496670006551,51
2584,2,4105,2050,2055,0,0,0,1.0,1,1.0,1,1.0,1,0.25281914412141765,51
2585,2,4107,2050,2057,0,0,0,1.0,1,1.0,1,1.0,1,0.21711036688125737,50
2586,3,4110,2053,2057,0,0,0,1.0,1,1.0,1,1.0,1,0.2567753742209456,50
2587,1,4111,2053,2058,0,0,0,1.0,1,1.0,1,1.0,1,0.22064143321530832,48
2588,7,4118,2055,2063,0,0,0,1.0,1,1.0,1,1.0,1,0.1803037104827299,50
2589,2,4120,2056,2064,0,0,0,1.0,1,1.0,1,1.0,1,0.1374547901482023,48
2590,0,4120,2056,2064,0,0,0,1.0,1,1.0,1,1.0,1,0.14570910572110246,47
2591,0,4120,2056,2064,0,0,0,1.0,1,1.0,1,1.0,1,0.14570910572110246,47
2592,2,4122,2057,2065,0,0,0,1.0,1,1.0,1,1.0,1,0.1488556373717498,47
2593,2,4124,2058,2066,0,0,0,1.0,1,1.0,1,1.0,1,0.1670372305212556,47
2594,3,4127,2061,2066,0,0,0,1.0,1,1.0,1,1.0,1,0.2352288509478865,49
2595,5,4132,2063,2069,0,0,0,1.0,1,1.0,1,1.0,1,0.1923950885365413,48
2596,3,4135,2065,2070,0,0,0,1.0,1,1.0,1,1.0,1,0.1642956551478331,47
2597,2,4137,2066,2071,0,0,0,1.0,1,1.0,1,1.0,1,0.12496638201629089,48
2598,2,4139,2068,2071,0,0,0,1.0,1,1.0,1,1.0,1,0.13049504525990704,48
2599,1,4140,2069,2071,0,0,0,1.0,1,1.0,1,1.0,1,0.1281660007975847,49
2600,0,4140,2069,2071,0,0,0,1.0,1,1.0,1,1.0,1,0.14231433216745948,52
2601,3,4143,2071,2072,0,0,0,1.0,1,1.0,1,1.0,1,0.17942728101125963,51
2602,1,4144,2072,2072,0,0,0,1.0,1,1.0,1,1.0,1,0.19707636046259133,52
2603,1,4145,2072,2073,0,0,0,1.0,1,1.0,1,1.0,1,0.20573320082159566,53
2604,1,4146,2072,2074,0,0,0,1.0,1,1.0,1,1.0,1,0.1765063498113355,53
2605,1,4147,2073,2074,0,0,0,1.0,1,1.0,1,1.0,1,0.210046313143302,52
2606,1,4148,2073,2075,0,0,0,1.0,1,1.0,1,1.0,1,0.19819998500429364,52
2607,1,4149,2074,2075,0,0,0,1.0,1,1.0,1,1.0,1,0.22758343634167116,52
2608,1,4150,2074,2076,0,0,0,1.0,1,1.0,1,1.0,1,0.21134856647713457,52
2609,0,4150,2074,2076,0,0,0,1.0,1,1.0,1,1.0,1,0.21441420228994926,53
2610,3,4153,2075,2078,0,0,0,1.0,1,1.0,1,1.0,1,0.2066339677221772,54
2611,4,4157,2076,2081,0,0,0,1.0,1,1.0,1,1.0,1,0.12868431168640906,54
2612,1,4158,2077,2081,0,0,0,1.0,1,1.0,1,1.0,1,0.13977149471887268,56
2613,0,4158,2077,2081,0,0,0,1.0,1,1.0,1,1.0,1,0.13977149471887268,56
2614,1,4159,2078,2081,0,0,0,1.0,1,1.0,1,1.0,1,0.1285865532100506,56
2615,1,4160,2079,2081,0,0,0,1.0,1,1.0,1,1.0,1,0.13018061594312455,57
2616,0,4160,2079,2081,0,0,0,1.0,1,1.0,1,1.0,1,0.13018061594312455,57
2617,1,4161,2080,2081,0,0,0,1.0,1,1.0,1,1.0,1,0.14229984675966764,58
2618,0,4161,2080,2081,0,0,0,1.0,1,1.0,1,1.0,1,0.14229984675966764,58
2619,1,4162,2080,2082,0,0,0,1.0,1,1.0,1,1.0,1,0.12903025569985582,58
2620,1,4163,2080,2083,0,0,0,1.0,1,1.0,1,1.0,1,0.13765065061879936,60
2621,2,4165,2080,2085,0,0,0,1.0,1,1.0,1,1.0,1,0.1096782278030839,59
2622,2,4167,2082,2085,0,0,0,1.0,1,1.0,1,1.0,1,0.1270342083971228,60
2623,4,4171,2083,2088,0,0,0,1.0,1,1.0,1,1.0,1,0.1273383148619815,59
2624,4,4175,2087,2088,0,0,0,1.0,1,1.0,1,1.0,1,0.1649549853049628,58
2625,3,4178,2090,2088,0,0,0,1.0,1,1.0,1,1.0,1,0.18307954518927647,58
2626,3,4181,2092,2089,0,0,0,1.0,1,1.0,1,1.0,1,0.1876188909209562,57
2627,3,4184,2093,2091,0,0,0,1.0,1,1.0,1,1.0,1,0.13239051269310204,55
2628,2,4186,2095,2091,0,0,0,1.0,1,1.0,1,1.0,1,0.15364087527773349,55
2629,0,4186,2095,2091,0,0,0,1.0,1,1.0,1,1.0,1,0.1351207974226061,54
2630,1,4187,2096,2091,0,0,0,1.0,1,1.0,1,1.0,1,0.1913772537245421,55
2631,0,4187,2096,2091,0,0,0,1.0,1,1.0,1,1.0,1,0.18608423869351942,55
2632,2,4189,2098,2091,0,0,0,1.0,1,1.0,1,1.0,1,0.23063303351193354,55
2633,2,4191,2099,2092,0,0,0,1.0,1,1.0,1,1.0,1,0.227055533910488,53
2634,4,4195,2101,2094,0,0,0,1.0,1,1.0,1,1.0,1,0.22128747088753475,52
2635,3,4198,2102,2096,0,0,0,1.0,1,1.0,1,1.0,1,0.21890613004046913,52
2636,3,4201,2104,2097,0,0,0,1.0,1,1.0,1,1.0,1,0.2717218205771677,51
2637,3,4204,2106,2098,0,0,0,1.0,1,1.0,1,1.0,1,0.2408067727139684,50
2638,4,4208,2109,2099,0,0,0,1.0,1,1.0,1,1.0,1,0.25862836867749944,48
2639,4,4212,2112,2100,0,0,0,1.0,1,1.0,1,1.0,1,0.28615480028451684,48
2640,9,4221,2116,2105,0,0,0,1.0,1,1.0,1,1.0,1,0.21333014097714795,46
2641,2,4223,2117,2106,0,0,0,1.0,1,1.0,1,1.0,1,0.19858904428923352,46
2642,5,4228,2120,2108,0,0,0,1.0,1,1.0,1,1.0,1,0.1726547035004191,47
2643,0,4228,2120,2108,0,0,0,1.0,1,1.0,1,1.0,1,0.18929178914996042,45
2644,1,4229,2121,2108,0,0,0,1.0,1,1.0,1,1.0,1,0.199467025947316,44
2645,0,4229,2121,2108,0,0,0,1.0,1,1.0,1,1.0,1,0.21159834363110464,42
2646,2,4231,2122,2109,0,0,0,1.0,1,1.0,1,1.0,1,0.20069212884944027,43
2647,0,4231,2122,2109,0,0,0,1.0,1,1.0,1,1.0,1,0.19316951280784936,40
2648,1,4232,2123,2109,0,0,0,1.0,1,1.0,1,1.0,1,0.12910100442557812,41
2649,2,4234,2123,2111,0,0,0,1.0,1,1.0,1,1.0,1,0.10371346273245799,43
2650,0,4234,2123,2111,0,0,0,1.0,1,1.0,1,1.0,1,0.1091188267281275,43
2651,0,4234,2123,2111,0,0,0,1.0,1,1.0,1,1.0,1,0.0962195097519406,44
2652,1,4235,2124,2111,0,0,0,1.0,1,1.0,1,1.0,1,0.09380412580741594,44
2653,0,4235,2124,2111,0,0,0,1.0,1,1.0,1,1.0,1,0.09380412580741594,44
2654,2,4237,2126,2111,0,0,0,1.0,1,1.0,1,1.0,1,0.13998485193718918,45
2655,1,4238,2127,2111,0,0,0,1.0,1,1.0,1,1.0,1,0.1623475977044543,45
2656,0,4238,2127,2111,0,0,0,1.0,1,1.0,1,1.0,1,0.1623475977044543,45
2657,2,4240,2127,2113,0,0,0,1.0,1,1.0,1,1.0,1,0.1401717582880334,45
2658,3,4243,2129,2114,0,0,0,1.0,1,1.0,1,1.0,1,0.15375018433605842,47
2659,1,4244,2129,2115,0,0,0,1.0,1,1.0,1,1.0,1,0.14937123298991453,46
2660,1,4245,2130,2115,0,0,0,1.0,1,1.0,1,1.0,1,0.1730055277858468,46
2661,4,4249,2131,2118,0,0,0,1.0,1,1.0,1,1.0,1,0.16743246350596722,46
2662,0,4249,2131,2118,0,0,0,1.0,1,1.0,1,1.0,1,0.18011785421645313,47
2663,3,4252,2134,2118,0,0,0,1.0,1,1.0,1,1.0,1,0.19771526122585226,46
2664,3,4255,2137,2118,0,0,0,1.0,1,1.0,1,1.0,1,0.2128683281885518,45
2665,4,4259,2139,2120,0,0,0,1.0,1,1.0,1,1.0,1,0.19987509558826905,47
2666,4,4263,2143,2120,0,0,0,1.0,1,1.0,1,1.0,1,0.2107948628823036,47
2667,6,4269,2145,2124,0,0,0,1.0,1,1.0,1,1.0,1,0.16847029858199555,45
2668,3,4272,2147,2125,0,0,0,1.0,1,1.0,1,1.0,1,0.16612818555431283,45
2669,1,4273,2148,2125,0,0,0,1.0,1,1.0,1,1.0,1,0.13653082291446628,45
2670,4,4277,2151,2126,0,0,0,1.0,1,1.0,1,1.0,1,0.17883244819631153,45
2671,0,4277,2151,2126,0,0,0,1.0,1,1.0,1,1.0,1,0.17307439386483722,41
2672,1,4278,2152,2126,0,0,0,1.0,1,1.0,1,1.0,1,0.21331957586937142,40
2673,0,4278,2152,2126,0,0,0,1.0,1,1.0,1,1.0,1,0.2343191159044895,39
2674,2,4280,2153,2127,0,0,0,1.0,1,1.0,1,1.0,1,0.25683456214636974,37
2675,2,4282,2155,2127,0,0,0,1.0,1,1.0,1,1.0,1,0.27306756632673423,35
2676,1,4283,2156,2127,0,0,0,1.0,1,1.0,1,1.0,1,0.2710341963088803,34
2677,4,4287,2159,2128,0,0,0,1.0,1,1.0,1,1.0,1,0.24204374280271684,32
2678,1,4288,2160,2128,0,0,0,1.0,1,1.0,1,1.0,1,0.24185909532795663,33
2679,1,4289,2161,2128,0,0,0,1.0,1,1.0,1,1.0,1,0.29095254379027174,33
2680,7,4296,2165,2131,0,0,0,1.0,1,1.0,1,1.0,1,0.26654092421795733,33
2681,2,4298,2166,2132,0,0,0,1.0,1,1.0,1,1.0,1,0.2012955211963623,32
2682,0,4298,2166,2132,0,0,0,1.0,1,1.0,1,1.0,1,0.2012955211963623,32
2683,1,4299,2167,2132,0,0,0,1.0,1,1.0,1,1.0,1,0.2931191264947555,32
2684,1,4300,2167,2133,0,0,0,1.0,1,1.0,1,1.0,1,0.25744864992422073,31
2685,2,4302,2168,2134,0,0,0,1.0,1,1.0,1,1.0,1,0.2988937877002741,30
2686,3,4305,2169,2136,0,0,0,1.0,1,1.0,1,1.0,1,0.2588878144060197,29
2687,0,4305,2169,2136,0,0,0,1.0,1,1.0,1,1.0,1,0.24986751731224566,28
2688,0,4305,2169,2136,0,0,0,1.0,1,1.0,1,1.0,1,0.24986751731224566,28
2689,1,4306,2169,2137,0,0,0,1.0,1,1.0,1,1.0,1,0.24195519769586737,29
2690,1,4307,2169,2138,0,0,0,1.0,1,1.0,1,1.0,1,0.21621618742597717,29
2691,2,4309,2171,2138,0,0,0,1.0,1,1.0,1,1.0,1,0.24024641297026067,29
2692,1,4310,2171,2139,0,0,0,1.0,1,1.0,1,1.0,1,0.22976921158202457,31
2693,2,4312,2173,2139,0,0,0,1.0,1,1.0,1,1.0,1,0.3026950409673309,32
2694,3,4315,2174,2141,0,0,0,1.0,1,1.0,1,1.0,1,0.24730886630610213,32
2695,1,4316,2174,2142,0,0,0,1.0,1,1.0,1,1.0,1,0.20927986543249838,33
2696,0,4316,2174,2142,0,0,0,1.0,1,1.0,1,1.0,1,0.20927986543249838,33
2697,1,4317,2175,2142,0,0,0,1.0,1,1.0,1,1.0,1,0.231243501765498,34
2698,2,4319,2177,2142,0,0,0,1.0,1,1.0,1,1.0,1,0.2325474363941496,34
2699,3,4322,2178,2144,0,0,0,1.0,1,1.0,1,1.0,1,0.1794019248825179,36
2700,1,4323,2178,2145,0,0,0,1.0,1,1.0,1,1.0,1,0.16727300187876504,36
2701,0,4323,2178,2145,0,0,0,1.0,1,1.0,1,1.0,1,0.16727300187876504,36
2702,1,4324,2179,2145,0,0,0,1.0,1,1.0,1,1.0,1,0.19869370015923493,36
2703,2,4326,2180,2146,0,0,0,1.0,1,1.0,1,1.0,1,0.18091063509594085,38
2704,1,4327,2181,2146,0,0,0,1.0,1,1.0,1,1.0,1,0.23408959311912958,37
2705,3,4330,2183,2147,0,0,0,1.0,1,1.0,1,1.0,1,0.21641290270083177,36
2706,2,4332,2185,2147,0,0,0,1.0,1,1.0,1,1.0,1,0.2646282906718113,34
2707,2,4334,2186,2148,0,0,0,1.0,1,1.0,1,1.0,1,0.27992247319246716,36
2708,3,4337,2189,2148,0,0,0,1.0,1,1.0,1,1.0,1,0.29246222760483215,36
2709,3,4340,2191,2149,0,0,0,1.0,1,1.0,1,1.0,1,0.2767277987622264,33
2710,1,4341,2192,2149,0,0,0,1.0,1,1.0,1,1.0,1,0.2975869639468356,32
2711,1,4342,2193,2149,0,0,0,1.0,1,1.0,1,1.0,1,0.26909762912404134,29
2712,1,4343,2194,2149,0,0,0,1.0,1,1.0,1,1.0,1,0.32044027431261995,28
2713,1,4344,2194,2150,0,0,0,1.0,1,1.0,1,1.0,1,0.29034511596221996,28
2714,2,4346,2196,2150,0,0,0,1.0,1,1.0,1,1.0,1,0.37190269605056203,25
2715,1,4347,2197,2150,0,0,0,1.0,1,1.0,1,1.0,1,0.4158040506651668,24
2716,4,4351,2199,2152,0,0,0,1.0,1,1.0,1,1.0,1,0.45037909048915475,23
2717,5,4356,2200,2156,0,0,0,1.0,1,1.0,1,1.0,1,0.251349423418838,24
2718,0,4356,2200,2156,0,0,0,1.0,1,1.0,1,1.0,1,0.251349423418838,24
2719,1,4357,2200,2157,0,0,0,1.0,1,1.0,1,1.0,1,0.17657138854323945,25
2720,2,4359,2202,2157,0,0,0,1.0,1,1.0,1,1.0,1,0.1941500625152696,25
2721,2,4361,2204,2157,0,0,0,1.0,1,1.0,1,1.0,1,0.19430221459702218,26
2722,1,4362,2205,2157,0,0,0,1.0,1,1.0,1,1.0,1,0.23955544888941754,26
2723,1,4363,2206,2157,0,0,0,1.0,1,1.0,1,1.0,1,0.2209367866352642,26
2724,2,4365,2207,2158,0,0,0,1.0,1,1.0,1,1.0,1,0.24788026168347757,27
2725,1,4366,2208,2158,0,0,0,1.0,1,1.0,1,1.0,1,0.24661444865241364,27
2726,1,4367,2208,2159,0,0,0,1.0,1,1.0,1,1.0,1,0.20015652676240525,28
2727,0,4367,2208,2159,0,0,0,1.0,1,1.0,1,1.0,1,0.18145647230821801,29
2728,0,4367,2208,2159,0,0,0,1.0,1,1.0,1,1.0,1,0.17441400477117572,28
2729,0,4367,2208,2159,0,0,0,1.0,1,1.0,1,1.0,1,0.17441400477117572,28
2730,0,4367,2208,2159,0,0,0,1.0,1,1.0,1,1.0,1,0.17399849120251726,29
2731,1,4368,2209,2159,0,0,0,1.0,1,1.0,1,1.0,1,0.2420634566200213,30
2732,2,4370,2210,2160,0,0,0,1.0,1,1.0,1,1.0,1,0.22836091403097142,29
2733,0,4370,2210,2160,0,0,0,1.0,1,1.0,1,1.0,1,0.22836091403097142,29
2734,0,4370,2210,2160,0,0,0,1.0,1,1.0,1,1.0,1,0.22836091403097142,29
2735,1,4371,2211,2160,0,0,0,1.0,1,1.0,1,1.0,1,0.2776003222577354,29
2736,2,4373,2211,2162,0,0,0,1.0,1,1.0,1,1.0,1,0.2533033591437527,30
2737,0,4373,2211,2162,0,0,0,1.0,1,1.0,1,1.0,1,0.2533033591437527,30
2738,3,4376,2214,2162,0,0,0,1.0,1,1.0,1,1.0,1,0.303253658209496,29
2739,0,4376,2214,2162,0,0,0,1.0,1,1.0,1,1.0,1,0.311350875300129,30
2740,1,4377,2215,2162,0,0,0,1.0,1,1.0,1,1.0,1,0.3413307054232586,29
2741,3,4380,2216,2164,0,0,0,1.0,1,1.0,1,1.0,1,0.31799380732896343,29
2742,2,4382,2217,2165,0,0,0,1.0,1,1.0,1,1.0,1,0.31427780139051437,29
2743,1,4383,2217,2166,0,0,0,1.0,1,1.0,1,1.0,1,0.32312620365925593,30
2744,3,4386,2219,2167,0,0,0,1.0,1,1.0,1,1.0,1,0.38222664128891654,28
2745,2,4388,2219,2169,0,0,0,1.0,1,1.0,1,1.0,1,0.29668724476262254,27
2746,1,4389,2220,2169,0,0,0,1.0,1,1.0,1,1.0,1,0.37257067230639807,26
2747,1,4390,2221,2169,0,0,0,1.0,1,1.0,1,1.0,1,0.42165076160637655,22
2748,2,4392,2221,2171,0,0,0,1.0,1,1.0,1,1.0,1,0.40624716933894406,22
2749,0,4392,2221,2171,0,0,0,1.0,1,1.0,1,1.0,1,0.4655319137247985,20
2750,0,4392,2221,2171,0,0,0,1.0,1,1.0,1,1.0,1,0.5011046056537029,17
2751,1,4393,2221,2172,0,0,0,1.0,1,1.0,1,1.0,1,0.45823622459350727,17
2752,0,4393,2221,2172,0,0,0,1.0,1,1.0,1,1.0,1,0.4267137594981858,16
2753,0,4393,2221,2172,0,0,0,1.0,1,1.0,1,1.0,1,0.4267137594981858,16
2754,1,4394,2222,2172,0,0,0,1.0,1,1.0,1,1.0,1,0.4469285379958192,16
2755,1,4395,2223,2172,0,0,0,1.0,1,1.0,1,1.0,1,0.49603875835505323,16
2756,1,4396,2223,2173,0,0,0,1.0,1,1.0,1,1.0,1,0.501408232155948,17
2757,1,4397,2224,2173,0,0,0,1.0,1,1.0,1,1.0,1,0.45495570728283646,18
2758,0,4397,2224,2173,0,0,0,1.0,1,1.0,1,1.0,1,0.45495570728283646,18
2759,0,4397,2224,2173,0,0,0,1.0,1,1.0,1,1.0,1,0.4743329883886808,19
2760,0,4397,2224,2173,0,0,0,1.0,1,1.0,1,1.0,1,0.4436907623110062,18
2761,0,4397,2224,2173,0,0,0,1.0,1,1.0,1,1.0,1,0.4436907623110062,18
2762,0,4397,2224,2173,0,0,0,1.0,1,1.0,1,1.0,1,0.4436907623110062,18
2763,0,4397,2224,2173,0,0,0,1.0,1,1.0,1,1.0,1,0.4436907623110062,18
2764,1,4398,2225,2173,0,0,0,1.0,1,1.0,1,1.0,1,0.42911453203433503,18
2765,1,4399,2226,2173,0,0,0,1.0,1,1.0,1,1.0,1,0.4474057087127034,18
2766,0,4399,2226,2173,0,0,0,1.0,1,1.0,1,1.0,1,0.4474057087127034,18
2767,0,4399,2226,2173,0,0,0,1.0,1,1.0,1,1.0,1,0.47975653308475297,17
2768,0,4399,2226,2173,0,0,0,1.0,1,1.0,1,1.0,1,0.47975653308475297,17
2769,1,4400,2227,2173,0,0,0,1.0,1,1.0,1,1.0,1,0.47975653308475297,17
2770,0,4400,2227,2173,0,0,0,1.0,1,1.0,1,1.0,1,0.47975653308475297,17
2771,0,4400,2227,2173,0,0,0,1.0,1,1.0,1,1.0,1,0.47975653308475297,17
2772,1,4401,2227,2174,0,0,0,1.0,1,1.0,1,1.0,1,0.4406677511587326,17
2773,0,4401,2227,2174,0,0,0,1.0,1,1.0,1,1.0,1,0.4406677511587326,17
2774,0,4401,2227,2174,0,0,0,1.0,1,1.0,1,1.0,1,0.39461328281674163,18
2775,2,4403,2229,2174,0,0,0,1.0,1,1.0,1,1.0,1,0.4195055943332546,20
2776,0,4403,2229,2174,0,0,0,1.0,1,1.0,1,1.0,1,0.4046524053014354,21
2777,1,4404,2230,2174,0,0,0,1.0,1,1.0,1,1.0,1,0.4328684870976462,21
2778,3,4407,2231,2176,0,0,0,1.0,1,1.0,1,1.0,1,0.39361159383245536,21
2779,1,4408,2232,2176,0,0,0,1.0,1,1.0,1,1.0,1,0.4118513626882933,22
2780,0,4408,2232,2176,0,0,0,1.0,1,1.0,1,1.0,1,0.4118513626882933,22
2781,3,4411,2233,2178,0,0,0,1.0,1,1.0,1,1.0,1,0.40248043523388605,22
2782,3,4414,2234,2180,0,0,0,1.0,1,1.0,1,1.0,1,0.2622644024488753,23
2783,0,4414,2234,2180,0,0,0,1.0,1,1.0,1,1.0,1,0.23402650727712734,22
2784,3,4417,2236,2181,0,0,0,1.0,1,1.0,1,1.0,1,0.3137406340817993,21
2785,0,4417,2236,2181,0,0,0,1.0,1,1.0,1,1.0,1,0.3159207654771718,19
2786,0,4417,2236,2181,0,0,0,1.0,1,1.0,1,1.0,1,0.3159207654771718,19
2787,0,4417,2236,2181,0,0,0,1.0,1,1.0,1,1.0,1,0.30436126775459754,20
2788,1,4418,2237,2181,0,0,0,1.0,1,1.0,1,1.0,1,0.3282481213476988,20
2789,0,4418,2237,2181,0,0,0,1.0,1,1.0,1,1.0,1,0.3390003720621745,19
2790,0,4418,2237,2181,0,0,0,1.0,1,1.0,1,1.0,1,0.3318048871073842,20
2791,0,4418,2237,2181,0,0,0,1.0,1,1.0,1,1.0,1,0.3318048871073842,20
2792,0,4418,2237,2181,0,0,0,1.0,1,1.0,1,1.0,1,0.3318048871073842,20
2793,0,4418,2237,2181,0,0,0,1.0,1,1.0,1,1.0,1,0.36866836684944393,19
2794,0,4418,2237,2181,0,0,0,1.0,1,1.0,1,1.0,1,0.388208103137435,20
2795,0,4418,2237,2181,0,0,0,1.0,1,1.0,1,1.0,1,0.39473275651338735,21
2796,0,4418,2237,2181,0,0,0,1.0,1,1.0,1,1.0,1,0.37991955550355855,22
2797,0,4418,2237,2181,0,0,0,1.0,1,1.0,1,1.0,1,0.4235965394082437,21
2798,1,4419,2238,2181,0,0,0,1.0,1,1.0,1,1.0,1,0.47689752326542684,21
2799,1,4420,2238,2182,0,0,0,1.0,1,1.0,1,1.0,1,0.4125358116684166,20
2800,0,4420,2238,2182,0,0,0,1.0,1,1.0,1,1.0,1,0.4125358116684166,20
2801,0,4420,2238,2182,0,0,0,1.0,1,1.0,1,1.0,1,0.4125358116684166,20
2802,1,4421,2238,2183,0,0,0,1.0,1,1.0,1,1.0,1,0.3565093061021987,20
2803,0,4421,2238,2183,0,0,0,1.0,1,1.0,1,1.0,1,0.36016533137967593,21
2804,1,4422,2238,2184,0,0,0,1.0,1,1.0,1,1.0,1,0.3247015176541651,22
2805,1,4423,2239,2184,0,0,0,1.0,1,1.0,1,1.0,1,0.29236327326168327,22
2806,1,4424,2239,2185,0,0,0,1.0,1,1.0,1,1.0,1,0.25533508428745066,23
2807,4,4428,2242,2186,0,0,0,1.0,1,1.0,1,1.0,1,0.3474237495706523,24
2808,2,4430,2244,2186,0,0,0,1.0,1,1.0,1,1.0,1,0.4073703988761064,24
2809,4,4434,2244,2190,0,0,0,1.0,1,1.0,1,1.0,1,0.2467389404234944,26
2810,1,4435,2244,2191,0,0,0,1.0,1,1.0,1,1.0,1,0.16427086930014181,26
2811,0,4435,2244,2191,0,0,0,1.0,1,1.0,1,1.0,1,0.17626626088626254,27
2812,0,4435,2244,2191,0,0,0,1.0,1,1.0,1,1.0,1,0.17626626088626254,27
2813,0,4435,2244,2191,0,0,0,1.0,1,1.0,1,1.0,1,0.16688344143760744,28
2814,1,4436,2245,2191,0,0,0,1.0,1,1.0,1,1.0,1,0.23174558764298508,29
2815,0,4436,2245,2191,0,0,0,1.0,1,1.0,1,1.0,1,0.2366804578073173,30
2816,1,4437,2246,2191,0,0,0,1.0,1,1.0,1,1.0,1,0.23484378506811332,31
2817,0,4437,2246,2191,0,0,0,1.0,1,1.0,1,1.0,1,0.23484378506811332,31
2818,3,4440,2247,2193,0,0,0,1.0,1,1.0,1,1.0,1,0.18885157666711225,32
2819,0,4440,2247,2193,0,0,0,1.0,1,1.0,1,1.0,1,0.18885157666711225,32
2820,0,4440,2247,2193,0,0,0,1.0,1,1.0,1,1.0,1,0.20031981186808084,33
2821,0,4440,2247,2193,0,0,0,1.0,1,1.0,1,1.0,1,0.22055063673882871,34
2822,1,4441,2248,2193,0,0,0,1.0,1,1.0,1,1.0,1,0.23136542716411884,35
2823,1,4442,2249,2193,0,0,0,1.0,1,1.0,1,1.0,1,0.21970330345863176,31
2824,3,4445,2251,2194,0,0,0,1.0,1,1.0,1,1.0,1,0.33136311676706304,33
2825,1,4446,2251,2195,0,0,0,1.0,1,1.0,1,1.0,1,0.2646751600048996,31
2826,1,4447,2252,2195,0,0,0,1.0,1,1.0,1,1.0,1,0.31515476050172914,31
2827,4,4451,2254,2197,0,0,0,1.0,1,1.0,1,1.0,1,0.2597966654972689,32
2828,3,4454,2255,2199,0,0,0,1.0,1,1.0,1,1.0,1,0.28692751688721935,33
2829,5,4459,2257,2202,0,0,0,1.0,1,1.0,1,1.0,1,0.264283039131489,33
2830,0,4459,2257,2202,0,0,0,1.0,1,1.0,1,1.0,1,0.25195905232029847,32
2831,1,4460,2258,2202,0,0,0,1.0,1,1.0,1,1.0,1,0.28388741789039335,31
2832,2,4462,2260,2202,0,0,0,1.0,1,1.0,1,1.0,1,0.3115234714723623,30
2833,4,4466,2262,2204,0,0,0,1.0,1,1.0,1,1.0,1,0.2881016494940178,29
2834,4,4470,2265,2205,0,0,0,1.0,1,1.0,1,1.0,1,0.3160844478263105,29
2835,3,4473,2267,2206,0,0,0,1.0,1,1.0,1,1.0,1,0.28421520463907324,27
2836,0,4473,2267,2206,0,0,0,1.0,1,1.0,1,1.0,1,0.25270701002946544,27
2837,0,4473,2267,2206,0,0,0,1.0,1,1.0,1,1.0,1,0.26485577191958715,28
2838,1,4474,2268,2206,0,0,0,1.0,1,1.0,1,1.0,1,0.3117900760184655,29
2839,1,4475,2268,2207,0,0,0,1.0,1,1.0,1,1.0,1,0.24936944879036593,29
2840,0,4475,2268,2207,0,0,0,1.0,1,1.0,1,1.0,1,0.24936944879036593,29
2841,1,4476,2269,2207,0,0,0,1.0,1,1.0,1,1.0,1,0.24544605658405216,31
2842,1,4477,2269,2208,0,0,0,1.0,1,1.0,1,1.0,1,0.22930532518161317,32
2843,0,4477,2269,2208,0,0,0,1.0,1,1.0,1,1.0,1,0.22930532518161317,32
2844,0,4477,2269,2208,0,0,0,1.0,1,1.0,1,1.0,1,0.25647006608118394,33
2845,2,4479,2271,2208,0,0,0,1.0,1,1.0,1,1.0,1,0.280502514120959,34
2846,2,4481,2272,2209,0,0,0,1.0,1,1.0,1,1.0,1,0.27128389733280334,34
2847,0,4481,2272,2209,0,0,0,1.0,1,1.0,1,1.0,1,0.27030515044570597,35
2848,3,4484,2273,2211,0,0,0,1.0,1,1.0,1,1.0,1,0.2561814363734571,37
2849,1,4485,2274,2211,0,0,0,1.0,1,1.0,1,1.0,1,0.30426347104302015,37
2850,1,4486,2275,2211,0,0,0,1.0,1,1.0,1,1.0,1,0.29810031931851066,37
2851,3,4489,2276,2213,0,0,0,1.0,1,1.0,1,1.0,1,0.2638276061721627,38
2852,1,4490,2277,2213,0,0,0,1.0,1,1.0,1,1.0,1,0.2755388481387608,36
2853,1,4491,2277,2214,0,0,0,1.0,1,1.0,1,1.0,1,0.2792940769368304,36
2854,1,4492,2277,2215,0,0,0,1.0,1,1.0,1,1.0,1,0.29031854031927046,37
2855,1,4493,2277,2216,0,0,0,1.0,1,1.0,1,1.0,1,0.29294235531408297,37
2856,2,4495,2277,2218,0,0,0,1.0,1,1.0,1,1.0,1,0.22186382069160354,38
2857,1,4496,2278,2218,0,0,0,1.0,1,1.0,1,1.0,1,0.284326937747241,39
2858,2,4498,2278,2220,0,0,0,1.0,1,1.0,1,1.0,1,0.24737217468488837,39
2859,0,4498,2278,2220,0,0,0,1.0,1,1.0,1,1.0,1,0.24737217468488837,39
2860,1,4499,2279,2220,0,0,0,1.0,1,1.0,1,1.0,1,0.24566306034685076,40
2861,2,4501,2280,2221,0,0,0,1.0,1,1.0,1,1.0,1,0.16210937758975222,38
2862,5,4506,2285,2221,0,0,0,1.0,1,1.0,1,1.0,1,0.24997367318132205,38
2863,3,4509,2286,2223,0,0,0,1.0,1,1.0,1,1.0,1,0.1896271342074083,37
2864,4,4513,2290,2223,0,0,0,1.0,1,1.0,1,1.0,1,0.24076662895142661,35
2865,2,4515,2291,2224,0,0,0,1.0,1,1.0,1,1.0,1,0.23850343985251715,33
2866,2,4517,2292,2225,0,0,0,1.0,1,1.0,1,1.0,1,0.23634760917432102,31
2867,3,4520,2294,2226,0,0,0,1.0,1,1.0,1,1.0,1,0.25684005220503436,30
2868,1,4521,2295,2226,0,0,0,1.0,1,1.0,1,1.0,1,0.2923732011136621,31
2869,5,4526,2298,2228,0,0,0,1.0,1,1.0,1,1.0,1,0.3509981032191701,30
2870,0,4526,2298,2228,0,0,0,1.0,1,1.0,1,1.0,1,0.33467608169758095,26
2871,2,4528,2299,2229,0,0,0,1.0,1,1.0,1,1.0,1,0.37357605992624077,27
2872,0,4528,2299,2229,0,0,0,1.0,1,1.0,1,1.0,1,0.35495895392330384,25
2873,0,4528,2299,2229,0,0,0,1.0,1,1.0,1,1.0,1,0.3453364754566095,24
2874,1,4529,2299,2230,0,0,0,1.0,1,1.0,1,1.0,1,0.28713114147959395,25
2875,1,4530,2300,2230,0,0,0,1.0,1,1.0,1,1.0,1,0.32309103606100087,26
2876,2,4532,2301,2231,0,0,0,1.0,1,1.0,1,1.0,1,0.3352757839220229,28
2877,0,4532,2301,2231,0,0,0,1.0,1,1.0,1,1.0,1,0.33524023763975563,29
2878,1,4533,2301,2232,0,0,0,1.0,1,1.0,1,1.0,1,0.3097666524405747,31
2879,1,4534,2301,2233,0,0,0,1.0,1,1.0,1,1.0,1,0.2637106378871833,31
2880,1,4535,2301,2234,0,0,0,1.0,1,1.0,1,1.0,1,0.2248219294985867,32
2881,0,4535,2301,2234,0,0,0,1.0,1,1.0,1,1.0,1,0.24881259508261566,31
2882,0,4535,2301,2234,0,0,0,1.0,1,1.0,1,1.0,1,0.24881259508261566,31
2883,1,4536,2301,2235,0,0,0,1.0,1,1.0,1,1.0,1,0.2503147933782466,32
2884,1,4537,2302,2235,0,0,0,1.0,1,1.0,1,1.0,1,0.25877917564870023,32
2885,3,4540,2303,2237,0,0,0,1.0,1,1.0,1,1.0,1,0.20742992876902458,33
2886,3,4543,2305,2238,0,0,0,1.0,1,1.0,1,1.0,1,0.20014211263680767,34
2887,0,4543,2305,2238,0,0,0,1.0,1,1.0,1,1.0,1,0.2145336172727311,34
2888,2,4545,2307,2238,0,0,0,1.0,1,1.0,1,1.0,1,0.2287120325282619,34
2889,4,4549,2308,2241,0,0,0,1.0,1,1.0,1,1.0,1,0.176315334012287,37
2890,0,4549,2308,2241,0,0,0,1.0,1,1.0,1,1.0,1,0.176315334012287,37
2891,1,4550,2309,2241,0,0,0,1.0,1,1.0,1,1.0,1,0.21534817155842753,37
2892,0,4550,2309,2241,0,0,0,1.0,1,1.0,1,1.0,1,0.21534817155842753,37
2893,1,4551,2310,2241,0,0,0,1.0,1,1.0,1,1.0,1,0.24204186421887677,38
2894,2,4553,2310,2243,0,0,0,1.0,1,1.0,1,1.0,1,0.21439796381883167,39
2895,0,4553,2310,2243,0,0,0,1.0,1,1.0,1,1.0,1,0.19780629259361193,40
2896,1,4554,2311,2243,0,0,0,1.0,1,1.0,1,1.0,1,0.22188241953583857,41
2897,1,4555,2312,2243,0,0,0,1.0,1,1.0,1,1.0,1,0.2287120240271345,41
2898,3,4558,2314,2244,0,0,0,1.0,1,1.0,1,1.0,1,0.23293295557120453,41
2899,2,4560,2315,2245,0,0,0,1.0,1,1.0,1,1.0,1,0.19909500433230345,39
2900,4,4564,2318,2246,0,0,0,1.0,1,1.0,1,1.0,1,0.3134345939403559,40
2901,1,4565,2318,2247,0,0,0,1.0,1,1.0,1,1.0,1,0.26629973893640324,40
2902,2,4567,2319,2248,0,0,0,1.0,1,1.0,1,1.0,1,0.29116063081297827,38
2903,0,4567,2319,2248,0,0,0,1.0,1,1.0,1,1.0,1,0.25995816162078933,36
2904,1,4568,2320,2248,0,0,0,1.0,1,1.0,1,1.0,1,0.29530523627765864,36
2905,1,4569,2321,2248,0,0,0,1.0,1,1.0,1,1.0,1,0.2883859232559649,35
2906,1,4570,2321,2249,0,0,0,1.0,1,1.0,1,1.0,1,0.2721843585914621,36
2907,2,4572,2322,2250,0,0,0,1.0,1,1.0,1,1.0,1,0.30843250780352727,37
2908,1,4573,2323,2250,0,0,0,1.0,1,1.0,1,1.0,1,0.33525161895622335,38
2909,0,4573,2323,2250,0,0,0,1.0,1,1.0,1,1.0,1,0.32540117255184153,37
2910,1,4574,2323,2251,0,0,0,1.0,1,1.0,1,1.0,1,0.3039717465194887,37
2911,0,4574,2323,2251,0,0,0,1.0,1,1.0,1,1.0,1,0.3134798922274606,36
2912,4,4578,2325,2253,0,0,0,1.0,1,1.0,1,1.0,1,0.32868829494218776,36
2913,2,4580,2326,2254,0,0,0,1.0,1,1.0,1,1.0,1,0.29462168218403756,36
2914,1,4581,2327,2254,0,0,0,1.0,1,1.0,1,1.0,1,0.3314181664825977,38
2915,1,4582,2327,2255,0,0,0,1.0,1,1.0,1,1.0,1,0.2866685955068751,37
2916,2,4584,2327,2257,0,0,0,1.0,1,1.0,1,1.0,1,0.25953329661884295,39
2917,3,4587,2328,2259,0,0,0,1.0,1,1.0,1,1.0,1,0.22511529398112787,40
2918,3,4590,2331,2259,0,0,0,1.0,1,1.0,1,1.0,1,0.23278961921421215,40
2919,2,4592,2332,2260,0,0,0,1.0,1,1.0,1,1.0,1,0.21290507912937684,42
2920,0,4592,2332,2260,0,0,0,1.0,1,1.0,1,1.0,1,0.21290507912937684,42
2921,0,4592,2332,2260,0,0,0,1.0,1,1.0,1,1.0,1,0.21290507912937684,42
2922,0,4592,2332,2260,0,0,0,1.0,1,1.0,1,1.0,1,0.1934207625170894,43
2923,1,4593,2332,2261,0,0,0,1.0,1,1.0,1,1.0,1,0.18971714172868023,45
2924,1,4594,2333,2261,0,0,0,1.0,1,1.0,1,1.0,1,0.19702761468367352,46
2925,1,4595,2333,2262,0,0,0,1.0,1,1.0,1,1.0,1,0.1858640056055881,46
2926,0,4595,2333,2262,0,0,0,1.0,1,1.0,1,1.0,1,0.1858640056055881,46
2927,2,4597,2334,2263,0,0,0,1.0,1,1.0,1,1.0,1,0.17392991157900692,48
2928,2,4599,2336,2263,0,0,0,1.0,1,1.0,1,1.0,1,0.2012245833811196,48
2929,0,4599,2336,2263,0,0,0,1.0,1,1.0,1,1.0,1,0.2012245833811196,48
2930,1,4600,2336,2264,0,0,0,1.0,1,1.0,1,1.0,1,0.2056882708635269,50
2931,1,4601,2337,2264,0,0,0,1.0,1,1.0,1,1.0,1,0.2420830410032273,51
2932,0,4601,2337,2264,0,0,0,1.0,1,1.0,1,1.0,1,0.2479151647973854,52
2933,3,4604,2337,2267,0,0,0,1.0,1,1.0,1,1.0,1,0.20859869635377243,53
2934,2,4606,2338,2268,0,0,0,1.0,1,1.0,1,1.0,1,0.2214589937266689,54
2935,1,4607,2339,2268,0,0,0,1.0,1,1.0,1,1.0,1,0.231594636022642,53
2936,0,4607,2339,2268,0,0,0,1.0,1,1.0,1,1.0,1,0.231594636022642,53
2937,1,4608,2340,2268,0,0,0,1.0,1,1.0,1,1.0,1,0.25975789231034485,51
2938,4,4612,2342,2270,0,0,0,1.0,1,1.0,1,1.0,1,0.2888958122232263,53
2939,4,4616,2343,2273,0,0,0,1.0,1,1.0,1,1.0,1,0.25383431948942614,52
2940,2,4618,2345,2273,0,0,0,1.0,1,1.0,1,1.0,1,0.30884273417159974,52
2941,0,4618,2345,2273,0,0,0,1.0,1,1.0,1,1.0,1,0.29475678684196865,50
2942,1,4619,2345,2274,0,0,0,1.0,1,1.0,1,1.0,1,0.2964386121635642,50
2943,1,4620,2346,2274,0,0,0,1.0,1,1.0,1,1.0,1,0.28854443737660834,49
2944,3,4623,2346,2277,0,0,0,1.0,1,1.0,1,1.0,1,0.24487263577736512,48
2945,2,4625,2346,2279,0,0,0,1.0,1,1.0,1,1.0,1,0.21060126693521702,48
2946,3,4628,2349,2279,0,0,0,1.0,1,1.0,1,1.0,1,0.1929107273219555,47
2947,1,4629,2350,2279,0,0,0,1.0,1,1.0,1,1.0,1,0.1940975466905616,47
2948,3,4632,2351,2281,0,0,0,1.0,1,1.0,1,1.0,1,0.17866662379734508,48
2949,0,4632,2351,2281,0,0,0,1.0,1,1.0,1,1.0,1,0.17866662379734508,48
2950,0,4632,2351,2281,0,0,0,1.0,1,1.0,1,1.0,1,0.17866662379734508,48
2951,1,4633,2351,2282,0,0,0,1.0,1,1.0,1,1.0,1,0.19031543841639242,50
2952,0,4633,2351,2282,0,0,0,1.0,1,1.0,1,1.0,1,0.19031543841639242,50
2953,0,4633,2351,2282,0,0,0,1.0,1,1.0,1,1.0,1,0.20305304731402993,51
2954,1,4634,2351,2283,0,0,0,1.0,1,1.0,1,1.0,1,0.178554573228677,51
2955,0,4634,2351,2283,0,0,0,1.0,1,1.0,1,1.0,1,0.178554573228677,51
2956,1,4635,2352,2283,0,0,0,1.0,1,1.0,1,1.0,1,0.20577503234528663,51
2957,1,4636,2352,2284,0,0,0,1.0,1,1.0,1,1.0,1,0.20069915011328363,52
2958,0,4636,2352,2284,0,0,0,1.0,1,1.0,1,1.0,1,0.20069915011328363,52
2959,2,4638,2353,2285,0,0,0,1.0,1,1.0,1,1.0,1,0.20394183716605924,53
2960,0,4638,2353,2285,0,0,0,1.0,1,1.0,1,1.0,1,0.19625439619153356,52
2961,0,4638,2353,2285,0,0,0,1.0,1,1.0,1,1.0,1,0.19929979737808248,53
2962,0,4638,2353,2285,0,0,0,1.0,1,1.0,1,1.0,1,0.2167530425362655,54
2963,1,4639,2354,2285,0,0,0,1.0,1,1.0,1,1.0,1,0.23203380043107327,55
2964,4,4643,2354,2289,0,0,0,1.0,1,1.0,1,1.0,1,0.20836977009697885,55
2965,2,4645,2354,2291,0,0,0,1.0,1,1.0,1,1.0,1,0.1822292332811712,55
2966,0,4645,2354,2291,0,0,0,1.0,1,1.0,1,1.0,1,0.1822292332811712,55
2967,3,4648,2354,2294,0,0,0,1.0,1,1.0,1,1.0,1,0.19840573713002713,56
2968,0,4648,2354,2294,0,0,0,1.0,1,1.0,1,1.0,1,0.19840573713002713,56
2969,1,4649,2355,2294,0,0,0,1.0,1,1.0,1,1.0,1,0.2099421082395841,55
2970,2,4651,2355,2296,0,0,0,1.0,1,1.0,1,1.0,1,0.19347185574224074,57
2971,2,4653,2357,2296,0,0,0,1.0,1,1.0,1,1.0,1,0.18630330313976462,56
2972,1,4654,2358,2296,0,0,0,1.0,1,1.0,1,1.0,1,0.19927527839258785,57
2973,4,4658,2360,2298,0,0,0,1.0,1,1.0,1,1.0,1,0.20540331878112705,59
2974,0,4658,2360,2298,0,0,0,1.0,1,1.0,1,1.0,1,0.2020546466315318,60
2975,5,4663,2362,2301,0,0,0,1.0,1,1.0,1,1.0,1,0.23623396030049226,58
2976,2,4665,2363,2302,0,0,0,1.0,1,1.0,1,1.0,1,0.24583604624630578,59
2977,6,4671,2364,2307,0,0,0,1.0,1,1.0,1,1.0,1,0.19652399006690405,59
2978,1,4672,2365,2307,0,0,0,1.0,1,1.0,1,1.0,1,0.19227407597215104,58
2979,3,4675,2366,2309,0,0,0,1.0,1,1.0,1,1.0,1,0.1796101329876148,57
2980,0,4675,2366,2309,0,0,0,1.0,1,1.0,1,1.0,1,0.18971708205402146,56
2981,0,4675,2366,2309,0,0,0,1.0,1,1.0,1,1.0,1,0.18971708205402146,56
2982,1,4676,2367,2309,0,0,0,1.0,1,1.0,1,1.0,1,0.1906022692441701,57
2983,2,4678,2368,2310,0,0,0,1.0,1,1.0,1,1.0,1,0.18471722963234513,57
2984,0,4678,2368,2310,0,0,0,1.0,1,1.0,1,1.0,1,0.17425450369616924,56
2985,3,4681,2368,2313,0,0,0,1.0,1,1.0,1,1.0,1,0.2202984510302473,55
2986,7,4688,2372,2316,0,0,0,1.0,1,1.0,1,1.0,1,0.21168575270409415,55
2987,3,4691,2372,2319,0,0,0,1.0,1,1.0,1,1.0,1,0.20618585418162816,51
2988,2,4693,2373,2320,0,0,0,1.0,1,1.0,1,1.0,1,0.18061692805863155,52
2989,1,4694,2373,2321,0,0,0,1.0,1,1.0,1,1.0,1,0.17443661713433342,50
2990,3,4697,2375,2322,0,0,0,1.0,1,1.0,1,1.0,1,0.18003229943760876,50
2991,1,4698,2375,2323,0,0,0,1.0,1,1.0,1,1.0,1,0.1526061376620518,50
2992,0,4698,2375,2323,0,0,0,1.0,1,1.0,1,1.0,1,0.1526061376620518,50
2993,0,4698,2375,2323,0,0,0,1.0,1,1.0,1,1.0,1,0.18887566306856807,51
2994,2,4700,2377,2323,0,0,0,1.0,1,1.0,1,1.0,1,0.23302462434008506,51
2995,2,4702,2377,2325,0,0,0,1.0,1,1.0,1,1.0,1,0.205027798108632,51
2996,4,4706,2379,2327,0,0,0,1.0,1,1.0,1,1.0,1,0.21219471993951525,52
2997,0,4706,2379,2327,0,0,0,1.0,1,1.0,1,1.0,1,0.23134130669613387,52
2998,5,4711,2383,2328,0,0,0,1.0,1,1.0,1,1.0,1,0.22320009782133357,51
2999,0,4711,2383,2328,0,0,0,1.0,1,1.0,1,1.0,1,0.22320009782133357,51
3000,2,4713,2385,2328,0,0,0,1.0,1,1.0,1,1.0,1,0.22242851759162816,52
3001,0,4713,2385,2328,0,0,0,1.0,1,1.0,1,1.0,1,0.22242851759162816,52
3002,1,4714,2386,2328,0,0,0,1.0,1,1.0,1,1.0,1,0.2529042178440273,53
3003,2,4716,2386,2330,0,0,0,1.0,1,1.0,1,1.0,1,0.20267189085352846,54
3004,0,4716,2386,2330,0,0,0,1.0,1,1.0,1,1.0,1,0.21129756772035257,55
3005,1,4717,2386,2331,0,0,0,1.0,1,1.0,1,1.0,1,0.19705369812569745,56
3006,0,4717,2386,2331,0,0,0,1.0,1,1.0,1,1.0,1,0.19155473970385992,57
3007,1,4718,2386,2332,0,0,0,1.0,1,1.0,1,1.0,1,0.18917460016419535,58
3008,2,4720,2388,2332,0,0,0,1.0,1,1.0,1,1.0,1,0.19738857625325967,59
3009,0,4720,2388,2332,0,0,0,1.0,1,1.0,1,1.0,1,0.19738857625325967,59
3010,1,4721,2388,2333,0,0,0,1.0,1,1.0,1,1.0,1,0.181391999300825,59
3011,2,4723,2389,2334,0,0,0,1.0,1,1.0,1,1.0,1,0.1671244348108528,59
3012,0,4723,2389,2334,0,0,0,1.0,1,1.0,1,1.0,1,0.17410150237109595,61
3013,1,4724,2390,2334,0,0,0,1.0,1,1.0,1,1.0,1,0.18453867094756043,59
3014,0,4724,2390,2334,0,0,0,1.0,1,1.0,1,1.0,1,0.1932527555907497,60
3015,1,4725,2390,2335,0,0,0,1.0,1,1.0,1,1.0,1,0.1883091148890168,58
3016,2,4727,2392,2335,0,0,0,1.0,1,1.0,1,1.0,1,0.23519711325378514,57
3017,3,4730,2395,2335,0,0,0,1.0,1,1.0,1,1.0,1,0.25018169801997464,58
3018,1,4731,2396,2335,0,0,0,1.0,1,1.0,1,1.0,1,0.27944297743920105,55
3019,2,4733,2396,2337,0,0,0,1.0,1,1.0,1,1.0,1,0.2597567741820142,56
3020,2,4735,2397,2338,0,0,0,1.0,1,1.0,1,1.0,1,0.29174152954351223,55
3021,3,4738,2398,2340,0,0,0,1.0,1,1.0,1,1.0,1,0.26050946601028907,55
3022,4,4742,2401,2341,0,0,0,1.0,1,1.0,1,1.0,1,0.2981819938223766,55
3023,2,4744,2401,2343,0,0,0,1.0,1,1.0,1,1.0,1,0.2318021115037097,54
3024,1,4745,2402,2343,0,0,0,1.0,1,1.0,1,1.0,1,0.24395216813458362,54
3025,5,4750,2405,2345,0,0,0,1.0,1,1.0,1,1.0,1,0.2427481686634916,54
3026,2,4752,2405,2347,0,0,0,1.0,1,1.0,1,1.0,1,0.1722433961505965,53
3027,1,4753,2405,2348,0,0,0,1.0,1,1.0,1,1.0,1,0.15393786863388323,53
3028,2,4755,2407,2348,0,0,0,1.0,1,1.0,1,1.0,1,0.14835438332097983,51
3029,3,4758,2408,2350,0,0,0,1.0,1,1.0,1,1.0,1,0.1615359871148551,51
3030,2,4760,2410,2350,0,0,0,1.0,1,1.0,1,1.0,1,0.19260342054709909,52
3031,4,4764,2412,2352,0,0,0,1.0,1,1.0,1,1.0,1,0.18701207507314907,51
3032,1,4765,2412,2353,0,0,0,1.0,1,1.0,1,1.0,1,0.16910725926319597,50
3033,1,4766,2413,2353,0,0,0,1.0,1,1.0,1,1.0,1,0.1581547803097502,52
3034,0,4766,2413,2353,0,0,0,1.0,1,1.0,1,1.0,1,0.16927885039229165,51
3035,0,4766,2413,2353,0,0,0,1.0,1,1.0,1,1.0,1,0.1676582995683656,51
3036,1,4767,2413,2354,0,0,0,1.0,1,1.0,1,1.0,1,0.156696603469644,53
3037,0,4767,2413,2354,0,0,0,1.0,1,1.0,1,1.0,1,0.17168922760063252,52
3038,0,4767,2413,2354,0,0,0,1.0,1,1.0,1,1.0,1,0.17168922760063252,52
3039,2,4769,2413,2356,0,0,0,1.0,1,1.0,1,1.0,1,0.1291721118380188,54
3040,1,4770,2414,2356,0,0,0,1.0,1,1.0,1,1.0,1,0.12020506122382586,55
3041,2,4772,2415,2357,0,0,0,1.0,1,1.0,1,1.0,1,0.13991466324036278,56
3042,2,4774,2416,2358,0,0,0,1.0,1,1.0,1,1.0,1,0.13667483438162922,56
3043,1,4775,2416,2359,0,0,0,1.0,1,1.0,1,1.0,1,0.10760595464841825,57
3044,1,4776,2417,2359,0,0,0,1.0,1,1.0,1,1.0,1,0.1329986132553161,57
3045,1,4777,2417,2360,0,0,0,1.0,1,1.0,1,1.0,1,0.13600938265553622,56
3046,2,4779,2419,2360,0,0,0,1.0,1,1.0,1,1.0,1,0.14312971636564245,57
3047,1,4780,2420,2360,0,0,0,1.0,1,1.0,1,1.0,1,0.16492437949438912,56
3048,3,4783,2420,2363,0,0,0,1.0,1,1.0,1,1.0,1,0.1467290000855235,58
3049,2,4785,2421,2364,0,0,0,1.0,1,1.0,1,1.0,1,0.19370839998196254,59
3050,1,4786,2421,2365,0,0,0,1.0,1,1.0,1,1.0,1,0.20525526126601845,60
3051,3,4789,2423,2366,0,0,0,1.0,1,1.0,1,1.0,1,0.23760692674910153,59
3052,5,4794,2424,2370,0,0,0,1.0,1,1.0,1,1.0,1,0.22302643464773753,58
3053,4,4798,2426,2372,0,0,0,1.0,1,1.0,1,1.0,1,0.24349614402589725,57
3054,4,4802,2428,2374,0,0,0,1.0,1,1.0,1,1.0,1,0.26279012276953106,55
3055,0,4802,2428,2374,0,0,0,1.0,1,1.0,1,1.0,1,0.24925104691656,54
3056,2,4804,2429,2375,0,0,0,1.0,1,1.0,1,1.0,1,0.2610243044108843,55
3057,2,4806,2430,2376,0,0,0,1.0,1,1.0,1,1.0,1,0.2739908723023039,54
3058,1,4807,2430,2377,0,0,0,1.0,1,1.0,1,1.0,1,0.2854148526003715,55
3059,2,4809,2430,2379,0,0,0,1.0,1,1.0,1,1.0,1,0.2649412869872784,56
3060,0,4809,2430,2379,0,0,0,1.0,1,1.0,1,1.0,1,0.2649412869872784,56
3061,1,4810,2431,2379,0,0,0,1.0,1,1.0,1,1.0,1,0.27899285473879476,56
3062,6,4816,2433,2383,0,0,0,1.0,1,1.0,1,1.0,1,0.2485191608160703,57
3063,1,4817,2434,2383,0,0,0,1.0,1,1.0,1,1.0,1,0.2348179213474376,55
3064,3,4820,2437,2383,0,0,0,1.0,1,1.0,1,1.0,1,0.2720357957864987,56
3065,2,4822,2438,2384,0,0,0,1.0,1,1.0,1,1.0,1,0.25796771140817876,55
3066,1,4823,2439,2384,0,0,0,1.0,1,1.0,1,1.0,1,0.27352205170475846,55
3067,3,4826,2441,2385,0,0,0,1.0,1,1.0,1,1.0,1,0.2727829716711114,54
3068,4,4830,2443,2387,0,0,0,1.0,1,1.0,1,1.0,1,0.29046455804077703,53
3069,3,4833,2445,2388,0,0,0,1.0,1,1.0,1,1.0,1,0.2565431880932704,51
3070,1,4834,2445,2389,0,0,0,1.0,1,1.0,1,1.0,1,0.24164190625043488,50
3071,2,4836,2445,2391,0,0,0,1.0,1,1.0,1,1.0,1,0.20595810070483092,51
3072,1,4837,2446,2391,0,0,0,1.0,1,1.0,1,1.0,1,0.2181005132921807,53
3073,1,4838,2446,2392,0,0,0,1.0,1,1.0,1,1.0,1,0.21551299445023303,51
3074,1,4839,2446,2393,0,0,0,1.0,1,1.0,1,1.0,1,0.20717321535504946,50
3075,2,4841,2447,2394,0,0,0,1.0,1,1.0,1,1.0,1,0.23123610048293455,52
3076,2,4843,2447,2396,0,0,0,1.0,1,1.0,1,1.0,1,0.23199010926594796,53
3077,0,4843,2447,2396,0,0,0,1.0,1,1.0,1,1.0,1,0.21587752406980237,52
3078,0,4843,2447,2396,0,0,0,1.0,1,1.0,1,1.0,1,0.247044675895952,53
3079,1,4844,2447,2397,0,0,0,1.0,1,1.0,1,1.0,1,0.24395645700561225,53
3080,1,4845,2447,2398,0,0,0,1.0,1,1.0,1,1.0,1,0.2532782900449271,52
3081,1,4846,2448,2398,0,0,0,1.0,1,1.0,1,1.0,1,0.28873695698482366,54
3082,2,4848,2450,2398,0,0,0,1.0,1,1.0,1,1.0,1,0.31373952261241467,54
3083,3,4851,2450,2401,0,0,0,1.0,1,1.0,1,1.0,1,0.2789985462083027,54
3084,1,4852,2451,2401,0,0,0,1.0,1,1.0,1,1.0,1,0.2959960502846761,55
3085,1,4853,2451,2402,0,0,0,1.0,1,1.0,1,1.0,1,0.27895494103365587,55
3086,1,4854,2451,2403,0,0,0,1.0,1,1.0,1,1.0,1,0.28065228942847403,56
3087,1,4855,2451,2404,0,0,0,1.0,1,1.0,1,1.0,1,0.2767273328261032,57
3088,0,4855,2451,2404,0,0,0,1.0,1,1.0,1,1.0,1,0.2907440518396714,56
3089,2,4857,2453,2404,0,0,0,1.0,1,1.0,1,1.0,1,0.31042898128482777,55
3090,1,4858,2453,2405,0,0,0,1.0,1,1.0,1,1.0,1,0.29773322356480053,54
3091,0,4858,2453,2405,0,0,0,1.0,1,1.0,1,1.0,1,0.31671021043704417,53
3092,2,4860,2453,2407,0,0,0,1.0,1,1.0,1,1.0,1,0.2857277612388121,56
3093,1,4861,2454,2407,0,0,0,1.0,1,1.0,1,1.0,1,0.30344062629253243,56
3094,0,4861,2454,2407,0,0,0,1.0,1,1.0,1,1.0,1,0.3151670964819536,58
3095,2,4863,2454,2409,0,0,0,1.0,1,1.0,1,1.0,1,0.2747106758719554,59
3096,0,4863,2454,2409,0,0,0,1.0,1,1.0,1,1.0,1,0.2819272381577199,60
3097,2,4865,2455,2410,0,0,0,1.0,1,1.0,1,1.0,1,0.2659025736005173,60
3098,0,4865,2455,2410,0,0,0,1.0,1,1.0,1,1.0,1,0.28860183570380066,58
3099,0,4865,2455,2410,0,0,0,1.0,1,1.0,1,1.0,1,0.2997179412382391,57
3100,1,4866,2456,2410,0,0,0,1.0,1,1.0,1,1.0,1,0.31177446255874364,57
3101,3,4869,2458,2411,0,0,0,1.0,1,1.0,1,1.0,1,0.3210885953729573,58
3102,3,4872,2460,2412,0,0,0,1.0,1,1.0,1,1.0,1,0.3601279949652523,59
3103,3,4875,2461,2414,0,0,0,1.0,1,1.0,1,1.0,1,0.29207904216367964,58
3104,5,4880,2462,2418,0,0,0,1.0,1,1.0,1,1.0,1,0.2507640466806342,58
3105,2,4882,2463,2419,0,0,0,1.0,1,1.0,1,1.0,1,0.2237938158583796,56
3106,6,4888,2467,2421,0,0,0,1.0,1,1.0,1,1.0,1,0.23782047875952034,57
3107,5,4893,2469,2424,0,0,0,1.0,1,1.0,1,1.0,1,0.18689598209069488,55
3108,3,4896,2471,2425,0,0,0,1.0,1,1.0,1,1.0,1,0.1927166576084239,55
3109,3,4899,2472,2427,0,0,0,1.0,1,1.0,1,1.0,1,0.19141568945425064,54
3110,3,4902,2475,2427,0,0,0,1.0,1,1.0,1,1.0,1,0.16995814737591267,54
3111,1,4903,2475,2428,0,0,0,1.0,1,1.0,1,1.0,1,0.15844078270707307,54
3112,4,4907,2479,2428,0,0,0,1.0,1,1.0,1,1.0,1,0.20688983937768207,56
3113,3,4910,2481,2429,0,0,0,1.0,1,1.0,1,1.0,1,0.213885738771975,55
3114,3,4913,2482,2431,0,0,0,1.0,1,1.0,1,1.0,1,0.1930888621337019,54
3115,0,4913,2482,2431,0,0,0,1.0,1,1.0,1,1.0,1,0.1808257029976555,56
3116,1,4914,2483,2431,0,0,0,1.0,1,1.0,1,1.0,1,0.18877053526240278,56
3117,1,4915,2483,2432,0,0,0,1.0,1,1.0,1,1.0,1,0.22234538887090013,58
3118,3,4918,2484,2434,0,0,0,1.0,1,1.0,1,1.0,1,0.20037439658345113,57
3119,1,4919,2485,2434,0,0,0,1.0,1,1.0,1,1.0,1,0.21160690745647048,57
3120,0,4919,2485,2434,0,0,0,1.0,1,1.0,1,1.0,1,0.2056431766147105,56
3121,3,4922,2488,2434,0,0,0,1.0,1,1.0,1,1.0,1,0.18987751898897964,57
3122,0,4922,2488,2434,0,0,0,1.0,1,1.0,1,1.0,1,0.18987751898897964,57
3123,1,4923,2488,2435,0,0,0,1.0,1,1.0,1,1.0,1,0.1738923641062323,57
3124,1,4924,2488,2436,0,0,0,1.0,1,1.0,1,1.0,1,0.1804518981513141,59
3125,5,4929,2490,2439,0,0,0,1.0,1,1.0,1,1.0,1,0.1886635101481067,61
3126,2,4931,2491,2440,0,0,0,1.0,1,1.0,1,1.0,1,0.1856311221461465,60
3127,2,4933,2492,2441,0,0,0,1.0,1,1.0,1,1.0,1,0.17700271161364084,58
3128,2,4935,2493,2442,0,0,0,1.0,1,1.0,1,1.0,1,0.21479650332291053,58
3129,3,4938,2494,2444,0,0,0,1.0,1,1.0,1,1.0,1,0.21383678040969084,56
3130,0,4938,2494,2444,0,0,0,1.0,1,1.0,1,1.0,1,0.21574352650092735,56
3131,2,4940,2494,2446,0,0,0,1.0,1,1.0,1,1.0,1,0.20822051938296493,55
3132,1,4941,2494,2447,0,0,0,1.0,1,1.0,1,1.0,1,0.18805145249656086,53
3133,2,4943,2494,2449,0,0,0,1.0,1,1.0,1,1.0,1,0.15032382113927023,52
3134,0,4943,2494,2449,0,0,0,1.0,1,1.0,1,1.0,1,0.17517791879239306,52
3135,2,4945,2495,2450,0,0,0,1.0,1,1.0,1,1.0,1,0.1471947498516793,53
3136,3,4948,2498,2450,0,0,0,1.0,1,1.0,1,1.0,1,0.16818855969135238,54
3137,2,4950,2500,2450,0,0,0,1.0,1,1.0,1,1.0,1,0.18449132348484865,55
3138,7,4957,2503,2454,0,0,0,1.0,1,1.0,1,1.0,1,0.18267795575942075,57
3139,3,4960,2504,2456,0,0,0,1.0,1,1.0,1,1.0,1,0.16593355126561846,56
3140,1,4961,2505,2456,0,0,0,1.0,1,1.0,1,1.0,1,0.15954055101002027,56
3141,1,4962,2506,2456,0,0,0,1.0,1,1.0,1,1.0,1,0.16777243598893635,56
3142,2,4964,2507,2457,0,0,0,1.0,1,1.0,1,1.0,1,0.17310753098876153,56
3143,2,4966,2508,2458,0,0,0,1.0,1,1.0,1,1.0,1,0.16981283318799525,56
3144,1,4967,2509,2458,0,0,0,1.0,1,1.0,1,1.0,1,0.16681998383235064,54
3145,3,4970,2510,2460,0,0,0,1.0,1,1.0,1,1.0,1,0.14094065062859906,55
3146,1,4971,2510,2461,0,0,0,1.0,1,1.0,1,1.0,1,0.11736223697441554,53
3147,1,4972,2510,2462,0,0,0,1.0,1,1.0,1,1.0,1,0.12017209285356795,54
3148,2,4974,2512,2462,0,0,0,1.0,1,1.0,1,1.0,1,0.13185005805779557,54
3149,1,4975,2512,2463,0,0,0,1.0,1,1.0,1,1.0,1,0.10627733129710837,53
3150,1,4976,2512,2464,0,0,0,1.0,1,1.0,1,1.0,1,0.08048382223068817,53
3151,0,4976,2512,2464,0,0,0,1.0,1,1.0,1,1.0,1,0.09470280454371469,53
3152,0,4976,2512,2464,0,0,0,1.0,1,1.0,1,1.0,1,0.09221061617674235,54
3153,0,4976,2512,2464,0,0,0,1.0,1,1.0,1,1.0,1,0.11195210107985164,53
3154,1,4977,2513,2464,0,0,0,1.0,1,1.0,1,1.0,1,0.15772808365431004,55
3155,2,4979,2513,2466,0,0,0,1.0,1,1.0,1,1.0,1,0.12505986624938675,56
3156,1,4980,2514,2466,0,0,0,1.0,1,1.0,1,1.0,1,0.17174950329882088,56
3157,0,4980,2514,2466,0,0,0,1.0,1,1.0,1,1.0,1,0.17174950329882088,56
3158,0,4980,2514,2466,0,0,0,1.0,1,1.0,1,1.0,1,0.1760441101818128,57
3159,1,4981,2515,2466,0,0,0,1.0,1,1.0,1,1.0,1,0.19493061691362726,56
3160,3,4984,2515,2469,0,0,0,1.0,1,1.0,1,1.0,1,0.1602229010230977,58
3161,0,4984,2515,2469,0,0,0,1.0,1,1.0,1,1.0,1,0.1577523525298206,59
3162,1,4985,2516,2469,0,0,0,1.0,1,1.0,1,1.0,1,0.16905186743628609,59
3163,2,4987,2518,2469,0,0,0,1.0,1,1.0,1,1.0,1,0.21252497907339618,59
3164,6,4993,2519,2474,0,0,0,1.0,1,1.0,1,1.0,1,0.19219000031865968,60
3165,1,4994,2519,2475,0,0,0,1.0,1,1.0,1,1.0,1,0.18583846566394222,58
3166,3,4997,2520,2477,0,0,0,1.0,1,1.0,1,1.0,1,0.16564528520091468,59
3167,6,5003,2525,2478,0,0,0,1.0,1,1.0,1,1.0,1,0.16877488158240908,57
3168,2,5005,2526,2479,0,0,0,1.0,1,1.0,1,1.0,1,0.16743706999679012,58
3169,1,5006,2527,2479,0,0,0,1.0,1,1.0,1,1.0,1,0.17032868040331148,57
3170,1,5007,2527,2480,0,0,0,1.0,1,1.0,1,1.0,1,0.11966889815513318,55
3171,1,5008,2528,2480,0,0,0,1.0,1,1.0,1,1.0,1,0.12658478198730747,56
3172,0,5008,2528,2480,0,0,0,1.0,1,1.0,1,1.0,1,0.12010015163509007,54
3173,1,5009,2529,2480,0,0,0,1.0,1,1.0,1,1.0,1,0.16062782058254207,53
3174,2,5011,2531,2480,0,0,0,1.0,1,1.0,1,1.0,1,0.20753555771677668,53
3175,4,5015,2532,2483,0,0,0,1.0,1,1.0,1,1.0,1,0.19972690738311363,52
3176,3,5018,2535,2483,0,0,0,1.0,1,1.0,1,1.0,1,0.2511048986342682,53
3177,4,5022,2537,2485,0,0,0,1.0,1,1.0,1,1.0,1,0.2618588645626207,52
3178,2,5024,2538,2486,0,0,0,1.0,1,1.0,1,1.0,1,0.2668080322218636,53
3179,3,5027,2539,2488,0,0,0,1.0,1,1.0,1,1.0,1,0.19963248785588714,54
3180,0,5027,2539,2488,0,0,0,1.0,1,1.0,1,1.0,1,0.23456157086007373,54
3181,2,5029,2539,2490,0,0,0,1.0,1,1.0,1,1.0,1,0.2021336804551076,55
3182,0,5029,2539,2490,0,0,0,1.0,1,1.0,1,1.0,1,0.2077730876279475,54
3183,4,5033,2541,2492,0,0,0,1.0,1,1.0,1,1.0,1,0.23771182256055956,56
3184,7,5040,2542,2498,0,0,0,1.0,1,1.0,1,1.0,1,0.1754365271031967,54
3185,1,5041,2543,2498,0,0,0,1.0,1,1.0,1,1.0,1,0.19409512365997542,53
3186,1,5042,2544,2498,0,0,0,1.0,1,1.0,1,1.0,1,0.2072017083320817,52
3187,2,5044,2546,2498,0,0,0,1.0,1,1.0,1,1.0,1,0.20449913046381116,50
3188,3,5047,2548,2499,0,0,0,1.0,1,1.0,1,1.0,1,0.19916741765805226,50
3189,5,5052,2551,2501,0,0,0,1.0,1,1.0,1,1.0,1,0.21036243737538357,49
3190,1,5053,2552,2501,0,0,0,1.0,1,1.0,1,1.0,1,0.23730954234584206,50
3191,3,5056,2554,2502,0,0,0,1.0,1,1.0,1,1.0,1,0.2636736196146954,49
3192,0,5056,2554,2502,0,0,0,1.0,1,1.0,1,1.0,1,0.2636736196146954,49
3193,0,5056,2554,2502,0,0,0,1.0,1,1.0,1,1.0,1,0.26479918013157855,49
3194,3,5059,2556,2503,0,0,0,1.0,1,1.0,1,1.0,1,0.28240890235458344,50
3195,2,5061,2556,2505,0,0,0,1.0,1,1.0,1,1.0,1,0.2437895445294626,49
3196,0,5061,2556,2505,0,0,0,1.0,1,1.0,1,1.0,1,0.2437895445294626,49
3197,2,5063,2556,2507,0,0,0,1.0,1,1.0,1,1.0,1,0.19821355496293463,50
3198,2,5065,2556,2509,0,0,0,1.0,1,1.0,1,1.0,1,0.15717974458112244,50
3199,2,5067,2556,2511,0,0,0,1.0,1,1.0,1,1.0,1,0.14748902522554258,52
3200,1,5068,2556,2512,0,0,0,1.0,1,1.0,1,1.0,1,0.1316763503351578,53
3201,0,5068,2556,2512,0,0,0,1.0,1,1.0,1,1.0,1,0.14211497960061506,55
3202,1,5069,2556,2513,0,0,0,1.0,1,1.0,1,1.0,1,0.12564527641177914,55
3203,0,5069,2556,2513,0,0,0,1.0,1,1.0,1,1.0,1,0.12365621230249975,53
3204,0,5069,2556,2513,0,0,0,1.0,1,1.0,1,1.0,1,0.1418998022092136,53
3205,2,5071,2558,2513,0,0,0,1.0,1,1.0,1,1.0,1,0.12825771405957406,53
3206,0,5071,2558,2513,0,0,0,1.0,1,1.0,1,1.0,1,0.151064444233934,52
3207,2,5073,2560,2513,0,0,0,1.0,1,1.0,1,1.0,1,0.18928499952628994,53
3208,0,5073,2560,2513,0,0,0,1.0,1,1.0,1,1.0,1,0.2412347477419627,51
3209,1,5074,2560,2514,0,0,0,1.0,1,1.0,1,1.0,1,0.2141932059143259,52
3210,0,5074,2560,2514,0,0,0,1.0,1,1.0,1,1.0,1,0.23477782110722006,49
3211,3,5077,2563,2514,0,0,0,1.0,1,1.0,1,1.0,1,0.2776901186012864,48
3212,1,5078,2563,2515,0,0,0,1.0,1,1.0,1,1.0,1,0.27523269302454645,48
3213,3,5081,2565,2516,0,0,0,1.0,1,1.0,1,1.0,1,0.20600060369169132,49
3214,3,5084,2567,2517,0,0,0,1.0,1,1.0,1,1.0,1,0.17544845178857518,51
3215,0,5084,2567,2517,0,0,0,1.0,1,1.0,1,1.0,1,0.17544845178857518,51
3216,3,5087,2569,2518,0,0,0,1.0,1,1.0,1,1.0,1,0.15486157418727375,51
3217,1,5088,2570,2518,0,0,0,1.0,1,1.0,1,1.0,1,0.17999891947363808,51
3218,0,5088,2570,2518,0,0,0,1.0,1,1.0,1,1.0,1,0.17999891947363808,51
3219,1,5089,2570,2519,0,0,0,1.0,1,1.0,1,1.0,1,0.18786145072541724,52
3220,0,5089,2570,2519,0,0,0,1.0,1,1.0,1,1.0,1,0.18786145072541724,52
3221,0,5089,2570,2519,0,0,0,1.0,1,1.0,1,1.0,1,0.18232432120676295,54
3222,0,5089,2570,2519,0,0,0,1.0,1,1.0,1,1.0,1,0.1816631276761912,54
3223,0,5089,2570,2519,0,0,0,1.0,1,1.0,1,1.0,1,0.19761730490472865,56
3224,1,5090,2571,2519,0,0,0,1.0,1,1.0,1,1.0,1,0.2037160493001392,57
3225,2,5092,2571,2521,0,0,0,1.0,1,1.0,1,1.0,1,0.19353025054955222,58
3226,0,5092,2571,2521,0,0,0,1.0,1,1.0,1,1.0,1,0.19353025054955222,58
3227,1,5093,2571,2522,0,0,0,1.0,1,1.0,1,1.0,1,0.18934315365139776,58
3228,1,5094,2571,2523,0,0,0,1.0,1,1.0,1,1.0,1,0.16991766611557246,58
3229,1,5095,2571,2524,0,0,0,1.0,1,1.0,1,1.0,1,0.17372734946760127,60
3230,0,5095,2571,2524,0,0,0,1.0,1,1.0,1,1.0,1,0.1718484384076656,61
3231,1,5096,2572,2524,0,0,0,1.0,1,1.0,1,1.0,1,0.19212558052223178,61
3232,0,5096,2572,2524,0,0,0,1.0,1,1.0,1,1.0,1,0.19212558052223178,61
3233,1,5097,2572,2525,0,0,0,1.0,1,1.0,1,1.0,1,0.20394615202049474,63
3234,1,5098,2573,2525,0,0,0,1.0,1,1.0,1,1.0,1,0.24065793306405647,64
3235,2,5100,2573,2527,0,0,0,1.0,1,1.0,1,1.0,1,0.21724558459654925,65
3236,1,5101,2573,2528,0,0,0,1.0,1,1.0,1,1.0,1,0.20672615491108945,66
3237,2,5103,2573,2530,0,0,0,1.0,1,1.0,1,1.0,1,0.19036028420767592,67
3238,1,5104,2573,2531,0,0,0,1.0,1,1.0,1,1.0,1,0.1815592489079762,67
3239,0,5104,2573,2531,0,0,0,1.0,1,1.0,1,1.0,1,0.19448336041360836,69
3240,1,5105,2574,2531,0,0,0,1.0,1,1.0,1,1.0,1,0.18979309482945358,69
3241,4,5109,2577,2532,0,0,0,1.0,1,1.0,1,1.0,1,0.18533760485338643,68
3242,1,5110,2577,2533,0,0,0,1.0,1,1.0,1,1.0,1,0.18046267927444984,67
3243,2,5112,2579,2533,0,0,0,1.0,1,1.0,1,1.0,1,0.2110554345966777,68
3244,1,5113,2579,2534,0,0,0,1.0,1,1.0,1,1.0,1,0.18739647788005448,68
3245,0,5113,2579,2534,0,0,0,1.0,1,1.0,1,1.0,1,0.2004898964328465,69
3246,1,5114,2580,2534,0,0,0,1.0,1,1.0,1,1.0,1,0.19976327056881504,68
3247,1,5115,2580,2535,0,0,0,1.0,1,1.0,1,1.0,1,0.19077066615708774,68
3248,5,5120,2582,2538,0,0,0,1.0,1,1.0,1,1.0,1,0.16667618670702938,68
3249,1,5121,2582,2539,0,0,0,1.0,1,1.0,1,1.0,1,0.16632613196030568,69
3250,1,5122,2582,2540,0,0,0,1.0,1,1.0,1,1.0,1,0.15161134519183034,69
3251,1,5123,2583,2540,0,0,0,1.0,1,1.0,1,1.0,1,0.18655369567161975,68
3252,0,5123,2583,2540,0,0,0,1.0,1,1.0,1,1.0,1,0.16804328223300488,68
3253,1,5124,2583,2541,0,0,0,1.0,1,1.0,1,1.0,1,0.17026268366016886,69
3254,0,5124,2583,2541,0,0,0,1.0,1,1.0,1,1.0,1,0.17026268366016886,69
3255,0,5124,2583,2541,0,0,0,1.0,1,1.0,1,1.0,1,0.18213979847849304,70
3256,2,5126,2583,2543,0,0,0,1.0,1,1.0,1,1.0,1,0.1572277661975516,70
3257,0,5126,2583,2543,0,0,0,1.0,1,1.0,1,1.0,1,0.16246100443290115,71
3258,2,5128,2585,2543,0,0,0,1.0,1,1.0,1,1.0,1,0.16334927625804954,72
3259,5,5133,2587,2546,0,0,0,1.0,1,1.0,1,1.0,1,0.1643973657940116,71
3260,2,5135,2588,2547,0,0,0,1.0,1,1.0,1,1.0,1,0.18112272566327456,72
3261,3,5138,2588,2550,0,0,0,1.0,1,1.0,1,1.0,1,0.1578038156827524,74
3262,1,5139,2589,2550,0,0,0,1.0,1,1.0,1,1.0,1,0.17250715316189447,73
3263,5,5144,2591,2553,0,0,0,1.0,1,1.0,1,1.0,1,0.1720511639664119,73
3264,2,5146,2592,2554,0,0,0,1.0,1,1.0,1,1.0,1,0.18943900481235507,71
3265,4,5150,2593,2557,0,0,0,1.0,1,1.0,1,1.0,1,0.16536201630943495,70
3266,3,5153,2596,2557,0,0,0,1.0,1,1.0,1,1.0,1,0.17614651487961921,69
3267,2,5155,2597,2558,0,0,0,1.0,1,1.0,1,1.0,1,0.17773583375971413,69
3268,3,5158,2600,2558,0,0,0,1.0,1,1.0,1,1.0,1,0.17152225280028144,68
3269,4,5162,2602,2560,0,0,0,1.0,1,1.0,1,1.0,1,0.18657403541107795,68
3270,0,5162,2602,2560,0,0,0,1.0,1,1.0,1,1.0,1,0.19986181093395888,67
3271,1,5163,2602,2561,0,0,0,1.0,1,1.0,1,1.0,1,0.20298480515443137,66
3272,0,5163,2602,2561,0,0,0,1.0,1,1.0,1,1.0,1,0.18658108714722207,67
3273,2,5165,2602,2563,0,0,0,1.0,1,1.0,1,1.0,1,0.17860641414771827,66
3274,1,5166,2603,2563,0,0,0,1.0,1,1.0,1,1.0,1,0.1976803826950002,68
3275,1,5167,2603,2564,0,0,0,1.0,1,1.0,1,1.0,1,0.19288310861114047,68
3276,2,5169,2604,2565,0,0,0,1.0,1,1.0,1,1.0,1,0.18199676328077238,69
3277,2,5171,2604,2567,0,0,0,1.0,1,1.0,1,1.0,1,0.1695680540257954,68
3278,3,5174,2604,2570,0,0,0,1.0,1,1.0,1,1.0,1,0.1357124152966019,69
3279,1,5175,2605,2570,0,0,0,1.0,1,1.0,1,1.0,1,0.12808316449543145,67
3280,1,5176,2606,2570,0,0,0,1.0,1,1.0,1,1.0,1,0.15490642040766103,66
3281,3,5179,2608,2571,0,0,0,1.0,1,1.0,1,1.0,1,0.19451711343972908,67
3282,4,5183,2609,2574,0,0,0,1.0,1,1.0,1,1.0,1,0.19631195845527005,66
3283,3,5186,2610,2576,0,0,0,1.0,1,1.0,1,1.0,1,0.20978794890782287,67
3284,3,5189,2611,2578,0,0,0,1.0,1,1.0,1,1.0,1,0.1299668357943169,66
3285,0,5189,2611,2578,0,0,0,1.0,1,1.0,1,1.0,1,0.1299668357943169,66
3286,0,5189,2611,2578,0,0,0,1.0,1,1.0,1,1.0,1,0.1291675011299377,63
3287,1,5190,2612,2578,0,0,0,1.0,1,1.0,1,1.0,1,0.17686016049678738,61
3288,0,5190,2612,2578,0,0,0,1.0,1,1.0,1,1.0,1,0.21195427057999774,63
3289,2,5192,2613,2579,0,0,0,1.0,1,1.0,1,1.0,1,0.22177994892607825,62
3290,1,5193,2614,2579,0,0,0,1.0,1,1.0,1,1.0,1,0.23274585246400975,63
3291,2,5195,2615,2580,0,0,0,1.0,1,1.0,1,1.0,1,0.23381100769121968,62
3292,2,5197,2616,2581,0,0,0,1.0,1,1.0,1,1.0,1,0.23807644763320648,63
3293,2,5199,2617,2582,0,0,0,1.0,1,1.0,1,1.0,1,0.24333933762966814,65
3294,0,5199,2617,2582,0,0,0,1.0,1,1.0,1,1.0,1,0.24333933762966814,65
3295,3,5202,2619,2583,0,0,0,1.0,1,1.0,1,1.0,1,0.2400816214752414,65
3296,0,5202,2619,2583,0,0,0,1.0,1,1.0,1,1.0,1,0.2400816214752414,65
3297,2,5204,2620,2584,0,0,0,1.0,1,1.0,1,1.0,1,0.23108033346044946,66
3298,0,5204,2620,2584,0,0,0,1.0,1,1.0,1,1.0,1,0.23108033346044946,66
3299,1,5205,2620,2585,0,0,0,1.0,1,1.0,1,1.0,1,0.2164079224696221,67
3300,2,5207,2622,2585,0,0,0,1.0,1,1.0,1,1.0,1,0.23815022532840507,67
3301,4,5211,2623,2588,0,0,0,1.0,1,1.0,1,1.0,1,0.2471923380742118,68
3302,1,5212,2623,2589,0,0,0,1.0,1,1.0,1,1.0,1,0.24719471589020509,67
3303,3,5215,2624,2591,0,0,0,1.0,1,1.0,1,1.0,1,0.25175049952993,67
3304,1,5216,2625,2591,0,0,0,1.0,1,1.0,1,1.0,1,0.256800923108555,67
3305,7,5223,2625,2598,0,0,0,1.0,1,1.0,1,1.0,1,0.19178072175140332,69
3306,0,5223,2625,2598,0,0,0,1.0,1,1.0,1,1.0,1,0.18425602895877574,70
3307,1,5224,2625,2599,0,0,0,1.0,1,1.0,1,1.0,1,0.17957899531354304,70
3308,0,5224,2625,2599,0,0,0,1.0,1,1.0,1,1.0,1,0.17957899531354304,70
3309,0,5224,2625,2599,0,0,0,1.0,1,1.0,1,1.0,1,0.19605776640813594,72
3310,2,5226,2625,2601,0,0,0,1.0,1,1.0,1,1.0,1,0.1946124331283548,74
3311,1,5227,2625,2602,0,0,0,1.0,1,1.0,1,1.0,1,0.1891976186712854,74
3312,0,5227,2625,2602,0,0,0,1.0,1,1.0,1,1.0,1,0.1891976186712854,74
3313,4,5231,2625,2606,0,0,0,1.0,1,1.0,1,1.0,1,0.16789533125898862,75
3314,3,5234,2625,2609,0,0,0,1.0,1,1.0,1,1.0,1,0.15715687044699303,76
3315,2,5236,2626,2610,0,0,0,1.0,1,1.0,1,1.0,1,0.1817953959669793,75
3316,3,5239,2629,2610,0,0,0,1.0,1,1.0,1,1.0,1,0.22504196692195502,76
3317,4,5243,2631,2612,0,0,0,1.0,1,1.0,1,1.0,1,0.2230129703851878,73
3318,3,5246,2633,2613,0,0,0,1.0,1,1.0,1,1.0,1,0.2454300609221642,72
3319,3,5249,2634,2615,0,0,0,1.0,1,1.0,1,1.0,1,0.23027862216283618,71
3320,1,5250,2634,2616,0,0,0,1.0,1,1.0,1,1.0,1,0.2171215473810095,70
3321,2,5252,2635,2617,0,0,0,1.0,1,1.0,1,1.0,1,0.22441026976765502,69
3322,1,5253,2636,2617,0,0,0,1.0,1,1.0,1,1.0,1,0.21209637936660378,68
3323,1,5254,2637,2617,0,0,0,1.0,1,1.0,1,1.0,1,0.24242283062285344,69
3324,1,5255,2638,2617,0,0,0,1.0,1,1.0,1,1.0,1,0.2241141567097883,69
3325,1,5256,2638,2618,0,0,0,1.0,1,1.0,1,1.0,1,0.21986724180805423,70
3326,3,5259,2639,2620,0,0,0,1.0,1,1.0,1,1.0,1,0.2241496130538518,69
3327,1,5260,2639,2621,0,0,0,1.0,1,1.0,1,1.0,1,0.21203697397542043,70
3328,1,5261,2640,2621,0,0,0,1.0,1,1.0,1,1.0,1,0.22925381201053716,73
3329,1,5262,2641,2621,0,0,0,1.0,1,1.0,1,1.0,1,0.2657725130348666,72
3330,4,5266,2642,2624,0,0,0,1.0,1,1.0,1,1.0,1,0.23553256943618975,72
3331,4,5270,2644,2626,0,0,0,1.0,1,1.0,1,1.0,1,0.2259994317956639,72
3332,2,5272,2644,2628,0,0,0,1.0,1,1.0,1,1.0,1,0.21714816784013027,73
3333,0,5272,2644,2628,0,0,0,1.0,1,1.0,1,1.0,1,0.2202329549369245,72
3334,1,5273,2644,2629,0,0,0,1.0,1,1.0,1,1.0,1,0.20761020180376885,73
3335,0,5273,2644,2629,0,0,0,1.0,1,1.0,1,1.0,1,0.21681882754280551,74
3336,0,5273,2644,2629,0,0,0,1.0,1,1.0,1,1.0,1,0.21681882754280551,74
3337,0,5273,2644,2629,0,0,0,1.0,1,1.0,1,1.0,1,0.21681882754280551,74
3338,0,5273,2644,2629,0,0,0,1.0,1,1.0,1,1.0,1,0.21681882754280551,74
3339,2,5275,2645,2630,0,0,0,1.0,1,1.0,1,1.0,1,0.22532504370096815,75
3340,1,5276,2645,2631,0,0,0,1.0,1,1.0,1,1.0,1,0.2215604270028048,75
3341,0,5276,2645,2631,0,0,0,1.0,1,1.0,1,1.0,1,0.2283858835789161,76
3342,1,5277,2646,2631,0,0,0,1.0,1,1.0,1,1.0,1,0.24505947073040554,76
3343,5,5282,2648,2634,0,0,0,1.0,1,1.0,1,1.0,1,0.20516245306130357,75
3344,2,5284,2649,2635,0,0,0,1.0,1,1.0,1,1.0,1,0.20807348745503004,75
3345,4,5288,2651,2637,0,0,0,1.0,1,1.0,1,1.0,1,0.22718011114745068,72
3346,3,5291,2652,2639,0,0,0,1.0,1,1.0,1,1.0,1,0.2333647764297774,73
3347,5,5296,2654,2642,0,0,0,1.0,1,1.0,1,1.0,1,0.20527458026169154,73
3348,1,5297,2654,2643,0,0,0,1.0,1,1.0,1,1.0,1,0.19475161805314695,73
3349,2,5299,2655,2644,0,0,0,1.0,1,1.0,1,1.0,1,0.2024665595190387,74
3350,2,5301,2656,2645,0,0,0,1.0,1,1.0,1,1.0,1,0.19986068816100538,73
3351,3,5304,2657,2647,0,0,0,1.0,1,1.0,1,1.0,1,0.17781064227525822,72
3352,2,5306,2658,2648,0,0,0,1.0,1,1.0,1,1.0,1,0.18365621647527744,72
3353,1,5307,2659,2648,0,0,0,1.0,1,1.0,1,1.0,1,0.20850429539415427,72
3354,3,5310,2661,2649,0,0,0,1.0,1,1.0,1,1.0,1,0.20531035816030252,70
3355,5,5315,2663,2652,0,0,0,1.0,1,1.0,1,1.0,1,0.2310225890525133,69
3356,2,5317,2665,2652,0,0,0,1.0,1,1.0,1,1.0,1,0.23967226929825355,69
3357,2,5319,2666,2653,0,0,0,1.0,1,1.0,1,1.0,1,0.2286436744404777,68
3358,1,5320,2667,2653,0,0,0,1.0,1,1.0,1,1.0,1,0.24352852943817893,68
3359,2,5322,2667,2655,0,0,0,1.0,1,1.0,1,1.0,1,0.23336180984357216,66
3360,1,5323,2668,2655,0,0,0,1.0,1,1.0,1,1.0,1,0.2495450662360719,65
3361,0,5323,2668,2655,0,0,0,1.0,1,1.0,1,1.0,1,0.26495672691226974,64
3362,0,5323,2668,2655,0,0,0,1.0,1,1.0,1,1.0,1,0.26495672691226974,64
3363,0,5323,2668,2655,0,0,0,1.0,1,1.0,1,1.0,1,0.2579310450468793,65
3364,1,5324,2668,2656,0,0,0,1.0,1,1.0,1,1.0,1,0.2500296852825694,66
3365,0,5324,2668,2656,0,0,0,1.0,1,1.0,1,1.0,1,0.25227650067885693,68
3366,1,5325,2669,2656,0,0,0,1.0,1,1.0,1,1.0,1,0.27331094702763986,66
3367,1,5326,2669,2657,0,0,0,1.0,1,1.0,1,1.0,1,0.2729587282142873,68
3368,4,5330,2670,2660,0,0,0,1.0,1,1.0,1,1.0,1,0.2352386715187971,68
3369,2,5332,2670,2662,0,0,0,1.0,1,1.0,1,1.0,1,0.23056684864353147,69
3370,1,5333,2670,2663,0,0,0,1.0,1,1.0,1,1.0,1,0.20154032530183227,71
3371,1,5334,2670,2664,0,0,0,1.0,1,1.0,1,1.0,1,0.19853171208923556,71
3372,2,5336,2671,2665,0,0,0,1.0,1,1.0,1,1.0,1,0.1919321699983111,71
3373,0,5336,2671,2665,0,0,0,1.0,1,1.0,1,1.0,1,0.18976588278605164,72
3374,0,5336,2671,2665,0,0,0,1.0,1,1.0,1,1.0,1,0.18555272561029923,72
3375,1,5337,2672,2665,0,0,0,1.0,1,1.0,1,1.0,1,0.18793111981814759,73
3376,1,5338,2672,2666,0,0,0,1.0,1,1.0,1,1.0,1,0.1754400945115628,75
3377,0,5338,2672,2666,0,0,0,1.0,1,1.0,1,1.0,1,0.17605034397108069,77
3378,0,5338,2672,2666,0,0,0,1.0,1,1.0,1,1.0,1,0.17605034397108069,77
3379,3,5341,2675,2666,0,0,0,1.0,1,1.0,1,1.0,1,0.21775252014687027,77
3380,2,5343,2676,2667,0,0,0,1.0,1,1.0,1,1.0,1,0.21913615233310801,76
3381,4,5347,2678,2669,0,0,0,1.0,1,1.0,1,1.0,1,0.2188043985365141,76
3382,2,5349,2679,2670,0,0,0,1.0,1,1.0,1,1.0,1,0.21899508667001433,78
3383,1,5350,2680,2670,0,0,0,1.0,1,1.0,1,1.0,1,0.21491185204852964,77
3384,4,5354,2684,2670,0,0,0,1.0,1,1.0,1,1.0,1,0.25536910324395196,77
3385,4,5358,2685,2673,0,0,0,1.0,1,1.0,1,1.0,1,0.2255905650382516,75
3386,2,5360,2686,2674,0,0,0,1.0,1,1.0,1,1.0,1,0.24658928645284953,76
3387,1,5361,2686,2675,0,0,0,1.0,1,1.0,1,1.0,1,0.2376892893467576,75
3388,2,5363,2687,2676,0,0,0,1.0,1,1.0,1,1.0,1,0.24325066742083648,76
3389,2,5365,2687,2678,0,0,0,1.0,1,1.0,1,1.0,1,0.22966478955833872,77
3390,0,5365,2687,2678,0,0,0,1.0,1,1.0,1,1.0,1,0.2297639252549857,76
3391,1,5366,2688,2678,0,0,0,1.0,1,1.0,1,1.0,1,0.214970398198245,77
3392,2,5368,2688,2680,0,0,0,1.0,1,1.0,1,1.0,1,0.19482405177996562,78
3393,2,5370,2689,2681,0,0,0,1.0,1,1.0,1,1.0,1,0.19250689907254423,76
3394,3,5373,2690,2683,0,0,0,1.0,1,1.0,1,1.0,1,0.20888846700748284,75
3395,2,5375,2690,2685,0,0,0,1.0,1,1.0,1,1.0,1,0.1984878754392661,73
3396,0,5375,2690,2685,0,0,0,1.0,1,1.0,1,1.0,1,0.1984878754392661,73
3397,2,5377,2691,2686,0,0,0,1.0,1,1.0,1,1.0,1,0.17935669335446525,74
3398,1,5378,2692,2686,0,0,0,1.0,1,1.0,1,1.0,1,0.16847389837088078,74
3399,4,5382,2694,2688,0,0,0,1.0,1,1.0,1,1.0,1,0.1601388629108044,75
3400,2,5384,2695,2689,0,0,0,1.0,1,1.0,1,1.0,1,0.16249751184993397,75
3401,2,5386,2696,2690,0,0,0,1.0,1,1.0,1,1.0,1,0.1550674654916722,77
3402,1,5387,2697,2690,0,0,0,1.0,1,1.0,1,1.0,1,0.17024028982024744,77
3403,1,5388,2698,2690,0,0,0,1.0,1,1.0,1,1.0,1,0.1723453450353046,78
3404,1,5389,2699,2690,0,0,0,1.0,1,1.0,1,1.0,1,0.174852031089488,78
3405,1,5390,2699,2691,0,0,0,1.0,1,1.0,1,1.0,1,0.16310969374727666,78
3406,1,5391,2700,2691,0,0,0,1.0,1,1.0,1,1.0,1,0.17322184528810686,78
3407,1,5392,2700,2692,0,0,0,1.0,1,1.0,1,1.0,1,0.16270108550632514,78
3408,1,5393,2700,2693,0,0,0,1.0,1,1.0,1,1.0,1,0.14970569526666974,79
3409,1,5394,2700,2694,0,0,0,1.0,1,1.0,1,1.0,1,0.1410434890487159,81
3410,0,5394,2700,2694,0,0,0,1.0,1,1.0,1,1.0,1,0.149521031087674,82
3411,0,5394,2700,2694,0,0,0,1.0,1,1.0,1,1.0,1,0.15463860404595295,84
3412,0,5394,2700,2694,0,0,0,1.0,1,1.0,1,1.0,1,0.15463860404595295,84
3413,1,5395,2701,2694,0,0,0,1.0,1,1.0,1,1.0,1,0.1564476281543236,84
3414,0,5395,2701,2694,0,0,0,1.0,1,1.0,1,1.0,1,0.1564476281543236,84
3415,2,5397,2702,2695,0,0,0,1.0,1,1.0,1,1.0,1,0.15689807107481543,85
3416,0,5397,2702,2695,0,0,0,1.0,1,1.0,1,1.0,1,0.15689807107481543,85
3417,5,5402,2703,2699,0,0,0,1.0,1,1.0,1,1.0,1,0.14518948696626985,86
3418,1,5403,2704,2699,0,0,0,1.0,1,1.0,1,1.0,1,0.150793486165504,86
3419,1,5404,2705,2699,0,0,0,1.0,1,1.0,1,1.0,1,0.1620562612986653,87
3420,0,5404,2705,2699,0,0,0,1.0,1,1.0,1,1.0,1,0.1697970682222794,88
3421,3,5407,2707,2700,0,0,0,1.0,1,1.0,1,1.0,1,0.17463087057596918,89
3422,2,5409,2707,2702,0,0,0,1.0,1,1.0,1,1.0,1,0.16611776447197607,90
3423,3,5412,2707,2705,0,0,0,1.0,1,1.0,1,1.0,1,0.15027404233649136,90
3424,1,5413,2707,2706,0,0,0,1.0,1,1.0,1,1.0,1,0.13898782064755183,91
3425,1,5414,2708,2706,0,0,0,1.0,1,1.0,1,1.0,1,0.13822882036106587,90
3426,2,5416,2710,2706,0,0,0,1.0,1,1.0,1,1.0,1,0.15614805473850266,92
3427,1,5417,2710,2707,0,0,0,1.0,1,1.0,1,1.0,1,0.15604632596828533,92
3428,1,5418,2710,2708,0,0,0,1.0,1,1.0,1,1.0,1,0.15305424448979166,91
3429,2,5420,2710,2710,0,0,0,1.0,1,1.0,1,1.0,1,0.14916379124610743,91
3430,1,5421,2711,2710,0,0,0,1.0,1,1.0,1,1.0,1,0.15985364352685574,91
3431,0,5421,2711,2710,0,0,0,1.0,1,1.0,1,1.0,1,0.14906037873502526,90
3432,7,5428,2714,2714,0,0,0,1.0,1,1.0,1,1.0,1,0.15950762574634805,91
3433,2,5430,2714,2716,0,0,0,1.0,1,1.0,1,1.0,1,0.14622614956769073,90
3434,0,5430,2714,2716,0,0,0,1.0,1,1.0,1,1.0,1,0.15133095058314858,89
3435,2,5432,2715,2717,0,0,0,1.0,1,1.0,1,1.0,1,0.15666872276331686,88
3436,0,5432,2715,2717,0,0,0,1.0,1,1.0,1,1.0,1,0.15812244653403768,86
3437,1,5433,2716,2717,0,0,0,1.0,1,1.0,1,1.0,1,0.16161811035387916,86
3438,1,5434,2716,2718,0,0,0,1.0,1,1.0,1,1.0,1,0.15814569742894402,87
3439,2,5436,2717,2719,0,0,0,1.0,1,1.0,1,1.0,1,0.17061279139840008,86
3440,2,5438,2717,2721,0,0,0,1.0,1,1.0,1,1.0,1,0.1579152279594359,86
3441,1,5439,2718,2721,0,0,0,1.0,1,1.0,1,1.0,1,0.15409716553783703,85
3442,0,5439,2718,2721,0,0,0,1.0,1,1.0,1,1.0,1,0.15459218936042032,85
3443,0,5439,2718,2721,0,0,0,1.0,1,1.0,1,1.0,1,0.16319848414609656,85
3444,3,5442,2720,2722,0,0,0,1.0,1,1.0,1,1.0,1,0.16803527913030167,85
3445,3,5445,2722,2723,0,0,0,1.0,1,1.0,1,1.0,1,0.18917938246490465,84
3446,4,5449,2724,2725,0,0,0,1.0,1,1.0,1,1.0,1,0.1969445070661223,85
3447,3,5452,2725,2727,0,0,0,1.0,1,1.0,1,1.0,1,0.18869529136330399,85
3448,4,5456,2728,2728,0,0,0,1.0,1,1.0,1,1.0,1,0.21111136154094504,85
3449,2,5458,2728,2730,0,0,0,1.0,1,1.0,1,1.0,1,0.21128019243503082,84
3450,0,5458,2728,2730,0,0,0,1.0,1,1.0,1,1.0,1,0.21128019243503082,84
3451,1,5459,2728,2731,0,0,0,1.0,1,1.0,1,1.0,1,0.20647651464004568,85
3452,3,5462,2730,2732,0,0,0,1.0,1,1.0,1,1.0,1,0.19319412286815965,86
3453,2,5464,2730,2734,0,0,0,1.0,1,1.0,1,1.0,1,0.18617559007170745,85
3454,3,5467,2730,2737,0,0,0,1.0,1,1.0,1,1.0,1,0.15637097602237368,88
3455,0,5467,2730,2737,0,0,0,1.0,1,1.0,1,1.0,1,0.15637097602237368,88
3456,1,5468,2731,2737,0,0,0,1.0,1,1.0,1,1.0,1,0.1603396002725915,88
3457,1,5469,2731,2738,0,0,0,1.0,1,1.0,1,1.0,1,0.15624808293204023,89
3458,0,5469,2731,2738,0,0,0,1.0,1,1.0,1,1.0,1,0.16374153325475482,88
3459,0,5469,2731,2738,0,0,0,1.0,1,1.0,1,1.0,1,0.16374153325475482,88
3460,0,5469,2731,2738,0,0,0,1.0,1,1.0,1,1.0,1,0.15778024339143523,89
3461,0,5469,2731,2738,0,0,0,1.0,1,1.0,1,1.0,1,0.15778024339143523,89
3462,1,5470,2732,2738,0,0,0,1.0,1,1.0,1,1.0,1,0.16006766312503062,90
3463,2,5472,2732,2740,0,0,0,1.0,1,1.0,1,1.0,1,0.14758078576823436,89
3464,0,5472,2732,2740,0,0,0,1.0,1,1.0,1,1.0,1,0.15313630156008262,88
3465,1,5473,2732,2741,0,0,0,1.0,1,1.0,1,1.0,1,0.17429450147950187,87
3466,1,5474,2732,2742,0,0,0,1.0,1,1.0,1,1.0,1,0.16677488274166372,87
3467,4,5478,2733,2745,0,0,0,1.0,1,1.0,1,1.0,1,0.15750661760282078,87
3468,3,5481,2734,2747,0,0,0,1.0,1,1.0,1,1.0,1,0.1740488638760412,88
3469,3,5484,2735,2749,0,0,0,1.0,1,1.0,1,1.0,1,0.18481215786532698,85
3470,2,5486,2736,2750,0,0,0,1.0,1,1.0,1,1.0,1,0.1979115476887704,86
3471,5,5491,2738,2753,0,0,0,1.0,1,1.0,1,1.0,1,0.20424686221826965,84
3472,1,5492,2739,2753,0,0,0,1.0,1,1.0,1,1.0,1,0.20952765014344105,83
3473,1,5493,2739,2754,0,0,0,1.0,1,1.0,1,1.0,1,0.2035637494741705,81
3474,2,5495,2739,2756,0,0,0,1.0,1,1.0,1,1.0,1,0.16254051264635502,80
3475,3,5498,2741,2757,0,0,0,1.0,1,1.0,1,1.0,1,0.2112018267553508,82
3476,1,5499,2742,2757,0,0,0,1.0,1,1.0,1,1.0,1,0.190718181454973,81
3477,4,5503,2744,2759,0,0,0,1.0,1,1.0,1,1.0,1,0.1951162117458113,83
3478,1,5504,2744,2760,0,0,0,1.0,1,1.0,1,1.0,1,0.18721984250078927,83
3479,3,5507,2745,2762,0,0,0,1.0,1,1.0,1,1.0,1,0.17450467801511943,83
3480,1,5508,2745,2763,0,0,0,1.0,1,1.0,1,1.0,1,0.1724869598608712,83
3481,4,5512,2746,2766,0,0,0,1.0,1,1.0,1,1.0,1,0.14429897295983282,83
3482,0,5512,2746,2766,0,0,0,1.0,1,1.0,1,1.0,1,0.14574517559535663,83
3483,4,5516,2748,2768,0,0,0,1.0,1,1.0,1,1.0,1,0.15708005507470602,82
3484,1,5517,2749,2768,0,0,0,1.0,1,1.0,1,1.0,1,0.17300168030777144,82
3485,2,5519,2750,2769,0,0,0,1.0,1,1.0,1,1.0,1,0.1869217190760979,83
3486,0,5519,2750,2769,0,0,0,1.0,1,1.0,1,1.0,1,0.1869217190760979,83
3487,1,5520,2750,2770,0,0,0,1.0,1,1.0,1,1.0,1,0.17858383472634337,84
3488,0,5520,2750,2770,0,0,0,1.0,1,1.0,1,1.0,1,0.18339923025221738,84
3489,1,5521,2750,2771,0,0,0,1.0,1,1.0,1,1.0,1,0.16280433376835396,84
3490,0,5521,2750,2771,0,0,0,1.0,1,1.0,1,1.0,1,0.16280433376835396,84
3491,1,5522,2750,2772,0,0,0,1.0,1,1.0,1,1.0,1,0.16344168094126477,86
3492,2,5524,2751,2773,0,0,0,1.0,1,1.0,1,1.0,1,0.14724051707334734,86
3493,0,5524,2751,2773,0,0,0,1.0,1,1.0,1,1.0,1,0.14724051707334734,86
3494,0,5524,2751,2773,0,0,0,1.0,1,1.0,1,1.0,1,0.14724051707334734,86
3495,0,5524,2751,2773,0,0,0,1.0,1,1.0,1,1.0,1,0.1441840047694108,87
3496,2,5526,2751,2775,0,0,0,1.0,1,1.0,1,1.0,1,0.13858130289498924,88
3497,3,5529,2752,2777,0,0,0,1.0,1,1.0,1,1.0,1,0.13712281134665255,89
3498,0,5529,2752,2777,0,0,0,1.0,1,1.0,1,1.0,1,0.15344567519286442,89
3499,2,5531,2753,2778,0,0,0,1.0,1,1.0,1,1.0,1,0.15247400607207268,91
3500,2,5533,2754,2779,0,0,0,1.0,1,1.0,1,1.0,1,0.15434408762392401,90
3501,3,5536,2754,2782,0,0,0,1.0,1,1.0,1,1.0,1,0.13456355164066133,90
3502,0,5536,2754,2782,0,0,0,1.0,1,1.0,1,1.0,1,0.14160644648417045,91
3503,5,5541,2757,2784,0,0,0,1.0,1,1.0,1,1.0,1,0.13692851804036285,91
3504,3,5544,2760,2784,0,0,0,1.0,1,1.0,1,1.0,1,0.1750222204905876,89
3505,2,5546,2760,2786,0,0,0,1.0,1,1.0,1,1.0,1,0.16580132418327492,87
3506,5,5551,2762,2789,0,0,0,1.0,1,1.0,1,1.0,1,0.13527812512164802,87
3507,4,5555,2764,2791,0,0,0,1.0,1,1.0,1,1.0,1,0.1292147192187304,84
3508,3,5558,2767,2791,0,0,0,1.0,1,1.0,1,1.0,1,0.15573679506309657,83
3509,2,5560,2769,2791,0,0,0,1.0,1,1.0,1,1.0,1,0.17127812123166555,80
3510,1,5561,2770,2791,0,0,0,1.0,1,1.0,1,1.0,1,0.17285833189449593,78
3511,3,5564,2772,2792,0,0,0,1.0,1,1.0,1,1.0,1,0.16834173164247243,77
3512,0,5564,2772,2792,0,0,0,1.0,1,1.0,1,1.0,1,0.17595997968413257,74
3513,2,5566,2773,2793,0,0,0,1.0,1,1.0,1,1.0,1,0.16347207156299756,76
3514,0,5566,2773,2793,0,0,0,1.0,1,1.0,1,1.0,1,0.16391845017163056,76
3515,0,5566,2773,2793,0,0,0,1.0,1,1.0,1,1.0,1,0.16483669681810675,75
3516,1,5567,2774,2793,0,0,0,1.0,1,1.0,1,1.0,1,0.18346884745040518,73
3517,4,5571,2777,2794,0,0,0,1.0,1,1.0,1,1.0,1,0.2001521975005604,74
3518,0,5571,2777,2794,0,0,0,1.0,1,1.0,1,1.0,1,0.21639772591613565,74
3519,0,5571,2777,2794,0,0,0,1.0,1,1.0,1,1.0,1,0.2268898237332441,73
3520,1,5572,2777,2795,0,0,0,1.0,1,1.0,1,1.0,1,0.20996624792591084,74
3521,3,5575,2777,2798,0,0,0,1.0,1,1.0,1,1.0,1,0.18455662445641094,75
3522,0,5575,2777,2798,0,0,0,1.0,1,1.0,1,1.0,1,0.18455662445641094,75
3523,2,5577,2777,2800,0,0,0,1.0,1,1.0,1,1.0,1,0.16041716456176006,75
3524,1,5578,2778,2800,0,0,0,1.0,1,1.0,1,1.0,1,0.14903466377258306,75
3525,0,5578,2778,2800,0,0,0,1.0,1,1.0,1,1.0,1,0.15659731561177348,75
3526,2,5580,2780,2800,0,0,0,1.0,1,1.0,1,1.0,1,0.16527933830660677,76
3527,4,5584,2782,2802,0,0,0,1.0,1,1.0,1,1.0,1,0.20000524886306,77
3528,3,5587,2783,2804,0,0,0,1.0,1,1.0,1,1.0,1,0.20685453919782537,77
3529,6,5593,2784,2809,0,0,0,1.0,1,1.0,1,1.0,1,0.17739462844596818,78
3530,0,5593,2784,2809,0,0,0,1.0,1,1.0,1,1.0,1,0.19791263100366308,78
3531,0,5593,2784,2809,0,0,0,1.0,1,1.0,1,1.0,1,0.20887251642247426,79
3532,2,5595,2785,2810,0,0,0,1.0,1,1.0,1,1.0,1,0.22468322339449487,79
3533,4,5599,2787,2812,0,0,0,1.0,1,1.0,1,1.0,1,0.23212708439272098,79
3534,3,5602,2790,2812,0,0,0,1.0,1,1.0,1,1.0,1,0.2574074575083264,80
3535,3,5605,2790,2815,0,0,0,1.0,1,1.0,1,1.0,1,0.23263166709418925,81
3536,1,5606,2790,2816,0,0,0,1.0,1,1.0,1,1.0,1,0.2261857708986356,82
3537,1,5607,2790,2817,0,0,0,1.0,1,1.0,1,1.0,1,0.2211419344104233,82
3538,1,5608,2791,2817,0,0,0,1.0,1,1.0,1,1.0,1,0.22972859379674895,83
3539,1,5609,2791,2818,0,0,0,1.0,1,1.0,1,1.0,1,0.21990902302992743,83
3540,1,5610,2792,2818,0,0,0,1.0,1,1.0,1,1.0,1,0.21798197294556024,85
3541,2,5612,2793,2819,0,0,0,1.0,1,1.0,1,1.0,1,0.2178036944858121,85
3542,3,5615,2794,2821,0,0,0,1.0,1,1.0,1,1.0,1,0.1944148691076328,88
3543,2,5617,2795,2822,0,0,0,1.0,1,1.0,1,1.0,1,0.18918768134761155,87
3544,1,5618,2796,2822,0,0,0,1.0,1,1.0,1,1.0,1,0.19103438588413874,87
3545,1,5619,2797,2822,0,0,0,1.0,1,1.0,1,1.0,1,0.19607986310087092,85
3546,0,5619,2797,2822,0,0,0,1.0,1,1.0,1,1.0,1,0.1893217351402639,83
3547,1,5620,2797,2823,0,0,0,1.0,1,1.0,1,1.0,1,0.16989975985019484,82
3548,2,5622,2799,2823,0,0,0,1.0,1,1.0,1,1.0,1,0.17750741356290872,82
3549,0,5622,2799,2823,0,0,0,1.0,1,1.0,1,1.0,1,0.16992591818937747,81
3550,1,5623,2800,2823,0,0,0,1.0,1,1.0,1,1.0,1,0.18653304857985697,79
3551,3,5626,2802,2824,0,0,0,1.0,1,1.0,1,1.0,1,0.1865469585329096,80
3552,2,5628,2803,2825,0,0,0,1.0,1,1.0,1,1.0,1,0.1893815906016768,78
3553,1,5629,2803,2826,0,0,0,1.0,1,1.0,1,1.0,1,0.18543043603153284,79
3554,1,5630,2803,2827,0,0,0,1.0,1,1.0,1,1.0,1,0.1788313985809278,77
3555,1,5631,2804,2827,0,0,0,1.0,1,1.0,1,1.0,1,0.19060165890726727,77
3556,0,5631,2804,2827,0,0,0,1.0,1,1.0,1,1.0,1,0.20216226711055205,76
3557,2,5633,2804,2829,0,0,0,1.0,1,1.0,1,1.0,1,0.18259950164510075,76
3558,3,5636,2805,2831,0,0,0,1.0,1,1.0,1,1.0,1,0.17025962960337382,76
3559,0,5636,2805,2831,0,0,0,1.0,1,1.0,1,1.0,1,0.17025962960337382,76
3560,5,5641,2806,2835,0,0,0,1.0,1,1.0,1,1.0,1,0.1576745522674156,78
3561,4,5645,2807,2838,0,0,0,1.0,1,1.0,1,1.0,1,0.14924395923253625,79
3562,2,5647,2809,2838,0,0,0,1.0,1,1.0,1,1.0,1,0.1651223162694218,79
3563,4,5651,2811,2840,0,0,0,1.0,1,1.0,1,1.0,1,0.13857292457509998,79
3564,2,5653,2813,2840,0,0,0,1.0,1,1.0,1,1.0,1,0.1478687692387857,80
3565,1,5654,2814,2840,0,0,0,1.0,1,1.0,1,1.0,1,0.15777635527025288,83
3566,1,5655,2815,2840,0,0,0,1.0,1,1.0,1,1.0,1,0.18048562980660635,84
3567,4,5659,2815,2844,0,0,0,1.0,1,1.0,1,1.0,1,0.15188559159643866,84
3568,2,5661,2817,2844,0,0,0,1.0,1,1.0,1,1.0,1,0.1657673667066823,84
3569,1,5662,2818,2844,0,0,0,1.0,1,1.0,1,1.0,1,0.1723388572595898,84
3570,4,5666,2820,2846,0,0,0,1.0,1,1.0,1,1.0,1,0.1764356425682227,87
3571,3,5669,2821,2848,0,0,0,1.0,1,1.0,1,1.0,1,0.18406988669842114,86
3572,2,5671,2822,2849,0,0,0,1.0,1,1.0,1,1.0,1,0.17845461561792839,87
3573,2,5673,2823,2850,0,0,0,1.0,1,1.0,1,1.0,1,0.18370850225069044,87
3574,1,5674,2824,2850,0,0,0,1.0,1,1.0,1,1.0,1,0.17680030592781162,88
3575,1,5675,2824,2851,0,0,0,1.0,1,1.0,1,1.0,1,0.17286586498350615,88
3576,2,5677,2825,2852,0,0,0,1.0,1,1.0,1,1.0,1,0.16738092954125425,90
3577,2,5679,2825,2854,0,0,0,1.0,1,1.0,1,1.0,1,0.14770206021539511,90
3578,0,5679,2825,2854,0,0,0,1.0,1,1.0,1,1.0,1,0.15597902454916332,91
3579,3,5682,2827,2855,0,0,0,1.0,1,1.0,1,1.0,1,0.14386188584758522,91
3580,1,5683,2828,2855,0,0,0,1.0,1,1.0,1,1.0,1,0.1748314537166913,91
3581,4,5687,2829,2858,0,0,0,1.0,1,1.0,1,1.0,1,0.15794693272131302,91
3582,3,5690,2830,2860,0,0,0,1.0,1,1.0,1,1.0,1,0.15599012123985137,92
3583,1,5691,2831,2860,0,0,0,1.0,1,1.0,1,1.0,1,0.1533691468181287,88
3584,1,5692,2831,2861,0,0,0,1.0,1,1.0,1,1.0,1,0.14508639353620667,87
3585,6,5698,2835,2863,0,0,0,1.0,1,1.0,1,1.0,1,0.1502760411498282,84
3586,5,5703,2838,2865,0,0,0,1.0,1,1.0,1,1.0,1,0.15047646318501443,83
3587,2,5705,2838,2867,0,0,0,1.0,1,1.0,1,1.0,1,0.14174343897473357,82
3588,2,5707,2840,2867,0,0,0,1.0,1,1.0,1,1.0,1,0.1621636493971196,81
3589,5,5712,2845,2867,0,0,0,1.0,1,1.0,1,1.0,1,0.19600525087383505,80
3590,3,5715,2847,2868,0,0,0,1.0,1,1.0,1,1.0,1,0.20031035201229114,78
3591,8,5723,2849,2874,0,0,0,1.0,1,1.0,1,1.0,1,0.13758752911278233,77
3592,1,5724,2850,2874,0,0,0,1.0,1,1.0,1,1.0,1,0.15706378676189212,75
3593,1,5725,2850,2875,0,0,0,1.0,1,1.0,1,1.0,1,0.16751350186165806,76
3594,0,5725,2850,2875,0,0,0,1.0,1,1.0,1,1.0,1,0.17927782819740593,74
3595,3,5728,2852,2876,0,0,0,1.0,1,1.0,1,1.0,1,0.18810365363769194,74
3596,1,5729,2853,2876,0,0,0,1.0,1,1.0,1,1.0,1,0.18569595884229761,73
3597,5,5734,2855,2879,0,0,0,1.0,1,1.0,1,1.0,1,0.15735448472088864,73
3598,2,5736,2857,2879,0,0,0,1.0,1,1.0,1,1.0,1,0.166648186342475,73
3599,4,5740,2858,2882,0,0,0,1.0,1,1.0,1,1.0,1,0.14312040584558117,73
3600,0,5740,2858,2882,0,0,0,1.0,1,1.0,1,1.0,1,0.1444803543861862,74
3601,2,5742,2859,2883,0,0,0,1.0,1,1.0,1,1.0,1,0.1466283088848225,75
3602,1,5743,2859,2884,0,0,0,1.0,1,1.0,1,1.0,1,0.1207390508292918,76
3603,1,5744,2860,2884,0,0,0,1.0,1,1.0,1,1.0,1,0.1400801926492049,77
3604,2,5746,2861,2885,0,0,0,1.0,1,1.0,1,1.0,1,0.14392117169291505,78
3605,1,5747,2861,2886,0,0,0,1.0,1,1.0,1,1.0,1,0.12635555897870165,77
3606,2,5749,2862,2887,0,0,0,1.0,1,1.0,1,1.0,1,0.1207465534023084,79
3607,1,5750,2862,2888,0,0,0,1.0,1,1.0,1,1.0,1,0.11368256403711967,79
3608,0,5750,2862,2888,0,0,0,1.0,1,1.0,1,1.0,1,0.11368256403711967,79
3609,0,5750,2862,2888,0,0,0,1.0,1,1.0,1,1.0,1,0.11368256403711967,79
3610,2,5752,2864,2888,0,0,0,1.0,1,1.0,1,1.0,1,0.13357990184703916,80
3611,2,5754,2865,2889,0,0,0,1.0,1,1.0,1,1.0,1,0.1247746855168742,80
3612,0,5754,2865,2889,0,0,0,1.0,1,1.0,1,1.0,1,0.14184158348637338,79
3613,3,5757,2867,2890,0,0,0,1.0,1,1.0,1,1.0,1,0.14675306405574476,79
3614,3,5760,2870,2890,0,0,0,1.0,1,1.0,1,1.0,1,0.1583119917486711,78
3615,3,5763,2870,2893,0,0,0,1.0,1,1.0,1,1.0,1,0.1276444823914317,79
3616,2,5765,2871,2894,0,0,0,1.0,1,1.0,1,1.0,1,0.14928247686224025,79
3617,4,5769,2873,2896,0,0,0,1.0,1,1.0,1,1.0,1,0.13629882634165885,80
3618,1,5770,2873,2897,0,0,0,1.0,1,1.0,1,1.0,1,0.14967495420865673,82
3619,1,5771,2873,2898,0,0,0,1.0,1,1.0,1,1.0,1,0.1539277089697782,82
3620,3,5774,2875,2899,0,0,0,1.0,1,1.0,1,1.0,1,0.16735935181353404,81
3621,3,5777,2876,2901,0,0,0,1.0,1,1.0,1,1.0,1,0.15870841643492004,83
3622,3,5780,2878,2902,0,0,0,1.0,1,1.0,1,1.0,1,0.1903633881273281,81
3623,7,5787,2881,2906,0,0,0,1.0,1,1.0,1,1.0,1,0.20990455848797743,81
3624,2,5789,2882,2907,0,0,0,1.0,1,1.0,1,1.0,1,0.2160469208097295,79
3625,4,5793,2884,2909,0,0,0,1.0,1,1.0,1,1.0,1,0.22680631811381652,80
3626,2,5795,2884,2911,0,0,0,1.0,1,1.0,1,1.0,1,0.18678275092806426,78
3627,1,5796,2884,2912,0,0,0,1.0,1,1.0,1,1.0,1,0.1935346933584121,78
3628,1,5797,2885,2912,0,0,0,1.0,1,1.0,1,1.0,1,0.18425164679952874,77
3629,2,5799,2885,2914,0,0,0,1.0,1,1.0,1,1.0,1,0.16060826773807604,76
3630,0,5799,2885,2914,0,0,0,1.0,1,1.0,1,1.0,1,0.16113253495718033,77
3631,3,5802,2887,2915,0,0,0,1.0,1,1.0,1,1.0,1,0.16686204093229512,75
3632,2,5804,2889,2915,0,0,0,1.0,1,1.0,1,1.0,1,0.1880646812896816,74
3633,3,5807,2890,2917,0,0,0,1.0,1,1.0,1,1.0,1,0.1617333831572922,75
3634,3,5810,2892,2918,0,0,0,1.0,1,1.0,1,1.0,1,0.18321697138912532,74
3635,4,5814,2893,2921,0,0,0,1.0,1,1.0,1,1.0,1,0.13531620378017628,74
3636,1,5815,2893,2922,0,0,0,1.0,1,1.0,1,1.0,1,0.13411827899769768,74
3637,1,5816,2893,2923,0,0,0,1.0,1,1.0,1,1.0,1,0.13307062237283554,74
3638,0,5816,2893,2923,0,0,0,1.0,1,1.0,1,1.0,1,0.14192038030016535,75
3639,4,5820,2895,2925,0,0,0,1.0,1,1.0,1,1.0,1,0.15423330538151706,76
3640,2,5822,2895,2927,0,0,0,1.0,1,1.0,1,1.0,1,0.1295225726536153,76
3641,4,5826,2897,2929,0,0,0,1.0,1,1.0,1,1.0,1,0.1572702550202351,75
3642,3,5829,2899,2930,0,0,0,1.0,1,1.0,1,1.0,1,0.1821124023717564,75
3643,1,5830,2899,2931,0,0,0,1.0,1,1.0,1,1.0,1,0.17474292674498448,74
3644,1,5831,2900,2931,0,0,0,1.0,1,1.0,1,1.0,1,0.16982826257690148,74
3645,0,5831,2900,2931,0,0,0,1.0,1,1.0,1,1.0,1,0.16982826257690148,74
3646,0,5831,2900,2931,0,0,0,1.0,1,1.0,1,1.0,1,0.16120677742777353,75
3647,1,5832,2900,2932,0,0,0,1.0,1,1.0,1,1.0,1,0.15810770897045603,77
3648,2,5834,2900,2934,0,0,0,1.0,1,1.0,1,1.0,1,0.15669402886935924,78
3649,1,5835,2900,2935,0,0,0,1.0,1,1.0,1,1.0,1,0.15043184785922717,80
3650,1,5836,2901,2935,0,0,0,1.0,1,1.0,1,1.0,1,0.16723012176742963,81
3651,1,5837,2901,2936,0,0,0,1.0,1,1.0,1,1.0,1,0.1564473362787517,81
3652,1,5838,2902,2936,0,0,0,1.0,1,1.0,1,1.0,1,0.1832784102738404,83
3653,2,5840,2902,2938,0,0,0,1.0,1,1.0,1,1.0,1,0.1602058427961161,83
3654,0,5840,2902,2938,0,0,0,1.0,1,1.0,1,1.0,1,0.1602058427961161,83
3655,0,5840,2902,2938,0,0,0,1.0,1,1.0,1,1.0,1,0.15401160653498547,84
3656,2,5842,2902,2940,0,0,0,1.0,1,1.0,1,1.0,1,0.15102999277503446,85
3657,1,5843,2903,2940,0,0,0,1.0,1,1.0,1,1.0,1,0.16320845219951463,86
3658,1,5844,2904,2940,0,0,0,1.0,1,1.0,1,1.0,1,0.18981963616685776,87
3659,1,5845,2904,2941,0,0,0,1.0,1,1.0,1,1.0,1,0.17769195776011854,87
3660,0,5845,2904,2941,0,0,0,1.0,1,1.0,1,1.0,1,0.17327462117642095,86
3661,2,5847,2905,2942,0,0,0,1.0,1,1.0,1,1.0,1,0.18375557922797423,86
3662,0,5847,2905,2942,0,0,0,1.0,1,1.0,1,1.0,1,0.1959469358312293,83
3663,9,5856,2909,2947,0,0,0,1.0,1,1.0,1,1.0,1,0.19903119379640857,85
3664,2,5858,2910,2948,0,0,0,1.0,1,1.0,1,1.0,1,0.19198807592932007,82
3665,2,5860,2910,2950,0,0,0,1.0,1,1.0,1,1.0,1,0.17851385292786726,81
3666,3,5863,2912,2951,0,0,0,1.0,1,1.0,1,1.0,1,0.20594930285267138,79
3667,4,5867,2912,2955,0,0,0,1.0,1,1.0,1,1.0,1,0.1855276208427752,79
3668,0,5867,2912,2955,0,0,0,1.0,1,1.0,1,1.0,1,0.18580369398749555,77
3669,3,5870,2912,2958,0,0,0,1.0,1,1.0,1,1.0,1,0.16825808451414306,75
3670,2,5872,2914,2958,0,0,0,1.0,1,1.0,1,1.0,1,0.15982519202506898,76
3671,3,5875,2915,2960,0,0,0,1.0,1,1.0,1,1.0,1,0.15118626250597808,74
3672,1,5876,2916,2960,0,0,0,1.0,1,1.0,1,1.0,1,0.16356478381138512,75
3673,1,5877,2916,2961,0,0,0,1.0,1,1.0,1,1.0,1,0.156007704497709,75
3674,3,5880,2919,2961,0,0,0,1.0,1,1.0,1,1.0,1,0.14070670973722343,75
3675,1,5881,2919,2962,0,0,0,1.0,1,1.0,1,1.0,1,0.13569653086133893,75
3676,1,5882,2920,2962,0,0,0,1.0,1,1.0,1,1.0,1,0.14466083077564545,75
3677,0,5882,2920,2962,0,0,0,1.0,1,1.0,1,1.0,1,0.14858002333412848,75
3678,0,5882,2920,2962,0,0,0,1.0,1,1.0,1,1.0,1,0.15957793086614483,77
3679,2,5884,2921,2963,0,0,0,1.0,1,1.0,1,1.0,1,0.18107911351591544,78
3680,1,5885,2921,2964,0,0,0,1.0,1,1.0,1,1.0,1,0.17985113226031732,80
3681,2,5887,2921,2966,0,0,0,1.0,1,1.0,1,1.0,1,0.17835670357733283,81
3682,0,5887,2921,2966,0,0,0,1.0,1,1.0,1,1.0,1,0.17835670357733283,81
3683,1,5888,2922,2966,0,0,0,1.0,1,1.0,1,1.0,1,0.19147177075143262,81
3684,0,5888,2922,2966,0,0,0,1.0,1,1.0,1,1.0,1,0.19147177075143262,81
3685,0,5888,2922,2966,0,0,0,1.0,1,1.0,1,1.0,1,0.19147177075143262,81
3686,0,5888,2922,2966,0,0,0,1.0,1,1.0,1,1.0,1,0.19147177075143262,81
3687,0,5888,2922,2966,0,0,0,1.0,1,1.0,1,1.0,1,0.1848656196386618,82
3688,2,5890,2922,2968,0,0,0,1.0,1,1.0,1,1.0,1,0.19254045489631322,84
3689,0,5890,2922,2968,0,0,0,1.0,1,1.0,1,1.0,1,0.19254045489631322,84
3690,4,5894,2922,2972,0,0,0,1.0,1,1.0,1,1.0,1,0.16775089662456066,85
3691,2,5896,2922,2974,0,0,0,1.0,1,1.0,1,1.0,1,0.15389048092414934,86
3692,0,5896,2922,2974,0,0,0,1.0,1,1.0,1,1.0,1,0.151632505728626,86
3693,0,5896,2922,2974,0,0,0,1.0,1,1.0,1,1.0,1,0.151632505728626,86
3694,0,5896,2922,2974,0,0,0,1.0,1,1.0,1,1.0,1,0.151632505728626,86
3695,3,5899,2925,2974,0,0,0,1.0,1,1.0,1,1.0,1,0.18132561762753832,86
3696,2,5901,2925,2976,0,0,0,1.0,1,1.0,1,1.0,1,0.15204024116957304,87
3697,1,5902,2926,2976,0,0,0,1.0,1,1.0,1,1.0,1,0.15818090053772893,85
3698,1,5903,2927,2976,0,0,0,1.0,1,1.0,1,1.0,1,0.15874796955860243,85
3699,1,5904,2928,2976,0,0,0,1.0,1,1.0,1,1.0,1,0.15104109540532798,85
3700,3,5907,2931,2976,0,0,0,1.0,1,1.0,1,1.0,1,0.17400226537213498,84
3701,2,5909,2931,2978,0,0,0,1.0,1,1.0,1,1.0,1,0.15474887654363298,85
3702,2,5911,2933,2978,0,0,0,1.0,1,1.0,1,1.0,1,0.16126366223600735,85
3703,0,5911,2933,2978,0,0,0,1.0,1,1.0,1,1.0,1,0.16126366223600735,85
3704,2,5913,2934,2979,0,0,0,1.0,1,1.0,1,1.0,1,0.17239648041738914,85
3705,2,5915,2934,2981,0,0,0,1.0,1,1.0,1,1.0,1,0.1494960025236986,86
3706,1,5916,2935,2981,0,0,0,1.0,1,1.0,1,1.0,1,0.15769383763904873,86
3707,1,5917,2936,2981,0,0,0,1.0,1,1.0,1,1.0,1,0.16402116992586432,85
3708,2,5919,2936,2983,0,0,0,1.0,1,1.0,1,1.0,1,0.14908604822271562,84
3709,0,5919,2936,2983,0,0,0,1.0,1,1.0,1,1.0,1,0.15553189027218334,85
3710,0,5919,2936,2983,0,0,0,1.0,1,1.0,1,1.0,1,0.14537642114263158,84
3711,0,5919,2936,2983,0,0,0,1.0,1,1.0,1,1.0,1,0.1534717778306144,85
3712,0,5919,2936,2983,0,0,0,1.0,1,1.0,1,1.0,1,0.1534717778306144,85
3713,0,5919,2936,2983,0,0,0,1.0,1,1.0,1,1.0,1,0.1534717778306144,85
3714,1,5920,2937,2983,0,0,0,1.0,1,1.0,1,1.0,1,0.1791680394096185,85
3715,2,5922,2938,2984,0,0,0,1.0,1,1.0,1,1.0,1,0.17251033226370693,85
3716,0,5922,2938,2984,0,0,0,1.0,1,1.0,1,1.0,1,0.1818271570185613,84
3717,2,5924,2938,2986,0,0,0,1.0,1,1.0,1,1.0,1,0.17779375611077555,86
3718,0,5924,2938,2986,0,0,0,1.0,1,1.0,1,1.0,1,0.1891635065480052,85
3719,5,5929,2940,2989,0,0,0,1.0,1,1.0,1,1.0,1,0.18439674308497708,84
3720,0,5929,2940,2989,0,0,0,1.0,1,1.0,1,1.0,1,0.2038715905410765,84
3721,6,5935,2944,2991,0,0,0,1.0,1,1.0,1,1.0,1,0.2043800922889812,85
3722,1,5936,2944,2992,0,0,0,1.0,1,1.0,1,1.0,1,0.19697672000948502,85
3723,2,5938,2945,2993,0,0,0,1.0,1,1.0,1,1.0,1,0.19662231667686067,85
3724,1,5939,2945,2994,0,0,0,1.0,1,1.0,1,1.0,1,0.1858027786609893,86
3725,4,5943,2946,2997,0,0,0,1.0,1,1.0,1,1.0,1,0.1589913150412521,86
3726,0,5943,2946,2997,0,0,0,1.0,1,1.0,1,1.0,1,0.1589913150412521,86
3727,1,5944,2946,2998,0,0,0,1.0,1,1.0,1,1.0,1,0.1513228306324453,86
3728,0,5944,2946,2998,0,0,0,1.0,1,1.0,1,1.0,1,0.1513228306324453,86
3729,2,5946,2947,2999,0,0,0,1.0,1,1.0,1,1.0,1,0.15934352409020036,86
3730,1,5947,2947,3000,0,0,0,1.0,1,1.0,1,1.0,1,0.16621486328616183,85
3731,2,5949,2947,3002,0,0,0,1.0,1,1.0,1,1.0,1,0.15418776025953967,86
3732,1,5950,2948,3002,0,0,0,1.0,1,1.0,1,1.0,1,0.16220198665225444,87
3733,2,5952,2949,3003,0,0,0,1.0,1,1.0,1,1.0,1,0.17156814172712373,87
3734,0,5952,2949,3003,0,0,0,1.0,1,1.0,1,1.0,1,0.17156814172712373,87
3735,3,5955,2950,3005,0,0,0,1.0,1,1.0,1,1.0,1,0.1780284748410018,86
3736,0,5955,2950,3005,0,0,0,1.0,1,1.0,1,1.0,1,0.1680276499010799,87
3737,3,5958,2951,3007,0,0,0,1.0,1,1.0,1,1.0,1,0.17181889473623033,87
3738,1,5959,2952,3007,0,0,0,1.0,1,1.0,1,1.0,1,0.17950754109569245,87
3739,2,5961,2952,3009,0,0,0,1.0,1,1.0,1,1.0,1,0.16373384256619222,88
3740,2,5963,2954,3009,0,0,0,1.0,1,1.0,1,1.0,1,0.19288243236516384,87
3741,3,5966,2954,3012,0,0,0,1.0,1,1.0,1,1.0,1,0.1671313175814927,87
3742,2,5968,2955,3013,0,0,0,1.0,1,1.0,1,1.0,1,0.16555060042946076,86
3743,2,5970,2955,3015,0,0,0,1.0,1,1.0,1,1.0,1,0.15469192840892365,84
3744,3,5973,2956,3017,0,0,0,1.0,1,1.0,1,1.0,1,0.16103749421659588,83
3745,1,5974,2956,3018,0,0,0,1.0,1,1.0,1,1.0,1,0.1510734308066873,83
3746,3,5977,2957,3020,0,0,0,1.0,1,1.0,1,1.0,1,0.1716802175326044,83
3747,3,5980,2958,3022,0,0,0,1.0,1,1.0,1,1.0,1,0.16666084941372453,81
3748,1,5981,2958,3023,0,0,0,1.0,1,1.0,1,1.0,1,0.1674738780404778,81
3749,1,5982,2958,3024,0,0,0,1.0,1,1.0,1,1.0,1,0.16933466721960966,80
3750,0,5982,2958,3024,0,0,0,1.0,1,1.0,1,1.0,1,0.17486884060532712,79
3751,5,5987,2962,3025,0,0,0,1.0,1,1.0,1,1.0,1,0.19298320872283065,80
3752,3,5990,2964,3026,0,0,0,1.0,1,1.0,1,1.0,1,0.210228129561297,80
3753,6,5996,2967,3029,0,0,0,1.0,1,1.0,1,1.0,1,0.20735876350763205,81
3754,1,5997,2968,3029,0,0,0,1.0,1,1.0,1,1.0,1,0.21142233927839427,81
3755,2,5999,2969,3030,0,0,0,1.0,1,1.0,1,1.0,1,0.19918304190911743,80
3756,1,6000,2970,3030,0,0,0,1.0,1,1.0,1,1.0,1,0.2093548406454922,79
3757,5,6005,2970,3035,0,0,0,1.0,1,1.0,1,1.0,1,0.18364738283578783,80
3758,2,6007,2971,3036,0,0,0,1.0,1,1.0,1,1.0,1,0.1949006596782294,79
3759,1,6008,2972,3036,0,0,0,1.0,1,1.0,1,1.0,1,0.21228098299669682,79
3760,0,6008,2972,3036,0,0,0,1.0,1,1.0,1,1.0,1,0.21228098299669682,79
3761,1,6009,2972,3037,0,0,0,1.0,1,1.0,1,1.0,1,0.2212638176303165,78
3762,1,6010,2972,3038,0,0,0,1.0,1,1.0,1,1.0,1,0.21563373911411507,80
3763,0,6010,2972,3038,0,0,0,1.0,1,1.0,1,1.0,1,0.21563373911411507,80
3764,3,6013,2974,3039,0,0,0,1.0,1,1.0,1,1.0,1,0.24312789137005453,80
3765,5,6018,2975,3043,0,0,0,1.0,1,1.0,1,1.0,1,0.21863735779589855,81
3766,2,6020,2976,3044,0,0,0,1.0,1,1.0,1,1.0,1,0.227865676416829,83
3767,1,6021,2977,3044,0,0,0,1.0,1,1.0,1,1.0,1,0.22051204760121362,83
3768,3,6024,2978,3046,0,0,0,1.0,1,1.0,1,1.0,1,0.2033227014143164,84
3769,2,6026,2978,3048,0,0,0,1.0,1,1.0,1,1.0,1,0.16915653536839348,86
3770,0,6026,2978,3048,0,0,0,1.0,1,1.0,1,1.0,1,0.17553353225884982,87
3771,1,6027,2979,3048,0,0,0,1.0,1,1.0,1,1.0,1,0.1772316772235918,87
3772,0,6027,2979,3048,0,0,0,1.0,1,1.0,1,1.0,1,0.19263471886081665,88
3773,2,6029,2979,3050,0,0,0,1.0,1,1.0,1,1.0,1,0.19478283168741387,85
3774,1,6030,2979,3051,0,0,0,1.0,1,1.0,1,1.0,1,0.19077899791031666,85
3775,2,6032,2980,3052,0,0,0,1.0,1,1.0,1,1.0,1,0.21545354618949966,83
3776,2,6034,2981,3053,0,0,0,1.0,1,1.0,1,1.0,1,0.2308096322885455,82
3777,6,6040,2983,3057,0,0,0,1.0,1,1.0,1,1.0,1,0.20367447765829452,81
3778,1,6041,2983,3058,0,0,0,1.0,1,1.0,1,1.0,1,0.20174874272491872,81
3779,2,6043,2985,3058,0,0,0,1.0,1,1.0,1,1.0,1,0.23321715205371468,80
3780,2,6045,2985,3060,0,0,0,1.0,1,1.0,1,1.0,1,0.2158696208485701,80
3781,1,6046,2985,3061,0,0,0,1.0,1,1.0,1,1.0,1,0.2092571029461884,80
3782,2,6048,2986,3062,0,0,0,1.0,1,1.0,1,1.0,1,0.21432799724119156,80
3783,3,6051,2988,3063,0,0,0,1.0,1,1.0,1,1.0,1,0.21962153794476164,80
3784,1,6052,2988,3064,0,0,0,1.0,1,1.0,1,1.0,1,0.20969638032902393,79
3785,1,6053,2988,3065,0,0,0,1.0,1,1.0,1,1.0,1,0.2169577506756197,77
3786,2,6055,2989,3066,0,0,0,1.0,1,1.0,1,1.0,1,0.19510491432403151,78
3787,1,6056,2989,3067,0,0,0,1.0,1,1.0,1,1.0,1,0.19026961804961856,77
3788,1,6057,2989,3068,0,0,0,1.0,1,1.0,1,1.0,1,0.18756715992610862,78
3789,3,6060,2990,3070,0,0,0,1.0,1,1.0,1,1.0,1,0.18066371567281442,77
3790,1,6061,2991,3070,0,0,0,1.0,1,1.0,1,1.0,1,0.1958055328313753,77
3791,3,6064,2992,3072,0,0,0,1.0,1,1.0,1,1.0,1,0.1943745910557257,77
3792,1,6065,2992,3073,0,0,0,1.0,1,1.0,1,1.0,1,0.17297147606133847,78
3793,3,6068,2994,3074,0,0,0,1.0,1,1.0,1,1.0,1,0.18048234086776985,80
3794,4,6072,2994,3078,0,0,0,1.0,1,1.0,1,1.0,1,0.13670955648829228,82
3795,0,6072,2994,3078,0,0,0,1.0,1,1.0,1,1.0,1,0.14832021900489747,83
3796,1,6073,2995,3078,0,0,0,1.0,1,1.0,1,1.0,1,0.1421946113912596,83
3797,1,6074,2995,3079,0,0,0,1.0,1,1.0,1,1.0,1,0.144918670543469,82
3798,1,6075,2996,3079,0,0,0,1.0,1,1.0,1,1.0,1,0.14699879321753995,82
3799,1,6076,2996,3080,0,0,0,1.0,1,1.0,1,1.0,1,0.14544312782283994,83
3800,2,6078,2997,3081,0,0,0,1.0,1,1.0,1,1.0,1,0.16866475077180573,83
3801,3,6081,2998,3083,0,0,0,1.0,1,1.0,1,1.0,1,0.15349414060001143,83
3802,0,6081,2998,3083,0,0,0,1.0,1,1.0,1,1.0,1,0.1661712098702031,82
3803,1,6082,2998,3084,0,0,0,1.0,1,1.0,1,1.0,1,0.1626749326887898,84
3804,1,6083,2998,3085,0,0,0,1.0,1,1.0,1,1.0,1,0.1510693645914935,84
3805,5,6088,2999,3089,0,0,0,1.0,1,1.0,1,1.0,1,0.16045311007823765,86
3806,0,6088,2999,3089,0,0,0,1.0,1,1.0,1,1.0,1,0.16045311007823765,86
3807,4,6092,3000,3092,0,0,0,1.0,1,1.0,1,1.0,1,0.1570967579370765,86
3808,0,6092,3000,3092,0,0,0,1.0,1,1.0,1,1.0,1,0.15846348754463996,85
3809,2,6094,3001,3093,0,0,0,1.0,1,1.0,1,1.0,1,0.16430900390760037,85
3810,2,6096,3002,3094,0,0,0,1.0,1,1.0,1,1.0,1,0.16679378172200518,85
3811,2,6098,3003,3095,0,0,0,1.0,1,1.0,1,1.0,1,0.1593584357555127,84
3812,0,6098,3003,3095,0,0,0,1.0,1,1.0,1,1.0,1,0.1571588865819246,83
3813,0,6098,3003,3095,0,0,0,1.0,1,1.0,1,1.0,1,0.1441019304613999,82
3814,2,6100,3005,3095,0,0,0,1.0,1,1.0,1,1.0,1,0.1742537349601966,81
3815,0,6100,3005,3095,0,0,0,1.0,1,1.0,1,1.0,1,0.17625149980776078,82
3816,2,6102,3006,3096,0,0,0,1.0,1,1.0,1,1.0,1,0.16815575168221686,81
3817,0,6102,3006,3096,0,0,0,1.0,1,1.0,1,1.0,1,0.16815575168221686,81
3818,3,6105,3008,3097,0,0,0,1.0,1,1.0,1,1.0,1,0.19939456857786675,81
3819,3,6108,3009,3099,0,0,0,1.0,1,1.0,1,1.0,1,0.20273014215088161,82
3820,3,6111,3009,3102,0,0,0,1.0,1,1.0,1,1.0,1,0.18296544710556542,84
3821,1,6112,3010,3102,0,0,0,1.0,1,1.0,1,1.0,1,0.21044823434468324,84
3822,1,6113,3010,3103,0,0,0,1.0,1,1.0,1,1.0,1,0.18743512688614766,82
3823,3,6116,3013,3103,0,0,0,1.0,1,1.0,1,1.0,1,0.18876934417822874,81
3824,0,6116,3013,3103,0,0,0,1.0,1,1.0,1,1.0,1,0.21008681337056542,78
3825,4,6120,3013,3107,0,0,0,1.0,1,1.0,1,1.0,1,0.19024949545216263,76
3826,1,6121,3014,3107,0,0,0,1.0,1,1.0,1,1.0,1,0.2145171834953683,76
3827,4,6125,3014,3111,0,0,0,1.0,1,1.0,1,1.0,1,0.16995656235550183,75
3828,2,6127,3015,3112,0,0,0,1.0,1,1.0,1,1.0,1,0.18008282034367348,74
3829,2,6129,3016,3113,0,0,0,1.0,1,1.0,1,1.0,1,0.20191216481204685,74
3830,0,6129,3016,3113,0,0,0,1.0,1,1.0,1,1.0,1,0.20191216481204685,74
3831,4,6133,3018,3115,0,0,0,1.0,1,1.0,1,1.0,1,0.20435966390417337,74
3832,2,6135,3018,3117,0,0,0,1.0,1,1.0,1,1.0,1,0.1938304923876592,73
3833,4,6139,3021,3118,0,0,0,1.0,1,1.0,1,1.0,1,0.19165570688485925,73
3834,0,6139,3021,3118,0,0,0,1.0,1,1.0,1,1.0,1,0.18582934832038692,74
3835,1,6140,3022,3118,0,0,0,1.0,1,1.0,1,1.0,1,0.2035049946569303,75
3836,1,6141,3022,3119,0,0,0,1.0,1,1.0,1,1.0,1,0.19372603255252202,75
3837,2,6143,3023,3120,0,0,0,1.0,1,1.0,1,1.0,1,0.22100886654691096,78
3838,2,6145,3025,3120,0,0,0,1.0,1,1.0,1,1.0,1,0.2183744266768626,78
3839,2,6147,3025,3122,0,0,0,1.0,1,1.0,1,1.0,1,0.20589167093900423,79
3840,4,6151,3026,3125,0,0,0,1.0,1,1.0,1,1.0,1,0.20006757170771186,82
3841,1,6152,3026,3126,0,0,0,1.0,1,1.0,1,1.0,1,0.19181029541785785,82
3842,0,6152,3026,3126,0,0,0,1.0,1,1.0,1,1.0,1,0.18960463947916423,82
3843,1,6153,3026,3127,0,0,0,1.0,1,1.0,1,1.0,1,0.18036386191499346,82
3844,0,6153,3026,3127,0,0,0,1.0,1,1.0,1,1.0,1,0.18585022894180708,83
3845,3,6156,3026,3130,0,0,0,1.0,1,1.0,1,1.0,1,0.17870435775838275,84
3846,1,6157,3026,3131,0,0,0,1.0,1,1.0,1,1.0,1,0.17567007586788505,85
3847,1,6158,3026,3132,0,0,0,1.0,1,1.0,1,1.0,1,0.18131706911927645,84
3848,3,6161,3029,3132,0,0,0,1.0,1,1.0,1,1.0,1,0.2108542474170076,84
3849,1,6162,3029,3133,0,0,0,1.0,1,1.0,1,1.0,1,0.18779046672158364,83
3850,0,6162,3029,3133,0,0,0,1.0,1,1.0,1,1.0,1,0.20676673217531968,80
3851,1,6163,3029,3134,0,0,0,1.0,1,1.0,1,1.0,1,0.19657864410831194,80
3852,0,6163,3029,3134,0,0,0,1.0,1,1.0,1,1.0,1,0.2144859530749512,79
3853,1,6164,3030,3134,0,0,0,1.0,1,1.0,1,1.0,1,0.22417478966959867,79
3854,3,6167,3032,3135,0,0,0,1.0,1,1.0,1,1.0,1,0.24387549520976134,78
3855,2,6169,3033,3136,0,0,0,1.0,1,1.0,1,1.0,1,0.2543613187340038,78
3856,2,6171,3034,3137,0,0,0,1.0,1,1.0,1,1.0,1,0.26983081094685946,80
3857,6,6177,3035,3142,0,0,0,1.0,1,1.0,1,1.0,1,0.23747788431903522,81
3858,1,6178,3036,3142,0,0,0,1.0,1,1.0,1,1.0,1,0.24324819031894837,81
3859,2,6180,3036,3144,0,0,0,1.0,1,1.0,1,1.0,1,0.23870996406952452,83
3860,2,6182,3038,3144,0,0,0,1.0,1,1.0,1,1.0,1,0.26806691313512426,82
3861,6,6188,3039,3149,0,0,0,1.0,1,1.0,1,1.0,1,0.254429209106339,84
3862,3,6191,3042,3149,0,0,0,1.0,1,1.0,1,1.0,1,0.2782249503142259,85
3863,4,6195,3042,3153,0,0,0,1.0,1,1.0,1,1.0,1,0.2481008631259334,84
3864,1,6196,3043,3153,0,0,0,1.0,1,1.0,1,1.0,1,0.2444411892205233,83
3865,2,6198,3044,3154,0,0,0,1.0,1,1.0,1,1.0,1,0.2395166626343954,82
3866,0,6198,3044,3154,0,0,0,1.0,1,1.0,1,1.0,1,0.2358029480760167,81
3867,2,6200,3046,3154,0,0,0,1.0,1,1.0,1,1.0,1,0.23522596778620794,81
3868,1,6201,3047,3154,0,0,0,1.0,1,1.0,1,1.0,1,0.23901621900873105,81
3869,1,6202,3048,3154,0,0,0,1.0,1,1.0,1,1.0,1,0.24540557389550696,81
3870,1,6203,3049,3154,0,0,0,1.0,1,1.0,1,1.0,1,0.22011175544530223,80
3871,5,6208,3051,3157,0,0,0,1.0,1,1.0,1,1.0,1,0.19859128971427242,82
3872,0,6208,3051,3157,0,0,0,1.0,1,1.0,1,1.0,1,0.1920547397049276,81
3873,0,6208,3051,3157,0,0,0,1.0,1,1.0,1,1.0,1,0.1920547397049276,81
3874,2,6210,3052,3158,0,0,0,1.0,1,1.0,1,1.0,1,0.19108065777618402,78
3875,3,6213,3052,3161,0,0,0,1.0,1,1.0,1,1.0,1,0.15811335927742506,77
3876,3,6216,3054,3162,0,0,0,1.0,1,1.0,1,1.0,1,0.14509033323408224,78
3877,0,6216,3054,3162,0,0,0,1.0,1,1.0,1,1.0,1,0.15403808531390795,75
3878,2,6218,3056,3162,0,0,0,1.0,1,1.0,1,1.0,1,0.15497510394890043,75
3879,0,6218,3056,3162,0,0,0,1.0,1,1.0,1,1.0,1,0.17040749427597862,73
3880,0,6218,3056,3162,0,0,0,1.0,1,1.0,1,1.0,1,0.17133691680104418,74
3881,1,6219,3057,3162,0,0,0,1.0,1,1.0,1,1.0,1,0.19170637263880633,75
3882,0,6219,3057,3162,0,0,0,1.0,1,1.0,1,1.0,1,0.20226074997533142,76
3883,3,6222,3057,3165,0,0,0,1.0,1,1.0,1,1.0,1,0.17189781400190873,77
3884,4,6226,3058,3168,0,0,0,1.0,1,1.0,1,1.0,1,0.1479410871737202,78
3885,3,6229,3058,3171,0,0,0,1.0,1,1.0,1,1.0,1,0.12844048529415128,78
3886,2,6231,3059,3172,0,0,0,1.0,1,1.0,1,1.0,1,0.13581203775529635,79
3887,1,6232,3060,3172,0,0,0,1.0,1,1.0,1,1.0,1,0.14670686436616343,78
3888,3,6235,3062,3173,0,0,0,1.0,1,1.0,1,1.0,1,0.15562965279112884,80
3889,1,6236,3062,3174,0,0,0,1.0,1,1.0,1,1.0,1,0.15196896246242056,82
3890,4,6240,3064,3176,0,0,0,1.0,1,1.0,1,1.0,1,0.135486268720292,82
3891,4,6244,3067,3177,0,0,0,1.0,1,1.0,1,1.0,1,0.15089573937941142,85
3892,3,6247,3068,3179,0,0,0,1.0,1,1.0,1,1.0,1,0.15365967158456534,87
3893,1,6248,3068,3180,0,0,0,1.0,1,1.0,1,1.0,1,0.13619487109614137,86
3894,1,6249,3068,3181,0,0,0,1.0,1,1.0,1,1.0,1,0.13858889181889317,87
3895,1,6250,3069,3181,0,0,0,1.0,1,1.0,1,1.0,1,0.15121012997713718,87
3896,1,6251,3070,3181,0,0,0,1.0,1,1.0,1,1.0,1,0.16485951608936947,85
3897,2,6253,3071,3182,0,0,0,1.0,1,1.0,1,1.0,1,0.15640354865709324,85
3898,4,6257,3074,3183,0,0,0,1.0,1,1.0,1,1.0,1,0.18166224323332975,86
3899,4,6261,3076,3185,0,0,0,1.0,1,1.0,1,1.0,1,0.17377608777888778,86
3900,0,6261,3076,3185,0,0,0,1.0,1,1.0,1,1.0,1,0.17377608777888778,86
3901,4,6265,3078,3187,0,0,0,1.0,1,1.0,1,1.0,1,0.17161342418387007,86
3902,0,6265,3078,3187,0,0,0,1.0,1,1.0,1,1.0,1,0.1697284659829261,87
3903,1,6266,3078,3188,0,0,0,1.0,1,1.0,1,1.0,1,0.1629346451149483,87
3904,1,6267,3079,3188,0,0,0,1.0,1,1.0,1,1.0,1,0.17036043479581936,85
3905,1,6268,3079,3189,0,0,0,1.0,1,1.0,1,1.0,1,0.1588898900662284,84
3906,3,6271,3080,3191,0,0,0,1.0,1,1.0,1,1.0,1,0.14027355302276412,86
3907,0,6271,3080,3191,0,0,0,1.0,1,1.0,1,1.0,1,0.14757633979075732,84
3908,1,6272,3081,3191,0,0,0,1.0,1,1.0,1,1.0,1,0.15044518276425894,83
3909,1,6273,3082,3191,0,0,0,1.0,1,1.0,1,1.0,1,0.16322126433177692,81
3910,4,6277,3085,3192,0,0,0,1.0,1,1.0,1,1.0,1,0.16743359490033233,82
3911,4,6281,3086,3195,0,0,0,1.0,1,1.0,1,1.0,1,0.15202898274591964,81
3912,1,6282,3086,3196,0,0,0,1.0,1,1.0,1,1.0,1,0.13567953340582506,80
3913,4,6286,3089,3197,0,0,0,1.0,1,1.0,1,1.0,1,0.13296481836040536,80
3914,2,6288,3090,3198,0,0,0,1.0,1,1.0,1,1.0,1,0.1387417913818908,81
3915,2,6290,3092,3198,0,0,0,1.0,1,1.0,1,1.0,1,0.15989791430001266,81
3916,5,6295,3093,3202,0,0,0,1.0,1,1.0,1,1.0,1,0.1570065548257333,81
3917,6,6301,3095,3206,0,0,0,1.0,1,1.0,1,1.0,1,0.14666413688046998,82
3918,5,6306,3097,3209,0,0,0,1.0,1,1.0,1,1.0,1,0.16569851314696674,85
3919,2,6308,3098,3210,0,0,0,1.0,1,1.0,1,1.0,1,0.16941014213716182,85
3920,3,6311,3099,3212,0,0,0,1.0,1,1.0,1,1.0,1,0.15489676333999594,85
3921,2,6313,3099,3214,0,0,0,1.0,1,1.0,1,1.0,1,0.14527579361864962,88
3922,0,6313,3099,3214,0,0,0,1.0,1,1.0,1,1.0,1,0.14527579361864962,88
3923,3,6316,3100,3216,0,0,0,1.0,1,1.0,1,1.0,1,0.1523188375024627,89
3924,1,6317,3100,3217,0,0,0,1.0,1,1.0,1,1.0,1,0.14036852499488903,90
3925,2,6319,3101,3218,0,0,0,1.0,1,1.0,1,1.0,1,0.13035355813080696,88
3926,0,6319,3101,3218,0,0,0,1.0,1,1.0,1,1.0,1,0.1330823354414839,89
3927,3,6322,3101,3221,0,0,0,1.0,1,1.0,1,1.0,1,0.12517661254682863,89
3928,0,6322,3101,3221,0,0,0,1.0,1,1.0,1,1.0,1,0.12758196150465212,88
3929,1,6323,3102,3221,0,0,0,1.0,1,1.0,1,1.0,1,0.13674407011979062,88
3930,0,6323,3102,3221,0,0,0,1.0,1,1.0,1,1.0,1,0.14583493878437495,87
3931,1,6324,3102,3222,0,0,0,1.0,1,1.0,1,1.0,1,0.14120805077878162,86
3932,1,6325,3103,3222,0,0,0,1.0,1,1.0,1,1.0,1,0.15324633501255017,85
3933,1,6326,3104,3222,0,0,0,1.0,1,1.0,1,1.0,1,0.16162337881875127,84
3934,1,6327,3105,3222,0,0,0,1.0,1,1.0,1,1.0,1,0.17678696210213463,85
3935,2,6329,3107,3222,0,0,0,1.0,1,1.0,1,1.0,1,0.20496933173237483,84
3936,2,6331,3107,3224,0,0,0,1.0,1,1.0,1,1.0,1,0.18251922453154076,84
3937,2,6333,3107,3226,0,0,0,1.0,1,1.0,1,1.0,1,0.15549715904602873,82
3938,0,6333,3107,3226,0,0,0,1.0,1,1.0,1,1.0,1,0.15549715904602873,82
3939,1,6334,3107,3227,0,0,0,1.0,1,1.0,1,1.0,1,0.1516058632546126,84
3940,3,6337,3108,3229,0,0,0,1.0,1,1.0,1,1.0,1,0.13541338172386597,84
3941,2,6339,3108,3231,0,0,0,1.0,1,1.0,1,1.0,1,0.11266764532541391,85
3942,3,6342,3109,3233,0,0,0,1.0,1,1.0,1,1.0,1,0.10114811978570332,85
3943,0,6342,3109,3233,0,0,0,1.0,1,1.0,1,1.0,1,0.09911036530186693,84
3944,5,6347,3113,3234,0,0,0,1.0,1,1.0,1,1.0,1,0.15724836586780203,83
3945,2,6349,3114,3235,0,0,0,1.0,1,1.0,1,1.0,1,0.1374628500000869,83
3946,2,6351,3116,3235,0,0,0,1.0,1,1.0,1,1.0,1,0.16541248510210355,83
3947,2,6353,3116,3237,0,0,0,1.0,1,1.0,1,1.0,1,0.149337555224481,83
3948,2,6355,3117,3238,0,0,0,1.0,1,1.0,1,1.0,1,0.16890807394351667,84
3949,2,6357,3117,3240,0,0,0,1.0,1,1.0,1,1.0,1,0.17915099813749044,84
3950,2,6359,3118,3241,0,0,0,1.0,1,1.0,1,1.0,1,0.18105151747751755,86
3951,1,6360,3118,3242,0,0,0,1.0,1,1.0,1,1.0,1,0.17466747478806305,87
3952,1,6361,3119,3242,0,0,0,1.0,1,1.0,1,1.0,1,0.17400781595217338,86
3953,3,6364,3121,3243,0,0,0,1.0,1,1.0,1,1.0,1,0.1880446864165889,86
3954,3,6367,3121,3246,0,0,0,1.0,1,1.0,1,1.0,1,0.1632944705276503,85
3955,2,6369,3121,3248,0,0,0,1.0,1,1.0,1,1.0,1,0.16917252247366585,85
3956,0,6369,3121,3248,0,0,0,1.0,1,1.0,1,1.0,1,0.17939724141416327,84
3957,0,6369,3121,3248,0,0,0,1.0,1,1.0,1,1.0,1,0.18202691776223182,85
3958,1,6370,3122,3248,0,0,0,1.0,1,1.0,1,1.0,1,0.18302666210837623,84
3959,1,6371,3122,3249,0,0,0,1.0,1,1.0,1,1.0,1,0.18374372427824984,83
3960,1,6372,3122,3250,0,0,0,1.0,1,1.0,1,1.0,1,0.1771363752100772,84
3961,0,6372,3122,3250,0,0,0,1.0,1,1.0,1,1.0,1,0.18508960374911612,83
3962,3,6375,3123,3252,0,0,0,1.0,1,1.0,1,1.0,1,0.16801868936039188,84
3963,0,6375,3123,3252,0,0,0,1.0,1,1.0,1,1.0,1,0.18276353626988642,81
3964,2,6377,3124,3253,0,0,0,1.0,1,1.0,1,1.0,1,0.17467067205872253,81
3965,1,6378,3124,3254,0,0,0,1.0,1,1.0,1,1.0,1,0.1631764521347591,81
3966,3,6381,3127,3254,0,0,0,1.0,1,1.0,1,1.0,1,0.20634434287743048,79
3967,6,6387,3129,3258,0,0,0,1.0,1,1.0,1,1.0,1,0.20663121018057834,81
3968,3,6390,3131,3259,0,0,0,1.0,1,1.0,1,1.0,1,0.18426233495383543,79
3969,4,6394,3134,3260,0,0,0,1.0,1,1.0,1,1.0,1,0.2015025191536208,79
3970,2,6396,3136,3260,0,0,0,1.0,1,1.0,1,1.0,1,0.2059896343898802,78
3971,1,6397,3136,3261,0,0,0,1.0,1,1.0,1,1.0,1,0.19390532883973302,77
3972,1,6398,3137,3261,0,0,0,1.0,1,1.0,1,1.0,1,0.19448805720057144,78
3973,0,6398,3137,3261,0,0,0,1.0,1,1.0,1,1.0,1,0.19011779853241687,77
3974,0,6398,3137,3261,0,0,0,1.0,1,1.0,1,1.0,1,0.19011779853241687,77
3975,1,6399,3138,3261,0,0,0,1.0,1,1.0,1,1.0,1,0.2185123720038445,76
3976,0,6399,3138,3261,0,0,0,1.0,1,1.0,1,1.0,1,0.23062163580592637,77
3977,1,6400,3138,3262,0,0,0,1.0,1,1.0,1,1.0,1,0.23069093524240838,78
3978,2,6402,3138,3264,0,0,0,1.0,1,1.0,1,1.0,1,0.21195170860740242,79
3979,3,6405,3138,3267,0,0,0,1.0,1,1.0,1,1.0,1,0.1939578499723716,79
3980,0,6405,3138,3267,0,0,0,1.0,1,1.0,1,1.0,1,0.1939578499723716,79
3981,5,6410,3140,3270,0,0,0,1.0,1,1.0,1,1.0,1,0.21555141678239306,83
3982,2,6412,3141,3271,0,0,0,1.0,1,1.0,1,1.0,1,0.21445501284428392,83
3983,3,6415,3142,3273,0,0,0,1.0,1,1.0,1,1.0,1,0.19219855461450908,82
3984,2,6417,3143,3274,0,0,0,1.0,1,1.0,1,1.0,1,0.2038981610316771,83
3985,6,6423,3145,3278,0,0,0,1.0,1,1.0,1,1.0,1,0.18794756248216554,84
3986,5,6428,3148,3280,0,0,0,1.0,1,1.0,1,1.0,1,0.2130737727766313,83
3987,3,6431,3150,3281,0,0,0,1.0,1,1.0,1,1.0,1,0.19887381681464433,82
3988,1,6432,3150,3282,0,0,0,1.0,1,1.0,1,1.0,1,0.19965007542049013,83
3989,1,6433,3150,3283,0,0,0,1.0,1,1.0,1,1.0,1,0.2036363421627214,81
3990,3,6436,3150,3286,0,0,0,1.0,1,1.0,1,1.0,1,0.17514994634835337,81
3991,1,6437,3150,3287,0,0,0,1.0,1,1.0,1,1.0,1,0.1851931043516524,79
3992,1,6438,3151,3287,0,0,0,1.0,1,1.0,1,1.0,1,0.17295328891654155,81
3993,1,6439,3151,3288,0,0,0,1.0,1,1.0,1,1.0,1,0.17371062343122645,80
3994,0,6439,3151,3288,0,0,0,1.0,1,1.0,1,1.0,1,0.17371062343122645,80
3995,2,6441,3153,3288,0,0,0,1.0,1,1.0,1,1.0,1,0.18599518516851346,81
3996,1,6442,3153,3289,0,0,0,1.0,1,1.0,1,1.0,1,0.20840657715643698,80
3997,4,6446,3153,3293,0,0,0,1.0,1,1.0,1,1.0,1,0.1695186489382924,81
3998,2,6448,3154,3294,0,0,0,1.0,1,1.0,1,1.0,1,0.16461264678896087,82
3999,4,6452,3155,3297,0,0,0,1.0,1,1.0,1,1.0,1,0.13829225178702814,82
4000,4,6456,3158,3298,0,0,0,1.0,1,1.0,1,1.0,1,0.16229653648592143,82
4001,3,6459,3159,3300,0,0,0,1.0,1,1.0,1,1.0,1,0.16113477878550345,81
4002,1,6460,3160,3300,0,0,0,1.0,1,1.0,1,1.0,1,0.1735583344555813,81
4003,2,6462,3161,3301,0,0,0,1.0,1,1.0,1,1.0,1,0.17881482245597288,81
4004,4,6466,3163,3303,0,0,0,1.0,1,1.0,1,1.0,1,0.1665619772172569,80
4005,1,6467,3164,3303,0,0,0,1.0,1,1.0,1,1.0,1,0.18286229053949551,78
4006,1,6468,3165,3303,0,0,0,1.0,1,1.0,1,1.0,1,0.17150580786836145,76
4007,3,6471,3166,3305,0,0,0,1.0,1,1.0,1,1.0,1,0.16876354662355053,75
4008,3,6474,3168,3306,0,0,0,1.0,1,1.0,1,1.0,1,0.16824466885238842,74
4009,4,6478,3170,3308,0,0,0,1.0,1,1.0,1,1.0,1,0.19839685340240584,75
4010,1,6479,3170,3309,0,0,0,1.0,1,1.0,1,1.0,1,0.2157679529413985,75
4011,2,6481,3172,3309,0,0,0,1.0,1,1.0,1,1.0,1,0.20372269372604318,74
4012,1,6482,3173,3309,0,0,0,1.0,1,1.0,1,1.0,1,0.2135753796364994,74
4013,2,6484,3174,3310,0,0,0,1.0,1,1.0,1,1.0,1,0.2046061711943605,74
4014,1,6485,3175,3310,0,0,0,1.0,1,1.0,1,1.0,1,0.22490899206022533,73
4015,1,6486,3175,3311,0,0,0,1.0,1,1.0,1,1.0,1,0.2268869035231773,74
4016,2,6488,3176,3312,0,0,0,1.0,1,1.0,1,1.0,1,0.2332041302387026,74
4017,3,6491,3176,3315,0,0,0,1.0,1,1.0,1,1.0,1,0.20651972841400906,78
4018,1,6492,3177,3315,0,0,0,1.0,1,1.0,1,1.0,1,0.22119784499432002,78
4019,1,6493,3178,3315,0,0,0,1.0,1,1.0,1,1.0,1,0.22820640146169224,78
4020,0,6493,3178,3315,0,0,0,1.0,1,1.0,1,1.0,1,0.22820640146169224,78
4021,0,6493,3178,3315,0,0,0,1.0,1,1.0,1,1.0,1,0.22820640146169224,78
4022,1,6494,3179,3315,0,0,0,1.0,1,1.0,1,1.0,1,0.2279271914792784,79
4023,0,6494,3179,3315,0,0,0,1.0,1,1.0,1,1.0,1,0.2215002429297602,78
4024,1,6495,3180,3315,0,0,0,1.0,1,1.0,1,1.0,1,0.22276293668061292,77
4025,1,6496,3181,3315,0,0,0,1.0,1,1.0,1,1.0,1,0.24129837097127732,76
4026,2,6498,3183,3315,0,0,0,1.0,1,1.0,1,1.0,1,0.2440371855070418,76
4027,5,6503,3185,3318,0,0,0,1.0,1,1.0,1,1.0,1,0.22861430841441993,75
4028,4,6507,3186,3321,0,0,0,1.0,1,1.0,1,1.0,1,0.20926837633685763,76
4029,5,6512,3188,3324,0,0,0,1.0,1,1.0,1,1.0,1,0.2089317906108016,75
4030,2,6514,3189,3325,0,0,0,1.0,1,1.0,1,1.0,1,0.20495457692129296,74
4031,4,6518,3191,3327,0,0,0,1.0,1,1.0,1,1.0,1,0.20464495896625368,73
4032,0,6518,3191,3327,0,0,0,1.0,1,1.0,1,1.0,1,0.19183797241911105,71
4033,1,6519,3191,3328,0,0,0,1.0,1,1.0,1,1.0,1,0.17732334513129408,73
4034,3,6522,3193,3329,0,0,0,1.0,1,1.0,1,1.0,1,0.16450998222191793,72
4035,1,6523,3193,3330,0,0,0,1.0,1,1.0,1,1.0,1,0.16861854893234696,71
4036,2,6525,3194,3331,0,0,0,1.0,1,1.0,1,1.0,1,0.15922809125497422,71
4037,1,6526,3195,3331,0,0,0,1.0,1,1.0,1,1.0,1,0.18280642581446058,70
4038,0,6526,3195,3331,0,0,0,1.0,1,1.0,1,1.0,1,0.20142844135232002,69
4039,2,6528,3196,3332,0,0,0,1.0,1,1.0,1,1.0,1,0.24434147331854517,68
4040,3,6531,3198,3333,0,0,0,1.0,1,1.0,1,1.0,1,0.2551529806192738,69
4041,2,6533,3198,3335,0,0,0,1.0,1,1.0,1,1.0,1,0.24385181411718232,67
4042,2,6535,3199,3336,0,0,0,1.0,1,1.0,1,1.0,1,0.2846444267271036,67
4043,2,6537,3200,3337,0,0,0,1.0,1,1.0,1,1.0,1,0.3157040756619829,66
4044,3,6540,3202,3338,0,0,0,1.0,1,1.0,1,1.0,1,0.31754902822302444,65
4045,0,6540,3202,3338,0,0,0,1.0,1,1.0,1,1.0,1,0.32417261015053694,66
4046,0,6540,3202,3338,0,0,0,1.0,1,1.0,1,1.0,1,0.339021628388242,68
4047,1,6541,3203,3338,0,0,0,1.0,1,1.0,1,1.0,1,0.3465098703489483,68
4048,3,6544,3203,3341,0,0,0,1.0,1,1.0,1,1.0,1,0.3270099522092852,69
4049,0,6544,3203,3341,0,0,0,1.0,1,1.0,1,1.0,1,0.3270099522092852,69
4050,0,6544,3203,3341,0,0,0,1.0,1,1.0,1,1.0,1,0.32099479482724047,69
4051,0,6544,3203,3341,0,0,0,1.0,1,1.0,1,1.0,1,0.32099479482724047,69
4052,2,6546,3204,3342,0,0,0,1.0,1,1.0,1,1.0,1,0.3027131753137538,69
4053,1,6547,3204,3343,0,0,0,1.0,1,1.0,1,1.0,1,0.29201098859585833,69
4054,0,6547,3204,3343,0,0,0,1.0,1,1.0,1,1.0,1,0.2888150574027817,70
4055,1,6548,3204,3344,0,0,0,1.0,1,1.0,1,1.0,1,0.26882471086639165,70
4056,0,6548,3204,3344,0,0,0,1.0,1,1.0,1,1.0,1,0.26882471086639165,70
4057,1,6549,3204,3345,0,0,0,1.0,1,1.0,1,1.0,1,0.265338420731813,71
4058,0,6549,3204,3345,0,0,0,1.0,1,1.0,1,1.0,1,0.265338420731813,71
4059,2,6551,3205,3346,0,0,0,1.0,1,1.0,1,1.0,1,0.25832454381464015,72
4060,2,6553,3206,3347,0,0,0,1.0,1,1.0,1,1.0,1,0.27058078418313825,71
4061,1,6554,3207,3347,0,0,0,1.0,1,1.0,1,1.0,1,0.2927410056181996,72
4062,6,6560,3209,3351,0,0,0,1.0,1,1.0,1,1.0,1,0.2519614518139424,72
4063,5,6565,3211,3354,0,0,0,1.0,1,1.0,1,1.0,1,0.21782989386919302,72
4064,2,6567,3213,3354,0,0,0,1.0,1,1.0,1,1.0,1,0.22042869642253854,71
4065,3,6570,3215,3355,0,0,0,1.0,1,1.0,1,1.0,1,0.20192885894382184,70
4066,3,6573,3217,3356,0,0,0,1.0,1,1.0,1,1.0,1,0.20711520923298812,70
4067,4,6577,3218,3359,0,0,0,1.0,1,1.0,1,1.0,1,0.1779453623188301,68
4068,2,6579,3218,3361,0,0,0,1.0,1,1.0,1,1.0,1,0.17982906362127193,70
4069,2,6581,3220,3361,0,0,0,1.0,1,1.0,1,1.0,1,0.1984376026735786,68
4070,1,6582,3221,3361,0,0,0,1.0,1,1.0,1,1.0,1,0.19690693701123702,67
4071,2,6584,3222,3362,0,0,0,1.0,1,1.0,1,1.0,1,0.19039121592592673,68
4072,4,6588,3224,3364,0,0,0,1.0,1,1.0,1,1.0,1,0.17949555864378786,70
4073,4,6592,3226,3366,0,0,0,1.0,1,1.0,1,1.0,1,0.14294616448000513,70
4074,8,6600,3231,3369,0,0,0,1.0,1,1.0,1,1.0,1,0.18314904054488026,71
4075,3,6603,3234,3369,0,0,0,1.0,1,1.0,1,1.0,1,0.1926633286550399,72
4076,5,6608,3237,3371,0,0,0,1.0,1,1.0,1,1.0,1,0.19919170961615856,73
4077,2,6610,3237,3373,0,0,0,1.0,1,1.0,1,1.0,1,0.1984118502330288,72
4078,3,6613,3240,3373,0,0,0,1.0,1,1.0,1,1.0,1,0.22806901574291888,71
4079,3,6616,3242,3374,0,0,0,1.0,1,1.0,1,1.0,1,0.24404894629449447,69
4080,1,6617,3243,3374,0,0,0,1.0,1,1.0,1,1.0,1,0.2540994945500068,67
4081,4,6621,3243,3378,0,0,0,1.0,1,1.0,1,1.0,1,0.20346267182031172,66
4082,0,6621,3243,3378,0,0,0,1.0,1,1.0,1,1.0,1,0.22312136056682358,65
4083,2,6623,3244,3379,0,0,0,1.0,1,1.0,1,1.0,1,0.2275624718637711,64
4084,2,6625,3246,3379,0,0,0,1.0,1,1.0,1,1.0,1,0.2568386998144319,64
4085,3,6628,3246,3382,0,0,0,1.0,1,1.0,1,1.0,1,0.21889749055713956,65
4086,1,6629,3247,3382,0,0,0,1.0,1,1.0,1,1.0,1,0.21114336986037852,66
4087,2,6631,3248,3383,0,0,0,1.0,1,1.0,1,1.0,1,0.19857832180572105,66
4088,0,6631,3248,3383,0,0,0,1.0,1,1.0,1,1.0,1,0.2145295480666796,65
4089,0,6631,3248,3383,0,0,0,1.0,1,1.0,1,1.0,1,0.2145295480666796,65
4090,0,6631,3248,3383,0,0,0,1.0,1,1.0,1,1.0,1,0.22445362421733814,65
4091,1,6632,3248,3384,0,0,0,1.0,1,1.0,1,1.0,1,0.21773323804905156,65
4092,1,6633,3248,3385,0,0,0,1.0,1,1.0,1,1.0,1,0.21425100176101175,64
4093,2,6635,3248,3387,0,0,0,1.0,1,1.0,1,1.0,1,0.1919889270267364,66
4094,0,6635,3248,3387,0,0,0,1.0,1,1.0,1,1.0,1,0.21028359984515355,65
4095,0,6635,3248,3387,0,0,0,1.0,1,1.0,1,1.0,1,0.21028359984515355,65
4096,2,6637,3250,3387,0,0,0,1.0,1,1.0,1,1.0,1,0.21648293682178305,67
4097,9,6646,3254,3392,0,0,0,1.0,1,1.0,1,1.0,1,0.16566180635631333,67
4098,3,6649,3256,3393,0,0,0,1.0,1,1.0,1,1.0,1,0.18725275506800548,68
4099,5,6654,3257,3397,0,0,0,1.0,1,1.0,1,1.0,1,0.16269857182810235,69
4100,1,6655,3257,3398,0,0,0,1.0,1,1.0,1,1.0,1,0.1520290057680356,70
4101,3,6658,3258,3400,0,0,0,1.0,1,1.0,1,1.0,1,0.15353108313743907,71
4102,2,6660,3260,3400,0,0,0,1.0,1,1.0,1,1.0,1,0.1540095081978757,71
4103,0,6660,3260,3400,0,0,0,1.0,1,1.0,1,1.0,1,0.15376362650098171,71
4104,4,6664,3263,3401,0,0,0,1.0,1,1.0,1,1.0,1,0.19558317231275443,69
4105,0,6664,3263,3401,0,0,0,1.0,1,1.0,1,1.0,1,0.20008896998352374,67
4106,2,6666,3264,3402,0,0,0,1.0,1,1.0,1,1.0,1,0.20033732676896276,68
4107,4,6670,3264,3406,0,0,0,1.0,1,1.0,1,1.0,1,0.16738421938413478,70
4108,0,6670,3264,3406,0,0,0,1.0,1,1.0,1,1.0,1,0.16525434707776993,70
4109,0,6670,3264,3406,0,0,0,1.0,1,1.0,1,1.0,1,0.173225068638879,69
4110,0,6670,3264,3406,0,0,0,1.0,1,1.0,1,1.0,1,0.15246104316901815,71
4111,1,6671,3264,3407,0,0,0,1.0,1,1.0,1,1.0,1,0.13687638167565253,70
4112,0,6671,3264,3407,0,0,0,1.0,1,1.0,1,1.0,1,0.13798603418523786,72
4113,0,6671,3264,3407,0,0,0,1.0,1,1.0,1,1.0,1,0.13798603418523786,72
4114,3,6674,3266,3408,0,0,0,1.0,1,1.0,1,1.0,1,0.1706397704200298,72
4115,1,6675,3267,3408,0,0,0,1.0,1,1.0,1,1.0,1,0.1674972207610458,70
4116,1,6676,3268,3408,0,0,0,1.0,1,1.0,1,1.0,1,0.1858868202084808,67
4117,2,6678,3269,3409,0,0,0,1.0,1,1.0,1,1.0,1,0.20031409458077362,67
4118,1,6679,3269,3410,0,0,0,1.0,1,1.0,1,1.0,1,0.20673597232581867,66
4119,3,6682,3271,3411,0,0,0,1.0,1,1.0,1,1.0,1,0.24813224023052077,67
4120,1,6683,3271,3412,0,0,0,1.0,1,1.0,1,1.0,1,0.2818442818533385,64
4121,5,6688,3272,3416,0,0,0,1.0,1,1.0,1,1.0,1,0.2576526536108716,63
4122,3,6691,3274,3417,0,0,0,1.0,1,1.0,1,1.0,1,0.25061480929488367,63
4123,2,6693,3276,3417,0,0,0,1.0,1,1.0,1,1.0,1,0.23032641164953874,61
4124,3,6696,3279,3417,0,0,0,1.0,1,1.0,1,1.0,1,0.2642573971858966,62
4125,2,6698,3279,3419,0,0,0,1.0,1,1.0,1,1.0,1,0.2265064657509402,60
4126,2,6700,3281,3419,0,0,0,1.0,1,1.0,1,1.0,1,0.23791687185262103,59
4127,2,6702,3282,3420,0,0,0,1.0,1,1.0,1,1.0,1,0.25103257459232653,60
4128,2,6704,3283,3421,0,0,0,1.0,1,1.0,1,1.0,1,0.24546360915927015,60
4129,2,6706,3283,3423,0,0,0,1.0,1,1.0,1,1.0,1,0.23453574558380602,60
4130,2,6708,3284,3424,0,0,0,1.0,1,1.0,1,1.0,1,0.2200458541703295,61
4131,1,6709,3284,3425,0,0,0,1.0,1,1.0,1,1.0,1,0.20499842658322634,60
4132,1,6710,3285,3425,0,0,0,1.0,1,1.0,1,1.0,1,0.2172543299658793,60
4133,3,6713,3286,3427,0,0,0,1.0,1,1.0,1,1.0,1,0.21196318749306206,62
4134,0,6713,3286,3427,0,0,0,1.0,1,1.0,1,1.0,1,0.19602452544124,63
4135,3,6716,3287,3429,0,0,0,1.0,1,1.0,1,1.0,1,0.16926023205910867,65
4136,1,6717,3288,3429,0,0,0,1.0,1,1.0,1,1.0,1,0.1861097065886765,65
4137,1,6718,3289,3429,0,0,0,1.0,1,1.0,1,1.0,1,0.19149340434164808,66
4138,1,6719,3290,3429,0,0,0,1.0,1,1.0,1,1.0,1,0.19627344430494545,67
4139,2,6721,3292,3429,0,0,0,1.0,1,1.0,1,1.0,1,0.23485242933589995,67
4140,0,6721,3292,3429,0,0,0,1.0,1,1.0,1,1.0,1,0.2225813131444762,66
4141,1,6722,3292,3430,0,0,0,1.0,1,1.0,1,1.0,1,0.20720117117095405,67
4142,1,6723,3293,3430,0,0,0,1.0,1,1.0,1,1.0,1,0.21302384952339168,67
4143,2,6725,3294,3431,0,0,0,1.0,1,1.0,1,1.0,1,0.1927710770125595,66
4144,2,6727,3295,3432,0,0,0,1.0,1,1.0,1,1.0,1,0.1994964731901481,64
4145,3,6730,3296,3434,0,0,0,1.0,1,1.0,1,1.0,1,0.18499855211056684,63
4146,2,6732,3298,3434,0,0,0,1.0,1,1.0,1,1.0,1,0.20818202376146933,62
4147,1,6733,3298,3435,0,0,0,1.0,1,1.0,1,1.0,1,0.1923694264037522,60
4148,4,6737,3300,3437,0,0,0,1.0,1,1.0,1,1.0,1,0.1706239457035362,62
4149,2,6739,3302,3437,0,0,0,1.0,1,1.0,1,1.0,1,0.17650098122600896,61
4150,2,6741,3304,3437,0,0,0,1.0,1,1.0,1,1.0,1,0.19164704229581647,60
4151,5,6746,3306,3440,0,0,0,1.0,1,1.0,1,1.0,1,0.17050542373704528,60
4152,2,6748,3307,3441,0,0,0,1.0,1,1.0,1,1.0,1,0.16980440880254882,60
4153,2,6750,3308,3442,0,0,0,1.0,1,1.0,1,1.0,1,0.15252895923625998,58
4154,0,6750,3308,3442,0,0,0,1.0,1,1.0,1,1.0,1,0.17209295938176025,57
4155,4,6754,3310,3444,0,0,0,1.0,1,1.0,1,1.0,1,0.1892618303658114,57
4156,4,6758,3313,3445,0,0,0,1.0,1,1.0,1,1.0,1,0.20299884450304947,58
4157,0,6758,3313,3445,0,0,0,1.0,1,1.0,1,1.0,1,0.20453541853133808,57
4158,1,6759,3314,3445,0,0,0,1.0,1,1.0,1,1.0,1,0.22798202567517636,55
4159,1,6760,3314,3446,0,0,0,1.0,1,1.0,1,1.0,1,0.22642074695791983,57
4160,1,6761,3315,3446,0,0,0,1.0,1,1.0,1,1.0,1,0.2284695630635351,58
4161,2,6763,3315,3448,0,0,0,1.0,1,1.0,1,1.0,1,0.19897766530344171,58
4162,0,6763,3315,3448,0,0,0,1.0,1,1.0,1,1.0,1,0.20283103187117746,57
4163,1,6764,3316,3448,0,0,0,1.0,1,1.0,1,1.0,1,0.2237096795029768,58
4164,3,6767,3319,3448,0,0,0,1.0,1,1.0,1,1.0,1,0.29064047905429996,56
4165,4,6771,3320,3451,0,0,0,1.0,1,1.0,1,1.0,1,0.29256911211855546,58
4166,1,6772,3320,3452,0,0,0,1.0,1,1.0,1,1.0,1,0.2686496089718323,57
4167,2,6774,3320,3454,0,0,0,1.0,1,1.0,1,1.0,1,0.2798295379878744,57
4168,1,6775,3320,3455,0,0,0,1.0,1,1.0,1,1.0,1,0.2667200225176442,58
4169,1,6776,3321,3455,0,0,0,1.0,1,1.0,1,1.0,1,0.26731559953803874,58
4170,2,6778,3322,3456,0,0,0,1.0,1,1.0,1,1.0,1,0.2801999729005997,58
4171,0,6778,3322,3456,0,0,0,1.0,1,1.0,1,1.0,1,0.29950335833669234,57
4172,0,6778,3322,3456,0,0,0,1.0,1,1.0,1,1.0,1,0.29950335833669234,57
4173,2,6780,3322,3458,0,0,0,1.0,1,1.0,1,1.0,1,0.309813748543116,56
4174,0,6780,3322,3458,0,0,0,1.0,1,1.0,1,1.0,1,0.309813748543116,56
4175,3,6783,3322,3461,0,0,0,1.0,1,1.0,1,1.0,1,0.2877327524808342,55
4176,1,6784,3322,3462,0,0,0,1.0,1,1.0,1,1.0,1,0.29550985259828755,57
4177,5,6789,3323,3466,0,0,0,1.0,1,1.0,1,1.0,1,0.281708579028289,58
4178,5,6794,3325,3469,0,0,0,1.0,1,1.0,1,1.0,1,0.24335840824074859,60
4179,5,6799,3326,3473,0,0,0,1.0,1,1.0,1,1.0,1,0.18342974872309434,61
4180,0,6799,3326,3473,0,0,0,1.0,1,1.0,1,1.0,1,0.17958985446633996,62
4181,0,6799,3326,3473,0,0,0,1.0,1,1.0,1,1.0,1,0.18569272837847053,63
4182,1,6800,3327,3473,0,0,0,1.0,1,1.0,1,1.0,1,0.20544079673681392,63
4183,1,6801,3327,3474,0,0,0,1.0,1,1.0,1,1.0,1,0.18843100598628837,63
4184,4,6805,3330,3475,0,0,0,1.0,1,1.0,1,1.0,1,0.198866785475233,63
4185,1,6806,3330,3476,0,0,0,1.0,1,1.0,1,1.0,1,0.18965211819003577,61
4186,6,6812,3333,3479,0,0,0,1.0,1,1.0,1,1.0,1,0.15948154639901713,62
4187,2,6814,3334,3480,0,0,0,1.0,1,1.0,1,1.0,1,0.16172403174809824,60
4188,1,6815,3335,3480,0,0,0,1.0,1,1.0,1,1.0,1,0.16799751414262556,60
4189,1,6816,3335,3481,0,0,0,1.0,1,1.0,1,1.0,1,0.1480749699864003,60
4190,1,6817,3336,3481,0,0,0,1.0,1,1.0,1,1.0,1,0.16266758334628745,61
4191,1,6818,3337,3481,0,0,0,1.0,1,1.0,1,1.0,1,0.1774819734179023,59
4192,1,6819,3338,3481,0,0,0,1.0,1,1.0,1,1.0,1,0.19577673895290182,58
4193,1,6820,3339,3481,0,0,0,1.0,1,1.0,1,1.0,1,0.20593425330244824,57
4194,1,6821,3340,3481,0,0,0,1.0,1,1.0,1,1.0,1,0.23138525867174173,54
4195,1,6822,3340,3482,0,0,0,1.0,1,1.0,1,1.0,1,0.21582045334387823,55
4196,0,6822,3340,3482,0,0,0,1.0,1,1.0,1,1.0,1,0.2318057617754357,56
4197,1,6823,3341,3482,0,0,0,1.0,1,1.0,1,1.0,1,0.2438175574900788,55
4198,2,6825,3342,3483,0,0,0,1.0,1,1.0,1,1.0,1,0.2728143079781763,56
4199,2,6827,3343,3484,0,0,0,1.0,1,1.0,1,1.0,1,0.30136589089037036,55
4200,0,6827,3343,3484,0,0,0,1.0,1,1.0,1,1.0,1,0.30138547702602336,55
4201,0,6827,3343,3484,0,0,0,1.0,1,1.0,1,1.0,1,0.2849844104166815,56
4202,0,6827,3343,3484,0,0,0,1.0,1,1.0,1,1.0,1,0.2849844104166815,56
4203,1,6828,3343,3485,0,0,0,1.0,1,1.0,1,1.0,1,0.28918028623512854,57
4204,1,6829,3343,3486,0,0,0,1.0,1,1.0,1,1.0,1,0.2794296497876293,57
4205,1,6830,3344,3486,0,0,0,1.0,1,1.0,1,1.0,1,0.27143723446746143,58
4206,3,6833,3346,3487,0,0,0,1.0,1,1.0,1,1.0,1,0.2542957746933834,58
4207,6,6839,3348,3491,0,0,0,1.0,1,1.0,1,1.0,1,0.19923841841915993,58
4208,3,6842,3349,3493,0,0,0,1.0,1,1.0,1,1.0,1,0.19546920550826968,60
4209,3,6845,3351,3494,0,0,0,1.0,1,1.0,1,1.0,1,0.1897815093892398,61
4210,1,6846,3352,3494,0,0,0,1.0,1,1.0,1,1.0,1,0.18355018700273512,62
4211,0,6846,3352,3494,0,0,0,1.0,1,1.0,1,1.0,1,0.1793875819708771,63
4212,1,6847,3352,3495,0,0,0,1.0,1,1.0,1,1.0,1,0.1659613512174658,64
4213,0,6847,3352,3495,0,0,0,1.0,1,1.0,1,1.0,1,0.16649697202105415,65
4214,0,6847,3352,3495,0,0,0,1.0,1,1.0,1,1.0,1,0.17320753634505692,65
4215,0,6847,3352,3495,0,0,0,1.0,1,1.0,1,1.0,1,0.17320753634505692,65
4216,0,6847,3352,3495,0,0,0,1.0,1,1.0,1,1.0,1,0.18430864545963865,64
4217,1,6848,3353,3495,0,0,0,1.0,1,1.0,1,1.0,1,0.20357023899475815,65
4218,0,6848,3353,3495,0,0,0,1.0,1,1.0,1,1.0,1,0.20357023899475815,65
4219,3,6851,3354,3497,0,0,0,1.0,1,1.0,1,1.0,1,0.20498005226838792,65
4220,0,6851,3354,3497,0,0,0,1.0,1,1.0,1,1.0,1,0.20498005226838792,65
4221,2,6853,3355,3498,0,0,0,1.0,1,1.0,1,1.0,1,0.22790787896858783,67
4222,0,6853,3355,3498,0,0,0,1.0,1,1.0,1,1.0,1,0.23321670083903923,68
4223,2,6855,3357,3498,0,0,0,1.0,1,1.0,1,1.0,1,0.2565678037996149,68
4224,2,6857,3358,3499,0,0,0,1.0,1,1.0,1,1.0,1,0.2681748092630472,68
4225,2,6859,3358,3501,0,0,0,1.0,1,1.0,1,1.0,1,0.24777813221354006,66
4226,1,6860,3359,3501,0,0,0,1.0,1,1.0,1,1.0,1,0.26488310876813537,66
4227,1,6861,3359,3502,0,0,0,1.0,1,1.0,1,1.0,1,0.2563224387888447,66
4228,0,6861,3359,3502,0,0,0,1.0,1,1.0,1,1.0,1,0.24964222287740642,65
4229,1,6862,3360,3502,0,0,0,1.0,1,1.0,1,1.0,1,0.2547585934649793,65
4230,3,6865,3361,3504,0,0,0,1.0,1,1.0,1,1.0,1,0.24493380399756398,64
4231,1,6866,3361,3505,0,0,0,1.0,1,1.0,1,1.0,1,0.23784525797366077,64
4232,2,6868,3362,3506,0,0,0,1.0,1,1.0,1,1.0,1,0.23404543005433348,65
4233,2,6870,3362,3508,0,0,0,1.0,1,1.0,1,1.0,1,0.221354484791398,64
4234,1,6871,3362,3509,0,0,0,1.0,1,1.0,1,1.0,1,0.211823916152142,63
4235,2,6873,3364,3509,0,0,0,1.0,1,1.0,1,1.0,1,0.21320399066345172,63
4236,0,6873,3364,3509,0,0,0,1.0,1,1.0,1,1.0,1,0.21320399066345172,63
4237,4,6877,3366,3511,0,0,0,1.0,1,1.0,1,1.0,1,0.21892811949678545,65
4238,1,6878,3366,3512,0,0,0,1.0,1,1.0,1,1.0,1,0.21134016390051974,65
4239,2,6880,3366,3514,0,0,0,1.0,1,1.0,1,1.0,1,0.19197588336545546,65
4240,1,6881,3367,3514,0,0,0,1.0,1,1.0,1,1.0,1,0.18052516682670014,66
4241,0,6881,3367,3514,0,0,0,1.0,1,1.0,1,1.0,1,0.18052516682670014,66
4242,1,6882,3367,3515,0,0,0,1.0,1,1.0,1,1.0,1,0.15166433516949443,69
4243,1,6883,3367,3516,0,0,0,1.0,1,1.0,1,1.0,1,0.16144276585821762,71
4244,0,6883,3367,3516,0,0,0,1.0,1,1.0,1,1.0,1,0.16144276585821762,71
4245,1,6884,3367,3517,0,0,0,1.0,1,1.0,1,1.0,1,0.15569071177755586,73
4246,1,6885,3367,3518,0,0,0,1.0,1,1.0,1,1.0,1,0.1299714414310794,74
4247,1,6886,3367,3519,0,0,0,1.0,1,1.0,1,1.0,1,0.12804295930221968,74
4248,0,6886,3367,3519,0,0,0,1.0,1,1.0,1,1.0,1,0.12804295930221968,74
4249,0,6886,3367,3519,0,0,0,1.0,1,1.0,1,1.0,1,0.12804295930221968,74
4250,0,6886,3367,3519,0,0,0,1.0,1,1.0,1,1.0,1,0.12804295930221968,74
4251,0,6886,3367,3519,0,0,0,1.0,1,1.0,1,1.0,1,0.13151449211336141,75
4252,2,6888,3369,3519,0,0,0,1.0,1,1.0,1,1.0,1,0.17598542774440615,75
4253,2,6890,3369,3521,0,0,0,1.0,1,1.0,1,1.0,1,0.1616046810123369,76
4254,2,6892,3371,3521,0,0,0,1.0,1,1.0,1,1.0,1,0.17494180506883167,75
4255,4,6896,3374,3522,0,0,0,1.0,1,1.0,1,1.0,1,0.18852586165982457,76
4256,2,6898,3375,3523,0,0,0,1.0,1,1.0,1,1.0,1,0.20090582941690419,78
4257,2,6900,3376,3524,0,0,0,1.0,1,1.0,1,1.0,1,0.17586712537658303,78
4258,0,6900,3376,3524,0,0,0,1.0,1,1.0,1,1.0,1,0.18772399750135754,77
4259,3,6903,3378,3525,0,0,0,1.0,1,1.0,1,1.0,1,0.20334235164567416,78
4260,3,6906,3378,3528,0,0,0,1.0,1,1.0,1,1.0,1,0.1736563669324116,77
4261,1,6907,3379,3528,0,0,0,1.0,1,1.0,1,1.0,1,0.17625413275343935,76
4262,0,6907,3379,3528,0,0,0,1.0,1,1.0,1,1.0,1,0.18813929755057296,75
4263,4,6911,3383,3528,0,0,0,1.0,1,1.0,1,1.0,1,0.18104897945866644,74
4264,4,6915,3383,3532,0,0,0,1.0,1,1.0,1,1.0,1,0.1853292474516789,74
4265,3,6918,3385,3533,0,0,0,1.0,1,1.0,1,1.0,1,0.18122209843632017,73
4266,0,6918,3385,3533,0,0,0,1.0,1,1.0,1,1.0,1,0.20891020176113245,71
4267,4,6922,3388,3534,0,0,0,1.0,1,1.0,1,1.0,1,0.20274589882075672,69
4268,2,6924,3390,3534,0,0,0,1.0,1,1.0,1,1.0,1,0.2487780278330264,67
4269,5,6929,3391,3538,0,0,0,1.0,1,1.0,1,1.0,1,0.20142132994355227,64
4270,2,6931,3392,3539,0,0,0,1.0,1,1.0,1,1.0,1,0.20576586458206422,63
4271,1,6932,3393,3539,0,0,0,1.0,1,1.0,1,1.0,1,0.22957670096229185,63
4272,1,6933,3394,3539,0,0,0,1.0,1,1.0,1,1.0,1,0.23417133815619412,62
4273,3,6936,3394,3542,0,0,0,1.0,1,1.0,1,1.0,1,0.2081122798155287,62
4274,1,6937,3394,3543,0,0,0,1.0,1,1.0,1,1.0,1,0.21572453992741866,62
4275,2,6939,3395,3544,0,0,0,1.0,1,1.0,1,1.0,1,0.19084997513255816,61
4276,0,6939,3395,3544,0,0,0,1.0,1,1.0,1,1.0,1,0.20139105976820781,62
4277,0,6939,3395,3544,0,0,0,1.0,1,1.0,1,1.0,1,0.21029073805577983,63
4278,0,6939,3395,3544,0,0,0,1.0,1,1.0,1,1.0,1,0.20117158866867216,64
4279,4,6943,3398,3545,0,0,0,1.0,1,1.0,1,1.0,1,0.21217425608724838,65
4280,1,6944,3399,3545,0,0,0,1.0,1,1.0,1,1.0,1,0.2099572658847204,65
4281,2,6946,3399,3547,0,0,0,1.0,1,1.0,1,1.0,1,0.19798797653955857,65
4282,5,6951,3403,3548,0,0,0,1.0,1,1.0,1,1.0,1,0.24451345534189814,66
4283,4,6955,3404,3551,0,0,0,1.0,1,1.0,1,1.0,1,0.23293694719633773,66
4284,2,6957,3405,3552,0,0,0,1.0,1,1.0,1,1.0,1,0.24811979975895204,66
4285,1,6958,3405,3553,0,0,0,1.0,1,1.0,1,1.0,1,0.24807978683191123,67
4286,0,6958,3405,3553,0,0,0,1.0,1,1.0,1,1.0,1,0.2590457778270773,67
4287,1,6959,3405,3554,0,0,0,1.0,1,1.0,1,1.0,1,0.25144305265105577,67
4288,2,6961,3405,3556,0,0,0,1.0,1,1.0,1,1.0,1,0.21838453607368907,68
4289,1,6962,3405,3557,0,0,0,1.0,1,1.0,1,1.0,1,0.23048984021851832,68
4290,1,6963,3405,3558,0,0,0,1.0,1,1.0,1,1.0,1,0.21912378030460894,70
4291,1,6964,3405,3559,0,0,0,1.0,1,1.0,1,1.0,1,0.20707018144328937,71
4292,1,6965,3405,3560,0,0,0,1.0,1,1.0,1,1.0,1,0.19859710070691847,71
4293,1,6966,3405,3561,0,0,0,1.0,1,1.0,1,1.0,1,0.1957727404614615,71
4294,0,6966,3405,3561,0,0,0,1.0,1,1.0,1,1.0,1,0.1957727404614615,71
4295,1,6967,3406,3561,0,0,0,1.0,1,1.0,1,1.0,1,0.21740623053689448,72
4296,1,6968,3406,3562,0,0,0,1.0,1,1.0,1,1.0,1,0.2207970365455514,73
4297,0,6968,3406,3562,0,0,0,1.0,1,1.0,1,1.0,1,0.2207970365455514,73
4298,1,6969,3406,3563,0,0,0,1.0,1,1.0,1,1.0,1,0.22007018220718932,74
4299,0,6969,3406,3563,0,0,0,1.0,1,1.0,1,1.0,1,0.21044404613216341,75
4300,1,6970,3406,3564,0,0,0,1.0,1,1.0,1,1.0,1,0.1959704616561282,75
4301,0,6970,3406,3564,0,0,0,1.0,1,1.0,1,1.0,1,0.1940971302952983,76
4302,1,6971,3407,3564,0,0,0,1.0,1,1.0,1,1.0,1,0.19278455156109198,76
4303,3,6974,3407,3567,0,0,0,1.0,1,1.0,1,1.0,1,0.1625768489695772,75
4304,1,6975,3408,3567,0,0,0,1.0,1,1.0,1,1.0,1,0.19104893234021225,75
4305,6,6981,3409,3572,0,0,0,1.0,1,1.0,1,1.0,1,0.18831184978038473,73
4306,6,6987,3413,3574,0,0,0,1.0,1,1.0,1,1.0,1,0.21039065611507146,74
4307,2,6989,3415,3574,0,0,0,1.0,1,1.0,1,1.0,1,0.22876200179779302,73
4308,0,6989,3415,3574,0,0,0,1.0,1,1.0,1,1.0,1,0.2529972534935516,71
4309,1,6990,3416,3574,0,0,0,1.0,1,1.0,1,1.0,1,0.25023264206657786,70
4310,2,6992,3417,3575,0,0,0,1.0,1,1.0,1,1.0,1,0.24998933923883648,69
4311,5,6997,3420,3577,0,0,0,1.0,1,1.0,1,1.0,1,0.23511302678223595,69
4312,2,6999,3421,3578,0,0,0,1.0,1,1.0,1,1.0,1,0.2495342118916777,66
4313,0,6999,3421,3578,0,0,0,1.0,1,1.0,1,1.0,1,0.2534711936212263,64
4314,1,7000,3421,3579,0,0,0,1.0,1,1.0,1,1.0,1,0.27242406609869296,61
4315,2,7002,3423,3579,0,0,0,1.0,1,1.0,1,1.0,1,0.2679220238631624,61
4316,5,7007,3426,3581,0,0,0,1.0,1,1.0,1,1.0,1,0.2612654020518916,60
4317,4,7011,3427,3584,0,0,0,1.0,1,1.0,1,1.0,1,0.21081918131240118,62
4318,0,7011,3427,3584,0,0,0,1.0,1,1.0,1,1.0,1,0.248662193721518,59
4319,1,7012,3427,3585,0,0,0,1.0,1,1.0,1,1.0,1,0.23513847307121047,60
4320,0,7012,3427,3585,0,0,0,1.0,1,1.0,1,1.0,1,0.23513847307121047,60
4321,3,7015,3430,3585,0,0,0,1.0,1,1.0,1,1.0,1,0.2420323710412562,61
4322,3,7018,3432,3586,0,0,0,1.0,1,1.0,1,1.0,1,0.2545368236722642,61
4323,0,7018,3432,3586,0,0,0,1.0,1,1.0,1,1.0,1,0.2545368236722642,61
4324,0,7018,3432,3586,0,0,0,1.0,1,1.0,1,1.0,1,0.2637602533712734,60
4325,1,7019,3432,3587,0,0,0,1.0,1,1.0,1,1.0,1,0.24514603374752378,60
4326,1,7020,3433,3587,0,0,0,1.0,1,1.0,1,1.0,1,0.2504106756564084,61
4327,1,7021,3433,3588,0,0,0,1.0,1,1.0,1,1.0,1,0.23585090819231408,62
4328,0,7021,3433,3588,0,0,0,1.0,1,1.0,1,1.0,1,0.23585090819231408,62
4329,0,7021,3433,3588,0,0,0,1.0,1,1.0,1,1.0,1,0.22911926477113476,65
4330,1,7022,3433,3589,0,0,0,1.0,1,1.0,1,1.0,1,0.21639794350515043,65
4331,0,7022,3433,3589,0,0,0,1.0,1,1.0,1,1.0,1,0.21639794350515043,65
4332,2,7024,3434,3590,0,0,0,1.0,1,1.0,1,1.0,1,0.21872824250515582,66
4333,3,7027,3435,3592,0,0,0,1.0,1,1.0,1,1.0,1,0.1987380456630923,66
4334,1,7028,3436,3592,0,0,0,1.0,1,1.0,1,1.0,1,0.2131318011351757,66
4335,1,7029,3436,3593,0,0,0,1.0,1,1.0,1,1.0,1,0.22047841338480498,65
4336,4,7033,3438,3595,0,0,0,1.0,1,1.0,1,1.0,1,0.20417186905699553,67
4337,0,7033,3438,3595,0,0,0,1.0,1,1.0,1,1.0,1,0.22371250138848459,69
4338,1,7034,3438,3596,0,0,0,1.0,1,1.0,1,1.0,1,0.21780469936535393,70
4339,1,7035,3438,3597,0,0,0,1.0,1,1.0,1,1.0,1,0.22315190148386024,70
4340,2,7037,3438,3599,0,0,0,1.0,1,1.0,1,1.0,1,0.20656894172919338,71
4341,2,7039,3439,3600,0,0,0,1.0,1,1.0,1,1.0,1,0.21465165515637302,70
4342,2,7041,3440,3601,0,0,0,1.0,1,1.0,1,1.0,1,0.2265872585420081,71
4343,4,7045,3443,3602,0,0,0,1.0,1,1.0,1,1.0,1,0.22988074079606807,67
4344,6,7051,3447,3604,0,0,0,1.0,1,1.0,1,1.0,1,0.24716655803073784,67
4345,3,7054,3450,3604,0,0,0,1.0,1,1.0,1,1.0,1,0.26026621966308877,64
4346,5,7059,3453,3606,0,0,0,1.0,1,1.0,1,1.0,1,0.26801723523684423,64
4347,7,7066,3457,3609,0,0,0,1.0,1,1.0,1,1.0,1,0.2521779620757365,62
4348,4,7070,3459,3611,0,0,0,1.0,1,1.0,1,1.0,1,0.24825510656312813,62
4349,1,7071,3460,3611,0,0,0,1.0,1,1.0,1,1.0,1,0.28430166512310434,61
4350,2,7073,3462,3611,0,0,0,1.0,1,1.0,1,1.0,1,0.3156720695192102,60
4351,2,7075,3462,3613,0,0,0,1.0,1,1.0,1,1.0,1,0.3005048023581834,60
4352,0,7075,3462,3613,0,0,0,1.0,1,1.0,1,1.0,1,0.3147597149078184,57
4353,2,7077,3463,3614,0,0,0,1.0,1,1.0,1,1.0,1,0.2938063978987228,55
4354,2,7079,3464,3615,0,0,0,1.0,1,1.0,1,1.0,1,0.26058622299439826,55
4355,3,7082,3464,3618,0,0,0,1.0,1,1.0,1,1.0,1,0.25676649907619575,53
4356,2,7084,3464,3620,0,0,0,1.0,1,1.0,1,1.0,1,0.21779882748540078,55
4357,0,7084,3464,3620,0,0,0,1.0,1,1.0,1,1.0,1,0.23061054200468867,55
4358,2,7086,3465,3621,0,0,0,1.0,1,1.0,1,1.0,1,0.23040488584871602,55
4359,1,7087,3465,3622,0,0,0,1.0,1,1.0,1,1.0,1,0.2321073040316012,54
4360,1,7088,3466,3622,0,0,0,1.0,1,1.0,1,1.0,1,0.23293325600886441,55
4361,1,7089,3467,3622,0,0,0,1.0,1,1.0,1,1.0,1,0.2603853170757799,54
4362,3,7092,3467,3625,0,0,0,1.0,1,1.0,1,1.0,1,0.21163747214332668,55
4363,4,7096,3468,3628,0,0,0,1.0,1,1.0,1,1.0,1,0.19205570020253757,55
4364,2,7098,3470,3628,0,0,0,1.0,1,1.0,1,1.0,1,0.22790428293029402,55
4365,1,7099,3470,3629,0,0,0,1.0,1,1.0,1,1.0,1,0.2146889411295021,54
4366,1,7100,3471,3629,0,0,0,1.0,1,1.0,1,1.0,1,0.2243294069128711,54
4367,1,7101,3471,3630,0,0,0,1.0,1,1.0,1,1.0,1,0.22076317807166237,57
4368,1,7102,3472,3630,0,0,0,1.0,1,1.0,1,1.0,1,0.2662280835043083,57
4369,3,7105,3472,3633,0,0,0,1.0,1,1.0,1,1.0,1,0.23132541544464102,58
4370,2,7107,3473,3634,0,0,0,1.0,1,1.0,1,1.0,1,0.23608102824553126,59
4371,1,7108,3473,3635,0,0,0,1.0,1,1.0,1,1.0,1,0.2218626936289317,60
4372,1,7109,3474,3635,0,0,0,1.0,1,1.0,1,1.0,1,0.23309683924776203,60
4373,1,7110,3474,3636,0,0,0,1.0,1,1.0,1,1.0,1,0.20496756784533376,60
4374,1,7111,3475,3636,0,0,0,1.0,1,1.0,1,1.0,1,0.24128152016683738,59
4375,1,7112,3475,3637,0,0,0,1.0,1,1.0,1,1.0,1,0.2429943820652049,60
4376,0,7112,3475,3637,0,0,0,1.0,1,1.0,1,1.0,1,0.25939751056215904,60
4377,1,7113,3475,3638,0,0,0,1.0,1,1.0,1,1.0,1,0.23672459212739763,61
4378,1,7114,3476,3638,0,0,0,1.0,1,1.0,1,1.0,1,0.23006357992607604,64
4379,1,7115,3476,3639,0,0,0,1.0,1,1.0,1,1.0,1,0.2230013179954805,64
4380,2,7117,3477,3640,0,0,0,1.0,1,1.0,1,1.0,1,0.23779344025660196,65
4381,0,7117,3477,3640,0,0,0,1.0,1,1.0,1,1.0,1,0.25043021393463466,64
4382,0,7117,3477,3640,0,0,0,1.0,1,1.0,1,1.0,1,0.2714399636094771,64
4383,1,7118,3478,3640,0,0,0,1.0,1,1.0,1,1.0,1,0.2859465104147,64
4384,1,7119,3479,3640,0,0,0,1.0,1,1.0,1,1.0,1,0.30922758105460624,60
4385,1,7120,3479,3641,0,0,0,1.0,1,1.0,1,1.0,1,0.2799727370004527,58
4386,3,7123,3482,3641,0,0,0,1.0,1,1.0,1,1.0,1,0.290226135390187,58
4387,2,7125,3482,3643,0,0,0,1.0,1,1.0,1,1.0,1,0.27021788465134006,55
4388,2,7127,3484,3643,0,0,0,1.0,1,1.0,1,1.0,1,0.2965626259441342,56
4389,2,7129,3485,3644,0,0,0,1.0,1,1.0,1,1.0,1,0.26246030725560754,55
4390,5,7134,3487,3647,0,0,0,1.0,1,1.0,1,1.0,1,0.24656664043069776,55
4391,3,7137,3489,3648,0,0,0,1.0,1,1.0,1,1.0,1,0.2496576078104775,56
4392,1,7138,3489,3649,0,0,0,1.0,1,1.0,1,1.0,1,0.25159589009450894,56
4393,2,7140,3490,3650,0,0,0,1.0,1,1.0,1,1.0,1,0.2920472764846597,55
4394,2,7142,3492,3650,0,0,0,1.0,1,1.0,1,1.0,1,0.29537282213020766,53
4395,3,7145,3494,3651,0,0,0,1.0,1,1.0,1,1.0,1,0.29672674177923025,53
4396,4,7149,3497,3652,0,0,0,1.0,1,1.0,1,1.0,1,0.3251246858994163,53
4397,2,7151,3498,3653,0,0,0,1.0,1,1.0,1,1.0,1,0.32409337307410624,50
4398,0,7151,3498,3653,0,0,0,1.0,1,1.0,1,1.0,1,0.3404154918218639,50
4399,0,7151,3498,3653,0,0,0,1.0,1,1.0,1,1.0,1,0.34458130906566353,52
4400,2,7153,3499,3654,0,0,0,1.0,1,1.0,1,1.0,1,0.3535289310592051,55
4401,2,7155,3499,3656,0,0,0,1.0,1,1.0,1,1.0,1,0.3244694162049651,56
4402,0,7155,3499,3656,0,0,0,1.0,1,1.0,1,1.0,1,0.3244694162049651,56
4403,3,7158,3501,3657,0,0,0,1.0,1,1.0,1,1.0,1,0.31224313496388756,57
4404,1,7159,3501,3658,0,0,0,1.0,1,1.0,1,1.0,1,0.30430939711795446,57
4405,0,7159,3501,3658,0,0,0,1.0,1,1.0,1,1.0,1,0.29772207321328903,58
4406,0,7159,3501,3658,0,0,0,1.0,1,1.0,1,1.0,1,0.29772207321328903,58
4407,0,7159,3501,3658,0,0,0,1.0,1,1.0,1,1.0,1,0.29772207321328903,58
4408,1,7160,3502,3658,0,0,0,1.0,1,1.0,1,1.0,1,0.30988108683694604,59
4409,0,7160,3502,3658,0,0,0,1.0,1,1.0,1,1.0,1,0.30988108683694604,59
4410,0,7160,3502,3658,0,0,0,1.0,1,1.0,1,1.0,1,0.30988108683694604,59
4411,0,7160,3502,3658,0,0,0,1.0,1,1.0,1,1.0,1,0.29681223505831156,62
4412,0,7160,3502,3658,0,0,0,1.0,1,1.0,1,1.0,1,0.2908900341066939,63
4413,0,7160,3502,3658,0,0,0,1.0,1,1.0,1,1.0,1,0.2908900341066939,63
4414,1,7161,3502,3659,0,0,0,1.0,1,1.0,1,1.0,1,0.28142059394519703,64
4415,1,7162,3502,3660,0,0,0,1.0,1,1.0,1,1.0,1,0.26937051261248274,64
4416,0,7162,3502,3660,0,0,0,1.0,1,1.0,1,1.0,1,0.26937051261248274,64
4417,3,7165,3502,3663,0,0,0,1.0,1,1.0,1,1.0,1,0.25972044306951797,65
4418,1,7166,3503,3663,0,0,0,1.0,1,1.0,1,1.0,1,0.27680545418042923,65
4419,0,7166,3503,3663,0,0,0,1.0,1,1.0,1,1.0,1,0.32272979293486825,62
4420,3,7169,3504,3665,0,0,0,1.0,1,1.0,1,1.0,1,0.30495758599085354,62
4421,6,7175,3505,3670,0,0,0,1.0,1,1.0,1,1.0,1,0.28903480171540713,65
4422,3,7178,3507,3671,0,0,0,1.0,1,1.0,1,1.0,1,0.3100302090374673,64
4423,2,7180,3508,3672,0,0,0,1.0,1,1.0,1,1.0,1,0.294860729765675,63
4424,3,7183,3509,3674,0,0,0,1.0,1,1.0,1,1.0,1,0.2764341271825694,63
4425,3,7186,3509,3677,0,0,0,1.0,1,1.0,1,1.0,1,0.27100064757595527,63
4426,1,7187,3510,3677,0,0,0,1.0,1,1.0,1,1.0,1,0.26333596156982025,63
4427,3,7190,3510,3680,0,0,0,1.0,1,1.0,1,1.0,1,0.212462659818499,62
4428,2,7192,3510,3682,0,0,0,1.0,1,1.0,1,1.0,1,0.18327197006606824,61
4429,3,7195,3512,3683,0,0,0,1.0,1,1.0,1,1.0,1,0.22442472323249005,62
4430,2,7197,3513,3684,0,0,0,1.0,1,1.0,1,1.0,1,0.231557873520834,60
4431,2,7199,3514,3685,0,0,0,1.0,1,1.0,1,1.0,1,0.1927497949787237,59
4432,4,7203,3515,3688,0,0,0,1.0,1,1.0,1,1.0,1,0.16834821841313183,60
4433,2,7205,3517,3688,0,0,0,1.0,1,1.0,1,1.0,1,0.16849902099433445,61
4434,3,7208,3519,3689,0,0,0,1.0,1,1.0,1,1.0,1,0.16999109385398845,61
4435,2,7210,3520,3690,0,0,0,1.0,1,1.0,1,1.0,1,0.1654893821498641,61
4436,2,7212,3521,3691,0,0,0,1.0,1,1.0,1,1.0,1,0.18234502504931702,61
4437,3,7215,3523,3692,0,0,0,1.0,1,1.0,1,1.0,1,0.22371386040230112,61
4438,1,7216,3523,3693,0,0,0,1.0,1,1.0,1,1.0,1,0.21194083380492934,62
4439,3,7219,3523,3696,0,0,0,1.0,1,1.0,1,1.0,1,0.19362185806287094,63
4440,3,7222,3523,3699,0,0,0,1.0,1,1.0,1,1.0,1,0.16760059390663198,64
4441,0,7222,3523,3699,0,0,0,1.0,1,1.0,1,1.0,1,0.16760059390663198,64
4442,2,7224,3525,3699,0,0,0,1.0,1,1.0,1,1.0,1,0.15422882831630078,67
4443,1,7225,3525,3700,0,0,0,1.0,1,1.0,1,1.0,1,0.13998887088757234,68
4444,0,7225,3525,3700,0,0,0,1.0,1,1.0,1,1.0,1,0.13836807701339537,69
4445,1,7226,3526,3700,0,0,0,1.0,1,1.0,1,1.0,1,0.1634194566151426,71
4446,0,7226,3526,3700,0,0,0,1.0,1,1.0,1,1.0,1,0.1634194566151426,71
4447,2,7228,3526,3702,0,0,0,1.0,1,1.0,1,1.0,1,0.14891521400979177,72
4448,0,7228,3526,3702,0,0,0,1.0,1,1.0,1,1.0,1,0.15890822548138273,71
4449,3,7231,3527,3704,0,0,0,1.0,1,1.0,1,1.0,1,0.14777406429104947,70
4450,0,7231,3527,3704,0,0,0,1.0,1,1.0,1,1.0,1,0.15483562375641463,69
4451,0,7231,3527,3704,0,0,0,1.0,1,1.0,1,1.0,1,0.1602098940444659,69
4452,0,7231,3527,3704,0,0,0,1.0,1,1.0,1,1.0,1,0.16215450161145378,70
4453,1,7232,3527,3705,0,0,0,1.0,1,1.0,1,1.0,1,0.17802364793024444,70
4454,5,7237,3529,3708,0,0,0,1.0,1,1.0,1,1.0,1,0.16737518537920068,71
4455,1,7238,3529,3709,0,0,0,1.0,1,1.0,1,1.0,1,0.1724328507058365,71
4456,6,7244,3533,3711,0,0,0,1.0,1,1.0,1,1.0,1,0.19259552418778858,71
4457,3,7247,3535,3712,0,0,0,1.0,1,1.0,1,1.0,1,0.17999302099448472,69
4458,4,7251,3538,3713,0,0,0,1.0,1,1.0,1,1.0,1,0.21580174057886495,70
4459,3,7254,3539,3715,0,0,0,1.0,1,1.0,1,1.0,1,0.19637392642321982,68
4460,4,7258,3543,3715,0,0,0,1.0,1,1.0,1,1.0,1,0.22377096562047372,68
4461,3,7261,3543,3718,0,0,0,1.0,1,1.0,1,1.0,1,0.1738625835396169,67
4462,4,7265,3547,3718,0,0,0,1.0,1,1.0,1,1.0,1,0.18284738208345294,66
4463,5,7270,3550,3720,0,0,0,1.0,1,1.0,1,1.0,1,0.17588783276048034,65
4464,3,7273,3553,3720,0,0,0,1.0,1,1.0,1,1.0,1,0.22444173583298313,62
4465,6,7279,3557,3722,0,0,0,1.0,1,1.0,1,1.0,1,0.22019825005851673,61
4466,1,7280,3557,3723,0,0,0,1.0,1,1.0,1,1.0,1,0.2245355207513299,60
4467,3,7283,3558,3725,0,0,0,1.0,1,1.0,1,1.0,1,0.19941693461207452,58
4468,1,7284,3559,3725,0,0,0,1.0,1,1.0,1,1.0,1,0.21423875418401206,57
4469,4,7288,3561,3727,0,0,0,1.0,1,1.0,1,1.0,1,0.2242918964452651,56
4470,1,7289,3561,3728,0,0,0,1.0,1,1.0,1,1.0,1,0.19628430705134528,55
4471,0,7289,3561,3728,0,0,0,1.0,1,1.0,1,1.0,1,0.1941236763089843,55
4472,3,7292,3564,3728,0,0,0,1.0,1,1.0,1,1.0,1,0.22383472734203194,55
4473,2,7294,3565,3729,0,0,0,1.0,1,1.0,1,1.0,1,0.2040630744689165,55
4474,4,7298,3567,3731,0,0,0,1.0,1,1.0,1,1.0,1,0.2063439974976484,55
4475,2,7300,3567,3733,0,0,0,1.0,1,1.0,1,1.0,1,0.15571246317602724,56
4476,1,7301,3568,3733,0,0,0,1.0,1,1.0,1,1.0,1,0.16672409695710388,56
4477,1,7302,3568,3734,0,0,0,1.0,1,1.0,1,1.0,1,0.16462379978755592,57
4478,0,7302,3568,3734,0,0,0,1.0,1,1.0,1,1.0,1,0.16869772743892636,55
4479,1,7303,3569,3734,0,0,0,1.0,1,1.0,1,1.0,1,0.17526717840626543,55
4480,0,7303,3569,3734,0,0,0,1.0,1,1.0,1,1.0,1,0.1833282274301594,54
4481,0,7303,3569,3734,0,0,0,1.0,1,1.0,1,1.0,1,0.21292400321846705,53
4482,2,7305,3571,3734,0,0,0,1.0,1,1.0,1,1.0,1,0.2190512677205875,54
4483,1,7306,3571,3735,0,0,0,1.0,1,1.0,1,1.0,1,0.201438271139422,55
4484,3,7309,3574,3735,0,0,0,1.0,1,1.0,1,1.0,1,0.20327787420501364,57
4485,2,7311,3576,3735,0,0,0,1.0,1,1.0,1,1.0,1,0.25028860702456174,60
4486,2,7313,3578,3735,0,0,0,1.0,1,1.0,1,1.0,1,0.23644691974668072,60
4487,2,7315,3578,3737,0,0,0,1.0,1,1.0,1,1.0,1,0.22126330267974414,60
4488,0,7315,3578,3737,0,0,0,1.0,1,1.0,1,1.0,1,0.22126330267974414,60
4489,2,7317,3579,3738,0,0,0,1.0,1,1.0,1,1.0,1,0.21484613045090656,60
4490,0,7317,3579,3738,0,0,0,1.0,1,1.0,1,1.0,1,0.21484613045090656,60
4491,2,7319,3580,3739,0,0,0,1.0,1,1.0,1,1.0,1,0.20257846692796277,61
4492,2,7321,3581,3740,0,0,0,1.0,1,1.0,1,1.0,1,0.16271834032150045,61
4493,1,7322,3582,3740,0,0,0,1.0,1,1.0,1,1.0,1,0.1609682503976684,60
4494,2,7324,3583,3741,0,0,0,1.0,1,1.0,1,1.0,1,0.16254483406573011,61
4495,2,7326,3584,3742,0,0,0,1.0,1,1.0,1,1.0,1,0.15451504454291504,59
4496,3,7329,3584,3745,0,0,0,1.0,1,1.0,1,1.0,1,0.15274719581370952,60
4497,1,7330,3585,3745,0,0,0,1.0,1,1.0,1,1.0,1,0.1856134757846072,59
4498,0,7330,3585,3745,0,0,0,1.0,1,1.0,1,1.0,1,0.1669062519948816,57
4499,3,7333,3587,3746,0,0,0,1.0,1,1.0,1,1.0,1,0.19236220956607106,58
4500,0,7333,3587,3746,0,0,0,1.0,1,1.0,1,1.0,1,0.16723710061526847,56
4501,1,7334,3587,3747,0,0,0,1.0,1,1.0,1,1.0,1,0.17137737997119815,57
4502,3,7337,3590,3747,0,0,0,1.0,1,1.0,1,1.0,1,0.2019903187285869,56
4503,3,7340,3591,3749,0,0,0,1.0,1,1.0,1,1.0,1,0.19627426928531302,54
4504,2,7342,3593,3749,0,0,0,1.0,1,1.0,1,1.0,1,0.22069376267079518,54
4505,3,7345,3595,3750,0,0,0,1.0,1,1.0,1,1.0,1,0.26049661194282575,51
4506,0,7345,3595,3750,0,0,0,1.0,1,1.0,1,1.0,1,0.24943917643723348,49
4507,2,7347,3597,3750,0,0,0,1.0,1,1.0,1,1.0,1,0.2843473730650714,48
4508,2,7349,3597,3752,0,0,0,1.0,1,1.0,1,1.0,1,0.25430066614773206,48
4509,4,7353,3600,3753,0,0,0,1.0,1,1.0,1,1.0,1,0.23556348376288222,46
4510,1,7354,3600,3754,0,0,0,1.0,1,1.0,1,1.0,1,0.2342286932343366,44
4511,3,7357,3601,3756,0,0,0,1.0,1,1.0,1,1.0,1,0.2332830284817694,45
4512,2,7359,3602,3757,0,0,0,1.0,1,1.0,1,1.0,1,0.21632636521033693,46
4513,1,7360,3602,3758,0,0,0,1.0,1,1.0,1,1.0,1,0.2294690073806502,45
4514,4,7364,3603,3761,0,0,0,1.0,1,1.0,1,1.0,1,0.1574217888428673,46
4515,1,7365,3603,3762,0,0,0,1.0,1,1.0,1,1.0,1,0.1622849754857736,48
4516,1,7366,3604,3762,0,0,0,1.0,1,1.0,1,1.0,1,0.18392270795088297,49
4517,1,7367,3604,3763,0,0,0,1.0,1,1.0,1,1.0,1,0.18293872023802352,50
4518,1,7368,3605,3763,0,0,0,1.0,1,1.0,1,1.0,1,0.17805292466927775,50
4519,2,7370,3607,3763,0,0,0,1.0,1,1.0,1,1.0,1,0.2018800854581197,49
4520,0,7370,3607,3763,0,0,0,1.0,1,1.0,1,1.0,1,0.21412713143000345,50
4521,0,7370,3607,3763,0,0,0,1.0,1,1.0,1,1.0,1,0.21412713143000345,50
4522,1,7371,3607,3764,0,0,0,1.0,1,1.0,1,1.0,1,0.19474172863041614,50
4523,0,7371,3607,3764,0,0,0,1.0,1,1.0,1,1.0,1,0.19286168280712665,51
4524,2,7373,3608,3765,0,0,0,1.0,1,1.0,1,1.0,1,0.19449005524374705,52
4525,2,7375,3609,3766,0,0,0,1.0,1,1.0,1,1.0,1,0.19044106312062906,53
4526,0,7375,3609,3766,0,0,0,1.0,1,1.0,1,1.0,1,0.18106345902381665,54
4527,2,7377,3610,3767,0,0,0,1.0,1,1.0,1,1.0,1,0.18120314628424725,55
4528,0,7377,3610,3767,0,0,0,1.0,1,1.0,1,1.0,1,0.18120314628424725,55
4529,2,7379,3610,3769,0,0,0,1.0,1,1.0,1,1.0,1,0.17860966047054938,55
4530,0,7379,3610,3769,0,0,0,1.0,1,1.0,1,1.0,1,0.17716875032730603,56
4531,4,7383,3613,3770,0,0,0,1.0,1,1.0,1,1.0,1,0.1907536283934148,56
4532,2,7385,3614,3771,0,0,0,1.0,1,1.0,1,1.0,1,0.2284427930166239,55
4533,3,7388,3615,3773,0,0,0,1.0,1,1.0,1,1.0,1,0.21819108057067693,54
4534,0,7388,3615,3773,0,0,0,1.0,1,1.0,1,1.0,1,0.22583490633924405,55
4535,2,7390,3615,3775,0,0,0,1.0,1,1.0,1,1.0,1,0.2049971134573473,52
4536,3,7393,3617,3776,0,0,0,1.0,1,1.0,1,1.0,1,0.20131183376994408,53
4537,2,7395,3618,3777,0,0,0,1.0,1,1.0,1,1.0,1,0.2049347891284595,52
4538,1,7396,3619,3777,0,0,0,1.0,1,1.0,1,1.0,1,0.19451428049434188,52
4539,2,7398,3620,3778,0,0,0,1.0,1,1.0,1,1.0,1,0.20429157923534905,53
4540,2,7400,3621,3779,0,0,0,1.0,1,1.0,1,1.0,1,0.2188783477092816,54
4541,1,7401,3621,3780,0,0,0,1.0,1,1.0,1,1.0,1,0.2303797377130412,53
4542,4,7405,3624,3781,0,0,0,1.0,1,1.0,1,1.0,1,0.24538758535629424,53
4543,2,7407,3625,3782,0,0,0,1.0,1,1.0,1,1.0,1,0.24808902119196793,53
4544,2,7409,3626,3783,0,0,0,1.0,1,1.0,1,1.0,1,0.2516115237329977,52
4545,4,7413,3626,3787,0,0,0,1.0,1,1.0,1,1.0,1,0.22461861068141575,50
4546,1,7414,3627,3787,0,0,0,1.0,1,1.0,1,1.0,1,0.21869192293803835,49
4547,1,7415,3628,3787,0,0,0,1.0,1,1.0,1,1.0,1,0.22692038886710894,49
4548,0,7415,3628,3787,0,0,0,1.0,1,1.0,1,1.0,1,0.22692038886710894,49
4549,1,7416,3629,3787,0,0,0,1.0,1,1.0,1,1.0,1,0.23072681793823085,50
4550,1,7417,3630,3787,0,0,0,1.0,1,1.0,1,1.0,1,0.23890879170349535,49
4551,2,7419,3630,3789,0,0,0,1.0,1,1.0,1,1.0,1,0.21888446410624796,49
4552,0,7419,3630,3789,0,0,0,1.0,1,1.0,1,1.0,1,0.21888446410624796,49
4553,2,7421,3632,3789,0,0,0,1.0,1,1.0,1,1.0,1,0.25912194053195353,49
4554,1,7422,3632,3790,0,0,0,1.0,1,1.0,1,1.0,1,0.2407368301412093,49
4555,1,7423,3633,3790,0,0,0,1.0,1,1.0,1,1.0,1,0.24869717818460724,48
4556,1,7424,3634,3790,0,0,0,1.0,1,1.0,1,1.0,1,0.2315222895294364,48
4557,3,7427,3635,3792,0,0,0,1.0,1,1.0,1,1.0,1,0.24557663864902643,49
4558,2,7429,3636,3793,0,0,0,1.0,1,1.0,1,1.0,1,0.19186144147865153,49
4559,1,7430,3636,3794,0,0,0,1.0,1,1.0,1,1.0,1,0.18534181231116523,50
4560,1,7431,3637,3794,0,0,0,1.0,1,1.0,1,1.0,1,0.2087634591954059,51
4561,1,7432,3637,3795,0,0,0,1.0,1,1.0,1,1.0,1,0.19324894277353857,52
4562,1,7433,3638,3795,0,0,0,1.0,1,1.0,1,1.0,1,0.2341539382195627,53
4563,0,7433,3638,3795,0,0,0,1.0,1,1.0,1,1.0,1,0.22459549188702835,52
4564,3,7436,3638,3798,0,0,0,1.0,1,1.0,1,1.0,1,0.18474123843513574,54
4565,0,7436,3638,3798,0,0,0,1.0,1,1.0,1,1.0,1,0.19727328574803435,55
4566,1,7437,3638,3799,0,0,0,1.0,1,1.0,1,1.0,1,0.18735969193693386,55
4567,3,7440,3640,3800,0,0,0,1.0,1,1.0,1,1.0,1,0.15858655863344398,56
4568,2,7442,3641,3801,0,0,0,1.0,1,1.0,1,1.0,1,0.16762792663673037,58
4569,0,7442,3641,3801,0,0,0,1.0,1,1.0,1,1.0,1,0.16986010906774954,59
4570,2,7444,3642,3802,0,0,0,1.0,1,1.0,1,1.0,1,0.1538195111943987,59
4571,0,7444,3642,3802,0,0,0,1.0,1,1.0,1,1.0,1,0.1345244918184883,57
4572,2,7446,3644,3802,0,0,0,1.0,1,1.0,1,1.0,1,0.17294795355961703,56
4573,3,7449,3646,3803,0,0,0,1.0,1,1.0,1,1.0,1,0.19431549608970308,56
4574,1,7450,3646,3804,0,0,0,1.0,1,1.0,1,1.0,1,0.2509697151947928,55
4575,2,7452,3647,3805,0,0,0,1.0,1,1.0,1,1.0,1,0.2416032965761929,55
4576,0,7452,3647,3805,0,0,0,1.0,1,1.0,1,1.0,1,0.2606978358569996,55
4577,2,7454,3647,3807,0,0,0,1.0,1,1.0,1,1.0,1,0.24222420076012888,54
4578,1,7455,3648,3807,0,0,0,1.0,1,1.0,1,1.0,1,0.24632893792474386,54
4579,2,7457,3648,3809,0,0,0,1.0,1,1.0,1,1.0,1,0.21052353156045875,54
4580,1,7458,3648,3810,0,0,0,1.0,1,1.0,1,1.0,1,0.19609487748518079,55
4581,1,7459,3649,3810,0,0,0,1.0,1,1.0,1,1.0,1,0.21748457974297242,56
4582,0,7459,3649,3810,0,0,0,1.0,1,1.0,1,1.0,1,0.21748457974297242,56
4583,1,7460,3650,3810,0,0,0,1.0,1,1.0,1,1.0,1,0.22239911105311866,57
4584,1,7461,3651,3810,0,0,0,1.0,1,1.0,1,1.0,1,0.24625673549769425,57
4585,0,7461,3651,3810,0,0,0,1.0,1,1.0,1,1.0,1,0.24625673549769425,57
4586,0,7461,3651,3810,0,0,0,1.0,1,1.0,1,1.0,1,0.24625673549769425,57
4587,0,7461,3651,3810,0,0,0,1.0,1,1.0,1,1.0,1,0.24625673549769425,57
4588,0,7461,3651,3810,0,0,0,1.0,1,1.0,1,1.0,1,0.2539943410665132,58
4589,0,7461,3651,3810,0,0,0,1.0,1,1.0,1,1.0,1,0.2557464316642768,59
4590,0,7461,3651,3810,0,0,0,1.0,1,1.0,1,1.0,1,0.2651380386266007,60
4591,0,7461,3651,3810,0,0,0,1.0,1,1.0,1,1.0,1,0.27229361478096586,61
4592,1,7462,3651,3811,0,0,0,1.0,1,1.0,1,1.0,1,0.2649617795093382,62
4593,3,7465,3651,3814,0,0,0,1.0,1,1.0,1,1.0,1,0.23000705843557656,64
4594,0,7465,3651,3814,0,0,0,1.0,1,1.0,1,1.0,1,0.23000705843557656,64
4595,0,7465,3651,3814,0,0,0,1.0,1,1.0,1,1.0,1,0.24230687426178343,63
4596,0,7465,3651,3814,0,0,0,1.0,1,1.0,1,1.0,1,0.24230687426178343,63
4597,2,7467,3653,3814,0,0,0,1.0,1,1.0,1,1.0,1,0.2386291306423974,63
4598,3,7470,3654,3816,0,0,0,1.0,1,1.0,1,1.0,1,0.20014966379563748,65
4599,3,7473,3655,3818,0,0,0,1.0,1,1.0,1,1.0,1,0.1832786495844055,66
4600,1,7474,3656,3818,0,0,0,1.0,1,1.0,1,1.0,1,0.19962464992501938,67
4601,1,7475,3656,3819,0,0,0,1.0,1,1.0,1,1.0,1,0.19279654134896734,67
4602,0,7475,3656,3819,0,0,0,1.0,1,1.0,1,1.0,1,0.1889263410816995,69
4603,2,7477,3657,3820,0,0,0,1.0,1,1.0,1,1.0,1,0.18107895342417485,69
4604,0,7477,3657,3820,0,0,0,1.0,1,1.0,1,1.0,1,0.18107895342417485,69
4605,0,7477,3657,3820,0,0,0,1.0,1,1.0,1,1.0,1,0.17420655857583986,70
4606,0,7477,3657,3820,0,0,0,1.0,1,1.0,1,1.0,1,0.17420655857583986,70
4607,1,7478,3658,3820,0,0,0,1.0,1,1.0,1,1.0,1,0.20356340080340352,72
4608,4,7482,3658,3824,0,0,0,1.0,1,1.0,1,1.0,1,0.1779809350556914,73
4609,0,7482,3658,3824,0,0,0,1.0,1,1.0,1,1.0,1,0.1734206961923017,72
4610,2,7484,3659,3825,0,0,0,1.0,1,1.0,1,1.0,1,0.15881118103290853,72
4611,0,7484,3659,3825,0,0,0,1.0,1,1.0,1,1.0,1,0.17269292995781146,71
4612,1,7485,3660,3825,0,0,0,1.0,1,1.0,1,1.0,1,0.1904682260302257,70
4613,0,7485,3660,3825,0,0,0,1.0,1,1.0,1,1.0,1,0.1836162994657111,69
4614,0,7485,3660,3825,0,0,0,1.0,1,1.0,1,1.0,1,0.21302200144210917,68
4615,3,7488,3662,3826,0,0,0,1.0,1,1.0,1,1.0,1,0.2098765479927366,68
4616,0,7488,3662,3826,0,0,0,1.0,1,1.0,1,1.0,1,0.24336735217790703,65
4617,3,7491,3664,3827,0,0,0,1.0,1,1.0,1,1.0,1,0.2288216742697613,66
4618,1,7492,3665,3827,0,0,0,1.0,1,1.0,1,1.0,1,0.24868833832228635,66
4619,2,7494,3665,3829,0,0,0,1.0,1,1.0,1,1.0,1,0.23219890127447576,65
4620,1,7495,3665,3830,0,0,0,1.0,1,1.0,1,1.0,1,0.22264749817905785,65
4621,7,7502,3670,3832,0,0,0,1.0,1,1.0,1,1.0,1,0.2465626756994113,67
4622,0,7502,3670,3832,0,0,0,1.0,1,1.0,1,1.0,1,0.2501003562715921,65
4623,3,7505,3673,3832,0,0,0,1.0,1,1.0,1,1.0,1,0.27588485207763097,66
4624,2,7507,3675,3832,0,0,0,1.0,1,1.0,1,1.0,1,0.2780869073420745,65
4625,5,7512,3675,3837,0,0,0,1.0,1,1.0,1,1.0,1,0.22225070967779137,64
4626,2,7514,3677,3837,0,0,0,1.0,1,1.0,1,1.0,1,0.22463168833768887,63
4627,5,7519,3678,3841,0,0,0,1.0,1,1.0,1,1.0,1,0.192605995045958,65
4628,1,7520,3678,3842,0,0,0,1.0,1,1.0,1,1.0,1,0.18904190398691245,64
4629,2,7522,3679,3843,0,0,0,1.0,1,1.0,1,1.0,1,0.18132088929481271,64
4630,1,7523,3679,3844,0,0,0,1.0,1,1.0,1,1.0,1,0.16239645425897273,64
4631,5,7528,3680,3848,0,0,0,1.0,1,1.0,1,1.0,1,0.1828922123614229,66
4632,2,7530,3680,3850,0,0,0,1.0,1,1.0,1,1.0,1,0.17126927074798826,65
4633,0,7530,3680,3850,0,0,0,1.0,1,1.0,1,1.0,1,0.16433147999757033,66
4634,0,7530,3680,3850,0,0,0,1.0,1,1.0,1,1.0,1,0.16433147999757033,66
4635,0,7530,3680,3850,0,0,0,1.0,1,1.0,1,1.0,1,0.16484180020709857,66
4636,0,7530,3680,3850,0,0,0,1.0,1,1.0,1,1.0,1,0.16484180020709857,66
4637,2,7532,3680,3852,0,0,0,1.0,1,1.0,1,1.0,1,0.1441656747577611,68
4638,0,7532,3680,3852,0,0,0,1.0,1,1.0,1,1.0,1,0.1441656747577611,68
4639,1,7533,3681,3852,0,0,0,1.0,1,1.0,1,1.0,1,0.15353513818551087,69
4640,0,7533,3681,3852,0,0,0,1.0,1,1.0,1,1.0,1,0.15353513818551087,69
4641,4,7537,3682,3855,0,0,0,1.0,1,1.0,1,1.0,1,0.13460927747465243,70
4642,1,7538,3682,3856,0,0,0,1.0,1,1.0,1,1.0,1,0.1352106074852065,69
4643,1,7539,3683,3856,0,0,0,1.0,1,1.0,1,1.0,1,0.15250270007536368,70
4644,1,7540,3684,3856,0,0,0,1.0,1,1.0,1,1.0,1,0.1844265659664789,69
4645,1,7541,3685,3856,0,0,0,1.0,1,1.0,1,1.0,1,0.19344579247959703,70
4646,1,7542,3686,3856,0,0,0,1.0,1,1.0,1,1.0,1,0.22960772783380584,68
4647,3,7545,3688,3857,0,0,0,1.0,1,1.0,1,1.0,1,0.23681344050764724,68
4648,3,7548,3688,3860,0,0,0,1.0,1,1.0,1,1.0,1,0.23896547549419558,67
4649,3,7551,3689,3862,0,0,0,1.0,1,1.0,1,1.0,1,0.2558537698592867,67
4650,1,7552,3689,3863,0,0,0,1.0,1,1.0,1,1.0,1,0.22416776603879535,67
4651,3,7555,3691,3864,0,0,0,1.0,1,1.0,1,1.0,1,0.2429688285116688,68
4652,1,7556,3692,3864,0,0,0,1.0,1,1.0,1,1.0,1,0.2648072703834436,66
4653,1,7557,3693,3864,0,0,0,1.0,1,1.0,1,1.0,1,0.24016563524448692,64
4654,2,7559,3694,3865,0,0,0,1.0,1,1.0,1,1.0,1,0.2568398344898192,65
4655,1,7560,3694,3866,0,0,0,1.0,1,1.0,1,1.0,1,0.24413540000275405,64
4656,1,7561,3694,3867,0,0,0,1.0,1,1.0,1,1.0,1,0.2459343729142491,65
4657,1,7562,3695,3867,0,0,0,1.0,1,1.0,1,1.0,1,0.25378334260788904,66
4658,4,7566,3696,3870,0,0,0,1.0,1,1.0,1,1.0,1,0.2623684690774312,65
4659,0,7566,3696,3870,0,0,0,1.0,1,1.0,1,1.0,1,0.2623684690774312,65
4660,3,7569,3698,3871,0,0,0,1.0,1,1.0,1,1.0,1,0.2827663965171301,66
4661,2,7571,3698,3873,0,0,0,1.0,1,1.0,1,1.0,1,0.2853408740764193,66
4662,3,7574,3699,3875,0,0,0,1.0,1,1.0,1,1.0,1,0.27033841657555724,68
4663,3,7577,3699,3878,0,0,0,1.0,1,1.0,1,1.0,1,0.24537151622673434,67
4664,4,7581,3700,3881,0,0,0,1.0,1,1.0,1,1.0,1,0.21855861836518178,67
4665,1,7582,3701,3881,0,0,0,1.0,1,1.0,1,1.0,1,0.21283858150525659,67
4666,0,7582,3701,3881,0,0,0,1.0,1,1.0,1,1.0,1,0.23045816097768557,67
4667,1,7583,3702,3881,0,0,0,1.0,1,1.0,1,1.0,1,0.23461896557772177,66
4668,1,7584,3703,3881,0,0,0,1.0,1,1.0,1,1.0,1,0.2361313903948597,66
4669,4,7588,3705,3883,0,0,0,1.0,1,1.0,1,1.0,1,0.24536643048700763,66
4670,1,7589,3706,3883,0,0,0,1.0,1,1.0,1,1.0,1,0.2763769053105878,64
4671,1,7590,3706,3884,0,0,0,1.0,1,1.0,1,1.0,1,0.2711994391336719,64
4672,3,7593,3708,3885,0,0,0,1.0,1,1.0,1,1.0,1,0.2942278410322362,64
4673,2,7595,3708,3887,0,0,0,1.0,1,1.0,1,1.0,1,0.28073247956787223,65
4674,3,7598,3710,3888,0,0,0,1.0,1,1.0,1,1.0,1,0.28416437159406216,66
4675,3,7601,3710,3891,0,0,0,1.0,1,1.0,1,1.0,1,0.2522971961607426,65
4676,1,7602,3710,3892,0,0,0,1.0,1,1.0,1,1.0,1,0.2503976290077942,65
4677,2,7604,3712,3892,0,0,0,1.0,1,1.0,1,1.0,1,0.2531887414021392,65
4678,0,7604,3712,3892,0,0,0,1.0,1,1.0,1,1.0,1,0.2640057178952105,64
4679,2,7606,3713,3893,0,0,0,1.0,1,1.0,1,1.0,1,0.25086038891540047,66
4680,2,7608,3713,3895,0,0,0,1.0,1,1.0,1,1.0,1,0.24720982509188336,67
4681,2,7610,3714,3896,0,0,0,1.0,1,1.0,1,1.0,1,0.23884903782784228,67
4682,2,7612,3716,3896,0,0,0,1.0,1,1.0,1,1.0,1,0.2475418524232985,67
4683,4,7616,3717,3899,0,0,0,1.0,1,1.0,1,1.0,1,0.2218025721991343,67
4684,0,7616,3717,3899,0,0,0,1.0,1,1.0,1,1.0,1,0.21287139983024267,66
4685,1,7617,3717,3900,0,0,0,1.0,1,1.0,1,1.0,1,0.20335479985622315,65
4686,0,7617,3717,3900,0,0,0,1.0,1,1.0,1,1.0,1,0.21618756053240426,65
4687,1,7618,3717,3901,0,0,0,1.0,1,1.0,1,1.0,1,0.1953101239538221,65
4688,2,7620,3719,3901,0,0,0,1.0,1,1.0,1,1.0,1,0.2398132330265515,64
4689,5,7625,3721,3904,0,0,0,1.0,1,1.0,1,1.0,1,0.27129570212576376,65
4690,0,7625,3721,3904,0,0,0,1.0,1,1.0,1,1.0,1,0.29390445539916665,63
4691,5,7630,3724,3906,0,0,0,1.0,1,1.0,1,1.0,1,0.3070212559721906,64
4692,0,7630,3724,3906,0,0,0,1.0,1,1.0,1,1.0,1,0.2748644700124031,63
4693,2,7632,3724,3908,0,0,0,1.0,1,1.0,1,1.0,1,0.2631790564707229,64
4694,0,7632,3724,3908,0,0,0,1.0,1,1.0,1,1.0,1,0.24952403381989005,63
4695,0,7632,3724,3908,0,0,0,1.0,1,1.0,1,1.0,1,0.24868385208578672,62
4696,1,7633,3724,3909,0,0,0,1.0,1,1.0,1,1.0,1,0.23536051341103548,61
4697,3,7636,3725,3911,0,0,0,1.0,1,1.0,1,1.0,1,0.2060953491784454,63
4698,0,7636,3725,3911,0,0,0,1.0,1,1.0,1,1.0,1,0.2204177059125974,63
4699,1,7637,3725,3912,0,0,0,1.0,1,1.0,1,1.0,1,0.20406883259482075,65
4700,0,7637,3725,3912,0,0,0,1.0,1,1.0,1,1.0,1,0.21487375459833308,64
4701,0,7637,3725,3912,0,0,0,1.0,1,1.0,1,1.0,1,0.21487375459833308,64
4702,0,7637,3725,3912,0,0,0,1.0,1,1.0,1,1.0,1,0.22676236188193302,66
4703,1,7638,3726,3912,0,0,0,1.0,1,1.0,1,1.0,1,0.23046602747091532,65
4704,4,7642,3728,3914,0,0,0,1.0,1,1.0,1,1.0,1,0.21836333489088683,64
4705,6,7648,3730,3918,0,0,0,1.0,1,1.0,1,1.0,1,0.24159211581259277,65
4706,3,7651,3732,3919,0,0,0,1.0,1,1.0,1,1.0,1,0.24466931316803597,65
4707,4,7655,3733,3922,0,0,0,1.0,1,1.0,1,1.0,1,0.2337370873050133,63
4708,2,7657,3734,3923,0,0,0,1.0,1,1.0,1,1.0,1,0.22600687111991813,62
4709,3,7660,3736,3924,0,0,0,1.0,1,1.0,1,1.0,1,0.2520402244857391,61
4710,0,7660,3736,3924,0,0,0,1.0,1,1.0,1,1.0,1,0.25562369122377016,60
4711,2,7662,3738,3924,0,0,0,1.0,1,1.0,1,1.0,1,0.25310118385941677,59
4712,1,7663,3739,3924,0,0,0,1.0,1,1.0,1,1.0,1,0.2505678847469558,58
4713,3,7666,3741,3925,0,0,0,1.0,1,1.0,1,1.0,1,0.2494958768263044,58
4714,0,7666,3741,3925,0,0,0,1.0,1,1.0,1,1.0,1,0.24691548761376664,57
4715,1,7667,3741,3926,0,0,0,1.0,1,1.0,1,1.0,1,0.24784543957791222,57
4716,1,7668,3742,3926,0,0,0,1.0,1,1.0,1,1.0,1,0.2698325667263209,55
4717,3,7671,3742,3929,0,0,0,1.0,1,1.0,1,1.0,1,0.24560121260182272,57
4718,2,7673,3742,3931,0,0,0,1.0,1,1.0,1,1.0,1,0.2216734891214477,56
4719,4,7677,3743,3934,0,0,0,1.0,1,1.0,1,1.0,1,0.23086851339210687,56
4720,3,7680,3743,3937,0,0,0,1.0,1,1.0,1,1.0,1,0.20581119856917096,57
4721,0,7680,3743,3937,0,0,0,1.0,1,1.0,1,1.0,1,0.20581119856917096,57
4722,1,7681,3744,3937,0,0,0,1.0,1,1.0,1,1.0,1,0.1986478588618503,57
4723,1,7682,3745,3937,0,0,0,1.0,1,1.0,1,1.0,1,0.21526892585354973,57
4724,0,7682,3745,3937,0,0,0,1.0,1,1.0,1,1.0,1,0.2168660420615454,57
4725,1,7683,3746,3937,0,0,0,1.0,1,1.0,1,1.0,1,0.2684229571785976,57
4726,1,7684,3747,3937,0,0,0,1.0,1,1.0,1,1.0,1,0.2797296412253405,57
4727,1,7685,3747,3938,0,0,0,1.0,1,1.0,1,1.0,1,0.2763918123499758,56
4728,1,7686,3747,3939,0,0,0,1.0,1,1.0,1,1.0,1,0.2801749251535442,57
4729,1,7687,3747,3940,0,0,0,1.0,1,1.0,1,1.0,1,0.2796088857664337,56
4730,1,7688,3748,3940,0,0,0,1.0,1,1.0,1,1.0,1,0.2994498146426111,54
4731,2,7690,3749,3941,0,0,0,1.0,1,1.0,1,1.0,1,0.28938135390282876,54
4732,3,7693,3752,3941,0,0,0,1.0,1,1.0,1,1.0,1,0.35076211529361295,54
4733,5,7698,3753,3945,0,0,0,1.0,1,1.0,1,1.0,1,0.3281952537361887,55
4734,2,7700,3754,3946,0,0,0,1.0,1,1.0,1,1.0,1,0.3366984083776192,56
4735,2,7702,3755,3947,0,0,0,1.0,1,1.0,1,1.0,1,0.343675525324497,56
4736,0,7702,3755,3947,0,0,0,1.0,1,1.0,1,1.0,1,0.34221045947140627,58
4737,2,7704,3755,3949,0,0,0,1.0,1,1.0,1,1.0,1,0.31107718295924613,59
4738,3,7707,3758,3949,0,0,0,1.0,1,1.0,1,1.0,1,0.36085503070676067,60
4739,2,7709,3758,3951,0,0,0,1.0,1,1.0,1,1.0,1,0.3321539400179345,60
4740,0,7709,3758,3951,0,0,0,1.0,1,1.0,1,1.0,1,0.3321539400179345,60
4741,0,7709,3758,3951,0,0,0,1.0,1,1.0,1,1.0,1,0.3402530060217489,61
4742,2,7711,3759,3952,0,0,0,1.0,1,1.0,1,1.0,1,0.3292848463151115,61
4743,1,7712,3759,3953,0,0,0,1.0,1,1.0,1,1.0,1,0.31304022108107077,60
4744,3,7715,3761,3954,0,0,0,1.0,1,1.0,1,1.0,1,0.31582268400186103,60
4745,3,7718,3762,3956,0,0,0,1.0,1,1.0,1,1.0,1,0.29694480148521113,59
4746,2,7720,3764,3956,0,0,0,1.0,1,1.0,1,1.0,1,0.32395662299267114,59
4747,2,7722,3765,3957,0,0,0,1.0,1,1.0,1,1.0,1,0.2740331361047298,58
4748,2,7724,3766,3958,0,0,0,1.0,1,1.0,1,1.0,1,0.24722517140265157,58
4749,2,7726,3767,3959,0,0,0,1.0,1,1.0,1,1.0,1,0.24401122454414267,58
4750,2,7728,3768,3960,0,0,0,1.0,1,1.0,1,1.0,1,0.2239209709262057,56
4751,7,7735,3771,3964,0,0,0,1.0,1,1.0,1,1.0,1,0.23139516411015112,58
4752,1,7736,3772,3964,0,0,0,1.0,1,1.0,1,1.0,1,0.23549181246172995,55
4753,2,7738,3773,3965,0,0,0,1.0,1,1.0,1,1.0,1,0.2176471923521221,55
4754,0,7738,3773,3965,0,0,0,1.0,1,1.0,1,1.0,1,0.21987298375991107,54
4755,1,7739,3774,3965,0,0,0,1.0,1,1.0,1,1.0,1,0.22524014679382087,54
4756,3,7742,3776,3966,0,0,0,1.0,1,1.0,1,1.0,1,0.24077052382868191,54
4757,0,7742,3776,3966,0,0,0,1.0,1,1.0,1,1.0,1,0.22715720770678524,53
4758,0,7742,3776,3966,0,0,0,1.0,1,1.0,1,1.0,1,0.22715720770678524,53
4759,1,7743,3776,3967,0,0,0,1.0,1,1.0,1,1.0,1,0.2101848546930641,53
4760,1,7744,3777,3967,0,0,0,1.0,1,1.0,1,1.0,1,0.2546213241025641,53
4761,4,7748,3779,3969,0,0,0,1.0,1,1.0,1,1.0,1,0.26419067245546046,52
4762,4,7752,3779,3973,0,0,0,1.0,1,1.0,1,1.0,1,0.2146283078725155,54
4763,3,7755,3780,3975,0,0,0,1.0,1,1.0,1,1.0,1,0.20534111282295833,54
4764,1,7756,3781,3975,0,0,0,1.0,1,1.0,1,1.0,1,0.21913540115768773,55
4765,3,7759,3784,3975,0,0,0,1.0,1,1.0,1,1.0,1,0.29748455388247846,56
4766,3,7762,3785,3977,0,0,0,1.0,1,1.0,1,1.0,1,0.2725568427687734,58
4767,5,7767,3786,3981,0,0,0,1.0,1,1.0,1,1.0,1,0.22549430283608532,59
4768,5,7772,3788,3984,0,0,0,1.0,1,1.0,1,1.0,1,0.2073712376419188,60
4769,0,7772,3788,3984,0,0,0,1.0,1,1.0,1,1.0,1,0.2131542468897852,59
4770,1,7773,3788,3985,0,0,0,1.0,1,1.0,1,1.0,1,0.21118620961139103,60
4771,2,7775,3788,3987,0,0,0,1.0,1,1.0,1,1.0,1,0.22317345426738697,59
4772,0,7775,3788,3987,0,0,0,1.0,1,1.0,1,1.0,1,0.22317345426738697,59
4773,0,7775,3788,3987,0,0,0,1.0,1,1.0,1,1.0,1,0.20574786056163996,60
4774,0,7775,3788,3987,0,0,0,1.0,1,1.0,1,1.0,1,0.20574786056163996,60
4775,0,7775,3788,3987,0,0,0,1.0,1,1.0,1,1.0,1,0.2088446263620128,62
4776,1,7776,3788,3988,0,0,0,1.0,1,1.0,1,1.0,1,0.1833462306900705,63
4777,1,7777,3788,3989,0,0,0,1.0,1,1.0,1,1.0,1,0.17286366113608947,63
4778,1,7778,3789,3989,0,0,0,1.0,1,1.0,1,1.0,1,0.1723231970280848,63
4779,0,7778,3789,3989,0,0,0,1.0,1,1.0,1,1.0,1,0.1723231970280848,63
4780,1,7779,3790,3989,0,0,0,1.0,1,1.0,1,1.0,1,0.17674558069460014,65
4781,1,7780,3790,3990,0,0,0,1.0,1,1.0,1,1.0,1,0.18975016213371626,64
4782,1,7781,3790,3991,0,0,0,1.0,1,1.0,1,1.0,1,0.191317925542504,65
4783,3,7784,3792,3992,0,0,0,1.0,1,1.0,1,1.0,1,0.19347923314527493,66
4784,4,7788,3795,3993,0,0,0,1.0,1,1.0,1,1.0,1,0.17493280579366183,64
4785,5,7793,3797,3996,0,0,0,1.0,1,1.0,1,1.0,1,0.1764542679893436,65
4786,3,7796,3799,3997,0,0,0,1.0,1,1.0,1,1.0,1,0.21891114976917345,66
4787,5,7801,3801,4000,0,0,0,1.0,1,1.0,1,1.0,1,0.1514291565586604,63
4788,5,7806,3804,4002,0,0,0,1.0,1,1.0,1,1.0,1,0.15646285522905035,63
4789,4,7810,3807,4003,0,0,0,1.0,1,1.0,1,1.0,1,0.1737951321354723,60
4790,6,7816,3810,4006,0,0,0,1.0,1,1.0,1,1.0,1,0.1451436424572939,61
4791,5,7821,3814,4007,0,0,0,1.0,1,1.0,1,1.0,1,0.16356598480574996,59
4792,2,7823,3816,4007,0,0,0,1.0,1,1.0,1,1.0,1,0.16796968162898923,59
4793,2,7825,3816,4009,0,0,0,1.0,1,1.0,1,1.0,1,0.14862491351307253,61
4794,3,7828,3818,4010,0,0,0,1.0,1,1.0,1,1.0,1,0.1472626959458822,60
4795,3,7831,3819,4012,0,0,0,1.0,1,1.0,1,1.0,1,0.10986023258386249,61
4796,2,7833,3821,4012,0,0,0,1.0,1,1.0,1,1.0,1,0.13759877022420286,60
4797,4,7837,3822,4015,0,0,0,1.0,1,1.0,1,1.0,1,0.11549862550633118,61
4798,2,7839,3823,4016,0,0,0,1.0,1,1.0,1,1.0,1,0.13263481181461664,61
4799,3,7842,3823,4019,0,0,0,1.0,1,1.0,1,1.0,1,0.12567892888433008,59
4800,1,7843,3823,4020,0,0,0,1.0,1,1.0,1,1.0,1,0.12036097535319693,57
4801,0,7843,3823,4020,0,0,0,1.0,1,1.0,1,1.0,1,0.12440176293571158,58
4802,0,7843,3823,4020,0,0,0,1.0,1,1.0,1,1.0,1,0.12874931979522833,56
4803,1,7844,3824,4020,0,0,0,1.0,1,1.0,1,1.0,1,0.14056172170605324,57
4804,0,7844,3824,4020,0,0,0,1.0,1,1.0,1,1.0,1,0.1266258594898608,55
4805,1,7845,3825,4020,0,0,0,1.0,1,1.0,1,1.0,1,0.12051115728472774,56
4806,0,7845,3825,4020,0,0,0,1.0,1,1.0,1,1.0,1,0.12826381358448224,55
4807,1,7846,3825,4021,0,0,0,1.0,1,1.0,1,1.0,1,0.1381843787278893,53
4808,2,7848,3826,4022,0,0,0,1.0,1,1.0,1,1.0,1,0.14406870805080096,54
4809,0,7848,3826,4022,0,0,0,1.0,1,1.0,1,1.0,1,0.16760190459305896,53
4810,1,7849,3827,4022,0,0,0,1.0,1,1.0,1,1.0,1,0.1620512457291518,53
4811,1,7850,3827,4023,0,0,0,1.0,1,1.0,1,1.0,1,0.14564880853759843,54
4812,3,7853,3829,4024,0,0,0,1.0,1,1.0,1,1.0,1,0.13119712906903064,54
4813,0,7853,3829,4024,0,0,0,1.0,1,1.0,1,1.0,1,0.12971345701478806,55
4814,2,7855,3831,4024,0,0,0,1.0,1,1.0,1,1.0,1,0.16661959812721075,55
4815,4,7859,3831,4028,0,0,0,1.0,1,1.0,1,1.0,1,0.10907598195279863,56
4816,3,7862,3834,4028,0,0,0,1.0,1,1.0,1,1.0,1,0.16729364247077355,56
4817,3,7865,3836,4029,0,0,0,1.0,1,1.0,1,1.0,1,0.21461626870370612,58
4818,3,7868,3838,4030,0,0,0,1.0,1,1.0,1,1.0,1,0.2618089134227162,58
4819,5,7873,3839,4034,0,0,0,1.0,1,1.0,1,1.0,1,0.22208763968856404,58
4820,2,7875,3839,4036,0,0,0,1.0,1,1.0,1,1.0,1,0.2176649934001364,58
4821,4,7879,3839,4040,0,0,0,1.0,1,1.0,1,1.0,1,0.16962972673858473,58
4822,1,7880,3840,4040,0,0,0,1.0,1,1.0,1,1.0,1,0.1842724181129824,58
4823,2,7882,3841,4041,0,0,0,1.0,1,1.0,1,1.0,1,0.1889341600490653,57
4824,0,7882,3841,4041,0,0,0,1.0,1,1.0,1,1.0,1,0.18740679975898042,56
4825,3,7885,3841,4044,0,0,0,1.0,1,1.0,1,1.0,1,0.17254940433617008,57
4826,0,7885,3841,4044,0,0,0,1.0,1,1.0,1,1.0,1,0.17254940433617008,57
4827,2,7887,3841,4046,0,0,0,1.0,1,1.0,1,1.0,1,0.17255691563238434,56
4828,1,7888,3842,4046,0,0,0,1.0,1,1.0,1,1.0,1,0.15972807204299655,57
4829,1,7889,3843,4046,0,0,0,1.0,1,1.0,1,1.0,1,0.18582826160466795,56
4830,1,7890,3844,4046,0,0,0,1.0,1,1.0,1,1.0,1,0.17795858296658484,57
4831,2,7892,3846,4046,0,0,0,1.0,1,1.0,1,1.0,1,0.2320589271383084,57
4832,0,7892,3846,4046,0,0,0,1.0,1,1.0,1,1.0,1,0.23887935988033177,55
4833,2,7894,3848,4046,0,0,0,1.0,1,1.0,1,1.0,1,0.27359865837047737,55
4834,3,7897,3849,4048,0,0,0,1.0,1,1.0,1,1.0,1,0.26056440357041155,55
4835,3,7900,3849,4051,0,0,0,1.0,1,1.0,1,1.0,1,0.23368702789361365,55
4836,1,7901,3849,4052,0,0,0,1.0,1,1.0,1,1.0,1,0.2156807256202003,55
4837,1,7902,3850,4052,0,0,0,1.0,1,1.0,1,1.0,1,0.19090544879081567,53
4838,3,7905,3851,4054,0,0,0,1.0,1,1.0,1,1.0,1,0.18063430777874245,54
4839,5,7910,3854,4056,0,0,0,1.0,1,1.0,1,1.0,1,0.17362968247691205,53
4840,2,7912,3855,4057,0,0,0,1.0,1,1.0,1,1.0,1,0.19824481654134277,52
4841,3,7915,3856,4059,0,0,0,1.0,1,1.0,1,1.0,1,0.1669348182207475,51
4842,2,7917,3858,4059,0,0,0,1.0,1,1.0,1,1.0,1,0.19685684083745972,50
4843,2,7919,3860,4059,0,0,0,1.0,1,1.0,1,1.0,1,0.2432095046137583,51
4844,1,7920,3860,4060,0,0,0,1.0,1,1.0,1,1.0,1,0.21383314620290708,50
4845,1,7921,3861,4060,0,0,0,1.0,1,1.0,1,1.0,1,0.25135781458645473,49
4846,2,7923,3863,4060,0,0,0,1.0,1,1.0,1,1.0,1,0.2725081438122923,49
4847,6,7929,3863,4066,0,0,0,1.0,1,1.0,1,1.0,1,0.18107735480152495,48
4848,1,7930,3864,4066,0,0,0,1.0,1,1.0,1,1.0,1,0.18432472773840755,48
4849,0,7930,3864,4066,0,0,0,1.0,1,1.0,1,1.0,1,0.1672187930757385,48
4850,1,7931,3865,4066,0,0,0,1.0,1,1.0,1,1.0,1,0.194484023298764,49
4851,0,7931,3865,4066,0,0,0,1.0,1,1.0,1,1.0,1,0.17411715511212278,49
4852,1,7932,3865,4067,0,0,0,1.0,1,1.0,1,1.0,1,0.19132323222190165,49
4853,0,7932,3865,4067,0,0,0,1.0,1,1.0,1,1.0,1,0.18891471875715474,50
4854,1,7933,3866,4067,0,0,0,1.0,1,1.0,1,1.0,1,0.20140643941481923,51
4855,1,7934,3866,4068,0,0,0,1.0,1,1.0,1,1.0,1,0.18347868255167984,51
4856,0,7934,3866,4068,0,0,0,1.0,1,1.0,1,1.0,1,0.17688444323778754,50
4857,0,7934,3866,4068,0,0,0,1.0,1,1.0,1,1.0,1,0.17991509252295024,51
4858,0,7934,3866,4068,0,0,0,1.0,1,1.0,1,1.0,1,0.18585076325572147,51
4859,1,7935,3866,4069,0,0,0,1.0,1,1.0,1,1.0,1,0.19463696630030355,52
4860,0,7935,3866,4069,0,0,0,1.0,1,1.0,1,1.0,1,0.19463696630030355,52
4861,3,7938,3866,4072,0,0,0,1.0,1,1.0,1,1.0,1,0.17780456811340525,53
4862,2,7940,3868,4072,0,0,0,1.0,1,1.0,1,1.0,1,0.2196391336900581,53
4863,2,7942,3868,4074,0,0,0,1.0,1,1.0,1,1.0,1,0.1566790954064828,51
4864,2,7944,3869,4075,0,0,0,1.0,1,1.0,1,1.0,1,0.17986267584201693,53
4865,1,7945,3869,4076,0,0,0,1.0,1,1.0,1,1.0,1,0.1586347243469795,52
4866,1,7946,3870,4076,0,0,0,1.0,1,1.0,1,1.0,1,0.20013331108060434,53
4867,1,7947,3871,4076,0,0,0,1.0,1,1.0,1,1.0,1,0.16687654989453804,51
4868,3,7950,3873,4077,0,0,0,1.0,1,1.0,1,1.0,1,0.15380703828970252,53
4869,1,7951,3873,4078,0,0,0,1.0,1,1.0,1,1.0,1,0.13298785602142277,53
4870,2,7953,3875,4078,0,0,0,1.0,1,1.0,1,1.0,1,0.1538263097659577,55
4871,1,7954,3876,4078,0,0,0,1.0,1,1.0,1,1.0,1,0.17006660253003966,55
4872,3,7957,3878,4079,0,0,0,1.0,1,1.0,1,1.0,1,0.1927404114325702,56
4873,4,7961,3878,4083,0,0,0,1.0,1,1.0,1,1.0,1,0.14304765278036888,56
4874,1,7962,3879,4083,0,0,0,1.0,1,1.0,1,1.0,1,0.16466216168916165,58
4875,5,7967,3880,4087,0,0,0,1.0,1,1.0,1,1.0,1,0.12286108058419436,56
4876,1,7968,3880,4088,0,0,0,1.0,1,1.0,1,1.0,1,0.1273422450941726,56
4877,2,7970,3882,4088,0,0,0,1.0,1,1.0,1,1.0,1,0.14623124416318112,54
4878,6,7976,3884,4092,0,0,0,1.0,1,1.0,1,1.0,1,0.14152418091245939,54
4879,6,7982,3888,4094,0,0,0,1.0,1,1.0,1,1.0,1,0.175239438848867,54
4880,1,7983,3888,4095,0,0,0,1.0,1,1.0,1,1.0,1,0.1589186824155781,53
4881,0,7983,3888,4095,0,0,0,1.0,1,1.0,1,1.0,1,0.16621193788594962,54
4882,0,7983,3888,4095,0,0,0,1.0,1,1.0,1,1.0,1,0.15384445996817497,52
4883,1,7984,3889,4095,0,0,0,1.0,1,1.0,1,1.0,1,0.17696020462759865,54
4884,0,7984,3889,4095,0,0,0,1.0,1,1.0,1,1.0,1,0.17404994593832884,52
4885,1,7985,3890,4095,0,0,0,1.0,1,1.0,1,1.0,1,0.21305618173523727,51
4886,0,7985,3890,4095,0,0,0,1.0,1,1.0,1,1.0,1,0.21568733569404144,50
4887,0,7985,3890,4095,0,0,0,1.0,1,1.0,1,1.0,1,0.23956864712863324,49
4888,0,7985,3890,4095,0,0,0,1.0,1,1.0,1,1.0,1,0.24430546745891066,48
4889,0,7985,3890,4095,0,0,0,1.0,1,1.0,1,1.0,1,0.24430546745891066,48
4890,0,7985,3890,4095,0,0,0,1.0,1,1.0,1,1.0,1,0.24430546745891066,48
4891,2,7987,3892,4095,0,0,0,1.0,1,1.0,1,1.0,1,0.27197766507042725,49
4892,1,7988,3892,4096,0,0,0,1.0,1,1.0,1,1.0,1,0.2865994986718681,51
4893,1,7989,3892,4097,0,0,0,1.0,1,1.0,1,1.0,1,0.28462733239435295,51
4894,1,7990,3892,4098,0,0,0,1.0,1,1.0,1,1.0,1,0.2660017980901186,52
4895,1,7991,3892,4099,0,0,0,1.0,1,1.0,1,1.0,1,0.2512459007981996,52
4896,2,7993,3893,4100,0,0,0,1.0,1,1.0,1,1.0,1,0.22916213610722694,51
4897,0,7993,3893,4100,0,0,0,1.0,1,1.0,1,1.0,1,0.2249109430237637,52
4898,2,7995,3895,4100,0,0,0,1.0,1,1.0,1,1.0,1,0.218113906637905,52
4899,1,7996,3895,4101,0,0,0,1.0,1,1.0,1,1.0,1,0.1964246642100314,53
4900,3,7999,3897,4102,0,0,0,1.0,1,1.0,1,1.0,1,0.15360294916434616,54
4901,4,8003,3899,4104,0,0,0,1.0,1,1.0,1,1.0,1,0.16583991664354697,54
4902,1,8004,3900,4104,0,0,0,1.0,1,1.0,1,1.0,1,0.17685017741591968,55
4903,2,8006,3901,4105,0,0,0,1.0,1,1.0,1,1.0,1,0.2037089115682745,56
4904,4,8010,3902,4108,0,0,0,1.0,1,1.0,1,1.0,1,0.19291610665540418,55
4905,0,8010,3902,4108,0,0,0,1.0,1,1.0,1,1.0,1,0.19312176823411698,54
4906,2,8012,3903,4109,0,0,0,1.0,1,1.0,1,1.0,1,0.20554249238593064,54
4907,2,8014,3903,4111,0,0,0,1.0,1,1.0,1,1.0,1,0.18110049259206665,54
4908,1,8015,3903,4112,0,0,0,1.0,1,1.0,1,1.0,1,0.16635897007087966,53
4909,2,8017,3904,4113,0,0,0,1.0,1,1.0,1,1.0,1,0.19551270600461376,54
4910,1,8018,3904,4114,0,0,0,1.0,1,1.0,1,1.0,1,0.18705030642536838,55
4911,5,8023,3906,4117,0,0,0,1.0,1,1.0,1,1.0,1,0.18201241211727445,57
4912,1,8024,3906,4118,0,0,0,1.0,1,1.0,1,1.0,1,0.1654319719453264,57
4913,3,8027,3907,4120,0,0,0,1.0,1,1.0,1,1.0,1,0.1226657667403019,56
4914,1,8028,3908,4120,0,0,0,1.0,1,1.0,1,1.0,1,0.1462747965178341,56
4915,3,8031,3910,4121,0,0,0,1.0,1,1.0,1,1.0,1,0.15857237182541206,56
4916,0,8031,3910,4121,0,0,0,1.0,1,1.0,1,1.0,1,0.1631396623678103,54
4917,3,8034,3910,4124,0,0,0,1.0,1,1.0,1,1.0,1,0.1228911772507138,53
4918,0,8034,3910,4124,0,0,0,1.0,1,1.0,1,1.0,1,0.14201658784033114,52
4919,0,8034,3910,4124,0,0,0,1.0,1,1.0,1,1.0,1,0.1726411317143386,49
4920,0,8034,3910,4124,0,0,0,1.0,1,1.0,1,1.0,1,0.1726411317143386,49
4921,2,8036,3912,4124,0,0,0,1.0,1,1.0,1,1.0,1,0.24279933387909672,50
4922,0,8036,3912,4124,0,0,0,1.0,1,1.0,1,1.0,1,0.24279933387909672,50
4923,2,8038,3914,4124,0,0,0,1.0,1,1.0,1,1.0,1,0.24636039967833365,52
4924,2,8040,3915,4125,0,0,0,1.0,1,1.0,1,1.0,1,0.25500291288235155,53
4925,3,8043,3916,4127,0,0,0,1.0,1,1.0,1,1.0,1,0.19533096100997913,54
4926,1,8044,3916,4128,0,0,0,1.0,1,1.0,1,1.0,1,0.18340610555808903,54
4927,2,8046,3918,4128,0,0,0,1.0,1,1.0,1,1.0,1,0.1955714239526124,54
4928,0,8046,3918,4128,0,0,0,1.0,1,1.0,1,1.0,1,0.1955714239526124,54
4929,1,8047,3918,4129,0,0,0,1.0,1,1.0,1,1.0,1,0.17502979481640063,55
4930,2,8049,3919,4130,0,0,0,1.0,1,1.0,1,1.0,1,0.18637628572847018,58
4931,0,8049,3919,4130,0,0,0,1.0,1,1.0,1,1.0,1,0.18637628572847018,58
4932,1,8050,3919,4131,0,0,0,1.0,1,1.0,1,1.0,1,0.19021289639345546,59
4933,0,8050,3919,4131,0,0,0,1.0,1,1.0,1,1.0,1,0.19021289639345546,59
4934,0,8050,3919,4131,0,0,0,1.0,1,1.0,1,1.0,1,0.19021289639345546,59
4935,1,8051,3919,4132,0,0,0,1.0,1,1.0,1,1.0,1,0.17320051455933427,59
4936,1,8052,3920,4132,0,0,0,1.0,1,1.0,1,1.0,1,0.19924438010270734,59
4937,2,8054,3920,4134,0,0,0,1.0,1,1.0,1,1.0,1,0.18272671060274645,61
4938,0,8054,3920,4134,0,0,0,1.0,1,1.0,1,1.0,1,0.19231053308063514,62
4939,1,8055,3920,4135,0,0,0,1.0,1,1.0,1,1.0,1,0.16825933334657936,63
4940,3,8058,3920,4138,0,0,0,1.0,1,1.0,1,1.0,1,0.17611619674380774,65
4941,1,8059,3921,4138,0,0,0,1.0,1,1.0,1,1.0,1,0.18741169014408798,65
4942,4,8063,3923,4140,0,0,0,1.0,1,1.0,1,1.0,1,0.19017820547773026,67
4943,4,8067,3924,4143,0,0,0,1.0,1,1.0,1,1.0,1,0.16578898834637681,66
4944,3,8070,3927,4143,0,0,0,1.0,1,1.0,1,1.0,1,0.21343382329536964,63
4945,6,8076,3928,4148,0,0,0,1.0,1,1.0,1,1.0,1,0.13314474085404215,61
4946,2,8078,3930,4148,0,0,0,1.0,1,1.0,1,1.0,1,0.17451642072652718,60
4947,0,8078,3930,4148,0,0,0,1.0,1,1.0,1,1.0,1,0.15440810464656002,58
4948,2,8080,3931,4149,0,0,0,1.0,1,1.0,1,1.0,1,0.1744109748643619,57
4949,2,8082,3933,4149,0,0,0,1.0,1,1.0,1,1.0,1,0.17666482942115727,56
4950,3,8085,3935,4150,0,0,0,1.0,1,1.0,1,1.0,1,0.17299386456177224,57
4951,4,8089,3937,4152,0,0,0,1.0,1,1.0,1,1.0,1,0.19041343038376574,55
4952,4,8093,3941,4152,0,0,0,1.0,1,1.0,1,1.0,1,0.23943699645762484,55
4953,5,8098,3943,4155,0,0,0,1.0,1,1.0,1,1.0,1,0.202598967270622,54
4954,2,8100,3944,4156,0,0,0,1.0,1,1.0,1,1.0,1,0.20785184800464834,54
4955,1,8101,3944,4157,0,0,0,1.0,1,1.0,1,1.0,1,0.1616878577879537,52
4956,0,8101,3944,4157,0,0,0,1.0,1,1.0,1,1.0,1,0.1616878577879537,52
4957,1,8102,3945,4157,0,0,0,1.0,1,1.0,1,1.0,1,0.14453264945662633,53
4958,1,8103,3946,4157,0,0,0,1.0,1,1.0,1,1.0,1,0.15962399749582773,52
4959,3,8106,3947,4159,0,0,0,1.0,1,1.0,1,1.0,1,0.13576144687777417,51
4960,1,8107,3947,4160,0,0,0,1.0,1,1.0,1,1.0,1,0.13328280208963975,53
4961,0,8107,3947,4160,0,0,0,1.0,1,1.0,1,1.0,1,0.13328280208963975,53
4962,1,8108,3947,4161,0,0,0,1.0,1,1.0,1,1.0,1,0.14386442208769434,55
4963,0,8108,3947,4161,0,0,0,1.0,1,1.0,1,1.0,1,0.12595172135470653,54
4964,1,8109,3948,4161,0,0,0,1.0,1,1.0,1,1.0,1,0.13052857361219844,54
4965,0,8109,3948,4161,0,0,0,1.0,1,1.0,1,1.0,1,0.13052857361219844,54
4966,1,8110,3949,4161,0,0,0,1.0,1,1.0,1,1.0,1,0.13201102134107698,54
4967,2,8112,3951,4161,0,0,0,1.0,1,1.0,1,1.0,1,0.14714345496420428,55
4968,3,8115,3953,4162,0,0,0,1.0,1,1.0,1,1.0,1,0.13492035585931605,55
4969,2,8117,3954,4163,0,0,0,1.0,1,1.0,1,1.0,1,0.16552763352961494,57
4970,1,8118,3955,4163,0,0,0,1.0,1,1.0,1,1.0,1,0.1968051916955225,56
4971,4,8122,3956,4166,0,0,0,1.0,1,1.0,1,1.0,1,0.1667334123810867,57
4972,6,8128,3958,4170,0,0,0,1.0,1,1.0,1,1.0,1,0.18763366361918704,57
4973,0,8128,3958,4170,0,0,0,1.0,1,1.0,1,1.0,1,0.1838960883997916,60
4974,1,8129,3958,4171,0,0,0,1.0,1,1.0,1,1.0,1,0.1773589507768459,58
4975,2,8131,3959,4172,0,0,0,1.0,1,1.0,1,1.0,1,0.18251274846877608,59
4976,1,8132,3960,4172,0,0,0,1.0,1,1.0,1,1.0,1,0.18213136154698006,59
4977,5,8137,3965,4172,0,0,0,1.0,1,1.0,1,1.0,1,0.2043764514176552,59
4978,1,8138,3966,4172,0,0,0,1.0,1,1.0,1,1.0,1,0.20920571825959244,59
4979,3,8141,3966,4175,0,0,0,1.0,1,1.0,1,1.0,1,0.17525431460408875,61
4980,2,8143,3967,4176,0,0,0,1.0,1,1.0,1,1.0,1,0.19583480124597763,62
4981,3,8146,3968,4178,0,0,0,1.0,1,1.0,1,1.0,1,0.18471601059975287,62
4982,4,8150,3970,4180,0,0,0,1.0,1,1.0,1,1.0,1,0.16192787816133633,63
4983,2,8152,3971,4181,0,0,0,1.0,1,1.0,1,1.0,1,0.15818157755838796,63
4984,1,8153,3972,4181,0,0,0,1.0,1,1.0,1,1.0,1,0.17843274257310907,61
4985,1,8154,3972,4182,0,0,0,1.0,1,1.0,1,1.0,1,0.15703182247431835,59
4986,5,8159,3974,4185,0,0,0,1.0,1,1.0,1,1.0,1,0.17347441015405146,62
4987,1,8160,3974,4186,0,0,0,1.0,1,1.0,1,1.0,1,0.1449979944746505,60
4988,1,8161,3975,4186,0,0,0,1.0,1,1.0,1,1.0,1,0.15630946131406942,59
4989,5,8166,3977,4189,0,0,0,1.0,1,1.0,1,1.0,1,0.18765720410173722,57
4990,0,8166,3977,4189,0,0,0,1.0,1,1.0,1,1.0,1,0.21054163248025184,55
4991,5,8171,3981,4190,0,0,0,1.0,1,1.0,1,1.0,1,0.18836675542727624,54
4992,2,8173,3981,4192,0,0,0,1.0,1,1.0,1,1.0,1,0.17234118629930892,52
4993,0,8173,3981,4192,0,0,0,1.0,1,1.0,1,1.0,1,0.15538946542108661,51
4994,1,8174,3982,4192,0,0,0,1.0,1,1.0,1,1.0,1,0.2008581377361354,49
4995,3,8177,3984,4193,0,0,0,1.0,1,1.0,1,1.0,1,0.20158564629935008,48
4996,3,8180,3986,4194,0,0,0,1.0,1,1.0,1,1.0,1,0.18677613868882204,48
4997,1,8181,3987,4194,0,0,0,1.0,1,1.0,1,1.0,1,0.19292820921720935,46
4998,1,8182,3988,4194,0,0,0,1.0,1,1.0,1,1.0,1,0.2014235299436662,48
4999,7,8189,3990,4199,0,0,0,1.0,1,1.0,1,1.0,1,0.20139090899547754,48
5000,1,8190,3991,4199,0,0,0,1.0,1,1.0,1,1.0,1,0.18812286839280376,47
5001,1,8191,3992,4199,0,0,0,1.0,1,1.0,1,1.0,1,0.22707054384896624,45
5002,3,8194,3995,4199,0,0,0,1.0,1,1.0,1,1.0,1,0.2660203779361582,46
5003,1,8195,3995,4200,0,0,0,1.0,1,1.0,1,1.0,1,0.27474873139319894,46
5004,2,8197,3995,4202,0,0,0,1.0,1,1.0,1,1.0,1,0.23820874114934432,46
5005,0,8197,3995,4202,0,0,0,1.0,1,1.0,1,1.0,1,0.26101586972591484,45
5006,0,8197,3995,4202,0,0,0,1.0,1,1.0,1,1.0,1,0.2938964883377767,45
5007,2,8199,3995,4204,0,0,0,1.0,1,1.0,1,1.0,1,0.24057474345491772,46
5008,0,8199,3995,4204,0,0,0,1.0,1,1.0,1,1.0,1,0.2329148134319233,49
5009,0,8199,3995,4204,0,0,0,1.0,1,1.0,1,1.0,1,0.22582010472789943,49
5010,0,8199,3995,4204,0,0,0,1.0,1,1.0,1,1.0,1,0.2420550452486572,50
5011,0,8199,3995,4204,0,0,0,1.0,1,1.0,1,1.0,1,0.24976100395360026,51
5012,0,8199,3995,4204,0,0,0,1.0,1,1.0,1,1.0,1,0.2615048055317395,52
5013,0,8199,3995,4204,0,0,0,1.0,1,1.0,1,1.0,1,0.2615048055317395,52
5014,0,8199,3995,4204,0,0,0,1.0,1,1.0,1,1.0,1,0.2643181712323249,53
5015,3,8202,3996,4206,0,0,0,1.0,1,1.0,1,1.0,1,0.27216516360645066,54
5016,1,8203,3996,4207,0,0,0,1.0,1,1.0,1,1.0,1,0.2655905215305536,55
5017,1,8204,3996,4208,0,0,0,1.0,1,1.0,1,1.0,1,0.255594213396416,55
5018,1,8205,3996,4209,0,0,0,1.0,1,1.0,1,1.0,1,0.2569562280040928,56
5019,0,8205,3996,4209,0,0,0,1.0,1,1.0,1,1.0,1,0.2569562280040928,56
5020,1,8206,3997,4209,0,0,0,1.0,1,1.0,1,1.0,1,0.25345057441657265,55
5021,1,8207,3997,4210,0,0,0,1.0,1,1.0,1,1.0,1,0.2546168033796526,56
5022,3,8210,4000,4210,0,0,0,1.0,1,1.0,1,1.0,1,0.29172296328924013,56
5023,2,8212,4001,4211,0,0,0,1.0,1,1.0,1,1.0,1,0.2737688808965513,55
5024,4,8216,4005,4211,0,0,0,1.0,1,1.0,1,1.0,1,0.29510623609788084,55
5025,5,8221,4006,4215,0,0,0,1.0,1,1.0,1,1.0,1,0.24987676356424895,53
5026,3,8224,4009,4215,0,0,0,1.0,1,1.0,1,1.0,1,0.2688763473844804,52
5027,3,8227,4010,4217,0,0,0,1.0,1,1.0,1,1.0,1,0.2874756589522321,51
5028,4,8231,4012,4219,0,0,0,1.0,1,1.0,1,1.0,1,0.30782265571032497,51
5029,3,8234,4013,4221,0,0,0,1.0,1,1.0,1,1.0,1,0.30972240820807423,50
5030,2,8236,4015,4221,0,0,0,1.0,1,1.0,1,1.0,1,0.32111721929284626,49
5031,4,8240,4016,4224,0,0,0,1.0,1,1.0,1,1.0,1,0.278480764454043,49
5032,1,8241,4017,4224,0,0,0,1.0,1,1.0,1,1.0,1,0.2886566593337396,48
5033,5,8246,4020,4226,0,0,0,1.0,1,1.0,1,1.0,1,0.32817577359986677,50
5034,3,8249,4020,4229,0,0,0,1.0,1,1.0,1,1.0,1,0.27602958128418537,49
5035,4,8253,4022,4231,0,0,0,1.0,1,1.0,1,1.0,1,0.2795118073161665,49
5036,0,8253,4022,4231,0,0,0,1.0,1,1.0,1,1.0,1,0.2537908799197889,47
5037,3,8256,4023,4233,0,0,0,1.0,1,1.0,1,1.0,1,0.24143920478735117,47
5038,0,8256,4023,4233,0,0,0,1.0,1,1.0,1,1.0,1,0.24015834635122388,47
5039,0,8256,4023,4233,0,0,0,1.0,1,1.0,1,1.0,1,0.24855255408671606,48
5040,0,8256,4023,4233,0,0,0,1.0,1,1.0,1,1.0,1,0.24855255408671606,48
5041,0,8256,4023,4233,0,0,0,1.0,1,1.0,1,1.0,1,0.24855255408671606,48
5042,0,8256,4023,4233,0,0,0,1.0,1,1.0,1,1.0,1,0.24859736576254354,50
5043,1,8257,4024,4233,0,0,0,1.0,1,1.0,1,1.0,1,0.22890375954884223,51
5044,0,8257,4024,4233,0,0,0,1.0,1,1.0,1,1.0,1,0.22890375954884223,51
5045,0,8257,4024,4233,0,0,0,1.0,1,1.0,1,1.0,1,0.2426725725104491,52
5046,1,8258,4025,4233,0,0,0,1.0,1,1.0,1,1.0,1,0.264335113595126,51
5047,1,8259,4026,4233,0,0,0,1.0,1,1.0,1,1.0,1,0.2535443757877805,51
5048,2,8261,4027,4234,0,0,0,1.0,1,1.0,1,1.0,1,0.24010332693012562,52
5049,4,8265,4028,4237,0,0,0,1.0,1,1.0,1,1.0,1,0.25257562327408334,54
5050,0,8265,4028,4237,0,0,0,1.0,1,1.0,1,1.0,1,0.2743415239186547,56
5051,4,8269,4028,4241,0,0,0,1.0,1,1.0,1,1.0,1,0.2163937670778685,55
5052,0,8269,4028,4241,0,0,0,1.0,1,1.0,1,1.0,1,0.2163937670778685,55
5053,0,8269,4028,4241,0,0,0,1.0,1,1.0,1,1.0,1,0.2163937670778685,55
5054,2,8271,4030,4241,0,0,0,1.0,1,1.0,1,1.0,1,0.22858407942088263,55
5055,1,8272,4030,4242,0,0,0,1.0,1,1.0,1,1.0,1,0.22867428776254473,55
5056,3,8275,4031,4244,0,0,0,1.0,1,1.0,1,1.0,1,0.2222890430313748,56
5057,1,8276,4031,4245,0,0,0,1.0,1,1.0,1,1.0,1,0.21448885809052357,58
5058,0,8276,4031,4245,0,0,0,1.0,1,1.0,1,1.0,1,0.22363961971331622,59
5059,2,8278,4031,4247,0,0,0,1.0,1,1.0,1,1.0,1,0.20968413209183337,59
5060,1,8279,4031,4248,0,0,0,1.0,1,1.0,1,1.0,1,0.1991208617771636,59
5061,0,8279,4031,4248,0,0,0,1.0,1,1.0,1,1.0,1,0.21205948319313628,59
5062,6,8285,4034,4251,0,0,0,1.0,1,1.0,1,1.0,1,0.2583701939075659,59
5063,4,8289,4036,4253,0,0,0,1.0,1,1.0,1,1.0,1,0.26784679192280747,59
5064,5,8294,4040,4254,0,0,0,1.0,1,1.0,1,1.0,1,0.3253160033232526,57
5065,5,8299,4041,4258,0,0,0,1.0,1,1.0,1,1.0,1,0.26097548100035306,55
5066,2,8301,4042,4259,0,0,0,1.0,1,1.0,1,1.0,1,0.2751795733001539,55
5067,3,8304,4042,4262,0,0,0,1.0,1,1.0,1,1.0,1,0.23661364807839513,54
5068,1,8305,4042,4263,0,0,0,1.0,1,1.0,1,1.0,1,0.21047164434064936,54
5069,1,8306,4043,4263,0,0,0,1.0,1,1.0,1,1.0,1,0.2042460986574503,54
5070,3,8309,4044,4265,0,0,0,1.0,1,1.0,1,1.0,1,0.18708173508245213,52
5071,3,8312,4046,4266,0,0,0,1.0,1,1.0,1,1.0,1,0.21359456961429163,54
5072,0,8312,4046,4266,0,0,0,1.0,1,1.0,1,1.0,1,0.19088563401011727,52
5073,0,8312,4046,4266,0,0,0,1.0,1,1.0,1,1.0,1,0.2070719963749219,51
5074,1,8313,4046,4267,0,0,0,1.0,1,1.0,1,1.0,1,0.19097203141094227,52
5075,0,8313,4046,4267,0,0,0,1.0,1,1.0,1,1.0,1,0.20038470819599538,53
5076,0,8313,4046,4267,0,0,0,1.0,1,1.0,1,1.0,1,0.20038470819599538,53
5077,3,8316,4048,4268,0,0,0,1.0,1,1.0,1,1.0,1,0.2298700684630377,56
5078,1,8317,4048,4269,0,0,0,1.0,1,1.0,1,1.0,1,0.2316108949935962,55
5079,5,8322,4048,4274,0,0,0,1.0,1,1.0,1,1.0,1,0.1899242699331131,56
5080,0,8322,4048,4274,0,0,0,1.0,1,1.0,1,1.0,1,0.17904785287740427,57
5081,3,8325,4048,4277,0,0,0,1.0,1,1.0,1,1.0,1,0.13723821504704736,58
5082,0,8325,4048,4277,0,0,0,1.0,1,1.0,1,1.0,1,0.13723821504704736,58
5083,1,8326,4048,4278,0,0,0,1.0,1,1.0,1,1.0,1,0.14198768325378394,59
5084,1,8327,4048,4279,0,0,0,1.0,1,1.0,1,1.0,1,0.11167112717015885,59
5085,1,8328,4049,4279,0,0,0,1.0,1,1.0,1,1.0,1,0.15306551766609428,60
5086,0,8328,4049,4279,0,0,0,1.0,1,1.0,1,1.0,1,0.15490978091318613,61
5087,5,8333,4051,4282,0,0,0,1.0,1,1.0,1,1.0,1,0.11364014877983743,62
5088,1,8334,4051,4283,0,0,0,1.0,1,1.0,1,1.0,1,0.12363042772066116,64
5089,1,8335,4052,4283,0,0,0,1.0,1,1.0,1,1.0,1,0.13905840479891318,64
5090,0,8335,4052,4283,0,0,0,1.0,1,1.0,1,1.0,1,0.13905840479891318,64
5091,4,8339,4055,4284,0,0,0,1.0,1,1.0,1,1.0,1,0.17610452277976413,64
5092,2,8341,4057,4284,0,0,0,1.0,1,1.0,1,1.0,1,0.21401809403397273,64
5093,3,8344,4057,4287,0,0,0,1.0,1,1.0,1,1.0,1,0.19430611686770854,64
5094,1,8345,4058,4287,0,0,0,1.0,1,1.0,1,1.0,1,0.20577673833398238,65
5095,5,8350,4059,4291,0,0,0,1.0,1,1.0,1,1.0,1,0.18737889230768792,66
5096,1,8351,4059,4292,0,0,0,1.0,1,1.0,1,1.0,1,0.17000007689292612,66
5097,2,8353,4061,4292,0,0,0,1.0,1,1.0,1,1.0,1,0.16710314584507022,67
5098,2,8355,4062,4293,0,0,0,1.0,1,1.0,1,1.0,1,0.13467729646038717,67
5099,2,8357,4062,4295,0,0,0,1.0,1,1.0,1,1.0,1,0.12387440750934219,70
5100,1,8358,4063,4295,0,0,0,1.0,1,1.0,1,1.0,1,0.1498033329948362,71
5101,1,8359,4063,4296,0,0,0,1.0,1,1.0,1,1.0,1,0.14832350628587887,72
5102,3,8362,4065,4297,0,0,0,1.0,1,1.0,1,1.0,1,0.1504650466051048,72
5103,5,8367,4068,4299,0,0,0,1.0,1,1.0,1,1.0,1,0.153312160916793,70
5104,3,8370,4070,4300,0,0,0,1.0,1,1.0,1,1.0,1,0.1730932069138811,67
5105,7,8377,4073,4304,0,0,0,1.0,1,1.0,1,1.0,1,0.15441756187845346,66
5106,4,8381,4077,4304,0,0,0,1.0,1,1.0,1,1.0,1,0.1979247124323513,64
5107,2,8383,4079,4304,0,0,0,1.0,1,1.0,1,1.0,1,0.1925619109852003,61
5108,2,8385,4080,4305,0,0,0,1.0,1,1.0,1,1.0,1,0.19053629634490496,57
5109,3,8388,4083,4305,0,0,0,1.0,1,1.0,1,1.0,1,0.22773160447902474,55
5110,3,8391,4085,4306,0,0,0,1.0,1,1.0,1,1.0,1,0.23174411787726654,53
5111,6,8397,4088,4309,0,0,0,1.0,1,1.0,1,1.0,1,0.23583048140923574,52
5112,2,8399,4089,4310,0,0,0,1.0,1,1.0,1,1.0,1,0.2246971672490252,52
5113,2,8401,4089,4312,0,0,0,1.0,1,1.0,1,1.0,1,0.19596226364342464,49
5114,4,8405,4093,4312,0,0,0,1.0,1,1.0,1,1.0,1,0.21191068616274825,49
5115,2,8407,4093,4314,0,0,0,1.0,1,1.0,1,1.0,1,0.17574238425876798,48
5116,2,8409,4094,4315,0,0,0,1.0,1,1.0,1,1.0,1,0.17767067163744726,47
5117,0,8409,4094,4315,0,0,0,1.0,1,1.0,1,1.0,1,0.18286809965670267,48
5118,0,8409,4094,4315,0,0,0,1.0,1,1.0,1,1.0,1,0.1614930306247377,49
5119,3,8412,4097,4315,0,0,0,1.0,1,1.0,1,1.0,1,0.18250550388453107,49
5120,0,8412,4097,4315,0,0,0,1.0,1,1.0,1,1.0,1,0.18461969108757947,48
5121,1,8413,4098,4315,0,0,0,1.0,1,1.0,1,1.0,1,0.17247580206261,48
5122,1,8414,4099,4315,0,0,0,1.0,1,1.0,1,1.0,1,0.21293447367544838,46
5123,0,8414,4099,4315,0,0,0,1.0,1,1.0,1,1.0,1,0.21293447367544838,46
5124,0,8414,4099,4315,0,0,0,1.0,1,1.0,1,1.0,1,0.1994507313253587,47
5125,7,8421,4100,4321,0,0,0,1.0,1,1.0,1,1.0,1,0.15154154750658735,49
5126,0,8421,4100,4321,0,0,0,1.0,1,1.0,1,1.0,1,0.15154154750658735,49
5127,1,8422,4100,4322,0,0,0,1.0,1,1.0,1,1.0,1,0.16679587203612717,51
5128,3,8425,4101,4324,0,0,0,1.0,1,1.0,1,1.0,1,0.19705811926382324,53
5129,4,8429,4102,4327,0,0,0,1.0,1,1.0,1,1.0,1,0.1578194066994114,55
5130,0,8429,4102,4327,0,0,0,1.0,1,1.0,1,1.0,1,0.1578194066994114,55
5131,0,8429,4102,4327,0,0,0,1.0,1,1.0,1,1.0,1,0.1578194066994114,55
5132,0,8429,4102,4327,0,0,0,1.0,1,1.0,1,1.0,1,0.1578194066994114,55
5133,0,8429,4102,4327,0,0,0,1.0,1,1.0,1,1.0,1,0.16226922823602838,56
5134,1,8430,4102,4328,0,0,0,1.0,1,1.0,1,1.0,1,0.18249906800485818,56
5135,4,8434,4104,4330,0,0,0,1.0,1,1.0,1,1.0,1,0.1730709251077486,56
5136,0,8434,4104,4330,0,0,0,1.0,1,1.0,1,1.0,1,0.18361872261870657,55
5137,2,8436,4105,4331,0,0,0,1.0,1,1.0,1,1.0,1,0.17511734875816848,55
5138,0,8436,4105,4331,0,0,0,1.0,1,1.0,1,1.0,1,0.18410987702206963,54
5139,3,8439,4108,4331,0,0,0,1.0,1,1.0,1,1.0,1,0.19560721624156485,54
5140,1,8440,4109,4331,0,0,0,1.0,1,1.0,1,1.0,1,0.2210935719670546,54
5141,5,8445,4112,4333,0,0,0,1.0,1,1.0,1,1.0,1,0.22061163894109723,53
5142,8,8453,4115,4338,0,0,0,1.0,1,1.0,1,1.0,1,0.21123770275012838,55
5143,3,8456,4118,4338,0,0,0,1.0,1,1.0,1,1.0,1,0.18649621392706092,54
5144,5,8461,4121,4340,0,0,0,1.0,1,1.0,1,1.0,1,0.2209839585757163,50
5145,5,8466,4122,4344,0,0,0,1.0,1,1.0,1,1.0,1,0.17387424840750906,51
5146,1,8467,4123,4344,0,0,0,1.0,1,1.0,1,1.0,1,0.17405698209021364,48
5147,3,8470,4124,4346,0,0,0,1.0,1,1.0,1,1.0,1,0.1754375346312689,49
5148,0,8470,4124,4346,0,0,0,1.0,1,1.0,1,1.0,1,0.15566341025715966,47
5149,1,8471,4125,4346,0,0,0,1.0,1,1.0,1,1.0,1,0.18646169760394685,46
5150,5,8476,4129,4347,0,0,0,1.0,1,1.0,1,1.0,1,0.19668664823896423,46
5151,2,8478,4129,4349,0,0,0,1.0,1,1.0,1,1.0,1,0.16742838436990784,45
5152,2,8480,4131,4349,0,0,0,1.0,1,1.0,1,1.0,1,0.19469646724780945,45
5153,3,8483,4133,4350,0,0,0,1.0,1,1.0,1,1.0,1,0.22158121730781666,45
5154,1,8484,4134,4350,0,0,0,1.0,1,1.0,1,1.0,1,0.2490171459515945,45
5155,3,8487,4135,4352,0,0,0,1.0,1,1.0,1,1.0,1,0.24720213722360718,44
5156,0,8487,4135,4352,0,0,0,1.0,1,1.0,1,1.0,1,0.2460741146103007,44
5157,0,8487,4135,4352,0,0,0,1.0,1,1.0,1,1.0,1,0.2379143554743981,42
5158,1,8488,4136,4352,0,0,0,1.0,1,1.0,1,1.0,1,0.26455898987549037,43
5159,0,8488,4136,4352,0,0,0,1.0,1,1.0,1,1.0,1,0.2786489904742797,43
5160,0,8488,4136,4352,0,0,0,1.0,1,1.0,1,1.0,1,0.2786489904742797,43
5161,0,8488,4136,4352,0,0,0,1.0,1,1.0,1,1.0,1,0.2786489904742797,43
5162,1,8489,4136,4353,0,0,0,1.0,1,1.0,1,1.0,1,0.26324085347430276,44
5163,2,8491,4136,4355,0,0,0,1.0,1,1.0,1,1.0,1,0.2638270567384782,46
5164,2,8493,4137,4356,0,0,0,1.0,1,1.0,1,1.0,1,0.2357571002188064,46
5165,0,8493,4137,4356,0,0,0,1.0,1,1.0,1,1.0,1,0.2357571002188064,46
5166,8,8501,4140,4361,0,0,0,1.0,1,1.0,1,1.0,1,0.18266791435920224,47
5167,1,8502,4140,4362,0,0,0,1.0,1,1.0,1,1.0,1,0.16644869557793296,47
5168,2,8504,4141,4363,0,0,0,1.0,1,1.0,1,1.0,1,0.1861441016193971,47
5169,0,8504,4141,4363,0,0,0,1.0,1,1.0,1,1.0,1,0.1861441016193971,47
5170,1,8505,4142,4363,0,0,0,1.0,1,1.0,1,1.0,1,0.19369013207362368,48
5171,2,8507,4143,4364,0,0,0,1.0,1,1.0,1,1.0,1,0.20738463588179362,48
5172,0,8507,4143,4364,0,0,0,1.0,1,1.0,1,1.0,1,0.1777831426900019,49
5173,0,8507,4143,4364,0,0,0,1.0,1,1.0,1,1.0,1,0.18600888142433936,49
5174,0,8507,4143,4364,0,0,0,1.0,1,1.0,1,1.0,1,0.1882053588565799,52
5175,2,8509,4144,4365,0,0,0,1.0,1,1.0,1,1.0,1,0.17768805126132223,53
5176,2,8511,4144,4367,0,0,0,1.0,1,1.0,1,1.0,1,0.16501521931079924,54
5177,4,8515,4147,4368,0,0,0,1.0,1,1.0,1,1.0,1,0.16628453735956497,54
5178,2,8517,4149,4368,0,0,0,1.0,1,1.0,1,1.0,1,0.19208074454106222,55
5179,0,8517,4149,4368,0,0,0,1.0,1,1.0,1,1.0,1,0.18272225529590996,53
5180,1,8518,4149,4369,0,0,0,1.0,1,1.0,1,1.0,1,0.1761059199960967,52
5181,1,8519,4150,4369,0,0,0,1.0,1,1.0,1,1.0,1,0.16444402543517828,52
5182,1,8520,4151,4369,0,0,0,1.0,1,1.0,1,1.0,1,0.1627710113100886,52
5183,2,8522,4153,4369,0,0,0,1.0,1,1.0,1,1.0,1,0.21628354692738205,52
5184,1,8523,4154,4369,0,0,0,1.0,1,1.0,1,1.0,1,0.2339470417299063,52
5185,3,8526,4156,4370,0,0,0,1.0,1,1.0,1,1.0,1,0.25840817591898635,50
5186,1,8527,4157,4370,0,0,0,1.0,1,1.0,1,1.0,1,0.3043363281125878,48
5187,6,8533,4158,4375,0,0,0,1.0,1,1.0,1,1.0,1,0.20922248056245277,46
5188,0,8533,4158,4375,0,0,0,1.0,1,1.0,1,1.0,1,0.22637126987626668,44
5189,0,8533,4158,4375,0,0,0,1.0,1,1.0,1,1.0,1,0.23343625306499802,44
5190,1,8534,4159,4375,0,0,0,1.0,1,1.0,1,1.0,1,0.23619215314568087,45
5191,1,8535,4159,4376,0,0,0,1.0,1,1.0,1,1.0,1,0.22055840090768897,45
5192,1,8536,4160,4376,0,0,0,1.0,1,1.0,1,1.0,1,0.23514186802426593,45
5193,1,8537,4160,4377,0,0,0,1.0,1,1.0,1,1.0,1,0.21409202575391106,45
5194,2,8539,4160,4379,0,0,0,1.0,1,1.0,1,1.0,1,0.19272928830631184,45
5195,1,8540,4161,4379,0,0,0,1.0,1,1.0,1,1.0,1,0.21133325777030404,46
5196,0,8540,4161,4379,0,0,0,1.0,1,1.0,1,1.0,1,0.21133325777030404,46
5197,3,8543,4163,4380,0,0,0,1.0,1,1.0,1,1.0,1,0.22322923353459492,46
5198,1,8544,4163,4381,0,0,0,1.0,1,1.0,1,1.0,1,0.19626582402038667,47
5199,2,8546,4164,4382,0,0,0,1.0,1,1.0,1,1.0,1,0.2199170759300525,49
5200,1,8547,4165,4382,0,0,0,1.0,1,1.0,1,1.0,1,0.22907822763007124,49
5201,3,8550,4167,4383,0,0,0,1.0,1,1.0,1,1.0,1,0.19767628010552213,50
5202,1,8551,4167,4384,0,0,0,1.0,1,1.0,1,1.0,1,0.17293841390988446,52
5203,0,8551,4167,4384,0,0,0,1.0,1,1.0,1,1.0,1,0.17293841390988446,52
5204,0,8551,4167,4384,0,0,0,1.0,1,1.0,1,1.0,1,0.1677164908361182,54
5205,0,8551,4167,4384,0,0,0,1.0,1,1.0,1,1.0,1,0.1677164908361182,54
5206,0,8551,4167,4384,0,0,0,1.0,1,1.0,1,1.0,1,0.17901751822182088,55
5207,0,8551,4167,4384,0,0,0,1.0,1,1.0,1,1.0,1,0.1841709885165281,54
5208,0,8551,4167,4384,0,0,0,1.0,1,1.0,1,1.0,1,0.1841709885165281,54
5209,1,8552,4167,4385,0,0,0,1.0,1,1.0,1,1.0,1,0.16331987853419136,54
5210,0,8552,4167,4385,0,0,0,1.0,1,1.0,1,1.0,1,0.16331987853419136,54
5211,3,8555,4168,4387,0,0,0,1.0,1,1.0,1,1.0,1,0.1618238262628513,56
5212,0,8555,4168,4387,0,0,0,1.0,1,1.0,1,1.0,1,0.15262286732044164,57
5213,1,8556,4169,4387,0,0,0,1.0,1,1.0,1,1.0,1,0.17408869108672476,57
5214,4,8560,4171,4389,0,0,0,1.0,1,1.0,1,1.0,1,0.22760151293813918,58
5215,2,8562,4171,4391,0,0,0,1.0,1,1.0,1,1.0,1,0.2214234333397994,57
5216,4,8566,4173,4393,0,0,0,1.0,1,1.0,1,1.0,1,0.2012523792265476,57
5217,2,8568,4174,4394,0,0,0,1.0,1,1.0,1,1.0,1,0.19615876229644874,56
5218,1,8569,4174,4395,0,0,0,1.0,1,1.0,1,1.0,1,0.188689906003901,56
5219,1,8570,4174,4396,0,0,0,1.0,1,1.0,1,1.0,1,0.1928755220396174,54
5220,0,8570,4174,4396,0,0,0,1.0,1,1.0,1,1.0,1,0.19379174372302738,53
5221,1,8571,4174,4397,0,0,0,1.0,1,1.0,1,1.0,1,0.1872588733968398,52
5222,0,8571,4174,4397,0,0,0,1.0,1,1.0,1,1.0,1,0.20430660311644874,52
5223,2,8573,4176,4397,0,0,0,1.0,1,1.0,1,1.0,1,0.2218134718191558,52
5224,5,8578,4179,4399,0,0,0,1.0,1,1.0,1,1.0,1,0.23369010954540304,52
5225,2,8580,4179,4401,0,0,0,1.0,1,1.0,1,1.0,1,0.18919630521303785,50
5226,3,8583,4182,4401,0,0,0,1.0,1,1.0,1,1.0,1,0.21979706387550127,51
5227,3,8586,4183,4403,0,0,0,1.0,1,1.0,1,1.0,1,0.2360081124274838,49
5228,0,8586,4183,4403,0,0,0,1.0,1,1.0,1,1.0,1,0.2598358609392132,48
5229,1,8587,4183,4404,0,0,0,1.0,1,1.0,1,1.0,1,0.2263714530109506,49
5230,0,8587,4183,4404,0,0,0,1.0,1,1.0,1,1.0,1,0.2263714530109506,49
5231,1,8588,4184,4404,0,0,0,1.0,1,1.0,1,1.0,1,0.21056267410978413,49
5232,4,8592,4185,4407,0,0,0,1.0,1,1.0,1,1.0,1,0.18159289128617906,51
5233,2,8594,4186,4408,0,0,0,1.0,1,1.0,1,1.0,1,0.18716885807832184,51
5234,5,8599,4189,4410,0,0,0,1.0,1,1.0,1,1.0,1,0.1872585135054105,52
5235,0,8599,4189,4410,0,0,0,1.0,1,1.0,1,1.0,1,0.1861794544837284,52
5236,0,8599,4189,4410,0,0,0,1.0,1,1.0,1,1.0,1,0.1861794544837284,52
5237,3,8602,4189,4413,0,0,0,1.0,1,1.0,1,1.0,1,0.17257708877815067,53
5238,1,8603,4190,4413,0,0,0,1.0,1,1.0,1,1.0,1,0.17540626305611762,53
5239,1,8604,4190,4414,0,0,0,1.0,1,1.0,1,1.0,1,0.1512923539279083,53
5240,2,8606,4192,4414,0,0,0,1.0,1,1.0,1,1.0,1,0.18508990337120484,55
5241,2,8608,4192,4416,0,0,0,1.0,1,1.0,1,1.0,1,0.16022328636977243,56
5242,3,8611,4193,4418,0,0,0,1.0,1,1.0,1,1.0,1,0.1604136124761335,54
5243,2,8613,4194,4419,0,0,0,1.0,1,1.0,1,1.0,1,0.17892107977615881,55
5244,2,8615,4195,4420,0,0,0,1.0,1,1.0,1,1.0,1,0.17742958543533155,55
5245,1,8616,4195,4421,0,0,0,1.0,1,1.0,1,1.0,1,0.1594950705012727,55
5246,2,8618,4197,4421,0,0,0,1.0,1,1.0,1,1.0,1,0.2246655718980489,55
5247,3,8621,4198,4423,0,0,0,1.0,1,1.0,1,1.0,1,0.20373467988170157,54
5248,2,8623,4199,4424,0,0,0,1.0,1,1.0,1,1.0,1,0.22413314031737142,53
5249,1,8624,4200,4424,0,0,0,1.0,1,1.0,1,1.0,1,0.233282351388001,55
5250,3,8627,4202,4425,0,0,0,1.0,1,1.0,1,1.0,1,0.2249692164072479,55
5251,5,8632,4203,4429,0,0,0,1.0,1,1.0,1,1.0,1,0.19097084041346532,57
5252,1,8633,4203,4430,0,0,0,1.0,1,1.0,1,1.0,1,0.18245796319449664,58
5253,2,8635,4204,4431,0,0,0,1.0,1,1.0,1,1.0,1,0.1922297111086915,59
5254,1,8636,4205,4431,0,0,0,1.0,1,1.0,1,1.0,1,0.1979169897419247,59
5255,1,8637,4206,4431,0,0,0,1.0,1,1.0,1,1.0,1,0.20203152443521546,58
5256,3,8640,4207,4433,0,0,0,1.0,1,1.0,1,1.0,1,0.19328082476583222,59
5257,0,8640,4207,4433,0,0,0,1.0,1,1.0,1,1.0,1,0.18731966646403983,58
5258,1,8641,4207,4434,0,0,0,1.0,1,1.0,1,1.0,1,0.17748008757453299,56
5259,0,8641,4207,4434,0,0,0,1.0,1,1.0,1,1.0,1,0.19006827324103398,56
5260,0,8641,4207,4434,0,0,0,1.0,1,1.0,1,1.0,1,0.19265031418990747,55
5261,2,8643,4208,4435,0,0,0,1.0,1,1.0,1,1.0,1,0.16578488354706158,54
5262,1,8644,4209,4435,0,0,0,1.0,1,1.0,1,1.0,1,0.17651382179711642,54
5263,4,8648,4211,4437,0,0,0,1.0,1,1.0,1,1.0,1,0.21802460768677376,53
5264,2,8650,4212,4438,0,0,0,1.0,1,1.0,1,1.0,1,0.2132509673936855,51
5265,3,8653,4214,4439,0,0,0,1.0,1,1.0,1,1.0,1,0.21396359963809108,50
5266,1,8654,4215,4439,0,0,0,1.0,1,1.0,1,1.0,1,0.22091015311510884,49
5267,3,8657,4216,4441,0,0,0,1.0,1,1.0,1,1.0,1,0.2135846252070887,48
5268,3,8660,4219,4441,0,0,0,1.0,1,1.0,1,1.0,1,0.21312789810198968,47
5269,2,8662,4219,4443,0,0,0,1.0,1,1.0,1,1.0,1,0.1925862426815922,45
5270,1,8663,4219,4444,0,0,0,1.0,1,1.0,1,1.0,1,0.19898847131016012,47
5271,1,8664,4219,4445,0,0,0,1.0,1,1.0,1,1.0,1,0.18187372960972742,45
5272,3,8667,4222,4445,0,0,0,1.0,1,1.0,1,1.0,1,0.20705846226392025,46
5273,0,8667,4222,4445,0,0,0,1.0,1,1.0,1,1.0,1,0.22975290240042362,44
5274,3,8670,4224,4446,0,0,0,1.0,1,1.0,1,1.0,1,0.2696412500268094,44
5275,5,8675,4225,4450,0,0,0,1.0,1,1.0,1,1.0,1,0.22832873021302472,46
5276,1,8676,4226,4450,0,0,0,1.0,1,1.0,1,1.0,1,0.20722459451407746,46
5277,2,8678,4227,4451,0,0,0,1.0,1,1.0,1,1.0,1,0.1892921817847901,46
5278,3,8681,4230,4451,0,0,0,1.0,1,1.0,1,1.0,1,0.20296204640640908,46
5279,3,8684,4231,4453,0,0,0,1.0,1,1.0,1,1.0,1,0.22015294271759667,47
5280,1,8685,4232,4453,0,0,0,1.0,1,1.0,1,1.0,1,0.2209279334748863,47
5281,0,8685,4232,4453,0,0,0,1.0,1,1.0,1,1.0,1,0.23134344889596203,48
5282,2,8687,4234,4453,0,0,0,1.0,1,1.0,1,1.0,1,0.26249653638460346,48
5283,2,8689,4234,4455,0,0,0,1.0,1,1.0,1,1.0,1,0.24654158656750644,49
5284,0,8689,4234,4455,0,0,0,1.0,1,1.0,1,1.0,1,0.24654158656750644,49
5285,1,8690,4234,4456,0,0,0,1.0,1,1.0,1,1.0,1,0.2000837498542992,50
5286,0,8690,4234,4456,0,0,0,1.0,1,1.0,1,1.0,1,0.21366660648278565,51
5287,0,8690,4234,4456,0,0,0,1.0,1,1.0,1,1.0,1,0.21366660648278565,51
5288,1,8691,4234,4457,0,0,0,1.0,1,1.0,1,1.0,1,0.19642377366371674,51
5289,2,8693,4234,4459,0,0,0,1.0,1,1.0,1,1.0,1,0.20139024798668806,53
5290,0,8693,4234,4459,0,0,0,1.0,1,1.0,1,1.0,1,0.20139024798668806,53
5291,2,8695,4235,4460,0,0,0,1.0,1,1.0,1,1.0,1,0.1936174277031446,53
5292,2,8697,4236,4461,0,0,0,1.0,1,1.0,1,1.0,1,0.19471749256833576,53
5293,4,8701,4239,4462,0,0,0,1.0,1,1.0,1,1.0,1,0.2402646599154019,53
5294,4,8705,4241,4464,0,0,0,1.0,1,1.0,1,1.0,1,0.25232168785249864,54
5295,4,8709,4242,4467,0,0,0,1.0,1,1.0,1,1.0,1,0.22105506522707996,52
5296,0,8709,4242,4467,0,0,0,1.0,1,1.0,1,1.0,1,0.22540411621259424,49
5297,4,8713,4244,4469,0,0,0,1.0,1,1.0,1,1.0,1,0.233556228361725,49
5298,0,8713,4244,4469,0,0,0,1.0,1,1.0,1,1.0,1,0.2324578590005596,49
5299,2,8715,4246,4469,0,0,0,1.0,1,1.0,1,1.0,1,0.24060604841955108,50
5300,0,8715,4246,4469,0,0,0,1.0,1,1.0,1,1.0,1,0.2563919808871375,48
5301,1,8716,4247,4469,0,0,0,1.0,1,1.0,1,1.0,1,0.2928409308449764,46
5302,2,8718,4248,4470,0,0,0,1.0,1,1.0,1,1.0,1,0.289013396234117,47
5303,3,8721,4250,4471,0,0,0,1.0,1,1.0,1,1.0,1,0.25296649013871125,46
5304,2,8723,4252,4471,0,0,0,1.0,1,1.0,1,1.0,1,0.2931991088699162,45
5305,1,8724,4252,4472,0,0,0,1.0,1,1.0,1,1.0,1,0.2773564217187632,44
5306,1,8725,4253,4472,0,0,0,1.0,1,1.0,1,1.0,1,0.30561790922683596,42
5307,1,8726,4254,4472,0,0,0,1.0,1,1.0,1,1.0,1,0.3310618781869688,42
5308,2,8728,4255,4473,0,0,0,1.0,1,1.0,1,1.0,1,0.33426093459348905,43
5309,1,8729,4256,4473,0,0,0,1.0,1,1.0,1,1.0,1,0.3313579240785815,41
5310,3,8732,4257,4475,0,0,0,1.0,1,1.0,1,1.0,1,0.3355265970687455,41
5311,2,8734,4258,4476,0,0,0,1.0,1,1.0,1,1.0,1,0.30277675642421414,42
5312,0,8734,4258,4476,0,0,0,1.0,1,1.0,1,1.0,1,0.3174281065655711,43
5313,0,8734,4258,4476,0,0,0,1.0,1,1.0,1,1.0,1,0.3199676815408502,44
5314,1,8735,4258,4477,0,0,0,1.0,1,1.0,1,1.0,1,0.29261216723182876,44
5315,5,8740,4259,4481,0,0,0,1.0,1,1.0,1,1.0,1,0.27768464083716304,45
5316,1,8741,4259,4482,0,0,0,1.0,1,1.0,1,1.0,1,0.2650797287753721,46
5317,3,8744,4259,4485,0,0,0,1.0,1,1.0,1,1.0,1,0.24812348085612504,46
5318,1,8745,4260,4485,0,0,0,1.0,1,1.0,1,1.0,1,0.23311401410386817,46
5319,1,8746,4260,4486,0,0,0,1.0,1,1.0,1,1.0,1,0.23338240051648743,47
5320,2,8748,4261,4487,0,0,0,1.0,1,1.0,1,1.0,1,0.21107308273094094,48
5321,0,8748,4261,4487,0,0,0,1.0,1,1.0,1,1.0,1,0.22012073697620244,49
5322,0,8748,4261,4487,0,0,0,1.0,1,1.0,1,1.0,1,0.22012073697620244,49
5323,2,8750,4261,4489,0,0,0,1.0,1,1.0,1,1.0,1,0.22488445770478366,51
5324,0,8750,4261,4489,0,0,0,1.0,1,1.0,1,1.0,1,0.22202512427861032,53
5325,1,8751,4262,4489,0,0,0,1.0,1,1.0,1,1.0,1,0.23657507091854357,53
5326,1,8752,4263,4489,0,0,0,1.0,1,1.0,1,1.0,1,0.2574249111514079,53
5327,1,8753,4263,4490,0,0,0,1.0,1,1.0,1,1.0,1,0.2673980274654092,53
5328,1,8754,4263,4491,0,0,0,1.0,1,1.0,1,1.0,1,0.261384027438016,54
5329,3,8757,4265,4492,0,0,0,1.0,1,1.0,1,1.0,1,0.2841546920349795,53
5330,2,8759,4267,4492,0,0,0,1.0,1,1.0,1,1.0,1,0.3151416444193301,52
5331,2,8761,4267,4494,0,0,0,1.0,1,1.0,1,1.0,1,0.3038255326302797,51
5332,3,8764,4267,4497,0,0,0,1.0,1,1.0,1,1.0,1,0.27548473180398664,52
5333,2,8766,4268,4498,0,0,0,1.0,1,1.0,1,1.0,1,0.3003768089034185,53
5334,3,8769,4269,4500,0,0,0,1.0,1,1.0,1,1.0,1,0.30175363832041324,54
5335,2,8771,4269,4502,0,0,0,1.0,1,1.0,1,1.0,1,0.2899564770180113,55
5336,0,8771,4269,4502,0,0,0,1.0,1,1.0,1,1.0,1,0.30080733005392707,54
5337,1,8772,4269,4503,0,0,0,1.0,1,1.0,1,1.0,1,0.29252871856723445,55
5338,2,8774,4270,4504,0,0,0,1.0,1,1.0,1,1.0,1,0.30659929500920946,55
5339,2,8776,4270,4506,0,0,0,1.0,1,1.0,1,1.0,1,0.2819213610113222,55
5340,0,8776,4270,4506,0,0,0,1.0,1,1.0,1,1.0,1,0.2819213610113222,55
5341,0,8776,4270,4506,0,0,0,1.0,1,1.0,1,1.0,1,0.3239216605350701,54
5342,1,8777,4271,4506,0,0,0,1.0,1,1.0,1,1.0,1,0.33478687965365145,55
5343,3,8780,4272,4508,0,0,0,1.0,1,1.0,1,1.0,1,0.305155344473838,54
5344,3,8783,4275,4508,0,0,0,1.0,1,1.0,1,1.0,1,0.3407457851682173,55
5345,5,8788,4275,4513,0,0,0,1.0,1,1.0,1,1.0,1,0.2684882417756215,53
5346,2,8790,4276,4514,0,0,0,1.0,1,1.0,1,1.0,1,0.27763688646518236,53
5347,4,8794,4278,4516,0,0,0,1.0,1,1.0,1,1.0,1,0.3030149753494138,51
5348,2,8796,4279,4517,0,0,0,1.0,1,1.0,1,1.0,1,0.2785037274734672,53
5349,7,8803,4281,4522,0,0,0,1.0,1,1.0,1,1.0,1,0.21153512168376756,52
5350,1,8804,4282,4522,0,0,0,1.0,1,1.0,1,1.0,1,0.22185578026401184,50
5351,3,8807,4284,4523,0,0,0,1.0,1,1.0,1,1.0,1,0.2779428918564889,52
5352,1,8808,4285,4523,0,0,0,1.0,1,1.0,1,1.0,1,0.2902026807249819,49
5353,2,8810,4285,4525,0,0,0,1.0,1,1.0,1,1.0,1,0.24886774614711918,49
5354,1,8811,4285,4526,0,0,0,1.0,1,1.0,1,1.0,1,0.21160326372838797,49
5355,0,8811,4285,4526,0,0,0,1.0,1,1.0,1,1.0,1,0.20328891120690465,48
5356,3,8814,4287,4527,0,0,0,1.0,1,1.0,1,1.0,1,0.24947784223029015,49
5357,1,8815,4287,4528,0,0,0,1.0,1,1.0,1,1.0,1,0.2316198066498885,47
5358,0,8815,4287,4528,0,0,0,1.0,1,1.0,1,1.0,1,0.2388697108593539,48
5359,1,8816,4287,4529,0,0,0,1.0,1,1.0,1,1.0,1,0.2323453178989536,48
5360,1,8817,4287,4530,0,0,0,1.0,1,1.0,1,1.0,1,0.22363322992608156,48
5361,1,8818,4287,4531,0,0,0,1.0,1,1.0,1,1.0,1,0.23310831481837796,50
5362,1,8819,4287,4532,0,0,0,1.0,1,1.0,1,1.0,1,0.21461800502825534,50
5363,0,8819,4287,4532,0,0,0,1.0,1,1.0,1,1.0,1,0.21461800502825534,50
5364,2,8821,4289,4532,0,0,0,1.0,1,1.0,1,1.0,1,0.20654119354865771,51
5365,2,8823,4289,4534,0,0,0,1.0,1,1.0,1,1.0,1,0.1978226051462032,52
5366,0,8823,4289,4534,0,0,0,1.0,1,1.0,1,1.0,1,0.1978226051462032,52
5367,3,8826,4290,4536,0,0,0,1.0,1,1.0,1,1.0,1,0.19412459998166448,54
5368,1,8827,4290,4537,0,0,0,1.0,1,1.0,1,1.0,1,0.19118262061259042,55
5369,2,8829,4291,4538,0,0,0,1.0,1,1.0,1,1.0,1,0.2190957127701498,53
5370,4,8833,4293,4540,0,0,0,1.0,1,1.0,1,1.0,1,0.2353540050620577,54
5371,3,8836,4295,4541,0,0,0,1.0,1,1.0,1,1.0,1,0.24381446800146905,53
5372,3,8839,4298,4541,0,0,0,1.0,1,1.0,1,1.0,1,0.315035232311235,53
5373,4,8843,4298,4545,0,0,0,1.0,1,1.0,1,1.0,1,0.23848951778933852,52
5374,0,8843,4298,4545,0,0,0,1.0,1,1.0,1,1.0,1,0.2278797877982324,51
5375,1,8844,4298,4546,0,0,0,1.0,1,1.0,1,1.0,1,0.18250213548862473,52
5376,3,8847,4300,4547,0,0,0,1.0,1,1.0,1,1.0,1,0.21438368764394886,51
5377,0,8847,4300,4547,0,0,0,1.0,1,1.0,1,1.0,1,0.22699544801088095,52
5378,2,8849,4302,4547,0,0,0,1.0,1,1.0,1,1.0,1,0.2720905970530289,50
5379,2,8851,4302,4549,0,0,0,1.0,1,1.0,1,1.0,1,0.2347533398685622,50
5380,1,8852,4302,4550,0,0,0,1.0,1,1.0,1,1.0,1,0.24755378443884346,52
5381,0,8852,4302,4550,0,0,0,1.0,1,1.0,1,1.0,1,0.24755378443884346,52
5382,0,8852,4302,4550,0,0,0,1.0,1,1.0,1,1.0,1,0.2471225793384943,52
5383,0,8852,4302,4550,0,0,0,1.0,1,1.0,1,1.0,1,0.23194540917130282,51
5384,3,8855,4303,4552,0,0,0,1.0,1,1.0,1,1.0,1,0.22365582475407425,52
5385,3,8858,4304,4554,0,0,0,1.0,1,1.0,1,1.0,1,0.21526352312976663,51
5386,3,8861,4305,4556,0,0,0,1.0,1,1.0,1,1.0,1,0.1809584852939068,52
5387,2,8863,4305,4558,0,0,0,1.0,1,1.0,1,1.0,1,0.14835903994861982,53
5388,1,8864,4305,4559,0,0,0,1.0,1,1.0,1,1.0,1,0.13673409599756986,54
5389,2,8866,4306,4560,0,0,0,1.0,1,1.0,1,1.0,1,0.12068509420077404,55
5390,1,8867,4307,4560,0,0,0,1.0,1,1.0,1,1.0,1,0.13256504604643246,56
5391,1,8868,4308,4560,0,0,0,1.0,1,1.0,1,1.0,1,0.14430351235075883,56
5392,5,8873,4311,4562,0,0,0,1.0,1,1.0,1,1.0,1,0.15864431939891752,56
5393,2,8875,4312,4563,0,0,0,1.0,1,1.0,1,1.0,1,0.17675284296099525,54
5394,1,8876,4313,4563,0,0,0,1.0,1,1.0,1,1.0,1,0.19239485118137492,53
5395,4,8880,4315,4565,0,0,0,1.0,1,1.0,1,1.0,1,0.1750447256032179,53
5396,3,8883,4316,4567,0,0,0,1.0,1,1.0,1,1.0,1,0.16187337675409602,54
5397,3,8886,4318,4568,0,0,0,1.0,1,1.0,1,1.0,1,0.14473666348579656,53
5398,1,8887,4319,4568,0,0,0,1.0,1,1.0,1,1.0,1,0.1316389637901399,53
5399,5,8892,4323,4569,0,0,0,1.0,1,1.0,1,1.0,1,0.20766031324433792,55
5400,3,8895,4323,4572,0,0,0,1.0,1,1.0,1,1.0,1,0.1735953769935911,55
5401,2,8897,4325,4572,0,0,0,1.0,1,1.0,1,1.0,1,0.22072453201727593,56
5402,0,8897,4325,4572,0,0,0,1.0,1,1.0,1,1.0,1,0.0,0
