,SuccessfulHandoverCount,TotalSuccessfulHandoverCount,TotalSuccessfulHandoverCountRange,TotalSuccessfulHandoverCountLoadBalancing,TotalSuccessfulHandoverCountOverload,FailedHandoverCount,TotalFailedHandoverCount,AvgQoS,MinQoS,AvgQoS_LoadBased,MinQoS_LoadBased,AvgQoS_RangeBased,MinQoS_RangeBased,GiniLoad,VehicleCount
0,0,0,0,0,0,0,0,1.0,1,1.0,1,1.0,1,0.0,0
1,22,22,0,22,0,0,0,1.0,1,1.0,1,1.0,1,0.2666439998729147,30
2,23,45,0,45,0,0,0,1.0,1,1.0,1,1.0,1,0.2713985427960271,32
3,23,68,0,68,0,0,0,1.0,1,1.0,1,1.0,1,0.2399327401436092,33
4,6,74,0,74,0,0,0,1.0,1,1.0,1,1.0,1,0.13967791034500066,34
5,1,75,0,75,0,0,0,1.0,1,1.0,1,1.0,1,0.12559176116673051,36
6,2,77,0,77,0,0,0,1.0,1,1.0,1,1.0,1,0.12705458134387884,38
7,1,78,0,78,0,0,0,1.0,1,1.0,1,1.0,1,0.13529922857317087,40
8,0,78,0,78,0,0,0,1.0,1,1.0,1,1.0,1,0.13529922857317087,40
9,0,78,0,78,0,0,0,1.0,1,1.0,1,1.0,1,0.13529922857317087,40
10,0,78,0,78,0,0,0,1.0,1,1.0,1,1.0,1,0.15178367230453751,41
11,0,78,0,78,0,0,0,1.0,1,1.0,1,1.0,1,0.18596441173020656,40
12,3,81,2,79,0,0,0,1.0,1,1.0,1,1.0,1,0.14102489288902056,39
13,3,84,4,80,0,0,0,1.0,1,1.0,1,1.0,1,0.15974924829242473,37
14,0,84,4,80,0,0,0,1.0,1,1.0,1,1.0,1,0.18767413829601737,35
15,1,85,4,81,0,0,0,1.0,1,1.0,1,1.0,1,0.16012653034159036,36
16,6,91,6,85,0,0,0,1.0,1,1.0,1,1.0,1,0.1522224811540892,34
17,0,91,6,85,0,0,0,1.0,1,1.0,1,1.0,1,0.19177143547640646,33
18,1,92,6,86,0,0,0,1.0,1,1.0,1,1.0,1,0.20030804465572044,34
19,4,96,7,89,0,0,0,1.0,1,1.0,1,1.0,1,0.1626118205252985,34
20,0,96,7,89,0,0,0,1.0,1,1.0,1,1.0,1,0.15492604738512616,34
21,1,97,8,89,0,0,0,1.0,1,1.0,1,1.0,1,0.18066637400359628,36
22,1,98,8,90,0,0,0,1.0,1,1.0,1,1.0,1,0.16835372066729493,35
23,4,102,10,92,0,0,0,1.0,1,1.0,1,1.0,1,0.16784428435700766,35
24,2,104,11,93,0,0,0,1.0,1,1.0,1,1.0,1,0.14001242524773685,35
25,6,110,15,95,0,0,0,1.0,1,1.0,1,1.0,1,0.24592991147083187,35
26,8,118,17,101,0,0,0,1.0,1,1.0,1,1.0,1,0.1384150141204306,36
27,2,120,19,101,0,0,0,1.0,1,1.0,1,1.0,1,0.14003438180628688,34
28,3,123,21,102,0,0,0,1.0,1,1.0,1,1.0,1,0.12715544712673837,35
29,0,123,21,102,0,0,0,1.0,1,1.0,1,1.0,1,0.13007800704465708,33
30,2,125,23,102,0,0,0,1.0,1,1.0,1,1.0,1,0.2088946354665753,33
31,2,127,23,104,0,0,0,1.0,1,1.0,1,1.0,1,0.16454166206720874,33
32,0,127,23,104,0,0,0,1.0,1,1.0,1,1.0,1,0.18210336410306202,32
33,1,128,23,105,0,0,0,1.0,1,1.0,1,1.0,1,0.16273823936874554,33
34,0,128,23,105,0,0,0,1.0,1,1.0,1,1.0,1,0.16273823936874554,33
35,0,128,23,105,0,0,0,1.0,1,1.0,1,1.0,1,0.1549141537648668,35
36,1,129,24,105,0,0,0,1.0,1,1.0,1,1.0,1,0.2069136220685962,36
37,3,132,25,107,0,0,0,1.0,1,1.0,1,1.0,1,0.1579149872081444,37
38,1,133,25,108,0,0,0,1.0,1,1.0,1,1.0,1,0.1426056041445476,36
39,1,134,25,109,0,0,0,1.0,1,1.0,1,1.0,1,0.1601659290805735,38
40,1,135,25,110,0,0,0,1.0,1,1.0,1,1.0,1,0.14693148247545057,40
41,0,135,25,110,0,0,0,1.0,1,1.0,1,1.0,1,0.14693148247545057,40
42,3,138,27,111,0,0,0,1.0,1,1.0,1,1.0,1,0.16243033174643537,40
43,4,142,29,113,0,0,0,1.0,1,1.0,1,1.0,1,0.19415421160891205,43
44,0,142,29,113,0,0,0,1.0,1,1.0,1,1.0,1,0.19415421160891205,43
45,0,142,29,113,0,0,0,1.0,1,1.0,1,1.0,1,0.18182255364436037,44
46,1,143,29,114,0,0,0,1.0,1,1.0,1,1.0,1,0.17614801097648353,44
47,0,143,29,114,0,0,0,1.0,1,1.0,1,1.0,1,0.17614801097648353,44
48,5,148,31,117,0,0,0,1.0,1,1.0,1,1.0,1,0.2102242225888998,44
49,1,149,31,118,0,0,0,1.0,1,1.0,1,1.0,1,0.1835037541823119,41
50,3,152,32,120,0,0,0,1.0,1,1.0,1,1.0,1,0.14451412878253944,40
51,0,152,32,120,0,0,0,1.0,1,1.0,1,1.0,1,0.12907857284007995,38
52,0,152,32,120,0,0,0,1.0,1,1.0,1,1.0,1,0.15169557271717343,37
53,0,152,32,120,0,0,0,1.0,1,1.0,1,1.0,1,0.1755065961709023,38
54,1,153,33,120,0,0,0,1.0,1,1.0,1,1.0,1,0.18745423227151806,38
55,1,154,33,121,0,0,0,1.0,1,1.0,1,1.0,1,0.17924906050608364,38
56,2,156,35,121,0,0,0,1.0,1,1.0,1,1.0,1,0.19884243752211012,38
57,2,158,37,121,0,0,0,1.0,1,1.0,1,1.0,1,0.22647255578449946,38
58,5,163,39,124,0,0,0,1.0,1,1.0,1,1.0,1,0.24709617793388755,38
59,5,168,39,129,0,0,0,1.0,1,1.0,1,1.0,1,0.1753915948400299,40
60,2,170,39,131,0,0,0,1.0,1,1.0,1,1.0,1,0.15541897206154487,40
61,2,172,39,133,0,0,0,1.0,1,1.0,1,1.0,1,0.12945772432652655,40
62,3,175,40,135,0,0,0,1.0,1,1.0,1,1.0,1,0.12565976278416863,42
63,2,177,40,137,0,0,0,1.0,1,1.0,1,1.0,1,0.1351598020794744,40
64,1,178,40,138,0,0,0,1.0,1,1.0,1,1.0,1,0.12964191061870847,41
65,0,178,40,138,0,0,0,1.0,1,1.0,1,1.0,1,0.12964191061870847,41
66,1,179,41,138,0,0,0,1.0,1,1.0,1,1.0,1,0.1430524364814994,41
67,0,179,41,138,0,0,0,1.0,1,1.0,1,1.0,1,0.1430524364814994,41
68,1,180,42,138,0,0,0,1.0,1,1.0,1,1.0,1,0.13550814832265057,41
69,0,180,42,138,0,0,0,1.0,1,1.0,1,1.0,1,0.15137549826430874,41
70,2,182,43,139,0,0,0,1.0,1,1.0,1,1.0,1,0.1742496187960073,42
71,2,184,44,140,0,0,0,1.0,1,1.0,1,1.0,1,0.14577479689692396,44
72,3,187,45,142,0,0,0,1.0,1,1.0,1,1.0,1,0.12778981837947165,44
73,4,191,45,146,0,0,0,1.0,1,1.0,1,1.0,1,0.11116107883790405,46
74,0,191,45,146,0,0,0,1.0,1,1.0,1,1.0,1,0.1355420769793497,44
75,2,193,45,148,0,0,0,1.0,1,1.0,1,1.0,1,0.14711369695663354,44
76,5,198,48,150,0,0,0,1.0,1,1.0,1,1.0,1,0.22386391505155534,45
77,2,200,49,151,0,0,0,1.0,1,1.0,1,1.0,1,0.20439354577465993,44
78,2,202,50,152,0,0,0,1.0,1,1.0,1,1.0,1,0.22960112704562652,44
79,3,205,50,155,0,0,0,1.0,1,1.0,1,1.0,1,0.1757155192204591,43
80,2,207,51,156,0,0,0,1.0,1,1.0,1,1.0,1,0.1636746639869791,43
81,5,212,53,159,0,0,0,1.0,1,1.0,1,1.0,1,0.22958629337274047,44
82,7,219,56,163,0,0,0,1.0,1,1.0,1,1.0,1,0.16357047503426794,45
83,3,222,58,164,0,0,0,1.0,1,1.0,1,1.0,1,0.2249078873132914,45
84,4,226,58,168,0,0,0,1.0,1,1.0,1,1.0,1,0.2249078873132914,45
85,1,227,58,169,0,0,0,1.0,1,1.0,1,1.0,1,0.21560866911764506,45
86,1,228,58,170,0,0,0,1.0,1,1.0,1,1.0,1,0.18372049667115578,45
87,0,228,58,170,0,0,0,1.0,1,1.0,1,1.0,1,0.19677487551773412,44
88,0,228,58,170,0,0,0,1.0,1,1.0,1,1.0,1,0.189637753520252,45
89,0,228,58,170,0,0,0,1.0,1,1.0,1,1.0,1,0.19674843762141814,46
90,0,228,58,170,0,0,0,1.0,1,1.0,1,1.0,1,0.22391742990000169,44
91,1,229,59,170,0,0,0,1.0,1,1.0,1,1.0,1,0.22457732172863315,45
92,0,229,59,170,0,0,0,1.0,1,1.0,1,1.0,1,0.23888007330723462,46
93,0,229,59,170,0,0,0,1.0,1,1.0,1,1.0,1,0.23888007330723462,46
94,0,229,59,170,0,0,0,1.0,1,1.0,1,1.0,1,0.23888007330723462,46
95,2,231,59,172,0,0,0,1.0,1,1.0,1,1.0,1,0.2348680013014442,46
96,1,232,60,172,0,0,0,1.0,1,1.0,1,1.0,1,0.24792662528262827,46
97,4,236,60,176,0,0,0,1.0,1,1.0,1,1.0,1,0.1766238953626904,47
98,0,236,60,176,0,0,0,1.0,1,1.0,1,1.0,1,0.1766238953626904,47
99,0,236,60,176,0,0,0,1.0,1,1.0,1,1.0,1,0.1879150775247152,46
100,0,236,60,176,0,0,0,1.0,1,1.0,1,1.0,1,0.2131161655328901,48
101,1,237,61,176,0,0,0,1.0,1,1.0,1,1.0,1,0.219926571374417,49
102,1,238,62,176,0,0,0,1.0,1,1.0,1,1.0,1,0.226028427408895,49
103,6,244,63,181,0,0,0,1.0,1,1.0,1,1.0,1,0.13575963055715728,48
104,4,248,66,182,0,0,0,1.0,1,1.0,1,1.0,1,0.19241698439813296,49
105,7,255,68,187,0,0,0,1.0,1,1.0,1,1.0,1,0.1498929551037061,48
106,5,260,69,191,0,0,0,1.0,1,1.0,1,1.0,1,0.0945607575607811,48
107,3,263,71,192,0,0,0,1.0,1,1.0,1,1.0,1,0.12506111873569276,47
108,2,265,71,194,0,0,0,1.0,1,1.0,1,1.0,1,0.14461190859224596,47
109,5,270,73,197,0,0,0,1.0,1,1.0,1,1.0,1,0.10497303530496467,47
110,1,271,74,197,0,0,0,1.0,1,1.0,1,1.0,1,0.11500364914496637,47
111,3,274,75,199,0,0,0,1.0,1,1.0,1,1.0,1,0.08325079122511954,46
112,4,278,78,200,0,0,0,1.0,1,1.0,1,1.0,1,0.07373433299021066,46
113,2,280,80,200,0,0,0,1.0,1,1.0,1,1.0,1,0.15312313336950745,45
114,1,281,80,201,0,0,0,1.0,1,1.0,1,1.0,1,0.11888130967893672,46
115,5,286,82,204,0,0,0,1.0,1,1.0,1,1.0,1,0.10577943220257557,47
116,0,286,82,204,0,0,0,1.0,1,1.0,1,1.0,1,0.0830596685455236,48
117,4,290,85,205,0,0,0,1.0,1,1.0,1,1.0,1,0.1464349421258335,48
118,2,292,85,207,0,0,0,1.0,1,1.0,1,1.0,1,0.1446963722494039,49
119,1,293,85,208,0,0,0,1.0,1,1.0,1,1.0,1,0.12288572596290495,50
120,3,296,85,211,0,0,0,1.0,1,1.0,1,1.0,1,0.1022929578147486,51
121,1,297,85,212,0,0,0,1.0,1,1.0,1,1.0,1,0.09134678502369538,51
122,0,297,85,212,0,0,0,1.0,1,1.0,1,1.0,1,0.09134678502369538,51
123,0,297,85,212,0,0,0,1.0,1,1.0,1,1.0,1,0.09134678502369538,51
124,0,297,85,212,0,0,0,1.0,1,1.0,1,1.0,1,0.09134678502369538,51
125,0,297,85,212,0,0,0,1.0,1,1.0,1,1.0,1,0.14587418722224849,50
126,2,299,87,212,0,0,0,1.0,1,1.0,1,1.0,1,0.17194320912345581,52
127,6,305,87,218,0,0,0,1.0,1,1.0,1,1.0,1,0.10323454998243574,50
128,0,305,87,218,0,0,0,1.0,1,1.0,1,1.0,1,0.10323454998243574,50
129,1,306,87,219,0,0,0,1.0,1,1.0,1,1.0,1,0.1210598266274036,52
130,3,309,88,221,0,0,0,1.0,1,1.0,1,1.0,1,0.11616863483270033,52
131,2,311,88,223,0,0,0,1.0,1,1.0,1,1.0,1,0.09868440458651152,54
132,1,312,89,223,0,0,0,1.0,1,1.0,1,1.0,1,0.0937450261424927,54
133,1,313,89,224,0,0,0,1.0,1,1.0,1,1.0,1,0.0954293510998873,52
134,1,314,90,224,0,0,0,1.0,1,1.0,1,1.0,1,0.07994733413321749,52
135,6,320,94,226,0,0,0,1.0,1,1.0,1,1.0,1,0.12201512284913649,51
136,6,326,95,231,0,0,0,1.0,1,1.0,1,1.0,1,0.06376543698003216,51
137,1,327,95,232,0,0,0,1.0,1,1.0,1,1.0,1,0.04616933571530381,50
138,3,330,97,233,0,0,0,1.0,1,1.0,1,1.0,1,0.07419388992719407,52
139,2,332,98,234,0,0,0,1.0,1,1.0,1,1.0,1,0.08948201356664791,51
140,2,334,99,235,0,0,0,1.0,1,1.0,1,1.0,1,0.0713539466505291,51
141,3,337,100,237,0,0,0,1.0,1,1.0,1,1.0,1,0.09381431767869133,50
142,2,339,101,238,0,0,0,1.0,1,1.0,1,1.0,1,0.10069562451442496,51
143,0,339,101,238,0,0,0,1.0,1,1.0,1,1.0,1,0.09653777446061287,48
144,3,342,103,239,0,0,0,1.0,1,1.0,1,1.0,1,0.10521796660857742,49
145,3,345,105,240,0,0,0,1.0,1,1.0,1,1.0,1,0.0710973146157177,47
146,2,347,106,241,0,0,0,1.0,1,1.0,1,1.0,1,0.08876808825560636,49
147,1,348,106,242,0,0,0,1.0,1,1.0,1,1.0,1,0.10167927415339925,46
148,2,350,107,243,0,0,0,1.0,1,1.0,1,1.0,1,0.07239810295101566,47
149,3,353,110,243,0,0,0,1.0,1,1.0,1,1.0,1,0.07151136217469213,46
150,0,353,110,243,0,0,0,1.0,1,1.0,1,1.0,1,0.057426695615428826,47
151,1,354,111,243,0,0,0,1.0,1,1.0,1,1.0,1,0.0690464450169448,46
152,0,354,111,243,0,0,0,1.0,1,1.0,1,1.0,1,0.08311905822742027,45
153,1,355,111,244,0,0,0,1.0,1,1.0,1,1.0,1,0.08380817212318704,46
154,0,355,111,244,0,0,0,1.0,1,1.0,1,1.0,1,0.11337818847418442,44
155,3,358,113,245,0,0,0,1.0,1,1.0,1,1.0,1,0.11633532473169396,45
156,1,359,114,245,0,0,0,1.0,1,1.0,1,1.0,1,0.13752533791718527,43
157,2,361,115,246,0,0,0,1.0,1,1.0,1,1.0,1,0.11928519162733509,42
158,2,363,115,248,0,0,0,1.0,1,1.0,1,1.0,1,0.1093162271373696,43
159,3,366,116,250,0,0,0,1.0,1,1.0,1,1.0,1,0.1324158825713635,44
160,4,370,117,253,0,0,0,1.0,1,1.0,1,1.0,1,0.09312945332902615,44
161,3,373,120,253,0,0,0,1.0,1,1.0,1,1.0,1,0.1327160398135992,44
162,2,375,122,253,0,0,0,1.0,1,1.0,1,1.0,1,0.16694602433289227,44
163,10,385,127,258,0,0,0,1.0,1,1.0,1,1.0,1,0.2104677049021857,44
164,5,390,128,262,0,0,0,1.0,1,1.0,1,1.0,1,0.22789430505722447,44
165,5,395,130,265,0,0,0,1.0,1,1.0,1,1.0,1,0.11024642897082805,43
166,2,397,130,267,0,0,0,1.0,1,1.0,1,1.0,1,0.10951636180821077,43
167,0,397,130,267,0,0,0,1.0,1,1.0,1,1.0,1,0.09467246360673086,42
168,2,399,131,268,0,0,0,1.0,1,1.0,1,1.0,1,0.14160651080268227,40
169,6,405,133,272,0,0,0,1.0,1,1.0,1,1.0,1,0.1399991670199883,41
170,1,406,133,273,0,0,0,1.0,1,1.0,1,1.0,1,0.1118103537815556,39
171,1,407,134,273,0,0,0,1.0,1,1.0,1,1.0,1,0.12836996391720246,39
172,2,409,134,275,0,0,0,1.0,1,1.0,1,1.0,1,0.05677029950474704,38
173,1,410,135,275,0,0,0,1.0,1,1.0,1,1.0,1,0.10484563027076753,38
174,2,412,135,277,0,0,0,1.0,1,1.0,1,1.0,1,0.12601905463793234,37
175,1,413,136,277,0,0,0,1.0,1,1.0,1,1.0,1,0.1521478100299572,36
176,1,414,136,278,0,0,0,1.0,1,1.0,1,1.0,1,0.13206076147206613,36
177,3,417,139,278,0,0,0,1.0,1,1.0,1,1.0,1,0.1642494485031518,38
178,4,421,140,281,0,0,0,1.0,1,1.0,1,1.0,1,0.1402089575623972,39
179,0,421,140,281,0,0,0,1.0,1,1.0,1,1.0,1,0.1567900328617419,40
180,0,421,140,281,0,0,0,1.0,1,1.0,1,1.0,1,0.1567900328617419,40
181,2,423,140,283,0,0,0,1.0,1,1.0,1,1.0,1,0.17571561274473246,39
182,2,425,141,284,0,0,0,1.0,1,1.0,1,1.0,1,0.14749808106827172,40
183,1,426,142,284,0,0,0,1.0,1,1.0,1,1.0,1,0.1824475043425867,40
184,1,427,142,285,0,0,0,1.0,1,1.0,1,1.0,1,0.16561739411487422,38
185,4,431,143,288,0,0,0,1.0,1,1.0,1,1.0,1,0.14318589176715293,38
186,4,435,145,290,0,0,0,1.0,1,1.0,1,1.0,1,0.13607866296336202,37
187,2,437,146,291,0,0,0,1.0,1,1.0,1,1.0,1,0.10588704789545891,36
188,1,438,147,291,0,0,0,1.0,1,1.0,1,1.0,1,0.10451737123523414,36
189,2,440,148,292,0,0,0,1.0,1,1.0,1,1.0,1,0.09802526765417044,36
190,2,442,149,293,0,0,0,1.0,1,1.0,1,1.0,1,0.14260491492880636,36
191,3,445,151,294,0,0,0,1.0,1,1.0,1,1.0,1,0.1625339325402417,37
192,1,446,152,294,0,0,0,1.0,1,1.0,1,1.0,1,0.16558962193866264,37
193,3,449,152,297,0,0,0,1.0,1,1.0,1,1.0,1,0.10985001330467034,38
194,2,451,153,298,0,0,0,1.0,1,1.0,1,1.0,1,0.11082340536822166,39
195,2,453,154,299,0,0,0,1.0,1,1.0,1,1.0,1,0.10075200454697311,40
196,0,453,154,299,0,0,0,1.0,1,1.0,1,1.0,1,0.10075200454697311,40
197,1,454,154,300,0,0,0,1.0,1,1.0,1,1.0,1,0.11816919478971397,40
198,1,455,155,300,0,0,0,1.0,1,1.0,1,1.0,1,0.10618477297408599,40
199,1,456,156,300,0,0,0,1.0,1,1.0,1,1.0,1,0.11777001948243021,40
200,1,457,156,301,0,0,0,1.0,1,1.0,1,1.0,1,0.11065848004907397,40
201,2,459,158,301,0,0,0,1.0,1,1.0,1,1.0,1,0.11617019102562286,39
202,1,460,158,302,0,0,0,1.0,1,1.0,1,1.0,1,0.08761330430680553,40
203,1,461,159,302,0,0,0,1.0,1,1.0,1,1.0,1,0.13863662100297902,39
204,2,463,161,302,0,0,0,1.0,1,1.0,1,1.0,1,0.12782557635293934,38
205,1,464,161,303,0,0,0,1.0,1,1.0,1,1.0,1,0.08226721067798429,37
206,1,465,162,303,0,0,0,1.0,1,1.0,1,1.0,1,0.1169475600857727,36
207,1,466,163,303,0,0,0,1.0,1,1.0,1,1.0,1,0.12455555350165941,37
208,3,469,163,306,0,0,0,1.0,1,1.0,1,1.0,1,0.14114692339305868,36
209,2,471,165,306,0,0,0,1.0,1,1.0,1,1.0,1,0.1674417235203654,36
210,1,472,165,307,0,0,0,1.0,1,1.0,1,1.0,1,0.19839375594505862,36
211,1,473,165,308,0,0,0,1.0,1,1.0,1,1.0,1,0.19237214207180084,34
212,1,474,166,308,0,0,0,1.0,1,1.0,1,1.0,1,0.21780469890013285,34
213,1,475,166,309,0,0,0,1.0,1,1.0,1,1.0,1,0.20087008579207627,36
214,2,477,167,310,0,0,0,1.0,1,1.0,1,1.0,1,0.2237541282358836,35
215,4,481,168,313,0,0,0,1.0,1,1.0,1,1.0,1,0.19847095533075873,35
216,1,482,168,314,0,0,0,1.0,1,1.0,1,1.0,1,0.18821401873239157,37
217,2,484,169,315,0,0,0,1.0,1,1.0,1,1.0,1,0.16986301788446576,37
218,4,488,171,317,0,0,0,1.0,1,1.0,1,1.0,1,0.13993956635646335,37
219,4,492,172,320,0,0,0,1.0,1,1.0,1,1.0,1,0.18912968900276553,37
220,4,496,172,324,0,0,0,1.0,1,1.0,1,1.0,1,0.12187485853825786,38
221,3,499,172,327,0,0,0,1.0,1,1.0,1,1.0,1,0.0942054572454574,39
222,0,499,172,327,0,0,0,1.0,1,1.0,1,1.0,1,0.0942054572454574,39
223,3,502,173,329,0,0,0,1.0,1,1.0,1,1.0,1,0.08570891270128077,40
224,5,507,176,331,0,0,0,1.0,1,1.0,1,1.0,1,0.16993378747204102,40
225,1,508,176,332,0,0,0,1.0,1,1.0,1,1.0,1,0.14923268367537915,39
226,4,512,178,334,0,0,0,1.0,1,1.0,1,1.0,1,0.10743331916550918,39
227,1,513,178,335,0,0,0,1.0,1,1.0,1,1.0,1,0.10757047082711071,39
228,0,513,178,335,0,0,0,1.0,1,1.0,1,1.0,1,0.10539514927012875,38
229,4,517,180,337,0,0,0,1.0,1,1.0,1,1.0,1,0.0769646284719111,39
230,1,518,181,337,0,0,0,1.0,1,1.0,1,1.0,1,0.07721963781367651,38
231,4,522,184,338,0,0,0,1.0,1,1.0,1,1.0,1,0.12567213985690603,38
232,4,526,187,339,0,0,0,1.0,1,1.0,1,1.0,1,0.148281497885967,37
233,2,528,188,340,0,0,0,1.0,1,1.0,1,1.0,1,0.1587987256856573,36
234,0,528,188,340,0,0,0,1.0,1,1.0,1,1.0,1,0.1541891510267786,34
235,1,529,189,340,0,0,0,1.0,1,1.0,1,1.0,1,0.23376590916686718,34
236,2,531,189,342,0,0,0,1.0,1,1.0,1,1.0,1,0.19168179542653294,33
237,0,531,189,342,0,0,0,1.0,1,1.0,1,1.0,1,0.22633074062651967,32
238,4,535,190,345,0,0,0,1.0,1,1.0,1,1.0,1,0.22497277122805132,32
239,3,538,193,345,0,0,0,1.0,1,1.0,1,1.0,1,0.22238860535306706,31
240,0,538,193,345,0,0,0,1.0,1,1.0,1,1.0,1,0.2668601035120939,28
241,4,542,194,348,0,0,0,1.0,1,1.0,1,1.0,1,0.253204452116599,27
242,2,544,195,349,0,0,0,1.0,1,1.0,1,1.0,1,0.26194135991242945,29
243,2,546,196,350,0,0,0,1.0,1,1.0,1,1.0,1,0.28541551928894426,28
244,2,548,196,352,0,0,0,1.0,1,1.0,1,1.0,1,0.199663006013878,28
245,2,550,196,354,0,0,0,1.0,1,1.0,1,1.0,1,0.10594176116418512,27
246,1,551,197,354,0,0,0,1.0,1,1.0,1,1.0,1,0.09982523799668346,25
247,0,551,197,354,0,0,0,1.0,1,1.0,1,1.0,1,0.1377536620271784,26
248,1,552,197,355,0,0,0,1.0,1,1.0,1,1.0,1,0.0949153862820708,27
249,1,553,198,355,0,0,0,1.0,1,1.0,1,1.0,1,0.1577783334028972,26
250,0,553,198,355,0,0,0,1.0,1,1.0,1,1.0,1,0.18948461589001062,27
251,2,555,198,357,0,0,0,1.0,1,1.0,1,1.0,1,0.15475343377984355,28
252,1,556,199,357,0,0,0,1.0,1,1.0,1,1.0,1,0.17057737913580884,28
253,1,557,200,357,0,0,0,1.0,1,1.0,1,1.0,1,0.19906318077687937,28
254,2,559,201,358,0,0,0,1.0,1,1.0,1,1.0,1,0.22496557456257255,29
255,6,565,202,363,0,0,0,1.0,1,1.0,1,1.0,1,0.1441931790624177,30
256,2,567,203,364,0,0,0,1.0,1,1.0,1,1.0,1,0.17344827575296776,30
257,0,567,203,364,0,0,0,1.0,1,1.0,1,1.0,1,0.1843552833906583,32
258,0,567,203,364,0,0,0,1.0,1,1.0,1,1.0,1,0.1843552833906583,32
259,0,567,203,364,0,0,0,1.0,1,1.0,1,1.0,1,0.1843552833906583,32
260,1,568,203,365,0,0,0,1.0,1,1.0,1,1.0,1,0.1330431385081926,34
261,0,568,203,365,0,0,0,1.0,1,1.0,1,1.0,1,0.15133044558173417,35
262,1,569,204,365,0,0,0,1.0,1,1.0,1,1.0,1,0.21031605799049938,36
263,0,569,204,365,0,0,0,1.0,1,1.0,1,1.0,1,0.18412320748257,34
264,1,570,205,365,0,0,0,1.0,1,1.0,1,1.0,1,0.22640951482162408,34
265,1,571,205,366,0,0,0,1.0,1,1.0,1,1.0,1,0.21714606730282798,33
266,2,573,206,367,0,0,0,1.0,1,1.0,1,1.0,1,0.22134613113228468,34
267,1,574,206,368,0,0,0,1.0,1,1.0,1,1.0,1,0.17896766532371966,33
268,1,575,206,369,0,0,0,1.0,1,1.0,1,1.0,1,0.18277616702313412,34
269,1,576,207,369,0,0,0,1.0,1,1.0,1,1.0,1,0.194083613887462,34
270,2,578,207,371,0,0,0,1.0,1,1.0,1,1.0,1,0.185382239921386,36
271,1,579,207,372,0,0,0,1.0,1,1.0,1,1.0,1,0.1683204741001625,36
272,1,580,207,373,0,0,0,1.0,1,1.0,1,1.0,1,0.18883367674774476,38
273,0,580,207,373,0,0,0,1.0,1,1.0,1,1.0,1,0.18883367674774476,38
274,3,583,209,374,0,0,0,1.0,1,1.0,1,1.0,1,0.21289928987410767,38
275,1,584,209,375,0,0,0,1.0,1,1.0,1,1.0,1,0.18563090424844247,38
276,2,586,209,377,0,0,0,1.0,1,1.0,1,1.0,1,0.18431524957244666,39
277,1,587,210,377,0,0,0,1.0,1,1.0,1,1.0,1,0.22547721024662656,38
278,1,588,210,378,0,0,0,1.0,1,1.0,1,1.0,1,0.1819781391579792,38
279,1,589,210,379,0,0,0,1.0,1,1.0,1,1.0,1,0.1468742672467967,38
280,2,591,212,379,0,0,0,1.0,1,1.0,1,1.0,1,0.19987598671923146,38
281,0,591,212,379,0,0,0,1.0,1,1.0,1,1.0,1,0.18853994219000436,38
282,2,593,212,381,0,0,0,1.0,1,1.0,1,1.0,1,0.131477924473739,38
283,0,593,212,381,0,0,0,1.0,1,1.0,1,1.0,1,0.131477924473739,38
284,1,594,212,382,0,0,0,1.0,1,1.0,1,1.0,1,0.10903553954971554,39
285,1,595,213,382,0,0,0,1.0,1,1.0,1,1.0,1,0.14328960127031953,39
286,2,597,213,384,0,0,0,1.0,1,1.0,1,1.0,1,0.13272264654285484,39
287,1,598,214,384,0,0,0,1.0,1,1.0,1,1.0,1,0.22849381422457143,39
288,1,599,214,385,0,0,0,1.0,1,1.0,1,1.0,1,0.1852010054624141,39
289,1,600,214,386,0,0,0,1.0,1,1.0,1,1.0,1,0.17745976884184006,39
290,0,600,214,386,0,0,0,1.0,1,1.0,1,1.0,1,0.17777602529947142,39
291,1,601,215,386,0,0,0,1.0,1,1.0,1,1.0,1,0.18993818285158987,39
292,4,605,216,389,0,0,0,1.0,1,1.0,1,1.0,1,0.14990831172204372,40
293,2,607,217,390,0,0,0,1.0,1,1.0,1,1.0,1,0.15082326216354663,41
294,2,609,218,391,0,0,0,1.0,1,1.0,1,1.0,1,0.145480987308468,40
295,6,615,221,394,0,0,0,1.0,1,1.0,1,1.0,1,0.0830990892198137,42
296,2,617,223,394,0,0,0,1.0,1,1.0,1,1.0,1,0.10961569736777559,42
297,6,623,224,399,0,0,0,1.0,1,1.0,1,1.0,1,0.07308210572213032,43
298,1,624,225,399,0,0,0,1.0,1,1.0,1,1.0,1,0.10232688657395668,44
299,0,624,225,399,0,0,0,1.0,1,1.0,1,1.0,1,0.10232688657395668,44
300,5,629,226,403,0,0,0,1.0,1,1.0,1,1.0,1,0.11818572730242398,45
301,4,633,228,405,0,0,0,1.0,1,1.0,1,1.0,1,0.10445556802537909,47
302,2,635,229,406,0,0,0,1.0,1,1.0,1,1.0,1,0.08123643357560223,46
303,2,637,230,407,0,0,0,1.0,1,1.0,1,1.0,1,0.08691829822137315,45
304,3,640,233,407,0,0,0,1.0,1,1.0,1,1.0,1,0.15058238127766657,45
305,0,640,233,407,0,0,0,1.0,1,1.0,1,1.0,1,0.14246402876780145,43
306,2,642,234,408,0,0,0,1.0,1,1.0,1,1.0,1,0.16605326830435144,44
307,6,648,236,412,0,0,0,1.0,1,1.0,1,1.0,1,0.11897478080693386,42
308,1,649,237,412,0,0,0,1.0,1,1.0,1,1.0,1,0.11718936396186991,41
309,2,651,237,414,0,0,0,1.0,1,1.0,1,1.0,1,0.09945887244373443,42
310,0,651,237,414,0,0,0,1.0,1,1.0,1,1.0,1,0.10119310316868138,41
311,0,651,237,414,0,0,0,1.0,1,1.0,1,1.0,1,0.10119310316868138,41
312,0,651,237,414,0,0,0,1.0,1,1.0,1,1.0,1,0.09569326364490557,44
313,0,651,237,414,0,0,0,1.0,1,1.0,1,1.0,1,0.10736212868332205,43
314,1,652,238,414,0,0,0,1.0,1,1.0,1,1.0,1,0.11356094076491845,43
315,0,652,238,414,0,0,0,1.0,1,1.0,1,1.0,1,0.0858062239980887,43
316,1,653,239,414,0,0,0,1.0,1,1.0,1,1.0,1,0.09354915693712781,43
317,0,653,239,414,0,0,0,1.0,1,1.0,1,1.0,1,0.10206482177759049,44
318,4,657,242,415,0,0,0,1.0,1,1.0,1,1.0,1,0.18646360279895577,45
319,5,662,242,420,0,0,0,1.0,1,1.0,1,1.0,1,0.11257189038465652,46
320,1,663,242,421,0,0,0,1.0,1,1.0,1,1.0,1,0.10980152252261703,45
321,0,663,242,421,0,0,0,1.0,1,1.0,1,1.0,1,0.11264049812181065,44
322,2,665,242,423,0,0,0,1.0,1,1.0,1,1.0,1,0.10327742897371471,42
323,3,668,244,424,0,0,0,1.0,1,1.0,1,1.0,1,0.11734602627456422,42
324,2,670,244,426,0,0,0,1.0,1,1.0,1,1.0,1,0.1258880627550574,43
325,5,675,246,429,0,0,0,1.0,1,1.0,1,1.0,1,0.16186035390002432,43
326,0,675,246,429,0,0,0,1.0,1,1.0,1,1.0,1,0.16186035390002432,43
327,1,676,247,429,0,0,0,1.0,1,1.0,1,1.0,1,0.20204542049677818,44
328,6,682,248,434,0,0,0,1.0,1,1.0,1,1.0,1,0.16432861644617838,44
329,1,683,248,435,0,0,0,1.0,1,1.0,1,1.0,1,0.1260892261181052,45
330,0,683,248,435,0,0,0,1.0,1,1.0,1,1.0,1,0.13166121007562698,46
331,0,683,248,435,0,0,0,1.0,1,1.0,1,1.0,1,0.13166121007562698,46
332,1,684,248,436,0,0,0,1.0,1,1.0,1,1.0,1,0.09489423628445104,47
333,2,686,248,438,0,0,0,1.0,1,1.0,1,1.0,1,0.09907340349379497,48
334,1,687,248,439,0,0,0,1.0,1,1.0,1,1.0,1,0.08318719972201612,48
335,2,689,249,440,0,0,0,1.0,1,1.0,1,1.0,1,0.09000611105012966,49
336,0,689,249,440,0,0,0,1.0,1,1.0,1,1.0,1,0.10980064347536546,50
337,2,691,249,442,0,0,0,1.0,1,1.0,1,1.0,1,0.11411754793236739,51
338,5,696,250,446,0,0,0,1.0,1,1.0,1,1.0,1,0.10857290090048352,51
339,2,698,251,447,0,0,0,1.0,1,1.0,1,1.0,1,0.07391853235612525,51
340,1,699,252,447,0,0,0,1.0,1,1.0,1,1.0,1,0.08456681057847922,51
341,0,699,252,447,0,0,0,1.0,1,1.0,1,1.0,1,0.07934798135951479,51
342,2,701,253,448,0,0,0,1.0,1,1.0,1,1.0,1,0.08087830860053814,51
343,1,702,253,449,0,0,0,1.0,1,1.0,1,1.0,1,0.09888865431004719,51
344,1,703,254,449,0,0,0,1.0,1,1.0,1,1.0,1,0.12380586788300027,50
345,1,704,254,450,0,0,0,1.0,1,1.0,1,1.0,1,0.10233737204043063,50
346,4,708,256,452,0,0,0,1.0,1,1.0,1,1.0,1,0.1487515200342711,50
347,1,709,256,453,0,0,0,1.0,1,1.0,1,1.0,1,0.1550442266078537,51
348,4,713,258,455,0,0,0,1.0,1,1.0,1,1.0,1,0.16702296698717672,52
349,5,718,260,458,0,0,0,1.0,1,1.0,1,1.0,1,0.11556885578045026,54
350,2,720,260,460,0,0,0,1.0,1,1.0,1,1.0,1,0.13312273524416143,54
351,1,721,261,460,0,0,0,1.0,1,1.0,1,1.0,1,0.1467017256958761,54
352,2,723,261,462,0,0,0,1.0,1,1.0,1,1.0,1,0.12397774939334347,56
353,3,726,264,462,0,0,0,1.0,1,1.0,1,1.0,1,0.14707470677712642,54
354,1,727,264,463,0,0,0,1.0,1,1.0,1,1.0,1,0.15663286496508863,53
355,3,730,265,465,0,0,0,1.0,1,1.0,1,1.0,1,0.1338626278643361,54
356,2,732,266,466,0,0,0,1.0,1,1.0,1,1.0,1,0.1543556675480187,54
357,2,734,268,466,0,0,0,1.0,1,1.0,1,1.0,1,0.17451523794412258,53
358,1,735,268,467,0,0,0,1.0,1,1.0,1,1.0,1,0.1326889458843368,49
359,0,735,268,467,0,0,0,1.0,1,1.0,1,1.0,1,0.13437293064390124,48
360,1,736,268,468,0,0,0,1.0,1,1.0,1,1.0,1,0.12295608201423666,47
361,0,736,268,468,0,0,0,1.0,1,1.0,1,1.0,1,0.13084629568732806,46
362,0,736,268,468,0,0,0,1.0,1,1.0,1,1.0,1,0.12957560033948318,46
363,0,736,268,468,0,0,0,1.0,1,1.0,1,1.0,1,0.1509954346800191,47
364,0,736,268,468,0,0,0,1.0,1,1.0,1,1.0,1,0.1509954346800191,47
365,3,739,270,469,0,0,0,1.0,1,1.0,1,1.0,1,0.18974057869141853,47
366,5,744,272,472,0,0,0,1.0,1,1.0,1,1.0,1,0.17395686050545217,50
367,3,747,272,475,0,0,0,1.0,1,1.0,1,1.0,1,0.11545882854897441,50
368,0,747,272,475,0,0,0,1.0,1,1.0,1,1.0,1,0.09339380137616411,51
369,0,747,272,475,0,0,0,1.0,1,1.0,1,1.0,1,0.11183979647449546,51
370,1,748,272,476,0,0,0,1.0,1,1.0,1,1.0,1,0.09929969620524899,51
371,0,748,272,476,0,0,0,1.0,1,1.0,1,1.0,1,0.1078940154801787,52
372,1,749,272,477,0,0,0,1.0,1,1.0,1,1.0,1,0.0906279234488635,53
373,2,751,274,477,0,0,0,1.0,1,1.0,1,1.0,1,0.11224077369185188,53
374,3,754,275,479,0,0,0,1.0,1,1.0,1,1.0,1,0.12591429490232317,53
375,5,759,279,480,0,0,0,1.0,1,1.0,1,1.0,1,0.15645626406356491,53
376,6,765,280,485,0,0,0,1.0,1,1.0,1,1.0,1,0.06320576868349913,53
377,2,767,282,485,0,0,0,1.0,1,1.0,1,1.0,1,0.05403939889997225,53
378,1,768,283,485,0,0,0,1.0,1,1.0,1,1.0,1,0.07599951725665492,53
379,1,769,284,485,0,0,0,1.0,1,1.0,1,1.0,1,0.09224247840962074,54
380,2,771,285,486,0,0,0,1.0,1,1.0,1,1.0,1,0.049079979162621384,54
381,1,772,286,486,0,0,0,1.0,1,1.0,1,1.0,1,0.06726296178964042,54
382,1,773,287,486,0,0,0,1.0,1,1.0,1,1.0,1,0.07926481633747859,55
383,3,776,289,487,0,0,0,1.0,1,1.0,1,1.0,1,0.08038676182550046,55
384,1,777,290,487,0,0,0,1.0,1,1.0,1,1.0,1,0.11897314096002708,54
385,3,780,291,489,0,0,0,1.0,1,1.0,1,1.0,1,0.10414636790602991,52
386,1,781,292,489,0,0,0,1.0,1,1.0,1,1.0,1,0.13143935538603466,52
387,2,783,293,490,0,0,0,1.0,1,1.0,1,1.0,1,0.1159498944018203,50
388,3,786,294,492,0,0,0,1.0,1,1.0,1,1.0,1,0.1201187716061856,52
389,4,790,295,495,0,0,0,1.0,1,1.0,1,1.0,1,0.12583218429010146,51
390,3,793,297,496,0,0,0,1.0,1,1.0,1,1.0,1,0.12203341355316338,50
391,5,798,300,498,0,0,0,1.0,1,1.0,1,1.0,1,0.11468421512890174,49
392,5,803,302,501,0,0,0,1.0,1,1.0,1,1.0,1,0.10987007005209158,47
393,5,808,306,502,0,0,0,1.0,1,1.0,1,1.0,1,0.22284850599598746,47
394,12,820,309,511,0,0,0,1.0,1,1.0,1,1.0,1,0.18645869066309478,48
395,2,822,310,512,0,0,0,1.0,1,1.0,1,1.0,1,0.24505125108705003,46
396,2,824,310,514,0,0,0,1.0,1,1.0,1,1.0,1,0.2012929658479524,43
397,6,830,310,520,0,0,0,1.0,1,1.0,1,1.0,1,0.12441574395447239,42
398,2,832,310,522,0,0,0,1.0,1,1.0,1,1.0,1,0.12043305673364713,40
399,1,833,311,522,0,0,0,1.0,1,1.0,1,1.0,1,0.10951275130824428,39
400,2,835,312,523,0,0,0,1.0,1,1.0,1,1.0,1,0.11353242833819417,38
401,0,835,312,523,0,0,0,1.0,1,1.0,1,1.0,1,0.11047828249307322,37
402,0,835,312,523,0,0,0,1.0,1,1.0,1,1.0,1,0.1311412194343748,36
403,2,837,313,524,0,0,0,1.0,1,1.0,1,1.0,1,0.11473842165068958,38
404,2,839,314,525,0,0,0,1.0,1,1.0,1,1.0,1,0.1320240339063291,39
405,1,840,314,526,0,0,0,1.0,1,1.0,1,1.0,1,0.10650062122731757,40
406,1,841,314,527,0,0,0,1.0,1,1.0,1,1.0,1,0.09967644968343972,41
407,1,842,314,528,0,0,0,1.0,1,1.0,1,1.0,1,0.10920414037759567,42
408,3,845,315,530,0,0,0,1.0,1,1.0,1,1.0,1,0.1426504880364344,43
409,2,847,316,531,0,0,0,1.0,1,1.0,1,1.0,1,0.16477190030587974,44
410,1,848,316,532,0,0,0,1.0,1,1.0,1,1.0,1,0.16910188859953137,46
411,0,848,316,532,0,0,0,1.0,1,1.0,1,1.0,1,0.16910188859953137,46
412,3,851,316,535,0,0,0,1.0,1,1.0,1,1.0,1,0.13176825064946435,47
413,1,852,317,535,0,0,0,1.0,1,1.0,1,1.0,1,0.16149133092573514,47
414,1,853,317,536,0,0,0,1.0,1,1.0,1,1.0,1,0.14344198864246732,47
415,2,855,317,538,0,0,0,1.0,1,1.0,1,1.0,1,0.14106707285250067,48
416,7,862,319,543,0,0,0,1.0,1,1.0,1,1.0,1,0.20491395553700692,49
417,2,864,319,545,0,0,0,1.0,1,1.0,1,1.0,1,0.17709224698122605,49
418,1,865,319,546,0,0,0,1.0,1,1.0,1,1.0,1,0.18793564991212192,50
419,3,868,320,548,0,0,0,1.0,1,1.0,1,1.0,1,0.13300990688365547,50
420,0,868,320,548,0,0,0,1.0,1,1.0,1,1.0,1,0.13300990688365547,50
421,1,869,320,549,0,0,0,1.0,1,1.0,1,1.0,1,0.12799865441652777,50
422,1,870,320,550,0,0,0,1.0,1,1.0,1,1.0,1,0.14290214087481656,50
423,4,874,323,551,0,0,0,1.0,1,1.0,1,1.0,1,0.1899535371767948,51
424,6,880,323,557,0,0,0,1.0,1,1.0,1,1.0,1,0.1114537295197901,49
425,1,881,323,558,0,0,0,1.0,1,1.0,1,1.0,1,0.11389220597855164,48
426,3,884,323,561,0,0,0,1.0,1,1.0,1,1.0,1,0.0755063170651457,50
427,5,889,325,564,0,0,0,1.0,1,1.0,1,1.0,1,0.10437563367471164,48
428,0,889,325,564,0,0,0,1.0,1,1.0,1,1.0,1,0.11398963761098842,49
429,1,890,326,564,0,0,0,1.0,1,1.0,1,1.0,1,0.1259627102519513,45
430,9,899,328,571,0,0,0,1.0,1,1.0,1,1.0,1,0.11568750647336795,44
431,3,902,329,573,0,0,0,1.0,1,1.0,1,1.0,1,0.13829315609921222,42
432,3,905,329,576,0,0,0,1.0,1,1.0,1,1.0,1,0.15241004388111265,40
433,5,910,330,580,0,0,0,1.0,1,1.0,1,1.0,1,0.10805671445422686,39
434,1,911,331,580,0,0,0,1.0,1,1.0,1,1.0,1,0.1030941889472152,39
435,3,914,333,581,0,0,0,1.0,1,1.0,1,1.0,1,0.1979923020105737,38
436,6,920,333,587,0,0,0,1.0,1,1.0,1,1.0,1,0.18069658861550839,38
437,4,924,333,591,0,0,0,1.0,1,1.0,1,1.0,1,0.17170180335716428,39
438,2,926,333,593,0,0,0,1.0,1,1.0,1,1.0,1,0.18255799264306313,38
439,4,930,334,596,0,0,0,1.0,1,1.0,1,1.0,1,0.10123036024441952,39
440,0,930,334,596,0,0,0,1.0,1,1.0,1,1.0,1,0.10123036024441952,39
441,2,932,334,598,0,0,0,1.0,1,1.0,1,1.0,1,0.08929443535712836,41
442,0,932,334,598,0,0,0,1.0,1,1.0,1,1.0,1,0.1005066399675051,42
443,1,933,335,598,0,0,0,1.0,1,1.0,1,1.0,1,0.11804748275228982,42
444,3,936,336,600,0,0,0,1.0,1,1.0,1,1.0,1,0.08242826250386329,43
445,3,939,338,601,0,0,0,1.0,1,1.0,1,1.0,1,0.10158861986245515,44
446,0,939,338,601,0,0,0,1.0,1,1.0,1,1.0,1,0.09415618075167702,44
447,2,941,338,603,0,0,0,1.0,1,1.0,1,1.0,1,0.09028326984014898,47
448,3,944,340,604,0,0,0,1.0,1,1.0,1,1.0,1,0.10280103046472397,46
449,0,944,340,604,0,0,0,1.0,1,1.0,1,1.0,1,0.10280103046472397,46
450,2,946,340,606,0,0,0,1.0,1,1.0,1,1.0,1,0.11242859442665087,46
451,2,948,340,608,0,0,0,1.0,1,1.0,1,1.0,1,0.08985677444591056,47
452,0,948,340,608,0,0,0,1.0,1,1.0,1,1.0,1,0.11700258085148252,47
453,0,948,340,608,0,0,0,1.0,1,1.0,1,1.0,1,0.11700258085148252,47
454,3,951,340,611,0,0,0,1.0,1,1.0,1,1.0,1,0.09783627587713525,46
455,1,952,340,612,0,0,0,1.0,1,1.0,1,1.0,1,0.10816126404404913,47
456,1,953,340,613,0,0,0,1.0,1,1.0,1,1.0,1,0.08685356861589998,49
457,1,954,341,613,0,0,0,1.0,1,1.0,1,1.0,1,0.109432529038357,50
458,1,955,341,614,0,0,0,1.0,1,1.0,1,1.0,1,0.09699099603770164,50
459,2,957,341,616,0,0,0,1.0,1,1.0,1,1.0,1,0.067994883288383,52
460,0,957,341,616,0,0,0,1.0,1,1.0,1,1.0,1,0.07229022054450324,53
461,0,957,341,616,0,0,0,1.0,1,1.0,1,1.0,1,0.08731233796060853,54
462,0,957,341,616,0,0,0,1.0,1,1.0,1,1.0,1,0.08731233796060853,54
463,4,961,343,618,0,0,0,1.0,1,1.0,1,1.0,1,0.11194510154476112,55
464,4,965,344,621,0,0,0,1.0,1,1.0,1,1.0,1,0.09084886538150956,56
465,0,965,344,621,0,0,0,1.0,1,1.0,1,1.0,1,0.11714190723076748,54
466,10,975,349,626,0,0,0,1.0,1,1.0,1,1.0,1,0.06876417231914803,54
467,2,977,350,627,0,0,0,1.0,1,1.0,1,1.0,1,0.07810821670248488,51
468,4,981,354,627,0,0,0,1.0,1,1.0,1,1.0,1,0.13916363454708416,51
469,6,987,356,631,0,0,0,1.0,1,1.0,1,1.0,1,0.09738463615210277,48
470,3,990,359,631,0,0,0,1.0,1,1.0,1,1.0,1,0.1707149623608546,47
471,2,992,360,632,0,0,0,1.0,1,1.0,1,1.0,1,0.15775942665907167,44
472,6,998,364,634,0,0,0,1.0,1,1.0,1,1.0,1,0.19156554155808267,43
473,0,998,364,634,0,0,0,1.0,1,1.0,1,1.0,1,0.164067698582621,41
474,0,998,364,634,0,0,0,1.0,1,1.0,1,1.0,1,0.1605101728977226,39
475,5,1003,367,636,0,0,0,1.0,1,1.0,1,1.0,1,0.1698881974019304,40
476,3,1006,368,638,0,0,0,1.0,1,1.0,1,1.0,1,0.21826041517293582,38
477,2,1008,369,639,0,0,0,1.0,1,1.0,1,1.0,1,0.28500080600352273,35
478,5,1013,369,644,0,0,0,1.0,1,1.0,1,1.0,1,0.20088971517956378,35
479,1,1014,370,644,0,0,0,1.0,1,1.0,1,1.0,1,0.21446335755661983,32
480,2,1016,370,646,0,0,0,1.0,1,1.0,1,1.0,1,0.2363330663912168,32
481,1,1017,370,647,0,0,0,1.0,1,1.0,1,1.0,1,0.1953313822401875,33
482,4,1021,371,650,0,0,0,1.0,1,1.0,1,1.0,1,0.183898972693295,34
483,2,1023,372,651,0,0,0,1.0,1,1.0,1,1.0,1,0.1987380445114938,32
484,2,1025,372,653,0,0,0,1.0,1,1.0,1,1.0,1,0.13515901770523842,33
485,1,1026,373,653,0,0,0,1.0,1,1.0,1,1.0,1,0.15013492459348546,34
486,2,1028,373,655,0,0,0,1.0,1,1.0,1,1.0,1,0.13129999053840025,36
487,0,1028,373,655,0,0,0,1.0,1,1.0,1,1.0,1,0.13129999053840025,36
488,2,1030,373,657,0,0,0,1.0,1,1.0,1,1.0,1,0.11347774369363674,37
489,2,1032,374,658,0,0,0,1.0,1,1.0,1,1.0,1,0.13050673219196135,38
490,2,1034,375,659,0,0,0,1.0,1,1.0,1,1.0,1,0.13593894040074972,38
491,0,1034,375,659,0,0,0,1.0,1,1.0,1,1.0,1,0.1267267388992388,37
492,0,1034,375,659,0,0,0,1.0,1,1.0,1,1.0,1,0.1267267388992388,37
493,0,1034,375,659,0,0,0,1.0,1,1.0,1,1.0,1,0.1267267388992388,37
494,4,1038,377,661,0,0,0,1.0,1,1.0,1,1.0,1,0.1530132340537237,39
495,2,1040,378,662,0,0,0,1.0,1,1.0,1,1.0,1,0.1320473371064059,40
496,2,1042,378,664,0,0,0,1.0,1,1.0,1,1.0,1,0.09049110700880553,40
497,0,1042,378,664,0,0,0,1.0,1,1.0,1,1.0,1,0.10596845296732535,43
498,1,1043,379,664,0,0,0,1.0,1,1.0,1,1.0,1,0.11236040270813767,43
499,4,1047,381,666,0,0,0,1.0,1,1.0,1,1.0,1,0.12552843677367864,44
500,2,1049,382,667,0,0,0,1.0,1,1.0,1,1.0,1,0.1356741207663781,45
501,2,1051,383,668,0,0,0,1.0,1,1.0,1,1.0,1,0.15015964874264853,45
502,0,1051,383,668,0,0,0,1.0,1,1.0,1,1.0,1,0.15015964874264853,45
503,2,1053,384,669,0,0,0,1.0,1,1.0,1,1.0,1,0.14744146670149783,46
504,4,1057,386,671,0,0,0,1.0,1,1.0,1,1.0,1,0.14869729599626913,47
505,0,1057,386,671,0,0,0,1.0,1,1.0,1,1.0,1,0.12186676760835898,42
506,4,1061,388,673,0,0,0,1.0,1,1.0,1,1.0,1,0.1379879305028185,41
507,0,1061,388,673,0,0,0,1.0,1,1.0,1,1.0,1,0.17034480993207804,38
508,3,1064,390,674,0,0,0,1.0,1,1.0,1,1.0,1,0.18938496604197083,38
509,0,1064,390,674,0,0,0,1.0,1,1.0,1,1.0,1,0.19098933839358792,37
510,0,1064,390,674,0,0,0,1.0,1,1.0,1,1.0,1,0.1903435744919697,36
511,2,1066,391,675,0,0,0,1.0,1,1.0,1,1.0,1,0.1877512785366248,34
512,0,1066,391,675,0,0,0,1.0,1,1.0,1,1.0,1,0.16371747750183538,32
513,1,1067,391,676,0,0,0,1.0,1,1.0,1,1.0,1,0.1538011560447154,32
514,1,1068,391,677,0,0,0,1.0,1,1.0,1,1.0,1,0.13046729553728112,35
515,1,1069,391,678,0,0,0,1.0,1,1.0,1,1.0,1,0.10962525307559184,35
516,1,1070,392,678,0,0,0,1.0,1,1.0,1,1.0,1,0.15712782002997558,36
517,2,1072,393,679,0,0,0,1.0,1,1.0,1,1.0,1,0.1783060756304853,36
518,4,1076,393,683,0,0,0,1.0,1,1.0,1,1.0,1,0.14926454419395122,39
519,1,1077,393,684,0,0,0,1.0,1,1.0,1,1.0,1,0.14405361909890319,39
520,1,1078,393,685,0,0,0,1.0,1,1.0,1,1.0,1,0.14514329252229974,39
521,1,1079,393,686,0,0,0,1.0,1,1.0,1,1.0,1,0.13168579666490673,40
522,0,1079,393,686,0,0,0,1.0,1,1.0,1,1.0,1,0.13168579666490673,40
523,3,1082,393,689,0,0,0,1.0,1,1.0,1,1.0,1,0.12272242449945554,41
524,0,1082,393,689,0,0,0,1.0,1,1.0,1,1.0,1,0.12272242449945554,41
525,2,1084,394,690,0,0,0,1.0,1,1.0,1,1.0,1,0.13765335312885682,40
526,1,1085,395,690,0,0,0,1.0,1,1.0,1,1.0,1,0.18007042625704778,40
527,1,1086,396,690,0,0,0,1.0,1,1.0,1,1.0,1,0.22765946250413313,40
528,3,1089,397,692,0,0,0,1.0,1,1.0,1,1.0,1,0.18301782086704607,40
529,0,1089,397,692,0,0,0,1.0,1,1.0,1,1.0,1,0.1921773642453404,39
530,1,1090,397,693,0,0,0,1.0,1,1.0,1,1.0,1,0.1728712729953551,39
531,1,1091,397,694,0,0,0,1.0,1,1.0,1,1.0,1,0.171900704972112,39
532,1,1092,398,694,0,0,0,1.0,1,1.0,1,1.0,1,0.2094133471498647,40
533,4,1096,400,696,0,0,0,1.0,1,1.0,1,1.0,1,0.20757277142980954,40
534,2,1098,400,698,0,0,0,1.0,1,1.0,1,1.0,1,0.1996160188190911,42
535,2,1100,400,700,0,0,0,1.0,1,1.0,1,1.0,1,0.1764537632546217,42
536,0,1100,400,700,0,0,0,1.0,1,1.0,1,1.0,1,0.18729635938771058,43
537,0,1100,400,700,0,0,0,1.0,1,1.0,1,1.0,1,0.18729635938771058,43
538,3,1103,402,701,0,0,0,1.0,1,1.0,1,1.0,1,0.20723347765982186,44
539,0,1103,402,701,0,0,0,1.0,1,1.0,1,1.0,1,0.20723347765982186,44
540,1,1104,403,701,0,0,0,1.0,1,1.0,1,1.0,1,0.2201039636179697,44
541,1,1105,403,702,0,0,0,1.0,1,1.0,1,1.0,1,0.18754755099507245,45
542,3,1108,404,704,0,0,0,1.0,1,1.0,1,1.0,1,0.19573740040291857,46
543,3,1111,405,706,0,0,0,1.0,1,1.0,1,1.0,1,0.23285585423956467,43
544,8,1119,406,713,0,0,0,1.0,1,1.0,1,1.0,1,0.17572664683872383,42
545,5,1124,407,717,0,0,0,1.0,1,1.0,1,1.0,1,0.14376139086252757,43
546,4,1128,409,719,0,0,0,1.0,1,1.0,1,1.0,1,0.18412933140978782,41
547,3,1131,409,722,0,0,0,1.0,1,1.0,1,1.0,1,0.09847247355088579,40
548,4,1135,412,723,0,0,0,1.0,1,1.0,1,1.0,1,0.17021433740399003,40
549,3,1138,414,724,0,0,0,1.0,1,1.0,1,1.0,1,0.20536096145752036,39
550,4,1142,415,727,0,0,0,1.0,1,1.0,1,1.0,1,0.1733333817699417,38
551,1,1143,415,728,0,0,0,1.0,1,1.0,1,1.0,1,0.1233429283640194,38
552,1,1144,416,728,0,0,0,1.0,1,1.0,1,1.0,1,0.16190821281773957,39
553,0,1144,416,728,0,0,0,1.0,1,1.0,1,1.0,1,0.14328566493794317,38
554,2,1146,418,728,0,0,0,1.0,1,1.0,1,1.0,1,0.1793899954616981,39
555,0,1146,418,728,0,0,0,1.0,1,1.0,1,1.0,1,0.18488356178007884,39
556,6,1152,419,733,0,0,0,1.0,1,1.0,1,1.0,1,0.11229038739574265,40
557,0,1152,419,733,0,0,0,1.0,1,1.0,1,1.0,1,0.1489880513608875,40
558,1,1153,419,734,0,0,0,1.0,1,1.0,1,1.0,1,0.13221053425766552,40
559,2,1155,420,735,0,0,0,1.0,1,1.0,1,1.0,1,0.08889736778941121,40
560,0,1155,420,735,0,0,0,1.0,1,1.0,1,1.0,1,0.10767049956204691,41
561,0,1155,420,735,0,0,0,1.0,1,1.0,1,1.0,1,0.12159031125372739,42
562,2,1157,422,735,0,0,0,1.0,1,1.0,1,1.0,1,0.16036308747679587,42
563,2,1159,424,735,0,0,0,1.0,1,1.0,1,1.0,1,0.2364388741138692,42
564,2,1161,424,737,0,0,0,1.0,1,1.0,1,1.0,1,0.2195269296413856,43
565,4,1165,426,739,0,0,0,1.0,1,1.0,1,1.0,1,0.22450013836386065,44
566,4,1169,426,743,0,0,0,1.0,1,1.0,1,1.0,1,0.22128637008475427,45
567,3,1172,427,745,0,0,0,1.0,1,1.0,1,1.0,1,0.21754016839187912,45
568,3,1175,427,748,0,0,0,1.0,1,1.0,1,1.0,1,0.17100004604439936,46
569,2,1177,429,748,0,0,0,1.0,1,1.0,1,1.0,1,0.16957372202653773,47
570,1,1178,429,749,0,0,0,1.0,1,1.0,1,1.0,1,0.1760881878202998,48
571,3,1181,431,750,0,0,0,1.0,1,1.0,1,1.0,1,0.19064818714242668,48
572,1,1182,431,751,0,0,0,1.0,1,1.0,1,1.0,1,0.19467962196407498,47
573,1,1183,431,752,0,0,0,1.0,1,1.0,1,1.0,1,0.18366887556799308,49
574,1,1184,431,753,0,0,0,1.0,1,1.0,1,1.0,1,0.17130422583425187,49
575,3,1187,431,756,0,0,0,1.0,1,1.0,1,1.0,1,0.11561704201039551,50
576,2,1189,431,758,0,0,0,1.0,1,1.0,1,1.0,1,0.114075113151401,51
577,2,1191,431,760,0,0,0,1.0,1,1.0,1,1.0,1,0.07754662260132049,51
578,0,1191,431,760,0,0,0,1.0,1,1.0,1,1.0,1,0.07754662260132049,51
579,0,1191,431,760,0,0,0,1.0,1,1.0,1,1.0,1,0.07520347120901645,52
580,3,1194,432,762,0,0,0,1.0,1,1.0,1,1.0,1,0.09317751428947245,52
581,3,1197,433,764,0,0,0,1.0,1,1.0,1,1.0,1,0.07623255909374542,52
582,0,1197,433,764,0,0,0,1.0,1,1.0,1,1.0,1,0.07694319361441572,53
583,2,1199,434,765,0,0,0,1.0,1,1.0,1,1.0,1,0.09160920709821649,51
584,3,1202,437,765,0,0,0,1.0,1,1.0,1,1.0,1,0.1662266689167138,51
585,3,1205,438,767,0,0,0,1.0,1,1.0,1,1.0,1,0.09690408717735856,49
586,3,1208,440,768,0,0,0,1.0,1,1.0,1,1.0,1,0.06954549640248553,49
587,3,1211,442,769,0,0,0,1.0,1,1.0,1,1.0,1,0.06549047658981276,48
588,0,1211,442,769,0,0,0,1.0,1,1.0,1,1.0,1,0.03494082622220173,46
589,3,1214,444,770,0,0,0,1.0,1,1.0,1,1.0,1,0.10701186086552171,48
590,0,1214,444,770,0,0,0,1.0,1,1.0,1,1.0,1,0.08415636603166633,47
591,2,1216,446,770,0,0,0,1.0,1,1.0,1,1.0,1,0.11580363361016513,48
592,3,1219,448,771,0,0,0,1.0,1,1.0,1,1.0,1,0.12685722654499826,47
593,3,1222,450,772,0,0,0,1.0,1,1.0,1,1.0,1,0.16629854016330642,45
594,3,1225,452,773,0,0,0,1.0,1,1.0,1,1.0,1,0.21762072641742305,44
595,7,1232,454,778,0,0,0,1.0,1,1.0,1,1.0,1,0.1853223185891648,43
596,4,1236,455,781,0,0,0,1.0,1,1.0,1,1.0,1,0.21218404835821184,44
597,0,1236,455,781,0,0,0,1.0,1,1.0,1,1.0,1,0.19855342402692122,43
598,3,1239,457,782,0,0,0,1.0,1,1.0,1,1.0,1,0.18666559335736596,45
599,4,1243,458,785,0,0,0,1.0,1,1.0,1,1.0,1,0.20222194710490704,44
600,1,1244,458,786,0,0,0,1.0,1,1.0,1,1.0,1,0.17251839487341816,44
601,6,1250,458,792,0,0,0,1.0,1,1.0,1,1.0,1,0.14633332369353375,45
602,3,1253,459,794,0,0,0,1.0,1,1.0,1,1.0,1,0.16663709649686861,46
603,3,1256,459,797,0,0,0,1.0,1,1.0,1,1.0,1,0.1555046056082155,46
604,3,1259,459,800,0,0,0,1.0,1,1.0,1,1.0,1,0.10540823563610556,47
605,1,1260,460,800,0,0,0,1.0,1,1.0,1,1.0,1,0.10539795450821304,47
606,0,1260,460,800,0,0,0,1.0,1,1.0,1,1.0,1,0.11715689632146731,47
607,1,1261,460,801,0,0,0,1.0,1,1.0,1,1.0,1,0.11620913510026007,48
608,0,1261,460,801,0,0,0,1.0,1,1.0,1,1.0,1,0.14132369647178636,47
609,3,1264,460,804,0,0,0,1.0,1,1.0,1,1.0,1,0.10029008405089065,48
610,3,1267,460,807,0,0,0,1.0,1,1.0,1,1.0,1,0.08597576092413683,48
611,0,1267,460,807,0,0,0,1.0,1,1.0,1,1.0,1,0.09488761699410399,49
612,3,1270,460,810,0,0,0,1.0,1,1.0,1,1.0,1,0.06868894042304031,50
613,0,1270,460,810,0,0,0,1.0,1,1.0,1,1.0,1,0.06868894042304031,50
614,1,1271,461,810,0,0,0,1.0,1,1.0,1,1.0,1,0.0855903195428658,50
615,1,1272,462,810,0,0,0,1.0,1,1.0,1,1.0,1,0.08163982414071608,50
616,2,1274,462,812,0,0,0,1.0,1,1.0,1,1.0,1,0.053990955322633705,50
617,0,1274,462,812,0,0,0,1.0,1,1.0,1,1.0,1,0.05997940556286573,52
618,0,1274,462,812,0,0,0,1.0,1,1.0,1,1.0,1,0.05997940556286573,52
619,1,1275,463,812,0,0,0,1.0,1,1.0,1,1.0,1,0.06531378705782831,50
620,1,1276,464,812,0,0,0,1.0,1,1.0,1,1.0,1,0.1212653347118509,50
621,2,1278,466,812,0,0,0,1.0,1,1.0,1,1.0,1,0.11666891293910236,49
622,5,1283,467,816,0,0,0,1.0,1,1.0,1,1.0,1,0.15515086783844312,49
623,3,1286,468,818,0,0,0,1.0,1,1.0,1,1.0,1,0.12538318188543812,48
624,2,1288,470,818,0,0,0,1.0,1,1.0,1,1.0,1,0.16843666783969583,46
625,3,1291,472,819,0,0,0,1.0,1,1.0,1,1.0,1,0.15205262137691622,45
626,5,1296,475,821,0,0,0,1.0,1,1.0,1,1.0,1,0.1661835152181595,44
627,1,1297,476,821,0,0,0,1.0,1,1.0,1,1.0,1,0.1784636240453447,44
628,5,1302,478,824,0,0,0,1.0,1,1.0,1,1.0,1,0.1637285086604728,44
629,2,1304,478,826,0,0,0,1.0,1,1.0,1,1.0,1,0.14902503499701936,41
630,2,1306,479,827,0,0,0,1.0,1,1.0,1,1.0,1,0.1263944333242993,40
631,2,1308,481,827,0,0,0,1.0,1,1.0,1,1.0,1,0.18884093007542668,38
632,2,1310,483,827,0,0,0,1.0,1,1.0,1,1.0,1,0.22399348768229693,38
633,1,1311,483,828,0,0,0,1.0,1,1.0,1,1.0,1,0.2414349004262522,36
634,1,1312,483,829,0,0,0,1.0,1,1.0,1,1.0,1,0.23060025929977482,35
635,1,1313,484,829,0,0,0,1.0,1,1.0,1,1.0,1,0.24129136025246148,35
636,6,1319,485,834,0,0,0,1.0,1,1.0,1,1.0,1,0.17743349328201508,36
637,1,1320,485,835,0,0,0,1.0,1,1.0,1,1.0,1,0.1612805186526602,35
638,0,1320,485,835,0,0,0,1.0,1,1.0,1,1.0,1,0.19210869458307497,34
639,2,1322,486,836,0,0,0,1.0,1,1.0,1,1.0,1,0.1860562262415791,36
640,1,1323,486,837,0,0,0,1.0,1,1.0,1,1.0,1,0.18510693272391732,37
641,0,1323,486,837,0,0,0,1.0,1,1.0,1,1.0,1,0.18510693272391732,37
642,1,1324,486,838,0,0,0,1.0,1,1.0,1,1.0,1,0.14181675025646864,38
643,2,1326,486,840,0,0,0,1.0,1,1.0,1,1.0,1,0.10328698345682437,39
644,2,1328,487,841,0,0,0,1.0,1,1.0,1,1.0,1,0.12068583659186777,39
645,1,1329,487,842,0,0,0,1.0,1,1.0,1,1.0,1,0.12091803526350912,39
646,3,1332,489,843,0,0,0,1.0,1,1.0,1,1.0,1,0.19175709754356388,40
647,1,1333,489,844,0,0,0,1.0,1,1.0,1,1.0,1,0.1659447143321403,40
648,1,1334,489,845,0,0,0,1.0,1,1.0,1,1.0,1,0.14226796808779663,40
649,1,1335,489,846,0,0,0,1.0,1,1.0,1,1.0,1,0.11659935088931384,40
650,4,1339,491,848,0,0,0,1.0,1,1.0,1,1.0,1,0.12030100814397816,41
651,1,1340,492,848,0,0,0,1.0,1,1.0,1,1.0,1,0.13038270267327726,42
652,1,1341,492,849,0,0,0,1.0,1,1.0,1,1.0,1,0.11019830789383506,41
653,2,1343,492,851,0,0,0,1.0,1,1.0,1,1.0,1,0.1063373180605577,41
654,1,1344,492,852,0,0,0,1.0,1,1.0,1,1.0,1,0.09216904409896308,42
655,0,1344,492,852,0,0,0,1.0,1,1.0,1,1.0,1,0.09843268370850604,45
656,3,1347,495,852,0,0,0,1.0,1,1.0,1,1.0,1,0.19697406586953706,45
657,2,1349,495,854,0,0,0,1.0,1,1.0,1,1.0,1,0.17891003633223576,43
658,3,1352,496,856,0,0,0,1.0,1,1.0,1,1.0,1,0.196478325055928,43
659,3,1355,497,858,0,0,0,1.0,1,1.0,1,1.0,1,0.17670357893647545,43
660,2,1357,499,858,0,0,0,1.0,1,1.0,1,1.0,1,0.21586632955570162,43
661,0,1357,499,858,0,0,0,1.0,1,1.0,1,1.0,1,0.22804560489662576,41
662,4,1361,500,861,0,0,0,1.0,1,1.0,1,1.0,1,0.1807364096502172,40
663,0,1361,500,861,0,0,0,1.0,1,1.0,1,1.0,1,0.17981768323794178,39
664,3,1364,503,861,0,0,0,1.0,1,1.0,1,1.0,1,0.22727066926082992,36
665,4,1368,504,864,0,0,0,1.0,1,1.0,1,1.0,1,0.1629972611700532,36
666,6,1374,506,868,0,0,0,1.0,1,1.0,1,1.0,1,0.148441463846714,36
667,2,1376,507,869,0,0,0,1.0,1,1.0,1,1.0,1,0.16565390567023183,35
668,2,1378,509,869,0,0,0,1.0,1,1.0,1,1.0,1,0.17042271690026428,34
669,1,1379,510,869,0,0,0,1.0,1,1.0,1,1.0,1,0.20098938819374518,34
670,4,1383,511,872,0,0,0,1.0,1,1.0,1,1.0,1,0.12585766379327015,32
671,2,1385,511,874,0,0,0,1.0,1,1.0,1,1.0,1,0.12903464256369085,33
672,0,1385,511,874,0,0,0,1.0,1,1.0,1,1.0,1,0.14899024060396862,32
673,1,1386,511,875,0,0,0,1.0,1,1.0,1,1.0,1,0.12699807714844785,32
674,0,1386,511,875,0,0,0,1.0,1,1.0,1,1.0,1,0.18873568134846494,32
675,2,1388,513,875,0,0,0,1.0,1,1.0,1,1.0,1,0.2388535984974219,34
676,4,1392,513,879,0,0,0,1.0,1,1.0,1,1.0,1,0.16598275970480586,35
677,2,1394,514,880,0,0,0,1.0,1,1.0,1,1.0,1,0.16628567752155227,35
678,1,1395,514,881,0,0,0,1.0,1,1.0,1,1.0,1,0.11238027131364532,35
679,2,1397,514,883,0,0,0,1.0,1,1.0,1,1.0,1,0.09580576658789088,36
680,2,1399,515,884,0,0,0,1.0,1,1.0,1,1.0,1,0.08048618841362813,37
681,0,1399,515,884,0,0,0,1.0,1,1.0,1,1.0,1,0.08048618841362813,37
682,1,1400,516,884,0,0,0,1.0,1,1.0,1,1.0,1,0.0791853719754479,37
683,0,1400,516,884,0,0,0,1.0,1,1.0,1,1.0,1,0.10214179594538446,38
684,1,1401,517,884,0,0,0,1.0,1,1.0,1,1.0,1,0.1389942233993762,39
685,1,1402,518,884,0,0,0,1.0,1,1.0,1,1.0,1,0.14904986199461148,38
686,1,1403,519,884,0,0,0,1.0,1,1.0,1,1.0,1,0.20650977074553076,37
687,6,1409,520,889,0,0,0,1.0,1,1.0,1,1.0,1,0.20164531547026793,38
688,4,1413,520,893,0,0,0,1.0,1,1.0,1,1.0,1,0.168975573102761,37
689,1,1414,520,894,0,0,0,1.0,1,1.0,1,1.0,1,0.19101688657797222,39
690,0,1414,520,894,0,0,0,1.0,1,1.0,1,1.0,1,0.20938824060338448,38
691,1,1415,521,894,0,0,0,1.0,1,1.0,1,1.0,1,0.1686143624642152,38
692,2,1417,522,895,0,0,0,1.0,1,1.0,1,1.0,1,0.18269666114909433,38
693,0,1417,522,895,0,0,0,1.0,1,1.0,1,1.0,1,0.1901019035264291,40
694,3,1420,523,897,0,0,0,1.0,1,1.0,1,1.0,1,0.15640134862728425,42
695,3,1423,524,899,0,0,0,1.0,1,1.0,1,1.0,1,0.09290106081497335,40
696,2,1425,525,900,0,0,0,1.0,1,1.0,1,1.0,1,0.13060633566320204,39
697,1,1426,525,901,0,0,0,1.0,1,1.0,1,1.0,1,0.12464793374606066,39
698,1,1427,526,901,0,0,0,1.0,1,1.0,1,1.0,1,0.17989669463254526,37
699,0,1427,526,901,0,0,0,1.0,1,1.0,1,1.0,1,0.1814101350748262,37
700,5,1432,526,906,0,0,0,1.0,1,1.0,1,1.0,1,0.14195756447700625,37
701,2,1434,526,908,0,0,0,1.0,1,1.0,1,1.0,1,0.13781683325141322,37
702,2,1436,528,908,0,0,0,1.0,1,1.0,1,1.0,1,0.14971696955967143,38
703,2,1438,529,909,0,0,0,1.0,1,1.0,1,1.0,1,0.1540545311208056,36
704,6,1444,532,912,0,0,0,1.0,1,1.0,1,1.0,1,0.16109110739968407,36
705,2,1446,533,913,0,0,0,1.0,1,1.0,1,1.0,1,0.14575194243495057,36
706,3,1449,536,913,0,0,0,1.0,1,1.0,1,1.0,1,0.1985881206781232,35
707,4,1453,538,915,0,0,0,1.0,1,1.0,1,1.0,1,0.08730269069152963,36
708,2,1455,540,915,0,0,0,1.0,1,1.0,1,1.0,1,0.14863111448171196,36
709,1,1456,540,916,0,0,0,1.0,1,1.0,1,1.0,1,0.06622574653926808,34
710,0,1456,540,916,0,0,0,1.0,1,1.0,1,1.0,1,0.06622574653926808,34
711,0,1456,540,916,0,0,0,1.0,1,1.0,1,1.0,1,0.05517889610273025,34
712,2,1458,542,916,0,0,0,1.0,1,1.0,1,1.0,1,0.15865192835234732,35
713,5,1463,544,919,0,0,0,1.0,1,1.0,1,1.0,1,0.1147180917209387,34
714,1,1464,545,919,0,0,0,1.0,1,1.0,1,1.0,1,0.14357244685937756,34
715,1,1465,545,920,0,0,0,1.0,1,1.0,1,1.0,1,0.13932886810985512,35
716,0,1465,545,920,0,0,0,1.0,1,1.0,1,1.0,1,0.12104164458006673,33
717,3,1468,546,922,0,0,0,1.0,1,1.0,1,1.0,1,0.16414734872224912,33
718,3,1471,547,924,0,0,0,1.0,1,1.0,1,1.0,1,0.2052109835715306,32
719,1,1472,547,925,0,0,0,1.0,1,1.0,1,1.0,1,0.15893060659414046,32
720,2,1474,549,925,0,0,0,1.0,1,1.0,1,1.0,1,0.17436607145768776,33
721,0,1474,549,925,0,0,0,1.0,1,1.0,1,1.0,1,0.17436607145768776,33
722,1,1475,550,925,0,0,0,1.0,1,1.0,1,1.0,1,0.2323017848950149,34
723,1,1476,550,926,0,0,0,1.0,1,1.0,1,1.0,1,0.21676740728365848,34
724,2,1478,550,928,0,0,0,1.0,1,1.0,1,1.0,1,0.2073395236302382,36
725,1,1479,550,929,0,0,0,1.0,1,1.0,1,1.0,1,0.18381257647713903,36
726,2,1481,551,930,0,0,0,1.0,1,1.0,1,1.0,1,0.17862311358598695,36
727,4,1485,551,934,0,0,0,1.0,1,1.0,1,1.0,1,0.12687389144732605,36
728,1,1486,551,935,0,0,0,1.0,1,1.0,1,1.0,1,0.14308667748907017,37
729,1,1487,551,936,0,0,0,1.0,1,1.0,1,1.0,1,0.1241028305740715,37
730,0,1487,551,936,0,0,0,1.0,1,1.0,1,1.0,1,0.1355454105885969,38
731,1,1488,552,936,0,0,0,1.0,1,1.0,1,1.0,1,0.21108769969684626,39
732,3,1491,552,939,0,0,0,1.0,1,1.0,1,1.0,1,0.14205316147698924,41
733,0,1491,552,939,0,0,0,1.0,1,1.0,1,1.0,1,0.1487824890672503,39
734,2,1493,553,940,0,0,0,1.0,1,1.0,1,1.0,1,0.15979269257128972,39
735,2,1495,555,940,0,0,0,1.0,1,1.0,1,1.0,1,0.19634172128843985,39
736,2,1497,555,942,0,0,0,1.0,1,1.0,1,1.0,1,0.12350721379667955,38
737,1,1498,556,942,0,0,0,1.0,1,1.0,1,1.0,1,0.15152733678207836,39
738,0,1498,556,942,0,0,0,1.0,1,1.0,1,1.0,1,0.1557306028624774,37
739,1,1499,557,942,0,0,0,1.0,1,1.0,1,1.0,1,0.1708172542776589,37
740,3,1502,558,944,0,0,0,1.0,1,1.0,1,1.0,1,0.1833448774098504,35
741,0,1502,558,944,0,0,0,1.0,1,1.0,1,1.0,1,0.20134723584554698,33
742,2,1504,558,946,0,0,0,1.0,1,1.0,1,1.0,1,0.16544385939672218,35
743,3,1507,560,947,0,0,0,1.0,1,1.0,1,1.0,1,0.19227193896367717,35
744,2,1509,562,947,0,0,0,1.0,1,1.0,1,1.0,1,0.17478600692987603,34
745,2,1511,563,948,0,0,0,1.0,1,1.0,1,1.0,1,0.17487304878754545,34
746,3,1514,565,949,0,0,0,1.0,1,1.0,1,1.0,1,0.1154388610138827,33
747,0,1514,565,949,0,0,0,1.0,1,1.0,1,1.0,1,0.13529056857425428,32
748,1,1515,565,950,0,0,0,1.0,1,1.0,1,1.0,1,0.1108532437238718,33
749,1,1516,566,950,0,0,0,1.0,1,1.0,1,1.0,1,0.11653928311125786,33
750,3,1519,567,952,0,0,0,1.0,1,1.0,1,1.0,1,0.12109156169923739,34
751,1,1520,568,952,0,0,0,1.0,1,1.0,1,1.0,1,0.16868335087976255,36
752,0,1520,568,952,0,0,0,1.0,1,1.0,1,1.0,1,0.16242887255730695,35
753,3,1523,569,954,0,0,0,1.0,1,1.0,1,1.0,1,0.1664602582780676,37
754,3,1526,571,955,0,0,0,1.0,1,1.0,1,1.0,1,0.1665693245200039,37
755,2,1528,572,956,0,0,0,1.0,1,1.0,1,1.0,1,0.14628810111559945,35
756,1,1529,573,956,0,0,0,1.0,1,1.0,1,1.0,1,0.2045914911768996,36
757,2,1531,573,958,0,0,0,1.0,1,1.0,1,1.0,1,0.1525915047239224,35
758,3,1534,573,961,0,0,0,1.0,1,1.0,1,1.0,1,0.14637855263592597,36
759,2,1536,574,962,0,0,0,1.0,1,1.0,1,1.0,1,0.1656042667933863,37
760,0,1536,574,962,0,0,0,1.0,1,1.0,1,1.0,1,0.15228383012095575,36
761,0,1536,574,962,0,0,0,1.0,1,1.0,1,1.0,1,0.15228383012095575,36
762,0,1536,574,962,0,0,0,1.0,1,1.0,1,1.0,1,0.1600796588502694,37
763,1,1537,574,963,0,0,0,1.0,1,1.0,1,1.0,1,0.16160362486861263,38
764,1,1538,574,964,0,0,0,1.0,1,1.0,1,1.0,1,0.1425683673461148,38
765,0,1538,574,964,0,0,0,1.0,1,1.0,1,1.0,1,0.1425683673461148,38
766,2,1540,574,966,0,0,0,1.0,1,1.0,1,1.0,1,0.12440462569666069,40
767,1,1541,574,967,0,0,0,1.0,1,1.0,1,1.0,1,0.13736848472482538,41
768,4,1545,575,970,0,0,0,1.0,1,1.0,1,1.0,1,0.1244239280023475,41
769,1,1546,575,971,0,0,0,1.0,1,1.0,1,1.0,1,0.11238143441226278,42
770,3,1549,575,974,0,0,0,1.0,1,1.0,1,1.0,1,0.0951487664083021,41
771,1,1550,575,975,0,0,0,1.0,1,1.0,1,1.0,1,0.09491409724731878,41
772,3,1553,577,976,0,0,0,1.0,1,1.0,1,1.0,1,0.10213554771883498,41
773,0,1553,577,976,0,0,0,1.0,1,1.0,1,1.0,1,0.10281746997875794,41
774,4,1557,579,978,0,0,0,1.0,1,1.0,1,1.0,1,0.14018045258007966,42
775,2,1559,579,980,0,0,0,1.0,1,1.0,1,1.0,1,0.1006593046606556,42
776,0,1559,579,980,0,0,0,1.0,1,1.0,1,1.0,1,0.1006593046606556,42
777,0,1559,579,980,0,0,0,1.0,1,1.0,1,1.0,1,0.1006593046606556,42
778,1,1560,579,981,0,0,0,1.0,1,1.0,1,1.0,1,0.10033701751147447,44
779,0,1560,579,981,0,0,0,1.0,1,1.0,1,1.0,1,0.10033701751147447,44
780,0,1560,579,981,0,0,0,1.0,1,1.0,1,1.0,1,0.10033701751147447,44
781,2,1562,579,983,0,0,0,1.0,1,1.0,1,1.0,1,0.0718294768491027,46
782,2,1564,581,983,0,0,0,1.0,1,1.0,1,1.0,1,0.10260791285908705,45
783,1,1565,582,983,0,0,0,1.0,1,1.0,1,1.0,1,0.15248108905356178,44
784,3,1568,583,985,0,0,0,1.0,1,1.0,1,1.0,1,0.17644984225965568,44
785,2,1570,584,986,0,0,0,1.0,1,1.0,1,1.0,1,0.09270625121428058,43
786,1,1571,585,986,0,0,0,1.0,1,1.0,1,1.0,1,0.0918002900813944,43
787,0,1571,585,986,0,0,0,1.0,1,1.0,1,1.0,1,0.0918002900813944,43
788,5,1576,587,989,0,0,0,1.0,1,1.0,1,1.0,1,0.1950835905362918,45
789,2,1578,588,990,0,0,0,1.0,1,1.0,1,1.0,1,0.18090677038846797,46
790,5,1583,588,995,0,0,0,1.0,1,1.0,1,1.0,1,0.15268179196004922,45
791,3,1586,588,998,0,0,0,1.0,1,1.0,1,1.0,1,0.16778194499669893,46
792,2,1588,589,999,0,0,0,1.0,1,1.0,1,1.0,1,0.11972954478199174,46
793,4,1592,589,1003,0,0,0,1.0,1,1.0,1,1.0,1,0.05842765333140154,46
794,1,1593,589,1004,0,0,0,1.0,1,1.0,1,1.0,1,0.11423192073921859,47
795,1,1594,589,1005,0,0,0,1.0,1,1.0,1,1.0,1,0.11751753516151804,47
796,4,1598,590,1008,0,0,0,1.0,1,1.0,1,1.0,1,0.11077160160282828,46
797,2,1600,590,1010,0,0,0,1.0,1,1.0,1,1.0,1,0.14300523223243725,47
798,1,1601,591,1010,0,0,0,1.0,1,1.0,1,1.0,1,0.17696898444263715,48
799,6,1607,592,1015,0,0,0,1.0,1,1.0,1,1.0,1,0.1426993870821599,48
800,3,1610,593,1017,0,0,0,1.0,1,1.0,1,1.0,1,0.1250829641459706,48
801,4,1614,593,1021,0,0,0,1.0,1,1.0,1,1.0,1,0.10183372993665554,49
802,0,1614,593,1021,0,0,0,1.0,1,1.0,1,1.0,1,0.10135238852849351,50
803,0,1614,593,1021,0,0,0,1.0,1,1.0,1,1.0,1,0.11582390868985228,49
804,3,1617,594,1023,0,0,0,1.0,1,1.0,1,1.0,1,0.08565681725433884,50
805,1,1618,594,1024,0,0,0,1.0,1,1.0,1,1.0,1,0.051444039806054616,50
806,2,1620,596,1024,0,0,0,1.0,1,1.0,1,1.0,1,0.08713236519308479,50
807,1,1621,597,1024,0,0,0,1.0,1,1.0,1,1.0,1,0.13429689770775508,51
808,2,1623,598,1025,0,0,0,1.0,1,1.0,1,1.0,1,0.12902949283807685,51
809,5,1628,600,1028,0,0,0,1.0,1,1.0,1,1.0,1,0.0986010142761947,51
810,1,1629,600,1029,0,0,0,1.0,1,1.0,1,1.0,1,0.09855514777208202,52
811,3,1632,601,1031,0,0,0,1.0,1,1.0,1,1.0,1,0.07591041950476403,50
812,1,1633,602,1031,0,0,0,1.0,1,1.0,1,1.0,1,0.12467896490376124,48
813,1,1634,603,1031,0,0,0,1.0,1,1.0,1,1.0,1,0.13657192443340196,49
814,5,1639,603,1036,0,0,0,1.0,1,1.0,1,1.0,1,0.08860837873508659,48
815,5,1644,605,1039,0,0,0,1.0,1,1.0,1,1.0,1,0.12721438233231955,48
816,2,1646,607,1039,0,0,0,1.0,1,1.0,1,1.0,1,0.1481906513154543,46
817,1,1647,607,1040,0,0,0,1.0,1,1.0,1,1.0,1,0.16176977845019475,44
818,1,1648,607,1041,0,0,0,1.0,1,1.0,1,1.0,1,0.1355464400221083,46
819,0,1648,607,1041,0,0,0,1.0,1,1.0,1,1.0,1,0.15915569896806742,44
820,1,1649,607,1042,0,0,0,1.0,1,1.0,1,1.0,1,0.17117553686146017,44
821,1,1650,607,1043,0,0,0,1.0,1,1.0,1,1.0,1,0.14207861472796854,44
822,2,1652,609,1043,0,0,0,1.0,1,1.0,1,1.0,1,0.1819777540348728,44
823,3,1655,610,1045,0,0,0,1.0,1,1.0,1,1.0,1,0.127184458157677,42
824,3,1658,613,1045,0,0,0,1.0,1,1.0,1,1.0,1,0.1622218420605773,42
825,2,1660,614,1046,0,0,0,1.0,1,1.0,1,1.0,1,0.16136757017770192,40
826,8,1668,617,1051,0,0,0,1.0,1,1.0,1,1.0,1,0.16724393717644426,41
827,6,1674,619,1055,0,0,0,1.0,1,1.0,1,1.0,1,0.12434619427856199,40
828,2,1676,620,1056,0,0,0,1.0,1,1.0,1,1.0,1,0.18282011225013498,40
829,10,1686,623,1063,0,0,0,1.0,1,1.0,1,1.0,1,0.14501930357585163,42
830,5,1691,624,1067,0,0,0,1.0,1,1.0,1,1.0,1,0.15738971904878096,42
831,6,1697,626,1071,0,0,0,1.0,1,1.0,1,1.0,1,0.1562936513265421,43
832,3,1700,627,1073,0,0,0,1.0,1,1.0,1,1.0,1,0.09718621577419663,42
833,0,1700,627,1073,0,0,0,1.0,1,1.0,1,1.0,1,0.11958909695553667,41
834,0,1700,627,1073,0,0,0,1.0,1,1.0,1,1.0,1,0.11958909695553667,41
835,0,1700,627,1073,0,0,0,1.0,1,1.0,1,1.0,1,0.10831829196457733,41
836,0,1700,627,1073,0,0,0,1.0,1,1.0,1,1.0,1,0.11588548572951297,40
837,0,1700,627,1073,0,0,0,1.0,1,1.0,1,1.0,1,0.10997658917908094,41
838,1,1701,628,1073,0,0,0,1.0,1,1.0,1,1.0,1,0.13069847246727034,41
839,2,1703,629,1074,0,0,0,1.0,1,1.0,1,1.0,1,0.09795392442161814,41
840,5,1708,632,1076,0,0,0,1.0,1,1.0,1,1.0,1,0.14323055404007537,42
841,1,1709,632,1077,0,0,0,1.0,1,1.0,1,1.0,1,0.13637259027967402,42
842,0,1709,632,1077,0,0,0,1.0,1,1.0,1,1.0,1,0.13637259027967402,42
843,2,1711,634,1077,0,0,0,1.0,1,1.0,1,1.0,1,0.16276462985762996,42
844,3,1714,634,1080,0,0,0,1.0,1,1.0,1,1.0,1,0.143414766576895,42
845,7,1721,634,1087,0,0,0,1.0,1,1.0,1,1.0,1,0.18672431434271164,44
846,5,1726,635,1091,0,0,0,1.0,1,1.0,1,1.0,1,0.16406548259778367,44
847,1,1727,636,1091,0,0,0,1.0,1,1.0,1,1.0,1,0.16439800815256225,42
848,0,1727,636,1091,0,0,0,1.0,1,1.0,1,1.0,1,0.18154993592998647,43
849,3,1730,636,1094,0,0,0,1.0,1,1.0,1,1.0,1,0.12521532718400444,43
850,6,1736,636,1100,0,0,0,1.0,1,1.0,1,1.0,1,0.09611912627069256,41
851,1,1737,636,1101,0,0,0,1.0,1,1.0,1,1.0,1,0.12387563843241499,40
852,1,1738,636,1102,0,0,0,1.0,1,1.0,1,1.0,1,0.10189349254828893,40
853,2,1740,636,1104,0,0,0,1.0,1,1.0,1,1.0,1,0.07523303078715879,40
854,2,1742,637,1105,0,0,0,1.0,1,1.0,1,1.0,1,0.10315442868126715,40
855,2,1744,638,1106,0,0,0,1.0,1,1.0,1,1.0,1,0.07969248382410514,41
856,3,1747,640,1107,0,0,0,1.0,1,1.0,1,1.0,1,0.147980753701472,41
857,0,1747,640,1107,0,0,0,1.0,1,1.0,1,1.0,1,0.16537505425645285,42
858,2,1749,640,1109,0,0,0,1.0,1,1.0,1,1.0,1,0.1094117047207711,43
859,0,1749,640,1109,0,0,0,1.0,1,1.0,1,1.0,1,0.1094117047207711,43
860,0,1749,640,1109,0,0,0,1.0,1,1.0,1,1.0,1,0.11632010902731334,44
861,2,1751,641,1110,0,0,0,1.0,1,1.0,1,1.0,1,0.11664681297255237,44
862,1,1752,642,1110,0,0,0,1.0,1,1.0,1,1.0,1,0.12708189577346451,44
863,3,1755,644,1111,0,0,0,1.0,1,1.0,1,1.0,1,0.1638742667243339,44
864,3,1758,644,1114,0,0,0,1.0,1,1.0,1,1.0,1,0.11727187958421656,44
865,3,1761,646,1115,0,0,0,1.0,1,1.0,1,1.0,1,0.08409820284634148,43
866,9,1770,651,1119,0,0,0,1.0,1,1.0,1,1.0,1,0.11233738187887278,45
867,0,1770,651,1119,0,0,0,1.0,1,1.0,1,1.0,1,0.13733160805210382,44
868,5,1775,653,1122,0,0,0,1.0,1,1.0,1,1.0,1,0.12370725768530479,45
869,3,1778,655,1123,0,0,0,1.0,1,1.0,1,1.0,1,0.11641116219565312,44
870,1,1779,656,1123,0,0,0,1.0,1,1.0,1,1.0,1,0.10590920706323416,44
871,3,1782,657,1125,0,0,0,1.0,1,1.0,1,1.0,1,0.12540994147131196,43
872,1,1783,658,1125,0,0,0,1.0,1,1.0,1,1.0,1,0.1289050331704967,43
873,4,1787,659,1128,0,0,0,1.0,1,1.0,1,1.0,1,0.1091443130632301,43
874,4,1791,660,1131,0,0,0,1.0,1,1.0,1,1.0,1,0.12725265191737495,46
875,2,1793,661,1132,0,0,0,1.0,1,1.0,1,1.0,1,0.09436741383264592,43
876,0,1793,661,1132,0,0,0,1.0,1,1.0,1,1.0,1,0.10816325174216318,44
877,3,1796,662,1134,0,0,0,1.0,1,1.0,1,1.0,1,0.10579142312544715,44
878,0,1796,662,1134,0,0,0,1.0,1,1.0,1,1.0,1,0.10579142312544715,44
879,4,1800,663,1137,0,0,0,1.0,1,1.0,1,1.0,1,0.07608073550920012,44
880,1,1801,664,1137,0,0,0,1.0,1,1.0,1,1.0,1,0.12111606921083586,44
881,1,1802,665,1137,0,0,0,1.0,1,1.0,1,1.0,1,0.11750944720234978,43
882,3,1805,667,1138,0,0,0,1.0,1,1.0,1,1.0,1,0.16024039004075025,45
883,2,1807,667,1140,0,0,0,1.0,1,1.0,1,1.0,1,0.13963605345828822,45
884,3,1810,669,1141,0,0,0,1.0,1,1.0,1,1.0,1,0.16344524725279636,45
885,2,1812,670,1142,0,0,0,1.0,1,1.0,1,1.0,1,0.11879841306688523,43
886,5,1817,672,1145,0,0,0,1.0,1,1.0,1,1.0,1,0.14026670428104354,43
887,2,1819,673,1146,0,0,0,1.0,1,1.0,1,1.0,1,0.09459791085255398,41
888,0,1819,673,1146,0,0,0,1.0,1,1.0,1,1.0,1,0.11166143996968764,40
889,2,1821,675,1146,0,0,0,1.0,1,1.0,1,1.0,1,0.16666298226894,40
890,1,1822,676,1146,0,0,0,1.0,1,1.0,1,1.0,1,0.15393650133862036,38
891,1,1823,676,1147,0,0,0,1.0,1,1.0,1,1.0,1,0.14342459449561323,39
892,5,1828,677,1151,0,0,0,1.0,1,1.0,1,1.0,1,0.1118049777597947,39
893,1,1829,678,1151,0,0,0,1.0,1,1.0,1,1.0,1,0.17374414149486617,37
894,1,1830,679,1151,0,0,0,1.0,1,1.0,1,1.0,1,0.21288176699961905,36
895,2,1832,679,1153,0,0,0,1.0,1,1.0,1,1.0,1,0.15764388396628468,37
896,5,1837,682,1155,0,0,0,1.0,1,1.0,1,1.0,1,0.16870982900339668,36
897,1,1838,683,1155,0,0,0,1.0,1,1.0,1,1.0,1,0.17896029289503493,36
898,0,1838,683,1155,0,0,0,1.0,1,1.0,1,1.0,1,0.18485850317481337,35
899,1,1839,684,1155,0,0,0,1.0,1,1.0,1,1.0,1,0.21472289242800147,35
900,0,1839,684,1155,0,0,0,1.0,1,1.0,1,1.0,1,0.24193662116859094,36
901,3,1842,685,1157,0,0,0,1.0,1,1.0,1,1.0,1,0.20147841338418912,36
902,3,1845,687,1158,0,0,0,1.0,1,1.0,1,1.0,1,0.21777332928664891,36
903,2,1847,687,1160,0,0,0,1.0,1,1.0,1,1.0,1,0.1748767341023657,35
904,4,1851,691,1160,0,0,0,1.0,1,1.0,1,1.0,1,0.20242671542793808,37
905,1,1852,692,1160,0,0,0,1.0,1,1.0,1,1.0,1,0.21225056619115248,36
906,2,1854,692,1162,0,0,0,1.0,1,1.0,1,1.0,1,0.13789978157467972,37
907,5,1859,695,1164,0,0,0,1.0,1,1.0,1,1.0,1,0.13537689166183647,37
908,0,1859,695,1164,0,0,0,1.0,1,1.0,1,1.0,1,0.13415945540838295,36
909,0,1859,695,1164,0,0,0,1.0,1,1.0,1,1.0,1,0.13786610597059662,36
910,5,1864,697,1167,0,0,0,1.0,1,1.0,1,1.0,1,0.17675647411627124,37
911,3,1867,698,1169,0,0,0,1.0,1,1.0,1,1.0,1,0.21235321975519453,36
912,5,1872,699,1173,0,0,0,1.0,1,1.0,1,1.0,1,0.20035784443049146,34
913,6,1878,702,1176,0,0,0,1.0,1,1.0,1,1.0,1,0.18246626908507402,34
914,1,1879,703,1176,0,0,0,1.0,1,1.0,1,1.0,1,0.20276358788831714,33
915,1,1880,703,1177,0,0,0,1.0,1,1.0,1,1.0,1,0.1897546420285819,33
916,3,1883,703,1180,0,0,0,1.0,1,1.0,1,1.0,1,0.11522085397208624,34
917,1,1884,704,1180,0,0,0,1.0,1,1.0,1,1.0,1,0.1117777727591772,34
918,0,1884,704,1180,0,0,0,1.0,1,1.0,1,1.0,1,0.10709742764339357,36
919,0,1884,704,1180,0,0,0,1.0,1,1.0,1,1.0,1,0.10709742764339357,36
920,2,1886,705,1181,0,0,0,1.0,1,1.0,1,1.0,1,0.1190332338308374,37
921,1,1887,705,1182,0,0,0,1.0,1,1.0,1,1.0,1,0.0934617656339676,37
922,2,1889,705,1184,0,0,0,1.0,1,1.0,1,1.0,1,0.06444397400924426,38
923,1,1890,706,1184,0,0,0,1.0,1,1.0,1,1.0,1,0.10909118548753007,36
924,1,1891,707,1184,0,0,0,1.0,1,1.0,1,1.0,1,0.12163133950380779,35
925,2,1893,708,1185,0,0,0,1.0,1,1.0,1,1.0,1,0.1712541971065339,35
926,2,1895,709,1186,0,0,0,1.0,1,1.0,1,1.0,1,0.12969228870891397,34
927,0,1895,709,1186,0,0,0,1.0,1,1.0,1,1.0,1,0.15979068407915722,32
928,1,1896,709,1187,0,0,0,1.0,1,1.0,1,1.0,1,0.12054267501387403,32
929,3,1899,711,1188,0,0,0,1.0,1,1.0,1,1.0,1,0.10236274082278085,31
930,1,1900,712,1188,0,0,0,1.0,1,1.0,1,1.0,1,0.19664355646980158,30
931,3,1903,714,1189,0,0,0,1.0,1,1.0,1,1.0,1,0.22326753100790114,29
932,0,1903,714,1189,0,0,0,1.0,1,1.0,1,1.0,1,0.22326753100790114,29
933,1,1904,714,1190,0,0,0,1.0,1,1.0,1,1.0,1,0.17007398214003033,29
934,1,1905,715,1190,0,0,0,1.0,1,1.0,1,1.0,1,0.17383614597097383,29
935,1,1906,715,1191,0,0,0,1.0,1,1.0,1,1.0,1,0.18211587039792831,31
936,1,1907,716,1191,0,0,0,1.0,1,1.0,1,1.0,1,0.23073617404303848,31
937,4,1911,716,1195,0,0,0,1.0,1,1.0,1,1.0,1,0.1750142267077793,34
938,0,1911,716,1195,0,0,0,1.0,1,1.0,1,1.0,1,0.18581639529468358,33
939,4,1915,717,1198,0,0,0,1.0,1,1.0,1,1.0,1,0.168152770005574,36
940,1,1916,717,1199,0,0,0,1.0,1,1.0,1,1.0,1,0.1677465662428282,36
941,3,1919,719,1200,0,0,0,1.0,1,1.0,1,1.0,1,0.21951047734519674,36
942,1,1920,719,1201,0,0,0,1.0,1,1.0,1,1.0,1,0.20328822019748027,36
943,3,1923,719,1204,0,0,0,1.0,1,1.0,1,1.0,1,0.12212323958899941,35
944,3,1926,722,1204,0,0,0,1.0,1,1.0,1,1.0,1,0.13455273589265795,35
945,0,1926,722,1204,0,0,0,1.0,1,1.0,1,1.0,1,0.11024755615907607,33
946,1,1927,723,1204,0,0,0,1.0,1,1.0,1,1.0,1,0.18223167280700797,36
947,1,1928,724,1204,0,0,0,1.0,1,1.0,1,1.0,1,0.20157190310031048,34
948,2,1930,726,1204,0,0,0,1.0,1,1.0,1,1.0,1,0.2499723946742581,33
949,3,1933,726,1207,0,0,0,1.0,1,1.0,1,1.0,1,0.25208090882171363,34
950,0,1933,726,1207,0,0,0,1.0,1,1.0,1,1.0,1,0.2745904848276714,33
951,0,1933,726,1207,0,0,0,1.0,1,1.0,1,1.0,1,0.2745904848276714,33
952,1,1934,726,1208,0,0,0,1.0,1,1.0,1,1.0,1,0.2822400454888914,32
953,1,1935,726,1209,0,0,0,1.0,1,1.0,1,1.0,1,0.2636034636134299,32
954,0,1935,726,1209,0,0,0,1.0,1,1.0,1,1.0,1,0.29070831491021426,31
955,2,1937,726,1211,0,0,0,1.0,1,1.0,1,1.0,1,0.24110478795675008,32
956,2,1939,727,1212,0,0,0,1.0,1,1.0,1,1.0,1,0.23328965341368776,32
957,1,1940,727,1213,0,0,0,1.0,1,1.0,1,1.0,1,0.1886551345491456,33
958,1,1941,727,1214,0,0,0,1.0,1,1.0,1,1.0,1,0.16972119160106472,35
959,2,1943,728,1215,0,0,0,1.0,1,1.0,1,1.0,1,0.17732368583434396,36
960,0,1943,728,1215,0,0,0,1.0,1,1.0,1,1.0,1,0.1861570095370486,38
961,4,1947,729,1218,0,0,0,1.0,1,1.0,1,1.0,1,0.19309491114721872,37
962,1,1948,730,1218,0,0,0,1.0,1,1.0,1,1.0,1,0.24380050826258454,35
963,0,1948,730,1218,0,0,0,1.0,1,1.0,1,1.0,1,0.2322576033459186,35
964,5,1953,730,1223,0,0,0,1.0,1,1.0,1,1.0,1,0.15764077175142355,34
965,5,1958,730,1228,0,0,0,1.0,1,1.0,1,1.0,1,0.1188356292121203,35
966,1,1959,730,1229,0,0,0,1.0,1,1.0,1,1.0,1,0.16300087158426996,34
967,1,1960,730,1230,0,0,0,1.0,1,1.0,1,1.0,1,0.15487022256884403,35
968,3,1963,731,1232,0,0,0,1.0,1,1.0,1,1.0,1,0.13889991636884097,36
969,0,1963,731,1232,0,0,0,1.0,1,1.0,1,1.0,1,0.1618322916867383,35
970,1,1964,731,1233,0,0,0,1.0,1,1.0,1,1.0,1,0.17214374914378758,34
971,3,1967,731,1236,0,0,0,1.0,1,1.0,1,1.0,1,0.11343572915920323,35
972,0,1967,731,1236,0,0,0,1.0,1,1.0,1,1.0,1,0.11343572915920323,35
973,1,1968,731,1237,0,0,0,1.0,1,1.0,1,1.0,1,0.12022666502172874,36
974,1,1969,732,1237,0,0,0,1.0,1,1.0,1,1.0,1,0.18668807375112276,35
975,1,1970,732,1238,0,0,0,1.0,1,1.0,1,1.0,1,0.141241020504973,36
976,0,1970,732,1238,0,0,0,1.0,1,1.0,1,1.0,1,0.15226639088148788,38
977,0,1970,732,1238,0,0,0,1.0,1,1.0,1,1.0,1,0.15226639088148788,38
978,0,1970,732,1238,0,0,0,1.0,1,1.0,1,1.0,1,0.15226639088148788,38
979,2,1972,732,1240,0,0,0,1.0,1,1.0,1,1.0,1,0.12742038237560022,39
980,1,1973,733,1240,0,0,0,1.0,1,1.0,1,1.0,1,0.1496907450151905,39
981,3,1976,735,1241,0,0,0,1.0,1,1.0,1,1.0,1,0.18817463371297738,40
982,6,1982,737,1245,0,0,0,1.0,1,1.0,1,1.0,1,0.20440221126075356,40
983,1,1983,738,1245,0,0,0,1.0,1,1.0,1,1.0,1,0.15939049543377354,38
984,1,1984,739,1245,0,0,0,1.0,1,1.0,1,1.0,1,0.15886646127836004,39
985,6,1990,742,1248,0,0,0,1.0,1,1.0,1,1.0,1,0.19763224015201258,38
986,0,1990,742,1248,0,0,0,1.0,1,1.0,1,1.0,1,0.19763224015201258,38
987,1,1991,743,1248,0,0,0,1.0,1,1.0,1,1.0,1,0.23166820910262054,38
988,5,1996,745,1251,0,0,0,1.0,1,1.0,1,1.0,1,0.23290579954071272,38
989,1,1997,745,1252,0,0,0,1.0,1,1.0,1,1.0,1,0.2076364003581859,38
990,1,1998,745,1253,0,0,0,1.0,1,1.0,1,1.0,1,0.1953985008737163,38
991,2,2000,745,1255,0,0,0,1.0,1,1.0,1,1.0,1,0.1501251183374107,40
992,0,2000,745,1255,0,0,0,1.0,1,1.0,1,1.0,1,0.13294640371473337,39
993,1,2001,746,1255,0,0,0,1.0,1,1.0,1,1.0,1,0.12548511773769344,38
994,1,2002,746,1256,0,0,0,1.0,1,1.0,1,1.0,1,0.11847102672420194,39
995,0,2002,746,1256,0,0,0,1.0,1,1.0,1,1.0,1,0.12244018583665753,41
996,0,2002,746,1256,0,0,0,1.0,1,1.0,1,1.0,1,0.14237285830730856,40
997,3,2005,746,1259,0,0,0,1.0,1,1.0,1,1.0,1,0.10646075391998878,41
998,0,2005,746,1259,0,0,0,1.0,1,1.0,1,1.0,1,0.13432656436499285,40
999,0,2005,746,1259,0,0,0,1.0,1,1.0,1,1.0,1,0.1631834016400517,40
1000,1,2006,746,1260,0,0,0,1.0,1,1.0,1,1.0,1,0.13075846200955554,40
1001,0,2006,746,1260,0,0,0,1.0,1,1.0,1,1.0,1,0.14289995091278063,39
1002,0,2006,746,1260,0,0,0,1.0,1,1.0,1,1.0,1,0.14289995091278063,39
1003,1,2007,746,1261,0,0,0,1.0,1,1.0,1,1.0,1,0.13878057717357226,39
1004,0,2007,746,1261,0,0,0,1.0,1,1.0,1,1.0,1,0.13878057717357226,39
1005,0,2007,746,1261,0,0,0,1.0,1,1.0,1,1.0,1,0.14268780490925226,40
1006,0,2007,746,1261,0,0,0,1.0,1,1.0,1,1.0,1,0.13589678240859177,41
1007,0,2007,746,1261,0,0,0,1.0,1,1.0,1,1.0,1,0.15087862327788906,42
1008,5,2012,748,1264,0,0,0,1.0,1,1.0,1,1.0,1,0.2137454605138678,43
1009,4,2016,748,1268,0,0,0,1.0,1,1.0,1,1.0,1,0.16151997324675427,44
1010,2,2018,749,1269,0,0,0,1.0,1,1.0,1,1.0,1,0.12652717324502633,44
1011,1,2019,749,1270,0,0,0,1.0,1,1.0,1,1.0,1,0.13551600619384496,44
1012,3,2022,750,1272,0,0,0,1.0,1,1.0,1,1.0,1,0.12507938911856936,46
1013,0,2022,750,1272,0,0,0,1.0,1,1.0,1,1.0,1,0.12507938911856936,46
1014,1,2023,751,1272,0,0,0,1.0,1,1.0,1,1.0,1,0.163670866011034,46
1015,0,2023,751,1272,0,0,0,1.0,1,1.0,1,1.0,1,0.163670866011034,46
1016,3,2026,752,1274,0,0,0,1.0,1,1.0,1,1.0,1,0.14684516851806906,47
1017,2,2028,752,1276,0,0,0,1.0,1,1.0,1,1.0,1,0.1308573779152538,47
1018,2,2030,753,1277,0,0,0,1.0,1,1.0,1,1.0,1,0.1437614493593248,48
1019,2,2032,753,1279,0,0,0,1.0,1,1.0,1,1.0,1,0.1399182985968412,49
1020,3,2035,753,1282,0,0,0,1.0,1,1.0,1,1.0,1,0.12039595361154563,51
1021,2,2037,755,1282,0,0,0,1.0,1,1.0,1,1.0,1,0.16229035050596166,51
1022,1,2038,755,1283,0,0,0,1.0,1,1.0,1,1.0,1,0.1472472615468115,52
1023,2,2040,755,1285,0,0,0,1.0,1,1.0,1,1.0,1,0.1597605079054646,52
1024,3,2043,755,1288,0,0,0,1.0,1,1.0,1,1.0,1,0.1092312641404445,52
1025,2,2045,755,1290,0,0,0,1.0,1,1.0,1,1.0,1,0.0754824035557458,54
1026,0,2045,755,1290,0,0,0,1.0,1,1.0,1,1.0,1,0.0754824035557458,54
1027,4,2049,757,1292,0,0,0,1.0,1,1.0,1,1.0,1,0.08762229472780778,55
1028,2,2051,757,1294,0,0,0,1.0,1,1.0,1,1.0,1,0.07951779853089319,56
1029,0,2051,757,1294,0,0,0,1.0,1,1.0,1,1.0,1,0.07951779853089319,56
1030,1,2052,758,1294,0,0,0,1.0,1,1.0,1,1.0,1,0.11974271290189695,57
1031,1,2053,758,1295,0,0,0,1.0,1,1.0,1,1.0,1,0.11864040261639604,58
1032,2,2055,759,1296,0,0,0,1.0,1,1.0,1,1.0,1,0.11334418851437873,58
1033,3,2058,760,1298,0,0,0,1.0,1,1.0,1,1.0,1,0.07665754595825562,57
1034,2,2060,761,1299,0,0,0,1.0,1,1.0,1,1.0,1,0.1033147613342458,57
1035,0,2060,761,1299,0,0,0,1.0,1,1.0,1,1.0,1,0.1033147613342458,57
1036,3,2063,762,1301,0,0,0,1.0,1,1.0,1,1.0,1,0.08329403095348419,59
1037,2,2065,764,1301,0,0,0,1.0,1,1.0,1,1.0,1,0.12048115922022612,57
1038,5,2070,766,1304,0,0,0,1.0,1,1.0,1,1.0,1,0.14547998482408087,59
1039,3,2073,767,1306,0,0,0,1.0,1,1.0,1,1.0,1,0.124547941855531,57
1040,2,2075,768,1307,0,0,0,1.0,1,1.0,1,1.0,1,0.1720426234113747,56
1041,5,2080,771,1309,0,0,0,1.0,1,1.0,1,1.0,1,0.19087278525583481,54
1042,5,2085,771,1314,0,0,0,1.0,1,1.0,1,1.0,1,0.13790234900960005,52
1043,2,2087,771,1316,0,0,0,1.0,1,1.0,1,1.0,1,0.12592689278341998,52
1044,0,2087,771,1316,0,0,0,1.0,1,1.0,1,1.0,1,0.12438476189189712,50
1045,3,2090,771,1319,0,0,0,1.0,1,1.0,1,1.0,1,0.10096700058602673,51
1046,2,2092,772,1320,0,0,0,1.0,1,1.0,1,1.0,1,0.09789825785619694,50
1047,2,2094,772,1322,0,0,0,1.0,1,1.0,1,1.0,1,0.09302724768396574,50
1048,2,2096,773,1323,0,0,0,1.0,1,1.0,1,1.0,1,0.0965590736877893,50
1049,4,2100,774,1326,0,0,0,1.0,1,1.0,1,1.0,1,0.09402077591687708,50
1050,3,2103,775,1328,0,0,0,1.0,1,1.0,1,1.0,1,0.09203512283070579,50
1051,1,2104,775,1329,0,0,0,1.0,1,1.0,1,1.0,1,0.09233453023249712,50
1052,1,2105,775,1330,0,0,0,1.0,1,1.0,1,1.0,1,0.06863765441034822,51
1053,0,2105,775,1330,0,0,0,1.0,1,1.0,1,1.0,1,0.06863765441034822,51
1054,0,2105,775,1330,0,0,0,1.0,1,1.0,1,1.0,1,0.05451517275528353,53
1055,1,2106,775,1331,0,0,0,1.0,1,1.0,1,1.0,1,0.056698852679922175,54
1056,1,2107,775,1332,0,0,0,1.0,1,1.0,1,1.0,1,0.05971282484469226,54
1057,2,2109,777,1332,0,0,0,1.0,1,1.0,1,1.0,1,0.123287633527225,55
1058,1,2110,777,1333,0,0,0,1.0,1,1.0,1,1.0,1,0.10102856675358697,54
1059,5,2115,780,1335,0,0,0,1.0,1,1.0,1,1.0,1,0.160985459763966,53
1060,2,2117,780,1337,0,0,0,1.0,1,1.0,1,1.0,1,0.14190849992393106,53
1061,1,2118,781,1337,0,0,0,1.0,1,1.0,1,1.0,1,0.1873435421639635,53
1062,5,2123,785,1338,0,0,0,1.0,1,1.0,1,1.0,1,0.1558657885603292,54
1063,5,2128,785,1343,0,0,0,1.0,1,1.0,1,1.0,1,0.1375262331546237,53
1064,11,2139,790,1349,0,0,0,1.0,1,1.0,1,1.0,1,0.13161002682495107,55
1065,2,2141,790,1351,0,0,0,1.0,1,1.0,1,1.0,1,0.17800295981918898,54
1066,4,2145,792,1353,0,0,0,1.0,1,1.0,1,1.0,1,0.14695740443393168,55
1067,2,2147,793,1354,0,0,0,1.0,1,1.0,1,1.0,1,0.15736432970805386,55
1068,1,2148,793,1355,0,0,0,1.0,1,1.0,1,1.0,1,0.15814473656940797,55
1069,5,2153,794,1359,0,0,0,1.0,1,1.0,1,1.0,1,0.1448553662543534,55
1070,0,2153,794,1359,0,0,0,1.0,1,1.0,1,1.0,1,0.1524959721491867,54
1071,1,2154,794,1360,0,0,0,1.0,1,1.0,1,1.0,1,0.13894784956150905,55
1072,0,2154,794,1360,0,0,0,1.0,1,1.0,1,1.0,1,0.13092186389832286,54
1073,2,2156,796,1360,0,0,0,1.0,1,1.0,1,1.0,1,0.14554988650802905,54
1074,3,2159,798,1361,0,0,0,1.0,1,1.0,1,1.0,1,0.12191460522704463,52
1075,2,2161,799,1362,0,0,0,1.0,1,1.0,1,1.0,1,0.10733827484432873,51
1076,4,2165,800,1365,0,0,0,1.0,1,1.0,1,1.0,1,0.08894363016572336,52
1077,2,2167,801,1366,0,0,0,1.0,1,1.0,1,1.0,1,0.09260773732550331,49
1078,5,2172,803,1369,0,0,0,1.0,1,1.0,1,1.0,1,0.10213095436634045,48
1079,5,2177,805,1372,0,0,0,1.0,1,1.0,1,1.0,1,0.08498456461121032,47
1080,2,2179,807,1372,0,0,0,1.0,1,1.0,1,1.0,1,0.12915847891850765,47
1081,2,2181,808,1373,0,0,0,1.0,1,1.0,1,1.0,1,0.14660407130444658,45
1082,1,2182,809,1373,0,0,0,1.0,1,1.0,1,1.0,1,0.2009574803959664,42
1083,1,2183,810,1373,0,0,0,1.0,1,1.0,1,1.0,1,0.2529968121926717,42
1084,1,2184,810,1374,0,0,0,1.0,1,1.0,1,1.0,1,0.21994658692987157,40
1085,1,2185,810,1375,0,0,0,1.0,1,1.0,1,1.0,1,0.18877124369204093,43
1086,2,2187,810,1377,0,0,0,1.0,1,1.0,1,1.0,1,0.16780072421156328,41
1087,2,2189,810,1379,0,0,0,1.0,1,1.0,1,1.0,1,0.15712730556202242,41
1088,1,2190,810,1380,0,0,0,1.0,1,1.0,1,1.0,1,0.14789994997337522,41
1089,1,2191,811,1380,0,0,0,1.0,1,1.0,1,1.0,1,0.1454184339750379,42
1090,0,2191,811,1380,0,0,0,1.0,1,1.0,1,1.0,1,0.13237705383996282,43
1091,3,2194,813,1381,0,0,0,1.0,1,1.0,1,1.0,1,0.1583216971721681,43
1092,2,2196,814,1382,0,0,0,1.0,1,1.0,1,1.0,1,0.17547381040579815,43
1093,1,2197,815,1382,0,0,0,1.0,1,1.0,1,1.0,1,0.15698718799490463,43
1094,0,2197,815,1382,0,0,0,1.0,1,1.0,1,1.0,1,0.15698718799490463,43
1095,2,2199,815,1384,0,0,0,1.0,1,1.0,1,1.0,1,0.13048673999170185,44
1096,0,2199,815,1384,0,0,0,1.0,1,1.0,1,1.0,1,0.13048673999170185,44
1097,2,2201,816,1385,0,0,0,1.0,1,1.0,1,1.0,1,0.1806608172452839,45
1098,0,2201,816,1385,0,0,0,1.0,1,1.0,1,1.0,1,0.18159855285673493,46
1099,3,2204,817,1387,0,0,0,1.0,1,1.0,1,1.0,1,0.19288923829708682,48
1100,1,2205,817,1388,0,0,0,1.0,1,1.0,1,1.0,1,0.16934905002676656,49
1101,2,2207,818,1389,0,0,0,1.0,1,1.0,1,1.0,1,0.16133327354739624,49
1102,6,2213,820,1393,0,0,0,1.0,1,1.0,1,1.0,1,0.1162369853133247,50
1103,4,2217,821,1396,0,0,0,1.0,1,1.0,1,1.0,1,0.08887614019760676,48
1104,3,2220,824,1396,0,0,0,1.0,1,1.0,1,1.0,1,0.054485991048579256,50
1105,2,2222,826,1396,0,0,0,1.0,1,1.0,1,1.0,1,0.023594971009328742,48
1106,0,2222,826,1396,0,0,0,1.0,1,1.0,1,1.0,1,0.060673756376959286,48
1107,2,2224,828,1396,0,0,0,1.0,1,1.0,1,1.0,1,0.0676707051382354,47
1108,2,2226,829,1397,0,0,0,1.0,1,1.0,1,1.0,1,0.07180045186084398,47
1109,3,2229,831,1398,0,0,0,1.0,1,1.0,1,1.0,1,0.08643555520186656,46
1110,1,2230,832,1398,0,0,0,1.0,1,1.0,1,1.0,1,0.15739757185543574,43
1111,5,2235,834,1401,0,0,0,1.0,1,1.0,1,1.0,1,0.15679461339150572,44
1112,5,2240,837,1403,0,0,0,1.0,1,1.0,1,1.0,1,0.16268355179875194,43
1113,3,2243,837,1406,0,0,0,1.0,1,1.0,1,1.0,1,0.1500257444491506,39
1114,2,2245,838,1407,0,0,0,1.0,1,1.0,1,1.0,1,0.17056551945491952,39
1115,2,2247,839,1408,0,0,0,1.0,1,1.0,1,1.0,1,0.1528375825294209,37
1116,2,2249,840,1409,0,0,0,1.0,1,1.0,1,1.0,1,0.17557990183038114,37
1117,5,2254,841,1413,0,0,0,1.0,1,1.0,1,1.0,1,0.1671772973814639,36
1118,3,2257,841,1416,0,0,0,1.0,1,1.0,1,1.0,1,0.16426394324225935,36
1119,2,2259,841,1418,0,0,0,1.0,1,1.0,1,1.0,1,0.1619276380347553,36
1120,1,2260,841,1419,0,0,0,1.0,1,1.0,1,1.0,1,0.13139394175699579,36
1121,1,2261,842,1419,0,0,0,1.0,1,1.0,1,1.0,1,0.17308564890394654,36
1122,1,2262,842,1420,0,0,0,1.0,1,1.0,1,1.0,1,0.16105931509514462,37
1123,1,2263,842,1421,0,0,0,1.0,1,1.0,1,1.0,1,0.13479438228537,37
1124,1,2264,843,1421,0,0,0,1.0,1,1.0,1,1.0,1,0.13338905883970312,37
1125,1,2265,844,1421,0,0,0,1.0,1,1.0,1,1.0,1,0.19939269115514063,38
1126,2,2267,844,1423,0,0,0,1.0,1,1.0,1,1.0,1,0.17194639454969418,38
1127,3,2270,844,1426,0,0,0,1.0,1,1.0,1,1.0,1,0.1634033958131646,39
1128,1,2271,844,1427,0,0,0,1.0,1,1.0,1,1.0,1,0.18159485261972308,39
1129,3,2274,845,1429,0,0,0,1.0,1,1.0,1,1.0,1,0.17483380876536314,39
1130,2,2276,846,1430,0,0,0,1.0,1,1.0,1,1.0,1,0.1846592109466579,39
1131,0,2276,846,1430,0,0,0,1.0,1,1.0,1,1.0,1,0.1846592109466579,39
1132,3,2279,846,1433,0,0,0,1.0,1,1.0,1,1.0,1,0.11982046383708615,39
1133,0,2279,846,1433,0,0,0,1.0,1,1.0,1,1.0,1,0.1219478506283379,42
1134,0,2279,846,1433,0,0,0,1.0,1,1.0,1,1.0,1,0.1219478506283379,42
1135,2,2281,846,1435,0,0,0,1.0,1,1.0,1,1.0,1,0.14852776335918505,44
1136,3,2284,846,1438,0,0,0,1.0,1,1.0,1,1.0,1,0.12333486901685854,46
1137,2,2286,846,1440,0,0,0,1.0,1,1.0,1,1.0,1,0.1434762167073877,45
1138,0,2286,846,1440,0,0,0,1.0,1,1.0,1,1.0,1,0.15165433765802486,46
1139,2,2288,847,1441,0,0,0,1.0,1,1.0,1,1.0,1,0.15670610275330366,47
1140,1,2289,848,1441,0,0,0,1.0,1,1.0,1,1.0,1,0.1758256464005794,46
1141,3,2292,848,1444,0,0,0,1.0,1,1.0,1,1.0,1,0.14069082100532151,45
1142,8,2300,853,1447,0,0,0,1.0,1,1.0,1,1.0,1,0.1539911397096491,45
1143,2,2302,854,1448,0,0,0,1.0,1,1.0,1,1.0,1,0.15453150873341706,43
1144,2,2304,855,1449,0,0,0,1.0,1,1.0,1,1.0,1,0.08961363004804135,45
1145,2,2306,857,1449,0,0,0,1.0,1,1.0,1,1.0,1,0.1624292587285547,44
1146,3,2309,858,1451,0,0,0,1.0,1,1.0,1,1.0,1,0.12365226630772232,45
1147,3,2312,860,1452,0,0,0,1.0,1,1.0,1,1.0,1,0.12005589764691531,44
1148,5,2317,863,1454,0,0,0,1.0,1,1.0,1,1.0,1,0.16708313055700538,43
1149,4,2321,864,1457,0,0,0,1.0,1,1.0,1,1.0,1,0.1850596890011227,42
1150,7,2328,866,1462,0,0,0,1.0,1,1.0,1,1.0,1,0.12162507894913463,45
1151,0,2328,866,1462,0,0,0,1.0,1,1.0,1,1.0,1,0.18973135997066762,40
1152,5,2333,868,1465,0,0,0,1.0,1,1.0,1,1.0,1,0.11604080224817831,41
1153,2,2335,870,1465,0,0,0,1.0,1,1.0,1,1.0,1,0.14139455222855968,38
1154,1,2336,871,1465,0,0,0,1.0,1,1.0,1,1.0,1,0.13558111282215982,37
1155,4,2340,873,1467,0,0,0,1.0,1,1.0,1,1.0,1,0.2100829833405461,38
1156,3,2343,873,1470,0,0,0,1.0,1,1.0,1,1.0,1,0.15994337034480346,38
1157,0,2343,873,1470,0,0,0,1.0,1,1.0,1,1.0,1,0.17561623954072833,37
1158,4,2347,874,1473,0,0,0,1.0,1,1.0,1,1.0,1,0.12747270323399768,36
1159,2,2349,874,1475,0,0,0,1.0,1,1.0,1,1.0,1,0.1379823270859792,35
1160,1,2350,875,1475,0,0,0,1.0,1,1.0,1,1.0,1,0.14185824124544685,35
1161,0,2350,875,1475,0,0,0,1.0,1,1.0,1,1.0,1,0.14797725352677074,36
1162,0,2350,875,1475,0,0,0,1.0,1,1.0,1,1.0,1,0.1500415802064378,37
1163,0,2350,875,1475,0,0,0,1.0,1,1.0,1,1.0,1,0.1500415802064378,37
1164,0,2350,875,1475,0,0,0,1.0,1,1.0,1,1.0,1,0.1547105891932945,38
1165,1,2351,875,1476,0,0,0,1.0,1,1.0,1,1.0,1,0.1326187715356516,38
1166,2,2353,875,1478,0,0,0,1.0,1,1.0,1,1.0,1,0.12196679965303789,40
1167,1,2354,875,1479,0,0,0,1.0,1,1.0,1,1.0,1,0.09416300669818232,40
1168,0,2354,875,1479,0,0,0,1.0,1,1.0,1,1.0,1,0.09416300669818232,40
1169,1,2355,875,1480,0,0,0,1.0,1,1.0,1,1.0,1,0.13416952640834187,41
1170,2,2357,876,1481,0,0,0,1.0,1,1.0,1,1.0,1,0.10424585163219097,41
1171,2,2359,877,1482,0,0,0,1.0,1,1.0,1,1.0,1,0.13647612605828066,43
1172,1,2360,878,1482,0,0,0,1.0,1,1.0,1,1.0,1,0.11619130504233492,43
1173,0,2360,878,1482,0,0,0,1.0,1,1.0,1,1.0,1,0.11619130504233492,43
1174,0,2360,878,1482,0,0,0,1.0,1,1.0,1,1.0,1,0.11619130504233492,43
1175,1,2361,878,1483,0,0,0,1.0,1,1.0,1,1.0,1,0.09738570598204353,44
1176,3,2364,879,1485,0,0,0,1.0,1,1.0,1,1.0,1,0.11114023208703619,45
1177,2,2366,881,1485,0,0,0,1.0,1,1.0,1,1.0,1,0.12294885131336072,45
1178,0,2366,881,1485,0,0,0,1.0,1,1.0,1,1.0,1,0.12294885131336072,45
1179,2,2368,882,1486,0,0,0,1.0,1,1.0,1,1.0,1,0.15794302496808504,46
1180,1,2369,882,1487,0,0,0,1.0,1,1.0,1,1.0,1,0.1224298927422752,47
1181,1,2370,883,1487,0,0,0,1.0,1,1.0,1,1.0,1,0.1772355921891004,48
1182,3,2373,885,1488,0,0,0,1.0,1,1.0,1,1.0,1,0.1890424286496027,48
1183,1,2374,885,1489,0,0,0,1.0,1,1.0,1,1.0,1,0.16291647745520899,46
1184,3,2377,887,1490,0,0,0,1.0,1,1.0,1,1.0,1,0.1577271057859638,47
1185,1,2378,887,1491,0,0,0,1.0,1,1.0,1,1.0,1,0.1618130485228541,44
1186,3,2381,887,1494,0,0,0,1.0,1,1.0,1,1.0,1,0.11921799222198982,47
1187,5,2386,888,1498,0,0,0,1.0,1,1.0,1,1.0,1,0.138022149286054,49
1188,4,2390,888,1502,0,0,0,1.0,1,1.0,1,1.0,1,0.13673693832677442,50
1189,0,2390,888,1502,0,0,0,1.0,1,1.0,1,1.0,1,0.13045532272638977,48
1190,1,2391,889,1502,0,0,0,1.0,1,1.0,1,1.0,1,0.15944439209520556,48
1191,0,2391,889,1502,0,0,0,1.0,1,1.0,1,1.0,1,0.18008110982077208,46
1192,4,2395,891,1504,0,0,0,1.0,1,1.0,1,1.0,1,0.1936808161594558,46
1193,2,2397,891,1506,0,0,0,1.0,1,1.0,1,1.0,1,0.18182411393786346,45
1194,0,2397,891,1506,0,0,0,1.0,1,1.0,1,1.0,1,0.18182411393786346,45
1195,5,2402,892,1510,0,0,0,1.0,1,1.0,1,1.0,1,0.14658271337441348,47
1196,0,2402,892,1510,0,0,0,1.0,1,1.0,1,1.0,1,0.15324300330623045,48
1197,0,2402,892,1510,0,0,0,1.0,1,1.0,1,1.0,1,0.1473960920030252,49
1198,4,2406,893,1513,0,0,0,1.0,1,1.0,1,1.0,1,0.10560724231588499,49
1199,1,2407,893,1514,0,0,0,1.0,1,1.0,1,1.0,1,0.11828433233947629,50
1200,1,2408,894,1514,0,0,0,1.0,1,1.0,1,1.0,1,0.12152468854411635,50
1201,0,2408,894,1514,0,0,0,1.0,1,1.0,1,1.0,1,0.12152468854411635,50
1202,1,2409,895,1514,0,0,0,1.0,1,1.0,1,1.0,1,0.12917115521750558,51
1203,0,2409,895,1514,0,0,0,1.0,1,1.0,1,1.0,1,0.11942445500784005,52
1204,0,2409,895,1514,0,0,0,1.0,1,1.0,1,1.0,1,0.11942445500784005,52
1205,1,2410,896,1514,0,0,0,1.0,1,1.0,1,1.0,1,0.1603920052156698,53
1206,1,2411,896,1515,0,0,0,1.0,1,1.0,1,1.0,1,0.15479676626956804,53
1207,2,2413,896,1517,0,0,0,1.0,1,1.0,1,1.0,1,0.1435208454995451,55
1208,3,2416,896,1520,0,0,0,1.0,1,1.0,1,1.0,1,0.11981160081226619,56
1209,1,2417,896,1521,0,0,0,1.0,1,1.0,1,1.0,1,0.12999832391322363,55
1210,1,2418,896,1522,0,0,0,1.0,1,1.0,1,1.0,1,0.10828007921236123,55
1211,3,2421,896,1525,0,0,0,1.0,1,1.0,1,1.0,1,0.08227993591286577,57
1212,1,2422,897,1525,0,0,0,1.0,1,1.0,1,1.0,1,0.08950697914200159,57
1213,0,2422,897,1525,0,0,0,1.0,1,1.0,1,1.0,1,0.08950697914200159,57
1214,3,2425,899,1526,0,0,0,1.0,1,1.0,1,1.0,1,0.13910009273597976,57
1215,5,2430,899,1531,0,0,0,1.0,1,1.0,1,1.0,1,0.11403892471714558,59
1216,3,2433,899,1534,0,0,0,1.0,1,1.0,1,1.0,1,0.10344667164201948,61
1217,0,2433,899,1534,0,0,0,1.0,1,1.0,1,1.0,1,0.10344667164201948,61
1218,2,2435,901,1534,0,0,0,1.0,1,1.0,1,1.0,1,0.12735419271596077,61
1219,3,2438,902,1536,0,0,0,1.0,1,1.0,1,1.0,1,0.11363668483584678,61
1220,2,2440,902,1538,0,0,0,1.0,1,1.0,1,1.0,1,0.10501013968903933,60
1221,2,2442,903,1539,0,0,0,1.0,1,1.0,1,1.0,1,0.10963511191252498,61
1222,1,2443,903,1540,0,0,0,1.0,1,1.0,1,1.0,1,0.10529768472442508,61
1223,2,2445,904,1541,0,0,0,1.0,1,1.0,1,1.0,1,0.0827949995194663,59
1224,2,2447,906,1541,0,0,0,1.0,1,1.0,1,1.0,1,0.09089581274690357,60
1225,8,2455,909,1546,0,0,0,1.0,1,1.0,1,1.0,1,0.13164865554966018,60
1226,8,2463,911,1552,0,0,0,1.0,1,1.0,1,1.0,1,0.0792481164111312,61
1227,4,2467,914,1553,0,0,0,1.0,1,1.0,1,1.0,1,0.0894092254359808,59
1228,2,2469,915,1554,0,0,0,1.0,1,1.0,1,1.0,1,0.07057696671873703,58
1229,1,2470,916,1554,0,0,0,1.0,1,1.0,1,1.0,1,0.07756404921077684,57
1230,0,2470,916,1554,0,0,0,1.0,1,1.0,1,1.0,1,0.10374208896111996,55
1231,4,2474,917,1557,0,0,0,1.0,1,1.0,1,1.0,1,0.09066487112030988,54
1232,3,2477,919,1558,0,0,0,1.0,1,1.0,1,1.0,1,0.10849821754972319,51
1233,3,2480,921,1559,0,0,0,1.0,1,1.0,1,1.0,1,0.13930361167571484,49
1234,5,2485,925,1560,0,0,0,1.0,1,1.0,1,1.0,1,0.21601369863730782,49
1235,1,2486,925,1561,0,0,0,1.0,1,1.0,1,1.0,1,0.16038026351856513,48
1236,0,2486,925,1561,0,0,0,1.0,1,1.0,1,1.0,1,0.16269656436298666,49
1237,6,2492,926,1566,0,0,0,1.0,1,1.0,1,1.0,1,0.14741293470420408,48
1238,2,2494,926,1568,0,0,0,1.0,1,1.0,1,1.0,1,0.14916611223263898,47
1239,2,2496,926,1570,0,0,0,1.0,1,1.0,1,1.0,1,0.10930451177569911,48
1240,2,2498,926,1572,0,0,0,1.0,1,1.0,1,1.0,1,0.09964455630872891,49
1241,0,2498,926,1572,0,0,0,1.0,1,1.0,1,1.0,1,0.09964455630872891,49
1242,0,2498,926,1572,0,0,0,1.0,1,1.0,1,1.0,1,0.10283169965216982,49
1243,1,2499,927,1572,0,0,0,1.0,1,1.0,1,1.0,1,0.12355592148346156,50
1244,1,2500,928,1572,0,0,0,1.0,1,1.0,1,1.0,1,0.17685073074591184,50
1245,1,2501,928,1573,0,0,0,1.0,1,1.0,1,1.0,1,0.17084707961946408,51
1246,5,2506,928,1578,0,0,0,1.0,1,1.0,1,1.0,1,0.12192620635122851,52
1247,0,2506,928,1578,0,0,0,1.0,1,1.0,1,1.0,1,0.12192620635122851,52
1248,1,2507,928,1579,0,0,0,1.0,1,1.0,1,1.0,1,0.13946189603352135,51
1249,4,2511,929,1582,0,0,0,1.0,1,1.0,1,1.0,1,0.10311491337925743,51
1250,3,2514,932,1582,0,0,0,1.0,1,1.0,1,1.0,1,0.12448149585861483,51
1251,2,2516,932,1584,0,0,0,1.0,1,1.0,1,1.0,1,0.11079550788107406,53
1252,3,2519,934,1585,0,0,0,1.0,1,1.0,1,1.0,1,0.10814396816040582,52
1253,0,2519,934,1585,0,0,0,1.0,1,1.0,1,1.0,1,0.10814396816040582,52
1254,0,2519,934,1585,0,0,0,1.0,1,1.0,1,1.0,1,0.10908832710528786,53
1255,3,2522,935,1587,0,0,0,1.0,1,1.0,1,1.0,1,0.08988654579362891,55
1256,0,2522,935,1587,0,0,0,1.0,1,1.0,1,1.0,1,0.08988654579362891,55
1257,2,2524,935,1589,0,0,0,1.0,1,1.0,1,1.0,1,0.08552062850041824,57
1258,0,2524,935,1589,0,0,0,1.0,1,1.0,1,1.0,1,0.08553966344931231,57
1259,0,2524,935,1589,0,0,0,1.0,1,1.0,1,1.0,1,0.08553966344931231,57
1260,1,2525,936,1589,0,0,0,1.0,1,1.0,1,1.0,1,0.11947298773530172,56
1261,3,2528,936,1592,0,0,0,1.0,1,1.0,1,1.0,1,0.08945704834083706,57
1262,2,2530,936,1594,0,0,0,1.0,1,1.0,1,1.0,1,0.06932749628702613,58
1263,5,2535,939,1596,0,0,0,1.0,1,1.0,1,1.0,1,0.10814885287497958,58
1264,2,2537,939,1598,0,0,0,1.0,1,1.0,1,1.0,1,0.06526674863604821,57
1265,7,2544,943,1601,0,0,0,1.0,1,1.0,1,1.0,1,0.1025045543644484,56
1266,6,2550,946,1604,0,0,0,1.0,1,1.0,1,1.0,1,0.15218771915512214,55
1267,7,2557,949,1608,0,0,0,1.0,1,1.0,1,1.0,1,0.1123224096488567,53
1268,2,2559,951,1608,0,0,0,1.0,1,1.0,1,1.0,1,0.12737417227693415,52
1269,3,2562,953,1609,0,0,0,1.0,1,1.0,1,1.0,1,0.15356956186072243,51
1270,2,2564,953,1611,0,0,0,1.0,1,1.0,1,1.0,1,0.12436978905491097,47
1271,4,2568,954,1614,0,0,0,1.0,1,1.0,1,1.0,1,0.10852152218337918,46
1272,0,2568,954,1614,0,0,0,1.0,1,1.0,1,1.0,1,0.14321072406737595,43
1273,4,2572,956,1616,0,0,0,1.0,1,1.0,1,1.0,1,0.11759362885872875,44
1274,2,2574,957,1617,0,0,0,1.0,1,1.0,1,1.0,1,0.13543426558756236,44
1275,1,2575,958,1617,0,0,0,1.0,1,1.0,1,1.0,1,0.15466716995802784,45
1276,4,2579,958,1621,0,0,0,1.0,1,1.0,1,1.0,1,0.0776100348457216,43
1277,1,2580,959,1621,0,0,0,1.0,1,1.0,1,1.0,1,0.0950955710363361,44
1278,4,2584,962,1622,0,0,0,1.0,1,1.0,1,1.0,1,0.12751133406175716,45
1279,3,2587,962,1625,0,0,0,1.0,1,1.0,1,1.0,1,0.12339868096966078,47
1280,0,2587,962,1625,0,0,0,1.0,1,1.0,1,1.0,1,0.12339868096966078,47
1281,0,2587,962,1625,0,0,0,1.0,1,1.0,1,1.0,1,0.12339868096966078,47
1282,3,2590,963,1627,0,0,0,1.0,1,1.0,1,1.0,1,0.09727339506991714,46
1283,1,2591,964,1627,0,0,0,1.0,1,1.0,1,1.0,1,0.09282883535662505,46
1284,0,2591,964,1627,0,0,0,1.0,1,1.0,1,1.0,1,0.09282883535662505,46
1285,2,2593,964,1629,0,0,0,1.0,1,1.0,1,1.0,1,0.0833021396164967,46
1286,0,2593,964,1629,0,0,0,1.0,1,1.0,1,1.0,1,0.07063212211184865,45
1287,3,2596,965,1631,0,0,0,1.0,1,1.0,1,1.0,1,0.1413148846843462,49
1288,1,2597,965,1632,0,0,0,1.0,1,1.0,1,1.0,1,0.1299890184571677,49
1289,2,2599,965,1634,0,0,0,1.0,1,1.0,1,1.0,1,0.10292779749672762,52
1290,2,2601,965,1636,0,0,0,1.0,1,1.0,1,1.0,1,0.09318893023340741,52
1291,0,2601,965,1636,0,0,0,1.0,1,1.0,1,1.0,1,0.09318893023340741,52
1292,1,2602,965,1637,0,0,0,1.0,1,1.0,1,1.0,1,0.07331764832581242,53
1293,0,2602,965,1637,0,0,0,1.0,1,1.0,1,1.0,1,0.07331764832581242,53
1294,0,2602,965,1637,0,0,0,1.0,1,1.0,1,1.0,1,0.07331764832581242,53
1295,1,2603,965,1638,0,0,0,1.0,1,1.0,1,1.0,1,0.06501798161469273,54
1296,1,2604,965,1639,0,0,0,1.0,1,1.0,1,1.0,1,0.0746485418177205,55
1297,2,2606,966,1640,0,0,0,1.0,1,1.0,1,1.0,1,0.06813547528284469,54
1298,1,2607,966,1641,0,0,0,1.0,1,1.0,1,1.0,1,0.07685686864730744,55
1299,0,2607,966,1641,0,0,0,1.0,1,1.0,1,1.0,1,0.08305486859566266,54
1300,4,2611,967,1644,0,0,0,1.0,1,1.0,1,1.0,1,0.09876611453681677,55
1301,3,2614,968,1646,0,0,0,1.0,1,1.0,1,1.0,1,0.12825449184942592,54
1302,4,2618,970,1648,0,0,0,1.0,1,1.0,1,1.0,1,0.16751527258493173,54
1303,11,2629,973,1656,0,0,0,1.0,1,1.0,1,1.0,1,0.1871342563625417,50
1304,4,2633,976,1657,0,0,0,1.0,1,1.0,1,1.0,1,0.1575325352104275,51
1305,2,2635,978,1657,0,0,0,1.0,1,1.0,1,1.0,1,0.20696811633092815,48
1306,9,2644,980,1664,0,0,0,1.0,1,1.0,1,1.0,1,0.12441332765922926,48
1307,1,2645,981,1664,0,0,0,1.0,1,1.0,1,1.0,1,0.10913802265712577,48
1308,0,2645,981,1664,0,0,0,1.0,1,1.0,1,1.0,1,0.12267678490471957,46
1309,6,2651,983,1668,0,0,0,1.0,1,1.0,1,1.0,1,0.13271502115912748,47
1310,1,2652,983,1669,0,0,0,1.0,1,1.0,1,1.0,1,0.12322470030804082,46
1311,2,2654,985,1669,0,0,0,1.0,1,1.0,1,1.0,1,0.17947524064197162,46
1312,4,2658,986,1672,0,0,0,1.0,1,1.0,1,1.0,1,0.14859055042699307,45
1313,0,2658,986,1672,0,0,0,1.0,1,1.0,1,1.0,1,0.1671633335330371,44
1314,1,2659,987,1672,0,0,0,1.0,1,1.0,1,1.0,1,0.15842959079336433,42
1315,3,2662,988,1674,0,0,0,1.0,1,1.0,1,1.0,1,0.16653828030310894,40
1316,1,2663,988,1675,0,0,0,1.0,1,1.0,1,1.0,1,0.14566513465063113,42
1317,1,2664,988,1676,0,0,0,1.0,1,1.0,1,1.0,1,0.1529115943846971,42
1318,1,2665,988,1677,0,0,0,1.0,1,1.0,1,1.0,1,0.1361888617760083,42
1319,0,2665,988,1677,0,0,0,1.0,1,1.0,1,1.0,1,0.1361888617760083,42
1320,0,2665,988,1677,0,0,0,1.0,1,1.0,1,1.0,1,0.1361888617760083,42
1321,1,2666,988,1678,0,0,0,1.0,1,1.0,1,1.0,1,0.09567645823391596,45
1322,0,2666,988,1678,0,0,0,1.0,1,1.0,1,1.0,1,0.09567645823391596,45
1323,1,2667,989,1678,0,0,0,1.0,1,1.0,1,1.0,1,0.13024763057778038,46
1324,1,2668,989,1679,0,0,0,1.0,1,1.0,1,1.0,1,0.11819442003097227,45
1325,1,2669,990,1679,0,0,0,1.0,1,1.0,1,1.0,1,0.16112386419269434,46
1326,1,2670,991,1679,0,0,0,1.0,1,1.0,1,1.0,1,0.1789012684326689,45
1327,5,2675,991,1684,0,0,0,1.0,1,1.0,1,1.0,1,0.12332770237218912,46
1328,2,2677,991,1686,0,0,0,1.0,1,1.0,1,1.0,1,0.10883997294413707,47
1329,0,2677,991,1686,0,0,0,1.0,1,1.0,1,1.0,1,0.10883997294413707,47
1330,1,2678,991,1687,0,0,0,1.0,1,1.0,1,1.0,1,0.12222322579252225,46
1331,1,2679,991,1688,0,0,0,1.0,1,1.0,1,1.0,1,0.11644814153741591,46
1332,2,2681,992,1689,0,0,0,1.0,1,1.0,1,1.0,1,0.15373506096467932,49
1333,1,2682,992,1690,0,0,0,1.0,1,1.0,1,1.0,1,0.15918045131344502,50
1334,2,2684,993,1691,0,0,0,1.0,1,1.0,1,1.0,1,0.17023287431483014,50
1335,4,2688,994,1694,0,0,0,1.0,1,1.0,1,1.0,1,0.18407557331845578,52
1336,3,2691,994,1697,0,0,0,1.0,1,1.0,1,1.0,1,0.13684094362238847,53
1337,4,2695,996,1699,0,0,0,1.0,1,1.0,1,1.0,1,0.17759307159445953,54
1338,0,2695,996,1699,0,0,0,1.0,1,1.0,1,1.0,1,0.17759307159445953,54
1339,1,2696,996,1700,0,0,0,1.0,1,1.0,1,1.0,1,0.1609310394420958,54
1340,0,2696,996,1700,0,0,0,1.0,1,1.0,1,1.0,1,0.14969358063737798,53
1341,0,2696,996,1700,0,0,0,1.0,1,1.0,1,1.0,1,0.1517786978981587,53
1342,3,2699,999,1700,0,0,0,1.0,1,1.0,1,1.0,1,0.1772263742714189,52
1343,2,2701,1000,1701,0,0,0,1.0,1,1.0,1,1.0,1,0.15692838067253542,50
1344,3,2704,1003,1701,0,0,0,1.0,1,1.0,1,1.0,1,0.2189689383513093,51
1345,3,2707,1003,1704,0,0,0,1.0,1,1.0,1,1.0,1,0.15497300911345466,50
1346,1,2708,1004,1704,0,0,0,1.0,1,1.0,1,1.0,1,0.16740130114726787,50
1347,1,2709,1004,1705,0,0,0,1.0,1,1.0,1,1.0,1,0.14506114788655725,48
1348,3,2712,1004,1708,0,0,0,1.0,1,1.0,1,1.0,1,0.11438750563584445,49
1349,0,2712,1004,1708,0,0,0,1.0,1,1.0,1,1.0,1,0.1069468391512242,48
1350,1,2713,1005,1708,0,0,0,1.0,1,1.0,1,1.0,1,0.12172838561535985,49
1351,1,2714,1005,1709,0,0,0,1.0,1,1.0,1,1.0,1,0.08869314068168711,48
1352,2,2716,1006,1710,0,0,0,1.0,1,1.0,1,1.0,1,0.07716465928891955,49
1353,2,2718,1006,1712,0,0,0,1.0,1,1.0,1,1.0,1,0.08049717970974567,49
1354,1,2719,1007,1712,0,0,0,1.0,1,1.0,1,1.0,1,0.10125765369443386,49
1355,3,2722,1007,1715,0,0,0,1.0,1,1.0,1,1.0,1,0.09225171066801136,50
1356,1,2723,1008,1715,0,0,0,1.0,1,1.0,1,1.0,1,0.1159938238807072,50
1357,5,2728,1010,1718,0,0,0,1.0,1,1.0,1,1.0,1,0.13561147333190543,50
1358,3,2731,1011,1720,0,0,0,1.0,1,1.0,1,1.0,1,0.13600570374787757,51
1359,3,2734,1012,1722,0,0,0,1.0,1,1.0,1,1.0,1,0.1479067171429477,53
1360,8,2742,1012,1730,0,0,0,1.0,1,1.0,1,1.0,1,0.09412642723467649,54
1361,1,2743,1012,1731,0,0,0,1.0,1,1.0,1,1.0,1,0.07061674639771716,54
1362,3,2746,1013,1733,0,0,0,1.0,1,1.0,1,1.0,1,0.08694875127689995,55
1363,0,2746,1013,1733,0,0,0,1.0,1,1.0,1,1.0,1,0.08694875127689995,55
1364,3,2749,1014,1735,0,0,0,1.0,1,1.0,1,1.0,1,0.08835592270189124,55
1365,5,2754,1016,1738,0,0,0,1.0,1,1.0,1,1.0,1,0.10958394664346903,56
1366,2,2756,1016,1740,0,0,0,1.0,1,1.0,1,1.0,1,0.09284816563333084,56
1367,3,2759,1018,1741,0,0,0,1.0,1,1.0,1,1.0,1,0.08616095804084423,56
1368,3,2762,1019,1743,0,0,0,1.0,1,1.0,1,1.0,1,0.10576863517610424,58
1369,3,2765,1019,1746,0,0,0,1.0,1,1.0,1,1.0,1,0.07614743394917851,59
1370,2,2767,1021,1746,0,0,0,1.0,1,1.0,1,1.0,1,0.07559666299329137,59
1371,2,2769,1021,1748,0,0,0,1.0,1,1.0,1,1.0,1,0.06005088124504183,59
1372,0,2769,1021,1748,0,0,0,1.0,1,1.0,1,1.0,1,0.06005088124504183,59
1373,0,2769,1021,1748,0,0,0,1.0,1,1.0,1,1.0,1,0.06005088124504183,59
1374,2,2771,1022,1749,0,0,0,1.0,1,1.0,1,1.0,1,0.09623095182842055,60
1375,2,2773,1022,1751,0,0,0,1.0,1,1.0,1,1.0,1,0.08858349893028791,61
1376,3,2776,1022,1754,0,0,0,1.0,1,1.0,1,1.0,1,0.08758956919208516,61
1377,0,2776,1022,1754,0,0,0,1.0,1,1.0,1,1.0,1,0.08758956919208516,61
1378,5,2781,1024,1757,0,0,0,1.0,1,1.0,1,1.0,1,0.1226686241849229,61
1379,0,2781,1024,1757,0,0,0,1.0,1,1.0,1,1.0,1,0.12151509380257669,60
1380,2,2783,1025,1758,0,0,0,1.0,1,1.0,1,1.0,1,0.12436863006589953,60
1381,1,2784,1025,1759,0,0,0,1.0,1,1.0,1,1.0,1,0.11549006856710983,58
1382,3,2787,1027,1760,0,0,0,1.0,1,1.0,1,1.0,1,0.15141047536288746,58
1383,4,2791,1029,1762,0,0,0,1.0,1,1.0,1,1.0,1,0.13247042860033906,57
1384,9,2800,1032,1768,0,0,0,1.0,1,1.0,1,1.0,1,0.10659012972431806,54
1385,1,2801,1033,1768,0,0,0,1.0,1,1.0,1,1.0,1,0.11145350384373642,52
1386,3,2804,1034,1770,0,0,0,1.0,1,1.0,1,1.0,1,0.10840842493872876,51
1387,2,2806,1034,1772,0,0,0,1.0,1,1.0,1,1.0,1,0.10251671867793276,51
1388,2,2808,1036,1772,0,0,0,1.0,1,1.0,1,1.0,1,0.1325321447821822,52
1389,3,2811,1036,1775,0,0,0,1.0,1,1.0,1,1.0,1,0.10240116815257647,50
1390,2,2813,1037,1776,0,0,0,1.0,1,1.0,1,1.0,1,0.0919575919824758,51
1391,0,2813,1037,1776,0,0,0,1.0,1,1.0,1,1.0,1,0.13048008243315748,50
1392,1,2814,1038,1776,0,0,0,1.0,1,1.0,1,1.0,1,0.14007340105039334,50
1393,5,2819,1038,1781,0,0,0,1.0,1,1.0,1,1.0,1,0.08094937123784805,49
1394,4,2823,1040,1783,0,0,0,1.0,1,1.0,1,1.0,1,0.10509434900704712,50
1395,1,2824,1040,1784,0,0,0,1.0,1,1.0,1,1.0,1,0.09881834289094191,51
1396,0,2824,1040,1784,0,0,0,1.0,1,1.0,1,1.0,1,0.11423853307473728,52
1397,0,2824,1040,1784,0,0,0,1.0,1,1.0,1,1.0,1,0.11423853307473728,52
1398,0,2824,1040,1784,0,0,0,1.0,1,1.0,1,1.0,1,0.11035728472699426,53
1399,2,2826,1042,1784,0,0,0,1.0,1,1.0,1,1.0,1,0.14831305000357378,54
1400,3,2829,1044,1785,0,0,0,1.0,1,1.0,1,1.0,1,0.1547123455094008,54
1401,2,2831,1046,1785,0,0,0,1.0,1,1.0,1,1.0,1,0.20204981331172361,54
1402,6,2837,1048,1789,0,0,0,1.0,1,1.0,1,1.0,1,0.19122122364442956,53
1403,2,2839,1048,1791,0,0,0,1.0,1,1.0,1,1.0,1,0.18700606756203533,52
1404,1,2840,1048,1792,0,0,0,1.0,1,1.0,1,1.0,1,0.1880705262491594,53
1405,3,2843,1049,1794,0,0,0,1.0,1,1.0,1,1.0,1,0.22431914332329078,52
1406,0,2843,1049,1794,0,0,0,1.0,1,1.0,1,1.0,1,0.21508792998525578,53
1407,1,2844,1049,1795,0,0,0,1.0,1,1.0,1,1.0,1,0.22025514598351276,54
1408,1,2845,1049,1796,0,0,0,1.0,1,1.0,1,1.0,1,0.2316626864419085,53
1409,1,2846,1049,1797,0,0,0,1.0,1,1.0,1,1.0,1,0.21922008407262564,55
1410,1,2847,1049,1798,0,0,0,1.0,1,1.0,1,1.0,1,0.22195611504917256,54
1411,0,2847,1049,1798,0,0,0,1.0,1,1.0,1,1.0,1,0.22195611504917256,54
1412,0,2847,1049,1798,0,0,0,1.0,1,1.0,1,1.0,1,0.22679704691173475,53
1413,0,2847,1049,1798,0,0,0,1.0,1,1.0,1,1.0,1,0.21750091520450668,54
1414,3,2850,1049,1801,0,0,0,1.0,1,1.0,1,1.0,1,0.2180382149107073,55
1415,5,2855,1050,1805,0,0,0,1.0,1,1.0,1,1.0,1,0.1645338061217168,57
1416,3,2858,1050,1808,0,0,0,1.0,1,1.0,1,1.0,1,0.15958091041371947,59
1417,3,2861,1052,1809,0,0,0,1.0,1,1.0,1,1.0,1,0.15671388447538878,58
1418,0,2861,1052,1809,0,0,0,1.0,1,1.0,1,1.0,1,0.1471231499726463,57
1419,2,2863,1054,1809,0,0,0,1.0,1,1.0,1,1.0,1,0.1813759189095058,56
1420,4,2867,1055,1812,0,0,0,1.0,1,1.0,1,1.0,1,0.17739117092214282,54
1421,2,2869,1056,1813,0,0,0,1.0,1,1.0,1,1.0,1,0.1645852163617544,55
1422,0,2869,1056,1813,0,0,0,1.0,1,1.0,1,1.0,1,0.1415826485268496,52
1423,3,2872,1057,1815,0,0,0,1.0,1,1.0,1,1.0,1,0.13774089313303767,52
1424,2,2874,1059,1815,0,0,0,1.0,1,1.0,1,1.0,1,0.13706091757479452,51
1425,1,2875,1059,1816,0,0,0,1.0,1,1.0,1,1.0,1,0.14788664198950432,50
1426,3,2878,1060,1818,0,0,0,1.0,1,1.0,1,1.0,1,0.14396231965690615,50
1427,1,2879,1060,1819,0,0,0,1.0,1,1.0,1,1.0,1,0.1580866216571045,48
1428,1,2880,1061,1819,0,0,0,1.0,1,1.0,1,1.0,1,0.17965487488483697,48
1429,2,2882,1061,1821,0,0,0,1.0,1,1.0,1,1.0,1,0.17841298888734933,48
1430,5,2887,1063,1824,0,0,0,1.0,1,1.0,1,1.0,1,0.12060246582566674,48
1431,1,2888,1063,1825,0,0,0,1.0,1,1.0,1,1.0,1,0.12065731245260006,48
1432,1,2889,1063,1826,0,0,0,1.0,1,1.0,1,1.0,1,0.09207129821175235,50
1433,2,2891,1063,1828,0,0,0,1.0,1,1.0,1,1.0,1,0.07444339022496307,51
1434,0,2891,1063,1828,0,0,0,1.0,1,1.0,1,1.0,1,0.07444339022496307,51
1435,5,2896,1066,1830,0,0,0,1.0,1,1.0,1,1.0,1,0.09081048249733757,50
1436,5,2901,1068,1833,0,0,0,1.0,1,1.0,1,1.0,1,0.144821271933081,51
1437,2,2903,1068,1835,0,0,0,1.0,1,1.0,1,1.0,1,0.14561393729660535,51
1438,5,2908,1071,1837,0,0,0,1.0,1,1.0,1,1.0,1,0.16992179951479947,51
1439,2,2910,1072,1838,0,0,0,1.0,1,1.0,1,1.0,1,0.16476933518945402,50
1440,3,2913,1073,1840,0,0,0,1.0,1,1.0,1,1.0,1,0.17697690811406608,51
1441,2,2915,1073,1842,0,0,0,1.0,1,1.0,1,1.0,1,0.1510382200049202,51
1442,5,2920,1075,1845,0,0,0,1.0,1,1.0,1,1.0,1,0.15824085356021864,52
1443,5,2925,1075,1850,0,0,0,1.0,1,1.0,1,1.0,1,0.1334679123793246,53
1444,1,2926,1075,1851,0,0,0,1.0,1,1.0,1,1.0,1,0.12995891891100808,54
1445,1,2927,1075,1852,0,0,0,1.0,1,1.0,1,1.0,1,0.1254890795303187,54
1446,3,2930,1075,1855,0,0,0,1.0,1,1.0,1,1.0,1,0.10143291397169671,54
1447,0,2930,1075,1855,0,0,0,1.0,1,1.0,1,1.0,1,0.09150823634672653,55
1448,0,2930,1075,1855,0,0,0,1.0,1,1.0,1,1.0,1,0.09150823634672653,55
1449,0,2930,1075,1855,0,0,0,1.0,1,1.0,1,1.0,1,0.09150823634672653,55
1450,1,2931,1075,1856,0,0,0,1.0,1,1.0,1,1.0,1,0.08941838673942827,57
1451,0,2931,1075,1856,0,0,0,1.0,1,1.0,1,1.0,1,0.08941838673942827,57
1452,5,2936,1076,1860,0,0,0,1.0,1,1.0,1,1.0,1,0.061969627323308935,57
1453,2,2938,1078,1860,0,0,0,1.0,1,1.0,1,1.0,1,0.11600268628210354,57
1454,2,2940,1078,1862,0,0,0,1.0,1,1.0,1,1.0,1,0.11509044245917202,58
1455,1,2941,1078,1863,0,0,0,1.0,1,1.0,1,1.0,1,0.10013058773810736,56
1456,2,2943,1079,1864,0,0,0,1.0,1,1.0,1,1.0,1,0.10793280890769771,55
1457,1,2944,1080,1864,0,0,0,1.0,1,1.0,1,1.0,1,0.14459122506901648,54
1458,2,2946,1081,1865,0,0,0,1.0,1,1.0,1,1.0,1,0.12655169721067233,53
1459,4,2950,1081,1869,0,0,0,1.0,1,1.0,1,1.0,1,0.09800541678833609,52
1460,0,2950,1081,1869,0,0,0,1.0,1,1.0,1,1.0,1,0.09891660536304726,51
1461,2,2952,1083,1869,0,0,0,1.0,1,1.0,1,1.0,1,0.11132520925995272,51
1462,5,2957,1087,1870,0,0,0,1.0,1,1.0,1,1.0,1,0.08710886725252932,51
1463,4,2961,1090,1871,0,0,0,1.0,1,1.0,1,1.0,1,0.14594345315431684,52
1464,3,2964,1093,1871,0,0,0,1.0,1,1.0,1,1.0,1,0.2012845773177443,52
1465,8,2972,1094,1878,0,0,0,1.0,1,1.0,1,1.0,1,0.12193652248592866,51
1466,3,2975,1096,1879,0,0,0,1.0,1,1.0,1,1.0,1,0.1354253730490179,50
1467,2,2977,1097,1880,0,0,0,1.0,1,1.0,1,1.0,1,0.19835834883244718,48
1468,7,2984,1099,1885,0,0,0,1.0,1,1.0,1,1.0,1,0.12682127134293086,48
1469,9,2993,1102,1891,0,0,0,1.0,1,1.0,1,1.0,1,0.14341319568390884,48
1470,4,2997,1103,1894,0,0,0,1.0,1,1.0,1,1.0,1,0.1292539848340937,48
1471,2,2999,1105,1894,0,0,0,1.0,1,1.0,1,1.0,1,0.15138512392637457,45
1472,2,3001,1105,1896,0,0,0,1.0,1,1.0,1,1.0,1,0.10733102951565605,45
1473,1,3002,1105,1897,0,0,0,1.0,1,1.0,1,1.0,1,0.10574662628689582,46
1474,0,3002,1105,1897,0,0,0,1.0,1,1.0,1,1.0,1,0.12760055447621765,46
1475,2,3004,1106,1898,0,0,0,1.0,1,1.0,1,1.0,1,0.1255596554820509,46
1476,1,3005,1106,1899,0,0,0,1.0,1,1.0,1,1.0,1,0.12232159686183061,47
1477,1,3006,1107,1899,0,0,0,1.0,1,1.0,1,1.0,1,0.13402707560329774,47
1478,2,3008,1108,1900,0,0,0,1.0,1,1.0,1,1.0,1,0.14512522425088942,47
1479,1,3009,1108,1901,0,0,0,1.0,1,1.0,1,1.0,1,0.13258433479628187,48
1480,5,3014,1109,1905,0,0,0,1.0,1,1.0,1,1.0,1,0.121328059345844,47
1481,3,3017,1110,1907,0,0,0,1.0,1,1.0,1,1.0,1,0.10480169254961622,47
1482,1,3018,1111,1907,0,0,0,1.0,1,1.0,1,1.0,1,0.14806853247008162,46
1483,2,3020,1112,1908,0,0,0,1.0,1,1.0,1,1.0,1,0.14058690347538874,47
1484,0,3020,1112,1908,0,0,0,1.0,1,1.0,1,1.0,1,0.17083065038190887,47
1485,3,3023,1112,1911,0,0,0,1.0,1,1.0,1,1.0,1,0.17041472181465878,47
1486,3,3026,1112,1914,0,0,0,1.0,1,1.0,1,1.0,1,0.15118110247171698,49
1487,1,3027,1113,1914,0,0,0,1.0,1,1.0,1,1.0,1,0.1524898593984,49
1488,1,3028,1114,1914,0,0,0,1.0,1,1.0,1,1.0,1,0.15063168950579375,51
1489,2,3030,1114,1916,0,0,0,1.0,1,1.0,1,1.0,1,0.12381356831258158,52
1490,1,3031,1114,1917,0,0,0,1.0,1,1.0,1,1.0,1,0.12049957709150456,52
1491,2,3033,1116,1917,0,0,0,1.0,1,1.0,1,1.0,1,0.13863195663728387,53
1492,5,3038,1119,1919,0,0,0,1.0,1,1.0,1,1.0,1,0.1400976282559931,53
1493,2,3040,1121,1919,0,0,0,1.0,1,1.0,1,1.0,1,0.13723033331387105,52
1494,3,3043,1124,1919,0,0,0,1.0,1,1.0,1,1.0,1,0.13653851958726104,50
1495,4,3047,1126,1921,0,0,0,1.0,1,1.0,1,1.0,1,0.12318050552167553,50
1496,6,3053,1128,1925,0,0,0,1.0,1,1.0,1,1.0,1,0.11417837393970644,52
1497,1,3054,1129,1925,0,0,0,1.0,1,1.0,1,1.0,1,0.13785795709353307,51
1498,1,3055,1129,1926,0,0,0,1.0,1,1.0,1,1.0,1,0.10458229870065489,50
1499,1,3056,1130,1926,0,0,0,1.0,1,1.0,1,1.0,1,0.11531834234978243,50
1500,2,3058,1131,1927,0,0,0,1.0,1,1.0,1,1.0,1,0.13925722551246508,49
1501,3,3061,1132,1929,0,0,0,1.0,1,1.0,1,1.0,1,0.1052180413820319,47
1502,3,3064,1135,1929,0,0,0,1.0,1,1.0,1,1.0,1,0.15849117848052702,47
1503,2,3066,1135,1931,0,0,0,1.0,1,1.0,1,1.0,1,0.15092811700733116,47
1504,5,3071,1138,1933,0,0,0,1.0,1,1.0,1,1.0,1,0.10576286123537891,48
1505,4,3075,1140,1935,0,0,0,1.0,1,1.0,1,1.0,1,0.08487891636565477,47
1506,2,3077,1141,1936,0,0,0,1.0,1,1.0,1,1.0,1,0.06735149648876493,47
1507,1,3078,1142,1936,0,0,0,1.0,1,1.0,1,1.0,1,0.07656427134313182,45
1508,1,3079,1143,1936,0,0,0,1.0,1,1.0,1,1.0,1,0.11904743286383405,45
1509,1,3080,1144,1936,0,0,0,1.0,1,1.0,1,1.0,1,0.11421865288304088,44
1510,3,3083,1147,1936,0,0,0,1.0,1,1.0,1,1.0,1,0.16150185717237295,42
1511,0,3083,1147,1936,0,0,0,1.0,1,1.0,1,1.0,1,0.1691856053565103,40
1512,5,3088,1150,1938,0,0,0,1.0,1,1.0,1,1.0,1,0.22771392177810695,39
1513,2,3090,1151,1939,0,0,0,1.0,1,1.0,1,1.0,1,0.23171626265299794,39
1514,1,3091,1151,1940,0,0,0,1.0,1,1.0,1,1.0,1,0.2383588750263379,38
1515,1,3092,1152,1940,0,0,0,1.0,1,1.0,1,1.0,1,0.2424845267635933,39
1516,2,3094,1152,1942,0,0,0,1.0,1,1.0,1,1.0,1,0.21317868894669798,39
1517,4,3098,1154,1944,0,0,0,1.0,1,1.0,1,1.0,1,0.1969745613242467,39
1518,3,3101,1155,1946,0,0,0,1.0,1,1.0,1,1.0,1,0.20130382728559623,39
1519,3,3104,1155,1949,0,0,0,1.0,1,1.0,1,1.0,1,0.12842872985411707,39
1520,3,3107,1157,1950,0,0,0,1.0,1,1.0,1,1.0,1,0.1648083652691632,39
1521,5,3112,1159,1953,0,0,0,1.0,1,1.0,1,1.0,1,0.2175354588723629,40
1522,5,3117,1160,1957,0,0,0,1.0,1,1.0,1,1.0,1,0.15939566907087607,40
1523,0,3117,1160,1957,0,0,0,1.0,1,1.0,1,1.0,1,0.15696048105630026,41
1524,0,3117,1160,1957,0,0,0,1.0,1,1.0,1,1.0,1,0.16881327017333722,42
1525,3,3120,1161,1959,0,0,0,1.0,1,1.0,1,1.0,1,0.15670111730026165,45
1526,1,3121,1161,1960,0,0,0,1.0,1,1.0,1,1.0,1,0.1705109849550085,46
1527,0,3121,1161,1960,0,0,0,1.0,1,1.0,1,1.0,1,0.1705109849550085,46
1528,0,3121,1161,1960,0,0,0,1.0,1,1.0,1,1.0,1,0.1764241743997738,47
1529,1,3122,1161,1961,0,0,0,1.0,1,1.0,1,1.0,1,0.1492843453235866,47
1530,0,3122,1161,1961,0,0,0,1.0,1,1.0,1,1.0,1,0.1593748795251846,48
1531,1,3123,1161,1962,0,0,0,1.0,1,1.0,1,1.0,1,0.1574105172918843,46
1532,3,3126,1162,1964,0,0,0,1.0,1,1.0,1,1.0,1,0.14930095142831193,47
1533,0,3126,1162,1964,0,0,0,1.0,1,1.0,1,1.0,1,0.14481373560211283,46
1534,1,3127,1162,1965,0,0,0,1.0,1,1.0,1,1.0,1,0.13886804726884242,47
1535,1,3128,1163,1965,0,0,0,1.0,1,1.0,1,1.0,1,0.1623907850367573,47
1536,5,3133,1163,1970,0,0,0,1.0,1,1.0,1,1.0,1,0.1013135838513907,48
1537,1,3134,1163,1971,0,0,0,1.0,1,1.0,1,1.0,1,0.09479445492182736,46
1538,0,3134,1163,1971,0,0,0,1.0,1,1.0,1,1.0,1,0.08721422702244457,47
1539,0,3134,1163,1971,0,0,0,1.0,1,1.0,1,1.0,1,0.1116147398291342,47
1540,1,3135,1164,1971,0,0,0,1.0,1,1.0,1,1.0,1,0.11921449629001939,47
1541,1,3136,1164,1972,0,0,0,1.0,1,1.0,1,1.0,1,0.10748740312196856,47
1542,6,3142,1168,1974,0,0,0,1.0,1,1.0,1,1.0,1,0.17783775709673336,50
1543,5,3147,1169,1978,0,0,0,1.0,1,1.0,1,1.0,1,0.11443999666332874,47
1544,6,3153,1172,1981,0,0,0,1.0,1,1.0,1,1.0,1,0.17296437474767895,48
1545,5,3158,1173,1985,0,0,0,1.0,1,1.0,1,1.0,1,0.08631891608671663,47
1546,1,3159,1174,1985,0,0,0,1.0,1,1.0,1,1.0,1,0.06434866085834991,47
1547,2,3161,1175,1986,0,0,0,1.0,1,1.0,1,1.0,1,0.13245527392741882,47
1548,5,3166,1177,1989,0,0,0,1.0,1,1.0,1,1.0,1,0.13138638026140032,47
1549,6,3172,1181,1991,0,0,0,1.0,1,1.0,1,1.0,1,0.10268555574579628,46
1550,2,3174,1182,1992,0,0,0,1.0,1,1.0,1,1.0,1,0.14294584534251417,44
1551,6,3180,1184,1996,0,0,0,1.0,1,1.0,1,1.0,1,0.15108107859011777,45
1552,5,3185,1187,1998,0,0,0,1.0,1,1.0,1,1.0,1,0.12072521899524484,43
1553,1,3186,1187,1999,0,0,0,1.0,1,1.0,1,1.0,1,0.10626548658868885,43
1554,0,3186,1187,1999,0,0,0,1.0,1,1.0,1,1.0,1,0.13153232345820884,41
1555,3,3189,1187,2002,0,0,0,1.0,1,1.0,1,1.0,1,0.11815554273679758,44
1556,3,3192,1188,2004,0,0,0,1.0,1,1.0,1,1.0,1,0.10281408968897068,45
1557,0,3192,1188,2004,0,0,0,1.0,1,1.0,1,1.0,1,0.10281408968897068,45
1558,1,3193,1188,2005,0,0,0,1.0,1,1.0,1,1.0,1,0.09149880559771371,46
1559,2,3195,1189,2006,0,0,0,1.0,1,1.0,1,1.0,1,0.11249748662193909,47
1560,3,3198,1191,2007,0,0,0,1.0,1,1.0,1,1.0,1,0.09416036284891723,46
1561,2,3200,1192,2008,0,0,0,1.0,1,1.0,1,1.0,1,0.08469443174512306,47
1562,1,3201,1192,2009,0,0,0,1.0,1,1.0,1,1.0,1,0.09176436263058359,47
1563,1,3202,1192,2010,0,0,0,1.0,1,1.0,1,1.0,1,0.06428342034859126,47
1564,1,3203,1192,2011,0,0,0,1.0,1,1.0,1,1.0,1,0.051281124279934164,47
1565,0,3203,1192,2011,0,0,0,1.0,1,1.0,1,1.0,1,0.09906759617144238,48
1566,0,3203,1192,2011,0,0,0,1.0,1,1.0,1,1.0,1,0.09906759617144238,48
1567,1,3204,1192,2012,0,0,0,1.0,1,1.0,1,1.0,1,0.1301852817198507,48
1568,4,3208,1195,2013,0,0,0,1.0,1,1.0,1,1.0,1,0.1759081522117565,48
1569,0,3208,1195,2013,0,0,0,1.0,1,1.0,1,1.0,1,0.14634473649015972,45
1570,5,3213,1196,2017,0,0,0,1.0,1,1.0,1,1.0,1,0.09190943169541822,44
1571,6,3219,1201,2018,0,0,0,1.0,1,1.0,1,1.0,1,0.13136525328123544,42
1572,2,3221,1201,2020,0,0,0,1.0,1,1.0,1,1.0,1,0.14558103277148238,43
1573,4,3225,1201,2024,0,0,0,1.0,1,1.0,1,1.0,1,0.09942937327900762,43
1574,4,3229,1204,2025,0,0,0,1.0,1,1.0,1,1.0,1,0.1332446255458326,42
1575,1,3230,1204,2026,0,0,0,1.0,1,1.0,1,1.0,1,0.1106056321648448,43
1576,2,3232,1206,2026,0,0,0,1.0,1,1.0,1,1.0,1,0.11835461616108979,41
1577,2,3234,1208,2026,0,0,0,1.0,1,1.0,1,1.0,1,0.13080533520464865,40
1578,0,3234,1208,2026,0,0,0,1.0,1,1.0,1,1.0,1,0.15164806021395946,40
1579,2,3236,1208,2028,0,0,0,1.0,1,1.0,1,1.0,1,0.11368001824844517,40
1580,0,3236,1208,2028,0,0,0,1.0,1,1.0,1,1.0,1,0.11368001824844517,40
1581,1,3237,1209,2028,0,0,0,1.0,1,1.0,1,1.0,1,0.10326835656176396,40
1582,6,3243,1213,2030,0,0,0,1.0,1,1.0,1,1.0,1,0.18077072458076643,40
1583,3,3246,1214,2032,0,0,0,1.0,1,1.0,1,1.0,1,0.17885089395591125,38
1584,6,3252,1217,2035,0,0,0,1.0,1,1.0,1,1.0,1,0.18360272052219967,39
1585,4,3256,1219,2037,0,0,0,1.0,1,1.0,1,1.0,1,0.12417812500541815,38
1586,4,3260,1221,2039,0,0,0,1.0,1,1.0,1,1.0,1,0.05697907359120894,38
1587,3,3263,1223,2040,0,0,0,1.0,1,1.0,1,1.0,1,0.15279674681901512,37
1588,3,3266,1224,2042,0,0,0,1.0,1,1.0,1,1.0,1,0.11291342330465799,39
1589,1,3267,1225,2042,0,0,0,1.0,1,1.0,1,1.0,1,0.105346669989074,37
1590,2,3269,1227,2042,0,0,0,1.0,1,1.0,1,1.0,1,0.1790039416285836,37
1591,6,3275,1228,2047,0,0,0,1.0,1,1.0,1,1.0,1,0.11663720241187236,36
1592,0,3275,1228,2047,0,0,0,1.0,1,1.0,1,1.0,1,0.15852958497195715,34
1593,0,3275,1228,2047,0,0,0,1.0,1,1.0,1,1.0,1,0.19049501799514343,33
1594,2,3277,1228,2049,0,0,0,1.0,1,1.0,1,1.0,1,0.19906847442740186,31
1595,3,3280,1229,2051,0,0,0,1.0,1,1.0,1,1.0,1,0.16858649055327654,34
1596,0,3280,1229,2051,0,0,0,1.0,1,1.0,1,1.0,1,0.16273705020307175,33
1597,3,3283,1230,2053,0,0,0,1.0,1,1.0,1,1.0,1,0.09898827773991477,33
1598,2,3285,1231,2054,0,0,0,1.0,1,1.0,1,1.0,1,0.12736956620201814,33
1599,0,3285,1231,2054,0,0,0,1.0,1,1.0,1,1.0,1,0.12736956620201814,33
1600,3,3288,1232,2056,0,0,0,1.0,1,1.0,1,1.0,1,0.1095802150745448,34
1601,0,3288,1232,2056,0,0,0,1.0,1,1.0,1,1.0,1,0.13500603952151152,35
1602,0,3288,1232,2056,0,0,0,1.0,1,1.0,1,1.0,1,0.13267058830869394,36
1603,2,3290,1233,2057,0,0,0,1.0,1,1.0,1,1.0,1,0.17119253289174965,38
1604,3,3293,1234,2059,0,0,0,1.0,1,1.0,1,1.0,1,0.14938175795607894,38
1605,2,3295,1234,2061,0,0,0,1.0,1,1.0,1,1.0,1,0.10805429465503574,38
1606,5,3300,1237,2063,0,0,0,1.0,1,1.0,1,1.0,1,0.16031616081469682,39
1607,2,3302,1238,2064,0,0,0,1.0,1,1.0,1,1.0,1,0.15794875980092332,37
1608,3,3305,1239,2066,0,0,0,1.0,1,1.0,1,1.0,1,0.18956583441098607,36
1609,1,3306,1239,2067,0,0,0,1.0,1,1.0,1,1.0,1,0.1635292766774002,34
1610,1,3307,1240,2067,0,0,0,1.0,1,1.0,1,1.0,1,0.18074902681204724,34
1611,2,3309,1241,2068,0,0,0,1.0,1,1.0,1,1.0,1,0.18857391792278855,35
1612,3,3312,1241,2071,0,0,0,1.0,1,1.0,1,1.0,1,0.11863635922749032,33
1613,0,3312,1241,2071,0,0,0,1.0,1,1.0,1,1.0,1,0.13803792136841597,34
1614,1,3313,1241,2072,0,0,0,1.0,1,1.0,1,1.0,1,0.11520606776326926,35
1615,1,3314,1242,2072,0,0,0,1.0,1,1.0,1,1.0,1,0.1301388760021491,35
1616,2,3316,1243,2073,0,0,0,1.0,1,1.0,1,1.0,1,0.15900318456144386,37
1617,5,3321,1245,2076,0,0,0,1.0,1,1.0,1,1.0,1,0.1626274898932769,38
1618,4,3325,1246,2079,0,0,0,1.0,1,1.0,1,1.0,1,0.08005125976859612,38
1619,1,3326,1246,2080,0,0,0,1.0,1,1.0,1,1.0,1,0.05894072674409141,38
1620,1,3327,1247,2080,0,0,0,1.0,1,1.0,1,1.0,1,0.09439828505806816,39
1621,0,3327,1247,2080,0,0,0,1.0,1,1.0,1,1.0,1,0.11003423187217423,37
1622,3,3330,1249,2081,0,0,0,1.0,1,1.0,1,1.0,1,0.1978680287670644,37
1623,3,3333,1251,2082,0,0,0,1.0,1,1.0,1,1.0,1,0.18470398586981746,37
1624,3,3336,1253,2083,0,0,0,1.0,1,1.0,1,1.0,1,0.2273622972238416,37
1625,1,3337,1254,2083,0,0,0,1.0,1,1.0,1,1.0,1,0.15960663274976628,35
1626,0,3337,1254,2083,0,0,0,1.0,1,1.0,1,1.0,1,0.15960663274976628,35
1627,1,3338,1255,2083,0,0,0,1.0,1,1.0,1,1.0,1,0.12044761791656904,34
1628,6,3344,1257,2087,0,0,0,1.0,1,1.0,1,1.0,1,0.09216456184221643,35
1629,2,3346,1259,2087,0,0,0,1.0,1,1.0,1,1.0,1,0.16308575005409282,34
1630,1,3347,1259,2088,0,0,0,1.0,1,1.0,1,1.0,1,0.10938381712296782,32
1631,0,3347,1259,2088,0,0,0,1.0,1,1.0,1,1.0,1,0.13781337540182345,33
1632,1,3348,1260,2088,0,0,0,1.0,1,1.0,1,1.0,1,0.20577467784244835,32
1633,1,3349,1260,2089,0,0,0,1.0,1,1.0,1,1.0,1,0.17438824907843453,31
1634,1,3350,1261,2089,0,0,0,1.0,1,1.0,1,1.0,1,0.22936506705406481,31
1635,1,3351,1261,2090,0,0,0,1.0,1,1.0,1,1.0,1,0.22305088659288305,31
1636,2,3353,1261,2092,0,0,0,1.0,1,1.0,1,1.0,1,0.2030968964866224,33
1637,0,3353,1261,2092,0,0,0,1.0,1,1.0,1,1.0,1,0.2030968964866224,33
1638,0,3353,1261,2092,0,0,0,1.0,1,1.0,1,1.0,1,0.20609105977878397,36
1639,3,3356,1262,2094,0,0,0,1.0,1,1.0,1,1.0,1,0.13484525217900648,36
1640,1,3357,1263,2094,0,0,0,1.0,1,1.0,1,1.0,1,0.1520577001278692,36
1641,0,3357,1263,2094,0,0,0,1.0,1,1.0,1,1.0,1,0.15638342721813372,38
1642,2,3359,1264,2095,0,0,0,1.0,1,1.0,1,1.0,1,0.17237213949083335,37
1643,2,3361,1265,2096,0,0,0,1.0,1,1.0,1,1.0,1,0.20732339594769286,37
1644,3,3364,1267,2097,0,0,0,1.0,1,1.0,1,1.0,1,0.25044603198823057,38
1645,1,3365,1267,2098,0,0,0,1.0,1,1.0,1,1.0,1,0.21190833162156128,36
1646,0,3365,1267,2098,0,0,0,1.0,1,1.0,1,1.0,1,0.225361531964982,37
1647,2,3367,1268,2099,0,0,0,1.0,1,1.0,1,1.0,1,0.2649764334386124,35
1648,2,3369,1268,2101,0,0,0,1.0,1,1.0,1,1.0,1,0.25568482952491506,38
1649,1,3370,1269,2101,0,0,0,1.0,1,1.0,1,1.0,1,0.2562395774675403,35
1650,0,3370,1269,2101,0,0,0,1.0,1,1.0,1,1.0,1,0.27334990589998825,34
1651,5,3375,1269,2106,0,0,0,1.0,1,1.0,1,1.0,1,0.2275837696485622,32
1652,2,3377,1269,2108,0,0,0,1.0,1,1.0,1,1.0,1,0.16145776121256047,33
1653,3,3380,1269,2111,0,0,0,1.0,1,1.0,1,1.0,1,0.12957772160166467,33
1654,0,3380,1269,2111,0,0,0,1.0,1,1.0,1,1.0,1,0.1501465107682854,34
1655,0,3380,1269,2111,0,0,0,1.0,1,1.0,1,1.0,1,0.16483349242158682,35
1656,1,3381,1269,2112,0,0,0,1.0,1,1.0,1,1.0,1,0.14030579648198005,35
1657,0,3381,1269,2112,0,0,0,1.0,1,1.0,1,1.0,1,0.1543011254471568,36
1658,2,3383,1271,2112,0,0,0,1.0,1,1.0,1,1.0,1,0.1622458010645609,36
1659,1,3384,1271,2113,0,0,0,1.0,1,1.0,1,1.0,1,0.1290985795906468,36
1660,5,3389,1275,2114,0,0,0,1.0,1,1.0,1,1.0,1,0.14609933676377726,38
1661,1,3390,1275,2115,0,0,0,1.0,1,1.0,1,1.0,1,0.13443427310641218,38
1662,4,3394,1277,2117,0,0,0,1.0,1,1.0,1,1.0,1,0.1291242711773664,39
1663,3,3397,1278,2119,0,0,0,1.0,1,1.0,1,1.0,1,0.13563699296057324,40
1664,2,3399,1279,2120,0,0,0,1.0,1,1.0,1,1.0,1,0.14600445060348713,39
1665,0,3399,1279,2120,0,0,0,1.0,1,1.0,1,1.0,1,0.15676610191748083,40
1666,2,3401,1279,2122,0,0,0,1.0,1,1.0,1,1.0,1,0.1571938519022493,40
1667,1,3402,1280,2122,0,0,0,1.0,1,1.0,1,1.0,1,0.18476095759288116,40
1668,6,3408,1283,2125,0,0,0,1.0,1,1.0,1,1.0,1,0.1525271645066992,41
1669,1,3409,1283,2126,0,0,0,1.0,1,1.0,1,1.0,1,0.11847063458381106,40
1670,1,3410,1284,2126,0,0,0,1.0,1,1.0,1,1.0,1,0.15248477502497332,40
1671,2,3412,1284,2128,0,0,0,1.0,1,1.0,1,1.0,1,0.10062954420653612,41
1672,2,3414,1285,2129,0,0,0,1.0,1,1.0,1,1.0,1,0.13002614927874737,40
1673,0,3414,1285,2129,0,0,0,1.0,1,1.0,1,1.0,1,0.11731882885747112,39
1674,1,3415,1286,2129,0,0,0,1.0,1,1.0,1,1.0,1,0.13342767790098364,40
1675,1,3416,1286,2130,0,0,0,1.0,1,1.0,1,1.0,1,0.11598758708524753,38
1676,1,3417,1287,2130,0,0,0,1.0,1,1.0,1,1.0,1,0.13010132048342465,39
1677,0,3417,1287,2130,0,0,0,1.0,1,1.0,1,1.0,1,0.13025449312907864,39
1678,0,3417,1287,2130,0,0,0,1.0,1,1.0,1,1.0,1,0.13025449312907864,39
1679,3,3420,1289,2131,0,0,0,1.0,1,1.0,1,1.0,1,0.12903461217976597,39
1680,5,3425,1291,2134,0,0,0,1.0,1,1.0,1,1.0,1,0.13215297985981544,41
1681,5,3430,1292,2138,0,0,0,1.0,1,1.0,1,1.0,1,0.08092695871379808,41
1682,0,3430,1292,2138,0,0,0,1.0,1,1.0,1,1.0,1,0.08442129994089165,43
1683,3,3433,1295,2138,0,0,0,1.0,1,1.0,1,1.0,1,0.11848375951337199,43
1684,3,3436,1296,2140,0,0,0,1.0,1,1.0,1,1.0,1,0.08546584335799737,42
1685,0,3436,1296,2140,0,0,0,1.0,1,1.0,1,1.0,1,0.08426493032419527,41
1686,2,3438,1298,2140,0,0,0,1.0,1,1.0,1,1.0,1,0.09710200003379017,41
1687,1,3439,1299,2140,0,0,0,1.0,1,1.0,1,1.0,1,0.11692160152531451,40
1688,2,3441,1301,2140,0,0,0,1.0,1,1.0,1,1.0,1,0.1828511802153092,39
1689,2,3443,1303,2140,0,0,0,1.0,1,1.0,1,1.0,1,0.2368191813661197,38
1690,5,3448,1303,2145,0,0,0,1.0,1,1.0,1,1.0,1,0.09200952426702641,38
1691,0,3448,1303,2145,0,0,0,1.0,1,1.0,1,1.0,1,0.09879720189761895,36
1692,1,3449,1304,2145,0,0,0,1.0,1,1.0,1,1.0,1,0.14474362151735765,36
1693,2,3451,1305,2146,0,0,0,1.0,1,1.0,1,1.0,1,0.11485341313464295,35
1694,1,3452,1306,2146,0,0,0,1.0,1,1.0,1,1.0,1,0.14308418896383096,33
1695,0,3452,1306,2146,0,0,0,1.0,1,1.0,1,1.0,1,0.13712080500819537,34
1696,1,3453,1307,2146,0,0,0,1.0,1,1.0,1,1.0,1,0.19581606129496776,35
1697,1,3454,1307,2147,0,0,0,1.0,1,1.0,1,1.0,1,0.2000113439687391,36
1698,4,3458,1309,2149,0,0,0,1.0,1,1.0,1,1.0,1,0.19215746832197927,38
1699,1,3459,1310,2149,0,0,0,1.0,1,1.0,1,1.0,1,0.20982425640188046,38
1700,1,3460,1310,2150,0,0,0,1.0,1,1.0,1,1.0,1,0.18396954879718583,39
1701,0,3460,1310,2150,0,0,0,1.0,1,1.0,1,1.0,1,0.19090382238046585,40
1702,3,3463,1312,2151,0,0,0,1.0,1,1.0,1,1.0,1,0.2322888949493594,41
1703,6,3469,1313,2156,0,0,0,1.0,1,1.0,1,1.0,1,0.15887289947994127,41
1704,2,3471,1315,2156,0,0,0,1.0,1,1.0,1,1.0,1,0.16092208408938752,41
1705,4,3475,1316,2159,0,0,0,1.0,1,1.0,1,1.0,1,0.09319634852301596,40
1706,2,3477,1317,2160,0,0,0,1.0,1,1.0,1,1.0,1,0.06630022944001618,40
1707,1,3478,1318,2160,0,0,0,1.0,1,1.0,1,1.0,1,0.1330439547558358,39
1708,2,3480,1319,2161,0,0,0,1.0,1,1.0,1,1.0,1,0.10559253922473023,39
1709,1,3481,1319,2162,0,0,0,1.0,1,1.0,1,1.0,1,0.09193369122702241,38
1710,5,3486,1322,2164,0,0,0,1.0,1,1.0,1,1.0,1,0.11334163334614562,39
1711,1,3487,1323,2164,0,0,0,1.0,1,1.0,1,1.0,1,0.1879007458614537,38
1712,2,3489,1325,2164,0,0,0,1.0,1,1.0,1,1.0,1,0.2194079000950328,38
1713,2,3491,1325,2166,0,0,0,1.0,1,1.0,1,1.0,1,0.20015773874431617,37
1714,2,3493,1326,2167,0,0,0,1.0,1,1.0,1,1.0,1,0.18224179387353664,38
1715,0,3493,1326,2167,0,0,0,1.0,1,1.0,1,1.0,1,0.1830925121994921,40
1716,0,3493,1326,2167,0,0,0,1.0,1,1.0,1,1.0,1,0.1938750763987646,39
1717,3,3496,1328,2168,0,0,0,1.0,1,1.0,1,1.0,1,0.15436806392285354,38
1718,0,3496,1328,2168,0,0,0,1.0,1,1.0,1,1.0,1,0.18531030077917607,38
1719,0,3496,1328,2168,0,0,0,1.0,1,1.0,1,1.0,1,0.18531030077917607,38
1720,1,3497,1328,2169,0,0,0,1.0,1,1.0,1,1.0,1,0.17522756472313444,41
1721,0,3497,1328,2169,0,0,0,1.0,1,1.0,1,1.0,1,0.14530533137555435,39
1722,3,3500,1330,2170,0,0,0,1.0,1,1.0,1,1.0,1,0.1540740358667292,40
1723,1,3501,1331,2170,0,0,0,1.0,1,1.0,1,1.0,1,0.14180526630689377,38
1724,0,3501,1331,2170,0,0,0,1.0,1,1.0,1,1.0,1,0.15384330905237578,37
1725,1,3502,1331,2171,0,0,0,1.0,1,1.0,1,1.0,1,0.16789453997494175,38
1726,2,3504,1332,2172,0,0,0,1.0,1,1.0,1,1.0,1,0.1572504077992891,37
1727,1,3505,1332,2173,0,0,0,1.0,1,1.0,1,1.0,1,0.13512092511603593,37
1728,0,3505,1332,2173,0,0,0,1.0,1,1.0,1,1.0,1,0.14143007701892354,35
1729,1,3506,1333,2173,0,0,0,1.0,1,1.0,1,1.0,1,0.14971680218504513,37
1730,1,3507,1334,2173,0,0,0,1.0,1,1.0,1,1.0,1,0.2172650285793506,37
1731,2,3509,1335,2174,0,0,0,1.0,1,1.0,1,1.0,1,0.2026853567442859,37
1732,6,3515,1335,2180,0,0,0,1.0,1,1.0,1,1.0,1,0.12168498804924231,37
1733,3,3518,1337,2181,0,0,0,1.0,1,1.0,1,1.0,1,0.13485685501527372,36
1734,2,3520,1338,2182,0,0,0,1.0,1,1.0,1,1.0,1,0.1431440728942829,35
1735,1,3521,1339,2182,0,0,0,1.0,1,1.0,1,1.0,1,0.1294000567241391,34
1736,1,3522,1339,2183,0,0,0,1.0,1,1.0,1,1.0,1,0.10319518370727936,35
1737,4,3526,1342,2184,0,0,0,1.0,1,1.0,1,1.0,1,0.11099710583187156,36
1738,4,3530,1343,2187,0,0,0,1.0,1,1.0,1,1.0,1,0.10768117946196144,37
1739,1,3531,1344,2187,0,0,0,1.0,1,1.0,1,1.0,1,0.10367593175756418,38
1740,0,3531,1344,2187,0,0,0,1.0,1,1.0,1,1.0,1,0.10214333205817798,37
1741,1,3532,1344,2188,0,0,0,1.0,1,1.0,1,1.0,1,0.10433489132855993,38
1742,2,3534,1346,2188,0,0,0,1.0,1,1.0,1,1.0,1,0.2027859865733656,39
1743,1,3535,1347,2188,0,0,0,1.0,1,1.0,1,1.0,1,0.18418644579125396,37
1744,5,3540,1349,2191,0,0,0,1.0,1,1.0,1,1.0,1,0.1774953772766171,38
1745,4,3544,1350,2194,0,0,0,1.0,1,1.0,1,1.0,1,0.22166237170768374,37
1746,2,3546,1351,2195,0,0,0,1.0,1,1.0,1,1.0,1,0.17656064640537691,38
1747,3,3549,1351,2198,0,0,0,1.0,1,1.0,1,1.0,1,0.11120426277988313,38
1748,1,3550,1351,2199,0,0,0,1.0,1,1.0,1,1.0,1,0.09473989305959665,38
1749,0,3550,1351,2199,0,0,0,1.0,1,1.0,1,1.0,1,0.11552775210958821,37
1750,0,3550,1351,2199,0,0,0,1.0,1,1.0,1,1.0,1,0.12302893912640475,39
1751,0,3550,1351,2199,0,0,0,1.0,1,1.0,1,1.0,1,0.12056225315404005,38
1752,0,3550,1351,2199,0,0,0,1.0,1,1.0,1,1.0,1,0.1332929778902119,39
1753,0,3550,1351,2199,0,0,0,1.0,1,1.0,1,1.0,1,0.12733024828333747,40
1754,1,3551,1352,2199,0,0,0,1.0,1,1.0,1,1.0,1,0.17667785245978865,41
1755,2,3553,1352,2201,0,0,0,1.0,1,1.0,1,1.0,1,0.18957334515634158,41
1756,4,3557,1353,2204,0,0,0,1.0,1,1.0,1,1.0,1,0.10896932571949146,42
1757,0,3557,1353,2204,0,0,0,1.0,1,1.0,1,1.0,1,0.1418158624611684,42
1758,1,3558,1354,2204,0,0,0,1.0,1,1.0,1,1.0,1,0.14518295784866855,42
1759,2,3560,1354,2206,0,0,0,1.0,1,1.0,1,1.0,1,0.11349865511012071,39
1760,2,3562,1356,2206,0,0,0,1.0,1,1.0,1,1.0,1,0.2174665752606818,39
1761,3,3565,1357,2208,0,0,0,1.0,1,1.0,1,1.0,1,0.14555753202599944,38
1762,3,3568,1358,2210,0,0,0,1.0,1,1.0,1,1.0,1,0.13279981779333233,37
1763,0,3568,1358,2210,0,0,0,1.0,1,1.0,1,1.0,1,0.13279981779333233,37
1764,3,3571,1360,2211,0,0,0,1.0,1,1.0,1,1.0,1,0.14330765076203178,36
1765,5,3576,1363,2213,0,0,0,1.0,1,1.0,1,1.0,1,0.11346273326082801,37
1766,0,3576,1363,2213,0,0,0,1.0,1,1.0,1,1.0,1,0.10655573863411961,36
1767,0,3576,1363,2213,0,0,0,1.0,1,1.0,1,1.0,1,0.10655573863411961,36
1768,1,3577,1363,2214,0,0,0,1.0,1,1.0,1,1.0,1,0.08134199986207588,36
1769,0,3577,1363,2214,0,0,0,1.0,1,1.0,1,1.0,1,0.07010682665852719,38
1770,0,3577,1363,2214,0,0,0,1.0,1,1.0,1,1.0,1,0.07010682665852719,38
1771,0,3577,1363,2214,0,0,0,1.0,1,1.0,1,1.0,1,0.07010682665852719,38
1772,0,3577,1363,2214,0,0,0,1.0,1,1.0,1,1.0,1,0.08301513427014102,40
1773,1,3578,1364,2214,0,0,0,1.0,1,1.0,1,1.0,1,0.11874245620325244,40
1774,0,3578,1364,2214,0,0,0,1.0,1,1.0,1,1.0,1,0.11874245620325244,40
1775,2,3580,1364,2216,0,0,0,1.0,1,1.0,1,1.0,1,0.10223496990559662,41
1776,0,3580,1364,2216,0,0,0,1.0,1,1.0,1,1.0,1,0.09521314030355262,43
1777,1,3581,1365,2216,0,0,0,1.0,1,1.0,1,1.0,1,0.08230686105160848,44
1778,2,3583,1367,2216,0,0,0,1.0,1,1.0,1,1.0,1,0.14232355832546656,44
1779,3,3586,1369,2217,0,0,0,1.0,1,1.0,1,1.0,1,0.13129022698430978,44
1780,6,3592,1369,2223,0,0,0,1.0,1,1.0,1,1.0,1,0.08659496715681586,46
1781,2,3594,1370,2224,0,0,0,1.0,1,1.0,1,1.0,1,0.08920146174154939,46
1782,4,3598,1371,2227,0,0,0,1.0,1,1.0,1,1.0,1,0.10907966241973084,45
1783,2,3600,1373,2227,0,0,0,1.0,1,1.0,1,1.0,1,0.14186266422928692,44
1784,3,3603,1375,2228,0,0,0,1.0,1,1.0,1,1.0,1,0.19480747078464428,44
1785,1,3604,1376,2228,0,0,0,1.0,1,1.0,1,1.0,1,0.2313233674954444,42
1786,7,3611,1378,2233,0,0,0,1.0,1,1.0,1,1.0,1,0.2017088440131684,42
1787,6,3617,1379,2238,0,0,0,1.0,1,1.0,1,1.0,1,0.1443784367479558,41
1788,8,3625,1380,2245,0,0,0,1.0,1,1.0,1,1.0,1,0.11845631405924274,41
1789,1,3626,1380,2246,0,0,0,1.0,1,1.0,1,1.0,1,0.11394937548343873,41
1790,3,3629,1382,2247,0,0,0,1.0,1,1.0,1,1.0,1,0.14509835721390424,41
1791,1,3630,1382,2248,0,0,0,1.0,1,1.0,1,1.0,1,0.11044214355567658,41
1792,1,3631,1382,2249,0,0,0,1.0,1,1.0,1,1.0,1,0.10437832376267302,43
1793,6,3637,1386,2251,0,0,0,1.0,1,1.0,1,1.0,1,0.056140082091939214,43
1794,2,3639,1388,2251,0,0,0,1.0,1,1.0,1,1.0,1,0.08420326786397811,41
1795,2,3641,1389,2252,0,0,0,1.0,1,1.0,1,1.0,1,0.03775895439392825,41
1796,1,3642,1390,2252,0,0,0,1.0,1,1.0,1,1.0,1,0.11442287742884272,40
1797,2,3644,1391,2253,0,0,0,1.0,1,1.0,1,1.0,1,0.184762854913622,38
1798,2,3646,1391,2255,0,0,0,1.0,1,1.0,1,1.0,1,0.13860080557385931,38
1799,2,3648,1393,2255,0,0,0,1.0,1,1.0,1,1.0,1,0.15307586430481168,37
1800,1,3649,1394,2255,0,0,0,1.0,1,1.0,1,1.0,1,0.16557774329099442,35
1801,3,3652,1395,2257,0,0,0,1.0,1,1.0,1,1.0,1,0.1414817318262616,34
1802,1,3653,1396,2257,0,0,0,1.0,1,1.0,1,1.0,1,0.12364279027766872,33
1803,0,3653,1396,2257,0,0,0,1.0,1,1.0,1,1.0,1,0.12364279027766872,33
1804,1,3654,1396,2258,0,0,0,1.0,1,1.0,1,1.0,1,0.10254331726016877,33
1805,0,3654,1396,2258,0,0,0,1.0,1,1.0,1,1.0,1,0.1027507855498375,35
1806,2,3656,1397,2259,0,0,0,1.0,1,1.0,1,1.0,1,0.12320567710211673,36
1807,2,3658,1397,2261,0,0,0,1.0,1,1.0,1,1.0,1,0.11431452973299415,35
1808,0,3658,1397,2261,0,0,0,1.0,1,1.0,1,1.0,1,0.10507942432582917,37
1809,0,3658,1397,2261,0,0,0,1.0,1,1.0,1,1.0,1,0.15255930964063721,35
1810,0,3658,1397,2261,0,0,0,1.0,1,1.0,1,1.0,1,0.16284691233233273,36
1811,2,3660,1399,2261,0,0,0,1.0,1,1.0,1,1.0,1,0.26970749413158057,34
1812,2,3662,1399,2263,0,0,0,1.0,1,1.0,1,1.0,1,0.23646576139698083,36
1813,3,3665,1399,2266,0,0,0,1.0,1,1.0,1,1.0,1,0.19148845197216965,35
1814,1,3666,1399,2267,0,0,0,1.0,1,1.0,1,1.0,1,0.20063174395050126,36
1815,1,3667,1400,2267,0,0,0,1.0,1,1.0,1,1.0,1,0.22099730177233085,35
1816,2,3669,1401,2268,0,0,0,1.0,1,1.0,1,1.0,1,0.188267636722705,35
1817,0,3669,1401,2268,0,0,0,1.0,1,1.0,1,1.0,1,0.188267636722705,35
1818,3,3672,1403,2269,0,0,0,1.0,1,1.0,1,1.0,1,0.17689931976826764,36
1819,6,3678,1404,2274,0,0,0,1.0,1,1.0,1,1.0,1,0.09992289184993546,37
1820,1,3679,1404,2275,0,0,0,1.0,1,1.0,1,1.0,1,0.08313148686181793,37
1821,1,3680,1404,2276,0,0,0,1.0,1,1.0,1,1.0,1,0.0959504801704147,38
1822,5,3685,1406,2279,0,0,0,1.0,1,1.0,1,1.0,1,0.11293256697528664,37
1823,2,3687,1407,2280,0,0,0,1.0,1,1.0,1,1.0,1,0.1280887342098795,36
1824,3,3690,1410,2280,0,0,0,1.0,1,1.0,1,1.0,1,0.163651684798543,36
1825,5,3695,1412,2283,0,0,0,1.0,1,1.0,1,1.0,1,0.1260265778323839,34
1826,3,3698,1413,2285,0,0,0,1.0,1,1.0,1,1.0,1,0.11106573045521251,35
1827,2,3700,1415,2285,0,0,0,1.0,1,1.0,1,1.0,1,0.11074027409404398,34
1828,2,3702,1417,2285,0,0,0,1.0,1,1.0,1,1.0,1,0.13789956950084958,33
1829,0,3702,1417,2285,0,0,0,1.0,1,1.0,1,1.0,1,0.10577794234806563,31
1830,0,3702,1417,2285,0,0,0,1.0,1,1.0,1,1.0,1,0.11932779148792037,31
1831,1,3703,1417,2286,0,0,0,1.0,1,1.0,1,1.0,1,0.12118205804331296,30
1832,1,3704,1418,2286,0,0,0,1.0,1,1.0,1,1.0,1,0.1370511901604562,29
1833,5,3709,1421,2288,0,0,0,1.0,1,1.0,1,1.0,1,0.18562461461771246,28
1834,3,3712,1422,2290,0,0,0,1.0,1,1.0,1,1.0,1,0.12407223440267177,27
1835,3,3715,1425,2290,0,0,0,1.0,1,1.0,1,1.0,1,0.15282871835599965,26
1836,1,3716,1425,2291,0,0,0,1.0,1,1.0,1,1.0,1,0.17557299632927895,26
1837,2,3718,1425,2293,0,0,0,1.0,1,1.0,1,1.0,1,0.15553711068528206,25
1838,1,3719,1426,2293,0,0,0,1.0,1,1.0,1,1.0,1,0.19867461039381407,25
1839,0,3719,1426,2293,0,0,0,1.0,1,1.0,1,1.0,1,0.2501581317568124,24
1840,2,3721,1426,2295,0,0,0,1.0,1,1.0,1,1.0,1,0.23195619877053797,23
1841,2,3723,1426,2297,0,0,0,1.0,1,1.0,1,1.0,1,0.16466929945735634,22
1842,3,3726,1427,2299,0,0,0,1.0,1,1.0,1,1.0,1,0.20680399569434632,23
1843,2,3728,1427,2301,0,0,0,1.0,1,1.0,1,1.0,1,0.1463175497325493,23
1844,1,3729,1428,2301,0,0,0,1.0,1,1.0,1,1.0,1,0.20034274131211105,23
1845,1,3730,1429,2301,0,0,0,1.0,1,1.0,1,1.0,1,0.18817191099119324,23
1846,0,3730,1429,2301,0,0,0,1.0,1,1.0,1,1.0,1,0.18817191099119324,23
1847,0,3730,1429,2301,0,0,0,1.0,1,1.0,1,1.0,1,0.17632242096760906,24
1848,0,3730,1429,2301,0,0,0,1.0,1,1.0,1,1.0,1,0.17632242096760906,24
1849,1,3731,1429,2302,0,0,0,1.0,1,1.0,1,1.0,1,0.14108800104199007,25
1850,0,3731,1429,2302,0,0,0,1.0,1,1.0,1,1.0,1,0.14108800104199007,25
1851,0,3731,1429,2302,0,0,0,1.0,1,1.0,1,1.0,1,0.14108800104199007,25
1852,0,3731,1429,2302,0,0,0,1.0,1,1.0,1,1.0,1,0.14108800104199007,25
1853,0,3731,1429,2302,0,0,0,1.0,1,1.0,1,1.0,1,0.1609350905282443,25
1854,0,3731,1429,2302,0,0,0,1.0,1,1.0,1,1.0,1,0.1609350905282443,25
1855,1,3732,1430,2302,0,0,0,1.0,1,1.0,1,1.0,1,0.22864125415207698,26
1856,0,3732,1430,2302,0,0,0,1.0,1,1.0,1,1.0,1,0.23567824444705748,27
1857,3,3735,1430,2305,0,0,0,1.0,1,1.0,1,1.0,1,0.21786254792500412,28
1858,1,3736,1431,2305,0,0,0,1.0,1,1.0,1,1.0,1,0.24793555200364878,28
1859,2,3738,1432,2306,0,0,0,1.0,1,1.0,1,1.0,1,0.24889015235185763,28
1860,0,3738,1432,2306,0,0,0,1.0,1,1.0,1,1.0,1,0.24889015235185763,28
1861,0,3738,1432,2306,0,0,0,1.0,1,1.0,1,1.0,1,0.24889015235185763,28
1862,0,3738,1432,2306,0,0,0,1.0,1,1.0,1,1.0,1,0.24889015235185763,28
1863,1,3739,1432,2307,0,0,0,1.0,1,1.0,1,1.0,1,0.2498446052875452,29
1864,3,3742,1434,2308,0,0,0,1.0,1,1.0,1,1.0,1,0.2415087399253384,27
1865,1,3743,1434,2309,0,0,0,1.0,1,1.0,1,1.0,1,0.20371337096165165,26
1866,1,3744,1435,2309,0,0,0,1.0,1,1.0,1,1.0,1,0.23578596450024242,26
1867,2,3746,1436,2310,0,0,0,1.0,1,1.0,1,1.0,1,0.25862363763460205,26
1868,0,3746,1436,2310,0,0,0,1.0,1,1.0,1,1.0,1,0.25862363763460205,26
1869,0,3746,1436,2310,0,0,0,1.0,1,1.0,1,1.0,1,0.25862363763460205,26
1870,2,3748,1436,2312,0,0,0,1.0,1,1.0,1,1.0,1,0.23957616630399126,27
1871,1,3749,1437,2312,0,0,0,1.0,1,1.0,1,1.0,1,0.2228096848702137,27
1872,0,3749,1437,2312,0,0,0,1.0,1,1.0,1,1.0,1,0.2628628733063122,25
1873,0,3749,1437,2312,0,0,0,1.0,1,1.0,1,1.0,1,0.2628628733063122,25
1874,2,3751,1437,2314,0,0,0,1.0,1,1.0,1,1.0,1,0.23006268521894704,25
1875,0,3751,1437,2314,0,0,0,1.0,1,1.0,1,1.0,1,0.23006268521894704,25
1876,0,3751,1437,2314,0,0,0,1.0,1,1.0,1,1.0,1,0.20065132903692257,26
1877,0,3751,1437,2314,0,0,0,1.0,1,1.0,1,1.0,1,0.19909275157509024,27
1878,2,3753,1439,2314,0,0,0,1.0,1,1.0,1,1.0,1,0.22674295271141207,28
1879,1,3754,1439,2315,0,0,0,1.0,1,1.0,1,1.0,1,0.19237937370423416,29
1880,1,3755,1439,2316,0,0,0,1.0,1,1.0,1,1.0,1,0.1790996306579509,29
1881,0,3755,1439,2316,0,0,0,1.0,1,1.0,1,1.0,1,0.1790996306579509,29
1882,0,3755,1439,2316,0,0,0,1.0,1,1.0,1,1.0,1,0.18957523264861506,28
1883,0,3755,1439,2316,0,0,0,1.0,1,1.0,1,1.0,1,0.18957523264861506,28
1884,1,3756,1440,2316,0,0,0,1.0,1,1.0,1,1.0,1,0.2168454617354118,28
1885,0,3756,1440,2316,0,0,0,1.0,1,1.0,1,1.0,1,0.2168454617354118,28
1886,0,3756,1440,2316,0,0,0,1.0,1,1.0,1,1.0,1,0.19294740049844902,29
1887,0,3756,1440,2316,0,0,0,1.0,1,1.0,1,1.0,1,0.19294740049844902,29
1888,2,3758,1440,2318,0,0,0,1.0,1,1.0,1,1.0,1,0.16444578877674434,31
1889,0,3758,1440,2318,0,0,0,1.0,1,1.0,1,1.0,1,0.16444578877674434,31
1890,0,3758,1440,2318,0,0,0,1.0,1,1.0,1,1.0,1,0.16444578877674434,31
1891,0,3758,1440,2318,0,0,0,1.0,1,1.0,1,1.0,1,0.18584538272609732,32
1892,0,3758,1440,2318,0,0,0,1.0,1,1.0,1,1.0,1,0.18584538272609732,32
1893,0,3758,1440,2318,0,0,0,1.0,1,1.0,1,1.0,1,0.18584538272609732,32
1894,0,3758,1440,2318,0,0,0,1.0,1,1.0,1,1.0,1,0.17053635045310644,33
1895,4,3762,1441,2321,0,0,0,1.0,1,1.0,1,1.0,1,0.12733115926052205,35
1896,1,3763,1441,2322,0,0,0,1.0,1,1.0,1,1.0,1,0.14044115495451334,34
1897,0,3763,1441,2322,0,0,0,1.0,1,1.0,1,1.0,1,0.14044115495451334,34
1898,0,3763,1441,2322,0,0,0,1.0,1,1.0,1,1.0,1,0.14044115495451334,34
1899,0,3763,1441,2322,0,0,0,1.0,1,1.0,1,1.0,1,0.14044115495451334,34
1900,1,3764,1441,2323,0,0,0,1.0,1,1.0,1,1.0,1,0.10879804568184191,35
1901,0,3764,1441,2323,0,0,0,1.0,1,1.0,1,1.0,1,0.10879804568184191,35
1902,1,3765,1442,2323,0,0,0,1.0,1,1.0,1,1.0,1,0.14694366151917868,35
1903,0,3765,1442,2323,0,0,0,1.0,1,1.0,1,1.0,1,0.14694366151917868,35
1904,0,3765,1442,2323,0,0,0,1.0,1,1.0,1,1.0,1,0.14694366151917868,35
1905,0,3765,1442,2323,0,0,0,1.0,1,1.0,1,1.0,1,0.13339120785819777,37
1906,0,3765,1442,2323,0,0,0,1.0,1,1.0,1,1.0,1,0.13339120785819777,37
1907,1,3766,1442,2324,0,0,0,1.0,1,1.0,1,1.0,1,0.13129171610291246,39
1908,0,3766,1442,2324,0,0,0,1.0,1,1.0,1,1.0,1,0.13129171610291246,39
1909,1,3767,1442,2325,0,0,0,1.0,1,1.0,1,1.0,1,0.1500160270642503,41
1910,1,3768,1443,2325,0,0,0,1.0,1,1.0,1,1.0,1,0.14624702929462763,41
1911,3,3771,1444,2327,0,0,0,1.0,1,1.0,1,1.0,1,0.23691673754415574,40
1912,5,3776,1445,2331,0,0,0,1.0,1,1.0,1,1.0,1,0.18188819080902643,39
1913,2,3778,1446,2332,0,0,0,1.0,1,1.0,1,1.0,1,0.180095912300164,40
1914,4,3782,1448,2334,0,0,0,1.0,1,1.0,1,1.0,1,0.17084401575954636,41
1915,2,3784,1448,2336,0,0,0,1.0,1,1.0,1,1.0,1,0.1577557004113599,42
1916,2,3786,1449,2337,0,0,0,1.0,1,1.0,1,1.0,1,0.15416779628053395,42
1917,1,3787,1450,2337,0,0,0,1.0,1,1.0,1,1.0,1,0.17596808756854104,41
1918,3,3790,1452,2338,0,0,0,1.0,1,1.0,1,1.0,1,0.1843983019423752,38
1919,6,3796,1454,2342,0,0,0,1.0,1,1.0,1,1.0,1,0.22734884174516792,38
1920,0,3796,1454,2342,0,0,0,1.0,1,1.0,1,1.0,1,0.244902525449031,38
1921,1,3797,1454,2343,0,0,0,1.0,1,1.0,1,1.0,1,0.20974809682438664,39
1922,0,3797,1454,2343,0,0,0,1.0,1,1.0,1,1.0,1,0.19107095609386876,40
1923,1,3798,1454,2344,0,0,0,1.0,1,1.0,1,1.0,1,0.15878568370362664,41
1924,2,3800,1456,2344,0,0,0,1.0,1,1.0,1,1.0,1,0.197194015390606,41
1925,2,3802,1456,2346,0,0,0,1.0,1,1.0,1,1.0,1,0.15836293755888736,41
1926,0,3802,1456,2346,0,0,0,1.0,1,1.0,1,1.0,1,0.15836293755888736,41
1927,1,3803,1456,2347,0,0,0,1.0,1,1.0,1,1.0,1,0.1526735935549236,41
1928,1,3804,1457,2347,0,0,0,1.0,1,1.0,1,1.0,1,0.1537494034802466,42
1929,0,3804,1457,2347,0,0,0,1.0,1,1.0,1,1.0,1,0.15322713855499562,41
1930,0,3804,1457,2347,0,0,0,1.0,1,1.0,1,1.0,1,0.15322713855499562,41
1931,0,3804,1457,2347,0,0,0,1.0,1,1.0,1,1.0,1,0.15322713855499562,41
1932,0,3804,1457,2347,0,0,0,1.0,1,1.0,1,1.0,1,0.15322713855499562,41
1933,2,3806,1458,2348,0,0,0,1.0,1,1.0,1,1.0,1,0.17176615935521194,43
1934,2,3808,1459,2349,0,0,0,1.0,1,1.0,1,1.0,1,0.161078506722757,44
1935,0,3808,1459,2349,0,0,0,1.0,1,1.0,1,1.0,1,0.1370487158792744,45
1936,2,3810,1459,2351,0,0,0,1.0,1,1.0,1,1.0,1,0.11363522524321815,48
1937,1,3811,1460,2351,0,0,0,1.0,1,1.0,1,1.0,1,0.1489361553548538,48
1938,0,3811,1460,2351,0,0,0,1.0,1,1.0,1,1.0,1,0.1489361553548538,48
1939,2,3813,1460,2353,0,0,0,1.0,1,1.0,1,1.0,1,0.1264534031468743,48
1940,0,3813,1460,2353,0,0,0,1.0,1,1.0,1,1.0,1,0.1264534031468743,48
1941,1,3814,1461,2353,0,0,0,1.0,1,1.0,1,1.0,1,0.15999176234103585,48
1942,5,3819,1462,2357,0,0,0,1.0,1,1.0,1,1.0,1,0.13569965602835674,49
1943,2,3821,1462,2359,0,0,0,1.0,1,1.0,1,1.0,1,0.12159925024329543,48
1944,2,3823,1464,2359,0,0,0,1.0,1,1.0,1,1.0,1,0.14959113186699882,47
1945,5,3828,1466,2362,0,0,0,1.0,1,1.0,1,1.0,1,0.11000357232245313,46
1946,1,3829,1467,2362,0,0,0,1.0,1,1.0,1,1.0,1,0.14709632104590972,46
1947,3,3832,1469,2363,0,0,0,1.0,1,1.0,1,1.0,1,0.21475067792587674,45
1948,4,3836,1471,2365,0,0,0,1.0,1,1.0,1,1.0,1,0.1573178914603732,46
1949,4,3840,1473,2367,0,0,0,1.0,1,1.0,1,1.0,1,0.22065807811274776,42
1950,0,3840,1473,2367,0,0,0,1.0,1,1.0,1,1.0,1,0.2270069959114009,40
1951,5,3845,1475,2370,0,0,0,1.0,1,1.0,1,1.0,1,0.2191271949322046,39
1952,1,3846,1476,2370,0,0,0,1.0,1,1.0,1,1.0,1,0.2374979540420549,35
1953,5,3851,1478,2373,0,0,0,1.0,1,1.0,1,1.0,1,0.1810123112030741,36
1954,3,3854,1478,2376,0,0,0,1.0,1,1.0,1,1.0,1,0.13633748233787202,34
1955,2,3856,1478,2378,0,0,0,1.0,1,1.0,1,1.0,1,0.14663552722924758,35
1956,2,3858,1479,2379,0,0,0,1.0,1,1.0,1,1.0,1,0.15451433843700976,37
1957,1,3859,1479,2380,0,0,0,1.0,1,1.0,1,1.0,1,0.13886245942098333,37
1958,1,3860,1479,2381,0,0,0,1.0,1,1.0,1,1.0,1,0.13080731162857745,39
1959,0,3860,1479,2381,0,0,0,1.0,1,1.0,1,1.0,1,0.15136553017440116,41
1960,4,3864,1481,2383,0,0,0,1.0,1,1.0,1,1.0,1,0.20276795353254853,40
1961,4,3868,1482,2386,0,0,0,1.0,1,1.0,1,1.0,1,0.1424883004357141,41
1962,0,3868,1482,2386,0,0,0,1.0,1,1.0,1,1.0,1,0.1653290309405858,40
1963,2,3870,1482,2388,0,0,0,1.0,1,1.0,1,1.0,1,0.13161719702667699,41
1964,0,3870,1482,2388,0,0,0,1.0,1,1.0,1,1.0,1,0.15757781989851283,40
1965,1,3871,1482,2389,0,0,0,1.0,1,1.0,1,1.0,1,0.1131602808711183,41
1966,0,3871,1482,2389,0,0,0,1.0,1,1.0,1,1.0,1,0.1131602808711183,41
1967,2,3873,1483,2390,0,0,0,1.0,1,1.0,1,1.0,1,0.11493221636022627,42
1968,0,3873,1483,2390,0,0,0,1.0,1,1.0,1,1.0,1,0.152058237942849,42
1969,3,3876,1485,2391,0,0,0,1.0,1,1.0,1,1.0,1,0.18690878986164128,43
1970,1,3877,1485,2392,0,0,0,1.0,1,1.0,1,1.0,1,0.19726947250205296,42
1971,2,3879,1486,2393,0,0,0,1.0,1,1.0,1,1.0,1,0.21443797863398292,42
1972,2,3881,1486,2395,0,0,0,1.0,1,1.0,1,1.0,1,0.1563911837284456,42
1973,0,3881,1486,2395,0,0,0,1.0,1,1.0,1,1.0,1,0.16144186541444794,43
1974,3,3884,1486,2398,0,0,0,1.0,1,1.0,1,1.0,1,0.16154178055511545,43
1975,2,3886,1486,2400,0,0,0,1.0,1,1.0,1,1.0,1,0.14234972057069278,43
1976,0,3886,1486,2400,0,0,0,1.0,1,1.0,1,1.0,1,0.14234972057069278,43
1977,2,3888,1486,2402,0,0,0,1.0,1,1.0,1,1.0,1,0.15714324028269852,48
1978,3,3891,1488,2403,0,0,0,1.0,1,1.0,1,1.0,1,0.1403878071811682,48
1979,1,3892,1489,2403,0,0,0,1.0,1,1.0,1,1.0,1,0.17304100173912307,49
1980,0,3892,1489,2403,0,0,0,1.0,1,1.0,1,1.0,1,0.1770647087317547,50
1981,7,3899,1491,2408,0,0,0,1.0,1,1.0,1,1.0,1,0.12030490214232262,50
1982,1,3900,1492,2408,0,0,0,1.0,1,1.0,1,1.0,1,0.12761847347976626,50
1983,1,3901,1493,2408,0,0,0,1.0,1,1.0,1,1.0,1,0.11979464419496082,49
1984,3,3904,1495,2409,0,0,0,1.0,1,1.0,1,1.0,1,0.18376270177624834,48
1985,2,3906,1497,2409,0,0,0,1.0,1,1.0,1,1.0,1,0.15362349812599668,46
1986,1,3907,1498,2409,0,0,0,1.0,1,1.0,1,1.0,1,0.14567834870484514,46
1987,1,3908,1499,2409,0,0,0,1.0,1,1.0,1,1.0,1,0.12429909779565466,42
1988,0,3908,1499,2409,0,0,0,1.0,1,1.0,1,1.0,1,0.14913064220520608,40
1989,2,3910,1501,2409,0,0,0,1.0,1,1.0,1,1.0,1,0.1621436513403731,38
1990,2,3912,1501,2411,0,0,0,1.0,1,1.0,1,1.0,1,0.1358432764263974,38
1991,2,3914,1503,2411,0,0,0,1.0,1,1.0,1,1.0,1,0.17666877680094112,38
1992,3,3917,1504,2413,0,0,0,1.0,1,1.0,1,1.0,1,0.16134949006972973,39
1993,5,3922,1507,2415,0,0,0,1.0,1,1.0,1,1.0,1,0.26094582618722617,38
1994,5,3927,1509,2418,0,0,0,1.0,1,1.0,1,1.0,1,0.16129139151021563,37
1995,1,3928,1509,2419,0,0,0,1.0,1,1.0,1,1.0,1,0.1820805938610129,37
1996,2,3930,1509,2421,0,0,0,1.0,1,1.0,1,1.0,1,0.15949992273860947,37
1997,3,3933,1510,2423,0,0,0,1.0,1,1.0,1,1.0,1,0.2329301580157269,35
1998,3,3936,1511,2425,0,0,0,1.0,1,1.0,1,1.0,1,0.2536782158676337,34
1999,3,3939,1512,2427,0,0,0,1.0,1,1.0,1,1.0,1,0.20546174036116788,35
2000,0,3939,1512,2427,0,0,0,1.0,1,1.0,1,1.0,1,0.23470269257710094,34
2001,2,3941,1512,2429,0,0,0,1.0,1,1.0,1,1.0,1,0.21021939646315313,35
2002,2,3943,1513,2430,0,0,0,1.0,1,1.0,1,1.0,1,0.2466258742401928,36
2003,0,3943,1513,2430,0,0,0,1.0,1,1.0,1,1.0,1,0.2563464716050583,37
2004,2,3945,1513,2432,0,0,0,1.0,1,1.0,1,1.0,1,0.2034101469472761,38
2005,2,3947,1513,2434,0,0,0,1.0,1,1.0,1,1.0,1,0.18802494372081352,38
2006,1,3948,1513,2435,0,0,0,1.0,1,1.0,1,1.0,1,0.1568195770008046,38
2007,0,3948,1513,2435,0,0,0,1.0,1,1.0,1,1.0,1,0.14952753122394621,40
2008,1,3949,1513,2436,0,0,0,1.0,1,1.0,1,1.0,1,0.12737783610331985,40
2009,0,3949,1513,2436,0,0,0,1.0,1,1.0,1,1.0,1,0.1427079929249237,41
2010,0,3949,1513,2436,0,0,0,1.0,1,1.0,1,1.0,1,0.1427079929249237,41
2011,0,3949,1513,2436,0,0,0,1.0,1,1.0,1,1.0,1,0.1427079929249237,41
2012,0,3949,1513,2436,0,0,0,1.0,1,1.0,1,1.0,1,0.1427079929249237,41
2013,2,3951,1513,2438,0,0,0,1.0,1,1.0,1,1.0,1,0.11645253102879977,43
2014,2,3953,1514,2439,0,0,0,1.0,1,1.0,1,1.0,1,0.14095692548291586,43
2015,1,3954,1515,2439,0,0,0,1.0,1,1.0,1,1.0,1,0.15497228381673786,43
2016,2,3956,1515,2441,0,0,0,1.0,1,1.0,1,1.0,1,0.13858047758414088,44
2017,1,3957,1515,2442,0,0,0,1.0,1,1.0,1,1.0,1,0.1330303700551425,45
2018,2,3959,1517,2442,0,0,0,1.0,1,1.0,1,1.0,1,0.1405929252276229,46
2019,2,3961,1517,2444,0,0,0,1.0,1,1.0,1,1.0,1,0.08898253718969414,47
2020,1,3962,1518,2444,0,0,0,1.0,1,1.0,1,1.0,1,0.10157475503998109,47
2021,0,3962,1518,2444,0,0,0,1.0,1,1.0,1,1.0,1,0.10157475503998109,47
2022,0,3962,1518,2444,0,0,0,1.0,1,1.0,1,1.0,1,0.1075427720650526,48
2023,3,3965,1521,2444,0,0,0,1.0,1,1.0,1,1.0,1,0.1442900336758937,48
2024,4,3969,1525,2444,0,0,0,1.0,1,1.0,1,1.0,1,0.16157455586014077,45
2025,1,3970,1526,2444,0,0,0,1.0,1,1.0,1,1.0,1,0.1985206087721756,42
2026,7,3977,1530,2447,0,0,0,1.0,1,1.0,1,1.0,1,0.22769242455640676,44
2027,3,3980,1531,2449,0,0,0,1.0,1,1.0,1,1.0,1,0.19434431404659333,40
2028,2,3982,1533,2449,0,0,0,1.0,1,1.0,1,1.0,1,0.1888482412579986,39
2029,3,3985,1534,2451,0,0,0,1.0,1,1.0,1,1.0,1,0.17894678854661183,37
2030,2,3987,1535,2452,0,0,0,1.0,1,1.0,1,1.0,1,0.20866759509886362,34
2031,3,3990,1537,2453,0,0,0,1.0,1,1.0,1,1.0,1,0.22003453191961514,35
2032,2,3992,1538,2454,0,0,0,1.0,1,1.0,1,1.0,1,0.2522211028005758,34
2033,3,3995,1541,2454,0,0,0,1.0,1,1.0,1,1.0,1,0.27449196089079014,36
2034,1,3996,1541,2455,0,0,0,1.0,1,1.0,1,1.0,1,0.2696590009426125,34
2035,3,3999,1542,2457,0,0,0,1.0,1,1.0,1,1.0,1,0.24872545966722123,35
2036,2,4001,1543,2458,0,0,0,1.0,1,1.0,1,1.0,1,0.21300377305343263,34
2037,0,4001,1543,2458,0,0,0,1.0,1,1.0,1,1.0,1,0.1968661818547727,35
2038,3,4004,1543,2461,0,0,0,1.0,1,1.0,1,1.0,1,0.17827099071859254,36
2039,0,4004,1543,2461,0,0,0,1.0,1,1.0,1,1.0,1,0.16402976529404406,38
2040,0,4004,1543,2461,0,0,0,1.0,1,1.0,1,1.0,1,0.16402976529404406,38
2041,0,4004,1543,2461,0,0,0,1.0,1,1.0,1,1.0,1,0.17082654026187113,39
2042,1,4005,1543,2462,0,0,0,1.0,1,1.0,1,1.0,1,0.14075698794596975,39
2043,0,4005,1543,2462,0,0,0,1.0,1,1.0,1,1.0,1,0.14075698794596975,39
2044,1,4006,1543,2463,0,0,0,1.0,1,1.0,1,1.0,1,0.11961165384974713,39
2045,4,4010,1544,2466,0,0,0,1.0,1,1.0,1,1.0,1,0.10174132532066611,41
2046,0,4010,1544,2466,0,0,0,1.0,1,1.0,1,1.0,1,0.12500645649784703,42
2047,0,4010,1544,2466,0,0,0,1.0,1,1.0,1,1.0,1,0.12500645649784703,42
2048,1,4011,1545,2466,0,0,0,1.0,1,1.0,1,1.0,1,0.15503940970693175,43
2049,3,4014,1546,2468,0,0,0,1.0,1,1.0,1,1.0,1,0.15881770725426544,44
2050,3,4017,1546,2471,0,0,0,1.0,1,1.0,1,1.0,1,0.09450427443810018,44
2051,5,4022,1548,2474,0,0,0,1.0,1,1.0,1,1.0,1,0.18782868670069797,45
2052,2,4024,1548,2476,0,0,0,1.0,1,1.0,1,1.0,1,0.17609958268018444,45
2053,2,4026,1548,2478,0,0,0,1.0,1,1.0,1,1.0,1,0.1252809163108981,45
2054,1,4027,1548,2479,0,0,0,1.0,1,1.0,1,1.0,1,0.10493633269591764,46
2055,0,4027,1548,2479,0,0,0,1.0,1,1.0,1,1.0,1,0.10493633269591764,46
2056,2,4029,1549,2480,0,0,0,1.0,1,1.0,1,1.0,1,0.08915506324538076,46
2057,3,4032,1552,2480,0,0,0,1.0,1,1.0,1,1.0,1,0.09772186590383691,47
2058,2,4034,1554,2480,0,0,0,1.0,1,1.0,1,1.0,1,0.16934053920666697,47
2059,6,4040,1555,2485,0,0,0,1.0,1,1.0,1,1.0,1,0.09513288103919977,48
2060,2,4042,1556,2486,0,0,0,1.0,1,1.0,1,1.0,1,0.10017200815901586,50
2061,1,4043,1556,2487,0,0,0,1.0,1,1.0,1,1.0,1,0.10287332606249008,51
2062,3,4046,1558,2488,0,0,0,1.0,1,1.0,1,1.0,1,0.1150544719378955,49
2063,1,4047,1559,2488,0,0,0,1.0,1,1.0,1,1.0,1,0.12152511861496755,48
2064,3,4050,1560,2490,0,0,0,1.0,1,1.0,1,1.0,1,0.1348014011699176,45
2065,5,4055,1561,2494,0,0,0,1.0,1,1.0,1,1.0,1,0.10762204999877384,44
2066,1,4056,1561,2495,0,0,0,1.0,1,1.0,1,1.0,1,0.1311275554796514,42
2067,2,4058,1562,2496,0,0,0,1.0,1,1.0,1,1.0,1,0.10685632074392355,41
2068,1,4059,1562,2497,0,0,0,1.0,1,1.0,1,1.0,1,0.11580165176028809,40
2069,2,4061,1563,2498,0,0,0,1.0,1,1.0,1,1.0,1,0.1253352028143238,40
2070,1,4062,1563,2499,0,0,0,1.0,1,1.0,1,1.0,1,0.1114053213015089,40
2071,2,4064,1564,2500,0,0,0,1.0,1,1.0,1,1.0,1,0.1101730784550941,40
2072,0,4064,1564,2500,0,0,0,1.0,1,1.0,1,1.0,1,0.13205810540903723,41
2073,1,4065,1565,2500,0,0,0,1.0,1,1.0,1,1.0,1,0.15908141556962752,41
2074,5,4070,1565,2505,0,0,0,1.0,1,1.0,1,1.0,1,0.08152563234626713,41
2075,0,4070,1565,2505,0,0,0,1.0,1,1.0,1,1.0,1,0.08152563234626713,41
2076,2,4072,1567,2505,0,0,0,1.0,1,1.0,1,1.0,1,0.1388267511534888,41
2077,0,4072,1567,2505,0,0,0,1.0,1,1.0,1,1.0,1,0.13058431076291516,40
2078,1,4073,1568,2505,0,0,0,1.0,1,1.0,1,1.0,1,0.15429498954547177,40
2079,1,4074,1568,2506,0,0,0,1.0,1,1.0,1,1.0,1,0.12996248723902368,39
2080,1,4075,1568,2507,0,0,0,1.0,1,1.0,1,1.0,1,0.09634446862567438,38
2081,2,4077,1568,2509,0,0,0,1.0,1,1.0,1,1.0,1,0.08564642565345218,40
2082,3,4080,1569,2511,0,0,0,1.0,1,1.0,1,1.0,1,0.059201501627946414,41
2083,1,4081,1570,2511,0,0,0,1.0,1,1.0,1,1.0,1,0.07148463152562887,40
2084,6,4087,1574,2513,0,0,0,1.0,1,1.0,1,1.0,1,0.16578600058918266,42
2085,6,4093,1576,2517,0,0,0,1.0,1,1.0,1,1.0,1,0.17563970671809692,42
2086,3,4096,1576,2520,0,0,0,1.0,1,1.0,1,1.0,1,0.1253934736537367,43
2087,2,4098,1577,2521,0,0,0,1.0,1,1.0,1,1.0,1,0.11980389362063722,45
2088,4,4102,1578,2524,0,0,0,1.0,1,1.0,1,1.0,1,0.12444678472371308,46
2089,0,4102,1578,2524,0,0,0,1.0,1,1.0,1,1.0,1,0.12164179401306163,47
2090,1,4103,1578,2525,0,0,0,1.0,1,1.0,1,1.0,1,0.13124094639368647,49
2091,0,4103,1578,2525,0,0,0,1.0,1,1.0,1,1.0,1,0.13124094639368647,49
2092,0,4103,1578,2525,0,0,0,1.0,1,1.0,1,1.0,1,0.13124094639368647,49
2093,2,4105,1579,2526,0,0,0,1.0,1,1.0,1,1.0,1,0.11311881070445882,49
2094,0,4105,1579,2526,0,0,0,1.0,1,1.0,1,1.0,1,0.11311881070445882,49
2095,1,4106,1579,2527,0,0,0,1.0,1,1.0,1,1.0,1,0.08665992647980572,49
2096,1,4107,1579,2528,0,0,0,1.0,1,1.0,1,1.0,1,0.0845432112129499,51
2097,0,4107,1579,2528,0,0,0,1.0,1,1.0,1,1.0,1,0.0845432112129499,51
2098,2,4109,1580,2529,0,0,0,1.0,1,1.0,1,1.0,1,0.1002721695766924,52
2099,0,4109,1580,2529,0,0,0,1.0,1,1.0,1,1.0,1,0.12597627676542372,51
2100,2,4111,1580,2531,0,0,0,1.0,1,1.0,1,1.0,1,0.10904606161454106,51
2101,3,4114,1580,2534,0,0,0,1.0,1,1.0,1,1.0,1,0.11772753352712723,48
2102,5,4119,1583,2536,0,0,0,1.0,1,1.0,1,1.0,1,0.14643072245596125,49
2103,7,4126,1586,2540,0,0,0,1.0,1,1.0,1,1.0,1,0.1492096753035133,48
2104,1,4127,1586,2541,0,0,0,1.0,1,1.0,1,1.0,1,0.16708542478680424,43
2105,2,4129,1587,2542,0,0,0,1.0,1,1.0,1,1.0,1,0.18088729062308795,42
2106,2,4131,1587,2544,0,0,0,1.0,1,1.0,1,1.0,1,0.162655544514852,40
2107,3,4134,1590,2544,0,0,0,1.0,1,1.0,1,1.0,1,0.18767530578369634,39
2108,4,4138,1592,2546,0,0,0,1.0,1,1.0,1,1.0,1,0.17456485231634877,38
2109,0,4138,1592,2546,0,0,0,1.0,1,1.0,1,1.0,1,0.15322912560140417,37
2110,5,4143,1594,2549,0,0,0,1.0,1,1.0,1,1.0,1,0.14462686648506493,38
2111,2,4145,1595,2550,0,0,0,1.0,1,1.0,1,1.0,1,0.15973317170880022,37
2112,0,4145,1595,2550,0,0,0,1.0,1,1.0,1,1.0,1,0.13244581173594228,36
2113,0,4145,1595,2550,0,0,0,1.0,1,1.0,1,1.0,1,0.13463457351027033,36
2114,0,4145,1595,2550,0,0,0,1.0,1,1.0,1,1.0,1,0.1300891246423219,36
2115,0,4145,1595,2550,0,0,0,1.0,1,1.0,1,1.0,1,0.13811764091351827,35
2116,1,4146,1596,2550,0,0,0,1.0,1,1.0,1,1.0,1,0.182809097709888,37
2117,1,4147,1596,2551,0,0,0,1.0,1,1.0,1,1.0,1,0.14514595956925858,38
2118,2,4149,1596,2553,0,0,0,1.0,1,1.0,1,1.0,1,0.15137094447285065,40
2119,0,4149,1596,2553,0,0,0,1.0,1,1.0,1,1.0,1,0.15137094447285065,40
2120,1,4150,1597,2553,0,0,0,1.0,1,1.0,1,1.0,1,0.16935914143945574,41
2121,2,4152,1597,2555,0,0,0,1.0,1,1.0,1,1.0,1,0.13696878491568204,41
2122,0,4152,1597,2555,0,0,0,1.0,1,1.0,1,1.0,1,0.12519249292703952,42
2123,0,4152,1597,2555,0,0,0,1.0,1,1.0,1,1.0,1,0.1273342133768151,43
2124,0,4152,1597,2555,0,0,0,1.0,1,1.0,1,1.0,1,0.12795040548546344,41
2125,0,4152,1597,2555,0,0,0,1.0,1,1.0,1,1.0,1,0.12795040548546344,41
2126,0,4152,1597,2555,0,0,0,1.0,1,1.0,1,1.0,1,0.154158803425588,40
2127,0,4152,1597,2555,0,0,0,1.0,1,1.0,1,1.0,1,0.154158803425588,40
2128,1,4153,1597,2556,0,0,0,1.0,1,1.0,1,1.0,1,0.13668214551082708,41
2129,1,4154,1597,2557,0,0,0,1.0,1,1.0,1,1.0,1,0.13146908029017237,42
2130,1,4155,1597,2558,0,0,0,1.0,1,1.0,1,1.0,1,0.12794260944910343,45
2131,2,4157,1597,2560,0,0,0,1.0,1,1.0,1,1.0,1,0.08196053026615689,45
2132,1,4158,1597,2561,0,0,0,1.0,1,1.0,1,1.0,1,0.08412075770826608,46
2133,1,4159,1598,2561,0,0,0,1.0,1,1.0,1,1.0,1,0.11377163762782191,46
2134,1,4160,1598,2562,0,0,0,1.0,1,1.0,1,1.0,1,0.10471470692828656,47
2135,4,4164,1600,2564,0,0,0,1.0,1,1.0,1,1.0,1,0.09242217934998812,47
2136,2,4166,1601,2565,0,0,0,1.0,1,1.0,1,1.0,1,0.12040225416040745,47
2137,4,4170,1602,2568,0,0,0,1.0,1,1.0,1,1.0,1,0.0714554129855684,49
2138,0,4170,1602,2568,0,0,0,1.0,1,1.0,1,1.0,1,0.0714554129855684,49
2139,1,4171,1603,2568,0,0,0,1.0,1,1.0,1,1.0,1,0.11709491937750986,47
2140,6,4177,1605,2572,0,0,0,1.0,1,1.0,1,1.0,1,0.06843700045166078,48
2141,2,4179,1606,2573,0,0,0,1.0,1,1.0,1,1.0,1,0.06612614505912988,47
2142,1,4180,1606,2574,0,0,0,1.0,1,1.0,1,1.0,1,0.05961038418956965,47
2143,2,4182,1607,2575,0,0,0,1.0,1,1.0,1,1.0,1,0.09350821417659894,48
2144,4,4186,1611,2575,0,0,0,1.0,1,1.0,1,1.0,1,0.15121912033353033,48
2145,3,4189,1613,2576,0,0,0,1.0,1,1.0,1,1.0,1,0.14148382611884733,46
2146,9,4198,1615,2583,0,0,0,1.0,1,1.0,1,1.0,1,0.0685026966277965,47
2147,3,4201,1618,2583,0,0,0,1.0,1,1.0,1,1.0,1,0.06490340498839672,48
2148,3,4204,1619,2585,0,0,0,1.0,1,1.0,1,1.0,1,0.12745793059290939,46
2149,5,4209,1622,2587,0,0,0,1.0,1,1.0,1,1.0,1,0.06775582348336419,46
2150,0,4209,1622,2587,0,0,0,1.0,1,1.0,1,1.0,1,0.09324219896606545,46
2151,2,4211,1624,2587,0,0,0,1.0,1,1.0,1,1.0,1,0.14386713677817137,44
2152,3,4214,1624,2590,0,0,0,1.0,1,1.0,1,1.0,1,0.11830812395882694,45
2153,7,4221,1626,2595,0,0,0,1.0,1,1.0,1,1.0,1,0.1476843567247194,48
2154,1,4222,1626,2596,0,0,0,1.0,1,1.0,1,1.0,1,0.172741191761135,47
2155,6,4228,1626,2602,0,0,0,1.0,1,1.0,1,1.0,1,0.0741698279548105,48
2156,1,4229,1627,2602,0,0,0,1.0,1,1.0,1,1.0,1,0.055332218910347196,45
2157,0,4229,1627,2602,0,0,0,1.0,1,1.0,1,1.0,1,0.07181305474295736,43
2158,0,4229,1627,2602,0,0,0,1.0,1,1.0,1,1.0,1,0.07181305474295736,43
2159,4,4233,1631,2602,0,0,0,1.0,1,1.0,1,1.0,1,0.16630988011152503,43
2160,1,4234,1631,2603,0,0,0,1.0,1,1.0,1,1.0,1,0.1116740262742697,41
2161,4,4238,1631,2607,0,0,0,1.0,1,1.0,1,1.0,1,0.09586971737389782,41
2162,1,4239,1632,2607,0,0,0,1.0,1,1.0,1,1.0,1,0.11217335963839672,42
2163,3,4242,1633,2609,0,0,0,1.0,1,1.0,1,1.0,1,0.09264860008734445,43
2164,2,4244,1635,2609,0,0,0,1.0,1,1.0,1,1.0,1,0.1874623053067803,44
2165,6,4250,1635,2615,0,0,0,1.0,1,1.0,1,1.0,1,0.1471403796449344,44
2166,0,4250,1635,2615,0,0,0,1.0,1,1.0,1,1.0,1,0.14087701766365343,46
2167,5,4255,1636,2619,0,0,0,1.0,1,1.0,1,1.0,1,0.12515220124572624,46
2168,1,4256,1636,2620,0,0,0,1.0,1,1.0,1,1.0,1,0.088194522963987,45
2169,3,4259,1637,2622,0,0,0,1.0,1,1.0,1,1.0,1,0.060102483594798646,49
2170,0,4259,1637,2622,0,0,0,1.0,1,1.0,1,1.0,1,0.060102483594798646,49
2171,2,4261,1638,2623,0,0,0,1.0,1,1.0,1,1.0,1,0.0794117982980413,51
2172,1,4262,1638,2624,0,0,0,1.0,1,1.0,1,1.0,1,0.06863347475575866,52
2173,0,4262,1638,2624,0,0,0,1.0,1,1.0,1,1.0,1,0.06863347475575866,52
2174,1,4263,1639,2624,0,0,0,1.0,1,1.0,1,1.0,1,0.08623066410861438,52
2175,0,4263,1639,2624,0,0,0,1.0,1,1.0,1,1.0,1,0.10203849518651226,53
2176,1,4264,1639,2625,0,0,0,1.0,1,1.0,1,1.0,1,0.08895288487736581,54
2177,2,4266,1640,2626,0,0,0,1.0,1,1.0,1,1.0,1,0.12905580044316986,55
2178,3,4269,1641,2628,0,0,0,1.0,1,1.0,1,1.0,1,0.11547058943840639,54
2179,8,4277,1643,2634,0,0,0,1.0,1,1.0,1,1.0,1,0.10430065304918283,52
2180,2,4279,1643,2636,0,0,0,1.0,1,1.0,1,1.0,1,0.10978297893760665,51
2181,6,4285,1644,2641,0,0,0,1.0,1,1.0,1,1.0,1,0.12632893910553866,49
2182,5,4290,1645,2645,0,0,0,1.0,1,1.0,1,1.0,1,0.08868471916123098,49
2183,4,4294,1649,2645,0,0,0,1.0,1,1.0,1,1.0,1,0.16243913783509586,46
2184,5,4299,1651,2648,0,0,0,1.0,1,1.0,1,1.0,1,0.1512110591494673,45
2185,4,4303,1651,2652,0,0,0,1.0,1,1.0,1,1.0,1,0.08456398307017497,44
2186,2,4305,1653,2652,0,0,0,1.0,1,1.0,1,1.0,1,0.1334257395200187,42
2187,3,4308,1656,2652,0,0,0,1.0,1,1.0,1,1.0,1,0.14840437391020073,40
2188,6,4314,1659,2655,0,0,0,1.0,1,1.0,1,1.0,1,0.09883380202813047,38
2189,1,4315,1660,2655,0,0,0,1.0,1,1.0,1,1.0,1,0.15132268014500416,36
2190,3,4318,1662,2656,0,0,0,1.0,1,1.0,1,1.0,1,0.12087011696302728,34
2191,3,4321,1663,2658,0,0,0,1.0,1,1.0,1,1.0,1,0.10135744320819913,34
2192,2,4323,1665,2658,0,0,0,1.0,1,1.0,1,1.0,1,0.1278386988999807,33
2193,0,4323,1665,2658,0,0,0,1.0,1,1.0,1,1.0,1,0.15490950826528402,32
2194,4,4327,1665,2662,0,0,0,1.0,1,1.0,1,1.0,1,0.14424567852155326,32
2195,1,4328,1665,2663,0,0,0,1.0,1,1.0,1,1.0,1,0.12509648117131528,31
2196,3,4331,1666,2665,0,0,0,1.0,1,1.0,1,1.0,1,0.11107481562677586,32
2197,2,4333,1666,2667,0,0,0,1.0,1,1.0,1,1.0,1,0.09396086001092992,31
2198,0,4333,1666,2667,0,0,0,1.0,1,1.0,1,1.0,1,0.09396086001092992,31
2199,1,4334,1667,2667,0,0,0,1.0,1,1.0,1,1.0,1,0.12377838293816486,32
2200,0,4334,1667,2667,0,0,0,1.0,1,1.0,1,1.0,1,0.15307222815246652,35
2201,1,4335,1667,2668,0,0,0,1.0,1,1.0,1,1.0,1,0.13902913336455341,36
2202,3,4338,1669,2669,0,0,0,1.0,1,1.0,1,1.0,1,0.15977428096629961,36
2203,2,4340,1669,2671,0,0,0,1.0,1,1.0,1,1.0,1,0.13931461130341424,37
2204,2,4342,1670,2672,0,0,0,1.0,1,1.0,1,1.0,1,0.18092316403775424,36
2205,0,4342,1670,2672,0,0,0,1.0,1,1.0,1,1.0,1,0.1766950808133581,37
2206,5,4347,1672,2675,0,0,0,1.0,1,1.0,1,1.0,1,0.1498147016296684,35
2207,3,4350,1674,2676,0,0,0,1.0,1,1.0,1,1.0,1,0.1593792970568991,37
2208,0,4350,1674,2676,0,0,0,1.0,1,1.0,1,1.0,1,0.15543797240454668,36
2209,2,4352,1675,2677,0,0,0,1.0,1,1.0,1,1.0,1,0.1875352271208405,35
2210,2,4354,1675,2679,0,0,0,1.0,1,1.0,1,1.0,1,0.17010562113551358,38
2211,1,4355,1675,2680,0,0,0,1.0,1,1.0,1,1.0,1,0.1799769218421635,37
2212,4,4359,1676,2683,0,0,0,1.0,1,1.0,1,1.0,1,0.13848609659037356,38
2213,2,4361,1677,2684,0,0,0,1.0,1,1.0,1,1.0,1,0.11779066380721732,38
2214,1,4362,1677,2685,0,0,0,1.0,1,1.0,1,1.0,1,0.13444778192822743,39
2215,4,4366,1678,2688,0,0,0,1.0,1,1.0,1,1.0,1,0.12208227495247315,39
2216,3,4369,1679,2690,0,0,0,1.0,1,1.0,1,1.0,1,0.11320233769791123,39
2217,0,4369,1679,2690,0,0,0,1.0,1,1.0,1,1.0,1,0.0860769543334939,38
2218,3,4372,1680,2692,0,0,0,1.0,1,1.0,1,1.0,1,0.10223479581054815,37
2219,0,4372,1680,2692,0,0,0,1.0,1,1.0,1,1.0,1,0.12422719359366365,36
2220,1,4373,1681,2692,0,0,0,1.0,1,1.0,1,1.0,1,0.11585683199912085,34
2221,1,4374,1682,2692,0,0,0,1.0,1,1.0,1,1.0,1,0.09761150516746922,35
2222,0,4374,1682,2692,0,0,0,1.0,1,1.0,1,1.0,1,0.1357559036439274,33
2223,4,4378,1685,2693,0,0,0,1.0,1,1.0,1,1.0,1,0.17149282572279878,34
2224,2,4380,1686,2694,0,0,0,1.0,1,1.0,1,1.0,1,0.17267560241917998,32
2225,1,4381,1686,2695,0,0,0,1.0,1,1.0,1,1.0,1,0.1464229594241244,33
2226,3,4384,1688,2696,0,0,0,1.0,1,1.0,1,1.0,1,0.2020114740499679,32
2227,3,4387,1688,2699,0,0,0,1.0,1,1.0,1,1.0,1,0.10120564140272721,31
2228,2,4389,1688,2701,0,0,0,1.0,1,1.0,1,1.0,1,0.10695038072781189,32
2229,2,4391,1689,2702,0,0,0,1.0,1,1.0,1,1.0,1,0.09593926219529274,32
2230,1,4392,1689,2703,0,0,0,1.0,1,1.0,1,1.0,1,0.09916587681705707,31
2231,0,4392,1689,2703,0,0,0,1.0,1,1.0,1,1.0,1,0.08481933461704855,32
2232,0,4392,1689,2703,0,0,0,1.0,1,1.0,1,1.0,1,0.10295282648221842,32
2233,0,4392,1689,2703,0,0,0,1.0,1,1.0,1,1.0,1,0.10518418481858861,31
2234,3,4395,1691,2704,0,0,0,1.0,1,1.0,1,1.0,1,0.1564131848898409,32
2235,2,4397,1691,2706,0,0,0,1.0,1,1.0,1,1.0,1,0.15853512941840156,31
2236,4,4401,1692,2709,0,0,0,1.0,1,1.0,1,1.0,1,0.11783402935324097,31
2237,2,4403,1694,2709,0,0,0,1.0,1,1.0,1,1.0,1,0.1846244151654552,31
2238,3,4406,1696,2710,0,0,0,1.0,1,1.0,1,1.0,1,0.24321988076821113,31
2239,3,4409,1696,2713,0,0,0,1.0,1,1.0,1,1.0,1,0.1742196972205593,31
2240,1,4410,1697,2713,0,0,0,1.0,1,1.0,1,1.0,1,0.19062428399609108,32
2241,0,4410,1697,2713,0,0,0,1.0,1,1.0,1,1.0,1,0.19062428399609108,32
2242,4,4414,1698,2716,0,0,0,1.0,1,1.0,1,1.0,1,0.1297913344194281,34
2243,4,4418,1700,2718,0,0,0,1.0,1,1.0,1,1.0,1,0.15811489226770772,34
2244,0,4418,1700,2718,0,0,0,1.0,1,1.0,1,1.0,1,0.14559245596269035,36
2245,0,4418,1700,2718,0,0,0,1.0,1,1.0,1,1.0,1,0.14559245596269035,36
2246,1,4419,1700,2719,0,0,0,1.0,1,1.0,1,1.0,1,0.14375391218201763,39
2247,0,4419,1700,2719,0,0,0,1.0,1,1.0,1,1.0,1,0.1347224377837723,40
2248,0,4419,1700,2719,0,0,0,1.0,1,1.0,1,1.0,1,0.1347224377837723,40
2249,0,4419,1700,2719,0,0,0,1.0,1,1.0,1,1.0,1,0.12634014946591426,41
2250,1,4420,1701,2719,0,0,0,1.0,1,1.0,1,1.0,1,0.1576972156175611,41
2251,2,4422,1701,2721,0,0,0,1.0,1,1.0,1,1.0,1,0.12961941398200755,42
2252,1,4423,1701,2722,0,0,0,1.0,1,1.0,1,1.0,1,0.12312472387600125,41
2253,0,4423,1701,2722,0,0,0,1.0,1,1.0,1,1.0,1,0.11721699909901603,40
2254,1,4424,1701,2723,0,0,0,1.0,1,1.0,1,1.0,1,0.1004976002676121,39
2255,1,4425,1701,2724,0,0,0,1.0,1,1.0,1,1.0,1,0.11554097651459622,39
2256,0,4425,1701,2724,0,0,0,1.0,1,1.0,1,1.0,1,0.11717433823993037,40
2257,1,4426,1702,2724,0,0,0,1.0,1,1.0,1,1.0,1,0.12975924724522656,40
2258,1,4427,1703,2724,0,0,0,1.0,1,1.0,1,1.0,1,0.16039496183623655,39
2259,3,4430,1706,2724,0,0,0,1.0,1,1.0,1,1.0,1,0.19638058994559507,41
2260,3,4433,1707,2726,0,0,0,1.0,1,1.0,1,1.0,1,0.2171200794610984,38
2261,2,4435,1708,2727,0,0,0,1.0,1,1.0,1,1.0,1,0.20680977270251752,38
2262,5,4440,1709,2731,0,0,0,1.0,1,1.0,1,1.0,1,0.1670002810938695,36
2263,3,4443,1711,2732,0,0,0,1.0,1,1.0,1,1.0,1,0.1569078553856189,35
2264,1,4444,1712,2732,0,0,0,1.0,1,1.0,1,1.0,1,0.17957590361685408,33
2265,4,4448,1713,2735,0,0,0,1.0,1,1.0,1,1.0,1,0.12526962223166058,33
2266,4,4452,1715,2737,0,0,0,1.0,1,1.0,1,1.0,1,0.10534980831649712,33
2267,3,4455,1718,2737,0,0,0,1.0,1,1.0,1,1.0,1,0.23536224488358906,33
2268,6,4461,1720,2741,0,0,0,1.0,1,1.0,1,1.0,1,0.14808597962290243,35
2269,4,4465,1723,2742,0,0,0,1.0,1,1.0,1,1.0,1,0.17154486173964362,36
2270,0,4465,1723,2742,0,0,0,1.0,1,1.0,1,1.0,1,0.1755113611126558,34
2271,1,4466,1724,2742,0,0,0,1.0,1,1.0,1,1.0,1,0.18195347459931333,34
2272,3,4469,1724,2745,0,0,0,1.0,1,1.0,1,1.0,1,0.14740531241580526,33
2273,4,4473,1727,2746,0,0,0,1.0,1,1.0,1,1.0,1,0.1295356438041574,32
2274,1,4474,1728,2746,0,0,0,1.0,1,1.0,1,1.0,1,0.0931618432156028,32
2275,0,4474,1728,2746,0,0,0,1.0,1,1.0,1,1.0,1,0.13602015223463806,32
2276,1,4475,1729,2746,0,0,0,1.0,1,1.0,1,1.0,1,0.166558496729192,31
2277,1,4476,1730,2746,0,0,0,1.0,1,1.0,1,1.0,1,0.17343154123976354,30
2278,1,4477,1730,2747,0,0,0,1.0,1,1.0,1,1.0,1,0.14908507432995635,33
2279,0,4477,1730,2747,0,0,0,1.0,1,1.0,1,1.0,1,0.14908507432995635,33
2280,3,4480,1731,2749,0,0,0,1.0,1,1.0,1,1.0,1,0.12596614322105107,35
2281,2,4482,1731,2751,0,0,0,1.0,1,1.0,1,1.0,1,0.10356958865755765,36
2282,0,4482,1731,2751,0,0,0,1.0,1,1.0,1,1.0,1,0.10356958865755765,36
2283,0,4482,1731,2751,0,0,0,1.0,1,1.0,1,1.0,1,0.10356958865755765,36
2284,0,4482,1731,2751,0,0,0,1.0,1,1.0,1,1.0,1,0.10356958865755765,36
2285,0,4482,1731,2751,0,0,0,1.0,1,1.0,1,1.0,1,0.09787193582144135,37
2286,1,4483,1732,2751,0,0,0,1.0,1,1.0,1,1.0,1,0.14559855730750584,38
2287,1,4484,1732,2752,0,0,0,1.0,1,1.0,1,1.0,1,0.11080809559386653,38
2288,1,4485,1733,2752,0,0,0,1.0,1,1.0,1,1.0,1,0.18363020259349985,40
2289,4,4489,1735,2754,0,0,0,1.0,1,1.0,1,1.0,1,0.1715897696325846,40
2290,2,4491,1736,2755,0,0,0,1.0,1,1.0,1,1.0,1,0.20572082783065396,39
2291,2,4493,1737,2756,0,0,0,1.0,1,1.0,1,1.0,1,0.2014709752673211,37
2292,5,4498,1738,2760,0,0,0,1.0,1,1.0,1,1.0,1,0.12565728451613156,35
2293,1,4499,1739,2760,0,0,0,1.0,1,1.0,1,1.0,1,0.16273886886330236,35
2294,1,4500,1739,2761,0,0,0,1.0,1,1.0,1,1.0,1,0.1400911412885156,35
2295,0,4500,1739,2761,0,0,0,1.0,1,1.0,1,1.0,1,0.15561995486400435,36
2296,1,4501,1739,2762,0,0,0,1.0,1,1.0,1,1.0,1,0.15870496270888718,34
2297,1,4502,1739,2763,0,0,0,1.0,1,1.0,1,1.0,1,0.17902949031202714,35
2298,0,4502,1739,2763,0,0,0,1.0,1,1.0,1,1.0,1,0.19991017346373566,34
2299,2,4504,1740,2764,0,0,0,1.0,1,1.0,1,1.0,1,0.17767060073678637,35
2300,0,4504,1740,2764,0,0,0,1.0,1,1.0,1,1.0,1,0.17767060073678637,35
2301,2,4506,1741,2765,0,0,0,1.0,1,1.0,1,1.0,1,0.2067877968287772,35
2302,3,4509,1743,2766,0,0,0,1.0,1,1.0,1,1.0,1,0.2296497874863822,37
2303,0,4509,1743,2766,0,0,0,1.0,1,1.0,1,1.0,1,0.18219270200476895,35
2304,3,4512,1746,2766,0,0,0,1.0,1,1.0,1,1.0,1,0.2839622209993993,36
2305,4,4516,1746,2770,0,0,0,1.0,1,1.0,1,1.0,1,0.19503522164673684,34
2306,2,4518,1747,2771,0,0,0,1.0,1,1.0,1,1.0,1,0.22106305453818845,35
2307,2,4520,1747,2773,0,0,0,1.0,1,1.0,1,1.0,1,0.17481952452573446,35
2308,0,4520,1747,2773,0,0,0,1.0,1,1.0,1,1.0,1,0.17481952452573446,35
2309,0,4520,1747,2773,0,0,0,1.0,1,1.0,1,1.0,1,0.16568478159122746,34
2310,2,4522,1747,2775,0,0,0,1.0,1,1.0,1,1.0,1,0.1492480047765967,36
2311,1,4523,1747,2776,0,0,0,1.0,1,1.0,1,1.0,1,0.15443869062746918,38
2312,2,4525,1749,2776,0,0,0,1.0,1,1.0,1,1.0,1,0.20210148013561016,39
2313,5,4530,1750,2780,0,0,0,1.0,1,1.0,1,1.0,1,0.10607464238628139,39
2314,0,4530,1750,2780,0,0,0,1.0,1,1.0,1,1.0,1,0.10607464238628139,39
2315,4,4534,1752,2782,0,0,0,1.0,1,1.0,1,1.0,1,0.1815898657483839,40
2316,5,4539,1753,2786,0,0,0,1.0,1,1.0,1,1.0,1,0.1399994153638637,40
2317,3,4542,1753,2789,0,0,0,1.0,1,1.0,1,1.0,1,0.10527839207073374,41
2318,3,4545,1754,2791,0,0,0,1.0,1,1.0,1,1.0,1,0.12358384488397325,41
2319,2,4547,1754,2793,0,0,0,1.0,1,1.0,1,1.0,1,0.12358384488397325,41
2320,3,4550,1754,2796,0,0,0,1.0,1,1.0,1,1.0,1,0.09383540014345317,42
2321,2,4552,1754,2798,0,0,0,1.0,1,1.0,1,1.0,1,0.05418799377884605,43
2322,0,4552,1754,2798,0,0,0,1.0,1,1.0,1,1.0,1,0.08204415758775684,42
2323,1,4553,1755,2798,0,0,0,1.0,1,1.0,1,1.0,1,0.13255224555495237,43
2324,0,4553,1755,2798,0,0,0,1.0,1,1.0,1,1.0,1,0.14569864030725693,44
2325,0,4553,1755,2798,0,0,0,1.0,1,1.0,1,1.0,1,0.14569864030725693,44
2326,1,4554,1755,2799,0,0,0,1.0,1,1.0,1,1.0,1,0.11829202070628085,45
2327,0,4554,1755,2799,0,0,0,1.0,1,1.0,1,1.0,1,0.11829202070628085,45
2328,5,4559,1757,2802,0,0,0,1.0,1,1.0,1,1.0,1,0.10760087884346398,46
2329,1,4560,1758,2802,0,0,0,1.0,1,1.0,1,1.0,1,0.15504467436801367,45
2330,1,4561,1759,2802,0,0,0,1.0,1,1.0,1,1.0,1,0.15411378991753408,47
2331,2,4563,1759,2804,0,0,0,1.0,1,1.0,1,1.0,1,0.12824666455780542,48
2332,3,4566,1759,2807,0,0,0,1.0,1,1.0,1,1.0,1,0.09192187940431205,48
2333,3,4569,1760,2809,0,0,0,1.0,1,1.0,1,1.0,1,0.14610638147065533,49
2334,3,4572,1760,2812,0,0,0,1.0,1,1.0,1,1.0,1,0.16570541233818628,47
2335,3,4575,1761,2814,0,0,0,1.0,1,1.0,1,1.0,1,0.18853553295528092,46
2336,2,4577,1761,2816,0,0,0,1.0,1,1.0,1,1.0,1,0.15518406411369176,46
2337,2,4579,1761,2818,0,0,0,1.0,1,1.0,1,1.0,1,0.1392818617169407,45
2338,2,4581,1761,2820,0,0,0,1.0,1,1.0,1,1.0,1,0.1268641816831198,44
2339,2,4583,1762,2821,0,0,0,1.0,1,1.0,1,1.0,1,0.1105691323650523,45
2340,0,4583,1762,2821,0,0,0,1.0,1,1.0,1,1.0,1,0.10123683674327591,44
2341,1,4584,1762,2822,0,0,0,1.0,1,1.0,1,1.0,1,0.1099321724671761,45
2342,3,4587,1764,2823,0,0,0,1.0,1,1.0,1,1.0,1,0.09617930841537857,47
2343,1,4588,1765,2823,0,0,0,1.0,1,1.0,1,1.0,1,0.11185803780610876,46
2344,4,4592,1765,2827,0,0,0,1.0,1,1.0,1,1.0,1,0.07206668114917766,46
2345,0,4592,1765,2827,0,0,0,1.0,1,1.0,1,1.0,1,0.08594731117994175,45
2346,0,4592,1765,2827,0,0,0,1.0,1,1.0,1,1.0,1,0.07343068214783705,46
2347,0,4592,1765,2827,0,0,0,1.0,1,1.0,1,1.0,1,0.08520775037956806,47
2348,1,4593,1765,2828,0,0,0,1.0,1,1.0,1,1.0,1,0.09899296959004295,49
2349,1,4594,1766,2828,0,0,0,1.0,1,1.0,1,1.0,1,0.12318053613893001,49
2350,1,4595,1766,2829,0,0,0,1.0,1,1.0,1,1.0,1,0.09591373509630371,50
2351,1,4596,1767,2829,0,0,0,1.0,1,1.0,1,1.0,1,0.10173667170644342,50
2352,2,4598,1767,2831,0,0,0,1.0,1,1.0,1,1.0,1,0.10217425659783597,51
2353,1,4599,1767,2832,0,0,0,1.0,1,1.0,1,1.0,1,0.09059544400538162,51
2354,1,4600,1767,2833,0,0,0,1.0,1,1.0,1,1.0,1,0.1098184267569567,51
2355,3,4603,1768,2835,0,0,0,1.0,1,1.0,1,1.0,1,0.07959519828648315,50
2356,0,4603,1768,2835,0,0,0,1.0,1,1.0,1,1.0,1,0.07959519828648315,50
2357,0,4603,1768,2835,0,0,0,1.0,1,1.0,1,1.0,1,0.10020107237853292,49
2358,1,4604,1768,2836,0,0,0,1.0,1,1.0,1,1.0,1,0.10065380481472708,51
2359,1,4605,1768,2837,0,0,0,1.0,1,1.0,1,1.0,1,0.0940553078370494,51
2360,2,4607,1769,2838,0,0,0,1.0,1,1.0,1,1.0,1,0.08554949811367392,51
2361,1,4608,1770,2838,0,0,0,1.0,1,1.0,1,1.0,1,0.11812501889027631,52
2362,2,4610,1770,2840,0,0,0,1.0,1,1.0,1,1.0,1,0.09267235606041399,53
2363,2,4612,1771,2841,0,0,0,1.0,1,1.0,1,1.0,1,0.07643386275149924,54
2364,1,4613,1771,2842,0,0,0,1.0,1,1.0,1,1.0,1,0.06647258126914933,55
2365,2,4615,1773,2842,0,0,0,1.0,1,1.0,1,1.0,1,0.11114458660336199,53
2366,2,4617,1775,2842,0,0,0,1.0,1,1.0,1,1.0,1,0.1312715212196292,53
2367,2,4619,1777,2842,0,0,0,1.0,1,1.0,1,1.0,1,0.18419961876272756,51
2368,8,4627,1779,2848,0,0,0,1.0,1,1.0,1,1.0,1,0.1739746202621998,50
2369,2,4629,1781,2848,0,0,0,1.0,1,1.0,1,1.0,1,0.1861034206691087,47
2370,1,4630,1781,2849,0,0,0,1.0,1,1.0,1,1.0,1,0.19771630904520365,48
2371,3,4633,1782,2851,0,0,0,1.0,1,1.0,1,1.0,1,0.19869672004134015,49
2372,0,4633,1782,2851,0,0,0,1.0,1,1.0,1,1.0,1,0.20189988278337875,48
2373,2,4635,1782,2853,0,0,0,1.0,1,1.0,1,1.0,1,0.16714256888565907,49
2374,1,4636,1782,2854,0,0,0,1.0,1,1.0,1,1.0,1,0.15832453060243487,50
2375,1,4637,1783,2854,0,0,0,1.0,1,1.0,1,1.0,1,0.17165364380481724,50
2376,0,4637,1783,2854,0,0,0,1.0,1,1.0,1,1.0,1,0.17684061278807112,50
2377,0,4637,1783,2854,0,0,0,1.0,1,1.0,1,1.0,1,0.17926119933564533,49
2378,0,4637,1783,2854,0,0,0,1.0,1,1.0,1,1.0,1,0.17926119933564533,49
2379,3,4640,1784,2856,0,0,0,1.0,1,1.0,1,1.0,1,0.1861376330472546,50
2380,2,4642,1785,2857,0,0,0,1.0,1,1.0,1,1.0,1,0.19697020748230548,50
2381,3,4645,1786,2859,0,0,0,1.0,1,1.0,1,1.0,1,0.1856404651234074,51
2382,1,4646,1787,2859,0,0,0,1.0,1,1.0,1,1.0,1,0.19180717424477473,51
2383,5,4651,1787,2864,0,0,0,1.0,1,1.0,1,1.0,1,0.15533341511239174,52
2384,3,4654,1788,2866,0,0,0,1.0,1,1.0,1,1.0,1,0.1276189225944872,52
2385,5,4659,1790,2869,0,0,0,1.0,1,1.0,1,1.0,1,0.14598443942144812,51
2386,4,4663,1792,2871,0,0,0,1.0,1,1.0,1,1.0,1,0.16119208797186363,52
2387,1,4664,1792,2872,0,0,0,1.0,1,1.0,1,1.0,1,0.16751648775672814,49
2388,1,4665,1792,2873,0,0,0,1.0,1,1.0,1,1.0,1,0.16357497629766976,48
2389,4,4669,1794,2875,0,0,0,1.0,1,1.0,1,1.0,1,0.14241238595850347,48
2390,2,4671,1795,2876,0,0,0,1.0,1,1.0,1,1.0,1,0.12011326180383097,49
2391,5,4676,1799,2877,0,0,0,1.0,1,1.0,1,1.0,1,0.1758061286207633,48
2392,3,4679,1799,2880,0,0,0,1.0,1,1.0,1,1.0,1,0.1352794098132031,49
2393,1,4680,1799,2881,0,0,0,1.0,1,1.0,1,1.0,1,0.12035325483642806,50
2394,3,4683,1801,2882,0,0,0,1.0,1,1.0,1,1.0,1,0.14367640304571455,50
2395,1,4684,1801,2883,0,0,0,1.0,1,1.0,1,1.0,1,0.13181554514062335,49
2396,1,4685,1801,2884,0,0,0,1.0,1,1.0,1,1.0,1,0.12465785961303853,50
2397,3,4688,1803,2885,0,0,0,1.0,1,1.0,1,1.0,1,0.16588486687625267,51
2398,5,4693,1805,2888,0,0,0,1.0,1,1.0,1,1.0,1,0.14425942168095768,49
2399,3,4696,1805,2891,0,0,0,1.0,1,1.0,1,1.0,1,0.13355558834952472,50
2400,2,4698,1806,2892,0,0,0,1.0,1,1.0,1,1.0,1,0.16374338092178004,51
2401,1,4699,1806,2893,0,0,0,1.0,1,1.0,1,1.0,1,0.14871650917039034,50
2402,0,4699,1806,2893,0,0,0,1.0,1,1.0,1,1.0,1,0.14671618802112818,51
2403,0,4699,1806,2893,0,0,0,1.0,1,1.0,1,1.0,1,0.15424953211032635,52
2404,3,4702,1806,2896,0,0,0,1.0,1,1.0,1,1.0,1,0.10855141924360306,53
2405,0,4702,1806,2896,0,0,0,1.0,1,1.0,1,1.0,1,0.10662715796451881,52
2406,1,4703,1807,2896,0,0,0,1.0,1,1.0,1,1.0,1,0.12299847687266192,52
2407,4,4707,1807,2900,0,0,0,1.0,1,1.0,1,1.0,1,0.12759118481421536,51
2408,0,4707,1807,2900,0,0,0,1.0,1,1.0,1,1.0,1,0.15030724018006825,50
2409,1,4708,1807,2901,0,0,0,1.0,1,1.0,1,1.0,1,0.15988031627953106,50
2410,1,4709,1808,2901,0,0,0,1.0,1,1.0,1,1.0,1,0.18571319584879648,49
2411,0,4709,1808,2901,0,0,0,1.0,1,1.0,1,1.0,1,0.1916259514741057,48
2412,0,4709,1808,2901,0,0,0,1.0,1,1.0,1,1.0,1,0.20914213836893308,47
2413,2,4711,1808,2903,0,0,0,1.0,1,1.0,1,1.0,1,0.18109016400095712,47
2414,2,4713,1809,2904,0,0,0,1.0,1,1.0,1,1.0,1,0.23407848612800244,47
2415,3,4716,1809,2907,0,0,0,1.0,1,1.0,1,1.0,1,0.20882249884258752,46
2416,1,4717,1809,2908,0,0,0,1.0,1,1.0,1,1.0,1,0.17693950227898161,47
2417,2,4719,1810,2909,0,0,0,1.0,1,1.0,1,1.0,1,0.19269628784606277,46
2418,4,4723,1811,2912,0,0,0,1.0,1,1.0,1,1.0,1,0.19378362172804206,48
2419,1,4724,1811,2913,0,0,0,1.0,1,1.0,1,1.0,1,0.18254994782116643,47
2420,0,4724,1811,2913,0,0,0,1.0,1,1.0,1,1.0,1,0.16493379460614774,49
2421,1,4725,1812,2913,0,0,0,1.0,1,1.0,1,1.0,1,0.16424024333692333,50
2422,5,4730,1814,2916,0,0,0,1.0,1,1.0,1,1.0,1,0.13007434428805706,50
2423,1,4731,1814,2917,0,0,0,1.0,1,1.0,1,1.0,1,0.12179000233034282,51
2424,3,4734,1817,2917,0,0,0,1.0,1,1.0,1,1.0,1,0.13247207366996525,50
2425,2,4736,1817,2919,0,0,0,1.0,1,1.0,1,1.0,1,0.09960129132419036,48
2426,5,4741,1821,2920,0,0,0,1.0,1,1.0,1,1.0,1,0.13598442011006845,51
2427,2,4743,1822,2921,0,0,0,1.0,1,1.0,1,1.0,1,0.13207518315987285,50
2428,4,4747,1823,2924,0,0,0,1.0,1,1.0,1,1.0,1,0.12089923907198138,49
2429,1,4748,1824,2924,0,0,0,1.0,1,1.0,1,1.0,1,0.11616384688415451,49
2430,0,4748,1824,2924,0,0,0,1.0,1,1.0,1,1.0,1,0.15161513129961365,46
2431,1,4749,1825,2924,0,0,0,1.0,1,1.0,1,1.0,1,0.14008152466369594,45
2432,2,4751,1826,2925,0,0,0,1.0,1,1.0,1,1.0,1,0.2284580730635483,44
2433,2,4753,1827,2926,0,0,0,1.0,1,1.0,1,1.0,1,0.1644809852616312,45
2434,3,4756,1828,2928,0,0,0,1.0,1,1.0,1,1.0,1,0.1731812831752344,44
2435,2,4758,1828,2930,0,0,0,1.0,1,1.0,1,1.0,1,0.11584709599008895,44
2436,1,4759,1829,2930,0,0,0,1.0,1,1.0,1,1.0,1,0.12211313441408404,44
2437,2,4761,1831,2930,0,0,0,1.0,1,1.0,1,1.0,1,0.18427323547047225,45
2438,3,4764,1832,2932,0,0,0,1.0,1,1.0,1,1.0,1,0.1989630871497361,45
2439,1,4765,1832,2933,0,0,0,1.0,1,1.0,1,1.0,1,0.17773705771798604,46
2440,2,4767,1832,2935,0,0,0,1.0,1,1.0,1,1.0,1,0.13978224850067497,45
2441,3,4770,1833,2937,0,0,0,1.0,1,1.0,1,1.0,1,0.12876247684776518,45
2442,0,4770,1833,2937,0,0,0,1.0,1,1.0,1,1.0,1,0.11719925118166347,46
2443,0,4770,1833,2937,0,0,0,1.0,1,1.0,1,1.0,1,0.13715898850502853,45
2444,5,4775,1837,2938,0,0,0,1.0,1,1.0,1,1.0,1,0.2084408537210386,46
2445,6,4781,1838,2943,0,0,0,1.0,1,1.0,1,1.0,1,0.16556406154848094,44
2446,5,4786,1839,2947,0,0,0,1.0,1,1.0,1,1.0,1,0.10406724269022205,44
2447,2,4788,1839,2949,0,0,0,1.0,1,1.0,1,1.0,1,0.11737900621572503,42
2448,3,4791,1842,2949,0,0,0,1.0,1,1.0,1,1.0,1,0.17475968676001244,41
2449,4,4795,1843,2952,0,0,0,1.0,1,1.0,1,1.0,1,0.15713542294473815,40
2450,4,4799,1844,2955,0,0,0,1.0,1,1.0,1,1.0,1,0.202187691864394,42
2451,3,4802,1844,2958,0,0,0,1.0,1,1.0,1,1.0,1,0.14535913485783652,43
2452,0,4802,1844,2958,0,0,0,1.0,1,1.0,1,1.0,1,0.14535913485783652,43
2453,1,4803,1844,2959,0,0,0,1.0,1,1.0,1,1.0,1,0.12963555394234388,45
2454,1,4804,1845,2959,0,0,0,1.0,1,1.0,1,1.0,1,0.13569004239149735,47
2455,0,4804,1845,2959,0,0,0,1.0,1,1.0,1,1.0,1,0.1436992363389729,48
2456,0,4804,1845,2959,0,0,0,1.0,1,1.0,1,1.0,1,0.1456348950702196,49
2457,2,4806,1847,2959,0,0,0,1.0,1,1.0,1,1.0,1,0.209062704319411,48
2458,2,4808,1848,2960,0,0,0,1.0,1,1.0,1,1.0,1,0.2101217507706291,49
2459,2,4810,1848,2962,0,0,0,1.0,1,1.0,1,1.0,1,0.1526567910427583,49
2460,5,4815,1850,2965,0,0,0,1.0,1,1.0,1,1.0,1,0.1579514071520809,50
2461,1,4816,1850,2966,0,0,0,1.0,1,1.0,1,1.0,1,0.1513583804502741,50
2462,3,4819,1852,2967,0,0,0,1.0,1,1.0,1,1.0,1,0.21426800665165435,51
2463,4,4823,1853,2970,0,0,0,1.0,1,1.0,1,1.0,1,0.2049552572420257,51
2464,7,4830,1856,2974,0,0,0,1.0,1,1.0,1,1.0,1,0.17555758085167747,50
2465,3,4833,1858,2975,0,0,0,1.0,1,1.0,1,1.0,1,0.19560020774847564,49
2466,6,4839,1860,2979,0,0,0,1.0,1,1.0,1,1.0,1,0.1702248599868939,49
2467,3,4842,1860,2982,0,0,0,1.0,1,1.0,1,1.0,1,0.11657074410003453,48
2468,3,4845,1862,2983,0,0,0,1.0,1,1.0,1,1.0,1,0.13452207872083186,47
2469,1,4846,1863,2983,0,0,0,1.0,1,1.0,1,1.0,1,0.13060316690858137,46
2470,1,4847,1863,2984,0,0,0,1.0,1,1.0,1,1.0,1,0.12467736828240124,44
2471,2,4849,1864,2985,0,0,0,1.0,1,1.0,1,1.0,1,0.1076045628689014,44
2472,3,4852,1864,2988,0,0,0,1.0,1,1.0,1,1.0,1,0.0635298285192023,44
2473,0,4852,1864,2988,0,0,0,1.0,1,1.0,1,1.0,1,0.06238315258048188,43
2474,2,4854,1866,2988,0,0,0,1.0,1,1.0,1,1.0,1,0.08834842121738247,44
2475,1,4855,1867,2988,0,0,0,1.0,1,1.0,1,1.0,1,0.05229403537904223,46
2476,1,4856,1868,2988,0,0,0,1.0,1,1.0,1,1.0,1,0.08763131073855643,46
2477,0,4856,1868,2988,0,0,0,1.0,1,1.0,1,1.0,1,0.08763131073855643,46
2478,0,4856,1868,2988,0,0,0,1.0,1,1.0,1,1.0,1,0.08763131073855643,46
2479,0,4856,1868,2988,0,0,0,1.0,1,1.0,1,1.0,1,0.08763131073855643,46
2480,2,4858,1869,2989,0,0,0,1.0,1,1.0,1,1.0,1,0.06792621878512226,47
2481,2,4860,1871,2989,0,0,0,1.0,1,1.0,1,1.0,1,0.10366276856257622,47
2482,4,4864,1871,2993,0,0,0,1.0,1,1.0,1,1.0,1,0.11891770252380574,45
2483,1,4865,1871,2994,0,0,0,1.0,1,1.0,1,1.0,1,0.13200029340817246,45
2484,2,4867,1872,2995,0,0,0,1.0,1,1.0,1,1.0,1,0.12000487309907586,46
2485,2,4869,1873,2996,0,0,0,1.0,1,1.0,1,1.0,1,0.13543137521456555,44
2486,1,4870,1873,2997,0,0,0,1.0,1,1.0,1,1.0,1,0.12783671194089036,43
2487,2,4872,1874,2998,0,0,0,1.0,1,1.0,1,1.0,1,0.1258960492815245,44
2488,1,4873,1874,2999,0,0,0,1.0,1,1.0,1,1.0,1,0.12673299624737958,45
2489,1,4874,1875,2999,0,0,0,1.0,1,1.0,1,1.0,1,0.15613123834196319,44
2490,2,4876,1876,3000,0,0,0,1.0,1,1.0,1,1.0,1,0.12653677277441908,44
2491,2,4878,1877,3001,0,0,0,1.0,1,1.0,1,1.0,1,0.15723894781395237,44
2492,3,4881,1880,3001,0,0,0,1.0,1,1.0,1,1.0,1,0.23462067406318718,44
2493,1,4882,1880,3002,0,0,0,1.0,1,1.0,1,1.0,1,0.2552410792604205,42
2494,5,4887,1882,3005,0,0,0,1.0,1,1.0,1,1.0,1,0.2350293870561421,42
2495,1,4888,1882,3006,0,0,0,1.0,1,1.0,1,1.0,1,0.2205951599988901,42
2496,3,4891,1883,3008,0,0,0,1.0,1,1.0,1,1.0,1,0.2399046941751172,42
2497,2,4893,1884,3009,0,0,0,1.0,1,1.0,1,1.0,1,0.21673127923038235,44
2498,1,4894,1884,3010,0,0,0,1.0,1,1.0,1,1.0,1,0.1942179052521797,43
2499,0,4894,1884,3010,0,0,0,1.0,1,1.0,1,1.0,1,0.1942179052521797,43
2500,2,4896,1884,3012,0,0,0,1.0,1,1.0,1,1.0,1,0.16117900612608385,44
2501,1,4897,1884,3013,0,0,0,1.0,1,1.0,1,1.0,1,0.16679202076173966,46
2502,5,4902,1887,3015,0,0,0,1.0,1,1.0,1,1.0,1,0.13181329113806955,47
2503,1,4903,1888,3015,0,0,0,1.0,1,1.0,1,1.0,1,0.13919651084155474,47
2504,1,4904,1888,3016,0,0,0,1.0,1,1.0,1,1.0,1,0.11481436053024427,46
2505,4,4908,1890,3018,0,0,0,1.0,1,1.0,1,1.0,1,0.09517056591808296,46
2506,6,4914,1892,3022,0,0,0,1.0,1,1.0,1,1.0,1,0.15081816045560215,45
2507,2,4916,1892,3024,0,0,0,1.0,1,1.0,1,1.0,1,0.13894937212231695,45
2508,2,4918,1893,3025,0,0,0,1.0,1,1.0,1,1.0,1,0.15231610590877676,46
2509,1,4919,1893,3026,0,0,0,1.0,1,1.0,1,1.0,1,0.13969498454900742,45
2510,2,4921,1894,3027,0,0,0,1.0,1,1.0,1,1.0,1,0.14750119751043997,46
2511,1,4922,1895,3027,0,0,0,1.0,1,1.0,1,1.0,1,0.1297800121967548,47
2512,4,4926,1897,3029,0,0,0,1.0,1,1.0,1,1.0,1,0.11981278933508177,47
2513,2,4928,1897,3031,0,0,0,1.0,1,1.0,1,1.0,1,0.10552019562707407,48
2514,1,4929,1898,3031,0,0,0,1.0,1,1.0,1,1.0,1,0.1445416798567477,48
2515,3,4932,1898,3034,0,0,0,1.0,1,1.0,1,1.0,1,0.1011667132604373,49
2516,0,4932,1898,3034,0,0,0,1.0,1,1.0,1,1.0,1,0.1011667132604373,49
2517,1,4933,1898,3035,0,0,0,1.0,1,1.0,1,1.0,1,0.09869916871877434,49
2518,2,4935,1900,3035,0,0,0,1.0,1,1.0,1,1.0,1,0.10839173035910349,48
2519,1,4936,1901,3035,0,0,0,1.0,1,1.0,1,1.0,1,0.1046207770511194,48
2520,1,4937,1902,3035,0,0,0,1.0,1,1.0,1,1.0,1,0.13444636023463746,46
2521,4,4941,1904,3037,0,0,0,1.0,1,1.0,1,1.0,1,0.13398785405120642,47
2522,2,4943,1906,3037,0,0,0,1.0,1,1.0,1,1.0,1,0.18286251584025703,45
2523,2,4945,1907,3038,0,0,0,1.0,1,1.0,1,1.0,1,0.19755039796630058,44
2524,3,4948,1907,3041,0,0,0,1.0,1,1.0,1,1.0,1,0.14730033899872522,42
2525,3,4951,1908,3043,0,0,0,1.0,1,1.0,1,1.0,1,0.14126427251037085,42
2526,1,4952,1908,3044,0,0,0,1.0,1,1.0,1,1.0,1,0.1553690023339569,41
2527,1,4953,1908,3045,0,0,0,1.0,1,1.0,1,1.0,1,0.14707723483369162,41
2528,0,4953,1908,3045,0,0,0,1.0,1,1.0,1,1.0,1,0.12583777779148927,41
2529,0,4953,1908,3045,0,0,0,1.0,1,1.0,1,1.0,1,0.13259316726498685,42
2530,1,4954,1908,3046,0,0,0,1.0,1,1.0,1,1.0,1,0.1371894955873978,41
2531,0,4954,1908,3046,0,0,0,1.0,1,1.0,1,1.0,1,0.1371894955873978,41
2532,0,4954,1908,3046,0,0,0,1.0,1,1.0,1,1.0,1,0.16026308412236162,43
2533,0,4954,1908,3046,0,0,0,1.0,1,1.0,1,1.0,1,0.16026308412236162,43
2534,0,4954,1908,3046,0,0,0,1.0,1,1.0,1,1.0,1,0.16026308412236162,43
2535,2,4956,1908,3048,0,0,0,1.0,1,1.0,1,1.0,1,0.1350086670645448,44
2536,1,4957,1908,3049,0,0,0,1.0,1,1.0,1,1.0,1,0.1257912222089782,44
2537,3,4960,1910,3050,0,0,0,1.0,1,1.0,1,1.0,1,0.2133615108070359,45
2538,2,4962,1910,3052,0,0,0,1.0,1,1.0,1,1.0,1,0.19445399094367666,48
2539,3,4965,1911,3054,0,0,0,1.0,1,1.0,1,1.0,1,0.17577773074445702,48
2540,5,4970,1911,3059,0,0,0,1.0,1,1.0,1,1.0,1,0.15997531860990552,50
2541,4,4974,1912,3062,0,0,0,1.0,1,1.0,1,1.0,1,0.1768214029987071,52
2542,9,4983,1914,3069,0,0,0,1.0,1,1.0,1,1.0,1,0.1362304600035216,52
2543,3,4986,1916,3070,0,0,0,1.0,1,1.0,1,1.0,1,0.15414117602513544,51
2544,4,4990,1919,3071,0,0,0,1.0,1,1.0,1,1.0,1,0.2079180993866561,51
2545,5,4995,1920,3075,0,0,0,1.0,1,1.0,1,1.0,1,0.14401640648810035,50
2546,2,4997,1921,3076,0,0,0,1.0,1,1.0,1,1.0,1,0.15244071762774364,50
2547,0,4997,1921,3076,0,0,0,1.0,1,1.0,1,1.0,1,0.17303802597845416,47
2548,3,5000,1921,3079,0,0,0,1.0,1,1.0,1,1.0,1,0.13236136088507228,46
2549,2,5002,1923,3079,0,0,0,1.0,1,1.0,1,1.0,1,0.16744247091417927,46
2550,1,5003,1924,3079,0,0,0,1.0,1,1.0,1,1.0,1,0.16915636432791228,44
2551,2,5005,1924,3081,0,0,0,1.0,1,1.0,1,1.0,1,0.11575199835005244,43
2552,1,5006,1925,3081,0,0,0,1.0,1,1.0,1,1.0,1,0.13892285533520943,43
2553,0,5006,1925,3081,0,0,0,1.0,1,1.0,1,1.0,1,0.1341004704134911,44
2554,5,5011,1926,3085,0,0,0,1.0,1,1.0,1,1.0,1,0.11976071946618465,45
2555,2,5013,1927,3086,0,0,0,1.0,1,1.0,1,1.0,1,0.14317030551833745,44
2556,0,5013,1927,3086,0,0,0,1.0,1,1.0,1,1.0,1,0.13080839740942368,44
2557,3,5016,1928,3088,0,0,0,1.0,1,1.0,1,1.0,1,0.14087114762028038,41
2558,1,5017,1928,3089,0,0,0,1.0,1,1.0,1,1.0,1,0.12561641558900574,40
2559,0,5017,1928,3089,0,0,0,1.0,1,1.0,1,1.0,1,0.143104983898255,41
2560,2,5019,1928,3091,0,0,0,1.0,1,1.0,1,1.0,1,0.12014104656834043,41
2561,0,5019,1928,3091,0,0,0,1.0,1,1.0,1,1.0,1,0.13534971034367396,43
2562,0,5019,1928,3091,0,0,0,1.0,1,1.0,1,1.0,1,0.1453089801494357,44
2563,2,5021,1929,3092,0,0,0,1.0,1,1.0,1,1.0,1,0.15645183758370357,44
2564,4,5025,1931,3094,0,0,0,1.0,1,1.0,1,1.0,1,0.1857151461399356,44
2565,0,5025,1931,3094,0,0,0,1.0,1,1.0,1,1.0,1,0.18088050767487612,45
2566,4,5029,1932,3097,0,0,0,1.0,1,1.0,1,1.0,1,0.1633556756115724,46
2567,4,5033,1933,3100,0,0,0,1.0,1,1.0,1,1.0,1,0.16882055022908818,48
2568,4,5037,1935,3102,0,0,0,1.0,1,1.0,1,1.0,1,0.19245954632829873,48
2569,2,5039,1935,3104,0,0,0,1.0,1,1.0,1,1.0,1,0.1905510488402031,49
2570,0,5039,1935,3104,0,0,0,1.0,1,1.0,1,1.0,1,0.20502254220004426,48
2571,3,5042,1935,3107,0,0,0,1.0,1,1.0,1,1.0,1,0.170843501254945,48
2572,3,5045,1935,3110,0,0,0,1.0,1,1.0,1,1.0,1,0.13235721849168672,49
2573,0,5045,1935,3110,0,0,0,1.0,1,1.0,1,1.0,1,0.1277148100876928,50
2574,1,5046,1936,3110,0,0,0,1.0,1,1.0,1,1.0,1,0.1562788117542446,49
2575,1,5047,1936,3111,0,0,0,1.0,1,1.0,1,1.0,1,0.1505300791605908,48
2576,0,5047,1936,3111,0,0,0,1.0,1,1.0,1,1.0,1,0.1505300791605908,48
2577,1,5048,1936,3112,0,0,0,1.0,1,1.0,1,1.0,1,0.16293393695255382,50
2578,1,5049,1936,3113,0,0,0,1.0,1,1.0,1,1.0,1,0.14824797103061044,50
2579,2,5051,1937,3114,0,0,0,1.0,1,1.0,1,1.0,1,0.13873855491295756,51
2580,2,5053,1937,3116,0,0,0,1.0,1,1.0,1,1.0,1,0.13972322935118622,52
2581,3,5056,1938,3118,0,0,0,1.0,1,1.0,1,1.0,1,0.14943596002657028,51
2582,1,5057,1939,3118,0,0,0,1.0,1,1.0,1,1.0,1,0.15971280243662245,51
2583,3,5060,1940,3120,0,0,0,1.0,1,1.0,1,1.0,1,0.14661771745768168,51
2584,6,5066,1943,3123,0,0,0,1.0,1,1.0,1,1.0,1,0.1313787207961589,51
2585,0,5066,1943,3123,0,0,0,1.0,1,1.0,1,1.0,1,0.11678346358894279,50
2586,6,5072,1947,3125,0,0,0,1.0,1,1.0,1,1.0,1,0.12038863710509584,50
2587,2,5074,1948,3126,0,0,0,1.0,1,1.0,1,1.0,1,0.0653268741792171,48
2588,2,5076,1950,3126,0,0,0,1.0,1,1.0,1,1.0,1,0.1250103832756517,50
2589,0,5076,1950,3126,0,0,0,1.0,1,1.0,1,1.0,1,0.09808447307969272,48
2590,2,5078,1950,3128,0,0,0,1.0,1,1.0,1,1.0,1,0.06758075907012631,47
2591,1,5079,1951,3128,0,0,0,1.0,1,1.0,1,1.0,1,0.0713953982965525,47
2592,3,5082,1952,3130,0,0,0,1.0,1,1.0,1,1.0,1,0.0704904492730722,47
2593,2,5084,1953,3131,0,0,0,1.0,1,1.0,1,1.0,1,0.0700480709092503,47
2594,3,5087,1955,3132,0,0,0,1.0,1,1.0,1,1.0,1,0.09550452573940853,49
2595,3,5090,1956,3134,0,0,0,1.0,1,1.0,1,1.0,1,0.09185144189128439,48
2596,5,5095,1959,3136,0,0,0,1.0,1,1.0,1,1.0,1,0.11778786165311253,47
2597,2,5097,1961,3136,0,0,0,1.0,1,1.0,1,1.0,1,0.11945881146315798,48
2598,3,5100,1961,3139,0,0,0,1.0,1,1.0,1,1.0,1,0.12299428240639929,48
2599,2,5102,1962,3140,0,0,0,1.0,1,1.0,1,1.0,1,0.09496536972485185,49
2600,2,5104,1963,3141,0,0,0,1.0,1,1.0,1,1.0,1,0.10718612959730907,52
2601,3,5107,1965,3142,0,0,0,1.0,1,1.0,1,1.0,1,0.15412741576479574,51
2602,1,5108,1965,3143,0,0,0,1.0,1,1.0,1,1.0,1,0.1234887293109065,52
2603,1,5109,1965,3144,0,0,0,1.0,1,1.0,1,1.0,1,0.13151047355970408,53
2604,0,5109,1965,3144,0,0,0,1.0,1,1.0,1,1.0,1,0.13151047355970408,53
2605,2,5111,1965,3146,0,0,0,1.0,1,1.0,1,1.0,1,0.14038205027461487,52
2606,2,5113,1965,3148,0,0,0,1.0,1,1.0,1,1.0,1,0.129474207563807,52
2607,0,5113,1965,3148,0,0,0,1.0,1,1.0,1,1.0,1,0.13059415651303494,52
2608,0,5113,1965,3148,0,0,0,1.0,1,1.0,1,1.0,1,0.13059415651303494,52
2609,1,5114,1965,3149,0,0,0,1.0,1,1.0,1,1.0,1,0.10792958399770942,53
2610,2,5116,1965,3151,0,0,0,1.0,1,1.0,1,1.0,1,0.09664308450246537,54
2611,3,5119,1967,3152,0,0,0,1.0,1,1.0,1,1.0,1,0.09043982087214461,54
2612,3,5122,1969,3153,0,0,0,1.0,1,1.0,1,1.0,1,0.10066305883308918,56
2613,3,5125,1972,3153,0,0,0,1.0,1,1.0,1,1.0,1,0.13989616851690723,56
2614,6,5131,1973,3158,0,0,0,1.0,1,1.0,1,1.0,1,0.07487375855778279,56
2615,2,5133,1974,3159,0,0,0,1.0,1,1.0,1,1.0,1,0.06319994693771419,57
2616,0,5133,1974,3159,0,0,0,1.0,1,1.0,1,1.0,1,0.06319994693771419,57
2617,2,5135,1975,3160,0,0,0,1.0,1,1.0,1,1.0,1,0.06270998881295078,58
2618,1,5136,1975,3161,0,0,0,1.0,1,1.0,1,1.0,1,0.05854327465437125,58
2619,0,5136,1975,3161,0,0,0,1.0,1,1.0,1,1.0,1,0.0866641300948238,58
2620,3,5139,1975,3164,0,0,0,1.0,1,1.0,1,1.0,1,0.05653078947022535,60
2621,0,5139,1975,3164,0,0,0,1.0,1,1.0,1,1.0,1,0.0654911109932133,59
2622,0,5139,1975,3164,0,0,0,1.0,1,1.0,1,1.0,1,0.07435667978733417,60
2623,4,5143,1976,3167,0,0,0,1.0,1,1.0,1,1.0,1,0.06469637366934906,59
2624,4,5147,1979,3168,0,0,0,1.0,1,1.0,1,1.0,1,0.11399606850006548,58
2625,5,5152,1981,3171,0,0,0,1.0,1,1.0,1,1.0,1,0.12464301228621377,58
2626,6,5158,1983,3175,0,0,0,1.0,1,1.0,1,1.0,1,0.11366191910330893,57
2627,1,5159,1983,3176,0,0,0,1.0,1,1.0,1,1.0,1,0.10351221698173603,55
2628,3,5162,1985,3177,0,0,0,1.0,1,1.0,1,1.0,1,0.11081406939393873,55
2629,1,5163,1985,3178,0,0,0,1.0,1,1.0,1,1.0,1,0.11695968736699935,54
2630,4,5167,1987,3180,0,0,0,1.0,1,1.0,1,1.0,1,0.13849274797297206,55
2631,0,5167,1987,3180,0,0,0,1.0,1,1.0,1,1.0,1,0.15115539877559633,55
2632,5,5172,1989,3183,0,0,0,1.0,1,1.0,1,1.0,1,0.1482475362415587,55
2633,2,5174,1990,3184,0,0,0,1.0,1,1.0,1,1.0,1,0.1422207516763579,53
2634,4,5178,1991,3187,0,0,0,1.0,1,1.0,1,1.0,1,0.0980521900279474,52
2635,0,5178,1991,3187,0,0,0,1.0,1,1.0,1,1.0,1,0.07416553870233371,52
2636,3,5181,1994,3187,0,0,0,1.0,1,1.0,1,1.0,1,0.15488009129232258,51
2637,1,5182,1995,3187,0,0,0,1.0,1,1.0,1,1.0,1,0.1209282145030305,50
2638,7,5189,1998,3191,0,0,0,1.0,1,1.0,1,1.0,1,0.10966389522042644,48
2639,2,5191,2000,3191,0,0,0,1.0,1,1.0,1,1.0,1,0.13736188352437437,48
2640,3,5194,2002,3192,0,0,0,1.0,1,1.0,1,1.0,1,0.14360299684242087,46
2641,5,5199,2005,3194,0,0,0,1.0,1,1.0,1,1.0,1,0.1721869382256382,46
2642,8,5207,2011,3196,0,0,0,1.0,1,1.0,1,1.0,1,0.15671896529365437,47
2643,0,5207,2011,3196,0,0,0,1.0,1,1.0,1,1.0,1,0.1576964864035125,45
2644,3,5210,2011,3199,0,0,0,1.0,1,1.0,1,1.0,1,0.09822382001257424,44
2645,2,5212,2012,3200,0,0,0,1.0,1,1.0,1,1.0,1,0.09156900535269047,42
2646,1,5213,2013,3200,0,0,0,1.0,1,1.0,1,1.0,1,0.12560405198662905,43
2647,1,5214,2013,3201,0,0,0,1.0,1,1.0,1,1.0,1,0.0914789818703974,40
2648,2,5216,2015,3201,0,0,0,1.0,1,1.0,1,1.0,1,0.04778426701443941,41
2649,3,5219,2016,3203,0,0,0,1.0,1,1.0,1,1.0,1,0.055899423579203626,43
2650,0,5219,2016,3203,0,0,0,1.0,1,1.0,1,1.0,1,0.09551732725394704,43
2651,0,5219,2016,3203,0,0,0,1.0,1,1.0,1,1.0,1,0.11008316415794711,44
2652,1,5220,2017,3203,0,0,0,1.0,1,1.0,1,1.0,1,0.11259987359124911,44
2653,2,5222,2017,3205,0,0,0,1.0,1,1.0,1,1.0,1,0.08469213399930212,44
2654,2,5224,2018,3206,0,0,0,1.0,1,1.0,1,1.0,1,0.11546433276721525,45
2655,1,5225,2019,3206,0,0,0,1.0,1,1.0,1,1.0,1,0.11527950022833577,45
2656,2,5227,2019,3208,0,0,0,1.0,1,1.0,1,1.0,1,0.08293048812358249,45
2657,1,5228,2019,3209,0,0,0,1.0,1,1.0,1,1.0,1,0.09565553243129485,45
2658,2,5230,2020,3210,0,0,0,1.0,1,1.0,1,1.0,1,0.09776478085180215,47
2659,1,5231,2020,3211,0,0,0,1.0,1,1.0,1,1.0,1,0.09707066671122941,46
2660,0,5231,2020,3211,0,0,0,1.0,1,1.0,1,1.0,1,0.09707066671122941,46
2661,0,5231,2020,3211,0,0,0,1.0,1,1.0,1,1.0,1,0.11590506243072919,46
2662,4,5235,2022,3213,0,0,0,1.0,1,1.0,1,1.0,1,0.10058856554726474,47
2663,5,5240,2023,3217,0,0,0,1.0,1,1.0,1,1.0,1,0.07536806458154822,46
2664,4,5244,2027,3217,0,0,0,1.0,1,1.0,1,1.0,1,0.15996867295349632,45
2665,6,5250,2029,3221,0,0,0,1.0,1,1.0,1,1.0,1,0.09760310698603576,47
2666,7,5257,2032,3225,0,0,0,1.0,1,1.0,1,1.0,1,0.13792204685362916,47
2667,3,5260,2033,3227,0,0,0,1.0,1,1.0,1,1.0,1,0.12997522349289434,45
2668,2,5262,2033,3229,0,0,0,1.0,1,1.0,1,1.0,1,0.06424918571813575,45
2669,2,5264,2034,3230,0,0,0,1.0,1,1.0,1,1.0,1,0.1188171553581086,45
2670,10,5274,2039,3235,0,0,0,1.0,1,1.0,1,1.0,1,0.11109047239817119,45
2671,4,5278,2041,3237,0,0,0,1.0,1,1.0,1,1.0,1,0.12079329769279368,41
2672,2,5280,2043,3237,0,0,0,1.0,1,1.0,1,1.0,1,0.1669207137690157,40
2673,4,5284,2044,3240,0,0,0,1.0,1,1.0,1,1.0,1,0.11467923809544042,39
2674,1,5285,2045,3240,0,0,0,1.0,1,1.0,1,1.0,1,0.14847186917054014,37
2675,1,5286,2046,3240,0,0,0,1.0,1,1.0,1,1.0,1,0.1631922587304905,35
2676,0,5286,2046,3240,0,0,0,1.0,1,1.0,1,1.0,1,0.17118840554102896,34
2677,0,5286,2046,3240,0,0,0,1.0,1,1.0,1,1.0,1,0.17286188640685857,32
2678,3,5289,2047,3242,0,0,0,1.0,1,1.0,1,1.0,1,0.15828732395933082,33
2679,1,5290,2048,3242,0,0,0,1.0,1,1.0,1,1.0,1,0.1924749841483987,33
2680,6,5296,2052,3244,0,0,0,1.0,1,1.0,1,1.0,1,0.25962844510704103,33
2681,4,5300,2053,3247,0,0,0,1.0,1,1.0,1,1.0,1,0.11388212402565777,32
2682,0,5300,2053,3247,0,0,0,1.0,1,1.0,1,1.0,1,0.11388212402565777,32
2683,3,5303,2054,3249,0,0,0,1.0,1,1.0,1,1.0,1,0.1526645839965931,32
2684,1,5304,2055,3249,0,0,0,1.0,1,1.0,1,1.0,1,0.16042166204087402,31
2685,2,5306,2056,3250,0,0,0,1.0,1,1.0,1,1.0,1,0.198084597816022,30
2686,1,5307,2056,3251,0,0,0,1.0,1,1.0,1,1.0,1,0.1669535398365407,29
2687,0,5307,2056,3251,0,0,0,1.0,1,1.0,1,1.0,1,0.17028915306377196,28
2688,1,5308,2056,3252,0,0,0,1.0,1,1.0,1,1.0,1,0.14600890991331864,28
2689,1,5309,2056,3253,0,0,0,1.0,1,1.0,1,1.0,1,0.16502372683120134,29
2690,1,5310,2057,3253,0,0,0,1.0,1,1.0,1,1.0,1,0.1941558507844162,29
2691,3,5313,2059,3254,0,0,0,1.0,1,1.0,1,1.0,1,0.17472711818967182,29
2692,3,5316,2059,3257,0,0,0,1.0,1,1.0,1,1.0,1,0.15382288274277076,31
2693,4,5320,2060,3260,0,0,0,1.0,1,1.0,1,1.0,1,0.17931139986367045,32
2694,1,5321,2060,3261,0,0,0,1.0,1,1.0,1,1.0,1,0.17053813893525915,32
2695,0,5321,2060,3261,0,0,0,1.0,1,1.0,1,1.0,1,0.15330432718336934,33
2696,2,5323,2061,3262,0,0,0,1.0,1,1.0,1,1.0,1,0.1617165766822235,33
2697,1,5324,2062,3262,0,0,0,1.0,1,1.0,1,1.0,1,0.154904621400822,34
2698,2,5326,2063,3263,0,0,0,1.0,1,1.0,1,1.0,1,0.13548566931713432,34
2699,1,5327,2063,3264,0,0,0,1.0,1,1.0,1,1.0,1,0.11161998641883504,36
2700,1,5328,2063,3265,0,0,0,1.0,1,1.0,1,1.0,1,0.12637010832199705,36
2701,1,5329,2063,3266,0,0,0,1.0,1,1.0,1,1.0,1,0.1061324789381181,36
2702,1,5330,2064,3266,0,0,0,1.0,1,1.0,1,1.0,1,0.1643721011655559,36
2703,4,5334,2066,3268,0,0,0,1.0,1,1.0,1,1.0,1,0.1733591361363974,38
2704,2,5336,2067,3269,0,0,0,1.0,1,1.0,1,1.0,1,0.1451059318743018,37
2705,4,5340,2068,3272,0,0,0,1.0,1,1.0,1,1.0,1,0.12961288508752686,36
2706,2,5342,2070,3272,0,0,0,1.0,1,1.0,1,1.0,1,0.20645428083937684,34
2707,5,5347,2070,3277,0,0,0,1.0,1,1.0,1,1.0,1,0.10279233346588083,36
2708,3,5350,2071,3279,0,0,0,1.0,1,1.0,1,1.0,1,0.10013127931306827,36
2709,1,5351,2072,3279,0,0,0,1.0,1,1.0,1,1.0,1,0.09672355359650661,33
2710,2,5353,2073,3280,0,0,0,1.0,1,1.0,1,1.0,1,0.13337530729679026,32
2711,0,5353,2073,3280,0,0,0,1.0,1,1.0,1,1.0,1,0.10765411859686755,29
2712,0,5353,2073,3280,0,0,0,1.0,1,1.0,1,1.0,1,0.1774816711075947,28
2713,0,5353,2073,3280,0,0,0,1.0,1,1.0,1,1.0,1,0.20262874913353376,28
2714,2,5355,2074,3281,0,0,0,1.0,1,1.0,1,1.0,1,0.30204673751527117,25
2715,2,5357,2075,3282,0,0,0,1.0,1,1.0,1,1.0,1,0.32336450504263325,24
2716,3,5360,2076,3284,0,0,0,1.0,1,1.0,1,1.0,1,0.2930273463395193,23
2717,2,5362,2077,3285,0,0,0,1.0,1,1.0,1,1.0,1,0.2602233744475774,24
2718,1,5363,2077,3286,0,0,0,1.0,1,1.0,1,1.0,1,0.2066481518270872,24
2719,2,5365,2077,3288,0,0,0,1.0,1,1.0,1,1.0,1,0.16741166192524315,25
2720,2,5367,2079,3288,0,0,0,1.0,1,1.0,1,1.0,1,0.17598202195365814,25
2721,1,5368,2080,3288,0,0,0,1.0,1,1.0,1,1.0,1,0.17752786350671357,26
2722,2,5370,2081,3289,0,0,0,1.0,1,1.0,1,1.0,1,0.2008054670286721,26
2723,2,5372,2082,3290,0,0,0,1.0,1,1.0,1,1.0,1,0.17189083741969993,26
2724,3,5375,2083,3292,0,0,0,1.0,1,1.0,1,1.0,1,0.1901739055792704,27
2725,3,5378,2084,3294,0,0,0,1.0,1,1.0,1,1.0,1,0.18971199388980325,27
2726,2,5380,2084,3296,0,0,0,1.0,1,1.0,1,1.0,1,0.12830806871386843,28
2727,1,5381,2084,3297,0,0,0,1.0,1,1.0,1,1.0,1,0.17912187281904057,29
2728,2,5383,2084,3299,0,0,0,1.0,1,1.0,1,1.0,1,0.08674067155752174,28
2729,0,5383,2084,3299,0,0,0,1.0,1,1.0,1,1.0,1,0.08674067155752174,28
2730,1,5384,2084,3300,0,0,0,1.0,1,1.0,1,1.0,1,0.10730186283696834,29
2731,0,5384,2084,3300,0,0,0,1.0,1,1.0,1,1.0,1,0.13108978815676545,30
2732,0,5384,2084,3300,0,0,0,1.0,1,1.0,1,1.0,1,0.1365077290642381,29
2733,0,5384,2084,3300,0,0,0,1.0,1,1.0,1,1.0,1,0.1365077290642381,29
2734,0,5384,2084,3300,0,0,0,1.0,1,1.0,1,1.0,1,0.1365077290642381,29
2735,2,5386,2086,3300,0,0,0,1.0,1,1.0,1,1.0,1,0.23394837425818138,29
2736,2,5388,2086,3302,0,0,0,1.0,1,1.0,1,1.0,1,0.2210159341566013,30
2737,2,5390,2086,3304,0,0,0,1.0,1,1.0,1,1.0,1,0.15382309153369914,30
2738,2,5392,2088,3304,0,0,0,1.0,1,1.0,1,1.0,1,0.23154326787335203,29
2739,0,5392,2088,3304,0,0,0,1.0,1,1.0,1,1.0,1,0.24020144861004827,30
2740,3,5395,2088,3307,0,0,0,1.0,1,1.0,1,1.0,1,0.15263584012736206,29
2741,0,5395,2088,3307,0,0,0,1.0,1,1.0,1,1.0,1,0.15263584012736206,29
2742,1,5396,2089,3307,0,0,0,1.0,1,1.0,1,1.0,1,0.16645762706057707,29
2743,3,5399,2089,3310,0,0,0,1.0,1,1.0,1,1.0,1,0.14726474771843587,30
2744,3,5402,2092,3310,0,0,0,1.0,1,1.0,1,1.0,1,0.2571193288046232,28
2745,1,5403,2092,3311,0,0,0,1.0,1,1.0,1,1.0,1,0.16072046877973278,27
2746,2,5405,2093,3312,0,0,0,1.0,1,1.0,1,1.0,1,0.21227946840977507,26
2747,1,5406,2094,3312,0,0,0,1.0,1,1.0,1,1.0,1,0.25006194473626986,22
2748,0,5406,2094,3312,0,0,0,1.0,1,1.0,1,1.0,1,0.24188896280513061,22
2749,3,5409,2094,3315,0,0,0,1.0,1,1.0,1,1.0,1,0.21350642044859064,20
2750,1,5410,2094,3316,0,0,0,1.0,1,1.0,1,1.0,1,0.20304874721931476,17
2751,0,5410,2094,3316,0,0,0,1.0,1,1.0,1,1.0,1,0.20304874721931476,17
2752,0,5410,2094,3316,0,0,0,1.0,1,1.0,1,1.0,1,0.22124217392567205,16
2753,0,5410,2094,3316,0,0,0,1.0,1,1.0,1,1.0,1,0.22124217392567205,16
2754,0,5410,2094,3316,0,0,0,1.0,1,1.0,1,1.0,1,0.22124217392567205,16
2755,1,5411,2095,3316,0,0,0,1.0,1,1.0,1,1.0,1,0.24077961233057296,16
2756,0,5411,2095,3316,0,0,0,1.0,1,1.0,1,1.0,1,0.2783883201067445,17
2757,1,5412,2096,3316,0,0,0,1.0,1,1.0,1,1.0,1,0.2849356462925803,18
2758,2,5414,2096,3318,0,0,0,1.0,1,1.0,1,1.0,1,0.21886010000743486,18
2759,0,5414,2096,3318,0,0,0,1.0,1,1.0,1,1.0,1,0.24878028762734786,19
2760,1,5415,2097,3318,0,0,0,1.0,1,1.0,1,1.0,1,0.28808577923919493,18
2761,1,5416,2097,3319,0,0,0,1.0,1,1.0,1,1.0,1,0.231049183376937,18
2762,0,5416,2097,3319,0,0,0,1.0,1,1.0,1,1.0,1,0.231049183376937,18
2763,1,5417,2097,3320,0,0,0,1.0,1,1.0,1,1.0,1,0.21424232261637027,18
2764,0,5417,2097,3320,0,0,0,1.0,1,1.0,1,1.0,1,0.21424232261637027,18
2765,0,5417,2097,3320,0,0,0,1.0,1,1.0,1,1.0,1,0.1886407923857306,18
2766,0,5417,2097,3320,0,0,0,1.0,1,1.0,1,1.0,1,0.1886407923857306,18
2767,0,5417,2097,3320,0,0,0,1.0,1,1.0,1,1.0,1,0.22927912446028004,17
2768,0,5417,2097,3320,0,0,0,1.0,1,1.0,1,1.0,1,0.22927912446028004,17
2769,1,5418,2098,3320,0,0,0,1.0,1,1.0,1,1.0,1,0.21351994184886344,17
2770,0,5418,2098,3320,0,0,0,1.0,1,1.0,1,1.0,1,0.21351994184886344,17
2771,0,5418,2098,3320,0,0,0,1.0,1,1.0,1,1.0,1,0.21351994184886344,17
2772,0,5418,2098,3320,0,0,0,1.0,1,1.0,1,1.0,1,0.21351994184886344,17
2773,1,5419,2099,3320,0,0,0,1.0,1,1.0,1,1.0,1,0.2175074189327635,17
2774,0,5419,2099,3320,0,0,0,1.0,1,1.0,1,1.0,1,0.1711862617399986,18
2775,1,5420,2100,3320,0,0,0,1.0,1,1.0,1,1.0,1,0.2125280175576336,20
2776,1,5421,2101,3320,0,0,0,1.0,1,1.0,1,1.0,1,0.23665197541861988,21
2777,0,5421,2101,3320,0,0,0,1.0,1,1.0,1,1.0,1,0.23665197541861988,21
2778,1,5422,2102,3320,0,0,0,1.0,1,1.0,1,1.0,1,0.3090491216340338,21
2779,3,5425,2103,3322,0,0,0,1.0,1,1.0,1,1.0,1,0.27495240016684314,22
2780,2,5427,2105,3322,0,0,0,1.0,1,1.0,1,1.0,1,0.3818306597771922,22
2781,4,5431,2106,3325,0,0,0,1.0,1,1.0,1,1.0,1,0.257906839636173,22
2782,3,5434,2108,3326,0,0,0,1.0,1,1.0,1,1.0,1,0.28793368825060683,23
2783,3,5437,2109,3328,0,0,0,1.0,1,1.0,1,1.0,1,0.18601260988749688,22
2784,0,5437,2109,3328,0,0,0,1.0,1,1.0,1,1.0,1,0.1764641337174411,21
2785,1,5438,2109,3329,0,0,0,1.0,1,1.0,1,1.0,1,0.2594382258115357,19
2786,1,5439,2110,3329,0,0,0,1.0,1,1.0,1,1.0,1,0.21773896887380875,19
2787,1,5440,2110,3330,0,0,0,1.0,1,1.0,1,1.0,1,0.28429219992536553,20
2788,2,5442,2112,3330,0,0,0,1.0,1,1.0,1,1.0,1,0.2689854715403172,20
2789,0,5442,2112,3330,0,0,0,1.0,1,1.0,1,1.0,1,0.31028995688714917,19
2790,0,5442,2112,3330,0,0,0,1.0,1,1.0,1,1.0,1,0.30077521564641346,20
2791,0,5442,2112,3330,0,0,0,1.0,1,1.0,1,1.0,1,0.30077521564641346,20
2792,1,5443,2112,3331,0,0,0,1.0,1,1.0,1,1.0,1,0.2551710416449476,20
2793,0,5443,2112,3331,0,0,0,1.0,1,1.0,1,1.0,1,0.259274821490977,19
2794,1,5444,2112,3332,0,0,0,1.0,1,1.0,1,1.0,1,0.2564289827375408,20
2795,2,5446,2112,3334,0,0,0,1.0,1,1.0,1,1.0,1,0.22643696486531883,21
2796,0,5446,2112,3334,0,0,0,1.0,1,1.0,1,1.0,1,0.21939901532714462,22
2797,0,5446,2112,3334,0,0,0,1.0,1,1.0,1,1.0,1,0.22080859394459806,21
2798,1,5447,2113,3334,0,0,0,1.0,1,1.0,1,1.0,1,0.2523974829716575,21
2799,0,5447,2113,3334,0,0,0,1.0,1,1.0,1,1.0,1,0.25903800602595467,20
2800,2,5449,2113,3336,0,0,0,1.0,1,1.0,1,1.0,1,0.1782083753727985,20
2801,0,5449,2113,3336,0,0,0,1.0,1,1.0,1,1.0,1,0.1782083753727985,20
2802,1,5450,2113,3337,0,0,0,1.0,1,1.0,1,1.0,1,0.13374231873269157,20
2803,0,5450,2113,3337,0,0,0,1.0,1,1.0,1,1.0,1,0.14398454045651393,21
2804,0,5450,2113,3337,0,0,0,1.0,1,1.0,1,1.0,1,0.14869122074125965,22
2805,1,5451,2114,3337,0,0,0,1.0,1,1.0,1,1.0,1,0.14287684892926608,22
2806,1,5452,2115,3337,0,0,0,1.0,1,1.0,1,1.0,1,0.18144444741536156,23
2807,2,5454,2116,3338,0,0,0,1.0,1,1.0,1,1.0,1,0.2512998968399041,24
2808,3,5457,2118,3339,0,0,0,1.0,1,1.0,1,1.0,1,0.26228017677402515,24
2809,3,5460,2118,3342,0,0,0,1.0,1,1.0,1,1.0,1,0.1211786747830258,26
2810,2,5462,2118,3344,0,0,0,1.0,1,1.0,1,1.0,1,0.12893616508847797,26
2811,2,5464,2118,3346,0,0,0,1.0,1,1.0,1,1.0,1,0.1605288135582905,27
2812,1,5465,2118,3347,0,0,0,1.0,1,1.0,1,1.0,1,0.12426943983643476,27
2813,0,5465,2118,3347,0,0,0,1.0,1,1.0,1,1.0,1,0.13966248804672377,28
2814,1,5466,2118,3348,0,0,0,1.0,1,1.0,1,1.0,1,0.13315875113167905,29
2815,1,5467,2118,3349,0,0,0,1.0,1,1.0,1,1.0,1,0.13410577948300792,30
2816,0,5467,2118,3349,0,0,0,1.0,1,1.0,1,1.0,1,0.1255305254153071,31
2817,0,5467,2118,3349,0,0,0,1.0,1,1.0,1,1.0,1,0.1255305254153071,31
2818,1,5468,2118,3350,0,0,0,1.0,1,1.0,1,1.0,1,0.10484885021400728,32
2819,0,5468,2118,3350,0,0,0,1.0,1,1.0,1,1.0,1,0.10484885021400728,32
2820,1,5469,2119,3350,0,0,0,1.0,1,1.0,1,1.0,1,0.11358226937205494,33
2821,0,5469,2119,3350,0,0,0,1.0,1,1.0,1,1.0,1,0.13567389893176435,34
2822,1,5470,2120,3350,0,0,0,1.0,1,1.0,1,1.0,1,0.12031352432700296,35
2823,1,5471,2121,3350,0,0,0,1.0,1,1.0,1,1.0,1,0.19821170298440616,31
2824,4,5475,2123,3352,0,0,0,1.0,1,1.0,1,1.0,1,0.2794497736939922,33
2825,0,5475,2123,3352,0,0,0,1.0,1,1.0,1,1.0,1,0.2410840777936861,31
2826,0,5475,2123,3352,0,0,0,1.0,1,1.0,1,1.0,1,0.2410840777936861,31
2827,4,5479,2124,3355,0,0,0,1.0,1,1.0,1,1.0,1,0.1706454902565723,32
2828,6,5485,2127,3358,0,0,0,1.0,1,1.0,1,1.0,1,0.19329874670519506,33
2829,3,5488,2129,3359,0,0,0,1.0,1,1.0,1,1.0,1,0.1785438423704154,33
2830,4,5492,2130,3362,0,0,0,1.0,1,1.0,1,1.0,1,0.1614121388188062,32
2831,2,5494,2131,3363,0,0,0,1.0,1,1.0,1,1.0,1,0.12161397343611877,31
2832,0,5494,2131,3363,0,0,0,1.0,1,1.0,1,1.0,1,0.10131813981341091,30
2833,0,5494,2131,3363,0,0,0,1.0,1,1.0,1,1.0,1,0.09314204890669037,29
2834,2,5496,2133,3363,0,0,0,1.0,1,1.0,1,1.0,1,0.21046249321000304,29
2835,4,5500,2135,3365,0,0,0,1.0,1,1.0,1,1.0,1,0.3028579054103221,27
2836,6,5506,2135,3371,0,0,0,1.0,1,1.0,1,1.0,1,0.1650152659711665,27
2837,2,5508,2135,3373,0,0,0,1.0,1,1.0,1,1.0,1,0.10241019415759711,28
2838,2,5510,2136,3374,0,0,0,1.0,1,1.0,1,1.0,1,0.2154334090336319,29
2839,2,5512,2136,3376,0,0,0,1.0,1,1.0,1,1.0,1,0.18136186077108127,29
2840,0,5512,2136,3376,0,0,0,1.0,1,1.0,1,1.0,1,0.18136186077108127,29
2841,2,5514,2136,3378,0,0,0,1.0,1,1.0,1,1.0,1,0.1436941308610826,31
2842,2,5516,2136,3380,0,0,0,1.0,1,1.0,1,1.0,1,0.10943476871444202,32
2843,0,5516,2136,3380,0,0,0,1.0,1,1.0,1,1.0,1,0.10943476871444202,32
2844,2,5518,2138,3380,0,0,0,1.0,1,1.0,1,1.0,1,0.1878806866610983,33
2845,4,5522,2139,3383,0,0,0,1.0,1,1.0,1,1.0,1,0.1526656609446779,34
2846,3,5525,2140,3385,0,0,0,1.0,1,1.0,1,1.0,1,0.13819993737074232,34
2847,0,5525,2140,3385,0,0,0,1.0,1,1.0,1,1.0,1,0.14598315090862887,35
2848,3,5528,2141,3387,0,0,0,1.0,1,1.0,1,1.0,1,0.16212340725652763,37
2849,1,5529,2141,3388,0,0,0,1.0,1,1.0,1,1.0,1,0.14372914820450156,37
2850,0,5529,2141,3388,0,0,0,1.0,1,1.0,1,1.0,1,0.14372914820450156,37
2851,3,5532,2141,3391,0,0,0,1.0,1,1.0,1,1.0,1,0.11006672655414,38
2852,0,5532,2141,3391,0,0,0,1.0,1,1.0,1,1.0,1,0.13469753608332488,36
2853,0,5532,2141,3391,0,0,0,1.0,1,1.0,1,1.0,1,0.17254501251887244,36
2854,1,5533,2141,3392,0,0,0,1.0,1,1.0,1,1.0,1,0.16592733872166324,37
2855,2,5535,2141,3394,0,0,0,1.0,1,1.0,1,1.0,1,0.15252680639053195,37
2856,1,5536,2141,3395,0,0,0,1.0,1,1.0,1,1.0,1,0.10986998509367188,38
2857,1,5537,2142,3395,0,0,0,1.0,1,1.0,1,1.0,1,0.16680690736896708,39
2858,1,5538,2142,3396,0,0,0,1.0,1,1.0,1,1.0,1,0.18035488424785429,39
2859,2,5540,2143,3397,0,0,0,1.0,1,1.0,1,1.0,1,0.13262142893957168,39
2860,3,5543,2144,3399,0,0,0,1.0,1,1.0,1,1.0,1,0.10812486494824357,40
2861,1,5544,2144,3400,0,0,0,1.0,1,1.0,1,1.0,1,0.06967273646608907,38
2862,5,5549,2149,3400,0,0,0,1.0,1,1.0,1,1.0,1,0.14128795668661423,38
2863,2,5551,2150,3401,0,0,0,1.0,1,1.0,1,1.0,1,0.10237595975303722,37
2864,6,5557,2154,3403,0,0,0,1.0,1,1.0,1,1.0,1,0.21280540192876515,35
2865,1,5558,2154,3404,0,0,0,1.0,1,1.0,1,1.0,1,0.23840429840344016,33
2866,7,5565,2156,3409,0,0,0,1.0,1,1.0,1,1.0,1,0.11431280529427738,31
2867,0,5565,2156,3409,0,0,0,1.0,1,1.0,1,1.0,1,0.13916345048773868,30
2868,2,5567,2158,3409,0,0,0,1.0,1,1.0,1,1.0,1,0.19350107194761354,31
2869,4,5571,2161,3410,0,0,0,1.0,1,1.0,1,1.0,1,0.2630174878305543,30
2870,0,5571,2161,3410,0,0,0,1.0,1,1.0,1,1.0,1,0.26508152610948094,26
2871,1,5572,2162,3410,0,0,0,1.0,1,1.0,1,1.0,1,0.3083289086726199,27
2872,0,5572,2162,3410,0,0,0,1.0,1,1.0,1,1.0,1,0.2865074722699363,25
2873,0,5572,2162,3410,0,0,0,1.0,1,1.0,1,1.0,1,0.2831338826354519,24
2874,1,5573,2162,3411,0,0,0,1.0,1,1.0,1,1.0,1,0.2334808345830717,25
2875,0,5573,2162,3411,0,0,0,1.0,1,1.0,1,1.0,1,0.2562113437132159,26
2876,2,5575,2163,3412,0,0,0,1.0,1,1.0,1,1.0,1,0.28673081288411434,28
2877,1,5576,2163,3413,0,0,0,1.0,1,1.0,1,1.0,1,0.246383280473325,29
2878,3,5579,2163,3416,0,0,0,1.0,1,1.0,1,1.0,1,0.15815471098743825,31
2879,0,5579,2163,3416,0,0,0,1.0,1,1.0,1,1.0,1,0.15815471098743825,31
2880,1,5580,2164,3416,0,0,0,1.0,1,1.0,1,1.0,1,0.1904626075828083,32
2881,3,5583,2164,3419,0,0,0,1.0,1,1.0,1,1.0,1,0.13481653624155288,31
2882,0,5583,2164,3419,0,0,0,1.0,1,1.0,1,1.0,1,0.13481653624155288,31
2883,0,5583,2164,3419,0,0,0,1.0,1,1.0,1,1.0,1,0.1794281652504739,32
2884,2,5585,2165,3420,0,0,0,1.0,1,1.0,1,1.0,1,0.19004035653481638,32
2885,4,5589,2165,3424,0,0,0,1.0,1,1.0,1,1.0,1,0.13361240958497855,33
2886,1,5590,2166,3424,0,0,0,1.0,1,1.0,1,1.0,1,0.1183638760558618,34
2887,2,5592,2166,3426,0,0,0,1.0,1,1.0,1,1.0,1,0.09203331272853753,34
2888,1,5593,2167,3426,0,0,0,1.0,1,1.0,1,1.0,1,0.0914326285313564,34
2889,3,5596,2169,3427,0,0,0,1.0,1,1.0,1,1.0,1,0.18524981976918625,37
2890,4,5600,2169,3431,0,0,0,1.0,1,1.0,1,1.0,1,0.11612485653478179,37
2891,1,5601,2170,3431,0,0,0,1.0,1,1.0,1,1.0,1,0.16526587174130697,37
2892,0,5601,2170,3431,0,0,0,1.0,1,1.0,1,1.0,1,0.16526587174130697,37
2893,2,5603,2171,3432,0,0,0,1.0,1,1.0,1,1.0,1,0.17837694416364713,38
2894,0,5603,2171,3432,0,0,0,1.0,1,1.0,1,1.0,1,0.18333825823677138,39
2895,6,5609,2172,3437,0,0,0,1.0,1,1.0,1,1.0,1,0.12343586107692538,40
2896,4,5613,2174,3439,0,0,0,1.0,1,1.0,1,1.0,1,0.12195127592358887,41
2897,0,5613,2174,3439,0,0,0,1.0,1,1.0,1,1.0,1,0.12195127592358887,41
2898,1,5614,2175,3439,0,0,0,1.0,1,1.0,1,1.0,1,0.1628247914403082,41
2899,2,5616,2176,3440,0,0,0,1.0,1,1.0,1,1.0,1,0.14470111411224612,39
2900,2,5618,2178,3440,0,0,0,1.0,1,1.0,1,1.0,1,0.2320964332062081,40
2901,1,5619,2178,3441,0,0,0,1.0,1,1.0,1,1.0,1,0.1962746736414551,40
2902,2,5621,2180,3441,0,0,0,1.0,1,1.0,1,1.0,1,0.22251146650972167,38
2903,0,5621,2180,3441,0,0,0,1.0,1,1.0,1,1.0,1,0.18197431033686826,36
2904,2,5623,2182,3441,0,0,0,1.0,1,1.0,1,1.0,1,0.20534514687521133,36
2905,2,5625,2182,3443,0,0,0,1.0,1,1.0,1,1.0,1,0.14421186962120947,35
2906,0,5625,2182,3443,0,0,0,1.0,1,1.0,1,1.0,1,0.16330730818692146,36
2907,1,5626,2183,3443,0,0,0,1.0,1,1.0,1,1.0,1,0.19470764775794613,37
2908,2,5628,2184,3444,0,0,0,1.0,1,1.0,1,1.0,1,0.21715584686209383,38
2909,1,5629,2185,3444,0,0,0,1.0,1,1.0,1,1.0,1,0.24218586315041396,37
2910,1,5630,2186,3444,0,0,0,1.0,1,1.0,1,1.0,1,0.2555571165976625,37
2911,6,5636,2186,3450,0,0,0,1.0,1,1.0,1,1.0,1,0.20828738850029277,36
2912,4,5640,2188,3452,0,0,0,1.0,1,1.0,1,1.0,1,0.27336221325114984,36
2913,4,5644,2189,3455,0,0,0,1.0,1,1.0,1,1.0,1,0.16324401071085914,36
2914,0,5644,2189,3455,0,0,0,1.0,1,1.0,1,1.0,1,0.17644632717968575,38
2915,0,5644,2189,3455,0,0,0,1.0,1,1.0,1,1.0,1,0.1610466546669108,37
2916,2,5646,2189,3457,0,0,0,1.0,1,1.0,1,1.0,1,0.1560076662588266,39
2917,4,5650,2191,3459,0,0,0,1.0,1,1.0,1,1.0,1,0.1192035790337426,40
2918,3,5653,2193,3460,0,0,0,1.0,1,1.0,1,1.0,1,0.17840283123042058,40
2919,2,5655,2194,3461,0,0,0,1.0,1,1.0,1,1.0,1,0.1544351426515358,42
2920,3,5658,2194,3464,0,0,0,1.0,1,1.0,1,1.0,1,0.09165937947931638,42
2921,0,5658,2194,3464,0,0,0,1.0,1,1.0,1,1.0,1,0.09165937947931638,42
2922,0,5658,2194,3464,0,0,0,1.0,1,1.0,1,1.0,1,0.06688319279461817,43
2923,0,5658,2194,3464,0,0,0,1.0,1,1.0,1,1.0,1,0.08740391911979813,45
2924,1,5659,2195,3464,0,0,0,1.0,1,1.0,1,1.0,1,0.09167715234437311,46
2925,0,5659,2195,3464,0,0,0,1.0,1,1.0,1,1.0,1,0.09167715234437311,46
2926,0,5659,2195,3464,0,0,0,1.0,1,1.0,1,1.0,1,0.09167715234437311,46
2927,2,5661,2196,3465,0,0,0,1.0,1,1.0,1,1.0,1,0.10411651036563777,48
2928,2,5663,2198,3465,0,0,0,1.0,1,1.0,1,1.0,1,0.15336099861113442,48
2929,4,5667,2198,3469,0,0,0,1.0,1,1.0,1,1.0,1,0.0774213406994411,48
2930,1,5668,2198,3470,0,0,0,1.0,1,1.0,1,1.0,1,0.08441386653630024,50
2931,1,5669,2199,3470,0,0,0,1.0,1,1.0,1,1.0,1,0.10363967279693136,51
2932,3,5672,2200,3472,0,0,0,1.0,1,1.0,1,1.0,1,0.11364925141893194,52
2933,0,5672,2200,3472,0,0,0,1.0,1,1.0,1,1.0,1,0.1205363900647308,53
2934,3,5675,2201,3474,0,0,0,1.0,1,1.0,1,1.0,1,0.16838491648902817,54
2935,1,5676,2201,3475,0,0,0,1.0,1,1.0,1,1.0,1,0.15459529616863354,53
2936,1,5677,2202,3475,0,0,0,1.0,1,1.0,1,1.0,1,0.1571751457012095,53
2937,1,5678,2203,3475,0,0,0,1.0,1,1.0,1,1.0,1,0.18257728356641761,51
2938,6,5684,2204,3480,0,0,0,1.0,1,1.0,1,1.0,1,0.1878916058126088,53
2939,1,5685,2205,3480,0,0,0,1.0,1,1.0,1,1.0,1,0.19163465626488485,52
2940,3,5688,2206,3482,0,0,0,1.0,1,1.0,1,1.0,1,0.18094472287528865,52
2941,3,5691,2206,3485,0,0,0,1.0,1,1.0,1,1.0,1,0.17041746866557195,50
2942,2,5693,2207,3486,0,0,0,1.0,1,1.0,1,1.0,1,0.18923515833588436,50
2943,1,5694,2208,3486,0,0,0,1.0,1,1.0,1,1.0,1,0.18256221478299545,49
2944,3,5697,2208,3489,0,0,0,1.0,1,1.0,1,1.0,1,0.12778168750457594,48
2945,2,5699,2209,3490,0,0,0,1.0,1,1.0,1,1.0,1,0.14174776084592342,48
2946,5,5704,2212,3492,0,0,0,1.0,1,1.0,1,1.0,1,0.12982860975999663,47
2947,3,5707,2212,3495,0,0,0,1.0,1,1.0,1,1.0,1,0.05683437192906434,47
2948,2,5709,2213,3496,0,0,0,1.0,1,1.0,1,1.0,1,0.09529677128436773,48
2949,1,5710,2213,3497,0,0,0,1.0,1,1.0,1,1.0,1,0.08506244344639163,48
2950,0,5710,2213,3497,0,0,0,1.0,1,1.0,1,1.0,1,0.08506244344639163,48
2951,1,5711,2214,3497,0,0,0,1.0,1,1.0,1,1.0,1,0.1287051687252902,50
2952,1,5712,2214,3498,0,0,0,1.0,1,1.0,1,1.0,1,0.105410606935233,50
2953,1,5713,2214,3499,0,0,0,1.0,1,1.0,1,1.0,1,0.10579676617938852,51
2954,1,5714,2214,3500,0,0,0,1.0,1,1.0,1,1.0,1,0.10026242449551474,51
2955,1,5715,2215,3500,0,0,0,1.0,1,1.0,1,1.0,1,0.10831641558428733,51
2956,0,5715,2215,3500,0,0,0,1.0,1,1.0,1,1.0,1,0.10831641558428733,51
2957,0,5715,2215,3500,0,0,0,1.0,1,1.0,1,1.0,1,0.1178682374217544,52
2958,0,5715,2215,3500,0,0,0,1.0,1,1.0,1,1.0,1,0.1178682374217544,52
2959,2,5717,2216,3501,0,0,0,1.0,1,1.0,1,1.0,1,0.1272258204133924,53
2960,0,5717,2216,3501,0,0,0,1.0,1,1.0,1,1.0,1,0.11507165752858235,52
2961,1,5718,2216,3502,0,0,0,1.0,1,1.0,1,1.0,1,0.10488152662856184,53
2962,2,5720,2216,3504,0,0,0,1.0,1,1.0,1,1.0,1,0.08915446337358891,54
2963,6,5726,2219,3507,0,0,0,1.0,1,1.0,1,1.0,1,0.1127547423409533,55
2964,0,5726,2219,3507,0,0,0,1.0,1,1.0,1,1.0,1,0.1342075235591623,55
2965,2,5728,2219,3509,0,0,0,1.0,1,1.0,1,1.0,1,0.1144235826789592,55
2966,0,5728,2219,3509,0,0,0,1.0,1,1.0,1,1.0,1,0.1144235826789592,55
2967,4,5732,2219,3513,0,0,0,1.0,1,1.0,1,1.0,1,0.10665647757505546,56
2968,1,5733,2219,3514,0,0,0,1.0,1,1.0,1,1.0,1,0.09425728440779013,56
2969,1,5734,2220,3514,0,0,0,1.0,1,1.0,1,1.0,1,0.12051234870786683,55
2970,2,5736,2221,3515,0,0,0,1.0,1,1.0,1,1.0,1,0.1212419354191945,57
2971,1,5737,2221,3516,0,0,0,1.0,1,1.0,1,1.0,1,0.1269712313134894,56
2972,2,5739,2222,3517,0,0,0,1.0,1,1.0,1,1.0,1,0.1271524936199301,57
2973,2,5741,2223,3518,0,0,0,1.0,1,1.0,1,1.0,1,0.14390086319547507,59
2974,1,5742,2223,3519,0,0,0,1.0,1,1.0,1,1.0,1,0.1273583831405715,60
2975,3,5745,2225,3520,0,0,0,1.0,1,1.0,1,1.0,1,0.1207048520699069,58
2976,4,5749,2227,3522,0,0,0,1.0,1,1.0,1,1.0,1,0.13420042133064322,59
2977,6,5755,2228,3527,0,0,0,1.0,1,1.0,1,1.0,1,0.08765949332788008,59
2978,2,5757,2229,3528,0,0,0,1.0,1,1.0,1,1.0,1,0.09022307779119634,58
2979,2,5759,2230,3529,0,0,0,1.0,1,1.0,1,1.0,1,0.09761422037379223,57
2980,0,5759,2230,3529,0,0,0,1.0,1,1.0,1,1.0,1,0.10674191152694788,56
2981,1,5760,2231,3529,0,0,0,1.0,1,1.0,1,1.0,1,0.13387726054655807,56
2982,1,5761,2232,3529,0,0,0,1.0,1,1.0,1,1.0,1,0.14621295306136964,57
2983,5,5766,2235,3531,0,0,0,1.0,1,1.0,1,1.0,1,0.17101389814402498,57
2984,2,5768,2237,3531,0,0,0,1.0,1,1.0,1,1.0,1,0.1748806454720202,56
2985,4,5772,2238,3534,0,0,0,1.0,1,1.0,1,1.0,1,0.1771696865030488,55
2986,11,5783,2241,3542,0,0,0,1.0,1,1.0,1,1.0,1,0.083049692049028,55
2987,1,5784,2242,3542,0,0,0,1.0,1,1.0,1,1.0,1,0.0978616674582423,51
2988,2,5786,2242,3544,0,0,0,1.0,1,1.0,1,1.0,1,0.10367107737513699,52
2989,1,5787,2242,3545,0,0,0,1.0,1,1.0,1,1.0,1,0.08780101635508362,50
2990,2,5789,2243,3546,0,0,0,1.0,1,1.0,1,1.0,1,0.11418785976784797,50
2991,1,5790,2243,3547,0,0,0,1.0,1,1.0,1,1.0,1,0.08313072443911776,50
2992,2,5792,2244,3548,0,0,0,1.0,1,1.0,1,1.0,1,0.07094845461744165,50
2993,0,5792,2244,3548,0,0,0,1.0,1,1.0,1,1.0,1,0.09726085953769777,51
2994,1,5793,2245,3548,0,0,0,1.0,1,1.0,1,1.0,1,0.12382160611817783,51
2995,2,5795,2245,3550,0,0,0,1.0,1,1.0,1,1.0,1,0.09956089094522322,51
2996,2,5797,2246,3551,0,0,0,1.0,1,1.0,1,1.0,1,0.10885388377256018,52
2997,2,5799,2246,3553,0,0,0,1.0,1,1.0,1,1.0,1,0.11336421782140164,52
2998,3,5802,2247,3555,0,0,0,1.0,1,1.0,1,1.0,1,0.12777269181427134,51
2999,1,5803,2247,3556,0,0,0,1.0,1,1.0,1,1.0,1,0.12319211080115386,51
3000,2,5805,2248,3557,0,0,0,1.0,1,1.0,1,1.0,1,0.10998115039171263,52
3001,1,5806,2248,3558,0,0,0,1.0,1,1.0,1,1.0,1,0.09134804888410052,52
3002,2,5808,2249,3559,0,0,0,1.0,1,1.0,1,1.0,1,0.12866181327249687,53
3003,0,5808,2249,3559,0,0,0,1.0,1,1.0,1,1.0,1,0.1186938604207034,54
3004,0,5808,2249,3559,0,0,0,1.0,1,1.0,1,1.0,1,0.1271499609840642,55
3005,1,5809,2249,3560,0,0,0,1.0,1,1.0,1,1.0,1,0.1385165152621746,56
3006,0,5809,2249,3560,0,0,0,1.0,1,1.0,1,1.0,1,0.14056971757976439,57
3007,1,5810,2249,3561,0,0,0,1.0,1,1.0,1,1.0,1,0.1334963791633132,58
3008,3,5813,2252,3561,0,0,0,1.0,1,1.0,1,1.0,1,0.15719557262323308,59
3009,1,5814,2252,3562,0,0,0,1.0,1,1.0,1,1.0,1,0.15441814114714428,59
3010,3,5817,2252,3565,0,0,0,1.0,1,1.0,1,1.0,1,0.09397514325470463,59
3011,0,5817,2252,3565,0,0,0,1.0,1,1.0,1,1.0,1,0.09397514325470463,59
3012,2,5819,2254,3565,0,0,0,1.0,1,1.0,1,1.0,1,0.13713420743878355,61
3013,3,5822,2255,3567,0,0,0,1.0,1,1.0,1,1.0,1,0.1347107990036518,59
3014,0,5822,2255,3567,0,0,0,1.0,1,1.0,1,1.0,1,0.14459270106591288,60
3015,2,5824,2256,3568,0,0,0,1.0,1,1.0,1,1.0,1,0.1711725925038294,58
3016,3,5827,2256,3571,0,0,0,1.0,1,1.0,1,1.0,1,0.1531362941417063,57
3017,1,5828,2257,3571,0,0,0,1.0,1,1.0,1,1.0,1,0.14660028127760788,58
3018,1,5829,2258,3571,0,0,0,1.0,1,1.0,1,1.0,1,0.16917365067718865,55
3019,4,5833,2259,3574,0,0,0,1.0,1,1.0,1,1.0,1,0.14565488321116923,56
3020,4,5837,2260,3577,0,0,0,1.0,1,1.0,1,1.0,1,0.19278080292385777,55
3021,4,5841,2262,3579,0,0,0,1.0,1,1.0,1,1.0,1,0.19083612368003297,55
3022,3,5844,2263,3581,0,0,0,1.0,1,1.0,1,1.0,1,0.17745461866145398,55
3023,0,5844,2263,3581,0,0,0,1.0,1,1.0,1,1.0,1,0.17346606057084077,54
3024,3,5847,2263,3584,0,0,0,1.0,1,1.0,1,1.0,1,0.1383482554293427,54
3025,4,5851,2266,3585,0,0,0,1.0,1,1.0,1,1.0,1,0.13755283524713438,54
3026,1,5852,2266,3586,0,0,0,1.0,1,1.0,1,1.0,1,0.1240852572397459,53
3027,3,5855,2267,3588,0,0,0,1.0,1,1.0,1,1.0,1,0.08579224734343235,53
3028,5,5860,2269,3591,0,0,0,1.0,1,1.0,1,1.0,1,0.06445062385957134,51
3029,2,5862,2269,3593,0,0,0,1.0,1,1.0,1,1.0,1,0.06200529640613902,51
3030,5,5867,2272,3595,0,0,0,1.0,1,1.0,1,1.0,1,0.10816566298728823,52
3031,2,5869,2273,3596,0,0,0,1.0,1,1.0,1,1.0,1,0.07307517863928294,51
3032,0,5869,2273,3596,0,0,0,1.0,1,1.0,1,1.0,1,0.06109620307005796,50
3033,1,5870,2274,3596,0,0,0,1.0,1,1.0,1,1.0,1,0.08583994075218622,52
3034,1,5871,2274,3597,0,0,0,1.0,1,1.0,1,1.0,1,0.05431494706173332,51
3035,1,5872,2274,3598,0,0,0,1.0,1,1.0,1,1.0,1,0.047984706976659165,51
3036,0,5872,2274,3598,0,0,0,1.0,1,1.0,1,1.0,1,0.06151576783801282,53
3037,0,5872,2274,3598,0,0,0,1.0,1,1.0,1,1.0,1,0.065168050144954,52
3038,1,5873,2275,3598,0,0,0,1.0,1,1.0,1,1.0,1,0.0740962169871988,52
3039,2,5875,2276,3599,0,0,0,1.0,1,1.0,1,1.0,1,0.10122041280906875,54
3040,1,5876,2276,3600,0,0,0,1.0,1,1.0,1,1.0,1,0.08288851208210252,55
3041,2,5878,2276,3602,0,0,0,1.0,1,1.0,1,1.0,1,0.06831828999198224,56
3042,3,5881,2278,3603,0,0,0,1.0,1,1.0,1,1.0,1,0.09139776528597564,56
3043,3,5884,2279,3605,0,0,0,1.0,1,1.0,1,1.0,1,0.09273243292908945,57
3044,4,5888,2281,3607,0,0,0,1.0,1,1.0,1,1.0,1,0.09095711824958769,57
3045,3,5891,2281,3610,0,0,0,1.0,1,1.0,1,1.0,1,0.11596539724423352,56
3046,4,5895,2282,3613,0,0,0,1.0,1,1.0,1,1.0,1,0.07451230759197819,57
3047,0,5895,2282,3613,0,0,0,1.0,1,1.0,1,1.0,1,0.08894672070654737,56
3048,5,5900,2283,3617,0,0,0,1.0,1,1.0,1,1.0,1,0.06413545260515323,58
3049,2,5902,2283,3619,0,0,0,1.0,1,1.0,1,1.0,1,0.07234943328340299,59
3050,1,5903,2284,3619,0,0,0,1.0,1,1.0,1,1.0,1,0.0618547688436163,60
3051,1,5904,2285,3619,0,0,0,1.0,1,1.0,1,1.0,1,0.10211679871812417,59
3052,4,5908,2285,3623,0,0,0,1.0,1,1.0,1,1.0,1,0.08355052371341896,58
3053,1,5909,2286,3623,0,0,0,1.0,1,1.0,1,1.0,1,0.11240633141996659,57
3054,5,5914,2289,3625,0,0,0,1.0,1,1.0,1,1.0,1,0.1684336575848895,55
3055,6,5920,2292,3628,0,0,0,1.0,1,1.0,1,1.0,1,0.16323747468397373,54
3056,5,5925,2294,3631,0,0,0,1.0,1,1.0,1,1.0,1,0.1846270151340228,55
3057,0,5925,2294,3631,0,0,0,1.0,1,1.0,1,1.0,1,0.2102189618862467,54
3058,6,5931,2294,3637,0,0,0,1.0,1,1.0,1,1.0,1,0.19933651401620703,55
3059,0,5931,2294,3637,0,0,0,1.0,1,1.0,1,1.0,1,0.19215534116857919,56
3060,0,5931,2294,3637,0,0,0,1.0,1,1.0,1,1.0,1,0.19215534116857919,56
3061,1,5932,2294,3638,0,0,0,1.0,1,1.0,1,1.0,1,0.18425650296246884,56
3062,5,5937,2297,3640,0,0,0,1.0,1,1.0,1,1.0,1,0.20820378431918513,57
3063,1,5938,2298,3640,0,0,0,1.0,1,1.0,1,1.0,1,0.18424396614220048,55
3064,6,5944,2300,3644,0,0,0,1.0,1,1.0,1,1.0,1,0.17201360553614084,56
3065,2,5946,2300,3646,0,0,0,1.0,1,1.0,1,1.0,1,0.14812857004427402,55
3066,2,5948,2301,3647,0,0,0,1.0,1,1.0,1,1.0,1,0.1512727272613908,55
3067,4,5952,2302,3650,0,0,0,1.0,1,1.0,1,1.0,1,0.13140455361580247,54
3068,4,5956,2303,3653,0,0,0,1.0,1,1.0,1,1.0,1,0.11575655688744003,53
3069,2,5958,2305,3653,0,0,0,1.0,1,1.0,1,1.0,1,0.13485994094784842,51
3070,1,5959,2305,3654,0,0,0,1.0,1,1.0,1,1.0,1,0.11530006972204354,50
3071,2,5961,2306,3655,0,0,0,1.0,1,1.0,1,1.0,1,0.08110022333081339,51
3072,1,5962,2306,3656,0,0,0,1.0,1,1.0,1,1.0,1,0.08546667490076804,53
3073,1,5963,2306,3657,0,0,0,1.0,1,1.0,1,1.0,1,0.07056648928342814,51
3074,0,5963,2306,3657,0,0,0,1.0,1,1.0,1,1.0,1,0.06676318644988051,50
3075,2,5965,2307,3658,0,0,0,1.0,1,1.0,1,1.0,1,0.10906724342046259,52
3076,3,5968,2308,3660,0,0,0,1.0,1,1.0,1,1.0,1,0.14166378453732276,53
3077,1,5969,2308,3661,0,0,0,1.0,1,1.0,1,1.0,1,0.11703557699155563,52
3078,0,5969,2308,3661,0,0,0,1.0,1,1.0,1,1.0,1,0.14514409651327373,53
3079,7,5976,2309,3667,0,0,0,1.0,1,1.0,1,1.0,1,0.09923565326810442,53
3080,3,5979,2310,3669,0,0,0,1.0,1,1.0,1,1.0,1,0.146070291729365,52
3081,2,5981,2311,3670,0,0,0,1.0,1,1.0,1,1.0,1,0.1646716395253788,54
3082,7,5988,2315,3673,0,0,0,1.0,1,1.0,1,1.0,1,0.18365415060493784,54
3083,1,5989,2315,3674,0,0,0,1.0,1,1.0,1,1.0,1,0.17523986099822564,54
3084,0,5989,2315,3674,0,0,0,1.0,1,1.0,1,1.0,1,0.17294216815532787,55
3085,1,5990,2315,3675,0,0,0,1.0,1,1.0,1,1.0,1,0.161287321897763,55
3086,2,5992,2315,3677,0,0,0,1.0,1,1.0,1,1.0,1,0.1372522803669227,56
3087,1,5993,2316,3677,0,0,0,1.0,1,1.0,1,1.0,1,0.16768567813470303,57
3088,1,5994,2316,3678,0,0,0,1.0,1,1.0,1,1.0,1,0.17239357952985265,56
3089,1,5995,2317,3678,0,0,0,1.0,1,1.0,1,1.0,1,0.22331913474293041,55
3090,1,5996,2317,3679,0,0,0,1.0,1,1.0,1,1.0,1,0.23856139133669366,54
3091,2,5998,2317,3681,0,0,0,1.0,1,1.0,1,1.0,1,0.2382825515493193,53
3092,2,6000,2317,3683,0,0,0,1.0,1,1.0,1,1.0,1,0.20758295915808428,56
3093,0,6000,2317,3683,0,0,0,1.0,1,1.0,1,1.0,1,0.20758295915808428,56
3094,3,6003,2317,3686,0,0,0,1.0,1,1.0,1,1.0,1,0.20204189689384192,58
3095,4,6007,2317,3690,0,0,0,1.0,1,1.0,1,1.0,1,0.16701026425690887,59
3096,0,6007,2317,3690,0,0,0,1.0,1,1.0,1,1.0,1,0.17537886250793477,60
3097,1,6008,2317,3691,0,0,0,1.0,1,1.0,1,1.0,1,0.1899062761566536,60
3098,0,6008,2317,3691,0,0,0,1.0,1,1.0,1,1.0,1,0.21181392643846822,58
3099,0,6008,2317,3691,0,0,0,1.0,1,1.0,1,1.0,1,0.22376136876731664,57
3100,1,6009,2317,3692,0,0,0,1.0,1,1.0,1,1.0,1,0.2163393871721851,57
3101,1,6010,2318,3692,0,0,0,1.0,1,1.0,1,1.0,1,0.19643478287410443,58
3102,4,6014,2320,3694,0,0,0,1.0,1,1.0,1,1.0,1,0.2211142437313817,59
3103,5,6019,2321,3698,0,0,0,1.0,1,1.0,1,1.0,1,0.1680572084926378,58
3104,5,6024,2323,3701,0,0,0,1.0,1,1.0,1,1.0,1,0.13004312525502235,58
3105,2,6026,2324,3702,0,0,0,1.0,1,1.0,1,1.0,1,0.10818805542452704,56
3106,5,6031,2327,3704,0,0,0,1.0,1,1.0,1,1.0,1,0.13594736046265776,57
3107,6,6037,2330,3707,0,0,0,1.0,1,1.0,1,1.0,1,0.08975861974993316,55
3108,2,6039,2332,3707,0,0,0,1.0,1,1.0,1,1.0,1,0.14235998348228163,55
3109,4,6043,2334,3709,0,0,0,1.0,1,1.0,1,1.0,1,0.1390537363850001,54
3110,5,6048,2336,3712,0,0,0,1.0,1,1.0,1,1.0,1,0.11714503996604311,54
3111,5,6053,2338,3715,0,0,0,1.0,1,1.0,1,1.0,1,0.16399127831567809,54
3112,11,6064,2343,3721,0,0,0,1.0,1,1.0,1,1.0,1,0.16253196112900548,56
3113,3,6067,2344,3723,0,0,0,1.0,1,1.0,1,1.0,1,0.13458130173114025,55
3114,0,6067,2344,3723,0,0,0,1.0,1,1.0,1,1.0,1,0.1160688061109702,54
3115,1,6068,2344,3724,0,0,0,1.0,1,1.0,1,1.0,1,0.08854032346155818,56
3116,4,6072,2345,3727,0,0,0,1.0,1,1.0,1,1.0,1,0.08271231937257217,56
3117,4,6076,2345,3731,0,0,0,1.0,1,1.0,1,1.0,1,0.07733496072882692,58
3118,2,6078,2346,3732,0,0,0,1.0,1,1.0,1,1.0,1,0.07065814883232083,57
3119,1,6079,2346,3733,0,0,0,1.0,1,1.0,1,1.0,1,0.06964625453023787,57
3120,0,6079,2346,3733,0,0,0,1.0,1,1.0,1,1.0,1,0.07753822637808876,56
3121,2,6081,2346,3735,0,0,0,1.0,1,1.0,1,1.0,1,0.060346743770264326,57
3122,1,6082,2346,3736,0,0,0,1.0,1,1.0,1,1.0,1,0.044239472617862506,57
3123,0,6082,2346,3736,0,0,0,1.0,1,1.0,1,1.0,1,0.044239472617862506,57
3124,0,6082,2346,3736,0,0,0,1.0,1,1.0,1,1.0,1,0.044694220361163675,59
3125,3,6085,2347,3738,0,0,0,1.0,1,1.0,1,1.0,1,0.0767345345996508,61
3126,5,6090,2348,3742,0,0,0,1.0,1,1.0,1,1.0,1,0.07115145067640297,60
3127,3,6093,2349,3744,0,0,0,1.0,1,1.0,1,1.0,1,0.0765473065446157,58
3128,3,6096,2350,3746,0,0,0,1.0,1,1.0,1,1.0,1,0.1284706667062578,58
3129,3,6099,2351,3748,0,0,0,1.0,1,1.0,1,1.0,1,0.16660085997610188,56
3130,8,6107,2351,3756,0,0,0,1.0,1,1.0,1,1.0,1,0.07982506968084045,56
3131,1,6108,2351,3757,0,0,0,1.0,1,1.0,1,1.0,1,0.07584098346438173,55
3132,3,6111,2352,3759,0,0,0,1.0,1,1.0,1,1.0,1,0.12053480400641689,53
3133,9,6120,2352,3768,0,0,0,1.0,1,1.0,1,1.0,1,0.1343477436598475,52
3134,1,6121,2352,3769,0,0,0,1.0,1,1.0,1,1.0,1,0.1450093201748741,52
3135,3,6124,2352,3772,0,0,0,1.0,1,1.0,1,1.0,1,0.10520850578885409,53
3136,6,6130,2353,3777,0,0,0,1.0,1,1.0,1,1.0,1,0.0962988078508115,54
3137,2,6132,2354,3778,0,0,0,1.0,1,1.0,1,1.0,1,0.11181620779297176,55
3138,12,6144,2356,3788,0,0,0,1.0,1,1.0,1,1.0,1,0.10430506542569713,57
3139,3,6147,2357,3790,0,0,0,1.0,1,1.0,1,1.0,1,0.08827675768951648,56
3140,3,6150,2357,3793,0,0,0,1.0,1,1.0,1,1.0,1,0.09245760153615155,56
3141,1,6151,2357,3794,0,0,0,1.0,1,1.0,1,1.0,1,0.08782505015637151,56
3142,1,6152,2358,3794,0,0,0,1.0,1,1.0,1,1.0,1,0.10259268206347374,56
3143,3,6155,2360,3795,0,0,0,1.0,1,1.0,1,1.0,1,0.12099579614286833,56
3144,1,6156,2361,3795,0,0,0,1.0,1,1.0,1,1.0,1,0.11730611886939082,54
3145,6,6162,2362,3800,0,0,0,1.0,1,1.0,1,1.0,1,0.08142365454651447,55
3146,0,6162,2362,3800,0,0,0,1.0,1,1.0,1,1.0,1,0.10142969123590496,53
3147,0,6162,2362,3800,0,0,0,1.0,1,1.0,1,1.0,1,0.11693898934577493,54
3148,3,6165,2363,3802,0,0,0,1.0,1,1.0,1,1.0,1,0.09174885514020498,54
3149,1,6166,2364,3802,0,0,0,1.0,1,1.0,1,1.0,1,0.09752254538684738,53
3150,0,6166,2364,3802,0,0,0,1.0,1,1.0,1,1.0,1,0.09752254538684738,53
3151,4,6170,2364,3806,0,0,0,1.0,1,1.0,1,1.0,1,0.05553553887963444,53
3152,0,6170,2364,3806,0,0,0,1.0,1,1.0,1,1.0,1,0.06176773794952128,54
3153,0,6170,2364,3806,0,0,0,1.0,1,1.0,1,1.0,1,0.0836431877826269,53
3154,3,6173,2365,3808,0,0,0,1.0,1,1.0,1,1.0,1,0.06767542608886,55
3155,0,6173,2365,3808,0,0,0,1.0,1,1.0,1,1.0,1,0.06371955843504543,56
3156,2,6175,2365,3810,0,0,0,1.0,1,1.0,1,1.0,1,0.06536031381469996,56
3157,0,6175,2365,3810,0,0,0,1.0,1,1.0,1,1.0,1,0.06536031381469996,56
3158,1,6176,2365,3811,0,0,0,1.0,1,1.0,1,1.0,1,0.07475960638665749,57
3159,0,6176,2365,3811,0,0,0,1.0,1,1.0,1,1.0,1,0.09160085681545081,56
3160,0,6176,2365,3811,0,0,0,1.0,1,1.0,1,1.0,1,0.11468992332906722,58
3161,2,6178,2366,3812,0,0,0,1.0,1,1.0,1,1.0,1,0.10224574681540449,59
3162,1,6179,2367,3812,0,0,0,1.0,1,1.0,1,1.0,1,0.12821117290477782,59
3163,6,6185,2371,3814,0,0,0,1.0,1,1.0,1,1.0,1,0.1390389738366506,59
3164,5,6190,2373,3817,0,0,0,1.0,1,1.0,1,1.0,1,0.1560166862134084,60
3165,2,6192,2374,3818,0,0,0,1.0,1,1.0,1,1.0,1,0.12148235633911968,58
3166,1,6193,2374,3819,0,0,0,1.0,1,1.0,1,1.0,1,0.11077209468358352,59
3167,2,6195,2376,3819,0,0,0,1.0,1,1.0,1,1.0,1,0.09535081871362153,57
3168,1,6196,2376,3820,0,0,0,1.0,1,1.0,1,1.0,1,0.07406020513740165,58
3169,1,6197,2377,3820,0,0,0,1.0,1,1.0,1,1.0,1,0.08666442393730081,57
3170,1,6198,2378,3820,0,0,0,1.0,1,1.0,1,1.0,1,0.12766787141054228,55
3171,0,6198,2378,3820,0,0,0,1.0,1,1.0,1,1.0,1,0.12761652926922457,56
3172,3,6201,2379,3822,0,0,0,1.0,1,1.0,1,1.0,1,0.13909021196553256,54
3173,3,6204,2382,3822,0,0,0,1.0,1,1.0,1,1.0,1,0.1891837395026572,53
3174,5,6209,2383,3826,0,0,0,1.0,1,1.0,1,1.0,1,0.12791868475349563,53
3175,0,6209,2383,3826,0,0,0,1.0,1,1.0,1,1.0,1,0.14793576605323486,52
3176,5,6214,2387,3827,0,0,0,1.0,1,1.0,1,1.0,1,0.15984171375275813,53
3177,6,6220,2389,3831,0,0,0,1.0,1,1.0,1,1.0,1,0.14556709909957966,52
3178,8,6228,2391,3837,0,0,0,1.0,1,1.0,1,1.0,1,0.09432474533172513,53
3179,1,6229,2391,3838,0,0,0,1.0,1,1.0,1,1.0,1,0.07773623437141473,54
3180,3,6232,2391,3841,0,0,0,1.0,1,1.0,1,1.0,1,0.07610821458633654,54
3181,0,6232,2391,3841,0,0,0,1.0,1,1.0,1,1.0,1,0.09374219617203881,55
3182,0,6232,2391,3841,0,0,0,1.0,1,1.0,1,1.0,1,0.10896765820988709,54
3183,4,6236,2393,3843,0,0,0,1.0,1,1.0,1,1.0,1,0.14519565169983367,56
3184,6,6242,2397,3845,0,0,0,1.0,1,1.0,1,1.0,1,0.08657173026526431,54
3185,0,6242,2397,3845,0,0,0,1.0,1,1.0,1,1.0,1,0.08794222738716376,53
3186,1,6243,2398,3845,0,0,0,1.0,1,1.0,1,1.0,1,0.1094486226324789,52
3187,3,6246,2399,3847,0,0,0,1.0,1,1.0,1,1.0,1,0.09717757059805004,50
3188,3,6249,2401,3848,0,0,0,1.0,1,1.0,1,1.0,1,0.11241557569403374,50
3189,6,6255,2404,3851,0,0,0,1.0,1,1.0,1,1.0,1,0.12025746822472831,49
3190,2,6257,2405,3852,0,0,0,1.0,1,1.0,1,1.0,1,0.14171486655582013,50
3191,1,6258,2406,3852,0,0,0,1.0,1,1.0,1,1.0,1,0.16045752696813767,49
3192,0,6258,2406,3852,0,0,0,1.0,1,1.0,1,1.0,1,0.16045752696813767,49
3193,1,6259,2406,3853,0,0,0,1.0,1,1.0,1,1.0,1,0.15319852101870737,49
3194,6,6265,2409,3856,0,0,0,1.0,1,1.0,1,1.0,1,0.15681364461469122,50
3195,1,6266,2409,3857,0,0,0,1.0,1,1.0,1,1.0,1,0.16219813844346473,49
3196,1,6267,2409,3858,0,0,0,1.0,1,1.0,1,1.0,1,0.14913667595565377,49
3197,1,6268,2409,3859,0,0,0,1.0,1,1.0,1,1.0,1,0.11181172478765761,50
3198,1,6269,2409,3860,0,0,0,1.0,1,1.0,1,1.0,1,0.10073945900067229,50
3199,0,6269,2409,3860,0,0,0,1.0,1,1.0,1,1.0,1,0.1040095198690592,52
3200,1,6270,2409,3861,0,0,0,1.0,1,1.0,1,1.0,1,0.09911837519073144,53
3201,2,6272,2409,3863,0,0,0,1.0,1,1.0,1,1.0,1,0.08621352516389093,55
3202,1,6273,2410,3863,0,0,0,1.0,1,1.0,1,1.0,1,0.10206176764712646,55
3203,0,6273,2410,3863,0,0,0,1.0,1,1.0,1,1.0,1,0.10127168060972606,53
3204,1,6274,2411,3863,0,0,0,1.0,1,1.0,1,1.0,1,0.1283749748897572,53
3205,2,6276,2413,3863,0,0,0,1.0,1,1.0,1,1.0,1,0.1456957756279188,53
3206,1,6277,2413,3864,0,0,0,1.0,1,1.0,1,1.0,1,0.16638199944562224,52
3207,3,6280,2415,3865,0,0,0,1.0,1,1.0,1,1.0,1,0.20938628327442252,53
3208,6,6286,2415,3871,0,0,0,1.0,1,1.0,1,1.0,1,0.18148829264276206,51
3209,2,6288,2415,3873,0,0,0,1.0,1,1.0,1,1.0,1,0.1693844522682924,52
3210,1,6289,2415,3874,0,0,0,1.0,1,1.0,1,1.0,1,0.14871637352356482,49
3211,3,6292,2417,3875,0,0,0,1.0,1,1.0,1,1.0,1,0.1653659627073504,48
3212,0,6292,2417,3875,0,0,0,1.0,1,1.0,1,1.0,1,0.166269961387599,48
3213,1,6293,2418,3875,0,0,0,1.0,1,1.0,1,1.0,1,0.14336937009139678,49
3214,3,6296,2420,3876,0,0,0,1.0,1,1.0,1,1.0,1,0.12891353037249156,51
3215,1,6297,2420,3877,0,0,0,1.0,1,1.0,1,1.0,1,0.1195920656484082,51
3216,2,6299,2422,3877,0,0,0,1.0,1,1.0,1,1.0,1,0.14325581285402675,51
3217,6,6305,2423,3882,0,0,0,1.0,1,1.0,1,1.0,1,0.1211711563072267,51
3218,4,6309,2423,3886,0,0,0,1.0,1,1.0,1,1.0,1,0.1211711563072267,51
3219,3,6312,2423,3889,0,0,0,1.0,1,1.0,1,1.0,1,0.10497481673536149,52
3220,2,6314,2423,3891,0,0,0,1.0,1,1.0,1,1.0,1,0.08815213754507259,52
3221,3,6317,2424,3893,0,0,0,1.0,1,1.0,1,1.0,1,0.07647801757446718,54
3222,0,6317,2424,3893,0,0,0,1.0,1,1.0,1,1.0,1,0.08110623791475102,54
3223,0,6317,2424,3893,0,0,0,1.0,1,1.0,1,1.0,1,0.09807695620386188,56
3224,1,6318,2425,3893,0,0,0,1.0,1,1.0,1,1.0,1,0.12008716718368403,57
3225,3,6321,2425,3896,0,0,0,1.0,1,1.0,1,1.0,1,0.10831798969403296,58
3226,3,6324,2425,3899,0,0,0,1.0,1,1.0,1,1.0,1,0.07128558239385101,58
3227,0,6324,2425,3899,0,0,0,1.0,1,1.0,1,1.0,1,0.07128558239385101,58
3228,0,6324,2425,3899,0,0,0,1.0,1,1.0,1,1.0,1,0.07128558239385101,58
3229,2,6326,2427,3899,0,0,0,1.0,1,1.0,1,1.0,1,0.14529579850029925,60
3230,1,6327,2427,3900,0,0,0,1.0,1,1.0,1,1.0,1,0.1395144232877442,61
3231,2,6329,2427,3902,0,0,0,1.0,1,1.0,1,1.0,1,0.12681080477825116,61
3232,3,6332,2427,3905,0,0,0,1.0,1,1.0,1,1.0,1,0.09833976079396807,61
3233,1,6333,2427,3906,0,0,0,1.0,1,1.0,1,1.0,1,0.1059319372160419,63
3234,2,6335,2428,3907,0,0,0,1.0,1,1.0,1,1.0,1,0.13994246277410577,64
3235,3,6338,2428,3910,0,0,0,1.0,1,1.0,1,1.0,1,0.10077424035031185,65
3236,1,6339,2428,3911,0,0,0,1.0,1,1.0,1,1.0,1,0.10272833039406234,66
3237,1,6340,2428,3912,0,0,0,1.0,1,1.0,1,1.0,1,0.0882458550607372,67
3238,0,6340,2428,3912,0,0,0,1.0,1,1.0,1,1.0,1,0.0882458550607372,67
3239,2,6342,2428,3914,0,0,0,1.0,1,1.0,1,1.0,1,0.09774473250617727,69
3240,0,6342,2428,3914,0,0,0,1.0,1,1.0,1,1.0,1,0.09774473250617727,69
3241,3,6345,2429,3916,0,0,0,1.0,1,1.0,1,1.0,1,0.06856424059901188,68
3242,1,6346,2430,3916,0,0,0,1.0,1,1.0,1,1.0,1,0.08245432537559597,67
3243,3,6349,2431,3918,0,0,0,1.0,1,1.0,1,1.0,1,0.04973233846115762,68
3244,1,6350,2431,3919,0,0,0,1.0,1,1.0,1,1.0,1,0.06425432234285743,68
3245,0,6350,2431,3919,0,0,0,1.0,1,1.0,1,1.0,1,0.0696076510931237,69
3246,1,6351,2432,3919,0,0,0,1.0,1,1.0,1,1.0,1,0.08128350207042682,68
3247,2,6353,2432,3921,0,0,0,1.0,1,1.0,1,1.0,1,0.06000127729081152,68
3248,3,6356,2434,3922,0,0,0,1.0,1,1.0,1,1.0,1,0.08267223278391941,68
3249,0,6356,2434,3922,0,0,0,1.0,1,1.0,1,1.0,1,0.08992353043901768,69
3250,3,6359,2435,3924,0,0,0,1.0,1,1.0,1,1.0,1,0.06776048955603697,69
3251,3,6362,2436,3926,0,0,0,1.0,1,1.0,1,1.0,1,0.08249410730008441,68
3252,0,6362,2436,3926,0,0,0,1.0,1,1.0,1,1.0,1,0.0929945043824009,68
3253,3,6365,2437,3928,0,0,0,1.0,1,1.0,1,1.0,1,0.06050249585838113,69
3254,0,6365,2437,3928,0,0,0,1.0,1,1.0,1,1.0,1,0.06050249585838113,69
3255,3,6368,2439,3929,0,0,0,1.0,1,1.0,1,1.0,1,0.09406814979462519,70
3256,3,6371,2439,3932,0,0,0,1.0,1,1.0,1,1.0,1,0.05928278348154841,70
3257,2,6373,2439,3934,0,0,0,1.0,1,1.0,1,1.0,1,0.06388238062990087,71
3258,2,6375,2440,3935,0,0,0,1.0,1,1.0,1,1.0,1,0.058720103530997395,72
3259,2,6377,2442,3935,0,0,0,1.0,1,1.0,1,1.0,1,0.091802031070261,71
3260,4,6381,2443,3938,0,0,0,1.0,1,1.0,1,1.0,1,0.11531385131123675,72
3261,2,6383,2443,3940,0,0,0,1.0,1,1.0,1,1.0,1,0.11186271094629395,74
3262,4,6387,2444,3943,0,0,0,1.0,1,1.0,1,1.0,1,0.10185477938717802,73
3263,2,6389,2446,3943,0,0,0,1.0,1,1.0,1,1.0,1,0.11127911181000663,73
3264,4,6393,2448,3945,0,0,0,1.0,1,1.0,1,1.0,1,0.15851540278108417,71
3265,6,6399,2451,3948,0,0,0,1.0,1,1.0,1,1.0,1,0.11186251799877991,70
3266,0,6399,2451,3948,0,0,0,1.0,1,1.0,1,1.0,1,0.12732426717283288,69
3267,3,6402,2452,3950,0,0,0,1.0,1,1.0,1,1.0,1,0.12884989492371918,69
3268,5,6407,2455,3952,0,0,0,1.0,1,1.0,1,1.0,1,0.11528570339574763,68
3269,2,6409,2457,3952,0,0,0,1.0,1,1.0,1,1.0,1,0.1547325079893613,68
3270,0,6409,2457,3952,0,0,0,1.0,1,1.0,1,1.0,1,0.1675926721327377,67
3271,2,6411,2457,3954,0,0,0,1.0,1,1.0,1,1.0,1,0.15533743263139613,66
3272,1,6412,2457,3955,0,0,0,1.0,1,1.0,1,1.0,1,0.14011358392474801,67
3273,3,6415,2457,3958,0,0,0,1.0,1,1.0,1,1.0,1,0.12549039052811323,66
3274,2,6417,2458,3959,0,0,0,1.0,1,1.0,1,1.0,1,0.11374771584591233,68
3275,2,6419,2458,3961,0,0,0,1.0,1,1.0,1,1.0,1,0.09681065753182949,68
3276,2,6421,2459,3962,0,0,0,1.0,1,1.0,1,1.0,1,0.09570688983338825,69
3277,3,6424,2460,3964,0,0,0,1.0,1,1.0,1,1.0,1,0.09641738578788385,68
3278,1,6425,2460,3965,0,0,0,1.0,1,1.0,1,1.0,1,0.09429750386602534,69
3279,0,6425,2460,3965,0,0,0,1.0,1,1.0,1,1.0,1,0.08615610621215887,67
3280,4,6429,2462,3967,0,0,0,1.0,1,1.0,1,1.0,1,0.09658914125744829,66
3281,3,6432,2465,3967,0,0,0,1.0,1,1.0,1,1.0,1,0.15603403144339537,67
3282,3,6435,2465,3970,0,0,0,1.0,1,1.0,1,1.0,1,0.11999890761397682,66
3283,2,6437,2466,3971,0,0,0,1.0,1,1.0,1,1.0,1,0.13132067591789218,67
3284,0,6437,2466,3971,0,0,0,1.0,1,1.0,1,1.0,1,0.10750304118940164,66
3285,0,6437,2466,3971,0,0,0,1.0,1,1.0,1,1.0,1,0.10750304118940164,66
3286,4,6441,2466,3975,0,0,0,1.0,1,1.0,1,1.0,1,0.11432759770174586,63
3287,2,6443,2468,3975,0,0,0,1.0,1,1.0,1,1.0,1,0.1832635751335073,61
3288,4,6447,2468,3979,0,0,0,1.0,1,1.0,1,1.0,1,0.1692475056276954,63
3289,6,6453,2470,3983,0,0,0,1.0,1,1.0,1,1.0,1,0.1456878901086179,62
3290,1,6454,2471,3983,0,0,0,1.0,1,1.0,1,1.0,1,0.1547111693043235,63
3291,4,6458,2472,3986,0,0,0,1.0,1,1.0,1,1.0,1,0.15678752848246472,62
3292,3,6461,2473,3988,0,0,0,1.0,1,1.0,1,1.0,1,0.15898142159964465,63
3293,4,6465,2473,3992,0,0,0,1.0,1,1.0,1,1.0,1,0.15570865129320072,65
3294,0,6465,2473,3992,0,0,0,1.0,1,1.0,1,1.0,1,0.15570865129320072,65
3295,2,6467,2473,3994,0,0,0,1.0,1,1.0,1,1.0,1,0.13575877494784977,65
3296,2,6469,2474,3995,0,0,0,1.0,1,1.0,1,1.0,1,0.14946039586021742,65
3297,1,6470,2474,3996,0,0,0,1.0,1,1.0,1,1.0,1,0.13619435829359622,66
3298,1,6471,2474,3997,0,0,0,1.0,1,1.0,1,1.0,1,0.12840605855864676,66
3299,3,6474,2475,3999,0,0,0,1.0,1,1.0,1,1.0,1,0.14749716222344675,67
3300,3,6477,2477,4000,0,0,0,1.0,1,1.0,1,1.0,1,0.17922870098202046,67
3301,4,6481,2478,4003,0,0,0,1.0,1,1.0,1,1.0,1,0.17050600765065,68
3302,1,6482,2478,4004,0,0,0,1.0,1,1.0,1,1.0,1,0.18217246161439407,67
3303,1,6483,2479,4004,0,0,0,1.0,1,1.0,1,1.0,1,0.1923944744524702,67
3304,1,6484,2479,4005,0,0,0,1.0,1,1.0,1,1.0,1,0.18447653802636677,67
3305,7,6491,2479,4012,0,0,0,1.0,1,1.0,1,1.0,1,0.15269530145900231,69
3306,2,6493,2479,4014,0,0,0,1.0,1,1.0,1,1.0,1,0.13942744826467485,70
3307,1,6494,2479,4015,0,0,0,1.0,1,1.0,1,1.0,1,0.13077386372145464,70
3308,1,6495,2479,4016,0,0,0,1.0,1,1.0,1,1.0,1,0.12552202198603937,70
3309,1,6496,2479,4017,0,0,0,1.0,1,1.0,1,1.0,1,0.13260089183059223,72
3310,2,6498,2479,4019,0,0,0,1.0,1,1.0,1,1.0,1,0.12976075398920142,74
3311,0,6498,2479,4019,0,0,0,1.0,1,1.0,1,1.0,1,0.12976075398920142,74
3312,0,6498,2479,4019,0,0,0,1.0,1,1.0,1,1.0,1,0.12976075398920142,74
3313,1,6499,2479,4020,0,0,0,1.0,1,1.0,1,1.0,1,0.13502990391715444,75
3314,3,6502,2479,4023,0,0,0,1.0,1,1.0,1,1.0,1,0.12586828152590337,76
3315,2,6504,2480,4024,0,0,0,1.0,1,1.0,1,1.0,1,0.15099228466255968,75
3316,4,6508,2481,4027,0,0,0,1.0,1,1.0,1,1.0,1,0.14283836817461393,76
3317,1,6509,2481,4028,0,0,0,1.0,1,1.0,1,1.0,1,0.13463064950859652,73
3318,1,6510,2482,4028,0,0,0,1.0,1,1.0,1,1.0,1,0.14865478639588559,72
3319,3,6513,2483,4030,0,0,0,1.0,1,1.0,1,1.0,1,0.15543644897508777,71
3320,1,6514,2483,4031,0,0,0,1.0,1,1.0,1,1.0,1,0.13434962444262052,70
3321,3,6517,2485,4032,0,0,0,1.0,1,1.0,1,1.0,1,0.16230648521510654,69
3322,4,6521,2486,4035,0,0,0,1.0,1,1.0,1,1.0,1,0.15161068080798415,68
3323,2,6523,2487,4036,0,0,0,1.0,1,1.0,1,1.0,1,0.17780732956525983,69
3324,1,6524,2488,4036,0,0,0,1.0,1,1.0,1,1.0,1,0.17792284502547073,69
3325,4,6528,2488,4040,0,0,0,1.0,1,1.0,1,1.0,1,0.1487910050099368,70
3326,2,6530,2489,4041,0,0,0,1.0,1,1.0,1,1.0,1,0.15042886097417532,69
3327,2,6532,2489,4043,0,0,0,1.0,1,1.0,1,1.0,1,0.13876398526023961,70
3328,3,6535,2490,4045,0,0,0,1.0,1,1.0,1,1.0,1,0.14994266766107386,73
3329,2,6537,2491,4046,0,0,0,1.0,1,1.0,1,1.0,1,0.18127700958230744,72
3330,4,6541,2493,4048,0,0,0,1.0,1,1.0,1,1.0,1,0.18597997213628292,72
3331,4,6545,2495,4050,0,0,0,1.0,1,1.0,1,1.0,1,0.19238194349582302,72
3332,2,6547,2495,4052,0,0,0,1.0,1,1.0,1,1.0,1,0.1808341037333001,73
3333,0,6547,2495,4052,0,0,0,1.0,1,1.0,1,1.0,1,0.18384087868306803,72
3334,4,6551,2495,4056,0,0,0,1.0,1,1.0,1,1.0,1,0.1606318744861392,73
3335,0,6551,2495,4056,0,0,0,1.0,1,1.0,1,1.0,1,0.1613186629656683,74
3336,0,6551,2495,4056,0,0,0,1.0,1,1.0,1,1.0,1,0.1613186629656683,74
3337,2,6553,2496,4057,0,0,0,1.0,1,1.0,1,1.0,1,0.15952458991666396,74
3338,1,6554,2496,4058,0,0,0,1.0,1,1.0,1,1.0,1,0.15740737193595847,74
3339,1,6555,2496,4059,0,0,0,1.0,1,1.0,1,1.0,1,0.15375246180719404,75
3340,5,6560,2496,4064,0,0,0,1.0,1,1.0,1,1.0,1,0.1302867021456369,75
3341,0,6560,2496,4064,0,0,0,1.0,1,1.0,1,1.0,1,0.14191945053679142,76
3342,0,6560,2496,4064,0,0,0,1.0,1,1.0,1,1.0,1,0.160616245076476,76
3343,2,6562,2497,4065,0,0,0,1.0,1,1.0,1,1.0,1,0.15361969848782772,75
3344,4,6566,2499,4067,0,0,0,1.0,1,1.0,1,1.0,1,0.1732841903446497,75
3345,1,6567,2500,4067,0,0,0,1.0,1,1.0,1,1.0,1,0.18488268776839376,72
3346,7,6574,2500,4074,0,0,0,1.0,1,1.0,1,1.0,1,0.15084682588700105,73
3347,1,6575,2501,4074,0,0,0,1.0,1,1.0,1,1.0,1,0.15176183684166786,73
3348,1,6576,2501,4075,0,0,0,1.0,1,1.0,1,1.0,1,0.1538240291382088,73
3349,5,6581,2501,4080,0,0,0,1.0,1,1.0,1,1.0,1,0.13769543414914592,74
3350,6,6587,2503,4084,0,0,0,1.0,1,1.0,1,1.0,1,0.15763322662736118,73
3351,3,6590,2504,4086,0,0,0,1.0,1,1.0,1,1.0,1,0.15500844094238356,72
3352,5,6595,2504,4091,0,0,0,1.0,1,1.0,1,1.0,1,0.10309994611460518,72
3353,1,6596,2505,4091,0,0,0,1.0,1,1.0,1,1.0,1,0.13456369275550228,72
3354,4,6600,2506,4094,0,0,0,1.0,1,1.0,1,1.0,1,0.16570284983752148,70
3355,4,6604,2507,4097,0,0,0,1.0,1,1.0,1,1.0,1,0.15642485834212522,69
3356,4,6608,2510,4098,0,0,0,1.0,1,1.0,1,1.0,1,0.1691221550884015,69
3357,3,6611,2510,4101,0,0,0,1.0,1,1.0,1,1.0,1,0.15333099972674188,68
3358,2,6613,2510,4103,0,0,0,1.0,1,1.0,1,1.0,1,0.13512565990844522,68
3359,0,6613,2510,4103,0,0,0,1.0,1,1.0,1,1.0,1,0.1334453254984919,66
3360,4,6617,2513,4104,0,0,0,1.0,1,1.0,1,1.0,1,0.18904956564611952,65
3361,3,6620,2513,4107,0,0,0,1.0,1,1.0,1,1.0,1,0.15251862088347537,64
3362,0,6620,2513,4107,0,0,0,1.0,1,1.0,1,1.0,1,0.15251862088347537,64
3363,1,6621,2513,4108,0,0,0,1.0,1,1.0,1,1.0,1,0.13988291424501167,65
3364,0,6621,2513,4108,0,0,0,1.0,1,1.0,1,1.0,1,0.14428108936299672,66
3365,1,6622,2513,4109,0,0,0,1.0,1,1.0,1,1.0,1,0.14436438794865633,68
3366,2,6624,2514,4110,0,0,0,1.0,1,1.0,1,1.0,1,0.14958366673302176,66
3367,3,6627,2514,4113,0,0,0,1.0,1,1.0,1,1.0,1,0.13375326460407833,68
3368,1,6628,2515,4113,0,0,0,1.0,1,1.0,1,1.0,1,0.1539878718181969,68
3369,0,6628,2515,4113,0,0,0,1.0,1,1.0,1,1.0,1,0.16313983558586725,69
3370,4,6632,2515,4117,0,0,0,1.0,1,1.0,1,1.0,1,0.1191570084479152,71
3371,4,6636,2516,4120,0,0,0,1.0,1,1.0,1,1.0,1,0.12640564924202635,71
3372,4,6640,2517,4123,0,0,0,1.0,1,1.0,1,1.0,1,0.12565162573973884,71
3373,1,6641,2517,4124,0,0,0,1.0,1,1.0,1,1.0,1,0.11331582822348628,72
3374,0,6641,2517,4124,0,0,0,1.0,1,1.0,1,1.0,1,0.10470057366684539,72
3375,3,6644,2518,4126,0,0,0,1.0,1,1.0,1,1.0,1,0.09062473916854112,73
3376,0,6644,2518,4126,0,0,0,1.0,1,1.0,1,1.0,1,0.07704586624878124,75
3377,2,6646,2519,4127,0,0,0,1.0,1,1.0,1,1.0,1,0.08389731615396209,77
3378,0,6646,2519,4127,0,0,0,1.0,1,1.0,1,1.0,1,0.08389731615396209,77
3379,1,6647,2520,4127,0,0,0,1.0,1,1.0,1,1.0,1,0.09437240712415389,77
3380,2,6649,2521,4128,0,0,0,1.0,1,1.0,1,1.0,1,0.116118415187127,76
3381,2,6651,2523,4128,0,0,0,1.0,1,1.0,1,1.0,1,0.13986696022959705,76
3382,4,6655,2524,4131,0,0,0,1.0,1,1.0,1,1.0,1,0.11538893724578944,78
3383,0,6655,2524,4131,0,0,0,1.0,1,1.0,1,1.0,1,0.1109927403271098,77
3384,3,6658,2527,4131,0,0,0,1.0,1,1.0,1,1.0,1,0.138306093597363,77
3385,3,6661,2528,4133,0,0,0,1.0,1,1.0,1,1.0,1,0.12902890699432615,75
3386,2,6663,2529,4134,0,0,0,1.0,1,1.0,1,1.0,1,0.15138504163988442,76
3387,4,6667,2529,4138,0,0,0,1.0,1,1.0,1,1.0,1,0.12798025638324403,75
3388,3,6670,2531,4139,0,0,0,1.0,1,1.0,1,1.0,1,0.14757743001141987,76
3389,4,6674,2532,4142,0,0,0,1.0,1,1.0,1,1.0,1,0.12928388279004588,77
3390,1,6675,2532,4143,0,0,0,1.0,1,1.0,1,1.0,1,0.12824630166203424,76
3391,4,6679,2533,4146,0,0,0,1.0,1,1.0,1,1.0,1,0.08530435290019223,77
3392,4,6683,2534,4149,0,0,0,1.0,1,1.0,1,1.0,1,0.08768082102363235,78
3393,2,6685,2534,4151,0,0,0,1.0,1,1.0,1,1.0,1,0.07603076020382335,76
3394,4,6689,2535,4154,0,0,0,1.0,1,1.0,1,1.0,1,0.09026493293074872,75
3395,0,6689,2535,4154,0,0,0,1.0,1,1.0,1,1.0,1,0.08636807253076585,73
3396,0,6689,2535,4154,0,0,0,1.0,1,1.0,1,1.0,1,0.08636807253076585,73
3397,1,6690,2536,4154,0,0,0,1.0,1,1.0,1,1.0,1,0.06901208604482853,74
3398,0,6690,2536,4154,0,0,0,1.0,1,1.0,1,1.0,1,0.06901208604482853,74
3399,0,6690,2536,4154,0,0,0,1.0,1,1.0,1,1.0,1,0.06320756127489062,75
3400,2,6692,2537,4155,0,0,0,1.0,1,1.0,1,1.0,1,0.06828276804018318,75
3401,2,6694,2538,4156,0,0,0,1.0,1,1.0,1,1.0,1,0.056158822640546724,77
3402,1,6695,2539,4156,0,0,0,1.0,1,1.0,1,1.0,1,0.07271973910242431,77
3403,4,6699,2540,4159,0,0,0,1.0,1,1.0,1,1.0,1,0.06208022436401259,78
3404,3,6702,2541,4161,0,0,0,1.0,1,1.0,1,1.0,1,0.07818964328955252,78
3405,2,6704,2541,4163,0,0,0,1.0,1,1.0,1,1.0,1,0.05235154183331091,78
3406,2,6706,2543,4163,0,0,0,1.0,1,1.0,1,1.0,1,0.0730595671661188,78
3407,2,6708,2544,4164,0,0,0,1.0,1,1.0,1,1.0,1,0.0998032787919969,78
3408,0,6708,2544,4164,0,0,0,1.0,1,1.0,1,1.0,1,0.10117123683470927,79
3409,3,6711,2544,4167,0,0,0,1.0,1,1.0,1,1.0,1,0.07388302738648289,81
3410,0,6711,2544,4167,0,0,0,1.0,1,1.0,1,1.0,1,0.08312190175820343,82
3411,1,6712,2544,4168,0,0,0,1.0,1,1.0,1,1.0,1,0.07629259075109347,84
3412,0,6712,2544,4168,0,0,0,1.0,1,1.0,1,1.0,1,0.07629259075109347,84
3413,0,6712,2544,4168,0,0,0,1.0,1,1.0,1,1.0,1,0.07629259075109347,84
3414,1,6713,2545,4168,0,0,0,1.0,1,1.0,1,1.0,1,0.08022994771372975,84
3415,3,6716,2547,4169,0,0,0,1.0,1,1.0,1,1.0,1,0.10232466650843788,85
3416,2,6718,2549,4169,0,0,0,1.0,1,1.0,1,1.0,1,0.11464470585429082,85
3417,3,6721,2550,4171,0,0,0,1.0,1,1.0,1,1.0,1,0.12120620601270408,86
3418,6,6727,2552,4175,0,0,0,1.0,1,1.0,1,1.0,1,0.1331576925230926,86
3419,3,6730,2553,4177,0,0,0,1.0,1,1.0,1,1.0,1,0.13863328783738998,87
3420,1,6731,2553,4178,0,0,0,1.0,1,1.0,1,1.0,1,0.13413695248777716,88
3421,4,6735,2554,4181,0,0,0,1.0,1,1.0,1,1.0,1,0.1342429063314997,89
3422,4,6739,2555,4184,0,0,0,1.0,1,1.0,1,1.0,1,0.15312826274711183,90
3423,1,6740,2555,4185,0,0,0,1.0,1,1.0,1,1.0,1,0.15644536431793685,90
3424,5,6745,2555,4190,0,0,0,1.0,1,1.0,1,1.0,1,0.12843504709924833,91
3425,1,6746,2555,4191,0,0,0,1.0,1,1.0,1,1.0,1,0.12507632159243262,90
3426,3,6749,2556,4193,0,0,0,1.0,1,1.0,1,1.0,1,0.10961944201212978,92
3427,3,6752,2556,4196,0,0,0,1.0,1,1.0,1,1.0,1,0.1106565709581314,92
3428,0,6752,2556,4196,0,0,0,1.0,1,1.0,1,1.0,1,0.11781705828928156,91
3429,0,6752,2556,4196,0,0,0,1.0,1,1.0,1,1.0,1,0.11781705828928156,91
3430,4,6756,2558,4198,0,0,0,1.0,1,1.0,1,1.0,1,0.11970720639014396,91
3431,0,6756,2558,4198,0,0,0,1.0,1,1.0,1,1.0,1,0.11266775344460389,90
3432,2,6758,2560,4198,0,0,0,1.0,1,1.0,1,1.0,1,0.11756962876122859,91
3433,0,6758,2560,4198,0,0,0,1.0,1,1.0,1,1.0,1,0.1168619813877583,90
3434,0,6758,2560,4198,0,0,0,1.0,1,1.0,1,1.0,1,0.11826560234477254,89
3435,1,6759,2561,4198,0,0,0,1.0,1,1.0,1,1.0,1,0.13123966445089424,88
3436,3,6762,2561,4201,0,0,0,1.0,1,1.0,1,1.0,1,0.11861549314325219,86
3437,1,6763,2561,4202,0,0,0,1.0,1,1.0,1,1.0,1,0.11202352714793233,86
3438,1,6764,2561,4203,0,0,0,1.0,1,1.0,1,1.0,1,0.10898222387695708,87
3439,3,6767,2562,4205,0,0,0,1.0,1,1.0,1,1.0,1,0.11503812858295803,86
3440,0,6767,2562,4205,0,0,0,1.0,1,1.0,1,1.0,1,0.11446263173640536,86
3441,3,6770,2564,4206,0,0,0,1.0,1,1.0,1,1.0,1,0.12274007261859605,85
3442,4,6774,2565,4209,0,0,0,1.0,1,1.0,1,1.0,1,0.10795152496270118,85
3443,1,6775,2565,4210,0,0,0,1.0,1,1.0,1,1.0,1,0.11216890147869492,85
3444,4,6779,2568,4211,0,0,0,1.0,1,1.0,1,1.0,1,0.12888145694357026,85
3445,2,6781,2568,4213,0,0,0,1.0,1,1.0,1,1.0,1,0.1305786018409611,84
3446,6,6787,2571,4216,0,0,0,1.0,1,1.0,1,1.0,1,0.15524302648625166,85
3447,5,6792,2572,4220,0,0,0,1.0,1,1.0,1,1.0,1,0.13068237712148728,85
3448,4,6796,2574,4222,0,0,0,1.0,1,1.0,1,1.0,1,0.13837851732278425,85
3449,0,6796,2574,4222,0,0,0,1.0,1,1.0,1,1.0,1,0.14912148919918075,84
3450,0,6796,2574,4222,0,0,0,1.0,1,1.0,1,1.0,1,0.14912148919918075,84
3451,2,6798,2574,4224,0,0,0,1.0,1,1.0,1,1.0,1,0.13957058423062962,85
3452,2,6800,2574,4226,0,0,0,1.0,1,1.0,1,1.0,1,0.12933831948147384,86
3453,1,6801,2574,4227,0,0,0,1.0,1,1.0,1,1.0,1,0.12264593304336342,85
3454,3,6804,2574,4230,0,0,0,1.0,1,1.0,1,1.0,1,0.0962653027876696,88
3455,0,6804,2574,4230,0,0,0,1.0,1,1.0,1,1.0,1,0.0962653027876696,88
3456,1,6805,2575,4230,0,0,0,1.0,1,1.0,1,1.0,1,0.09603185721760098,88
3457,0,6805,2575,4230,0,0,0,1.0,1,1.0,1,1.0,1,0.10328271497337171,89
3458,1,6806,2575,4231,0,0,0,1.0,1,1.0,1,1.0,1,0.11021447722231027,88
3459,0,6806,2575,4231,0,0,0,1.0,1,1.0,1,1.0,1,0.11021447722231027,88
3460,1,6807,2575,4232,0,0,0,1.0,1,1.0,1,1.0,1,0.10288966451314249,89
3461,0,6807,2575,4232,0,0,0,1.0,1,1.0,1,1.0,1,0.10288966451314249,89
3462,2,6809,2575,4234,0,0,0,1.0,1,1.0,1,1.0,1,0.10138787713184623,90
3463,4,6813,2575,4238,0,0,0,1.0,1,1.0,1,1.0,1,0.07731269380884422,89
3464,1,6814,2575,4239,0,0,0,1.0,1,1.0,1,1.0,1,0.07538494778719587,88
3465,1,6815,2575,4240,0,0,0,1.0,1,1.0,1,1.0,1,0.08878158782683429,87
3466,1,6816,2575,4241,0,0,0,1.0,1,1.0,1,1.0,1,0.07727581638760876,87
3467,1,6817,2576,4241,0,0,0,1.0,1,1.0,1,1.0,1,0.09011249584581067,87
3468,5,6822,2579,4243,0,0,0,1.0,1,1.0,1,1.0,1,0.10391828494263872,88
3469,4,6826,2580,4246,0,0,0,1.0,1,1.0,1,1.0,1,0.10541775260508221,85
3470,5,6831,2582,4249,0,0,0,1.0,1,1.0,1,1.0,1,0.10522085643818847,86
3471,2,6833,2584,4249,0,0,0,1.0,1,1.0,1,1.0,1,0.13268749331909976,84
3472,4,6837,2585,4252,0,0,0,1.0,1,1.0,1,1.0,1,0.12927250952596506,83
3473,3,6840,2587,4253,0,0,0,1.0,1,1.0,1,1.0,1,0.1613031995907679,81
3474,2,6842,2588,4254,0,0,0,1.0,1,1.0,1,1.0,1,0.1478011353743441,80
3475,4,6846,2588,4258,0,0,0,1.0,1,1.0,1,1.0,1,0.13088734920359177,82
3476,2,6848,2588,4260,0,0,0,1.0,1,1.0,1,1.0,1,0.1189066706773823,81
3477,1,6849,2588,4261,0,0,0,1.0,1,1.0,1,1.0,1,0.13566361947843572,83
3478,8,6857,2590,4267,0,0,0,1.0,1,1.0,1,1.0,1,0.10942619429217887,83
3479,1,6858,2590,4268,0,0,0,1.0,1,1.0,1,1.0,1,0.10610152146378286,83
3480,0,6858,2590,4268,0,0,0,1.0,1,1.0,1,1.0,1,0.10610152146378286,83
3481,6,6864,2592,4272,0,0,0,1.0,1,1.0,1,1.0,1,0.09567381035649997,83
3482,6,6870,2595,4275,0,0,0,1.0,1,1.0,1,1.0,1,0.13997379524628648,83
3483,5,6875,2596,4279,0,0,0,1.0,1,1.0,1,1.0,1,0.14678316718639814,82
3484,4,6879,2597,4282,0,0,0,1.0,1,1.0,1,1.0,1,0.14052541654127482,82
3485,3,6882,2598,4284,0,0,0,1.0,1,1.0,1,1.0,1,0.13833364586945712,83
3486,0,6882,2598,4284,0,0,0,1.0,1,1.0,1,1.0,1,0.13833364586945712,83
3487,0,6882,2598,4284,0,0,0,1.0,1,1.0,1,1.0,1,0.14241860797498926,84
3488,0,6882,2598,4284,0,0,0,1.0,1,1.0,1,1.0,1,0.14480688040325,84
3489,2,6884,2598,4286,0,0,0,1.0,1,1.0,1,1.0,1,0.1376287398032326,84
3490,2,6886,2598,4288,0,0,0,1.0,1,1.0,1,1.0,1,0.12018264430689538,84
3491,3,6889,2598,4291,0,0,0,1.0,1,1.0,1,1.0,1,0.10808735585003848,86
3492,1,6890,2598,4292,0,0,0,1.0,1,1.0,1,1.0,1,0.10927059386505653,86
3493,1,6891,2598,4293,0,0,0,1.0,1,1.0,1,1.0,1,0.10574012713298797,86
3494,0,6891,2598,4293,0,0,0,1.0,1,1.0,1,1.0,1,0.10574012713298797,86
3495,0,6891,2598,4293,0,0,0,1.0,1,1.0,1,1.0,1,0.10079906879649336,87
3496,2,6893,2598,4295,0,0,0,1.0,1,1.0,1,1.0,1,0.0946146402325138,88
3497,2,6895,2599,4296,0,0,0,1.0,1,1.0,1,1.0,1,0.09473541718601391,89
3498,6,6901,2599,4302,0,0,0,1.0,1,1.0,1,1.0,1,0.08887091972064001,89
3499,4,6905,2600,4305,0,0,0,1.0,1,1.0,1,1.0,1,0.07521875732153864,91
3500,2,6907,2600,4307,0,0,0,1.0,1,1.0,1,1.0,1,0.08111759915483321,90
3501,0,6907,2600,4307,0,0,0,1.0,1,1.0,1,1.0,1,0.08111759915483321,90
3502,3,6910,2600,4310,0,0,0,1.0,1,1.0,1,1.0,1,0.07507950328286594,91
3503,2,6912,2601,4311,0,0,0,1.0,1,1.0,1,1.0,1,0.06801558096339798,91
3504,2,6914,2603,4311,0,0,0,1.0,1,1.0,1,1.0,1,0.09717928239098236,89
3505,2,6916,2603,4313,0,0,0,1.0,1,1.0,1,1.0,1,0.1001840878082087,87
3506,3,6919,2604,4315,0,0,0,1.0,1,1.0,1,1.0,1,0.11557178118147615,87
3507,1,6920,2605,4315,0,0,0,1.0,1,1.0,1,1.0,1,0.11138035717207082,84
3508,6,6926,2607,4319,0,0,0,1.0,1,1.0,1,1.0,1,0.11858628029767351,83
3509,4,6930,2610,4320,0,0,0,1.0,1,1.0,1,1.0,1,0.12435584224295354,80
3510,1,6931,2611,4320,0,0,0,1.0,1,1.0,1,1.0,1,0.12067507535830091,78
3511,5,6936,2612,4324,0,0,0,1.0,1,1.0,1,1.0,1,0.08948070012205574,77
3512,0,6936,2612,4324,0,0,0,1.0,1,1.0,1,1.0,1,0.1008994958090336,74
3513,3,6939,2613,4326,0,0,0,1.0,1,1.0,1,1.0,1,0.09277901356600146,76
3514,2,6941,2614,4327,0,0,0,1.0,1,1.0,1,1.0,1,0.10167427669439659,76
3515,0,6941,2614,4327,0,0,0,1.0,1,1.0,1,1.0,1,0.10384598491710466,75
3516,0,6941,2614,4327,0,0,0,1.0,1,1.0,1,1.0,1,0.12708248776227363,73
3517,5,6946,2616,4330,0,0,0,1.0,1,1.0,1,1.0,1,0.12364942052701704,74
3518,3,6949,2616,4333,0,0,0,1.0,1,1.0,1,1.0,1,0.1251234982870847,74
3519,1,6950,2616,4334,0,0,0,1.0,1,1.0,1,1.0,1,0.1372046405102851,73
3520,5,6955,2616,4339,0,0,0,1.0,1,1.0,1,1.0,1,0.08780491901643332,74
3521,2,6957,2616,4341,0,0,0,1.0,1,1.0,1,1.0,1,0.0816262217967988,75
3522,0,6957,2616,4341,0,0,0,1.0,1,1.0,1,1.0,1,0.0816262217967988,75
3523,1,6958,2617,4341,0,0,0,1.0,1,1.0,1,1.0,1,0.09072630214709107,75
3524,0,6958,2617,4341,0,0,0,1.0,1,1.0,1,1.0,1,0.09116403934531159,75
3525,0,6958,2617,4341,0,0,0,1.0,1,1.0,1,1.0,1,0.07506587956510721,75
3526,2,6960,2618,4342,0,0,0,1.0,1,1.0,1,1.0,1,0.06534841735596206,76
3527,3,6963,2620,4343,0,0,0,1.0,1,1.0,1,1.0,1,0.09469034194381894,77
3528,4,6967,2621,4346,0,0,0,1.0,1,1.0,1,1.0,1,0.11733298418341688,77
3529,9,6976,2623,4353,0,0,0,1.0,1,1.0,1,1.0,1,0.11026802449122412,78
3530,3,6979,2623,4356,0,0,0,1.0,1,1.0,1,1.0,1,0.14363014401979585,78
3531,7,6986,2624,4362,0,0,0,1.0,1,1.0,1,1.0,1,0.15896422435936094,79
3532,7,6993,2624,4369,0,0,0,1.0,1,1.0,1,1.0,1,0.11827677884072628,79
3533,3,6996,2625,4371,0,0,0,1.0,1,1.0,1,1.0,1,0.13075233598023292,79
3534,7,7003,2628,4375,0,0,0,1.0,1,1.0,1,1.0,1,0.16141150419072345,80
3535,5,7008,2628,4380,0,0,0,1.0,1,1.0,1,1.0,1,0.1313039689835681,81
3536,1,7009,2629,4380,0,0,0,1.0,1,1.0,1,1.0,1,0.13837977963942089,82
3537,0,7009,2629,4380,0,0,0,1.0,1,1.0,1,1.0,1,0.13837977963942089,82
3538,3,7012,2629,4383,0,0,0,1.0,1,1.0,1,1.0,1,0.12308839968726325,83
3539,0,7012,2629,4383,0,0,0,1.0,1,1.0,1,1.0,1,0.12308839968726325,83
3540,1,7013,2630,4383,0,0,0,1.0,1,1.0,1,1.0,1,0.11570808681625706,85
3541,1,7014,2630,4384,0,0,0,1.0,1,1.0,1,1.0,1,0.11394197048971554,85
3542,3,7017,2630,4387,0,0,0,1.0,1,1.0,1,1.0,1,0.0831472525205356,88
3543,0,7017,2630,4387,0,0,0,1.0,1,1.0,1,1.0,1,0.08949518772711561,87
3544,3,7020,2630,4390,0,0,0,1.0,1,1.0,1,1.0,1,0.06751378555654258,87
3545,0,7020,2630,4390,0,0,0,1.0,1,1.0,1,1.0,1,0.0592291640798576,85
3546,2,7022,2631,4391,0,0,0,1.0,1,1.0,1,1.0,1,0.0548421149466644,83
3547,1,7023,2631,4392,0,0,0,1.0,1,1.0,1,1.0,1,0.046674301818890124,82
3548,2,7025,2633,4392,0,0,0,1.0,1,1.0,1,1.0,1,0.06308705128572853,82
3549,0,7025,2633,4392,0,0,0,1.0,1,1.0,1,1.0,1,0.06406484004000734,81
3550,2,7027,2634,4393,0,0,0,1.0,1,1.0,1,1.0,1,0.05158480407435902,79
3551,1,7028,2635,4393,0,0,0,1.0,1,1.0,1,1.0,1,0.06617642632007875,80
3552,2,7030,2636,4394,0,0,0,1.0,1,1.0,1,1.0,1,0.06975307062834901,78
3553,3,7033,2637,4396,0,0,0,1.0,1,1.0,1,1.0,1,0.07595161364111302,79
3554,0,7033,2637,4396,0,0,0,1.0,1,1.0,1,1.0,1,0.08629132418630388,77
3555,0,7033,2637,4396,0,0,0,1.0,1,1.0,1,1.0,1,0.09275693071622038,77
3556,3,7036,2637,4399,0,0,0,1.0,1,1.0,1,1.0,1,0.07890726351662851,76
3557,1,7037,2637,4400,0,0,0,1.0,1,1.0,1,1.0,1,0.06544534357969961,76
3558,1,7038,2638,4400,0,0,0,1.0,1,1.0,1,1.0,1,0.09626944975202524,76
3559,1,7039,2638,4401,0,0,0,1.0,1,1.0,1,1.0,1,0.0858053312587612,76
3560,2,7041,2639,4402,0,0,0,1.0,1,1.0,1,1.0,1,0.09066875867107606,78
3561,2,7043,2639,4404,0,0,0,1.0,1,1.0,1,1.0,1,0.08958625369128798,79
3562,3,7046,2640,4406,0,0,0,1.0,1,1.0,1,1.0,1,0.08624461171246821,79
3563,2,7048,2642,4406,0,0,0,1.0,1,1.0,1,1.0,1,0.07338881717887011,79
3564,3,7051,2644,4407,0,0,0,1.0,1,1.0,1,1.0,1,0.10592299258655853,80
3565,8,7059,2645,4414,0,0,0,1.0,1,1.0,1,1.0,1,0.09992887149096445,83
3566,3,7062,2646,4416,0,0,0,1.0,1,1.0,1,1.0,1,0.10327570994326839,84
3567,1,7063,2646,4417,0,0,0,1.0,1,1.0,1,1.0,1,0.10658832443498642,84
3568,8,7071,2648,4423,0,0,0,1.0,1,1.0,1,1.0,1,0.0828641167279682,84
3569,3,7074,2650,4424,0,0,0,1.0,1,1.0,1,1.0,1,0.101598341994255,84
3570,7,7081,2652,4429,0,0,0,1.0,1,1.0,1,1.0,1,0.09342850468613828,87
3571,2,7083,2653,4430,0,0,0,1.0,1,1.0,1,1.0,1,0.1099514040142836,86
3572,4,7087,2655,4432,0,0,0,1.0,1,1.0,1,1.0,1,0.11578239557524314,87
3573,4,7091,2657,4434,0,0,0,1.0,1,1.0,1,1.0,1,0.14229589226893852,87
3574,6,7097,2659,4438,0,0,0,1.0,1,1.0,1,1.0,1,0.1563644213761993,88
3575,3,7100,2659,4441,0,0,0,1.0,1,1.0,1,1.0,1,0.1412859336797681,88
3576,3,7103,2660,4443,0,0,0,1.0,1,1.0,1,1.0,1,0.12882133248765576,90
3577,2,7105,2660,4445,0,0,0,1.0,1,1.0,1,1.0,1,0.12021953010808059,90
3578,2,7107,2660,4447,0,0,0,1.0,1,1.0,1,1.0,1,0.11409090847360942,91
3579,1,7108,2661,4447,0,0,0,1.0,1,1.0,1,1.0,1,0.11542105349446281,91
3580,7,7115,2661,4454,0,0,0,1.0,1,1.0,1,1.0,1,0.1282955968382525,91
3581,4,7119,2661,4458,0,0,0,1.0,1,1.0,1,1.0,1,0.09766071343932355,91
3582,6,7125,2662,4463,0,0,0,1.0,1,1.0,1,1.0,1,0.10147907957599066,92
3583,3,7128,2662,4466,0,0,0,1.0,1,1.0,1,1.0,1,0.08271564483293767,88
3584,1,7129,2663,4466,0,0,0,1.0,1,1.0,1,1.0,1,0.08470010446523357,87
3585,1,7130,2664,4466,0,0,0,1.0,1,1.0,1,1.0,1,0.10671354291869246,84
3586,6,7136,2666,4470,0,0,0,1.0,1,1.0,1,1.0,1,0.07757365708556846,83
3587,2,7138,2667,4471,0,0,0,1.0,1,1.0,1,1.0,1,0.057690369728247384,82
3588,1,7139,2668,4471,0,0,0,1.0,1,1.0,1,1.0,1,0.07320707792270356,81
3589,5,7144,2671,4473,0,0,0,1.0,1,1.0,1,1.0,1,0.08592637232517449,80
3590,2,7146,2672,4474,0,0,0,1.0,1,1.0,1,1.0,1,0.11914641434357938,78
3591,2,7148,2673,4475,0,0,0,1.0,1,1.0,1,1.0,1,0.09494055651234863,77
3592,4,7152,2674,4478,0,0,0,1.0,1,1.0,1,1.0,1,0.0754001322116188,75
3593,1,7153,2674,4479,0,0,0,1.0,1,1.0,1,1.0,1,0.08272526963697939,76
3594,1,7154,2675,4479,0,0,0,1.0,1,1.0,1,1.0,1,0.09032088699682071,74
3595,3,7157,2676,4481,0,0,0,1.0,1,1.0,1,1.0,1,0.09239626159488716,74
3596,0,7157,2676,4481,0,0,0,1.0,1,1.0,1,1.0,1,0.09656550251871038,73
3597,2,7159,2678,4481,0,0,0,1.0,1,1.0,1,1.0,1,0.10326451746111465,73
3598,3,7162,2679,4483,0,0,0,1.0,1,1.0,1,1.0,1,0.09532123318199405,73
3599,1,7163,2679,4484,0,0,0,1.0,1,1.0,1,1.0,1,0.08898842475688332,73
3600,1,7164,2679,4485,0,0,0,1.0,1,1.0,1,1.0,1,0.08027789936763585,74
3601,5,7169,2683,4486,0,0,0,1.0,1,1.0,1,1.0,1,0.11443313553154169,75
3602,1,7170,2683,4487,0,0,0,1.0,1,1.0,1,1.0,1,0.09124001487465316,76
3603,4,7174,2685,4489,0,0,0,1.0,1,1.0,1,1.0,1,0.11470978937257895,77
3604,4,7178,2687,4491,0,0,0,1.0,1,1.0,1,1.0,1,0.13632247109970866,78
3605,5,7183,2689,4494,0,0,0,1.0,1,1.0,1,1.0,1,0.12237675070477057,77
3606,2,7185,2689,4496,0,0,0,1.0,1,1.0,1,1.0,1,0.10748735800955607,79
3607,3,7188,2689,4499,0,0,0,1.0,1,1.0,1,1.0,1,0.08623044728668168,79
3608,1,7189,2689,4500,0,0,0,1.0,1,1.0,1,1.0,1,0.08337014944704138,79
3609,0,7189,2689,4500,0,0,0,1.0,1,1.0,1,1.0,1,0.08337014944704138,79
3610,3,7192,2691,4501,0,0,0,1.0,1,1.0,1,1.0,1,0.0872391595126066,80
3611,2,7194,2692,4502,0,0,0,1.0,1,1.0,1,1.0,1,0.0729952043980001,80
3612,1,7195,2693,4502,0,0,0,1.0,1,1.0,1,1.0,1,0.09703834930093133,79
3613,5,7200,2695,4505,0,0,0,1.0,1,1.0,1,1.0,1,0.08360933824567578,79
3614,4,7204,2698,4506,0,0,0,1.0,1,1.0,1,1.0,1,0.07834695442280606,78
3615,2,7206,2698,4508,0,0,0,1.0,1,1.0,1,1.0,1,0.06645542831033684,79
3616,2,7208,2699,4509,0,0,0,1.0,1,1.0,1,1.0,1,0.07084824587887505,79
3617,1,7209,2700,4509,0,0,0,1.0,1,1.0,1,1.0,1,0.0706568866085673,80
3618,3,7212,2700,4512,0,0,0,1.0,1,1.0,1,1.0,1,0.07119716539541958,82
3619,2,7214,2700,4514,0,0,0,1.0,1,1.0,1,1.0,1,0.074356302639844,82
3620,1,7215,2701,4514,0,0,0,1.0,1,1.0,1,1.0,1,0.08474334012105011,81
3621,1,7216,2701,4515,0,0,0,1.0,1,1.0,1,1.0,1,0.08881908840564466,83
3622,2,7218,2701,4517,0,0,0,1.0,1,1.0,1,1.0,1,0.07066742183373834,81
3623,1,7219,2702,4517,0,0,0,1.0,1,1.0,1,1.0,1,0.07906987357961927,81
3624,1,7220,2703,4517,0,0,0,1.0,1,1.0,1,1.0,1,0.0925863829289143,79
3625,6,7226,2705,4521,0,0,0,1.0,1,1.0,1,1.0,1,0.07360228933920035,80
3626,1,7227,2705,4522,0,0,0,1.0,1,1.0,1,1.0,1,0.06428582146502332,78
3627,3,7230,2707,4523,0,0,0,1.0,1,1.0,1,1.0,1,0.09447048843424401,78
3628,4,7234,2707,4527,0,0,0,1.0,1,1.0,1,1.0,1,0.055653238553258724,77
3629,0,7234,2707,4527,0,0,0,1.0,1,1.0,1,1.0,1,0.05630862659302498,76
3630,2,7236,2708,4528,0,0,0,1.0,1,1.0,1,1.0,1,0.060606710966841705,77
3631,1,7237,2708,4529,0,0,0,1.0,1,1.0,1,1.0,1,0.051761080025342694,75
3632,6,7243,2711,4532,0,0,0,1.0,1,1.0,1,1.0,1,0.10284006450850114,74
3633,4,7247,2713,4534,0,0,0,1.0,1,1.0,1,1.0,1,0.08213343172502004,75
3634,3,7250,2715,4535,0,0,0,1.0,1,1.0,1,1.0,1,0.12034347190747557,74
3635,3,7253,2717,4536,0,0,0,1.0,1,1.0,1,1.0,1,0.11187846716224344,74
3636,3,7256,2718,4538,0,0,0,1.0,1,1.0,1,1.0,1,0.10633584329788247,74
3637,2,7258,2719,4539,0,0,0,1.0,1,1.0,1,1.0,1,0.10734616597316689,74
3638,2,7260,2719,4541,0,0,0,1.0,1,1.0,1,1.0,1,0.10233315226978232,75
3639,4,7264,2720,4544,0,0,0,1.0,1,1.0,1,1.0,1,0.10222962765046048,76
3640,1,7265,2720,4545,0,0,0,1.0,1,1.0,1,1.0,1,0.09143901220747327,76
3641,2,7267,2722,4545,0,0,0,1.0,1,1.0,1,1.0,1,0.11138657630368745,75
3642,2,7269,2724,4545,0,0,0,1.0,1,1.0,1,1.0,1,0.14580818383989697,75
3643,2,7271,2724,4547,0,0,0,1.0,1,1.0,1,1.0,1,0.13161181220714507,74
3644,1,7272,2725,4547,0,0,0,1.0,1,1.0,1,1.0,1,0.12837100043445515,74
3645,3,7275,2725,4550,0,0,0,1.0,1,1.0,1,1.0,1,0.09778179906643873,74
3646,2,7277,2725,4552,0,0,0,1.0,1,1.0,1,1.0,1,0.06453587223617654,75
3647,2,7279,2725,4554,0,0,0,1.0,1,1.0,1,1.0,1,0.0597177634755302,77
3648,2,7281,2725,4556,0,0,0,1.0,1,1.0,1,1.0,1,0.0667288782240012,78
3649,0,7281,2725,4556,0,0,0,1.0,1,1.0,1,1.0,1,0.07241275639297155,80
3650,2,7283,2726,4557,0,0,0,1.0,1,1.0,1,1.0,1,0.08538353308338585,81
3651,3,7286,2726,4560,0,0,0,1.0,1,1.0,1,1.0,1,0.08177637237824194,81
3652,3,7289,2727,4562,0,0,0,1.0,1,1.0,1,1.0,1,0.10064283353856217,83
3653,0,7289,2727,4562,0,0,0,1.0,1,1.0,1,1.0,1,0.10064283353856217,83
3654,0,7289,2727,4562,0,0,0,1.0,1,1.0,1,1.0,1,0.10064283353856217,83
3655,2,7291,2727,4564,0,0,0,1.0,1,1.0,1,1.0,1,0.08671054537942646,84
3656,1,7292,2727,4565,0,0,0,1.0,1,1.0,1,1.0,1,0.08687839106474199,85
3657,2,7294,2728,4566,0,0,0,1.0,1,1.0,1,1.0,1,0.09729011288074049,86
3658,1,7295,2728,4567,0,0,0,1.0,1,1.0,1,1.0,1,0.08433987494435845,87
3659,1,7296,2729,4567,0,0,0,1.0,1,1.0,1,1.0,1,0.09796325781584497,87
3660,0,7296,2729,4567,0,0,0,1.0,1,1.0,1,1.0,1,0.0982240871346195,86
3661,2,7298,2730,4568,0,0,0,1.0,1,1.0,1,1.0,1,0.10723490553838132,86
3662,2,7300,2731,4569,0,0,0,1.0,1,1.0,1,1.0,1,0.12092175270852376,83
3663,8,7308,2737,4571,0,0,0,1.0,1,1.0,1,1.0,1,0.15237543537667664,85
3664,9,7317,2739,4578,0,0,0,1.0,1,1.0,1,1.0,1,0.113200974267537,82
3665,3,7320,2741,4579,0,0,0,1.0,1,1.0,1,1.0,1,0.10786008343426194,81
3666,1,7321,2742,4579,0,0,0,1.0,1,1.0,1,1.0,1,0.12848054051363655,79
3667,5,7326,2744,4582,0,0,0,1.0,1,1.0,1,1.0,1,0.10839541354255837,79
3668,2,7328,2745,4583,0,0,0,1.0,1,1.0,1,1.0,1,0.10403159704804744,77
3669,1,7329,2745,4584,0,0,0,1.0,1,1.0,1,1.0,1,0.0978746394389952,75
3670,2,7331,2746,4585,0,0,0,1.0,1,1.0,1,1.0,1,0.11388932786175007,76
3671,1,7332,2746,4586,0,0,0,1.0,1,1.0,1,1.0,1,0.09625144162496807,74
3672,2,7334,2747,4587,0,0,0,1.0,1,1.0,1,1.0,1,0.08954152398733724,75
3673,1,7335,2748,4587,0,0,0,1.0,1,1.0,1,1.0,1,0.1051260622381334,75
3674,4,7339,2750,4589,0,0,0,1.0,1,1.0,1,1.0,1,0.08973903776272092,75
3675,0,7339,2750,4589,0,0,0,1.0,1,1.0,1,1.0,1,0.09048330566134924,75
3676,1,7340,2751,4589,0,0,0,1.0,1,1.0,1,1.0,1,0.10588542892150841,75
3677,1,7341,2751,4590,0,0,0,1.0,1,1.0,1,1.0,1,0.10320319114284594,75
3678,1,7342,2751,4591,0,0,0,1.0,1,1.0,1,1.0,1,0.10440865538545396,77
3679,2,7344,2752,4592,0,0,0,1.0,1,1.0,1,1.0,1,0.1275244028150414,78
3680,2,7346,2752,4594,0,0,0,1.0,1,1.0,1,1.0,1,0.12817637649449806,80
3681,1,7347,2752,4595,0,0,0,1.0,1,1.0,1,1.0,1,0.1310624542569954,81
3682,2,7349,2752,4597,0,0,0,1.0,1,1.0,1,1.0,1,0.118607945100122,81
3683,1,7350,2753,4597,0,0,0,1.0,1,1.0,1,1.0,1,0.12861356495126514,81
3684,0,7350,2753,4597,0,0,0,1.0,1,1.0,1,1.0,1,0.12861356495126514,81
3685,0,7350,2753,4597,0,0,0,1.0,1,1.0,1,1.0,1,0.12861356495126514,81
3686,0,7350,2753,4597,0,0,0,1.0,1,1.0,1,1.0,1,0.12861356495126514,81
3687,1,7351,2753,4598,0,0,0,1.0,1,1.0,1,1.0,1,0.11566693540781645,82
3688,1,7352,2753,4599,0,0,0,1.0,1,1.0,1,1.0,1,0.12094141380347774,84
3689,0,7352,2753,4599,0,0,0,1.0,1,1.0,1,1.0,1,0.12094141380347774,84
3690,2,7354,2755,4599,0,0,0,1.0,1,1.0,1,1.0,1,0.13325394365573864,85
3691,1,7355,2755,4600,0,0,0,1.0,1,1.0,1,1.0,1,0.12379642571840886,86
3692,1,7356,2755,4601,0,0,0,1.0,1,1.0,1,1.0,1,0.11209113862414861,86
3693,0,7356,2755,4601,0,0,0,1.0,1,1.0,1,1.0,1,0.11209113862414861,86
3694,0,7356,2755,4601,0,0,0,1.0,1,1.0,1,1.0,1,0.11209113862414861,86
3695,3,7359,2758,4601,0,0,0,1.0,1,1.0,1,1.0,1,0.15450673063907033,86
3696,2,7361,2758,4603,0,0,0,1.0,1,1.0,1,1.0,1,0.12712901329909163,87
3697,2,7363,2760,4603,0,0,0,1.0,1,1.0,1,1.0,1,0.13573735508689455,85
3698,0,7363,2760,4603,0,0,0,1.0,1,1.0,1,1.0,1,0.13602020782857574,85
3699,0,7363,2760,4603,0,0,0,1.0,1,1.0,1,1.0,1,0.12516991634168734,85
3700,4,7367,2762,4605,0,0,0,1.0,1,1.0,1,1.0,1,0.11739418732337628,84
3701,3,7370,2763,4607,0,0,0,1.0,1,1.0,1,1.0,1,0.14662943234691284,85
3702,5,7375,2766,4609,0,0,0,1.0,1,1.0,1,1.0,1,0.17748886857240795,85
3703,2,7377,2766,4611,0,0,0,1.0,1,1.0,1,1.0,1,0.16745815453257873,85
3704,2,7379,2767,4612,0,0,0,1.0,1,1.0,1,1.0,1,0.17378629998059164,85
3705,1,7380,2767,4613,0,0,0,1.0,1,1.0,1,1.0,1,0.1595853279489644,86
3706,3,7383,2767,4616,0,0,0,1.0,1,1.0,1,1.0,1,0.1386005631766711,86
3707,2,7385,2769,4616,0,0,0,1.0,1,1.0,1,1.0,1,0.16025669589003727,85
3708,1,7386,2769,4617,0,0,0,1.0,1,1.0,1,1.0,1,0.14092746888221416,84
3709,1,7387,2769,4618,0,0,0,1.0,1,1.0,1,1.0,1,0.145516150300359,85
3710,0,7387,2769,4618,0,0,0,1.0,1,1.0,1,1.0,1,0.1512525796361318,84
3711,3,7390,2769,4621,0,0,0,1.0,1,1.0,1,1.0,1,0.14204971992906873,85
3712,2,7392,2769,4623,0,0,0,1.0,1,1.0,1,1.0,1,0.13157306486822495,85
3713,1,7393,2769,4624,0,0,0,1.0,1,1.0,1,1.0,1,0.11447311788319837,85
3714,3,7396,2770,4626,0,0,0,1.0,1,1.0,1,1.0,1,0.12424724672977659,85
3715,2,7398,2770,4628,0,0,0,1.0,1,1.0,1,1.0,1,0.11929673777892885,85
3716,0,7398,2770,4628,0,0,0,1.0,1,1.0,1,1.0,1,0.12814646437594,84
3717,2,7400,2770,4630,0,0,0,1.0,1,1.0,1,1.0,1,0.129371356137748,86
3718,3,7403,2770,4633,0,0,0,1.0,1,1.0,1,1.0,1,0.13244467436986893,85
3719,1,7404,2771,4633,0,0,0,1.0,1,1.0,1,1.0,1,0.1489312690606995,84
3720,1,7405,2771,4634,0,0,0,1.0,1,1.0,1,1.0,1,0.163913589573652,84
3721,7,7412,2774,4638,0,0,0,1.0,1,1.0,1,1.0,1,0.1392599000437185,85
3722,2,7414,2775,4639,0,0,0,1.0,1,1.0,1,1.0,1,0.1433309771061614,85
3723,3,7417,2775,4642,0,0,0,1.0,1,1.0,1,1.0,1,0.13769177082045356,85
3724,2,7419,2775,4644,0,0,0,1.0,1,1.0,1,1.0,1,0.1158405027044601,86
3725,1,7420,2776,4644,0,0,0,1.0,1,1.0,1,1.0,1,0.11186534919678968,86
3726,1,7421,2776,4645,0,0,0,1.0,1,1.0,1,1.0,1,0.10611574982957404,86
3727,0,7421,2776,4645,0,0,0,1.0,1,1.0,1,1.0,1,0.10611574982957404,86
3728,1,7422,2777,4645,0,0,0,1.0,1,1.0,1,1.0,1,0.1286123569819106,86
3729,2,7424,2778,4646,0,0,0,1.0,1,1.0,1,1.0,1,0.12385686243446192,86
3730,0,7424,2778,4646,0,0,0,1.0,1,1.0,1,1.0,1,0.13570073146108594,85
3731,0,7424,2778,4646,0,0,0,1.0,1,1.0,1,1.0,1,0.14714899268866224,86
3732,1,7425,2779,4646,0,0,0,1.0,1,1.0,1,1.0,1,0.1570840892803707,87
3733,2,7427,2780,4647,0,0,0,1.0,1,1.0,1,1.0,1,0.1536885905559155,87
3734,1,7428,2780,4648,0,0,0,1.0,1,1.0,1,1.0,1,0.15045354432001376,87
3735,4,7432,2781,4651,0,0,0,1.0,1,1.0,1,1.0,1,0.13944496010949128,86
3736,1,7433,2781,4652,0,0,0,1.0,1,1.0,1,1.0,1,0.12389528874709713,87
3737,1,7434,2782,4652,0,0,0,1.0,1,1.0,1,1.0,1,0.13706330806192604,87
3738,1,7435,2782,4653,0,0,0,1.0,1,1.0,1,1.0,1,0.14256855502462737,87
3739,4,7439,2782,4657,0,0,0,1.0,1,1.0,1,1.0,1,0.1236091172745766,88
3740,2,7441,2783,4658,0,0,0,1.0,1,1.0,1,1.0,1,0.13677865010320533,87
3741,0,7441,2783,4658,0,0,0,1.0,1,1.0,1,1.0,1,0.13745642217301873,87
3742,4,7445,2784,4661,0,0,0,1.0,1,1.0,1,1.0,1,0.10483684507752744,86
3743,1,7446,2785,4661,0,0,0,1.0,1,1.0,1,1.0,1,0.11862892477311136,84
3744,1,7447,2786,4661,0,0,0,1.0,1,1.0,1,1.0,1,0.15023364415596827,83
3745,6,7453,2786,4667,0,0,0,1.0,1,1.0,1,1.0,1,0.11446657680512848,83
3746,3,7456,2787,4669,0,0,0,1.0,1,1.0,1,1.0,1,0.1208378931679208,83
3747,2,7458,2788,4670,0,0,0,1.0,1,1.0,1,1.0,1,0.12239339105196959,81
3748,1,7459,2788,4671,0,0,0,1.0,1,1.0,1,1.0,1,0.10874647694875884,81
3749,0,7459,2788,4671,0,0,0,1.0,1,1.0,1,1.0,1,0.10837915204865141,80
3750,0,7459,2788,4671,0,0,0,1.0,1,1.0,1,1.0,1,0.11337192846267276,79
3751,2,7461,2790,4671,0,0,0,1.0,1,1.0,1,1.0,1,0.13736031156037967,80
3752,2,7463,2791,4672,0,0,0,1.0,1,1.0,1,1.0,1,0.14609638197289576,80
3753,3,7466,2793,4673,0,0,0,1.0,1,1.0,1,1.0,1,0.16278920354605242,81
3754,5,7471,2794,4677,0,0,0,1.0,1,1.0,1,1.0,1,0.15476778973640334,81
3755,5,7476,2795,4681,0,0,0,1.0,1,1.0,1,1.0,1,0.16633361278198547,80
3756,3,7479,2796,4683,0,0,0,1.0,1,1.0,1,1.0,1,0.18965801834114715,79
3757,5,7484,2796,4688,0,0,0,1.0,1,1.0,1,1.0,1,0.1839587729459247,80
3758,1,7485,2796,4689,0,0,0,1.0,1,1.0,1,1.0,1,0.17717678484963073,79
3759,2,7487,2797,4690,0,0,0,1.0,1,1.0,1,1.0,1,0.17580734585429206,79
3760,3,7490,2798,4692,0,0,0,1.0,1,1.0,1,1.0,1,0.17309907728082977,79
3761,0,7490,2798,4692,0,0,0,1.0,1,1.0,1,1.0,1,0.18870170941992873,78
3762,1,7491,2798,4693,0,0,0,1.0,1,1.0,1,1.0,1,0.18326041027990525,80
3763,0,7491,2798,4693,0,0,0,1.0,1,1.0,1,1.0,1,0.18326041027990525,80
3764,2,7493,2800,4693,0,0,0,1.0,1,1.0,1,1.0,1,0.21442297039710712,80
3765,5,7498,2800,4698,0,0,0,1.0,1,1.0,1,1.0,1,0.19459711192019474,81
3766,10,7508,2801,4707,0,0,0,1.0,1,1.0,1,1.0,1,0.16563578096201434,83
3767,1,7509,2802,4707,0,0,0,1.0,1,1.0,1,1.0,1,0.16277209913596685,83
3768,1,7510,2803,4707,0,0,0,1.0,1,1.0,1,1.0,1,0.1674032554481939,84
3769,8,7518,2803,4715,0,0,0,1.0,1,1.0,1,1.0,1,0.11270010922221306,86
3770,2,7520,2803,4717,0,0,0,1.0,1,1.0,1,1.0,1,0.11304955203579778,87
3771,4,7524,2803,4721,0,0,0,1.0,1,1.0,1,1.0,1,0.11307126177166307,87
3772,0,7524,2803,4721,0,0,0,1.0,1,1.0,1,1.0,1,0.123155600795736,88
3773,1,7525,2803,4722,0,0,0,1.0,1,1.0,1,1.0,1,0.11604008604638308,85
3774,1,7526,2803,4723,0,0,0,1.0,1,1.0,1,1.0,1,0.1127511172382388,85
3775,1,7527,2804,4723,0,0,0,1.0,1,1.0,1,1.0,1,0.14857526168016638,83
3776,4,7531,2805,4726,0,0,0,1.0,1,1.0,1,1.0,1,0.1547609404381942,82
3777,3,7534,2806,4728,0,0,0,1.0,1,1.0,1,1.0,1,0.14134825032958348,81
3778,3,7537,2806,4731,0,0,0,1.0,1,1.0,1,1.0,1,0.1223651924297613,81
3779,2,7539,2808,4731,0,0,0,1.0,1,1.0,1,1.0,1,0.15373437529543885,80
3780,1,7540,2808,4732,0,0,0,1.0,1,1.0,1,1.0,1,0.1662338693436475,80
3781,4,7544,2808,4736,0,0,0,1.0,1,1.0,1,1.0,1,0.14272370452726624,80
3782,0,7544,2808,4736,0,0,0,1.0,1,1.0,1,1.0,1,0.14272370452726624,80
3783,2,7546,2809,4737,0,0,0,1.0,1,1.0,1,1.0,1,0.14565100017168578,80
3784,0,7546,2809,4737,0,0,0,1.0,1,1.0,1,1.0,1,0.14447694819860737,79
3785,2,7548,2810,4738,0,0,0,1.0,1,1.0,1,1.0,1,0.16698357811169565,77
3786,0,7548,2810,4738,0,0,0,1.0,1,1.0,1,1.0,1,0.15727509548529178,78
3787,3,7551,2811,4740,0,0,0,1.0,1,1.0,1,1.0,1,0.17243219118194414,77
3788,4,7555,2812,4743,0,0,0,1.0,1,1.0,1,1.0,1,0.14935573349889777,78
3789,2,7557,2814,4743,0,0,0,1.0,1,1.0,1,1.0,1,0.18077637635026886,77
3790,4,7561,2815,4746,0,0,0,1.0,1,1.0,1,1.0,1,0.17034415238369718,77
3791,1,7562,2815,4747,0,0,0,1.0,1,1.0,1,1.0,1,0.16335854923146007,77
3792,0,7562,2815,4747,0,0,0,1.0,1,1.0,1,1.0,1,0.14943198025035875,78
3793,1,7563,2815,4748,0,0,0,1.0,1,1.0,1,1.0,1,0.1427543739271414,80
3794,4,7567,2815,4752,0,0,0,1.0,1,1.0,1,1.0,1,0.11594291929537112,82
3795,4,7571,2815,4756,0,0,0,1.0,1,1.0,1,1.0,1,0.10562621036097229,83
3796,3,7574,2815,4759,0,0,0,1.0,1,1.0,1,1.0,1,0.08780252469861854,83
3797,0,7574,2815,4759,0,0,0,1.0,1,1.0,1,1.0,1,0.09633463826365446,82
3798,1,7575,2816,4759,0,0,0,1.0,1,1.0,1,1.0,1,0.09585202820062606,82
3799,2,7577,2816,4761,0,0,0,1.0,1,1.0,1,1.0,1,0.09174261897905714,83
3800,1,7578,2817,4761,0,0,0,1.0,1,1.0,1,1.0,1,0.1042241861467509,83
3801,2,7580,2818,4762,0,0,0,1.0,1,1.0,1,1.0,1,0.10384547796814904,83
3802,1,7581,2819,4762,0,0,0,1.0,1,1.0,1,1.0,1,0.11612767880761868,82
3803,0,7581,2819,4762,0,0,0,1.0,1,1.0,1,1.0,1,0.12296614248021488,84
3804,1,7582,2819,4763,0,0,0,1.0,1,1.0,1,1.0,1,0.11094160582268364,84
3805,2,7584,2820,4764,0,0,0,1.0,1,1.0,1,1.0,1,0.1287958376148407,86
3806,0,7584,2820,4764,0,0,0,1.0,1,1.0,1,1.0,1,0.1287958376148407,86
3807,1,7585,2821,4764,0,0,0,1.0,1,1.0,1,1.0,1,0.1411231752586297,86
3808,2,7587,2821,4766,0,0,0,1.0,1,1.0,1,1.0,1,0.13097354656626853,85
3809,3,7590,2822,4768,0,0,0,1.0,1,1.0,1,1.0,1,0.13352670552084936,85
3810,0,7590,2822,4768,0,0,0,1.0,1,1.0,1,1.0,1,0.13352670552084936,85
3811,2,7592,2823,4769,0,0,0,1.0,1,1.0,1,1.0,1,0.12654493509240888,84
3812,0,7592,2823,4769,0,0,0,1.0,1,1.0,1,1.0,1,0.12723079976649368,83
3813,1,7593,2823,4770,0,0,0,1.0,1,1.0,1,1.0,1,0.12050459583791037,82
3814,2,7595,2825,4770,0,0,0,1.0,1,1.0,1,1.0,1,0.13330140048635572,81
3815,1,7596,2825,4771,0,0,0,1.0,1,1.0,1,1.0,1,0.12909572954827617,82
3816,2,7598,2825,4773,0,0,0,1.0,1,1.0,1,1.0,1,0.10247343992052745,81
3817,2,7600,2825,4775,0,0,0,1.0,1,1.0,1,1.0,1,0.08334752649262783,81
3818,2,7602,2827,4775,0,0,0,1.0,1,1.0,1,1.0,1,0.10883598432084884,81
3819,4,7606,2829,4777,0,0,0,1.0,1,1.0,1,1.0,1,0.12963498087079112,82
3820,3,7609,2829,4780,0,0,0,1.0,1,1.0,1,1.0,1,0.13161516820220528,84
3821,1,7610,2830,4780,0,0,0,1.0,1,1.0,1,1.0,1,0.1590979673898912,84
3822,2,7612,2830,4782,0,0,0,1.0,1,1.0,1,1.0,1,0.12946080317783715,82
3823,4,7616,2831,4785,0,0,0,1.0,1,1.0,1,1.0,1,0.10701186781925766,81
3824,0,7616,2831,4785,0,0,0,1.0,1,1.0,1,1.0,1,0.13266784875284188,78
3825,1,7617,2831,4786,0,0,0,1.0,1,1.0,1,1.0,1,0.14738507187355895,76
3826,5,7622,2832,4790,0,0,0,1.0,1,1.0,1,1.0,1,0.1411943111761112,76
3827,1,7623,2833,4790,0,0,0,1.0,1,1.0,1,1.0,1,0.17083451321149637,75
3828,1,7624,2834,4790,0,0,0,1.0,1,1.0,1,1.0,1,0.18424034900654687,74
3829,9,7633,2836,4797,0,0,0,1.0,1,1.0,1,1.0,1,0.1757949808908382,74
3830,2,7635,2836,4799,0,0,0,1.0,1,1.0,1,1.0,1,0.16828159167505383,74
3831,5,7640,2838,4802,0,0,0,1.0,1,1.0,1,1.0,1,0.18156078089658895,74
3832,5,7645,2838,4807,0,0,0,1.0,1,1.0,1,1.0,1,0.15729905188863266,73
3833,2,7647,2840,4807,0,0,0,1.0,1,1.0,1,1.0,1,0.1695515537421578,73
3834,4,7651,2841,4810,0,0,0,1.0,1,1.0,1,1.0,1,0.16126169592426823,74
3835,6,7657,2842,4815,0,0,0,1.0,1,1.0,1,1.0,1,0.13638318917565964,75
3836,2,7659,2842,4817,0,0,0,1.0,1,1.0,1,1.0,1,0.1337181448807446,75
3837,5,7664,2843,4821,0,0,0,1.0,1,1.0,1,1.0,1,0.17551754074129208,78
3838,7,7671,2844,4827,0,0,0,1.0,1,1.0,1,1.0,1,0.1395342193705029,78
3839,3,7674,2844,4830,0,0,0,1.0,1,1.0,1,1.0,1,0.10812325872153146,79
3840,3,7677,2845,4832,0,0,0,1.0,1,1.0,1,1.0,1,0.10445136021188252,82
3841,1,7678,2845,4833,0,0,0,1.0,1,1.0,1,1.0,1,0.09654488608289769,82
3842,0,7678,2845,4833,0,0,0,1.0,1,1.0,1,1.0,1,0.09475520916955056,82
3843,1,7679,2845,4834,0,0,0,1.0,1,1.0,1,1.0,1,0.08491326421136645,82
3844,0,7679,2845,4834,0,0,0,1.0,1,1.0,1,1.0,1,0.08575589112065451,83
3845,1,7680,2845,4835,0,0,0,1.0,1,1.0,1,1.0,1,0.08695175233738899,84
3846,2,7682,2845,4837,0,0,0,1.0,1,1.0,1,1.0,1,0.08701587515523926,85
3847,3,7685,2845,4840,0,0,0,1.0,1,1.0,1,1.0,1,0.08117339982659257,84
3848,2,7687,2846,4841,0,0,0,1.0,1,1.0,1,1.0,1,0.08434743983554249,84
3849,1,7688,2846,4842,0,0,0,1.0,1,1.0,1,1.0,1,0.08637697739463611,83
3850,6,7694,2846,4848,0,0,0,1.0,1,1.0,1,1.0,1,0.09778717422762613,80
3851,0,7694,2846,4848,0,0,0,1.0,1,1.0,1,1.0,1,0.09778717422762613,80
3852,0,7694,2846,4848,0,0,0,1.0,1,1.0,1,1.0,1,0.11397899814891067,79
3853,3,7697,2847,4850,0,0,0,1.0,1,1.0,1,1.0,1,0.10843765540345786,79
3854,3,7700,2849,4851,0,0,0,1.0,1,1.0,1,1.0,1,0.12982780472117955,78
3855,1,7701,2850,4851,0,0,0,1.0,1,1.0,1,1.0,1,0.1469270381763579,78
3856,6,7707,2851,4856,0,0,0,1.0,1,1.0,1,1.0,1,0.12658191469509317,80
3857,1,7708,2851,4857,0,0,0,1.0,1,1.0,1,1.0,1,0.11279407799138337,81
3858,2,7710,2852,4858,0,0,0,1.0,1,1.0,1,1.0,1,0.11032771510604274,81
3859,3,7713,2852,4861,0,0,0,1.0,1,1.0,1,1.0,1,0.09100825736453017,83
3860,2,7715,2853,4862,0,0,0,1.0,1,1.0,1,1.0,1,0.10846292974367813,82
3861,8,7723,2855,4868,0,0,0,1.0,1,1.0,1,1.0,1,0.15249556629072095,84
3862,3,7726,2855,4871,0,0,0,1.0,1,1.0,1,1.0,1,0.14206474969151403,85
3863,1,7727,2855,4872,0,0,0,1.0,1,1.0,1,1.0,1,0.13079415339023986,84
3864,1,7728,2856,4872,0,0,0,1.0,1,1.0,1,1.0,1,0.12566299631928168,83
3865,3,7731,2858,4873,0,0,0,1.0,1,1.0,1,1.0,1,0.12156265677116776,82
3866,0,7731,2858,4873,0,0,0,1.0,1,1.0,1,1.0,1,0.11417065104522557,81
3867,1,7732,2859,4873,0,0,0,1.0,1,1.0,1,1.0,1,0.11167047248763104,81
3868,3,7735,2861,4874,0,0,0,1.0,1,1.0,1,1.0,1,0.10654970147329858,81
3869,2,7737,2862,4875,0,0,0,1.0,1,1.0,1,1.0,1,0.10578067683102964,81
3870,0,7737,2862,4875,0,0,0,1.0,1,1.0,1,1.0,1,0.0936573910526476,80
3871,6,7743,2865,4878,0,0,0,1.0,1,1.0,1,1.0,1,0.1099502325532028,82
3872,2,7745,2865,4880,0,0,0,1.0,1,1.0,1,1.0,1,0.07831691225490113,81
3873,0,7745,2865,4880,0,0,0,1.0,1,1.0,1,1.0,1,0.07831691225490113,81
3874,2,7747,2866,4881,0,0,0,1.0,1,1.0,1,1.0,1,0.06961924402796088,78
3875,0,7747,2866,4881,0,0,0,1.0,1,1.0,1,1.0,1,0.07088091917448945,77
3876,2,7749,2867,4882,0,0,0,1.0,1,1.0,1,1.0,1,0.07627440975112057,78
3877,2,7751,2867,4884,0,0,0,1.0,1,1.0,1,1.0,1,0.08078442886577414,75
3878,2,7753,2868,4885,0,0,0,1.0,1,1.0,1,1.0,1,0.07368341452642588,75
3879,0,7753,2868,4885,0,0,0,1.0,1,1.0,1,1.0,1,0.08578767120700789,73
3880,1,7754,2868,4886,0,0,0,1.0,1,1.0,1,1.0,1,0.07829382949836666,74
3881,1,7755,2868,4887,0,0,0,1.0,1,1.0,1,1.0,1,0.0838681832380409,75
3882,2,7757,2868,4889,0,0,0,1.0,1,1.0,1,1.0,1,0.0836866049862181,76
3883,1,7758,2868,4890,0,0,0,1.0,1,1.0,1,1.0,1,0.07613373708331596,77
3884,3,7761,2870,4891,0,0,0,1.0,1,1.0,1,1.0,1,0.10647697971594403,78
3885,0,7761,2870,4891,0,0,0,1.0,1,1.0,1,1.0,1,0.10647697971594403,78
3886,4,7765,2872,4893,0,0,0,1.0,1,1.0,1,1.0,1,0.09634369515111939,79
3887,2,7767,2873,4894,0,0,0,1.0,1,1.0,1,1.0,1,0.09593544810028035,78
3888,2,7769,2874,4895,0,0,0,1.0,1,1.0,1,1.0,1,0.10210891515983235,80
3889,4,7773,2874,4899,0,0,0,1.0,1,1.0,1,1.0,1,0.06209267914443043,82
3890,2,7775,2875,4900,0,0,0,1.0,1,1.0,1,1.0,1,0.06739497119732059,82
3891,5,7780,2877,4903,0,0,0,1.0,1,1.0,1,1.0,1,0.060585978249906185,85
3892,3,7783,2879,4904,0,0,0,1.0,1,1.0,1,1.0,1,0.0816100960086409,87
3893,1,7784,2879,4905,0,0,0,1.0,1,1.0,1,1.0,1,0.06780835811176963,86
3894,0,7784,2879,4905,0,0,0,1.0,1,1.0,1,1.0,1,0.0741459425300443,87
3895,3,7787,2881,4906,0,0,0,1.0,1,1.0,1,1.0,1,0.09544732114394566,87
3896,0,7787,2881,4906,0,0,0,1.0,1,1.0,1,1.0,1,0.10332224829240742,85
3897,1,7788,2882,4906,0,0,0,1.0,1,1.0,1,1.0,1,0.10862940816033875,85
3898,4,7792,2883,4909,0,0,0,1.0,1,1.0,1,1.0,1,0.1040068274844255,86
3899,4,7796,2885,4911,0,0,0,1.0,1,1.0,1,1.0,1,0.10721780718098184,86
3900,1,7797,2886,4911,0,0,0,1.0,1,1.0,1,1.0,1,0.11747636763860832,86
3901,6,7803,2887,4916,0,0,0,1.0,1,1.0,1,1.0,1,0.10468078380612753,86
3902,3,7806,2888,4918,0,0,0,1.0,1,1.0,1,1.0,1,0.11231355635857794,87
3903,4,7810,2891,4919,0,0,0,1.0,1,1.0,1,1.0,1,0.11010785605058007,87
3904,2,7812,2891,4921,0,0,0,1.0,1,1.0,1,1.0,1,0.08544753686795376,85
3905,0,7812,2891,4921,0,0,0,1.0,1,1.0,1,1.0,1,0.08487288330767599,84
3906,1,7813,2892,4921,0,0,0,1.0,1,1.0,1,1.0,1,0.08298786507317794,86
3907,7,7820,2895,4925,0,0,0,1.0,1,1.0,1,1.0,1,0.04996929058625608,84
3908,0,7820,2895,4925,0,0,0,1.0,1,1.0,1,1.0,1,0.049953200154818585,83
3909,2,7822,2897,4925,0,0,0,1.0,1,1.0,1,1.0,1,0.06640751384657398,81
3910,5,7827,2901,4926,0,0,0,1.0,1,1.0,1,1.0,1,0.08566370708184663,82
3911,3,7830,2903,4927,0,0,0,1.0,1,1.0,1,1.0,1,0.09349980073876385,81
3912,2,7832,2903,4929,0,0,0,1.0,1,1.0,1,1.0,1,0.0789937303755599,80
3913,3,7835,2905,4930,0,0,0,1.0,1,1.0,1,1.0,1,0.08256058395993643,80
3914,3,7838,2907,4931,0,0,0,1.0,1,1.0,1,1.0,1,0.09903666707121174,81
3915,4,7842,2909,4933,0,0,0,1.0,1,1.0,1,1.0,1,0.11137853461952969,81
3916,7,7849,2910,4939,0,0,0,1.0,1,1.0,1,1.0,1,0.09516427071479204,81
3917,0,7849,2910,4939,0,0,0,1.0,1,1.0,1,1.0,1,0.0880207439202373,82
3918,4,7853,2912,4941,0,0,0,1.0,1,1.0,1,1.0,1,0.11794263155523022,85
3919,3,7856,2914,4942,0,0,0,1.0,1,1.0,1,1.0,1,0.11039163033611696,85
3920,2,7858,2915,4943,0,0,0,1.0,1,1.0,1,1.0,1,0.09276644990872819,85
3921,4,7862,2915,4947,0,0,0,1.0,1,1.0,1,1.0,1,0.08763108645703432,88
3922,1,7863,2915,4948,0,0,0,1.0,1,1.0,1,1.0,1,0.07606571206481513,88
3923,1,7864,2915,4949,0,0,0,1.0,1,1.0,1,1.0,1,0.06577288083193124,89
3924,0,7864,2915,4949,0,0,0,1.0,1,1.0,1,1.0,1,0.0727435487227443,90
3925,1,7865,2916,4949,0,0,0,1.0,1,1.0,1,1.0,1,0.06496709443623845,88
3926,3,7868,2917,4951,0,0,0,1.0,1,1.0,1,1.0,1,0.06505967511228146,89
3927,2,7870,2919,4951,0,0,0,1.0,1,1.0,1,1.0,1,0.08067171248140714,89
3928,0,7870,2919,4951,0,0,0,1.0,1,1.0,1,1.0,1,0.0740214272988852,88
3929,0,7870,2919,4951,0,0,0,1.0,1,1.0,1,1.0,1,0.0740214272988852,88
3930,0,7870,2919,4951,0,0,0,1.0,1,1.0,1,1.0,1,0.08459940243828576,87
3931,3,7873,2920,4953,0,0,0,1.0,1,1.0,1,1.0,1,0.07512341992577186,86
3932,1,7874,2921,4953,0,0,0,1.0,1,1.0,1,1.0,1,0.09029790362417399,85
3933,2,7876,2922,4954,0,0,0,1.0,1,1.0,1,1.0,1,0.10334326352199667,84
3934,3,7879,2923,4956,0,0,0,1.0,1,1.0,1,1.0,1,0.09378025361158121,85
3935,5,7884,2926,4958,0,0,0,1.0,1,1.0,1,1.0,1,0.10180313251581086,84
3936,3,7887,2926,4961,0,0,0,1.0,1,1.0,1,1.0,1,0.09322213198320296,84
3937,2,7889,2926,4963,0,0,0,1.0,1,1.0,1,1.0,1,0.0825218482487654,82
3938,2,7891,2926,4965,0,0,0,1.0,1,1.0,1,1.0,1,0.060303016999386574,82
3939,2,7893,2926,4967,0,0,0,1.0,1,1.0,1,1.0,1,0.06146641564852829,84
3940,1,7894,2927,4967,0,0,0,1.0,1,1.0,1,1.0,1,0.06039366500939516,84
3941,0,7894,2927,4967,0,0,0,1.0,1,1.0,1,1.0,1,0.057454248067304696,85
3942,5,7899,2930,4969,0,0,0,1.0,1,1.0,1,1.0,1,0.06509117881061877,85
3943,3,7902,2930,4972,0,0,0,1.0,1,1.0,1,1.0,1,0.052131212753739734,84
3944,2,7904,2932,4972,0,0,0,1.0,1,1.0,1,1.0,1,0.0920308890405718,83
3945,3,7907,2933,4974,0,0,0,1.0,1,1.0,1,1.0,1,0.08070255864990142,83
3946,6,7913,2935,4978,0,0,0,1.0,1,1.0,1,1.0,1,0.09196271620997468,83
3947,1,7914,2935,4979,0,0,0,1.0,1,1.0,1,1.0,1,0.08702611627548897,83
3948,2,7916,2937,4979,0,0,0,1.0,1,1.0,1,1.0,1,0.1223871533825555,84
3949,5,7921,2937,4984,0,0,0,1.0,1,1.0,1,1.0,1,0.11832632745003425,84
3950,4,7925,2939,4986,0,0,0,1.0,1,1.0,1,1.0,1,0.13440510819630883,86
3951,5,7930,2939,4991,0,0,0,1.0,1,1.0,1,1.0,1,0.10629387536250194,87
3952,2,7932,2939,4993,0,0,0,1.0,1,1.0,1,1.0,1,0.08549537445858907,86
3953,1,7933,2940,4993,0,0,0,1.0,1,1.0,1,1.0,1,0.09635125683585576,86
3954,1,7934,2940,4994,0,0,0,1.0,1,1.0,1,1.0,1,0.09004305508233988,85
3955,0,7934,2940,4994,0,0,0,1.0,1,1.0,1,1.0,1,0.10474494156076232,85
3956,0,7934,2940,4994,0,0,0,1.0,1,1.0,1,1.0,1,0.11302552935392475,84
3957,2,7936,2941,4995,0,0,0,1.0,1,1.0,1,1.0,1,0.10746707602244719,85
3958,3,7939,2942,4997,0,0,0,1.0,1,1.0,1,1.0,1,0.10414894129806,84
3959,0,7939,2942,4997,0,0,0,1.0,1,1.0,1,1.0,1,0.11490007872324028,83
3960,4,7943,2944,4999,0,0,0,1.0,1,1.0,1,1.0,1,0.1292106775890441,84
3961,6,7949,2945,5004,0,0,0,1.0,1,1.0,1,1.0,1,0.11423177175377364,83
3962,1,7950,2946,5004,0,0,0,1.0,1,1.0,1,1.0,1,0.11710582090544365,84
3963,2,7952,2947,5005,0,0,0,1.0,1,1.0,1,1.0,1,0.11818035122697042,81
3964,6,7958,2949,5009,0,0,0,1.0,1,1.0,1,1.0,1,0.11012539256108587,81
3965,2,7960,2950,5010,0,0,0,1.0,1,1.0,1,1.0,1,0.11787210767155817,81
3966,1,7961,2951,5010,0,0,0,1.0,1,1.0,1,1.0,1,0.11606647585934099,79
3967,4,7965,2951,5014,0,0,0,1.0,1,1.0,1,1.0,1,0.08211501739852671,81
3968,0,7965,2951,5014,0,0,0,1.0,1,1.0,1,1.0,1,0.07329072053758173,79
3969,3,7968,2954,5014,0,0,0,1.0,1,1.0,1,1.0,1,0.11345098757418919,79
3970,4,7972,2956,5016,0,0,0,1.0,1,1.0,1,1.0,1,0.10485412897237324,78
3971,0,7972,2956,5016,0,0,0,1.0,1,1.0,1,1.0,1,0.13222481184288326,77
3972,1,7973,2957,5016,0,0,0,1.0,1,1.0,1,1.0,1,0.13339355722830173,78
3973,2,7975,2957,5018,0,0,0,1.0,1,1.0,1,1.0,1,0.11288031278886873,77
3974,0,7975,2957,5018,0,0,0,1.0,1,1.0,1,1.0,1,0.11288031278886873,77
3975,3,7978,2959,5019,0,0,0,1.0,1,1.0,1,1.0,1,0.14907676564875766,76
3976,3,7981,2959,5022,0,0,0,1.0,1,1.0,1,1.0,1,0.14761683701025913,77
3977,2,7983,2959,5024,0,0,0,1.0,1,1.0,1,1.0,1,0.13210470143639658,78
3978,3,7986,2960,5026,0,0,0,1.0,1,1.0,1,1.0,1,0.14710902820714056,79
3979,3,7989,2960,5029,0,0,0,1.0,1,1.0,1,1.0,1,0.13185255271263163,79
3980,0,7989,2960,5029,0,0,0,1.0,1,1.0,1,1.0,1,0.13185255271263163,79
3981,5,7994,2962,5032,0,0,0,1.0,1,1.0,1,1.0,1,0.1509318627539235,83
3982,4,7998,2962,5036,0,0,0,1.0,1,1.0,1,1.0,1,0.10847050486217805,83
3983,2,8000,2962,5038,0,0,0,1.0,1,1.0,1,1.0,1,0.11610984586902147,82
3984,2,8002,2962,5040,0,0,0,1.0,1,1.0,1,1.0,1,0.11437791948693067,83
3985,5,8007,2963,5044,0,0,0,1.0,1,1.0,1,1.0,1,0.09518157005762379,84
3986,3,8010,2964,5046,0,0,0,1.0,1,1.0,1,1.0,1,0.1136985464033126,83
3987,1,8011,2964,5047,0,0,0,1.0,1,1.0,1,1.0,1,0.12468887412123593,82
3988,5,8016,2965,5051,0,0,0,1.0,1,1.0,1,1.0,1,0.11362362641593096,83
3989,1,8017,2965,5052,0,0,0,1.0,1,1.0,1,1.0,1,0.11855590753377138,81
3990,1,8018,2965,5053,0,0,0,1.0,1,1.0,1,1.0,1,0.10625942594319336,81
3991,2,8020,2966,5054,0,0,0,1.0,1,1.0,1,1.0,1,0.12328088711174542,79
3992,3,8023,2966,5057,0,0,0,1.0,1,1.0,1,1.0,1,0.11692068265351316,81
3993,2,8025,2967,5058,0,0,0,1.0,1,1.0,1,1.0,1,0.11249703788801087,80
3994,3,8028,2968,5060,0,0,0,1.0,1,1.0,1,1.0,1,0.08841334008545104,80
3995,1,8029,2969,5060,0,0,0,1.0,1,1.0,1,1.0,1,0.08722083851019116,81
3996,2,8031,2969,5062,0,0,0,1.0,1,1.0,1,1.0,1,0.1048012116476002,80
3997,2,8033,2969,5064,0,0,0,1.0,1,1.0,1,1.0,1,0.09054605666261867,81
3998,3,8036,2970,5066,0,0,0,1.0,1,1.0,1,1.0,1,0.08928377645380288,82
3999,1,8037,2970,5067,0,0,0,1.0,1,1.0,1,1.0,1,0.08489157471913793,82
4000,2,8039,2971,5068,0,0,0,1.0,1,1.0,1,1.0,1,0.07738224690678489,82
4001,0,8039,2971,5068,0,0,0,1.0,1,1.0,1,1.0,1,0.06958743548421532,81
4002,2,8041,2973,5068,0,0,0,1.0,1,1.0,1,1.0,1,0.08003541025469751,81
4003,4,8045,2976,5069,0,0,0,1.0,1,1.0,1,1.0,1,0.12838764684491763,81
4004,4,8049,2978,5071,0,0,0,1.0,1,1.0,1,1.0,1,0.12476445807174491,80
4005,4,8053,2980,5073,0,0,0,1.0,1,1.0,1,1.0,1,0.13943112476164685,78
4006,3,8056,2981,5075,0,0,0,1.0,1,1.0,1,1.0,1,0.11586996077969186,76
4007,1,8057,2982,5075,0,0,0,1.0,1,1.0,1,1.0,1,0.14077573049752967,75
4008,0,8057,2982,5075,0,0,0,1.0,1,1.0,1,1.0,1,0.13160721335025508,74
4009,4,8061,2983,5078,0,0,0,1.0,1,1.0,1,1.0,1,0.12491155221716845,75
4010,3,8064,2983,5081,0,0,0,1.0,1,1.0,1,1.0,1,0.10630627988195246,75
4011,1,8065,2984,5081,0,0,0,1.0,1,1.0,1,1.0,1,0.1154235503683563,74
4012,2,8067,2985,5082,0,0,0,1.0,1,1.0,1,1.0,1,0.11343543082784373,74
4013,3,8070,2986,5084,0,0,0,1.0,1,1.0,1,1.0,1,0.11172060972210085,74
4014,1,8071,2986,5085,0,0,0,1.0,1,1.0,1,1.0,1,0.11644464726301601,73
4015,2,8073,2986,5087,0,0,0,1.0,1,1.0,1,1.0,1,0.10726547145063832,74
4016,0,8073,2986,5087,0,0,0,1.0,1,1.0,1,1.0,1,0.1186097497801974,74
4017,9,8082,2989,5093,0,0,0,1.0,1,1.0,1,1.0,1,0.12454867105874697,78
4018,6,8088,2991,5097,0,0,0,1.0,1,1.0,1,1.0,1,0.11853746205616039,78
4019,0,8088,2991,5097,0,0,0,1.0,1,1.0,1,1.0,1,0.11853746205616039,78
4020,3,8091,2992,5099,0,0,0,1.0,1,1.0,1,1.0,1,0.10316005308073782,78
4021,0,8091,2992,5099,0,0,0,1.0,1,1.0,1,1.0,1,0.10316005308073782,78
4022,2,8093,2994,5099,0,0,0,1.0,1,1.0,1,1.0,1,0.1242199886025252,79
4023,0,8093,2994,5099,0,0,0,1.0,1,1.0,1,1.0,1,0.12396173970520548,78
4024,4,8097,2995,5102,0,0,0,1.0,1,1.0,1,1.0,1,0.11634822278215583,77
4025,3,8100,2996,5104,0,0,0,1.0,1,1.0,1,1.0,1,0.11817008449306796,76
4026,3,8103,2997,5106,0,0,0,1.0,1,1.0,1,1.0,1,0.10923429839985206,76
4027,6,8109,3000,5109,0,0,0,1.0,1,1.0,1,1.0,1,0.13094045623766135,75
4028,2,8111,3000,5111,0,0,0,1.0,1,1.0,1,1.0,1,0.11954567114294803,76
4029,1,8112,3000,5112,0,0,0,1.0,1,1.0,1,1.0,1,0.11141089359484847,75
4030,3,8115,3001,5114,0,0,0,1.0,1,1.0,1,1.0,1,0.08538357869624195,74
4031,3,8118,3002,5116,0,0,0,1.0,1,1.0,1,1.0,1,0.11031073406577485,73
4032,1,8119,3002,5117,0,0,0,1.0,1,1.0,1,1.0,1,0.09897999672460042,71
4033,0,8119,3002,5117,0,0,0,1.0,1,1.0,1,1.0,1,0.09570663192916617,73
4034,4,8123,3005,5118,0,0,0,1.0,1,1.0,1,1.0,1,0.08889287018038411,72
4035,1,8124,3006,5118,0,0,0,1.0,1,1.0,1,1.0,1,0.10057642453866712,71
4036,3,8127,3008,5119,0,0,0,1.0,1,1.0,1,1.0,1,0.0842567491175776,71
4037,3,8130,3010,5120,0,0,0,1.0,1,1.0,1,1.0,1,0.0987739011793871,70
4038,1,8131,3010,5121,0,0,0,1.0,1,1.0,1,1.0,1,0.0958262096492301,69
4039,1,8132,3011,5121,0,0,0,1.0,1,1.0,1,1.0,1,0.1492099164847137,68
4040,4,8136,3013,5123,0,0,0,1.0,1,1.0,1,1.0,1,0.17504999332751786,69
4041,4,8140,3014,5126,0,0,0,1.0,1,1.0,1,1.0,1,0.2176915804599628,67
4042,7,8147,3014,5133,0,0,0,1.0,1,1.0,1,1.0,1,0.18669646385612368,67
4043,3,8150,3015,5135,0,0,0,1.0,1,1.0,1,1.0,1,0.1933356678473729,66
4044,3,8153,3016,5137,0,0,0,1.0,1,1.0,1,1.0,1,0.1877338434415307,65
4045,1,8154,3016,5138,0,0,0,1.0,1,1.0,1,1.0,1,0.18701560666191805,66
4046,4,8158,3017,5141,0,0,0,1.0,1,1.0,1,1.0,1,0.17565207210129485,68
4047,1,8159,3017,5142,0,0,0,1.0,1,1.0,1,1.0,1,0.17363186222429933,68
4048,2,8161,3017,5144,0,0,0,1.0,1,1.0,1,1.0,1,0.15414735481401481,69
4049,1,8162,3018,5144,0,0,0,1.0,1,1.0,1,1.0,1,0.16413905141417778,69
4050,0,8162,3018,5144,0,0,0,1.0,1,1.0,1,1.0,1,0.16475350989590365,69
4051,2,8164,3018,5146,0,0,0,1.0,1,1.0,1,1.0,1,0.15357533449170244,69
4052,1,8165,3018,5147,0,0,0,1.0,1,1.0,1,1.0,1,0.13781934899336876,69
4053,0,8165,3018,5147,0,0,0,1.0,1,1.0,1,1.0,1,0.13781934899336876,69
4054,1,8166,3018,5148,0,0,0,1.0,1,1.0,1,1.0,1,0.12942327592370506,70
4055,1,8167,3018,5149,0,0,0,1.0,1,1.0,1,1.0,1,0.11803843353963504,70
4056,1,8168,3018,5150,0,0,0,1.0,1,1.0,1,1.0,1,0.1119440741751066,70
4057,2,8170,3018,5152,0,0,0,1.0,1,1.0,1,1.0,1,0.09598513819808445,71
4058,0,8170,3018,5152,0,0,0,1.0,1,1.0,1,1.0,1,0.09598513819808445,71
4059,2,8172,3019,5153,0,0,0,1.0,1,1.0,1,1.0,1,0.11519550085606313,72
4060,0,8172,3019,5153,0,0,0,1.0,1,1.0,1,1.0,1,0.12339616628819282,71
4061,2,8174,3020,5154,0,0,0,1.0,1,1.0,1,1.0,1,0.12209818287218546,72
4062,0,8174,3020,5154,0,0,0,1.0,1,1.0,1,1.0,1,0.12209818287218546,72
4063,2,8176,3020,5156,0,0,0,1.0,1,1.0,1,1.0,1,0.10747650612523618,72
4064,3,8179,3022,5157,0,0,0,1.0,1,1.0,1,1.0,1,0.0920265813997729,71
4065,2,8181,3024,5157,0,0,0,1.0,1,1.0,1,1.0,1,0.10576862556830034,70
4066,9,8190,3026,5164,0,0,0,1.0,1,1.0,1,1.0,1,0.11671035861545856,70
4067,5,8195,3026,5169,0,0,0,1.0,1,1.0,1,1.0,1,0.06259482478795511,68
4068,3,8198,3027,5171,0,0,0,1.0,1,1.0,1,1.0,1,0.09424499614139543,70
4069,5,8203,3029,5174,0,0,0,1.0,1,1.0,1,1.0,1,0.08576777739704353,68
4070,1,8204,3030,5174,0,0,0,1.0,1,1.0,1,1.0,1,0.10592857347444828,67
4071,4,8208,3031,5177,0,0,0,1.0,1,1.0,1,1.0,1,0.11557360181966485,68
4072,8,8216,3033,5183,0,0,0,1.0,1,1.0,1,1.0,1,0.07059765973493459,70
4073,3,8219,3035,5184,0,0,0,1.0,1,1.0,1,1.0,1,0.07384962481383364,70
4074,2,8221,3037,5184,0,0,0,1.0,1,1.0,1,1.0,1,0.1008721188415343,71
4075,5,8226,3039,5187,0,0,0,1.0,1,1.0,1,1.0,1,0.09445284181298653,72
4076,4,8230,3042,5188,0,0,0,1.0,1,1.0,1,1.0,1,0.09748844751523944,73
4077,2,8232,3043,5189,0,0,0,1.0,1,1.0,1,1.0,1,0.10990112946100022,72
4078,2,8234,3045,5189,0,0,0,1.0,1,1.0,1,1.0,1,0.14561330570947872,71
4079,2,8236,3047,5189,0,0,0,1.0,1,1.0,1,1.0,1,0.15045552123411757,69
4080,1,8237,3048,5189,0,0,0,1.0,1,1.0,1,1.0,1,0.14856529759102913,67
4081,3,8240,3048,5192,0,0,0,1.0,1,1.0,1,1.0,1,0.12992666173690087,66
4082,1,8241,3048,5193,0,0,0,1.0,1,1.0,1,1.0,1,0.13696333189959348,65
4083,2,8243,3050,5193,0,0,0,1.0,1,1.0,1,1.0,1,0.17195238394152407,64
4084,4,8247,3051,5196,0,0,0,1.0,1,1.0,1,1.0,1,0.14234797617993367,64
4085,2,8249,3052,5197,0,0,0,1.0,1,1.0,1,1.0,1,0.13658449321949542,65
4086,1,8250,3053,5197,0,0,0,1.0,1,1.0,1,1.0,1,0.1443960373736499,66
4087,1,8251,3053,5198,0,0,0,1.0,1,1.0,1,1.0,1,0.13586975018615563,66
4088,1,8252,3053,5199,0,0,0,1.0,1,1.0,1,1.0,1,0.15883152771837036,65
4089,1,8253,3053,5200,0,0,0,1.0,1,1.0,1,1.0,1,0.1548024862829252,65
4090,3,8256,3053,5203,0,0,0,1.0,1,1.0,1,1.0,1,0.14212696511996498,65
4091,1,8257,3053,5204,0,0,0,1.0,1,1.0,1,1.0,1,0.1364546807941617,65
4092,1,8258,3053,5205,0,0,0,1.0,1,1.0,1,1.0,1,0.14597398420567684,64
4093,4,8262,3053,5209,0,0,0,1.0,1,1.0,1,1.0,1,0.11983709115358564,66
4094,1,8263,3054,5209,0,0,0,1.0,1,1.0,1,1.0,1,0.1388804120072563,65
4095,1,8264,3055,5209,0,0,0,1.0,1,1.0,1,1.0,1,0.14943957525356927,65
4096,4,8268,3056,5212,0,0,0,1.0,1,1.0,1,1.0,1,0.11142379616489784,67
4097,3,8271,3058,5213,0,0,0,1.0,1,1.0,1,1.0,1,0.11406382032683231,67
4098,1,8272,3059,5213,0,0,0,1.0,1,1.0,1,1.0,1,0.13414518770555284,68
4099,6,8278,3060,5218,0,0,0,1.0,1,1.0,1,1.0,1,0.09445898714940391,69
4100,2,8280,3061,5219,0,0,0,1.0,1,1.0,1,1.0,1,0.09892746446414097,70
4101,1,8281,3062,5219,0,0,0,1.0,1,1.0,1,1.0,1,0.11171493259937415,71
4102,5,8286,3064,5222,0,0,0,1.0,1,1.0,1,1.0,1,0.09971473105764524,71
4103,1,8287,3065,5222,0,0,0,1.0,1,1.0,1,1.0,1,0.10653091984006441,71
4104,2,8289,3067,5222,0,0,0,1.0,1,1.0,1,1.0,1,0.15112750551899762,69
4105,5,8294,3067,5227,0,0,0,1.0,1,1.0,1,1.0,1,0.1297577483878453,67
4106,1,8295,3068,5227,0,0,0,1.0,1,1.0,1,1.0,1,0.1486656246165513,68
4107,3,8298,3068,5230,0,0,0,1.0,1,1.0,1,1.0,1,0.12881195244058488,70
4108,1,8299,3068,5231,0,0,0,1.0,1,1.0,1,1.0,1,0.11743878780244367,70
4109,0,8299,3068,5231,0,0,0,1.0,1,1.0,1,1.0,1,0.12317277212004932,69
4110,0,8299,3068,5231,0,0,0,1.0,1,1.0,1,1.0,1,0.11054108252519901,71
4111,1,8300,3068,5232,0,0,0,1.0,1,1.0,1,1.0,1,0.10236415937803632,70
4112,0,8300,3068,5232,0,0,0,1.0,1,1.0,1,1.0,1,0.1125698414423369,72
4113,0,8300,3068,5232,0,0,0,1.0,1,1.0,1,1.0,1,0.1125698414423369,72
4114,6,8306,3071,5235,0,0,0,1.0,1,1.0,1,1.0,1,0.12497063812816833,72
4115,5,8311,3072,5239,0,0,0,1.0,1,1.0,1,1.0,1,0.10392858475352074,70
4116,3,8314,3073,5241,0,0,0,1.0,1,1.0,1,1.0,1,0.08968184782455312,67
4117,2,8316,3074,5242,0,0,0,1.0,1,1.0,1,1.0,1,0.10088407949314987,67
4118,0,8316,3074,5242,0,0,0,1.0,1,1.0,1,1.0,1,0.10866258501683944,66
4119,1,8317,3075,5242,0,0,0,1.0,1,1.0,1,1.0,1,0.14362458764425678,67
4120,4,8321,3077,5244,0,0,0,1.0,1,1.0,1,1.0,1,0.17950776787462736,64
4121,2,8323,3078,5245,0,0,0,1.0,1,1.0,1,1.0,1,0.18725483605274396,63
4122,2,8325,3079,5246,0,0,0,1.0,1,1.0,1,1.0,1,0.19100749675640927,63
4123,7,8332,3080,5252,0,0,0,1.0,1,1.0,1,1.0,1,0.14376985406201084,61
4124,4,8336,3082,5254,0,0,0,1.0,1,1.0,1,1.0,1,0.1463920108190645,62
4125,1,8337,3082,5255,0,0,0,1.0,1,1.0,1,1.0,1,0.1519148769092757,60
4126,4,8341,3084,5257,0,0,0,1.0,1,1.0,1,1.0,1,0.12293592514678539,59
4127,1,8342,3085,5257,0,0,0,1.0,1,1.0,1,1.0,1,0.11933663830835033,60
4128,1,8343,3086,5257,0,0,0,1.0,1,1.0,1,1.0,1,0.14498684248739185,60
4129,3,8346,3086,5260,0,0,0,1.0,1,1.0,1,1.0,1,0.1486910183116019,60
4130,3,8349,3089,5260,0,0,0,1.0,1,1.0,1,1.0,1,0.15494246738695336,61
4131,2,8351,3090,5261,0,0,0,1.0,1,1.0,1,1.0,1,0.13677743955874633,60
4132,1,8352,3090,5262,0,0,0,1.0,1,1.0,1,1.0,1,0.12759569642925278,60
4133,2,8354,3091,5263,0,0,0,1.0,1,1.0,1,1.0,1,0.1497133625629916,62
4134,1,8355,3092,5263,0,0,0,1.0,1,1.0,1,1.0,1,0.14509968578147872,63
4135,3,8358,3093,5265,0,0,0,1.0,1,1.0,1,1.0,1,0.12641467076638482,65
4136,0,8358,3093,5265,0,0,0,1.0,1,1.0,1,1.0,1,0.12641467076638482,65
4137,1,8359,3094,5265,0,0,0,1.0,1,1.0,1,1.0,1,0.14389127513395122,66
4138,0,8359,3094,5265,0,0,0,1.0,1,1.0,1,1.0,1,0.14402472279796616,67
4139,5,8364,3096,5268,0,0,0,1.0,1,1.0,1,1.0,1,0.14018723890009707,67
4140,0,8364,3096,5268,0,0,0,1.0,1,1.0,1,1.0,1,0.1362976120606341,66
4141,1,8365,3096,5269,0,0,0,1.0,1,1.0,1,1.0,1,0.11957118721815845,67
4142,1,8366,3096,5270,0,0,0,1.0,1,1.0,1,1.0,1,0.11619538035868793,67
4143,2,8368,3097,5271,0,0,0,1.0,1,1.0,1,1.0,1,0.11623848488470886,66
4144,3,8371,3097,5274,0,0,0,1.0,1,1.0,1,1.0,1,0.09843165830000326,64
4145,4,8375,3100,5275,0,0,0,1.0,1,1.0,1,1.0,1,0.13559977775978996,63
4146,6,8381,3104,5277,0,0,0,1.0,1,1.0,1,1.0,1,0.17900100755077333,62
4147,5,8386,3105,5281,0,0,0,1.0,1,1.0,1,1.0,1,0.1279298145799711,60
4148,7,8393,3107,5286,0,0,0,1.0,1,1.0,1,1.0,1,0.1387983154318647,62
4149,3,8396,3107,5289,0,0,0,1.0,1,1.0,1,1.0,1,0.12860247864573993,61
4150,2,8398,3107,5291,0,0,0,1.0,1,1.0,1,1.0,1,0.10381233464211294,60
4151,2,8400,3108,5292,0,0,0,1.0,1,1.0,1,1.0,1,0.12007821721022745,60
4152,1,8401,3109,5292,0,0,0,1.0,1,1.0,1,1.0,1,0.15359411316605967,60
4153,1,8402,3110,5292,0,0,0,1.0,1,1.0,1,1.0,1,0.16717491180216376,58
4154,2,8404,3111,5293,0,0,0,1.0,1,1.0,1,1.0,1,0.15531206859121388,57
4155,1,8405,3112,5293,0,0,0,1.0,1,1.0,1,1.0,1,0.1439110589934536,57
4156,3,8408,3112,5296,0,0,0,1.0,1,1.0,1,1.0,1,0.11102056621258823,58
4157,1,8409,3113,5296,0,0,0,1.0,1,1.0,1,1.0,1,0.12005092072353984,57
4158,1,8410,3114,5296,0,0,0,1.0,1,1.0,1,1.0,1,0.13784375282939293,55
4159,4,8414,3115,5299,0,0,0,1.0,1,1.0,1,1.0,1,0.13256989587729368,57
4160,2,8416,3116,5300,0,0,0,1.0,1,1.0,1,1.0,1,0.16500404284732165,58
4161,2,8418,3117,5301,0,0,0,1.0,1,1.0,1,1.0,1,0.156314906750054,58
4162,4,8422,3118,5304,0,0,0,1.0,1,1.0,1,1.0,1,0.12929881932560947,57
4163,0,8422,3118,5304,0,0,0,1.0,1,1.0,1,1.0,1,0.1271730620424341,58
4164,3,8425,3120,5305,0,0,0,1.0,1,1.0,1,1.0,1,0.14715770892969496,56
4165,3,8428,3120,5308,0,0,0,1.0,1,1.0,1,1.0,1,0.1351150019695134,58
4166,0,8428,3120,5308,0,0,0,1.0,1,1.0,1,1.0,1,0.1338553569286325,57
4167,1,8429,3120,5309,0,0,0,1.0,1,1.0,1,1.0,1,0.12555955571873742,57
4168,0,8429,3120,5309,0,0,0,1.0,1,1.0,1,1.0,1,0.13091038228583352,58
4169,0,8429,3120,5309,0,0,0,1.0,1,1.0,1,1.0,1,0.13091038228583352,58
4170,1,8430,3121,5309,0,0,0,1.0,1,1.0,1,1.0,1,0.16009843059909099,58
4171,0,8430,3121,5309,0,0,0,1.0,1,1.0,1,1.0,1,0.17695336604404444,57
4172,2,8432,3121,5311,0,0,0,1.0,1,1.0,1,1.0,1,0.1525212624373762,57
4173,2,8434,3123,5311,0,0,0,1.0,1,1.0,1,1.0,1,0.20441946219957824,56
4174,5,8439,3124,5315,0,0,0,1.0,1,1.0,1,1.0,1,0.1945984080287896,56
4175,2,8441,3124,5317,0,0,0,1.0,1,1.0,1,1.0,1,0.1825889081696075,55
4176,1,8442,3124,5318,0,0,0,1.0,1,1.0,1,1.0,1,0.18863851786413208,57
4177,3,8445,3124,5321,0,0,0,1.0,1,1.0,1,1.0,1,0.15771924063228468,58
4178,7,8452,3127,5325,0,0,0,1.0,1,1.0,1,1.0,1,0.11695473829808319,60
4179,0,8452,3127,5325,0,0,0,1.0,1,1.0,1,1.0,1,0.10677376359289108,61
4180,1,8453,3127,5326,0,0,0,1.0,1,1.0,1,1.0,1,0.09245627359938825,62
4181,2,8455,3127,5328,0,0,0,1.0,1,1.0,1,1.0,1,0.09774411268286842,63
4182,1,8456,3128,5328,0,0,0,1.0,1,1.0,1,1.0,1,0.10758218438684196,63
4183,2,8458,3129,5329,0,0,0,1.0,1,1.0,1,1.0,1,0.10144519448919752,63
4184,2,8460,3131,5329,0,0,0,1.0,1,1.0,1,1.0,1,0.12546757542630885,63
4185,1,8461,3131,5330,0,0,0,1.0,1,1.0,1,1.0,1,0.11021340828888819,61
4186,3,8464,3132,5332,0,0,0,1.0,1,1.0,1,1.0,1,0.10041645052159776,62
4187,2,8466,3132,5334,0,0,0,1.0,1,1.0,1,1.0,1,0.10792420837679781,60
4188,0,8466,3132,5334,0,0,0,1.0,1,1.0,1,1.0,1,0.13651115804627093,60
4189,6,8472,3133,5339,0,0,0,1.0,1,1.0,1,1.0,1,0.09808335999122578,60
4190,2,8474,3134,5340,0,0,0,1.0,1,1.0,1,1.0,1,0.1238291182755375,61
4191,2,8476,3135,5341,0,0,0,1.0,1,1.0,1,1.0,1,0.12484832600652901,59
4192,6,8482,3137,5345,0,0,0,1.0,1,1.0,1,1.0,1,0.08103444180903145,58
4193,1,8483,3138,5345,0,0,0,1.0,1,1.0,1,1.0,1,0.09742302843060596,57
4194,1,8484,3139,5345,0,0,0,1.0,1,1.0,1,1.0,1,0.11830791115410803,54
4195,4,8488,3141,5347,0,0,0,1.0,1,1.0,1,1.0,1,0.12326432301974857,55
4196,2,8490,3142,5348,0,0,0,1.0,1,1.0,1,1.0,1,0.12424618756437178,56
4197,0,8490,3142,5348,0,0,0,1.0,1,1.0,1,1.0,1,0.10881075879719873,55
4198,3,8493,3143,5350,0,0,0,1.0,1,1.0,1,1.0,1,0.1671155737249846,56
4199,2,8495,3144,5351,0,0,0,1.0,1,1.0,1,1.0,1,0.19778110873370486,55
4200,0,8495,3144,5351,0,0,0,1.0,1,1.0,1,1.0,1,0.19766507086799323,55
4201,3,8498,3144,5354,0,0,0,1.0,1,1.0,1,1.0,1,0.14438330748627887,56
4202,0,8498,3144,5354,0,0,0,1.0,1,1.0,1,1.0,1,0.14438330748627887,56
4203,1,8499,3144,5355,0,0,0,1.0,1,1.0,1,1.0,1,0.14546564326345113,57
4204,1,8500,3145,5355,0,0,0,1.0,1,1.0,1,1.0,1,0.14708274175708733,57
4205,2,8502,3145,5357,0,0,0,1.0,1,1.0,1,1.0,1,0.12074466691211357,58
4206,1,8503,3146,5357,0,0,0,1.0,1,1.0,1,1.0,1,0.1201947453148291,58
4207,1,8504,3147,5357,0,0,0,1.0,1,1.0,1,1.0,1,0.11347890091954001,58
4208,1,8505,3148,5357,0,0,0,1.0,1,1.0,1,1.0,1,0.12841956216333986,60
4209,3,8508,3150,5358,0,0,0,1.0,1,1.0,1,1.0,1,0.1407545026746994,61
4210,6,8514,3150,5364,0,0,0,1.0,1,1.0,1,1.0,1,0.09407730622571822,62
4211,4,8518,3151,5367,0,0,0,1.0,1,1.0,1,1.0,1,0.09473479425741298,63
4212,3,8521,3151,5370,0,0,0,1.0,1,1.0,1,1.0,1,0.0903129662787735,64
4213,0,8521,3151,5370,0,0,0,1.0,1,1.0,1,1.0,1,0.10410937801659913,65
4214,0,8521,3151,5370,0,0,0,1.0,1,1.0,1,1.0,1,0.11864044795281695,65
4215,0,8521,3151,5370,0,0,0,1.0,1,1.0,1,1.0,1,0.11864044795281695,65
4216,0,8521,3151,5370,0,0,0,1.0,1,1.0,1,1.0,1,0.12889526826454786,64
4217,3,8524,3152,5372,0,0,0,1.0,1,1.0,1,1.0,1,0.13161444754125542,65
4218,0,8524,3152,5372,0,0,0,1.0,1,1.0,1,1.0,1,0.13161444754125542,65
4219,4,8528,3153,5375,0,0,0,1.0,1,1.0,1,1.0,1,0.11505055904865845,65
4220,1,8529,3154,5375,0,0,0,1.0,1,1.0,1,1.0,1,0.13784756267735165,65
4221,1,8530,3155,5375,0,0,0,1.0,1,1.0,1,1.0,1,0.17692583865612418,67
4222,5,8535,3155,5380,0,0,0,1.0,1,1.0,1,1.0,1,0.1313083305720794,68
4223,5,8540,3158,5382,0,0,0,1.0,1,1.0,1,1.0,1,0.13755577491487464,68
4224,5,8545,3160,5385,0,0,0,1.0,1,1.0,1,1.0,1,0.13960754848889123,68
4225,4,8549,3161,5388,0,0,0,1.0,1,1.0,1,1.0,1,0.11415524845686188,66
4226,0,8549,3161,5388,0,0,0,1.0,1,1.0,1,1.0,1,0.11423174505344239,66
4227,1,8550,3162,5388,0,0,0,1.0,1,1.0,1,1.0,1,0.13292985287625536,66
4228,1,8551,3162,5389,0,0,0,1.0,1,1.0,1,1.0,1,0.1286966564746019,65
4229,0,8551,3162,5389,0,0,0,1.0,1,1.0,1,1.0,1,0.14105861077923368,65
4230,2,8553,3163,5390,0,0,0,1.0,1,1.0,1,1.0,1,0.13033055175369646,64
4231,4,8557,3164,5393,0,0,0,1.0,1,1.0,1,1.0,1,0.11587385698731438,64
4232,3,8560,3164,5396,0,0,0,1.0,1,1.0,1,1.0,1,0.10021967736835531,65
4233,2,8562,3164,5398,0,0,0,1.0,1,1.0,1,1.0,1,0.10537941437056247,64
4234,3,8565,3164,5401,0,0,0,1.0,1,1.0,1,1.0,1,0.08297269198040848,63
4235,0,8565,3164,5401,0,0,0,1.0,1,1.0,1,1.0,1,0.08297269198040848,63
4236,0,8565,3164,5401,0,0,0,1.0,1,1.0,1,1.0,1,0.08297269198040848,63
4237,1,8566,3165,5401,0,0,0,1.0,1,1.0,1,1.0,1,0.12017982759994938,65
4238,1,8567,3165,5402,0,0,0,1.0,1,1.0,1,1.0,1,0.11130823542469473,65
4239,0,8567,3165,5402,0,0,0,1.0,1,1.0,1,1.0,1,0.11130823542469473,65
4240,1,8568,3165,5403,0,0,0,1.0,1,1.0,1,1.0,1,0.09601368243890969,66
4241,0,8568,3165,5403,0,0,0,1.0,1,1.0,1,1.0,1,0.09601368243890969,66
4242,5,8573,3166,5407,0,0,0,1.0,1,1.0,1,1.0,1,0.08415052553181962,69
4243,1,8574,3166,5408,0,0,0,1.0,1,1.0,1,1.0,1,0.08605923899234554,71
4244,0,8574,3166,5408,0,0,0,1.0,1,1.0,1,1.0,1,0.08605923899234554,71
4245,1,8575,3166,5409,0,0,0,1.0,1,1.0,1,1.0,1,0.08282516553468221,73
4246,0,8575,3166,5409,0,0,0,1.0,1,1.0,1,1.0,1,0.082354660539785,74
4247,0,8575,3166,5409,0,0,0,1.0,1,1.0,1,1.0,1,0.082354660539785,74
4248,0,8575,3166,5409,0,0,0,1.0,1,1.0,1,1.0,1,0.082354660539785,74
4249,0,8575,3166,5409,0,0,0,1.0,1,1.0,1,1.0,1,0.082354660539785,74
4250,3,8578,3168,5410,0,0,0,1.0,1,1.0,1,1.0,1,0.09040608106679499,74
4251,0,8578,3168,5410,0,0,0,1.0,1,1.0,1,1.0,1,0.08926229104680888,75
4252,6,8584,3172,5412,0,0,0,1.0,1,1.0,1,1.0,1,0.1455387663460805,75
4253,3,8587,3172,5415,0,0,0,1.0,1,1.0,1,1.0,1,0.146201381679125,76
4254,3,8590,3175,5415,0,0,0,1.0,1,1.0,1,1.0,1,0.142165708491803,75
4255,5,8595,3176,5419,0,0,0,1.0,1,1.0,1,1.0,1,0.1116230323633412,76
4256,2,8597,3176,5421,0,0,0,1.0,1,1.0,1,1.0,1,0.1041164834543936,78
4257,2,8599,3176,5423,0,0,0,1.0,1,1.0,1,1.0,1,0.08556585267403614,78
4258,1,8600,3177,5423,0,0,0,1.0,1,1.0,1,1.0,1,0.1086588538891361,77
4259,3,8603,3178,5425,0,0,0,1.0,1,1.0,1,1.0,1,0.10174479336322634,78
4260,0,8603,3178,5425,0,0,0,1.0,1,1.0,1,1.0,1,0.10976253380303973,77
4261,1,8604,3179,5425,0,0,0,1.0,1,1.0,1,1.0,1,0.12008457376540334,76
4262,3,8607,3179,5428,0,0,0,1.0,1,1.0,1,1.0,1,0.12034917536302622,75
4263,1,8608,3180,5428,0,0,0,1.0,1,1.0,1,1.0,1,0.10310901286723767,74
4264,5,8613,3180,5433,0,0,0,1.0,1,1.0,1,1.0,1,0.09299145380518424,74
4265,3,8616,3182,5434,0,0,0,1.0,1,1.0,1,1.0,1,0.08446790198086758,73
4266,1,8617,3183,5434,0,0,0,1.0,1,1.0,1,1.0,1,0.10237650698828535,71
4267,4,8621,3186,5435,0,0,0,1.0,1,1.0,1,1.0,1,0.08895277684305891,69
4268,0,8621,3186,5435,0,0,0,1.0,1,1.0,1,1.0,1,0.11189584788012594,67
4269,3,8624,3189,5435,0,0,0,1.0,1,1.0,1,1.0,1,0.14398151610999688,64
4270,4,8628,3191,5437,0,0,0,1.0,1,1.0,1,1.0,1,0.11596287877562547,63
4271,4,8632,3192,5440,0,0,0,1.0,1,1.0,1,1.0,1,0.11995900435155057,63
4272,3,8635,3194,5441,0,0,0,1.0,1,1.0,1,1.0,1,0.15513356087247207,62
4273,2,8637,3195,5442,0,0,0,1.0,1,1.0,1,1.0,1,0.16201539570120976,62
4274,3,8640,3195,5445,0,0,0,1.0,1,1.0,1,1.0,1,0.14916464169345198,62
4275,1,8641,3195,5446,0,0,0,1.0,1,1.0,1,1.0,1,0.15734675055979144,61
4276,1,8642,3195,5447,0,0,0,1.0,1,1.0,1,1.0,1,0.137098830809796,62
4277,5,8647,3195,5452,0,0,0,1.0,1,1.0,1,1.0,1,0.11606881660341876,63
4278,2,8649,3196,5453,0,0,0,1.0,1,1.0,1,1.0,1,0.12883594741872648,64
4279,4,8653,3199,5454,0,0,0,1.0,1,1.0,1,1.0,1,0.13476322961209367,65
4280,0,8653,3199,5454,0,0,0,1.0,1,1.0,1,1.0,1,0.13476322961209367,65
4281,4,8657,3200,5457,0,0,0,1.0,1,1.0,1,1.0,1,0.13927776582751364,65
4282,7,8664,3203,5461,0,0,0,1.0,1,1.0,1,1.0,1,0.15720464394474784,66
4283,1,8665,3204,5461,0,0,0,1.0,1,1.0,1,1.0,1,0.1783155135905402,66
4284,4,8669,3205,5464,0,0,0,1.0,1,1.0,1,1.0,1,0.1937795122507443,66
4285,4,8673,3205,5468,0,0,0,1.0,1,1.0,1,1.0,1,0.16251792922752914,67
4286,0,8673,3205,5468,0,0,0,1.0,1,1.0,1,1.0,1,0.16983454449658505,67
4287,1,8674,3205,5469,0,0,0,1.0,1,1.0,1,1.0,1,0.16341549366470587,67
4288,3,8677,3205,5472,0,0,0,1.0,1,1.0,1,1.0,1,0.13270053105083798,68
4289,0,8677,3205,5472,0,0,0,1.0,1,1.0,1,1.0,1,0.14713495526761106,68
4290,0,8677,3205,5472,0,0,0,1.0,1,1.0,1,1.0,1,0.1583402627126094,70
4291,4,8681,3206,5475,0,0,0,1.0,1,1.0,1,1.0,1,0.15414782247904943,71
4292,0,8681,3206,5475,0,0,0,1.0,1,1.0,1,1.0,1,0.15414782247904943,71
4293,0,8681,3206,5475,0,0,0,1.0,1,1.0,1,1.0,1,0.15414782247904943,71
4294,2,8683,3207,5476,0,0,0,1.0,1,1.0,1,1.0,1,0.1389763611317664,71
4295,2,8685,3208,5477,0,0,0,1.0,1,1.0,1,1.0,1,0.14624058253151023,72
4296,2,8687,3209,5478,0,0,0,1.0,1,1.0,1,1.0,1,0.1682140556315473,73
4297,2,8689,3209,5480,0,0,0,1.0,1,1.0,1,1.0,1,0.15361787569271274,73
4298,2,8691,3210,5481,0,0,0,1.0,1,1.0,1,1.0,1,0.17188291418228693,74
4299,0,8691,3210,5481,0,0,0,1.0,1,1.0,1,1.0,1,0.161150980571156,75
4300,6,8697,3210,5487,0,0,0,1.0,1,1.0,1,1.0,1,0.10312939188950657,75
4301,0,8697,3210,5487,0,0,0,1.0,1,1.0,1,1.0,1,0.10302833520389637,76
4302,0,8697,3210,5487,0,0,0,1.0,1,1.0,1,1.0,1,0.10302833520389637,76
4303,1,8698,3210,5488,0,0,0,1.0,1,1.0,1,1.0,1,0.08935353016702119,75
4304,2,8700,3211,5489,0,0,0,1.0,1,1.0,1,1.0,1,0.1016636401814424,75
4305,1,8701,3212,5489,0,0,0,1.0,1,1.0,1,1.0,1,0.11736449266004287,73
4306,6,8707,3215,5492,0,0,0,1.0,1,1.0,1,1.0,1,0.11954151036864774,74
4307,4,8711,3216,5495,0,0,0,1.0,1,1.0,1,1.0,1,0.09320452579801178,73
4308,2,8713,3217,5496,0,0,0,1.0,1,1.0,1,1.0,1,0.12611417070944517,71
4309,3,8716,3218,5498,0,0,0,1.0,1,1.0,1,1.0,1,0.11290168294160025,70
4310,1,8717,3219,5498,0,0,0,1.0,1,1.0,1,1.0,1,0.124330434396008,69
4311,2,8719,3220,5499,0,0,0,1.0,1,1.0,1,1.0,1,0.11492574544065819,69
4312,5,8724,3221,5503,0,0,0,1.0,1,1.0,1,1.0,1,0.10901863279899426,66
4313,1,8725,3222,5503,0,0,0,1.0,1,1.0,1,1.0,1,0.12313557234030136,64
4314,1,8726,3222,5504,0,0,0,1.0,1,1.0,1,1.0,1,0.15287722990582156,61
4315,5,8731,3223,5508,0,0,0,1.0,1,1.0,1,1.0,1,0.11773899213245834,61
4316,0,8731,3223,5508,0,0,0,1.0,1,1.0,1,1.0,1,0.13527411431744998,60
4317,1,8732,3223,5509,0,0,0,1.0,1,1.0,1,1.0,1,0.12185315053226609,62
4318,3,8735,3224,5511,0,0,0,1.0,1,1.0,1,1.0,1,0.1264790432425568,59
4319,0,8735,3224,5511,0,0,0,1.0,1,1.0,1,1.0,1,0.11626896504105923,60
4320,0,8735,3224,5511,0,0,0,1.0,1,1.0,1,1.0,1,0.11626896504105923,60
4321,6,8741,3229,5512,0,0,0,1.0,1,1.0,1,1.0,1,0.16690408579745658,61
4322,8,8749,3232,5517,0,0,0,1.0,1,1.0,1,1.0,1,0.20417021882521083,61
4323,6,8755,3233,5522,0,0,0,1.0,1,1.0,1,1.0,1,0.2089276436766408,61
4324,3,8758,3233,5525,0,0,0,1.0,1,1.0,1,1.0,1,0.18411526434283287,60
4325,3,8761,3234,5527,0,0,0,1.0,1,1.0,1,1.0,1,0.18705462666551184,60
4326,0,8761,3234,5527,0,0,0,1.0,1,1.0,1,1.0,1,0.18189907919948012,61
4327,4,8765,3234,5531,0,0,0,1.0,1,1.0,1,1.0,1,0.12024521910491716,62
4328,0,8765,3234,5531,0,0,0,1.0,1,1.0,1,1.0,1,0.12024521910491716,62
4329,0,8765,3234,5531,0,0,0,1.0,1,1.0,1,1.0,1,0.11090769129623754,65
4330,1,8766,3234,5532,0,0,0,1.0,1,1.0,1,1.0,1,0.0916616542863127,65
4331,0,8766,3234,5532,0,0,0,1.0,1,1.0,1,1.0,1,0.0916616542863127,65
4332,2,8768,3235,5533,0,0,0,1.0,1,1.0,1,1.0,1,0.11404821829656872,66
4333,0,8768,3235,5533,0,0,0,1.0,1,1.0,1,1.0,1,0.11404821829656872,66
4334,1,8769,3236,5533,0,0,0,1.0,1,1.0,1,1.0,1,0.13154193708897208,66
4335,0,8769,3236,5533,0,0,0,1.0,1,1.0,1,1.0,1,0.14630009009559686,65
4336,5,8774,3239,5535,0,0,0,1.0,1,1.0,1,1.0,1,0.13822364942216792,67
4337,2,8776,3240,5536,0,0,0,1.0,1,1.0,1,1.0,1,0.1651316248196901,69
4338,1,8777,3240,5537,0,0,0,1.0,1,1.0,1,1.0,1,0.16227440927969675,70
4339,4,8781,3240,5541,0,0,0,1.0,1,1.0,1,1.0,1,0.12205177967072517,70
4340,1,8782,3240,5542,0,0,0,1.0,1,1.0,1,1.0,1,0.12629689412113076,71
4341,2,8784,3242,5542,0,0,0,1.0,1,1.0,1,1.0,1,0.1446566979867613,70
4342,2,8786,3242,5544,0,0,0,1.0,1,1.0,1,1.0,1,0.1373868119368842,71
4343,4,8790,3245,5545,0,0,0,1.0,1,1.0,1,1.0,1,0.1679705079186585,67
4344,8,8798,3248,5550,0,0,0,1.0,1,1.0,1,1.0,1,0.19920404860879815,67
4345,6,8804,3248,5556,0,0,0,1.0,1,1.0,1,1.0,1,0.14815912874173334,64
4346,2,8806,3249,5557,0,0,0,1.0,1,1.0,1,1.0,1,0.1359795541915003,64
4347,4,8810,3252,5558,0,0,0,1.0,1,1.0,1,1.0,1,0.18840591461090692,62
4348,4,8814,3254,5560,0,0,0,1.0,1,1.0,1,1.0,1,0.1733285593681962,62
4349,2,8816,3255,5561,0,0,0,1.0,1,1.0,1,1.0,1,0.20445864701033425,61
4350,1,8817,3255,5562,0,0,0,1.0,1,1.0,1,1.0,1,0.19882736146163424,60
4351,5,8822,3256,5566,0,0,0,1.0,1,1.0,1,1.0,1,0.17062981213192882,60
4352,0,8822,3256,5566,0,0,0,1.0,1,1.0,1,1.0,1,0.19125812084495097,57
4353,2,8824,3257,5567,0,0,0,1.0,1,1.0,1,1.0,1,0.19131526129196164,55
4354,5,8829,3259,5570,0,0,0,1.0,1,1.0,1,1.0,1,0.17354633913125117,55
4355,1,8830,3259,5571,0,0,0,1.0,1,1.0,1,1.0,1,0.17851595015248356,53
4356,0,8830,3259,5571,0,0,0,1.0,1,1.0,1,1.0,1,0.1590096786020198,55
4357,7,8837,3260,5577,0,0,0,1.0,1,1.0,1,1.0,1,0.10349580062881827,55
4358,2,8839,3260,5579,0,0,0,1.0,1,1.0,1,1.0,1,0.09317602420101417,55
4359,1,8840,3260,5580,0,0,0,1.0,1,1.0,1,1.0,1,0.1198133995103893,54
4360,2,8842,3260,5582,0,0,0,1.0,1,1.0,1,1.0,1,0.0771176188984165,55
4361,1,8843,3261,5582,0,0,0,1.0,1,1.0,1,1.0,1,0.10250944286112933,54
4362,0,8843,3261,5582,0,0,0,1.0,1,1.0,1,1.0,1,0.10238540209771768,55
4363,3,8846,3262,5584,0,0,0,1.0,1,1.0,1,1.0,1,0.09987066566126654,55
4364,1,8847,3263,5584,0,0,0,1.0,1,1.0,1,1.0,1,0.1151916534103879,55
4365,0,8847,3263,5584,0,0,0,1.0,1,1.0,1,1.0,1,0.1251565048226959,54
4366,4,8851,3264,5587,0,0,0,1.0,1,1.0,1,1.0,1,0.10203468808291312,54
4367,2,8853,3265,5588,0,0,0,1.0,1,1.0,1,1.0,1,0.1072477207149158,57
4368,0,8853,3265,5588,0,0,0,1.0,1,1.0,1,1.0,1,0.13847079837533374,57
4369,2,8855,3265,5590,0,0,0,1.0,1,1.0,1,1.0,1,0.10374727938483451,58
4370,3,8858,3267,5591,0,0,0,1.0,1,1.0,1,1.0,1,0.1238535325630796,59
4371,1,8859,3267,5592,0,0,0,1.0,1,1.0,1,1.0,1,0.10962814269477417,60
4372,3,8862,3268,5594,0,0,0,1.0,1,1.0,1,1.0,1,0.08816857549358006,60
4373,0,8862,3268,5594,0,0,0,1.0,1,1.0,1,1.0,1,0.08816857549358006,60
4374,2,8864,3269,5595,0,0,0,1.0,1,1.0,1,1.0,1,0.12105009669278234,59
4375,1,8865,3269,5596,0,0,0,1.0,1,1.0,1,1.0,1,0.118462628562242,60
4376,0,8865,3269,5596,0,0,0,1.0,1,1.0,1,1.0,1,0.13949283855489403,60
4377,4,8869,3272,5597,0,0,0,1.0,1,1.0,1,1.0,1,0.19654276860913497,61
4378,5,8874,3273,5601,0,0,0,1.0,1,1.0,1,1.0,1,0.16089582258522012,64
4379,4,8878,3274,5604,0,0,0,1.0,1,1.0,1,1.0,1,0.1619348144222989,64
4380,2,8880,3274,5606,0,0,0,1.0,1,1.0,1,1.0,1,0.16876957798456801,65
4381,3,8883,3275,5608,0,0,0,1.0,1,1.0,1,1.0,1,0.15948077530147486,64
4382,1,8884,3275,5609,0,0,0,1.0,1,1.0,1,1.0,1,0.1786592750903001,64
4383,2,8886,3277,5609,0,0,0,1.0,1,1.0,1,1.0,1,0.2029028172922934,64
4384,8,8894,3280,5614,0,0,0,1.0,1,1.0,1,1.0,1,0.23758628467416565,60
4385,2,8896,3281,5615,0,0,0,1.0,1,1.0,1,1.0,1,0.22026955834977408,58
4386,8,8904,3284,5620,0,0,0,1.0,1,1.0,1,1.0,1,0.21588867786136287,58
4387,4,8908,3285,5623,0,0,0,1.0,1,1.0,1,1.0,1,0.18689341749484625,55
4388,1,8909,3285,5624,0,0,0,1.0,1,1.0,1,1.0,1,0.1864872173858853,56
4389,1,8910,3285,5625,0,0,0,1.0,1,1.0,1,1.0,1,0.1633676706654065,55
4390,3,8913,3286,5627,0,0,0,1.0,1,1.0,1,1.0,1,0.155936858249831,55
4391,0,8913,3286,5627,0,0,0,1.0,1,1.0,1,1.0,1,0.14354470160487642,56
4392,2,8915,3287,5628,0,0,0,1.0,1,1.0,1,1.0,1,0.15069148646319463,56
4393,2,8917,3288,5629,0,0,0,1.0,1,1.0,1,1.0,1,0.16564393668898134,55
4394,0,8917,3288,5629,0,0,0,1.0,1,1.0,1,1.0,1,0.15256085077242557,53
4395,0,8917,3288,5629,0,0,0,1.0,1,1.0,1,1.0,1,0.15256085077242557,53
4396,3,8920,3290,5630,0,0,0,1.0,1,1.0,1,1.0,1,0.14447305001044414,53
4397,2,8922,3291,5631,0,0,0,1.0,1,1.0,1,1.0,1,0.17473182018618927,50
4398,3,8925,3292,5633,0,0,0,1.0,1,1.0,1,1.0,1,0.2040425152626887,50
4399,0,8925,3292,5633,0,0,0,1.0,1,1.0,1,1.0,1,0.1919305399558066,52
4400,6,8931,3293,5638,0,0,0,1.0,1,1.0,1,1.0,1,0.17250118018342353,55
4401,1,8932,3293,5639,0,0,0,1.0,1,1.0,1,1.0,1,0.1612386870371463,56
4402,2,8934,3294,5640,0,0,0,1.0,1,1.0,1,1.0,1,0.1645428627317248,56
4403,2,8936,3295,5641,0,0,0,1.0,1,1.0,1,1.0,1,0.15359763112214284,57
4404,0,8936,3295,5641,0,0,0,1.0,1,1.0,1,1.0,1,0.15359763112214284,57
4405,0,8936,3295,5641,0,0,0,1.0,1,1.0,1,1.0,1,0.15444250636770207,58
4406,0,8936,3295,5641,0,0,0,1.0,1,1.0,1,1.0,1,0.15444250636770207,58
4407,0,8936,3295,5641,0,0,0,1.0,1,1.0,1,1.0,1,0.15444250636770207,58
4408,1,8937,3296,5641,0,0,0,1.0,1,1.0,1,1.0,1,0.17415077487127797,59
4409,2,8939,3296,5643,0,0,0,1.0,1,1.0,1,1.0,1,0.15029362150103304,59
4410,0,8939,3296,5643,0,0,0,1.0,1,1.0,1,1.0,1,0.15029362150103304,59
4411,0,8939,3296,5643,0,0,0,1.0,1,1.0,1,1.0,1,0.13643095371981312,62
4412,0,8939,3296,5643,0,0,0,1.0,1,1.0,1,1.0,1,0.1469995906614788,63
4413,2,8941,3297,5644,0,0,0,1.0,1,1.0,1,1.0,1,0.12915385754169628,63
4414,1,8942,3297,5645,0,0,0,1.0,1,1.0,1,1.0,1,0.13277601326139007,64
4415,3,8945,3298,5647,0,0,0,1.0,1,1.0,1,1.0,1,0.12556699119820755,64
4416,0,8945,3298,5647,0,0,0,1.0,1,1.0,1,1.0,1,0.12556699119820755,64
4417,1,8946,3298,5648,0,0,0,1.0,1,1.0,1,1.0,1,0.12305154596617059,65
4418,2,8948,3300,5648,0,0,0,1.0,1,1.0,1,1.0,1,0.15445854830672998,65
4419,1,8949,3300,5649,0,0,0,1.0,1,1.0,1,1.0,1,0.195845572720255,62
4420,4,8953,3300,5653,0,0,0,1.0,1,1.0,1,1.0,1,0.14965247749044577,62
4421,3,8956,3301,5655,0,0,0,1.0,1,1.0,1,1.0,1,0.15581660714697296,65
4422,2,8958,3302,5656,0,0,0,1.0,1,1.0,1,1.0,1,0.1587451589279044,64
4423,2,8960,3302,5658,0,0,0,1.0,1,1.0,1,1.0,1,0.12558972779062555,63
4424,2,8962,3303,5659,0,0,0,1.0,1,1.0,1,1.0,1,0.12247714995450201,63
4425,6,8968,3305,5663,0,0,0,1.0,1,1.0,1,1.0,1,0.11638420984490577,63
4426,0,8968,3305,5663,0,0,0,1.0,1,1.0,1,1.0,1,0.09330492432764442,63
4427,0,8968,3305,5663,0,0,0,1.0,1,1.0,1,1.0,1,0.09177961210823583,62
4428,0,8968,3305,5663,0,0,0,1.0,1,1.0,1,1.0,1,0.09854622021666036,61
4429,3,8971,3307,5664,0,0,0,1.0,1,1.0,1,1.0,1,0.10350518819561806,62
4430,3,8974,3308,5666,0,0,0,1.0,1,1.0,1,1.0,1,0.09680093591532998,60
4431,4,8978,3311,5667,0,0,0,1.0,1,1.0,1,1.0,1,0.08473154446643374,59
4432,4,8982,3312,5670,0,0,0,1.0,1,1.0,1,1.0,1,0.04654072663624438,60
4433,10,8992,3316,5676,0,0,0,1.0,1,1.0,1,1.0,1,0.08964900543010967,61
4434,4,8996,3316,5680,0,0,0,1.0,1,1.0,1,1.0,1,0.08964900543010967,61
4435,3,8999,3317,5682,0,0,0,1.0,1,1.0,1,1.0,1,0.080699211676554,61
4436,0,8999,3317,5682,0,0,0,1.0,1,1.0,1,1.0,1,0.080699211676554,61
4437,2,9001,3319,5682,0,0,0,1.0,1,1.0,1,1.0,1,0.13484150197853453,61
4438,6,9007,3319,5688,0,0,0,1.0,1,1.0,1,1.0,1,0.0837167354164846,62
4439,2,9009,3319,5690,0,0,0,1.0,1,1.0,1,1.0,1,0.08859458282862488,63
4440,4,9013,3319,5694,0,0,0,1.0,1,1.0,1,1.0,1,0.11390802639741976,64
4441,4,9017,3320,5697,0,0,0,1.0,1,1.0,1,1.0,1,0.08753530675789678,64
4442,6,9023,3322,5701,0,0,0,1.0,1,1.0,1,1.0,1,0.12425779425375134,67
4443,2,9025,3323,5702,0,0,0,1.0,1,1.0,1,1.0,1,0.15297990774932493,68
4444,5,9030,3324,5706,0,0,0,1.0,1,1.0,1,1.0,1,0.11330844033821448,69
4445,3,9033,3324,5709,0,0,0,1.0,1,1.0,1,1.0,1,0.08842980489632342,71
4446,1,9034,3324,5710,0,0,0,1.0,1,1.0,1,1.0,1,0.09034198318335339,71
4447,1,9035,3324,5711,0,0,0,1.0,1,1.0,1,1.0,1,0.08055880475080213,72
4448,0,9035,3324,5711,0,0,0,1.0,1,1.0,1,1.0,1,0.08827041229924726,71
4449,1,9036,3325,5711,0,0,0,1.0,1,1.0,1,1.0,1,0.08539061856715013,70
4450,1,9037,3325,5712,0,0,0,1.0,1,1.0,1,1.0,1,0.08475205515955449,69
4451,0,9037,3325,5712,0,0,0,1.0,1,1.0,1,1.0,1,0.08464222015998321,69
4452,1,9038,3325,5713,0,0,0,1.0,1,1.0,1,1.0,1,0.09179018615851364,70
4453,4,9042,3325,5717,0,0,0,1.0,1,1.0,1,1.0,1,0.09393185383086777,70
4454,4,9046,3326,5720,0,0,0,1.0,1,1.0,1,1.0,1,0.0814388829903458,71
4455,2,9048,3326,5722,0,0,0,1.0,1,1.0,1,1.0,1,0.08860875744849883,71
4456,3,9051,3327,5724,0,0,0,1.0,1,1.0,1,1.0,1,0.07228833558832484,71
4457,2,9053,3328,5725,0,0,0,1.0,1,1.0,1,1.0,1,0.07358135851833011,69
4458,4,9057,3329,5728,0,0,0,1.0,1,1.0,1,1.0,1,0.10104396837494684,70
4459,5,9062,3331,5731,0,0,0,1.0,1,1.0,1,1.0,1,0.12602224005740081,68
4460,3,9065,3332,5733,0,0,0,1.0,1,1.0,1,1.0,1,0.12369179995518097,68
4461,0,9065,3332,5733,0,0,0,1.0,1,1.0,1,1.0,1,0.13458042734150907,67
4462,6,9071,3335,5736,0,0,0,1.0,1,1.0,1,1.0,1,0.12643807038918678,66
4463,5,9076,3338,5738,0,0,0,1.0,1,1.0,1,1.0,1,0.12458513451036973,65
4464,5,9081,3341,5740,0,0,0,1.0,1,1.0,1,1.0,1,0.15662234731984945,62
4465,6,9087,3344,5743,0,0,0,1.0,1,1.0,1,1.0,1,0.1320429111885813,61
4466,3,9090,3344,5746,0,0,0,1.0,1,1.0,1,1.0,1,0.12649515905080294,60
4467,4,9094,3347,5747,0,0,0,1.0,1,1.0,1,1.0,1,0.11251580119764289,58
4468,1,9095,3347,5748,0,0,0,1.0,1,1.0,1,1.0,1,0.10347828553817795,57
4469,2,9097,3348,5749,0,0,0,1.0,1,1.0,1,1.0,1,0.11444156659916965,56
4470,1,9098,3349,5749,0,0,0,1.0,1,1.0,1,1.0,1,0.13792952242920747,55
4471,3,9101,3350,5751,0,0,0,1.0,1,1.0,1,1.0,1,0.10889705379171513,55
4472,4,9105,3353,5752,0,0,0,1.0,1,1.0,1,1.0,1,0.1261327051388751,55
4473,2,9107,3355,5752,0,0,0,1.0,1,1.0,1,1.0,1,0.1548370433764384,55
4474,5,9112,3357,5755,0,0,0,1.0,1,1.0,1,1.0,1,0.15661033634568491,55
4475,4,9116,3358,5758,0,0,0,1.0,1,1.0,1,1.0,1,0.09781516065934982,56
4476,1,9117,3358,5759,0,0,0,1.0,1,1.0,1,1.0,1,0.07804372940438506,56
4477,0,9117,3358,5759,0,0,0,1.0,1,1.0,1,1.0,1,0.08959509080584387,57
4478,0,9117,3358,5759,0,0,0,1.0,1,1.0,1,1.0,1,0.10745943320177191,55
4479,1,9118,3359,5759,0,0,0,1.0,1,1.0,1,1.0,1,0.11111725862365703,55
4480,4,9122,3360,5762,0,0,0,1.0,1,1.0,1,1.0,1,0.12208679910095,54
4481,1,9123,3360,5763,0,0,0,1.0,1,1.0,1,1.0,1,0.14807474037308968,53
4482,2,9125,3362,5763,0,0,0,1.0,1,1.0,1,1.0,1,0.18279616627389172,54
4483,5,9130,3362,5768,0,0,0,1.0,1,1.0,1,1.0,1,0.12828681224263527,55
4484,0,9130,3362,5768,0,0,0,1.0,1,1.0,1,1.0,1,0.12199242964277437,57
4485,5,9135,3364,5771,0,0,0,1.0,1,1.0,1,1.0,1,0.10720275594397484,60
4486,2,9137,3365,5772,0,0,0,1.0,1,1.0,1,1.0,1,0.09730636291667165,60
4487,0,9137,3365,5772,0,0,0,1.0,1,1.0,1,1.0,1,0.09730636291667165,60
4488,0,9137,3365,5772,0,0,0,1.0,1,1.0,1,1.0,1,0.09730636291667165,60
4489,2,9139,3366,5773,0,0,0,1.0,1,1.0,1,1.0,1,0.07630559023171679,60
4490,0,9139,3366,5773,0,0,0,1.0,1,1.0,1,1.0,1,0.07630559023171679,60
4491,0,9139,3366,5773,0,0,0,1.0,1,1.0,1,1.0,1,0.07712000002933042,61
4492,1,9140,3367,5773,0,0,0,1.0,1,1.0,1,1.0,1,0.06743034847821407,61
4493,1,9141,3368,5773,0,0,0,1.0,1,1.0,1,1.0,1,0.10254502663539054,60
4494,2,9143,3369,5774,0,0,0,1.0,1,1.0,1,1.0,1,0.10387886981652407,61
4495,1,9144,3369,5775,0,0,0,1.0,1,1.0,1,1.0,1,0.08527458905575516,59
4496,0,9144,3369,5775,0,0,0,1.0,1,1.0,1,1.0,1,0.12534878291591714,60
4497,1,9145,3370,5775,0,0,0,1.0,1,1.0,1,1.0,1,0.16498235894208932,59
4498,2,9147,3370,5777,0,0,0,1.0,1,1.0,1,1.0,1,0.11584691774450677,57
4499,3,9150,3372,5778,0,0,0,1.0,1,1.0,1,1.0,1,0.13071228982629787,58
4500,4,9154,3374,5780,0,0,0,1.0,1,1.0,1,1.0,1,0.13751248828366583,56
4501,5,9159,3374,5785,0,0,0,1.0,1,1.0,1,1.0,1,0.08376109976501306,57
4502,4,9163,3378,5785,0,0,0,1.0,1,1.0,1,1.0,1,0.14990642837766943,56
4503,2,9165,3380,5785,0,0,0,1.0,1,1.0,1,1.0,1,0.19802559615282436,54
4504,7,9172,3380,5792,0,0,0,1.0,1,1.0,1,1.0,1,0.11210733804222907,54
4505,3,9175,3382,5793,0,0,0,1.0,1,1.0,1,1.0,1,0.12953480728255426,51
4506,3,9178,3382,5796,0,0,0,1.0,1,1.0,1,1.0,1,0.11498317675355924,49
4507,4,9182,3383,5799,0,0,0,1.0,1,1.0,1,1.0,1,0.10870514692147505,48
4508,0,9182,3383,5799,0,0,0,1.0,1,1.0,1,1.0,1,0.12873015935833462,48
4509,3,9185,3386,5799,0,0,0,1.0,1,1.0,1,1.0,1,0.13227671904427174,46
4510,3,9188,3386,5802,0,0,0,1.0,1,1.0,1,1.0,1,0.08413075718794345,44
4511,2,9190,3387,5803,0,0,0,1.0,1,1.0,1,1.0,1,0.094762018287094,45
4512,0,9190,3387,5803,0,0,0,1.0,1,1.0,1,1.0,1,0.09616365163472176,46
4513,2,9192,3388,5804,0,0,0,1.0,1,1.0,1,1.0,1,0.10017339388372615,45
4514,0,9192,3388,5804,0,0,0,1.0,1,1.0,1,1.0,1,0.09343491218336647,46
4515,0,9192,3388,5804,0,0,0,1.0,1,1.0,1,1.0,1,0.1125770041386184,48
4516,3,9195,3389,5806,0,0,0,1.0,1,1.0,1,1.0,1,0.13696641628272285,49
4517,1,9196,3389,5807,0,0,0,1.0,1,1.0,1,1.0,1,0.13620715228305316,50
4518,1,9197,3390,5807,0,0,0,1.0,1,1.0,1,1.0,1,0.13285494853353486,50
4519,3,9200,3392,5808,0,0,0,1.0,1,1.0,1,1.0,1,0.149440784498029,49
4520,0,9200,3392,5808,0,0,0,1.0,1,1.0,1,1.0,1,0.16015373526678434,50
4521,0,9200,3392,5808,0,0,0,1.0,1,1.0,1,1.0,1,0.16015373526678434,50
4522,1,9201,3392,5809,0,0,0,1.0,1,1.0,1,1.0,1,0.15008547257473154,50
4523,1,9202,3392,5810,0,0,0,1.0,1,1.0,1,1.0,1,0.12941695006682077,51
4524,3,9205,3393,5812,0,0,0,1.0,1,1.0,1,1.0,1,0.12888537874137002,52
4525,1,9206,3393,5813,0,0,0,1.0,1,1.0,1,1.0,1,0.10899049853868681,53
4526,0,9206,3393,5813,0,0,0,1.0,1,1.0,1,1.0,1,0.10453896659943435,54
4527,2,9208,3393,5815,0,0,0,1.0,1,1.0,1,1.0,1,0.08554470614694303,55
4528,0,9208,3393,5815,0,0,0,1.0,1,1.0,1,1.0,1,0.08554470614694303,55
4529,3,9211,3395,5816,0,0,0,1.0,1,1.0,1,1.0,1,0.1477062805989091,55
4530,1,9212,3395,5817,0,0,0,1.0,1,1.0,1,1.0,1,0.12267664272178032,56
4531,8,9220,3399,5821,0,0,0,1.0,1,1.0,1,1.0,1,0.12475033701152602,56
4532,1,9221,3399,5822,0,0,0,1.0,1,1.0,1,1.0,1,0.10749557495690021,55
4533,0,9221,3399,5822,0,0,0,1.0,1,1.0,1,1.0,1,0.12064712756970034,54
4534,1,9222,3399,5823,0,0,0,1.0,1,1.0,1,1.0,1,0.10596775728988292,55
4535,0,9222,3399,5823,0,0,0,1.0,1,1.0,1,1.0,1,0.1417581189974544,52
4536,2,9224,3401,5823,0,0,0,1.0,1,1.0,1,1.0,1,0.13065950980417976,53
4537,3,9227,3401,5826,0,0,0,1.0,1,1.0,1,1.0,1,0.12011199716225911,52
4538,0,9227,3401,5826,0,0,0,1.0,1,1.0,1,1.0,1,0.11858376805652629,52
4539,3,9230,3402,5828,0,0,0,1.0,1,1.0,1,1.0,1,0.16327170075961442,53
4540,7,9237,3403,5834,0,0,0,1.0,1,1.0,1,1.0,1,0.11436166156202962,54
4541,2,9239,3403,5836,0,0,0,1.0,1,1.0,1,1.0,1,0.11178626643929798,53
4542,3,9242,3405,5837,0,0,0,1.0,1,1.0,1,1.0,1,0.13992433086461062,53
4543,2,9244,3406,5838,0,0,0,1.0,1,1.0,1,1.0,1,0.118482786202016,53
4544,5,9249,3410,5839,0,0,0,1.0,1,1.0,1,1.0,1,0.12315971547233268,52
4545,0,9249,3410,5839,0,0,0,1.0,1,1.0,1,1.0,1,0.12682794264828476,50
4546,1,9250,3410,5840,0,0,0,1.0,1,1.0,1,1.0,1,0.12258506642248974,49
4547,1,9251,3411,5840,0,0,0,1.0,1,1.0,1,1.0,1,0.12048105701464835,49
4548,0,9251,3411,5840,0,0,0,1.0,1,1.0,1,1.0,1,0.12048105701464835,49
4549,0,9251,3411,5840,0,0,0,1.0,1,1.0,1,1.0,1,0.11332065356919137,50
4550,1,9252,3412,5840,0,0,0,1.0,1,1.0,1,1.0,1,0.14118925681571676,49
4551,1,9253,3412,5841,0,0,0,1.0,1,1.0,1,1.0,1,0.13611841590006793,49
4552,1,9254,3413,5841,0,0,0,1.0,1,1.0,1,1.0,1,0.12154878426610859,49
4553,2,9256,3414,5842,0,0,0,1.0,1,1.0,1,1.0,1,0.11770655142202063,49
4554,2,9258,3416,5842,0,0,0,1.0,1,1.0,1,1.0,1,0.13563079483391252,49
4555,1,9259,3417,5842,0,0,0,1.0,1,1.0,1,1.0,1,0.14324776878963327,48
4556,2,9261,3419,5842,0,0,0,1.0,1,1.0,1,1.0,1,0.15886798700401847,48
4557,1,9262,3419,5843,0,0,0,1.0,1,1.0,1,1.0,1,0.1644643906556028,49
4558,2,9264,3419,5845,0,0,0,1.0,1,1.0,1,1.0,1,0.11902794188800432,49
4559,2,9266,3420,5846,0,0,0,1.0,1,1.0,1,1.0,1,0.14621349093861113,50
4560,0,9266,3420,5846,0,0,0,1.0,1,1.0,1,1.0,1,0.15778846029863552,51
4561,2,9268,3420,5848,0,0,0,1.0,1,1.0,1,1.0,1,0.1418129402943817,52
4562,4,9272,3420,5852,0,0,0,1.0,1,1.0,1,1.0,1,0.09983931924608047,53
4563,0,9272,3420,5852,0,0,0,1.0,1,1.0,1,1.0,1,0.08523692849337199,52
4564,0,9272,3420,5852,0,0,0,1.0,1,1.0,1,1.0,1,0.0919374826147898,54
4565,1,9273,3421,5852,0,0,0,1.0,1,1.0,1,1.0,1,0.10143618316131149,55
4566,2,9275,3422,5853,0,0,0,1.0,1,1.0,1,1.0,1,0.07831606222869893,55
4567,2,9277,3424,5853,0,0,0,1.0,1,1.0,1,1.0,1,0.07877911341710309,56
4568,2,9279,3425,5854,0,0,0,1.0,1,1.0,1,1.0,1,0.10917804673588087,58
4569,0,9279,3425,5854,0,0,0,1.0,1,1.0,1,1.0,1,0.09064926843865538,59
4570,1,9280,3426,5854,0,0,0,1.0,1,1.0,1,1.0,1,0.09836209644157498,59
4571,0,9280,3426,5854,0,0,0,1.0,1,1.0,1,1.0,1,0.0974079279892772,57
4572,2,9282,3428,5854,0,0,0,1.0,1,1.0,1,1.0,1,0.13973487637913454,56
4573,4,9286,3429,5857,0,0,0,1.0,1,1.0,1,1.0,1,0.11783229344853167,56
4574,2,9288,3429,5859,0,0,0,1.0,1,1.0,1,1.0,1,0.13908342551098862,55
4575,3,9291,3430,5861,0,0,0,1.0,1,1.0,1,1.0,1,0.15088328151189373,55
4576,5,9296,3430,5866,0,0,0,1.0,1,1.0,1,1.0,1,0.1356016868164447,55
4577,0,9296,3430,5866,0,0,0,1.0,1,1.0,1,1.0,1,0.1490798572241331,54
4578,0,9296,3430,5866,0,0,0,1.0,1,1.0,1,1.0,1,0.15057177341456027,54
4579,3,9299,3431,5868,0,0,0,1.0,1,1.0,1,1.0,1,0.13577800490373448,54
4580,1,9300,3431,5869,0,0,0,1.0,1,1.0,1,1.0,1,0.12210281510235033,55
4581,2,9302,3433,5869,0,0,0,1.0,1,1.0,1,1.0,1,0.17139765383567362,56
4582,1,9303,3433,5870,0,0,0,1.0,1,1.0,1,1.0,1,0.16451023229112885,56
4583,2,9305,3434,5871,0,0,0,1.0,1,1.0,1,1.0,1,0.15081645709901184,57
4584,3,9308,3436,5872,0,0,0,1.0,1,1.0,1,1.0,1,0.17686408887048516,57
4585,3,9311,3436,5875,0,0,0,1.0,1,1.0,1,1.0,1,0.14467443277068723,57
4586,0,9311,3436,5875,0,0,0,1.0,1,1.0,1,1.0,1,0.14467443277068723,57
4587,0,9311,3436,5875,0,0,0,1.0,1,1.0,1,1.0,1,0.14467443277068723,57
4588,0,9311,3436,5875,0,0,0,1.0,1,1.0,1,1.0,1,0.14969054800123754,58
4589,0,9311,3436,5875,0,0,0,1.0,1,1.0,1,1.0,1,0.1499679868916209,59
4590,0,9311,3436,5875,0,0,0,1.0,1,1.0,1,1.0,1,0.16092864700841922,60
4591,0,9311,3436,5875,0,0,0,1.0,1,1.0,1,1.0,1,0.16966721954652203,61
4592,1,9312,3436,5876,0,0,0,1.0,1,1.0,1,1.0,1,0.1592551437739579,62
4593,3,9315,3436,5879,0,0,0,1.0,1,1.0,1,1.0,1,0.13480766701854044,64
4594,3,9318,3436,5882,0,0,0,1.0,1,1.0,1,1.0,1,0.10037616078384079,64
4595,0,9318,3436,5882,0,0,0,1.0,1,1.0,1,1.0,1,0.11200052402024074,63
4596,0,9318,3436,5882,0,0,0,1.0,1,1.0,1,1.0,1,0.11200052402024074,63
4597,0,9318,3436,5882,0,0,0,1.0,1,1.0,1,1.0,1,0.11200052402024074,63
4598,3,9321,3437,5884,0,0,0,1.0,1,1.0,1,1.0,1,0.0874961007647088,65
4599,2,9323,3437,5886,0,0,0,1.0,1,1.0,1,1.0,1,0.0677290134257219,66
4600,1,9324,3438,5886,0,0,0,1.0,1,1.0,1,1.0,1,0.09406920469020658,67
4601,1,9325,3439,5886,0,0,0,1.0,1,1.0,1,1.0,1,0.11186796292576688,67
4602,0,9325,3439,5886,0,0,0,1.0,1,1.0,1,1.0,1,0.10509714543244149,69
4603,2,9327,3440,5887,0,0,0,1.0,1,1.0,1,1.0,1,0.1102668990997936,69
4604,0,9327,3440,5887,0,0,0,1.0,1,1.0,1,1.0,1,0.1102668990997936,69
4605,0,9327,3440,5887,0,0,0,1.0,1,1.0,1,1.0,1,0.10571894535605704,70
4606,0,9327,3440,5887,0,0,0,1.0,1,1.0,1,1.0,1,0.10571894535605704,70
4607,3,9330,3441,5889,0,0,0,1.0,1,1.0,1,1.0,1,0.12367022468895417,72
4608,1,9331,3441,5890,0,0,0,1.0,1,1.0,1,1.0,1,0.12265436314167406,73
4609,1,9332,3442,5890,0,0,0,1.0,1,1.0,1,1.0,1,0.14150218975669263,72
4610,3,9335,3443,5892,0,0,0,1.0,1,1.0,1,1.0,1,0.12696646785615884,72
4611,1,9336,3443,5893,0,0,0,1.0,1,1.0,1,1.0,1,0.1396816682840624,71
4612,4,9340,3444,5896,0,0,0,1.0,1,1.0,1,1.0,1,0.13917116982151415,70
4613,0,9340,3444,5896,0,0,0,1.0,1,1.0,1,1.0,1,0.1330366235819541,69
4614,2,9342,3444,5898,0,0,0,1.0,1,1.0,1,1.0,1,0.14070190621213638,68
4615,3,9345,3446,5899,0,0,0,1.0,1,1.0,1,1.0,1,0.13013938508955963,68
4616,0,9345,3446,5899,0,0,0,1.0,1,1.0,1,1.0,1,0.15101391360737762,65
4617,1,9346,3447,5899,0,0,0,1.0,1,1.0,1,1.0,1,0.1581856374279141,66
4618,4,9350,3448,5902,0,0,0,1.0,1,1.0,1,1.0,1,0.15945489274673508,66
4619,1,9351,3448,5903,0,0,0,1.0,1,1.0,1,1.0,1,0.1478812098922529,65
4620,4,9355,3449,5906,0,0,0,1.0,1,1.0,1,1.0,1,0.1165103456704611,65
4621,7,9362,3453,5909,0,0,0,1.0,1,1.0,1,1.0,1,0.14624174749222552,67
4622,1,9363,3453,5910,0,0,0,1.0,1,1.0,1,1.0,1,0.1361240745529339,65
4623,2,9365,3455,5910,0,0,0,1.0,1,1.0,1,1.0,1,0.1338688860123526,66
4624,6,9371,3457,5914,0,0,0,1.0,1,1.0,1,1.0,1,0.11021254979872257,65
4625,2,9373,3457,5916,0,0,0,1.0,1,1.0,1,1.0,1,0.09505057856020324,64
4626,2,9375,3458,5917,0,0,0,1.0,1,1.0,1,1.0,1,0.10881605279422439,63
4627,3,9378,3459,5919,0,0,0,1.0,1,1.0,1,1.0,1,0.08085983230852689,65
4628,0,9378,3459,5919,0,0,0,1.0,1,1.0,1,1.0,1,0.0845715693908005,64
4629,2,9380,3461,5919,0,0,0,1.0,1,1.0,1,1.0,1,0.10803657453358201,64
4630,1,9381,3461,5920,0,0,0,1.0,1,1.0,1,1.0,1,0.09518546207446199,64
4631,4,9385,3463,5922,0,0,0,1.0,1,1.0,1,1.0,1,0.1643653924229141,66
4632,3,9388,3463,5925,0,0,0,1.0,1,1.0,1,1.0,1,0.1422272110659454,65
4633,2,9390,3463,5927,0,0,0,1.0,1,1.0,1,1.0,1,0.1057180867285463,66
4634,2,9392,3463,5929,0,0,0,1.0,1,1.0,1,1.0,1,0.09891146025224173,66
4635,0,9392,3463,5929,0,0,0,1.0,1,1.0,1,1.0,1,0.09852852685425273,66
4636,1,9393,3463,5930,0,0,0,1.0,1,1.0,1,1.0,1,0.07902686655059186,66
4637,0,9393,3463,5930,0,0,0,1.0,1,1.0,1,1.0,1,0.08079129578878004,68
4638,1,9394,3463,5931,0,0,0,1.0,1,1.0,1,1.0,1,0.07099586968708227,68
4639,3,9397,3464,5933,0,0,0,1.0,1,1.0,1,1.0,1,0.06682467253177296,69
4640,0,9397,3464,5933,0,0,0,1.0,1,1.0,1,1.0,1,0.06682467253177296,69
4641,1,9398,3464,5934,0,0,0,1.0,1,1.0,1,1.0,1,0.07542925673611425,70
4642,1,9399,3464,5935,0,0,0,1.0,1,1.0,1,1.0,1,0.06807730925581837,69
4643,3,9402,3465,5937,0,0,0,1.0,1,1.0,1,1.0,1,0.07558574724825949,70
4644,1,9403,3466,5937,0,0,0,1.0,1,1.0,1,1.0,1,0.09997843821034176,69
4645,5,9408,3467,5941,0,0,0,1.0,1,1.0,1,1.0,1,0.08717170065211022,70
4646,1,9409,3468,5941,0,0,0,1.0,1,1.0,1,1.0,1,0.11752208683776826,68
4647,5,9414,3471,5943,0,0,0,1.0,1,1.0,1,1.0,1,0.13981187784527205,68
4648,1,9415,3471,5944,0,0,0,1.0,1,1.0,1,1.0,1,0.1532261210136573,67
4649,3,9418,3473,5945,0,0,0,1.0,1,1.0,1,1.0,1,0.15630181765808154,67
4650,0,9418,3473,5945,0,0,0,1.0,1,1.0,1,1.0,1,0.14021120664535666,67
4651,6,9424,3475,5949,0,0,0,1.0,1,1.0,1,1.0,1,0.15078054488671147,68
4652,0,9424,3475,5949,0,0,0,1.0,1,1.0,1,1.0,1,0.14779706194335854,66
4653,1,9425,3476,5949,0,0,0,1.0,1,1.0,1,1.0,1,0.15902261576698046,64
4654,3,9428,3477,5951,0,0,0,1.0,1,1.0,1,1.0,1,0.14281579512426934,65
4655,1,9429,3477,5952,0,0,0,1.0,1,1.0,1,1.0,1,0.13534593773479517,64
4656,1,9430,3478,5952,0,0,0,1.0,1,1.0,1,1.0,1,0.15478033951397974,65
4657,2,9432,3478,5954,0,0,0,1.0,1,1.0,1,1.0,1,0.1285143315963872,66
4658,6,9438,3481,5957,0,0,0,1.0,1,1.0,1,1.0,1,0.17611083409668019,65
4659,1,9439,3481,5958,0,0,0,1.0,1,1.0,1,1.0,1,0.1748444471363968,65
4660,5,9444,3484,5960,0,0,0,1.0,1,1.0,1,1.0,1,0.16774679128770764,66
4661,0,9444,3484,5960,0,0,0,1.0,1,1.0,1,1.0,1,0.19683404771992166,66
4662,1,9445,3484,5961,0,0,0,1.0,1,1.0,1,1.0,1,0.1758014859024316,68
4663,2,9447,3484,5963,0,0,0,1.0,1,1.0,1,1.0,1,0.14910172289432705,67
4664,1,9448,3485,5963,0,0,0,1.0,1,1.0,1,1.0,1,0.15735325509991827,67
4665,1,9449,3486,5963,0,0,0,1.0,1,1.0,1,1.0,1,0.1555255338069643,67
4666,5,9454,3486,5968,0,0,0,1.0,1,1.0,1,1.0,1,0.11986068561193206,67
4667,1,9455,3487,5968,0,0,0,1.0,1,1.0,1,1.0,1,0.1232070997088208,66
4668,1,9456,3488,5968,0,0,0,1.0,1,1.0,1,1.0,1,0.13920915615096358,66
4669,2,9458,3489,5969,0,0,0,1.0,1,1.0,1,1.0,1,0.14675108530216374,66
4670,0,9458,3489,5969,0,0,0,1.0,1,1.0,1,1.0,1,0.16662533215738384,64
4671,0,9458,3489,5969,0,0,0,1.0,1,1.0,1,1.0,1,0.16662533215738384,64
4672,6,9464,3490,5974,0,0,0,1.0,1,1.0,1,1.0,1,0.1602821518942465,64
4673,2,9466,3490,5976,0,0,0,1.0,1,1.0,1,1.0,1,0.1341030993995715,65
4674,2,9468,3492,5976,0,0,0,1.0,1,1.0,1,1.0,1,0.14891641776182749,66
4675,3,9471,3492,5979,0,0,0,1.0,1,1.0,1,1.0,1,0.13408397126897795,65
4676,1,9472,3492,5980,0,0,0,1.0,1,1.0,1,1.0,1,0.1541745500916692,65
4677,0,9472,3492,5980,0,0,0,1.0,1,1.0,1,1.0,1,0.1688813007290616,65
4678,3,9475,3492,5983,0,0,0,1.0,1,1.0,1,1.0,1,0.1610728401687742,64
4679,0,9475,3492,5983,0,0,0,1.0,1,1.0,1,1.0,1,0.15923418940780204,66
4680,3,9478,3492,5986,0,0,0,1.0,1,1.0,1,1.0,1,0.15217509852660477,67
4681,1,9479,3492,5987,0,0,0,1.0,1,1.0,1,1.0,1,0.14696339298508987,67
4682,6,9485,3495,5990,0,0,0,1.0,1,1.0,1,1.0,1,0.15161445896660516,67
4683,1,9486,3496,5990,0,0,0,1.0,1,1.0,1,1.0,1,0.1492508611625892,67
4684,4,9490,3498,5992,0,0,0,1.0,1,1.0,1,1.0,1,0.16327232772248249,66
4685,1,9491,3498,5993,0,0,0,1.0,1,1.0,1,1.0,1,0.13168366789151384,65
4686,0,9491,3498,5993,0,0,0,1.0,1,1.0,1,1.0,1,0.13576066647359544,65
4687,0,9491,3498,5993,0,0,0,1.0,1,1.0,1,1.0,1,0.12741820866676556,65
4688,1,9492,3499,5993,0,0,0,1.0,1,1.0,1,1.0,1,0.14730669692648737,64
4689,3,9495,3501,5994,0,0,0,1.0,1,1.0,1,1.0,1,0.20250537092335108,65
4690,3,9498,3501,5997,0,0,0,1.0,1,1.0,1,1.0,1,0.1688390965829495,63
4691,6,9504,3504,6000,0,0,0,1.0,1,1.0,1,1.0,1,0.16728259551058308,64
4692,1,9505,3504,6001,0,0,0,1.0,1,1.0,1,1.0,1,0.14429502104211356,63
4693,3,9508,3504,6004,0,0,0,1.0,1,1.0,1,1.0,1,0.13526287073898316,64
4694,1,9509,3505,6004,0,0,0,1.0,1,1.0,1,1.0,1,0.17654217785131546,63
4695,1,9510,3505,6005,0,0,0,1.0,1,1.0,1,1.0,1,0.1674551454982704,62
4696,4,9514,3506,6008,0,0,0,1.0,1,1.0,1,1.0,1,0.15657423276160568,61
4697,2,9516,3506,6010,0,0,0,1.0,1,1.0,1,1.0,1,0.11042015821378402,63
4698,2,9518,3506,6012,0,0,0,1.0,1,1.0,1,1.0,1,0.10775400861176006,63
4699,1,9519,3506,6013,0,0,0,1.0,1,1.0,1,1.0,1,0.0932897156878747,65
4700,0,9519,3506,6013,0,0,0,1.0,1,1.0,1,1.0,1,0.10444282624485018,64
4701,1,9520,3507,6013,0,0,0,1.0,1,1.0,1,1.0,1,0.12088571546539188,64
4702,2,9522,3507,6015,0,0,0,1.0,1,1.0,1,1.0,1,0.10970425833030997,66
4703,1,9523,3508,6015,0,0,0,1.0,1,1.0,1,1.0,1,0.1116162541556204,65
4704,3,9526,3511,6015,0,0,0,1.0,1,1.0,1,1.0,1,0.12880972236352847,64
4705,4,9530,3512,6018,0,0,0,1.0,1,1.0,1,1.0,1,0.15870509848538694,65
4706,4,9534,3515,6019,0,0,0,1.0,1,1.0,1,1.0,1,0.18328963329983208,65
4707,7,9541,3517,6024,0,0,0,1.0,1,1.0,1,1.0,1,0.2075856236781398,63
4708,10,9551,3520,6031,0,0,0,1.0,1,1.0,1,1.0,1,0.12476634088340315,62
4709,2,9553,3522,6031,0,0,0,1.0,1,1.0,1,1.0,1,0.14645486069119498,61
4710,0,9553,3522,6031,0,0,0,1.0,1,1.0,1,1.0,1,0.14184045772187928,60
4711,2,9555,3523,6032,0,0,0,1.0,1,1.0,1,1.0,1,0.13635144037080102,59
4712,0,9555,3523,6032,0,0,0,1.0,1,1.0,1,1.0,1,0.13290350867264755,58
4713,0,9555,3523,6032,0,0,0,1.0,1,1.0,1,1.0,1,0.13290350867264755,58
4714,2,9557,3523,6034,0,0,0,1.0,1,1.0,1,1.0,1,0.10981203373601406,57
4715,1,9558,3523,6035,0,0,0,1.0,1,1.0,1,1.0,1,0.1312239530489686,57
4716,4,9562,3524,6038,0,0,0,1.0,1,1.0,1,1.0,1,0.1259487955358813,55
4717,5,9567,3526,6041,0,0,0,1.0,1,1.0,1,1.0,1,0.1005237283250533,57
4718,0,9567,3526,6041,0,0,0,1.0,1,1.0,1,1.0,1,0.09584435867212043,56
4719,2,9569,3527,6042,0,0,0,1.0,1,1.0,1,1.0,1,0.13035891714029035,56
4720,2,9571,3527,6044,0,0,0,1.0,1,1.0,1,1.0,1,0.10388437269921398,57
4721,0,9571,3527,6044,0,0,0,1.0,1,1.0,1,1.0,1,0.10388437269921398,57
4722,1,9572,3528,6044,0,0,0,1.0,1,1.0,1,1.0,1,0.12754863812444384,57
4723,2,9574,3528,6046,0,0,0,1.0,1,1.0,1,1.0,1,0.09738263647862572,57
4724,1,9575,3528,6047,0,0,0,1.0,1,1.0,1,1.0,1,0.08869870344251249,57
4725,1,9576,3529,6047,0,0,0,1.0,1,1.0,1,1.0,1,0.10952239575755884,57
4726,3,9579,3531,6048,0,0,0,1.0,1,1.0,1,1.0,1,0.13351224939231662,57
4727,0,9579,3531,6048,0,0,0,1.0,1,1.0,1,1.0,1,0.15090045135333444,56
4728,0,9579,3531,6048,0,0,0,1.0,1,1.0,1,1.0,1,0.1648550542290876,57
4729,2,9581,3531,6050,0,0,0,1.0,1,1.0,1,1.0,1,0.14131370528863083,56
4730,1,9582,3532,6050,0,0,0,1.0,1,1.0,1,1.0,1,0.16644334728511065,54
4731,2,9584,3533,6051,0,0,0,1.0,1,1.0,1,1.0,1,0.1541732888509863,54
4732,4,9588,3536,6052,0,0,0,1.0,1,1.0,1,1.0,1,0.20073443510132014,54
4733,3,9591,3537,6054,0,0,0,1.0,1,1.0,1,1.0,1,0.20955584452697562,55
4734,11,9602,3540,6062,0,0,0,1.0,1,1.0,1,1.0,1,0.30048556557762074,56
4735,8,9610,3542,6068,0,0,0,1.0,1,1.0,1,1.0,1,0.27209641215935043,56
4736,2,9612,3543,6069,0,0,0,1.0,1,1.0,1,1.0,1,0.2628901102973717,58
4737,4,9616,3543,6073,0,0,0,1.0,1,1.0,1,1.0,1,0.2314546332401761,59
4738,3,9619,3544,6075,0,0,0,1.0,1,1.0,1,1.0,1,0.2503819302694584,60
4739,0,9619,3544,6075,0,0,0,1.0,1,1.0,1,1.0,1,0.2503819302694584,60
4740,0,9619,3544,6075,0,0,0,1.0,1,1.0,1,1.0,1,0.2503819302694584,60
4741,4,9623,3545,6078,0,0,0,1.0,1,1.0,1,1.0,1,0.2385966544839037,61
4742,4,9627,3547,6080,0,0,0,1.0,1,1.0,1,1.0,1,0.238358774073487,61
4743,2,9629,3547,6082,0,0,0,1.0,1,1.0,1,1.0,1,0.2141628131322263,60
4744,2,9631,3548,6083,0,0,0,1.0,1,1.0,1,1.0,1,0.18622373465380607,60
4745,0,9631,3548,6083,0,0,0,1.0,1,1.0,1,1.0,1,0.17684149314955466,59
4746,2,9633,3549,6084,0,0,0,1.0,1,1.0,1,1.0,1,0.17721768352528916,59
4747,3,9636,3549,6087,0,0,0,1.0,1,1.0,1,1.0,1,0.13536606832174272,58
4748,4,9640,3551,6089,0,0,0,1.0,1,1.0,1,1.0,1,0.12388867681251689,58
4749,2,9642,3552,6090,0,0,0,1.0,1,1.0,1,1.0,1,0.10898139044535642,58
4750,1,9643,3552,6091,0,0,0,1.0,1,1.0,1,1.0,1,0.10252456292746565,56
4751,5,9648,3555,6093,0,0,0,1.0,1,1.0,1,1.0,1,0.08980021461065368,58
4752,2,9650,3556,6094,0,0,0,1.0,1,1.0,1,1.0,1,0.09005283766800248,55
4753,0,9650,3556,6094,0,0,0,1.0,1,1.0,1,1.0,1,0.09005283766800248,55
4754,1,9651,3557,6094,0,0,0,1.0,1,1.0,1,1.0,1,0.1123563013362071,54
4755,2,9653,3558,6095,0,0,0,1.0,1,1.0,1,1.0,1,0.11064267593067903,54
4756,3,9656,3559,6097,0,0,0,1.0,1,1.0,1,1.0,1,0.09486998945261346,54
4757,1,9657,3559,6098,0,0,0,1.0,1,1.0,1,1.0,1,0.085872722435328,53
4758,0,9657,3559,6098,0,0,0,1.0,1,1.0,1,1.0,1,0.085872722435328,53
4759,2,9659,3560,6099,0,0,0,1.0,1,1.0,1,1.0,1,0.10415070025564843,53
4760,2,9661,3561,6100,0,0,0,1.0,1,1.0,1,1.0,1,0.13851392169361904,53
4761,1,9662,3561,6101,0,0,0,1.0,1,1.0,1,1.0,1,0.12982616094160054,52
4762,6,9668,3563,6105,0,0,0,1.0,1,1.0,1,1.0,1,0.16748174105480473,54
4763,5,9673,3566,6107,0,0,0,1.0,1,1.0,1,1.0,1,0.1817423449360669,54
4764,3,9676,3567,6109,0,0,0,1.0,1,1.0,1,1.0,1,0.1808141869246513,55
4765,4,9680,3568,6112,0,0,0,1.0,1,1.0,1,1.0,1,0.18983741476793223,56
4766,4,9684,3569,6115,0,0,0,1.0,1,1.0,1,1.0,1,0.16231570342269427,58
4767,3,9687,3569,6118,0,0,0,1.0,1,1.0,1,1.0,1,0.1489924052205354,59
4768,2,9689,3570,6119,0,0,0,1.0,1,1.0,1,1.0,1,0.13011156928893047,60
4769,0,9689,3570,6119,0,0,0,1.0,1,1.0,1,1.0,1,0.13448982394273024,59
4770,1,9690,3570,6120,0,0,0,1.0,1,1.0,1,1.0,1,0.1370492961422934,60
4771,1,9691,3570,6121,0,0,0,1.0,1,1.0,1,1.0,1,0.14040050108326274,59
4772,0,9691,3570,6121,0,0,0,1.0,1,1.0,1,1.0,1,0.14040050108326274,59
4773,0,9691,3570,6121,0,0,0,1.0,1,1.0,1,1.0,1,0.12746492509055107,60
4774,0,9691,3570,6121,0,0,0,1.0,1,1.0,1,1.0,1,0.12746492509055107,60
4775,0,9691,3570,6121,0,0,0,1.0,1,1.0,1,1.0,1,0.13300177237242414,62
4776,3,9694,3570,6124,0,0,0,1.0,1,1.0,1,1.0,1,0.10876526589292915,63
4777,1,9695,3570,6125,0,0,0,1.0,1,1.0,1,1.0,1,0.1018057590448253,63
4778,0,9695,3570,6125,0,0,0,1.0,1,1.0,1,1.0,1,0.1018057590448253,63
4779,1,9696,3571,6125,0,0,0,1.0,1,1.0,1,1.0,1,0.09885008982569156,63
4780,5,9701,3573,6128,0,0,0,1.0,1,1.0,1,1.0,1,0.1130189432759353,65
4781,1,9702,3573,6129,0,0,0,1.0,1,1.0,1,1.0,1,0.11000820730742503,64
4782,2,9704,3573,6131,0,0,0,1.0,1,1.0,1,1.0,1,0.09182748450269178,65
4783,4,9708,3575,6133,0,0,0,1.0,1,1.0,1,1.0,1,0.11394844630400096,66
4784,1,9709,3576,6133,0,0,0,1.0,1,1.0,1,1.0,1,0.10336552545936784,64
4785,2,9711,3578,6133,0,0,0,1.0,1,1.0,1,1.0,1,0.09974569307935716,65
4786,4,9715,3581,6134,0,0,0,1.0,1,1.0,1,1.0,1,0.11458083431951331,66
4787,3,9718,3583,6135,0,0,0,1.0,1,1.0,1,1.0,1,0.10044967484851597,63
4788,7,9725,3587,6138,0,0,0,1.0,1,1.0,1,1.0,1,0.12763772572679996,63
4789,8,9733,3590,6143,0,0,0,1.0,1,1.0,1,1.0,1,0.07223786754495667,60
4790,4,9737,3592,6145,0,0,0,1.0,1,1.0,1,1.0,1,0.09914778948662502,61
4791,2,9739,3594,6145,0,0,0,1.0,1,1.0,1,1.0,1,0.11474549357931875,59
4792,3,9742,3595,6147,0,0,0,1.0,1,1.0,1,1.0,1,0.08324950649848352,59
4793,3,9745,3596,6149,0,0,0,1.0,1,1.0,1,1.0,1,0.08101600000177453,61
4794,2,9747,3598,6149,0,0,0,1.0,1,1.0,1,1.0,1,0.10205157408073322,60
4795,0,9747,3598,6149,0,0,0,1.0,1,1.0,1,1.0,1,0.09122173831848703,61
4796,4,9751,3600,6151,0,0,0,1.0,1,1.0,1,1.0,1,0.11345435730770732,60
4797,6,9757,3602,6155,0,0,0,1.0,1,1.0,1,1.0,1,0.12072666334267465,61
4798,2,9759,3602,6157,0,0,0,1.0,1,1.0,1,1.0,1,0.10610428951469876,61
4799,0,9759,3602,6157,0,0,0,1.0,1,1.0,1,1.0,1,0.12450952451410487,59
4800,2,9761,3603,6158,0,0,0,1.0,1,1.0,1,1.0,1,0.1420957578887922,57
4801,8,9769,3605,6164,0,0,0,1.0,1,1.0,1,1.0,1,0.10713403861956709,58
4802,0,9769,3605,6164,0,0,0,1.0,1,1.0,1,1.0,1,0.0963483194825849,56
4803,2,9771,3607,6164,0,0,0,1.0,1,1.0,1,1.0,1,0.14251780674082778,57
4804,6,9777,3609,6168,0,0,0,1.0,1,1.0,1,1.0,1,0.07624441546039369,55
4805,1,9778,3610,6168,0,0,0,1.0,1,1.0,1,1.0,1,0.06971729837794342,56
4806,0,9778,3610,6168,0,0,0,1.0,1,1.0,1,1.0,1,0.07622307340573603,55
4807,0,9778,3610,6168,0,0,0,1.0,1,1.0,1,1.0,1,0.1132111696442965,53
4808,2,9780,3611,6169,0,0,0,1.0,1,1.0,1,1.0,1,0.13937241111497994,54
4809,0,9780,3611,6169,0,0,0,1.0,1,1.0,1,1.0,1,0.17629703947580677,53
4810,3,9783,3612,6171,0,0,0,1.0,1,1.0,1,1.0,1,0.15685310594821777,53
4811,4,9787,3612,6175,0,0,0,1.0,1,1.0,1,1.0,1,0.12674671947556776,54
4812,5,9792,3614,6178,0,0,0,1.0,1,1.0,1,1.0,1,0.17109563416866921,54
4813,6,9798,3614,6184,0,0,0,1.0,1,1.0,1,1.0,1,0.07438981809577026,55
4814,1,9799,3615,6184,0,0,0,1.0,1,1.0,1,1.0,1,0.07659524798866471,55
4815,2,9801,3615,6186,0,0,0,1.0,1,1.0,1,1.0,1,0.08647088286727868,56
4816,3,9804,3616,6188,0,0,0,1.0,1,1.0,1,1.0,1,0.06863217794468486,56
4817,8,9812,3618,6194,0,0,0,1.0,1,1.0,1,1.0,1,0.11621660924663449,58
4818,7,9819,3620,6199,0,0,0,1.0,1,1.0,1,1.0,1,0.15511942418993757,58
4819,5,9824,3620,6204,0,0,0,1.0,1,1.0,1,1.0,1,0.09136358412648408,58
4820,2,9826,3620,6206,0,0,0,1.0,1,1.0,1,1.0,1,0.09311118239896338,58
4821,2,9828,3620,6208,0,0,0,1.0,1,1.0,1,1.0,1,0.10865013055645822,58
4822,2,9830,3621,6209,0,0,0,1.0,1,1.0,1,1.0,1,0.10196423190664143,58
4823,2,9832,3622,6210,0,0,0,1.0,1,1.0,1,1.0,1,0.10208414885101248,57
4824,1,9833,3623,6210,0,0,0,1.0,1,1.0,1,1.0,1,0.1323827664890263,56
4825,2,9835,3623,6212,0,0,0,1.0,1,1.0,1,1.0,1,0.1322449510632206,57
4826,1,9836,3624,6212,0,0,0,1.0,1,1.0,1,1.0,1,0.1338547852851118,57
4827,0,9836,3624,6212,0,0,0,1.0,1,1.0,1,1.0,1,0.1687495256344367,56
4828,2,9838,3626,6212,0,0,0,1.0,1,1.0,1,1.0,1,0.16698623972169716,57
4829,1,9839,3627,6212,0,0,0,1.0,1,1.0,1,1.0,1,0.18269045086804525,56
4830,1,9840,3628,6212,0,0,0,1.0,1,1.0,1,1.0,1,0.16436624426444102,57
4831,4,9844,3630,6214,0,0,0,1.0,1,1.0,1,1.0,1,0.184574187600266,57
4832,1,9845,3630,6215,0,0,0,1.0,1,1.0,1,1.0,1,0.1919351756547499,55
4833,6,9851,3632,6219,0,0,0,1.0,1,1.0,1,1.0,1,0.18048710030378262,55
4834,2,9853,3632,6221,0,0,0,1.0,1,1.0,1,1.0,1,0.15880325071064316,55
4835,2,9855,3632,6223,0,0,0,1.0,1,1.0,1,1.0,1,0.16957511577189519,55
4836,0,9855,3632,6223,0,0,0,1.0,1,1.0,1,1.0,1,0.16957511577189519,55
4837,7,9862,3632,6230,0,0,0,1.0,1,1.0,1,1.0,1,0.11585980871973815,53
4838,2,9864,3633,6231,0,0,0,1.0,1,1.0,1,1.0,1,0.09838491099296474,54
4839,3,9867,3635,6232,0,0,0,1.0,1,1.0,1,1.0,1,0.08047511106050936,53
4840,3,9870,3636,6234,0,0,0,1.0,1,1.0,1,1.0,1,0.0701964413910982,52
4841,3,9873,3639,6234,0,0,0,1.0,1,1.0,1,1.0,1,0.11903135813687638,51
4842,1,9874,3640,6234,0,0,0,1.0,1,1.0,1,1.0,1,0.17186402755240968,50
4843,5,9879,3642,6237,0,0,0,1.0,1,1.0,1,1.0,1,0.12714853026597106,51
4844,3,9882,3643,6239,0,0,0,1.0,1,1.0,1,1.0,1,0.08272809023042431,50
4845,4,9886,3647,6239,0,0,0,1.0,1,1.0,1,1.0,1,0.10954149916059104,49
4846,1,9887,3647,6240,0,0,0,1.0,1,1.0,1,1.0,1,0.09708637128846019,49
4847,1,9888,3648,6240,0,0,0,1.0,1,1.0,1,1.0,1,0.12337255895576028,48
4848,2,9890,3649,6241,0,0,0,1.0,1,1.0,1,1.0,1,0.12860338988144862,48
4849,2,9892,3650,6242,0,0,0,1.0,1,1.0,1,1.0,1,0.09462744038806281,48
4850,1,9893,3650,6243,0,0,0,1.0,1,1.0,1,1.0,1,0.08385529720702453,49
4851,4,9897,3651,6246,0,0,0,1.0,1,1.0,1,1.0,1,0.09138876341934375,49
4852,2,9899,3651,6248,0,0,0,1.0,1,1.0,1,1.0,1,0.08146053402833935,49
4853,0,9899,3651,6248,0,0,0,1.0,1,1.0,1,1.0,1,0.07975666541986186,50
4854,2,9901,3651,6250,0,0,0,1.0,1,1.0,1,1.0,1,0.06784471980719677,51
4855,0,9901,3651,6250,0,0,0,1.0,1,1.0,1,1.0,1,0.06784471980719677,51
4856,1,9902,3652,6250,0,0,0,1.0,1,1.0,1,1.0,1,0.0868086976733802,50
4857,1,9903,3652,6251,0,0,0,1.0,1,1.0,1,1.0,1,0.0703416019096107,51
4858,3,9906,3652,6254,0,0,0,1.0,1,1.0,1,1.0,1,0.06311472959789884,51
4859,0,9906,3652,6254,0,0,0,1.0,1,1.0,1,1.0,1,0.07643851416209581,52
4860,0,9906,3652,6254,0,0,0,1.0,1,1.0,1,1.0,1,0.07643851416209581,52
4861,1,9907,3652,6255,0,0,0,1.0,1,1.0,1,1.0,1,0.07831213943369153,53
4862,2,9909,3654,6255,0,0,0,1.0,1,1.0,1,1.0,1,0.1572552148621486,53
4863,0,9909,3654,6255,0,0,0,1.0,1,1.0,1,1.0,1,0.12806569169730211,51
4864,3,9912,3654,6258,0,0,0,1.0,1,1.0,1,1.0,1,0.08396647697823313,53
4865,0,9912,3654,6258,0,0,0,1.0,1,1.0,1,1.0,1,0.07555748333781076,52
4866,1,9913,3655,6258,0,0,0,1.0,1,1.0,1,1.0,1,0.11144753610272752,53
4867,4,9917,3656,6261,0,0,0,1.0,1,1.0,1,1.0,1,0.063613967528866,51
4868,4,9921,3657,6264,0,0,0,1.0,1,1.0,1,1.0,1,0.0537638566580874,53
4869,2,9923,3658,6265,0,0,0,1.0,1,1.0,1,1.0,1,0.06095382241008552,53
4870,3,9926,3660,6266,0,0,0,1.0,1,1.0,1,1.0,1,0.10945526705759105,55
4871,2,9928,3661,6267,0,0,0,1.0,1,1.0,1,1.0,1,0.09731552867632207,55
4872,3,9931,3662,6269,0,0,0,1.0,1,1.0,1,1.0,1,0.12621448370774796,56
4873,7,9938,3662,6276,0,0,0,1.0,1,1.0,1,1.0,1,0.09605607309350908,56
4874,3,9941,3663,6278,0,0,0,1.0,1,1.0,1,1.0,1,0.11775450309919548,58
4875,3,9944,3665,6279,0,0,0,1.0,1,1.0,1,1.0,1,0.1403386466725946,56
4876,5,9949,3665,6284,0,0,0,1.0,1,1.0,1,1.0,1,0.0971436159370879,56
4877,1,9950,3666,6284,0,0,0,1.0,1,1.0,1,1.0,1,0.12374416303788012,54
4878,3,9953,3667,6286,0,0,0,1.0,1,1.0,1,1.0,1,0.1195450537994663,54
4879,6,9959,3670,6289,0,0,0,1.0,1,1.0,1,1.0,1,0.1377947601711155,54
4880,4,9963,3670,6293,0,0,0,1.0,1,1.0,1,1.0,1,0.13665634598884288,53
4881,4,9967,3672,6295,0,0,0,1.0,1,1.0,1,1.0,1,0.14197641707668912,54
4882,1,9968,3672,6296,0,0,0,1.0,1,1.0,1,1.0,1,0.11913024104870215,52
4883,1,9969,3672,6297,0,0,0,1.0,1,1.0,1,1.0,1,0.12665928255849734,54
4884,0,9969,3672,6297,0,0,0,1.0,1,1.0,1,1.0,1,0.11635866624236052,52
4885,2,9971,3673,6298,0,0,0,1.0,1,1.0,1,1.0,1,0.11966959066163335,51
4886,0,9971,3673,6298,0,0,0,1.0,1,1.0,1,1.0,1,0.12155289951879009,50
4887,0,9971,3673,6298,0,0,0,1.0,1,1.0,1,1.0,1,0.13764772626129312,49
4888,0,9971,3673,6298,0,0,0,1.0,1,1.0,1,1.0,1,0.15195078802971565,48
4889,0,9971,3673,6298,0,0,0,1.0,1,1.0,1,1.0,1,0.15195078802971565,48
4890,0,9971,3673,6298,0,0,0,1.0,1,1.0,1,1.0,1,0.15195078802971565,48
4891,3,9974,3675,6299,0,0,0,1.0,1,1.0,1,1.0,1,0.19742542219154244,49
4892,6,9980,3675,6305,0,0,0,1.0,1,1.0,1,1.0,1,0.1577146135358537,51
4893,0,9980,3675,6305,0,0,0,1.0,1,1.0,1,1.0,1,0.15829957533895872,51
4894,2,9982,3675,6307,0,0,0,1.0,1,1.0,1,1.0,1,0.13586320907460506,52
4895,1,9983,3675,6308,0,0,0,1.0,1,1.0,1,1.0,1,0.11407871390461581,52
4896,0,9983,3675,6308,0,0,0,1.0,1,1.0,1,1.0,1,0.10505288479942276,51
4897,2,9985,3675,6310,0,0,0,1.0,1,1.0,1,1.0,1,0.07579808639625253,52
4898,1,9986,3675,6311,0,0,0,1.0,1,1.0,1,1.0,1,0.07401776369215333,52
4899,0,9986,3675,6311,0,0,0,1.0,1,1.0,1,1.0,1,0.07400350888981468,53
4900,1,9987,3676,6311,0,0,0,1.0,1,1.0,1,1.0,1,0.07336809039545993,54
4901,3,9990,3678,6312,0,0,0,1.0,1,1.0,1,1.0,1,0.08526726090632043,54
4902,4,9994,3681,6313,0,0,0,1.0,1,1.0,1,1.0,1,0.08654149283846482,55
4903,4,9998,3683,6315,0,0,0,1.0,1,1.0,1,1.0,1,0.12435261838196184,56
4904,3,10001,3685,6316,0,0,0,1.0,1,1.0,1,1.0,1,0.13947051847501277,55
4905,2,10003,3685,6318,0,0,0,1.0,1,1.0,1,1.0,1,0.13233380564608724,54
4906,5,10008,3685,6323,0,0,0,1.0,1,1.0,1,1.0,1,0.12334980864061797,54
4907,1,10009,3685,6324,0,0,0,1.0,1,1.0,1,1.0,1,0.10568656212193069,54
4908,1,10010,3685,6325,0,0,0,1.0,1,1.0,1,1.0,1,0.1123880835817255,53
4909,4,10014,3686,6328,0,0,0,1.0,1,1.0,1,1.0,1,0.10796640002736323,54
4910,2,10016,3686,6330,0,0,0,1.0,1,1.0,1,1.0,1,0.10555188045289164,55
4911,6,10022,3688,6334,0,0,0,1.0,1,1.0,1,1.0,1,0.1563060293483782,57
4912,7,10029,3691,6338,0,0,0,1.0,1,1.0,1,1.0,1,0.11487283297928538,57
4913,0,10029,3691,6338,0,0,0,1.0,1,1.0,1,1.0,1,0.11753401841382706,56
4914,1,10030,3691,6339,0,0,0,1.0,1,1.0,1,1.0,1,0.12324066468417404,56
4915,8,10038,3693,6345,0,0,0,1.0,1,1.0,1,1.0,1,0.08913604410855815,56
4916,0,10038,3693,6345,0,0,0,1.0,1,1.0,1,1.0,1,0.09298355358906844,54
4917,1,10039,3694,6345,0,0,0,1.0,1,1.0,1,1.0,1,0.10818877528773316,53
4918,1,10040,3694,6346,0,0,0,1.0,1,1.0,1,1.0,1,0.1102477193508697,52
4919,2,10042,3695,6347,0,0,0,1.0,1,1.0,1,1.0,1,0.1510608567520956,49
4920,0,10042,3695,6347,0,0,0,1.0,1,1.0,1,1.0,1,0.1510608567520956,49
4921,5,10047,3698,6349,0,0,0,1.0,1,1.0,1,1.0,1,0.19412173911950678,50
4922,2,10049,3698,6351,0,0,0,1.0,1,1.0,1,1.0,1,0.1862371963024788,50
4923,4,10053,3699,6354,0,0,0,1.0,1,1.0,1,1.0,1,0.19941731082644593,52
4924,4,10057,3700,6357,0,0,0,1.0,1,1.0,1,1.0,1,0.14762879822615807,53
4925,4,10061,3701,6360,0,0,0,1.0,1,1.0,1,1.0,1,0.12645968806139937,54
4926,4,10065,3701,6364,0,0,0,1.0,1,1.0,1,1.0,1,0.12645968806139937,54
4927,3,10068,3703,6365,0,0,0,1.0,1,1.0,1,1.0,1,0.12783414746251168,54
4928,1,10069,3703,6366,0,0,0,1.0,1,1.0,1,1.0,1,0.1065293071301602,54
4929,0,10069,3703,6366,0,0,0,1.0,1,1.0,1,1.0,1,0.10538620927074717,55
4930,2,10071,3704,6367,0,0,0,1.0,1,1.0,1,1.0,1,0.1205733502798716,58
4931,1,10072,3705,6367,0,0,0,1.0,1,1.0,1,1.0,1,0.12552735679474292,58
4932,1,10073,3705,6368,0,0,0,1.0,1,1.0,1,1.0,1,0.11635986069443144,59
4933,2,10075,3705,6370,0,0,0,1.0,1,1.0,1,1.0,1,0.09417237594583741,59
4934,0,10075,3705,6370,0,0,0,1.0,1,1.0,1,1.0,1,0.09417237594583741,59
4935,3,10078,3706,6372,0,0,0,1.0,1,1.0,1,1.0,1,0.10037923148300931,59
4936,1,10079,3706,6373,0,0,0,1.0,1,1.0,1,1.0,1,0.08931802546759036,59
4937,0,10079,3706,6373,0,0,0,1.0,1,1.0,1,1.0,1,0.0936483220862973,61
4938,0,10079,3706,6373,0,0,0,1.0,1,1.0,1,1.0,1,0.10292443104382755,62
4939,0,10079,3706,6373,0,0,0,1.0,1,1.0,1,1.0,1,0.10352372071037944,63
4940,1,10080,3706,6374,0,0,0,1.0,1,1.0,1,1.0,1,0.12168992067794464,65
4941,2,10082,3707,6375,0,0,0,1.0,1,1.0,1,1.0,1,0.12181311804359565,65
4942,6,10088,3710,6378,0,0,0,1.0,1,1.0,1,1.0,1,0.1109275086767866,67
4943,2,10090,3711,6379,0,0,0,1.0,1,1.0,1,1.0,1,0.13019388832969428,66
4944,2,10092,3713,6379,0,0,0,1.0,1,1.0,1,1.0,1,0.16976314409026114,63
4945,5,10097,3713,6384,0,0,0,1.0,1,1.0,1,1.0,1,0.06757162646496258,61
4946,2,10099,3714,6385,0,0,0,1.0,1,1.0,1,1.0,1,0.07323886388439342,60
4947,1,10100,3715,6385,0,0,0,1.0,1,1.0,1,1.0,1,0.07264697270300206,58
4948,2,10102,3716,6386,0,0,0,1.0,1,1.0,1,1.0,1,0.08213201816249492,57
4949,1,10103,3717,6386,0,0,0,1.0,1,1.0,1,1.0,1,0.10714998097693082,56
4950,3,10106,3719,6387,0,0,0,1.0,1,1.0,1,1.0,1,0.11231848163614624,57
4951,5,10111,3720,6391,0,0,0,1.0,1,1.0,1,1.0,1,0.09460253492411466,55
4952,4,10115,3724,6391,0,0,0,1.0,1,1.0,1,1.0,1,0.10158792298766021,55
4953,4,10119,3726,6393,0,0,0,1.0,1,1.0,1,1.0,1,0.10071830570866251,54
4954,1,10120,3727,6393,0,0,0,1.0,1,1.0,1,1.0,1,0.12435202927754044,54
4955,0,10120,3727,6393,0,0,0,1.0,1,1.0,1,1.0,1,0.09490830603757826,52
4956,1,10121,3727,6394,0,0,0,1.0,1,1.0,1,1.0,1,0.085519666661116,52
4957,0,10121,3727,6394,0,0,0,1.0,1,1.0,1,1.0,1,0.08641131899333591,53
4958,1,10122,3728,6394,0,0,0,1.0,1,1.0,1,1.0,1,0.09827581311565375,52
4959,2,10124,3729,6395,0,0,0,1.0,1,1.0,1,1.0,1,0.07115295814368715,51
4960,1,10125,3729,6396,0,0,0,1.0,1,1.0,1,1.0,1,0.06909700386242254,53
4961,1,10126,3730,6396,0,0,0,1.0,1,1.0,1,1.0,1,0.08929161898799808,53
4962,1,10127,3730,6397,0,0,0,1.0,1,1.0,1,1.0,1,0.06777248307191572,55
4963,1,10128,3731,6397,0,0,0,1.0,1,1.0,1,1.0,1,0.07036478463425169,54
4964,1,10129,3732,6397,0,0,0,1.0,1,1.0,1,1.0,1,0.07811520368889009,54
4965,6,10135,3734,6401,0,0,0,1.0,1,1.0,1,1.0,1,0.10705093238149425,54
4966,2,10137,3736,6401,0,0,0,1.0,1,1.0,1,1.0,1,0.13653279038258176,54
4967,6,10143,3737,6406,0,0,0,1.0,1,1.0,1,1.0,1,0.10833798751441838,55
4968,0,10143,3737,6406,0,0,0,1.0,1,1.0,1,1.0,1,0.10833798751441838,55
4969,2,10145,3738,6407,0,0,0,1.0,1,1.0,1,1.0,1,0.09032890425542638,57
4970,0,10145,3738,6407,0,0,0,1.0,1,1.0,1,1.0,1,0.1072730023243271,56
4971,2,10147,3739,6408,0,0,0,1.0,1,1.0,1,1.0,1,0.15385297756106908,57
4972,7,10154,3740,6414,0,0,0,1.0,1,1.0,1,1.0,1,0.08393945285561272,57
4973,2,10156,3741,6415,0,0,0,1.0,1,1.0,1,1.0,1,0.0888847316108334,60
4974,1,10157,3742,6415,0,0,0,1.0,1,1.0,1,1.0,1,0.10202014458253317,58
4975,2,10159,3743,6416,0,0,0,1.0,1,1.0,1,1.0,1,0.10610507619962722,59
4976,3,10162,3745,6417,0,0,0,1.0,1,1.0,1,1.0,1,0.09899765396607509,59
4977,4,10166,3749,6417,0,0,0,1.0,1,1.0,1,1.0,1,0.11444124713717813,59
4978,2,10168,3749,6419,0,0,0,1.0,1,1.0,1,1.0,1,0.08402591910416071,59
4979,2,10170,3749,6421,0,0,0,1.0,1,1.0,1,1.0,1,0.07509956852687222,61
4980,3,10173,3750,6423,0,0,0,1.0,1,1.0,1,1.0,1,0.08218829316681056,62
4981,1,10174,3750,6424,0,0,0,1.0,1,1.0,1,1.0,1,0.0754126080604599,62
4982,4,10178,3752,6426,0,0,0,1.0,1,1.0,1,1.0,1,0.07003641040611444,63
4983,0,10178,3752,6426,0,0,0,1.0,1,1.0,1,1.0,1,0.06917919704676989,63
4984,2,10180,3753,6427,0,0,0,1.0,1,1.0,1,1.0,1,0.06935466296529191,61
4985,0,10180,3753,6427,0,0,0,1.0,1,1.0,1,1.0,1,0.0751022929473169,59
4986,2,10182,3754,6428,0,0,0,1.0,1,1.0,1,1.0,1,0.08975770323605495,62
4987,2,10184,3756,6428,0,0,0,1.0,1,1.0,1,1.0,1,0.10063273711638998,60
4988,1,10185,3757,6428,0,0,0,1.0,1,1.0,1,1.0,1,0.11208339115624992,59
4989,6,10191,3761,6430,0,0,0,1.0,1,1.0,1,1.0,1,0.10529001852604612,57
4990,2,10193,3761,6432,0,0,0,1.0,1,1.0,1,1.0,1,0.09481817098549103,55
4991,3,10196,3763,6433,0,0,0,1.0,1,1.0,1,1.0,1,0.10816529579364682,54
4992,5,10201,3763,6438,0,0,0,1.0,1,1.0,1,1.0,1,0.0875611265409085,52
4993,2,10203,3763,6440,0,0,0,1.0,1,1.0,1,1.0,1,0.06581564082925517,51
4994,3,10206,3765,6441,0,0,0,1.0,1,1.0,1,1.0,1,0.09129721463062518,49
4995,3,10209,3768,6441,0,0,0,1.0,1,1.0,1,1.0,1,0.13094198980786187,48
4996,6,10215,3773,6442,0,0,0,1.0,1,1.0,1,1.0,1,0.1153277891279119,48
4997,0,10215,3773,6442,0,0,0,1.0,1,1.0,1,1.0,1,0.10012547598027073,46
4998,2,10217,3773,6444,0,0,0,1.0,1,1.0,1,1.0,1,0.09148654546175333,48
4999,1,10218,3774,6444,0,0,0,1.0,1,1.0,1,1.0,1,0.133636672376956,48
5000,0,10218,3774,6444,0,0,0,1.0,1,1.0,1,1.0,1,0.10891119781460905,47
5001,1,10219,3775,6444,0,0,0,1.0,1,1.0,1,1.0,1,0.16068808140860097,45
5002,2,10221,3777,6444,0,0,0,1.0,1,1.0,1,1.0,1,0.1948133207764532,46
5003,3,10224,3777,6447,0,0,0,1.0,1,1.0,1,1.0,1,0.20003090165251886,46
5004,0,10224,3777,6447,0,0,0,1.0,1,1.0,1,1.0,1,0.20003090165251886,46
5005,2,10226,3777,6449,0,0,0,1.0,1,1.0,1,1.0,1,0.17877978019168245,45
5006,0,10226,3777,6449,0,0,0,1.0,1,1.0,1,1.0,1,0.217027157339766,45
5007,1,10227,3777,6450,0,0,0,1.0,1,1.0,1,1.0,1,0.19642682523700003,46
5008,2,10229,3777,6452,0,0,0,1.0,1,1.0,1,1.0,1,0.18104580847884635,49
5009,0,10229,3777,6452,0,0,0,1.0,1,1.0,1,1.0,1,0.18367686243803552,49
5010,2,10231,3777,6454,0,0,0,1.0,1,1.0,1,1.0,1,0.1586217047619091,50
5011,2,10233,3777,6456,0,0,0,1.0,1,1.0,1,1.0,1,0.14428554039995806,51
5012,0,10233,3777,6456,0,0,0,1.0,1,1.0,1,1.0,1,0.14319333181610247,52
5013,1,10234,3777,6457,0,0,0,1.0,1,1.0,1,1.0,1,0.1315218102154786,52
5014,0,10234,3777,6457,0,0,0,1.0,1,1.0,1,1.0,1,0.13172767776854835,53
5015,5,10239,3778,6461,0,0,0,1.0,1,1.0,1,1.0,1,0.12418545255604639,54
5016,0,10239,3778,6461,0,0,0,1.0,1,1.0,1,1.0,1,0.13293067715159199,55
5017,2,10241,3779,6462,0,0,0,1.0,1,1.0,1,1.0,1,0.1375925630019649,55
5018,2,10243,3779,6464,0,0,0,1.0,1,1.0,1,1.0,1,0.1280858029327726,56
5019,2,10245,3779,6466,0,0,0,1.0,1,1.0,1,1.0,1,0.09200559716099706,56
5020,0,10245,3779,6466,0,0,0,1.0,1,1.0,1,1.0,1,0.10729447488819996,55
5021,0,10245,3779,6466,0,0,0,1.0,1,1.0,1,1.0,1,0.11983430660679431,56
5022,2,10247,3781,6466,0,0,0,1.0,1,1.0,1,1.0,1,0.15781950963216446,56
5023,3,10250,3782,6468,0,0,0,1.0,1,1.0,1,1.0,1,0.12428355395130841,55
5024,3,10253,3784,6469,0,0,0,1.0,1,1.0,1,1.0,1,0.1395404481795018,55
5025,5,10258,3786,6472,0,0,0,1.0,1,1.0,1,1.0,1,0.10375338046052948,53
5026,4,10262,3789,6473,0,0,0,1.0,1,1.0,1,1.0,1,0.11448352291564827,52
5027,2,10264,3790,6474,0,0,0,1.0,1,1.0,1,1.0,1,0.13578211891137473,51
5028,4,10268,3793,6475,0,0,0,1.0,1,1.0,1,1.0,1,0.17931303447114882,51
5029,7,10275,3796,6479,0,0,0,1.0,1,1.0,1,1.0,1,0.17326120619144142,50
5030,1,10276,3796,6480,0,0,0,1.0,1,1.0,1,1.0,1,0.11568079472858324,49
5031,3,10279,3798,6481,0,0,0,1.0,1,1.0,1,1.0,1,0.13912158867858018,49
5032,1,10280,3798,6482,0,0,0,1.0,1,1.0,1,1.0,1,0.11795364421549064,48
5033,2,10282,3800,6482,0,0,0,1.0,1,1.0,1,1.0,1,0.1383597309344293,50
5034,1,10283,3801,6482,0,0,0,1.0,1,1.0,1,1.0,1,0.1418008736532814,49
5035,4,10287,3802,6485,0,0,0,1.0,1,1.0,1,1.0,1,0.11763243824722347,49
5036,2,10289,3804,6485,0,0,0,1.0,1,1.0,1,1.0,1,0.12623543517887903,47
5037,1,10290,3805,6485,0,0,0,1.0,1,1.0,1,1.0,1,0.1465332526620472,47
5038,2,10292,3805,6487,0,0,0,1.0,1,1.0,1,1.0,1,0.1216524867177472,47
5039,0,10292,3805,6487,0,0,0,1.0,1,1.0,1,1.0,1,0.12261449091456153,48
5040,1,10293,3805,6488,0,0,0,1.0,1,1.0,1,1.0,1,0.11344545208350192,48
5041,0,10293,3805,6488,0,0,0,1.0,1,1.0,1,1.0,1,0.11344545208350192,48
5042,1,10294,3805,6489,0,0,0,1.0,1,1.0,1,1.0,1,0.07317639936032704,50
5043,0,10294,3805,6489,0,0,0,1.0,1,1.0,1,1.0,1,0.08174135629355352,51
5044,0,10294,3805,6489,0,0,0,1.0,1,1.0,1,1.0,1,0.08174135629355352,51
5045,0,10294,3805,6489,0,0,0,1.0,1,1.0,1,1.0,1,0.09011826322703809,52
5046,1,10295,3806,6489,0,0,0,1.0,1,1.0,1,1.0,1,0.12248660327031692,51
5047,1,10296,3807,6489,0,0,0,1.0,1,1.0,1,1.0,1,0.10896685621973996,51
5048,3,10299,3808,6491,0,0,0,1.0,1,1.0,1,1.0,1,0.0907419903806961,52
5049,4,10303,3809,6494,0,0,0,1.0,1,1.0,1,1.0,1,0.12032835521343196,54
5050,3,10306,3809,6497,0,0,0,1.0,1,1.0,1,1.0,1,0.09729413894275402,56
5051,1,10307,3809,6498,0,0,0,1.0,1,1.0,1,1.0,1,0.0877662764689712,55
5052,0,10307,3809,6498,0,0,0,1.0,1,1.0,1,1.0,1,0.0877662764689712,55
5053,0,10307,3809,6498,0,0,0,1.0,1,1.0,1,1.0,1,0.0877662764689712,55
5054,0,10307,3809,6498,0,0,0,1.0,1,1.0,1,1.0,1,0.0877662764689712,55
5055,0,10307,3809,6498,0,0,0,1.0,1,1.0,1,1.0,1,0.11239800024070352,55
5056,3,10310,3810,6500,0,0,0,1.0,1,1.0,1,1.0,1,0.13828468436211527,56
5057,1,10311,3810,6501,0,0,0,1.0,1,1.0,1,1.0,1,0.11711131894741118,58
5058,3,10314,3811,6503,0,0,0,1.0,1,1.0,1,1.0,1,0.09042766922054471,59
5059,2,10316,3811,6505,0,0,0,1.0,1,1.0,1,1.0,1,0.059603602843254166,59
5060,0,10316,3811,6505,0,0,0,1.0,1,1.0,1,1.0,1,0.059603602843254166,59
5061,3,10319,3811,6508,0,0,0,1.0,1,1.0,1,1.0,1,0.07177617007060755,59
5062,3,10322,3813,6509,0,0,0,1.0,1,1.0,1,1.0,1,0.11667968468501376,59
5063,1,10323,3814,6509,0,0,0,1.0,1,1.0,1,1.0,1,0.15067682578281666,59
5064,5,10328,3819,6509,0,0,0,1.0,1,1.0,1,1.0,1,0.20828763143283702,57
5065,3,10331,3819,6512,0,0,0,1.0,1,1.0,1,1.0,1,0.1366210272665546,55
5066,5,10336,3822,6514,0,0,0,1.0,1,1.0,1,1.0,1,0.16879106369876273,55
5067,6,10342,3823,6519,0,0,0,1.0,1,1.0,1,1.0,1,0.1501438202229052,54
5068,0,10342,3823,6519,0,0,0,1.0,1,1.0,1,1.0,1,0.14252297706503134,54
5069,4,10346,3824,6522,0,0,0,1.0,1,1.0,1,1.0,1,0.12228815538309336,54
5070,1,10347,3825,6522,0,0,0,1.0,1,1.0,1,1.0,1,0.1327709741978932,52
5071,2,10349,3826,6523,0,0,0,1.0,1,1.0,1,1.0,1,0.1614181207060149,54
5072,1,10350,3826,6524,0,0,0,1.0,1,1.0,1,1.0,1,0.14968823768097772,52
5073,0,10350,3826,6524,0,0,0,1.0,1,1.0,1,1.0,1,0.16163520956452276,51
5074,4,10354,3826,6528,0,0,0,1.0,1,1.0,1,1.0,1,0.09444810780837139,52
5075,0,10354,3826,6528,0,0,0,1.0,1,1.0,1,1.0,1,0.10516259325103611,53
5076,0,10354,3826,6528,0,0,0,1.0,1,1.0,1,1.0,1,0.10516259325103611,53
5077,6,10360,3827,6533,0,0,0,1.0,1,1.0,1,1.0,1,0.09649624486662751,56
5078,1,10361,3828,6533,0,0,0,1.0,1,1.0,1,1.0,1,0.10951495955592543,55
5079,2,10363,3828,6535,0,0,0,1.0,1,1.0,1,1.0,1,0.11005209669701782,56
5080,1,10364,3828,6536,0,0,0,1.0,1,1.0,1,1.0,1,0.08779686080394036,57
5081,0,10364,3828,6536,0,0,0,1.0,1,1.0,1,1.0,1,0.09687902194521845,58
5082,0,10364,3828,6536,0,0,0,1.0,1,1.0,1,1.0,1,0.09687902194521845,58
5083,0,10364,3828,6536,0,0,0,1.0,1,1.0,1,1.0,1,0.10657402244119635,59
5084,2,10366,3830,6536,0,0,0,1.0,1,1.0,1,1.0,1,0.07636105210341107,59
5085,1,10367,3831,6536,0,0,0,1.0,1,1.0,1,1.0,1,0.09534834035237548,60
5086,2,10369,3831,6538,0,0,0,1.0,1,1.0,1,1.0,1,0.06994704604713511,61
5087,2,10371,3833,6538,0,0,0,1.0,1,1.0,1,1.0,1,0.07947531277504115,62
5088,4,10375,3835,6540,0,0,0,1.0,1,1.0,1,1.0,1,0.10597842447661339,64
5089,6,10381,3837,6544,0,0,0,1.0,1,1.0,1,1.0,1,0.06947963310791554,64
5090,2,10383,3837,6546,0,0,0,1.0,1,1.0,1,1.0,1,0.08800398640531837,64
5091,11,10394,3842,6552,0,0,0,1.0,1,1.0,1,1.0,1,0.13460348893723062,64
5092,4,10398,3843,6555,0,0,0,1.0,1,1.0,1,1.0,1,0.11572995462911773,64
5093,1,10399,3843,6556,0,0,0,1.0,1,1.0,1,1.0,1,0.09852352885604743,64
5094,1,10400,3844,6556,0,0,0,1.0,1,1.0,1,1.0,1,0.12100665157196,65
5095,5,10405,3846,6559,0,0,0,1.0,1,1.0,1,1.0,1,0.08391534537129704,66
5096,1,10406,3846,6560,0,0,0,1.0,1,1.0,1,1.0,1,0.08916017900525156,66
5097,3,10409,3847,6562,0,0,0,1.0,1,1.0,1,1.0,1,0.08101996490582335,67
5098,0,10409,3847,6562,0,0,0,1.0,1,1.0,1,1.0,1,0.08101996490582335,67
5099,2,10411,3848,6563,0,0,0,1.0,1,1.0,1,1.0,1,0.10667938476658687,70
5100,2,10413,3848,6565,0,0,0,1.0,1,1.0,1,1.0,1,0.10002323746128415,71
5101,4,10417,3848,6569,0,0,0,1.0,1,1.0,1,1.0,1,0.07797303351808417,72
5102,6,10423,3851,6572,0,0,0,1.0,1,1.0,1,1.0,1,0.07541185229168697,72
5103,5,10428,3853,6575,0,0,0,1.0,1,1.0,1,1.0,1,0.0756034979736853,70
5104,6,10434,3857,6577,0,0,0,1.0,1,1.0,1,1.0,1,0.08263039071114932,67
5105,4,10438,3859,6579,0,0,0,1.0,1,1.0,1,1.0,1,0.108573986449891,66
5106,3,10441,3860,6581,0,0,0,1.0,1,1.0,1,1.0,1,0.15513991160500373,64
5107,5,10446,3861,6585,0,0,0,1.0,1,1.0,1,1.0,1,0.10660860302399719,61
5108,3,10449,3863,6586,0,0,0,1.0,1,1.0,1,1.0,1,0.12583733728412289,57
5109,4,10453,3865,6588,0,0,0,1.0,1,1.0,1,1.0,1,0.12752583735196904,55
5110,3,10456,3866,6590,0,0,0,1.0,1,1.0,1,1.0,1,0.10293625471477269,53
5111,4,10460,3869,6591,0,0,0,1.0,1,1.0,1,1.0,1,0.15285745887799065,52
5112,4,10464,3872,6592,0,0,0,1.0,1,1.0,1,1.0,1,0.14644742715474737,52
5113,5,10469,3873,6596,0,0,0,1.0,1,1.0,1,1.0,1,0.08369902557194181,49
5114,2,10471,3875,6596,0,0,0,1.0,1,1.0,1,1.0,1,0.12196335192672536,49
5115,0,10471,3875,6596,0,0,0,1.0,1,1.0,1,1.0,1,0.11475533323479932,48
5116,5,10476,3876,6600,0,0,0,1.0,1,1.0,1,1.0,1,0.09958680395229647,47
5117,0,10476,3876,6600,0,0,0,1.0,1,1.0,1,1.0,1,0.10879050774972064,48
5118,1,10477,3877,6600,0,0,0,1.0,1,1.0,1,1.0,1,0.12578208073602118,49
5119,1,10478,3877,6601,0,0,0,1.0,1,1.0,1,1.0,1,0.11283347243363624,49
5120,0,10478,3877,6601,0,0,0,1.0,1,1.0,1,1.0,1,0.13296550777406874,48
5121,2,10480,3879,6601,0,0,0,1.0,1,1.0,1,1.0,1,0.14339471827610412,48
5122,3,10483,3881,6602,0,0,0,1.0,1,1.0,1,1.0,1,0.17089618357744127,46
5123,1,10484,3881,6603,0,0,0,1.0,1,1.0,1,1.0,1,0.16924786716284662,46
5124,1,10485,3881,6604,0,0,0,1.0,1,1.0,1,1.0,1,0.15021680264103215,47
5125,7,10492,3882,6610,0,0,0,1.0,1,1.0,1,1.0,1,0.15555316303030944,49
5126,2,10494,3882,6612,0,0,0,1.0,1,1.0,1,1.0,1,0.13518215076552326,49
5127,4,10498,3883,6615,0,0,0,1.0,1,1.0,1,1.0,1,0.13720815040333956,51
5128,5,10503,3884,6619,0,0,0,1.0,1,1.0,1,1.0,1,0.1332561099184469,53
5129,5,10508,3885,6623,0,0,0,1.0,1,1.0,1,1.0,1,0.14948713758696502,55
5130,3,10511,3885,6626,0,0,0,1.0,1,1.0,1,1.0,1,0.13404000669195154,55
5131,2,10513,3885,6628,0,0,0,1.0,1,1.0,1,1.0,1,0.09520844386759168,55
5132,0,10513,3885,6628,0,0,0,1.0,1,1.0,1,1.0,1,0.09520844386759168,55
5133,0,10513,3885,6628,0,0,0,1.0,1,1.0,1,1.0,1,0.10479029705171546,56
5134,1,10514,3885,6629,0,0,0,1.0,1,1.0,1,1.0,1,0.11878150459705292,56
5135,1,10515,3886,6629,0,0,0,1.0,1,1.0,1,1.0,1,0.12249637391578655,56
5136,1,10516,3886,6630,0,0,0,1.0,1,1.0,1,1.0,1,0.11283161051357826,55
5137,1,10517,3887,6630,0,0,0,1.0,1,1.0,1,1.0,1,0.13357210608182032,55
5138,2,10519,3887,6632,0,0,0,1.0,1,1.0,1,1.0,1,0.11812076164352173,54
5139,0,10519,3887,6632,0,0,0,1.0,1,1.0,1,1.0,1,0.11812076164352173,54
5140,1,10520,3888,6632,0,0,0,1.0,1,1.0,1,1.0,1,0.11641557128014882,54
5141,3,10523,3891,6632,0,0,0,1.0,1,1.0,1,1.0,1,0.18091767765747482,53
5142,6,10529,3894,6635,0,0,0,1.0,1,1.0,1,1.0,1,0.18536822336244274,55
5143,6,10535,3895,6640,0,0,0,1.0,1,1.0,1,1.0,1,0.09684298182615855,54
5144,3,10538,3898,6640,0,0,0,1.0,1,1.0,1,1.0,1,0.10971669786923134,50
5145,4,10542,3899,6643,0,0,0,1.0,1,1.0,1,1.0,1,0.06708638933790437,51
5146,2,10544,3900,6644,0,0,0,1.0,1,1.0,1,1.0,1,0.05236905079994984,48
5147,2,10546,3901,6645,0,0,0,1.0,1,1.0,1,1.0,1,0.095126136624128,49
5148,0,10546,3901,6645,0,0,0,1.0,1,1.0,1,1.0,1,0.09400628690261013,47
5149,4,10550,3903,6647,0,0,0,1.0,1,1.0,1,1.0,1,0.12480022959185025,46
5150,2,10552,3905,6647,0,0,0,1.0,1,1.0,1,1.0,1,0.1327885700276337,46
5151,0,10552,3905,6647,0,0,0,1.0,1,1.0,1,1.0,1,0.13018099396618954,45
5152,3,10555,3908,6647,0,0,0,1.0,1,1.0,1,1.0,1,0.17455694023741167,45
5153,1,10556,3908,6648,0,0,0,1.0,1,1.0,1,1.0,1,0.17750624081446456,45
5154,4,10560,3911,6649,0,0,0,1.0,1,1.0,1,1.0,1,0.21525475267041316,45
5155,5,10565,3912,6653,0,0,0,1.0,1,1.0,1,1.0,1,0.16369229467513333,44
5156,3,10568,3913,6655,0,0,0,1.0,1,1.0,1,1.0,1,0.14303651435967013,44
5157,0,10568,3913,6655,0,0,0,1.0,1,1.0,1,1.0,1,0.1596482657139137,42
5158,1,10569,3913,6656,0,0,0,1.0,1,1.0,1,1.0,1,0.14628928078381187,43
5159,5,10574,3913,6661,0,0,0,1.0,1,1.0,1,1.0,1,0.13413685344973522,43
5160,0,10574,3913,6661,0,0,0,1.0,1,1.0,1,1.0,1,0.13413685344973522,43
5161,0,10574,3913,6661,0,0,0,1.0,1,1.0,1,1.0,1,0.13413685344973522,43
5162,0,10574,3913,6661,0,0,0,1.0,1,1.0,1,1.0,1,0.13760253808840875,44
5163,1,10575,3913,6662,0,0,0,1.0,1,1.0,1,1.0,1,0.13620145898230737,46
5164,1,10576,3914,6662,0,0,0,1.0,1,1.0,1,1.0,1,0.1273242334313946,46
5165,2,10578,3915,6663,0,0,0,1.0,1,1.0,1,1.0,1,0.1264791219735591,46
5166,4,10582,3917,6665,0,0,0,1.0,1,1.0,1,1.0,1,0.14566075872992254,47
5167,3,10585,3917,6668,0,0,0,1.0,1,1.0,1,1.0,1,0.1003922027203413,47
5168,2,10587,3918,6669,0,0,0,1.0,1,1.0,1,1.0,1,0.135872769883125,47
5169,4,10591,3919,6672,0,0,0,1.0,1,1.0,1,1.0,1,0.12004133991014805,47
5170,2,10593,3920,6673,0,0,0,1.0,1,1.0,1,1.0,1,0.11176900295680756,48
5171,2,10595,3921,6674,0,0,0,1.0,1,1.0,1,1.0,1,0.11139586479101111,48
5172,0,10595,3921,6674,0,0,0,1.0,1,1.0,1,1.0,1,0.08438623245377173,49
5173,0,10595,3921,6674,0,0,0,1.0,1,1.0,1,1.0,1,0.09306699078482143,49
5174,1,10596,3921,6675,0,0,0,1.0,1,1.0,1,1.0,1,0.09095063556660193,52
5175,1,10597,3921,6676,0,0,0,1.0,1,1.0,1,1.0,1,0.08626911899781957,53
5176,2,10599,3921,6678,0,0,0,1.0,1,1.0,1,1.0,1,0.08076547957348582,54
5177,1,10600,3922,6678,0,0,0,1.0,1,1.0,1,1.0,1,0.1053291947597623,54
5178,4,10604,3924,6680,0,0,0,1.0,1,1.0,1,1.0,1,0.15726468612216288,55
5179,5,10609,3926,6683,0,0,0,1.0,1,1.0,1,1.0,1,0.11586368223951327,53
5180,1,10610,3927,6683,0,0,0,1.0,1,1.0,1,1.0,1,0.12326232047165343,52
5181,1,10611,3928,6683,0,0,0,1.0,1,1.0,1,1.0,1,0.10682206707844216,52
5182,1,10612,3929,6683,0,0,0,1.0,1,1.0,1,1.0,1,0.12259577837007367,52
5183,2,10614,3931,6683,0,0,0,1.0,1,1.0,1,1.0,1,0.13964593235936196,52
5184,0,10614,3931,6683,0,0,0,1.0,1,1.0,1,1.0,1,0.13991772571952402,52
5185,5,10619,3934,6685,0,0,0,1.0,1,1.0,1,1.0,1,0.16111605601769327,50
5186,3,10622,3935,6687,0,0,0,1.0,1,1.0,1,1.0,1,0.15807957870234732,48
5187,0,10622,3935,6687,0,0,0,1.0,1,1.0,1,1.0,1,0.1496384854238406,46
5188,2,10624,3935,6689,0,0,0,1.0,1,1.0,1,1.0,1,0.14516938775590038,44
5189,1,10625,3935,6690,0,0,0,1.0,1,1.0,1,1.0,1,0.15177957804628672,44
5190,1,10626,3936,6690,0,0,0,1.0,1,1.0,1,1.0,1,0.17207312918397832,45
5191,2,10628,3936,6692,0,0,0,1.0,1,1.0,1,1.0,1,0.1318532519132797,45
5192,1,10629,3936,6693,0,0,0,1.0,1,1.0,1,1.0,1,0.09937382629265559,45
5193,0,10629,3936,6693,0,0,0,1.0,1,1.0,1,1.0,1,0.09937382629265559,45
5194,1,10630,3936,6694,0,0,0,1.0,1,1.0,1,1.0,1,0.10127008769059212,45
5195,3,10633,3937,6696,0,0,0,1.0,1,1.0,1,1.0,1,0.1240972328538088,46
5196,1,10634,3937,6697,0,0,0,1.0,1,1.0,1,1.0,1,0.1184083601471333,46
5197,1,10635,3938,6697,0,0,0,1.0,1,1.0,1,1.0,1,0.1378988326133636,46
5198,0,10635,3938,6697,0,0,0,1.0,1,1.0,1,1.0,1,0.12941620610098747,47
5199,2,10637,3939,6698,0,0,0,1.0,1,1.0,1,1.0,1,0.1599954442685642,49
5200,3,10640,3940,6700,0,0,0,1.0,1,1.0,1,1.0,1,0.15892113908349398,49
5201,3,10643,3942,6701,0,0,0,1.0,1,1.0,1,1.0,1,0.14804676400951028,50
5202,4,10647,3942,6705,0,0,0,1.0,1,1.0,1,1.0,1,0.11581882456910783,52
5203,0,10647,3942,6705,0,0,0,1.0,1,1.0,1,1.0,1,0.11581882456910783,52
5204,0,10647,3942,6705,0,0,0,1.0,1,1.0,1,1.0,1,0.11145676860581183,54
5205,0,10647,3942,6705,0,0,0,1.0,1,1.0,1,1.0,1,0.11145676860581183,54
5206,3,10650,3942,6708,0,0,0,1.0,1,1.0,1,1.0,1,0.08774760860392919,55
5207,0,10650,3942,6708,0,0,0,1.0,1,1.0,1,1.0,1,0.09167237788919944,54
5208,0,10650,3942,6708,0,0,0,1.0,1,1.0,1,1.0,1,0.09167237788919944,54
5209,1,10651,3942,6709,0,0,0,1.0,1,1.0,1,1.0,1,0.07116157966825888,54
5210,0,10651,3942,6709,0,0,0,1.0,1,1.0,1,1.0,1,0.07116157966825888,54
5211,1,10652,3942,6710,0,0,0,1.0,1,1.0,1,1.0,1,0.07371999167369216,56
5212,2,10654,3943,6711,0,0,0,1.0,1,1.0,1,1.0,1,0.05839489897857693,57
5213,4,10658,3947,6711,0,0,0,1.0,1,1.0,1,1.0,1,0.13724132532506933,57
5214,5,10663,3949,6714,0,0,0,1.0,1,1.0,1,1.0,1,0.1823150405926949,58
5215,4,10667,3949,6718,0,0,0,1.0,1,1.0,1,1.0,1,0.1619380471622861,57
5216,3,10670,3950,6720,0,0,0,1.0,1,1.0,1,1.0,1,0.13705057456711525,57
5217,3,10673,3950,6723,0,0,0,1.0,1,1.0,1,1.0,1,0.13614021686022706,56
5218,4,10677,3952,6725,0,0,0,1.0,1,1.0,1,1.0,1,0.10858944918287092,56
5219,1,10678,3952,6726,0,0,0,1.0,1,1.0,1,1.0,1,0.11701493479760444,54
5220,1,10679,3953,6726,0,0,0,1.0,1,1.0,1,1.0,1,0.13891759061379222,53
5221,2,10681,3953,6728,0,0,0,1.0,1,1.0,1,1.0,1,0.12102629730169819,52
5222,2,10683,3954,6729,0,0,0,1.0,1,1.0,1,1.0,1,0.11231175146220045,52
5223,1,10684,3955,6729,0,0,0,1.0,1,1.0,1,1.0,1,0.11441892230511691,52
5224,2,10686,3956,6730,0,0,0,1.0,1,1.0,1,1.0,1,0.1097175811399458,52
5225,0,10686,3956,6730,0,0,0,1.0,1,1.0,1,1.0,1,0.13140435407704812,50
5226,1,10687,3957,6730,0,0,0,1.0,1,1.0,1,1.0,1,0.10601962336122608,51
5227,4,10691,3959,6732,0,0,0,1.0,1,1.0,1,1.0,1,0.11550341039367439,49
5228,1,10692,3959,6733,0,0,0,1.0,1,1.0,1,1.0,1,0.12039030730304856,48
5229,0,10692,3959,6733,0,0,0,1.0,1,1.0,1,1.0,1,0.10283034329314572,49
5230,1,10693,3959,6734,0,0,0,1.0,1,1.0,1,1.0,1,0.09223021756617984,49
5231,1,10694,3960,6734,0,0,0,1.0,1,1.0,1,1.0,1,0.10027245997601017,49
5232,4,10698,3962,6736,0,0,0,1.0,1,1.0,1,1.0,1,0.08423060678738606,51
5233,2,10700,3963,6737,0,0,0,1.0,1,1.0,1,1.0,1,0.13511830452137408,51
5234,4,10704,3965,6739,0,0,0,1.0,1,1.0,1,1.0,1,0.1384025541555228,52
5235,0,10704,3965,6739,0,0,0,1.0,1,1.0,1,1.0,1,0.14178033551989858,52
5236,6,10710,3965,6745,0,0,0,1.0,1,1.0,1,1.0,1,0.07624961248176201,52
5237,1,10711,3965,6746,0,0,0,1.0,1,1.0,1,1.0,1,0.08225188367072653,53
5238,2,10713,3965,6748,0,0,0,1.0,1,1.0,1,1.0,1,0.0771761091496958,53
5239,0,10713,3965,6748,0,0,0,1.0,1,1.0,1,1.0,1,0.0771761091496958,53
5240,3,10716,3968,6748,0,0,0,1.0,1,1.0,1,1.0,1,0.15179893967175526,55
5241,2,10718,3968,6750,0,0,0,1.0,1,1.0,1,1.0,1,0.1146820291594399,56
5242,3,10721,3969,6752,0,0,0,1.0,1,1.0,1,1.0,1,0.08944530522007961,54
5243,1,10722,3970,6752,0,0,0,1.0,1,1.0,1,1.0,1,0.09987344299478133,55
5244,3,10725,3972,6753,0,0,0,1.0,1,1.0,1,1.0,1,0.145449996185652,55
5245,4,10729,3972,6757,0,0,0,1.0,1,1.0,1,1.0,1,0.0958358593692767,55
5246,4,10733,3974,6759,0,0,0,1.0,1,1.0,1,1.0,1,0.16098761846414572,55
5247,2,10735,3975,6760,0,0,0,1.0,1,1.0,1,1.0,1,0.14732743589496725,54
5248,2,10737,3976,6761,0,0,0,1.0,1,1.0,1,1.0,1,0.14613748631539664,53
5249,5,10742,3978,6764,0,0,0,1.0,1,1.0,1,1.0,1,0.12389286198798637,55
5250,1,10743,3978,6765,0,0,0,1.0,1,1.0,1,1.0,1,0.11101735989974441,55
5251,3,10746,3979,6767,0,0,0,1.0,1,1.0,1,1.0,1,0.09637305908112635,57
5252,1,10747,3979,6768,0,0,0,1.0,1,1.0,1,1.0,1,0.09513426218800868,58
5253,2,10749,3980,6769,0,0,0,1.0,1,1.0,1,1.0,1,0.10020034738586205,59
5254,4,10753,3980,6773,0,0,0,1.0,1,1.0,1,1.0,1,0.06699830323650474,59
5255,1,10754,3981,6773,0,0,0,1.0,1,1.0,1,1.0,1,0.07614143496043169,58
5256,2,10756,3983,6773,0,0,0,1.0,1,1.0,1,1.0,1,0.11413719644208128,59
5257,2,10758,3984,6774,0,0,0,1.0,1,1.0,1,1.0,1,0.103335498665543,58
5258,0,10758,3984,6774,0,0,0,1.0,1,1.0,1,1.0,1,0.12022571307494044,56
5259,1,10759,3984,6775,0,0,0,1.0,1,1.0,1,1.0,1,0.12993792934307064,56
5260,2,10761,3985,6776,0,0,0,1.0,1,1.0,1,1.0,1,0.14218842098156265,55
5261,4,10765,3986,6779,0,0,0,1.0,1,1.0,1,1.0,1,0.10837359365467909,54
5262,2,10767,3987,6780,0,0,0,1.0,1,1.0,1,1.0,1,0.12173038468473064,54
5263,5,10772,3988,6784,0,0,0,1.0,1,1.0,1,1.0,1,0.12498837015559336,53
5264,0,10772,3988,6784,0,0,0,1.0,1,1.0,1,1.0,1,0.09849342788958715,51
5265,0,10772,3988,6784,0,0,0,1.0,1,1.0,1,1.0,1,0.10035252103469539,50
5266,5,10777,3991,6786,0,0,0,1.0,1,1.0,1,1.0,1,0.07227931317981733,49
5267,2,10779,3993,6786,0,0,0,1.0,1,1.0,1,1.0,1,0.11493880392724354,48
5268,5,10784,3995,6789,0,0,0,1.0,1,1.0,1,1.0,1,0.08171682270071698,47
5269,2,10786,3996,6790,0,0,0,1.0,1,1.0,1,1.0,1,0.09665646737139953,45
5270,1,10787,3997,6790,0,0,0,1.0,1,1.0,1,1.0,1,0.1063619938758539,47
5271,1,10788,3997,6791,0,0,0,1.0,1,1.0,1,1.0,1,0.10242889465192224,45
5272,4,10792,3999,6793,0,0,0,1.0,1,1.0,1,1.0,1,0.12887319845637432,46
5273,1,10793,3999,6794,0,0,0,1.0,1,1.0,1,1.0,1,0.16785219552425207,44
5274,2,10795,4001,6794,0,0,0,1.0,1,1.0,1,1.0,1,0.16991746897494645,44
5275,5,10800,4004,6796,0,0,0,1.0,1,1.0,1,1.0,1,0.15439082450663594,46
5276,3,10803,4004,6799,0,0,0,1.0,1,1.0,1,1.0,1,0.1217355853688185,46
5277,1,10804,4005,6799,0,0,0,1.0,1,1.0,1,1.0,1,0.12327717427053608,46
5278,2,10806,4007,6799,0,0,0,1.0,1,1.0,1,1.0,1,0.10561044335519518,46
5279,2,10808,4007,6801,0,0,0,1.0,1,1.0,1,1.0,1,0.10571101290002374,47
5280,2,10810,4009,6801,0,0,0,1.0,1,1.0,1,1.0,1,0.13388859699367806,47
5281,2,10812,4009,6803,0,0,0,1.0,1,1.0,1,1.0,1,0.10624654187495487,48
5282,1,10813,4009,6804,0,0,0,1.0,1,1.0,1,1.0,1,0.09312845715674777,48
5283,1,10814,4010,6804,0,0,0,1.0,1,1.0,1,1.0,1,0.1263190260899921,49
5284,0,10814,4010,6804,0,0,0,1.0,1,1.0,1,1.0,1,0.1263190260899921,49
5285,0,10814,4010,6804,0,0,0,1.0,1,1.0,1,1.0,1,0.10622313745810001,50
5286,2,10816,4010,6806,0,0,0,1.0,1,1.0,1,1.0,1,0.08829033744138222,51
5287,0,10816,4010,6806,0,0,0,1.0,1,1.0,1,1.0,1,0.08829033744138222,51
5288,0,10816,4010,6806,0,0,0,1.0,1,1.0,1,1.0,1,0.08829033744138222,51
5289,2,10818,4010,6808,0,0,0,1.0,1,1.0,1,1.0,1,0.06604839937005835,53
5290,0,10818,4010,6808,0,0,0,1.0,1,1.0,1,1.0,1,0.06604839937005835,53
5291,1,10819,4011,6808,0,0,0,1.0,1,1.0,1,1.0,1,0.09253031884878929,53
5292,1,10820,4012,6808,0,0,0,1.0,1,1.0,1,1.0,1,0.11252847874945603,53
5293,3,10823,4014,6809,0,0,0,1.0,1,1.0,1,1.0,1,0.12246713316540997,53
5294,2,10825,4015,6810,0,0,0,1.0,1,1.0,1,1.0,1,0.12254903813775044,54
5295,3,10828,4017,6811,0,0,0,1.0,1,1.0,1,1.0,1,0.1360085715862369,52
5296,2,10830,4017,6813,0,0,0,1.0,1,1.0,1,1.0,1,0.11757781798165284,49
5297,3,10833,4019,6814,0,0,0,1.0,1,1.0,1,1.0,1,0.15656754937343864,49
5298,2,10835,4019,6816,0,0,0,1.0,1,1.0,1,1.0,1,0.16624704235502713,49
5299,2,10837,4020,6817,0,0,0,1.0,1,1.0,1,1.0,1,0.16118979626523647,50
5300,2,10839,4021,6818,0,0,0,1.0,1,1.0,1,1.0,1,0.1758609138305172,48
5301,2,10841,4022,6819,0,0,0,1.0,1,1.0,1,1.0,1,0.20028572076022474,46
5302,5,10846,4024,6822,0,0,0,1.0,1,1.0,1,1.0,1,0.21175212735021834,47
5303,3,10849,4025,6824,0,0,0,1.0,1,1.0,1,1.0,1,0.1887954252295492,46
5304,3,10852,4025,6827,0,0,0,1.0,1,1.0,1,1.0,1,0.20318018973210392,45
5305,2,10854,4025,6829,0,0,0,1.0,1,1.0,1,1.0,1,0.18199016629259357,44
5306,3,10857,4027,6830,0,0,0,1.0,1,1.0,1,1.0,1,0.2045943536245012,42
5307,1,10858,4028,6830,0,0,0,1.0,1,1.0,1,1.0,1,0.23012950420738107,42
5308,6,10864,4030,6834,0,0,0,1.0,1,1.0,1,1.0,1,0.1911956046648934,43
5309,1,10865,4031,6834,0,0,0,1.0,1,1.0,1,1.0,1,0.2002931812414929,41
5310,2,10867,4032,6835,0,0,0,1.0,1,1.0,1,1.0,1,0.22619234682480077,41
5311,0,10867,4032,6835,0,0,0,1.0,1,1.0,1,1.0,1,0.2031885102975968,42
5312,2,10869,4032,6837,0,0,0,1.0,1,1.0,1,1.0,1,0.17815472760112658,43
5313,4,10873,4032,6841,0,0,0,1.0,1,1.0,1,1.0,1,0.13372233202257464,44
5314,1,10874,4032,6842,0,0,0,1.0,1,1.0,1,1.0,1,0.12474300218339911,44
5315,3,10877,4034,6843,0,0,0,1.0,1,1.0,1,1.0,1,0.15276110857724656,45
5316,1,10878,4034,6844,0,0,0,1.0,1,1.0,1,1.0,1,0.14263052093350959,46
5317,3,10881,4036,6845,0,0,0,1.0,1,1.0,1,1.0,1,0.1566690767280353,46
5318,0,10881,4036,6845,0,0,0,1.0,1,1.0,1,1.0,1,0.1566690767280353,46
5319,0,10881,4036,6845,0,0,0,1.0,1,1.0,1,1.0,1,0.17088110148532165,47
5320,3,10884,4037,6847,0,0,0,1.0,1,1.0,1,1.0,1,0.11950061476053779,48
5321,0,10884,4037,6847,0,0,0,1.0,1,1.0,1,1.0,1,0.12775831362912332,49
5322,2,10886,4037,6849,0,0,0,1.0,1,1.0,1,1.0,1,0.08498373078307943,49
5323,2,10888,4037,6851,0,0,0,1.0,1,1.0,1,1.0,1,0.09227124980569859,51
5324,0,10888,4037,6851,0,0,0,1.0,1,1.0,1,1.0,1,0.09043814820206414,53
5325,1,10889,4038,6851,0,0,0,1.0,1,1.0,1,1.0,1,0.10549374996442062,53
5326,2,10891,4039,6852,0,0,0,1.0,1,1.0,1,1.0,1,0.11207159725673535,53
5327,2,10893,4039,6854,0,0,0,1.0,1,1.0,1,1.0,1,0.12538478012030443,53
5328,1,10894,4039,6855,0,0,0,1.0,1,1.0,1,1.0,1,0.11719604163919511,54
5329,4,10898,4041,6857,0,0,0,1.0,1,1.0,1,1.0,1,0.155705628360077,53
5330,2,10900,4043,6857,0,0,0,1.0,1,1.0,1,1.0,1,0.20411163508983243,52
5331,3,10903,4043,6860,0,0,0,1.0,1,1.0,1,1.0,1,0.20684467930224557,51
5332,5,10908,4043,6865,0,0,0,1.0,1,1.0,1,1.0,1,0.15494375998457563,52
5333,1,10909,4044,6865,0,0,0,1.0,1,1.0,1,1.0,1,0.1907857256028933,53
5334,6,10915,4045,6870,0,0,0,1.0,1,1.0,1,1.0,1,0.20420512447192676,54
5335,3,10918,4045,6873,0,0,0,1.0,1,1.0,1,1.0,1,0.1689718122163603,55
5336,0,10918,4045,6873,0,0,0,1.0,1,1.0,1,1.0,1,0.16681031546714467,54
5337,0,10918,4045,6873,0,0,0,1.0,1,1.0,1,1.0,1,0.17233980403089774,55
5338,1,10919,4046,6873,0,0,0,1.0,1,1.0,1,1.0,1,0.19191953670687456,55
5339,2,10921,4046,6875,0,0,0,1.0,1,1.0,1,1.0,1,0.15525370088473375,55
5340,1,10922,4046,6876,0,0,0,1.0,1,1.0,1,1.0,1,0.1512172448968385,55
5341,4,10926,4047,6879,0,0,0,1.0,1,1.0,1,1.0,1,0.15414199754585253,54
5342,0,10926,4047,6879,0,0,0,1.0,1,1.0,1,1.0,1,0.15125054003729385,55
5343,3,10929,4049,6880,0,0,0,1.0,1,1.0,1,1.0,1,0.14512357925409014,54
5344,3,10932,4052,6880,0,0,0,1.0,1,1.0,1,1.0,1,0.20651794584507685,55
5345,2,10934,4053,6881,0,0,0,1.0,1,1.0,1,1.0,1,0.17148868620129404,53
5346,4,10938,4054,6884,0,0,0,1.0,1,1.0,1,1.0,1,0.14818208189942542,53
5347,6,10944,4057,6887,0,0,0,1.0,1,1.0,1,1.0,1,0.10672302544778561,51
5348,2,10946,4058,6888,0,0,0,1.0,1,1.0,1,1.0,1,0.12456073118441792,53
5349,1,10947,4058,6889,0,0,0,1.0,1,1.0,1,1.0,1,0.10754363466085805,52
5350,5,10952,4059,6893,0,0,0,1.0,1,1.0,1,1.0,1,0.09121322747407619,50
5351,2,10954,4060,6894,0,0,0,1.0,1,1.0,1,1.0,1,0.12372925244746927,52
5352,2,10956,4061,6895,0,0,0,1.0,1,1.0,1,1.0,1,0.10169437663151126,49
5353,2,10958,4061,6897,0,0,0,1.0,1,1.0,1,1.0,1,0.08482897330794377,49
5354,1,10959,4061,6898,0,0,0,1.0,1,1.0,1,1.0,1,0.08209121267356753,49
5355,0,10959,4061,6898,0,0,0,1.0,1,1.0,1,1.0,1,0.09595394187043063,48
5356,3,10962,4062,6900,0,0,0,1.0,1,1.0,1,1.0,1,0.08796641284519122,49
5357,0,10962,4062,6900,0,0,0,1.0,1,1.0,1,1.0,1,0.09859980842490473,47
5358,2,10964,4063,6901,0,0,0,1.0,1,1.0,1,1.0,1,0.10180461131062941,48
5359,1,10965,4064,6901,0,0,0,1.0,1,1.0,1,1.0,1,0.10639594411932535,48
5360,1,10966,4064,6902,0,0,0,1.0,1,1.0,1,1.0,1,0.10069448153012253,48
5361,0,10966,4064,6902,0,0,0,1.0,1,1.0,1,1.0,1,0.10975051087831729,50
5362,1,10967,4064,6903,0,0,0,1.0,1,1.0,1,1.0,1,0.09554663204193369,50
5363,1,10968,4065,6903,0,0,0,1.0,1,1.0,1,1.0,1,0.09989821167547178,50
5364,0,10968,4065,6903,0,0,0,1.0,1,1.0,1,1.0,1,0.1050103273936424,51
5365,0,10968,4065,6903,0,0,0,1.0,1,1.0,1,1.0,1,0.13726016288030432,52
5366,0,10968,4065,6903,0,0,0,1.0,1,1.0,1,1.0,1,0.13726016288030432,52
5367,1,10969,4066,6903,0,0,0,1.0,1,1.0,1,1.0,1,0.14200611722362855,54
5368,6,10975,4068,6907,0,0,0,1.0,1,1.0,1,1.0,1,0.11963953236629014,55
5369,5,10980,4071,6909,0,0,0,1.0,1,1.0,1,1.0,1,0.1310045363243533,53
5370,2,10982,4072,6910,0,0,0,1.0,1,1.0,1,1.0,1,0.1739491432661941,54
5371,6,10988,4075,6913,0,0,0,1.0,1,1.0,1,1.0,1,0.14135724224788754,53
5372,1,10989,4076,6913,0,0,0,1.0,1,1.0,1,1.0,1,0.15095672319890077,53
5373,0,10989,4076,6913,0,0,0,1.0,1,1.0,1,1.0,1,0.14041853950895872,52
5374,7,10996,4080,6916,0,0,0,1.0,1,1.0,1,1.0,1,0.12442667273157874,51
5375,1,10997,4080,6917,0,0,0,1.0,1,1.0,1,1.0,1,0.08580648960259712,52
5376,2,10999,4082,6917,0,0,0,1.0,1,1.0,1,1.0,1,0.10980208938618821,51
5377,2,11001,4082,6919,0,0,0,1.0,1,1.0,1,1.0,1,0.08265245851384491,52
5378,3,11004,4084,6920,0,0,0,1.0,1,1.0,1,1.0,1,0.13230362068168788,50
5379,0,11004,4084,6920,0,0,0,1.0,1,1.0,1,1.0,1,0.13230362068168788,50
5380,1,11005,4084,6921,0,0,0,1.0,1,1.0,1,1.0,1,0.12144652521536839,52
5381,1,11006,4084,6922,0,0,0,1.0,1,1.0,1,1.0,1,0.11134343675631703,52
5382,0,11006,4084,6922,0,0,0,1.0,1,1.0,1,1.0,1,0.11158728728893894,52
5383,1,11007,4084,6923,0,0,0,1.0,1,1.0,1,1.0,1,0.08831009659176244,51
5384,2,11009,4086,6923,0,0,0,1.0,1,1.0,1,1.0,1,0.11063146813729074,52
5385,1,11010,4087,6923,0,0,0,1.0,1,1.0,1,1.0,1,0.15092991420928523,51
5386,5,11015,4089,6926,0,0,0,1.0,1,1.0,1,1.0,1,0.10995867940655285,52
5387,2,11017,4089,6928,0,0,0,1.0,1,1.0,1,1.0,1,0.07871246831537741,53
5388,1,11018,4089,6929,0,0,0,1.0,1,1.0,1,1.0,1,0.08054468793380214,54
5389,1,11019,4090,6929,0,0,0,1.0,1,1.0,1,1.0,1,0.053513739943138294,55
5390,1,11020,4091,6929,0,0,0,1.0,1,1.0,1,1.0,1,0.0611536701375535,56
5391,1,11021,4092,6929,0,0,0,1.0,1,1.0,1,1.0,1,0.07523023366309115,56
5392,3,11024,4094,6930,0,0,0,1.0,1,1.0,1,1.0,1,0.07901444456187748,56
5393,1,11025,4095,6930,0,0,0,1.0,1,1.0,1,1.0,1,0.10298370338788454,54
5394,1,11026,4096,6930,0,0,0,1.0,1,1.0,1,1.0,1,0.11805544792771581,53
5395,5,11031,4096,6935,0,0,0,1.0,1,1.0,1,1.0,1,0.06812643258383183,53
5396,1,11032,4097,6935,0,0,0,1.0,1,1.0,1,1.0,1,0.0945883797214717,54
5397,3,11035,4099,6936,0,0,0,1.0,1,1.0,1,1.0,1,0.08862060248638681,53
5398,3,11038,4101,6937,0,0,0,1.0,1,1.0,1,1.0,1,0.07667582177842384,53
5399,4,11042,4105,6937,0,0,0,1.0,1,1.0,1,1.0,1,0.10892227787355148,55
5400,3,11045,4105,6940,0,0,0,1.0,1,1.0,1,1.0,1,0.10050876578431685,55
5401,4,11049,4108,6941,0,0,0,1.0,1,1.0,1,1.0,1,0.08416319011906331,56
5402,0,11049,4108,6941,0,0,0,1.0,1,1.0,1,1.0,1,0.0,0
