,SuccessfulHandoverCount,TotalSuccessfulHandoverCount,TotalSuccessfulHandoverCountRange,TotalSuccessfulHandoverCountLoadBalancing,TotalSuccessfulHandoverCountOverload,FailedHandoverCount,TotalFailedHandoverCount,AvgQoS,MinQoS,AvgQoS_LoadBased,MinQoS_LoadBased,AvgQoS_RangeBased,MinQoS_RangeBased,GiniLoad,VehicleCount
0,0,0,0,0,0,0,0,1.0,1,1.0,1,1.0,1,0.0,0
1,0,0,0,0,0,0,0,1.0,1,1.0,1,1.0,1,0.5618426117878546,30
2,1,1,1,0,0,0,0,1.0,1,1.0,1,1.0,1,0.49595507616326323,32
3,7,8,8,0,0,0,0,1.0,1,1.0,1,1.0,1,0.6000198329063351,33
4,0,8,8,0,0,0,0,1.0,1,1.0,1,1.0,1,0.5791050616033631,34
5,3,11,11,0,0,0,0,1.0,1,1.0,1,1.0,1,0.5906433329867392,36
6,3,14,14,0,0,0,0,1.0,1,1.0,1,1.0,1,0.5803262292489393,38
7,2,16,16,0,0,0,0,1.0,1,1.0,1,1.0,1,0.5337335342953975,40
8,6,22,22,0,0,0,0,1.0,1,1.0,1,1.0,1,0.49671728737404236,40
9,3,25,25,0,0,0,0,1.0,1,1.0,1,1.0,1,0.5301578827013276,40
10,1,26,26,0,0,0,0,1.0,1,1.0,1,1.0,1,0.5116350712866288,41
11,1,27,27,0,0,0,0,1.0,1,1.0,1,1.0,1,0.4822101884897817,40
12,0,27,27,0,0,0,0,1.0,1,1.0,1,1.0,1,0.48283772488529,39
13,1,28,28,0,0,0,0,1.0,1,1.0,1,1.0,1,0.48791676947477813,37
14,1,29,29,0,0,0,0,1.0,1,1.0,1,1.0,1,0.4764322306502637,35
15,4,33,33,0,0,0,0,1.0,1,1.0,1,1.0,1,0.483821334935988,36
16,0,33,33,0,0,0,0,1.0,1,1.0,1,1.0,1,0.5014206059644588,34
17,2,35,35,0,0,0,0,1.0,1,1.0,1,1.0,1,0.540342085382585,33
18,1,36,36,0,0,0,0,1.0,1,1.0,1,1.0,1,0.5151386396928115,34
19,5,41,41,0,0,0,0,1.0,1,1.0,1,1.0,1,0.4775429285714499,34
20,1,42,42,0,0,0,0,1.0,1,1.0,1,1.0,1,0.4786646077540034,34
21,6,48,48,0,0,0,0,1.0,1,1.0,1,1.0,1,0.4508413079936078,36
22,2,50,50,0,0,0,0,1.0,1,1.0,1,1.0,1,0.4465476115546201,35
23,3,53,53,0,0,0,0,1.0,1,1.0,1,1.0,1,0.4981916514553152,35
24,6,59,59,0,0,0,0,1.0,1,1.0,1,1.0,1,0.4947292297334516,35
25,1,60,60,0,0,0,0,1.0,1,1.0,1,1.0,1,0.4981923341830513,35
26,5,65,65,0,0,0,0,1.0,1,1.0,1,1.0,1,0.528854482496526,36
27,2,67,67,0,0,0,0,1.0,1,1.0,1,1.0,1,0.5537738011435571,34
28,4,71,71,0,0,0,0,1.0,1,1.0,1,1.0,1,0.5137647513006959,35
29,1,72,72,0,0,0,0,1.0,1,1.0,1,1.0,1,0.5198091811361943,33
30,2,74,74,0,0,0,0,1.0,1,1.0,1,1.0,1,0.48426934459872156,33
31,1,75,75,0,0,0,0,1.0,1,1.0,1,1.0,1,0.5305505275645939,33
32,1,76,76,0,0,0,0,1.0,1,1.0,1,1.0,1,0.55611332805993,32
33,2,78,78,0,0,0,0,1.0,1,1.0,1,1.0,1,0.5773031069577242,33
34,3,81,81,0,0,0,0,1.0,1,1.0,1,1.0,1,0.6092728569784782,33
35,1,82,82,0,0,0,0,1.0,1,1.0,1,1.0,1,0.6137562170711974,35
36,2,84,84,0,0,0,0,1.0,1,1.0,1,1.0,1,0.6081454882383981,36
37,1,85,85,0,0,0,0,1.0,1,1.0,1,1.0,1,0.6023037783283173,37
38,1,86,86,0,0,0,0,1.0,1,1.0,1,1.0,1,0.6385886002902038,36
39,2,88,88,0,0,0,0,1.0,1,1.0,1,1.0,1,0.6028495939333215,38
40,1,89,89,0,0,0,0,1.0,1,1.0,1,1.0,1,0.5783827477594466,40
41,1,90,90,0,0,0,0,1.0,1,1.0,1,1.0,1,0.5688061436998231,40
42,3,93,93,0,0,0,0,1.0,1,1.0,1,1.0,1,0.5725520965009483,40
43,1,94,94,0,0,0,0,1.0,1,1.0,1,1.0,1,0.5714917745618177,43
44,2,96,96,0,0,0,0,1.0,1,1.0,1,1.0,1,0.5707044161067734,43
45,0,96,96,0,0,0,0,1.0,1,1.0,1,1.0,1,0.5603572961754794,44
46,2,98,98,0,0,0,0,1.0,1,1.0,1,1.0,1,0.5741751224618368,44
47,0,98,98,0,0,0,0,1.0,1,1.0,1,1.0,1,0.5741751224618368,44
48,1,99,99,0,0,0,0,1.0,1,1.0,1,1.0,1,0.5886944021839097,44
49,1,100,100,0,0,0,0,1.0,1,1.0,1,1.0,1,0.5778528333475702,41
50,3,103,103,0,0,0,0,1.0,1,1.0,1,1.0,1,0.5717132616207613,40
51,0,103,103,0,0,0,0,1.0,1,1.0,1,1.0,1,0.5535068516798207,38
52,3,106,106,0,0,0,0,1.0,1,1.0,1,1.0,1,0.5516940984194455,37
53,3,109,109,0,0,0,0,1.0,1,1.0,1,1.0,1,0.5650411952933793,38
54,5,114,114,0,0,0,0,1.0,1,1.0,1,1.0,1,0.6141257148015432,38
55,4,118,118,0,0,0,0,1.0,1,1.0,1,1.0,1,0.6041549800675988,38
56,5,123,123,0,0,0,0,1.0,1,1.0,1,1.0,1,0.6433439575053401,38
57,4,127,127,0,0,0,0,1.0,1,1.0,1,1.0,1,0.6051307791026574,38
58,3,130,130,0,0,0,0,1.0,1,1.0,1,1.0,1,0.5802872334522325,38
59,2,132,132,0,0,0,0,1.0,1,1.0,1,1.0,1,0.5682669519270821,40
60,3,135,135,0,0,0,0,1.0,1,1.0,1,1.0,1,0.5667393931962221,40
61,1,136,136,0,0,0,0,1.0,1,1.0,1,1.0,1,0.5760646525524752,40
62,2,138,138,0,0,0,0,1.0,1,1.0,1,1.0,1,0.5728570575198169,42
63,1,139,139,0,0,0,0,1.0,1,1.0,1,1.0,1,0.6005184189686056,40
64,2,141,141,0,0,0,0,1.0,1,1.0,1,1.0,1,0.6053032812912452,41
65,1,142,142,0,0,0,0,1.0,1,1.0,1,1.0,1,0.5920457845487285,41
66,2,144,144,0,0,0,0,1.0,1,1.0,1,1.0,1,0.609694611136622,41
67,0,144,144,0,0,0,0,1.0,1,1.0,1,1.0,1,0.609694611136622,41
68,1,145,145,0,0,0,0,1.0,1,1.0,1,1.0,1,0.572391706238121,41
69,4,149,149,0,0,0,0,1.0,1,1.0,1,1.0,1,0.5336771559911405,41
70,3,152,152,0,0,0,0,1.0,1,1.0,1,1.0,1,0.5431508262880295,42
71,1,153,153,0,0,0,0,1.0,1,1.0,1,1.0,1,0.5026675843625442,44
72,2,155,155,0,0,0,0,1.0,1,1.0,1,1.0,1,0.5248119121429824,44
73,2,157,157,0,0,0,0,1.0,1,1.0,1,1.0,1,0.5316561500675377,46
74,1,158,158,0,0,0,0,1.0,1,1.0,1,1.0,1,0.5369977812018111,44
75,5,163,163,0,0,0,0,1.0,1,1.0,1,1.0,1,0.4935997859351163,44
76,1,164,164,0,0,0,0,1.0,1,1.0,1,1.0,1,0.4871396660342407,45
77,6,170,170,0,0,0,0,1.0,1,1.0,1,1.0,1,0.45270825302448725,44
78,2,172,172,0,0,0,0,1.0,1,1.0,1,1.0,1,0.44441994395967066,44
79,4,176,176,0,0,0,0,1.0,1,1.0,1,1.0,1,0.49646746419390264,43
80,3,179,179,0,0,0,0,1.0,1,1.0,1,1.0,1,0.49684514486090114,43
81,5,184,184,0,0,0,0,1.0,1,1.0,1,1.0,1,0.5030212114767414,44
82,3,187,187,0,0,0,0,1.0,1,1.0,1,1.0,1,0.4593127251912525,45
83,3,190,190,0,0,0,0,1.0,1,1.0,1,1.0,1,0.4867797964753613,45
84,3,193,193,0,0,0,0,1.0,1,1.0,1,1.0,1,0.4609977291622834,45
85,1,194,194,0,0,0,0,1.0,1,1.0,1,1.0,1,0.47937258007946776,45
86,0,194,194,0,0,0,0,1.0,1,1.0,1,1.0,1,0.47937258007946776,45
87,2,196,196,0,0,0,0,1.0,1,1.0,1,1.0,1,0.5162554491128409,44
88,1,197,197,0,0,0,0,1.0,1,1.0,1,1.0,1,0.4970551031548418,45
89,1,198,198,0,0,0,0,1.0,1,1.0,1,1.0,1,0.5056523872642252,46
90,1,199,199,0,0,0,0,1.0,1,1.0,1,1.0,1,0.5105190818095456,44
91,0,199,199,0,0,0,0,1.0,1,1.0,1,1.0,1,0.49829673057800344,45
92,2,201,201,0,0,0,0,1.0,1,1.0,1,1.0,1,0.4824527226983106,46
93,2,203,203,0,0,0,0,1.0,1,1.0,1,1.0,1,0.5406514377563485,46
94,4,207,207,0,0,0,0,1.0,1,1.0,1,1.0,1,0.5145820550278006,46
95,0,207,207,0,0,0,0,1.0,1,1.0,1,1.0,1,0.521222187592741,46
96,2,209,209,0,0,0,0,1.0,1,1.0,1,1.0,1,0.5194168333706187,46
97,1,210,210,0,0,0,0,1.0,1,1.0,1,1.0,1,0.5375636877652741,47
98,2,212,212,0,0,0,0,1.0,1,1.0,1,1.0,1,0.5329432013841304,47
99,4,216,216,0,0,0,0,1.0,1,1.0,1,1.0,1,0.5107741299617601,46
100,2,218,218,0,0,0,0,1.0,1,1.0,1,1.0,1,0.5486580853956662,48
101,1,219,219,0,0,0,0,1.0,1,1.0,1,1.0,1,0.5685622843406872,49
102,3,222,222,0,0,0,0,1.0,1,1.0,1,1.0,1,0.5690735760014841,49
103,4,226,226,0,0,0,0,1.0,1,1.0,1,1.0,1,0.5699862961601103,48
104,2,228,228,0,0,0,0,1.0,1,1.0,1,1.0,1,0.6154067810191545,49
105,3,231,231,0,0,0,0,1.0,1,1.0,1,1.0,1,0.5665130307747405,48
106,3,234,234,0,0,0,0,1.0,1,1.0,1,1.0,1,0.5818046482540774,48
107,2,236,236,0,0,0,0,1.0,1,1.0,1,1.0,1,0.5729260437147808,47
108,7,243,243,0,0,0,0,1.0,1,1.0,1,1.0,1,0.5699666241749141,47
109,2,245,245,0,0,0,0,1.0,1,1.0,1,1.0,1,0.5830608951070443,47
110,8,253,253,0,0,0,0,1.0,1,1.0,1,1.0,1,0.6043979516131839,47
111,5,258,258,0,0,0,0,1.0,1,1.0,1,1.0,1,0.5815128735930933,46
112,8,266,266,0,0,0,0,1.0,1,1.0,1,1.0,1,0.6068880821594332,46
113,4,270,270,0,0,0,0,1.0,1,1.0,1,1.0,1,0.6164586587478845,45
114,4,274,274,0,0,0,0,1.0,1,1.0,1,1.0,1,0.5905025564141955,46
115,2,276,276,0,0,0,0,1.0,1,1.0,1,1.0,1,0.5704757716532676,47
116,2,278,278,0,0,0,0,1.0,1,1.0,1,1.0,1,0.5413565880127802,48
117,2,280,280,0,0,0,0,1.0,1,1.0,1,1.0,1,0.527144053949362,48
118,1,281,281,0,0,0,0,1.0,1,1.0,1,1.0,1,0.5010036755639578,49
119,0,281,281,0,0,0,0,1.0,1,1.0,1,1.0,1,0.5002419101681158,50
120,1,282,282,0,0,0,0,1.0,1,1.0,1,1.0,1,0.46649466070753287,51
121,0,282,282,0,0,0,0,1.0,1,1.0,1,1.0,1,0.46649466070753287,51
122,1,283,283,0,0,0,0,1.0,1,1.0,1,1.0,1,0.47086092513342936,51
123,1,284,284,0,0,0,0,1.0,1,1.0,1,1.0,1,0.474168309235169,51
124,3,287,287,0,0,0,0,1.0,1,1.0,1,1.0,1,0.4858840807838433,51
125,2,289,289,0,0,0,0,1.0,1,1.0,1,1.0,1,0.5055177540355913,50
126,4,293,293,0,0,0,0,1.0,1,1.0,1,1.0,1,0.5054327248359552,52
127,4,297,297,0,0,0,0,1.0,1,1.0,1,1.0,1,0.5054011850325459,50
128,0,297,297,0,0,0,0,1.0,1,1.0,1,1.0,1,0.5054011850325459,50
129,3,300,300,0,0,0,0,1.0,1,1.0,1,1.0,1,0.48913931314380427,52
130,3,303,303,0,0,0,0,1.0,1,1.0,1,1.0,1,0.5166606173109265,52
131,3,306,306,0,0,0,0,1.0,1,1.0,1,1.0,1,0.5012595808905204,54
132,5,311,311,0,0,0,0,1.0,1,1.0,1,1.0,1,0.5291816508870185,54
133,2,313,313,0,0,0,0,1.0,1,1.0,1,1.0,1,0.5396793186882161,52
134,4,317,317,0,0,0,0,1.0,1,1.0,1,1.0,1,0.5462180980161867,52
135,3,320,320,0,0,0,0,1.0,1,1.0,1,1.0,1,0.537445574523811,51
136,4,324,324,0,0,0,0,1.0,1,1.0,1,1.0,1,0.5373385803656358,51
137,4,328,328,0,0,0,0,1.0,1,1.0,1,1.0,1,0.5561777282578049,50
138,1,329,329,0,0,0,0,1.0,1,1.0,1,1.0,1,0.5521426392651989,52
139,6,335,335,0,0,0,0,1.0,1,1.0,1,1.0,1,0.527558656986395,51
140,2,337,337,0,0,0,0,1.0,1,1.0,1,1.0,1,0.5192881298626882,51
141,3,340,340,0,0,0,0,1.0,1,1.0,1,1.0,1,0.5042224013148099,50
142,6,346,346,0,0,0,0,1.0,1,1.0,1,1.0,1,0.5328646730720356,51
143,3,349,349,0,0,0,0,1.0,1,1.0,1,1.0,1,0.5390873038051847,48
144,3,352,352,0,0,0,0,1.0,1,1.0,1,1.0,1,0.5365434647275856,49
145,3,355,355,0,0,0,0,1.0,1,1.0,1,1.0,1,0.5723225014058629,47
146,3,358,358,0,0,0,0,1.0,1,1.0,1,1.0,1,0.5950497994668417,49
147,4,362,362,0,0,0,0,1.0,1,1.0,1,1.0,1,0.621024886831879,46
148,2,364,364,0,0,0,0,1.0,1,1.0,1,1.0,1,0.582803780563802,47
149,4,368,368,0,0,0,0,1.0,1,1.0,1,1.0,1,0.5637351624692294,46
150,1,369,369,0,0,0,0,1.0,1,1.0,1,1.0,1,0.5412651963620063,47
151,3,372,372,0,0,0,0,1.0,1,1.0,1,1.0,1,0.5639988495965991,46
152,2,374,374,0,0,0,0,1.0,1,1.0,1,1.0,1,0.5805355026576289,45
153,3,377,377,0,0,0,0,1.0,1,1.0,1,1.0,1,0.5676087696476164,46
154,2,379,379,0,0,0,0,1.0,1,1.0,1,1.0,1,0.5951081800184488,44
155,3,382,382,0,0,0,0,1.0,1,1.0,1,1.0,1,0.5850613713352577,45
156,3,385,385,0,0,0,0,1.0,1,1.0,1,1.0,1,0.6211052408795281,43
157,4,389,389,0,0,0,0,1.0,1,1.0,1,1.0,1,0.6370997608300233,42
158,3,392,392,0,0,0,0,1.0,1,1.0,1,1.0,1,0.6425485749381695,43
159,4,396,396,0,0,0,0,1.0,1,1.0,1,1.0,1,0.6301116776936793,44
160,4,400,400,0,0,0,0,1.0,1,1.0,1,1.0,1,0.6356869394681532,44
161,5,405,405,0,0,0,0,1.0,1,1.0,1,1.0,1,0.6620768177072486,44
162,2,407,407,0,0,0,0,1.0,1,1.0,1,1.0,1,0.6528643627642471,44
163,6,413,413,0,0,0,0,1.0,1,1.0,1,1.0,1,0.6562322579411374,44
164,2,415,415,0,0,0,0,1.0,1,1.0,1,1.0,1,0.6564590773900243,44
165,4,419,419,0,0,0,0,1.0,1,1.0,1,1.0,1,0.6302660166722064,43
166,3,422,422,0,0,0,0,1.0,1,1.0,1,1.0,1,0.6168872974022538,43
167,3,425,425,0,0,0,0,1.0,1,1.0,1,1.0,1,0.590786303701476,42
168,1,426,426,0,0,0,0,1.0,1,1.0,1,1.0,1,0.5898363970859603,40
169,4,430,430,0,0,0,0,1.0,1,1.0,1,1.0,1,0.5827417745511544,41
170,0,430,430,0,0,0,0,1.0,1,1.0,1,1.0,1,0.5710018860589047,39
171,3,433,433,0,0,0,0,1.0,1,1.0,1,1.0,1,0.5763327847552298,39
172,0,433,433,0,0,0,0,1.0,1,1.0,1,1.0,1,0.5692577729689572,38
173,3,436,436,0,0,0,0,1.0,1,1.0,1,1.0,1,0.6018520493997995,38
174,2,438,438,0,0,0,0,1.0,1,1.0,1,1.0,1,0.5760069003013433,37
175,3,441,441,0,0,0,0,1.0,1,1.0,1,1.0,1,0.5713957723637664,36
176,2,443,443,0,0,0,0,1.0,1,1.0,1,1.0,1,0.5734647582714247,36
177,1,444,444,0,0,0,0,1.0,1,1.0,1,1.0,1,0.5627541599137477,38
178,3,447,447,0,0,0,0,1.0,1,1.0,1,1.0,1,0.5358188091183116,39
179,3,450,450,0,0,0,0,1.0,1,1.0,1,1.0,1,0.5560215462721435,40
180,1,451,451,0,0,0,0,1.0,1,1.0,1,1.0,1,0.5568869512878297,40
181,1,452,452,0,0,0,0,1.0,1,1.0,1,1.0,1,0.5768634971573585,39
182,3,455,455,0,0,0,0,1.0,1,1.0,1,1.0,1,0.5461371929007599,40
183,6,461,461,0,0,0,0,1.0,1,1.0,1,1.0,1,0.5612161616627125,40
184,4,465,465,0,0,0,0,1.0,1,1.0,1,1.0,1,0.5642911683092023,38
185,6,471,471,0,0,0,0,1.0,1,1.0,1,1.0,1,0.5748739660664436,38
186,4,475,475,0,0,0,0,1.0,1,1.0,1,1.0,1,0.6019873208935889,37
187,2,477,477,0,0,0,0,1.0,1,1.0,1,1.0,1,0.630698727244056,36
188,2,479,479,0,0,0,0,1.0,1,1.0,1,1.0,1,0.6082164836980388,36
189,5,484,484,0,0,0,0,1.0,1,1.0,1,1.0,1,0.5812699905262377,36
190,2,486,486,0,0,0,0,1.0,1,1.0,1,1.0,1,0.5818794225791257,36
191,2,488,488,0,0,0,0,1.0,1,1.0,1,1.0,1,0.5990527024701696,37
192,4,492,492,0,0,0,0,1.0,1,1.0,1,1.0,1,0.6190481697265924,37
193,2,494,494,0,0,0,0,1.0,1,1.0,1,1.0,1,0.6344133121369456,38
194,3,497,497,0,0,0,0,1.0,1,1.0,1,1.0,1,0.6590620275525932,39
195,2,499,499,0,0,0,0,1.0,1,1.0,1,1.0,1,0.6379551088963005,40
196,4,503,503,0,0,0,0,1.0,1,1.0,1,1.0,1,0.6244808101015932,40
197,4,507,507,0,0,0,0,1.0,1,1.0,1,1.0,1,0.5982572162543991,40
198,3,510,510,0,0,0,0,1.0,1,1.0,1,1.0,1,0.6076196417014904,40
199,2,512,512,0,0,0,0,1.0,1,1.0,1,1.0,1,0.6289718419377918,40
200,3,515,515,0,0,0,0,1.0,1,1.0,1,1.0,1,0.6356078509230817,40
201,0,515,515,0,0,0,0,1.0,1,1.0,1,1.0,1,0.6273009288628917,39
202,3,518,518,0,0,0,0,1.0,1,1.0,1,1.0,1,0.5930078124474238,40
203,2,520,520,0,0,0,0,1.0,1,1.0,1,1.0,1,0.5714830848267829,39
204,1,521,521,0,0,0,0,1.0,1,1.0,1,1.0,1,0.5667551131891477,38
205,3,524,524,0,0,0,0,1.0,1,1.0,1,1.0,1,0.5689942722177082,37
206,1,525,525,0,0,0,0,1.0,1,1.0,1,1.0,1,0.5256485165400155,36
207,2,527,527,0,0,0,0,1.0,1,1.0,1,1.0,1,0.5373197734720657,37
208,1,528,528,0,0,0,0,1.0,1,1.0,1,1.0,1,0.4926900029656705,36
209,0,528,528,0,0,0,0,1.0,1,1.0,1,1.0,1,0.4926900029656705,36
210,4,532,532,0,0,0,0,1.0,1,1.0,1,1.0,1,0.4682362896375898,36
211,1,533,533,0,0,0,0,1.0,1,1.0,1,1.0,1,0.5020982332043205,34
212,6,539,539,0,0,0,0,1.0,1,1.0,1,1.0,1,0.5298564608969084,34
213,4,543,543,0,0,0,0,1.0,1,1.0,1,1.0,1,0.5253240477698465,36
214,4,547,547,0,0,0,0,1.0,1,1.0,1,1.0,1,0.5914004310326189,35
215,3,550,550,0,0,0,0,1.0,1,1.0,1,1.0,1,0.5990207300142292,35
216,3,553,553,0,0,0,0,1.0,1,1.0,1,1.0,1,0.6048721534457124,37
217,2,555,555,0,0,0,0,1.0,1,1.0,1,1.0,1,0.6285027113806145,37
218,3,558,558,0,0,0,0,1.0,1,1.0,1,1.0,1,0.6455665305265398,37
219,5,563,563,0,0,0,0,1.0,1,1.0,1,1.0,1,0.5828656462077094,37
220,5,568,568,0,0,0,0,1.0,1,1.0,1,1.0,1,0.5592225027866143,38
221,5,573,573,0,0,0,0,1.0,1,1.0,1,1.0,1,0.5371526344254358,39
222,3,576,576,0,0,0,0,1.0,1,1.0,1,1.0,1,0.5169889767060287,39
223,4,580,580,0,0,0,0,1.0,1,1.0,1,1.0,1,0.5241937628796266,40
224,6,586,586,0,0,0,0,1.0,1,1.0,1,1.0,1,0.5371957657118717,40
225,1,587,587,0,0,0,0,1.0,1,1.0,1,1.0,1,0.5697854110439227,39
226,5,592,592,0,0,0,0,1.0,1,1.0,1,1.0,1,0.5397006234992485,39
227,3,595,595,0,0,0,0,1.0,1,1.0,1,1.0,1,0.5091863294772165,39
228,3,598,598,0,0,0,0,1.0,1,1.0,1,1.0,1,0.5186134948247033,38
229,2,600,600,0,0,0,0,1.0,1,1.0,1,1.0,1,0.5098920605016279,39
230,4,604,604,0,0,0,0,1.0,1,1.0,1,1.0,1,0.564093871108547,38
231,3,607,607,0,0,0,0,1.0,1,1.0,1,1.0,1,0.5640656609817912,38
232,2,609,609,0,0,0,0,1.0,1,1.0,1,1.0,1,0.5610462960199513,37
233,2,611,611,0,0,0,0,1.0,1,1.0,1,1.0,1,0.5620093001603593,36
234,3,614,614,0,0,0,0,1.0,1,1.0,1,1.0,1,0.6138753700297713,34
235,1,615,615,0,0,0,0,1.0,1,1.0,1,1.0,1,0.64026174698126,34
236,1,616,616,0,0,0,0,1.0,1,1.0,1,1.0,1,0.6367601867118751,33
237,2,618,618,0,0,0,0,1.0,1,1.0,1,1.0,1,0.6275959942724679,32
238,2,620,620,0,0,0,0,1.0,1,1.0,1,1.0,1,0.6183778183513124,32
239,0,620,620,0,0,0,0,1.0,1,1.0,1,1.0,1,0.5751188092415676,31
240,2,622,622,0,0,0,0,1.0,1,1.0,1,1.0,1,0.647376839591374,28
241,1,623,623,0,0,0,0,1.0,1,1.0,1,1.0,1,0.6548558396401626,27
242,1,624,624,0,0,0,0,1.0,1,1.0,1,1.0,1,0.6267855361432003,29
243,3,627,627,0,0,0,0,1.0,1,1.0,1,1.0,1,0.6604460409276469,28
244,2,629,629,0,0,0,0,1.0,1,1.0,1,1.0,1,0.6126285961630796,28
245,2,631,631,0,0,0,0,1.0,1,1.0,1,1.0,1,0.6208552425137529,27
246,2,633,633,0,0,0,0,1.0,1,1.0,1,1.0,1,0.650108560725041,25
247,0,633,633,0,0,0,0,1.0,1,1.0,1,1.0,1,0.6081776825340783,26
248,4,637,637,0,0,0,0,1.0,1,1.0,1,1.0,1,0.5855291867457088,27
249,2,639,639,0,0,0,0,1.0,1,1.0,1,1.0,1,0.5999852898828212,26
250,1,640,640,0,0,0,0,1.0,1,1.0,1,1.0,1,0.644216929491073,27
251,3,643,643,0,0,0,0,1.0,1,1.0,1,1.0,1,0.6859245703054206,28
252,0,643,643,0,0,0,0,1.0,1,1.0,1,1.0,1,0.6859245703054206,28
253,4,647,647,0,0,0,0,1.0,1,1.0,1,1.0,1,0.6587820254964349,28
254,0,647,647,0,0,0,0,1.0,1,1.0,1,1.0,1,0.6691538658330762,29
255,1,648,648,0,0,0,0,1.0,1,1.0,1,1.0,1,0.6607741688536517,30
256,2,650,650,0,0,0,0,1.0,1,1.0,1,1.0,1,0.6399343378930485,30
257,1,651,651,0,0,0,0,1.0,1,1.0,1,1.0,1,0.6421457115650845,32
258,2,653,653,0,0,0,0,1.0,1,1.0,1,1.0,1,0.6018065161206756,32
259,1,654,654,0,0,0,0,1.0,1,1.0,1,1.0,1,0.6140301625722834,32
260,3,657,657,0,0,0,0,1.0,1,1.0,1,1.0,1,0.6639582994216789,34
261,1,658,658,0,0,0,0,1.0,1,1.0,1,1.0,1,0.6746571713512557,35
262,1,659,659,0,0,0,0,1.0,1,1.0,1,1.0,1,0.6946859507913781,36
263,0,659,659,0,0,0,0,1.0,1,1.0,1,1.0,1,0.696510583185957,34
264,0,659,659,0,0,0,0,1.0,1,1.0,1,1.0,1,0.696510583185957,34
265,1,660,660,0,0,0,0,1.0,1,1.0,1,1.0,1,0.693865307326941,33
266,0,660,660,0,0,0,0,1.0,1,1.0,1,1.0,1,0.6736430122243862,34
267,1,661,661,0,0,0,0,1.0,1,1.0,1,1.0,1,0.6921060881082346,33
268,2,663,663,0,0,0,0,1.0,1,1.0,1,1.0,1,0.7190115404389076,34
269,0,663,663,0,0,0,0,1.0,1,1.0,1,1.0,1,0.7190115404389076,34
270,0,663,663,0,0,0,0,1.0,1,1.0,1,1.0,1,0.7170121677817101,36
271,2,665,665,0,0,0,0,1.0,1,1.0,1,1.0,1,0.7017356563113016,36
272,1,666,666,0,0,0,0,1.0,1,1.0,1,1.0,1,0.6980792959510737,38
273,1,667,667,0,0,0,0,1.0,1,1.0,1,1.0,1,0.7195435592379474,38
274,1,668,668,0,0,0,0,1.0,1,1.0,1,1.0,1,0.7378724744287996,38
275,2,670,670,0,0,0,0,1.0,1,1.0,1,1.0,1,0.729898445969875,38
276,1,671,671,0,0,0,0,1.0,1,1.0,1,1.0,1,0.6923332268615192,39
277,0,671,671,0,0,0,0,1.0,1,1.0,1,1.0,1,0.6889086637431159,38
278,1,672,672,0,0,0,0,1.0,1,1.0,1,1.0,1,0.6809383877721096,38
279,2,674,674,0,0,0,0,1.0,1,1.0,1,1.0,1,0.702860028805021,38
280,0,674,674,0,0,0,0,1.0,1,1.0,1,1.0,1,0.7048703527170622,38
281,0,674,674,0,0,0,0,1.0,1,1.0,1,1.0,1,0.6969756673098096,38
282,2,676,676,0,0,0,0,1.0,1,1.0,1,1.0,1,0.7116254776850811,38
283,0,676,676,0,0,0,0,1.0,1,1.0,1,1.0,1,0.7116254776850811,38
284,2,678,678,0,0,0,0,1.0,1,1.0,1,1.0,1,0.7156268210914741,39
285,1,679,679,0,0,0,0,1.0,1,1.0,1,1.0,1,0.7060284259883753,39
286,4,683,683,0,0,0,0,1.0,1,1.0,1,1.0,1,0.6459083197681542,39
287,1,684,684,0,0,0,0,1.0,1,1.0,1,1.0,1,0.6395709241581126,39
288,5,689,689,0,0,0,0,1.0,1,1.0,1,1.0,1,0.5717631503727659,39
289,6,695,695,0,0,0,0,1.0,1,1.0,1,1.0,1,0.5811401896464364,39
290,3,698,698,0,0,0,0,1.0,1,1.0,1,1.0,1,0.5756620102934228,39
291,7,705,705,0,0,0,0,1.0,1,1.0,1,1.0,1,0.6071691814520489,39
292,7,712,712,0,0,0,0,1.0,1,1.0,1,1.0,1,0.5732444585415769,40
293,6,718,718,0,0,0,0,1.0,1,1.0,1,1.0,1,0.5981619372391956,41
294,3,721,721,0,0,0,0,1.0,1,1.0,1,1.0,1,0.5924008999322439,40
295,8,729,729,0,0,0,0,1.0,1,1.0,1,1.0,1,0.5195946391004235,42
296,2,731,731,0,0,0,0,1.0,1,1.0,1,1.0,1,0.4917060912603886,42
297,3,734,734,0,0,0,0,1.0,1,1.0,1,1.0,1,0.5062320636539774,43
298,4,738,738,0,0,0,0,1.0,1,1.0,1,1.0,1,0.46334403583832967,44
299,7,745,745,0,0,0,0,1.0,1,1.0,1,1.0,1,0.4570437470322827,44
300,1,746,746,0,0,0,0,1.0,1,1.0,1,1.0,1,0.4789957737878698,45
301,3,749,749,0,0,0,0,1.0,1,1.0,1,1.0,1,0.46366211756857484,47
302,2,751,751,0,0,0,0,1.0,1,1.0,1,1.0,1,0.48100883912502984,46
303,5,756,756,0,0,0,0,1.0,1,1.0,1,1.0,1,0.5076191616022756,45
304,2,758,758,0,0,0,0,1.0,1,1.0,1,1.0,1,0.5427489871473435,45
305,1,759,759,0,0,0,0,1.0,1,1.0,1,1.0,1,0.5213171843079929,43
306,1,760,760,0,0,0,0,1.0,1,1.0,1,1.0,1,0.5508949581506706,44
307,1,761,761,0,0,0,0,1.0,1,1.0,1,1.0,1,0.5699804098125688,42
308,1,762,762,0,0,0,0,1.0,1,1.0,1,1.0,1,0.5847806052919275,41
309,0,762,762,0,0,0,0,1.0,1,1.0,1,1.0,1,0.5897233343679757,42
310,2,764,764,0,0,0,0,1.0,1,1.0,1,1.0,1,0.6420166159500704,41
311,0,764,764,0,0,0,0,1.0,1,1.0,1,1.0,1,0.6420166159500704,41
312,2,766,766,0,0,0,0,1.0,1,1.0,1,1.0,1,0.6320772147996404,44
313,2,768,768,0,0,0,0,1.0,1,1.0,1,1.0,1,0.6538462059115709,43
314,1,769,769,0,0,0,0,1.0,1,1.0,1,1.0,1,0.6640176140868755,43
315,2,771,771,0,0,0,0,1.0,1,1.0,1,1.0,1,0.6579112159252793,43
316,0,771,771,0,0,0,0,1.0,1,1.0,1,1.0,1,0.6579112159252793,43
317,3,774,774,0,0,0,0,1.0,1,1.0,1,1.0,1,0.6566696469637688,44
318,1,775,775,0,0,0,0,1.0,1,1.0,1,1.0,1,0.6716620997781827,45
319,1,776,776,0,0,0,0,1.0,1,1.0,1,1.0,1,0.6657822398484492,46
320,0,776,776,0,0,0,0,1.0,1,1.0,1,1.0,1,0.6614390330697859,45
321,2,778,778,0,0,0,0,1.0,1,1.0,1,1.0,1,0.64868507481372,44
322,1,779,779,0,0,0,0,1.0,1,1.0,1,1.0,1,0.648573812250085,42
323,3,782,782,0,0,0,0,1.0,1,1.0,1,1.0,1,0.6675497792369948,42
324,2,784,784,0,0,0,0,1.0,1,1.0,1,1.0,1,0.675395514876687,43
325,3,787,787,0,0,0,0,1.0,1,1.0,1,1.0,1,0.6669804893847421,43
326,2,789,789,0,0,0,0,1.0,1,1.0,1,1.0,1,0.6588268330097632,43
327,1,790,790,0,0,0,0,1.0,1,1.0,1,1.0,1,0.6695655577347543,44
328,0,790,790,0,0,0,0,1.0,1,1.0,1,1.0,1,0.6695655577347543,44
329,3,793,793,0,0,0,0,1.0,1,1.0,1,1.0,1,0.6874450357370699,45
330,0,793,793,0,0,0,0,1.0,1,1.0,1,1.0,1,0.6762647506753893,46
331,0,793,793,0,0,0,0,1.0,1,1.0,1,1.0,1,0.6762647506753893,46
332,0,793,793,0,0,0,0,1.0,1,1.0,1,1.0,1,0.6628953159991632,47
333,1,794,794,0,0,0,0,1.0,1,1.0,1,1.0,1,0.6707062783309488,48
334,1,795,795,0,0,0,0,1.0,1,1.0,1,1.0,1,0.6590548000422407,48
335,1,796,796,0,0,0,0,1.0,1,1.0,1,1.0,1,0.6383837736792433,49
336,4,800,800,0,0,0,0,1.0,1,1.0,1,1.0,1,0.6283920853545362,50
337,2,802,802,0,0,0,0,1.0,1,1.0,1,1.0,1,0.624110391078466,51
338,4,806,806,0,0,0,0,1.0,1,1.0,1,1.0,1,0.6118985183577096,51
339,3,809,809,0,0,0,0,1.0,1,1.0,1,1.0,1,0.6294459567633593,51
340,2,811,811,0,0,0,0,1.0,1,1.0,1,1.0,1,0.6060480185474081,51
341,3,814,814,0,0,0,0,1.0,1,1.0,1,1.0,1,0.5881971635379838,51
342,0,814,814,0,0,0,0,1.0,1,1.0,1,1.0,1,0.5881971635379838,51
343,1,815,815,0,0,0,0,1.0,1,1.0,1,1.0,1,0.6065676464117624,51
344,6,821,821,0,0,0,0,1.0,1,1.0,1,1.0,1,0.6409412535130674,50
345,2,823,823,0,0,0,0,1.0,1,1.0,1,1.0,1,0.6489582558328643,50
346,5,828,828,0,0,0,0,1.0,1,1.0,1,1.0,1,0.657800828191465,50
347,1,829,829,0,0,0,0,1.0,1,1.0,1,1.0,1,0.6592482069374993,51
348,3,832,832,0,0,0,0,1.0,1,1.0,1,1.0,1,0.6430915403017963,52
349,2,834,834,0,0,0,0,1.0,1,1.0,1,1.0,1,0.6353031319783289,54
350,2,836,836,0,0,0,0,1.0,1,1.0,1,1.0,1,0.6449105456541849,54
351,4,840,840,0,0,0,0,1.0,1,1.0,1,1.0,1,0.6416716857322563,54
352,1,841,841,0,0,0,0,1.0,1,1.0,1,1.0,1,0.6493275192906897,56
353,7,848,848,0,0,0,0,1.0,1,1.0,1,1.0,1,0.6392728866195138,54
354,1,849,849,0,0,0,0,1.0,1,1.0,1,1.0,1,0.6320908634796085,53
355,5,854,854,0,0,0,0,1.0,1,1.0,1,1.0,1,0.608690685801064,54
356,2,856,856,0,0,0,0,1.0,1,1.0,1,1.0,1,0.596620915012179,54
357,1,857,857,0,0,0,0,1.0,1,1.0,1,1.0,1,0.5947674756790103,53
358,0,857,857,0,0,0,0,1.0,1,1.0,1,1.0,1,0.6007579275821998,49
359,1,858,858,0,0,0,0,1.0,1,1.0,1,1.0,1,0.5859606198391859,48
360,2,860,860,0,0,0,0,1.0,1,1.0,1,1.0,1,0.6077828496778486,47
361,2,862,862,0,0,0,0,1.0,1,1.0,1,1.0,1,0.5903538344026654,46
362,6,868,868,0,0,0,0,1.0,1,1.0,1,1.0,1,0.6061290199991203,46
363,6,874,874,0,0,0,0,1.0,1,1.0,1,1.0,1,0.5720661741709534,47
364,3,877,877,0,0,0,0,1.0,1,1.0,1,1.0,1,0.574726273377517,47
365,7,884,884,0,0,0,0,1.0,1,1.0,1,1.0,1,0.5455882680995376,47
366,0,884,884,0,0,0,0,1.0,1,1.0,1,1.0,1,0.5428262927937199,50
367,5,889,889,0,0,0,0,1.0,1,1.0,1,1.0,1,0.5268848308763496,50
368,2,891,891,0,0,0,0,1.0,1,1.0,1,1.0,1,0.5039653050996789,51
369,1,892,892,0,0,0,0,1.0,1,1.0,1,1.0,1,0.5052064839033072,51
370,1,893,893,0,0,0,0,1.0,1,1.0,1,1.0,1,0.5086448467649292,51
371,3,896,896,0,0,0,0,1.0,1,1.0,1,1.0,1,0.5451105395515295,52
372,1,897,897,0,0,0,0,1.0,1,1.0,1,1.0,1,0.5439280502248757,53
373,3,900,900,0,0,0,0,1.0,1,1.0,1,1.0,1,0.586208249554522,53
374,2,902,902,0,0,0,0,1.0,1,1.0,1,1.0,1,0.6297547786876304,53
375,3,905,905,0,0,0,0,1.0,1,1.0,1,1.0,1,0.6338448782754962,53
376,4,909,909,0,0,0,0,1.0,1,1.0,1,1.0,1,0.6160018600411894,53
377,4,913,913,0,0,0,0,1.0,1,1.0,1,1.0,1,0.6247797163732864,53
378,5,918,918,0,0,0,0,1.0,1,1.0,1,1.0,1,0.6227926328529302,53
379,6,924,924,0,0,0,0,1.0,1,1.0,1,1.0,1,0.5839410776456285,54
380,6,930,930,0,0,0,0,1.0,1,1.0,1,1.0,1,0.5850959752038859,54
381,5,935,935,0,0,0,0,1.0,1,1.0,1,1.0,1,0.5678346032876684,54
382,6,941,941,0,0,0,0,1.0,1,1.0,1,1.0,1,0.5702354128992163,55
383,1,942,942,0,0,0,0,1.0,1,1.0,1,1.0,1,0.5683227100514759,55
384,4,946,946,0,0,0,0,1.0,1,1.0,1,1.0,1,0.6197140669688898,54
385,3,949,949,0,0,0,0,1.0,1,1.0,1,1.0,1,0.6207982188376419,52
386,3,952,952,0,0,0,0,1.0,1,1.0,1,1.0,1,0.6319494845921034,52
387,4,956,956,0,0,0,0,1.0,1,1.0,1,1.0,1,0.6324091939538851,50
388,2,958,958,0,0,0,0,1.0,1,1.0,1,1.0,1,0.6036984950444464,52
389,7,965,965,0,0,0,0,1.0,1,1.0,1,1.0,1,0.564650554319263,51
390,7,972,972,0,0,0,0,1.0,1,1.0,1,1.0,1,0.5469871435107518,50
391,3,975,975,0,0,0,0,1.0,1,1.0,1,1.0,1,0.5284393286762918,49
392,7,982,982,0,0,0,0,1.0,1,1.0,1,1.0,1,0.5379626703476955,47
393,4,986,986,0,0,0,0,1.0,1,1.0,1,1.0,1,0.5203447740109104,47
394,4,990,990,0,0,0,0,1.0,1,1.0,1,1.0,1,0.520013089381868,48
395,2,992,992,0,0,0,0,1.0,1,1.0,1,1.0,1,0.5366525045251681,46
396,0,992,992,0,0,0,0,1.0,1,1.0,1,1.0,1,0.5406927542474987,43
397,3,995,995,0,0,0,0,1.0,1,1.0,1,1.0,1,0.559820126006782,42
398,1,996,996,0,0,0,0,1.0,1,1.0,1,1.0,1,0.5781122224869214,40
399,0,996,996,0,0,0,0,1.0,1,1.0,1,1.0,1,0.5722319160898524,39
400,1,997,997,0,0,0,0,1.0,1,1.0,1,1.0,1,0.5927017105534721,38
401,0,997,997,0,0,0,0,1.0,1,1.0,1,1.0,1,0.6133926486381911,37
402,0,997,997,0,0,0,0,1.0,1,1.0,1,1.0,1,0.6119761848545399,36
403,2,999,999,0,0,0,0,1.0,1,1.0,1,1.0,1,0.5673413106574222,38
404,2,1001,1001,0,0,0,0,1.0,1,1.0,1,1.0,1,0.6002868789449568,39
405,1,1002,1002,0,0,0,0,1.0,1,1.0,1,1.0,1,0.5859366331854589,40
406,3,1005,1005,0,0,0,0,1.0,1,1.0,1,1.0,1,0.5837372236032907,41
407,1,1006,1006,0,0,0,0,1.0,1,1.0,1,1.0,1,0.5633332749810543,42
408,4,1010,1010,0,0,0,0,1.0,1,1.0,1,1.0,1,0.562400821606259,43
409,1,1011,1011,0,0,0,0,1.0,1,1.0,1,1.0,1,0.5646062662908394,44
410,2,1013,1013,0,0,0,0,1.0,1,1.0,1,1.0,1,0.5600268890851804,46
411,4,1017,1017,0,0,0,0,1.0,1,1.0,1,1.0,1,0.5676891348107949,46
412,1,1018,1018,0,0,0,0,1.0,1,1.0,1,1.0,1,0.5702791581474669,47
413,4,1022,1022,0,0,0,0,1.0,1,1.0,1,1.0,1,0.5594207679678244,47
414,2,1024,1024,0,0,0,0,1.0,1,1.0,1,1.0,1,0.5647844320563526,47
415,3,1027,1027,0,0,0,0,1.0,1,1.0,1,1.0,1,0.5668307264840577,48
416,3,1030,1030,0,0,0,0,1.0,1,1.0,1,1.0,1,0.5243945139562031,49
417,2,1032,1032,0,0,0,0,1.0,1,1.0,1,1.0,1,0.5110331670331315,49
418,4,1036,1036,0,0,0,0,1.0,1,1.0,1,1.0,1,0.5241574615608096,50
419,5,1041,1041,0,0,0,0,1.0,1,1.0,1,1.0,1,0.48957006310039175,50
420,2,1043,1043,0,0,0,0,1.0,1,1.0,1,1.0,1,0.47518573320433666,50
421,2,1045,1045,0,0,0,0,1.0,1,1.0,1,1.0,1,0.47566507229506527,50
422,4,1049,1049,0,0,0,0,1.0,1,1.0,1,1.0,1,0.48957945257740393,50
423,4,1053,1053,0,0,0,0,1.0,1,1.0,1,1.0,1,0.4525255103813694,51
424,3,1056,1056,0,0,0,0,1.0,1,1.0,1,1.0,1,0.501314213682606,49
425,6,1062,1062,0,0,0,0,1.0,1,1.0,1,1.0,1,0.5538767062959902,48
426,1,1063,1063,0,0,0,0,1.0,1,1.0,1,1.0,1,0.5473099670340714,50
427,3,1066,1066,0,0,0,0,1.0,1,1.0,1,1.0,1,0.5669483433360486,48
428,1,1067,1067,0,0,0,0,1.0,1,1.0,1,1.0,1,0.5621647496651981,49
429,1,1068,1068,0,0,0,0,1.0,1,1.0,1,1.0,1,0.5845632706966306,45
430,2,1070,1070,0,0,0,0,1.0,1,1.0,1,1.0,1,0.5690614226568564,44
431,3,1073,1073,0,0,0,0,1.0,1,1.0,1,1.0,1,0.5788755253217505,42
432,1,1074,1074,0,0,0,0,1.0,1,1.0,1,1.0,1,0.622477378747431,40
433,2,1076,1076,0,0,0,0,1.0,1,1.0,1,1.0,1,0.6165706896458838,39
434,2,1078,1078,0,0,0,0,1.0,1,1.0,1,1.0,1,0.6484664863425603,39
435,1,1079,1079,0,0,0,0,1.0,1,1.0,1,1.0,1,0.6716418041210381,38
436,2,1081,1081,0,0,0,0,1.0,1,1.0,1,1.0,1,0.6572111010744894,38
437,4,1085,1085,0,0,0,0,1.0,1,1.0,1,1.0,1,0.6911778865178425,39
438,6,1091,1091,0,0,0,0,1.0,1,1.0,1,1.0,1,0.6650318985071587,38
439,4,1095,1095,0,0,0,0,1.0,1,1.0,1,1.0,1,0.6658061088044909,39
440,1,1096,1096,0,0,0,0,1.0,1,1.0,1,1.0,1,0.6727666194107935,39
441,7,1103,1103,0,0,0,0,1.0,1,1.0,1,1.0,1,0.6344251326367679,41
442,3,1106,1106,0,0,0,0,1.0,1,1.0,1,1.0,1,0.6275174577428132,42
443,2,1108,1108,0,0,0,0,1.0,1,1.0,1,1.0,1,0.6362590782917513,42
444,4,1112,1112,0,0,0,0,1.0,1,1.0,1,1.0,1,0.5949727092580595,43
445,3,1115,1115,0,0,0,0,1.0,1,1.0,1,1.0,1,0.5509462732144729,44
446,3,1118,1118,0,0,0,0,1.0,1,1.0,1,1.0,1,0.5193528139151531,44
447,4,1122,1122,0,0,0,0,1.0,1,1.0,1,1.0,1,0.5055837415361275,47
448,0,1122,1122,0,0,0,0,1.0,1,1.0,1,1.0,1,0.5028691840711771,46
449,0,1122,1122,0,0,0,0,1.0,1,1.0,1,1.0,1,0.5028691840711771,46
450,0,1122,1122,0,0,0,0,1.0,1,1.0,1,1.0,1,0.5029171696929868,46
451,1,1123,1123,0,0,0,0,1.0,1,1.0,1,1.0,1,0.5180130884681159,47
452,4,1127,1127,0,0,0,0,1.0,1,1.0,1,1.0,1,0.5584418156774089,47
453,3,1130,1130,0,0,0,0,1.0,1,1.0,1,1.0,1,0.5788702097484597,47
454,2,1132,1132,0,0,0,0,1.0,1,1.0,1,1.0,1,0.6243439234738982,46
455,2,1134,1134,0,0,0,0,1.0,1,1.0,1,1.0,1,0.6173368449143743,47
456,3,1137,1137,0,0,0,0,1.0,1,1.0,1,1.0,1,0.6014070774027507,49
457,2,1139,1139,0,0,0,0,1.0,1,1.0,1,1.0,1,0.614379899268021,50
458,2,1141,1141,0,0,0,0,1.0,1,1.0,1,1.0,1,0.5938490214393733,50
459,5,1146,1146,0,0,0,0,1.0,1,1.0,1,1.0,1,0.5525299636373551,52
460,1,1147,1147,0,0,0,0,1.0,1,1.0,1,1.0,1,0.5542232065308286,53
461,3,1150,1150,0,0,0,0,1.0,1,1.0,1,1.0,1,0.544798466571413,54
462,6,1156,1156,0,0,0,0,1.0,1,1.0,1,1.0,1,0.5447113092077924,54
463,2,1158,1158,0,0,0,0,1.0,1,1.0,1,1.0,1,0.5412642884468706,55
464,6,1164,1164,0,0,0,0,1.0,1,1.0,1,1.0,1,0.5409559631023345,56
465,10,1174,1174,0,0,0,0,1.0,1,1.0,1,1.0,1,0.5444180243505699,54
466,4,1178,1178,0,0,0,0,1.0,1,1.0,1,1.0,1,0.5544535978254694,54
467,4,1182,1182,0,0,0,0,1.0,1,1.0,1,1.0,1,0.5613119647438901,51
468,3,1185,1185,0,0,0,0,1.0,1,1.0,1,1.0,1,0.5654837614024585,51
469,9,1194,1194,0,0,0,0,1.0,1,1.0,1,1.0,1,0.5198255745063495,48
470,2,1196,1196,0,0,0,0,1.0,1,1.0,1,1.0,1,0.5136281021418981,47
471,10,1206,1206,0,0,0,0,1.0,1,1.0,1,1.0,1,0.5150716571502818,44
472,1,1207,1207,0,0,0,0,1.0,1,1.0,1,1.0,1,0.5043780732349465,43
473,6,1213,1213,0,0,0,0,1.0,1,1.0,1,1.0,1,0.48436365608444354,41
474,1,1214,1214,0,0,0,0,1.0,1,1.0,1,1.0,1,0.46711109020990754,39
475,3,1217,1217,0,0,0,0,1.0,1,1.0,1,1.0,1,0.5045905067459049,40
476,2,1219,1219,0,0,0,0,1.0,1,1.0,1,1.0,1,0.4747724984601723,38
477,1,1220,1220,0,0,0,0,1.0,1,1.0,1,1.0,1,0.4657715580353708,35
478,4,1224,1224,0,0,0,0,1.0,1,1.0,1,1.0,1,0.5266249812550226,35
479,2,1226,1226,0,0,0,0,1.0,1,1.0,1,1.0,1,0.4973097832781814,32
480,0,1226,1226,0,0,0,0,1.0,1,1.0,1,1.0,1,0.5272632244351402,32
481,1,1227,1227,0,0,0,0,1.0,1,1.0,1,1.0,1,0.5111312295699477,33
482,0,1227,1227,0,0,0,0,1.0,1,1.0,1,1.0,1,0.4833010413312341,34
483,3,1230,1230,0,0,0,0,1.0,1,1.0,1,1.0,1,0.48540816071034837,32
484,4,1234,1234,0,0,0,0,1.0,1,1.0,1,1.0,1,0.47436376523305396,33
485,3,1237,1237,0,0,0,0,1.0,1,1.0,1,1.0,1,0.47923456692097965,34
486,1,1238,1238,0,0,0,0,1.0,1,1.0,1,1.0,1,0.5117693065028502,36
487,5,1243,1243,0,0,0,0,1.0,1,1.0,1,1.0,1,0.5283284938220854,36
488,2,1245,1245,0,0,0,0,1.0,1,1.0,1,1.0,1,0.5519425424420478,37
489,0,1245,1245,0,0,0,0,1.0,1,1.0,1,1.0,1,0.5582720043522597,38
490,1,1246,1246,0,0,0,0,1.0,1,1.0,1,1.0,1,0.5789329452360783,38
491,0,1246,1246,0,0,0,0,1.0,1,1.0,1,1.0,1,0.5900010198936634,37
492,2,1248,1248,0,0,0,0,1.0,1,1.0,1,1.0,1,0.6044819442188857,37
493,1,1249,1249,0,0,0,0,1.0,1,1.0,1,1.0,1,0.6351602876297725,37
494,1,1250,1250,0,0,0,0,1.0,1,1.0,1,1.0,1,0.6330628819514894,39
495,0,1250,1250,0,0,0,0,1.0,1,1.0,1,1.0,1,0.6257625565736052,40
496,2,1252,1252,0,0,0,0,1.0,1,1.0,1,1.0,1,0.6408875451980622,40
497,1,1253,1253,0,0,0,0,1.0,1,1.0,1,1.0,1,0.6010151667810736,43
498,4,1257,1257,0,0,0,0,1.0,1,1.0,1,1.0,1,0.569816057712215,43
499,4,1261,1261,0,0,0,0,1.0,1,1.0,1,1.0,1,0.5551107106630544,44
500,4,1265,1265,0,0,0,0,1.0,1,1.0,1,1.0,1,0.5523255993032066,45
501,3,1268,1268,0,0,0,0,1.0,1,1.0,1,1.0,1,0.5741507574634095,45
502,2,1270,1270,0,0,0,0,1.0,1,1.0,1,1.0,1,0.6165563343402102,45
503,2,1272,1272,0,0,0,0,1.0,1,1.0,1,1.0,1,0.6163554418957344,46
504,1,1273,1273,0,0,0,0,1.0,1,1.0,1,1.0,1,0.6394544092349628,47
505,2,1275,1275,0,0,0,0,1.0,1,1.0,1,1.0,1,0.659748387084376,42
506,0,1275,1275,0,0,0,0,1.0,1,1.0,1,1.0,1,0.6545133380845806,41
507,0,1275,1275,0,0,0,0,1.0,1,1.0,1,1.0,1,0.6602340107307002,38
508,1,1276,1276,0,0,0,0,1.0,1,1.0,1,1.0,1,0.6578349941935421,38
509,0,1276,1276,0,0,0,0,1.0,1,1.0,1,1.0,1,0.6600386618579377,37
510,1,1277,1277,0,0,0,0,1.0,1,1.0,1,1.0,1,0.6316072651236363,36
511,1,1278,1278,0,0,0,0,1.0,1,1.0,1,1.0,1,0.637754179115723,34
512,0,1278,1278,0,0,0,0,1.0,1,1.0,1,1.0,1,0.6243010974675963,32
513,4,1282,1282,0,0,0,0,1.0,1,1.0,1,1.0,1,0.6030313180578142,32
514,1,1283,1283,0,0,0,0,1.0,1,1.0,1,1.0,1,0.5845153370547357,35
515,8,1291,1291,0,0,0,0,1.0,1,1.0,1,1.0,1,0.6188655954236824,35
516,1,1292,1292,0,0,0,0,1.0,1,1.0,1,1.0,1,0.600023609095609,36
517,8,1300,1300,0,0,0,0,1.0,1,1.0,1,1.0,1,0.6091857108676363,36
518,2,1302,1302,0,0,0,0,1.0,1,1.0,1,1.0,1,0.5787453107476721,39
519,4,1306,1306,0,0,0,0,1.0,1,1.0,1,1.0,1,0.5599552599774332,39
520,2,1308,1308,0,0,0,0,1.0,1,1.0,1,1.0,1,0.582340349439012,39
521,3,1311,1311,0,0,0,0,1.0,1,1.0,1,1.0,1,0.5372491771508537,40
522,1,1312,1312,0,0,0,0,1.0,1,1.0,1,1.0,1,0.543677316628228,40
523,3,1315,1315,0,0,0,0,1.0,1,1.0,1,1.0,1,0.5302998390932604,41
524,1,1316,1316,0,0,0,0,1.0,1,1.0,1,1.0,1,0.5394877019883841,41
525,4,1320,1320,0,0,0,0,1.0,1,1.0,1,1.0,1,0.536527809092222,40
526,2,1322,1322,0,0,0,0,1.0,1,1.0,1,1.0,1,0.49787032373724077,40
527,3,1325,1325,0,0,0,0,1.0,1,1.0,1,1.0,1,0.5190726688707857,40
528,1,1326,1326,0,0,0,0,1.0,1,1.0,1,1.0,1,0.49588524255343663,40
529,0,1326,1326,0,0,0,0,1.0,1,1.0,1,1.0,1,0.5121164531311158,39
530,5,1331,1331,0,0,0,0,1.0,1,1.0,1,1.0,1,0.5012300366321547,39
531,2,1333,1333,0,0,0,0,1.0,1,1.0,1,1.0,1,0.47261186738709177,39
532,1,1334,1334,0,0,0,0,1.0,1,1.0,1,1.0,1,0.4923790671505246,40
533,0,1334,1334,0,0,0,0,1.0,1,1.0,1,1.0,1,0.5258573962750107,40
534,1,1335,1335,0,0,0,0,1.0,1,1.0,1,1.0,1,0.545623192977208,42
535,1,1336,1336,0,0,0,0,1.0,1,1.0,1,1.0,1,0.5411092036741142,42
536,0,1336,1336,0,0,0,0,1.0,1,1.0,1,1.0,1,0.5413060342839525,43
537,0,1336,1336,0,0,0,0,1.0,1,1.0,1,1.0,1,0.5413060342839525,43
538,2,1338,1338,0,0,0,0,1.0,1,1.0,1,1.0,1,0.5652753558751964,44
539,3,1341,1341,0,0,0,0,1.0,1,1.0,1,1.0,1,0.5644150226824654,44
540,1,1342,1342,0,0,0,0,1.0,1,1.0,1,1.0,1,0.5734166527828269,44
541,4,1346,1346,0,0,0,0,1.0,1,1.0,1,1.0,1,0.585216304820166,45
542,2,1348,1348,0,0,0,0,1.0,1,1.0,1,1.0,1,0.6031573235026595,46
543,3,1351,1351,0,0,0,0,1.0,1,1.0,1,1.0,1,0.601972539509868,43
544,4,1355,1355,0,0,0,0,1.0,1,1.0,1,1.0,1,0.633261930204202,42
545,3,1358,1358,0,0,0,0,1.0,1,1.0,1,1.0,1,0.6455421039687927,43
546,3,1361,1361,0,0,0,0,1.0,1,1.0,1,1.0,1,0.6653557103148592,41
547,1,1362,1362,0,0,0,0,1.0,1,1.0,1,1.0,1,0.6258401841528964,40
548,1,1363,1363,0,0,0,0,1.0,1,1.0,1,1.0,1,0.6567517780946595,40
549,1,1364,1364,0,0,0,0,1.0,1,1.0,1,1.0,1,0.6580308205289629,39
550,2,1366,1366,0,0,0,0,1.0,1,1.0,1,1.0,1,0.6737868947643467,38
551,2,1368,1368,0,0,0,0,1.0,1,1.0,1,1.0,1,0.6641724492363716,38
552,0,1368,1368,0,0,0,0,1.0,1,1.0,1,1.0,1,0.6642496999915953,39
553,2,1370,1370,0,0,0,0,1.0,1,1.0,1,1.0,1,0.6485925822880477,38
554,0,1370,1370,0,0,0,0,1.0,1,1.0,1,1.0,1,0.6563426657540815,39
555,2,1372,1372,0,0,0,0,1.0,1,1.0,1,1.0,1,0.6281296091970769,39
556,2,1374,1374,0,0,0,0,1.0,1,1.0,1,1.0,1,0.6186361103484065,40
557,2,1376,1376,0,0,0,0,1.0,1,1.0,1,1.0,1,0.6368785823204218,40
558,2,1378,1378,0,0,0,0,1.0,1,1.0,1,1.0,1,0.6497967407474963,40
559,4,1382,1382,0,0,0,0,1.0,1,1.0,1,1.0,1,0.6561252105678749,40
560,5,1387,1387,0,0,0,0,1.0,1,1.0,1,1.0,1,0.6383235693926135,41
561,4,1391,1391,0,0,0,0,1.0,1,1.0,1,1.0,1,0.6522206327368377,42
562,2,1393,1393,0,0,0,0,1.0,1,1.0,1,1.0,1,0.6701191867196196,42
563,2,1395,1395,0,0,0,0,1.0,1,1.0,1,1.0,1,0.679443343846492,42
564,5,1400,1400,0,0,0,0,1.0,1,1.0,1,1.0,1,0.6834857169623153,43
565,2,1402,1402,0,0,0,0,1.0,1,1.0,1,1.0,1,0.6778407459102387,44
566,4,1406,1406,0,0,0,0,1.0,1,1.0,1,1.0,1,0.6711457870023695,45
567,5,1411,1411,0,0,0,0,1.0,1,1.0,1,1.0,1,0.6760579925196573,45
568,4,1415,1415,0,0,0,0,1.0,1,1.0,1,1.0,1,0.6441252390777968,46
569,6,1421,1421,0,0,0,0,1.0,1,1.0,1,1.0,1,0.6150269852798502,47
570,3,1424,1424,0,0,0,0,1.0,1,1.0,1,1.0,1,0.6369871541963009,48
571,3,1427,1427,0,0,0,0,1.0,1,1.0,1,1.0,1,0.6351701349664116,48
572,0,1427,1427,0,0,0,0,1.0,1,1.0,1,1.0,1,0.6482021746302797,47
573,3,1430,1430,0,0,0,0,1.0,1,1.0,1,1.0,1,0.6368697994010404,49
574,3,1433,1433,0,0,0,0,1.0,1,1.0,1,1.0,1,0.6341001479193257,49
575,2,1435,1435,0,0,0,0,1.0,1,1.0,1,1.0,1,0.6371521110522381,50
576,3,1438,1438,0,0,0,0,1.0,1,1.0,1,1.0,1,0.6374191763877509,51
577,3,1441,1441,0,0,0,0,1.0,1,1.0,1,1.0,1,0.6625076372104223,51
578,1,1442,1442,0,0,0,0,1.0,1,1.0,1,1.0,1,0.6673884144130872,51
579,2,1444,1444,0,0,0,0,1.0,1,1.0,1,1.0,1,0.6541326387159228,52
580,3,1447,1447,0,0,0,0,1.0,1,1.0,1,1.0,1,0.6756397952796284,52
581,1,1448,1448,0,0,0,0,1.0,1,1.0,1,1.0,1,0.6708051162976157,52
582,1,1449,1449,0,0,0,0,1.0,1,1.0,1,1.0,1,0.6823265421787382,53
583,3,1452,1452,0,0,0,0,1.0,1,1.0,1,1.0,1,0.6937781725754997,51
584,4,1456,1456,0,0,0,0,1.0,1,1.0,1,1.0,1,0.719157297128632,51
585,7,1463,1463,0,0,0,0,1.0,1,1.0,1,1.0,1,0.7101282669474511,49
586,4,1467,1467,0,0,0,0,1.0,1,1.0,1,1.0,1,0.6587995209364992,49
587,5,1472,1472,0,0,0,0,1.0,1,1.0,1,1.0,1,0.6477659565116554,48
588,3,1475,1475,0,0,0,0,1.0,1,1.0,1,1.0,1,0.6521071459061264,46
589,4,1479,1479,0,0,0,0,1.0,1,1.0,1,1.0,1,0.6232922477223569,48
590,3,1482,1482,0,0,0,0,1.0,1,1.0,1,1.0,1,0.5884562391238138,47
591,5,1487,1487,0,0,0,0,1.0,1,1.0,1,1.0,1,0.5952571884932389,48
592,8,1495,1495,0,0,0,0,1.0,1,1.0,1,1.0,1,0.6392944075887438,47
593,5,1500,1500,0,0,0,0,1.0,1,1.0,1,1.0,1,0.5988190815450372,45
594,8,1508,1508,0,0,0,0,1.0,1,1.0,1,1.0,1,0.6218658239650738,44
595,6,1514,1514,0,0,0,0,1.0,1,1.0,1,1.0,1,0.6213206878594909,43
596,6,1520,1520,0,0,0,0,1.0,1,1.0,1,1.0,1,0.6264710752732627,44
597,2,1522,1522,0,0,0,0,1.0,1,1.0,1,1.0,1,0.5823602400046263,43
598,3,1525,1525,0,0,0,0,1.0,1,1.0,1,1.0,1,0.5607690758540613,45
599,2,1527,1527,0,0,0,0,1.0,1,1.0,1,1.0,1,0.578783962065029,44
600,3,1530,1530,0,0,0,0,1.0,1,1.0,1,1.0,1,0.5330875597354349,44
601,4,1534,1534,0,0,0,0,1.0,1,1.0,1,1.0,1,0.5001538911472004,45
602,0,1534,1534,0,0,0,0,1.0,1,1.0,1,1.0,1,0.5086224295308328,46
603,2,1536,1536,0,0,0,0,1.0,1,1.0,1,1.0,1,0.5007342480403916,46
604,0,1536,1536,0,0,0,0,1.0,1,1.0,1,1.0,1,0.48533629529434463,47
605,1,1537,1537,0,0,0,0,1.0,1,1.0,1,1.0,1,0.48642238941267796,47
606,1,1538,1538,0,0,0,0,1.0,1,1.0,1,1.0,1,0.49378556819801817,47
607,3,1541,1541,0,0,0,0,1.0,1,1.0,1,1.0,1,0.5177926271095423,48
608,3,1544,1544,0,0,0,0,1.0,1,1.0,1,1.0,1,0.5650859196774084,47
609,0,1544,1544,0,0,0,0,1.0,1,1.0,1,1.0,1,0.5666442669063396,48
610,2,1546,1546,0,0,0,0,1.0,1,1.0,1,1.0,1,0.6116198106843664,48
611,0,1546,1546,0,0,0,0,1.0,1,1.0,1,1.0,1,0.600967195829059,49
612,4,1550,1550,0,0,0,0,1.0,1,1.0,1,1.0,1,0.6135805794278018,50
613,1,1551,1551,0,0,0,0,1.0,1,1.0,1,1.0,1,0.587062273620992,50
614,2,1553,1553,0,0,0,0,1.0,1,1.0,1,1.0,1,0.5932288430561475,50
615,1,1554,1554,0,0,0,0,1.0,1,1.0,1,1.0,1,0.5796642901262343,50
616,3,1557,1557,0,0,0,0,1.0,1,1.0,1,1.0,1,0.5762635491523801,50
617,1,1558,1558,0,0,0,0,1.0,1,1.0,1,1.0,1,0.5675531909289301,52
618,5,1563,1563,0,0,0,0,1.0,1,1.0,1,1.0,1,0.5612594834582835,52
619,3,1566,1566,0,0,0,0,1.0,1,1.0,1,1.0,1,0.5358328661656343,50
620,4,1570,1570,0,0,0,0,1.0,1,1.0,1,1.0,1,0.5376800201394046,50
621,4,1574,1574,0,0,0,0,1.0,1,1.0,1,1.0,1,0.530601426197022,49
622,4,1578,1578,0,0,0,0,1.0,1,1.0,1,1.0,1,0.5733626573461578,49
623,5,1583,1583,0,0,0,0,1.0,1,1.0,1,1.0,1,0.5435449542533122,48
624,4,1587,1587,0,0,0,0,1.0,1,1.0,1,1.0,1,0.565740938736971,46
625,5,1592,1592,0,0,0,0,1.0,1,1.0,1,1.0,1,0.5082974889531099,45
626,3,1595,1595,0,0,0,0,1.0,1,1.0,1,1.0,1,0.4955019609888522,44
627,6,1601,1601,0,0,0,0,1.0,1,1.0,1,1.0,1,0.49895121144452853,44
628,1,1602,1602,0,0,0,0,1.0,1,1.0,1,1.0,1,0.503108341278847,44
629,7,1609,1609,0,0,0,0,1.0,1,1.0,1,1.0,1,0.5040978253963637,41
630,1,1610,1610,0,0,0,0,1.0,1,1.0,1,1.0,1,0.5230369912377477,40
631,0,1610,1610,0,0,0,0,1.0,1,1.0,1,1.0,1,0.5352187704487528,38
632,3,1613,1613,0,0,0,0,1.0,1,1.0,1,1.0,1,0.5537108548534908,38
633,2,1615,1615,0,0,0,0,1.0,1,1.0,1,1.0,1,0.5708175361258431,36
634,3,1618,1618,0,0,0,0,1.0,1,1.0,1,1.0,1,0.5852117262006373,35
635,3,1621,1621,0,0,0,0,1.0,1,1.0,1,1.0,1,0.5399141066897376,35
636,2,1623,1623,0,0,0,0,1.0,1,1.0,1,1.0,1,0.577497762919905,36
637,2,1625,1625,0,0,0,0,1.0,1,1.0,1,1.0,1,0.5739363010365417,35
638,0,1625,1625,0,0,0,0,1.0,1,1.0,1,1.0,1,0.606959919383392,34
639,3,1628,1628,0,0,0,0,1.0,1,1.0,1,1.0,1,0.5703355500759695,36
640,2,1630,1630,0,0,0,0,1.0,1,1.0,1,1.0,1,0.5656394318797042,37
641,1,1631,1631,0,0,0,0,1.0,1,1.0,1,1.0,1,0.5565406845965511,37
642,2,1633,1633,0,0,0,0,1.0,1,1.0,1,1.0,1,0.553978691304116,38
643,1,1634,1634,0,0,0,0,1.0,1,1.0,1,1.0,1,0.5531423965611281,39
644,2,1636,1636,0,0,0,0,1.0,1,1.0,1,1.0,1,0.5626400685481788,39
645,2,1638,1638,0,0,0,0,1.0,1,1.0,1,1.0,1,0.5560240836795001,39
646,4,1642,1642,0,0,0,0,1.0,1,1.0,1,1.0,1,0.5880583709583602,40
647,3,1645,1645,0,0,0,0,1.0,1,1.0,1,1.0,1,0.586272011495383,40
648,5,1650,1650,0,0,0,0,1.0,1,1.0,1,1.0,1,0.5713325470123417,40
649,0,1650,1650,0,0,0,0,1.0,1,1.0,1,1.0,1,0.5713325470123417,40
650,3,1653,1653,0,0,0,0,1.0,1,1.0,1,1.0,1,0.5602657293868349,41
651,4,1657,1657,0,0,0,0,1.0,1,1.0,1,1.0,1,0.578324719967831,42
652,1,1658,1658,0,0,0,0,1.0,1,1.0,1,1.0,1,0.5686430425728991,41
653,2,1660,1660,0,0,0,0,1.0,1,1.0,1,1.0,1,0.5693841210892984,41
654,4,1664,1664,0,0,0,0,1.0,1,1.0,1,1.0,1,0.5572851179067981,42
655,2,1666,1666,0,0,0,0,1.0,1,1.0,1,1.0,1,0.541223435816423,45
656,2,1668,1668,0,0,0,0,1.0,1,1.0,1,1.0,1,0.5500836827847835,45
657,1,1669,1669,0,0,0,0,1.0,1,1.0,1,1.0,1,0.5455549134540997,43
658,4,1673,1673,0,0,0,0,1.0,1,1.0,1,1.0,1,0.5451075099024077,43
659,3,1676,1676,0,0,0,0,1.0,1,1.0,1,1.0,1,0.5139934827607834,43
660,1,1677,1677,0,0,0,0,1.0,1,1.0,1,1.0,1,0.5399797193017339,43
661,4,1681,1681,0,0,0,0,1.0,1,1.0,1,1.0,1,0.5432839766218035,41
662,3,1684,1684,0,0,0,0,1.0,1,1.0,1,1.0,1,0.5405946986040426,40
663,3,1687,1687,0,0,0,0,1.0,1,1.0,1,1.0,1,0.5474938649404346,39
664,3,1690,1690,0,0,0,0,1.0,1,1.0,1,1.0,1,0.5350018199274653,36
665,3,1693,1693,0,0,0,0,1.0,1,1.0,1,1.0,1,0.5719496742681784,36
666,8,1701,1701,0,0,0,0,1.0,1,1.0,1,1.0,1,0.5691681083572746,36
667,2,1703,1703,0,0,0,0,1.0,1,1.0,1,1.0,1,0.576833347103687,35
668,6,1709,1709,0,0,0,0,1.0,1,1.0,1,1.0,1,0.6084902627215395,34
669,7,1716,1716,0,0,0,0,1.0,1,1.0,1,1.0,1,0.5441158739191119,34
670,5,1721,1721,0,0,0,0,1.0,1,1.0,1,1.0,1,0.6143017038029199,32
671,1,1722,1722,0,0,0,0,1.0,1,1.0,1,1.0,1,0.6079861717677141,33
672,1,1723,1723,0,0,0,0,1.0,1,1.0,1,1.0,1,0.619861902109613,32
673,3,1726,1726,0,0,0,0,1.0,1,1.0,1,1.0,1,0.6316699872027314,32
674,1,1727,1727,0,0,0,0,1.0,1,1.0,1,1.0,1,0.6617916594544789,32
675,3,1730,1730,0,0,0,0,1.0,1,1.0,1,1.0,1,0.638709045037934,34
676,1,1731,1731,0,0,0,0,1.0,1,1.0,1,1.0,1,0.5989728976647211,35
677,3,1734,1734,0,0,0,0,1.0,1,1.0,1,1.0,1,0.5716301418565295,35
678,5,1739,1739,0,0,0,0,1.0,1,1.0,1,1.0,1,0.5418315622366225,35
679,2,1741,1741,0,0,0,0,1.0,1,1.0,1,1.0,1,0.5604557567273054,36
680,1,1742,1742,0,0,0,0,1.0,1,1.0,1,1.0,1,0.5298145310478984,37
681,2,1744,1744,0,0,0,0,1.0,1,1.0,1,1.0,1,0.5025584302346582,37
682,2,1746,1746,0,0,0,0,1.0,1,1.0,1,1.0,1,0.4918032974470022,37
683,1,1747,1747,0,0,0,0,1.0,1,1.0,1,1.0,1,0.4538648349550544,38
684,4,1751,1751,0,0,0,0,1.0,1,1.0,1,1.0,1,0.49824122253214564,39
685,2,1753,1753,0,0,0,0,1.0,1,1.0,1,1.0,1,0.5093276555030396,38
686,3,1756,1756,0,0,0,0,1.0,1,1.0,1,1.0,1,0.5370808668830009,37
687,2,1758,1758,0,0,0,0,1.0,1,1.0,1,1.0,1,0.5704499301979834,38
688,2,1760,1760,0,0,0,0,1.0,1,1.0,1,1.0,1,0.6182855364168619,37
689,2,1762,1762,0,0,0,0,1.0,1,1.0,1,1.0,1,0.5923888971261273,39
690,4,1766,1766,0,0,0,0,1.0,1,1.0,1,1.0,1,0.6363854159065444,38
691,2,1768,1768,0,0,0,0,1.0,1,1.0,1,1.0,1,0.6346491639188575,38
692,3,1771,1771,0,0,0,0,1.0,1,1.0,1,1.0,1,0.6081037345949196,38
693,4,1775,1775,0,0,0,0,1.0,1,1.0,1,1.0,1,0.5599518369891788,40
694,8,1783,1783,0,0,0,0,1.0,1,1.0,1,1.0,1,0.5169860352427261,42
695,3,1786,1786,0,0,0,0,1.0,1,1.0,1,1.0,1,0.538316964974473,40
696,2,1788,1788,0,0,0,0,1.0,1,1.0,1,1.0,1,0.5279832971160425,39
697,4,1792,1792,0,0,0,0,1.0,1,1.0,1,1.0,1,0.5234286035226094,39
698,2,1794,1794,0,0,0,0,1.0,1,1.0,1,1.0,1,0.5077342695804178,37
699,2,1796,1796,0,0,0,0,1.0,1,1.0,1,1.0,1,0.4592571184265672,37
700,3,1799,1799,0,0,0,0,1.0,1,1.0,1,1.0,1,0.43915850685390284,37
701,3,1802,1802,0,0,0,0,1.0,1,1.0,1,1.0,1,0.4927193583850622,37
702,4,1806,1806,0,0,0,0,1.0,1,1.0,1,1.0,1,0.5073187577750853,38
703,3,1809,1809,0,0,0,0,1.0,1,1.0,1,1.0,1,0.5520433425687297,36
704,3,1812,1812,0,0,0,0,1.0,1,1.0,1,1.0,1,0.5976180204046658,36
705,4,1816,1816,0,0,0,0,1.0,1,1.0,1,1.0,1,0.49098738674213893,36
706,4,1820,1820,0,0,0,0,1.0,1,1.0,1,1.0,1,0.47599887253726136,35
707,1,1821,1821,0,0,0,0,1.0,1,1.0,1,1.0,1,0.44544559645506404,36
708,2,1823,1823,0,0,0,0,1.0,1,1.0,1,1.0,1,0.48220593894679353,36
709,3,1826,1826,0,0,0,0,1.0,1,1.0,1,1.0,1,0.4899387392353361,34
710,3,1829,1829,0,0,0,0,1.0,1,1.0,1,1.0,1,0.41799916866744835,34
711,2,1831,1831,0,0,0,0,1.0,1,1.0,1,1.0,1,0.42717944085591264,34
712,3,1834,1834,0,0,0,0,1.0,1,1.0,1,1.0,1,0.4468272770365057,35
713,5,1839,1839,0,0,0,0,1.0,1,1.0,1,1.0,1,0.5186236668561943,34
714,1,1840,1840,0,0,0,0,1.0,1,1.0,1,1.0,1,0.5106525898106997,34
715,3,1843,1843,0,0,0,0,1.0,1,1.0,1,1.0,1,0.4942902068307469,35
716,2,1845,1845,0,0,0,0,1.0,1,1.0,1,1.0,1,0.5285358199017122,33
717,1,1846,1846,0,0,0,0,1.0,1,1.0,1,1.0,1,0.5643550145536259,33
718,2,1848,1848,0,0,0,0,1.0,1,1.0,1,1.0,1,0.5794933981064055,32
719,1,1849,1849,0,0,0,0,1.0,1,1.0,1,1.0,1,0.6002451694528178,32
720,3,1852,1852,0,0,0,0,1.0,1,1.0,1,1.0,1,0.5689994682048073,33
721,0,1852,1852,0,0,0,0,1.0,1,1.0,1,1.0,1,0.5689994682048073,33
722,2,1854,1854,0,0,0,0,1.0,1,1.0,1,1.0,1,0.6038434497825038,34
723,3,1857,1857,0,0,0,0,1.0,1,1.0,1,1.0,1,0.61511066640289,34
724,1,1858,1858,0,0,0,0,1.0,1,1.0,1,1.0,1,0.6063351929890062,36
725,4,1862,1862,0,0,0,0,1.0,1,1.0,1,1.0,1,0.6402151598607404,36
726,2,1864,1864,0,0,0,0,1.0,1,1.0,1,1.0,1,0.6637966741648519,36
727,0,1864,1864,0,0,0,0,1.0,1,1.0,1,1.0,1,0.6637966741648519,36
728,0,1864,1864,0,0,0,0,1.0,1,1.0,1,1.0,1,0.6689111968384764,37
729,4,1868,1868,0,0,0,0,1.0,1,1.0,1,1.0,1,0.6442592805411222,37
730,1,1869,1869,0,0,0,0,1.0,1,1.0,1,1.0,1,0.6209011133885033,38
731,2,1871,1871,0,0,0,0,1.0,1,1.0,1,1.0,1,0.6499859642760095,39
732,2,1873,1873,0,0,0,0,1.0,1,1.0,1,1.0,1,0.66282511163941,41
733,0,1873,1873,0,0,0,0,1.0,1,1.0,1,1.0,1,0.648516235846532,39
734,0,1873,1873,0,0,0,0,1.0,1,1.0,1,1.0,1,0.6402267629473097,39
735,2,1875,1875,0,0,0,0,1.0,1,1.0,1,1.0,1,0.622740813364771,39
736,0,1875,1875,0,0,0,0,1.0,1,1.0,1,1.0,1,0.5871881196358744,38
737,0,1875,1875,0,0,0,0,1.0,1,1.0,1,1.0,1,0.5828833735495383,39
738,2,1877,1877,0,0,0,0,1.0,1,1.0,1,1.0,1,0.5811310254349631,37
739,4,1881,1881,0,0,0,0,1.0,1,1.0,1,1.0,1,0.5824161943328982,37
740,2,1883,1883,0,0,0,0,1.0,1,1.0,1,1.0,1,0.5721931612134109,35
741,6,1889,1889,0,0,0,0,1.0,1,1.0,1,1.0,1,0.6010222477306879,33
742,6,1895,1895,0,0,0,0,1.0,1,1.0,1,1.0,1,0.6097416765260496,35
743,5,1900,1900,0,0,0,0,1.0,1,1.0,1,1.0,1,0.6290518802264733,35
744,6,1906,1906,0,0,0,0,1.0,1,1.0,1,1.0,1,0.6484400447880782,34
745,2,1908,1908,0,0,0,0,1.0,1,1.0,1,1.0,1,0.6750059317119156,34
746,4,1912,1912,0,0,0,0,1.0,1,1.0,1,1.0,1,0.6243276906978104,33
747,3,1915,1915,0,0,0,0,1.0,1,1.0,1,1.0,1,0.638053796369656,32
748,4,1919,1919,0,0,0,0,1.0,1,1.0,1,1.0,1,0.597336920088382,33
749,2,1921,1921,0,0,0,0,1.0,1,1.0,1,1.0,1,0.5569174285097528,33
750,4,1925,1925,0,0,0,0,1.0,1,1.0,1,1.0,1,0.5956013217976985,34
751,2,1927,1927,0,0,0,0,1.0,1,1.0,1,1.0,1,0.53468699026829,36
752,4,1931,1931,0,0,0,0,1.0,1,1.0,1,1.0,1,0.5750755258847047,35
753,1,1932,1932,0,0,0,0,1.0,1,1.0,1,1.0,1,0.5909033665725854,37
754,1,1933,1933,0,0,0,0,1.0,1,1.0,1,1.0,1,0.6078631307421195,37
755,3,1936,1936,0,0,0,0,1.0,1,1.0,1,1.0,1,0.5939244415679122,35
756,0,1936,1936,0,0,0,0,1.0,1,1.0,1,1.0,1,0.6003046364518797,36
757,1,1937,1937,0,0,0,0,1.0,1,1.0,1,1.0,1,0.6183246595491232,35
758,0,1937,1937,0,0,0,0,1.0,1,1.0,1,1.0,1,0.6124944118409427,36
759,0,1937,1937,0,0,0,0,1.0,1,1.0,1,1.0,1,0.6034344554756218,37
760,0,1937,1937,0,0,0,0,1.0,1,1.0,1,1.0,1,0.6245805782164086,36
761,0,1937,1937,0,0,0,0,1.0,1,1.0,1,1.0,1,0.6245805782164086,36
762,0,1937,1937,0,0,0,0,1.0,1,1.0,1,1.0,1,0.6138443027659956,37
763,2,1939,1939,0,0,0,0,1.0,1,1.0,1,1.0,1,0.6588624531083778,38
764,0,1939,1939,0,0,0,0,1.0,1,1.0,1,1.0,1,0.6588624531083778,38
765,1,1940,1940,0,0,0,0,1.0,1,1.0,1,1.0,1,0.6645280334112648,38
766,3,1943,1943,0,0,0,0,1.0,1,1.0,1,1.0,1,0.656869770743972,40
767,0,1943,1943,0,0,0,0,1.0,1,1.0,1,1.0,1,0.6457099794931094,41
768,2,1945,1945,0,0,0,0,1.0,1,1.0,1,1.0,1,0.668555872055206,41
769,0,1945,1945,0,0,0,0,1.0,1,1.0,1,1.0,1,0.6724882291988429,42
770,0,1945,1945,0,0,0,0,1.0,1,1.0,1,1.0,1,0.6509251716207933,41
771,3,1948,1948,0,0,0,0,1.0,1,1.0,1,1.0,1,0.6698712869913707,41
772,1,1949,1949,0,0,0,0,1.0,1,1.0,1,1.0,1,0.6560807254725304,41
773,1,1950,1950,0,0,0,0,1.0,1,1.0,1,1.0,1,0.6154262973776882,41
774,0,1950,1950,0,0,0,0,1.0,1,1.0,1,1.0,1,0.6165976995619259,42
775,3,1953,1953,0,0,0,0,1.0,1,1.0,1,1.0,1,0.6072775195952023,42
776,1,1954,1954,0,0,0,0,1.0,1,1.0,1,1.0,1,0.6209147350852706,42
777,2,1956,1956,0,0,0,0,1.0,1,1.0,1,1.0,1,0.6281487047437571,42
778,2,1958,1958,0,0,0,0,1.0,1,1.0,1,1.0,1,0.6431055021452132,44
779,3,1961,1961,0,0,0,0,1.0,1,1.0,1,1.0,1,0.6635854633178458,44
780,2,1963,1963,0,0,0,0,1.0,1,1.0,1,1.0,1,0.6637598098357839,44
781,0,1963,1963,0,0,0,0,1.0,1,1.0,1,1.0,1,0.6534255367226939,46
782,2,1965,1965,0,0,0,0,1.0,1,1.0,1,1.0,1,0.6765175363549745,45
783,1,1966,1966,0,0,0,0,1.0,1,1.0,1,1.0,1,0.6561688926907034,44
784,1,1967,1967,0,0,0,0,1.0,1,1.0,1,1.0,1,0.6484427594432319,44
785,2,1969,1969,0,0,0,0,1.0,1,1.0,1,1.0,1,0.6511176119395671,43
786,3,1972,1972,0,0,0,0,1.0,1,1.0,1,1.0,1,0.6365155744500706,43
787,2,1974,1974,0,0,0,0,1.0,1,1.0,1,1.0,1,0.6410259852385211,43
788,4,1978,1978,0,0,0,0,1.0,1,1.0,1,1.0,1,0.6304047253005688,45
789,3,1981,1981,0,0,0,0,1.0,1,1.0,1,1.0,1,0.6230940152178512,46
790,3,1984,1984,0,0,0,0,1.0,1,1.0,1,1.0,1,0.6252699636219375,45
791,3,1987,1987,0,0,0,0,1.0,1,1.0,1,1.0,1,0.6122428026897442,46
792,2,1989,1989,0,0,0,0,1.0,1,1.0,1,1.0,1,0.610518916830178,46
793,6,1995,1995,0,0,0,0,1.0,1,1.0,1,1.0,1,0.6237577243156963,46
794,3,1998,1998,0,0,0,0,1.0,1,1.0,1,1.0,1,0.641354356598121,47
795,6,2004,2004,0,0,0,0,1.0,1,1.0,1,1.0,1,0.6636275259324013,47
796,5,2009,2009,0,0,0,0,1.0,1,1.0,1,1.0,1,0.6491370358171781,46
797,5,2014,2014,0,0,0,0,1.0,1,1.0,1,1.0,1,0.7233209436722007,47
798,6,2020,2020,0,0,0,0,1.0,1,1.0,1,1.0,1,0.6537375138702993,48
799,3,2023,2023,0,0,0,0,1.0,1,1.0,1,1.0,1,0.6656581814458772,48
800,4,2027,2027,0,0,0,0,1.0,1,1.0,1,1.0,1,0.649492999582944,48
801,4,2031,2031,0,0,0,0,1.0,1,1.0,1,1.0,1,0.6040191869715913,49
802,1,2032,2032,0,0,0,0,1.0,1,1.0,1,1.0,1,0.6053794970642186,50
803,1,2033,2033,0,0,0,0,1.0,1,1.0,1,1.0,1,0.6134305156589407,49
804,1,2034,2034,0,0,0,0,1.0,1,1.0,1,1.0,1,0.5919981214491733,50
805,0,2034,2034,0,0,0,0,1.0,1,1.0,1,1.0,1,0.5919981214491733,50
806,3,2037,2037,0,0,0,0,1.0,1,1.0,1,1.0,1,0.6100532541935199,50
807,2,2039,2039,0,0,0,0,1.0,1,1.0,1,1.0,1,0.6172463497001864,51
808,1,2040,2040,0,0,0,0,1.0,1,1.0,1,1.0,1,0.6302855579353082,51
809,3,2043,2043,0,0,0,0,1.0,1,1.0,1,1.0,1,0.6166065875873326,51
810,2,2045,2045,0,0,0,0,1.0,1,1.0,1,1.0,1,0.6164437385153475,52
811,2,2047,2047,0,0,0,0,1.0,1,1.0,1,1.0,1,0.5953225729076986,50
812,3,2050,2050,0,0,0,0,1.0,1,1.0,1,1.0,1,0.5691870357861593,48
813,2,2052,2052,0,0,0,0,1.0,1,1.0,1,1.0,1,0.5760050034252255,49
814,3,2055,2055,0,0,0,0,1.0,1,1.0,1,1.0,1,0.5466423283266065,48
815,2,2057,2057,0,0,0,0,1.0,1,1.0,1,1.0,1,0.5387352333023506,48
816,3,2060,2060,0,0,0,0,1.0,1,1.0,1,1.0,1,0.5162858116126853,46
817,1,2061,2061,0,0,0,0,1.0,1,1.0,1,1.0,1,0.5162193933171593,44
818,5,2066,2066,0,0,0,0,1.0,1,1.0,1,1.0,1,0.5059953748582459,46
819,2,2068,2068,0,0,0,0,1.0,1,1.0,1,1.0,1,0.4958053877064377,44
820,4,2072,2072,0,0,0,0,1.0,1,1.0,1,1.0,1,0.5105888329478345,44
821,1,2073,2073,0,0,0,0,1.0,1,1.0,1,1.0,1,0.49524599814824877,44
822,6,2079,2079,0,0,0,0,1.0,1,1.0,1,1.0,1,0.5194299083906665,44
823,3,2082,2082,0,0,0,0,1.0,1,1.0,1,1.0,1,0.5218793585939927,42
824,7,2089,2089,0,0,0,0,1.0,1,1.0,1,1.0,1,0.5128103116694654,42
825,6,2095,2095,0,0,0,0,1.0,1,1.0,1,1.0,1,0.5996251571945765,40
826,7,2102,2102,0,0,0,0,1.0,1,1.0,1,1.0,1,0.5203010328018078,41
827,3,2105,2105,0,0,0,0,1.0,1,1.0,1,1.0,1,0.5160676774384637,40
828,2,2107,2107,0,0,0,0,1.0,1,1.0,1,1.0,1,0.5219981925171298,40
829,1,2108,2108,0,0,0,0,1.0,1,1.0,1,1.0,1,0.5309225956961438,42
830,1,2109,2109,0,0,0,0,1.0,1,1.0,1,1.0,1,0.5321853753561973,42
831,4,2113,2113,0,0,0,0,1.0,1,1.0,1,1.0,1,0.493247541301341,43
832,1,2114,2114,0,0,0,0,1.0,1,1.0,1,1.0,1,0.5034409615982263,42
833,5,2119,2119,0,0,0,0,1.0,1,1.0,1,1.0,1,0.5018078688914566,41
834,1,2120,2120,0,0,0,0,1.0,1,1.0,1,1.0,1,0.5058606647815604,41
835,2,2122,2122,0,0,0,0,1.0,1,1.0,1,1.0,1,0.49658851178647306,41
836,1,2123,2123,0,0,0,0,1.0,1,1.0,1,1.0,1,0.4908741681760402,40
837,3,2126,2126,0,0,0,0,1.0,1,1.0,1,1.0,1,0.4801342553325711,41
838,0,2126,2126,0,0,0,0,1.0,1,1.0,1,1.0,1,0.4801342553325711,41
839,1,2127,2127,0,0,0,0,1.0,1,1.0,1,1.0,1,0.46281828445008705,41
840,6,2133,2133,0,0,0,0,1.0,1,1.0,1,1.0,1,0.5126404465367964,42
841,2,2135,2135,0,0,0,0,1.0,1,1.0,1,1.0,1,0.4961176531785914,42
842,7,2142,2142,0,0,0,0,1.0,1,1.0,1,1.0,1,0.4930968066377137,42
843,5,2147,2147,0,0,0,0,1.0,1,1.0,1,1.0,1,0.4719869607132248,42
844,2,2149,2149,0,0,0,0,1.0,1,1.0,1,1.0,1,0.5017510417950578,42
845,2,2151,2151,0,0,0,0,1.0,1,1.0,1,1.0,1,0.5057326921196822,44
846,0,2151,2151,0,0,0,0,1.0,1,1.0,1,1.0,1,0.5057326921196822,44
847,5,2156,2156,0,0,0,0,1.0,1,1.0,1,1.0,1,0.5073622295065131,42
848,1,2157,2157,0,0,0,0,1.0,1,1.0,1,1.0,1,0.5087539101026857,43
849,1,2158,2158,0,0,0,0,1.0,1,1.0,1,1.0,1,0.5196687328445282,43
850,0,2158,2158,0,0,0,0,1.0,1,1.0,1,1.0,1,0.5293266136327479,41
851,1,2159,2159,0,0,0,0,1.0,1,1.0,1,1.0,1,0.5581584133237918,40
852,1,2160,2160,0,0,0,0,1.0,1,1.0,1,1.0,1,0.5320070012553796,40
853,1,2161,2161,0,0,0,0,1.0,1,1.0,1,1.0,1,0.5054265426889977,40
854,3,2164,2164,0,0,0,0,1.0,1,1.0,1,1.0,1,0.5625850101633373,40
855,2,2166,2166,0,0,0,0,1.0,1,1.0,1,1.0,1,0.5540984234090279,41
856,1,2167,2167,0,0,0,0,1.0,1,1.0,1,1.0,1,0.5671095568137561,41
857,1,2168,2168,0,0,0,0,1.0,1,1.0,1,1.0,1,0.5613909414563101,42
858,4,2172,2172,0,0,0,0,1.0,1,1.0,1,1.0,1,0.5803364319301746,43
859,4,2176,2176,0,0,0,0,1.0,1,1.0,1,1.0,1,0.5546723546862493,43
860,3,2179,2179,0,0,0,0,1.0,1,1.0,1,1.0,1,0.5662924190148793,44
861,3,2182,2182,0,0,0,0,1.0,1,1.0,1,1.0,1,0.546752442004615,44
862,6,2188,2188,0,0,0,0,1.0,1,1.0,1,1.0,1,0.5084341052742838,44
863,1,2189,2189,0,0,0,0,1.0,1,1.0,1,1.0,1,0.5244395406789034,44
864,4,2193,2193,0,0,0,0,1.0,1,1.0,1,1.0,1,0.588061924110363,44
865,3,2196,2196,0,0,0,0,1.0,1,1.0,1,1.0,1,0.5825838919043214,43
866,6,2202,2202,0,0,0,0,1.0,1,1.0,1,1.0,1,0.60958913242629,45
867,5,2207,2207,0,0,0,0,1.0,1,1.0,1,1.0,1,0.5246077137094628,44
868,5,2212,2212,0,0,0,0,1.0,1,1.0,1,1.0,1,0.5776118355432023,45
869,2,2214,2214,0,0,0,0,1.0,1,1.0,1,1.0,1,0.5351453250450491,44
870,5,2219,2219,0,0,0,0,1.0,1,1.0,1,1.0,1,0.5479881932717083,44
871,2,2221,2221,0,0,0,0,1.0,1,1.0,1,1.0,1,0.5568007533524344,43
872,3,2224,2224,0,0,0,0,1.0,1,1.0,1,1.0,1,0.565649049176418,43
873,6,2230,2230,0,0,0,0,1.0,1,1.0,1,1.0,1,0.561647372468209,43
874,3,2233,2233,0,0,0,0,1.0,1,1.0,1,1.0,1,0.5879272531959849,46
875,7,2240,2240,0,0,0,0,1.0,1,1.0,1,1.0,1,0.5885819619610241,43
876,2,2242,2242,0,0,0,0,1.0,1,1.0,1,1.0,1,0.6145020095988214,44
877,2,2244,2244,0,0,0,0,1.0,1,1.0,1,1.0,1,0.6249510295000252,44
878,2,2246,2246,0,0,0,0,1.0,1,1.0,1,1.0,1,0.6283045002303365,44
879,4,2250,2250,0,0,0,0,1.0,1,1.0,1,1.0,1,0.6136489747873952,44
880,0,2250,2250,0,0,0,0,1.0,1,1.0,1,1.0,1,0.6136489747873952,44
881,4,2254,2254,0,0,0,0,1.0,1,1.0,1,1.0,1,0.5994511448411141,43
882,0,2254,2254,0,0,0,0,1.0,1,1.0,1,1.0,1,0.5727720305841232,45
883,1,2255,2255,0,0,0,0,1.0,1,1.0,1,1.0,1,0.594108990296492,45
884,3,2258,2258,0,0,0,0,1.0,1,1.0,1,1.0,1,0.5976805852117673,45
885,2,2260,2260,0,0,0,0,1.0,1,1.0,1,1.0,1,0.5980366652318619,43
886,4,2264,2264,0,0,0,0,1.0,1,1.0,1,1.0,1,0.5656928977502328,43
887,2,2266,2266,0,0,0,0,1.0,1,1.0,1,1.0,1,0.5765105173496267,41
888,4,2270,2270,0,0,0,0,1.0,1,1.0,1,1.0,1,0.5732144020313629,40
889,2,2272,2272,0,0,0,0,1.0,1,1.0,1,1.0,1,0.6122998667875116,40
890,4,2276,2276,0,0,0,0,1.0,1,1.0,1,1.0,1,0.61181818955288,38
891,3,2279,2279,0,0,0,0,1.0,1,1.0,1,1.0,1,0.5235376341192934,39
892,5,2284,2284,0,0,0,0,1.0,1,1.0,1,1.0,1,0.533322128079504,39
893,5,2289,2289,0,0,0,0,1.0,1,1.0,1,1.0,1,0.5225045642928862,37
894,5,2294,2294,0,0,0,0,1.0,1,1.0,1,1.0,1,0.5586593447908627,36
895,3,2297,2297,0,0,0,0,1.0,1,1.0,1,1.0,1,0.542640712296909,37
896,2,2299,2299,0,0,0,0,1.0,1,1.0,1,1.0,1,0.5465834938763936,36
897,1,2300,2300,0,0,0,0,1.0,1,1.0,1,1.0,1,0.5390518068182668,36
898,2,2302,2302,0,0,0,0,1.0,1,1.0,1,1.0,1,0.5619984191569273,35
899,5,2307,2307,0,0,0,0,1.0,1,1.0,1,1.0,1,0.5538007164769497,35
900,3,2310,2310,0,0,0,0,1.0,1,1.0,1,1.0,1,0.5822680556445945,36
901,2,2312,2312,0,0,0,0,1.0,1,1.0,1,1.0,1,0.6193600386683815,36
902,5,2317,2317,0,0,0,0,1.0,1,1.0,1,1.0,1,0.5604512331975714,36
903,2,2319,2319,0,0,0,0,1.0,1,1.0,1,1.0,1,0.5651630273670835,35
904,8,2327,2327,0,0,0,0,1.0,1,1.0,1,1.0,1,0.5011590769676147,37
905,2,2329,2329,0,0,0,0,1.0,1,1.0,1,1.0,1,0.5259590602412779,36
906,5,2334,2334,0,0,0,0,1.0,1,1.0,1,1.0,1,0.5049530254384703,37
907,4,2338,2338,0,0,0,0,1.0,1,1.0,1,1.0,1,0.471462616162672,37
908,2,2340,2340,0,0,0,0,1.0,1,1.0,1,1.0,1,0.5134337864692966,36
909,4,2344,2344,0,0,0,0,1.0,1,1.0,1,1.0,1,0.5433751293460645,36
910,4,2348,2348,0,0,0,0,1.0,1,1.0,1,1.0,1,0.5603151228311385,37
911,0,2348,2348,0,0,0,0,1.0,1,1.0,1,1.0,1,0.5953350830151933,36
912,1,2349,2349,0,0,0,0,1.0,1,1.0,1,1.0,1,0.6173825876160252,34
913,2,2351,2351,0,0,0,0,1.0,1,1.0,1,1.0,1,0.6449325571040233,34
914,3,2354,2354,0,0,0,0,1.0,1,1.0,1,1.0,1,0.6710681455000292,33
915,2,2356,2356,0,0,0,0,1.0,1,1.0,1,1.0,1,0.6499851112361889,33
916,1,2357,2357,0,0,0,0,1.0,1,1.0,1,1.0,1,0.6403377006651934,34
917,1,2358,2358,0,0,0,0,1.0,1,1.0,1,1.0,1,0.6454614400193084,34
918,4,2362,2362,0,0,0,0,1.0,1,1.0,1,1.0,1,0.6149834327820792,36
919,2,2364,2364,0,0,0,0,1.0,1,1.0,1,1.0,1,0.6099393291640482,36
920,2,2366,2366,0,0,0,0,1.0,1,1.0,1,1.0,1,0.5804543853459277,37
921,0,2366,2366,0,0,0,0,1.0,1,1.0,1,1.0,1,0.5804543853459277,37
922,2,2368,2368,0,0,0,0,1.0,1,1.0,1,1.0,1,0.567653730351214,38
923,1,2369,2369,0,0,0,0,1.0,1,1.0,1,1.0,1,0.5469699728555157,36
924,4,2373,2373,0,0,0,0,1.0,1,1.0,1,1.0,1,0.5004356766313458,35
925,1,2374,2374,0,0,0,0,1.0,1,1.0,1,1.0,1,0.5080789560559871,35
926,2,2376,2376,0,0,0,0,1.0,1,1.0,1,1.0,1,0.5108198755041558,34
927,0,2376,2376,0,0,0,0,1.0,1,1.0,1,1.0,1,0.5150520468666964,32
928,6,2382,2382,0,0,0,0,1.0,1,1.0,1,1.0,1,0.47986713934398384,32
929,0,2382,2382,0,0,0,0,1.0,1,1.0,1,1.0,1,0.47285361849922547,31
930,3,2385,2385,0,0,0,0,1.0,1,1.0,1,1.0,1,0.5316727778019489,30
931,0,2385,2385,0,0,0,0,1.0,1,1.0,1,1.0,1,0.5267977904146578,29
932,3,2388,2388,0,0,0,0,1.0,1,1.0,1,1.0,1,0.5256647079730842,29
933,7,2395,2395,0,0,0,0,1.0,1,1.0,1,1.0,1,0.6015924021472244,29
934,0,2395,2395,0,0,0,0,1.0,1,1.0,1,1.0,1,0.6015924021472244,29
935,4,2399,2399,0,0,0,0,1.0,1,1.0,1,1.0,1,0.634433502464166,31
936,0,2399,2399,0,0,0,0,1.0,1,1.0,1,1.0,1,0.634433502464166,31
937,3,2402,2402,0,0,0,0,1.0,1,1.0,1,1.0,1,0.5989909795070391,34
938,2,2404,2404,0,0,0,0,1.0,1,1.0,1,1.0,1,0.6396664441842441,33
939,5,2409,2409,0,0,0,0,1.0,1,1.0,1,1.0,1,0.647859331232571,36
940,3,2412,2412,0,0,0,0,1.0,1,1.0,1,1.0,1,0.6506266138948857,36
941,2,2414,2414,0,0,0,0,1.0,1,1.0,1,1.0,1,0.6476220623264987,36
942,1,2415,2415,0,0,0,0,1.0,1,1.0,1,1.0,1,0.6581160330309039,36
943,3,2418,2418,0,0,0,0,1.0,1,1.0,1,1.0,1,0.6784006078783659,35
944,1,2419,2419,0,0,0,0,1.0,1,1.0,1,1.0,1,0.6618059689851571,35
945,2,2421,2421,0,0,0,0,1.0,1,1.0,1,1.0,1,0.6832871162853053,33
946,1,2422,2422,0,0,0,0,1.0,1,1.0,1,1.0,1,0.671192504560221,36
947,0,2422,2422,0,0,0,0,1.0,1,1.0,1,1.0,1,0.6714427666188544,34
948,1,2423,2423,0,0,0,0,1.0,1,1.0,1,1.0,1,0.6793580591137088,33
949,1,2424,2424,0,0,0,0,1.0,1,1.0,1,1.0,1,0.7074059982950686,34
950,1,2425,2425,0,0,0,0,1.0,1,1.0,1,1.0,1,0.7046272565198021,33
951,0,2425,2425,0,0,0,0,1.0,1,1.0,1,1.0,1,0.7046272565198021,33
952,1,2426,2426,0,0,0,0,1.0,1,1.0,1,1.0,1,0.6989134631619783,32
953,0,2426,2426,0,0,0,0,1.0,1,1.0,1,1.0,1,0.6989134631619783,32
954,0,2426,2426,0,0,0,0,1.0,1,1.0,1,1.0,1,0.7031186099308149,31
955,1,2427,2427,0,0,0,0,1.0,1,1.0,1,1.0,1,0.6978623772779426,32
956,1,2428,2428,0,0,0,0,1.0,1,1.0,1,1.0,1,0.7188531156103892,32
957,3,2431,2431,0,0,0,0,1.0,1,1.0,1,1.0,1,0.6971159066382818,33
958,0,2431,2431,0,0,0,0,1.0,1,1.0,1,1.0,1,0.6843432434075851,35
959,3,2434,2434,0,0,0,0,1.0,1,1.0,1,1.0,1,0.7045040042273478,36
960,0,2434,2434,0,0,0,0,1.0,1,1.0,1,1.0,1,0.7079399639650276,38
961,1,2435,2435,0,0,0,0,1.0,1,1.0,1,1.0,1,0.679673885953987,37
962,2,2437,2437,0,0,0,0,1.0,1,1.0,1,1.0,1,0.6706505173635758,35
963,4,2441,2441,0,0,0,0,1.0,1,1.0,1,1.0,1,0.6362998667090708,35
964,1,2442,2442,0,0,0,0,1.0,1,1.0,1,1.0,1,0.62866636408969,34
965,5,2447,2447,0,0,0,0,1.0,1,1.0,1,1.0,1,0.6134292454393551,35
966,3,2450,2450,0,0,0,0,1.0,1,1.0,1,1.0,1,0.565518961237878,34
967,6,2456,2456,0,0,0,0,1.0,1,1.0,1,1.0,1,0.5099245296093613,35
968,2,2458,2458,0,0,0,0,1.0,1,1.0,1,1.0,1,0.4846422480390721,36
969,5,2463,2463,0,0,0,0,1.0,1,1.0,1,1.0,1,0.4849534652021153,35
970,1,2464,2464,0,0,0,0,1.0,1,1.0,1,1.0,1,0.465501125923035,34
971,0,2464,2464,0,0,0,0,1.0,1,1.0,1,1.0,1,0.4749065746093208,35
972,3,2467,2467,0,0,0,0,1.0,1,1.0,1,1.0,1,0.48158567064703506,35
973,1,2468,2468,0,0,0,0,1.0,1,1.0,1,1.0,1,0.4953035150513071,36
974,4,2472,2472,0,0,0,0,1.0,1,1.0,1,1.0,1,0.5284227650534128,35
975,1,2473,2473,0,0,0,0,1.0,1,1.0,1,1.0,1,0.5034973930202431,36
976,3,2476,2476,0,0,0,0,1.0,1,1.0,1,1.0,1,0.50132763327232,38
977,1,2477,2477,0,0,0,0,1.0,1,1.0,1,1.0,1,0.5116728771531823,38
978,2,2479,2479,0,0,0,0,1.0,1,1.0,1,1.0,1,0.5160947298270276,38
979,2,2481,2481,0,0,0,0,1.0,1,1.0,1,1.0,1,0.5358567421948572,39
980,6,2487,2487,0,0,0,0,1.0,1,1.0,1,1.0,1,0.6009767928379853,39
981,1,2488,2488,0,0,0,0,1.0,1,1.0,1,1.0,1,0.6243092060151786,40
982,4,2492,2492,0,0,0,0,1.0,1,1.0,1,1.0,1,0.6768998061467829,40
983,2,2494,2494,0,0,0,0,1.0,1,1.0,1,1.0,1,0.6645413905701206,38
984,2,2496,2496,0,0,0,0,1.0,1,1.0,1,1.0,1,0.6659444995135713,39
985,2,2498,2498,0,0,0,0,1.0,1,1.0,1,1.0,1,0.6720767714477353,38
986,0,2498,2498,0,0,0,0,1.0,1,1.0,1,1.0,1,0.6720767714477353,38
987,1,2499,2499,0,0,0,0,1.0,1,1.0,1,1.0,1,0.6933121087194773,38
988,1,2500,2500,0,0,0,0,1.0,1,1.0,1,1.0,1,0.7154023424583965,38
989,0,2500,2500,0,0,0,0,1.0,1,1.0,1,1.0,1,0.7199681440260826,38
990,0,2500,2500,0,0,0,0,1.0,1,1.0,1,1.0,1,0.7199681440260826,38
991,1,2501,2501,0,0,0,0,1.0,1,1.0,1,1.0,1,0.7026592510734899,40
992,1,2502,2502,0,0,0,0,1.0,1,1.0,1,1.0,1,0.6995021912763308,39
993,1,2503,2503,0,0,0,0,1.0,1,1.0,1,1.0,1,0.7054418908885591,38
994,1,2504,2504,0,0,0,0,1.0,1,1.0,1,1.0,1,0.7165913133892152,39
995,2,2506,2506,0,0,0,0,1.0,1,1.0,1,1.0,1,0.7110698772568456,41
996,0,2506,2506,0,0,0,0,1.0,1,1.0,1,1.0,1,0.7074774545331626,40
997,0,2506,2506,0,0,0,0,1.0,1,1.0,1,1.0,1,0.712981122470514,41
998,0,2506,2506,0,0,0,0,1.0,1,1.0,1,1.0,1,0.7207289303379946,40
999,0,2506,2506,0,0,0,0,1.0,1,1.0,1,1.0,1,0.7142779793415497,40
1000,0,2506,2506,0,0,0,0,1.0,1,1.0,1,1.0,1,0.7142779793415497,40
1001,0,2506,2506,0,0,0,0,1.0,1,1.0,1,1.0,1,0.6967675497079224,39
1002,0,2506,2506,0,0,0,0,1.0,1,1.0,1,1.0,1,0.6967675497079224,39
1003,2,2508,2508,0,0,0,0,1.0,1,1.0,1,1.0,1,0.6793378646888202,39
1004,0,2508,2508,0,0,0,0,1.0,1,1.0,1,1.0,1,0.6793378646888202,39
1005,2,2510,2510,0,0,0,0,1.0,1,1.0,1,1.0,1,0.6720184687957854,40
1006,1,2511,2511,0,0,0,0,1.0,1,1.0,1,1.0,1,0.653084773936467,41
1007,2,2513,2513,0,0,0,0,1.0,1,1.0,1,1.0,1,0.6636769714629158,42
1008,3,2516,2516,0,0,0,0,1.0,1,1.0,1,1.0,1,0.649198640838373,43
1009,2,2518,2518,0,0,0,0,1.0,1,1.0,1,1.0,1,0.6588515114367757,44
1010,2,2520,2520,0,0,0,0,1.0,1,1.0,1,1.0,1,0.6651736803687555,44
1011,2,2522,2522,0,0,0,0,1.0,1,1.0,1,1.0,1,0.6798417761979687,44
1012,4,2526,2526,0,0,0,0,1.0,1,1.0,1,1.0,1,0.6513983776295424,46
1013,1,2527,2527,0,0,0,0,1.0,1,1.0,1,1.0,1,0.6558663749830063,46
1014,1,2528,2528,0,0,0,0,1.0,1,1.0,1,1.0,1,0.6608661764716055,46
1015,1,2529,2529,0,0,0,0,1.0,1,1.0,1,1.0,1,0.6641317072522047,46
1016,4,2533,2533,0,0,0,0,1.0,1,1.0,1,1.0,1,0.6593814725724116,47
1017,1,2534,2534,0,0,0,0,1.0,1,1.0,1,1.0,1,0.6529918639240002,47
1018,4,2538,2538,0,0,0,0,1.0,1,1.0,1,1.0,1,0.6256248632344339,48
1019,5,2543,2543,0,0,0,0,1.0,1,1.0,1,1.0,1,0.6136777769936897,49
1020,2,2545,2545,0,0,0,0,1.0,1,1.0,1,1.0,1,0.5950021453092533,51
1021,3,2548,2548,0,0,0,0,1.0,1,1.0,1,1.0,1,0.5809058502795269,51
1022,1,2549,2549,0,0,0,0,1.0,1,1.0,1,1.0,1,0.5677728330880905,52
1023,2,2551,2551,0,0,0,0,1.0,1,1.0,1,1.0,1,0.5893795552942888,52
1024,2,2553,2553,0,0,0,0,1.0,1,1.0,1,1.0,1,0.5954133313518604,52
1025,4,2557,2557,0,0,0,0,1.0,1,1.0,1,1.0,1,0.5895411336325493,54
1026,2,2559,2559,0,0,0,0,1.0,1,1.0,1,1.0,1,0.6039314607851388,54
1027,4,2563,2563,0,0,0,0,1.0,1,1.0,1,1.0,1,0.5983706786130648,55
1028,2,2565,2565,0,0,0,0,1.0,1,1.0,1,1.0,1,0.6017463958152272,56
1029,2,2567,2567,0,0,0,0,1.0,1,1.0,1,1.0,1,0.59593264570433,56
1030,5,2572,2572,0,0,0,0,1.0,1,1.0,1,1.0,1,0.6472610032920783,57
1031,1,2573,2573,0,0,0,0,1.0,1,1.0,1,1.0,1,0.6264782080467303,58
1032,7,2580,2580,0,0,0,0,1.0,1,1.0,1,1.0,1,0.659371168725403,58
1033,3,2583,2583,0,0,0,0,1.0,1,1.0,1,1.0,1,0.6847332618077396,57
1034,2,2585,2585,0,0,0,0,1.0,1,1.0,1,1.0,1,0.6968889300387097,57
1035,5,2590,2590,0,0,0,0,1.0,1,1.0,1,1.0,1,0.6727156159315126,57
1036,2,2592,2592,0,0,0,0,1.0,1,1.0,1,1.0,1,0.6674214684227864,59
1037,7,2599,2599,0,0,0,0,1.0,1,1.0,1,1.0,1,0.681954803774015,57
1038,3,2602,2602,0,0,0,0,1.0,1,1.0,1,1.0,1,0.6803599076582301,59
1039,2,2604,2604,0,0,0,0,1.0,1,1.0,1,1.0,1,0.671264188614308,57
1040,4,2608,2608,0,0,0,0,1.0,1,1.0,1,1.0,1,0.6657051905313603,56
1041,4,2612,2612,0,0,0,0,1.0,1,1.0,1,1.0,1,0.6576097380396647,54
1042,6,2618,2618,0,0,0,0,1.0,1,1.0,1,1.0,1,0.6705621996078827,52
1043,4,2622,2622,0,0,0,0,1.0,1,1.0,1,1.0,1,0.6765140216734971,52
1044,2,2624,2624,0,0,0,0,1.0,1,1.0,1,1.0,1,0.6514643946594342,50
1045,7,2631,2631,0,0,0,0,1.0,1,1.0,1,1.0,1,0.6452828092862404,51
1046,3,2634,2634,0,0,0,0,1.0,1,1.0,1,1.0,1,0.6312756805773686,50
1047,4,2638,2638,0,0,0,0,1.0,1,1.0,1,1.0,1,0.5993847019855512,50
1048,1,2639,2639,0,0,0,0,1.0,1,1.0,1,1.0,1,0.5887763908930213,50
1049,1,2640,2640,0,0,0,0,1.0,1,1.0,1,1.0,1,0.5710298388149602,50
1050,2,2642,2642,0,0,0,0,1.0,1,1.0,1,1.0,1,0.5447973411087325,50
1051,1,2643,2643,0,0,0,0,1.0,1,1.0,1,1.0,1,0.5278556658787689,50
1052,2,2645,2645,0,0,0,0,1.0,1,1.0,1,1.0,1,0.5319107665595338,51
1053,0,2645,2645,0,0,0,0,1.0,1,1.0,1,1.0,1,0.5319107665595338,51
1054,1,2646,2646,0,0,0,0,1.0,1,1.0,1,1.0,1,0.5279610152708007,53
1055,2,2648,2648,0,0,0,0,1.0,1,1.0,1,1.0,1,0.5269300321145605,54
1056,1,2649,2649,0,0,0,0,1.0,1,1.0,1,1.0,1,0.5265809923422179,54
1057,4,2653,2653,0,0,0,0,1.0,1,1.0,1,1.0,1,0.5563252198293174,55
1058,2,2655,2655,0,0,0,0,1.0,1,1.0,1,1.0,1,0.577918503687118,54
1059,6,2661,2661,0,0,0,0,1.0,1,1.0,1,1.0,1,0.5860156444621142,53
1060,3,2664,2664,0,0,0,0,1.0,1,1.0,1,1.0,1,0.5940777092388272,53
1061,3,2667,2667,0,0,0,0,1.0,1,1.0,1,1.0,1,0.5903265841359606,53
1062,3,2670,2670,0,0,0,0,1.0,1,1.0,1,1.0,1,0.5753759801827941,54
1063,4,2674,2674,0,0,0,0,1.0,1,1.0,1,1.0,1,0.6020439418610084,53
1064,4,2678,2678,0,0,0,0,1.0,1,1.0,1,1.0,1,0.6081524455147858,55
1065,5,2683,2683,0,0,0,0,1.0,1,1.0,1,1.0,1,0.6415097212795023,54
1066,4,2687,2687,0,0,0,0,1.0,1,1.0,1,1.0,1,0.6347680653979197,55
1067,4,2691,2691,0,0,0,0,1.0,1,1.0,1,1.0,1,0.6397951753554189,55
1068,4,2695,2695,0,0,0,0,1.0,1,1.0,1,1.0,1,0.6480456446730672,55
1069,3,2698,2698,0,0,0,0,1.0,1,1.0,1,1.0,1,0.6300099837729501,55
1070,4,2702,2702,0,0,0,0,1.0,1,1.0,1,1.0,1,0.6524885483504891,54
1071,5,2707,2707,0,0,0,0,1.0,1,1.0,1,1.0,1,0.6260737837869507,55
1072,3,2710,2710,0,0,0,0,1.0,1,1.0,1,1.0,1,0.6143390728558454,54
1073,6,2716,2716,0,0,0,0,1.0,1,1.0,1,1.0,1,0.6486184495635854,54
1074,6,2722,2722,0,0,0,0,1.0,1,1.0,1,1.0,1,0.6223179492246729,52
1075,2,2724,2724,0,0,0,0,1.0,1,1.0,1,1.0,1,0.6320902377923532,51
1076,5,2729,2729,0,0,0,0,1.0,1,1.0,1,1.0,1,0.6378838383078387,52
1077,3,2732,2732,0,0,0,0,1.0,1,1.0,1,1.0,1,0.6125822661524938,49
1078,1,2733,2733,0,0,0,0,1.0,1,1.0,1,1.0,1,0.6146392049494557,48
1079,4,2737,2737,0,0,0,0,1.0,1,1.0,1,1.0,1,0.5831176790840942,47
1080,0,2737,2737,0,0,0,0,1.0,1,1.0,1,1.0,1,0.5538532344547132,47
1081,1,2738,2738,0,0,0,0,1.0,1,1.0,1,1.0,1,0.5648540941238341,45
1082,4,2742,2742,0,0,0,0,1.0,1,1.0,1,1.0,1,0.5724377780762725,42
1083,1,2743,2743,0,0,0,0,1.0,1,1.0,1,1.0,1,0.5660538989220402,42
1084,2,2745,2745,0,0,0,0,1.0,1,1.0,1,1.0,1,0.5748941118694954,40
1085,2,2747,2747,0,0,0,0,1.0,1,1.0,1,1.0,1,0.5388795049708004,43
1086,1,2748,2748,0,0,0,0,1.0,1,1.0,1,1.0,1,0.5539026074951604,41
1087,1,2749,2749,0,0,0,0,1.0,1,1.0,1,1.0,1,0.5785494007452309,41
1088,0,2749,2749,0,0,0,0,1.0,1,1.0,1,1.0,1,0.5785494007452309,41
1089,2,2751,2751,0,0,0,0,1.0,1,1.0,1,1.0,1,0.5661224470998658,42
1090,3,2754,2754,0,0,0,0,1.0,1,1.0,1,1.0,1,0.5237914065363367,43
1091,4,2758,2758,0,0,0,0,1.0,1,1.0,1,1.0,1,0.5288770568563604,43
1092,3,2761,2761,0,0,0,0,1.0,1,1.0,1,1.0,1,0.5859188640422778,43
1093,4,2765,2765,0,0,0,0,1.0,1,1.0,1,1.0,1,0.5573480573040683,43
1094,2,2767,2767,0,0,0,0,1.0,1,1.0,1,1.0,1,0.5615559194256872,43
1095,4,2771,2771,0,0,0,0,1.0,1,1.0,1,1.0,1,0.6028736384702643,44
1096,3,2774,2774,0,0,0,0,1.0,1,1.0,1,1.0,1,0.6216055177665913,44
1097,3,2777,2777,0,0,0,0,1.0,1,1.0,1,1.0,1,0.6231084935444585,45
1098,2,2779,2779,0,0,0,0,1.0,1,1.0,1,1.0,1,0.5952935713535089,46
1099,6,2785,2785,0,0,0,0,1.0,1,1.0,1,1.0,1,0.5507627942575388,48
1100,5,2790,2790,0,0,0,0,1.0,1,1.0,1,1.0,1,0.5673777057117525,49
1101,3,2793,2793,0,0,0,0,1.0,1,1.0,1,1.0,1,0.5254826067869323,49
1102,5,2798,2798,0,0,0,0,1.0,1,1.0,1,1.0,1,0.5043779388562993,50
1103,1,2799,2799,0,0,0,0,1.0,1,1.0,1,1.0,1,0.4958327765211136,48
1104,4,2803,2803,0,0,0,0,1.0,1,1.0,1,1.0,1,0.513483634215028,50
1105,5,2808,2808,0,0,0,0,1.0,1,1.0,1,1.0,1,0.5213942187437297,48
1106,2,2810,2810,0,0,0,0,1.0,1,1.0,1,1.0,1,0.5562638292043043,48
1107,3,2813,2813,0,0,0,0,1.0,1,1.0,1,1.0,1,0.5633224770671783,47
1108,4,2817,2817,0,0,0,0,1.0,1,1.0,1,1.0,1,0.5826984793102387,47
1109,4,2821,2821,0,0,0,0,1.0,1,1.0,1,1.0,1,0.5214733092199895,46
1110,2,2823,2823,0,0,0,0,1.0,1,1.0,1,1.0,1,0.5549359000600652,43
1111,3,2826,2826,0,0,0,0,1.0,1,1.0,1,1.0,1,0.5946999526869056,44
1112,1,2827,2827,0,0,0,0,1.0,1,1.0,1,1.0,1,0.6197771574355414,43
1113,4,2831,2831,0,0,0,0,1.0,1,1.0,1,1.0,1,0.6633774693221739,39
1114,1,2832,2832,0,0,0,0,1.0,1,1.0,1,1.0,1,0.6782670232266484,39
1115,2,2834,2834,0,0,0,0,1.0,1,1.0,1,1.0,1,0.6532426996034648,37
1116,5,2839,2839,0,0,0,0,1.0,1,1.0,1,1.0,1,0.6025364334337494,37
1117,2,2841,2841,0,0,0,0,1.0,1,1.0,1,1.0,1,0.605179637544786,36
1118,2,2843,2843,0,0,0,0,1.0,1,1.0,1,1.0,1,0.5483856413819769,36
1119,2,2845,2845,0,0,0,0,1.0,1,1.0,1,1.0,1,0.5475529666440163,36
1120,1,2846,2846,0,0,0,0,1.0,1,1.0,1,1.0,1,0.5486301860611859,36
1121,2,2848,2848,0,0,0,0,1.0,1,1.0,1,1.0,1,0.5711551175788214,36
1122,3,2851,2851,0,0,0,0,1.0,1,1.0,1,1.0,1,0.6043046101936296,37
1123,4,2855,2855,0,0,0,0,1.0,1,1.0,1,1.0,1,0.6175299400045569,37
1124,3,2858,2858,0,0,0,0,1.0,1,1.0,1,1.0,1,0.6129694155377833,37
1125,1,2859,2859,0,0,0,0,1.0,1,1.0,1,1.0,1,0.6066959862077292,38
1126,2,2861,2861,0,0,0,0,1.0,1,1.0,1,1.0,1,0.6002144841994715,38
1127,0,2861,2861,0,0,0,0,1.0,1,1.0,1,1.0,1,0.6092489307313065,39
1128,3,2864,2864,0,0,0,0,1.0,1,1.0,1,1.0,1,0.5892190336601629,39
1129,0,2864,2864,0,0,0,0,1.0,1,1.0,1,1.0,1,0.5892190336601629,39
1130,2,2866,2866,0,0,0,0,1.0,1,1.0,1,1.0,1,0.5769836388189371,39
1131,2,2868,2868,0,0,0,0,1.0,1,1.0,1,1.0,1,0.5953321435908365,39
1132,3,2871,2871,0,0,0,0,1.0,1,1.0,1,1.0,1,0.5668938003136833,39
1133,2,2873,2873,0,0,0,0,1.0,1,1.0,1,1.0,1,0.5093002278754656,42
1134,1,2874,2874,0,0,0,0,1.0,1,1.0,1,1.0,1,0.5233680807445886,42
1135,2,2876,2876,0,0,0,0,1.0,1,1.0,1,1.0,1,0.5217148051315469,44
1136,1,2877,2877,0,0,0,0,1.0,1,1.0,1,1.0,1,0.5445903996552804,46
1137,0,2877,2877,0,0,0,0,1.0,1,1.0,1,1.0,1,0.5601450683218911,45
1138,5,2882,2882,0,0,0,0,1.0,1,1.0,1,1.0,1,0.5956807704990609,46
1139,3,2885,2885,0,0,0,0,1.0,1,1.0,1,1.0,1,0.602670930943627,47
1140,3,2888,2888,0,0,0,0,1.0,1,1.0,1,1.0,1,0.6187623252867104,46
1141,8,2896,2896,0,0,0,0,1.0,1,1.0,1,1.0,1,0.6137318760549829,45
1142,3,2899,2899,0,0,0,0,1.0,1,1.0,1,1.0,1,0.6184112852734573,45
1143,9,2908,2908,0,0,0,0,1.0,1,1.0,1,1.0,1,0.583405799372894,43
1144,4,2912,2912,0,0,0,0,1.0,1,1.0,1,1.0,1,0.5264292336100754,45
1145,8,2920,2920,0,0,0,0,1.0,1,1.0,1,1.0,1,0.49004984591096595,44
1146,3,2923,2923,0,0,0,0,1.0,1,1.0,1,1.0,1,0.5198187717719686,45
1147,5,2928,2928,0,0,0,0,1.0,1,1.0,1,1.0,1,0.5160143320165159,44
1148,3,2931,2931,0,0,0,0,1.0,1,1.0,1,1.0,1,0.5410849575737365,43
1149,3,2934,2934,0,0,0,0,1.0,1,1.0,1,1.0,1,0.6094956266426269,42
1150,5,2939,2939,0,0,0,0,1.0,1,1.0,1,1.0,1,0.5913169920941644,45
1151,1,2940,2940,0,0,0,0,1.0,1,1.0,1,1.0,1,0.6134904597846291,40
1152,2,2942,2942,0,0,0,0,1.0,1,1.0,1,1.0,1,0.5966886122920487,41
1153,3,2945,2945,0,0,0,0,1.0,1,1.0,1,1.0,1,0.5688988803015993,38
1154,3,2948,2948,0,0,0,0,1.0,1,1.0,1,1.0,1,0.5883818835699425,37
1155,3,2951,2951,0,0,0,0,1.0,1,1.0,1,1.0,1,0.5444550054385138,38
1156,1,2952,2952,0,0,0,0,1.0,1,1.0,1,1.0,1,0.5477596271726851,38
1157,0,2952,2952,0,0,0,0,1.0,1,1.0,1,1.0,1,0.5412916748633833,37
1158,2,2954,2954,0,0,0,0,1.0,1,1.0,1,1.0,1,0.5072928946319123,36
1159,0,2954,2954,0,0,0,0,1.0,1,1.0,1,1.0,1,0.5181195832677982,35
1160,2,2956,2956,0,0,0,0,1.0,1,1.0,1,1.0,1,0.5036891350757928,35
1161,1,2957,2957,0,0,0,0,1.0,1,1.0,1,1.0,1,0.5050175617259898,36
1162,0,2957,2957,0,0,0,0,1.0,1,1.0,1,1.0,1,0.49958688922199196,37
1163,3,2960,2960,0,0,0,0,1.0,1,1.0,1,1.0,1,0.5310308848274443,37
1164,3,2963,2963,0,0,0,0,1.0,1,1.0,1,1.0,1,0.5220708494122263,38
1165,1,2964,2964,0,0,0,0,1.0,1,1.0,1,1.0,1,0.5389420199161442,38
1166,3,2967,2967,0,0,0,0,1.0,1,1.0,1,1.0,1,0.6125078242780811,40
1167,1,2968,2968,0,0,0,0,1.0,1,1.0,1,1.0,1,0.644634450874972,40
1168,2,2970,2970,0,0,0,0,1.0,1,1.0,1,1.0,1,0.699949945290031,40
1169,2,2972,2972,0,0,0,0,1.0,1,1.0,1,1.0,1,0.6458145525131832,41
1170,0,2972,2972,0,0,0,0,1.0,1,1.0,1,1.0,1,0.6458145525131832,41
1171,2,2974,2974,0,0,0,0,1.0,1,1.0,1,1.0,1,0.6079830561792564,43
1172,2,2976,2976,0,0,0,0,1.0,1,1.0,1,1.0,1,0.5816799058359984,43
1173,2,2978,2978,0,0,0,0,1.0,1,1.0,1,1.0,1,0.5959909695402298,43
1174,0,2978,2978,0,0,0,0,1.0,1,1.0,1,1.0,1,0.5959909695402298,43
1175,0,2978,2978,0,0,0,0,1.0,1,1.0,1,1.0,1,0.602053597593912,44
1176,0,2978,2978,0,0,0,0,1.0,1,1.0,1,1.0,1,0.6075376146951597,45
1177,1,2979,2979,0,0,0,0,1.0,1,1.0,1,1.0,1,0.6253410121463168,45
1178,3,2982,2982,0,0,0,0,1.0,1,1.0,1,1.0,1,0.6026966506044884,45
1179,2,2984,2984,0,0,0,0,1.0,1,1.0,1,1.0,1,0.6055638712201272,46
1180,4,2988,2988,0,0,0,0,1.0,1,1.0,1,1.0,1,0.6262555241631582,47
1181,3,2991,2991,0,0,0,0,1.0,1,1.0,1,1.0,1,0.6522123683996147,48
1182,0,2991,2991,0,0,0,0,1.0,1,1.0,1,1.0,1,0.6522123683996147,48
1183,2,2993,2993,0,0,0,0,1.0,1,1.0,1,1.0,1,0.6793974439662632,46
1184,0,2993,2993,0,0,0,0,1.0,1,1.0,1,1.0,1,0.6609256020206201,47
1185,0,2993,2993,0,0,0,0,1.0,1,1.0,1,1.0,1,0.6842954089139842,44
1186,0,2993,2993,0,0,0,0,1.0,1,1.0,1,1.0,1,0.6830132635444883,47
1187,0,2993,2993,0,0,0,0,1.0,1,1.0,1,1.0,1,0.6833078227968088,49
1188,1,2994,2994,0,0,0,0,1.0,1,1.0,1,1.0,1,0.6734713895847684,50
1189,2,2996,2996,0,0,0,0,1.0,1,1.0,1,1.0,1,0.6576349381022424,48
1190,1,2997,2997,0,0,0,0,1.0,1,1.0,1,1.0,1,0.6553421771712531,48
1191,4,3001,3001,0,0,0,0,1.0,1,1.0,1,1.0,1,0.6276561379125886,46
1192,3,3004,3004,0,0,0,0,1.0,1,1.0,1,1.0,1,0.6309444515951745,46
1193,4,3008,3008,0,0,0,0,1.0,1,1.0,1,1.0,1,0.6295859076701044,45
1194,1,3009,3009,0,0,0,0,1.0,1,1.0,1,1.0,1,0.6216810351267322,45
1195,2,3011,3011,0,0,0,0,1.0,1,1.0,1,1.0,1,0.615285672780536,47
1196,3,3014,3014,0,0,0,0,1.0,1,1.0,1,1.0,1,0.6305260725397257,48
1197,3,3017,3017,0,0,0,0,1.0,1,1.0,1,1.0,1,0.6598386572578093,49
1198,2,3019,3019,0,0,0,0,1.0,1,1.0,1,1.0,1,0.6315171637150874,49
1199,0,3019,3019,0,0,0,0,1.0,1,1.0,1,1.0,1,0.6267547809586609,50
1200,1,3020,3020,0,0,0,0,1.0,1,1.0,1,1.0,1,0.6225964916771596,50
1201,1,3021,3021,0,0,0,0,1.0,1,1.0,1,1.0,1,0.6380270111036558,50
1202,3,3024,3024,0,0,0,0,1.0,1,1.0,1,1.0,1,0.6246845993644246,51
1203,0,3024,3024,0,0,0,0,1.0,1,1.0,1,1.0,1,0.61515467664299,52
1204,1,3025,3025,0,0,0,0,1.0,1,1.0,1,1.0,1,0.6157252405798155,52
1205,2,3027,3027,0,0,0,0,1.0,1,1.0,1,1.0,1,0.6405407357371098,53
1206,0,3027,3027,0,0,0,0,1.0,1,1.0,1,1.0,1,0.6405407357371098,53
1207,1,3028,3028,0,0,0,0,1.0,1,1.0,1,1.0,1,0.6130583114842127,55
1208,1,3029,3029,0,0,0,0,1.0,1,1.0,1,1.0,1,0.6215353776579843,56
1209,1,3030,3030,0,0,0,0,1.0,1,1.0,1,1.0,1,0.6098587461247703,55
1210,1,3031,3031,0,0,0,0,1.0,1,1.0,1,1.0,1,0.6173067731099363,55
1211,1,3032,3032,0,0,0,0,1.0,1,1.0,1,1.0,1,0.593150893265608,57
1212,5,3037,3037,0,0,0,0,1.0,1,1.0,1,1.0,1,0.6002835382848589,57
1213,1,3038,3038,0,0,0,0,1.0,1,1.0,1,1.0,1,0.5950968417788518,57
1214,5,3043,3043,0,0,0,0,1.0,1,1.0,1,1.0,1,0.6135746129679429,57
1215,2,3045,3045,0,0,0,0,1.0,1,1.0,1,1.0,1,0.5962563475068111,59
1216,5,3050,3050,0,0,0,0,1.0,1,1.0,1,1.0,1,0.5783443484037581,61
1217,2,3052,3052,0,0,0,0,1.0,1,1.0,1,1.0,1,0.5849352224501813,61
1218,4,3056,3056,0,0,0,0,1.0,1,1.0,1,1.0,1,0.5888843373140356,61
1219,6,3062,3062,0,0,0,0,1.0,1,1.0,1,1.0,1,0.5824607580468227,61
1220,3,3065,3065,0,0,0,0,1.0,1,1.0,1,1.0,1,0.5854980659385369,60
1221,5,3070,3070,0,0,0,0,1.0,1,1.0,1,1.0,1,0.5820001672846019,61
1222,10,3080,3080,0,0,0,0,1.0,1,1.0,1,1.0,1,0.5854897129546938,61
1223,5,3085,3085,0,0,0,0,1.0,1,1.0,1,1.0,1,0.5925945694846176,59
1224,2,3087,3087,0,0,0,0,1.0,1,1.0,1,1.0,1,0.5702452409229628,60
1225,6,3093,3093,0,0,0,0,1.0,1,1.0,1,1.0,1,0.5447948412323945,60
1226,4,3097,3097,0,0,0,0,1.0,1,1.0,1,1.0,1,0.5415873817839265,61
1227,5,3102,3102,0,0,0,0,1.0,1,1.0,1,1.0,1,0.5175644708441963,59
1228,3,3105,3105,0,0,0,0,1.0,1,1.0,1,1.0,1,0.5246865681955861,58
1229,4,3109,3109,0,0,0,0,1.0,1,1.0,1,1.0,1,0.5337371819021697,57
1230,5,3114,3114,0,0,0,0,1.0,1,1.0,1,1.0,1,0.5637763318854591,55
1231,2,3116,3116,0,0,0,0,1.0,1,1.0,1,1.0,1,0.5420370645545767,54
1232,4,3120,3120,0,0,0,0,1.0,1,1.0,1,1.0,1,0.5749479240118636,51
1233,5,3125,3125,0,0,0,0,1.0,1,1.0,1,1.0,1,0.5869444435730962,49
1234,1,3126,3126,0,0,0,0,1.0,1,1.0,1,1.0,1,0.5884883603129651,49
1235,1,3127,3127,0,0,0,0,1.0,1,1.0,1,1.0,1,0.5897243417230982,48
1236,3,3130,3130,0,0,0,0,1.0,1,1.0,1,1.0,1,0.5973727871636514,49
1237,2,3132,3132,0,0,0,0,1.0,1,1.0,1,1.0,1,0.6108454699123979,48
1238,3,3135,3135,0,0,0,0,1.0,1,1.0,1,1.0,1,0.5818350038414015,47
1239,2,3137,3137,0,0,0,0,1.0,1,1.0,1,1.0,1,0.5551608668974435,48
1240,3,3140,3140,0,0,0,0,1.0,1,1.0,1,1.0,1,0.5522162744584388,49
1241,4,3144,3144,0,0,0,0,1.0,1,1.0,1,1.0,1,0.5423343151579625,49
1242,0,3144,3144,0,0,0,0,1.0,1,1.0,1,1.0,1,0.5433663926573244,49
1243,3,3147,3147,0,0,0,0,1.0,1,1.0,1,1.0,1,0.5519751857094986,50
1244,3,3150,3150,0,0,0,0,1.0,1,1.0,1,1.0,1,0.5498576916106169,50
1245,2,3152,3152,0,0,0,0,1.0,1,1.0,1,1.0,1,0.5698457302673371,51
1246,7,3159,3159,0,0,0,0,1.0,1,1.0,1,1.0,1,0.6195186486183258,52
1247,1,3160,3160,0,0,0,0,1.0,1,1.0,1,1.0,1,0.6156740770925107,52
1248,7,3167,3167,0,0,0,0,1.0,1,1.0,1,1.0,1,0.6546356868877442,51
1249,1,3168,3168,0,0,0,0,1.0,1,1.0,1,1.0,1,0.6748810314945527,51
1250,3,3171,3171,0,0,0,0,1.0,1,1.0,1,1.0,1,0.6459543628417922,51
1251,5,3176,3176,0,0,0,0,1.0,1,1.0,1,1.0,1,0.6131935149569122,53
1252,1,3177,3177,0,0,0,0,1.0,1,1.0,1,1.0,1,0.6296662702300174,52
1253,3,3180,3180,0,0,0,0,1.0,1,1.0,1,1.0,1,0.6294317710127845,52
1254,1,3181,3181,0,0,0,0,1.0,1,1.0,1,1.0,1,0.6145153878259704,53
1255,1,3182,3182,0,0,0,0,1.0,1,1.0,1,1.0,1,0.602236620899173,55
1256,1,3183,3183,0,0,0,0,1.0,1,1.0,1,1.0,1,0.6050755942654712,55
1257,0,3183,3183,0,0,0,0,1.0,1,1.0,1,1.0,1,0.6009995255203519,57
1258,1,3184,3184,0,0,0,0,1.0,1,1.0,1,1.0,1,0.6163675347294875,57
1259,3,3187,3187,0,0,0,0,1.0,1,1.0,1,1.0,1,0.6108755655659737,57
1260,2,3189,3189,0,0,0,0,1.0,1,1.0,1,1.0,1,0.6163548018142658,56
1261,3,3192,3192,0,0,0,0,1.0,1,1.0,1,1.0,1,0.626880832903475,57
1262,2,3194,3194,0,0,0,0,1.0,1,1.0,1,1.0,1,0.6430245794240901,58
1263,4,3198,3198,0,0,0,0,1.0,1,1.0,1,1.0,1,0.6060325417812716,58
1264,4,3202,3202,0,0,0,0,1.0,1,1.0,1,1.0,1,0.6023469413373228,57
1265,7,3209,3209,0,0,0,0,1.0,1,1.0,1,1.0,1,0.5847677920659499,56
1266,3,3212,3212,0,0,0,0,1.0,1,1.0,1,1.0,1,0.5826614032271072,55
1267,9,3221,3221,0,0,0,0,1.0,1,1.0,1,1.0,1,0.5565323222999905,53
1268,0,3221,3221,0,0,0,0,1.0,1,1.0,1,1.0,1,0.5509649728686185,52
1269,4,3225,3225,0,0,0,0,1.0,1,1.0,1,1.0,1,0.5244521363813605,51
1270,2,3227,3227,0,0,0,0,1.0,1,1.0,1,1.0,1,0.5260446244699917,47
1271,2,3229,3229,0,0,0,0,1.0,1,1.0,1,1.0,1,0.5459081277346286,46
1272,1,3230,3230,0,0,0,0,1.0,1,1.0,1,1.0,1,0.5395142114899648,43
1273,3,3233,3233,0,0,0,0,1.0,1,1.0,1,1.0,1,0.5770017086341761,44
1274,4,3237,3237,0,0,0,0,1.0,1,1.0,1,1.0,1,0.6047304470035653,44
1275,2,3239,3239,0,0,0,0,1.0,1,1.0,1,1.0,1,0.6215102169228167,45
1276,4,3243,3243,0,0,0,0,1.0,1,1.0,1,1.0,1,0.6309018855509856,43
1277,1,3244,3244,0,0,0,0,1.0,1,1.0,1,1.0,1,0.6245136035143031,44
1278,2,3246,3246,0,0,0,0,1.0,1,1.0,1,1.0,1,0.6201536915090432,45
1279,5,3251,3251,0,0,0,0,1.0,1,1.0,1,1.0,1,0.6298198252110893,47
1280,3,3254,3254,0,0,0,0,1.0,1,1.0,1,1.0,1,0.6209085838749683,47
1281,2,3256,3256,0,0,0,0,1.0,1,1.0,1,1.0,1,0.6357872311418831,47
1282,2,3258,3258,0,0,0,0,1.0,1,1.0,1,1.0,1,0.648488624789609,46
1283,2,3260,3260,0,0,0,0,1.0,1,1.0,1,1.0,1,0.6397589316292438,46
1284,0,3260,3260,0,0,0,0,1.0,1,1.0,1,1.0,1,0.6397589316292438,46
1285,2,3262,3262,0,0,0,0,1.0,1,1.0,1,1.0,1,0.6684554404949401,46
1286,1,3263,3263,0,0,0,0,1.0,1,1.0,1,1.0,1,0.6957548868120657,45
1287,0,3263,3263,0,0,0,0,1.0,1,1.0,1,1.0,1,0.6752577062576552,49
1288,3,3266,3266,0,0,0,0,1.0,1,1.0,1,1.0,1,0.6726479189421503,49
1289,1,3267,3267,0,0,0,0,1.0,1,1.0,1,1.0,1,0.6509997557499512,52
1290,4,3271,3271,0,0,0,0,1.0,1,1.0,1,1.0,1,0.6577990707177149,52
1291,5,3276,3276,0,0,0,0,1.0,1,1.0,1,1.0,1,0.6487836546721527,52
1292,2,3278,3278,0,0,0,0,1.0,1,1.0,1,1.0,1,0.6253472191896764,53
1293,3,3281,3281,0,0,0,0,1.0,1,1.0,1,1.0,1,0.589456764643012,53
1294,1,3282,3282,0,0,0,0,1.0,1,1.0,1,1.0,1,0.5992341627019484,53
1295,4,3286,3286,0,0,0,0,1.0,1,1.0,1,1.0,1,0.597616603643042,54
1296,2,3288,3288,0,0,0,0,1.0,1,1.0,1,1.0,1,0.5680340634119055,55
1297,3,3291,3291,0,0,0,0,1.0,1,1.0,1,1.0,1,0.562649782335945,54
1298,4,3295,3295,0,0,0,0,1.0,1,1.0,1,1.0,1,0.5609452029901191,55
1299,4,3299,3299,0,0,0,0,1.0,1,1.0,1,1.0,1,0.5727955211258595,54
1300,4,3303,3303,0,0,0,0,1.0,1,1.0,1,1.0,1,0.6114903657486956,55
1301,1,3304,3304,0,0,0,0,1.0,1,1.0,1,1.0,1,0.6271042422868828,54
1302,4,3308,3308,0,0,0,0,1.0,1,1.0,1,1.0,1,0.6416324554341033,54
1303,3,3311,3311,0,0,0,0,1.0,1,1.0,1,1.0,1,0.6778236945168251,50
1304,2,3313,3313,0,0,0,0,1.0,1,1.0,1,1.0,1,0.6547178693638587,51
1305,4,3317,3317,0,0,0,0,1.0,1,1.0,1,1.0,1,0.6350914009539818,48
1306,5,3322,3322,0,0,0,0,1.0,1,1.0,1,1.0,1,0.654425539208647,48
1307,4,3326,3326,0,0,0,0,1.0,1,1.0,1,1.0,1,0.6261847199704842,48
1308,2,3328,3328,0,0,0,0,1.0,1,1.0,1,1.0,1,0.6396263941221929,46
1309,1,3329,3329,0,0,0,0,1.0,1,1.0,1,1.0,1,0.6363005861636054,47
1310,3,3332,3332,0,0,0,0,1.0,1,1.0,1,1.0,1,0.6338935248064278,46
1311,1,3333,3333,0,0,0,0,1.0,1,1.0,1,1.0,1,0.640401506934126,46
1312,0,3333,3333,0,0,0,0,1.0,1,1.0,1,1.0,1,0.6332193471438055,45
1313,3,3336,3336,0,0,0,0,1.0,1,1.0,1,1.0,1,0.6444447225032551,44
1314,1,3337,3337,0,0,0,0,1.0,1,1.0,1,1.0,1,0.6520175607640242,42
1315,4,3341,3341,0,0,0,0,1.0,1,1.0,1,1.0,1,0.650497044503718,40
1316,1,3342,3342,0,0,0,0,1.0,1,1.0,1,1.0,1,0.6132626423208538,42
1317,5,3347,3347,0,0,0,0,1.0,1,1.0,1,1.0,1,0.5884882436779465,42
1318,1,3348,3348,0,0,0,0,1.0,1,1.0,1,1.0,1,0.5908276271223369,42
1319,1,3349,3349,0,0,0,0,1.0,1,1.0,1,1.0,1,0.5826587394101573,42
1320,2,3351,3351,0,0,0,0,1.0,1,1.0,1,1.0,1,0.5566407507344886,42
1321,3,3354,3354,0,0,0,0,1.0,1,1.0,1,1.0,1,0.5253207813547672,45
1322,2,3356,3356,0,0,0,0,1.0,1,1.0,1,1.0,1,0.5164984267103345,45
1323,4,3360,3360,0,0,0,0,1.0,1,1.0,1,1.0,1,0.49311049982807137,46
1324,1,3361,3361,0,0,0,0,1.0,1,1.0,1,1.0,1,0.5069837843352963,45
1325,2,3363,3363,0,0,0,0,1.0,1,1.0,1,1.0,1,0.5177785689744473,46
1326,2,3365,3365,0,0,0,0,1.0,1,1.0,1,1.0,1,0.5182630577455418,45
1327,1,3366,3366,0,0,0,0,1.0,1,1.0,1,1.0,1,0.5428008034676501,46
1328,1,3367,3367,0,0,0,0,1.0,1,1.0,1,1.0,1,0.5637722454287457,47
1329,2,3369,3369,0,0,0,0,1.0,1,1.0,1,1.0,1,0.593164548722076,47
1330,2,3371,3371,0,0,0,0,1.0,1,1.0,1,1.0,1,0.637798007515382,46
1331,0,3371,3371,0,0,0,0,1.0,1,1.0,1,1.0,1,0.637798007515382,46
1332,2,3373,3373,0,0,0,0,1.0,1,1.0,1,1.0,1,0.5919807552429146,49
1333,2,3375,3375,0,0,0,0,1.0,1,1.0,1,1.0,1,0.5892513270919786,50
1334,2,3377,3377,0,0,0,0,1.0,1,1.0,1,1.0,1,0.614967359621481,50
1335,1,3378,3378,0,0,0,0,1.0,1,1.0,1,1.0,1,0.631943378528361,52
1336,3,3381,3381,0,0,0,0,1.0,1,1.0,1,1.0,1,0.6268062017709757,53
1337,2,3383,3383,0,0,0,0,1.0,1,1.0,1,1.0,1,0.6288413188666966,54
1338,3,3386,3386,0,0,0,0,1.0,1,1.0,1,1.0,1,0.6342281048009554,54
1339,4,3390,3390,0,0,0,0,1.0,1,1.0,1,1.0,1,0.6221021435321643,54
1340,4,3394,3394,0,0,0,0,1.0,1,1.0,1,1.0,1,0.6162445545460375,53
1341,1,3395,3395,0,0,0,0,1.0,1,1.0,1,1.0,1,0.6028756901144207,53
1342,7,3402,3402,0,0,0,0,1.0,1,1.0,1,1.0,1,0.5778015669099247,52
1343,0,3402,3402,0,0,0,0,1.0,1,1.0,1,1.0,1,0.5805521556075315,50
1344,4,3406,3406,0,0,0,0,1.0,1,1.0,1,1.0,1,0.5659556016352755,51
1345,2,3408,3408,0,0,0,0,1.0,1,1.0,1,1.0,1,0.5477117570666784,50
1346,3,3411,3411,0,0,0,0,1.0,1,1.0,1,1.0,1,0.5449717408708908,50
1347,1,3412,3412,0,0,0,0,1.0,1,1.0,1,1.0,1,0.5727539446361712,48
1348,1,3413,3413,0,0,0,0,1.0,1,1.0,1,1.0,1,0.5876686725080528,49
1349,3,3416,3416,0,0,0,0,1.0,1,1.0,1,1.0,1,0.5908793602893174,48
1350,0,3416,3416,0,0,0,0,1.0,1,1.0,1,1.0,1,0.5875526512356394,49
1351,3,3419,3419,0,0,0,0,1.0,1,1.0,1,1.0,1,0.6097777257188801,48
1352,1,3420,3420,0,0,0,0,1.0,1,1.0,1,1.0,1,0.6114759274063258,49
1353,6,3426,3426,0,0,0,0,1.0,1,1.0,1,1.0,1,0.6388488736378108,49
1354,2,3428,3428,0,0,0,0,1.0,1,1.0,1,1.0,1,0.6335118800624122,49
1355,2,3430,3430,0,0,0,0,1.0,1,1.0,1,1.0,1,0.6201480502314373,50
1356,3,3433,3433,0,0,0,0,1.0,1,1.0,1,1.0,1,0.6397807930823476,50
1357,2,3435,3435,0,0,0,0,1.0,1,1.0,1,1.0,1,0.6299586641060074,50
1358,2,3437,3437,0,0,0,0,1.0,1,1.0,1,1.0,1,0.6258379671104204,51
1359,0,3437,3437,0,0,0,0,1.0,1,1.0,1,1.0,1,0.6167143645086535,53
1360,1,3438,3438,0,0,0,0,1.0,1,1.0,1,1.0,1,0.6057118646329925,54
1361,3,3441,3441,0,0,0,0,1.0,1,1.0,1,1.0,1,0.6084543964045718,54
1362,3,3444,3444,0,0,0,0,1.0,1,1.0,1,1.0,1,0.6056010051314923,55
1363,1,3445,3445,0,0,0,0,1.0,1,1.0,1,1.0,1,0.6087102635720935,55
1364,2,3447,3447,0,0,0,0,1.0,1,1.0,1,1.0,1,0.6311719548083071,55
1365,4,3451,3451,0,0,0,0,1.0,1,1.0,1,1.0,1,0.632132184966973,56
1366,0,3451,3451,0,0,0,0,1.0,1,1.0,1,1.0,1,0.632132184966973,56
1367,3,3454,3454,0,0,0,0,1.0,1,1.0,1,1.0,1,0.6309053587684486,56
1368,2,3456,3456,0,0,0,0,1.0,1,1.0,1,1.0,1,0.6131287411633208,58
1369,1,3457,3457,0,0,0,0,1.0,1,1.0,1,1.0,1,0.6119494271080209,59
1370,5,3462,3462,0,0,0,0,1.0,1,1.0,1,1.0,1,0.6195281453501337,59
1371,1,3463,3463,0,0,0,0,1.0,1,1.0,1,1.0,1,0.6118696343396859,59
1372,4,3467,3467,0,0,0,0,1.0,1,1.0,1,1.0,1,0.6174407620945175,59
1373,3,3470,3470,0,0,0,0,1.0,1,1.0,1,1.0,1,0.5977905629732471,59
1374,2,3472,3472,0,0,0,0,1.0,1,1.0,1,1.0,1,0.6061510425152816,60
1375,5,3477,3477,0,0,0,0,1.0,1,1.0,1,1.0,1,0.5950774666259867,61
1376,0,3477,3477,0,0,0,0,1.0,1,1.0,1,1.0,1,0.6058724314371626,61
1377,2,3479,3479,0,0,0,0,1.0,1,1.0,1,1.0,1,0.6136865806948344,61
1378,3,3482,3482,0,0,0,0,1.0,1,1.0,1,1.0,1,0.6101728397185624,61
1379,4,3486,3486,0,0,0,0,1.0,1,1.0,1,1.0,1,0.5967332197081956,60
1380,3,3489,3489,0,0,0,0,1.0,1,1.0,1,1.0,1,0.5746623314501729,60
1381,3,3492,3492,0,0,0,0,1.0,1,1.0,1,1.0,1,0.5680374054864263,58
1382,3,3495,3495,0,0,0,0,1.0,1,1.0,1,1.0,1,0.565359524593316,58
1383,6,3501,3501,0,0,0,0,1.0,1,1.0,1,1.0,1,0.5652184442489784,57
1384,2,3503,3503,0,0,0,0,1.0,1,1.0,1,1.0,1,0.5969027466045865,54
1385,5,3508,3508,0,0,0,0,1.0,1,1.0,1,1.0,1,0.5919980210255513,52
1386,2,3510,3510,0,0,0,0,1.0,1,1.0,1,1.0,1,0.5963919861031576,51
1387,1,3511,3511,0,0,0,0,1.0,1,1.0,1,1.0,1,0.5900848559891246,51
1388,2,3513,3513,0,0,0,0,1.0,1,1.0,1,1.0,1,0.6055302477197988,52
1389,1,3514,3514,0,0,0,0,1.0,1,1.0,1,1.0,1,0.6493362067171379,50
1390,2,3516,3516,0,0,0,0,1.0,1,1.0,1,1.0,1,0.6661010540534762,51
1391,1,3517,3517,0,0,0,0,1.0,1,1.0,1,1.0,1,0.6632473127013795,50
1392,1,3518,3518,0,0,0,0,1.0,1,1.0,1,1.0,1,0.6699696991358177,50
1393,1,3519,3519,0,0,0,0,1.0,1,1.0,1,1.0,1,0.6860468723311963,49
1394,1,3520,3520,0,0,0,0,1.0,1,1.0,1,1.0,1,0.6946705704832835,50
1395,3,3523,3523,0,0,0,0,1.0,1,1.0,1,1.0,1,0.674202585030682,51
1396,0,3523,3523,0,0,0,0,1.0,1,1.0,1,1.0,1,0.678785684863951,52
1397,4,3527,3527,0,0,0,0,1.0,1,1.0,1,1.0,1,0.6874538756786216,52
1398,5,3532,3532,0,0,0,0,1.0,1,1.0,1,1.0,1,0.6768631926628786,53
1399,3,3535,3535,0,0,0,0,1.0,1,1.0,1,1.0,1,0.6696317339943314,54
1400,2,3537,3537,0,0,0,0,1.0,1,1.0,1,1.0,1,0.676799151074703,54
1401,4,3541,3541,0,0,0,0,1.0,1,1.0,1,1.0,1,0.6711263689409497,54
1402,1,3542,3542,0,0,0,0,1.0,1,1.0,1,1.0,1,0.6691881318404082,53
1403,2,3544,3544,0,0,0,0,1.0,1,1.0,1,1.0,1,0.6739297353788463,52
1404,2,3546,3546,0,0,0,0,1.0,1,1.0,1,1.0,1,0.668122597473489,53
1405,1,3547,3547,0,0,0,0,1.0,1,1.0,1,1.0,1,0.6631084581960548,52
1406,0,3547,3547,0,0,0,0,1.0,1,1.0,1,1.0,1,0.6489005917924506,53
1407,1,3548,3548,0,0,0,0,1.0,1,1.0,1,1.0,1,0.6725126222474969,54
1408,1,3549,3549,0,0,0,0,1.0,1,1.0,1,1.0,1,0.6846849459493694,53
1409,0,3549,3549,0,0,0,0,1.0,1,1.0,1,1.0,1,0.6735788049473611,55
1410,0,3549,3549,0,0,0,0,1.0,1,1.0,1,1.0,1,0.6813510001611901,54
1411,1,3550,3550,0,0,0,0,1.0,1,1.0,1,1.0,1,0.6980517359597617,54
1412,1,3551,3551,0,0,0,0,1.0,1,1.0,1,1.0,1,0.7157123971100173,53
1413,2,3553,3553,0,0,0,0,1.0,1,1.0,1,1.0,1,0.7109830639113636,54
1414,4,3557,3557,0,0,0,0,1.0,1,1.0,1,1.0,1,0.7304471214908017,55
1415,2,3559,3559,0,0,0,0,1.0,1,1.0,1,1.0,1,0.6830892831666178,57
1416,4,3563,3563,0,0,0,0,1.0,1,1.0,1,1.0,1,0.6835321207232598,59
1417,5,3568,3568,0,0,0,0,1.0,1,1.0,1,1.0,1,0.6543162713763724,58
1418,3,3571,3571,0,0,0,0,1.0,1,1.0,1,1.0,1,0.6261867920256301,57
1419,5,3576,3576,0,0,0,0,1.0,1,1.0,1,1.0,1,0.6256400267874127,56
1420,3,3579,3579,0,0,0,0,1.0,1,1.0,1,1.0,1,0.6044413922989881,54
1421,3,3582,3582,0,0,0,0,1.0,1,1.0,1,1.0,1,0.6296317493208222,55
1422,2,3584,3584,0,0,0,0,1.0,1,1.0,1,1.0,1,0.6161601237293775,52
1423,2,3586,3586,0,0,0,0,1.0,1,1.0,1,1.0,1,0.6026732500198162,52
1424,2,3588,3588,0,0,0,0,1.0,1,1.0,1,1.0,1,0.6046257756258522,51
1425,1,3589,3589,0,0,0,0,1.0,1,1.0,1,1.0,1,0.6294505542413745,50
1426,2,3591,3591,0,0,0,0,1.0,1,1.0,1,1.0,1,0.6346239212930372,50
1427,3,3594,3594,0,0,0,0,1.0,1,1.0,1,1.0,1,0.6398445560312805,48
1428,2,3596,3596,0,0,0,0,1.0,1,1.0,1,1.0,1,0.633794231242491,48
1429,4,3600,3600,0,0,0,0,1.0,1,1.0,1,1.0,1,0.6467985321606508,48
1430,3,3603,3603,0,0,0,0,1.0,1,1.0,1,1.0,1,0.6391049936868612,48
1431,7,3610,3610,0,0,0,0,1.0,1,1.0,1,1.0,1,0.639110130054307,48
1432,1,3611,3611,0,0,0,0,1.0,1,1.0,1,1.0,1,0.6258271713242147,50
1433,4,3615,3615,0,0,0,0,1.0,1,1.0,1,1.0,1,0.6246309401381451,51
1434,4,3619,3619,0,0,0,0,1.0,1,1.0,1,1.0,1,0.6325130683364206,51
1435,4,3623,3623,0,0,0,0,1.0,1,1.0,1,1.0,1,0.6213546776728944,50
1436,3,3626,3626,0,0,0,0,1.0,1,1.0,1,1.0,1,0.6165646779623741,51
1437,3,3629,3629,0,0,0,0,1.0,1,1.0,1,1.0,1,0.6187238297298283,51
1438,5,3634,3634,0,0,0,0,1.0,1,1.0,1,1.0,1,0.6245849496869588,51
1439,3,3637,3637,0,0,0,0,1.0,1,1.0,1,1.0,1,0.6332882454376986,50
1440,3,3640,3640,0,0,0,0,1.0,1,1.0,1,1.0,1,0.6387175652416845,51
1441,6,3646,3646,0,0,0,0,1.0,1,1.0,1,1.0,1,0.6051848919214754,51
1442,5,3651,3651,0,0,0,0,1.0,1,1.0,1,1.0,1,0.590497503009829,52
1443,3,3654,3654,0,0,0,0,1.0,1,1.0,1,1.0,1,0.5911801343364316,53
1444,2,3656,3656,0,0,0,0,1.0,1,1.0,1,1.0,1,0.5785305403140584,54
1445,4,3660,3660,0,0,0,0,1.0,1,1.0,1,1.0,1,0.5961104999391218,54
1446,4,3664,3664,0,0,0,0,1.0,1,1.0,1,1.0,1,0.5868863865430859,54
1447,2,3666,3666,0,0,0,0,1.0,1,1.0,1,1.0,1,0.6063981956649588,55
1448,0,3666,3666,0,0,0,0,1.0,1,1.0,1,1.0,1,0.6063981956649588,55
1449,3,3669,3669,0,0,0,0,1.0,1,1.0,1,1.0,1,0.5999449950406607,55
1450,0,3669,3669,0,0,0,0,1.0,1,1.0,1,1.0,1,0.5914132857880114,57
1451,3,3672,3672,0,0,0,0,1.0,1,1.0,1,1.0,1,0.5892079029603405,57
1452,1,3673,3673,0,0,0,0,1.0,1,1.0,1,1.0,1,0.5828416722680296,57
1453,1,3674,3674,0,0,0,0,1.0,1,1.0,1,1.0,1,0.5799418159318536,57
1454,1,3675,3675,0,0,0,0,1.0,1,1.0,1,1.0,1,0.592756862716567,58
1455,0,3675,3675,0,0,0,0,1.0,1,1.0,1,1.0,1,0.5717516893829798,56
1456,3,3678,3678,0,0,0,0,1.0,1,1.0,1,1.0,1,0.5959219476868208,55
1457,0,3678,3678,0,0,0,0,1.0,1,1.0,1,1.0,1,0.607388227090211,54
1458,6,3684,3684,0,0,0,0,1.0,1,1.0,1,1.0,1,0.6207935272219276,53
1459,5,3689,3689,0,0,0,0,1.0,1,1.0,1,1.0,1,0.6366819127380576,52
1460,4,3693,3693,0,0,0,0,1.0,1,1.0,1,1.0,1,0.6496395450079024,51
1461,4,3697,3697,0,0,0,0,1.0,1,1.0,1,1.0,1,0.6300524183438716,51
1462,5,3702,3702,0,0,0,0,1.0,1,1.0,1,1.0,1,0.6417006651315781,51
1463,3,3705,3705,0,0,0,0,1.0,1,1.0,1,1.0,1,0.6367507591416629,52
1464,8,3713,3713,0,0,0,0,1.0,1,1.0,1,1.0,1,0.6357091261455095,52
1465,6,3719,3719,0,0,0,0,1.0,1,1.0,1,1.0,1,0.6300333941666781,51
1466,4,3723,3723,0,0,0,0,1.0,1,1.0,1,1.0,1,0.6178526684778228,50
1467,3,3726,3726,0,0,0,0,1.0,1,1.0,1,1.0,1,0.6421380861999916,48
1468,8,3734,3734,0,0,0,0,1.0,1,1.0,1,1.0,1,0.5906584543237587,48
1469,4,3738,3738,0,0,0,0,1.0,1,1.0,1,1.0,1,0.6028266583407136,48
1470,3,3741,3741,0,0,0,0,1.0,1,1.0,1,1.0,1,0.5706908382675463,48
1471,6,3747,3747,0,0,0,0,1.0,1,1.0,1,1.0,1,0.5765340051602635,45
1472,2,3749,3749,0,0,0,0,1.0,1,1.0,1,1.0,1,0.5799420077617222,45
1473,4,3753,3753,0,0,0,0,1.0,1,1.0,1,1.0,1,0.5603461315564573,46
1474,2,3755,3755,0,0,0,0,1.0,1,1.0,1,1.0,1,0.5747874081199416,46
1475,2,3757,3757,0,0,0,0,1.0,1,1.0,1,1.0,1,0.5687750862377408,46
1476,3,3760,3760,0,0,0,0,1.0,1,1.0,1,1.0,1,0.566301538489546,47
1477,2,3762,3762,0,0,0,0,1.0,1,1.0,1,1.0,1,0.5623420397714155,47
1478,2,3764,3764,0,0,0,0,1.0,1,1.0,1,1.0,1,0.6013151271748014,47
1479,4,3768,3768,0,0,0,0,1.0,1,1.0,1,1.0,1,0.5960866834717488,48
1480,0,3768,3768,0,0,0,0,1.0,1,1.0,1,1.0,1,0.6057543418062048,47
1481,1,3769,3769,0,0,0,0,1.0,1,1.0,1,1.0,1,0.6139822709891203,47
1482,0,3769,3769,0,0,0,0,1.0,1,1.0,1,1.0,1,0.6209235721689632,46
1483,3,3772,3772,0,0,0,0,1.0,1,1.0,1,1.0,1,0.6536624303534303,47
1484,2,3774,3774,0,0,0,0,1.0,1,1.0,1,1.0,1,0.6670499350451794,47
1485,3,3777,3777,0,0,0,0,1.0,1,1.0,1,1.0,1,0.7037215876823103,47
1486,2,3779,3779,0,0,0,0,1.0,1,1.0,1,1.0,1,0.6841523891566011,49
1487,4,3783,3783,0,0,0,0,1.0,1,1.0,1,1.0,1,0.6694455147340412,49
1488,6,3789,3789,0,0,0,0,1.0,1,1.0,1,1.0,1,0.6353237401060654,51
1489,4,3793,3793,0,0,0,0,1.0,1,1.0,1,1.0,1,0.6260802305777586,52
1490,3,3796,3796,0,0,0,0,1.0,1,1.0,1,1.0,1,0.6368674698703193,52
1491,6,3802,3802,0,0,0,0,1.0,1,1.0,1,1.0,1,0.6475869446735805,53
1492,5,3807,3807,0,0,0,0,1.0,1,1.0,1,1.0,1,0.622302614262541,53
1493,2,3809,3809,0,0,0,0,1.0,1,1.0,1,1.0,1,0.6082984169435462,52
1494,5,3814,3814,0,0,0,0,1.0,1,1.0,1,1.0,1,0.61796852963601,50
1495,1,3815,3815,0,0,0,0,1.0,1,1.0,1,1.0,1,0.5792939598244803,50
1496,3,3818,3818,0,0,0,0,1.0,1,1.0,1,1.0,1,0.6144740508589315,52
1497,0,3818,3818,0,0,0,0,1.0,1,1.0,1,1.0,1,0.6078111927247865,51
1498,3,3821,3821,0,0,0,0,1.0,1,1.0,1,1.0,1,0.5968070383017235,50
1499,4,3825,3825,0,0,0,0,1.0,1,1.0,1,1.0,1,0.5634949654267525,50
1500,4,3829,3829,0,0,0,0,1.0,1,1.0,1,1.0,1,0.5328625039216673,49
1501,1,3830,3830,0,0,0,0,1.0,1,1.0,1,1.0,1,0.5069128566631735,47
1502,4,3834,3834,0,0,0,0,1.0,1,1.0,1,1.0,1,0.5203205665539674,47
1503,3,3837,3837,0,0,0,0,1.0,1,1.0,1,1.0,1,0.5022096867825909,47
1504,5,3842,3842,0,0,0,0,1.0,1,1.0,1,1.0,1,0.5038693616677659,48
1505,5,3847,3847,0,0,0,0,1.0,1,1.0,1,1.0,1,0.5209403135050193,47
1506,1,3848,3848,0,0,0,0,1.0,1,1.0,1,1.0,1,0.5248854541166897,47
1507,4,3852,3852,0,0,0,0,1.0,1,1.0,1,1.0,1,0.5643759438155934,45
1508,0,3852,3852,0,0,0,0,1.0,1,1.0,1,1.0,1,0.5713634304039299,45
1509,3,3855,3855,0,0,0,0,1.0,1,1.0,1,1.0,1,0.6289337336672457,44
1510,3,3858,3858,0,0,0,0,1.0,1,1.0,1,1.0,1,0.6619318688980866,42
1511,1,3859,3859,0,0,0,0,1.0,1,1.0,1,1.0,1,0.669217855235471,40
1512,0,3859,3859,0,0,0,0,1.0,1,1.0,1,1.0,1,0.6917819500890348,39
1513,3,3862,3862,0,0,0,0,1.0,1,1.0,1,1.0,1,0.6581743875556045,39
1514,3,3865,3865,0,0,0,0,1.0,1,1.0,1,1.0,1,0.6624591414923785,38
1515,2,3867,3867,0,0,0,0,1.0,1,1.0,1,1.0,1,0.6742091297626305,39
1516,6,3873,3873,0,0,0,0,1.0,1,1.0,1,1.0,1,0.6223895529883701,39
1517,5,3878,3878,0,0,0,0,1.0,1,1.0,1,1.0,1,0.5817066182256676,39
1518,6,3884,3884,0,0,0,0,1.0,1,1.0,1,1.0,1,0.5747347305975087,39
1519,5,3889,3889,0,0,0,0,1.0,1,1.0,1,1.0,1,0.5976647278544419,39
1520,6,3895,3895,0,0,0,0,1.0,1,1.0,1,1.0,1,0.5676794361406542,39
1521,1,3896,3896,0,0,0,0,1.0,1,1.0,1,1.0,1,0.5768018039496677,40
1522,3,3899,3899,0,0,0,0,1.0,1,1.0,1,1.0,1,0.5622009017317809,40
1523,1,3900,3900,0,0,0,0,1.0,1,1.0,1,1.0,1,0.5847929554032709,41
1524,2,3902,3902,0,0,0,0,1.0,1,1.0,1,1.0,1,0.5726048652082244,42
1525,0,3902,3902,0,0,0,0,1.0,1,1.0,1,1.0,1,0.557828144393058,45
1526,1,3903,3903,0,0,0,0,1.0,1,1.0,1,1.0,1,0.542373859018773,46
1527,0,3903,3903,0,0,0,0,1.0,1,1.0,1,1.0,1,0.542373859018773,46
1528,0,3903,3903,0,0,0,0,1.0,1,1.0,1,1.0,1,0.5334317188294174,47
1529,0,3903,3903,0,0,0,0,1.0,1,1.0,1,1.0,1,0.5334317188294174,47
1530,1,3904,3904,0,0,0,0,1.0,1,1.0,1,1.0,1,0.5146835764230339,48
1531,0,3904,3904,0,0,0,0,1.0,1,1.0,1,1.0,1,0.5023916971594422,46
1532,2,3906,3906,0,0,0,0,1.0,1,1.0,1,1.0,1,0.5219797970115996,47
1533,1,3907,3907,0,0,0,0,1.0,1,1.0,1,1.0,1,0.5016223775341481,46
1534,2,3909,3909,0,0,0,0,1.0,1,1.0,1,1.0,1,0.5171528126322705,47
1535,1,3910,3910,0,0,0,0,1.0,1,1.0,1,1.0,1,0.5330193695835134,47
1536,1,3911,3911,0,0,0,0,1.0,1,1.0,1,1.0,1,0.5338940305295738,48
1537,0,3911,3911,0,0,0,0,1.0,1,1.0,1,1.0,1,0.5301244279727536,46
1538,3,3914,3914,0,0,0,0,1.0,1,1.0,1,1.0,1,0.5645830962281894,47
1539,3,3917,3917,0,0,0,0,1.0,1,1.0,1,1.0,1,0.5733961276143448,47
1540,3,3920,3920,0,0,0,0,1.0,1,1.0,1,1.0,1,0.6040225774493073,47
1541,5,3925,3925,0,0,0,0,1.0,1,1.0,1,1.0,1,0.5916725138124517,47
1542,2,3927,3927,0,0,0,0,1.0,1,1.0,1,1.0,1,0.6090032044084026,50
1543,5,3932,3932,0,0,0,0,1.0,1,1.0,1,1.0,1,0.6234054269720859,47
1544,3,3935,3935,0,0,0,0,1.0,1,1.0,1,1.0,1,0.6343178576575441,48
1545,6,3941,3941,0,0,0,0,1.0,1,1.0,1,1.0,1,0.6395164565288695,47
1546,6,3947,3947,0,0,0,0,1.0,1,1.0,1,1.0,1,0.6107118520859891,47
1547,6,3953,3953,0,0,0,0,1.0,1,1.0,1,1.0,1,0.6047827171822419,47
1548,5,3958,3958,0,0,0,0,1.0,1,1.0,1,1.0,1,0.5869429026973323,47
1549,9,3967,3967,0,0,0,0,1.0,1,1.0,1,1.0,1,0.6092648076608396,46
1550,4,3971,3971,0,0,0,0,1.0,1,1.0,1,1.0,1,0.6193541360072053,44
1551,10,3981,3981,0,0,0,0,1.0,1,1.0,1,1.0,1,0.5895128256962003,45
1552,3,3984,3984,0,0,0,0,1.0,1,1.0,1,1.0,1,0.6118298130345461,43
1553,7,3991,3991,0,0,0,0,1.0,1,1.0,1,1.0,1,0.5909945788647694,43
1554,5,3996,3996,0,0,0,0,1.0,1,1.0,1,1.0,1,0.5943957151583106,41
1555,3,3999,3999,0,0,0,0,1.0,1,1.0,1,1.0,1,0.5926346560578074,44
1556,4,4003,4003,0,0,0,0,1.0,1,1.0,1,1.0,1,0.6181807429694046,45
1557,2,4005,4005,0,0,0,0,1.0,1,1.0,1,1.0,1,0.5924428183167066,45
1558,1,4006,4006,0,0,0,0,1.0,1,1.0,1,1.0,1,0.6009040915369944,46
1559,1,4007,4007,0,0,0,0,1.0,1,1.0,1,1.0,1,0.5738387964774023,47
1560,3,4010,4010,0,0,0,0,1.0,1,1.0,1,1.0,1,0.5785250181551072,46
1561,0,4010,4010,0,0,0,0,1.0,1,1.0,1,1.0,1,0.5586435947043544,47
1562,3,4013,4013,0,0,0,0,1.0,1,1.0,1,1.0,1,0.5467934351778114,47
1563,3,4016,4016,0,0,0,0,1.0,1,1.0,1,1.0,1,0.5514846617918593,47
1564,2,4018,4018,0,0,0,0,1.0,1,1.0,1,1.0,1,0.5565540296636186,47
1565,1,4019,4019,0,0,0,0,1.0,1,1.0,1,1.0,1,0.5709804013060576,48
1566,0,4019,4019,0,0,0,0,1.0,1,1.0,1,1.0,1,0.5709804013060576,48
1567,0,4019,4019,0,0,0,0,1.0,1,1.0,1,1.0,1,0.5766322580038757,48
1568,1,4020,4020,0,0,0,0,1.0,1,1.0,1,1.0,1,0.5878509444844144,48
1569,3,4023,4023,0,0,0,0,1.0,1,1.0,1,1.0,1,0.613866678836495,45
1570,3,4026,4026,0,0,0,0,1.0,1,1.0,1,1.0,1,0.6164031656431145,44
1571,2,4028,4028,0,0,0,0,1.0,1,1.0,1,1.0,1,0.6359192366414885,42
1572,7,4035,4035,0,0,0,0,1.0,1,1.0,1,1.0,1,0.6181605870461486,43
1573,5,4040,4040,0,0,0,0,1.0,1,1.0,1,1.0,1,0.6301873159818554,43
1574,3,4043,4043,0,0,0,0,1.0,1,1.0,1,1.0,1,0.6120594606431544,42
1575,5,4048,4048,0,0,0,0,1.0,1,1.0,1,1.0,1,0.6240144530958298,43
1576,5,4053,4053,0,0,0,0,1.0,1,1.0,1,1.0,1,0.5669386808878482,41
1577,3,4056,4056,0,0,0,0,1.0,1,1.0,1,1.0,1,0.5738169808854255,40
1578,3,4059,4059,0,0,0,0,1.0,1,1.0,1,1.0,1,0.5484645583220699,40
1579,4,4063,4063,0,0,0,0,1.0,1,1.0,1,1.0,1,0.4889631410231837,40
1580,4,4067,4067,0,0,0,0,1.0,1,1.0,1,1.0,1,0.4786520485554162,40
1581,4,4071,4071,0,0,0,0,1.0,1,1.0,1,1.0,1,0.49134662122035583,40
1582,6,4077,4077,0,0,0,0,1.0,1,1.0,1,1.0,1,0.5242894949437992,40
1583,5,4082,4082,0,0,0,0,1.0,1,1.0,1,1.0,1,0.540233896194106,38
1584,4,4086,4086,0,0,0,0,1.0,1,1.0,1,1.0,1,0.5250024068758472,39
1585,6,4092,4092,0,0,0,0,1.0,1,1.0,1,1.0,1,0.47645366796868266,38
1586,4,4096,4096,0,0,0,0,1.0,1,1.0,1,1.0,1,0.46582283596552587,38
1587,5,4101,4101,0,0,0,0,1.0,1,1.0,1,1.0,1,0.4859926054168797,37
1588,5,4106,4106,0,0,0,0,1.0,1,1.0,1,1.0,1,0.5004235306645701,39
1589,1,4107,4107,0,0,0,0,1.0,1,1.0,1,1.0,1,0.5137772635668046,37
1590,1,4108,4108,0,0,0,0,1.0,1,1.0,1,1.0,1,0.5517234457463286,37
1591,2,4110,4110,0,0,0,0,1.0,1,1.0,1,1.0,1,0.5799552063989608,36
1592,1,4111,4111,0,0,0,0,1.0,1,1.0,1,1.0,1,0.5925738780203036,34
1593,1,4112,4112,0,0,0,0,1.0,1,1.0,1,1.0,1,0.6098274740131104,33
1594,0,4112,4112,0,0,0,0,1.0,1,1.0,1,1.0,1,0.6177570270607329,31
1595,3,4115,4115,0,0,0,0,1.0,1,1.0,1,1.0,1,0.59053584582236,34
1596,2,4117,4117,0,0,0,0,1.0,1,1.0,1,1.0,1,0.5854968960159024,33
1597,1,4118,4118,0,0,0,0,1.0,1,1.0,1,1.0,1,0.6024209555202839,33
1598,2,4120,4120,0,0,0,0,1.0,1,1.0,1,1.0,1,0.5915583370192995,33
1599,0,4120,4120,0,0,0,0,1.0,1,1.0,1,1.0,1,0.5915583370192995,33
1600,3,4123,4123,0,0,0,0,1.0,1,1.0,1,1.0,1,0.6210321108504752,34
1601,2,4125,4125,0,0,0,0,1.0,1,1.0,1,1.0,1,0.6261621005709598,35
1602,2,4127,4127,0,0,0,0,1.0,1,1.0,1,1.0,1,0.6088165501808257,36
1603,3,4130,4130,0,0,0,0,1.0,1,1.0,1,1.0,1,0.5808427825532488,38
1604,7,4137,4137,0,0,0,0,1.0,1,1.0,1,1.0,1,0.6310974406708688,38
1605,3,4140,4140,0,0,0,0,1.0,1,1.0,1,1.0,1,0.5887132041664561,38
1606,5,4145,4145,0,0,0,0,1.0,1,1.0,1,1.0,1,0.6054167255741594,39
1607,4,4149,4149,0,0,0,0,1.0,1,1.0,1,1.0,1,0.5604659275062148,37
1608,5,4154,4154,0,0,0,0,1.0,1,1.0,1,1.0,1,0.5543252151410359,36
1609,3,4157,4157,0,0,0,0,1.0,1,1.0,1,1.0,1,0.5543621062317804,34
1610,1,4158,4158,0,0,0,0,1.0,1,1.0,1,1.0,1,0.5142291152972215,34
1611,3,4161,4161,0,0,0,0,1.0,1,1.0,1,1.0,1,0.5103508214991892,35
1612,4,4165,4165,0,0,0,0,1.0,1,1.0,1,1.0,1,0.5355003710324858,33
1613,4,4169,4169,0,0,0,0,1.0,1,1.0,1,1.0,1,0.5513211557974509,34
1614,3,4172,4172,0,0,0,0,1.0,1,1.0,1,1.0,1,0.5526120856423871,35
1615,1,4173,4173,0,0,0,0,1.0,1,1.0,1,1.0,1,0.5410418813384321,35
1616,4,4177,4177,0,0,0,0,1.0,1,1.0,1,1.0,1,0.5236082377586302,37
1617,2,4179,4179,0,0,0,0,1.0,1,1.0,1,1.0,1,0.516221943235529,38
1618,3,4182,4182,0,0,0,0,1.0,1,1.0,1,1.0,1,0.47152078928756136,38
1619,3,4185,4185,0,0,0,0,1.0,1,1.0,1,1.0,1,0.45879640204892425,38
1620,2,4187,4187,0,0,0,0,1.0,1,1.0,1,1.0,1,0.4672176218188111,39
1621,1,4188,4188,0,0,0,0,1.0,1,1.0,1,1.0,1,0.45178428028585255,37
1622,3,4191,4191,0,0,0,0,1.0,1,1.0,1,1.0,1,0.5210656659494391,37
1623,3,4194,4194,0,0,0,0,1.0,1,1.0,1,1.0,1,0.5496361984687083,37
1624,2,4196,4196,0,0,0,0,1.0,1,1.0,1,1.0,1,0.5677026643000976,37
1625,4,4200,4200,0,0,0,0,1.0,1,1.0,1,1.0,1,0.5963510649226821,35
1626,0,4200,4200,0,0,0,0,1.0,1,1.0,1,1.0,1,0.5963510649226821,35
1627,2,4202,4202,0,0,0,0,1.0,1,1.0,1,1.0,1,0.5613201492608473,34
1628,3,4205,4205,0,0,0,0,1.0,1,1.0,1,1.0,1,0.5710876697043109,35
1629,1,4206,4206,0,0,0,0,1.0,1,1.0,1,1.0,1,0.5379827502385885,34
1630,2,4208,4208,0,0,0,0,1.0,1,1.0,1,1.0,1,0.5520233912539498,32
1631,3,4211,4211,0,0,0,0,1.0,1,1.0,1,1.0,1,0.5399221379229261,33
1632,2,4213,4213,0,0,0,0,1.0,1,1.0,1,1.0,1,0.5810436237762987,32
1633,4,4217,4217,0,0,0,0,1.0,1,1.0,1,1.0,1,0.6784333421128694,31
1634,3,4220,4220,0,0,0,0,1.0,1,1.0,1,1.0,1,0.6697961307556997,31
1635,0,4220,4220,0,0,0,0,1.0,1,1.0,1,1.0,1,0.6845060696206369,31
1636,1,4221,4221,0,0,0,0,1.0,1,1.0,1,1.0,1,0.6561981387806405,33
1637,1,4222,4222,0,0,0,0,1.0,1,1.0,1,1.0,1,0.664388820299291,33
1638,0,4222,4222,0,0,0,0,1.0,1,1.0,1,1.0,1,0.6394287984859636,36
1639,0,4222,4222,0,0,0,0,1.0,1,1.0,1,1.0,1,0.6394287984859636,36
1640,0,4222,4222,0,0,0,0,1.0,1,1.0,1,1.0,1,0.6394287984859636,36
1641,0,4222,4222,0,0,0,0,1.0,1,1.0,1,1.0,1,0.6251003312678657,38
1642,1,4223,4223,0,0,0,0,1.0,1,1.0,1,1.0,1,0.5994969219170191,37
1643,2,4225,4225,0,0,0,0,1.0,1,1.0,1,1.0,1,0.6096940457224433,37
1644,2,4227,4227,0,0,0,0,1.0,1,1.0,1,1.0,1,0.5899671185579953,38
1645,3,4230,4230,0,0,0,0,1.0,1,1.0,1,1.0,1,0.5905016719669384,36
1646,1,4231,4231,0,0,0,0,1.0,1,1.0,1,1.0,1,0.5820617911181972,37
1647,1,4232,4232,0,0,0,0,1.0,1,1.0,1,1.0,1,0.582541368422142,35
1648,0,4232,4232,0,0,0,0,1.0,1,1.0,1,1.0,1,0.5924423191150344,38
1649,1,4233,4233,0,0,0,0,1.0,1,1.0,1,1.0,1,0.5926776913366466,35
1650,0,4233,4233,0,0,0,0,1.0,1,1.0,1,1.0,1,0.606487197487547,34
1651,0,4233,4233,0,0,0,0,1.0,1,1.0,1,1.0,1,0.5992462905640124,32
1652,4,4237,4237,0,0,0,0,1.0,1,1.0,1,1.0,1,0.5489115920041633,33
1653,3,4240,4240,0,0,0,0,1.0,1,1.0,1,1.0,1,0.5515186793441869,33
1654,2,4242,4242,0,0,0,0,1.0,1,1.0,1,1.0,1,0.5739178463978202,34
1655,8,4250,4250,0,0,0,0,1.0,1,1.0,1,1.0,1,0.5535341755617831,35
1656,4,4254,4254,0,0,0,0,1.0,1,1.0,1,1.0,1,0.5420956483300725,35
1657,6,4260,4260,0,0,0,0,1.0,1,1.0,1,1.0,1,0.5316047513563162,36
1658,5,4265,4265,0,0,0,0,1.0,1,1.0,1,1.0,1,0.49523888668945054,36
1659,2,4267,4267,0,0,0,0,1.0,1,1.0,1,1.0,1,0.48492945130219156,36
1660,3,4270,4270,0,0,0,0,1.0,1,1.0,1,1.0,1,0.5116797971812416,38
1661,3,4273,4273,0,0,0,0,1.0,1,1.0,1,1.0,1,0.5144557623750999,38
1662,3,4276,4276,0,0,0,0,1.0,1,1.0,1,1.0,1,0.5596987386364001,39
1663,2,4278,4278,0,0,0,0,1.0,1,1.0,1,1.0,1,0.541594932169666,40
1664,6,4284,4284,0,0,0,0,1.0,1,1.0,1,1.0,1,0.5926060956148926,39
1665,5,4289,4289,0,0,0,0,1.0,1,1.0,1,1.0,1,0.5972398991119726,40
1666,2,4291,4291,0,0,0,0,1.0,1,1.0,1,1.0,1,0.5698358197496732,40
1667,4,4295,4295,0,0,0,0,1.0,1,1.0,1,1.0,1,0.5652426719422812,40
1668,2,4297,4297,0,0,0,0,1.0,1,1.0,1,1.0,1,0.5210615343623438,41
1669,3,4300,4300,0,0,0,0,1.0,1,1.0,1,1.0,1,0.49686835769047333,40
1670,2,4302,4302,0,0,0,0,1.0,1,1.0,1,1.0,1,0.5155525305757311,40
1671,3,4305,4305,0,0,0,0,1.0,1,1.0,1,1.0,1,0.5729730858568721,41
1672,2,4307,4307,0,0,0,0,1.0,1,1.0,1,1.0,1,0.5611119303763689,40
1673,1,4308,4308,0,0,0,0,1.0,1,1.0,1,1.0,1,0.5459796721256194,39
1674,0,4308,4308,0,0,0,0,1.0,1,1.0,1,1.0,1,0.555754894569903,40
1675,1,4309,4309,0,0,0,0,1.0,1,1.0,1,1.0,1,0.5789548023528435,38
1676,0,4309,4309,0,0,0,0,1.0,1,1.0,1,1.0,1,0.5846357345338454,39
1677,3,4312,4312,0,0,0,0,1.0,1,1.0,1,1.0,1,0.5920493597225142,39
1678,4,4316,4316,0,0,0,0,1.0,1,1.0,1,1.0,1,0.584102380095879,39
1679,7,4323,4323,0,0,0,0,1.0,1,1.0,1,1.0,1,0.6163560146048855,39
1680,4,4327,4327,0,0,0,0,1.0,1,1.0,1,1.0,1,0.598440767627277,41
1681,8,4335,4335,0,0,0,0,1.0,1,1.0,1,1.0,1,0.5505337680542147,41
1682,5,4340,4340,0,0,0,0,1.0,1,1.0,1,1.0,1,0.5782931869640837,43
1683,7,4347,4347,0,0,0,0,1.0,1,1.0,1,1.0,1,0.5471093477038601,43
1684,3,4350,4350,0,0,0,0,1.0,1,1.0,1,1.0,1,0.5112776472686237,42
1685,3,4353,4353,0,0,0,0,1.0,1,1.0,1,1.0,1,0.48452117774621173,41
1686,7,4360,4360,0,0,0,0,1.0,1,1.0,1,1.0,1,0.49985504657161,41
1687,0,4360,4360,0,0,0,0,1.0,1,1.0,1,1.0,1,0.4898223002651043,40
1688,2,4362,4362,0,0,0,0,1.0,1,1.0,1,1.0,1,0.4778876917119031,39
1689,2,4364,4364,0,0,0,0,1.0,1,1.0,1,1.0,1,0.49153752057516403,38
1690,1,4365,4365,0,0,0,0,1.0,1,1.0,1,1.0,1,0.49511299888293275,38
1691,1,4366,4366,0,0,0,0,1.0,1,1.0,1,1.0,1,0.49966956691518216,36
1692,0,4366,4366,0,0,0,0,1.0,1,1.0,1,1.0,1,0.469550035235815,36
1693,3,4369,4369,0,0,0,0,1.0,1,1.0,1,1.0,1,0.48612308962296374,35
1694,1,4370,4370,0,0,0,0,1.0,1,1.0,1,1.0,1,0.4938094312109692,33
1695,3,4373,4373,0,0,0,0,1.0,1,1.0,1,1.0,1,0.541315225627168,34
1696,3,4376,4376,0,0,0,0,1.0,1,1.0,1,1.0,1,0.5326886183113324,35
1697,1,4377,4377,0,0,0,0,1.0,1,1.0,1,1.0,1,0.5374934462444068,36
1698,3,4380,4380,0,0,0,0,1.0,1,1.0,1,1.0,1,0.5260899140419794,38
1699,3,4383,4383,0,0,0,0,1.0,1,1.0,1,1.0,1,0.5403476907114291,38
1700,4,4387,4387,0,0,0,0,1.0,1,1.0,1,1.0,1,0.5290332889602533,39
1701,2,4389,4389,0,0,0,0,1.0,1,1.0,1,1.0,1,0.5171255000798961,40
1702,2,4391,4391,0,0,0,0,1.0,1,1.0,1,1.0,1,0.5020968271893209,41
1703,2,4393,4393,0,0,0,0,1.0,1,1.0,1,1.0,1,0.537203287090706,41
1704,4,4397,4397,0,0,0,0,1.0,1,1.0,1,1.0,1,0.5109358750805009,41
1705,1,4398,4398,0,0,0,0,1.0,1,1.0,1,1.0,1,0.5268707937316597,40
1706,6,4404,4404,0,0,0,0,1.0,1,1.0,1,1.0,1,0.6235084038267731,40
1707,1,4405,4405,0,0,0,0,1.0,1,1.0,1,1.0,1,0.6557485216544011,39
1708,4,4409,4409,0,0,0,0,1.0,1,1.0,1,1.0,1,0.6249552240166375,39
1709,2,4411,4411,0,0,0,0,1.0,1,1.0,1,1.0,1,0.6347822897814058,38
1710,4,4415,4415,0,0,0,0,1.0,1,1.0,1,1.0,1,0.6104559519291441,39
1711,4,4419,4419,0,0,0,0,1.0,1,1.0,1,1.0,1,0.6006002064102133,38
1712,2,4421,4421,0,0,0,0,1.0,1,1.0,1,1.0,1,0.6283442083796178,38
1713,2,4423,4423,0,0,0,0,1.0,1,1.0,1,1.0,1,0.6585991246410118,37
1714,3,4426,4426,0,0,0,0,1.0,1,1.0,1,1.0,1,0.6840076124440027,38
1715,0,4426,4426,0,0,0,0,1.0,1,1.0,1,1.0,1,0.6780138968345819,40
1716,0,4426,4426,0,0,0,0,1.0,1,1.0,1,1.0,1,0.6874954999689604,39
1717,2,4428,4428,0,0,0,0,1.0,1,1.0,1,1.0,1,0.7120019143318366,38
1718,0,4428,4428,0,0,0,0,1.0,1,1.0,1,1.0,1,0.7294048106620132,38
1719,0,4428,4428,0,0,0,0,1.0,1,1.0,1,1.0,1,0.7294048106620132,38
1720,1,4429,4429,0,0,0,0,1.0,1,1.0,1,1.0,1,0.7005992134978686,41
1721,0,4429,4429,0,0,0,0,1.0,1,1.0,1,1.0,1,0.6920509747051102,39
1722,1,4430,4430,0,0,0,0,1.0,1,1.0,1,1.0,1,0.6781575606814713,40
1723,1,4431,4431,0,0,0,0,1.0,1,1.0,1,1.0,1,0.6648034889179829,38
1724,2,4433,4433,0,0,0,0,1.0,1,1.0,1,1.0,1,0.6435891994430664,37
1725,1,4434,4434,0,0,0,0,1.0,1,1.0,1,1.0,1,0.6425244250102677,38
1726,1,4435,4435,0,0,0,0,1.0,1,1.0,1,1.0,1,0.6210650780881183,37
1727,3,4438,4438,0,0,0,0,1.0,1,1.0,1,1.0,1,0.6072979609210827,37
1728,1,4439,4439,0,0,0,0,1.0,1,1.0,1,1.0,1,0.597283708057911,35
1729,4,4443,4443,0,0,0,0,1.0,1,1.0,1,1.0,1,0.5751754204048134,37
1730,0,4443,4443,0,0,0,0,1.0,1,1.0,1,1.0,1,0.5935402579276399,37
1731,5,4448,4448,0,0,0,0,1.0,1,1.0,1,1.0,1,0.5938509646854723,37
1732,3,4451,4451,0,0,0,0,1.0,1,1.0,1,1.0,1,0.6063935253259564,37
1733,4,4455,4455,0,0,0,0,1.0,1,1.0,1,1.0,1,0.5867550196971295,36
1734,6,4461,4461,0,0,0,0,1.0,1,1.0,1,1.0,1,0.6598585892839302,35
1735,5,4466,4466,0,0,0,0,1.0,1,1.0,1,1.0,1,0.6324204262067838,34
1736,9,4475,4475,0,0,0,0,1.0,1,1.0,1,1.0,1,0.6121538589280103,35
1737,3,4478,4478,0,0,0,0,1.0,1,1.0,1,1.0,1,0.5903307642762804,36
1738,4,4482,4482,0,0,0,0,1.0,1,1.0,1,1.0,1,0.5647167460369813,37
1739,1,4483,4483,0,0,0,0,1.0,1,1.0,1,1.0,1,0.5528135259885911,38
1740,5,4488,4488,0,0,0,0,1.0,1,1.0,1,1.0,1,0.5351724959396577,37
1741,1,4489,4489,0,0,0,0,1.0,1,1.0,1,1.0,1,0.5492204155919153,38
1742,3,4492,4492,0,0,0,0,1.0,1,1.0,1,1.0,1,0.5769953138025973,39
1743,4,4496,4496,0,0,0,0,1.0,1,1.0,1,1.0,1,0.6292286856272448,37
1744,2,4498,4498,0,0,0,0,1.0,1,1.0,1,1.0,1,0.6277698986716737,38
1745,0,4498,4498,0,0,0,0,1.0,1,1.0,1,1.0,1,0.6509371019485309,37
1746,2,4500,4500,0,0,0,0,1.0,1,1.0,1,1.0,1,0.6256291806415969,38
1747,0,4500,4500,0,0,0,0,1.0,1,1.0,1,1.0,1,0.6294240085612309,38
1748,1,4501,4501,0,0,0,0,1.0,1,1.0,1,1.0,1,0.6189240504405266,38
1749,0,4501,4501,0,0,0,0,1.0,1,1.0,1,1.0,1,0.6368244411289593,37
1750,2,4503,4503,0,0,0,0,1.0,1,1.0,1,1.0,1,0.6223528709912556,39
1751,1,4504,4504,0,0,0,0,1.0,1,1.0,1,1.0,1,0.6051971778348589,38
1752,1,4505,4505,0,0,0,0,1.0,1,1.0,1,1.0,1,0.6113112084977881,39
1753,1,4506,4506,0,0,0,0,1.0,1,1.0,1,1.0,1,0.5842905754916337,40
1754,2,4508,4508,0,0,0,0,1.0,1,1.0,1,1.0,1,0.5995078194766532,41
1755,7,4515,4515,0,0,0,0,1.0,1,1.0,1,1.0,1,0.5859514923008295,41
1756,3,4518,4518,0,0,0,0,1.0,1,1.0,1,1.0,1,0.5514168576669478,42
1757,5,4523,4523,0,0,0,0,1.0,1,1.0,1,1.0,1,0.5609391125551345,42
1758,6,4529,4529,0,0,0,0,1.0,1,1.0,1,1.0,1,0.5785263033829734,42
1759,6,4535,4535,0,0,0,0,1.0,1,1.0,1,1.0,1,0.578264099164702,39
1760,6,4541,4541,0,0,0,0,1.0,1,1.0,1,1.0,1,0.6131773441489038,39
1761,5,4546,4546,0,0,0,0,1.0,1,1.0,1,1.0,1,0.5667517422951713,38
1762,3,4549,4549,0,0,0,0,1.0,1,1.0,1,1.0,1,0.5476564057273623,37
1763,3,4552,4552,0,0,0,0,1.0,1,1.0,1,1.0,1,0.623545275270184,37
1764,2,4554,4554,0,0,0,0,1.0,1,1.0,1,1.0,1,0.5789278746100261,36
1765,1,4555,4555,0,0,0,0,1.0,1,1.0,1,1.0,1,0.5766560768068032,37
1766,2,4557,4557,0,0,0,0,1.0,1,1.0,1,1.0,1,0.5440536647181606,36
1767,3,4560,4560,0,0,0,0,1.0,1,1.0,1,1.0,1,0.5641556088955361,36
1768,1,4561,4561,0,0,0,0,1.0,1,1.0,1,1.0,1,0.5862803007509246,36
1769,2,4563,4563,0,0,0,0,1.0,1,1.0,1,1.0,1,0.6049700061716601,38
1770,1,4564,4564,0,0,0,0,1.0,1,1.0,1,1.0,1,0.6006237373488749,38
1771,2,4566,4566,0,0,0,0,1.0,1,1.0,1,1.0,1,0.5786673138349984,38
1772,1,4567,4567,0,0,0,0,1.0,1,1.0,1,1.0,1,0.5823723215308487,40
1773,1,4568,4568,0,0,0,0,1.0,1,1.0,1,1.0,1,0.5824120376987363,40
1774,0,4568,4568,0,0,0,0,1.0,1,1.0,1,1.0,1,0.5824120376987363,40
1775,2,4570,4570,0,0,0,0,1.0,1,1.0,1,1.0,1,0.5720657720917068,41
1776,1,4571,4571,0,0,0,0,1.0,1,1.0,1,1.0,1,0.5252687796722828,43
1777,1,4572,4572,0,0,0,0,1.0,1,1.0,1,1.0,1,0.5157212488671064,44
1778,2,4574,4574,0,0,0,0,1.0,1,1.0,1,1.0,1,0.5305818892885124,44
1779,7,4581,4581,0,0,0,0,1.0,1,1.0,1,1.0,1,0.4802482796613119,44
1780,4,4585,4585,0,0,0,0,1.0,1,1.0,1,1.0,1,0.48027707948773574,46
1781,2,4587,4587,0,0,0,0,1.0,1,1.0,1,1.0,1,0.4693643206473279,46
1782,8,4595,4595,0,0,0,0,1.0,1,1.0,1,1.0,1,0.43950891536890924,45
1783,4,4599,4599,0,0,0,0,1.0,1,1.0,1,1.0,1,0.44281094108618796,44
1784,2,4601,4601,0,0,0,0,1.0,1,1.0,1,1.0,1,0.45124434047983475,44
1785,3,4604,4604,0,0,0,0,1.0,1,1.0,1,1.0,1,0.48058806198602444,42
1786,9,4613,4613,0,0,0,0,1.0,1,1.0,1,1.0,1,0.49969907829484705,42
1787,3,4616,4616,0,0,0,0,1.0,1,1.0,1,1.0,1,0.5423534510104739,41
1788,5,4621,4621,0,0,0,0,1.0,1,1.0,1,1.0,1,0.5589194516421587,41
1789,5,4626,4626,0,0,0,0,1.0,1,1.0,1,1.0,1,0.5815342281076807,41
1790,3,4629,4629,0,0,0,0,1.0,1,1.0,1,1.0,1,0.5632328390363834,41
1791,7,4636,4636,0,0,0,0,1.0,1,1.0,1,1.0,1,0.6072994826370038,41
1792,3,4639,4639,0,0,0,0,1.0,1,1.0,1,1.0,1,0.6006762856151378,43
1793,3,4642,4642,0,0,0,0,1.0,1,1.0,1,1.0,1,0.5444555812749066,43
1794,2,4644,4644,0,0,0,0,1.0,1,1.0,1,1.0,1,0.5757231288713855,41
1795,4,4648,4648,0,0,0,0,1.0,1,1.0,1,1.0,1,0.5488270793265682,41
1796,5,4653,4653,0,0,0,0,1.0,1,1.0,1,1.0,1,0.5869993857813581,40
1797,1,4654,4654,0,0,0,0,1.0,1,1.0,1,1.0,1,0.5783084882448764,38
1798,2,4656,4656,0,0,0,0,1.0,1,1.0,1,1.0,1,0.5746343227971986,38
1799,0,4656,4656,0,0,0,0,1.0,1,1.0,1,1.0,1,0.5650666311878914,37
1800,1,4657,4657,0,0,0,0,1.0,1,1.0,1,1.0,1,0.5967306965767925,35
1801,2,4659,4659,0,0,0,0,1.0,1,1.0,1,1.0,1,0.5833180022234933,34
1802,2,4661,4661,0,0,0,0,1.0,1,1.0,1,1.0,1,0.5557261105878467,33
1803,3,4664,4664,0,0,0,0,1.0,1,1.0,1,1.0,1,0.5850569653745182,33
1804,2,4666,4666,0,0,0,0,1.0,1,1.0,1,1.0,1,0.592625728938398,33
1805,3,4669,4669,0,0,0,0,1.0,1,1.0,1,1.0,1,0.5751501737786472,35
1806,4,4673,4673,0,0,0,0,1.0,1,1.0,1,1.0,1,0.5819815907467011,36
1807,0,4673,4673,0,0,0,0,1.0,1,1.0,1,1.0,1,0.5463790026205066,35
1808,4,4677,4677,0,0,0,0,1.0,1,1.0,1,1.0,1,0.5006219991325184,37
1809,0,4677,4677,0,0,0,0,1.0,1,1.0,1,1.0,1,0.49575168834138583,35
1810,5,4682,4682,0,0,0,0,1.0,1,1.0,1,1.0,1,0.4421008136593417,36
1811,3,4685,4685,0,0,0,0,1.0,1,1.0,1,1.0,1,0.43202986434792723,34
1812,5,4690,4690,0,0,0,0,1.0,1,1.0,1,1.0,1,0.5041909588084073,36
1813,1,4691,4691,0,0,0,0,1.0,1,1.0,1,1.0,1,0.512032561082164,35
1814,4,4695,4695,0,0,0,0,1.0,1,1.0,1,1.0,1,0.5417621706754727,36
1815,3,4698,4698,0,0,0,0,1.0,1,1.0,1,1.0,1,0.588632183923295,35
1816,0,4698,4698,0,0,0,0,1.0,1,1.0,1,1.0,1,0.588632183923295,35
1817,6,4704,4704,0,0,0,0,1.0,1,1.0,1,1.0,1,0.6034213840201615,35
1818,5,4709,4709,0,0,0,0,1.0,1,1.0,1,1.0,1,0.6026823663725422,36
1819,6,4715,4715,0,0,0,0,1.0,1,1.0,1,1.0,1,0.5203025694306207,37
1820,1,4716,4716,0,0,0,0,1.0,1,1.0,1,1.0,1,0.502278324729663,37
1821,3,4719,4719,0,0,0,0,1.0,1,1.0,1,1.0,1,0.47015237156907,38
1822,4,4723,4723,0,0,0,0,1.0,1,1.0,1,1.0,1,0.4513117295970041,37
1823,4,4727,4727,0,0,0,0,1.0,1,1.0,1,1.0,1,0.45810457297224694,36
1824,3,4730,4730,0,0,0,0,1.0,1,1.0,1,1.0,1,0.47431734689545524,36
1825,1,4731,4731,0,0,0,0,1.0,1,1.0,1,1.0,1,0.4464093002810697,34
1826,5,4736,4736,0,0,0,0,1.0,1,1.0,1,1.0,1,0.4891789081007077,35
1827,0,4736,4736,0,0,0,0,1.0,1,1.0,1,1.0,1,0.4909010792212419,34
1828,4,4740,4740,0,0,0,0,1.0,1,1.0,1,1.0,1,0.452732380231305,33
1829,4,4744,4744,0,0,0,0,1.0,1,1.0,1,1.0,1,0.42689262125213806,31
1830,3,4747,4747,0,0,0,0,1.0,1,1.0,1,1.0,1,0.4931884970136855,31
1831,3,4750,4750,0,0,0,0,1.0,1,1.0,1,1.0,1,0.5497330379841832,30
1832,5,4755,4755,0,0,0,0,1.0,1,1.0,1,1.0,1,0.5137983614918121,29
1833,2,4757,4757,0,0,0,0,1.0,1,1.0,1,1.0,1,0.5022466191094064,28
1834,2,4759,4759,0,0,0,0,1.0,1,1.0,1,1.0,1,0.5444467413984646,27
1835,2,4761,4761,0,0,0,0,1.0,1,1.0,1,1.0,1,0.5497397393354249,26
1836,1,4762,4762,0,0,0,0,1.0,1,1.0,1,1.0,1,0.5801055670601308,26
1837,1,4763,4763,0,0,0,0,1.0,1,1.0,1,1.0,1,0.5447638789298274,25
1838,1,4764,4764,0,0,0,0,1.0,1,1.0,1,1.0,1,0.5731858131613603,25
1839,2,4766,4766,0,0,0,0,1.0,1,1.0,1,1.0,1,0.6289434738285579,24
1840,0,4766,4766,0,0,0,0,1.0,1,1.0,1,1.0,1,0.6148956029079811,23
1841,1,4767,4767,0,0,0,0,1.0,1,1.0,1,1.0,1,0.6432242790644244,22
1842,1,4768,4768,0,0,0,0,1.0,1,1.0,1,1.0,1,0.6379250686002497,23
1843,1,4769,4769,0,0,0,0,1.0,1,1.0,1,1.0,1,0.6549037685188954,23
1844,2,4771,4771,0,0,0,0,1.0,1,1.0,1,1.0,1,0.6297459144846419,23
1845,2,4773,4773,0,0,0,0,1.0,1,1.0,1,1.0,1,0.6250863983449355,23
1846,3,4776,4776,0,0,0,0,1.0,1,1.0,1,1.0,1,0.5273561975371399,23
1847,0,4776,4776,0,0,0,0,1.0,1,1.0,1,1.0,1,0.5325732022210203,24
1848,0,4776,4776,0,0,0,0,1.0,1,1.0,1,1.0,1,0.5325732022210203,24
1849,0,4776,4776,0,0,0,0,1.0,1,1.0,1,1.0,1,0.5456484612229117,25
1850,1,4777,4777,0,0,0,0,1.0,1,1.0,1,1.0,1,0.5872251380304767,25
1851,0,4777,4777,0,0,0,0,1.0,1,1.0,1,1.0,1,0.5872251380304767,25
1852,2,4779,4779,0,0,0,0,1.0,1,1.0,1,1.0,1,0.6026619642184172,25
1853,2,4781,4781,0,0,0,0,1.0,1,1.0,1,1.0,1,0.5688154338152206,25
1854,1,4782,4782,0,0,0,0,1.0,1,1.0,1,1.0,1,0.5799119895783421,25
1855,5,4787,4787,0,0,0,0,1.0,1,1.0,1,1.0,1,0.6023763713995822,26
1856,3,4790,4790,0,0,0,0,1.0,1,1.0,1,1.0,1,0.5740363171094216,27
1857,4,4794,4794,0,0,0,0,1.0,1,1.0,1,1.0,1,0.5635116917641966,28
1858,1,4795,4795,0,0,0,0,1.0,1,1.0,1,1.0,1,0.5563545082922954,28
1859,3,4798,4798,0,0,0,0,1.0,1,1.0,1,1.0,1,0.593960403586457,28
1860,3,4801,4801,0,0,0,0,1.0,1,1.0,1,1.0,1,0.6291097176746161,28
1861,0,4801,4801,0,0,0,0,1.0,1,1.0,1,1.0,1,0.6291097176746161,28
1862,1,4802,4802,0,0,0,0,1.0,1,1.0,1,1.0,1,0.6652581317133144,28
1863,2,4804,4804,0,0,0,0,1.0,1,1.0,1,1.0,1,0.6240795107391341,29
1864,1,4805,4805,0,0,0,0,1.0,1,1.0,1,1.0,1,0.6522526629154982,27
1865,2,4807,4807,0,0,0,0,1.0,1,1.0,1,1.0,1,0.6562130957634191,26
1866,0,4807,4807,0,0,0,0,1.0,1,1.0,1,1.0,1,0.6562130957634191,26
1867,1,4808,4808,0,0,0,0,1.0,1,1.0,1,1.0,1,0.6902161849097103,26
1868,0,4808,4808,0,0,0,0,1.0,1,1.0,1,1.0,1,0.6902161849097103,26
1869,1,4809,4809,0,0,0,0,1.0,1,1.0,1,1.0,1,0.711340501845337,26
1870,0,4809,4809,0,0,0,0,1.0,1,1.0,1,1.0,1,0.7098140415222025,27
1871,0,4809,4809,0,0,0,0,1.0,1,1.0,1,1.0,1,0.7098140415222025,27
1872,1,4810,4810,0,0,0,0,1.0,1,1.0,1,1.0,1,0.6985606737245245,25
1873,0,4810,4810,0,0,0,0,1.0,1,1.0,1,1.0,1,0.6985606737245245,25
1874,1,4811,4811,0,0,0,0,1.0,1,1.0,1,1.0,1,0.719001644717731,25
1875,0,4811,4811,0,0,0,0,1.0,1,1.0,1,1.0,1,0.719001644717731,25
1876,1,4812,4812,0,0,0,0,1.0,1,1.0,1,1.0,1,0.6895309798825238,26
1877,3,4815,4815,0,0,0,0,1.0,1,1.0,1,1.0,1,0.7182992081693007,27
1878,1,4816,4816,0,0,0,0,1.0,1,1.0,1,1.0,1,0.6769184195828857,28
1879,0,4816,4816,0,0,0,0,1.0,1,1.0,1,1.0,1,0.6712712889622963,29
1880,3,4819,4819,0,0,0,0,1.0,1,1.0,1,1.0,1,0.6687707225179441,29
1881,0,4819,4819,0,0,0,0,1.0,1,1.0,1,1.0,1,0.6687707225179441,29
1882,1,4820,4820,0,0,0,0,1.0,1,1.0,1,1.0,1,0.7187445919819477,28
1883,3,4823,4823,0,0,0,0,1.0,1,1.0,1,1.0,1,0.7410054385971215,28
1884,0,4823,4823,0,0,0,0,1.0,1,1.0,1,1.0,1,0.7410054385971215,28
1885,2,4825,4825,0,0,0,0,1.0,1,1.0,1,1.0,1,0.7669742374210649,28
1886,1,4826,4826,0,0,0,0,1.0,1,1.0,1,1.0,1,0.7575425926243752,29
1887,0,4826,4826,0,0,0,0,1.0,1,1.0,1,1.0,1,0.7575425926243752,29
1888,1,4827,4827,0,0,0,0,1.0,1,1.0,1,1.0,1,0.731663907288978,31
1889,0,4827,4827,0,0,0,0,1.0,1,1.0,1,1.0,1,0.731663907288978,31
1890,1,4828,4828,0,0,0,0,1.0,1,1.0,1,1.0,1,0.7203211218363923,31
1891,1,4829,4829,0,0,0,0,1.0,1,1.0,1,1.0,1,0.7398104803259296,32
1892,0,4829,4829,0,0,0,0,1.0,1,1.0,1,1.0,1,0.7398104803259296,32
1893,0,4829,4829,0,0,0,0,1.0,1,1.0,1,1.0,1,0.7398104803259296,32
1894,1,4830,4830,0,0,0,0,1.0,1,1.0,1,1.0,1,0.7138907539142395,33
1895,1,4831,4831,0,0,0,0,1.0,1,1.0,1,1.0,1,0.6791130069959976,35
1896,0,4831,4831,0,0,0,0,1.0,1,1.0,1,1.0,1,0.6846090815503039,34
1897,1,4832,4832,0,0,0,0,1.0,1,1.0,1,1.0,1,0.7026019116510789,34
1898,0,4832,4832,0,0,0,0,1.0,1,1.0,1,1.0,1,0.7026019116510789,34
1899,0,4832,4832,0,0,0,0,1.0,1,1.0,1,1.0,1,0.7026019116510789,34
1900,1,4833,4833,0,0,0,0,1.0,1,1.0,1,1.0,1,0.6843014457104007,35
1901,0,4833,4833,0,0,0,0,1.0,1,1.0,1,1.0,1,0.6843014457104007,35
1902,0,4833,4833,0,0,0,0,1.0,1,1.0,1,1.0,1,0.6843014457104007,35
1903,1,4834,4834,0,0,0,0,1.0,1,1.0,1,1.0,1,0.7031684019198824,35
1904,0,4834,4834,0,0,0,0,1.0,1,1.0,1,1.0,1,0.7031684019198824,35
1905,0,4834,4834,0,0,0,0,1.0,1,1.0,1,1.0,1,0.6695121464570319,37
1906,0,4834,4834,0,0,0,0,1.0,1,1.0,1,1.0,1,0.6695121464570319,37
1907,0,4834,4834,0,0,0,0,1.0,1,1.0,1,1.0,1,0.6644832189577623,39
1908,3,4837,4837,0,0,0,0,1.0,1,1.0,1,1.0,1,0.636873874064668,39
1909,2,4839,4839,0,0,0,0,1.0,1,1.0,1,1.0,1,0.6133211125260036,41
1910,5,4844,4844,0,0,0,0,1.0,1,1.0,1,1.0,1,0.5761482185487746,41
1911,3,4847,4847,0,0,0,0,1.0,1,1.0,1,1.0,1,0.5837568351769159,40
1912,6,4853,4853,0,0,0,0,1.0,1,1.0,1,1.0,1,0.5986265137265537,39
1913,4,4857,4857,0,0,0,0,1.0,1,1.0,1,1.0,1,0.5713804198945611,40
1914,5,4862,4862,0,0,0,0,1.0,1,1.0,1,1.0,1,0.5759927841464455,41
1915,1,4863,4863,0,0,0,0,1.0,1,1.0,1,1.0,1,0.5787293679297907,42
1916,2,4865,4865,0,0,0,0,1.0,1,1.0,1,1.0,1,0.5513208062876198,42
1917,2,4867,4867,0,0,0,0,1.0,1,1.0,1,1.0,1,0.5610316196329679,41
1918,2,4869,4869,0,0,0,0,1.0,1,1.0,1,1.0,1,0.5992110817084197,38
1919,1,4870,4870,0,0,0,0,1.0,1,1.0,1,1.0,1,0.598966161330373,38
1920,3,4873,4873,0,0,0,0,1.0,1,1.0,1,1.0,1,0.6368689326993177,38
1921,1,4874,4874,0,0,0,0,1.0,1,1.0,1,1.0,1,0.6306320921315727,39
1922,3,4877,4877,0,0,0,0,1.0,1,1.0,1,1.0,1,0.6083015880111176,40
1923,5,4882,4882,0,0,0,0,1.0,1,1.0,1,1.0,1,0.5940210014646973,41
1924,2,4884,4884,0,0,0,0,1.0,1,1.0,1,1.0,1,0.5738504377029017,41
1925,2,4886,4886,0,0,0,0,1.0,1,1.0,1,1.0,1,0.5922095148282319,41
1926,2,4888,4888,0,0,0,0,1.0,1,1.0,1,1.0,1,0.5886687928974874,41
1927,2,4890,4890,0,0,0,0,1.0,1,1.0,1,1.0,1,0.5814246408750788,41
1928,2,4892,4892,0,0,0,0,1.0,1,1.0,1,1.0,1,0.5713221357062866,42
1929,2,4894,4894,0,0,0,0,1.0,1,1.0,1,1.0,1,0.5759484182437657,41
1930,2,4896,4896,0,0,0,0,1.0,1,1.0,1,1.0,1,0.573328507828275,41
1931,1,4897,4897,0,0,0,0,1.0,1,1.0,1,1.0,1,0.5945515060219134,41
1932,0,4897,4897,0,0,0,0,1.0,1,1.0,1,1.0,1,0.5945515060219134,41
1933,2,4899,4899,0,0,0,0,1.0,1,1.0,1,1.0,1,0.58408258542234,43
1934,1,4900,4900,0,0,0,0,1.0,1,1.0,1,1.0,1,0.6087920947827291,44
1935,1,4901,4901,0,0,0,0,1.0,1,1.0,1,1.0,1,0.5754202063661906,45
1936,1,4902,4902,0,0,0,0,1.0,1,1.0,1,1.0,1,0.5333236639272817,48
1937,1,4903,4903,0,0,0,0,1.0,1,1.0,1,1.0,1,0.5276821304648169,48
1938,2,4905,4905,0,0,0,0,1.0,1,1.0,1,1.0,1,0.5120551042014304,48
1939,3,4908,4908,0,0,0,0,1.0,1,1.0,1,1.0,1,0.49165866905970274,48
1940,5,4913,4913,0,0,0,0,1.0,1,1.0,1,1.0,1,0.469234856000588,48
1941,2,4915,4915,0,0,0,0,1.0,1,1.0,1,1.0,1,0.4681382415390676,48
1942,2,4917,4917,0,0,0,0,1.0,1,1.0,1,1.0,1,0.46679245997175445,49
1943,1,4918,4918,0,0,0,0,1.0,1,1.0,1,1.0,1,0.4961609386642927,48
1944,6,4924,4924,0,0,0,0,1.0,1,1.0,1,1.0,1,0.5343606456407712,47
1945,4,4928,4928,0,0,0,0,1.0,1,1.0,1,1.0,1,0.5488060145144348,46
1946,2,4930,4930,0,0,0,0,1.0,1,1.0,1,1.0,1,0.5579204196202769,46
1947,2,4932,4932,0,0,0,0,1.0,1,1.0,1,1.0,1,0.5974958234071566,45
1948,1,4933,4933,0,0,0,0,1.0,1,1.0,1,1.0,1,0.5919138198622991,46
1949,3,4936,4936,0,0,0,0,1.0,1,1.0,1,1.0,1,0.6372648789664975,42
1950,1,4937,4937,0,0,0,0,1.0,1,1.0,1,1.0,1,0.6491527045117882,40
1951,1,4938,4938,0,0,0,0,1.0,1,1.0,1,1.0,1,0.6334435534700353,39
1952,1,4939,4939,0,0,0,0,1.0,1,1.0,1,1.0,1,0.6228142206285886,35
1953,4,4943,4943,0,0,0,0,1.0,1,1.0,1,1.0,1,0.6137805518577293,36
1954,4,4947,4947,0,0,0,0,1.0,1,1.0,1,1.0,1,0.6411649743875868,34
1955,5,4952,4952,0,0,0,0,1.0,1,1.0,1,1.0,1,0.6266859182363191,35
1956,8,4960,4960,0,0,0,0,1.0,1,1.0,1,1.0,1,0.6094877397483883,37
1957,3,4963,4963,0,0,0,0,1.0,1,1.0,1,1.0,1,0.6167120649170292,37
1958,4,4967,4967,0,0,0,0,1.0,1,1.0,1,1.0,1,0.6048757529573895,39
1959,2,4969,4969,0,0,0,0,1.0,1,1.0,1,1.0,1,0.6227694249892963,41
1960,2,4971,4971,0,0,0,0,1.0,1,1.0,1,1.0,1,0.6392242094761261,40
1961,3,4974,4974,0,0,0,0,1.0,1,1.0,1,1.0,1,0.6165168841586988,41
1962,2,4976,4976,0,0,0,0,1.0,1,1.0,1,1.0,1,0.604765692129462,40
1963,1,4977,4977,0,0,0,0,1.0,1,1.0,1,1.0,1,0.5930346632760796,41
1964,2,4979,4979,0,0,0,0,1.0,1,1.0,1,1.0,1,0.5828504235108803,40
1965,1,4980,4980,0,0,0,0,1.0,1,1.0,1,1.0,1,0.5689006523953473,41
1966,1,4981,4981,0,0,0,0,1.0,1,1.0,1,1.0,1,0.5609581862325697,41
1967,4,4985,4985,0,0,0,0,1.0,1,1.0,1,1.0,1,0.5399591006246277,42
1968,2,4987,4987,0,0,0,0,1.0,1,1.0,1,1.0,1,0.5170169580973281,42
1969,2,4989,4989,0,0,0,0,1.0,1,1.0,1,1.0,1,0.5019451511248693,43
1970,1,4990,4990,0,0,0,0,1.0,1,1.0,1,1.0,1,0.5239591724956204,42
1971,2,4992,4992,0,0,0,0,1.0,1,1.0,1,1.0,1,0.5064442922333278,42
1972,3,4995,4995,0,0,0,0,1.0,1,1.0,1,1.0,1,0.5226665741140109,42
1973,1,4996,4996,0,0,0,0,1.0,1,1.0,1,1.0,1,0.5372852580430297,43
1974,1,4997,4997,0,0,0,0,1.0,1,1.0,1,1.0,1,0.5520355548409097,43
1975,3,5000,5000,0,0,0,0,1.0,1,1.0,1,1.0,1,0.5807891725827166,43
1976,0,5000,5000,0,0,0,0,1.0,1,1.0,1,1.0,1,0.5807891725827166,43
1977,1,5001,5001,0,0,0,0,1.0,1,1.0,1,1.0,1,0.568211379160929,48
1978,4,5005,5005,0,0,0,0,1.0,1,1.0,1,1.0,1,0.5490036088890773,48
1979,7,5012,5012,0,0,0,0,1.0,1,1.0,1,1.0,1,0.5518095147158955,49
1980,5,5017,5017,0,0,0,0,1.0,1,1.0,1,1.0,1,0.5626714874994675,50
1981,3,5020,5020,0,0,0,0,1.0,1,1.0,1,1.0,1,0.5418381402913474,50
1982,7,5027,5027,0,0,0,0,1.0,1,1.0,1,1.0,1,0.5653046834872956,50
1983,4,5031,5031,0,0,0,0,1.0,1,1.0,1,1.0,1,0.5732813478620993,49
1984,7,5038,5038,0,0,0,0,1.0,1,1.0,1,1.0,1,0.5627047716188285,48
1985,5,5043,5043,0,0,0,0,1.0,1,1.0,1,1.0,1,0.5850379847251935,46
1986,4,5047,5047,0,0,0,0,1.0,1,1.0,1,1.0,1,0.5869785947015373,46
1987,3,5050,5050,0,0,0,0,1.0,1,1.0,1,1.0,1,0.6456535741717523,42
1988,5,5055,5055,0,0,0,0,1.0,1,1.0,1,1.0,1,0.6422828942488159,40
1989,3,5058,5058,0,0,0,0,1.0,1,1.0,1,1.0,1,0.626593378743129,38
1990,1,5059,5059,0,0,0,0,1.0,1,1.0,1,1.0,1,0.620106156483475,38
1991,4,5063,5063,0,0,0,0,1.0,1,1.0,1,1.0,1,0.6144736581508885,38
1992,0,5063,5063,0,0,0,0,1.0,1,1.0,1,1.0,1,0.621989203318297,39
1993,3,5066,5066,0,0,0,0,1.0,1,1.0,1,1.0,1,0.5960673245813364,38
1994,1,5067,5067,0,0,0,0,1.0,1,1.0,1,1.0,1,0.5872006178723443,37
1995,4,5071,5071,0,0,0,0,1.0,1,1.0,1,1.0,1,0.5923150858859153,37
1996,2,5073,5073,0,0,0,0,1.0,1,1.0,1,1.0,1,0.5728043306810927,37
1997,3,5076,5076,0,0,0,0,1.0,1,1.0,1,1.0,1,0.5692952318544471,35
1998,3,5079,5079,0,0,0,0,1.0,1,1.0,1,1.0,1,0.5771232198091345,34
1999,2,5081,5081,0,0,0,0,1.0,1,1.0,1,1.0,1,0.5658414201337179,35
2000,0,5081,5081,0,0,0,0,1.0,1,1.0,1,1.0,1,0.5756975402061981,34
2001,4,5085,5085,0,0,0,0,1.0,1,1.0,1,1.0,1,0.554401266944443,35
2002,2,5087,5087,0,0,0,0,1.0,1,1.0,1,1.0,1,0.5474452570352154,36
2003,3,5090,5090,0,0,0,0,1.0,1,1.0,1,1.0,1,0.561687175912885,37
2004,1,5091,5091,0,0,0,0,1.0,1,1.0,1,1.0,1,0.5885891437939367,38
2005,3,5094,5094,0,0,0,0,1.0,1,1.0,1,1.0,1,0.5717003892104692,38
2006,2,5096,5096,0,0,0,0,1.0,1,1.0,1,1.0,1,0.6005732480944382,38
2007,3,5099,5099,0,0,0,0,1.0,1,1.0,1,1.0,1,0.5657243827728442,40
2008,1,5100,5100,0,0,0,0,1.0,1,1.0,1,1.0,1,0.5434927740487386,40
2009,0,5100,5100,0,0,0,0,1.0,1,1.0,1,1.0,1,0.5217069085047973,41
2010,1,5101,5101,0,0,0,0,1.0,1,1.0,1,1.0,1,0.5052613578856463,41
2011,1,5102,5102,0,0,0,0,1.0,1,1.0,1,1.0,1,0.5044661399096456,41
2012,3,5105,5105,0,0,0,0,1.0,1,1.0,1,1.0,1,0.5279344005085508,41
2013,4,5109,5109,0,0,0,0,1.0,1,1.0,1,1.0,1,0.5635174726183204,43
2014,2,5111,5111,0,0,0,0,1.0,1,1.0,1,1.0,1,0.5762627383215337,43
2015,4,5115,5115,0,0,0,0,1.0,1,1.0,1,1.0,1,0.6304919216655345,43
2016,2,5117,5117,0,0,0,0,1.0,1,1.0,1,1.0,1,0.6212087841556333,44
2017,3,5120,5120,0,0,0,0,1.0,1,1.0,1,1.0,1,0.5882655934863096,45
2018,3,5123,5123,0,0,0,0,1.0,1,1.0,1,1.0,1,0.5935973825035804,46
2019,4,5127,5127,0,0,0,0,1.0,1,1.0,1,1.0,1,0.5234048965306939,47
2020,5,5132,5132,0,0,0,0,1.0,1,1.0,1,1.0,1,0.5221196288628436,47
2021,2,5134,5134,0,0,0,0,1.0,1,1.0,1,1.0,1,0.5164161371154962,47
2022,4,5138,5138,0,0,0,0,1.0,1,1.0,1,1.0,1,0.5130259830225673,48
2023,3,5141,5141,0,0,0,0,1.0,1,1.0,1,1.0,1,0.5058248844869943,48
2024,2,5143,5143,0,0,0,0,1.0,1,1.0,1,1.0,1,0.5258410967252632,45
2025,2,5145,5145,0,0,0,0,1.0,1,1.0,1,1.0,1,0.537400029771147,42
2026,4,5149,5149,0,0,0,0,1.0,1,1.0,1,1.0,1,0.5071525549584348,44
2027,2,5151,5151,0,0,0,0,1.0,1,1.0,1,1.0,1,0.5346104371413232,40
2028,3,5154,5154,0,0,0,0,1.0,1,1.0,1,1.0,1,0.49660749007173616,39
2029,5,5159,5159,0,0,0,0,1.0,1,1.0,1,1.0,1,0.580187985531384,37
2030,3,5162,5162,0,0,0,0,1.0,1,1.0,1,1.0,1,0.5577904125279807,34
2031,3,5165,5165,0,0,0,0,1.0,1,1.0,1,1.0,1,0.5822096844157952,35
2032,2,5167,5167,0,0,0,0,1.0,1,1.0,1,1.0,1,0.6077359155465346,34
2033,5,5172,5172,0,0,0,0,1.0,1,1.0,1,1.0,1,0.5612305089174342,36
2034,2,5174,5174,0,0,0,0,1.0,1,1.0,1,1.0,1,0.6071161662296537,34
2035,1,5175,5175,0,0,0,0,1.0,1,1.0,1,1.0,1,0.5682055798777519,35
2036,0,5175,5175,0,0,0,0,1.0,1,1.0,1,1.0,1,0.58607865322511,34
2037,3,5178,5178,0,0,0,0,1.0,1,1.0,1,1.0,1,0.5454427414890614,35
2038,1,5179,5179,0,0,0,0,1.0,1,1.0,1,1.0,1,0.5501827483965853,36
2039,1,5180,5180,0,0,0,0,1.0,1,1.0,1,1.0,1,0.5225474619104254,38
2040,0,5180,5180,0,0,0,0,1.0,1,1.0,1,1.0,1,0.5225474619104254,38
2041,0,5180,5180,0,0,0,0,1.0,1,1.0,1,1.0,1,0.5095750701604359,39
2042,0,5180,5180,0,0,0,0,1.0,1,1.0,1,1.0,1,0.5095750701604359,39
2043,2,5182,5182,0,0,0,0,1.0,1,1.0,1,1.0,1,0.4900305663978947,39
2044,0,5182,5182,0,0,0,0,1.0,1,1.0,1,1.0,1,0.4900305663978947,39
2045,4,5186,5186,0,0,0,0,1.0,1,1.0,1,1.0,1,0.4750530574196763,41
2046,0,5186,5186,0,0,0,0,1.0,1,1.0,1,1.0,1,0.47922165439912967,42
2047,5,5191,5191,0,0,0,0,1.0,1,1.0,1,1.0,1,0.5130471267063332,42
2048,1,5192,5192,0,0,0,0,1.0,1,1.0,1,1.0,1,0.5149994967798559,43
2049,5,5197,5197,0,0,0,0,1.0,1,1.0,1,1.0,1,0.4675539616445514,44
2050,1,5198,5198,0,0,0,0,1.0,1,1.0,1,1.0,1,0.4877171472361183,44
2051,3,5201,5201,0,0,0,0,1.0,1,1.0,1,1.0,1,0.5308664963603572,45
2052,0,5201,5201,0,0,0,0,1.0,1,1.0,1,1.0,1,0.5308664963603572,45
2053,6,5207,5207,0,0,0,0,1.0,1,1.0,1,1.0,1,0.5305839539731407,45
2054,3,5210,5210,0,0,0,0,1.0,1,1.0,1,1.0,1,0.5109651515691781,46
2055,4,5214,5214,0,0,0,0,1.0,1,1.0,1,1.0,1,0.5505301858844146,46
2056,4,5218,5218,0,0,0,0,1.0,1,1.0,1,1.0,1,0.54421197306897,46
2057,2,5220,5220,0,0,0,0,1.0,1,1.0,1,1.0,1,0.5243397272351145,47
2058,8,5228,5228,0,0,0,0,1.0,1,1.0,1,1.0,1,0.4924513173639954,47
2059,6,5234,5234,0,0,0,0,1.0,1,1.0,1,1.0,1,0.47058556917534194,48
2060,3,5237,5237,0,0,0,0,1.0,1,1.0,1,1.0,1,0.4776871427891877,50
2061,2,5239,5239,0,0,0,0,1.0,1,1.0,1,1.0,1,0.47119676609198524,51
2062,3,5242,5242,0,0,0,0,1.0,1,1.0,1,1.0,1,0.44989473317779277,49
2063,3,5245,5245,0,0,0,0,1.0,1,1.0,1,1.0,1,0.48511437489698767,48
2064,1,5246,5246,0,0,0,0,1.0,1,1.0,1,1.0,1,0.4962599567039043,45
2065,6,5252,5252,0,0,0,0,1.0,1,1.0,1,1.0,1,0.5614511075492299,44
2066,0,5252,5252,0,0,0,0,1.0,1,1.0,1,1.0,1,0.567617201780198,42
2067,3,5255,5255,0,0,0,0,1.0,1,1.0,1,1.0,1,0.6319564854565978,41
2068,2,5257,5257,0,0,0,0,1.0,1,1.0,1,1.0,1,0.6406944104203931,40
2069,0,5257,5257,0,0,0,0,1.0,1,1.0,1,1.0,1,0.6361790461652331,40
2070,2,5259,5259,0,0,0,0,1.0,1,1.0,1,1.0,1,0.6217012276171786,40
2071,1,5260,5260,0,0,0,0,1.0,1,1.0,1,1.0,1,0.6042713479785872,40
2072,2,5262,5262,0,0,0,0,1.0,1,1.0,1,1.0,1,0.5971155499895934,41
2073,1,5263,5263,0,0,0,0,1.0,1,1.0,1,1.0,1,0.611290821521113,41
2074,2,5265,5265,0,0,0,0,1.0,1,1.0,1,1.0,1,0.6044795883868707,41
2075,2,5267,5267,0,0,0,0,1.0,1,1.0,1,1.0,1,0.5858314281642506,41
2076,2,5269,5269,0,0,0,0,1.0,1,1.0,1,1.0,1,0.5742065446015548,41
2077,2,5271,5271,0,0,0,0,1.0,1,1.0,1,1.0,1,0.599619593471257,40
2078,3,5274,5274,0,0,0,0,1.0,1,1.0,1,1.0,1,0.6029668092843311,40
2079,3,5277,5277,0,0,0,0,1.0,1,1.0,1,1.0,1,0.5587155107004138,39
2080,6,5283,5283,0,0,0,0,1.0,1,1.0,1,1.0,1,0.6000012630360531,38
2081,2,5285,5285,0,0,0,0,1.0,1,1.0,1,1.0,1,0.5777509263912298,40
2082,9,5294,5294,0,0,0,0,1.0,1,1.0,1,1.0,1,0.6007570416836335,41
2083,3,5297,5297,0,0,0,0,1.0,1,1.0,1,1.0,1,0.5730972621596151,40
2084,5,5302,5302,0,0,0,0,1.0,1,1.0,1,1.0,1,0.5704871194183714,42
2085,7,5309,5309,0,0,0,0,1.0,1,1.0,1,1.0,1,0.525696930221878,42
2086,4,5313,5313,0,0,0,0,1.0,1,1.0,1,1.0,1,0.5091425865138096,43
2087,1,5314,5314,0,0,0,0,1.0,1,1.0,1,1.0,1,0.4847004420010883,45
2088,2,5316,5316,0,0,0,0,1.0,1,1.0,1,1.0,1,0.5057191430364278,46
2089,0,5316,5316,0,0,0,0,1.0,1,1.0,1,1.0,1,0.4902448698483415,47
2090,0,5316,5316,0,0,0,0,1.0,1,1.0,1,1.0,1,0.48279322966157545,49
2091,1,5317,5317,0,0,0,0,1.0,1,1.0,1,1.0,1,0.49219450103886836,49
2092,0,5317,5317,0,0,0,0,1.0,1,1.0,1,1.0,1,0.49219450103886836,49
2093,1,5318,5318,0,0,0,0,1.0,1,1.0,1,1.0,1,0.4712131129894378,49
2094,4,5322,5322,0,0,0,0,1.0,1,1.0,1,1.0,1,0.45794535614998444,49
2095,2,5324,5324,0,0,0,0,1.0,1,1.0,1,1.0,1,0.44040363248651776,49
2096,2,5326,5326,0,0,0,0,1.0,1,1.0,1,1.0,1,0.48014418851741225,51
2097,2,5328,5328,0,0,0,0,1.0,1,1.0,1,1.0,1,0.46813265317680475,51
2098,2,5330,5330,0,0,0,0,1.0,1,1.0,1,1.0,1,0.47276143742956994,52
2099,4,5334,5334,0,0,0,0,1.0,1,1.0,1,1.0,1,0.4542794196577295,51
2100,3,5337,5337,0,0,0,0,1.0,1,1.0,1,1.0,1,0.4734795868166239,51
2101,1,5338,5338,0,0,0,0,1.0,1,1.0,1,1.0,1,0.47737078883490563,48
2102,2,5340,5340,0,0,0,0,1.0,1,1.0,1,1.0,1,0.4899356622079799,49
2103,4,5344,5344,0,0,0,0,1.0,1,1.0,1,1.0,1,0.4923788205562405,48
2104,1,5345,5345,0,0,0,0,1.0,1,1.0,1,1.0,1,0.5109283356956758,43
2105,5,5350,5350,0,0,0,0,1.0,1,1.0,1,1.0,1,0.5290545624438285,42
2106,0,5350,5350,0,0,0,0,1.0,1,1.0,1,1.0,1,0.5245373808365971,40
2107,4,5354,5354,0,0,0,0,1.0,1,1.0,1,1.0,1,0.5808569524146341,39
2108,2,5356,5356,0,0,0,0,1.0,1,1.0,1,1.0,1,0.6226947693716409,38
2109,2,5358,5358,0,0,0,0,1.0,1,1.0,1,1.0,1,0.622464810811611,37
2110,1,5359,5359,0,0,0,0,1.0,1,1.0,1,1.0,1,0.6322391611839366,38
2111,1,5360,5360,0,0,0,0,1.0,1,1.0,1,1.0,1,0.6219345749942559,37
2112,1,5361,5361,0,0,0,0,1.0,1,1.0,1,1.0,1,0.6492760596519345,36
2113,0,5361,5361,0,0,0,0,1.0,1,1.0,1,1.0,1,0.6499693773874161,36
2114,0,5361,5361,0,0,0,0,1.0,1,1.0,1,1.0,1,0.6418877211534827,36
2115,0,5361,5361,0,0,0,0,1.0,1,1.0,1,1.0,1,0.6354074642895093,35
2116,0,5361,5361,0,0,0,0,1.0,1,1.0,1,1.0,1,0.6282841470494864,37
2117,2,5363,5363,0,0,0,0,1.0,1,1.0,1,1.0,1,0.5796800118356726,38
2118,0,5363,5363,0,0,0,0,1.0,1,1.0,1,1.0,1,0.5756711245117553,40
2119,3,5366,5366,0,0,0,0,1.0,1,1.0,1,1.0,1,0.5877248247611185,40
2120,0,5366,5366,0,0,0,0,1.0,1,1.0,1,1.0,1,0.589643059114768,41
2121,1,5367,5367,0,0,0,0,1.0,1,1.0,1,1.0,1,0.5849532964348801,41
2122,1,5368,5368,0,0,0,0,1.0,1,1.0,1,1.0,1,0.6060519525384045,42
2123,0,5368,5368,0,0,0,0,1.0,1,1.0,1,1.0,1,0.6007896847150054,43
2124,0,5368,5368,0,0,0,0,1.0,1,1.0,1,1.0,1,0.6007101920221806,41
2125,0,5368,5368,0,0,0,0,1.0,1,1.0,1,1.0,1,0.6007101920221806,41
2126,0,5368,5368,0,0,0,0,1.0,1,1.0,1,1.0,1,0.6104654831315496,40
2127,2,5370,5370,0,0,0,0,1.0,1,1.0,1,1.0,1,0.6246360685536225,40
2128,2,5372,5372,0,0,0,0,1.0,1,1.0,1,1.0,1,0.6175107612415355,41
2129,1,5373,5373,0,0,0,0,1.0,1,1.0,1,1.0,1,0.6132867823470862,42
2130,3,5376,5376,0,0,0,0,1.0,1,1.0,1,1.0,1,0.6087098732008637,45
2131,1,5377,5377,0,0,0,0,1.0,1,1.0,1,1.0,1,0.6129882238417157,45
2132,5,5382,5382,0,0,0,0,1.0,1,1.0,1,1.0,1,0.6318552563221064,46
2133,5,5387,5387,0,0,0,0,1.0,1,1.0,1,1.0,1,0.629648200680151,46
2134,3,5390,5390,0,0,0,0,1.0,1,1.0,1,1.0,1,0.5957557784225451,47
2135,10,5400,5400,0,0,0,0,1.0,1,1.0,1,1.0,1,0.6190138398202263,47
2136,4,5404,5404,0,0,0,0,1.0,1,1.0,1,1.0,1,0.6148697777620588,47
2137,5,5409,5409,0,0,0,0,1.0,1,1.0,1,1.0,1,0.5804826973380313,49
2138,4,5413,5413,0,0,0,0,1.0,1,1.0,1,1.0,1,0.5796393568062105,49
2139,1,5414,5414,0,0,0,0,1.0,1,1.0,1,1.0,1,0.5902177617980104,47
2140,2,5416,5416,0,0,0,0,1.0,1,1.0,1,1.0,1,0.5870712383134976,48
2141,3,5419,5419,0,0,0,0,1.0,1,1.0,1,1.0,1,0.5900999821824265,47
2142,3,5422,5422,0,0,0,0,1.0,1,1.0,1,1.0,1,0.5934486934625146,47
2143,2,5424,5424,0,0,0,0,1.0,1,1.0,1,1.0,1,0.5865473045577438,48
2144,6,5430,5430,0,0,0,0,1.0,1,1.0,1,1.0,1,0.5908383088403054,48
2145,2,5432,5432,0,0,0,0,1.0,1,1.0,1,1.0,1,0.6392922961497471,46
2146,3,5435,5435,0,0,0,0,1.0,1,1.0,1,1.0,1,0.6027053374511325,47
2147,6,5441,5441,0,0,0,0,1.0,1,1.0,1,1.0,1,0.5873508810869945,48
2148,1,5442,5442,0,0,0,0,1.0,1,1.0,1,1.0,1,0.561123561577637,46
2149,9,5451,5451,0,0,0,0,1.0,1,1.0,1,1.0,1,0.5292480597931969,46
2150,3,5454,5454,0,0,0,0,1.0,1,1.0,1,1.0,1,0.5036694226092844,46
2151,6,5460,5460,0,0,0,0,1.0,1,1.0,1,1.0,1,0.5044840523058798,44
2152,4,5464,5464,0,0,0,0,1.0,1,1.0,1,1.0,1,0.5323591619474798,45
2153,3,5467,5467,0,0,0,0,1.0,1,1.0,1,1.0,1,0.5425751838121746,48
2154,0,5467,5467,0,0,0,0,1.0,1,1.0,1,1.0,1,0.5459309246934126,47
2155,5,5472,5472,0,0,0,0,1.0,1,1.0,1,1.0,1,0.5577613593911213,48
2156,0,5472,5472,0,0,0,0,1.0,1,1.0,1,1.0,1,0.5657499242427299,45
2157,5,5477,5477,0,0,0,0,1.0,1,1.0,1,1.0,1,0.5319212205821952,43
2158,3,5480,5480,0,0,0,0,1.0,1,1.0,1,1.0,1,0.5520785705980625,43
2159,4,5484,5484,0,0,0,0,1.0,1,1.0,1,1.0,1,0.5486121090874411,43
2160,7,5491,5491,0,0,0,0,1.0,1,1.0,1,1.0,1,0.5884818600994995,41
2161,6,5497,5497,0,0,0,0,1.0,1,1.0,1,1.0,1,0.5925685880010129,41
2162,2,5499,5499,0,0,0,0,1.0,1,1.0,1,1.0,1,0.5494900142324072,42
2163,3,5502,5502,0,0,0,0,1.0,1,1.0,1,1.0,1,0.5650277569384445,43
2164,0,5502,5502,0,0,0,0,1.0,1,1.0,1,1.0,1,0.5595058132532068,44
2165,3,5505,5505,0,0,0,0,1.0,1,1.0,1,1.0,1,0.5632445335734428,44
2166,2,5507,5507,0,0,0,0,1.0,1,1.0,1,1.0,1,0.5264370943625682,46
2167,3,5510,5510,0,0,0,0,1.0,1,1.0,1,1.0,1,0.5681270541716817,46
2168,0,5510,5510,0,0,0,0,1.0,1,1.0,1,1.0,1,0.5730494739087526,45
2169,0,5510,5510,0,0,0,0,1.0,1,1.0,1,1.0,1,0.5533073017755971,49
2170,1,5511,5511,0,0,0,0,1.0,1,1.0,1,1.0,1,0.5693704028241002,49
2171,3,5514,5514,0,0,0,0,1.0,1,1.0,1,1.0,1,0.5249725078139115,51
2172,3,5517,5517,0,0,0,0,1.0,1,1.0,1,1.0,1,0.5422741174283726,52
2173,4,5521,5521,0,0,0,0,1.0,1,1.0,1,1.0,1,0.5760554002211931,52
2174,6,5527,5527,0,0,0,0,1.0,1,1.0,1,1.0,1,0.5829286655405015,52
2175,3,5530,5530,0,0,0,0,1.0,1,1.0,1,1.0,1,0.5632039683209742,53
2176,2,5532,5532,0,0,0,0,1.0,1,1.0,1,1.0,1,0.5443727312691885,54
2177,4,5536,5536,0,0,0,0,1.0,1,1.0,1,1.0,1,0.5601566272864537,55
2178,5,5541,5541,0,0,0,0,1.0,1,1.0,1,1.0,1,0.5609018377711047,54
2179,4,5545,5545,0,0,0,0,1.0,1,1.0,1,1.0,1,0.5358969165496105,52
2180,2,5547,5547,0,0,0,0,1.0,1,1.0,1,1.0,1,0.5439741798504328,51
2181,5,5552,5552,0,0,0,0,1.0,1,1.0,1,1.0,1,0.5443316501964729,49
2182,8,5560,5560,0,0,0,0,1.0,1,1.0,1,1.0,1,0.5528477343199317,49
2183,5,5565,5565,0,0,0,0,1.0,1,1.0,1,1.0,1,0.5511955661986923,46
2184,7,5572,5572,0,0,0,0,1.0,1,1.0,1,1.0,1,0.5206940301345032,45
2185,7,5579,5579,0,0,0,0,1.0,1,1.0,1,1.0,1,0.5584508486421967,44
2186,7,5586,5586,0,0,0,0,1.0,1,1.0,1,1.0,1,0.542110429334447,42
2187,6,5592,5592,0,0,0,0,1.0,1,1.0,1,1.0,1,0.5098384072939685,40
2188,4,5596,5596,0,0,0,0,1.0,1,1.0,1,1.0,1,0.5216897708153265,38
2189,5,5601,5601,0,0,0,0,1.0,1,1.0,1,1.0,1,0.5533720948907156,36
2190,3,5604,5604,0,0,0,0,1.0,1,1.0,1,1.0,1,0.5725159021178173,34
2191,3,5607,5607,0,0,0,0,1.0,1,1.0,1,1.0,1,0.5771022783454485,34
2192,6,5613,5613,0,0,0,0,1.0,1,1.0,1,1.0,1,0.5739155435820155,33
2193,1,5614,5614,0,0,0,0,1.0,1,1.0,1,1.0,1,0.5950498112253284,32
2194,1,5615,5615,0,0,0,0,1.0,1,1.0,1,1.0,1,0.5856796083163135,32
2195,1,5616,5616,0,0,0,0,1.0,1,1.0,1,1.0,1,0.5720552378086335,31
2196,2,5618,5618,0,0,0,0,1.0,1,1.0,1,1.0,1,0.5831119066925,32
2197,0,5618,5618,0,0,0,0,1.0,1,1.0,1,1.0,1,0.6082309243007816,31
2198,1,5619,5619,0,0,0,0,1.0,1,1.0,1,1.0,1,0.576936134080402,31
2199,3,5622,5622,0,0,0,0,1.0,1,1.0,1,1.0,1,0.509939442171851,32
2200,0,5622,5622,0,0,0,0,1.0,1,1.0,1,1.0,1,0.5093289974703225,35
2201,2,5624,5624,0,0,0,0,1.0,1,1.0,1,1.0,1,0.49142812062962565,36
2202,0,5624,5624,0,0,0,0,1.0,1,1.0,1,1.0,1,0.49142812062962565,36
2203,3,5627,5627,0,0,0,0,1.0,1,1.0,1,1.0,1,0.48482634751369447,37
2204,5,5632,5632,0,0,0,0,1.0,1,1.0,1,1.0,1,0.46561910735353707,36
2205,5,5637,5637,0,0,0,0,1.0,1,1.0,1,1.0,1,0.4973224449703289,37
2206,3,5640,5640,0,0,0,0,1.0,1,1.0,1,1.0,1,0.5009470402032971,35
2207,1,5641,5641,0,0,0,0,1.0,1,1.0,1,1.0,1,0.49891016402272054,37
2208,3,5644,5644,0,0,0,0,1.0,1,1.0,1,1.0,1,0.5288575371040944,36
2209,2,5646,5646,0,0,0,0,1.0,1,1.0,1,1.0,1,0.5769144904895596,35
2210,0,5646,5646,0,0,0,0,1.0,1,1.0,1,1.0,1,0.5594047388514785,38
2211,3,5649,5649,0,0,0,0,1.0,1,1.0,1,1.0,1,0.6036359826223013,37
2212,0,5649,5649,0,0,0,0,1.0,1,1.0,1,1.0,1,0.6097916298806391,38
2213,3,5652,5652,0,0,0,0,1.0,1,1.0,1,1.0,1,0.6066715167105475,38
2214,0,5652,5652,0,0,0,0,1.0,1,1.0,1,1.0,1,0.5895423390988874,39
2215,1,5653,5653,0,0,0,0,1.0,1,1.0,1,1.0,1,0.5889209106089706,39
2216,4,5657,5657,0,0,0,0,1.0,1,1.0,1,1.0,1,0.5548499053059266,39
2217,2,5659,5659,0,0,0,0,1.0,1,1.0,1,1.0,1,0.4766784328534606,38
2218,3,5662,5662,0,0,0,0,1.0,1,1.0,1,1.0,1,0.4459634224054841,37
2219,2,5664,5664,0,0,0,0,1.0,1,1.0,1,1.0,1,0.4202244905021898,36
2220,2,5666,5666,0,0,0,0,1.0,1,1.0,1,1.0,1,0.3901070667080596,34
2221,5,5671,5671,0,0,0,0,1.0,1,1.0,1,1.0,1,0.42525498444682047,35
2222,2,5673,5673,0,0,0,0,1.0,1,1.0,1,1.0,1,0.4556255913384923,33
2223,3,5676,5676,0,0,0,0,1.0,1,1.0,1,1.0,1,0.5107499102063066,34
2224,2,5678,5678,0,0,0,0,1.0,1,1.0,1,1.0,1,0.540248975749967,32
2225,2,5680,5680,0,0,0,0,1.0,1,1.0,1,1.0,1,0.5810830319901886,33
2226,1,5681,5681,0,0,0,0,1.0,1,1.0,1,1.0,1,0.5645949877865191,32
2227,3,5684,5684,0,0,0,0,1.0,1,1.0,1,1.0,1,0.5031797100460086,31
2228,2,5686,5686,0,0,0,0,1.0,1,1.0,1,1.0,1,0.5177640278795731,32
2229,0,5686,5686,0,0,0,0,1.0,1,1.0,1,1.0,1,0.5177640278795731,32
2230,3,5689,5689,0,0,0,0,1.0,1,1.0,1,1.0,1,0.5339136199390395,31
2231,0,5689,5689,0,0,0,0,1.0,1,1.0,1,1.0,1,0.5219918100446178,32
2232,4,5693,5693,0,0,0,0,1.0,1,1.0,1,1.0,1,0.4950978005977555,32
2233,3,5696,5696,0,0,0,0,1.0,1,1.0,1,1.0,1,0.5161558253513481,31
2234,4,5700,5700,0,0,0,0,1.0,1,1.0,1,1.0,1,0.5558668190656713,32
2235,6,5706,5706,0,0,0,0,1.0,1,1.0,1,1.0,1,0.5426837956553692,31
2236,5,5711,5711,0,0,0,0,1.0,1,1.0,1,1.0,1,0.5501644023195551,31
2237,6,5717,5717,0,0,0,0,1.0,1,1.0,1,1.0,1,0.5457830807938244,31
2238,4,5721,5721,0,0,0,0,1.0,1,1.0,1,1.0,1,0.5581872153348065,31
2239,3,5724,5724,0,0,0,0,1.0,1,1.0,1,1.0,1,0.5999135805539416,31
2240,3,5727,5727,0,0,0,0,1.0,1,1.0,1,1.0,1,0.6500422187038416,32
2241,1,5728,5728,0,0,0,0,1.0,1,1.0,1,1.0,1,0.6321735952474888,32
2242,2,5730,5730,0,0,0,0,1.0,1,1.0,1,1.0,1,0.5908802337596342,34
2243,0,5730,5730,0,0,0,0,1.0,1,1.0,1,1.0,1,0.5908802337596342,34
2244,1,5731,5731,0,0,0,0,1.0,1,1.0,1,1.0,1,0.5927279603789193,36
2245,3,5734,5734,0,0,0,0,1.0,1,1.0,1,1.0,1,0.579146754174832,36
2246,0,5734,5734,0,0,0,0,1.0,1,1.0,1,1.0,1,0.5651178153514163,39
2247,1,5735,5735,0,0,0,0,1.0,1,1.0,1,1.0,1,0.5488108949091082,40
2248,2,5737,5737,0,0,0,0,1.0,1,1.0,1,1.0,1,0.5793073434302357,40
2249,0,5737,5737,0,0,0,0,1.0,1,1.0,1,1.0,1,0.5632301758710321,41
2250,0,5737,5737,0,0,0,0,1.0,1,1.0,1,1.0,1,0.5632301758710321,41
2251,2,5739,5739,0,0,0,0,1.0,1,1.0,1,1.0,1,0.5991593231336324,42
2252,0,5739,5739,0,0,0,0,1.0,1,1.0,1,1.0,1,0.5936731867664944,41
2253,3,5742,5742,0,0,0,0,1.0,1,1.0,1,1.0,1,0.6093134747933789,40
2254,2,5744,5744,0,0,0,0,1.0,1,1.0,1,1.0,1,0.644209104170904,39
2255,3,5747,5747,0,0,0,0,1.0,1,1.0,1,1.0,1,0.6565644812222841,39
2256,1,5748,5748,0,0,0,0,1.0,1,1.0,1,1.0,1,0.6373347514246525,40
2257,2,5750,5750,0,0,0,0,1.0,1,1.0,1,1.0,1,0.5958618185275247,40
2258,3,5753,5753,0,0,0,0,1.0,1,1.0,1,1.0,1,0.5572852321133004,39
2259,5,5758,5758,0,0,0,0,1.0,1,1.0,1,1.0,1,0.5239883239951391,41
2260,4,5762,5762,0,0,0,0,1.0,1,1.0,1,1.0,1,0.4993076254631601,38
2261,7,5769,5769,0,0,0,0,1.0,1,1.0,1,1.0,1,0.4764247516793032,38
2262,3,5772,5772,0,0,0,0,1.0,1,1.0,1,1.0,1,0.5353447848061873,36
2263,7,5779,5779,0,0,0,0,1.0,1,1.0,1,1.0,1,0.5185927927064305,35
2264,4,5783,5783,0,0,0,0,1.0,1,1.0,1,1.0,1,0.5671990273970654,33
2265,7,5790,5790,0,0,0,0,1.0,1,1.0,1,1.0,1,0.5547788596958543,33
2266,3,5793,5793,0,0,0,0,1.0,1,1.0,1,1.0,1,0.5491163344847896,33
2267,4,5797,5797,0,0,0,0,1.0,1,1.0,1,1.0,1,0.4910432013081433,33
2268,3,5800,5800,0,0,0,0,1.0,1,1.0,1,1.0,1,0.5470360141290619,35
2269,4,5804,5804,0,0,0,0,1.0,1,1.0,1,1.0,1,0.5103384373889244,36
2270,5,5809,5809,0,0,0,0,1.0,1,1.0,1,1.0,1,0.5468663479377686,34
2271,4,5813,5813,0,0,0,0,1.0,1,1.0,1,1.0,1,0.5294590457899478,34
2272,3,5816,5816,0,0,0,0,1.0,1,1.0,1,1.0,1,0.6031527550623436,33
2273,4,5820,5820,0,0,0,0,1.0,1,1.0,1,1.0,1,0.5744732310037299,32
2274,2,5822,5822,0,0,0,0,1.0,1,1.0,1,1.0,1,0.5495509480804535,32
2275,2,5824,5824,0,0,0,0,1.0,1,1.0,1,1.0,1,0.5505486772944894,32
2276,3,5827,5827,0,0,0,0,1.0,1,1.0,1,1.0,1,0.5907444736277667,31
2277,1,5828,5828,0,0,0,0,1.0,1,1.0,1,1.0,1,0.6268433580426402,30
2278,3,5831,5831,0,0,0,0,1.0,1,1.0,1,1.0,1,0.5412622421206242,33
2279,0,5831,5831,0,0,0,0,1.0,1,1.0,1,1.0,1,0.5412622421206242,33
2280,1,5832,5832,0,0,0,0,1.0,1,1.0,1,1.0,1,0.5267677520715222,35
2281,0,5832,5832,0,0,0,0,1.0,1,1.0,1,1.0,1,0.5347638335587169,36
2282,4,5836,5836,0,0,0,0,1.0,1,1.0,1,1.0,1,0.5494463211831424,36
2283,1,5837,5837,0,0,0,0,1.0,1,1.0,1,1.0,1,0.5688908356357136,36
2284,1,5838,5838,0,0,0,0,1.0,1,1.0,1,1.0,1,0.5662690415999911,36
2285,6,5844,5844,0,0,0,0,1.0,1,1.0,1,1.0,1,0.611351840236338,37
2286,1,5845,5845,0,0,0,0,1.0,1,1.0,1,1.0,1,0.5847618981247148,38
2287,1,5846,5846,0,0,0,0,1.0,1,1.0,1,1.0,1,0.579821867929713,38
2288,0,5846,5846,0,0,0,0,1.0,1,1.0,1,1.0,1,0.5656983902548636,40
2289,0,5846,5846,0,0,0,0,1.0,1,1.0,1,1.0,1,0.5951006161964825,40
2290,0,5846,5846,0,0,0,0,1.0,1,1.0,1,1.0,1,0.61028209904271,39
2291,1,5847,5847,0,0,0,0,1.0,1,1.0,1,1.0,1,0.5852747277591711,37
2292,0,5847,5847,0,0,0,0,1.0,1,1.0,1,1.0,1,0.6041441205100829,35
2293,0,5847,5847,0,0,0,0,1.0,1,1.0,1,1.0,1,0.60449352701159,35
2294,1,5848,5848,0,0,0,0,1.0,1,1.0,1,1.0,1,0.537917070965115,35
2295,0,5848,5848,0,0,0,0,1.0,1,1.0,1,1.0,1,0.5373923162925061,36
2296,1,5849,5849,0,0,0,0,1.0,1,1.0,1,1.0,1,0.552193363850569,34
2297,0,5849,5849,0,0,0,0,1.0,1,1.0,1,1.0,1,0.5561944938591136,35
2298,1,5850,5850,0,0,0,0,1.0,1,1.0,1,1.0,1,0.5664363211167704,34
2299,1,5851,5851,0,0,0,0,1.0,1,1.0,1,1.0,1,0.5584432697471392,35
2300,2,5853,5853,0,0,0,0,1.0,1,1.0,1,1.0,1,0.6043481026400193,35
2301,2,5855,5855,0,0,0,0,1.0,1,1.0,1,1.0,1,0.6075282047731744,35
2302,2,5857,5857,0,0,0,0,1.0,1,1.0,1,1.0,1,0.6229657432256142,37
2303,1,5858,5858,0,0,0,0,1.0,1,1.0,1,1.0,1,0.6005243247992902,35
2304,0,5858,5858,0,0,0,0,1.0,1,1.0,1,1.0,1,0.6107655259100797,36
2305,1,5859,5859,0,0,0,0,1.0,1,1.0,1,1.0,1,0.5964841026584816,34
2306,0,5859,5859,0,0,0,0,1.0,1,1.0,1,1.0,1,0.5965956055755193,35
2307,2,5861,5861,0,0,0,0,1.0,1,1.0,1,1.0,1,0.5754855881259436,35
2308,0,5861,5861,0,0,0,0,1.0,1,1.0,1,1.0,1,0.5754855881259436,35
2309,5,5866,5866,0,0,0,0,1.0,1,1.0,1,1.0,1,0.5753102346044805,34
2310,2,5868,5868,0,0,0,0,1.0,1,1.0,1,1.0,1,0.5477252437661791,36
2311,2,5870,5870,0,0,0,0,1.0,1,1.0,1,1.0,1,0.5559805003031856,38
2312,4,5874,5874,0,0,0,0,1.0,1,1.0,1,1.0,1,0.5381161332754032,39
2313,8,5882,5882,0,0,0,0,1.0,1,1.0,1,1.0,1,0.6091288474054841,39
2314,4,5886,5886,0,0,0,0,1.0,1,1.0,1,1.0,1,0.6023058679336561,39
2315,7,5893,5893,0,0,0,0,1.0,1,1.0,1,1.0,1,0.6185033837895929,40
2316,2,5895,5895,0,0,0,0,1.0,1,1.0,1,1.0,1,0.5890435872661297,40
2317,5,5900,5900,0,0,0,0,1.0,1,1.0,1,1.0,1,0.5673734785861676,41
2318,4,5904,5904,0,0,0,0,1.0,1,1.0,1,1.0,1,0.6419189658299771,41
2319,4,5908,5908,0,0,0,0,1.0,1,1.0,1,1.0,1,0.6036064780041155,41
2320,2,5910,5910,0,0,0,0,1.0,1,1.0,1,1.0,1,0.5973755985540562,42
2321,0,5910,5910,0,0,0,0,1.0,1,1.0,1,1.0,1,0.5819760961127678,43
2322,1,5911,5911,0,0,0,0,1.0,1,1.0,1,1.0,1,0.5866868465654043,42
2323,0,5911,5911,0,0,0,0,1.0,1,1.0,1,1.0,1,0.5888354909305306,43
2324,1,5912,5912,0,0,0,0,1.0,1,1.0,1,1.0,1,0.5907534578806324,44
2325,1,5913,5913,0,0,0,0,1.0,1,1.0,1,1.0,1,0.607173465832573,44
2326,2,5915,5915,0,0,0,0,1.0,1,1.0,1,1.0,1,0.5925038251630943,45
2327,2,5917,5917,0,0,0,0,1.0,1,1.0,1,1.0,1,0.5804260101388066,45
2328,4,5921,5921,0,0,0,0,1.0,1,1.0,1,1.0,1,0.5954392867485151,46
2329,2,5923,5923,0,0,0,0,1.0,1,1.0,1,1.0,1,0.589071997485353,45
2330,5,5928,5928,0,0,0,0,1.0,1,1.0,1,1.0,1,0.6182657369026748,47
2331,1,5929,5929,0,0,0,0,1.0,1,1.0,1,1.0,1,0.6164927805869165,48
2332,2,5931,5931,0,0,0,0,1.0,1,1.0,1,1.0,1,0.6078189680038958,48
2333,1,5932,5932,0,0,0,0,1.0,1,1.0,1,1.0,1,0.616246932076966,49
2334,3,5935,5935,0,0,0,0,1.0,1,1.0,1,1.0,1,0.6362344903630754,47
2335,1,5936,5936,0,0,0,0,1.0,1,1.0,1,1.0,1,0.6304529599047193,46
2336,1,5937,5937,0,0,0,0,1.0,1,1.0,1,1.0,1,0.6513502429581761,46
2337,2,5939,5939,0,0,0,0,1.0,1,1.0,1,1.0,1,0.6552524913449925,45
2338,2,5941,5941,0,0,0,0,1.0,1,1.0,1,1.0,1,0.6278521190729834,44
2339,4,5945,5945,0,0,0,0,1.0,1,1.0,1,1.0,1,0.6176423287080258,45
2340,2,5947,5947,0,0,0,0,1.0,1,1.0,1,1.0,1,0.6373185690309827,44
2341,2,5949,5949,0,0,0,0,1.0,1,1.0,1,1.0,1,0.604693762401839,45
2342,1,5950,5950,0,0,0,0,1.0,1,1.0,1,1.0,1,0.599817700992613,47
2343,0,5950,5950,0,0,0,0,1.0,1,1.0,1,1.0,1,0.612192270812093,46
2344,1,5951,5951,0,0,0,0,1.0,1,1.0,1,1.0,1,0.6330537172874039,46
2345,1,5952,5952,0,0,0,0,1.0,1,1.0,1,1.0,1,0.6621241766653403,45
2346,2,5954,5954,0,0,0,0,1.0,1,1.0,1,1.0,1,0.6507455131213851,46
2347,0,5954,5954,0,0,0,0,1.0,1,1.0,1,1.0,1,0.6511306890097971,47
2348,2,5956,5956,0,0,0,0,1.0,1,1.0,1,1.0,1,0.6531309299093473,49
2349,0,5956,5956,0,0,0,0,1.0,1,1.0,1,1.0,1,0.6531309299093473,49
2350,2,5958,5958,0,0,0,0,1.0,1,1.0,1,1.0,1,0.6269998016251395,50
2351,0,5958,5958,0,0,0,0,1.0,1,1.0,1,1.0,1,0.6269998016251395,50
2352,1,5959,5959,0,0,0,0,1.0,1,1.0,1,1.0,1,0.6179623035623688,51
2353,2,5961,5961,0,0,0,0,1.0,1,1.0,1,1.0,1,0.6033916098915351,51
2354,2,5963,5963,0,0,0,0,1.0,1,1.0,1,1.0,1,0.5676160144764011,51
2355,1,5964,5964,0,0,0,0,1.0,1,1.0,1,1.0,1,0.5661429840957855,50
2356,4,5968,5968,0,0,0,0,1.0,1,1.0,1,1.0,1,0.5629713012362532,50
2357,3,5971,5971,0,0,0,0,1.0,1,1.0,1,1.0,1,0.5713956482373036,49
2358,3,5974,5974,0,0,0,0,1.0,1,1.0,1,1.0,1,0.533656672638351,51
2359,6,5980,5980,0,0,0,0,1.0,1,1.0,1,1.0,1,0.5558696842776729,51
2360,5,5985,5985,0,0,0,0,1.0,1,1.0,1,1.0,1,0.5282126547599072,51
2361,5,5990,5990,0,0,0,0,1.0,1,1.0,1,1.0,1,0.546553008820808,52
2362,6,5996,5996,0,0,0,0,1.0,1,1.0,1,1.0,1,0.5217120662078801,53
2363,5,6001,6001,0,0,0,0,1.0,1,1.0,1,1.0,1,0.5405016805839468,54
2364,8,6009,6009,0,0,0,0,1.0,1,1.0,1,1.0,1,0.5614618758817466,55
2365,5,6014,6014,0,0,0,0,1.0,1,1.0,1,1.0,1,0.5652105866703057,53
2366,7,6021,6021,0,0,0,0,1.0,1,1.0,1,1.0,1,0.5551760850142575,53
2367,4,6025,6025,0,0,0,0,1.0,1,1.0,1,1.0,1,0.5711459119303288,51
2368,5,6030,6030,0,0,0,0,1.0,1,1.0,1,1.0,1,0.5783864947674394,50
2369,3,6033,6033,0,0,0,0,1.0,1,1.0,1,1.0,1,0.619161162336785,47
2370,2,6035,6035,0,0,0,0,1.0,1,1.0,1,1.0,1,0.6017476039906108,48
2371,1,6036,6036,0,0,0,0,1.0,1,1.0,1,1.0,1,0.5529467976719337,49
2372,2,6038,6038,0,0,0,0,1.0,1,1.0,1,1.0,1,0.5518962048850242,48
2373,0,6038,6038,0,0,0,0,1.0,1,1.0,1,1.0,1,0.5418964465591963,49
2374,0,6038,6038,0,0,0,0,1.0,1,1.0,1,1.0,1,0.5401742576714039,50
2375,2,6040,6040,0,0,0,0,1.0,1,1.0,1,1.0,1,0.5806685819965481,50
2376,0,6040,6040,0,0,0,0,1.0,1,1.0,1,1.0,1,0.5716147385795893,50
2377,1,6041,6041,0,0,0,0,1.0,1,1.0,1,1.0,1,0.6003678327157399,49
2378,4,6045,6045,0,0,0,0,1.0,1,1.0,1,1.0,1,0.6214911899382936,49
2379,4,6049,6049,0,0,0,0,1.0,1,1.0,1,1.0,1,0.5536162074928621,50
2380,3,6052,6052,0,0,0,0,1.0,1,1.0,1,1.0,1,0.5211650777944208,50
2381,4,6056,6056,0,0,0,0,1.0,1,1.0,1,1.0,1,0.5012830379120445,51
2382,2,6058,6058,0,0,0,0,1.0,1,1.0,1,1.0,1,0.5099744079758329,51
2383,1,6059,6059,0,0,0,0,1.0,1,1.0,1,1.0,1,0.5309311317484242,52
2384,2,6061,6061,0,0,0,0,1.0,1,1.0,1,1.0,1,0.5279675302410567,52
2385,1,6062,6062,0,0,0,0,1.0,1,1.0,1,1.0,1,0.5511486185792295,51
2386,6,6068,6068,0,0,0,0,1.0,1,1.0,1,1.0,1,0.5627502439955819,52
2387,2,6070,6070,0,0,0,0,1.0,1,1.0,1,1.0,1,0.5766411822821605,49
2388,6,6076,6076,0,0,0,0,1.0,1,1.0,1,1.0,1,0.625411826678933,48
2389,5,6081,6081,0,0,0,0,1.0,1,1.0,1,1.0,1,0.6498087735911625,48
2390,7,6088,6088,0,0,0,0,1.0,1,1.0,1,1.0,1,0.6431660794995716,49
2391,6,6094,6094,0,0,0,0,1.0,1,1.0,1,1.0,1,0.6161545273835674,48
2392,2,6096,6096,0,0,0,0,1.0,1,1.0,1,1.0,1,0.5902675981471273,49
2393,3,6099,6099,0,0,0,0,1.0,1,1.0,1,1.0,1,0.5585046128793547,50
2394,4,6103,6103,0,0,0,0,1.0,1,1.0,1,1.0,1,0.5482359376137153,50
2395,4,6107,6107,0,0,0,0,1.0,1,1.0,1,1.0,1,0.5724148016143616,49
2396,5,6112,6112,0,0,0,0,1.0,1,1.0,1,1.0,1,0.5470444778661661,50
2397,3,6115,6115,0,0,0,0,1.0,1,1.0,1,1.0,1,0.5409701612697612,51
2398,1,6116,6116,0,0,0,0,1.0,1,1.0,1,1.0,1,0.5592620398348939,49
2399,1,6117,6117,0,0,0,0,1.0,1,1.0,1,1.0,1,0.5533761905072457,50
2400,3,6120,6120,0,0,0,0,1.0,1,1.0,1,1.0,1,0.5729499227578417,51
2401,0,6120,6120,0,0,0,0,1.0,1,1.0,1,1.0,1,0.5773107506845176,50
2402,1,6121,6121,0,0,0,0,1.0,1,1.0,1,1.0,1,0.5741347448726469,51
2403,0,6121,6121,0,0,0,0,1.0,1,1.0,1,1.0,1,0.5628174126652828,52
2404,0,6121,6121,0,0,0,0,1.0,1,1.0,1,1.0,1,0.5701697910150731,53
2405,3,6124,6124,0,0,0,0,1.0,1,1.0,1,1.0,1,0.5400805134313182,52
2406,2,6126,6126,0,0,0,0,1.0,1,1.0,1,1.0,1,0.5653628674109782,52
2407,1,6127,6127,0,0,0,0,1.0,1,1.0,1,1.0,1,0.5450107993117065,51
2408,2,6129,6129,0,0,0,0,1.0,1,1.0,1,1.0,1,0.5479047765796216,50
2409,2,6131,6131,0,0,0,0,1.0,1,1.0,1,1.0,1,0.5184630043890643,50
2410,3,6134,6134,0,0,0,0,1.0,1,1.0,1,1.0,1,0.5122560126147852,49
2411,1,6135,6135,0,0,0,0,1.0,1,1.0,1,1.0,1,0.529531868314084,48
2412,2,6137,6137,0,0,0,0,1.0,1,1.0,1,1.0,1,0.5188097898700077,47
2413,0,6137,6137,0,0,0,0,1.0,1,1.0,1,1.0,1,0.5144754914652764,47
2414,1,6138,6138,0,0,0,0,1.0,1,1.0,1,1.0,1,0.4940709555398725,47
2415,2,6140,6140,0,0,0,0,1.0,1,1.0,1,1.0,1,0.5397767890550978,46
2416,1,6141,6141,0,0,0,0,1.0,1,1.0,1,1.0,1,0.5308407843796865,47
2417,2,6143,6143,0,0,0,0,1.0,1,1.0,1,1.0,1,0.5799496368630359,46
2418,3,6146,6146,0,0,0,0,1.0,1,1.0,1,1.0,1,0.5719540277092534,48
2419,4,6150,6150,0,0,0,0,1.0,1,1.0,1,1.0,1,0.5513764353674524,47
2420,4,6154,6154,0,0,0,0,1.0,1,1.0,1,1.0,1,0.529277097744892,49
2421,4,6158,6158,0,0,0,0,1.0,1,1.0,1,1.0,1,0.5164770130086009,50
2422,4,6162,6162,0,0,0,0,1.0,1,1.0,1,1.0,1,0.5247658450944291,50
2423,6,6168,6168,0,0,0,0,1.0,1,1.0,1,1.0,1,0.4784982459672795,51
2424,4,6172,6172,0,0,0,0,1.0,1,1.0,1,1.0,1,0.5078838410083051,50
2425,4,6176,6176,0,0,0,0,1.0,1,1.0,1,1.0,1,0.5275318971630976,48
2426,1,6177,6177,0,0,0,0,1.0,1,1.0,1,1.0,1,0.5349259497051972,51
2427,4,6181,6181,0,0,0,0,1.0,1,1.0,1,1.0,1,0.5841852434182279,50
2428,2,6183,6183,0,0,0,0,1.0,1,1.0,1,1.0,1,0.6094937173011715,49
2429,2,6185,6185,0,0,0,0,1.0,1,1.0,1,1.0,1,0.623918257967749,49
2430,0,6185,6185,0,0,0,0,1.0,1,1.0,1,1.0,1,0.6465657135931173,46
2431,2,6187,6187,0,0,0,0,1.0,1,1.0,1,1.0,1,0.644225655942544,45
2432,1,6188,6188,0,0,0,0,1.0,1,1.0,1,1.0,1,0.6742811982608757,44
2433,3,6191,6191,0,0,0,0,1.0,1,1.0,1,1.0,1,0.6201649892787734,45
2434,3,6194,6194,0,0,0,0,1.0,1,1.0,1,1.0,1,0.6257539993608253,44
2435,5,6199,6199,0,0,0,0,1.0,1,1.0,1,1.0,1,0.5585373837722853,44
2436,1,6200,6200,0,0,0,0,1.0,1,1.0,1,1.0,1,0.5666298134813895,44
2437,9,6209,6209,0,0,0,0,1.0,1,1.0,1,1.0,1,0.5243706707144631,45
2438,5,6214,6214,0,0,0,0,1.0,1,1.0,1,1.0,1,0.530849545142375,45
2439,3,6217,6217,0,0,0,0,1.0,1,1.0,1,1.0,1,0.5484060361098594,46
2440,4,6221,6221,0,0,0,0,1.0,1,1.0,1,1.0,1,0.568629683756505,45
2441,1,6222,6222,0,0,0,0,1.0,1,1.0,1,1.0,1,0.5757990347888747,45
2442,4,6226,6226,0,0,0,0,1.0,1,1.0,1,1.0,1,0.5812349166445665,46
2443,0,6226,6226,0,0,0,0,1.0,1,1.0,1,1.0,1,0.590053499250821,45
2444,2,6228,6228,0,0,0,0,1.0,1,1.0,1,1.0,1,0.5787413067346585,46
2445,2,6230,6230,0,0,0,0,1.0,1,1.0,1,1.0,1,0.6175828935585264,44
2446,4,6234,6234,0,0,0,0,1.0,1,1.0,1,1.0,1,0.5968558048396958,44
2447,1,6235,6235,0,0,0,0,1.0,1,1.0,1,1.0,1,0.601388487884923,42
2448,3,6238,6238,0,0,0,0,1.0,1,1.0,1,1.0,1,0.6071744291762052,41
2449,1,6239,6239,0,0,0,0,1.0,1,1.0,1,1.0,1,0.615534023896865,40
2450,4,6243,6243,0,0,0,0,1.0,1,1.0,1,1.0,1,0.6378228104151441,42
2451,5,6248,6248,0,0,0,0,1.0,1,1.0,1,1.0,1,0.570290067229213,43
2452,2,6250,6250,0,0,0,0,1.0,1,1.0,1,1.0,1,0.5785850128362816,43
2453,2,6252,6252,0,0,0,0,1.0,1,1.0,1,1.0,1,0.5920530239016899,45
2454,2,6254,6254,0,0,0,0,1.0,1,1.0,1,1.0,1,0.5824430094974208,47
2455,1,6255,6255,0,0,0,0,1.0,1,1.0,1,1.0,1,0.5752465314463014,48
2456,2,6257,6257,0,0,0,0,1.0,1,1.0,1,1.0,1,0.5813300199328585,49
2457,0,6257,6257,0,0,0,0,1.0,1,1.0,1,1.0,1,0.5766839083009041,48
2458,2,6259,6259,0,0,0,0,1.0,1,1.0,1,1.0,1,0.5604796284100889,49
2459,3,6262,6262,0,0,0,0,1.0,1,1.0,1,1.0,1,0.5390350327881588,49
2460,4,6266,6266,0,0,0,0,1.0,1,1.0,1,1.0,1,0.496797044259637,50
2461,4,6270,6270,0,0,0,0,1.0,1,1.0,1,1.0,1,0.47261275562820254,50
2462,8,6278,6278,0,0,0,0,1.0,1,1.0,1,1.0,1,0.5098978660292086,51
2463,7,6285,6285,0,0,0,0,1.0,1,1.0,1,1.0,1,0.5062933556127015,51
2464,7,6292,6292,0,0,0,0,1.0,1,1.0,1,1.0,1,0.529668061151918,50
2465,3,6295,6295,0,0,0,0,1.0,1,1.0,1,1.0,1,0.5222976856833627,49
2466,5,6300,6300,0,0,0,0,1.0,1,1.0,1,1.0,1,0.5140104742229985,49
2467,2,6302,6302,0,0,0,0,1.0,1,1.0,1,1.0,1,0.5225458596694075,48
2468,4,6306,6306,0,0,0,0,1.0,1,1.0,1,1.0,1,0.5779166561438634,47
2469,2,6308,6308,0,0,0,0,1.0,1,1.0,1,1.0,1,0.598980408555769,46
2470,0,6308,6308,0,0,0,0,1.0,1,1.0,1,1.0,1,0.6167932458903562,44
2471,2,6310,6310,0,0,0,0,1.0,1,1.0,1,1.0,1,0.6406569370300566,44
2472,1,6311,6311,0,0,0,0,1.0,1,1.0,1,1.0,1,0.6500424395478539,44
2473,1,6312,6312,0,0,0,0,1.0,1,1.0,1,1.0,1,0.6546476967527064,43
2474,3,6315,6315,0,0,0,0,1.0,1,1.0,1,1.0,1,0.6343388298461806,44
2475,4,6319,6319,0,0,0,0,1.0,1,1.0,1,1.0,1,0.5636212523211851,46
2476,2,6321,6321,0,0,0,0,1.0,1,1.0,1,1.0,1,0.5664196502232328,46
2477,0,6321,6321,0,0,0,0,1.0,1,1.0,1,1.0,1,0.5664196502232328,46
2478,4,6325,6325,0,0,0,0,1.0,1,1.0,1,1.0,1,0.5986714468500951,46
2479,0,6325,6325,0,0,0,0,1.0,1,1.0,1,1.0,1,0.5986714468500951,46
2480,2,6327,6327,0,0,0,0,1.0,1,1.0,1,1.0,1,0.5904273489411245,47
2481,1,6328,6328,0,0,0,0,1.0,1,1.0,1,1.0,1,0.5913353638932505,47
2482,3,6331,6331,0,0,0,0,1.0,1,1.0,1,1.0,1,0.5980805334356258,45
2483,1,6332,6332,0,0,0,0,1.0,1,1.0,1,1.0,1,0.5912131868603718,45
2484,1,6333,6333,0,0,0,0,1.0,1,1.0,1,1.0,1,0.5866254241980632,46
2485,2,6335,6335,0,0,0,0,1.0,1,1.0,1,1.0,1,0.5730411681316898,44
2486,3,6338,6338,0,0,0,0,1.0,1,1.0,1,1.0,1,0.5456806395572077,43
2487,2,6340,6340,0,0,0,0,1.0,1,1.0,1,1.0,1,0.5329566427612082,44
2488,5,6345,6345,0,0,0,0,1.0,1,1.0,1,1.0,1,0.5061875909903882,45
2489,1,6346,6346,0,0,0,0,1.0,1,1.0,1,1.0,1,0.5120895610447787,44
2490,4,6350,6350,0,0,0,0,1.0,1,1.0,1,1.0,1,0.5045705600432833,44
2491,2,6352,6352,0,0,0,0,1.0,1,1.0,1,1.0,1,0.5101710796011169,44
2492,4,6356,6356,0,0,0,0,1.0,1,1.0,1,1.0,1,0.5025251501688621,44
2493,4,6360,6360,0,0,0,0,1.0,1,1.0,1,1.0,1,0.53571354276749,42
2494,1,6361,6361,0,0,0,0,1.0,1,1.0,1,1.0,1,0.5399817064690307,42
2495,2,6363,6363,0,0,0,0,1.0,1,1.0,1,1.0,1,0.5422146860463496,42
2496,2,6365,6365,0,0,0,0,1.0,1,1.0,1,1.0,1,0.553911413947148,42
2497,1,6366,6366,0,0,0,0,1.0,1,1.0,1,1.0,1,0.538186770850481,44
2498,1,6367,6367,0,0,0,0,1.0,1,1.0,1,1.0,1,0.5763173623965555,43
2499,4,6371,6371,0,0,0,0,1.0,1,1.0,1,1.0,1,0.6029058503571685,43
2500,3,6374,6374,0,0,0,0,1.0,1,1.0,1,1.0,1,0.5394871119931843,44
2501,4,6378,6378,0,0,0,0,1.0,1,1.0,1,1.0,1,0.5750128786439662,46
2502,5,6383,6383,0,0,0,0,1.0,1,1.0,1,1.0,1,0.559269538351509,47
2503,2,6385,6385,0,0,0,0,1.0,1,1.0,1,1.0,1,0.5432433866776181,47
2504,4,6389,6389,0,0,0,0,1.0,1,1.0,1,1.0,1,0.5068974632623893,46
2505,5,6394,6394,0,0,0,0,1.0,1,1.0,1,1.0,1,0.5249853035373057,46
2506,2,6396,6396,0,0,0,0,1.0,1,1.0,1,1.0,1,0.5290598048467502,45
2507,4,6400,6400,0,0,0,0,1.0,1,1.0,1,1.0,1,0.5611175514301139,45
2508,1,6401,6401,0,0,0,0,1.0,1,1.0,1,1.0,1,0.5683273815372148,46
2509,3,6404,6404,0,0,0,0,1.0,1,1.0,1,1.0,1,0.5870189769863179,45
2510,3,6407,6407,0,0,0,0,1.0,1,1.0,1,1.0,1,0.5989604911128926,46
2511,1,6408,6408,0,0,0,0,1.0,1,1.0,1,1.0,1,0.6068470743942357,47
2512,2,6410,6410,0,0,0,0,1.0,1,1.0,1,1.0,1,0.5943576009164216,47
2513,4,6414,6414,0,0,0,0,1.0,1,1.0,1,1.0,1,0.573125224795343,48
2514,3,6417,6417,0,0,0,0,1.0,1,1.0,1,1.0,1,0.5529285171496056,48
2515,2,6419,6419,0,0,0,0,1.0,1,1.0,1,1.0,1,0.554168406680743,49
2516,5,6424,6424,0,0,0,0,1.0,1,1.0,1,1.0,1,0.5224434294788618,49
2517,2,6426,6426,0,0,0,0,1.0,1,1.0,1,1.0,1,0.5191147615827026,49
2518,1,6427,6427,0,0,0,0,1.0,1,1.0,1,1.0,1,0.5372795241201072,48
2519,2,6429,6429,0,0,0,0,1.0,1,1.0,1,1.0,1,0.5275018588336833,48
2520,0,6429,6429,0,0,0,0,1.0,1,1.0,1,1.0,1,0.5201882700942387,46
2521,0,6429,6429,0,0,0,0,1.0,1,1.0,1,1.0,1,0.509501670014405,47
2522,2,6431,6431,0,0,0,0,1.0,1,1.0,1,1.0,1,0.5152650372941685,45
2523,3,6434,6434,0,0,0,0,1.0,1,1.0,1,1.0,1,0.47728048455292255,44
2524,1,6435,6435,0,0,0,0,1.0,1,1.0,1,1.0,1,0.44037805222483895,42
2525,1,6436,6436,0,0,0,0,1.0,1,1.0,1,1.0,1,0.4471398499517597,42
2526,0,6436,6436,0,0,0,0,1.0,1,1.0,1,1.0,1,0.4394980028952738,41
2527,2,6438,6438,0,0,0,0,1.0,1,1.0,1,1.0,1,0.43858082926222797,41
2528,0,6438,6438,0,0,0,0,1.0,1,1.0,1,1.0,1,0.4709810954458468,41
2529,0,6438,6438,0,0,0,0,1.0,1,1.0,1,1.0,1,0.4663789060676268,42
2530,2,6440,6440,0,0,0,0,1.0,1,1.0,1,1.0,1,0.46603346294644793,41
2531,1,6441,6441,0,0,0,0,1.0,1,1.0,1,1.0,1,0.4835458992270455,41
2532,2,6443,6443,0,0,0,0,1.0,1,1.0,1,1.0,1,0.5351753501872529,43
2533,0,6443,6443,0,0,0,0,1.0,1,1.0,1,1.0,1,0.5351753501872529,43
2534,1,6444,6444,0,0,0,0,1.0,1,1.0,1,1.0,1,0.5389032287508372,43
2535,2,6446,6446,0,0,0,0,1.0,1,1.0,1,1.0,1,0.5143055781835768,44
2536,2,6448,6448,0,0,0,0,1.0,1,1.0,1,1.0,1,0.5190007911136616,44
2537,2,6450,6450,0,0,0,0,1.0,1,1.0,1,1.0,1,0.5120469598429126,45
2538,4,6454,6454,0,0,0,0,1.0,1,1.0,1,1.0,1,0.5149914889436613,48
2539,5,6459,6459,0,0,0,0,1.0,1,1.0,1,1.0,1,0.5187875825380429,48
2540,5,6464,6464,0,0,0,0,1.0,1,1.0,1,1.0,1,0.5567205306374364,50
2541,9,6473,6473,0,0,0,0,1.0,1,1.0,1,1.0,1,0.49158386304495383,52
2542,3,6476,6476,0,0,0,0,1.0,1,1.0,1,1.0,1,0.4877679469231787,52
2543,5,6481,6481,0,0,0,0,1.0,1,1.0,1,1.0,1,0.468322746706454,51
2544,3,6484,6484,0,0,0,0,1.0,1,1.0,1,1.0,1,0.5045894293255331,51
2545,4,6488,6488,0,0,0,0,1.0,1,1.0,1,1.0,1,0.5277908573027801,50
2546,4,6492,6492,0,0,0,0,1.0,1,1.0,1,1.0,1,0.5408219277267405,50
2547,0,6492,6492,0,0,0,0,1.0,1,1.0,1,1.0,1,0.5451099455090344,47
2548,3,6495,6495,0,0,0,0,1.0,1,1.0,1,1.0,1,0.5226830704899782,46
2549,0,6495,6495,0,0,0,0,1.0,1,1.0,1,1.0,1,0.530984630880482,46
2550,2,6497,6497,0,0,0,0,1.0,1,1.0,1,1.0,1,0.5346639069177265,44
2551,2,6499,6499,0,0,0,0,1.0,1,1.0,1,1.0,1,0.5378438258300272,43
2552,2,6501,6501,0,0,0,0,1.0,1,1.0,1,1.0,1,0.5599749231629795,43
2553,3,6504,6504,0,0,0,0,1.0,1,1.0,1,1.0,1,0.5787739155590162,44
2554,1,6505,6505,0,0,0,0,1.0,1,1.0,1,1.0,1,0.5573034807703782,45
2555,2,6507,6507,0,0,0,0,1.0,1,1.0,1,1.0,1,0.5596524792381068,44
2556,1,6508,6508,0,0,0,0,1.0,1,1.0,1,1.0,1,0.5504341304532469,44
2557,2,6510,6510,0,0,0,0,1.0,1,1.0,1,1.0,1,0.5372308434157289,41
2558,0,6510,6510,0,0,0,0,1.0,1,1.0,1,1.0,1,0.5124306389484826,40
2559,0,6510,6510,0,0,0,0,1.0,1,1.0,1,1.0,1,0.5034995720112503,41
2560,1,6511,6511,0,0,0,0,1.0,1,1.0,1,1.0,1,0.4989243831471646,41
2561,4,6515,6515,0,0,0,0,1.0,1,1.0,1,1.0,1,0.5300046426566037,43
2562,4,6519,6519,0,0,0,0,1.0,1,1.0,1,1.0,1,0.5609262602453846,44
2563,3,6522,6522,0,0,0,0,1.0,1,1.0,1,1.0,1,0.5778645437255422,44
2564,4,6526,6526,0,0,0,0,1.0,1,1.0,1,1.0,1,0.5745434102308477,44
2565,4,6530,6530,0,0,0,0,1.0,1,1.0,1,1.0,1,0.5874721123884807,45
2566,1,6531,6531,0,0,0,0,1.0,1,1.0,1,1.0,1,0.5913240486208633,46
2567,4,6535,6535,0,0,0,0,1.0,1,1.0,1,1.0,1,0.5564859564177759,48
2568,3,6538,6538,0,0,0,0,1.0,1,1.0,1,1.0,1,0.5604851274898289,48
2569,2,6540,6540,0,0,0,0,1.0,1,1.0,1,1.0,1,0.5469538576537151,49
2570,0,6540,6540,0,0,0,0,1.0,1,1.0,1,1.0,1,0.5485906100758222,48
2571,1,6541,6541,0,0,0,0,1.0,1,1.0,1,1.0,1,0.530657505334084,48
2572,0,6541,6541,0,0,0,0,1.0,1,1.0,1,1.0,1,0.5130229546788398,49
2573,1,6542,6542,0,0,0,0,1.0,1,1.0,1,1.0,1,0.49503906608677023,50
2574,0,6542,6542,0,0,0,0,1.0,1,1.0,1,1.0,1,0.4927991076541222,49
2575,1,6543,6543,0,0,0,0,1.0,1,1.0,1,1.0,1,0.4875319120564572,48
2576,1,6544,6544,0,0,0,0,1.0,1,1.0,1,1.0,1,0.47221825133146866,48
2577,0,6544,6544,0,0,0,0,1.0,1,1.0,1,1.0,1,0.49655843625796214,50
2578,2,6546,6546,0,0,0,0,1.0,1,1.0,1,1.0,1,0.5255930313784672,50
2579,5,6551,6551,0,0,0,0,1.0,1,1.0,1,1.0,1,0.49214559981731076,51
2580,2,6553,6553,0,0,0,0,1.0,1,1.0,1,1.0,1,0.5358210242361271,52
2581,4,6557,6557,0,0,0,0,1.0,1,1.0,1,1.0,1,0.5364198158504642,51
2582,5,6562,6562,0,0,0,0,1.0,1,1.0,1,1.0,1,0.5822552824485441,51
2583,4,6566,6566,0,0,0,0,1.0,1,1.0,1,1.0,1,0.5887970975247715,51
2584,7,6573,6573,0,0,0,0,1.0,1,1.0,1,1.0,1,0.5880432349770685,51
2585,6,6579,6579,0,0,0,0,1.0,1,1.0,1,1.0,1,0.5546672529626127,50
2586,6,6585,6585,0,0,0,0,1.0,1,1.0,1,1.0,1,0.5507908245437745,50
2587,1,6586,6586,0,0,0,0,1.0,1,1.0,1,1.0,1,0.5561817505166373,48
2588,4,6590,6590,0,0,0,0,1.0,1,1.0,1,1.0,1,0.5108274936552352,50
2589,2,6592,6592,0,0,0,0,1.0,1,1.0,1,1.0,1,0.5040434468877609,48
2590,6,6598,6598,0,0,0,0,1.0,1,1.0,1,1.0,1,0.5213473908701582,47
2591,3,6601,6601,0,0,0,0,1.0,1,1.0,1,1.0,1,0.5450313708931483,47
2592,6,6607,6607,0,0,0,0,1.0,1,1.0,1,1.0,1,0.6296366946362395,47
2593,2,6609,6609,0,0,0,0,1.0,1,1.0,1,1.0,1,0.614841754279263,47
2594,2,6611,6611,0,0,0,0,1.0,1,1.0,1,1.0,1,0.5970570902233556,49
2595,4,6615,6615,0,0,0,0,1.0,1,1.0,1,1.0,1,0.5944401606069171,48
2596,1,6616,6616,0,0,0,0,1.0,1,1.0,1,1.0,1,0.5870084171159756,47
2597,3,6619,6619,0,0,0,0,1.0,1,1.0,1,1.0,1,0.5756687067216637,48
2598,1,6620,6620,0,0,0,0,1.0,1,1.0,1,1.0,1,0.5647300436037769,48
2599,4,6624,6624,0,0,0,0,1.0,1,1.0,1,1.0,1,0.5098776085523427,49
2600,0,6624,6624,0,0,0,0,1.0,1,1.0,1,1.0,1,0.5037594634073087,52
2601,3,6627,6627,0,0,0,0,1.0,1,1.0,1,1.0,1,0.5011289242773103,51
2602,1,6628,6628,0,0,0,0,1.0,1,1.0,1,1.0,1,0.5048962435174799,52
2603,3,6631,6631,0,0,0,0,1.0,1,1.0,1,1.0,1,0.476155260436432,53
2604,1,6632,6632,0,0,0,0,1.0,1,1.0,1,1.0,1,0.4850215641524265,53
2605,0,6632,6632,0,0,0,0,1.0,1,1.0,1,1.0,1,0.4860733906916941,52
2606,3,6635,6635,0,0,0,0,1.0,1,1.0,1,1.0,1,0.5120715664943705,52
2607,3,6638,6638,0,0,0,0,1.0,1,1.0,1,1.0,1,0.5008725465654805,52
2608,4,6642,6642,0,0,0,0,1.0,1,1.0,1,1.0,1,0.54493347758029,52
2609,3,6645,6645,0,0,0,0,1.0,1,1.0,1,1.0,1,0.5542769197775711,53
2610,5,6650,6650,0,0,0,0,1.0,1,1.0,1,1.0,1,0.5363922561601782,54
2611,5,6655,6655,0,0,0,0,1.0,1,1.0,1,1.0,1,0.49623226986455043,54
2612,3,6658,6658,0,0,0,0,1.0,1,1.0,1,1.0,1,0.5131954065445039,56
2613,3,6661,6661,0,0,0,0,1.0,1,1.0,1,1.0,1,0.5239134886840319,56
2614,5,6666,6666,0,0,0,0,1.0,1,1.0,1,1.0,1,0.5564720222187758,56
2615,2,6668,6668,0,0,0,0,1.0,1,1.0,1,1.0,1,0.5502111097643054,57
2616,3,6671,6671,0,0,0,0,1.0,1,1.0,1,1.0,1,0.5490324220181242,57
2617,3,6674,6674,0,0,0,0,1.0,1,1.0,1,1.0,1,0.5490399734945629,58
2618,2,6676,6676,0,0,0,0,1.0,1,1.0,1,1.0,1,0.5402749097032499,58
2619,3,6679,6679,0,0,0,0,1.0,1,1.0,1,1.0,1,0.5257194691932991,58
2620,1,6680,6680,0,0,0,0,1.0,1,1.0,1,1.0,1,0.5144981700125678,60
2621,2,6682,6682,0,0,0,0,1.0,1,1.0,1,1.0,1,0.5327544143472908,59
2622,2,6684,6684,0,0,0,0,1.0,1,1.0,1,1.0,1,0.5338376562395979,60
2623,5,6689,6689,0,0,0,0,1.0,1,1.0,1,1.0,1,0.531727755653758,59
2624,5,6694,6694,0,0,0,0,1.0,1,1.0,1,1.0,1,0.5613425270697676,58
2625,3,6697,6697,0,0,0,0,1.0,1,1.0,1,1.0,1,0.579687538425398,58
2626,1,6698,6698,0,0,0,0,1.0,1,1.0,1,1.0,1,0.5921111864732735,57
2627,2,6700,6700,0,0,0,0,1.0,1,1.0,1,1.0,1,0.6184292739599186,55
2628,2,6702,6702,0,0,0,0,1.0,1,1.0,1,1.0,1,0.6027390470295905,55
2629,1,6703,6703,0,0,0,0,1.0,1,1.0,1,1.0,1,0.6159617203234246,54
2630,1,6704,6704,0,0,0,0,1.0,1,1.0,1,1.0,1,0.6149416026276203,55
2631,0,6704,6704,0,0,0,0,1.0,1,1.0,1,1.0,1,0.6026173209925032,55
2632,2,6706,6706,0,0,0,0,1.0,1,1.0,1,1.0,1,0.5948218380941708,55
2633,4,6710,6710,0,0,0,0,1.0,1,1.0,1,1.0,1,0.5954479270564907,53
2634,3,6713,6713,0,0,0,0,1.0,1,1.0,1,1.0,1,0.5806349808095266,52
2635,6,6719,6719,0,0,0,0,1.0,1,1.0,1,1.0,1,0.6042568801842778,52
2636,7,6726,6726,0,0,0,0,1.0,1,1.0,1,1.0,1,0.6136129504927783,51
2637,6,6732,6732,0,0,0,0,1.0,1,1.0,1,1.0,1,0.6352440036306264,50
2638,8,6740,6740,0,0,0,0,1.0,1,1.0,1,1.0,1,0.5538317342718398,48
2639,6,6746,6746,0,0,0,0,1.0,1,1.0,1,1.0,1,0.5951007632221711,48
2640,4,6750,6750,0,0,0,0,1.0,1,1.0,1,1.0,1,0.5677714584505678,46
2641,4,6754,6754,0,0,0,0,1.0,1,1.0,1,1.0,1,0.5793251484832922,46
2642,4,6758,6758,0,0,0,0,1.0,1,1.0,1,1.0,1,0.5479084367769468,47
2643,3,6761,6761,0,0,0,0,1.0,1,1.0,1,1.0,1,0.5575792103919387,45
2644,3,6764,6764,0,0,0,0,1.0,1,1.0,1,1.0,1,0.5719829337859287,44
2645,6,6770,6770,0,0,0,0,1.0,1,1.0,1,1.0,1,0.5274454708609805,42
2646,3,6773,6773,0,0,0,0,1.0,1,1.0,1,1.0,1,0.5430945872330293,43
2647,5,6778,6778,0,0,0,0,1.0,1,1.0,1,1.0,1,0.5513145470283473,40
2648,2,6780,6780,0,0,0,0,1.0,1,1.0,1,1.0,1,0.5556184903193063,41
2649,1,6781,6781,0,0,0,0,1.0,1,1.0,1,1.0,1,0.5453789185785297,43
2650,1,6782,6782,0,0,0,0,1.0,1,1.0,1,1.0,1,0.5668762132666723,43
2651,3,6785,6785,0,0,0,0,1.0,1,1.0,1,1.0,1,0.525418242026587,44
2652,1,6786,6786,0,0,0,0,1.0,1,1.0,1,1.0,1,0.5296027804189508,44
2653,1,6787,6787,0,0,0,0,1.0,1,1.0,1,1.0,1,0.5236013793586123,44
2654,5,6792,6792,0,0,0,0,1.0,1,1.0,1,1.0,1,0.5307283874710704,45
2655,0,6792,6792,0,0,0,0,1.0,1,1.0,1,1.0,1,0.5307283874710704,45
2656,2,6794,6794,0,0,0,0,1.0,1,1.0,1,1.0,1,0.5445815854562376,45
2657,2,6796,6796,0,0,0,0,1.0,1,1.0,1,1.0,1,0.5333689799643158,45
2658,4,6800,6800,0,0,0,0,1.0,1,1.0,1,1.0,1,0.5290116026090113,47
2659,5,6805,6805,0,0,0,0,1.0,1,1.0,1,1.0,1,0.5392482412841113,46
2660,9,6814,6814,0,0,0,0,1.0,1,1.0,1,1.0,1,0.5261968680299851,46
2661,2,6816,6816,0,0,0,0,1.0,1,1.0,1,1.0,1,0.5318481945650603,46
2662,8,6824,6824,0,0,0,0,1.0,1,1.0,1,1.0,1,0.5339983065262827,47
2663,7,6831,6831,0,0,0,0,1.0,1,1.0,1,1.0,1,0.5432359674106658,46
2664,3,6834,6834,0,0,0,0,1.0,1,1.0,1,1.0,1,0.5431956428118886,45
2665,3,6837,6837,0,0,0,0,1.0,1,1.0,1,1.0,1,0.5484144974204108,47
2666,6,6843,6843,0,0,0,0,1.0,1,1.0,1,1.0,1,0.5321944322647845,47
2667,4,6847,6847,0,0,0,0,1.0,1,1.0,1,1.0,1,0.5183385806369095,45
2668,3,6850,6850,0,0,0,0,1.0,1,1.0,1,1.0,1,0.5759737104586246,45
2669,3,6853,6853,0,0,0,0,1.0,1,1.0,1,1.0,1,0.562857396044527,45
2670,4,6857,6857,0,0,0,0,1.0,1,1.0,1,1.0,1,0.5809588181572002,45
2671,3,6860,6860,0,0,0,0,1.0,1,1.0,1,1.0,1,0.6021737421600928,41
2672,2,6862,6862,0,0,0,0,1.0,1,1.0,1,1.0,1,0.6321154708038248,40
2673,3,6865,6865,0,0,0,0,1.0,1,1.0,1,1.0,1,0.6421470258767619,39
2674,6,6871,6871,0,0,0,0,1.0,1,1.0,1,1.0,1,0.6341359246662521,37
2675,1,6872,6872,0,0,0,0,1.0,1,1.0,1,1.0,1,0.6190672849555418,35
2676,3,6875,6875,0,0,0,0,1.0,1,1.0,1,1.0,1,0.6265563669235854,34
2677,2,6877,6877,0,0,0,0,1.0,1,1.0,1,1.0,1,0.580635013883369,32
2678,2,6879,6879,0,0,0,0,1.0,1,1.0,1,1.0,1,0.5768292666399792,33
2679,1,6880,6880,0,0,0,0,1.0,1,1.0,1,1.0,1,0.5729680348181286,33
2680,1,6881,6881,0,0,0,0,1.0,1,1.0,1,1.0,1,0.5797306616368109,33
2681,1,6882,6882,0,0,0,0,1.0,1,1.0,1,1.0,1,0.5341838214071256,32
2682,0,6882,6882,0,0,0,0,1.0,1,1.0,1,1.0,1,0.5341838214071256,32
2683,2,6884,6884,0,0,0,0,1.0,1,1.0,1,1.0,1,0.5178732051625897,32
2684,1,6885,6885,0,0,0,0,1.0,1,1.0,1,1.0,1,0.49682128292647876,31
2685,2,6887,6887,0,0,0,0,1.0,1,1.0,1,1.0,1,0.498469342735463,30
2686,3,6890,6890,0,0,0,0,1.0,1,1.0,1,1.0,1,0.4656929046146081,29
2687,1,6891,6891,0,0,0,0,1.0,1,1.0,1,1.0,1,0.503133991789651,28
2688,3,6894,6894,0,0,0,0,1.0,1,1.0,1,1.0,1,0.5530086386106937,28
2689,3,6897,6897,0,0,0,0,1.0,1,1.0,1,1.0,1,0.6150361989477287,29
2690,1,6898,6898,0,0,0,0,1.0,1,1.0,1,1.0,1,0.6389759722664123,29
2691,0,6898,6898,0,0,0,0,1.0,1,1.0,1,1.0,1,0.6389759722664123,29
2692,5,6903,6903,0,0,0,0,1.0,1,1.0,1,1.0,1,0.6286420467026805,31
2693,3,6906,6906,0,0,0,0,1.0,1,1.0,1,1.0,1,0.5447130698542069,32
2694,2,6908,6908,0,0,0,0,1.0,1,1.0,1,1.0,1,0.5147929500937535,32
2695,2,6910,6910,0,0,0,0,1.0,1,1.0,1,1.0,1,0.5398432549343495,33
2696,2,6912,6912,0,0,0,0,1.0,1,1.0,1,1.0,1,0.5731567902703787,33
2697,1,6913,6913,0,0,0,0,1.0,1,1.0,1,1.0,1,0.5734574598379166,34
2698,0,6913,6913,0,0,0,0,1.0,1,1.0,1,1.0,1,0.5734574598379166,34
2699,5,6918,6918,0,0,0,0,1.0,1,1.0,1,1.0,1,0.5327168133262473,36
2700,4,6922,6922,0,0,0,0,1.0,1,1.0,1,1.0,1,0.5596675444921767,36
2701,2,6924,6924,0,0,0,0,1.0,1,1.0,1,1.0,1,0.5721404666775528,36
2702,3,6927,6927,0,0,0,0,1.0,1,1.0,1,1.0,1,0.5783294863056679,36
2703,3,6930,6930,0,0,0,0,1.0,1,1.0,1,1.0,1,0.57325339296197,38
2704,3,6933,6933,0,0,0,0,1.0,1,1.0,1,1.0,1,0.590074179815394,37
2705,3,6936,6936,0,0,0,0,1.0,1,1.0,1,1.0,1,0.6098197397910294,36
2706,3,6939,6939,0,0,0,0,1.0,1,1.0,1,1.0,1,0.6642435496663083,34
2707,3,6942,6942,0,0,0,0,1.0,1,1.0,1,1.0,1,0.6309663988478318,36
2708,3,6945,6945,0,0,0,0,1.0,1,1.0,1,1.0,1,0.5955362658581269,36
2709,5,6950,6950,0,0,0,0,1.0,1,1.0,1,1.0,1,0.57636117076352,33
2710,5,6955,6955,0,0,0,0,1.0,1,1.0,1,1.0,1,0.546560158619235,32
2711,3,6958,6958,0,0,0,0,1.0,1,1.0,1,1.0,1,0.5249589100255021,29
2712,2,6960,6960,0,0,0,0,1.0,1,1.0,1,1.0,1,0.4906540940470331,28
2713,1,6961,6961,0,0,0,0,1.0,1,1.0,1,1.0,1,0.5129803903873766,28
2714,4,6965,6965,0,0,0,0,1.0,1,1.0,1,1.0,1,0.5104347866595879,25
2715,1,6966,6966,0,0,0,0,1.0,1,1.0,1,1.0,1,0.47855930719578205,24
2716,6,6972,6972,0,0,0,0,1.0,1,1.0,1,1.0,1,0.5683896807466223,23
2717,2,6974,6974,0,0,0,0,1.0,1,1.0,1,1.0,1,0.5583928331981859,24
2718,3,6977,6977,0,0,0,0,1.0,1,1.0,1,1.0,1,0.5746028587589144,24
2719,2,6979,6979,0,0,0,0,1.0,1,1.0,1,1.0,1,0.5288470547227305,25
2720,2,6981,6981,0,0,0,0,1.0,1,1.0,1,1.0,1,0.5478266393545684,25
2721,2,6983,6983,0,0,0,0,1.0,1,1.0,1,1.0,1,0.5189310336604857,26
2722,2,6985,6985,0,0,0,0,1.0,1,1.0,1,1.0,1,0.5827316593563524,26
2723,2,6987,6987,0,0,0,0,1.0,1,1.0,1,1.0,1,0.5462829763424277,26
2724,2,6989,6989,0,0,0,0,1.0,1,1.0,1,1.0,1,0.5013440565375286,27
2725,2,6991,6991,0,0,0,0,1.0,1,1.0,1,1.0,1,0.500975808453654,27
2726,0,6991,6991,0,0,0,0,1.0,1,1.0,1,1.0,1,0.5179397732910868,28
2727,0,6991,6991,0,0,0,0,1.0,1,1.0,1,1.0,1,0.49797551023685666,29
2728,3,6994,6994,0,0,0,0,1.0,1,1.0,1,1.0,1,0.5474356416186178,28
2729,1,6995,6995,0,0,0,0,1.0,1,1.0,1,1.0,1,0.4927353034579834,28
2730,1,6996,6996,0,0,0,0,1.0,1,1.0,1,1.0,1,0.47861221442925617,29
2731,3,6999,6999,0,0,0,0,1.0,1,1.0,1,1.0,1,0.5045133678195877,30
2732,2,7001,7001,0,0,0,0,1.0,1,1.0,1,1.0,1,0.5749718534853471,29
2733,3,7004,7004,0,0,0,0,1.0,1,1.0,1,1.0,1,0.6073564219767178,29
2734,2,7006,7006,0,0,0,0,1.0,1,1.0,1,1.0,1,0.609448280698306,29
2735,3,7009,7009,0,0,0,0,1.0,1,1.0,1,1.0,1,0.6631408788682356,29
2736,0,7009,7009,0,0,0,0,1.0,1,1.0,1,1.0,1,0.6683852080545516,30
2737,0,7009,7009,0,0,0,0,1.0,1,1.0,1,1.0,1,0.6683852080545516,30
2738,0,7009,7009,0,0,0,0,1.0,1,1.0,1,1.0,1,0.6961316760863004,29
2739,3,7012,7012,0,0,0,0,1.0,1,1.0,1,1.0,1,0.6672039836554943,30
2740,3,7015,7015,0,0,0,0,1.0,1,1.0,1,1.0,1,0.6848578162117285,29
2741,0,7015,7015,0,0,0,0,1.0,1,1.0,1,1.0,1,0.6848578162117285,29
2742,2,7017,7017,0,0,0,0,1.0,1,1.0,1,1.0,1,0.713619285231799,29
2743,0,7017,7017,0,0,0,0,1.0,1,1.0,1,1.0,1,0.7119724380562125,30
2744,2,7019,7019,0,0,0,0,1.0,1,1.0,1,1.0,1,0.7369576052253461,28
2745,0,7019,7019,0,0,0,0,1.0,1,1.0,1,1.0,1,0.7477291096430192,27
2746,2,7021,7021,0,0,0,0,1.0,1,1.0,1,1.0,1,0.705095188116952,26
2747,1,7022,7022,0,0,0,0,1.0,1,1.0,1,1.0,1,0.709021831975118,22
2748,5,7027,7027,0,0,0,0,1.0,1,1.0,1,1.0,1,0.6023854274754012,22
2749,2,7029,7029,0,0,0,0,1.0,1,1.0,1,1.0,1,0.5400141414935161,20
2750,3,7032,7032,0,0,0,0,1.0,1,1.0,1,1.0,1,0.5498268982935482,17
2751,4,7036,7036,0,0,0,0,1.0,1,1.0,1,1.0,1,0.5967740658805556,17
2752,3,7039,7039,0,0,0,0,1.0,1,1.0,1,1.0,1,0.6288813791081886,16
2753,1,7040,7040,0,0,0,0,1.0,1,1.0,1,1.0,1,0.5961188970467067,16
2754,2,7042,7042,0,0,0,0,1.0,1,1.0,1,1.0,1,0.5976066452733857,16
2755,1,7043,7043,0,0,0,0,1.0,1,1.0,1,1.0,1,0.6058004154020098,16
2756,0,7043,7043,0,0,0,0,1.0,1,1.0,1,1.0,1,0.622227570604459,17
2757,0,7043,7043,0,0,0,0,1.0,1,1.0,1,1.0,1,0.5816419696395801,18
2758,0,7043,7043,0,0,0,0,1.0,1,1.0,1,1.0,1,0.5816419696395801,18
2759,1,7044,7044,0,0,0,0,1.0,1,1.0,1,1.0,1,0.5680129182677329,19
2760,1,7045,7045,0,0,0,0,1.0,1,1.0,1,1.0,1,0.47009301979607443,18
2761,1,7046,7046,0,0,0,0,1.0,1,1.0,1,1.0,1,0.48103161985578813,18
2762,1,7047,7047,0,0,0,0,1.0,1,1.0,1,1.0,1,0.5015643766846591,18
2763,0,7047,7047,0,0,0,0,1.0,1,1.0,1,1.0,1,0.5015643766846591,18
2764,0,7047,7047,0,0,0,0,1.0,1,1.0,1,1.0,1,0.5015643766846591,18
2765,0,7047,7047,0,0,0,0,1.0,1,1.0,1,1.0,1,0.535841594355051,18
2766,0,7047,7047,0,0,0,0,1.0,1,1.0,1,1.0,1,0.535841594355051,18
2767,0,7047,7047,0,0,0,0,1.0,1,1.0,1,1.0,1,0.5779033823438967,17
2768,2,7049,7049,0,0,0,0,1.0,1,1.0,1,1.0,1,0.5752171648639305,17
2769,1,7050,7050,0,0,0,0,1.0,1,1.0,1,1.0,1,0.5911702890348133,17
2770,0,7050,7050,0,0,0,0,1.0,1,1.0,1,1.0,1,0.5911702890348133,17
2771,3,7053,7053,0,0,0,0,1.0,1,1.0,1,1.0,1,0.5840690630334467,17
2772,1,7054,7054,0,0,0,0,1.0,1,1.0,1,1.0,1,0.5919848869092258,17
2773,0,7054,7054,0,0,0,0,1.0,1,1.0,1,1.0,1,0.5919848869092258,17
2774,4,7058,7058,0,0,0,0,1.0,1,1.0,1,1.0,1,0.48218547042861165,18
2775,1,7059,7059,0,0,0,0,1.0,1,1.0,1,1.0,1,0.501721306255367,20
2776,3,7062,7062,0,0,0,0,1.0,1,1.0,1,1.0,1,0.5104207618585125,21
2777,0,7062,7062,0,0,0,0,1.0,1,1.0,1,1.0,1,0.5104207618585125,21
2778,3,7065,7065,0,0,0,0,1.0,1,1.0,1,1.0,1,0.5614634373285577,21
2779,2,7067,7067,0,0,0,0,1.0,1,1.0,1,1.0,1,0.5429665020445905,22
2780,2,7069,7069,0,0,0,0,1.0,1,1.0,1,1.0,1,0.6006385368100284,22
2781,1,7070,7070,0,0,0,0,1.0,1,1.0,1,1.0,1,0.648481829583056,22
2782,2,7072,7072,0,0,0,0,1.0,1,1.0,1,1.0,1,0.6579867826925908,23
2783,1,7073,7073,0,0,0,0,1.0,1,1.0,1,1.0,1,0.6820756127362732,22
2784,0,7073,7073,0,0,0,0,1.0,1,1.0,1,1.0,1,0.6737392050943358,21
2785,0,7073,7073,0,0,0,0,1.0,1,1.0,1,1.0,1,0.6516134978045509,19
2786,0,7073,7073,0,0,0,0,1.0,1,1.0,1,1.0,1,0.6516134978045509,19
2787,0,7073,7073,0,0,0,0,1.0,1,1.0,1,1.0,1,0.606121065825943,20
2788,1,7074,7074,0,0,0,0,1.0,1,1.0,1,1.0,1,0.5952825105352769,20
2789,0,7074,7074,0,0,0,0,1.0,1,1.0,1,1.0,1,0.5848087831889457,19
2790,1,7075,7075,0,0,0,0,1.0,1,1.0,1,1.0,1,0.5376130303248198,20
2791,0,7075,7075,0,0,0,0,1.0,1,1.0,1,1.0,1,0.5376130303248198,20
2792,2,7077,7077,0,0,0,0,1.0,1,1.0,1,1.0,1,0.547812032749293,20
2793,1,7078,7078,0,0,0,0,1.0,1,1.0,1,1.0,1,0.5815570088336189,19
2794,1,7079,7079,0,0,0,0,1.0,1,1.0,1,1.0,1,0.5407258030925214,20
2795,1,7080,7080,0,0,0,0,1.0,1,1.0,1,1.0,1,0.549948868556761,21
2796,0,7080,7080,0,0,0,0,1.0,1,1.0,1,1.0,1,0.5604835564818711,22
2797,0,7080,7080,0,0,0,0,1.0,1,1.0,1,1.0,1,0.582354080930453,21
2798,0,7080,7080,0,0,0,0,1.0,1,1.0,1,1.0,1,0.582354080930453,21
2799,0,7080,7080,0,0,0,0,1.0,1,1.0,1,1.0,1,0.5986762830868004,20
2800,1,7081,7081,0,0,0,0,1.0,1,1.0,1,1.0,1,0.6072284477554495,20
2801,2,7083,7083,0,0,0,0,1.0,1,1.0,1,1.0,1,0.6140247772518872,20
2802,2,7085,7085,0,0,0,0,1.0,1,1.0,1,1.0,1,0.6623612072664562,20
2803,6,7091,7091,0,0,0,0,1.0,1,1.0,1,1.0,1,0.6487620269888131,21
2804,3,7094,7094,0,0,0,0,1.0,1,1.0,1,1.0,1,0.679465249881033,22
2805,3,7097,7097,0,0,0,0,1.0,1,1.0,1,1.0,1,0.7074471905836751,22
2806,5,7102,7102,0,0,0,0,1.0,1,1.0,1,1.0,1,0.7043930268865324,23
2807,2,7104,7104,0,0,0,0,1.0,1,1.0,1,1.0,1,0.6684376487564385,24
2808,3,7107,7107,0,0,0,0,1.0,1,1.0,1,1.0,1,0.6080810834517432,24
2809,2,7109,7109,0,0,0,0,1.0,1,1.0,1,1.0,1,0.6178397275949586,26
2810,3,7112,7112,0,0,0,0,1.0,1,1.0,1,1.0,1,0.56377954684549,26
2811,2,7114,7114,0,0,0,0,1.0,1,1.0,1,1.0,1,0.567978645952643,27
2812,2,7116,7116,0,0,0,0,1.0,1,1.0,1,1.0,1,0.5301962860436982,27
2813,0,7116,7116,0,0,0,0,1.0,1,1.0,1,1.0,1,0.5041336939592527,28
2814,0,7116,7116,0,0,0,0,1.0,1,1.0,1,1.0,1,0.5107130863704491,29
2815,1,7117,7117,0,0,0,0,1.0,1,1.0,1,1.0,1,0.5290469790763783,30
2816,0,7117,7117,0,0,0,0,1.0,1,1.0,1,1.0,1,0.5207263272592263,31
2817,0,7117,7117,0,0,0,0,1.0,1,1.0,1,1.0,1,0.5207263272592263,31
2818,2,7119,7119,0,0,0,0,1.0,1,1.0,1,1.0,1,0.48381272354935284,32
2819,3,7122,7122,0,0,0,0,1.0,1,1.0,1,1.0,1,0.4457073638180265,32
2820,1,7123,7123,0,0,0,0,1.0,1,1.0,1,1.0,1,0.4579477490989937,33
2821,1,7124,7124,0,0,0,0,1.0,1,1.0,1,1.0,1,0.4927643444528029,34
2822,3,7127,7127,0,0,0,0,1.0,1,1.0,1,1.0,1,0.5222468897498131,35
2823,1,7128,7128,0,0,0,0,1.0,1,1.0,1,1.0,1,0.5540726807855002,31
2824,4,7132,7132,0,0,0,0,1.0,1,1.0,1,1.0,1,0.5131353229673611,33
2825,1,7133,7133,0,0,0,0,1.0,1,1.0,1,1.0,1,0.5436855172125421,31
2826,3,7136,7136,0,0,0,0,1.0,1,1.0,1,1.0,1,0.5747965265347724,31
2827,3,7139,7139,0,0,0,0,1.0,1,1.0,1,1.0,1,0.5819647516693016,32
2828,10,7149,7149,0,0,0,0,1.0,1,1.0,1,1.0,1,0.6255494804636708,33
2829,1,7150,7150,0,0,0,0,1.0,1,1.0,1,1.0,1,0.6038729475917293,33
2830,8,7158,7158,0,0,0,0,1.0,1,1.0,1,1.0,1,0.6328565867075361,32
2831,2,7160,7160,0,0,0,0,1.0,1,1.0,1,1.0,1,0.6015054387417489,31
2832,4,7164,7164,0,0,0,0,1.0,1,1.0,1,1.0,1,0.6520298196938042,30
2833,5,7169,7169,0,0,0,0,1.0,1,1.0,1,1.0,1,0.6355758098972819,29
2834,3,7172,7172,0,0,0,0,1.0,1,1.0,1,1.0,1,0.6173080767239493,29
2835,4,7176,7176,0,0,0,0,1.0,1,1.0,1,1.0,1,0.6000217068155993,27
2836,3,7179,7179,0,0,0,0,1.0,1,1.0,1,1.0,1,0.5376550200571532,27
2837,4,7183,7183,0,0,0,0,1.0,1,1.0,1,1.0,1,0.5572716645742982,28
2838,2,7185,7185,0,0,0,0,1.0,1,1.0,1,1.0,1,0.5066166334695013,29
2839,2,7187,7187,0,0,0,0,1.0,1,1.0,1,1.0,1,0.5255754014892273,29
2840,2,7189,7189,0,0,0,0,1.0,1,1.0,1,1.0,1,0.5396306418678325,29
2841,2,7191,7191,0,0,0,0,1.0,1,1.0,1,1.0,1,0.49841409703577905,31
2842,3,7194,7194,0,0,0,0,1.0,1,1.0,1,1.0,1,0.5311550311417835,32
2843,1,7195,7195,0,0,0,0,1.0,1,1.0,1,1.0,1,0.5263865850309225,32
2844,1,7196,7196,0,0,0,0,1.0,1,1.0,1,1.0,1,0.5493421568274207,33
2845,1,7197,7197,0,0,0,0,1.0,1,1.0,1,1.0,1,0.5013040214338689,34
2846,2,7199,7199,0,0,0,0,1.0,1,1.0,1,1.0,1,0.47073362911869115,34
2847,2,7201,7201,0,0,0,0,1.0,1,1.0,1,1.0,1,0.4298357725365086,35
2848,1,7202,7202,0,0,0,0,1.0,1,1.0,1,1.0,1,0.43385596032339907,37
2849,1,7203,7203,0,0,0,0,1.0,1,1.0,1,1.0,1,0.4271292414057174,37
2850,0,7203,7203,0,0,0,0,1.0,1,1.0,1,1.0,1,0.4271292414057174,37
2851,0,7203,7203,0,0,0,0,1.0,1,1.0,1,1.0,1,0.43659253740164145,38
2852,3,7206,7206,0,0,0,0,1.0,1,1.0,1,1.0,1,0.4239526100202466,36
2853,4,7210,7210,0,0,0,0,1.0,1,1.0,1,1.0,1,0.49108946539570575,36
2854,0,7210,7210,0,0,0,0,1.0,1,1.0,1,1.0,1,0.4824123378947886,37
2855,5,7215,7215,0,0,0,0,1.0,1,1.0,1,1.0,1,0.6026829663307156,37
2856,1,7216,7216,0,0,0,0,1.0,1,1.0,1,1.0,1,0.5764810663550485,38
2857,2,7218,7218,0,0,0,0,1.0,1,1.0,1,1.0,1,0.6150301483891052,39
2858,4,7222,7222,0,0,0,0,1.0,1,1.0,1,1.0,1,0.6050754479281857,39
2859,5,7227,7227,0,0,0,0,1.0,1,1.0,1,1.0,1,0.6052103950845875,39
2860,5,7232,7232,0,0,0,0,1.0,1,1.0,1,1.0,1,0.5988702545535831,40
2861,4,7236,7236,0,0,0,0,1.0,1,1.0,1,1.0,1,0.5903509545665607,38
2862,3,7239,7239,0,0,0,0,1.0,1,1.0,1,1.0,1,0.5926498726680385,38
2863,5,7244,7244,0,0,0,0,1.0,1,1.0,1,1.0,1,0.5434036619941321,37
2864,5,7249,7249,0,0,0,0,1.0,1,1.0,1,1.0,1,0.591596168098783,35
2865,3,7252,7252,0,0,0,0,1.0,1,1.0,1,1.0,1,0.6179689368949016,33
2866,1,7253,7253,0,0,0,0,1.0,1,1.0,1,1.0,1,0.6095540834693328,31
2867,2,7255,7255,0,0,0,0,1.0,1,1.0,1,1.0,1,0.6525496570002774,30
2868,1,7256,7256,0,0,0,0,1.0,1,1.0,1,1.0,1,0.6376521732469266,31
2869,0,7256,7256,0,0,0,0,1.0,1,1.0,1,1.0,1,0.64251274255126,30
2870,0,7256,7256,0,0,0,0,1.0,1,1.0,1,1.0,1,0.6641555531770591,26
2871,1,7257,7257,0,0,0,0,1.0,1,1.0,1,1.0,1,0.6588532667191356,27
2872,1,7258,7258,0,0,0,0,1.0,1,1.0,1,1.0,1,0.6870179419557825,25
2873,0,7258,7258,0,0,0,0,1.0,1,1.0,1,1.0,1,0.6903926639475061,24
2874,0,7258,7258,0,0,0,0,1.0,1,1.0,1,1.0,1,0.6618438400127636,25
2875,2,7260,7260,0,0,0,0,1.0,1,1.0,1,1.0,1,0.6713986540632068,26
2876,3,7263,7263,0,0,0,0,1.0,1,1.0,1,1.0,1,0.646391828089896,28
2877,1,7264,7264,0,0,0,0,1.0,1,1.0,1,1.0,1,0.6135587143527885,29
2878,4,7268,7268,0,0,0,0,1.0,1,1.0,1,1.0,1,0.5586227892126132,31
2879,3,7271,7271,0,0,0,0,1.0,1,1.0,1,1.0,1,0.5328290601394369,31
2880,4,7275,7275,0,0,0,0,1.0,1,1.0,1,1.0,1,0.514255093795077,32
2881,1,7276,7276,0,0,0,0,1.0,1,1.0,1,1.0,1,0.5364990240762724,31
2882,5,7281,7281,0,0,0,0,1.0,1,1.0,1,1.0,1,0.551713001722478,31
2883,3,7284,7284,0,0,0,0,1.0,1,1.0,1,1.0,1,0.5540725103701828,32
2884,2,7286,7286,0,0,0,0,1.0,1,1.0,1,1.0,1,0.5649780326342828,32
2885,3,7289,7289,0,0,0,0,1.0,1,1.0,1,1.0,1,0.5953226735729947,33
2886,2,7291,7291,0,0,0,0,1.0,1,1.0,1,1.0,1,0.5641213824411464,34
2887,3,7294,7294,0,0,0,0,1.0,1,1.0,1,1.0,1,0.5164268753251439,34
2888,0,7294,7294,0,0,0,0,1.0,1,1.0,1,1.0,1,0.5164268753251439,34
2889,4,7298,7298,0,0,0,0,1.0,1,1.0,1,1.0,1,0.5718742339723133,37
2890,1,7299,7299,0,0,0,0,1.0,1,1.0,1,1.0,1,0.5770525436362712,37
2891,3,7302,7302,0,0,0,0,1.0,1,1.0,1,1.0,1,0.5957382246181847,37
2892,4,7306,7306,0,0,0,0,1.0,1,1.0,1,1.0,1,0.6075986018374103,37
2893,2,7308,7308,0,0,0,0,1.0,1,1.0,1,1.0,1,0.6247673201180758,38
2894,2,7310,7310,0,0,0,0,1.0,1,1.0,1,1.0,1,0.6313072403699695,39
2895,1,7311,7311,0,0,0,0,1.0,1,1.0,1,1.0,1,0.5932435306511064,40
2896,3,7314,7314,0,0,0,0,1.0,1,1.0,1,1.0,1,0.5945841503954125,41
2897,0,7314,7314,0,0,0,0,1.0,1,1.0,1,1.0,1,0.5945841503954125,41
2898,2,7316,7316,0,0,0,0,1.0,1,1.0,1,1.0,1,0.6025304094930042,41
2899,2,7318,7318,0,0,0,0,1.0,1,1.0,1,1.0,1,0.5800455169304193,39
2900,3,7321,7321,0,0,0,0,1.0,1,1.0,1,1.0,1,0.5986425544706213,40
2901,1,7322,7322,0,0,0,0,1.0,1,1.0,1,1.0,1,0.5872689440851526,40
2902,2,7324,7324,0,0,0,0,1.0,1,1.0,1,1.0,1,0.559020374833095,38
2903,2,7326,7326,0,0,0,0,1.0,1,1.0,1,1.0,1,0.5898475103894989,36
2904,4,7330,7330,0,0,0,0,1.0,1,1.0,1,1.0,1,0.6464612023859392,36
2905,2,7332,7332,0,0,0,0,1.0,1,1.0,1,1.0,1,0.6345776693955774,35
2906,7,7339,7339,0,0,0,0,1.0,1,1.0,1,1.0,1,0.5974622162601436,36
2907,3,7342,7342,0,0,0,0,1.0,1,1.0,1,1.0,1,0.5627461872868229,37
2908,7,7349,7349,0,0,0,0,1.0,1,1.0,1,1.0,1,0.6405560122499214,38
2909,1,7350,7350,0,0,0,0,1.0,1,1.0,1,1.0,1,0.6283445674380926,37
2910,6,7356,7356,0,0,0,0,1.0,1,1.0,1,1.0,1,0.5816600722518103,37
2911,1,7357,7357,0,0,0,0,1.0,1,1.0,1,1.0,1,0.6010483021675601,36
2912,3,7360,7360,0,0,0,0,1.0,1,1.0,1,1.0,1,0.630043772663433,36
2913,2,7362,7362,0,0,0,0,1.0,1,1.0,1,1.0,1,0.6430873424484058,36
2914,3,7365,7365,0,0,0,0,1.0,1,1.0,1,1.0,1,0.6348358017375905,38
2915,1,7366,7366,0,0,0,0,1.0,1,1.0,1,1.0,1,0.652382525071624,37
2916,2,7368,7368,0,0,0,0,1.0,1,1.0,1,1.0,1,0.6310849613143901,39
2917,2,7370,7370,0,0,0,0,1.0,1,1.0,1,1.0,1,0.5582995514330943,40
2918,2,7372,7372,0,0,0,0,1.0,1,1.0,1,1.0,1,0.6273907765790604,40
2919,2,7374,7374,0,0,0,0,1.0,1,1.0,1,1.0,1,0.622336498184974,42
2920,3,7377,7377,0,0,0,0,1.0,1,1.0,1,1.0,1,0.5998750121070419,42
2921,3,7380,7380,0,0,0,0,1.0,1,1.0,1,1.0,1,0.6283762074025289,42
2922,1,7381,7381,0,0,0,0,1.0,1,1.0,1,1.0,1,0.5928954305245001,43
2923,2,7383,7383,0,0,0,0,1.0,1,1.0,1,1.0,1,0.593872732116416,45
2924,2,7385,7385,0,0,0,0,1.0,1,1.0,1,1.0,1,0.5793227840588557,46
2925,2,7387,7387,0,0,0,0,1.0,1,1.0,1,1.0,1,0.5890032811635747,46
2926,2,7389,7389,0,0,0,0,1.0,1,1.0,1,1.0,1,0.5680279631882112,46
2927,0,7389,7389,0,0,0,0,1.0,1,1.0,1,1.0,1,0.5594630244284089,48
2928,3,7392,7392,0,0,0,0,1.0,1,1.0,1,1.0,1,0.5599158995909337,48
2929,1,7393,7393,0,0,0,0,1.0,1,1.0,1,1.0,1,0.551951642335056,48
2930,3,7396,7396,0,0,0,0,1.0,1,1.0,1,1.0,1,0.5349476311797715,50
2931,4,7400,7400,0,0,0,0,1.0,1,1.0,1,1.0,1,0.5356186309341109,51
2932,3,7403,7403,0,0,0,0,1.0,1,1.0,1,1.0,1,0.5591925187747616,52
2933,3,7406,7406,0,0,0,0,1.0,1,1.0,1,1.0,1,0.5656791049633084,53
2934,1,7407,7407,0,0,0,0,1.0,1,1.0,1,1.0,1,0.5810708593278407,54
2935,0,7407,7407,0,0,0,0,1.0,1,1.0,1,1.0,1,0.5845557699460415,53
2936,0,7407,7407,0,0,0,0,1.0,1,1.0,1,1.0,1,0.5845557699460415,53
2937,1,7408,7408,0,0,0,0,1.0,1,1.0,1,1.0,1,0.5764686278742404,51
2938,1,7409,7409,0,0,0,0,1.0,1,1.0,1,1.0,1,0.5755468278530683,53
2939,2,7411,7411,0,0,0,0,1.0,1,1.0,1,1.0,1,0.5739370556626026,52
2940,3,7414,7414,0,0,0,0,1.0,1,1.0,1,1.0,1,0.6015788642871824,52
2941,3,7417,7417,0,0,0,0,1.0,1,1.0,1,1.0,1,0.5990257225009423,50
2942,3,7420,7420,0,0,0,0,1.0,1,1.0,1,1.0,1,0.639830864805009,50
2943,0,7420,7420,0,0,0,0,1.0,1,1.0,1,1.0,1,0.6509735380687777,49
2944,1,7421,7421,0,0,0,0,1.0,1,1.0,1,1.0,1,0.6662882553804258,48
2945,4,7425,7425,0,0,0,0,1.0,1,1.0,1,1.0,1,0.6423478903940573,48
2946,0,7425,7425,0,0,0,0,1.0,1,1.0,1,1.0,1,0.6511574785016471,47
2947,4,7429,7429,0,0,0,0,1.0,1,1.0,1,1.0,1,0.6508945379303035,47
2948,1,7430,7430,0,0,0,0,1.0,1,1.0,1,1.0,1,0.6391228800289973,48
2949,5,7435,7435,0,0,0,0,1.0,1,1.0,1,1.0,1,0.6337888961128163,48
2950,0,7435,7435,0,0,0,0,1.0,1,1.0,1,1.0,1,0.6337888961128163,48
2951,4,7439,7439,0,0,0,0,1.0,1,1.0,1,1.0,1,0.6415811921865004,50
2952,2,7441,7441,0,0,0,0,1.0,1,1.0,1,1.0,1,0.6532163632076283,50
2953,4,7445,7445,0,0,0,0,1.0,1,1.0,1,1.0,1,0.6580382942563855,51
2954,1,7446,7446,0,0,0,0,1.0,1,1.0,1,1.0,1,0.6643000339066059,51
2955,2,7448,7448,0,0,0,0,1.0,1,1.0,1,1.0,1,0.6563914381220448,51
2956,0,7448,7448,0,0,0,0,1.0,1,1.0,1,1.0,1,0.6563914381220448,51
2957,2,7450,7450,0,0,0,0,1.0,1,1.0,1,1.0,1,0.6473305502570438,52
2958,1,7451,7451,0,0,0,0,1.0,1,1.0,1,1.0,1,0.6340723626654884,52
2959,3,7454,7454,0,0,0,0,1.0,1,1.0,1,1.0,1,0.6168862090931012,53
2960,1,7455,7455,0,0,0,0,1.0,1,1.0,1,1.0,1,0.6023950051701851,52
2961,1,7456,7456,0,0,0,0,1.0,1,1.0,1,1.0,1,0.5911896381176575,53
2962,3,7459,7459,0,0,0,0,1.0,1,1.0,1,1.0,1,0.5273090973392714,54
2963,1,7460,7460,0,0,0,0,1.0,1,1.0,1,1.0,1,0.5242764272069079,55
2964,4,7464,7464,0,0,0,0,1.0,1,1.0,1,1.0,1,0.507896602477747,55
2965,4,7468,7468,0,0,0,0,1.0,1,1.0,1,1.0,1,0.4994366625080775,55
2966,1,7469,7469,0,0,0,0,1.0,1,1.0,1,1.0,1,0.5026471031447012,55
2967,4,7473,7473,0,0,0,0,1.0,1,1.0,1,1.0,1,0.5171283585060309,56
2968,2,7475,7475,0,0,0,0,1.0,1,1.0,1,1.0,1,0.5154734425061602,56
2969,2,7477,7477,0,0,0,0,1.0,1,1.0,1,1.0,1,0.5498925648137138,55
2970,2,7479,7479,0,0,0,0,1.0,1,1.0,1,1.0,1,0.5529426733414157,57
2971,0,7479,7479,0,0,0,0,1.0,1,1.0,1,1.0,1,0.5629728189584301,56
2972,4,7483,7483,0,0,0,0,1.0,1,1.0,1,1.0,1,0.571547354647118,57
2973,2,7485,7485,0,0,0,0,1.0,1,1.0,1,1.0,1,0.5528325313578911,59
2974,1,7486,7486,0,0,0,0,1.0,1,1.0,1,1.0,1,0.5418966503372871,60
2975,1,7487,7487,0,0,0,0,1.0,1,1.0,1,1.0,1,0.5311960179953794,58
2976,3,7490,7490,0,0,0,0,1.0,1,1.0,1,1.0,1,0.5718411533988313,59
2977,2,7492,7492,0,0,0,0,1.0,1,1.0,1,1.0,1,0.5702804132069947,59
2978,7,7499,7499,0,0,0,0,1.0,1,1.0,1,1.0,1,0.5429799834555675,58
2979,4,7503,7503,0,0,0,0,1.0,1,1.0,1,1.0,1,0.5278013257820737,57
2980,8,7511,7511,0,0,0,0,1.0,1,1.0,1,1.0,1,0.4978092267346014,56
2981,5,7516,7516,0,0,0,0,1.0,1,1.0,1,1.0,1,0.5243827490301032,56
2982,4,7520,7520,0,0,0,0,1.0,1,1.0,1,1.0,1,0.5318405000890039,57
2983,3,7523,7523,0,0,0,0,1.0,1,1.0,1,1.0,1,0.5523868644220725,57
2984,5,7528,7528,0,0,0,0,1.0,1,1.0,1,1.0,1,0.5437612587860245,56
2985,1,7529,7529,0,0,0,0,1.0,1,1.0,1,1.0,1,0.5492764316410902,55
2986,2,7531,7531,0,0,0,0,1.0,1,1.0,1,1.0,1,0.5611575559704252,55
2987,1,7532,7532,0,0,0,0,1.0,1,1.0,1,1.0,1,0.576792171378416,51
2988,2,7534,7534,0,0,0,0,1.0,1,1.0,1,1.0,1,0.5679749190824843,52
2989,1,7535,7535,0,0,0,0,1.0,1,1.0,1,1.0,1,0.5809941535193467,50
2990,3,7538,7538,0,0,0,0,1.0,1,1.0,1,1.0,1,0.5635102892517128,50
2991,3,7541,7541,0,0,0,0,1.0,1,1.0,1,1.0,1,0.543003507175251,50
2992,1,7542,7542,0,0,0,0,1.0,1,1.0,1,1.0,1,0.535826069190474,50
2993,2,7544,7544,0,0,0,0,1.0,1,1.0,1,1.0,1,0.5491067342282437,51
2994,5,7549,7549,0,0,0,0,1.0,1,1.0,1,1.0,1,0.536447856364583,51
2995,3,7552,7552,0,0,0,0,1.0,1,1.0,1,1.0,1,0.5610330130607568,51
2996,3,7555,7555,0,0,0,0,1.0,1,1.0,1,1.0,1,0.5445983174747021,52
2997,4,7559,7559,0,0,0,0,1.0,1,1.0,1,1.0,1,0.599926883699696,52
2998,3,7562,7562,0,0,0,0,1.0,1,1.0,1,1.0,1,0.6343423527581477,51
2999,1,7563,7563,0,0,0,0,1.0,1,1.0,1,1.0,1,0.6233783591346131,51
3000,2,7565,7565,0,0,0,0,1.0,1,1.0,1,1.0,1,0.5916586740368245,52
3001,0,7565,7565,0,0,0,0,1.0,1,1.0,1,1.0,1,0.5916586740368245,52
3002,4,7569,7569,0,0,0,0,1.0,1,1.0,1,1.0,1,0.5886758146619717,53
3003,1,7570,7570,0,0,0,0,1.0,1,1.0,1,1.0,1,0.576221932763534,54
3004,5,7575,7575,0,0,0,0,1.0,1,1.0,1,1.0,1,0.5925397161003055,55
3005,2,7577,7577,0,0,0,0,1.0,1,1.0,1,1.0,1,0.5907028492833678,56
3006,5,7582,7582,0,0,0,0,1.0,1,1.0,1,1.0,1,0.5762587215294026,57
3007,3,7585,7585,0,0,0,0,1.0,1,1.0,1,1.0,1,0.580411110727044,58
3008,5,7590,7590,0,0,0,0,1.0,1,1.0,1,1.0,1,0.5832257104508776,59
3009,0,7590,7590,0,0,0,0,1.0,1,1.0,1,1.0,1,0.5832257104508776,59
3010,4,7594,7594,0,0,0,0,1.0,1,1.0,1,1.0,1,0.5780030480372025,59
3011,4,7598,7598,0,0,0,0,1.0,1,1.0,1,1.0,1,0.5532221770811114,59
3012,2,7600,7600,0,0,0,0,1.0,1,1.0,1,1.0,1,0.5514955958824497,61
3013,1,7601,7601,0,0,0,0,1.0,1,1.0,1,1.0,1,0.5437739368803517,59
3014,2,7603,7603,0,0,0,0,1.0,1,1.0,1,1.0,1,0.5357474586491785,60
3015,2,7605,7605,0,0,0,0,1.0,1,1.0,1,1.0,1,0.518156316793502,58
3016,0,7605,7605,0,0,0,0,1.0,1,1.0,1,1.0,1,0.5157996905164705,57
3017,0,7605,7605,0,0,0,0,1.0,1,1.0,1,1.0,1,0.5063496732755731,58
3018,3,7608,7608,0,0,0,0,1.0,1,1.0,1,1.0,1,0.4993720041177845,55
3019,3,7611,7611,0,0,0,0,1.0,1,1.0,1,1.0,1,0.4988747696180964,56
3020,1,7612,7612,0,0,0,0,1.0,1,1.0,1,1.0,1,0.5072367239446339,55
3021,4,7616,7616,0,0,0,0,1.0,1,1.0,1,1.0,1,0.5246190702809125,55
3022,3,7619,7619,0,0,0,0,1.0,1,1.0,1,1.0,1,0.5320326779983072,55
3023,4,7623,7623,0,0,0,0,1.0,1,1.0,1,1.0,1,0.5607908717349429,54
3024,2,7625,7625,0,0,0,0,1.0,1,1.0,1,1.0,1,0.5715110058148465,54
3025,4,7629,7629,0,0,0,0,1.0,1,1.0,1,1.0,1,0.5303031845055495,54
3026,5,7634,7634,0,0,0,0,1.0,1,1.0,1,1.0,1,0.5653398676838892,53
3027,3,7637,7637,0,0,0,0,1.0,1,1.0,1,1.0,1,0.5378948448511482,53
3028,3,7640,7640,0,0,0,0,1.0,1,1.0,1,1.0,1,0.5513292730591798,51
3029,6,7646,7646,0,0,0,0,1.0,1,1.0,1,1.0,1,0.5171686350797254,51
3030,3,7649,7649,0,0,0,0,1.0,1,1.0,1,1.0,1,0.5141274477174312,52
3031,3,7652,7652,0,0,0,0,1.0,1,1.0,1,1.0,1,0.5515627692739158,51
3032,4,7656,7656,0,0,0,0,1.0,1,1.0,1,1.0,1,0.5832827214796527,50
3033,1,7657,7657,0,0,0,0,1.0,1,1.0,1,1.0,1,0.5541916767870733,52
3034,0,7657,7657,0,0,0,0,1.0,1,1.0,1,1.0,1,0.5645385399494413,51
3035,2,7659,7659,0,0,0,0,1.0,1,1.0,1,1.0,1,0.5776505361988818,51
3036,0,7659,7659,0,0,0,0,1.0,1,1.0,1,1.0,1,0.5777262138504012,53
3037,0,7659,7659,0,0,0,0,1.0,1,1.0,1,1.0,1,0.5864468191091997,52
3038,2,7661,7661,0,0,0,0,1.0,1,1.0,1,1.0,1,0.6209605731784988,52
3039,1,7662,7662,0,0,0,0,1.0,1,1.0,1,1.0,1,0.5957486906486754,54
3040,1,7663,7663,0,0,0,0,1.0,1,1.0,1,1.0,1,0.6124319323344342,55
3041,3,7666,7666,0,0,0,0,1.0,1,1.0,1,1.0,1,0.5817699194433511,56
3042,2,7668,7668,0,0,0,0,1.0,1,1.0,1,1.0,1,0.5828685990948244,56
3043,3,7671,7671,0,0,0,0,1.0,1,1.0,1,1.0,1,0.5771885623196262,57
3044,3,7674,7674,0,0,0,0,1.0,1,1.0,1,1.0,1,0.5865784509393328,57
3045,6,7680,7680,0,0,0,0,1.0,1,1.0,1,1.0,1,0.5622047284890308,56
3046,2,7682,7682,0,0,0,0,1.0,1,1.0,1,1.0,1,0.5701235916503947,57
3047,2,7684,7684,0,0,0,0,1.0,1,1.0,1,1.0,1,0.5853057677665741,56
3048,3,7687,7687,0,0,0,0,1.0,1,1.0,1,1.0,1,0.5611060205968557,58
3049,1,7688,7688,0,0,0,0,1.0,1,1.0,1,1.0,1,0.5648142051095312,59
3050,2,7690,7690,0,0,0,0,1.0,1,1.0,1,1.0,1,0.5198389386508563,60
3051,1,7691,7691,0,0,0,0,1.0,1,1.0,1,1.0,1,0.5243080036057296,59
3052,1,7692,7692,0,0,0,0,1.0,1,1.0,1,1.0,1,0.5119384349530227,58
3053,2,7694,7694,0,0,0,0,1.0,1,1.0,1,1.0,1,0.4988533619335289,57
3054,2,7696,7696,0,0,0,0,1.0,1,1.0,1,1.0,1,0.4817443180420481,55
3055,5,7701,7701,0,0,0,0,1.0,1,1.0,1,1.0,1,0.4586029372121899,54
3056,5,7706,7706,0,0,0,0,1.0,1,1.0,1,1.0,1,0.4279718980984837,55
3057,6,7712,7712,0,0,0,0,1.0,1,1.0,1,1.0,1,0.47832931127476164,54
3058,4,7716,7716,0,0,0,0,1.0,1,1.0,1,1.0,1,0.5348423974453466,55
3059,5,7721,7721,0,0,0,0,1.0,1,1.0,1,1.0,1,0.5432218084060225,56
3060,3,7724,7724,0,0,0,0,1.0,1,1.0,1,1.0,1,0.5452441760730419,56
3061,3,7727,7727,0,0,0,0,1.0,1,1.0,1,1.0,1,0.5420447866610909,56
3062,2,7729,7729,0,0,0,0,1.0,1,1.0,1,1.0,1,0.5480788904854212,57
3063,4,7733,7733,0,0,0,0,1.0,1,1.0,1,1.0,1,0.5339447164723495,55
3064,2,7735,7735,0,0,0,0,1.0,1,1.0,1,1.0,1,0.5613655299548486,56
3065,3,7738,7738,0,0,0,0,1.0,1,1.0,1,1.0,1,0.5531679237674277,55
3066,3,7741,7741,0,0,0,0,1.0,1,1.0,1,1.0,1,0.5543252879290836,55
3067,1,7742,7742,0,0,0,0,1.0,1,1.0,1,1.0,1,0.5443187768768973,54
3068,4,7746,7746,0,0,0,0,1.0,1,1.0,1,1.0,1,0.5556491851438019,53
3069,3,7749,7749,0,0,0,0,1.0,1,1.0,1,1.0,1,0.5776398252713462,51
3070,3,7752,7752,0,0,0,0,1.0,1,1.0,1,1.0,1,0.5621941117295535,50
3071,2,7754,7754,0,0,0,0,1.0,1,1.0,1,1.0,1,0.5786130910941242,51
3072,2,7756,7756,0,0,0,0,1.0,1,1.0,1,1.0,1,0.57659334090075,53
3073,1,7757,7757,0,0,0,0,1.0,1,1.0,1,1.0,1,0.5758986767019023,51
3074,4,7761,7761,0,0,0,0,1.0,1,1.0,1,1.0,1,0.568098325339777,50
3075,1,7762,7762,0,0,0,0,1.0,1,1.0,1,1.0,1,0.5620964845688439,52
3076,2,7764,7764,0,0,0,0,1.0,1,1.0,1,1.0,1,0.5648460579417494,53
3077,2,7766,7766,0,0,0,0,1.0,1,1.0,1,1.0,1,0.5545694762473504,52
3078,4,7770,7770,0,0,0,0,1.0,1,1.0,1,1.0,1,0.5373274104709461,53
3079,0,7770,7770,0,0,0,0,1.0,1,1.0,1,1.0,1,0.5373274104709461,53
3080,8,7778,7778,0,0,0,0,1.0,1,1.0,1,1.0,1,0.5114128124706437,52
3081,2,7780,7780,0,0,0,0,1.0,1,1.0,1,1.0,1,0.5267911004810594,54
3082,4,7784,7784,0,0,0,0,1.0,1,1.0,1,1.0,1,0.5097179742895235,54
3083,4,7788,7788,0,0,0,0,1.0,1,1.0,1,1.0,1,0.5035794401644031,54
3084,3,7791,7791,0,0,0,0,1.0,1,1.0,1,1.0,1,0.495315415821182,55
3085,2,7793,7793,0,0,0,0,1.0,1,1.0,1,1.0,1,0.5023398176952025,55
3086,2,7795,7795,0,0,0,0,1.0,1,1.0,1,1.0,1,0.497567000047938,56
3087,1,7796,7796,0,0,0,0,1.0,1,1.0,1,1.0,1,0.5152379617410353,57
3088,2,7798,7798,0,0,0,0,1.0,1,1.0,1,1.0,1,0.5271661034602625,56
3089,0,7798,7798,0,0,0,0,1.0,1,1.0,1,1.0,1,0.5336708577078535,55
3090,1,7799,7799,0,0,0,0,1.0,1,1.0,1,1.0,1,0.5500786899878535,54
3091,2,7801,7801,0,0,0,0,1.0,1,1.0,1,1.0,1,0.5382051577734969,53
3092,0,7801,7801,0,0,0,0,1.0,1,1.0,1,1.0,1,0.5171179311701823,56
3093,4,7805,7805,0,0,0,0,1.0,1,1.0,1,1.0,1,0.5007365773945973,56
3094,0,7805,7805,0,0,0,0,1.0,1,1.0,1,1.0,1,0.5099174017992487,58
3095,3,7808,7808,0,0,0,0,1.0,1,1.0,1,1.0,1,0.4915245715466899,59
3096,0,7808,7808,0,0,0,0,1.0,1,1.0,1,1.0,1,0.49619358479206715,60
3097,1,7809,7809,0,0,0,0,1.0,1,1.0,1,1.0,1,0.4961186219526901,60
3098,2,7811,7811,0,0,0,0,1.0,1,1.0,1,1.0,1,0.5286265624561444,58
3099,4,7815,7815,0,0,0,0,1.0,1,1.0,1,1.0,1,0.5253269085950221,57
3100,1,7816,7816,0,0,0,0,1.0,1,1.0,1,1.0,1,0.5375009263182029,57
3101,4,7820,7820,0,0,0,0,1.0,1,1.0,1,1.0,1,0.5525212687261208,58
3102,5,7825,7825,0,0,0,0,1.0,1,1.0,1,1.0,1,0.5790001895922163,59
3103,2,7827,7827,0,0,0,0,1.0,1,1.0,1,1.0,1,0.5935660505737774,58
3104,5,7832,7832,0,0,0,0,1.0,1,1.0,1,1.0,1,0.5823632072961643,58
3105,3,7835,7835,0,0,0,0,1.0,1,1.0,1,1.0,1,0.5753457713044425,56
3106,6,7841,7841,0,0,0,0,1.0,1,1.0,1,1.0,1,0.5770124307219724,57
3107,7,7848,7848,0,0,0,0,1.0,1,1.0,1,1.0,1,0.5631339180324237,55
3108,5,7853,7853,0,0,0,0,1.0,1,1.0,1,1.0,1,0.5978931011331938,55
3109,9,7862,7862,0,0,0,0,1.0,1,1.0,1,1.0,1,0.5819803237876877,54
3110,9,7871,7871,0,0,0,0,1.0,1,1.0,1,1.0,1,0.5910584086382232,54
3111,11,7882,7882,0,0,0,0,1.0,1,1.0,1,1.0,1,0.5837454361159264,54
3112,6,7888,7888,0,0,0,0,1.0,1,1.0,1,1.0,1,0.5659835834912939,56
3113,9,7897,7897,0,0,0,0,1.0,1,1.0,1,1.0,1,0.5517072439879679,55
3114,6,7903,7903,0,0,0,0,1.0,1,1.0,1,1.0,1,0.5173313431002353,54
3115,1,7904,7904,0,0,0,0,1.0,1,1.0,1,1.0,1,0.49972353617560766,56
3116,1,7905,7905,0,0,0,0,1.0,1,1.0,1,1.0,1,0.5067171107051651,56
3117,2,7907,7907,0,0,0,0,1.0,1,1.0,1,1.0,1,0.4970987656241196,58
3118,0,7907,7907,0,0,0,0,1.0,1,1.0,1,1.0,1,0.5037604912345829,57
3119,2,7909,7909,0,0,0,0,1.0,1,1.0,1,1.0,1,0.500564668075311,57
3120,1,7910,7910,0,0,0,0,1.0,1,1.0,1,1.0,1,0.493672630654961,56
3121,3,7913,7913,0,0,0,0,1.0,1,1.0,1,1.0,1,0.5167184104353906,57
3122,2,7915,7915,0,0,0,0,1.0,1,1.0,1,1.0,1,0.4990822826316196,57
3123,5,7920,7920,0,0,0,0,1.0,1,1.0,1,1.0,1,0.4908282143891816,57
3124,3,7923,7923,0,0,0,0,1.0,1,1.0,1,1.0,1,0.4741358160848521,59
3125,0,7923,7923,0,0,0,0,1.0,1,1.0,1,1.0,1,0.47857076177770863,61
3126,2,7925,7925,0,0,0,0,1.0,1,1.0,1,1.0,1,0.4947586062433652,60
3127,1,7926,7926,0,0,0,0,1.0,1,1.0,1,1.0,1,0.4672854556492824,58
3128,0,7926,7926,0,0,0,0,1.0,1,1.0,1,1.0,1,0.4628233218875296,58
3129,3,7929,7929,0,0,0,0,1.0,1,1.0,1,1.0,1,0.4763916840277185,56
3130,0,7929,7929,0,0,0,0,1.0,1,1.0,1,1.0,1,0.46356664110900647,56
3131,3,7932,7932,0,0,0,0,1.0,1,1.0,1,1.0,1,0.5082056361353433,55
3132,2,7934,7934,0,0,0,0,1.0,1,1.0,1,1.0,1,0.538242802712459,53
3133,5,7939,7939,0,0,0,0,1.0,1,1.0,1,1.0,1,0.5855783760694889,52
3134,6,7945,7945,0,0,0,0,1.0,1,1.0,1,1.0,1,0.5522481291676251,52
3135,3,7948,7948,0,0,0,0,1.0,1,1.0,1,1.0,1,0.6084175100610686,53
3136,8,7956,7956,0,0,0,0,1.0,1,1.0,1,1.0,1,0.5796118563943056,54
3137,5,7961,7961,0,0,0,0,1.0,1,1.0,1,1.0,1,0.563866530423844,55
3138,7,7968,7968,0,0,0,0,1.0,1,1.0,1,1.0,1,0.5664105102180749,57
3139,5,7973,7973,0,0,0,0,1.0,1,1.0,1,1.0,1,0.5514440632150789,56
3140,6,7979,7979,0,0,0,0,1.0,1,1.0,1,1.0,1,0.5413030159452968,56
3141,4,7983,7983,0,0,0,0,1.0,1,1.0,1,1.0,1,0.5558141837383809,56
3142,5,7988,7988,0,0,0,0,1.0,1,1.0,1,1.0,1,0.5632715409584046,56
3143,0,7988,7988,0,0,0,0,1.0,1,1.0,1,1.0,1,0.5632715409584046,56
3144,3,7991,7991,0,0,0,0,1.0,1,1.0,1,1.0,1,0.5667331531224136,54
3145,1,7992,7992,0,0,0,0,1.0,1,1.0,1,1.0,1,0.5790508502521846,55
3146,2,7994,7994,0,0,0,0,1.0,1,1.0,1,1.0,1,0.5844372010608533,53
3147,1,7995,7995,0,0,0,0,1.0,1,1.0,1,1.0,1,0.574342492631687,54
3148,1,7996,7996,0,0,0,0,1.0,1,1.0,1,1.0,1,0.5651366816098673,54
3149,2,7998,7998,0,0,0,0,1.0,1,1.0,1,1.0,1,0.5577276028481848,53
3150,4,8002,8002,0,0,0,0,1.0,1,1.0,1,1.0,1,0.5740767104764172,53
3151,4,8006,8006,0,0,0,0,1.0,1,1.0,1,1.0,1,0.5930706596415996,53
3152,4,8010,8010,0,0,0,0,1.0,1,1.0,1,1.0,1,0.5825278306076341,54
3153,3,8013,8013,0,0,0,0,1.0,1,1.0,1,1.0,1,0.5993996682375605,53
3154,0,8013,8013,0,0,0,0,1.0,1,1.0,1,1.0,1,0.5956506566202673,55
3155,1,8014,8014,0,0,0,0,1.0,1,1.0,1,1.0,1,0.5971177788567383,56
3156,3,8017,8017,0,0,0,0,1.0,1,1.0,1,1.0,1,0.6208935276384304,56
3157,3,8020,8020,0,0,0,0,1.0,1,1.0,1,1.0,1,0.6078385589247542,56
3158,2,8022,8022,0,0,0,0,1.0,1,1.0,1,1.0,1,0.6257492731704872,57
3159,1,8023,8023,0,0,0,0,1.0,1,1.0,1,1.0,1,0.6085843884965446,56
3160,1,8024,8024,0,0,0,0,1.0,1,1.0,1,1.0,1,0.6253259299078086,58
3161,3,8027,8027,0,0,0,0,1.0,1,1.0,1,1.0,1,0.6382334084755716,59
3162,1,8028,8028,0,0,0,0,1.0,1,1.0,1,1.0,1,0.6492044161070977,59
3163,2,8030,8030,0,0,0,0,1.0,1,1.0,1,1.0,1,0.6434976516417882,59
3164,1,8031,8031,0,0,0,0,1.0,1,1.0,1,1.0,1,0.6322403087175841,60
3165,3,8034,8034,0,0,0,0,1.0,1,1.0,1,1.0,1,0.6285887917762469,58
3166,2,8036,8036,0,0,0,0,1.0,1,1.0,1,1.0,1,0.6267946482030091,59
3167,2,8038,8038,0,0,0,0,1.0,1,1.0,1,1.0,1,0.6452564846554129,57
3168,2,8040,8040,0,0,0,0,1.0,1,1.0,1,1.0,1,0.6111699527758035,58
3169,3,8043,8043,0,0,0,0,1.0,1,1.0,1,1.0,1,0.6358495695410973,57
3170,2,8045,8045,0,0,0,0,1.0,1,1.0,1,1.0,1,0.6394408997278741,55
3171,4,8049,8049,0,0,0,0,1.0,1,1.0,1,1.0,1,0.5987320131901752,56
3172,2,8051,8051,0,0,0,0,1.0,1,1.0,1,1.0,1,0.6196735567161821,54
3173,5,8056,8056,0,0,0,0,1.0,1,1.0,1,1.0,1,0.5870566482215072,53
3174,2,8058,8058,0,0,0,0,1.0,1,1.0,1,1.0,1,0.5714457609188076,53
3175,5,8063,8063,0,0,0,0,1.0,1,1.0,1,1.0,1,0.5623232926395154,52
3176,1,8064,8064,0,0,0,0,1.0,1,1.0,1,1.0,1,0.5458539815600889,53
3177,2,8066,8066,0,0,0,0,1.0,1,1.0,1,1.0,1,0.5194349818910002,52
3178,3,8069,8069,0,0,0,0,1.0,1,1.0,1,1.0,1,0.5288902403576433,53
3179,4,8073,8073,0,0,0,0,1.0,1,1.0,1,1.0,1,0.4743824159181484,54
3180,2,8075,8075,0,0,0,0,1.0,1,1.0,1,1.0,1,0.48961904201186285,54
3181,5,8080,8080,0,0,0,0,1.0,1,1.0,1,1.0,1,0.49090506412036433,55
3182,3,8083,8083,0,0,0,0,1.0,1,1.0,1,1.0,1,0.5093151991974362,54
3183,3,8086,8086,0,0,0,0,1.0,1,1.0,1,1.0,1,0.5170222299117827,56
3184,7,8093,8093,0,0,0,0,1.0,1,1.0,1,1.0,1,0.577582126865362,54
3185,2,8095,8095,0,0,0,0,1.0,1,1.0,1,1.0,1,0.5960426731234866,53
3186,4,8099,8099,0,0,0,0,1.0,1,1.0,1,1.0,1,0.6328140319212876,52
3187,2,8101,8101,0,0,0,0,1.0,1,1.0,1,1.0,1,0.6556399742280085,50
3188,3,8104,8104,0,0,0,0,1.0,1,1.0,1,1.0,1,0.6557760140652982,50
3189,3,8107,8107,0,0,0,0,1.0,1,1.0,1,1.0,1,0.677114811137066,49
3190,0,8107,8107,0,0,0,0,1.0,1,1.0,1,1.0,1,0.6826171438780894,50
3191,0,8107,8107,0,0,0,0,1.0,1,1.0,1,1.0,1,0.6862759213488787,49
3192,0,8107,8107,0,0,0,0,1.0,1,1.0,1,1.0,1,0.6862759213488787,49
3193,1,8108,8108,0,0,0,0,1.0,1,1.0,1,1.0,1,0.6985596452467373,49
3194,0,8108,8108,0,0,0,0,1.0,1,1.0,1,1.0,1,0.7024313365406267,50
3195,2,8110,8110,0,0,0,0,1.0,1,1.0,1,1.0,1,0.7187462506542922,49
3196,6,8116,8116,0,0,0,0,1.0,1,1.0,1,1.0,1,0.7186102967113118,49
3197,1,8117,8117,0,0,0,0,1.0,1,1.0,1,1.0,1,0.7069230298175887,50
3198,5,8122,8122,0,0,0,0,1.0,1,1.0,1,1.0,1,0.678778306686215,50
3199,8,8130,8130,0,0,0,0,1.0,1,1.0,1,1.0,1,0.6752571070941823,52
3200,3,8133,8133,0,0,0,0,1.0,1,1.0,1,1.0,1,0.6614846947445682,53
3201,3,8136,8136,0,0,0,0,1.0,1,1.0,1,1.0,1,0.6569739192365076,55
3202,5,8141,8141,0,0,0,0,1.0,1,1.0,1,1.0,1,0.6588074822995398,55
3203,1,8142,8142,0,0,0,0,1.0,1,1.0,1,1.0,1,0.6468790996596192,53
3204,1,8143,8143,0,0,0,0,1.0,1,1.0,1,1.0,1,0.6476493944176702,53
3205,3,8146,8146,0,0,0,0,1.0,1,1.0,1,1.0,1,0.6389995784575934,53
3206,0,8146,8146,0,0,0,0,1.0,1,1.0,1,1.0,1,0.6314925188279429,52
3207,1,8147,8147,0,0,0,0,1.0,1,1.0,1,1.0,1,0.6150482967280311,53
3208,1,8148,8148,0,0,0,0,1.0,1,1.0,1,1.0,1,0.6212470997398174,51
3209,2,8150,8150,0,0,0,0,1.0,1,1.0,1,1.0,1,0.6436898130593434,52
3210,1,8151,8151,0,0,0,0,1.0,1,1.0,1,1.0,1,0.6412851506770209,49
3211,2,8153,8153,0,0,0,0,1.0,1,1.0,1,1.0,1,0.675321665942051,48
3212,0,8153,8153,0,0,0,0,1.0,1,1.0,1,1.0,1,0.676583792078024,48
3213,4,8157,8157,0,0,0,0,1.0,1,1.0,1,1.0,1,0.660451409248702,49
3214,2,8159,8159,0,0,0,0,1.0,1,1.0,1,1.0,1,0.6453277363574634,51
3215,1,8160,8160,0,0,0,0,1.0,1,1.0,1,1.0,1,0.6346024980526475,51
3216,2,8162,8162,0,0,0,0,1.0,1,1.0,1,1.0,1,0.608417200797752,51
3217,0,8162,8162,0,0,0,0,1.0,1,1.0,1,1.0,1,0.608417200797752,51
3218,0,8162,8162,0,0,0,0,1.0,1,1.0,1,1.0,1,0.608417200797752,51
3219,1,8163,8163,0,0,0,0,1.0,1,1.0,1,1.0,1,0.6280766268398331,52
3220,1,8164,8164,0,0,0,0,1.0,1,1.0,1,1.0,1,0.6499951501969664,52
3221,0,8164,8164,0,0,0,0,1.0,1,1.0,1,1.0,1,0.6399324023038238,54
3222,1,8165,8165,0,0,0,0,1.0,1,1.0,1,1.0,1,0.6365971925201518,54
3223,0,8165,8165,0,0,0,0,1.0,1,1.0,1,1.0,1,0.6345568871257726,56
3224,1,8166,8166,0,0,0,0,1.0,1,1.0,1,1.0,1,0.6458523324782518,57
3225,0,8166,8166,0,0,0,0,1.0,1,1.0,1,1.0,1,0.6416540101407585,58
3226,0,8166,8166,0,0,0,0,1.0,1,1.0,1,1.0,1,0.6416540101407585,58
3227,4,8170,8170,0,0,0,0,1.0,1,1.0,1,1.0,1,0.6541224794555682,58
3228,1,8171,8171,0,0,0,0,1.0,1,1.0,1,1.0,1,0.6457005515917386,58
3229,2,8173,8173,0,0,0,0,1.0,1,1.0,1,1.0,1,0.6322304298169747,60
3230,0,8173,8173,0,0,0,0,1.0,1,1.0,1,1.0,1,0.6273908592493533,61
3231,2,8175,8175,0,0,0,0,1.0,1,1.0,1,1.0,1,0.640202481946963,61
3232,0,8175,8175,0,0,0,0,1.0,1,1.0,1,1.0,1,0.640202481946963,61
3233,1,8176,8176,0,0,0,0,1.0,1,1.0,1,1.0,1,0.6391456464836548,63
3234,0,8176,8176,0,0,0,0,1.0,1,1.0,1,1.0,1,0.6369160829209802,64
3235,1,8177,8177,0,0,0,0,1.0,1,1.0,1,1.0,1,0.6392913248789367,65
3236,0,8177,8177,0,0,0,0,1.0,1,1.0,1,1.0,1,0.6419962956637935,66
3237,3,8180,8180,0,0,0,0,1.0,1,1.0,1,1.0,1,0.6505713794563018,67
3238,1,8181,8181,0,0,0,0,1.0,1,1.0,1,1.0,1,0.6592759089605009,67
3239,1,8182,8182,0,0,0,0,1.0,1,1.0,1,1.0,1,0.6635129168514745,69
3240,1,8183,8183,0,0,0,0,1.0,1,1.0,1,1.0,1,0.657135549877768,69
3241,2,8185,8185,0,0,0,0,1.0,1,1.0,1,1.0,1,0.6415629465431802,68
3242,1,8186,8186,0,0,0,0,1.0,1,1.0,1,1.0,1,0.6287326673377501,67
3243,3,8189,8189,0,0,0,0,1.0,1,1.0,1,1.0,1,0.6433064150136848,68
3244,2,8191,8191,0,0,0,0,1.0,1,1.0,1,1.0,1,0.6327860800934844,68
3245,0,8191,8191,0,0,0,0,1.0,1,1.0,1,1.0,1,0.6334184646329157,69
3246,1,8192,8192,0,0,0,0,1.0,1,1.0,1,1.0,1,0.6295661597701442,68
3247,0,8192,8192,0,0,0,0,1.0,1,1.0,1,1.0,1,0.6295661597701442,68
3248,2,8194,8194,0,0,0,0,1.0,1,1.0,1,1.0,1,0.627496027337955,68
3249,2,8196,8196,0,0,0,0,1.0,1,1.0,1,1.0,1,0.650067478966772,69
3250,2,8198,8198,0,0,0,0,1.0,1,1.0,1,1.0,1,0.6404273061809812,69
3251,0,8198,8198,0,0,0,0,1.0,1,1.0,1,1.0,1,0.6448326030511191,68
3252,2,8200,8200,0,0,0,0,1.0,1,1.0,1,1.0,1,0.6127199950202691,68
3253,1,8201,8201,0,0,0,0,1.0,1,1.0,1,1.0,1,0.620861534763542,69
3254,2,8203,8203,0,0,0,0,1.0,1,1.0,1,1.0,1,0.6016879324102176,69
3255,5,8208,8208,0,0,0,0,1.0,1,1.0,1,1.0,1,0.6090752467293811,70
3256,2,8210,8210,0,0,0,0,1.0,1,1.0,1,1.0,1,0.5999824959414137,70
3257,5,8215,8215,0,0,0,0,1.0,1,1.0,1,1.0,1,0.591781963259358,71
3258,7,8222,8222,0,0,0,0,1.0,1,1.0,1,1.0,1,0.5699992517401375,72
3259,7,8229,8229,0,0,0,0,1.0,1,1.0,1,1.0,1,0.5653814566432432,71
3260,6,8235,8235,0,0,0,0,1.0,1,1.0,1,1.0,1,0.5699771154383672,72
3261,4,8239,8239,0,0,0,0,1.0,1,1.0,1,1.0,1,0.5725942372984862,74
3262,8,8247,8247,0,0,0,0,1.0,1,1.0,1,1.0,1,0.6056127675636293,73
3263,3,8250,8250,0,0,0,0,1.0,1,1.0,1,1.0,1,0.6025709700182906,73
3264,3,8253,8253,0,0,0,0,1.0,1,1.0,1,1.0,1,0.6330356777162665,71
3265,4,8257,8257,0,0,0,0,1.0,1,1.0,1,1.0,1,0.6419520525642352,70
3266,5,8262,8262,0,0,0,0,1.0,1,1.0,1,1.0,1,0.6672936021751009,69
3267,4,8266,8266,0,0,0,0,1.0,1,1.0,1,1.0,1,0.6451413768069848,69
3268,2,8268,8268,0,0,0,0,1.0,1,1.0,1,1.0,1,0.6544931144036813,68
3269,2,8270,8270,0,0,0,0,1.0,1,1.0,1,1.0,1,0.666975551889146,68
3270,0,8270,8270,0,0,0,0,1.0,1,1.0,1,1.0,1,0.6746343651558017,67
3271,2,8272,8272,0,0,0,0,1.0,1,1.0,1,1.0,1,0.6701894971363138,66
3272,2,8274,8274,0,0,0,0,1.0,1,1.0,1,1.0,1,0.6739987504152728,67
3273,3,8277,8277,0,0,0,0,1.0,1,1.0,1,1.0,1,0.6805918875743435,66
3274,3,8280,8280,0,0,0,0,1.0,1,1.0,1,1.0,1,0.6626567618250724,68
3275,2,8282,8282,0,0,0,0,1.0,1,1.0,1,1.0,1,0.6574560995169962,68
3276,1,8283,8283,0,0,0,0,1.0,1,1.0,1,1.0,1,0.6532710224023759,69
3277,4,8287,8287,0,0,0,0,1.0,1,1.0,1,1.0,1,0.644510641365024,68
3278,3,8290,8290,0,0,0,0,1.0,1,1.0,1,1.0,1,0.6477449385118784,69
3279,5,8295,8295,0,0,0,0,1.0,1,1.0,1,1.0,1,0.6480850998500884,67
3280,0,8295,8295,0,0,0,0,1.0,1,1.0,1,1.0,1,0.6455731420026425,66
3281,3,8298,8298,0,0,0,0,1.0,1,1.0,1,1.0,1,0.6416342173200823,67
3282,1,8299,8299,0,0,0,0,1.0,1,1.0,1,1.0,1,0.6365362580429212,66
3283,2,8301,8301,0,0,0,0,1.0,1,1.0,1,1.0,1,0.6314233745605118,67
3284,1,8302,8302,0,0,0,0,1.0,1,1.0,1,1.0,1,0.6118026628757336,66
3285,3,8305,8305,0,0,0,0,1.0,1,1.0,1,1.0,1,0.6040760336402164,66
3286,3,8308,8308,0,0,0,0,1.0,1,1.0,1,1.0,1,0.5872744186520026,63
3287,1,8309,8309,0,0,0,0,1.0,1,1.0,1,1.0,1,0.5947323765934649,61
3288,0,8309,8309,0,0,0,0,1.0,1,1.0,1,1.0,1,0.5900249479499926,63
3289,7,8316,8316,0,0,0,0,1.0,1,1.0,1,1.0,1,0.6188001737412986,62
3290,0,8316,8316,0,0,0,0,1.0,1,1.0,1,1.0,1,0.6073624821503788,63
3291,5,8321,8321,0,0,0,0,1.0,1,1.0,1,1.0,1,0.637371321696832,62
3292,1,8322,8322,0,0,0,0,1.0,1,1.0,1,1.0,1,0.6361282241705526,63
3293,1,8323,8323,0,0,0,0,1.0,1,1.0,1,1.0,1,0.6459862448361021,65
3294,3,8326,8326,0,0,0,0,1.0,1,1.0,1,1.0,1,0.6411553726313053,65
3295,2,8328,8328,0,0,0,0,1.0,1,1.0,1,1.0,1,0.6554201924307504,65
3296,2,8330,8330,0,0,0,0,1.0,1,1.0,1,1.0,1,0.6486516537046184,65
3297,3,8333,8333,0,0,0,0,1.0,1,1.0,1,1.0,1,0.6412589370622008,66
3298,3,8336,8336,0,0,0,0,1.0,1,1.0,1,1.0,1,0.6484549946055667,66
3299,5,8341,8341,0,0,0,0,1.0,1,1.0,1,1.0,1,0.6529700482140133,67
3300,3,8344,8344,0,0,0,0,1.0,1,1.0,1,1.0,1,0.6468911155077518,67
3301,4,8348,8348,0,0,0,0,1.0,1,1.0,1,1.0,1,0.6450642056786947,68
3302,2,8350,8350,0,0,0,0,1.0,1,1.0,1,1.0,1,0.6527417875237146,67
3303,1,8351,8351,0,0,0,0,1.0,1,1.0,1,1.0,1,0.6551686493873655,67
3304,1,8352,8352,0,0,0,0,1.0,1,1.0,1,1.0,1,0.6582030293853309,67
3305,2,8354,8354,0,0,0,0,1.0,1,1.0,1,1.0,1,0.6733771134603201,69
3306,0,8354,8354,0,0,0,0,1.0,1,1.0,1,1.0,1,0.6651880339572953,70
3307,1,8355,8355,0,0,0,0,1.0,1,1.0,1,1.0,1,0.6607446540952769,70
3308,2,8357,8357,0,0,0,0,1.0,1,1.0,1,1.0,1,0.6519572291519355,70
3309,3,8360,8360,0,0,0,0,1.0,1,1.0,1,1.0,1,0.6608714306290604,72
3310,1,8361,8361,0,0,0,0,1.0,1,1.0,1,1.0,1,0.6637126984825708,74
3311,1,8362,8362,0,0,0,0,1.0,1,1.0,1,1.0,1,0.6530077952374533,74
3312,2,8364,8364,0,0,0,0,1.0,1,1.0,1,1.0,1,0.6605175279039708,74
3313,3,8367,8367,0,0,0,0,1.0,1,1.0,1,1.0,1,0.6454030761058263,75
3314,1,8368,8368,0,0,0,0,1.0,1,1.0,1,1.0,1,0.642605647581509,76
3315,2,8370,8370,0,0,0,0,1.0,1,1.0,1,1.0,1,0.6490559916130136,75
3316,6,8376,8376,0,0,0,0,1.0,1,1.0,1,1.0,1,0.6371645175602835,76
3317,3,8379,8379,0,0,0,0,1.0,1,1.0,1,1.0,1,0.6525262890881249,73
3318,1,8380,8380,0,0,0,0,1.0,1,1.0,1,1.0,1,0.6550475196840914,72
3319,5,8385,8385,0,0,0,0,1.0,1,1.0,1,1.0,1,0.6647137481588156,71
3320,1,8386,8386,0,0,0,0,1.0,1,1.0,1,1.0,1,0.6680646457237481,70
3321,6,8392,8392,0,0,0,0,1.0,1,1.0,1,1.0,1,0.6551113967173929,69
3322,1,8393,8393,0,0,0,0,1.0,1,1.0,1,1.0,1,0.6473961549858468,68
3323,2,8395,8395,0,0,0,0,1.0,1,1.0,1,1.0,1,0.649105551633482,69
3324,2,8397,8397,0,0,0,0,1.0,1,1.0,1,1.0,1,0.6344737261971284,69
3325,7,8404,8404,0,0,0,0,1.0,1,1.0,1,1.0,1,0.6369503071377327,70
3326,3,8407,8407,0,0,0,0,1.0,1,1.0,1,1.0,1,0.6123417379907092,69
3327,5,8412,8412,0,0,0,0,1.0,1,1.0,1,1.0,1,0.6047706647588769,70
3328,4,8416,8416,0,0,0,0,1.0,1,1.0,1,1.0,1,0.5923005714357064,73
3329,5,8421,8421,0,0,0,0,1.0,1,1.0,1,1.0,1,0.5969670220340436,72
3330,3,8424,8424,0,0,0,0,1.0,1,1.0,1,1.0,1,0.6065802469137485,72
3331,1,8425,8425,0,0,0,0,1.0,1,1.0,1,1.0,1,0.6001084134715469,72
3332,3,8428,8428,0,0,0,0,1.0,1,1.0,1,1.0,1,0.5999346182862211,73
3333,1,8429,8429,0,0,0,0,1.0,1,1.0,1,1.0,1,0.5904770012919399,72
3334,2,8431,8431,0,0,0,0,1.0,1,1.0,1,1.0,1,0.5877622380376477,73
3335,2,8433,8433,0,0,0,0,1.0,1,1.0,1,1.0,1,0.5788550224251106,74
3336,3,8436,8436,0,0,0,0,1.0,1,1.0,1,1.0,1,0.5909148733164589,74
3337,2,8438,8438,0,0,0,0,1.0,1,1.0,1,1.0,1,0.5815091020267795,74
3338,6,8444,8444,0,0,0,0,1.0,1,1.0,1,1.0,1,0.6114182605159505,74
3339,4,8448,8448,0,0,0,0,1.0,1,1.0,1,1.0,1,0.599287312790942,75
3340,1,8449,8449,0,0,0,0,1.0,1,1.0,1,1.0,1,0.5995392642050419,75
3341,3,8452,8452,0,0,0,0,1.0,1,1.0,1,1.0,1,0.5958605820016836,76
3342,3,8455,8455,0,0,0,0,1.0,1,1.0,1,1.0,1,0.6164012084912451,76
3343,2,8457,8457,0,0,0,0,1.0,1,1.0,1,1.0,1,0.6167541538886094,75
3344,4,8461,8461,0,0,0,0,1.0,1,1.0,1,1.0,1,0.6293232980286997,75
3345,4,8465,8465,0,0,0,0,1.0,1,1.0,1,1.0,1,0.6488626331191117,72
3346,3,8468,8468,0,0,0,0,1.0,1,1.0,1,1.0,1,0.6419561583751396,73
3347,5,8473,8473,0,0,0,0,1.0,1,1.0,1,1.0,1,0.6228326437226634,73
3348,2,8475,8475,0,0,0,0,1.0,1,1.0,1,1.0,1,0.6321120058038042,73
3349,5,8480,8480,0,0,0,0,1.0,1,1.0,1,1.0,1,0.6411700533400084,74
3350,0,8480,8480,0,0,0,0,1.0,1,1.0,1,1.0,1,0.6453944193185146,73
3351,3,8483,8483,0,0,0,0,1.0,1,1.0,1,1.0,1,0.6425785530661755,72
3352,4,8487,8487,0,0,0,0,1.0,1,1.0,1,1.0,1,0.6581974630525348,72
3353,2,8489,8489,0,0,0,0,1.0,1,1.0,1,1.0,1,0.6431917680880901,72
3354,4,8493,8493,0,0,0,0,1.0,1,1.0,1,1.0,1,0.6335060819764652,70
3355,4,8497,8497,0,0,0,0,1.0,1,1.0,1,1.0,1,0.6433400028710557,69
3356,6,8503,8503,0,0,0,0,1.0,1,1.0,1,1.0,1,0.6220076722471829,69
3357,4,8507,8507,0,0,0,0,1.0,1,1.0,1,1.0,1,0.6321611424988295,68
3358,5,8512,8512,0,0,0,0,1.0,1,1.0,1,1.0,1,0.6170771147357842,68
3359,1,8513,8513,0,0,0,0,1.0,1,1.0,1,1.0,1,0.6205679630691456,66
3360,3,8516,8516,0,0,0,0,1.0,1,1.0,1,1.0,1,0.633680395985717,65
3361,1,8517,8517,0,0,0,0,1.0,1,1.0,1,1.0,1,0.6176887095013461,64
3362,1,8518,8518,0,0,0,0,1.0,1,1.0,1,1.0,1,0.6094006402354444,64
3363,1,8519,8519,0,0,0,0,1.0,1,1.0,1,1.0,1,0.6158643206733843,65
3364,1,8520,8520,0,0,0,0,1.0,1,1.0,1,1.0,1,0.6033756736548628,66
3365,1,8521,8521,0,0,0,0,1.0,1,1.0,1,1.0,1,0.6004896488266145,68
3366,0,8521,8521,0,0,0,0,1.0,1,1.0,1,1.0,1,0.6007115552964238,66
3367,5,8526,8526,0,0,0,0,1.0,1,1.0,1,1.0,1,0.6279220065810702,68
3368,2,8528,8528,0,0,0,0,1.0,1,1.0,1,1.0,1,0.6176463638675129,68
3369,4,8532,8532,0,0,0,0,1.0,1,1.0,1,1.0,1,0.6506349679463573,69
3370,3,8535,8535,0,0,0,0,1.0,1,1.0,1,1.0,1,0.6321175070988718,71
3371,1,8536,8536,0,0,0,0,1.0,1,1.0,1,1.0,1,0.6384236586503376,71
3372,4,8540,8540,0,0,0,0,1.0,1,1.0,1,1.0,1,0.6165140146291203,71
3373,1,8541,8541,0,0,0,0,1.0,1,1.0,1,1.0,1,0.6103022951712346,72
3374,0,8541,8541,0,0,0,0,1.0,1,1.0,1,1.0,1,0.60340405093342,72
3375,3,8544,8544,0,0,0,0,1.0,1,1.0,1,1.0,1,0.5891217273329669,73
3376,0,8544,8544,0,0,0,0,1.0,1,1.0,1,1.0,1,0.5835447302627966,75
3377,3,8547,8547,0,0,0,0,1.0,1,1.0,1,1.0,1,0.5632622550702536,77
3378,3,8550,8550,0,0,0,0,1.0,1,1.0,1,1.0,1,0.5535991834824388,77
3379,4,8554,8554,0,0,0,0,1.0,1,1.0,1,1.0,1,0.5585830140489662,77
3380,5,8559,8559,0,0,0,0,1.0,1,1.0,1,1.0,1,0.5853498192539923,76
3381,4,8563,8563,0,0,0,0,1.0,1,1.0,1,1.0,1,0.599532655256453,76
3382,6,8569,8569,0,0,0,0,1.0,1,1.0,1,1.0,1,0.5914759717104948,78
3383,1,8570,8570,0,0,0,0,1.0,1,1.0,1,1.0,1,0.6039129789415584,77
3384,5,8575,8575,0,0,0,0,1.0,1,1.0,1,1.0,1,0.5935049927639495,77
3385,4,8579,8579,0,0,0,0,1.0,1,1.0,1,1.0,1,0.6025242239913599,75
3386,1,8580,8580,0,0,0,0,1.0,1,1.0,1,1.0,1,0.6005525205855563,76
3387,1,8581,8581,0,0,0,0,1.0,1,1.0,1,1.0,1,0.600505007310476,75
3388,4,8585,8585,0,0,0,0,1.0,1,1.0,1,1.0,1,0.6057912472134444,76
3389,1,8586,8586,0,0,0,0,1.0,1,1.0,1,1.0,1,0.6106678939344884,77
3390,2,8588,8588,0,0,0,0,1.0,1,1.0,1,1.0,1,0.6250574093481891,76
3391,0,8588,8588,0,0,0,0,1.0,1,1.0,1,1.0,1,0.6149359062107363,77
3392,0,8588,8588,0,0,0,0,1.0,1,1.0,1,1.0,1,0.616273272253136,78
3393,1,8589,8589,0,0,0,0,1.0,1,1.0,1,1.0,1,0.6082778029885615,76
3394,3,8592,8592,0,0,0,0,1.0,1,1.0,1,1.0,1,0.6191356759964766,75
3395,0,8592,8592,0,0,0,0,1.0,1,1.0,1,1.0,1,0.625169137979671,73
3396,2,8594,8594,0,0,0,0,1.0,1,1.0,1,1.0,1,0.6437358063245471,73
3397,2,8596,8596,0,0,0,0,1.0,1,1.0,1,1.0,1,0.6314045632956797,74
3398,4,8600,8600,0,0,0,0,1.0,1,1.0,1,1.0,1,0.6595255429500485,74
3399,2,8602,8602,0,0,0,0,1.0,1,1.0,1,1.0,1,0.6586469922625611,75
3400,4,8606,8606,0,0,0,0,1.0,1,1.0,1,1.0,1,0.6587604548973711,75
3401,2,8608,8608,0,0,0,0,1.0,1,1.0,1,1.0,1,0.6388635023112897,77
3402,0,8608,8608,0,0,0,0,1.0,1,1.0,1,1.0,1,0.6388635023112897,77
3403,2,8610,8610,0,0,0,0,1.0,1,1.0,1,1.0,1,0.6426686713536189,78
3404,2,8612,8612,0,0,0,0,1.0,1,1.0,1,1.0,1,0.6438008354813867,78
3405,2,8614,8614,0,0,0,0,1.0,1,1.0,1,1.0,1,0.6495502715136318,78
3406,1,8615,8615,0,0,0,0,1.0,1,1.0,1,1.0,1,0.6529428844376749,78
3407,2,8617,8617,0,0,0,0,1.0,1,1.0,1,1.0,1,0.6594277097673159,78
3408,0,8617,8617,0,0,0,0,1.0,1,1.0,1,1.0,1,0.6574435446065093,79
3409,0,8617,8617,0,0,0,0,1.0,1,1.0,1,1.0,1,0.6450090141188626,81
3410,0,8617,8617,0,0,0,0,1.0,1,1.0,1,1.0,1,0.6477736267814483,82
3411,2,8619,8619,0,0,0,0,1.0,1,1.0,1,1.0,1,0.6412848668876111,84
3412,1,8620,8620,0,0,0,0,1.0,1,1.0,1,1.0,1,0.6391182053346162,84
3413,3,8623,8623,0,0,0,0,1.0,1,1.0,1,1.0,1,0.6259125174645772,84
3414,3,8626,8626,0,0,0,0,1.0,1,1.0,1,1.0,1,0.6367552694447676,84
3415,3,8629,8629,0,0,0,0,1.0,1,1.0,1,1.0,1,0.6329938146969358,85
3416,2,8631,8631,0,0,0,0,1.0,1,1.0,1,1.0,1,0.630669643832394,85
3417,3,8634,8634,0,0,0,0,1.0,1,1.0,1,1.0,1,0.6344097677811966,86
3418,2,8636,8636,0,0,0,0,1.0,1,1.0,1,1.0,1,0.6437721708975179,86
3419,3,8639,8639,0,0,0,0,1.0,1,1.0,1,1.0,1,0.6470151555801077,87
3420,3,8642,8642,0,0,0,0,1.0,1,1.0,1,1.0,1,0.6607242795939916,88
3421,4,8646,8646,0,0,0,0,1.0,1,1.0,1,1.0,1,0.6659697942794641,89
3422,1,8647,8647,0,0,0,0,1.0,1,1.0,1,1.0,1,0.6695728339545034,90
3423,2,8649,8649,0,0,0,0,1.0,1,1.0,1,1.0,1,0.669129607990734,90
3424,1,8650,8650,0,0,0,0,1.0,1,1.0,1,1.0,1,0.6608627218963409,91
3425,0,8650,8650,0,0,0,0,1.0,1,1.0,1,1.0,1,0.6605917338052977,90
3426,1,8651,8651,0,0,0,0,1.0,1,1.0,1,1.0,1,0.6478695907714795,92
3427,1,8652,8652,0,0,0,0,1.0,1,1.0,1,1.0,1,0.6596375800687635,92
3428,3,8655,8655,0,0,0,0,1.0,1,1.0,1,1.0,1,0.6520065288755792,91
3429,3,8658,8658,0,0,0,0,1.0,1,1.0,1,1.0,1,0.654014444274554,91
3430,3,8661,8661,0,0,0,0,1.0,1,1.0,1,1.0,1,0.649585291233954,91
3431,2,8663,8663,0,0,0,0,1.0,1,1.0,1,1.0,1,0.6568431914330635,90
3432,3,8666,8666,0,0,0,0,1.0,1,1.0,1,1.0,1,0.6552321436572175,91
3433,1,8667,8667,0,0,0,0,1.0,1,1.0,1,1.0,1,0.6590547929753763,90
3434,1,8668,8668,0,0,0,0,1.0,1,1.0,1,1.0,1,0.6614795138949444,89
3435,1,8669,8669,0,0,0,0,1.0,1,1.0,1,1.0,1,0.6644030512992096,88
3436,1,8670,8670,0,0,0,0,1.0,1,1.0,1,1.0,1,0.6611349611279043,86
3437,1,8671,8671,0,0,0,0,1.0,1,1.0,1,1.0,1,0.6547095951696563,86
3438,1,8672,8672,0,0,0,0,1.0,1,1.0,1,1.0,1,0.6472464616564724,87
3439,2,8674,8674,0,0,0,0,1.0,1,1.0,1,1.0,1,0.6343640134618911,86
3440,1,8675,8675,0,0,0,0,1.0,1,1.0,1,1.0,1,0.6321801823987918,86
3441,2,8677,8677,0,0,0,0,1.0,1,1.0,1,1.0,1,0.6302230661174996,85
3442,1,8678,8678,0,0,0,0,1.0,1,1.0,1,1.0,1,0.6279904756831568,85
3443,2,8680,8680,0,0,0,0,1.0,1,1.0,1,1.0,1,0.6132482728768969,85
3444,5,8685,8685,0,0,0,0,1.0,1,1.0,1,1.0,1,0.6208156097424279,85
3445,3,8688,8688,0,0,0,0,1.0,1,1.0,1,1.0,1,0.6205537691015298,84
3446,5,8693,8693,0,0,0,0,1.0,1,1.0,1,1.0,1,0.6286719921374105,85
3447,2,8695,8695,0,0,0,0,1.0,1,1.0,1,1.0,1,0.6310306851799912,85
3448,4,8699,8699,0,0,0,0,1.0,1,1.0,1,1.0,1,0.6505534795207626,85
3449,1,8700,8700,0,0,0,0,1.0,1,1.0,1,1.0,1,0.6654774692037089,84
3450,0,8700,8700,0,0,0,0,1.0,1,1.0,1,1.0,1,0.6654774692037089,84
3451,4,8704,8704,0,0,0,0,1.0,1,1.0,1,1.0,1,0.6563953234711248,85
3452,3,8707,8707,0,0,0,0,1.0,1,1.0,1,1.0,1,0.6665993918197823,86
3453,4,8711,8711,0,0,0,0,1.0,1,1.0,1,1.0,1,0.6469780572652127,85
3454,3,8714,8714,0,0,0,0,1.0,1,1.0,1,1.0,1,0.6273584653148679,88
3455,1,8715,8715,0,0,0,0,1.0,1,1.0,1,1.0,1,0.6324228086361519,88
3456,0,8715,8715,0,0,0,0,1.0,1,1.0,1,1.0,1,0.6324228086361519,88
3457,4,8719,8719,0,0,0,0,1.0,1,1.0,1,1.0,1,0.6271917864805965,89
3458,2,8721,8721,0,0,0,0,1.0,1,1.0,1,1.0,1,0.6354169670458383,88
3459,4,8725,8725,0,0,0,0,1.0,1,1.0,1,1.0,1,0.6219092676808231,88
3460,5,8730,8730,0,0,0,0,1.0,1,1.0,1,1.0,1,0.6378009916844781,89
3461,2,8732,8732,0,0,0,0,1.0,1,1.0,1,1.0,1,0.6391597441391803,89
3462,1,8733,8733,0,0,0,0,1.0,1,1.0,1,1.0,1,0.6429755342324303,90
3463,5,8738,8738,0,0,0,0,1.0,1,1.0,1,1.0,1,0.6556222126786914,89
3464,0,8738,8738,0,0,0,0,1.0,1,1.0,1,1.0,1,0.659689204110228,88
3465,2,8740,8740,0,0,0,0,1.0,1,1.0,1,1.0,1,0.6640299463279616,87
3466,1,8741,8741,0,0,0,0,1.0,1,1.0,1,1.0,1,0.6610304212497047,87
3467,2,8743,8743,0,0,0,0,1.0,1,1.0,1,1.0,1,0.648359115464579,87
3468,2,8745,8745,0,0,0,0,1.0,1,1.0,1,1.0,1,0.6460729302966507,88
3469,3,8748,8748,0,0,0,0,1.0,1,1.0,1,1.0,1,0.6340005197344758,85
3470,0,8748,8748,0,0,0,0,1.0,1,1.0,1,1.0,1,0.6342881146681953,86
3471,4,8752,8752,0,0,0,0,1.0,1,1.0,1,1.0,1,0.6367448240085686,84
3472,4,8756,8756,0,0,0,0,1.0,1,1.0,1,1.0,1,0.6363982571474858,83
3473,4,8760,8760,0,0,0,0,1.0,1,1.0,1,1.0,1,0.6390744909455176,81
3474,2,8762,8762,0,0,0,0,1.0,1,1.0,1,1.0,1,0.6235547452676755,80
3475,5,8767,8767,0,0,0,0,1.0,1,1.0,1,1.0,1,0.6402137351479443,82
3476,0,8767,8767,0,0,0,0,1.0,1,1.0,1,1.0,1,0.6324796017263077,81
3477,4,8771,8771,0,0,0,0,1.0,1,1.0,1,1.0,1,0.6460125429293927,83
3478,4,8775,8775,0,0,0,0,1.0,1,1.0,1,1.0,1,0.616687516661139,83
3479,3,8778,8778,0,0,0,0,1.0,1,1.0,1,1.0,1,0.6133850977888072,83
3480,3,8781,8781,0,0,0,0,1.0,1,1.0,1,1.0,1,0.6196338706786666,83
3481,8,8789,8789,0,0,0,0,1.0,1,1.0,1,1.0,1,0.6072190774445386,83
3482,7,8796,8796,0,0,0,0,1.0,1,1.0,1,1.0,1,0.6163855793939197,83
3483,2,8798,8798,0,0,0,0,1.0,1,1.0,1,1.0,1,0.6142179345033314,82
3484,4,8802,8802,0,0,0,0,1.0,1,1.0,1,1.0,1,0.6260360965550955,82
3485,2,8804,8804,0,0,0,0,1.0,1,1.0,1,1.0,1,0.6224988939799068,83
3486,1,8805,8805,0,0,0,0,1.0,1,1.0,1,1.0,1,0.6170017734148502,83
3487,1,8806,8806,0,0,0,0,1.0,1,1.0,1,1.0,1,0.6285762026491133,84
3488,1,8807,8807,0,0,0,0,1.0,1,1.0,1,1.0,1,0.6306553266407066,84
3489,0,8807,8807,0,0,0,0,1.0,1,1.0,1,1.0,1,0.6306553266407066,84
3490,1,8808,8808,0,0,0,0,1.0,1,1.0,1,1.0,1,0.6277312273385801,84
3491,3,8811,8811,0,0,0,0,1.0,1,1.0,1,1.0,1,0.6239082888918027,86
3492,0,8811,8811,0,0,0,0,1.0,1,1.0,1,1.0,1,0.6239082888918027,86
3493,2,8813,8813,0,0,0,0,1.0,1,1.0,1,1.0,1,0.6258605434556936,86
3494,2,8815,8815,0,0,0,0,1.0,1,1.0,1,1.0,1,0.6271513717874296,86
3495,2,8817,8817,0,0,0,0,1.0,1,1.0,1,1.0,1,0.61133643821635,87
3496,2,8819,8819,0,0,0,0,1.0,1,1.0,1,1.0,1,0.6144940628592295,88
3497,1,8820,8820,0,0,0,0,1.0,1,1.0,1,1.0,1,0.603149289244499,89
3498,3,8823,8823,0,0,0,0,1.0,1,1.0,1,1.0,1,0.6092746166004255,89
3499,4,8827,8827,0,0,0,0,1.0,1,1.0,1,1.0,1,0.5912151733809388,91
3500,2,8829,8829,0,0,0,0,1.0,1,1.0,1,1.0,1,0.5967886248621211,90
3501,3,8832,8832,0,0,0,0,1.0,1,1.0,1,1.0,1,0.5929550943771615,90
3502,4,8836,8836,0,0,0,0,1.0,1,1.0,1,1.0,1,0.5807365962759004,91
3503,6,8842,8842,0,0,0,0,1.0,1,1.0,1,1.0,1,0.574016511148028,91
3504,5,8847,8847,0,0,0,0,1.0,1,1.0,1,1.0,1,0.5868822712648987,89
3505,4,8851,8851,0,0,0,0,1.0,1,1.0,1,1.0,1,0.5954231295239639,87
3506,9,8860,8860,0,0,0,0,1.0,1,1.0,1,1.0,1,0.6063096955271281,87
3507,3,8863,8863,0,0,0,0,1.0,1,1.0,1,1.0,1,0.5918976184902754,84
3508,7,8870,8870,0,0,0,0,1.0,1,1.0,1,1.0,1,0.6122736031027464,83
3509,3,8873,8873,0,0,0,0,1.0,1,1.0,1,1.0,1,0.6080827425572349,80
3510,4,8877,8877,0,0,0,0,1.0,1,1.0,1,1.0,1,0.6066925522371232,78
3511,2,8879,8879,0,0,0,0,1.0,1,1.0,1,1.0,1,0.6082458684758671,77
3512,3,8882,8882,0,0,0,0,1.0,1,1.0,1,1.0,1,0.6335540414846769,74
3513,2,8884,8884,0,0,0,0,1.0,1,1.0,1,1.0,1,0.6189445390230273,76
3514,1,8885,8885,0,0,0,0,1.0,1,1.0,1,1.0,1,0.6325500851216856,76
3515,3,8888,8888,0,0,0,0,1.0,1,1.0,1,1.0,1,0.6113914090168573,75
3516,1,8889,8889,0,0,0,0,1.0,1,1.0,1,1.0,1,0.6158899228513667,73
3517,2,8891,8891,0,0,0,0,1.0,1,1.0,1,1.0,1,0.5881275750132934,74
3518,1,8892,8892,0,0,0,0,1.0,1,1.0,1,1.0,1,0.5876697684625778,74
3519,4,8896,8896,0,0,0,0,1.0,1,1.0,1,1.0,1,0.6276136435021251,73
3520,1,8897,8897,0,0,0,0,1.0,1,1.0,1,1.0,1,0.6148865936508662,74
3521,0,8897,8897,0,0,0,0,1.0,1,1.0,1,1.0,1,0.6155888803037929,75
3522,2,8899,8899,0,0,0,0,1.0,1,1.0,1,1.0,1,0.6153010330010985,75
3523,3,8902,8902,0,0,0,0,1.0,1,1.0,1,1.0,1,0.6066346077648531,75
3524,2,8904,8904,0,0,0,0,1.0,1,1.0,1,1.0,1,0.5787934312672991,75
3525,2,8906,8906,0,0,0,0,1.0,1,1.0,1,1.0,1,0.5909276641317383,75
3526,3,8909,8909,0,0,0,0,1.0,1,1.0,1,1.0,1,0.5879145395035904,76
3527,3,8912,8912,0,0,0,0,1.0,1,1.0,1,1.0,1,0.569632387926527,77
3528,2,8914,8914,0,0,0,0,1.0,1,1.0,1,1.0,1,0.567626498031297,77
3529,4,8918,8918,0,0,0,0,1.0,1,1.0,1,1.0,1,0.5507146739862873,78
3530,2,8920,8920,0,0,0,0,1.0,1,1.0,1,1.0,1,0.5623493571854408,78
3531,7,8927,8927,0,0,0,0,1.0,1,1.0,1,1.0,1,0.5585304985345715,79
3532,2,8929,8929,0,0,0,0,1.0,1,1.0,1,1.0,1,0.5761377975950281,79
3533,2,8931,8931,0,0,0,0,1.0,1,1.0,1,1.0,1,0.5781966660582405,79
3534,1,8932,8932,0,0,0,0,1.0,1,1.0,1,1.0,1,0.5674024602518069,80
3535,2,8934,8934,0,0,0,0,1.0,1,1.0,1,1.0,1,0.5892697624573208,81
3536,3,8937,8937,0,0,0,0,1.0,1,1.0,1,1.0,1,0.5857535135920907,82
3537,0,8937,8937,0,0,0,0,1.0,1,1.0,1,1.0,1,0.5857535135920907,82
3538,3,8940,8940,0,0,0,0,1.0,1,1.0,1,1.0,1,0.6009198111008492,83
3539,3,8943,8943,0,0,0,0,1.0,1,1.0,1,1.0,1,0.5951116269604221,83
3540,1,8944,8944,0,0,0,0,1.0,1,1.0,1,1.0,1,0.5853560675151432,85
3541,1,8945,8945,0,0,0,0,1.0,1,1.0,1,1.0,1,0.5945339025765404,85
3542,2,8947,8947,0,0,0,0,1.0,1,1.0,1,1.0,1,0.5985459313995808,88
3543,1,8948,8948,0,0,0,0,1.0,1,1.0,1,1.0,1,0.5959342131522413,87
3544,3,8951,8951,0,0,0,0,1.0,1,1.0,1,1.0,1,0.5981324127171236,87
3545,4,8955,8955,0,0,0,0,1.0,1,1.0,1,1.0,1,0.6046426250336107,85
3546,1,8956,8956,0,0,0,0,1.0,1,1.0,1,1.0,1,0.600588436926024,83
3547,5,8961,8961,0,0,0,0,1.0,1,1.0,1,1.0,1,0.5860051972519118,82
3548,0,8961,8961,0,0,0,0,1.0,1,1.0,1,1.0,1,0.5860051972519118,82
3549,2,8963,8963,0,0,0,0,1.0,1,1.0,1,1.0,1,0.5915106227955917,81
3550,2,8965,8965,0,0,0,0,1.0,1,1.0,1,1.0,1,0.6025033364205813,79
3551,1,8966,8966,0,0,0,0,1.0,1,1.0,1,1.0,1,0.6133713577926926,80
3552,1,8967,8967,0,0,0,0,1.0,1,1.0,1,1.0,1,0.6291393115764808,78
3553,2,8969,8969,0,0,0,0,1.0,1,1.0,1,1.0,1,0.6318608450612595,79
3554,4,8973,8973,0,0,0,0,1.0,1,1.0,1,1.0,1,0.6177357400456976,77
3555,2,8975,8975,0,0,0,0,1.0,1,1.0,1,1.0,1,0.6179061459386028,77
3556,5,8980,8980,0,0,0,0,1.0,1,1.0,1,1.0,1,0.6241512149614005,76
3557,1,8981,8981,0,0,0,0,1.0,1,1.0,1,1.0,1,0.6210182788530612,76
3558,5,8986,8986,0,0,0,0,1.0,1,1.0,1,1.0,1,0.6000434973935475,76
3559,5,8991,8991,0,0,0,0,1.0,1,1.0,1,1.0,1,0.5797936263468575,76
3560,5,8996,8996,0,0,0,0,1.0,1,1.0,1,1.0,1,0.5740035854877084,78
3561,4,9000,9000,0,0,0,0,1.0,1,1.0,1,1.0,1,0.5790203247851552,79
3562,5,9005,9005,0,0,0,0,1.0,1,1.0,1,1.0,1,0.5712197271280531,79
3563,6,9011,9011,0,0,0,0,1.0,1,1.0,1,1.0,1,0.5695505377823843,79
3564,6,9017,9017,0,0,0,0,1.0,1,1.0,1,1.0,1,0.5743068567279316,80
3565,8,9025,9025,0,0,0,0,1.0,1,1.0,1,1.0,1,0.5738399642004628,83
3566,1,9026,9026,0,0,0,0,1.0,1,1.0,1,1.0,1,0.574678574690012,84
3567,3,9029,9029,0,0,0,0,1.0,1,1.0,1,1.0,1,0.5858320420563277,84
3568,2,9031,9031,0,0,0,0,1.0,1,1.0,1,1.0,1,0.5803344541847404,84
3569,3,9034,9034,0,0,0,0,1.0,1,1.0,1,1.0,1,0.585593719745373,84
3570,2,9036,9036,0,0,0,0,1.0,1,1.0,1,1.0,1,0.5890657717476461,87
3571,1,9037,9037,0,0,0,0,1.0,1,1.0,1,1.0,1,0.6015418040531894,86
3572,3,9040,9040,0,0,0,0,1.0,1,1.0,1,1.0,1,0.600238633062951,87
3573,3,9043,9043,0,0,0,0,1.0,1,1.0,1,1.0,1,0.5894774661802253,87
3574,2,9045,9045,0,0,0,0,1.0,1,1.0,1,1.0,1,0.5824056219607172,88
3575,5,9050,9050,0,0,0,0,1.0,1,1.0,1,1.0,1,0.5934355113701257,88
3576,3,9053,9053,0,0,0,0,1.0,1,1.0,1,1.0,1,0.5761871998111587,90
3577,1,9054,9054,0,0,0,0,1.0,1,1.0,1,1.0,1,0.5680130235950699,90
3578,0,9054,9054,0,0,0,0,1.0,1,1.0,1,1.0,1,0.5719868623810673,91
3579,4,9058,9058,0,0,0,0,1.0,1,1.0,1,1.0,1,0.5734050227098281,91
3580,2,9060,9060,0,0,0,0,1.0,1,1.0,1,1.0,1,0.5988847446929292,91
3581,3,9063,9063,0,0,0,0,1.0,1,1.0,1,1.0,1,0.6002433142701911,91
3582,3,9066,9066,0,0,0,0,1.0,1,1.0,1,1.0,1,0.6001653808996178,92
3583,6,9072,9072,0,0,0,0,1.0,1,1.0,1,1.0,1,0.5967256728309659,88
3584,6,9078,9078,0,0,0,0,1.0,1,1.0,1,1.0,1,0.5891999546547901,87
3585,7,9085,9085,0,0,0,0,1.0,1,1.0,1,1.0,1,0.6149478887413895,84
3586,9,9094,9094,0,0,0,0,1.0,1,1.0,1,1.0,1,0.5932234624312867,83
3587,9,9103,9103,0,0,0,0,1.0,1,1.0,1,1.0,1,0.5843105595167429,82
3588,5,9108,9108,0,0,0,0,1.0,1,1.0,1,1.0,1,0.594172147931496,81
3589,7,9115,9115,0,0,0,0,1.0,1,1.0,1,1.0,1,0.6031884388595875,80
3590,3,9118,9118,0,0,0,0,1.0,1,1.0,1,1.0,1,0.6130118652093361,78
3591,4,9122,9122,0,0,0,0,1.0,1,1.0,1,1.0,1,0.6058064759989864,77
3592,3,9125,9125,0,0,0,0,1.0,1,1.0,1,1.0,1,0.620590148729874,75
3593,4,9129,9129,0,0,0,0,1.0,1,1.0,1,1.0,1,0.6076992229741878,76
3594,1,9130,9130,0,0,0,0,1.0,1,1.0,1,1.0,1,0.6234071296541579,74
3595,1,9131,9131,0,0,0,0,1.0,1,1.0,1,1.0,1,0.6179237254141784,74
3596,2,9133,9133,0,0,0,0,1.0,1,1.0,1,1.0,1,0.619205395278234,73
3597,2,9135,9135,0,0,0,0,1.0,1,1.0,1,1.0,1,0.6226368894165866,73
3598,0,9135,9135,0,0,0,0,1.0,1,1.0,1,1.0,1,0.6226368894165866,73
3599,3,9138,9138,0,0,0,0,1.0,1,1.0,1,1.0,1,0.6294099831545085,73
3600,2,9140,9140,0,0,0,0,1.0,1,1.0,1,1.0,1,0.622759344439475,74
3601,5,9145,9145,0,0,0,0,1.0,1,1.0,1,1.0,1,0.6358680742319698,75
3602,1,9146,9146,0,0,0,0,1.0,1,1.0,1,1.0,1,0.6286497717992974,76
3603,7,9153,9153,0,0,0,0,1.0,1,1.0,1,1.0,1,0.6093183197942712,77
3604,3,9156,9156,0,0,0,0,1.0,1,1.0,1,1.0,1,0.6036837635252212,78
3605,3,9159,9159,0,0,0,0,1.0,1,1.0,1,1.0,1,0.5867447602871528,77
3606,2,9161,9161,0,0,0,0,1.0,1,1.0,1,1.0,1,0.5852828128484053,79
3607,2,9163,9163,0,0,0,0,1.0,1,1.0,1,1.0,1,0.5746980256083737,79
3608,5,9168,9168,0,0,0,0,1.0,1,1.0,1,1.0,1,0.5999917861260975,79
3609,3,9171,9171,0,0,0,0,1.0,1,1.0,1,1.0,1,0.5838571196122067,79
3610,2,9173,9173,0,0,0,0,1.0,1,1.0,1,1.0,1,0.5875626050567796,80
3611,7,9180,9180,0,0,0,0,1.0,1,1.0,1,1.0,1,0.5788220882115962,80
3612,1,9181,9181,0,0,0,0,1.0,1,1.0,1,1.0,1,0.5812376054423847,79
3613,4,9185,9185,0,0,0,0,1.0,1,1.0,1,1.0,1,0.5874050352123562,79
3614,3,9188,9188,0,0,0,0,1.0,1,1.0,1,1.0,1,0.5787335499033158,78
3615,2,9190,9190,0,0,0,0,1.0,1,1.0,1,1.0,1,0.5745644970118847,79
3616,3,9193,9193,0,0,0,0,1.0,1,1.0,1,1.0,1,0.5807671479049831,79
3617,3,9196,9196,0,0,0,0,1.0,1,1.0,1,1.0,1,0.5922137817865695,80
3618,0,9196,9196,0,0,0,0,1.0,1,1.0,1,1.0,1,0.6042554834300523,82
3619,4,9200,9200,0,0,0,0,1.0,1,1.0,1,1.0,1,0.5972242117193902,82
3620,2,9202,9202,0,0,0,0,1.0,1,1.0,1,1.0,1,0.588651071387291,81
3621,3,9205,9205,0,0,0,0,1.0,1,1.0,1,1.0,1,0.6016379600504485,83
3622,4,9209,9209,0,0,0,0,1.0,1,1.0,1,1.0,1,0.6061314645458731,81
3623,1,9210,9210,0,0,0,0,1.0,1,1.0,1,1.0,1,0.5990671507832122,81
3624,2,9212,9212,0,0,0,0,1.0,1,1.0,1,1.0,1,0.5895939276922805,79
3625,1,9213,9213,0,0,0,0,1.0,1,1.0,1,1.0,1,0.6005640478385006,80
3626,3,9216,9216,0,0,0,0,1.0,1,1.0,1,1.0,1,0.5845595352590948,78
3627,3,9219,9219,0,0,0,0,1.0,1,1.0,1,1.0,1,0.6024277226736184,78
3628,4,9223,9223,0,0,0,0,1.0,1,1.0,1,1.0,1,0.5699635053453059,77
3629,3,9226,9226,0,0,0,0,1.0,1,1.0,1,1.0,1,0.5688083090552365,76
3630,2,9228,9228,0,0,0,0,1.0,1,1.0,1,1.0,1,0.5775273371577326,77
3631,2,9230,9230,0,0,0,0,1.0,1,1.0,1,1.0,1,0.5894970117049498,75
3632,3,9233,9233,0,0,0,0,1.0,1,1.0,1,1.0,1,0.5946949649389421,74
3633,4,9237,9237,0,0,0,0,1.0,1,1.0,1,1.0,1,0.600775849420412,75
3634,3,9240,9240,0,0,0,0,1.0,1,1.0,1,1.0,1,0.6017493823542168,74
3635,5,9245,9245,0,0,0,0,1.0,1,1.0,1,1.0,1,0.6068827606635738,74
3636,4,9249,9249,0,0,0,0,1.0,1,1.0,1,1.0,1,0.6232942922723832,74
3637,4,9253,9253,0,0,0,0,1.0,1,1.0,1,1.0,1,0.6396184369946472,74
3638,1,9254,9254,0,0,0,0,1.0,1,1.0,1,1.0,1,0.6463578839094326,75
3639,2,9256,9256,0,0,0,0,1.0,1,1.0,1,1.0,1,0.6481060991123458,76
3640,1,9257,9257,0,0,0,0,1.0,1,1.0,1,1.0,1,0.6445907838499191,76
3641,3,9260,9260,0,0,0,0,1.0,1,1.0,1,1.0,1,0.6418483415113074,75
3642,0,9260,9260,0,0,0,0,1.0,1,1.0,1,1.0,1,0.6418483415113074,75
3643,1,9261,9261,0,0,0,0,1.0,1,1.0,1,1.0,1,0.6451836681456204,74
3644,1,9262,9262,0,0,0,0,1.0,1,1.0,1,1.0,1,0.64810473023368,74
3645,1,9263,9263,0,0,0,0,1.0,1,1.0,1,1.0,1,0.6447240110463975,74
3646,3,9266,9266,0,0,0,0,1.0,1,1.0,1,1.0,1,0.6398919800886689,75
3647,2,9268,9268,0,0,0,0,1.0,1,1.0,1,1.0,1,0.6377661507430831,77
3648,2,9270,9270,0,0,0,0,1.0,1,1.0,1,1.0,1,0.6451645313703663,78
3649,0,9270,9270,0,0,0,0,1.0,1,1.0,1,1.0,1,0.6411019296992327,80
3650,1,9271,9271,0,0,0,0,1.0,1,1.0,1,1.0,1,0.6520076592903873,81
3651,1,9272,9272,0,0,0,0,1.0,1,1.0,1,1.0,1,0.6430307811738777,81
3652,1,9273,9273,0,0,0,0,1.0,1,1.0,1,1.0,1,0.6462333794240134,83
3653,3,9276,9276,0,0,0,0,1.0,1,1.0,1,1.0,1,0.6488452961103621,83
3654,0,9276,9276,0,0,0,0,1.0,1,1.0,1,1.0,1,0.6488452961103621,83
3655,0,9276,9276,0,0,0,0,1.0,1,1.0,1,1.0,1,0.639063042871386,84
3656,0,9276,9276,0,0,0,0,1.0,1,1.0,1,1.0,1,0.6421321180220805,85
3657,0,9276,9276,0,0,0,0,1.0,1,1.0,1,1.0,1,0.6327868739896801,86
3658,2,9278,9278,0,0,0,0,1.0,1,1.0,1,1.0,1,0.6391661569235357,87
3659,2,9280,9280,0,0,0,0,1.0,1,1.0,1,1.0,1,0.63173833971859,87
3660,3,9283,9283,0,0,0,0,1.0,1,1.0,1,1.0,1,0.6250419556032673,86
3661,6,9289,9289,0,0,0,0,1.0,1,1.0,1,1.0,1,0.6234357738255915,86
3662,5,9294,9294,0,0,0,0,1.0,1,1.0,1,1.0,1,0.6110813286603174,83
3663,6,9300,9300,0,0,0,0,1.0,1,1.0,1,1.0,1,0.6138384659834869,85
3664,7,9307,9307,0,0,0,0,1.0,1,1.0,1,1.0,1,0.6057930764155124,82
3665,5,9312,9312,0,0,0,0,1.0,1,1.0,1,1.0,1,0.6159026009034364,81
3666,6,9318,9318,0,0,0,0,1.0,1,1.0,1,1.0,1,0.6415927769887894,79
3667,3,9321,9321,0,0,0,0,1.0,1,1.0,1,1.0,1,0.6313731932427812,79
3668,2,9323,9323,0,0,0,0,1.0,1,1.0,1,1.0,1,0.6356414307277881,77
3669,3,9326,9326,0,0,0,0,1.0,1,1.0,1,1.0,1,0.6467670718992754,75
3670,5,9331,9331,0,0,0,0,1.0,1,1.0,1,1.0,1,0.6574896019656129,76
3671,2,9333,9333,0,0,0,0,1.0,1,1.0,1,1.0,1,0.6604030634893822,74
3672,2,9335,9335,0,0,0,0,1.0,1,1.0,1,1.0,1,0.6528482012024591,75
3673,4,9339,9339,0,0,0,0,1.0,1,1.0,1,1.0,1,0.6535856398779657,75
3674,1,9340,9340,0,0,0,0,1.0,1,1.0,1,1.0,1,0.6566088459430904,75
3675,0,9340,9340,0,0,0,0,1.0,1,1.0,1,1.0,1,0.6581753638050019,75
3676,0,9340,9340,0,0,0,0,1.0,1,1.0,1,1.0,1,0.6581753638050019,75
3677,2,9342,9342,0,0,0,0,1.0,1,1.0,1,1.0,1,0.6622006882442409,75
3678,0,9342,9342,0,0,0,0,1.0,1,1.0,1,1.0,1,0.6623114235740527,77
3679,1,9343,9343,0,0,0,0,1.0,1,1.0,1,1.0,1,0.6698831506503281,78
3680,1,9344,9344,0,0,0,0,1.0,1,1.0,1,1.0,1,0.6688383952505003,80
3681,0,9344,9344,0,0,0,0,1.0,1,1.0,1,1.0,1,0.6688052297939543,81
3682,1,9345,9345,0,0,0,0,1.0,1,1.0,1,1.0,1,0.6710705082272395,81
3683,0,9345,9345,0,0,0,0,1.0,1,1.0,1,1.0,1,0.6710705082272395,81
3684,0,9345,9345,0,0,0,0,1.0,1,1.0,1,1.0,1,0.6710705082272395,81
3685,0,9345,9345,0,0,0,0,1.0,1,1.0,1,1.0,1,0.6710705082272395,81
3686,0,9345,9345,0,0,0,0,1.0,1,1.0,1,1.0,1,0.6710705082272395,81
3687,1,9346,9346,0,0,0,0,1.0,1,1.0,1,1.0,1,0.6662285969029531,82
3688,0,9346,9346,0,0,0,0,1.0,1,1.0,1,1.0,1,0.6681962983214456,84
3689,1,9347,9347,0,0,0,0,1.0,1,1.0,1,1.0,1,0.673236067473087,84
3690,0,9347,9347,0,0,0,0,1.0,1,1.0,1,1.0,1,0.6731440155725785,85
3691,1,9348,9348,0,0,0,0,1.0,1,1.0,1,1.0,1,0.6759190612421617,86
3692,2,9350,9350,0,0,0,0,1.0,1,1.0,1,1.0,1,0.6759857820859149,86
3693,1,9351,9351,0,0,0,0,1.0,1,1.0,1,1.0,1,0.678452705158891,86
3694,2,9353,9353,0,0,0,0,1.0,1,1.0,1,1.0,1,0.684488133555,86
3695,1,9354,9354,0,0,0,0,1.0,1,1.0,1,1.0,1,0.6878805949837778,86
3696,1,9355,9355,0,0,0,0,1.0,1,1.0,1,1.0,1,0.6776119205270138,87
3697,2,9357,9357,0,0,0,0,1.0,1,1.0,1,1.0,1,0.6858720627938474,85
3698,3,9360,9360,0,0,0,0,1.0,1,1.0,1,1.0,1,0.6822367979366386,85
3699,0,9360,9360,0,0,0,0,1.0,1,1.0,1,1.0,1,0.6744957309480587,85
3700,4,9364,9364,0,0,0,0,1.0,1,1.0,1,1.0,1,0.678944040642013,84
3701,2,9366,9366,0,0,0,0,1.0,1,1.0,1,1.0,1,0.6801696596734739,85
3702,3,9369,9369,0,0,0,0,1.0,1,1.0,1,1.0,1,0.6714945781054364,85
3703,2,9371,9371,0,0,0,0,1.0,1,1.0,1,1.0,1,0.6775093502067179,85
3704,1,9372,9372,0,0,0,0,1.0,1,1.0,1,1.0,1,0.6843026683014977,85
3705,0,9372,9372,0,0,0,0,1.0,1,1.0,1,1.0,1,0.6792368434288396,86
3706,2,9374,9374,0,0,0,0,1.0,1,1.0,1,1.0,1,0.6762473127876764,86
3707,1,9375,9375,0,0,0,0,1.0,1,1.0,1,1.0,1,0.6777265200635688,85
3708,1,9376,9376,0,0,0,0,1.0,1,1.0,1,1.0,1,0.67287326895033,84
3709,2,9378,9378,0,0,0,0,1.0,1,1.0,1,1.0,1,0.6753687668565806,85
3710,2,9380,9380,0,0,0,0,1.0,1,1.0,1,1.0,1,0.6644165646208522,84
3711,4,9384,9384,0,0,0,0,1.0,1,1.0,1,1.0,1,0.656689660834071,85
3712,2,9386,9386,0,0,0,0,1.0,1,1.0,1,1.0,1,0.6540100500572429,85
3713,4,9390,9390,0,0,0,0,1.0,1,1.0,1,1.0,1,0.6522976502821538,85
3714,3,9393,9393,0,0,0,0,1.0,1,1.0,1,1.0,1,0.6358347837114883,85
3715,4,9397,9397,0,0,0,0,1.0,1,1.0,1,1.0,1,0.6293185697731337,85
3716,1,9398,9398,0,0,0,0,1.0,1,1.0,1,1.0,1,0.6304955255430048,84
3717,5,9403,9403,0,0,0,0,1.0,1,1.0,1,1.0,1,0.6045078243215559,86
3718,0,9403,9403,0,0,0,0,1.0,1,1.0,1,1.0,1,0.6145861041258297,85
3719,4,9407,9407,0,0,0,0,1.0,1,1.0,1,1.0,1,0.6340109772235942,84
3720,5,9412,9412,0,0,0,0,1.0,1,1.0,1,1.0,1,0.6548268844857174,84
3721,1,9413,9413,0,0,0,0,1.0,1,1.0,1,1.0,1,0.6553145895689299,85
3722,4,9417,9417,0,0,0,0,1.0,1,1.0,1,1.0,1,0.6503414429685475,85
3723,3,9420,9420,0,0,0,0,1.0,1,1.0,1,1.0,1,0.6591970727742837,85
3724,3,9423,9423,0,0,0,0,1.0,1,1.0,1,1.0,1,0.6341535248294994,86
3725,2,9425,9425,0,0,0,0,1.0,1,1.0,1,1.0,1,0.6258930280203144,86
3726,2,9427,9427,0,0,0,0,1.0,1,1.0,1,1.0,1,0.6276128448320927,86
3727,1,9428,9428,0,0,0,0,1.0,1,1.0,1,1.0,1,0.6340404468756173,86
3728,3,9431,9431,0,0,0,0,1.0,1,1.0,1,1.0,1,0.6533336474996633,86
3729,0,9431,9431,0,0,0,0,1.0,1,1.0,1,1.0,1,0.6533336474996633,86
3730,1,9432,9432,0,0,0,0,1.0,1,1.0,1,1.0,1,0.6657959540042508,85
3731,2,9434,9434,0,0,0,0,1.0,1,1.0,1,1.0,1,0.6796277553357222,86
3732,1,9435,9435,0,0,0,0,1.0,1,1.0,1,1.0,1,0.6661742923510723,87
3733,1,9436,9436,0,0,0,0,1.0,1,1.0,1,1.0,1,0.6746808441093675,87
3734,1,9437,9437,0,0,0,0,1.0,1,1.0,1,1.0,1,0.6798832770119758,87
3735,1,9438,9438,0,0,0,0,1.0,1,1.0,1,1.0,1,0.6848754922508516,86
3736,2,9440,9440,0,0,0,0,1.0,1,1.0,1,1.0,1,0.6626657005300395,87
3737,0,9440,9440,0,0,0,0,1.0,1,1.0,1,1.0,1,0.6512319139129171,87
3738,4,9444,9444,0,0,0,0,1.0,1,1.0,1,1.0,1,0.6325705584959109,87
3739,3,9447,9447,0,0,0,0,1.0,1,1.0,1,1.0,1,0.6273388298014246,88
3740,3,9450,9450,0,0,0,0,1.0,1,1.0,1,1.0,1,0.6165072491846738,87
3741,2,9452,9452,0,0,0,0,1.0,1,1.0,1,1.0,1,0.6107891184707058,87
3742,7,9459,9459,0,0,0,0,1.0,1,1.0,1,1.0,1,0.6093220644049109,86
3743,1,9460,9460,0,0,0,0,1.0,1,1.0,1,1.0,1,0.6158777675605801,84
3744,5,9465,9465,0,0,0,0,1.0,1,1.0,1,1.0,1,0.6247647184306977,83
3745,2,9467,9467,0,0,0,0,1.0,1,1.0,1,1.0,1,0.6195428047039118,83
3746,6,9473,9473,0,0,0,0,1.0,1,1.0,1,1.0,1,0.6289834789678913,83
3747,3,9476,9476,0,0,0,0,1.0,1,1.0,1,1.0,1,0.6324647330016044,81
3748,3,9479,9479,0,0,0,0,1.0,1,1.0,1,1.0,1,0.6318499752637782,81
3749,2,9481,9481,0,0,0,0,1.0,1,1.0,1,1.0,1,0.6378877780580763,80
3750,2,9483,9483,0,0,0,0,1.0,1,1.0,1,1.0,1,0.6418497781887443,79
3751,2,9485,9485,0,0,0,0,1.0,1,1.0,1,1.0,1,0.6478092810274025,80
3752,4,9489,9489,0,0,0,0,1.0,1,1.0,1,1.0,1,0.6530648929186564,80
3753,4,9493,9493,0,0,0,0,1.0,1,1.0,1,1.0,1,0.6577072621879096,81
3754,6,9499,9499,0,0,0,0,1.0,1,1.0,1,1.0,1,0.6671899377230556,81
3755,3,9502,9502,0,0,0,0,1.0,1,1.0,1,1.0,1,0.6688183363063264,80
3756,1,9503,9503,0,0,0,0,1.0,1,1.0,1,1.0,1,0.6806776945525589,79
3757,1,9504,9504,0,0,0,0,1.0,1,1.0,1,1.0,1,0.6885522640394462,80
3758,1,9505,9505,0,0,0,0,1.0,1,1.0,1,1.0,1,0.6916952450535286,79
3759,2,9507,9507,0,0,0,0,1.0,1,1.0,1,1.0,1,0.6992098012018029,79
3760,0,9507,9507,0,0,0,0,1.0,1,1.0,1,1.0,1,0.6992098012018029,79
3761,3,9510,9510,0,0,0,0,1.0,1,1.0,1,1.0,1,0.6984156175322942,78
3762,0,9510,9510,0,0,0,0,1.0,1,1.0,1,1.0,1,0.6917987142190984,80
3763,2,9512,9512,0,0,0,0,1.0,1,1.0,1,1.0,1,0.6839646715763731,80
3764,2,9514,9514,0,0,0,0,1.0,1,1.0,1,1.0,1,0.684175761499508,80
3765,4,9518,9518,0,0,0,0,1.0,1,1.0,1,1.0,1,0.680690021834298,81
3766,2,9520,9520,0,0,0,0,1.0,1,1.0,1,1.0,1,0.670557256216987,83
3767,3,9523,9523,0,0,0,0,1.0,1,1.0,1,1.0,1,0.6620518124089738,83
3768,1,9524,9524,0,0,0,0,1.0,1,1.0,1,1.0,1,0.6675088763385529,84
3769,4,9528,9528,0,0,0,0,1.0,1,1.0,1,1.0,1,0.6441155661992342,86
3770,3,9531,9531,0,0,0,0,1.0,1,1.0,1,1.0,1,0.646571935349995,87
3771,3,9534,9534,0,0,0,0,1.0,1,1.0,1,1.0,1,0.6486225856933227,87
3772,3,9537,9537,0,0,0,0,1.0,1,1.0,1,1.0,1,0.647649480359048,88
3773,5,9542,9542,0,0,0,0,1.0,1,1.0,1,1.0,1,0.6476985204066014,85
3774,2,9544,9544,0,0,0,0,1.0,1,1.0,1,1.0,1,0.648889836207721,85
3775,3,9547,9547,0,0,0,0,1.0,1,1.0,1,1.0,1,0.6662012068122058,83
3776,2,9549,9549,0,0,0,0,1.0,1,1.0,1,1.0,1,0.6696953246458073,82
3777,3,9552,9552,0,0,0,0,1.0,1,1.0,1,1.0,1,0.6649872984799373,81
3778,3,9555,9555,0,0,0,0,1.0,1,1.0,1,1.0,1,0.6646017420925131,81
3779,4,9559,9559,0,0,0,0,1.0,1,1.0,1,1.0,1,0.6470717056084132,80
3780,3,9562,9562,0,0,0,0,1.0,1,1.0,1,1.0,1,0.6409871335642949,80
3781,6,9568,9568,0,0,0,0,1.0,1,1.0,1,1.0,1,0.6462973567233209,80
3782,3,9571,9571,0,0,0,0,1.0,1,1.0,1,1.0,1,0.6578160043880741,80
3783,4,9575,9575,0,0,0,0,1.0,1,1.0,1,1.0,1,0.64993921029549,80
3784,3,9578,9578,0,0,0,0,1.0,1,1.0,1,1.0,1,0.6681682545899883,79
3785,3,9581,9581,0,0,0,0,1.0,1,1.0,1,1.0,1,0.6898283977019354,77
3786,2,9583,9583,0,0,0,0,1.0,1,1.0,1,1.0,1,0.6775567663947726,78
3787,4,9587,9587,0,0,0,0,1.0,1,1.0,1,1.0,1,0.6762254661843595,77
3788,5,9592,9592,0,0,0,0,1.0,1,1.0,1,1.0,1,0.6677438401260981,78
3789,1,9593,9593,0,0,0,0,1.0,1,1.0,1,1.0,1,0.6757291666452272,77
3790,3,9596,9596,0,0,0,0,1.0,1,1.0,1,1.0,1,0.6783963297033478,77
3791,1,9597,9597,0,0,0,0,1.0,1,1.0,1,1.0,1,0.6842977047317912,77
3792,2,9599,9599,0,0,0,0,1.0,1,1.0,1,1.0,1,0.6674778548405748,78
3793,0,9599,9599,0,0,0,0,1.0,1,1.0,1,1.0,1,0.6611058941891028,80
3794,3,9602,9602,0,0,0,0,1.0,1,1.0,1,1.0,1,0.6447018757907534,82
3795,3,9605,9605,0,0,0,0,1.0,1,1.0,1,1.0,1,0.6359042635916635,83
3796,4,9609,9609,0,0,0,0,1.0,1,1.0,1,1.0,1,0.62962395213864,83
3797,3,9612,9612,0,0,0,0,1.0,1,1.0,1,1.0,1,0.6142538872531987,82
3798,0,9612,9612,0,0,0,0,1.0,1,1.0,1,1.0,1,0.612277836267477,82
3799,2,9614,9614,0,0,0,0,1.0,1,1.0,1,1.0,1,0.6051497099017518,83
3800,5,9619,9619,0,0,0,0,1.0,1,1.0,1,1.0,1,0.6269531965143547,83
3801,4,9623,9623,0,0,0,0,1.0,1,1.0,1,1.0,1,0.6337614280139409,83
3802,0,9623,9623,0,0,0,0,1.0,1,1.0,1,1.0,1,0.6469922100929416,82
3803,4,9627,9627,0,0,0,0,1.0,1,1.0,1,1.0,1,0.6576420995708235,84
3804,2,9629,9629,0,0,0,0,1.0,1,1.0,1,1.0,1,0.6525670255114856,84
3805,2,9631,9631,0,0,0,0,1.0,1,1.0,1,1.0,1,0.6606347422913015,86
3806,1,9632,9632,0,0,0,0,1.0,1,1.0,1,1.0,1,0.6642603220842201,86
3807,4,9636,9636,0,0,0,0,1.0,1,1.0,1,1.0,1,0.6523770156937632,86
3808,3,9639,9639,0,0,0,0,1.0,1,1.0,1,1.0,1,0.6430716443472058,85
3809,2,9641,9641,0,0,0,0,1.0,1,1.0,1,1.0,1,0.6611697419718108,85
3810,0,9641,9641,0,0,0,0,1.0,1,1.0,1,1.0,1,0.6611697419718108,85
3811,2,9643,9643,0,0,0,0,1.0,1,1.0,1,1.0,1,0.6534220976036956,84
3812,0,9643,9643,0,0,0,0,1.0,1,1.0,1,1.0,1,0.6516053791461691,83
3813,4,9647,9647,0,0,0,0,1.0,1,1.0,1,1.0,1,0.6314300076246755,82
3814,0,9647,9647,0,0,0,0,1.0,1,1.0,1,1.0,1,0.6284055183824141,81
3815,2,9649,9649,0,0,0,0,1.0,1,1.0,1,1.0,1,0.6195974093404278,82
3816,2,9651,9651,0,0,0,0,1.0,1,1.0,1,1.0,1,0.6305195736809407,81
3817,2,9653,9653,0,0,0,0,1.0,1,1.0,1,1.0,1,0.631892686945247,81
3818,3,9656,9656,0,0,0,0,1.0,1,1.0,1,1.0,1,0.6386019619410362,81
3819,5,9661,9661,0,0,0,0,1.0,1,1.0,1,1.0,1,0.6206842287145701,82
3820,4,9665,9665,0,0,0,0,1.0,1,1.0,1,1.0,1,0.6422523765421913,84
3821,3,9668,9668,0,0,0,0,1.0,1,1.0,1,1.0,1,0.6296637421117571,84
3822,2,9670,9670,0,0,0,0,1.0,1,1.0,1,1.0,1,0.6326963335225418,82
3823,2,9672,9672,0,0,0,0,1.0,1,1.0,1,1.0,1,0.6309271474680004,81
3824,5,9677,9677,0,0,0,0,1.0,1,1.0,1,1.0,1,0.6399750427270523,78
3825,4,9681,9681,0,0,0,0,1.0,1,1.0,1,1.0,1,0.6453680150422375,76
3826,1,9682,9682,0,0,0,0,1.0,1,1.0,1,1.0,1,0.649365493019676,76
3827,5,9687,9687,0,0,0,0,1.0,1,1.0,1,1.0,1,0.6445330609125304,75
3828,2,9689,9689,0,0,0,0,1.0,1,1.0,1,1.0,1,0.648027022820233,74
3829,6,9695,9695,0,0,0,0,1.0,1,1.0,1,1.0,1,0.6432558106852789,74
3830,7,9702,9702,0,0,0,0,1.0,1,1.0,1,1.0,1,0.6377740335808478,74
3831,4,9706,9706,0,0,0,0,1.0,1,1.0,1,1.0,1,0.6211320958133626,74
3832,7,9713,9713,0,0,0,0,1.0,1,1.0,1,1.0,1,0.6321357050795009,73
3833,8,9721,9721,0,0,0,0,1.0,1,1.0,1,1.0,1,0.644643015217555,73
3834,5,9726,9726,0,0,0,0,1.0,1,1.0,1,1.0,1,0.624202646499424,74
3835,3,9729,9729,0,0,0,0,1.0,1,1.0,1,1.0,1,0.6255026032759552,75
3836,3,9732,9732,0,0,0,0,1.0,1,1.0,1,1.0,1,0.6311374831085965,75
3837,2,9734,9734,0,0,0,0,1.0,1,1.0,1,1.0,1,0.6234289937556731,78
3838,2,9736,9736,0,0,0,0,1.0,1,1.0,1,1.0,1,0.6136043257056241,78
3839,0,9736,9736,0,0,0,0,1.0,1,1.0,1,1.0,1,0.6144156804741246,79
3840,4,9740,9740,0,0,0,0,1.0,1,1.0,1,1.0,1,0.5934326115846348,82
3841,0,9740,9740,0,0,0,0,1.0,1,1.0,1,1.0,1,0.5934326115846348,82
3842,3,9743,9743,0,0,0,0,1.0,1,1.0,1,1.0,1,0.5785409383720247,82
3843,2,9745,9745,0,0,0,0,1.0,1,1.0,1,1.0,1,0.563718039923667,82
3844,1,9746,9746,0,0,0,0,1.0,1,1.0,1,1.0,1,0.5650661426264411,83
3845,1,9747,9747,0,0,0,0,1.0,1,1.0,1,1.0,1,0.5555519068339265,84
3846,3,9750,9750,0,0,0,0,1.0,1,1.0,1,1.0,1,0.5520569539811473,85
3847,1,9751,9751,0,0,0,0,1.0,1,1.0,1,1.0,1,0.556410335750501,84
3848,1,9752,9752,0,0,0,0,1.0,1,1.0,1,1.0,1,0.5493651670238017,84
3849,1,9753,9753,0,0,0,0,1.0,1,1.0,1,1.0,1,0.5535195095830007,83
3850,1,9754,9754,0,0,0,0,1.0,1,1.0,1,1.0,1,0.5550187313570341,80
3851,2,9756,9756,0,0,0,0,1.0,1,1.0,1,1.0,1,0.5505741755931238,80
3852,4,9760,9760,0,0,0,0,1.0,1,1.0,1,1.0,1,0.5518133481221013,79
3853,5,9765,9765,0,0,0,0,1.0,1,1.0,1,1.0,1,0.5490228534575916,79
3854,2,9767,9767,0,0,0,0,1.0,1,1.0,1,1.0,1,0.5609754834731924,78
3855,0,9767,9767,0,0,0,0,1.0,1,1.0,1,1.0,1,0.5609754834731924,78
3856,3,9770,9770,0,0,0,0,1.0,1,1.0,1,1.0,1,0.5561732139356731,80
3857,1,9771,9771,0,0,0,0,1.0,1,1.0,1,1.0,1,0.5538970359122999,81
3858,1,9772,9772,0,0,0,0,1.0,1,1.0,1,1.0,1,0.557336254157057,81
3859,3,9775,9775,0,0,0,0,1.0,1,1.0,1,1.0,1,0.5498375680604307,83
3860,1,9776,9776,0,0,0,0,1.0,1,1.0,1,1.0,1,0.5595370379561397,82
3861,3,9779,9779,0,0,0,0,1.0,1,1.0,1,1.0,1,0.552974390194433,84
3862,5,9784,9784,0,0,0,0,1.0,1,1.0,1,1.0,1,0.5797455222195909,85
3863,3,9787,9787,0,0,0,0,1.0,1,1.0,1,1.0,1,0.5772462683861479,84
3864,6,9793,9793,0,0,0,0,1.0,1,1.0,1,1.0,1,0.5964238289440967,83
3865,1,9794,9794,0,0,0,0,1.0,1,1.0,1,1.0,1,0.5944788310150563,82
3866,2,9796,9796,0,0,0,0,1.0,1,1.0,1,1.0,1,0.6062024956785802,81
3867,5,9801,9801,0,0,0,0,1.0,1,1.0,1,1.0,1,0.5978442339536334,81
3868,2,9803,9803,0,0,0,0,1.0,1,1.0,1,1.0,1,0.6005739297670657,81
3869,3,9806,9806,0,0,0,0,1.0,1,1.0,1,1.0,1,0.6165236823007345,81
3870,3,9809,9809,0,0,0,0,1.0,1,1.0,1,1.0,1,0.6053046313090987,80
3871,1,9810,9810,0,0,0,0,1.0,1,1.0,1,1.0,1,0.6084212238778394,82
3872,3,9813,9813,0,0,0,0,1.0,1,1.0,1,1.0,1,0.6288025685081248,81
3873,2,9815,9815,0,0,0,0,1.0,1,1.0,1,1.0,1,0.6108700821424801,81
3874,1,9816,9816,0,0,0,0,1.0,1,1.0,1,1.0,1,0.6229968855251763,78
3875,2,9818,9818,0,0,0,0,1.0,1,1.0,1,1.0,1,0.6067624687706614,77
3876,0,9818,9818,0,0,0,0,1.0,1,1.0,1,1.0,1,0.6092181158090149,78
3877,3,9821,9821,0,0,0,0,1.0,1,1.0,1,1.0,1,0.605489014927137,75
3878,1,9822,9822,0,0,0,0,1.0,1,1.0,1,1.0,1,0.6025764192229774,75
3879,1,9823,9823,0,0,0,0,1.0,1,1.0,1,1.0,1,0.6069029706979683,73
3880,1,9824,9824,0,0,0,0,1.0,1,1.0,1,1.0,1,0.608425149686985,74
3881,2,9826,9826,0,0,0,0,1.0,1,1.0,1,1.0,1,0.6002291101113666,75
3882,3,9829,9829,0,0,0,0,1.0,1,1.0,1,1.0,1,0.5767174466828796,76
3883,3,9832,9832,0,0,0,0,1.0,1,1.0,1,1.0,1,0.5781691894090608,77
3884,5,9837,9837,0,0,0,0,1.0,1,1.0,1,1.0,1,0.572656924748389,78
3885,5,9842,9842,0,0,0,0,1.0,1,1.0,1,1.0,1,0.5764521725189368,78
3886,8,9850,9850,0,0,0,0,1.0,1,1.0,1,1.0,1,0.5533365585037666,79
3887,5,9855,9855,0,0,0,0,1.0,1,1.0,1,1.0,1,0.5476570445701704,78
3888,8,9863,9863,0,0,0,0,1.0,1,1.0,1,1.0,1,0.5754447486054486,80
3889,5,9868,9868,0,0,0,0,1.0,1,1.0,1,1.0,1,0.545551712618658,82
3890,6,9874,9874,0,0,0,0,1.0,1,1.0,1,1.0,1,0.5402327769375781,82
3891,5,9879,9879,0,0,0,0,1.0,1,1.0,1,1.0,1,0.5125230314867959,85
3892,3,9882,9882,0,0,0,0,1.0,1,1.0,1,1.0,1,0.5069230921478974,87
3893,0,9882,9882,0,0,0,0,1.0,1,1.0,1,1.0,1,0.503859307311263,86
3894,4,9886,9886,0,0,0,0,1.0,1,1.0,1,1.0,1,0.5172810931766564,87
3895,2,9888,9888,0,0,0,0,1.0,1,1.0,1,1.0,1,0.5241470500914827,87
3896,2,9890,9890,0,0,0,0,1.0,1,1.0,1,1.0,1,0.5220860857044226,85
3897,3,9893,9893,0,0,0,0,1.0,1,1.0,1,1.0,1,0.5371522584278752,85
3898,2,9895,9895,0,0,0,0,1.0,1,1.0,1,1.0,1,0.5540514212174215,86
3899,5,9900,9900,0,0,0,0,1.0,1,1.0,1,1.0,1,0.5408187933402995,86
3900,3,9903,9903,0,0,0,0,1.0,1,1.0,1,1.0,1,0.5546376476001549,86
3901,4,9907,9907,0,0,0,0,1.0,1,1.0,1,1.0,1,0.545060440958507,86
3902,3,9910,9910,0,0,0,0,1.0,1,1.0,1,1.0,1,0.5539037802646983,87
3903,4,9914,9914,0,0,0,0,1.0,1,1.0,1,1.0,1,0.532004454910487,87
3904,3,9917,9917,0,0,0,0,1.0,1,1.0,1,1.0,1,0.5404905888192286,85
3905,4,9921,9921,0,0,0,0,1.0,1,1.0,1,1.0,1,0.5395759751600646,84
3906,2,9923,9923,0,0,0,0,1.0,1,1.0,1,1.0,1,0.5452534302570102,86
3907,5,9928,9928,0,0,0,0,1.0,1,1.0,1,1.0,1,0.5391057695660637,84
3908,4,9932,9932,0,0,0,0,1.0,1,1.0,1,1.0,1,0.5424273832654365,83
3909,4,9936,9936,0,0,0,0,1.0,1,1.0,1,1.0,1,0.5607570453562067,81
3910,6,9942,9942,0,0,0,0,1.0,1,1.0,1,1.0,1,0.5812010817069072,82
3911,3,9945,9945,0,0,0,0,1.0,1,1.0,1,1.0,1,0.599304327358651,81
3912,3,9948,9948,0,0,0,0,1.0,1,1.0,1,1.0,1,0.6081239020720722,80
3913,5,9953,9953,0,0,0,0,1.0,1,1.0,1,1.0,1,0.6212473674687705,80
3914,5,9958,9958,0,0,0,0,1.0,1,1.0,1,1.0,1,0.6256600611662206,81
3915,3,9961,9961,0,0,0,0,1.0,1,1.0,1,1.0,1,0.6326596405564817,81
3916,7,9968,9968,0,0,0,0,1.0,1,1.0,1,1.0,1,0.6425212580969438,81
3917,3,9971,9971,0,0,0,0,1.0,1,1.0,1,1.0,1,0.6288131781764806,82
3918,0,9971,9971,0,0,0,0,1.0,1,1.0,1,1.0,1,0.6365346944226244,85
3919,4,9975,9975,0,0,0,0,1.0,1,1.0,1,1.0,1,0.632539728569353,85
3920,2,9977,9977,0,0,0,0,1.0,1,1.0,1,1.0,1,0.6337028502366191,85
3921,1,9978,9978,0,0,0,0,1.0,1,1.0,1,1.0,1,0.6367893966145188,88
3922,2,9980,9980,0,0,0,0,1.0,1,1.0,1,1.0,1,0.640982680438688,88
3923,1,9981,9981,0,0,0,0,1.0,1,1.0,1,1.0,1,0.6409288154763462,89
3924,0,9981,9981,0,0,0,0,1.0,1,1.0,1,1.0,1,0.6412233105070076,90
3925,3,9984,9984,0,0,0,0,1.0,1,1.0,1,1.0,1,0.6488884174690767,88
3926,1,9985,9985,0,0,0,0,1.0,1,1.0,1,1.0,1,0.6412652341349069,89
3927,0,9985,9985,0,0,0,0,1.0,1,1.0,1,1.0,1,0.6436453170075713,89
3928,4,9989,9989,0,0,0,0,1.0,1,1.0,1,1.0,1,0.6459616889206211,88
3929,1,9990,9990,0,0,0,0,1.0,1,1.0,1,1.0,1,0.6480557805749364,88
3930,3,9993,9993,0,0,0,0,1.0,1,1.0,1,1.0,1,0.6449555857561765,87
3931,1,9994,9994,0,0,0,0,1.0,1,1.0,1,1.0,1,0.6472562947370337,86
3932,3,9997,9997,0,0,0,0,1.0,1,1.0,1,1.0,1,0.6281699577251623,85
3933,2,9999,9999,0,0,0,0,1.0,1,1.0,1,1.0,1,0.6182098201367188,84
3934,1,10000,10000,0,0,0,0,1.0,1,1.0,1,1.0,1,0.6028259311238197,85
3935,1,10001,10001,0,0,0,0,1.0,1,1.0,1,1.0,1,0.6090225697310943,84
3936,1,10002,10002,0,0,0,0,1.0,1,1.0,1,1.0,1,0.6019096351105863,84
3937,3,10005,10005,0,0,0,0,1.0,1,1.0,1,1.0,1,0.6026206773291222,82
3938,2,10007,10007,0,0,0,0,1.0,1,1.0,1,1.0,1,0.6083928706158719,82
3939,3,10010,10010,0,0,0,0,1.0,1,1.0,1,1.0,1,0.6184949869535683,84
3940,3,10013,10013,0,0,0,0,1.0,1,1.0,1,1.0,1,0.6005359703957842,84
3941,4,10017,10017,0,0,0,0,1.0,1,1.0,1,1.0,1,0.5925438448678525,85
3942,5,10022,10022,0,0,0,0,1.0,1,1.0,1,1.0,1,0.6024642080457918,85
3943,2,10024,10024,0,0,0,0,1.0,1,1.0,1,1.0,1,0.6076315182061294,84
3944,4,10028,10028,0,0,0,0,1.0,1,1.0,1,1.0,1,0.6175796697300185,83
3945,3,10031,10031,0,0,0,0,1.0,1,1.0,1,1.0,1,0.617256411087186,83
3946,5,10036,10036,0,0,0,0,1.0,1,1.0,1,1.0,1,0.632868361607858,83
3947,1,10037,10037,0,0,0,0,1.0,1,1.0,1,1.0,1,0.6301181515174175,83
3948,6,10043,10043,0,0,0,0,1.0,1,1.0,1,1.0,1,0.6342821748182127,84
3949,3,10046,10046,0,0,0,0,1.0,1,1.0,1,1.0,1,0.6576972240283054,84
3950,2,10048,10048,0,0,0,0,1.0,1,1.0,1,1.0,1,0.6486910292128945,86
3951,2,10050,10050,0,0,0,0,1.0,1,1.0,1,1.0,1,0.6529221803466234,87
3952,3,10053,10053,0,0,0,0,1.0,1,1.0,1,1.0,1,0.648332711113191,86
3953,2,10055,10055,0,0,0,0,1.0,1,1.0,1,1.0,1,0.6480012968337262,86
3954,3,10058,10058,0,0,0,0,1.0,1,1.0,1,1.0,1,0.6410911816192579,85
3955,2,10060,10060,0,0,0,0,1.0,1,1.0,1,1.0,1,0.6408961194794708,85
3956,1,10061,10061,0,0,0,0,1.0,1,1.0,1,1.0,1,0.6506824786229829,84
3957,5,10066,10066,0,0,0,0,1.0,1,1.0,1,1.0,1,0.6341159804887153,85
3958,3,10069,10069,0,0,0,0,1.0,1,1.0,1,1.0,1,0.6192693480457387,84
3959,2,10071,10071,0,0,0,0,1.0,1,1.0,1,1.0,1,0.6141393195654367,83
3960,5,10076,10076,0,0,0,0,1.0,1,1.0,1,1.0,1,0.6017200787905279,84
3961,3,10079,10079,0,0,0,0,1.0,1,1.0,1,1.0,1,0.6042722835475738,83
3962,6,10085,10085,0,0,0,0,1.0,1,1.0,1,1.0,1,0.6112898848565042,84
3963,5,10090,10090,0,0,0,0,1.0,1,1.0,1,1.0,1,0.6086225231948637,81
3964,3,10093,10093,0,0,0,0,1.0,1,1.0,1,1.0,1,0.6256255372866998,81
3965,3,10096,10096,0,0,0,0,1.0,1,1.0,1,1.0,1,0.6188289040843982,81
3966,3,10099,10099,0,0,0,0,1.0,1,1.0,1,1.0,1,0.6212239726085268,79
3967,4,10103,10103,0,0,0,0,1.0,1,1.0,1,1.0,1,0.6035880701364454,81
3968,2,10105,10105,0,0,0,0,1.0,1,1.0,1,1.0,1,0.6031435511490753,79
3969,2,10107,10107,0,0,0,0,1.0,1,1.0,1,1.0,1,0.5919450038264181,79
3970,2,10109,10109,0,0,0,0,1.0,1,1.0,1,1.0,1,0.5922839447553815,78
3971,1,10110,10110,0,0,0,0,1.0,1,1.0,1,1.0,1,0.5922019609118274,77
3972,2,10112,10112,0,0,0,0,1.0,1,1.0,1,1.0,1,0.5948895148893228,78
3973,4,10116,10116,0,0,0,0,1.0,1,1.0,1,1.0,1,0.6023603329482139,77
3974,0,10116,10116,0,0,0,0,1.0,1,1.0,1,1.0,1,0.6023603329482139,77
3975,1,10117,10117,0,0,0,0,1.0,1,1.0,1,1.0,1,0.6153307925608115,76
3976,1,10118,10118,0,0,0,0,1.0,1,1.0,1,1.0,1,0.6191097752102939,77
3977,1,10119,10119,0,0,0,0,1.0,1,1.0,1,1.0,1,0.6250213313711271,78
3978,1,10120,10120,0,0,0,0,1.0,1,1.0,1,1.0,1,0.6258902453028106,79
3979,3,10123,10123,0,0,0,0,1.0,1,1.0,1,1.0,1,0.6067285384803938,79
3980,2,10125,10125,0,0,0,0,1.0,1,1.0,1,1.0,1,0.6068098190860061,79
3981,5,10130,10130,0,0,0,0,1.0,1,1.0,1,1.0,1,0.608502753998413,83
3982,2,10132,10132,0,0,0,0,1.0,1,1.0,1,1.0,1,0.6091479554460674,83
3983,6,10138,10138,0,0,0,0,1.0,1,1.0,1,1.0,1,0.6214386213573083,82
3984,5,10143,10143,0,0,0,0,1.0,1,1.0,1,1.0,1,0.6117830492363237,83
3985,2,10145,10145,0,0,0,0,1.0,1,1.0,1,1.0,1,0.6042892690734142,84
3986,4,10149,10149,0,0,0,0,1.0,1,1.0,1,1.0,1,0.6024633212310812,83
3987,3,10152,10152,0,0,0,0,1.0,1,1.0,1,1.0,1,0.6318173130517245,82
3988,6,10158,10158,0,0,0,0,1.0,1,1.0,1,1.0,1,0.6120586253299404,83
3989,4,10162,10162,0,0,0,0,1.0,1,1.0,1,1.0,1,0.6231705778038911,81
3990,1,10163,10163,0,0,0,0,1.0,1,1.0,1,1.0,1,0.6205217604066695,81
3991,7,10170,10170,0,0,0,0,1.0,1,1.0,1,1.0,1,0.6611872112568147,79
3992,3,10173,10173,0,0,0,0,1.0,1,1.0,1,1.0,1,0.6599004098339141,81
3993,3,10176,10176,0,0,0,0,1.0,1,1.0,1,1.0,1,0.660130276185033,80
3994,0,10176,10176,0,0,0,0,1.0,1,1.0,1,1.0,1,0.660130276185033,80
3995,4,10180,10180,0,0,0,0,1.0,1,1.0,1,1.0,1,0.6327895849379047,81
3996,1,10181,10181,0,0,0,0,1.0,1,1.0,1,1.0,1,0.6446753995139586,80
3997,2,10183,10183,0,0,0,0,1.0,1,1.0,1,1.0,1,0.6443702688570887,81
3998,2,10185,10185,0,0,0,0,1.0,1,1.0,1,1.0,1,0.6399755616963819,82
3999,2,10187,10187,0,0,0,0,1.0,1,1.0,1,1.0,1,0.6457116994556517,82
4000,0,10187,10187,0,0,0,0,1.0,1,1.0,1,1.0,1,0.6457116994556517,82
4001,2,10189,10189,0,0,0,0,1.0,1,1.0,1,1.0,1,0.6345263205619868,81
4002,4,10193,10193,0,0,0,0,1.0,1,1.0,1,1.0,1,0.647317317320822,81
4003,2,10195,10195,0,0,0,0,1.0,1,1.0,1,1.0,1,0.6524650868875709,81
4004,2,10197,10197,0,0,0,0,1.0,1,1.0,1,1.0,1,0.6402343700635819,80
4005,3,10200,10200,0,0,0,0,1.0,1,1.0,1,1.0,1,0.6420454313173947,78
4006,2,10202,10202,0,0,0,0,1.0,1,1.0,1,1.0,1,0.6308846702507744,76
4007,3,10205,10205,0,0,0,0,1.0,1,1.0,1,1.0,1,0.6382417827895469,75
4008,5,10210,10210,0,0,0,0,1.0,1,1.0,1,1.0,1,0.6224028452716293,74
4009,5,10215,10215,0,0,0,0,1.0,1,1.0,1,1.0,1,0.6197609666198238,75
4010,4,10219,10219,0,0,0,0,1.0,1,1.0,1,1.0,1,0.6121463957784427,75
4011,3,10222,10222,0,0,0,0,1.0,1,1.0,1,1.0,1,0.5915889313622075,74
4012,3,10225,10225,0,0,0,0,1.0,1,1.0,1,1.0,1,0.586681523854439,74
4013,4,10229,10229,0,0,0,0,1.0,1,1.0,1,1.0,1,0.5654710234689925,74
4014,3,10232,10232,0,0,0,0,1.0,1,1.0,1,1.0,1,0.573086718650039,73
4015,5,10237,10237,0,0,0,0,1.0,1,1.0,1,1.0,1,0.5796025884332044,74
4016,1,10238,10238,0,0,0,0,1.0,1,1.0,1,1.0,1,0.5808949421395065,74
4017,7,10245,10245,0,0,0,0,1.0,1,1.0,1,1.0,1,0.5494461907871013,78
4018,6,10251,10251,0,0,0,0,1.0,1,1.0,1,1.0,1,0.585805297868782,78
4019,5,10256,10256,0,0,0,0,1.0,1,1.0,1,1.0,1,0.5793258670021937,78
4020,5,10261,10261,0,0,0,0,1.0,1,1.0,1,1.0,1,0.591880770009868,78
4021,4,10265,10265,0,0,0,0,1.0,1,1.0,1,1.0,1,0.5861860115179216,78
4022,5,10270,10270,0,0,0,0,1.0,1,1.0,1,1.0,1,0.5860728804461578,79
4023,4,10274,10274,0,0,0,0,1.0,1,1.0,1,1.0,1,0.5989471691299152,78
4024,4,10278,10278,0,0,0,0,1.0,1,1.0,1,1.0,1,0.6046846616111576,77
4025,2,10280,10280,0,0,0,0,1.0,1,1.0,1,1.0,1,0.6020233136859346,76
4026,5,10285,10285,0,0,0,0,1.0,1,1.0,1,1.0,1,0.6080223502197998,76
4027,3,10288,10288,0,0,0,0,1.0,1,1.0,1,1.0,1,0.6133413971271314,75
4028,2,10290,10290,0,0,0,0,1.0,1,1.0,1,1.0,1,0.5958041456196003,76
4029,5,10295,10295,0,0,0,0,1.0,1,1.0,1,1.0,1,0.6223755200698761,75
4030,1,10296,10296,0,0,0,0,1.0,1,1.0,1,1.0,1,0.6226466137420296,74
4031,1,10297,10297,0,0,0,0,1.0,1,1.0,1,1.0,1,0.6328115724383765,73
4032,3,10300,10300,0,0,0,0,1.0,1,1.0,1,1.0,1,0.6408577402681026,71
4033,1,10301,10301,0,0,0,0,1.0,1,1.0,1,1.0,1,0.6239632230648403,73
4034,5,10306,10306,0,0,0,0,1.0,1,1.0,1,1.0,1,0.6051697685924962,72
4035,0,10306,10306,0,0,0,0,1.0,1,1.0,1,1.0,1,0.6155699158790696,71
4036,5,10311,10311,0,0,0,0,1.0,1,1.0,1,1.0,1,0.605989580505326,71
4037,1,10312,10312,0,0,0,0,1.0,1,1.0,1,1.0,1,0.6038028094461051,70
4038,4,10316,10316,0,0,0,0,1.0,1,1.0,1,1.0,1,0.595394902785393,69
4039,1,10317,10317,0,0,0,0,1.0,1,1.0,1,1.0,1,0.6045002847650282,68
4040,3,10320,10320,0,0,0,0,1.0,1,1.0,1,1.0,1,0.5885108073143087,69
4041,1,10321,10321,0,0,0,0,1.0,1,1.0,1,1.0,1,0.6029586280336406,67
4042,2,10323,10323,0,0,0,0,1.0,1,1.0,1,1.0,1,0.5885402772433115,67
4043,1,10324,10324,0,0,0,0,1.0,1,1.0,1,1.0,1,0.5897497315361171,66
4044,2,10326,10326,0,0,0,0,1.0,1,1.0,1,1.0,1,0.5878924154369771,65
4045,2,10328,10328,0,0,0,0,1.0,1,1.0,1,1.0,1,0.5951295750962821,66
4046,4,10332,10332,0,0,0,0,1.0,1,1.0,1,1.0,1,0.5825044708849645,68
4047,2,10334,10334,0,0,0,0,1.0,1,1.0,1,1.0,1,0.5813847147303177,68
4048,1,10335,10335,0,0,0,0,1.0,1,1.0,1,1.0,1,0.5891551596827733,69
4049,3,10338,10338,0,0,0,0,1.0,1,1.0,1,1.0,1,0.6122570112548402,69
4050,1,10339,10339,0,0,0,0,1.0,1,1.0,1,1.0,1,0.6112905662068254,69
4051,0,10339,10339,0,0,0,0,1.0,1,1.0,1,1.0,1,0.6112905662068254,69
4052,2,10341,10341,0,0,0,0,1.0,1,1.0,1,1.0,1,0.6010900663969557,69
4053,3,10344,10344,0,0,0,0,1.0,1,1.0,1,1.0,1,0.5815171385769211,69
4054,1,10345,10345,0,0,0,0,1.0,1,1.0,1,1.0,1,0.5737933890423988,70
4055,3,10348,10348,0,0,0,0,1.0,1,1.0,1,1.0,1,0.5567920964839662,70
4056,1,10349,10349,0,0,0,0,1.0,1,1.0,1,1.0,1,0.5450194666922785,70
4057,2,10351,10351,0,0,0,0,1.0,1,1.0,1,1.0,1,0.5367142983648499,71
4058,1,10352,10352,0,0,0,0,1.0,1,1.0,1,1.0,1,0.5407205459673492,71
4059,4,10356,10356,0,0,0,0,1.0,1,1.0,1,1.0,1,0.5277303506634734,72
4060,2,10358,10358,0,0,0,0,1.0,1,1.0,1,1.0,1,0.5528590263965142,71
4061,2,10360,10360,0,0,0,0,1.0,1,1.0,1,1.0,1,0.5573440610813137,72
4062,3,10363,10363,0,0,0,0,1.0,1,1.0,1,1.0,1,0.5757999495843513,72
4063,1,10364,10364,0,0,0,0,1.0,1,1.0,1,1.0,1,0.5891903924424857,72
4064,7,10371,10371,0,0,0,0,1.0,1,1.0,1,1.0,1,0.5803158367031073,71
4065,1,10372,10372,0,0,0,0,1.0,1,1.0,1,1.0,1,0.5885540887415165,70
4066,6,10378,10378,0,0,0,0,1.0,1,1.0,1,1.0,1,0.5707295560108195,70
4067,2,10380,10380,0,0,0,0,1.0,1,1.0,1,1.0,1,0.5781028522211221,68
4068,6,10386,10386,0,0,0,0,1.0,1,1.0,1,1.0,1,0.5777333902222258,70
4069,4,10390,10390,0,0,0,0,1.0,1,1.0,1,1.0,1,0.5929540086617158,68
4070,8,10398,10398,0,0,0,0,1.0,1,1.0,1,1.0,1,0.6053907874353169,67
4071,8,10406,10406,0,0,0,0,1.0,1,1.0,1,1.0,1,0.6055170132975705,68
4072,7,10413,10413,0,0,0,0,1.0,1,1.0,1,1.0,1,0.6126230547509597,70
4073,8,10421,10421,0,0,0,0,1.0,1,1.0,1,1.0,1,0.6206543298336873,70
4074,11,10432,10432,0,0,0,0,1.0,1,1.0,1,1.0,1,0.6020081002097945,71
4075,8,10440,10440,0,0,0,0,1.0,1,1.0,1,1.0,1,0.591755171145798,72
4076,5,10445,10445,0,0,0,0,1.0,1,1.0,1,1.0,1,0.5782564459066105,73
4077,2,10447,10447,0,0,0,0,1.0,1,1.0,1,1.0,1,0.577382287824269,72
4078,4,10451,10451,0,0,0,0,1.0,1,1.0,1,1.0,1,0.5705571206217956,71
4079,0,10451,10451,0,0,0,0,1.0,1,1.0,1,1.0,1,0.5796686397888796,69
4080,3,10454,10454,0,0,0,0,1.0,1,1.0,1,1.0,1,0.6001431518122647,67
4081,2,10456,10456,0,0,0,0,1.0,1,1.0,1,1.0,1,0.5982223186305776,66
4082,2,10458,10458,0,0,0,0,1.0,1,1.0,1,1.0,1,0.6145528496181322,65
4083,3,10461,10461,0,0,0,0,1.0,1,1.0,1,1.0,1,0.5981767820284212,64
4084,1,10462,10462,0,0,0,0,1.0,1,1.0,1,1.0,1,0.5881469628876198,64
4085,5,10467,10467,0,0,0,0,1.0,1,1.0,1,1.0,1,0.5713668626436149,65
4086,0,10467,10467,0,0,0,0,1.0,1,1.0,1,1.0,1,0.5658195630884436,66
4087,3,10470,10470,0,0,0,0,1.0,1,1.0,1,1.0,1,0.5546192727940032,66
4088,1,10471,10471,0,0,0,0,1.0,1,1.0,1,1.0,1,0.56836582543387,65
4089,0,10471,10471,0,0,0,0,1.0,1,1.0,1,1.0,1,0.56836582543387,65
4090,0,10471,10471,0,0,0,0,1.0,1,1.0,1,1.0,1,0.5708534785408609,65
4091,2,10473,10473,0,0,0,0,1.0,1,1.0,1,1.0,1,0.5799313121631148,65
4092,1,10474,10474,0,0,0,0,1.0,1,1.0,1,1.0,1,0.5958249680637401,64
4093,2,10476,10476,0,0,0,0,1.0,1,1.0,1,1.0,1,0.6015436490265258,66
4094,5,10481,10481,0,0,0,0,1.0,1,1.0,1,1.0,1,0.6287991674377941,65
4095,3,10484,10484,0,0,0,0,1.0,1,1.0,1,1.0,1,0.634740805218942,65
4096,5,10489,10489,0,0,0,0,1.0,1,1.0,1,1.0,1,0.6458850184590483,67
4097,5,10494,10494,0,0,0,0,1.0,1,1.0,1,1.0,1,0.6234405487437183,67
4098,3,10497,10497,0,0,0,0,1.0,1,1.0,1,1.0,1,0.6390447989507604,68
4099,4,10501,10501,0,0,0,0,1.0,1,1.0,1,1.0,1,0.6337369685456777,69
4100,4,10505,10505,0,0,0,0,1.0,1,1.0,1,1.0,1,0.6186265175584875,70
4101,3,10508,10508,0,0,0,0,1.0,1,1.0,1,1.0,1,0.6255463633267699,71
4102,5,10513,10513,0,0,0,0,1.0,1,1.0,1,1.0,1,0.622541958164985,71
4103,2,10515,10515,0,0,0,0,1.0,1,1.0,1,1.0,1,0.625687373177563,71
4104,1,10516,10516,0,0,0,0,1.0,1,1.0,1,1.0,1,0.6337122322823376,69
4105,3,10519,10519,0,0,0,0,1.0,1,1.0,1,1.0,1,0.6624784892560075,67
4106,2,10521,10521,0,0,0,0,1.0,1,1.0,1,1.0,1,0.6601088912734447,68
4107,0,10521,10521,0,0,0,0,1.0,1,1.0,1,1.0,1,0.657318030659943,70
4108,3,10524,10524,0,0,0,0,1.0,1,1.0,1,1.0,1,0.6297696318338786,70
4109,1,10525,10525,0,0,0,0,1.0,1,1.0,1,1.0,1,0.6398006242177302,69
4110,1,10526,10526,0,0,0,0,1.0,1,1.0,1,1.0,1,0.6203730987781138,71
4111,4,10530,10530,0,0,0,0,1.0,1,1.0,1,1.0,1,0.6356348603470804,70
4112,1,10531,10531,0,0,0,0,1.0,1,1.0,1,1.0,1,0.625479736891383,72
4113,3,10534,10534,0,0,0,0,1.0,1,1.0,1,1.0,1,0.6153902019891678,72
4114,2,10536,10536,0,0,0,0,1.0,1,1.0,1,1.0,1,0.5991209874945125,72
4115,1,10537,10537,0,0,0,0,1.0,1,1.0,1,1.0,1,0.6134548540384356,70
4116,4,10541,10541,0,0,0,0,1.0,1,1.0,1,1.0,1,0.602762951524506,67
4117,0,10541,10541,0,0,0,0,1.0,1,1.0,1,1.0,1,0.6097893375450196,67
4118,5,10546,10546,0,0,0,0,1.0,1,1.0,1,1.0,1,0.6140608979194505,66
4119,2,10548,10548,0,0,0,0,1.0,1,1.0,1,1.0,1,0.605722064417202,67
4120,8,10556,10556,0,0,0,0,1.0,1,1.0,1,1.0,1,0.6421098794667112,64
4121,2,10558,10558,0,0,0,0,1.0,1,1.0,1,1.0,1,0.6460002098672539,63
4122,3,10561,10561,0,0,0,0,1.0,1,1.0,1,1.0,1,0.6290175503596493,63
4123,4,10565,10565,0,0,0,0,1.0,1,1.0,1,1.0,1,0.6455951457160594,61
4124,3,10568,10568,0,0,0,0,1.0,1,1.0,1,1.0,1,0.6380333804492794,62
4125,2,10570,10570,0,0,0,0,1.0,1,1.0,1,1.0,1,0.6627634320848261,60
4126,4,10574,10574,0,0,0,0,1.0,1,1.0,1,1.0,1,0.6649856230166066,59
4127,3,10577,10577,0,0,0,0,1.0,1,1.0,1,1.0,1,0.65222878754176,60
4128,2,10579,10579,0,0,0,0,1.0,1,1.0,1,1.0,1,0.652430392689542,60
4129,5,10584,10584,0,0,0,0,1.0,1,1.0,1,1.0,1,0.6657329454506024,60
4130,2,10586,10586,0,0,0,0,1.0,1,1.0,1,1.0,1,0.6627440354517062,61
4131,3,10589,10589,0,0,0,0,1.0,1,1.0,1,1.0,1,0.6864955079198911,60
4132,3,10592,10592,0,0,0,0,1.0,1,1.0,1,1.0,1,0.6796188110487098,60
4133,1,10593,10593,0,0,0,0,1.0,1,1.0,1,1.0,1,0.6674517625845955,62
4134,3,10596,10596,0,0,0,0,1.0,1,1.0,1,1.0,1,0.6510561101821464,63
4135,1,10597,10597,0,0,0,0,1.0,1,1.0,1,1.0,1,0.6195004253842832,65
4136,1,10598,10598,0,0,0,0,1.0,1,1.0,1,1.0,1,0.6158335185604682,65
4137,2,10600,10600,0,0,0,0,1.0,1,1.0,1,1.0,1,0.6129005617443741,66
4138,1,10601,10601,0,0,0,0,1.0,1,1.0,1,1.0,1,0.5992337519684129,67
4139,6,10607,10607,0,0,0,0,1.0,1,1.0,1,1.0,1,0.5789457955146576,67
4140,1,10608,10608,0,0,0,0,1.0,1,1.0,1,1.0,1,0.5742337259798288,66
4141,2,10610,10610,0,0,0,0,1.0,1,1.0,1,1.0,1,0.5666095517488233,67
4142,4,10614,10614,0,0,0,0,1.0,1,1.0,1,1.0,1,0.5756448176625752,67
4143,5,10619,10619,0,0,0,0,1.0,1,1.0,1,1.0,1,0.568302864570649,66
4144,5,10624,10624,0,0,0,0,1.0,1,1.0,1,1.0,1,0.5934504018706999,64
4145,4,10628,10628,0,0,0,0,1.0,1,1.0,1,1.0,1,0.599464209789492,63
4146,8,10636,10636,0,0,0,0,1.0,1,1.0,1,1.0,1,0.6207946627963865,62
4147,6,10642,10642,0,0,0,0,1.0,1,1.0,1,1.0,1,0.6441482739792904,60
4148,2,10644,10644,0,0,0,0,1.0,1,1.0,1,1.0,1,0.639211269817528,62
4149,4,10648,10648,0,0,0,0,1.0,1,1.0,1,1.0,1,0.6459171501216572,61
4150,0,10648,10648,0,0,0,0,1.0,1,1.0,1,1.0,1,0.6539528799284765,60
4151,1,10649,10649,0,0,0,0,1.0,1,1.0,1,1.0,1,0.6500076908627657,60
4152,1,10650,10650,0,0,0,0,1.0,1,1.0,1,1.0,1,0.6584213993481379,60
4153,0,10650,10650,0,0,0,0,1.0,1,1.0,1,1.0,1,0.6654440168248965,58
4154,3,10653,10653,0,0,0,0,1.0,1,1.0,1,1.0,1,0.671328058558804,57
4155,2,10655,10655,0,0,0,0,1.0,1,1.0,1,1.0,1,0.681968861631665,57
4156,1,10656,10656,0,0,0,0,1.0,1,1.0,1,1.0,1,0.6803182988262052,58
4157,3,10659,10659,0,0,0,0,1.0,1,1.0,1,1.0,1,0.6744997565928011,57
4158,3,10662,10662,0,0,0,0,1.0,1,1.0,1,1.0,1,0.6857733078523075,55
4159,3,10665,10665,0,0,0,0,1.0,1,1.0,1,1.0,1,0.6970241637144785,57
4160,2,10667,10667,0,0,0,0,1.0,1,1.0,1,1.0,1,0.6925461436483539,58
4161,2,10669,10669,0,0,0,0,1.0,1,1.0,1,1.0,1,0.6924929500542044,58
4162,2,10671,10671,0,0,0,0,1.0,1,1.0,1,1.0,1,0.6860784956878592,57
4163,2,10673,10673,0,0,0,0,1.0,1,1.0,1,1.0,1,0.6638511323133869,58
4164,1,10674,10674,0,0,0,0,1.0,1,1.0,1,1.0,1,0.6731758136011066,56
4165,2,10676,10676,0,0,0,0,1.0,1,1.0,1,1.0,1,0.6454071530688634,58
4166,4,10680,10680,0,0,0,0,1.0,1,1.0,1,1.0,1,0.6203500144067579,57
4167,1,10681,10681,0,0,0,0,1.0,1,1.0,1,1.0,1,0.6113981759552479,57
4168,5,10686,10686,0,0,0,0,1.0,1,1.0,1,1.0,1,0.5595193011418366,58
4169,0,10686,10686,0,0,0,0,1.0,1,1.0,1,1.0,1,0.5595193011418366,58
4170,1,10687,10687,0,0,0,0,1.0,1,1.0,1,1.0,1,0.5675477528927901,58
4171,1,10688,10688,0,0,0,0,1.0,1,1.0,1,1.0,1,0.5791341445034143,57
4172,5,10693,10693,0,0,0,0,1.0,1,1.0,1,1.0,1,0.5543655578583206,57
4173,4,10697,10697,0,0,0,0,1.0,1,1.0,1,1.0,1,0.5804328472014296,56
4174,5,10702,10702,0,0,0,0,1.0,1,1.0,1,1.0,1,0.6163455857737292,56
4175,1,10703,10703,0,0,0,0,1.0,1,1.0,1,1.0,1,0.6279673724495989,55
4176,3,10706,10706,0,0,0,0,1.0,1,1.0,1,1.0,1,0.6321059404254481,57
4177,3,10709,10709,0,0,0,0,1.0,1,1.0,1,1.0,1,0.6141249279183184,58
4178,3,10712,10712,0,0,0,0,1.0,1,1.0,1,1.0,1,0.6139802072180598,60
4179,2,10714,10714,0,0,0,0,1.0,1,1.0,1,1.0,1,0.5837345459173869,61
4180,2,10716,10716,0,0,0,0,1.0,1,1.0,1,1.0,1,0.5567692656805123,62
4181,2,10718,10718,0,0,0,0,1.0,1,1.0,1,1.0,1,0.5734547347227896,63
4182,2,10720,10720,0,0,0,0,1.0,1,1.0,1,1.0,1,0.5875442712989756,63
4183,2,10722,10722,0,0,0,0,1.0,1,1.0,1,1.0,1,0.5900642121878985,63
4184,1,10723,10723,0,0,0,0,1.0,1,1.0,1,1.0,1,0.5978465572760416,63
4185,4,10727,10727,0,0,0,0,1.0,1,1.0,1,1.0,1,0.6092649625749732,61
4186,3,10730,10730,0,0,0,0,1.0,1,1.0,1,1.0,1,0.6143154628158163,62
4187,6,10736,10736,0,0,0,0,1.0,1,1.0,1,1.0,1,0.5884522650790218,60
4188,3,10739,10739,0,0,0,0,1.0,1,1.0,1,1.0,1,0.5955453106749714,60
4189,2,10741,10741,0,0,0,0,1.0,1,1.0,1,1.0,1,0.5844704896120634,60
4190,5,10746,10746,0,0,0,0,1.0,1,1.0,1,1.0,1,0.6038751629149794,61
4191,1,10747,10747,0,0,0,0,1.0,1,1.0,1,1.0,1,0.589428721788953,59
4192,6,10753,10753,0,0,0,0,1.0,1,1.0,1,1.0,1,0.5949739758369944,58
4193,0,10753,10753,0,0,0,0,1.0,1,1.0,1,1.0,1,0.5969591966853681,57
4194,2,10755,10755,0,0,0,0,1.0,1,1.0,1,1.0,1,0.6163083185161836,54
4195,5,10760,10760,0,0,0,0,1.0,1,1.0,1,1.0,1,0.6137371042110452,55
4196,1,10761,10761,0,0,0,0,1.0,1,1.0,1,1.0,1,0.5930932697259547,56
4197,4,10765,10765,0,0,0,0,1.0,1,1.0,1,1.0,1,0.6043265871471732,55
4198,1,10766,10766,0,0,0,0,1.0,1,1.0,1,1.0,1,0.5849934239310565,56
4199,2,10768,10768,0,0,0,0,1.0,1,1.0,1,1.0,1,0.5624620842540667,55
4200,0,10768,10768,0,0,0,0,1.0,1,1.0,1,1.0,1,0.562546285413075,55
4201,1,10769,10769,0,0,0,0,1.0,1,1.0,1,1.0,1,0.5707192855429154,56
4202,3,10772,10772,0,0,0,0,1.0,1,1.0,1,1.0,1,0.5638369103788594,56
4203,3,10775,10775,0,0,0,0,1.0,1,1.0,1,1.0,1,0.5871232844284047,57
4204,2,10777,10777,0,0,0,0,1.0,1,1.0,1,1.0,1,0.621858017616101,57
4205,1,10778,10778,0,0,0,0,1.0,1,1.0,1,1.0,1,0.5985356719514962,58
4206,3,10781,10781,0,0,0,0,1.0,1,1.0,1,1.0,1,0.6453330200816233,58
4207,2,10783,10783,0,0,0,0,1.0,1,1.0,1,1.0,1,0.6279164288658652,58
4208,0,10783,10783,0,0,0,0,1.0,1,1.0,1,1.0,1,0.6199864715306249,60
4209,4,10787,10787,0,0,0,0,1.0,1,1.0,1,1.0,1,0.6345215937233036,61
4210,2,10789,10789,0,0,0,0,1.0,1,1.0,1,1.0,1,0.6021848032528483,62
4211,0,10789,10789,0,0,0,0,1.0,1,1.0,1,1.0,1,0.5991545890909582,63
4212,1,10790,10790,0,0,0,0,1.0,1,1.0,1,1.0,1,0.5873491438876741,64
4213,0,10790,10790,0,0,0,0,1.0,1,1.0,1,1.0,1,0.5719006021748103,65
4214,0,10790,10790,0,0,0,0,1.0,1,1.0,1,1.0,1,0.5636736168566249,65
4215,0,10790,10790,0,0,0,0,1.0,1,1.0,1,1.0,1,0.5636736168566249,65
4216,0,10790,10790,0,0,0,0,1.0,1,1.0,1,1.0,1,0.5703594726997965,64
4217,4,10794,10794,0,0,0,0,1.0,1,1.0,1,1.0,1,0.5940888520630268,65
4218,3,10797,10797,0,0,0,0,1.0,1,1.0,1,1.0,1,0.6010994661414928,65
4219,5,10802,10802,0,0,0,0,1.0,1,1.0,1,1.0,1,0.6242708960679657,65
4220,4,10806,10806,0,0,0,0,1.0,1,1.0,1,1.0,1,0.6335001133598969,65
4221,5,10811,10811,0,0,0,0,1.0,1,1.0,1,1.0,1,0.6523973363525777,67
4222,2,10813,10813,0,0,0,0,1.0,1,1.0,1,1.0,1,0.6495425947972739,68
4223,2,10815,10815,0,0,0,0,1.0,1,1.0,1,1.0,1,0.6551239668342225,68
4224,1,10816,10816,0,0,0,0,1.0,1,1.0,1,1.0,1,0.6612733596180239,68
4225,0,10816,10816,0,0,0,0,1.0,1,1.0,1,1.0,1,0.66448035535518,66
4226,0,10816,10816,0,0,0,0,1.0,1,1.0,1,1.0,1,0.6641672972504146,66
4227,0,10816,10816,0,0,0,0,1.0,1,1.0,1,1.0,1,0.6641672972504146,66
4228,0,10816,10816,0,0,0,0,1.0,1,1.0,1,1.0,1,0.6685918210210661,65
4229,1,10817,10817,0,0,0,0,1.0,1,1.0,1,1.0,1,0.6610239093830901,65
4230,2,10819,10819,0,0,0,0,1.0,1,1.0,1,1.0,1,0.6784239190958924,64
4231,0,10819,10819,0,0,0,0,1.0,1,1.0,1,1.0,1,0.6769978276561281,64
4232,2,10821,10821,0,0,0,0,1.0,1,1.0,1,1.0,1,0.6871118828746131,65
4233,0,10821,10821,0,0,0,0,1.0,1,1.0,1,1.0,1,0.6913079063171266,64
4234,1,10822,10822,0,0,0,0,1.0,1,1.0,1,1.0,1,0.7021835725180697,63
4235,4,10826,10826,0,0,0,0,1.0,1,1.0,1,1.0,1,0.7223574548489954,63
4236,3,10829,10829,0,0,0,0,1.0,1,1.0,1,1.0,1,0.7110020114115452,63
4237,2,10831,10831,0,0,0,0,1.0,1,1.0,1,1.0,1,0.7082849169930706,65
4238,3,10834,10834,0,0,0,0,1.0,1,1.0,1,1.0,1,0.7016248674982466,65
4239,0,10834,10834,0,0,0,0,1.0,1,1.0,1,1.0,1,0.7016248674982466,65
4240,1,10835,10835,0,0,0,0,1.0,1,1.0,1,1.0,1,0.680226638112714,66
4241,1,10836,10836,0,0,0,0,1.0,1,1.0,1,1.0,1,0.6773237196412364,66
4242,0,10836,10836,0,0,0,0,1.0,1,1.0,1,1.0,1,0.652389371400521,69
4243,0,10836,10836,0,0,0,0,1.0,1,1.0,1,1.0,1,0.6536379196770057,71
4244,0,10836,10836,0,0,0,0,1.0,1,1.0,1,1.0,1,0.6536379196770057,71
4245,0,10836,10836,0,0,0,0,1.0,1,1.0,1,1.0,1,0.6477034871343812,73
4246,0,10836,10836,0,0,0,0,1.0,1,1.0,1,1.0,1,0.6405130645365568,74
4247,3,10839,10839,0,0,0,0,1.0,1,1.0,1,1.0,1,0.6535529443026343,74
4248,1,10840,10840,0,0,0,0,1.0,1,1.0,1,1.0,1,0.6496654831325431,74
4249,2,10842,10842,0,0,0,0,1.0,1,1.0,1,1.0,1,0.6506927610741008,74
4250,4,10846,10846,0,0,0,0,1.0,1,1.0,1,1.0,1,0.6436680826788597,74
4251,4,10850,10850,0,0,0,0,1.0,1,1.0,1,1.0,1,0.6424053954039742,75
4252,4,10854,10854,0,0,0,0,1.0,1,1.0,1,1.0,1,0.6306791475677435,75
4253,4,10858,10858,0,0,0,0,1.0,1,1.0,1,1.0,1,0.6175110907232229,76
4254,6,10864,10864,0,0,0,0,1.0,1,1.0,1,1.0,1,0.6203409512529404,75
4255,1,10865,10865,0,0,0,0,1.0,1,1.0,1,1.0,1,0.6099066581138914,76
4256,2,10867,10867,0,0,0,0,1.0,1,1.0,1,1.0,1,0.5862575950525772,78
4257,6,10873,10873,0,0,0,0,1.0,1,1.0,1,1.0,1,0.5904480167166375,78
4258,4,10877,10877,0,0,0,0,1.0,1,1.0,1,1.0,1,0.5966640483169271,77
4259,5,10882,10882,0,0,0,0,1.0,1,1.0,1,1.0,1,0.6022951437126214,78
4260,1,10883,10883,0,0,0,0,1.0,1,1.0,1,1.0,1,0.6045427024443816,77
4261,4,10887,10887,0,0,0,0,1.0,1,1.0,1,1.0,1,0.6200297700304648,76
4262,3,10890,10890,0,0,0,0,1.0,1,1.0,1,1.0,1,0.6168323132137046,75
4263,5,10895,10895,0,0,0,0,1.0,1,1.0,1,1.0,1,0.6165214701603671,74
4264,2,10897,10897,0,0,0,0,1.0,1,1.0,1,1.0,1,0.6342014892229147,74
4265,2,10899,10899,0,0,0,0,1.0,1,1.0,1,1.0,1,0.6383466477019054,73
4266,3,10902,10902,0,0,0,0,1.0,1,1.0,1,1.0,1,0.6603677360623769,71
4267,1,10903,10903,0,0,0,0,1.0,1,1.0,1,1.0,1,0.64988037292945,69
4268,4,10907,10907,0,0,0,0,1.0,1,1.0,1,1.0,1,0.6562302896058195,67
4269,2,10909,10909,0,0,0,0,1.0,1,1.0,1,1.0,1,0.6736146370217636,64
4270,3,10912,10912,0,0,0,0,1.0,1,1.0,1,1.0,1,0.6548403423328408,63
4271,2,10914,10914,0,0,0,0,1.0,1,1.0,1,1.0,1,0.6595121070550909,63
4272,1,10915,10915,0,0,0,0,1.0,1,1.0,1,1.0,1,0.6618169304134967,62
4273,0,10915,10915,0,0,0,0,1.0,1,1.0,1,1.0,1,0.6618169304134967,62
4274,2,10917,10917,0,0,0,0,1.0,1,1.0,1,1.0,1,0.6515166398425462,62
4275,0,10917,10917,0,0,0,0,1.0,1,1.0,1,1.0,1,0.6555525467540048,61
4276,2,10919,10919,0,0,0,0,1.0,1,1.0,1,1.0,1,0.6427219943862466,62
4277,2,10921,10921,0,0,0,0,1.0,1,1.0,1,1.0,1,0.6407218331169665,63
4278,1,10922,10922,0,0,0,0,1.0,1,1.0,1,1.0,1,0.6415196438099298,64
4279,6,10928,10928,0,0,0,0,1.0,1,1.0,1,1.0,1,0.6329417101640882,65
4280,2,10930,10930,0,0,0,0,1.0,1,1.0,1,1.0,1,0.6153291773586693,65
4281,5,10935,10935,0,0,0,0,1.0,1,1.0,1,1.0,1,0.6091486346665145,65
4282,2,10937,10937,0,0,0,0,1.0,1,1.0,1,1.0,1,0.6124112492693824,66
4283,4,10941,10941,0,0,0,0,1.0,1,1.0,1,1.0,1,0.6177845188104977,66
4284,4,10945,10945,0,0,0,0,1.0,1,1.0,1,1.0,1,0.6390592964762346,66
4285,2,10947,10947,0,0,0,0,1.0,1,1.0,1,1.0,1,0.6486124016981181,67
4286,2,10949,10949,0,0,0,0,1.0,1,1.0,1,1.0,1,0.6643527596287739,67
4287,0,10949,10949,0,0,0,0,1.0,1,1.0,1,1.0,1,0.6643527596287739,67
4288,2,10951,10951,0,0,0,0,1.0,1,1.0,1,1.0,1,0.6498578182074529,68
4289,1,10952,10952,0,0,0,0,1.0,1,1.0,1,1.0,1,0.6409835216523255,68
4290,2,10954,10954,0,0,0,0,1.0,1,1.0,1,1.0,1,0.6294117148597457,70
4291,1,10955,10955,0,0,0,0,1.0,1,1.0,1,1.0,1,0.6288399201554851,71
4292,2,10957,10957,0,0,0,0,1.0,1,1.0,1,1.0,1,0.6222738220082986,71
4293,2,10959,10959,0,0,0,0,1.0,1,1.0,1,1.0,1,0.6207578508324815,71
4294,4,10963,10963,0,0,0,0,1.0,1,1.0,1,1.0,1,0.6252297776494503,71
4295,2,10965,10965,0,0,0,0,1.0,1,1.0,1,1.0,1,0.6302941038626682,72
4296,5,10970,10970,0,0,0,0,1.0,1,1.0,1,1.0,1,0.6451761262958486,73
4297,4,10974,10974,0,0,0,0,1.0,1,1.0,1,1.0,1,0.6608855652948797,73
4298,3,10977,10977,0,0,0,0,1.0,1,1.0,1,1.0,1,0.66239675108646,74
4299,1,10978,10978,0,0,0,0,1.0,1,1.0,1,1.0,1,0.6522892555910353,75
4300,3,10981,10981,0,0,0,0,1.0,1,1.0,1,1.0,1,0.6688302046251902,75
4301,1,10982,10982,0,0,0,0,1.0,1,1.0,1,1.0,1,0.6670518611571298,76
4302,1,10983,10983,0,0,0,0,1.0,1,1.0,1,1.0,1,0.6625393552951281,76
4303,1,10984,10984,0,0,0,0,1.0,1,1.0,1,1.0,1,0.6652562372064285,75
4304,2,10986,10986,0,0,0,0,1.0,1,1.0,1,1.0,1,0.6516835388068858,75
4305,3,10989,10989,0,0,0,0,1.0,1,1.0,1,1.0,1,0.6383026093148295,73
4306,2,10991,10991,0,0,0,0,1.0,1,1.0,1,1.0,1,0.6249191423872145,74
4307,5,10996,10996,0,0,0,0,1.0,1,1.0,1,1.0,1,0.5916491534458681,73
4308,3,10999,10999,0,0,0,0,1.0,1,1.0,1,1.0,1,0.5745267076039673,71
4309,7,11006,11006,0,0,0,0,1.0,1,1.0,1,1.0,1,0.5757345825294913,70
4310,0,11006,11006,0,0,0,0,1.0,1,1.0,1,1.0,1,0.574728042818287,69
4311,6,11012,11012,0,0,0,0,1.0,1,1.0,1,1.0,1,0.5934939552522028,69
4312,3,11015,11015,0,0,0,0,1.0,1,1.0,1,1.0,1,0.5954034156400638,66
4313,9,11024,11024,0,0,0,0,1.0,1,1.0,1,1.0,1,0.6083268099996025,64
4314,3,11027,11027,0,0,0,0,1.0,1,1.0,1,1.0,1,0.6205310606073541,61
4315,2,11029,11029,0,0,0,0,1.0,1,1.0,1,1.0,1,0.6174833170745986,61
4316,3,11032,11032,0,0,0,0,1.0,1,1.0,1,1.0,1,0.6253975573173992,60
4317,3,11035,11035,0,0,0,0,1.0,1,1.0,1,1.0,1,0.6120270139863692,62
4318,6,11041,11041,0,0,0,0,1.0,1,1.0,1,1.0,1,0.6009288378019406,59
4319,2,11043,11043,0,0,0,0,1.0,1,1.0,1,1.0,1,0.6065881320554808,60
4320,7,11050,11050,0,0,0,0,1.0,1,1.0,1,1.0,1,0.6077764150562258,60
4321,6,11056,11056,0,0,0,0,1.0,1,1.0,1,1.0,1,0.6024414000204209,61
4322,2,11058,11058,0,0,0,0,1.0,1,1.0,1,1.0,1,0.6041512985093437,61
4323,6,11064,11064,0,0,0,0,1.0,1,1.0,1,1.0,1,0.616400249417088,61
4324,1,11065,11065,0,0,0,0,1.0,1,1.0,1,1.0,1,0.6197336093142108,60
4325,2,11067,11067,0,0,0,0,1.0,1,1.0,1,1.0,1,0.6209893988383923,60
4326,1,11068,11068,0,0,0,0,1.0,1,1.0,1,1.0,1,0.6145701118689346,61
4327,0,11068,11068,0,0,0,0,1.0,1,1.0,1,1.0,1,0.6113358185167054,62
4328,6,11074,11074,0,0,0,0,1.0,1,1.0,1,1.0,1,0.6163263606355592,62
4329,2,11076,11076,0,0,0,0,1.0,1,1.0,1,1.0,1,0.6048061650494612,65
4330,2,11078,11078,0,0,0,0,1.0,1,1.0,1,1.0,1,0.6024662286507755,65
4331,1,11079,11079,0,0,0,0,1.0,1,1.0,1,1.0,1,0.5989451696820167,65
4332,0,11079,11079,0,0,0,0,1.0,1,1.0,1,1.0,1,0.5930395318731352,66
4333,1,11080,11080,0,0,0,0,1.0,1,1.0,1,1.0,1,0.5831621207286037,66
4334,3,11083,11083,0,0,0,0,1.0,1,1.0,1,1.0,1,0.5589079525744027,66
4335,2,11085,11085,0,0,0,0,1.0,1,1.0,1,1.0,1,0.5605701343405368,65
4336,0,11085,11085,0,0,0,0,1.0,1,1.0,1,1.0,1,0.552275475959954,67
4337,2,11087,11087,0,0,0,0,1.0,1,1.0,1,1.0,1,0.5624758846928306,69
4338,3,11090,11090,0,0,0,0,1.0,1,1.0,1,1.0,1,0.5774844676722805,70
4339,3,11093,11093,0,0,0,0,1.0,1,1.0,1,1.0,1,0.5734004616301377,70
4340,3,11096,11096,0,0,0,0,1.0,1,1.0,1,1.0,1,0.5808325548622023,71
4341,5,11101,11101,0,0,0,0,1.0,1,1.0,1,1.0,1,0.5957326476361174,70
4342,5,11106,11106,0,0,0,0,1.0,1,1.0,1,1.0,1,0.6126505748457163,71
4343,7,11113,11113,0,0,0,0,1.0,1,1.0,1,1.0,1,0.6175406046173715,67
4344,4,11117,11117,0,0,0,0,1.0,1,1.0,1,1.0,1,0.6308675002590517,67
4345,9,11126,11126,0,0,0,0,1.0,1,1.0,1,1.0,1,0.640658475505986,64
4346,8,11134,11134,0,0,0,0,1.0,1,1.0,1,1.0,1,0.6438109584074662,64
4347,6,11140,11140,0,0,0,0,1.0,1,1.0,1,1.0,1,0.6507290944201183,62
4348,6,11146,11146,0,0,0,0,1.0,1,1.0,1,1.0,1,0.6285599338408231,62
4349,3,11149,11149,0,0,0,0,1.0,1,1.0,1,1.0,1,0.6218819715128595,61
4350,4,11153,11153,0,0,0,0,1.0,1,1.0,1,1.0,1,0.6109567987814291,60
4351,0,11153,11153,0,0,0,0,1.0,1,1.0,1,1.0,1,0.6137358050550581,60
4352,2,11155,11155,0,0,0,0,1.0,1,1.0,1,1.0,1,0.6424402556728397,57
4353,4,11159,11159,0,0,0,0,1.0,1,1.0,1,1.0,1,0.6611984394490676,55
4354,1,11160,11160,0,0,0,0,1.0,1,1.0,1,1.0,1,0.6706764531417658,55
4355,4,11164,11164,0,0,0,0,1.0,1,1.0,1,1.0,1,0.6510420472240906,53
4356,1,11165,11165,0,0,0,0,1.0,1,1.0,1,1.0,1,0.6218657276863512,55
4357,3,11168,11168,0,0,0,0,1.0,1,1.0,1,1.0,1,0.587642636099594,55
4358,2,11170,11170,0,0,0,0,1.0,1,1.0,1,1.0,1,0.6160583554181637,55
4359,2,11172,11172,0,0,0,0,1.0,1,1.0,1,1.0,1,0.645230192839654,54
4360,1,11173,11173,0,0,0,0,1.0,1,1.0,1,1.0,1,0.6411642626615005,55
4361,1,11174,11174,0,0,0,0,1.0,1,1.0,1,1.0,1,0.6378858859068947,54
4362,3,11177,11177,0,0,0,0,1.0,1,1.0,1,1.0,1,0.6316066314933286,55
4363,1,11178,11178,0,0,0,0,1.0,1,1.0,1,1.0,1,0.623740378217481,55
4364,1,11179,11179,0,0,0,0,1.0,1,1.0,1,1.0,1,0.6199952437185259,55
4365,2,11181,11181,0,0,0,0,1.0,1,1.0,1,1.0,1,0.6214872886023455,54
4366,3,11184,11184,0,0,0,0,1.0,1,1.0,1,1.0,1,0.59706335844479,54
4367,3,11187,11187,0,0,0,0,1.0,1,1.0,1,1.0,1,0.5671667270422647,57
4368,3,11190,11190,0,0,0,0,1.0,1,1.0,1,1.0,1,0.5510629352886617,57
4369,2,11192,11192,0,0,0,0,1.0,1,1.0,1,1.0,1,0.550612916086029,58
4370,3,11195,11195,0,0,0,0,1.0,1,1.0,1,1.0,1,0.5365340706286992,59
4371,1,11196,11196,0,0,0,0,1.0,1,1.0,1,1.0,1,0.5476448086835274,60
4372,0,11196,11196,0,0,0,0,1.0,1,1.0,1,1.0,1,0.5476448086835274,60
4373,1,11197,11197,0,0,0,0,1.0,1,1.0,1,1.0,1,0.5629550536288556,60
4374,1,11198,11198,0,0,0,0,1.0,1,1.0,1,1.0,1,0.5786281141907207,59
4375,2,11200,11200,0,0,0,0,1.0,1,1.0,1,1.0,1,0.5662737655604702,60
4376,4,11204,11204,0,0,0,0,1.0,1,1.0,1,1.0,1,0.5674591467574207,60
4377,2,11206,11206,0,0,0,0,1.0,1,1.0,1,1.0,1,0.5834707791987824,61
4378,6,11212,11212,0,0,0,0,1.0,1,1.0,1,1.0,1,0.5716566049749069,64
4379,5,11217,11217,0,0,0,0,1.0,1,1.0,1,1.0,1,0.5825258657797914,64
4380,3,11220,11220,0,0,0,0,1.0,1,1.0,1,1.0,1,0.6004901359763404,65
4381,4,11224,11224,0,0,0,0,1.0,1,1.0,1,1.0,1,0.6157525529072178,64
4382,3,11227,11227,0,0,0,0,1.0,1,1.0,1,1.0,1,0.6468546734192155,64
4383,2,11229,11229,0,0,0,0,1.0,1,1.0,1,1.0,1,0.6390868686232082,64
4384,2,11231,11231,0,0,0,0,1.0,1,1.0,1,1.0,1,0.6962657158890034,60
4385,5,11236,11236,0,0,0,0,1.0,1,1.0,1,1.0,1,0.6726231711226522,58
4386,0,11236,11236,0,0,0,0,1.0,1,1.0,1,1.0,1,0.659421082467377,58
4387,4,11240,11240,0,0,0,0,1.0,1,1.0,1,1.0,1,0.6211789972693567,55
4388,1,11241,11241,0,0,0,0,1.0,1,1.0,1,1.0,1,0.6458688117724007,56
4389,4,11245,11245,0,0,0,0,1.0,1,1.0,1,1.0,1,0.6226990006249034,55
4390,6,11251,11251,0,0,0,0,1.0,1,1.0,1,1.0,1,0.6486953327017286,55
4391,0,11251,11251,0,0,0,0,1.0,1,1.0,1,1.0,1,0.6423977616161786,56
4392,2,11253,11253,0,0,0,0,1.0,1,1.0,1,1.0,1,0.6655992664196226,56
4393,1,11254,11254,0,0,0,0,1.0,1,1.0,1,1.0,1,0.6749567316472416,55
4394,2,11256,11256,0,0,0,0,1.0,1,1.0,1,1.0,1,0.6497697442382807,53
4395,1,11257,11257,0,0,0,0,1.0,1,1.0,1,1.0,1,0.638720400095584,53
4396,2,11259,11259,0,0,0,0,1.0,1,1.0,1,1.0,1,0.6163737726716828,53
4397,0,11259,11259,0,0,0,0,1.0,1,1.0,1,1.0,1,0.6238162313513828,50
4398,4,11263,11263,0,0,0,0,1.0,1,1.0,1,1.0,1,0.5985367656452704,50
4399,0,11263,11263,0,0,0,0,1.0,1,1.0,1,1.0,1,0.5956215794105835,52
4400,2,11265,11265,0,0,0,0,1.0,1,1.0,1,1.0,1,0.5898957495482673,55
4401,1,11266,11266,0,0,0,0,1.0,1,1.0,1,1.0,1,0.5696312079359794,56
4402,2,11268,11268,0,0,0,0,1.0,1,1.0,1,1.0,1,0.5874289177635148,56
4403,0,11268,11268,0,0,0,0,1.0,1,1.0,1,1.0,1,0.5779547302109636,57
4404,1,11269,11269,0,0,0,0,1.0,1,1.0,1,1.0,1,0.5719501006167935,57
4405,1,11270,11270,0,0,0,0,1.0,1,1.0,1,1.0,1,0.5672167764070201,58
4406,2,11272,11272,0,0,0,0,1.0,1,1.0,1,1.0,1,0.5685459985047173,58
4407,0,11272,11272,0,0,0,0,1.0,1,1.0,1,1.0,1,0.5685459985047173,58
4408,0,11272,11272,0,0,0,0,1.0,1,1.0,1,1.0,1,0.5697967464643133,59
4409,0,11272,11272,0,0,0,0,1.0,1,1.0,1,1.0,1,0.5697967464643133,59
4410,0,11272,11272,0,0,0,0,1.0,1,1.0,1,1.0,1,0.5697967464643133,59
4411,0,11272,11272,0,0,0,0,1.0,1,1.0,1,1.0,1,0.5566025481226831,62
4412,1,11273,11273,0,0,0,0,1.0,1,1.0,1,1.0,1,0.5466261572164198,63
4413,2,11275,11275,0,0,0,0,1.0,1,1.0,1,1.0,1,0.5280104985035875,63
4414,1,11276,11276,0,0,0,0,1.0,1,1.0,1,1.0,1,0.5346002118820851,64
4415,3,11279,11279,0,0,0,0,1.0,1,1.0,1,1.0,1,0.5078304414942889,64
4416,1,11280,11280,0,0,0,0,1.0,1,1.0,1,1.0,1,0.49876221003007193,64
4417,1,11281,11281,0,0,0,0,1.0,1,1.0,1,1.0,1,0.49142123857173403,65
4418,2,11283,11283,0,0,0,0,1.0,1,1.0,1,1.0,1,0.49629165965680416,65
4419,2,11285,11285,0,0,0,0,1.0,1,1.0,1,1.0,1,0.5308101068604485,62
4420,3,11288,11288,0,0,0,0,1.0,1,1.0,1,1.0,1,0.5531530094667853,62
4421,2,11290,11290,0,0,0,0,1.0,1,1.0,1,1.0,1,0.5631776686846833,65
4422,2,11292,11292,0,0,0,0,1.0,1,1.0,1,1.0,1,0.5796081321938156,64
4423,2,11294,11294,0,0,0,0,1.0,1,1.0,1,1.0,1,0.5918114718769405,63
4424,4,11298,11298,0,0,0,0,1.0,1,1.0,1,1.0,1,0.5896887568268533,63
4425,0,11298,11298,0,0,0,0,1.0,1,1.0,1,1.0,1,0.5963701140264692,63
4426,3,11301,11301,0,0,0,0,1.0,1,1.0,1,1.0,1,0.5639887268845623,63
4427,3,11304,11304,0,0,0,0,1.0,1,1.0,1,1.0,1,0.5794827401427862,62
4428,3,11307,11307,0,0,0,0,1.0,1,1.0,1,1.0,1,0.5840917973813086,61
4429,6,11313,11313,0,0,0,0,1.0,1,1.0,1,1.0,1,0.6074932878346084,62
4430,7,11320,11320,0,0,0,0,1.0,1,1.0,1,1.0,1,0.6112116509626775,60
4431,5,11325,11325,0,0,0,0,1.0,1,1.0,1,1.0,1,0.6389907223470371,59
4432,5,11330,11330,0,0,0,0,1.0,1,1.0,1,1.0,1,0.6531332662719984,60
4433,7,11337,11337,0,0,0,0,1.0,1,1.0,1,1.0,1,0.6166444435521949,61
4434,4,11341,11341,0,0,0,0,1.0,1,1.0,1,1.0,1,0.6108057923880077,61
4435,5,11346,11346,0,0,0,0,1.0,1,1.0,1,1.0,1,0.6094410188959171,61
4436,4,11350,11350,0,0,0,0,1.0,1,1.0,1,1.0,1,0.5953728354937097,61
4437,3,11353,11353,0,0,0,0,1.0,1,1.0,1,1.0,1,0.5832487755572192,61
4438,1,11354,11354,0,0,0,0,1.0,1,1.0,1,1.0,1,0.5757092232385498,62
4439,2,11356,11356,0,0,0,0,1.0,1,1.0,1,1.0,1,0.5633464785198182,63
4440,4,11360,11360,0,0,0,0,1.0,1,1.0,1,1.0,1,0.5466200060460725,64
4441,2,11362,11362,0,0,0,0,1.0,1,1.0,1,1.0,1,0.5564609405744978,64
4442,3,11365,11365,0,0,0,0,1.0,1,1.0,1,1.0,1,0.5350067156160867,67
4443,4,11369,11369,0,0,0,0,1.0,1,1.0,1,1.0,1,0.5277338980473114,68
4444,4,11373,11373,0,0,0,0,1.0,1,1.0,1,1.0,1,0.551359742716306,69
4445,4,11377,11377,0,0,0,0,1.0,1,1.0,1,1.0,1,0.546705610837308,71
4446,1,11378,11378,0,0,0,0,1.0,1,1.0,1,1.0,1,0.5399369576637012,71
4447,2,11380,11380,0,0,0,0,1.0,1,1.0,1,1.0,1,0.5302238780735873,72
4448,1,11381,11381,0,0,0,0,1.0,1,1.0,1,1.0,1,0.5279486086189566,71
4449,1,11382,11382,0,0,0,0,1.0,1,1.0,1,1.0,1,0.5257253650793421,70
4450,0,11382,11382,0,0,0,0,1.0,1,1.0,1,1.0,1,0.5336549233330767,69
4451,2,11384,11384,0,0,0,0,1.0,1,1.0,1,1.0,1,0.538972462938908,69
4452,3,11387,11387,0,0,0,0,1.0,1,1.0,1,1.0,1,0.5562217221620409,70
4453,5,11392,11392,0,0,0,0,1.0,1,1.0,1,1.0,1,0.5542245877354903,70
4454,4,11396,11396,0,0,0,0,1.0,1,1.0,1,1.0,1,0.5830214808063497,71
4455,4,11400,11400,0,0,0,0,1.0,1,1.0,1,1.0,1,0.596513335136206,71
4456,10,11410,11410,0,0,0,0,1.0,1,1.0,1,1.0,1,0.5898645196864611,71
4457,5,11415,11415,0,0,0,0,1.0,1,1.0,1,1.0,1,0.5976065387738219,69
4458,5,11420,11420,0,0,0,0,1.0,1,1.0,1,1.0,1,0.5907297577342,70
4459,4,11424,11424,0,0,0,0,1.0,1,1.0,1,1.0,1,0.5687510171153063,68
4460,8,11432,11432,0,0,0,0,1.0,1,1.0,1,1.0,1,0.5512398776827454,68
4461,2,11434,11434,0,0,0,0,1.0,1,1.0,1,1.0,1,0.5414834439784266,67
4462,5,11439,11439,0,0,0,0,1.0,1,1.0,1,1.0,1,0.5463190223573816,66
4463,4,11443,11443,0,0,0,0,1.0,1,1.0,1,1.0,1,0.5493515865418263,65
4464,6,11449,11449,0,0,0,0,1.0,1,1.0,1,1.0,1,0.5748578144312804,62
4465,3,11452,11452,0,0,0,0,1.0,1,1.0,1,1.0,1,0.562049609586797,61
4466,3,11455,11455,0,0,0,0,1.0,1,1.0,1,1.0,1,0.5798717139551273,60
4467,4,11459,11459,0,0,0,0,1.0,1,1.0,1,1.0,1,0.5905752889508281,58
4468,2,11461,11461,0,0,0,0,1.0,1,1.0,1,1.0,1,0.6101449689084981,57
4469,5,11466,11466,0,0,0,0,1.0,1,1.0,1,1.0,1,0.5974769100039832,56
4470,1,11467,11467,0,0,0,0,1.0,1,1.0,1,1.0,1,0.5905216388396433,55
4471,6,11473,11473,0,0,0,0,1.0,1,1.0,1,1.0,1,0.5888538182974103,55
4472,4,11477,11477,0,0,0,0,1.0,1,1.0,1,1.0,1,0.5826697018220436,55
4473,4,11481,11481,0,0,0,0,1.0,1,1.0,1,1.0,1,0.5888894370346875,55
4474,2,11483,11483,0,0,0,0,1.0,1,1.0,1,1.0,1,0.5919221193461002,55
4475,2,11485,11485,0,0,0,0,1.0,1,1.0,1,1.0,1,0.5578446956746789,56
4476,3,11488,11488,0,0,0,0,1.0,1,1.0,1,1.0,1,0.5567166940113599,56
4477,2,11490,11490,0,0,0,0,1.0,1,1.0,1,1.0,1,0.548486313750894,57
4478,4,11494,11494,0,0,0,0,1.0,1,1.0,1,1.0,1,0.5654767052832997,55
4479,1,11495,11495,0,0,0,0,1.0,1,1.0,1,1.0,1,0.5634585019160103,55
4480,4,11499,11499,0,0,0,0,1.0,1,1.0,1,1.0,1,0.590358093928645,54
4481,4,11503,11503,0,0,0,0,1.0,1,1.0,1,1.0,1,0.6209418500096117,53
4482,2,11505,11505,0,0,0,0,1.0,1,1.0,1,1.0,1,0.6443858529926347,54
4483,5,11510,11510,0,0,0,0,1.0,1,1.0,1,1.0,1,0.6570913395214645,55
4484,2,11512,11512,0,0,0,0,1.0,1,1.0,1,1.0,1,0.6187889218288963,57
4485,3,11515,11515,0,0,0,0,1.0,1,1.0,1,1.0,1,0.6023463982130381,60
4486,2,11517,11517,0,0,0,0,1.0,1,1.0,1,1.0,1,0.602329823420169,60
4487,2,11519,11519,0,0,0,0,1.0,1,1.0,1,1.0,1,0.5882865577717002,60
4488,0,11519,11519,0,0,0,0,1.0,1,1.0,1,1.0,1,0.5882865577717002,60
4489,1,11520,11520,0,0,0,0,1.0,1,1.0,1,1.0,1,0.5835272544960359,60
4490,2,11522,11522,0,0,0,0,1.0,1,1.0,1,1.0,1,0.5937637860599583,60
4491,1,11523,11523,0,0,0,0,1.0,1,1.0,1,1.0,1,0.600347424183438,61
4492,0,11523,11523,0,0,0,0,1.0,1,1.0,1,1.0,1,0.600347424183438,61
4493,0,11523,11523,0,0,0,0,1.0,1,1.0,1,1.0,1,0.6088887645667941,60
4494,1,11524,11524,0,0,0,0,1.0,1,1.0,1,1.0,1,0.6092800920649015,61
4495,1,11525,11525,0,0,0,0,1.0,1,1.0,1,1.0,1,0.6086655893428079,59
4496,4,11529,11529,0,0,0,0,1.0,1,1.0,1,1.0,1,0.6177425387265276,60
4497,1,11530,11530,0,0,0,0,1.0,1,1.0,1,1.0,1,0.6152916837171528,59
4498,5,11535,11535,0,0,0,0,1.0,1,1.0,1,1.0,1,0.6394309961023574,57
4499,4,11539,11539,0,0,0,0,1.0,1,1.0,1,1.0,1,0.6008614365505406,58
4500,5,11544,11544,0,0,0,0,1.0,1,1.0,1,1.0,1,0.5782045450916783,56
4501,1,11545,11545,0,0,0,0,1.0,1,1.0,1,1.0,1,0.5765579146921105,57
4502,7,11552,11552,0,0,0,0,1.0,1,1.0,1,1.0,1,0.5783866231364705,56
4503,5,11557,11557,0,0,0,0,1.0,1,1.0,1,1.0,1,0.569974247445172,54
4504,2,11559,11559,0,0,0,0,1.0,1,1.0,1,1.0,1,0.560561877960746,54
4505,6,11565,11565,0,0,0,0,1.0,1,1.0,1,1.0,1,0.5618310653662515,51
4506,2,11567,11567,0,0,0,0,1.0,1,1.0,1,1.0,1,0.5683129900587519,49
4507,3,11570,11570,0,0,0,0,1.0,1,1.0,1,1.0,1,0.5860592544018711,48
4508,1,11571,11571,0,0,0,0,1.0,1,1.0,1,1.0,1,0.6026696349358357,48
4509,1,11572,11572,0,0,0,0,1.0,1,1.0,1,1.0,1,0.6267870265347487,46
4510,2,11574,11574,0,0,0,0,1.0,1,1.0,1,1.0,1,0.6238484243178873,44
4511,1,11575,11575,0,0,0,0,1.0,1,1.0,1,1.0,1,0.6247971737549143,45
4512,3,11578,11578,0,0,0,0,1.0,1,1.0,1,1.0,1,0.62051565550489,46
4513,3,11581,11581,0,0,0,0,1.0,1,1.0,1,1.0,1,0.6083535424580583,45
4514,5,11586,11586,0,0,0,0,1.0,1,1.0,1,1.0,1,0.6238817885044561,46
4515,3,11589,11589,0,0,0,0,1.0,1,1.0,1,1.0,1,0.633942300509636,48
4516,4,11593,11593,0,0,0,0,1.0,1,1.0,1,1.0,1,0.6054460141637362,49
4517,2,11595,11595,0,0,0,0,1.0,1,1.0,1,1.0,1,0.5939118375784461,50
4518,3,11598,11598,0,0,0,0,1.0,1,1.0,1,1.0,1,0.573356482793991,50
4519,0,11598,11598,0,0,0,0,1.0,1,1.0,1,1.0,1,0.5796451233021893,49
4520,3,11601,11601,0,0,0,0,1.0,1,1.0,1,1.0,1,0.5728245448868075,50
4521,0,11601,11601,0,0,0,0,1.0,1,1.0,1,1.0,1,0.5728245448868075,50
4522,3,11604,11604,0,0,0,0,1.0,1,1.0,1,1.0,1,0.5526373314951375,50
4523,1,11605,11605,0,0,0,0,1.0,1,1.0,1,1.0,1,0.5387317095922736,51
4524,2,11607,11607,0,0,0,0,1.0,1,1.0,1,1.0,1,0.5197611851719669,52
4525,2,11609,11609,0,0,0,0,1.0,1,1.0,1,1.0,1,0.5108179824864219,53
4526,1,11610,11610,0,0,0,0,1.0,1,1.0,1,1.0,1,0.5098503445426454,54
4527,3,11613,11613,0,0,0,0,1.0,1,1.0,1,1.0,1,0.5099236459536876,55
4528,3,11616,11616,0,0,0,0,1.0,1,1.0,1,1.0,1,0.4859481821634791,55
4529,6,11622,11622,0,0,0,0,1.0,1,1.0,1,1.0,1,0.4909197850054043,55
4530,4,11626,11626,0,0,0,0,1.0,1,1.0,1,1.0,1,0.47831552788363774,56
4531,4,11630,11630,0,0,0,0,1.0,1,1.0,1,1.0,1,0.5001398223923151,56
4532,4,11634,11634,0,0,0,0,1.0,1,1.0,1,1.0,1,0.5190860852999971,55
4533,3,11637,11637,0,0,0,0,1.0,1,1.0,1,1.0,1,0.510304868344113,54
4534,3,11640,11640,0,0,0,0,1.0,1,1.0,1,1.0,1,0.5289829765817657,55
4535,1,11641,11641,0,0,0,0,1.0,1,1.0,1,1.0,1,0.5405944709921604,52
4536,3,11644,11644,0,0,0,0,1.0,1,1.0,1,1.0,1,0.5504714709025664,53
4537,3,11647,11647,0,0,0,0,1.0,1,1.0,1,1.0,1,0.5678470349523287,52
4538,5,11652,11652,0,0,0,0,1.0,1,1.0,1,1.0,1,0.5858126063648924,52
4539,3,11655,11655,0,0,0,0,1.0,1,1.0,1,1.0,1,0.5577605516852832,53
4540,1,11656,11656,0,0,0,0,1.0,1,1.0,1,1.0,1,0.552151611400384,54
4541,4,11660,11660,0,0,0,0,1.0,1,1.0,1,1.0,1,0.5390762893641056,53
4542,4,11664,11664,0,0,0,0,1.0,1,1.0,1,1.0,1,0.5353089860594427,53
4543,0,11664,11664,0,0,0,0,1.0,1,1.0,1,1.0,1,0.5353089860594427,53
4544,1,11665,11665,0,0,0,0,1.0,1,1.0,1,1.0,1,0.5616540502390575,52
4545,6,11671,11671,0,0,0,0,1.0,1,1.0,1,1.0,1,0.5925500087155193,50
4546,1,11672,11672,0,0,0,0,1.0,1,1.0,1,1.0,1,0.5717734525470722,49
4547,4,11676,11676,0,0,0,0,1.0,1,1.0,1,1.0,1,0.5763066713850823,49
4548,3,11679,11679,0,0,0,0,1.0,1,1.0,1,1.0,1,0.55275309407,49
4549,2,11681,11681,0,0,0,0,1.0,1,1.0,1,1.0,1,0.5244437988166346,50
4550,2,11683,11683,0,0,0,0,1.0,1,1.0,1,1.0,1,0.5536492862098134,49
4551,1,11684,11684,0,0,0,0,1.0,1,1.0,1,1.0,1,0.5648385010968551,49
4552,4,11688,11688,0,0,0,0,1.0,1,1.0,1,1.0,1,0.5693534668048443,49
4553,3,11691,11691,0,0,0,0,1.0,1,1.0,1,1.0,1,0.5979821625829804,49
4554,4,11695,11695,0,0,0,0,1.0,1,1.0,1,1.0,1,0.62281540005897,49
4555,2,11697,11697,0,0,0,0,1.0,1,1.0,1,1.0,1,0.6241406161369206,48
4556,7,11704,11704,0,0,0,0,1.0,1,1.0,1,1.0,1,0.6511553500600614,48
4557,3,11707,11707,0,0,0,0,1.0,1,1.0,1,1.0,1,0.6510696405944701,49
4558,2,11709,11709,0,0,0,0,1.0,1,1.0,1,1.0,1,0.6465656038021467,49
4559,0,11709,11709,0,0,0,0,1.0,1,1.0,1,1.0,1,0.6475361737546191,50
4560,4,11713,11713,0,0,0,0,1.0,1,1.0,1,1.0,1,0.6214670804550653,51
4561,3,11716,11716,0,0,0,0,1.0,1,1.0,1,1.0,1,0.6340232573537538,52
4562,2,11718,11718,0,0,0,0,1.0,1,1.0,1,1.0,1,0.6193383963188623,53
4563,0,11718,11718,0,0,0,0,1.0,1,1.0,1,1.0,1,0.6139879956197359,52
4564,1,11719,11719,0,0,0,0,1.0,1,1.0,1,1.0,1,0.6175291392388994,54
4565,0,11719,11719,0,0,0,0,1.0,1,1.0,1,1.0,1,0.6224920173553468,55
4566,2,11721,11721,0,0,0,0,1.0,1,1.0,1,1.0,1,0.6302368101952233,55
4567,1,11722,11722,0,0,0,0,1.0,1,1.0,1,1.0,1,0.6053219506254789,56
4568,3,11725,11725,0,0,0,0,1.0,1,1.0,1,1.0,1,0.6105284255425059,58
4569,4,11729,11729,0,0,0,0,1.0,1,1.0,1,1.0,1,0.6064390319704778,59
4570,3,11732,11732,0,0,0,0,1.0,1,1.0,1,1.0,1,0.6304504197407876,59
4571,1,11733,11733,0,0,0,0,1.0,1,1.0,1,1.0,1,0.6320450186956114,57
4572,1,11734,11734,0,0,0,0,1.0,1,1.0,1,1.0,1,0.6333393167695693,56
4573,1,11735,11735,0,0,0,0,1.0,1,1.0,1,1.0,1,0.6276064351357342,56
4574,0,11735,11735,0,0,0,0,1.0,1,1.0,1,1.0,1,0.6140466723945032,55
4575,1,11736,11736,0,0,0,0,1.0,1,1.0,1,1.0,1,0.6286971379948924,55
4576,2,11738,11738,0,0,0,0,1.0,1,1.0,1,1.0,1,0.637594728422603,55
4577,0,11738,11738,0,0,0,0,1.0,1,1.0,1,1.0,1,0.6401358083539227,54
4578,0,11738,11738,0,0,0,0,1.0,1,1.0,1,1.0,1,0.6420941890471936,54
4579,3,11741,11741,0,0,0,0,1.0,1,1.0,1,1.0,1,0.6519981305765007,54
4580,4,11745,11745,0,0,0,0,1.0,1,1.0,1,1.0,1,0.6687007338646171,55
4581,0,11745,11745,0,0,0,0,1.0,1,1.0,1,1.0,1,0.6720798455456359,56
4582,3,11748,11748,0,0,0,0,1.0,1,1.0,1,1.0,1,0.6767056975565985,56
4583,1,11749,11749,0,0,0,0,1.0,1,1.0,1,1.0,1,0.675649425325318,57
4584,1,11750,11750,0,0,0,0,1.0,1,1.0,1,1.0,1,0.677657468418983,57
4585,0,11750,11750,0,0,0,0,1.0,1,1.0,1,1.0,1,0.677657468418983,57
4586,0,11750,11750,0,0,0,0,1.0,1,1.0,1,1.0,1,0.677657468418983,57
4587,0,11750,11750,0,0,0,0,1.0,1,1.0,1,1.0,1,0.677657468418983,57
4588,0,11750,11750,0,0,0,0,1.0,1,1.0,1,1.0,1,0.6733652015170469,58
4589,1,11751,11751,0,0,0,0,1.0,1,1.0,1,1.0,1,0.6769918598487243,59
4590,1,11752,11752,0,0,0,0,1.0,1,1.0,1,1.0,1,0.6761372889307227,60
4591,2,11754,11754,0,0,0,0,1.0,1,1.0,1,1.0,1,0.6649876498471193,61
4592,3,11757,11757,0,0,0,0,1.0,1,1.0,1,1.0,1,0.6743533402549033,62
4593,0,11757,11757,0,0,0,0,1.0,1,1.0,1,1.0,1,0.6614307815027421,64
4594,2,11759,11759,0,0,0,0,1.0,1,1.0,1,1.0,1,0.6733949400229324,64
4595,4,11763,11763,0,0,0,0,1.0,1,1.0,1,1.0,1,0.6748415325331871,63
4596,2,11765,11765,0,0,0,0,1.0,1,1.0,1,1.0,1,0.6763180026285228,63
4597,3,11768,11768,0,0,0,0,1.0,1,1.0,1,1.0,1,0.6923879487118143,63
4598,3,11771,11771,0,0,0,0,1.0,1,1.0,1,1.0,1,0.6698693774070097,65
4599,0,11771,11771,0,0,0,0,1.0,1,1.0,1,1.0,1,0.6619054681233263,66
4600,1,11772,11772,0,0,0,0,1.0,1,1.0,1,1.0,1,0.6748009505654331,67
4601,4,11776,11776,0,0,0,0,1.0,1,1.0,1,1.0,1,0.6687930616900348,67
4602,0,11776,11776,0,0,0,0,1.0,1,1.0,1,1.0,1,0.653198250023766,69
4603,3,11779,11779,0,0,0,0,1.0,1,1.0,1,1.0,1,0.6501064986542393,69
4604,3,11782,11782,0,0,0,0,1.0,1,1.0,1,1.0,1,0.6460275713111311,69
4605,1,11783,11783,0,0,0,0,1.0,1,1.0,1,1.0,1,0.647087854288649,70
4606,1,11784,11784,0,0,0,0,1.0,1,1.0,1,1.0,1,0.6494434454174326,70
4607,4,11788,11788,0,0,0,0,1.0,1,1.0,1,1.0,1,0.6629414990806471,72
4608,0,11788,11788,0,0,0,0,1.0,1,1.0,1,1.0,1,0.6651192626587747,73
4609,4,11792,11792,0,0,0,0,1.0,1,1.0,1,1.0,1,0.6568063770673579,72
4610,0,11792,11792,0,0,0,0,1.0,1,1.0,1,1.0,1,0.6568063770673579,72
4611,2,11794,11794,0,0,0,0,1.0,1,1.0,1,1.0,1,0.6490296662019861,71
4612,0,11794,11794,0,0,0,0,1.0,1,1.0,1,1.0,1,0.6525708010908893,70
4613,1,11795,11795,0,0,0,0,1.0,1,1.0,1,1.0,1,0.652329588215078,69
4614,3,11798,11798,0,0,0,0,1.0,1,1.0,1,1.0,1,0.6145652281141871,68
4615,4,11802,11802,0,0,0,0,1.0,1,1.0,1,1.0,1,0.5789895214058891,68
4616,0,11802,11802,0,0,0,0,1.0,1,1.0,1,1.0,1,0.5882001485459969,65
4617,3,11805,11805,0,0,0,0,1.0,1,1.0,1,1.0,1,0.5716027362869375,66
4618,1,11806,11806,0,0,0,0,1.0,1,1.0,1,1.0,1,0.5834964688860443,66
4619,6,11812,11812,0,0,0,0,1.0,1,1.0,1,1.0,1,0.6163939618108439,65
4620,2,11814,11814,0,0,0,0,1.0,1,1.0,1,1.0,1,0.6103288949478468,65
4621,5,11819,11819,0,0,0,0,1.0,1,1.0,1,1.0,1,0.6498985720475916,67
4622,5,11824,11824,0,0,0,0,1.0,1,1.0,1,1.0,1,0.6404404816066306,65
4623,4,11828,11828,0,0,0,0,1.0,1,1.0,1,1.0,1,0.6283229746190148,66
4624,4,11832,11832,0,0,0,0,1.0,1,1.0,1,1.0,1,0.634765484085435,65
4625,5,11837,11837,0,0,0,0,1.0,1,1.0,1,1.0,1,0.6368622386153864,64
4626,1,11838,11838,0,0,0,0,1.0,1,1.0,1,1.0,1,0.6285164902183543,63
4627,5,11843,11843,0,0,0,0,1.0,1,1.0,1,1.0,1,0.6079711518608583,65
4628,2,11845,11845,0,0,0,0,1.0,1,1.0,1,1.0,1,0.6229374948944814,64
4629,3,11848,11848,0,0,0,0,1.0,1,1.0,1,1.0,1,0.6054116276685788,64
4630,3,11851,11851,0,0,0,0,1.0,1,1.0,1,1.0,1,0.6182744001684016,64
4631,2,11853,11853,0,0,0,0,1.0,1,1.0,1,1.0,1,0.638698895471573,66
4632,3,11856,11856,0,0,0,0,1.0,1,1.0,1,1.0,1,0.6513037382225263,65
4633,0,11856,11856,0,0,0,0,1.0,1,1.0,1,1.0,1,0.6425629776569645,66
4634,1,11857,11857,0,0,0,0,1.0,1,1.0,1,1.0,1,0.6463416995954939,66
4635,2,11859,11859,0,0,0,0,1.0,1,1.0,1,1.0,1,0.6480389885030117,66
4636,1,11860,11860,0,0,0,0,1.0,1,1.0,1,1.0,1,0.6423496978833466,66
4637,1,11861,11861,0,0,0,0,1.0,1,1.0,1,1.0,1,0.6322995847960498,68
4638,4,11865,11865,0,0,0,0,1.0,1,1.0,1,1.0,1,0.6385761486636288,68
4639,1,11866,11866,0,0,0,0,1.0,1,1.0,1,1.0,1,0.6391845547039234,69
4640,1,11867,11867,0,0,0,0,1.0,1,1.0,1,1.0,1,0.6354589795149234,69
4641,1,11868,11868,0,0,0,0,1.0,1,1.0,1,1.0,1,0.635566188586422,70
4642,0,11868,11868,0,0,0,0,1.0,1,1.0,1,1.0,1,0.6406031983432475,69
4643,3,11871,11871,0,0,0,0,1.0,1,1.0,1,1.0,1,0.6257625436068834,70
4644,0,11871,11871,0,0,0,0,1.0,1,1.0,1,1.0,1,0.6328958917778523,69
4645,4,11875,11875,0,0,0,0,1.0,1,1.0,1,1.0,1,0.6089552414664047,70
4646,4,11879,11879,0,0,0,0,1.0,1,1.0,1,1.0,1,0.6184040660508445,68
4647,1,11880,11880,0,0,0,0,1.0,1,1.0,1,1.0,1,0.6244195699078701,68
4648,4,11884,11884,0,0,0,0,1.0,1,1.0,1,1.0,1,0.6429929529789397,67
4649,1,11885,11885,0,0,0,0,1.0,1,1.0,1,1.0,1,0.6344171419747767,67
4650,1,11886,11886,0,0,0,0,1.0,1,1.0,1,1.0,1,0.6243610109882827,67
4651,1,11887,11887,0,0,0,0,1.0,1,1.0,1,1.0,1,0.6220226578460326,68
4652,2,11889,11889,0,0,0,0,1.0,1,1.0,1,1.0,1,0.597639120069168,66
4653,4,11893,11893,0,0,0,0,1.0,1,1.0,1,1.0,1,0.5931075389322089,64
4654,6,11899,11899,0,0,0,0,1.0,1,1.0,1,1.0,1,0.6039168407187341,65
4655,3,11902,11902,0,0,0,0,1.0,1,1.0,1,1.0,1,0.5926798924466165,64
4656,5,11907,11907,0,0,0,0,1.0,1,1.0,1,1.0,1,0.602638755445527,65
4657,1,11908,11908,0,0,0,0,1.0,1,1.0,1,1.0,1,0.5916155233270478,66
4658,4,11912,11912,0,0,0,0,1.0,1,1.0,1,1.0,1,0.5962475709409563,65
4659,3,11915,11915,0,0,0,0,1.0,1,1.0,1,1.0,1,0.5806626280680147,65
4660,2,11917,11917,0,0,0,0,1.0,1,1.0,1,1.0,1,0.5932793027433716,66
4661,2,11919,11919,0,0,0,0,1.0,1,1.0,1,1.0,1,0.6032717921897648,66
4662,2,11921,11921,0,0,0,0,1.0,1,1.0,1,1.0,1,0.6049627833282581,68
4663,3,11924,11924,0,0,0,0,1.0,1,1.0,1,1.0,1,0.5906014714369102,67
4664,3,11927,11927,0,0,0,0,1.0,1,1.0,1,1.0,1,0.6060371123974142,67
4665,3,11930,11930,0,0,0,0,1.0,1,1.0,1,1.0,1,0.6000548491765213,67
4666,0,11930,11930,0,0,0,0,1.0,1,1.0,1,1.0,1,0.6119438993298708,67
4667,4,11934,11934,0,0,0,0,1.0,1,1.0,1,1.0,1,0.5962096565889817,66
4668,2,11936,11936,0,0,0,0,1.0,1,1.0,1,1.0,1,0.5962454035533028,66
4669,6,11942,11942,0,0,0,0,1.0,1,1.0,1,1.0,1,0.6053224232002588,66
4670,2,11944,11944,0,0,0,0,1.0,1,1.0,1,1.0,1,0.62141313192199,64
4671,4,11948,11948,0,0,0,0,1.0,1,1.0,1,1.0,1,0.6259486095839054,64
4672,5,11953,11953,0,0,0,0,1.0,1,1.0,1,1.0,1,0.634180490661603,64
4673,3,11956,11956,0,0,0,0,1.0,1,1.0,1,1.0,1,0.6408257827580872,65
4674,3,11959,11959,0,0,0,0,1.0,1,1.0,1,1.0,1,0.6197115083212092,66
4675,1,11960,11960,0,0,0,0,1.0,1,1.0,1,1.0,1,0.6390616429124782,65
4676,3,11963,11963,0,0,0,0,1.0,1,1.0,1,1.0,1,0.6344173464390779,65
4677,1,11964,11964,0,0,0,0,1.0,1,1.0,1,1.0,1,0.639580282245867,65
4678,4,11968,11968,0,0,0,0,1.0,1,1.0,1,1.0,1,0.626497389467824,64
4679,2,11970,11970,0,0,0,0,1.0,1,1.0,1,1.0,1,0.5988503165281881,66
4680,5,11975,11975,0,0,0,0,1.0,1,1.0,1,1.0,1,0.582486564262817,67
4681,4,11979,11979,0,0,0,0,1.0,1,1.0,1,1.0,1,0.6082266004748879,67
4682,7,11986,11986,0,0,0,0,1.0,1,1.0,1,1.0,1,0.5971372652027868,67
4683,5,11991,11991,0,0,0,0,1.0,1,1.0,1,1.0,1,0.6004485398612056,67
4684,3,11994,11994,0,0,0,0,1.0,1,1.0,1,1.0,1,0.6106611449550081,66
4685,6,12000,12000,0,0,0,0,1.0,1,1.0,1,1.0,1,0.6129967404500967,65
4686,4,12004,12004,0,0,0,0,1.0,1,1.0,1,1.0,1,0.6306828805412437,65
4687,3,12007,12007,0,0,0,0,1.0,1,1.0,1,1.0,1,0.6107499268315988,65
4688,4,12011,12011,0,0,0,0,1.0,1,1.0,1,1.0,1,0.6390296224725844,64
4689,2,12013,12013,0,0,0,0,1.0,1,1.0,1,1.0,1,0.6311795631358141,65
4690,3,12016,12016,0,0,0,0,1.0,1,1.0,1,1.0,1,0.6286880119229178,63
4691,1,12017,12017,0,0,0,0,1.0,1,1.0,1,1.0,1,0.6169259789445785,64
4692,1,12018,12018,0,0,0,0,1.0,1,1.0,1,1.0,1,0.6023404608631476,63
4693,1,12019,12019,0,0,0,0,1.0,1,1.0,1,1.0,1,0.6014133096891554,64
4694,3,12022,12022,0,0,0,0,1.0,1,1.0,1,1.0,1,0.5673107392932442,63
4695,0,12022,12022,0,0,0,0,1.0,1,1.0,1,1.0,1,0.5663874078539315,62
4696,3,12025,12025,0,0,0,0,1.0,1,1.0,1,1.0,1,0.5524783643611746,61
4697,0,12025,12025,0,0,0,0,1.0,1,1.0,1,1.0,1,0.5327867880278525,63
4698,2,12027,12027,0,0,0,0,1.0,1,1.0,1,1.0,1,0.5340644514056614,63
4699,5,12032,12032,0,0,0,0,1.0,1,1.0,1,1.0,1,0.5154770049827628,65
4700,2,12034,12034,0,0,0,0,1.0,1,1.0,1,1.0,1,0.518094637547732,64
4701,5,12039,12039,0,0,0,0,1.0,1,1.0,1,1.0,1,0.5171512646712421,64
4702,2,12041,12041,0,0,0,0,1.0,1,1.0,1,1.0,1,0.5068840881193476,66
4703,7,12048,12048,0,0,0,0,1.0,1,1.0,1,1.0,1,0.4979025029972541,65
4704,4,12052,12052,0,0,0,0,1.0,1,1.0,1,1.0,1,0.5141620588678781,64
4705,6,12058,12058,0,0,0,0,1.0,1,1.0,1,1.0,1,0.5403633168568317,65
4706,7,12065,12065,0,0,0,0,1.0,1,1.0,1,1.0,1,0.5353555341515275,65
4707,5,12070,12070,0,0,0,0,1.0,1,1.0,1,1.0,1,0.5417439844483405,63
4708,5,12075,12075,0,0,0,0,1.0,1,1.0,1,1.0,1,0.5497089729949816,62
4709,4,12079,12079,0,0,0,0,1.0,1,1.0,1,1.0,1,0.5886342349691936,61
4710,2,12081,12081,0,0,0,0,1.0,1,1.0,1,1.0,1,0.6211302412766007,60
4711,2,12083,12083,0,0,0,0,1.0,1,1.0,1,1.0,1,0.621479688959631,59
4712,1,12084,12084,0,0,0,0,1.0,1,1.0,1,1.0,1,0.6142599830771862,58
4713,3,12087,12087,0,0,0,0,1.0,1,1.0,1,1.0,1,0.6229973068974858,58
4714,2,12089,12089,0,0,0,0,1.0,1,1.0,1,1.0,1,0.5999263122594064,57
4715,1,12090,12090,0,0,0,0,1.0,1,1.0,1,1.0,1,0.5985395771605974,57
4716,3,12093,12093,0,0,0,0,1.0,1,1.0,1,1.0,1,0.5882503526433001,55
4717,2,12095,12095,0,0,0,0,1.0,1,1.0,1,1.0,1,0.5834576713266876,57
4718,0,12095,12095,0,0,0,0,1.0,1,1.0,1,1.0,1,0.5859159363275219,56
4719,1,12096,12096,0,0,0,0,1.0,1,1.0,1,1.0,1,0.5877438453004661,56
4720,4,12100,12100,0,0,0,0,1.0,1,1.0,1,1.0,1,0.5934471548972551,57
4721,0,12100,12100,0,0,0,0,1.0,1,1.0,1,1.0,1,0.5934471548972551,57
4722,3,12103,12103,0,0,0,0,1.0,1,1.0,1,1.0,1,0.5837180276524242,57
4723,0,12103,12103,0,0,0,0,1.0,1,1.0,1,1.0,1,0.5841329457733576,57
4724,4,12107,12107,0,0,0,0,1.0,1,1.0,1,1.0,1,0.5685757915166372,57
4725,4,12111,12111,0,0,0,0,1.0,1,1.0,1,1.0,1,0.5835449851975303,57
4726,2,12113,12113,0,0,0,0,1.0,1,1.0,1,1.0,1,0.5860876153750479,57
4727,2,12115,12115,0,0,0,0,1.0,1,1.0,1,1.0,1,0.5740224511272436,56
4728,4,12119,12119,0,0,0,0,1.0,1,1.0,1,1.0,1,0.5413339814902474,57
4729,1,12120,12120,0,0,0,0,1.0,1,1.0,1,1.0,1,0.5434132144476528,56
4730,2,12122,12122,0,0,0,0,1.0,1,1.0,1,1.0,1,0.5204730422304189,54
4731,8,12130,12130,0,0,0,0,1.0,1,1.0,1,1.0,1,0.5409336574498926,54
4732,5,12135,12135,0,0,0,0,1.0,1,1.0,1,1.0,1,0.5342415273331854,54
4733,5,12140,12140,0,0,0,0,1.0,1,1.0,1,1.0,1,0.5369414841863533,55
4734,4,12144,12144,0,0,0,0,1.0,1,1.0,1,1.0,1,0.5618504452706016,56
4735,1,12145,12145,0,0,0,0,1.0,1,1.0,1,1.0,1,0.5647410040396174,56
4736,3,12148,12148,0,0,0,0,1.0,1,1.0,1,1.0,1,0.5630695246883495,58
4737,1,12149,12149,0,0,0,0,1.0,1,1.0,1,1.0,1,0.5500311593616348,59
4738,3,12152,12152,0,0,0,0,1.0,1,1.0,1,1.0,1,0.5647145084856338,60
4739,4,12156,12156,0,0,0,0,1.0,1,1.0,1,1.0,1,0.5505159787746894,60
4740,1,12157,12157,0,0,0,0,1.0,1,1.0,1,1.0,1,0.5613737593212955,60
4741,3,12160,12160,0,0,0,0,1.0,1,1.0,1,1.0,1,0.5615005167400501,61
4742,2,12162,12162,0,0,0,0,1.0,1,1.0,1,1.0,1,0.5940300342496647,61
4743,4,12166,12166,0,0,0,0,1.0,1,1.0,1,1.0,1,0.562993129168379,60
4744,4,12170,12170,0,0,0,0,1.0,1,1.0,1,1.0,1,0.5754154419358743,60
4745,5,12175,12175,0,0,0,0,1.0,1,1.0,1,1.0,1,0.5785906182212562,59
4746,1,12176,12176,0,0,0,0,1.0,1,1.0,1,1.0,1,0.570056356097577,59
4747,5,12181,12181,0,0,0,0,1.0,1,1.0,1,1.0,1,0.5719604925494658,58
4748,0,12181,12181,0,0,0,0,1.0,1,1.0,1,1.0,1,0.5645664644881845,58
4749,3,12184,12184,0,0,0,0,1.0,1,1.0,1,1.0,1,0.5520305346267982,58
4750,1,12185,12185,0,0,0,0,1.0,1,1.0,1,1.0,1,0.5655996660971311,56
4751,0,12185,12185,0,0,0,0,1.0,1,1.0,1,1.0,1,0.560083473921565,58
4752,1,12186,12186,0,0,0,0,1.0,1,1.0,1,1.0,1,0.5839763706558575,55
4753,0,12186,12186,0,0,0,0,1.0,1,1.0,1,1.0,1,0.5839763706558575,55
4754,3,12189,12189,0,0,0,0,1.0,1,1.0,1,1.0,1,0.5610792341708658,54
4755,2,12191,12191,0,0,0,0,1.0,1,1.0,1,1.0,1,0.5634691923842529,54
4756,4,12195,12195,0,0,0,0,1.0,1,1.0,1,1.0,1,0.5328792583783597,54
4757,4,12199,12199,0,0,0,0,1.0,1,1.0,1,1.0,1,0.5092406574137204,53
4758,6,12205,12205,0,0,0,0,1.0,1,1.0,1,1.0,1,0.47535570673025834,53
4759,5,12210,12210,0,0,0,0,1.0,1,1.0,1,1.0,1,0.48176414746819424,53
4760,8,12218,12218,0,0,0,0,1.0,1,1.0,1,1.0,1,0.5056023450095454,53
4761,8,12226,12226,0,0,0,0,1.0,1,1.0,1,1.0,1,0.5430270340814151,52
4762,4,12230,12230,0,0,0,0,1.0,1,1.0,1,1.0,1,0.5515628142790857,54
4763,8,12238,12238,0,0,0,0,1.0,1,1.0,1,1.0,1,0.5792324624302246,54
4764,3,12241,12241,0,0,0,0,1.0,1,1.0,1,1.0,1,0.5365913692644191,55
4765,6,12247,12247,0,0,0,0,1.0,1,1.0,1,1.0,1,0.5406740607753667,56
4766,1,12248,12248,0,0,0,0,1.0,1,1.0,1,1.0,1,0.5122583037613687,58
4767,1,12249,12249,0,0,0,0,1.0,1,1.0,1,1.0,1,0.5206941212917214,59
4768,0,12249,12249,0,0,0,0,1.0,1,1.0,1,1.0,1,0.5101437604098124,60
4769,1,12250,12250,0,0,0,0,1.0,1,1.0,1,1.0,1,0.5032427523063779,59
4770,0,12250,12250,0,0,0,0,1.0,1,1.0,1,1.0,1,0.5067916159228774,60
4771,0,12250,12250,0,0,0,0,1.0,1,1.0,1,1.0,1,0.5227154259368924,59
4772,0,12250,12250,0,0,0,0,1.0,1,1.0,1,1.0,1,0.5227154259368924,59
4773,2,12252,12252,0,0,0,0,1.0,1,1.0,1,1.0,1,0.5189003030915775,60
4774,1,12253,12253,0,0,0,0,1.0,1,1.0,1,1.0,1,0.5158736519243157,60
4775,2,12255,12255,0,0,0,0,1.0,1,1.0,1,1.0,1,0.5197343128080025,62
4776,2,12257,12257,0,0,0,0,1.0,1,1.0,1,1.0,1,0.5183750648510278,63
4777,2,12259,12259,0,0,0,0,1.0,1,1.0,1,1.0,1,0.5209373729248546,63
4778,2,12261,12261,0,0,0,0,1.0,1,1.0,1,1.0,1,0.4844861623169346,63
4779,6,12267,12267,0,0,0,0,1.0,1,1.0,1,1.0,1,0.4629958176596072,63
4780,2,12269,12269,0,0,0,0,1.0,1,1.0,1,1.0,1,0.47455363764072167,65
4781,8,12277,12277,0,0,0,0,1.0,1,1.0,1,1.0,1,0.45036360980150253,64
4782,4,12281,12281,0,0,0,0,1.0,1,1.0,1,1.0,1,0.4587594609528421,65
4783,7,12288,12288,0,0,0,0,1.0,1,1.0,1,1.0,1,0.48212642492429636,66
4784,8,12296,12296,0,0,0,0,1.0,1,1.0,1,1.0,1,0.5086706393926729,64
4785,6,12302,12302,0,0,0,0,1.0,1,1.0,1,1.0,1,0.4901430222791201,65
4786,8,12310,12310,0,0,0,0,1.0,1,1.0,1,1.0,1,0.5013054082803484,66
4787,9,12319,12319,0,0,0,0,1.0,1,1.0,1,1.0,1,0.5278401979282701,63
4788,8,12327,12327,0,0,0,0,1.0,1,1.0,1,1.0,1,0.5335402051003951,63
4789,8,12335,12335,0,0,0,0,1.0,1,1.0,1,1.0,1,0.5622990850531585,60
4790,6,12341,12341,0,0,0,0,1.0,1,1.0,1,1.0,1,0.5076738462594198,61
4791,6,12347,12347,0,0,0,0,1.0,1,1.0,1,1.0,1,0.5236446226797214,59
4792,5,12352,12352,0,0,0,0,1.0,1,1.0,1,1.0,1,0.5160513500269918,59
4793,6,12358,12358,0,0,0,0,1.0,1,1.0,1,1.0,1,0.5547680930869338,61
4794,2,12360,12360,0,0,0,0,1.0,1,1.0,1,1.0,1,0.5567685504596904,60
4795,0,12360,12360,0,0,0,0,1.0,1,1.0,1,1.0,1,0.5582559910759567,61
4796,3,12363,12363,0,0,0,0,1.0,1,1.0,1,1.0,1,0.5480748295138052,60
4797,0,12363,12363,0,0,0,0,1.0,1,1.0,1,1.0,1,0.5500036991190881,61
4798,1,12364,12364,0,0,0,0,1.0,1,1.0,1,1.0,1,0.5619832451887952,61
4799,4,12368,12368,0,0,0,0,1.0,1,1.0,1,1.0,1,0.5396364849458559,59
4800,0,12368,12368,0,0,0,0,1.0,1,1.0,1,1.0,1,0.5421135319029666,57
4801,0,12368,12368,0,0,0,0,1.0,1,1.0,1,1.0,1,0.5353086319697369,58
4802,3,12371,12371,0,0,0,0,1.0,1,1.0,1,1.0,1,0.5287467484874936,56
4803,1,12372,12372,0,0,0,0,1.0,1,1.0,1,1.0,1,0.5229379831906624,57
4804,1,12373,12373,0,0,0,0,1.0,1,1.0,1,1.0,1,0.5169091841269825,55
4805,3,12376,12376,0,0,0,0,1.0,1,1.0,1,1.0,1,0.5082725562030886,56
4806,0,12376,12376,0,0,0,0,1.0,1,1.0,1,1.0,1,0.5097574119054961,55
4807,3,12379,12379,0,0,0,0,1.0,1,1.0,1,1.0,1,0.5318751245907539,53
4808,3,12382,12382,0,0,0,0,1.0,1,1.0,1,1.0,1,0.5481471391298504,54
4809,3,12385,12385,0,0,0,0,1.0,1,1.0,1,1.0,1,0.5223900270917738,53
4810,2,12387,12387,0,0,0,0,1.0,1,1.0,1,1.0,1,0.5309903012110256,53
4811,5,12392,12392,0,0,0,0,1.0,1,1.0,1,1.0,1,0.5367113418211806,54
4812,1,12393,12393,0,0,0,0,1.0,1,1.0,1,1.0,1,0.5340404451472822,54
4813,6,12399,12399,0,0,0,0,1.0,1,1.0,1,1.0,1,0.5405511656054426,55
4814,5,12404,12404,0,0,0,0,1.0,1,1.0,1,1.0,1,0.5791560152871551,55
4815,4,12408,12408,0,0,0,0,1.0,1,1.0,1,1.0,1,0.5949016467362674,56
4816,1,12409,12409,0,0,0,0,1.0,1,1.0,1,1.0,1,0.5850719095233768,56
4817,3,12412,12412,0,0,0,0,1.0,1,1.0,1,1.0,1,0.5963514907778047,58
4818,5,12417,12417,0,0,0,0,1.0,1,1.0,1,1.0,1,0.5886839547287419,58
4819,3,12420,12420,0,0,0,0,1.0,1,1.0,1,1.0,1,0.5625613995511608,58
4820,1,12421,12421,0,0,0,0,1.0,1,1.0,1,1.0,1,0.5610131224295766,58
4821,4,12425,12425,0,0,0,0,1.0,1,1.0,1,1.0,1,0.5473285761641649,58
4822,2,12427,12427,0,0,0,0,1.0,1,1.0,1,1.0,1,0.55375084581107,58
4823,1,12428,12428,0,0,0,0,1.0,1,1.0,1,1.0,1,0.5561586661295598,57
4824,3,12431,12431,0,0,0,0,1.0,1,1.0,1,1.0,1,0.5850323945316457,56
4825,3,12434,12434,0,0,0,0,1.0,1,1.0,1,1.0,1,0.5745596704788087,57
4826,1,12435,12435,0,0,0,0,1.0,1,1.0,1,1.0,1,0.5860967175866979,57
4827,2,12437,12437,0,0,0,0,1.0,1,1.0,1,1.0,1,0.6023465936279592,56
4828,1,12438,12438,0,0,0,0,1.0,1,1.0,1,1.0,1,0.5615880692740202,57
4829,2,12440,12440,0,0,0,0,1.0,1,1.0,1,1.0,1,0.5696040367873463,56
4830,1,12441,12441,0,0,0,0,1.0,1,1.0,1,1.0,1,0.5537663101480675,57
4831,1,12442,12442,0,0,0,0,1.0,1,1.0,1,1.0,1,0.5776474783435824,57
4832,1,12443,12443,0,0,0,0,1.0,1,1.0,1,1.0,1,0.5996321544507041,55
4833,1,12444,12444,0,0,0,0,1.0,1,1.0,1,1.0,1,0.6041541820046719,55
4834,1,12445,12445,0,0,0,0,1.0,1,1.0,1,1.0,1,0.6226618489889962,55
4835,4,12449,12449,0,0,0,0,1.0,1,1.0,1,1.0,1,0.6456789596780245,55
4836,4,12453,12453,0,0,0,0,1.0,1,1.0,1,1.0,1,0.6732880742377808,55
4837,3,12456,12456,0,0,0,0,1.0,1,1.0,1,1.0,1,0.6580269288695132,53
4838,0,12456,12456,0,0,0,0,1.0,1,1.0,1,1.0,1,0.649098650038546,54
4839,3,12459,12459,0,0,0,0,1.0,1,1.0,1,1.0,1,0.6467286283991763,53
4840,3,12462,12462,0,0,0,0,1.0,1,1.0,1,1.0,1,0.6553960901096525,52
4841,1,12463,12463,0,0,0,0,1.0,1,1.0,1,1.0,1,0.6458300684045676,51
4842,3,12466,12466,0,0,0,0,1.0,1,1.0,1,1.0,1,0.6365959853042178,50
4843,3,12469,12469,0,0,0,0,1.0,1,1.0,1,1.0,1,0.6351349419829126,51
4844,2,12471,12471,0,0,0,0,1.0,1,1.0,1,1.0,1,0.6423309032288368,50
4845,2,12473,12473,0,0,0,0,1.0,1,1.0,1,1.0,1,0.630099645380038,49
4846,2,12475,12475,0,0,0,0,1.0,1,1.0,1,1.0,1,0.6375111315247423,49
4847,1,12476,12476,0,0,0,0,1.0,1,1.0,1,1.0,1,0.6374803646469208,48
4848,2,12478,12478,0,0,0,0,1.0,1,1.0,1,1.0,1,0.6475575551462763,48
4849,1,12479,12479,0,0,0,0,1.0,1,1.0,1,1.0,1,0.6357743209897527,48
4850,3,12482,12482,0,0,0,0,1.0,1,1.0,1,1.0,1,0.6153679969461996,49
4851,2,12484,12484,0,0,0,0,1.0,1,1.0,1,1.0,1,0.5849732368593041,49
4852,1,12485,12485,0,0,0,0,1.0,1,1.0,1,1.0,1,0.6120360830078104,49
4853,3,12488,12488,0,0,0,0,1.0,1,1.0,1,1.0,1,0.6289050384692663,50
4854,0,12488,12488,0,0,0,0,1.0,1,1.0,1,1.0,1,0.6320287260409456,51
4855,2,12490,12490,0,0,0,0,1.0,1,1.0,1,1.0,1,0.6552201718210003,51
4856,1,12491,12491,0,0,0,0,1.0,1,1.0,1,1.0,1,0.6446007407643637,50
4857,1,12492,12492,0,0,0,0,1.0,1,1.0,1,1.0,1,0.6472839353635905,51
4858,1,12493,12493,0,0,0,0,1.0,1,1.0,1,1.0,1,0.6657490067796688,51
4859,2,12495,12495,0,0,0,0,1.0,1,1.0,1,1.0,1,0.695550137474597,52
4860,4,12499,12499,0,0,0,0,1.0,1,1.0,1,1.0,1,0.673791934297782,52
4861,2,12501,12501,0,0,0,0,1.0,1,1.0,1,1.0,1,0.6752124037981193,53
4862,4,12505,12505,0,0,0,0,1.0,1,1.0,1,1.0,1,0.6598590713752077,53
4863,5,12510,12510,0,0,0,0,1.0,1,1.0,1,1.0,1,0.6622087578926652,51
4864,6,12516,12516,0,0,0,0,1.0,1,1.0,1,1.0,1,0.6653205671764311,53
4865,3,12519,12519,0,0,0,0,1.0,1,1.0,1,1.0,1,0.6672782480055741,52
4866,7,12526,12526,0,0,0,0,1.0,1,1.0,1,1.0,1,0.6446560345466211,53
4867,4,12530,12530,0,0,0,0,1.0,1,1.0,1,1.0,1,0.6524080182113748,51
4868,1,12531,12531,0,0,0,0,1.0,1,1.0,1,1.0,1,0.6234162967180318,53
4869,7,12538,12538,0,0,0,0,1.0,1,1.0,1,1.0,1,0.6072418897047146,53
4870,4,12542,12542,0,0,0,0,1.0,1,1.0,1,1.0,1,0.6112261254324031,55
4871,4,12546,12546,0,0,0,0,1.0,1,1.0,1,1.0,1,0.6238118796251554,55
4872,2,12548,12548,0,0,0,0,1.0,1,1.0,1,1.0,1,0.6411077250180652,56
4873,1,12549,12549,0,0,0,0,1.0,1,1.0,1,1.0,1,0.6488995777139479,56
4874,5,12554,12554,0,0,0,0,1.0,1,1.0,1,1.0,1,0.6559213601907404,58
4875,2,12556,12556,0,0,0,0,1.0,1,1.0,1,1.0,1,0.6319805693198824,56
4876,2,12558,12558,0,0,0,0,1.0,1,1.0,1,1.0,1,0.6312969263335538,56
4877,2,12560,12560,0,0,0,0,1.0,1,1.0,1,1.0,1,0.6327981718146175,54
4878,2,12562,12562,0,0,0,0,1.0,1,1.0,1,1.0,1,0.6346494845438179,54
4879,3,12565,12565,0,0,0,0,1.0,1,1.0,1,1.0,1,0.5978818729561869,54
4880,0,12565,12565,0,0,0,0,1.0,1,1.0,1,1.0,1,0.5755271952450657,53
4881,4,12569,12569,0,0,0,0,1.0,1,1.0,1,1.0,1,0.5877096890504845,54
4882,0,12569,12569,0,0,0,0,1.0,1,1.0,1,1.0,1,0.577179451936256,52
4883,0,12569,12569,0,0,0,0,1.0,1,1.0,1,1.0,1,0.5754573963314114,54
4884,2,12571,12571,0,0,0,0,1.0,1,1.0,1,1.0,1,0.5549773824812461,52
4885,0,12571,12571,0,0,0,0,1.0,1,1.0,1,1.0,1,0.5469136134117061,51
4886,2,12573,12573,0,0,0,0,1.0,1,1.0,1,1.0,1,0.5507582035523244,50
4887,2,12575,12575,0,0,0,0,1.0,1,1.0,1,1.0,1,0.5727956431437762,49
4888,3,12578,12578,0,0,0,0,1.0,1,1.0,1,1.0,1,0.577952030552273,48
4889,0,12578,12578,0,0,0,0,1.0,1,1.0,1,1.0,1,0.577952030552273,48
4890,1,12579,12579,0,0,0,0,1.0,1,1.0,1,1.0,1,0.5841472532522245,48
4891,0,12579,12579,0,0,0,0,1.0,1,1.0,1,1.0,1,0.5915688743120289,49
4892,2,12581,12581,0,0,0,0,1.0,1,1.0,1,1.0,1,0.6226500587904824,51
4893,0,12581,12581,0,0,0,0,1.0,1,1.0,1,1.0,1,0.623193216597319,51
4894,2,12583,12583,0,0,0,0,1.0,1,1.0,1,1.0,1,0.6370989765743007,52
4895,0,12583,12583,0,0,0,0,1.0,1,1.0,1,1.0,1,0.6370989765743007,52
4896,0,12583,12583,0,0,0,0,1.0,1,1.0,1,1.0,1,0.6398892187947224,51
4897,2,12585,12585,0,0,0,0,1.0,1,1.0,1,1.0,1,0.6215609715160354,52
4898,3,12588,12588,0,0,0,0,1.0,1,1.0,1,1.0,1,0.5895937916074256,52
4899,2,12590,12590,0,0,0,0,1.0,1,1.0,1,1.0,1,0.6079827216766146,53
4900,4,12594,12594,0,0,0,0,1.0,1,1.0,1,1.0,1,0.5950975865879619,54
4901,2,12596,12596,0,0,0,0,1.0,1,1.0,1,1.0,1,0.6059074087885721,54
4902,3,12599,12599,0,0,0,0,1.0,1,1.0,1,1.0,1,0.619421821064344,55
4903,6,12605,12605,0,0,0,0,1.0,1,1.0,1,1.0,1,0.6488239041580119,56
4904,2,12607,12607,0,0,0,0,1.0,1,1.0,1,1.0,1,0.6667075164762424,55
4905,1,12608,12608,0,0,0,0,1.0,1,1.0,1,1.0,1,0.6727068257344677,54
4906,1,12609,12609,0,0,0,0,1.0,1,1.0,1,1.0,1,0.6892882794031119,54
4907,2,12611,12611,0,0,0,0,1.0,1,1.0,1,1.0,1,0.6880693712624424,54
4908,1,12612,12612,0,0,0,0,1.0,1,1.0,1,1.0,1,0.6966374501159961,53
4909,2,12614,12614,0,0,0,0,1.0,1,1.0,1,1.0,1,0.6676824789037175,54
4910,0,12614,12614,0,0,0,0,1.0,1,1.0,1,1.0,1,0.6631173056728613,55
4911,5,12619,12619,0,0,0,0,1.0,1,1.0,1,1.0,1,0.634738417163978,57
4912,3,12622,12622,0,0,0,0,1.0,1,1.0,1,1.0,1,0.6296452382565507,57
4913,6,12628,12628,0,0,0,0,1.0,1,1.0,1,1.0,1,0.5980395372748442,56
4914,6,12634,12634,0,0,0,0,1.0,1,1.0,1,1.0,1,0.5633990362530309,56
4915,2,12636,12636,0,0,0,0,1.0,1,1.0,1,1.0,1,0.5354940221029135,56
4916,5,12641,12641,0,0,0,0,1.0,1,1.0,1,1.0,1,0.5346103232644522,54
4917,7,12648,12648,0,0,0,0,1.0,1,1.0,1,1.0,1,0.5312360472604594,53
4918,3,12651,12651,0,0,0,0,1.0,1,1.0,1,1.0,1,0.5129144827103179,52
4919,7,12658,12658,0,0,0,0,1.0,1,1.0,1,1.0,1,0.5393580638039708,49
4920,2,12660,12660,0,0,0,0,1.0,1,1.0,1,1.0,1,0.524868279449757,49
4921,2,12662,12662,0,0,0,0,1.0,1,1.0,1,1.0,1,0.5559513434979689,50
4922,3,12665,12665,0,0,0,0,1.0,1,1.0,1,1.0,1,0.5848234294090534,50
4923,2,12667,12667,0,0,0,0,1.0,1,1.0,1,1.0,1,0.600216913107725,52
4924,3,12670,12670,0,0,0,0,1.0,1,1.0,1,1.0,1,0.5978074261278621,53
4925,2,12672,12672,0,0,0,0,1.0,1,1.0,1,1.0,1,0.559033267027782,54
4926,0,12672,12672,0,0,0,0,1.0,1,1.0,1,1.0,1,0.559033267027782,54
4927,1,12673,12673,0,0,0,0,1.0,1,1.0,1,1.0,1,0.5690195980531124,54
4928,0,12673,12673,0,0,0,0,1.0,1,1.0,1,1.0,1,0.5690195980531124,54
4929,2,12675,12675,0,0,0,0,1.0,1,1.0,1,1.0,1,0.5817070717563794,55
4930,1,12676,12676,0,0,0,0,1.0,1,1.0,1,1.0,1,0.5831198500100385,58
4931,2,12678,12678,0,0,0,0,1.0,1,1.0,1,1.0,1,0.581464904250711,58
4932,3,12681,12681,0,0,0,0,1.0,1,1.0,1,1.0,1,0.558975824761625,59
4933,1,12682,12682,0,0,0,0,1.0,1,1.0,1,1.0,1,0.5596625643580307,59
4934,2,12684,12684,0,0,0,0,1.0,1,1.0,1,1.0,1,0.5802198596754362,59
4935,0,12684,12684,0,0,0,0,1.0,1,1.0,1,1.0,1,0.5802198596754362,59
4936,3,12687,12687,0,0,0,0,1.0,1,1.0,1,1.0,1,0.5712523055280893,59
4937,0,12687,12687,0,0,0,0,1.0,1,1.0,1,1.0,1,0.5611991675819132,61
4938,2,12689,12689,0,0,0,0,1.0,1,1.0,1,1.0,1,0.5519037614003458,62
4939,4,12693,12693,0,0,0,0,1.0,1,1.0,1,1.0,1,0.5182452642666754,63
4940,2,12695,12695,0,0,0,0,1.0,1,1.0,1,1.0,1,0.5435476581060714,65
4941,3,12698,12698,0,0,0,0,1.0,1,1.0,1,1.0,1,0.5224577548532988,65
4942,3,12701,12701,0,0,0,0,1.0,1,1.0,1,1.0,1,0.5547087109570342,67
4943,3,12704,12704,0,0,0,0,1.0,1,1.0,1,1.0,1,0.5571576234509259,66
4944,2,12706,12706,0,0,0,0,1.0,1,1.0,1,1.0,1,0.5758644036823107,63
4945,3,12709,12709,0,0,0,0,1.0,1,1.0,1,1.0,1,0.5923542937281351,61
4946,4,12713,12713,0,0,0,0,1.0,1,1.0,1,1.0,1,0.5907671548328924,60
4947,3,12716,12716,0,0,0,0,1.0,1,1.0,1,1.0,1,0.6098478245913215,58
4948,6,12722,12722,0,0,0,0,1.0,1,1.0,1,1.0,1,0.6481147532934118,57
4949,1,12723,12723,0,0,0,0,1.0,1,1.0,1,1.0,1,0.6494500680792302,56
4950,6,12729,12729,0,0,0,0,1.0,1,1.0,1,1.0,1,0.6300202024812656,57
4951,2,12731,12731,0,0,0,0,1.0,1,1.0,1,1.0,1,0.6202116848044353,55
4952,1,12732,12732,0,0,0,0,1.0,1,1.0,1,1.0,1,0.6244742573353289,55
4953,5,12737,12737,0,0,0,0,1.0,1,1.0,1,1.0,1,0.6374235848995627,54
4954,3,12740,12740,0,0,0,0,1.0,1,1.0,1,1.0,1,0.6356226273276135,54
4955,1,12741,12741,0,0,0,0,1.0,1,1.0,1,1.0,1,0.636656916304859,52
4956,1,12742,12742,0,0,0,0,1.0,1,1.0,1,1.0,1,0.641730987046457,52
4957,2,12744,12744,0,0,0,0,1.0,1,1.0,1,1.0,1,0.6178804448778553,53
4958,1,12745,12745,0,0,0,0,1.0,1,1.0,1,1.0,1,0.6319628151238396,52
4959,2,12747,12747,0,0,0,0,1.0,1,1.0,1,1.0,1,0.6327267037492135,51
4960,1,12748,12748,0,0,0,0,1.0,1,1.0,1,1.0,1,0.6335491296851999,53
4961,1,12749,12749,0,0,0,0,1.0,1,1.0,1,1.0,1,0.649337224162789,53
4962,3,12752,12752,0,0,0,0,1.0,1,1.0,1,1.0,1,0.6695505507523454,55
4963,2,12754,12754,0,0,0,0,1.0,1,1.0,1,1.0,1,0.6689227898169853,54
4964,6,12760,12760,0,0,0,0,1.0,1,1.0,1,1.0,1,0.6479612393327852,54
4965,6,12766,12766,0,0,0,0,1.0,1,1.0,1,1.0,1,0.6196666092534218,54
4966,3,12769,12769,0,0,0,0,1.0,1,1.0,1,1.0,1,0.6217966530326696,54
4967,8,12777,12777,0,0,0,0,1.0,1,1.0,1,1.0,1,0.5833435011690514,55
4968,2,12779,12779,0,0,0,0,1.0,1,1.0,1,1.0,1,0.5925726020778282,55
4969,7,12786,12786,0,0,0,0,1.0,1,1.0,1,1.0,1,0.5722448508315787,57
4970,2,12788,12788,0,0,0,0,1.0,1,1.0,1,1.0,1,0.5737141427568461,56
4971,5,12793,12793,0,0,0,0,1.0,1,1.0,1,1.0,1,0.5764518272896947,57
4972,2,12795,12795,0,0,0,0,1.0,1,1.0,1,1.0,1,0.58349280375038,57
4973,3,12798,12798,0,0,0,0,1.0,1,1.0,1,1.0,1,0.5924783852963004,60
4974,1,12799,12799,0,0,0,0,1.0,1,1.0,1,1.0,1,0.6165585023892471,58
4975,2,12801,12801,0,0,0,0,1.0,1,1.0,1,1.0,1,0.6400321369346967,59
4976,2,12803,12803,0,0,0,0,1.0,1,1.0,1,1.0,1,0.6395287030638567,59
4977,2,12805,12805,0,0,0,0,1.0,1,1.0,1,1.0,1,0.6393090377509144,59
4978,5,12810,12810,0,0,0,0,1.0,1,1.0,1,1.0,1,0.6100881632077423,59
4979,6,12816,12816,0,0,0,0,1.0,1,1.0,1,1.0,1,0.5862984843733594,61
4980,4,12820,12820,0,0,0,0,1.0,1,1.0,1,1.0,1,0.5818273319662208,62
4981,4,12824,12824,0,0,0,0,1.0,1,1.0,1,1.0,1,0.5679524419330333,62
4982,4,12828,12828,0,0,0,0,1.0,1,1.0,1,1.0,1,0.5652335691909435,63
4983,3,12831,12831,0,0,0,0,1.0,1,1.0,1,1.0,1,0.5527968401481038,63
4984,2,12833,12833,0,0,0,0,1.0,1,1.0,1,1.0,1,0.5837796154006596,61
4985,4,12837,12837,0,0,0,0,1.0,1,1.0,1,1.0,1,0.625561124031818,59
4986,0,12837,12837,0,0,0,0,1.0,1,1.0,1,1.0,1,0.6208847715528885,62
4987,2,12839,12839,0,0,0,0,1.0,1,1.0,1,1.0,1,0.616684122925131,60
4988,3,12842,12842,0,0,0,0,1.0,1,1.0,1,1.0,1,0.6206723963005971,59
4989,1,12843,12843,0,0,0,0,1.0,1,1.0,1,1.0,1,0.6215629780887171,57
4990,2,12845,12845,0,0,0,0,1.0,1,1.0,1,1.0,1,0.640550395759663,55
4991,1,12846,12846,0,0,0,0,1.0,1,1.0,1,1.0,1,0.6483546905282859,54
4992,3,12849,12849,0,0,0,0,1.0,1,1.0,1,1.0,1,0.6685818415166004,52
4993,4,12853,12853,0,0,0,0,1.0,1,1.0,1,1.0,1,0.6297611093737034,51
4994,4,12857,12857,0,0,0,0,1.0,1,1.0,1,1.0,1,0.6210006269920578,49
4995,2,12859,12859,0,0,0,0,1.0,1,1.0,1,1.0,1,0.6428010681160871,48
4996,3,12862,12862,0,0,0,0,1.0,1,1.0,1,1.0,1,0.6283830702059554,48
4997,1,12863,12863,0,0,0,0,1.0,1,1.0,1,1.0,1,0.6307397115883459,46
4998,5,12868,12868,0,0,0,0,1.0,1,1.0,1,1.0,1,0.59867309670197,48
4999,0,12868,12868,0,0,0,0,1.0,1,1.0,1,1.0,1,0.5991903850379806,48
5000,2,12870,12870,0,0,0,0,1.0,1,1.0,1,1.0,1,0.5898974187388735,47
5001,0,12870,12870,0,0,0,0,1.0,1,1.0,1,1.0,1,0.5849933267364462,45
5002,1,12871,12871,0,0,0,0,1.0,1,1.0,1,1.0,1,0.5932161348529716,46
5003,0,12871,12871,0,0,0,0,1.0,1,1.0,1,1.0,1,0.5937916369693708,46
5004,1,12872,12872,0,0,0,0,1.0,1,1.0,1,1.0,1,0.6100195099983686,46
5005,1,12873,12873,0,0,0,0,1.0,1,1.0,1,1.0,1,0.6431562347920021,45
5006,1,12874,12874,0,0,0,0,1.0,1,1.0,1,1.0,1,0.652418661423596,45
5007,0,12874,12874,0,0,0,0,1.0,1,1.0,1,1.0,1,0.6526840646075087,46
5008,1,12875,12875,0,0,0,0,1.0,1,1.0,1,1.0,1,0.6386902853312961,49
5009,1,12876,12876,0,0,0,0,1.0,1,1.0,1,1.0,1,0.6472494662984186,49
5010,2,12878,12878,0,0,0,0,1.0,1,1.0,1,1.0,1,0.6704244802626709,50
5011,1,12879,12879,0,0,0,0,1.0,1,1.0,1,1.0,1,0.6562044965690318,51
5012,1,12880,12880,0,0,0,0,1.0,1,1.0,1,1.0,1,0.6494360205154711,52
5013,4,12884,12884,0,0,0,0,1.0,1,1.0,1,1.0,1,0.6349904135353903,52
5014,2,12886,12886,0,0,0,0,1.0,1,1.0,1,1.0,1,0.6283934724114044,53
5015,4,12890,12890,0,0,0,0,1.0,1,1.0,1,1.0,1,0.6258622186828863,54
5016,3,12893,12893,0,0,0,0,1.0,1,1.0,1,1.0,1,0.6082825781975773,55
5017,7,12900,12900,0,0,0,0,1.0,1,1.0,1,1.0,1,0.5870504752677138,55
5018,3,12903,12903,0,0,0,0,1.0,1,1.0,1,1.0,1,0.5784020955731315,56
5019,5,12908,12908,0,0,0,0,1.0,1,1.0,1,1.0,1,0.567133026266107,56
5020,3,12911,12911,0,0,0,0,1.0,1,1.0,1,1.0,1,0.5856285185768352,55
5021,3,12914,12914,0,0,0,0,1.0,1,1.0,1,1.0,1,0.5947440795892839,56
5022,2,12916,12916,0,0,0,0,1.0,1,1.0,1,1.0,1,0.6129777596828707,56
5023,5,12921,12921,0,0,0,0,1.0,1,1.0,1,1.0,1,0.5768649715493145,55
5024,4,12925,12925,0,0,0,0,1.0,1,1.0,1,1.0,1,0.6020070323204973,55
5025,5,12930,12930,0,0,0,0,1.0,1,1.0,1,1.0,1,0.6106799597146712,53
5026,2,12932,12932,0,0,0,0,1.0,1,1.0,1,1.0,1,0.606542160303403,52
5027,5,12937,12937,0,0,0,0,1.0,1,1.0,1,1.0,1,0.6232784741947316,51
5028,1,12938,12938,0,0,0,0,1.0,1,1.0,1,1.0,1,0.6106982386789515,51
5029,6,12944,12944,0,0,0,0,1.0,1,1.0,1,1.0,1,0.6304547485926185,50
5030,2,12946,12946,0,0,0,0,1.0,1,1.0,1,1.0,1,0.5892757700171765,49
5031,5,12951,12951,0,0,0,0,1.0,1,1.0,1,1.0,1,0.6101154853172609,49
5032,1,12952,12952,0,0,0,0,1.0,1,1.0,1,1.0,1,0.613135726849928,48
5033,5,12957,12957,0,0,0,0,1.0,1,1.0,1,1.0,1,0.6281835902235908,50
5034,0,12957,12957,0,0,0,0,1.0,1,1.0,1,1.0,1,0.6074256755736166,49
5035,3,12960,12960,0,0,0,0,1.0,1,1.0,1,1.0,1,0.601079217968858,49
5036,0,12960,12960,0,0,0,0,1.0,1,1.0,1,1.0,1,0.5954484057203376,47
5037,0,12960,12960,0,0,0,0,1.0,1,1.0,1,1.0,1,0.601465830675807,47
5038,1,12961,12961,0,0,0,0,1.0,1,1.0,1,1.0,1,0.6055401237822778,47
5039,0,12961,12961,0,0,0,0,1.0,1,1.0,1,1.0,1,0.6067653497589743,48
5040,0,12961,12961,0,0,0,0,1.0,1,1.0,1,1.0,1,0.6067653497589743,48
5041,3,12964,12964,0,0,0,0,1.0,1,1.0,1,1.0,1,0.6398011788113253,48
5042,1,12965,12965,0,0,0,0,1.0,1,1.0,1,1.0,1,0.6390200573579804,50
5043,2,12967,12967,0,0,0,0,1.0,1,1.0,1,1.0,1,0.6227567882419476,51
5044,1,12968,12968,0,0,0,0,1.0,1,1.0,1,1.0,1,0.6373741431294656,51
5045,2,12970,12970,0,0,0,0,1.0,1,1.0,1,1.0,1,0.6361126345659507,52
5046,0,12970,12970,0,0,0,0,1.0,1,1.0,1,1.0,1,0.6318373248931713,51
5047,1,12971,12971,0,0,0,0,1.0,1,1.0,1,1.0,1,0.6441041155922601,51
5048,1,12972,12972,0,0,0,0,1.0,1,1.0,1,1.0,1,0.6412605249988764,52
5049,0,12972,12972,0,0,0,0,1.0,1,1.0,1,1.0,1,0.6467617804610257,54
5050,0,12972,12972,0,0,0,0,1.0,1,1.0,1,1.0,1,0.6523795960905515,56
5051,1,12973,12973,0,0,0,0,1.0,1,1.0,1,1.0,1,0.6543877533688138,55
5052,0,12973,12973,0,0,0,0,1.0,1,1.0,1,1.0,1,0.6543877533688138,55
5053,2,12975,12975,0,0,0,0,1.0,1,1.0,1,1.0,1,0.664962488548018,55
5054,2,12977,12977,0,0,0,0,1.0,1,1.0,1,1.0,1,0.6490635224189375,55
5055,1,12978,12978,0,0,0,0,1.0,1,1.0,1,1.0,1,0.6706716986198792,55
5056,3,12981,12981,0,0,0,0,1.0,1,1.0,1,1.0,1,0.6501830065994497,56
5057,1,12982,12982,0,0,0,0,1.0,1,1.0,1,1.0,1,0.6377420633009602,58
5058,2,12984,12984,0,0,0,0,1.0,1,1.0,1,1.0,1,0.6290522829075251,59
5059,5,12989,12989,0,0,0,0,1.0,1,1.0,1,1.0,1,0.6299515423630978,59
5060,5,12994,12994,0,0,0,0,1.0,1,1.0,1,1.0,1,0.6421595673727643,59
5061,3,12997,12997,0,0,0,0,1.0,1,1.0,1,1.0,1,0.6499461628088986,59
5062,5,13002,13002,0,0,0,0,1.0,1,1.0,1,1.0,1,0.6755820368460755,59
5063,3,13005,13005,0,0,0,0,1.0,1,1.0,1,1.0,1,0.6998852330091542,59
5064,4,13009,13009,0,0,0,0,1.0,1,1.0,1,1.0,1,0.7062508232666223,57
5065,4,13013,13013,0,0,0,0,1.0,1,1.0,1,1.0,1,0.6738908887384902,55
5066,3,13016,13016,0,0,0,0,1.0,1,1.0,1,1.0,1,0.6790113896627077,55
5067,6,13022,13022,0,0,0,0,1.0,1,1.0,1,1.0,1,0.6556652340857181,54
5068,3,13025,13025,0,0,0,0,1.0,1,1.0,1,1.0,1,0.6515987297786754,54
5069,3,13028,13028,0,0,0,0,1.0,1,1.0,1,1.0,1,0.6286129411215737,54
5070,2,13030,13030,0,0,0,0,1.0,1,1.0,1,1.0,1,0.6214034707424678,52
5071,3,13033,13033,0,0,0,0,1.0,1,1.0,1,1.0,1,0.593216737866183,54
5072,5,13038,13038,0,0,0,0,1.0,1,1.0,1,1.0,1,0.5969151637277818,52
5073,2,13040,13040,0,0,0,0,1.0,1,1.0,1,1.0,1,0.5875770934416213,51
5074,1,13041,13041,0,0,0,0,1.0,1,1.0,1,1.0,1,0.5725691557480029,52
5075,4,13045,13045,0,0,0,0,1.0,1,1.0,1,1.0,1,0.565133090164071,53
5076,0,13045,13045,0,0,0,0,1.0,1,1.0,1,1.0,1,0.565133090164071,53
5077,0,13045,13045,0,0,0,0,1.0,1,1.0,1,1.0,1,0.565020815120106,56
5078,0,13045,13045,0,0,0,0,1.0,1,1.0,1,1.0,1,0.5750278188274853,55
5079,0,13045,13045,0,0,0,0,1.0,1,1.0,1,1.0,1,0.5721097199264005,56
5080,1,13046,13046,0,0,0,0,1.0,1,1.0,1,1.0,1,0.5536665410456161,57
5081,2,13048,13048,0,0,0,0,1.0,1,1.0,1,1.0,1,0.5679584663167117,58
5082,0,13048,13048,0,0,0,0,1.0,1,1.0,1,1.0,1,0.5679584663167117,58
5083,3,13051,13051,0,0,0,0,1.0,1,1.0,1,1.0,1,0.586382774662768,59
5084,2,13053,13053,0,0,0,0,1.0,1,1.0,1,1.0,1,0.5949041300584622,59
5085,7,13060,13060,0,0,0,0,1.0,1,1.0,1,1.0,1,0.60841997210817,60
5086,1,13061,13061,0,0,0,0,1.0,1,1.0,1,1.0,1,0.5866138891619579,61
5087,6,13067,13067,0,0,0,0,1.0,1,1.0,1,1.0,1,0.6214587299646769,62
5088,4,13071,13071,0,0,0,0,1.0,1,1.0,1,1.0,1,0.5983024527381047,64
5089,7,13078,13078,0,0,0,0,1.0,1,1.0,1,1.0,1,0.6224259097831101,64
5090,4,13082,13082,0,0,0,0,1.0,1,1.0,1,1.0,1,0.6034822337246027,64
5091,6,13088,13088,0,0,0,0,1.0,1,1.0,1,1.0,1,0.6241128213944422,64
5092,3,13091,13091,0,0,0,0,1.0,1,1.0,1,1.0,1,0.619416961325723,64
5093,5,13096,13096,0,0,0,0,1.0,1,1.0,1,1.0,1,0.6318801890930525,64
5094,3,13099,13099,0,0,0,0,1.0,1,1.0,1,1.0,1,0.6020369179739725,65
5095,6,13105,13105,0,0,0,0,1.0,1,1.0,1,1.0,1,0.6228730735654879,66
5096,4,13109,13109,0,0,0,0,1.0,1,1.0,1,1.0,1,0.6334301904280788,66
5097,5,13114,13114,0,0,0,0,1.0,1,1.0,1,1.0,1,0.6090594634249699,67
5098,5,13119,13119,0,0,0,0,1.0,1,1.0,1,1.0,1,0.5681849624788945,67
5099,5,13124,13124,0,0,0,0,1.0,1,1.0,1,1.0,1,0.5389371915387909,70
5100,6,13130,13130,0,0,0,0,1.0,1,1.0,1,1.0,1,0.5137703380434824,71
5101,2,13132,13132,0,0,0,0,1.0,1,1.0,1,1.0,1,0.4905402461922206,72
5102,4,13136,13136,0,0,0,0,1.0,1,1.0,1,1.0,1,0.5133287698452833,72
5103,5,13141,13141,0,0,0,0,1.0,1,1.0,1,1.0,1,0.5160024809367988,70
5104,4,13145,13145,0,0,0,0,1.0,1,1.0,1,1.0,1,0.52465440746572,67
5105,4,13149,13149,0,0,0,0,1.0,1,1.0,1,1.0,1,0.5429559777043905,66
5106,3,13152,13152,0,0,0,0,1.0,1,1.0,1,1.0,1,0.5831277581322653,64
5107,5,13157,13157,0,0,0,0,1.0,1,1.0,1,1.0,1,0.5951287977126124,61
5108,3,13160,13160,0,0,0,0,1.0,1,1.0,1,1.0,1,0.6072523567407678,57
5109,3,13163,13163,0,0,0,0,1.0,1,1.0,1,1.0,1,0.6320217734052014,55
5110,2,13165,13165,0,0,0,0,1.0,1,1.0,1,1.0,1,0.640896348495177,53
5111,3,13168,13168,0,0,0,0,1.0,1,1.0,1,1.0,1,0.6482028642541694,52
5112,1,13169,13169,0,0,0,0,1.0,1,1.0,1,1.0,1,0.6360150370051761,52
5113,2,13171,13171,0,0,0,0,1.0,1,1.0,1,1.0,1,0.6368413620235052,49
5114,3,13174,13174,0,0,0,0,1.0,1,1.0,1,1.0,1,0.6514820535371312,49
5115,3,13177,13177,0,0,0,0,1.0,1,1.0,1,1.0,1,0.6286939700060845,48
5116,3,13180,13180,0,0,0,0,1.0,1,1.0,1,1.0,1,0.628385717180267,47
5117,6,13186,13186,0,0,0,0,1.0,1,1.0,1,1.0,1,0.598711438309984,48
5118,6,13192,13192,0,0,0,0,1.0,1,1.0,1,1.0,1,0.5861549474257483,49
5119,4,13196,13196,0,0,0,0,1.0,1,1.0,1,1.0,1,0.5837332710594353,49
5120,4,13200,13200,0,0,0,0,1.0,1,1.0,1,1.0,1,0.6163158132569362,48
5121,2,13202,13202,0,0,0,0,1.0,1,1.0,1,1.0,1,0.6420160490122083,48
5122,5,13207,13207,0,0,0,0,1.0,1,1.0,1,1.0,1,0.6562535009407853,46
5123,3,13210,13210,0,0,0,0,1.0,1,1.0,1,1.0,1,0.6549335793451883,46
5124,4,13214,13214,0,0,0,0,1.0,1,1.0,1,1.0,1,0.6211635992745503,47
5125,4,13218,13218,0,0,0,0,1.0,1,1.0,1,1.0,1,0.6185495693601404,49
5126,4,13222,13222,0,0,0,0,1.0,1,1.0,1,1.0,1,0.5998624321156851,49
5127,4,13226,13226,0,0,0,0,1.0,1,1.0,1,1.0,1,0.5949877767671368,51
5128,1,13227,13227,0,0,0,0,1.0,1,1.0,1,1.0,1,0.5647394252478675,53
5129,2,13229,13229,0,0,0,0,1.0,1,1.0,1,1.0,1,0.5391381774448927,55
5130,2,13231,13231,0,0,0,0,1.0,1,1.0,1,1.0,1,0.5385856435384203,55
5131,2,13233,13233,0,0,0,0,1.0,1,1.0,1,1.0,1,0.5228005395261228,55
5132,1,13234,13234,0,0,0,0,1.0,1,1.0,1,1.0,1,0.5257297004754079,55
5133,2,13236,13236,0,0,0,0,1.0,1,1.0,1,1.0,1,0.5143910698198242,56
5134,2,13238,13238,0,0,0,0,1.0,1,1.0,1,1.0,1,0.5700975478781607,56
5135,2,13240,13240,0,0,0,0,1.0,1,1.0,1,1.0,1,0.5957656491565422,56
5136,1,13241,13241,0,0,0,0,1.0,1,1.0,1,1.0,1,0.616956791361189,55
5137,1,13242,13242,0,0,0,0,1.0,1,1.0,1,1.0,1,0.6432468519181653,55
5138,3,13245,13245,0,0,0,0,1.0,1,1.0,1,1.0,1,0.6913165463126921,54
5139,5,13250,13250,0,0,0,0,1.0,1,1.0,1,1.0,1,0.6905164107483139,54
5140,1,13251,13251,0,0,0,0,1.0,1,1.0,1,1.0,1,0.6709215120054861,54
5141,4,13255,13255,0,0,0,0,1.0,1,1.0,1,1.0,1,0.6128354138796835,53
5142,3,13258,13258,0,0,0,0,1.0,1,1.0,1,1.0,1,0.5828896853118141,55
5143,3,13261,13261,0,0,0,0,1.0,1,1.0,1,1.0,1,0.5831370045075773,54
5144,2,13263,13263,0,0,0,0,1.0,1,1.0,1,1.0,1,0.6038743068945887,50
5145,3,13266,13266,0,0,0,0,1.0,1,1.0,1,1.0,1,0.6176207790010151,51
5146,5,13271,13271,0,0,0,0,1.0,1,1.0,1,1.0,1,0.600512461969824,48
5147,6,13277,13277,0,0,0,0,1.0,1,1.0,1,1.0,1,0.5844589026118413,49
5148,2,13279,13279,0,0,0,0,1.0,1,1.0,1,1.0,1,0.5926855350750487,47
5149,7,13286,13286,0,0,0,0,1.0,1,1.0,1,1.0,1,0.618469364314319,46
5150,2,13288,13288,0,0,0,0,1.0,1,1.0,1,1.0,1,0.6472605240756067,46
5151,5,13293,13293,0,0,0,0,1.0,1,1.0,1,1.0,1,0.6546187379298442,45
5152,1,13294,13294,0,0,0,0,1.0,1,1.0,1,1.0,1,0.6652790349893357,45
5153,3,13297,13297,0,0,0,0,1.0,1,1.0,1,1.0,1,0.7033855488031402,45
5154,2,13299,13299,0,0,0,0,1.0,1,1.0,1,1.0,1,0.6954729813806019,45
5155,0,13299,13299,0,0,0,0,1.0,1,1.0,1,1.0,1,0.6890359495202419,44
5156,0,13299,13299,0,0,0,0,1.0,1,1.0,1,1.0,1,0.6890961049723051,44
5157,1,13300,13300,0,0,0,0,1.0,1,1.0,1,1.0,1,0.7034119592232673,42
5158,0,13300,13300,0,0,0,0,1.0,1,1.0,1,1.0,1,0.6880020343230374,43
5159,1,13301,13301,0,0,0,0,1.0,1,1.0,1,1.0,1,0.6730924893029091,43
5160,3,13304,13304,0,0,0,0,1.0,1,1.0,1,1.0,1,0.6615358510418123,43
5161,0,13304,13304,0,0,0,0,1.0,1,1.0,1,1.0,1,0.6615358510418123,43
5162,3,13307,13307,0,0,0,0,1.0,1,1.0,1,1.0,1,0.6813240668557019,44
5163,3,13310,13310,0,0,0,0,1.0,1,1.0,1,1.0,1,0.6820594921391763,46
5164,1,13311,13311,0,0,0,0,1.0,1,1.0,1,1.0,1,0.6770313052759445,46
5165,6,13317,13317,0,0,0,0,1.0,1,1.0,1,1.0,1,0.6775240701491669,46
5166,7,13324,13324,0,0,0,0,1.0,1,1.0,1,1.0,1,0.6613945628470157,47
5167,8,13332,13332,0,0,0,0,1.0,1,1.0,1,1.0,1,0.6588169267664372,47
5168,4,13336,13336,0,0,0,0,1.0,1,1.0,1,1.0,1,0.6739513717634682,47
5169,4,13340,13340,0,0,0,0,1.0,1,1.0,1,1.0,1,0.6729832817527294,47
5170,2,13342,13342,0,0,0,0,1.0,1,1.0,1,1.0,1,0.6425251120326666,48
5171,0,13342,13342,0,0,0,0,1.0,1,1.0,1,1.0,1,0.6425251120326666,48
5172,4,13346,13346,0,0,0,0,1.0,1,1.0,1,1.0,1,0.6178140436480781,49
5173,0,13346,13346,0,0,0,0,1.0,1,1.0,1,1.0,1,0.6288381926263501,49
5174,2,13348,13348,0,0,0,0,1.0,1,1.0,1,1.0,1,0.6164105629172812,52
5175,2,13350,13350,0,0,0,0,1.0,1,1.0,1,1.0,1,0.6235008429176463,53
5176,3,13353,13353,0,0,0,0,1.0,1,1.0,1,1.0,1,0.628833465029487,54
5177,2,13355,13355,0,0,0,0,1.0,1,1.0,1,1.0,1,0.6245785784546577,54
5178,4,13359,13359,0,0,0,0,1.0,1,1.0,1,1.0,1,0.638304093531961,55
5179,5,13364,13364,0,0,0,0,1.0,1,1.0,1,1.0,1,0.6333800020931757,53
5180,5,13369,13369,0,0,0,0,1.0,1,1.0,1,1.0,1,0.6161530234384093,52
5181,1,13370,13370,0,0,0,0,1.0,1,1.0,1,1.0,1,0.6000897780264537,52
5182,5,13375,13375,0,0,0,0,1.0,1,1.0,1,1.0,1,0.6248722209822464,52
5183,1,13376,13376,0,0,0,0,1.0,1,1.0,1,1.0,1,0.6099214191160741,52
5184,3,13379,13379,0,0,0,0,1.0,1,1.0,1,1.0,1,0.6293223123378144,52
5185,1,13380,13380,0,0,0,0,1.0,1,1.0,1,1.0,1,0.6255464770712401,50
5186,2,13382,13382,0,0,0,0,1.0,1,1.0,1,1.0,1,0.6493509988619903,48
5187,1,13383,13383,0,0,0,0,1.0,1,1.0,1,1.0,1,0.666112941000566,46
5188,0,13383,13383,0,0,0,0,1.0,1,1.0,1,1.0,1,0.6682759047426677,44
5189,1,13384,13384,0,0,0,0,1.0,1,1.0,1,1.0,1,0.6574263493980923,44
5190,0,13384,13384,0,0,0,0,1.0,1,1.0,1,1.0,1,0.6524853037164136,45
5191,1,13385,13385,0,0,0,0,1.0,1,1.0,1,1.0,1,0.6642836571773157,45
5192,1,13386,13386,0,0,0,0,1.0,1,1.0,1,1.0,1,0.6761155996140644,45
5193,1,13387,13387,0,0,0,0,1.0,1,1.0,1,1.0,1,0.6827169493801215,45
5194,1,13388,13388,0,0,0,0,1.0,1,1.0,1,1.0,1,0.6968932483064704,45
5195,0,13388,13388,0,0,0,0,1.0,1,1.0,1,1.0,1,0.7022577686131032,46
5196,4,13392,13392,0,0,0,0,1.0,1,1.0,1,1.0,1,0.7217309336711314,46
5197,2,13394,13394,0,0,0,0,1.0,1,1.0,1,1.0,1,0.7244142817505902,46
5198,0,13394,13394,0,0,0,0,1.0,1,1.0,1,1.0,1,0.7138621966928426,47
5199,1,13395,13395,0,0,0,0,1.0,1,1.0,1,1.0,1,0.6980206929619239,49
5200,1,13396,13396,0,0,0,0,1.0,1,1.0,1,1.0,1,0.6893345460106494,49
5201,1,13397,13397,0,0,0,0,1.0,1,1.0,1,1.0,1,0.6760477107117246,50
5202,0,13397,13397,0,0,0,0,1.0,1,1.0,1,1.0,1,0.6637083073750412,52
5203,0,13397,13397,0,0,0,0,1.0,1,1.0,1,1.0,1,0.6637083073750412,52
5204,1,13398,13398,0,0,0,0,1.0,1,1.0,1,1.0,1,0.6464972213093905,54
5205,1,13399,13399,0,0,0,0,1.0,1,1.0,1,1.0,1,0.6548668943466119,54
5206,0,13399,13399,0,0,0,0,1.0,1,1.0,1,1.0,1,0.6585341044907429,55
5207,0,13399,13399,0,0,0,0,1.0,1,1.0,1,1.0,1,0.6662855374985939,54
5208,3,13402,13402,0,0,0,0,1.0,1,1.0,1,1.0,1,0.6643236419425638,54
5209,1,13403,13403,0,0,0,0,1.0,1,1.0,1,1.0,1,0.6692393977080917,54
5210,3,13406,13406,0,0,0,0,1.0,1,1.0,1,1.0,1,0.6510930739185143,54
5211,3,13409,13409,0,0,0,0,1.0,1,1.0,1,1.0,1,0.6660393746093648,56
5212,1,13410,13410,0,0,0,0,1.0,1,1.0,1,1.0,1,0.646200955268154,57
5213,2,13412,13412,0,0,0,0,1.0,1,1.0,1,1.0,1,0.6565147843017494,57
5214,8,13420,13420,0,0,0,0,1.0,1,1.0,1,1.0,1,0.6336879577329745,58
5215,4,13424,13424,0,0,0,0,1.0,1,1.0,1,1.0,1,0.6274637460853871,57
5216,6,13430,13430,0,0,0,0,1.0,1,1.0,1,1.0,1,0.604026077598808,57
5217,8,13438,13438,0,0,0,0,1.0,1,1.0,1,1.0,1,0.5565227382366441,56
5218,4,13442,13442,0,0,0,0,1.0,1,1.0,1,1.0,1,0.5736772475958642,56
5219,6,13448,13448,0,0,0,0,1.0,1,1.0,1,1.0,1,0.5388501516275537,54
5220,6,13454,13454,0,0,0,0,1.0,1,1.0,1,1.0,1,0.5634072321581953,53
5221,0,13454,13454,0,0,0,0,1.0,1,1.0,1,1.0,1,0.558774612988205,52
5222,3,13457,13457,0,0,0,0,1.0,1,1.0,1,1.0,1,0.5663998804749149,52
5223,7,13464,13464,0,0,0,0,1.0,1,1.0,1,1.0,1,0.5721761923428715,52
5224,3,13467,13467,0,0,0,0,1.0,1,1.0,1,1.0,1,0.5690342656621243,52
5225,0,13467,13467,0,0,0,0,1.0,1,1.0,1,1.0,1,0.5767518204000878,50
5226,2,13469,13469,0,0,0,0,1.0,1,1.0,1,1.0,1,0.5753071727876646,51
5227,3,13472,13472,0,0,0,0,1.0,1,1.0,1,1.0,1,0.5978047564109895,49
5228,4,13476,13476,0,0,0,0,1.0,1,1.0,1,1.0,1,0.6166857486866707,48
5229,2,13478,13478,0,0,0,0,1.0,1,1.0,1,1.0,1,0.5953597972754143,49
5230,2,13480,13480,0,0,0,0,1.0,1,1.0,1,1.0,1,0.6051029722283827,49
5231,2,13482,13482,0,0,0,0,1.0,1,1.0,1,1.0,1,0.6156126374153872,49
5232,1,13483,13483,0,0,0,0,1.0,1,1.0,1,1.0,1,0.6250796271913951,51
5233,3,13486,13486,0,0,0,0,1.0,1,1.0,1,1.0,1,0.6410567001030564,51
5234,1,13487,13487,0,0,0,0,1.0,1,1.0,1,1.0,1,0.637213249503597,52
5235,2,13489,13489,0,0,0,0,1.0,1,1.0,1,1.0,1,0.6390991917467166,52
5236,2,13491,13491,0,0,0,0,1.0,1,1.0,1,1.0,1,0.6144614886186347,52
5237,2,13493,13493,0,0,0,0,1.0,1,1.0,1,1.0,1,0.6193230767250574,53
5238,5,13498,13498,0,0,0,0,1.0,1,1.0,1,1.0,1,0.5921536460220934,53
5239,3,13501,13501,0,0,0,0,1.0,1,1.0,1,1.0,1,0.5884334881950378,53
5240,3,13504,13504,0,0,0,0,1.0,1,1.0,1,1.0,1,0.5799765677112476,55
5241,3,13507,13507,0,0,0,0,1.0,1,1.0,1,1.0,1,0.5657286962882492,56
5242,6,13513,13513,0,0,0,0,1.0,1,1.0,1,1.0,1,0.5484430420941977,54
5243,2,13515,13515,0,0,0,0,1.0,1,1.0,1,1.0,1,0.5355827588595045,55
5244,10,13525,13525,0,0,0,0,1.0,1,1.0,1,1.0,1,0.5588106825552668,55
5245,6,13531,13531,0,0,0,0,1.0,1,1.0,1,1.0,1,0.5696120033709187,55
5246,5,13536,13536,0,0,0,0,1.0,1,1.0,1,1.0,1,0.6074622087787459,55
5247,6,13542,13542,0,0,0,0,1.0,1,1.0,1,1.0,1,0.6394436545029378,54
5248,3,13545,13545,0,0,0,0,1.0,1,1.0,1,1.0,1,0.6540658221667225,53
5249,3,13548,13548,0,0,0,0,1.0,1,1.0,1,1.0,1,0.6193957075996102,55
5250,1,13549,13549,0,0,0,0,1.0,1,1.0,1,1.0,1,0.6080824436852467,55
5251,3,13552,13552,0,0,0,0,1.0,1,1.0,1,1.0,1,0.6194686568615787,57
5252,3,13555,13555,0,0,0,0,1.0,1,1.0,1,1.0,1,0.6088602317563978,58
5253,1,13556,13556,0,0,0,0,1.0,1,1.0,1,1.0,1,0.617009920883423,59
5254,1,13557,13557,0,0,0,0,1.0,1,1.0,1,1.0,1,0.6065620128744793,59
5255,3,13560,13560,0,0,0,0,1.0,1,1.0,1,1.0,1,0.6208010861060118,58
5256,3,13563,13563,0,0,0,0,1.0,1,1.0,1,1.0,1,0.6117267877334149,59
5257,1,13564,13564,0,0,0,0,1.0,1,1.0,1,1.0,1,0.579554742574199,58
5258,2,13566,13566,0,0,0,0,1.0,1,1.0,1,1.0,1,0.6103130891786254,56
5259,4,13570,13570,0,0,0,0,1.0,1,1.0,1,1.0,1,0.5661797275506717,56
5260,0,13570,13570,0,0,0,0,1.0,1,1.0,1,1.0,1,0.5617957826325982,55
5261,3,13573,13573,0,0,0,0,1.0,1,1.0,1,1.0,1,0.5673188418795523,54
5262,6,13579,13579,0,0,0,0,1.0,1,1.0,1,1.0,1,0.5648017281685527,54
5263,1,13580,13580,0,0,0,0,1.0,1,1.0,1,1.0,1,0.5576862750327645,53
5264,7,13587,13587,0,0,0,0,1.0,1,1.0,1,1.0,1,0.5539616753674411,51
5265,1,13588,13588,0,0,0,0,1.0,1,1.0,1,1.0,1,0.5345290245160774,50
5266,6,13594,13594,0,0,0,0,1.0,1,1.0,1,1.0,1,0.512834089067943,49
5267,5,13599,13599,0,0,0,0,1.0,1,1.0,1,1.0,1,0.5110013623782946,48
5268,4,13603,13603,0,0,0,0,1.0,1,1.0,1,1.0,1,0.5202893019265604,47
5269,5,13608,13608,0,0,0,0,1.0,1,1.0,1,1.0,1,0.5451692213172785,45
5270,4,13612,13612,0,0,0,0,1.0,1,1.0,1,1.0,1,0.5656811026734472,47
5271,5,13617,13617,0,0,0,0,1.0,1,1.0,1,1.0,1,0.5395916576717623,45
5272,5,13622,13622,0,0,0,0,1.0,1,1.0,1,1.0,1,0.6037212918502111,46
5273,5,13627,13627,0,0,0,0,1.0,1,1.0,1,1.0,1,0.605021063813856,44
5274,3,13630,13630,0,0,0,0,1.0,1,1.0,1,1.0,1,0.6331448317385372,44
5275,4,13634,13634,0,0,0,0,1.0,1,1.0,1,1.0,1,0.6065729804379243,46
5276,2,13636,13636,0,0,0,0,1.0,1,1.0,1,1.0,1,0.6229201592200461,46
5277,2,13638,13638,0,0,0,0,1.0,1,1.0,1,1.0,1,0.5974021797814542,46
5278,2,13640,13640,0,0,0,0,1.0,1,1.0,1,1.0,1,0.5364872476464865,46
5279,4,13644,13644,0,0,0,0,1.0,1,1.0,1,1.0,1,0.5608650042571665,47
5280,2,13646,13646,0,0,0,0,1.0,1,1.0,1,1.0,1,0.5784289851976732,47
5281,4,13650,13650,0,0,0,0,1.0,1,1.0,1,1.0,1,0.5994138711910748,48
5282,2,13652,13652,0,0,0,0,1.0,1,1.0,1,1.0,1,0.5932526721424489,48
5283,3,13655,13655,0,0,0,0,1.0,1,1.0,1,1.0,1,0.5906361399499681,49
5284,1,13656,13656,0,0,0,0,1.0,1,1.0,1,1.0,1,0.6096615602816948,49
5285,1,13657,13657,0,0,0,0,1.0,1,1.0,1,1.0,1,0.5812124546664666,50
5286,0,13657,13657,0,0,0,0,1.0,1,1.0,1,1.0,1,0.587279668409718,51
5287,0,13657,13657,0,0,0,0,1.0,1,1.0,1,1.0,1,0.587279668409718,51
5288,1,13658,13658,0,0,0,0,1.0,1,1.0,1,1.0,1,0.611947743596728,51
5289,1,13659,13659,0,0,0,0,1.0,1,1.0,1,1.0,1,0.5911391995690896,53
5290,1,13660,13660,0,0,0,0,1.0,1,1.0,1,1.0,1,0.6023304686635967,53
5291,2,13662,13662,0,0,0,0,1.0,1,1.0,1,1.0,1,0.6066100664408607,53
5292,2,13664,13664,0,0,0,0,1.0,1,1.0,1,1.0,1,0.5917531049179987,53
5293,2,13666,13666,0,0,0,0,1.0,1,1.0,1,1.0,1,0.5624219967130772,53
5294,2,13668,13668,0,0,0,0,1.0,1,1.0,1,1.0,1,0.5673860086044137,54
5295,2,13670,13670,0,0,0,0,1.0,1,1.0,1,1.0,1,0.543524067602456,52
5296,1,13671,13671,0,0,0,0,1.0,1,1.0,1,1.0,1,0.5501428352434196,49
5297,0,13671,13671,0,0,0,0,1.0,1,1.0,1,1.0,1,0.5574308611683613,49
5298,2,13673,13673,0,0,0,0,1.0,1,1.0,1,1.0,1,0.5314164759861704,49
5299,4,13677,13677,0,0,0,0,1.0,1,1.0,1,1.0,1,0.4874928095375795,50
5300,1,13678,13678,0,0,0,0,1.0,1,1.0,1,1.0,1,0.5001788890055586,48
5301,3,13681,13681,0,0,0,0,1.0,1,1.0,1,1.0,1,0.528718968319446,46
5302,1,13682,13682,0,0,0,0,1.0,1,1.0,1,1.0,1,0.5497248185353157,47
5303,2,13684,13684,0,0,0,0,1.0,1,1.0,1,1.0,1,0.5502521202982114,46
5304,5,13689,13689,0,0,0,0,1.0,1,1.0,1,1.0,1,0.6220785177075535,45
5305,2,13691,13691,0,0,0,0,1.0,1,1.0,1,1.0,1,0.6231989806614666,44
5306,0,13691,13691,0,0,0,0,1.0,1,1.0,1,1.0,1,0.6401034317569504,42
5307,3,13694,13694,0,0,0,0,1.0,1,1.0,1,1.0,1,0.6781604853882777,42
5308,2,13696,13696,0,0,0,0,1.0,1,1.0,1,1.0,1,0.6900888057640833,43
5309,0,13696,13696,0,0,0,0,1.0,1,1.0,1,1.0,1,0.6910879894625546,41
5310,1,13697,13697,0,0,0,0,1.0,1,1.0,1,1.0,1,0.6667887793899248,41
5311,0,13697,13697,0,0,0,0,1.0,1,1.0,1,1.0,1,0.6511306485503491,42
5312,2,13699,13699,0,0,0,0,1.0,1,1.0,1,1.0,1,0.6749698256316569,43
5313,3,13702,13702,0,0,0,0,1.0,1,1.0,1,1.0,1,0.640279828422984,44
5314,2,13704,13704,0,0,0,0,1.0,1,1.0,1,1.0,1,0.6388988772687895,44
5315,6,13710,13710,0,0,0,0,1.0,1,1.0,1,1.0,1,0.5944187828444945,45
5316,2,13712,13712,0,0,0,0,1.0,1,1.0,1,1.0,1,0.600612496230062,46
5317,5,13717,13717,0,0,0,0,1.0,1,1.0,1,1.0,1,0.569541751130072,46
5318,3,13720,13720,0,0,0,0,1.0,1,1.0,1,1.0,1,0.5280871054237986,46
5319,3,13723,13723,0,0,0,0,1.0,1,1.0,1,1.0,1,0.514270126963815,47
5320,4,13727,13727,0,0,0,0,1.0,1,1.0,1,1.0,1,0.5237064717289028,48
5321,1,13728,13728,0,0,0,0,1.0,1,1.0,1,1.0,1,0.5344244175907235,49
5322,2,13730,13730,0,0,0,0,1.0,1,1.0,1,1.0,1,0.5301210374620465,49
5323,2,13732,13732,0,0,0,0,1.0,1,1.0,1,1.0,1,0.5506885516943045,51
5324,3,13735,13735,0,0,0,0,1.0,1,1.0,1,1.0,1,0.5249112603578482,53
5325,1,13736,13736,0,0,0,0,1.0,1,1.0,1,1.0,1,0.521654675136679,53
5326,5,13741,13741,0,0,0,0,1.0,1,1.0,1,1.0,1,0.5066597046626696,53
5327,2,13743,13743,0,0,0,0,1.0,1,1.0,1,1.0,1,0.5394221808825875,53
5328,1,13744,13744,0,0,0,0,1.0,1,1.0,1,1.0,1,0.5472061879337963,54
5329,2,13746,13746,0,0,0,0,1.0,1,1.0,1,1.0,1,0.559706703132255,53
5330,4,13750,13750,0,0,0,0,1.0,1,1.0,1,1.0,1,0.5265562584316946,52
5331,3,13753,13753,0,0,0,0,1.0,1,1.0,1,1.0,1,0.5231652146913857,51
5332,1,13754,13754,0,0,0,0,1.0,1,1.0,1,1.0,1,0.5378882651284309,52
5333,2,13756,13756,0,0,0,0,1.0,1,1.0,1,1.0,1,0.5512572335721757,53
5334,0,13756,13756,0,0,0,0,1.0,1,1.0,1,1.0,1,0.5594976866468624,54
5335,0,13756,13756,0,0,0,0,1.0,1,1.0,1,1.0,1,0.5617732000414518,55
5336,4,13760,13760,0,0,0,0,1.0,1,1.0,1,1.0,1,0.6057731307509742,54
5337,0,13760,13760,0,0,0,0,1.0,1,1.0,1,1.0,1,0.6108697381172512,55
5338,1,13761,13761,0,0,0,0,1.0,1,1.0,1,1.0,1,0.6186381637950985,55
5339,3,13764,13764,0,0,0,0,1.0,1,1.0,1,1.0,1,0.6182235636399458,55
5340,1,13765,13765,0,0,0,0,1.0,1,1.0,1,1.0,1,0.6245497431444047,55
5341,3,13768,13768,0,0,0,0,1.0,1,1.0,1,1.0,1,0.6192314187416256,54
5342,3,13771,13771,0,0,0,0,1.0,1,1.0,1,1.0,1,0.6377452347059075,55
5343,5,13776,13776,0,0,0,0,1.0,1,1.0,1,1.0,1,0.638546951234793,54
5344,2,13778,13778,0,0,0,0,1.0,1,1.0,1,1.0,1,0.6399947974634134,55
5345,3,13781,13781,0,0,0,0,1.0,1,1.0,1,1.0,1,0.6489713318385009,53
5346,3,13784,13784,0,0,0,0,1.0,1,1.0,1,1.0,1,0.6748161375040324,53
5347,2,13786,13786,0,0,0,0,1.0,1,1.0,1,1.0,1,0.6713152201722478,51
5348,2,13788,13788,0,0,0,0,1.0,1,1.0,1,1.0,1,0.6884457729952358,53
5349,2,13790,13790,0,0,0,0,1.0,1,1.0,1,1.0,1,0.6853676270632654,52
5350,3,13793,13793,0,0,0,0,1.0,1,1.0,1,1.0,1,0.718876872243052,50
5351,1,13794,13794,0,0,0,0,1.0,1,1.0,1,1.0,1,0.6983667566573244,52
5352,1,13795,13795,0,0,0,0,1.0,1,1.0,1,1.0,1,0.713146569545173,49
5353,0,13795,13795,0,0,0,0,1.0,1,1.0,1,1.0,1,0.713146569545173,49
5354,4,13799,13799,0,0,0,0,1.0,1,1.0,1,1.0,1,0.7041659520056437,49
5355,0,13799,13799,0,0,0,0,1.0,1,1.0,1,1.0,1,0.7050004179534671,48
5356,3,13802,13802,0,0,0,0,1.0,1,1.0,1,1.0,1,0.6953417718231597,49
5357,1,13803,13803,0,0,0,0,1.0,1,1.0,1,1.0,1,0.7096277845392513,47
5358,3,13806,13806,0,0,0,0,1.0,1,1.0,1,1.0,1,0.6933003474364414,48
5359,2,13808,13808,0,0,0,0,1.0,1,1.0,1,1.0,1,0.6827415732594508,48
5360,3,13811,13811,0,0,0,0,1.0,1,1.0,1,1.0,1,0.6847674855278745,48
5361,1,13812,13812,0,0,0,0,1.0,1,1.0,1,1.0,1,0.6766463937965654,50
5362,1,13813,13813,0,0,0,0,1.0,1,1.0,1,1.0,1,0.6650262721039942,50
5363,1,13814,13814,0,0,0,0,1.0,1,1.0,1,1.0,1,0.6726775325401961,50
5364,1,13815,13815,0,0,0,0,1.0,1,1.0,1,1.0,1,0.6724925776595653,51
5365,0,13815,13815,0,0,0,0,1.0,1,1.0,1,1.0,1,0.6719551113783513,52
5366,4,13819,13819,0,0,0,0,1.0,1,1.0,1,1.0,1,0.6774872127034375,52
5367,4,13823,13823,0,0,0,0,1.0,1,1.0,1,1.0,1,0.6751112248169281,54
5368,4,13827,13827,0,0,0,0,1.0,1,1.0,1,1.0,1,0.6709886944088967,55
5369,6,13833,13833,0,0,0,0,1.0,1,1.0,1,1.0,1,0.6424078088414104,53
5370,4,13837,13837,0,0,0,0,1.0,1,1.0,1,1.0,1,0.6406906790723276,54
5371,6,13843,13843,0,0,0,0,1.0,1,1.0,1,1.0,1,0.6295709147763665,53
5372,6,13849,13849,0,0,0,0,1.0,1,1.0,1,1.0,1,0.6218166282221977,53
5373,5,13854,13854,0,0,0,0,1.0,1,1.0,1,1.0,1,0.623015346009435,52
5374,2,13856,13856,0,0,0,0,1.0,1,1.0,1,1.0,1,0.6249328440556924,51
5375,3,13859,13859,0,0,0,0,1.0,1,1.0,1,1.0,1,0.6051577727463165,52
5376,2,13861,13861,0,0,0,0,1.0,1,1.0,1,1.0,1,0.6134163755847574,51
5377,0,13861,13861,0,0,0,0,1.0,1,1.0,1,1.0,1,0.6144120393619965,52
5378,2,13863,13863,0,0,0,0,1.0,1,1.0,1,1.0,1,0.6419296388250518,50
5379,2,13865,13865,0,0,0,0,1.0,1,1.0,1,1.0,1,0.6386083598794394,50
5380,0,13865,13865,0,0,0,0,1.0,1,1.0,1,1.0,1,0.6369132169631442,52
5381,3,13868,13868,0,0,0,0,1.0,1,1.0,1,1.0,1,0.6216040539261306,52
5382,4,13872,13872,0,0,0,0,1.0,1,1.0,1,1.0,1,0.6214439924231654,52
5383,2,13874,13874,0,0,0,0,1.0,1,1.0,1,1.0,1,0.6100104221313649,51
5384,5,13879,13879,0,0,0,0,1.0,1,1.0,1,1.0,1,0.6461439253235529,52
5385,3,13882,13882,0,0,0,0,1.0,1,1.0,1,1.0,1,0.6356444197738194,51
5386,7,13889,13889,0,0,0,0,1.0,1,1.0,1,1.0,1,0.6279961061375335,52
5387,4,13893,13893,0,0,0,0,1.0,1,1.0,1,1.0,1,0.6046139619067328,53
5388,5,13898,13898,0,0,0,0,1.0,1,1.0,1,1.0,1,0.6394884792116837,54
5389,3,13901,13901,0,0,0,0,1.0,1,1.0,1,1.0,1,0.6058468128466747,55
5390,2,13903,13903,0,0,0,0,1.0,1,1.0,1,1.0,1,0.6244689305225496,56
5391,3,13906,13906,0,0,0,0,1.0,1,1.0,1,1.0,1,0.5993385107925474,56
5392,2,13908,13908,0,0,0,0,1.0,1,1.0,1,1.0,1,0.6168646618013898,56
5393,3,13911,13911,0,0,0,0,1.0,1,1.0,1,1.0,1,0.5946029040194667,54
5394,5,13916,13916,0,0,0,0,1.0,1,1.0,1,1.0,1,0.5820275894033043,53
5395,3,13919,13919,0,0,0,0,1.0,1,1.0,1,1.0,1,0.5825931995825763,53
5396,9,13928,13928,0,0,0,0,1.0,1,1.0,1,1.0,1,0.5872347701566235,54
5397,8,13936,13936,0,0,0,0,1.0,1,1.0,1,1.0,1,0.5794574040730742,53
5398,5,13941,13941,0,0,0,0,1.0,1,1.0,1,1.0,1,0.5634989631153263,53
5399,5,13946,13946,0,0,0,0,1.0,1,1.0,1,1.0,1,0.5410175086805776,55
5400,5,13951,13951,0,0,0,0,1.0,1,1.0,1,1.0,1,0.5564841644754058,55
5401,3,13954,13954,0,0,0,0,1.0,1,1.0,1,1.0,1,0.5443436871341109,56
5402,0,13954,13954,0,0,0,0,1.0,1,1.0,1,1.0,1,0.0,0
