,SuccessfulHandoverCount,TotalSuccessfulHandoverCount,TotalSuccessfulHandoverCountRange,TotalSuccessfulHandoverCountLoadBalancing,TotalSuccessfulHandoverCountOverload,FailedHandoverCount,TotalFailedHandoverCount,AvgQoS,MinQoS,AvgQoS_LoadBased,MinQoS_LoadBased,AvgQoS_RangeBased,MinQoS_RangeBased,GiniLoad,VehicleCount
0,0,0,0,0,0,0,0,1.0,1,1.0,1,1.0,1,0.0,0
1,21,21,0,21,0,0,0,1.0,1,1.0,1,1.0,1,0.2165790718897854,26
2,15,36,0,36,0,0,0,1.0,1,1.0,1,1.0,1,0.16846339338089764,27
3,13,49,0,49,0,0,0,1.0,1,1.0,1,1.0,1,0.22257496808157784,28
4,11,60,0,60,0,0,0,1.0,1,1.0,1,1.0,1,0.21762892822371374,29
5,13,73,0,73,0,0,0,1.0,1,1.0,1,1.0,1,0.22162179893446707,29
6,2,75,0,75,0,0,0,1.0,1,1.0,1,1.0,1,0.1836252107082231,32
7,1,76,0,76,0,0,0,1.0,1,1.0,1,1.0,1,0.12625407864712887,33
8,2,78,0,78,0,0,0,1.0,1,1.0,1,1.0,1,0.11992176565182723,35
9,1,79,0,79,0,0,0,1.0,1,1.0,1,1.0,1,0.10864095341900686,35
10,1,80,1,79,0,0,0,1.0,1,1.0,1,1.0,1,0.11163164823342792,35
11,2,82,2,80,0,0,0,1.0,1,1.0,1,1.0,1,0.11732756389769701,35
12,2,84,3,81,0,0,0,1.0,1,1.0,1,1.0,1,0.14465885451556193,34
13,1,85,4,81,0,0,0,1.0,1,1.0,1,1.0,1,0.17624277668519706,32
14,3,88,7,81,0,0,0,1.0,1,1.0,1,1.0,1,0.24383415941396122,31
15,0,88,7,81,0,0,0,1.0,1,1.0,1,1.0,1,0.25128502732310587,30
16,4,92,7,85,0,0,0,1.0,1,1.0,1,1.0,1,0.1823255531137244,30
17,0,92,7,85,0,0,0,1.0,1,1.0,1,1.0,1,0.2106512719766107,29
18,2,94,8,86,0,0,0,1.0,1,1.0,1,1.0,1,0.2539953974812235,29
19,0,94,8,86,0,0,0,1.0,1,1.0,1,1.0,1,0.2727974842385623,28
20,0,94,8,86,0,0,0,1.0,1,1.0,1,1.0,1,0.26263727882901694,28
21,4,98,9,89,0,0,0,1.0,1,1.0,1,1.0,1,0.18129992476625723,28
22,2,100,11,89,0,0,0,1.0,1,1.0,1,1.0,1,0.23549024609715685,28
23,3,103,12,91,0,0,0,1.0,1,1.0,1,1.0,1,0.21070572288231743,27
24,1,104,13,91,0,0,0,1.0,1,1.0,1,1.0,1,0.27061173048441667,28
25,8,112,15,97,0,0,0,1.0,1,1.0,1,1.0,1,0.19546409401178894,28
26,7,119,17,102,0,0,0,1.0,1,1.0,1,1.0,1,0.09776775207298845,30
27,0,119,17,102,0,0,0,1.0,1,1.0,1,1.0,1,0.09153667710160601,30
28,4,123,19,104,0,0,0,1.0,1,1.0,1,1.0,1,0.1119412013970484,31
29,2,125,20,105,0,0,0,1.0,1,1.0,1,1.0,1,0.1257986533040283,30
30,1,126,20,106,0,0,0,1.0,1,1.0,1,1.0,1,0.10513969594566779,30
31,2,128,21,107,0,0,0,1.0,1,1.0,1,1.0,1,0.11165467849503778,31
32,0,128,21,107,0,0,0,1.0,1,1.0,1,1.0,1,0.11709342574872118,31
33,1,129,22,107,0,0,0,1.0,1,1.0,1,1.0,1,0.17447557450246332,31
34,2,131,24,107,0,0,0,1.0,1,1.0,1,1.0,1,0.2480024750035373,29
35,0,131,24,107,0,0,0,1.0,1,1.0,1,1.0,1,0.22208324277221686,30
36,3,134,24,110,0,0,0,1.0,1,1.0,1,1.0,1,0.13317126924194525,30
37,4,138,24,114,0,0,0,1.0,1,1.0,1,1.0,1,0.10208212031742214,31
38,3,141,24,117,0,0,0,1.0,1,1.0,1,1.0,1,0.12878345619620454,32
39,2,143,24,119,0,0,0,1.0,1,1.0,1,1.0,1,0.06992097891419181,36
40,2,145,24,121,0,0,0,1.0,1,1.0,1,1.0,1,0.0977067821424502,37
41,2,147,24,123,0,0,0,1.0,1,1.0,1,1.0,1,0.0524231163788275,37
42,0,147,24,123,0,0,0,1.0,1,1.0,1,1.0,1,0.0581769697843392,38
43,3,150,26,124,0,0,0,1.0,1,1.0,1,1.0,1,0.13061800976623902,40
44,0,150,26,124,0,0,0,1.0,1,1.0,1,1.0,1,0.1595974088641201,39
45,1,151,27,124,0,0,0,1.0,1,1.0,1,1.0,1,0.20160349361457156,40
46,3,154,27,127,0,0,0,1.0,1,1.0,1,1.0,1,0.1141336068593192,39
47,1,155,27,128,0,0,0,1.0,1,1.0,1,1.0,1,0.13033891623049845,39
48,2,157,28,129,0,0,0,1.0,1,1.0,1,1.0,1,0.12972235905166557,39
49,3,160,30,130,0,0,0,1.0,1,1.0,1,1.0,1,0.10489838503016131,37
50,1,161,31,130,0,0,0,1.0,1,1.0,1,1.0,1,0.11182241040653007,35
51,0,161,31,130,0,0,0,1.0,1,1.0,1,1.0,1,0.09785642244533242,34
52,0,161,31,130,0,0,0,1.0,1,1.0,1,1.0,1,0.11789447981135161,34
53,0,161,31,130,0,0,0,1.0,1,1.0,1,1.0,1,0.11237273441209909,35
54,0,161,31,130,0,0,0,1.0,1,1.0,1,1.0,1,0.133447753292745,36
55,0,161,31,130,0,0,0,1.0,1,1.0,1,1.0,1,0.133447753292745,36
56,4,165,34,131,0,0,0,1.0,1,1.0,1,1.0,1,0.1271145115675282,36
57,1,166,34,132,0,0,0,1.0,1,1.0,1,1.0,1,0.11669465199806862,37
58,3,169,37,132,0,0,0,1.0,1,1.0,1,1.0,1,0.18329304633162177,38
59,2,171,39,132,0,0,0,1.0,1,1.0,1,1.0,1,0.18299689401966693,37
60,2,173,39,134,0,0,0,1.0,1,1.0,1,1.0,1,0.1325844635355734,38
61,3,176,40,136,0,0,0,1.0,1,1.0,1,1.0,1,0.13816978005045458,37
62,1,177,41,136,0,0,0,1.0,1,1.0,1,1.0,1,0.17231773405405743,39
63,1,178,42,136,0,0,0,1.0,1,1.0,1,1.0,1,0.19917995234171462,39
64,1,179,43,136,0,0,0,1.0,1,1.0,1,1.0,1,0.1978606677688511,38
65,2,181,43,138,0,0,0,1.0,1,1.0,1,1.0,1,0.16239624176639603,39
66,3,184,45,139,0,0,0,1.0,1,1.0,1,1.0,1,0.1893330174393421,39
67,0,184,45,139,0,0,0,1.0,1,1.0,1,1.0,1,0.1826041488220928,36
68,1,185,46,139,0,0,0,1.0,1,1.0,1,1.0,1,0.21761085735075342,36
69,0,185,46,139,0,0,0,1.0,1,1.0,1,1.0,1,0.22831025734752425,37
70,1,186,46,140,0,0,0,1.0,1,1.0,1,1.0,1,0.2160897083876146,36
71,1,187,46,141,0,0,0,1.0,1,1.0,1,1.0,1,0.18727311419945755,38
72,4,191,48,143,0,0,0,1.0,1,1.0,1,1.0,1,0.22631696021533065,38
73,1,192,48,144,0,0,0,1.0,1,1.0,1,1.0,1,0.1985594151965863,37
74,1,193,49,144,0,0,0,1.0,1,1.0,1,1.0,1,0.19542764467990317,38
75,0,193,49,144,0,0,0,1.0,1,1.0,1,1.0,1,0.19542764467990317,38
76,4,197,50,147,0,0,0,1.0,1,1.0,1,1.0,1,0.15081620883538602,39
77,1,198,50,148,0,0,0,1.0,1,1.0,1,1.0,1,0.14226649865440927,40
78,1,199,50,149,0,0,0,1.0,1,1.0,1,1.0,1,0.13685067658352404,41
79,0,199,50,149,0,0,0,1.0,1,1.0,1,1.0,1,0.13685067658352404,41
80,0,199,50,149,0,0,0,1.0,1,1.0,1,1.0,1,0.13685067658352404,41
81,1,200,51,149,0,0,0,1.0,1,1.0,1,1.0,1,0.1773638912102386,41
82,3,203,51,152,0,0,0,1.0,1,1.0,1,1.0,1,0.15439344330843047,44
83,0,203,51,152,0,0,0,1.0,1,1.0,1,1.0,1,0.15439344330843047,44
84,1,204,51,153,0,0,0,1.0,1,1.0,1,1.0,1,0.13655462394773057,45
85,0,204,51,153,0,0,0,1.0,1,1.0,1,1.0,1,0.13655462394773057,45
86,2,206,51,155,0,0,0,1.0,1,1.0,1,1.0,1,0.11363080998777055,45
87,1,207,52,155,0,0,0,1.0,1,1.0,1,1.0,1,0.1668470730126528,44
88,1,208,53,155,0,0,0,1.0,1,1.0,1,1.0,1,0.18423598043095282,44
89,0,208,53,155,0,0,0,1.0,1,1.0,1,1.0,1,0.1955750668651507,43
90,2,210,53,157,0,0,0,1.0,1,1.0,1,1.0,1,0.24376901259187803,44
91,4,214,54,160,0,0,0,1.0,1,1.0,1,1.0,1,0.21033804584031005,44
92,0,214,54,160,0,0,0,1.0,1,1.0,1,1.0,1,0.19537910867250163,43
93,1,215,54,161,0,0,0,1.0,1,1.0,1,1.0,1,0.19568223867864096,44
94,1,216,55,161,0,0,0,1.0,1,1.0,1,1.0,1,0.19400921228892473,44
95,0,216,55,161,0,0,0,1.0,1,1.0,1,1.0,1,0.19263059580018976,43
96,3,219,56,163,0,0,0,1.0,1,1.0,1,1.0,1,0.1354329462257035,44
97,0,219,56,163,0,0,0,1.0,1,1.0,1,1.0,1,0.1354329462257035,44
98,0,219,56,163,0,0,0,1.0,1,1.0,1,1.0,1,0.1473794268076626,43
99,0,219,56,163,0,0,0,1.0,1,1.0,1,1.0,1,0.1473794268076626,43
100,1,220,56,164,0,0,0,1.0,1,1.0,1,1.0,1,0.1436520346049666,47
101,2,222,56,166,0,0,0,1.0,1,1.0,1,1.0,1,0.12815515916005854,47
102,1,223,57,166,0,0,0,1.0,1,1.0,1,1.0,1,0.1408390840041412,47
103,2,225,59,166,0,0,0,1.0,1,1.0,1,1.0,1,0.1402745868627351,46
104,4,229,63,166,0,0,0,1.0,1,1.0,1,1.0,1,0.20483162570094915,45
105,4,233,65,168,0,0,0,1.0,1,1.0,1,1.0,1,0.17180042210742358,44
106,5,238,68,170,0,0,0,1.0,1,1.0,1,1.0,1,0.14413897585323499,45
107,2,240,69,171,0,0,0,1.0,1,1.0,1,1.0,1,0.14385704157756937,44
108,0,240,69,171,0,0,0,1.0,1,1.0,1,1.0,1,0.13914158135941582,46
109,3,243,71,172,0,0,0,1.0,1,1.0,1,1.0,1,0.10186926306061385,46
110,5,248,73,175,0,0,0,1.0,1,1.0,1,1.0,1,0.10353030803442492,46
111,2,250,75,175,0,0,0,1.0,1,1.0,1,1.0,1,0.15648095005235116,46
112,3,253,77,176,0,0,0,1.0,1,1.0,1,1.0,1,0.10257666740015144,46
113,1,254,77,177,0,0,0,1.0,1,1.0,1,1.0,1,0.0764346161667839,46
114,1,255,78,177,0,0,0,1.0,1,1.0,1,1.0,1,0.0902375999051212,46
115,2,257,79,178,0,0,0,1.0,1,1.0,1,1.0,1,0.10633884692498645,47
116,3,260,81,179,0,0,0,1.0,1,1.0,1,1.0,1,0.0989326965711487,47
117,3,263,82,181,0,0,0,1.0,1,1.0,1,1.0,1,0.10387527691170623,45
118,1,264,83,181,0,0,0,1.0,1,1.0,1,1.0,1,0.09415423132923849,46
119,2,266,83,183,0,0,0,1.0,1,1.0,1,1.0,1,0.09525214576198904,46
120,0,266,83,183,0,0,0,1.0,1,1.0,1,1.0,1,0.08770293566682727,47
121,1,267,83,184,0,0,0,1.0,1,1.0,1,1.0,1,0.092337127359728,46
122,0,267,83,184,0,0,0,1.0,1,1.0,1,1.0,1,0.092337127359728,46
123,0,267,83,184,0,0,0,1.0,1,1.0,1,1.0,1,0.11421126601023072,45
124,2,269,85,184,0,0,0,1.0,1,1.0,1,1.0,1,0.14144532156236142,46
125,0,269,85,184,0,0,0,1.0,1,1.0,1,1.0,1,0.14932158741757598,44
126,4,273,85,188,0,0,0,1.0,1,1.0,1,1.0,1,0.06714517650324156,45
127,0,273,85,188,0,0,0,1.0,1,1.0,1,1.0,1,0.05986169079284307,45
128,2,275,85,190,0,0,0,1.0,1,1.0,1,1.0,1,0.09837217343733237,46
129,4,279,86,193,0,0,0,1.0,1,1.0,1,1.0,1,0.07534649061780167,48
130,1,280,87,193,0,0,0,1.0,1,1.0,1,1.0,1,0.07528530153739678,48
131,1,281,88,193,0,0,0,1.0,1,1.0,1,1.0,1,0.09243475279717203,49
132,7,288,91,197,0,0,0,1.0,1,1.0,1,1.0,1,0.09689892544539098,51
133,1,289,92,197,0,0,0,1.0,1,1.0,1,1.0,1,0.09466702103246198,49
134,4,293,94,199,0,0,0,1.0,1,1.0,1,1.0,1,0.10764352309784653,49
135,0,293,94,199,0,0,0,1.0,1,1.0,1,1.0,1,0.12940673741138203,49
136,10,303,98,205,0,0,0,1.0,1,1.0,1,1.0,1,0.1095683335381551,48
137,1,304,99,205,0,0,0,1.0,1,1.0,1,1.0,1,0.0879706762830987,47
138,2,306,101,205,0,0,0,1.0,1,1.0,1,1.0,1,0.0857429328158614,48
139,2,308,103,205,0,0,0,1.0,1,1.0,1,1.0,1,0.1030360606503653,48
140,2,310,105,205,0,0,0,1.0,1,1.0,1,1.0,1,0.14116215900792226,49
141,5,315,107,208,0,0,0,1.0,1,1.0,1,1.0,1,0.10817840698760038,49
142,2,317,108,209,0,0,0,1.0,1,1.0,1,1.0,1,0.11133941485223163,49
143,3,320,109,211,0,0,0,1.0,1,1.0,1,1.0,1,0.13628912243630667,47
144,3,323,112,211,0,0,0,1.0,1,1.0,1,1.0,1,0.1642500954035389,46
145,3,326,113,213,0,0,0,1.0,1,1.0,1,1.0,1,0.19150097021419685,44
146,3,329,114,215,0,0,0,1.0,1,1.0,1,1.0,1,0.12620270733985856,44
147,1,330,114,216,0,0,0,1.0,1,1.0,1,1.0,1,0.09107766413373096,43
148,2,332,115,217,0,0,0,1.0,1,1.0,1,1.0,1,0.10366227005497927,43
149,1,333,116,217,0,0,0,1.0,1,1.0,1,1.0,1,0.1054374864080769,43
150,0,333,116,217,0,0,0,1.0,1,1.0,1,1.0,1,0.13394752275745678,42
151,3,336,117,219,0,0,0,1.0,1,1.0,1,1.0,1,0.12307515599051631,42
152,0,336,117,219,0,0,0,1.0,1,1.0,1,1.0,1,0.12307515599051631,42
153,1,337,117,220,0,0,0,1.0,1,1.0,1,1.0,1,0.12662344981290988,42
154,4,341,119,222,0,0,0,1.0,1,1.0,1,1.0,1,0.18363227984766956,43
155,0,341,119,222,0,0,0,1.0,1,1.0,1,1.0,1,0.16666126862634342,43
156,4,345,119,226,0,0,0,1.0,1,1.0,1,1.0,1,0.11762563765874941,42
157,1,346,119,227,0,0,0,1.0,1,1.0,1,1.0,1,0.13887855685494788,41
158,2,348,119,229,0,0,0,1.0,1,1.0,1,1.0,1,0.10787332082189739,42
159,2,350,119,231,0,0,0,1.0,1,1.0,1,1.0,1,0.11543570408067007,43
160,4,354,120,234,0,0,0,1.0,1,1.0,1,1.0,1,0.1514650719074938,44
161,3,357,121,236,0,0,0,1.0,1,1.0,1,1.0,1,0.15128589845514612,44
162,5,362,123,239,0,0,0,1.0,1,1.0,1,1.0,1,0.1932085689220686,45
163,5,367,124,243,0,0,0,1.0,1,1.0,1,1.0,1,0.23172142915481736,43
164,2,369,124,245,0,0,0,1.0,1,1.0,1,1.0,1,0.2370217082876813,42
165,7,376,127,249,0,0,0,1.0,1,1.0,1,1.0,1,0.2232282761068008,42
166,6,382,127,255,0,0,0,1.0,1,1.0,1,1.0,1,0.1514586670219032,42
167,2,384,129,255,0,0,0,1.0,1,1.0,1,1.0,1,0.17907289948764518,41
168,1,385,130,255,0,0,0,1.0,1,1.0,1,1.0,1,0.1754714676613491,40
169,1,386,130,256,0,0,0,1.0,1,1.0,1,1.0,1,0.13240174177781214,40
170,1,387,131,256,0,0,0,1.0,1,1.0,1,1.0,1,0.13720096643495164,38
171,2,389,131,258,0,0,0,1.0,1,1.0,1,1.0,1,0.09273535022949368,37
172,1,390,132,258,0,0,0,1.0,1,1.0,1,1.0,1,0.16412657595520652,35
173,3,393,134,259,0,0,0,1.0,1,1.0,1,1.0,1,0.2053778565040716,36
174,0,393,134,259,0,0,0,1.0,1,1.0,1,1.0,1,0.18545442016472813,34
175,1,394,134,260,0,0,0,1.0,1,1.0,1,1.0,1,0.23159775616699327,33
176,4,398,134,264,0,0,0,1.0,1,1.0,1,1.0,1,0.1428656879940883,34
177,1,399,134,265,0,0,0,1.0,1,1.0,1,1.0,1,0.11951749237028907,36
178,1,400,134,266,0,0,0,1.0,1,1.0,1,1.0,1,0.1305739637177871,37
179,0,400,134,266,0,0,0,1.0,1,1.0,1,1.0,1,0.1305739637177871,37
180,0,400,134,266,0,0,0,1.0,1,1.0,1,1.0,1,0.15182311920414687,36
181,0,400,134,266,0,0,0,1.0,1,1.0,1,1.0,1,0.15182311920414687,36
182,1,401,135,266,0,0,0,1.0,1,1.0,1,1.0,1,0.15994456828486214,38
183,1,402,136,266,0,0,0,1.0,1,1.0,1,1.0,1,0.17348306955519321,37
184,4,406,138,268,0,0,0,1.0,1,1.0,1,1.0,1,0.19811948597944945,36
185,3,409,139,270,0,0,0,1.0,1,1.0,1,1.0,1,0.14756733490601845,35
186,6,415,141,274,0,0,0,1.0,1,1.0,1,1.0,1,0.1358339132794075,34
187,0,415,141,274,0,0,0,1.0,1,1.0,1,1.0,1,0.1470196290714017,33
188,0,415,141,274,0,0,0,1.0,1,1.0,1,1.0,1,0.15036726920231544,33
189,3,418,144,274,0,0,0,1.0,1,1.0,1,1.0,1,0.2436766726396119,33
190,2,420,145,275,0,0,0,1.0,1,1.0,1,1.0,1,0.2773053896680938,32
191,7,427,145,282,0,0,0,1.0,1,1.0,1,1.0,1,0.14979796594168568,34
192,0,427,145,282,0,0,0,1.0,1,1.0,1,1.0,1,0.14979796594168568,34
193,3,430,145,285,0,0,0,1.0,1,1.0,1,1.0,1,0.1541864907274736,35
194,3,433,146,287,0,0,0,1.0,1,1.0,1,1.0,1,0.1633057381818911,37
195,1,434,146,288,0,0,0,1.0,1,1.0,1,1.0,1,0.14550489511546533,36
196,1,435,146,289,0,0,0,1.0,1,1.0,1,1.0,1,0.12675531287768638,36
197,1,436,146,290,0,0,0,1.0,1,1.0,1,1.0,1,0.13766310007331403,37
198,1,437,147,290,0,0,0,1.0,1,1.0,1,1.0,1,0.15493224352000895,37
199,2,439,148,291,0,0,0,1.0,1,1.0,1,1.0,1,0.1502865963758621,37
200,3,442,149,293,0,0,0,1.0,1,1.0,1,1.0,1,0.1735690069194773,37
201,1,443,149,294,0,0,0,1.0,1,1.0,1,1.0,1,0.1486369401973887,36
202,2,445,150,295,0,0,0,1.0,1,1.0,1,1.0,1,0.11100120493463782,36
203,2,447,152,295,0,0,0,1.0,1,1.0,1,1.0,1,0.1821745311326054,35
204,2,449,152,297,0,0,0,1.0,1,1.0,1,1.0,1,0.21425300970047417,35
205,4,453,154,299,0,0,0,1.0,1,1.0,1,1.0,1,0.27996584589451917,35
206,6,459,156,303,0,0,0,1.0,1,1.0,1,1.0,1,0.16196673459954228,34
207,1,460,156,304,0,0,0,1.0,1,1.0,1,1.0,1,0.1399865822094165,34
208,2,462,157,305,0,0,0,1.0,1,1.0,1,1.0,1,0.17694337169918312,33
209,1,463,157,306,0,0,0,1.0,1,1.0,1,1.0,1,0.20260651743683972,33
210,3,466,158,308,0,0,0,1.0,1,1.0,1,1.0,1,0.22152528120195822,34
211,4,470,159,311,0,0,0,1.0,1,1.0,1,1.0,1,0.2202206801107063,33
212,4,474,159,315,0,0,0,1.0,1,1.0,1,1.0,1,0.14728409110333637,33
213,2,476,160,316,0,0,0,1.0,1,1.0,1,1.0,1,0.12152478652365856,35
214,0,476,160,316,0,0,0,1.0,1,1.0,1,1.0,1,0.14764054227061235,34
215,1,477,161,316,0,0,0,1.0,1,1.0,1,1.0,1,0.1799671936601328,35
216,4,481,162,319,0,0,0,1.0,1,1.0,1,1.0,1,0.12049963058667224,36
217,3,484,163,321,0,0,0,1.0,1,1.0,1,1.0,1,0.11156956817110225,36
218,4,488,165,323,0,0,0,1.0,1,1.0,1,1.0,1,0.1251297747074415,36
219,0,488,165,323,0,0,0,1.0,1,1.0,1,1.0,1,0.10390783844172108,37
220,7,495,166,329,0,0,0,1.0,1,1.0,1,1.0,1,0.12085233932406521,38
221,0,495,166,329,0,0,0,1.0,1,1.0,1,1.0,1,0.13072535528393395,37
222,2,497,167,330,0,0,0,1.0,1,1.0,1,1.0,1,0.10816296600091276,38
223,2,499,169,330,0,0,0,1.0,1,1.0,1,1.0,1,0.1644853410452844,38
224,3,502,171,331,0,0,0,1.0,1,1.0,1,1.0,1,0.18268227311480625,38
225,1,503,172,331,0,0,0,1.0,1,1.0,1,1.0,1,0.17362460451316677,36
226,7,510,173,337,0,0,0,1.0,1,1.0,1,1.0,1,0.1505190361115635,37
227,4,514,173,341,0,0,0,1.0,1,1.0,1,1.0,1,0.1123630351179374,35
228,3,517,173,344,0,0,0,1.0,1,1.0,1,1.0,1,0.11260838448071876,35
229,5,522,174,348,0,0,0,1.0,1,1.0,1,1.0,1,0.18234770837546493,35
230,4,526,176,350,0,0,0,1.0,1,1.0,1,1.0,1,0.21078130849294827,35
231,5,531,176,355,0,0,0,1.0,1,1.0,1,1.0,1,0.09568252659939053,35
232,2,533,177,356,0,0,0,1.0,1,1.0,1,1.0,1,0.14814406708323746,36
233,1,534,177,357,0,0,0,1.0,1,1.0,1,1.0,1,0.1140582515043319,36
234,1,535,178,357,0,0,0,1.0,1,1.0,1,1.0,1,0.19738426811717869,34
235,2,537,180,357,0,0,0,1.0,1,1.0,1,1.0,1,0.26078194002925925,33
236,0,537,180,357,0,0,0,1.0,1,1.0,1,1.0,1,0.24237788728548953,31
237,0,537,180,357,0,0,0,1.0,1,1.0,1,1.0,1,0.26630662321645715,32
238,1,538,180,358,0,0,0,1.0,1,1.0,1,1.0,1,0.2423156200142992,31
239,3,541,182,359,0,0,0,1.0,1,1.0,1,1.0,1,0.2519521391554029,30
240,1,542,183,359,0,0,0,1.0,1,1.0,1,1.0,1,0.22896201399393437,27
241,3,545,184,361,0,0,0,1.0,1,1.0,1,1.0,1,0.18961654394946792,27
242,3,548,184,364,0,0,0,1.0,1,1.0,1,1.0,1,0.19780858304105195,28
243,0,548,184,364,0,0,0,1.0,1,1.0,1,1.0,1,0.19780858304105195,28
244,2,550,185,365,0,0,0,1.0,1,1.0,1,1.0,1,0.22468244852235125,27
245,4,554,187,367,0,0,0,1.0,1,1.0,1,1.0,1,0.287854734254034,27
246,5,559,189,370,0,0,0,1.0,1,1.0,1,1.0,1,0.23832465006494946,25
247,0,559,189,370,0,0,0,1.0,1,1.0,1,1.0,1,0.23015747240008733,24
248,0,559,189,370,0,0,0,1.0,1,1.0,1,1.0,1,0.22763679796782657,24
249,0,559,189,370,0,0,0,1.0,1,1.0,1,1.0,1,0.23412551401516246,25
250,3,562,189,373,0,0,0,1.0,1,1.0,1,1.0,1,0.16585703063966467,27
251,1,563,189,374,0,0,0,1.0,1,1.0,1,1.0,1,0.12186386861090856,27
252,0,563,189,374,0,0,0,1.0,1,1.0,1,1.0,1,0.12186386861090856,27
253,1,564,189,375,0,0,0,1.0,1,1.0,1,1.0,1,0.0957128356309262,29
254,2,566,191,375,0,0,0,1.0,1,1.0,1,1.0,1,0.09698978274819839,30
255,1,567,192,375,0,0,0,1.0,1,1.0,1,1.0,1,0.1313062415107068,31
256,2,569,194,375,0,0,0,1.0,1,1.0,1,1.0,1,0.1538696702176078,31
257,1,570,194,376,0,0,0,1.0,1,1.0,1,1.0,1,0.15522965248884307,33
258,1,571,195,376,0,0,0,1.0,1,1.0,1,1.0,1,0.15658639889626247,33
259,0,571,195,376,0,0,0,1.0,1,1.0,1,1.0,1,0.15658639889626247,33
260,3,574,196,378,0,0,0,1.0,1,1.0,1,1.0,1,0.23476527839271408,35
261,3,577,197,380,0,0,0,1.0,1,1.0,1,1.0,1,0.14803898453493772,35
262,2,579,199,380,0,0,0,1.0,1,1.0,1,1.0,1,0.21835402474337676,35
263,0,579,199,380,0,0,0,1.0,1,1.0,1,1.0,1,0.19733739000998543,34
264,2,581,201,380,0,0,0,1.0,1,1.0,1,1.0,1,0.29149351201735435,32
265,3,584,203,381,0,0,0,1.0,1,1.0,1,1.0,1,0.22201533140604762,30
266,3,587,205,382,0,0,0,1.0,1,1.0,1,1.0,1,0.18109958282973626,31
267,1,588,206,382,0,0,0,1.0,1,1.0,1,1.0,1,0.18521845066266127,30
268,2,590,207,383,0,0,0,1.0,1,1.0,1,1.0,1,0.21309820033716434,31
269,1,591,208,383,0,0,0,1.0,1,1.0,1,1.0,1,0.24626222044532164,31
270,3,594,209,385,0,0,0,1.0,1,1.0,1,1.0,1,0.2735223131341193,32
271,6,600,210,390,0,0,0,1.0,1,1.0,1,1.0,1,0.18388782520902663,31
272,2,602,211,391,0,0,0,1.0,1,1.0,1,1.0,1,0.26151453463499125,32
273,1,603,211,392,0,0,0,1.0,1,1.0,1,1.0,1,0.24899428447761338,32
274,0,603,211,392,0,0,0,1.0,1,1.0,1,1.0,1,0.24899428447761338,32
275,1,604,212,392,0,0,0,1.0,1,1.0,1,1.0,1,0.24964775842158832,33
276,5,609,214,395,0,0,0,1.0,1,1.0,1,1.0,1,0.2330366177256089,34
277,4,613,215,398,0,0,0,1.0,1,1.0,1,1.0,1,0.19716874571098625,32
278,1,614,215,399,0,0,0,1.0,1,1.0,1,1.0,1,0.16702267666606288,31
279,2,616,216,400,0,0,0,1.0,1,1.0,1,1.0,1,0.15312663180645145,31
280,3,619,217,402,0,0,0,1.0,1,1.0,1,1.0,1,0.1331673444176034,30
281,0,619,217,402,0,0,0,1.0,1,1.0,1,1.0,1,0.11337313537607198,31
282,0,619,217,402,0,0,0,1.0,1,1.0,1,1.0,1,0.12488101318720883,30
283,0,619,217,402,0,0,0,1.0,1,1.0,1,1.0,1,0.15381062139681137,31
284,0,619,217,402,0,0,0,1.0,1,1.0,1,1.0,1,0.15381062139681137,31
285,0,619,217,402,0,0,0,1.0,1,1.0,1,1.0,1,0.15381062139681137,31
286,0,619,217,402,0,0,0,1.0,1,1.0,1,1.0,1,0.15381062139681137,31
287,4,623,219,404,0,0,0,1.0,1,1.0,1,1.0,1,0.20392159288135464,33
288,3,626,219,407,0,0,0,1.0,1,1.0,1,1.0,1,0.18489693455071649,32
289,2,628,220,408,0,0,0,1.0,1,1.0,1,1.0,1,0.26935288166933297,32
290,0,628,220,408,0,0,0,1.0,1,1.0,1,1.0,1,0.25799150155777795,31
291,3,631,220,411,0,0,0,1.0,1,1.0,1,1.0,1,0.16469193908789717,30
292,1,632,221,411,0,0,0,1.0,1,1.0,1,1.0,1,0.1627805758904101,32
293,0,632,221,411,0,0,0,1.0,1,1.0,1,1.0,1,0.1627805758904101,32
294,0,632,221,411,0,0,0,1.0,1,1.0,1,1.0,1,0.1627805758904101,32
295,4,636,222,414,0,0,0,1.0,1,1.0,1,1.0,1,0.13418976710027314,34
296,1,637,222,415,0,0,0,1.0,1,1.0,1,1.0,1,0.12215161000084021,34
297,1,638,223,415,0,0,0,1.0,1,1.0,1,1.0,1,0.11183529168126508,34
298,0,638,223,415,0,0,0,1.0,1,1.0,1,1.0,1,0.13532459766280694,35
299,0,638,223,415,0,0,0,1.0,1,1.0,1,1.0,1,0.15913923423253615,35
300,1,639,224,415,0,0,0,1.0,1,1.0,1,1.0,1,0.1702086607822638,35
301,6,645,224,421,0,0,0,1.0,1,1.0,1,1.0,1,0.15760893890551886,38
302,1,646,225,421,0,0,0,1.0,1,1.0,1,1.0,1,0.16321767036370438,38
303,2,648,227,421,0,0,0,1.0,1,1.0,1,1.0,1,0.19515249610190843,37
304,6,654,228,426,0,0,0,1.0,1,1.0,1,1.0,1,0.223387487503327,37
305,4,658,229,429,0,0,0,1.0,1,1.0,1,1.0,1,0.22862555982340665,36
306,7,665,230,435,0,0,0,1.0,1,1.0,1,1.0,1,0.15409048635095143,36
307,2,667,230,437,0,0,0,1.0,1,1.0,1,1.0,1,0.1466597417596205,35
308,6,673,231,442,0,0,0,1.0,1,1.0,1,1.0,1,0.18710052225285856,37
309,2,675,231,444,0,0,0,1.0,1,1.0,1,1.0,1,0.15405733232480534,37
310,3,678,231,447,0,0,0,1.0,1,1.0,1,1.0,1,0.1708131551875788,37
311,2,680,231,449,0,0,0,1.0,1,1.0,1,1.0,1,0.13904623417823825,39
312,1,681,232,449,0,0,0,1.0,1,1.0,1,1.0,1,0.1437569608886014,40
313,0,681,232,449,0,0,0,1.0,1,1.0,1,1.0,1,0.1294308576427297,39
314,1,682,233,449,0,0,0,1.0,1,1.0,1,1.0,1,0.13551178071654701,40
315,1,683,234,449,0,0,0,1.0,1,1.0,1,1.0,1,0.1586970500834184,39
316,2,685,235,450,0,0,0,1.0,1,1.0,1,1.0,1,0.17253858895940258,39
317,3,688,235,453,0,0,0,1.0,1,1.0,1,1.0,1,0.13584750558449316,40
318,1,689,236,453,0,0,0,1.0,1,1.0,1,1.0,1,0.1595628720182835,41
319,1,690,236,454,0,0,0,1.0,1,1.0,1,1.0,1,0.1337932414319028,41
320,0,690,236,454,0,0,0,1.0,1,1.0,1,1.0,1,0.13386754557277664,41
321,0,690,236,454,0,0,0,1.0,1,1.0,1,1.0,1,0.13386754557277664,41
322,2,692,238,454,0,0,0,1.0,1,1.0,1,1.0,1,0.1483178854292433,41
323,1,693,238,455,0,0,0,1.0,1,1.0,1,1.0,1,0.11042615240865,41
324,1,694,239,455,0,0,0,1.0,1,1.0,1,1.0,1,0.13196794185675234,42
325,1,695,240,455,0,0,0,1.0,1,1.0,1,1.0,1,0.14860613350665558,42
326,6,701,241,460,0,0,0,1.0,1,1.0,1,1.0,1,0.08288014163459032,42
327,1,702,242,460,0,0,0,1.0,1,1.0,1,1.0,1,0.08043791616338762,42
328,4,706,243,463,0,0,0,1.0,1,1.0,1,1.0,1,0.063584058839724,43
329,0,706,243,463,0,0,0,1.0,1,1.0,1,1.0,1,0.063584058839724,43
330,0,706,243,463,0,0,0,1.0,1,1.0,1,1.0,1,0.07233238576138651,45
331,1,707,244,463,0,0,0,1.0,1,1.0,1,1.0,1,0.09163422563587559,45
332,0,707,244,463,0,0,0,1.0,1,1.0,1,1.0,1,0.0865617256727403,45
333,2,709,245,464,0,0,0,1.0,1,1.0,1,1.0,1,0.10963648095157032,46
334,2,711,246,465,0,0,0,1.0,1,1.0,1,1.0,1,0.11732090819170084,48
335,2,713,246,467,0,0,0,1.0,1,1.0,1,1.0,1,0.11590822913744125,48
336,1,714,246,468,0,0,0,1.0,1,1.0,1,1.0,1,0.10271702849527344,48
337,0,714,246,468,0,0,0,1.0,1,1.0,1,1.0,1,0.11759220919774585,49
338,2,716,247,469,0,0,0,1.0,1,1.0,1,1.0,1,0.09514757960542618,50
339,0,716,247,469,0,0,0,1.0,1,1.0,1,1.0,1,0.09514757960542618,50
340,0,716,247,469,0,0,0,1.0,1,1.0,1,1.0,1,0.09514757960542618,50
341,2,718,247,471,0,0,0,1.0,1,1.0,1,1.0,1,0.06297027318608837,51
342,1,719,248,471,0,0,0,1.0,1,1.0,1,1.0,1,0.07884574259001147,51
343,1,720,249,471,0,0,0,1.0,1,1.0,1,1.0,1,0.08833164036045413,51
344,0,720,249,471,0,0,0,1.0,1,1.0,1,1.0,1,0.10989673144465167,50
345,0,720,249,471,0,0,0,1.0,1,1.0,1,1.0,1,0.12056531071996553,51
346,1,721,249,472,0,0,0,1.0,1,1.0,1,1.0,1,0.11165493818261299,51
347,3,724,252,472,0,0,0,1.0,1,1.0,1,1.0,1,0.12472052861202443,51
348,5,729,254,475,0,0,0,1.0,1,1.0,1,1.0,1,0.13892461558929528,53
349,4,733,256,477,0,0,0,1.0,1,1.0,1,1.0,1,0.10254407057324301,55
350,1,734,256,478,0,0,0,1.0,1,1.0,1,1.0,1,0.12305064264860399,54
351,4,738,259,479,0,0,0,1.0,1,1.0,1,1.0,1,0.1374580545981894,54
352,2,740,260,480,0,0,0,1.0,1,1.0,1,1.0,1,0.12247810581014909,53
353,5,745,262,483,0,0,0,1.0,1,1.0,1,1.0,1,0.12889355173246222,53
354,1,746,262,484,0,0,0,1.0,1,1.0,1,1.0,1,0.09035957973970997,50
355,2,748,263,485,0,0,0,1.0,1,1.0,1,1.0,1,0.0991445111292534,51
356,3,751,264,487,0,0,0,1.0,1,1.0,1,1.0,1,0.10358999025643154,51
357,1,752,265,487,0,0,0,1.0,1,1.0,1,1.0,1,0.0953401865043612,50
358,2,754,266,488,0,0,0,1.0,1,1.0,1,1.0,1,0.11059255319239103,48
359,2,756,267,489,0,0,0,1.0,1,1.0,1,1.0,1,0.10332392285594082,47
360,1,757,268,489,0,0,0,1.0,1,1.0,1,1.0,1,0.17168987956015744,45
361,3,760,269,491,0,0,0,1.0,1,1.0,1,1.0,1,0.1590237836226429,44
362,2,762,269,493,0,0,0,1.0,1,1.0,1,1.0,1,0.17209758692393173,44
363,1,763,270,493,0,0,0,1.0,1,1.0,1,1.0,1,0.1607069312819625,44
364,3,766,271,495,0,0,0,1.0,1,1.0,1,1.0,1,0.15394385769362445,43
365,2,768,272,496,0,0,0,1.0,1,1.0,1,1.0,1,0.15249182072985665,43
366,3,771,273,498,0,0,0,1.0,1,1.0,1,1.0,1,0.11286561139720477,45
367,1,772,274,498,0,0,0,1.0,1,1.0,1,1.0,1,0.16097085353683221,44
368,2,774,275,499,0,0,0,1.0,1,1.0,1,1.0,1,0.14756332798376953,46
369,3,777,276,501,0,0,0,1.0,1,1.0,1,1.0,1,0.1574003651547108,45
370,3,780,276,504,0,0,0,1.0,1,1.0,1,1.0,1,0.1682305114148105,46
371,4,784,276,508,0,0,0,1.0,1,1.0,1,1.0,1,0.16976711891908372,47
372,3,787,276,511,0,0,0,1.0,1,1.0,1,1.0,1,0.13706820367469547,48
373,0,787,276,511,0,0,0,1.0,1,1.0,1,1.0,1,0.13706820367469547,48
374,3,790,277,513,0,0,0,1.0,1,1.0,1,1.0,1,0.14871778247685707,49
375,3,793,277,516,0,0,0,1.0,1,1.0,1,1.0,1,0.1541911801198887,49
376,3,796,278,518,0,0,0,1.0,1,1.0,1,1.0,1,0.15086546116076754,49
377,1,797,279,518,0,0,0,1.0,1,1.0,1,1.0,1,0.17481129682285793,49
378,4,801,280,521,0,0,0,1.0,1,1.0,1,1.0,1,0.11766525793324208,49
379,2,803,281,522,0,0,0,1.0,1,1.0,1,1.0,1,0.12063277418380562,50
380,1,804,282,522,0,0,0,1.0,1,1.0,1,1.0,1,0.13947578790264775,50
381,7,811,284,527,0,0,0,1.0,1,1.0,1,1.0,1,0.10497305583812537,51
382,1,812,284,528,0,0,0,1.0,1,1.0,1,1.0,1,0.10855736032223137,50
383,1,813,285,528,0,0,0,1.0,1,1.0,1,1.0,1,0.14640515815664285,51
384,3,816,287,529,0,0,0,1.0,1,1.0,1,1.0,1,0.11577702730426938,50
385,2,818,288,530,0,0,0,1.0,1,1.0,1,1.0,1,0.13905835526943675,50
386,1,819,288,531,0,0,0,1.0,1,1.0,1,1.0,1,0.09880420469234495,48
387,1,820,288,532,0,0,0,1.0,1,1.0,1,1.0,1,0.09276949399789074,47
388,3,823,289,534,0,0,0,1.0,1,1.0,1,1.0,1,0.06222483172624463,48
389,0,823,289,534,0,0,0,1.0,1,1.0,1,1.0,1,0.07901325482733332,47
390,3,826,291,535,0,0,0,1.0,1,1.0,1,1.0,1,0.06026823832802484,49
391,3,829,293,536,0,0,0,1.0,1,1.0,1,1.0,1,0.07366822470994965,46
392,1,830,293,537,0,0,0,1.0,1,1.0,1,1.0,1,0.08775673255431816,46
393,4,834,296,538,0,0,0,1.0,1,1.0,1,1.0,1,0.1531599015441733,44
394,0,834,296,538,0,0,0,1.0,1,1.0,1,1.0,1,0.14033139700009273,43
395,1,835,297,538,0,0,0,1.0,1,1.0,1,1.0,1,0.1945182016243919,42
396,4,839,299,540,0,0,0,1.0,1,1.0,1,1.0,1,0.2330435181106209,39
397,2,841,300,541,0,0,0,1.0,1,1.0,1,1.0,1,0.28059442211629015,39
398,1,842,300,542,0,0,0,1.0,1,1.0,1,1.0,1,0.24424438803796888,36
399,0,842,300,542,0,0,0,1.0,1,1.0,1,1.0,1,0.24424438803796888,36
400,3,845,302,543,0,0,0,1.0,1,1.0,1,1.0,1,0.2552999617547022,34
401,5,850,303,547,0,0,0,1.0,1,1.0,1,1.0,1,0.1535382599635713,33
402,1,851,303,548,0,0,0,1.0,1,1.0,1,1.0,1,0.12347299765061548,34
403,1,852,303,549,0,0,0,1.0,1,1.0,1,1.0,1,0.16277366526899845,36
404,0,852,303,549,0,0,0,1.0,1,1.0,1,1.0,1,0.16277366526899845,36
405,2,854,304,550,0,0,0,1.0,1,1.0,1,1.0,1,0.19876727286198054,37
406,2,856,304,552,0,0,0,1.0,1,1.0,1,1.0,1,0.15344502898,37
407,3,859,304,555,0,0,0,1.0,1,1.0,1,1.0,1,0.1370156779086669,39
408,8,867,306,561,0,0,0,1.0,1,1.0,1,1.0,1,0.14848646756911257,40
409,9,876,308,568,0,0,0,1.0,1,1.0,1,1.0,1,0.21205404425062283,41
410,13,889,310,579,0,0,0,1.0,1,1.0,1,1.0,1,0.2662340317002705,42
411,5,894,310,584,0,0,0,1.0,1,1.0,1,1.0,1,0.18873153363336462,43
412,6,900,311,589,0,0,0,1.0,1,1.0,1,1.0,1,0.2108965357364289,44
413,4,904,311,593,0,0,0,1.0,1,1.0,1,1.0,1,0.2108965357364289,44
414,6,910,311,599,0,0,0,1.0,1,1.0,1,1.0,1,0.18421663767502885,45
415,3,913,311,602,0,0,0,1.0,1,1.0,1,1.0,1,0.15363875579131048,45
416,0,913,311,602,0,0,0,1.0,1,1.0,1,1.0,1,0.15936476759170157,46
417,1,914,312,602,0,0,0,1.0,1,1.0,1,1.0,1,0.1618604999077415,46
418,1,915,312,603,0,0,0,1.0,1,1.0,1,1.0,1,0.14599145730041405,47
419,0,915,312,603,0,0,0,1.0,1,1.0,1,1.0,1,0.14599145730041405,47
420,0,915,312,603,0,0,0,1.0,1,1.0,1,1.0,1,0.14599145730041405,47
421,0,915,312,603,0,0,0,1.0,1,1.0,1,1.0,1,0.14599145730041405,47
422,1,916,313,603,0,0,0,1.0,1,1.0,1,1.0,1,0.15954186902324494,49
423,1,917,314,603,0,0,0,1.0,1,1.0,1,1.0,1,0.1747128260833491,47
424,5,922,317,605,0,0,0,1.0,1,1.0,1,1.0,1,0.18825406453482807,45
425,3,925,317,608,0,0,0,1.0,1,1.0,1,1.0,1,0.1582508656756221,46
426,4,929,319,610,0,0,0,1.0,1,1.0,1,1.0,1,0.16309704746472747,46
427,4,933,321,612,0,0,0,1.0,1,1.0,1,1.0,1,0.16913133061916596,45
428,3,936,322,614,0,0,0,1.0,1,1.0,1,1.0,1,0.1661077613920379,45
429,4,940,324,616,0,0,0,1.0,1,1.0,1,1.0,1,0.1482368812125656,42
430,0,940,324,616,0,0,0,1.0,1,1.0,1,1.0,1,0.14114457257307514,40
431,7,947,327,620,0,0,0,1.0,1,1.0,1,1.0,1,0.11353976718739824,39
432,1,948,328,620,0,0,0,1.0,1,1.0,1,1.0,1,0.14053340183672244,37
433,2,950,330,620,0,0,0,1.0,1,1.0,1,1.0,1,0.16836731542588368,35
434,1,951,331,620,0,0,0,1.0,1,1.0,1,1.0,1,0.18020604614582583,33
435,0,951,331,620,0,0,0,1.0,1,1.0,1,1.0,1,0.18020604614582583,33
436,4,955,332,623,0,0,0,1.0,1,1.0,1,1.0,1,0.11326512041551065,33
437,0,955,332,623,0,0,0,1.0,1,1.0,1,1.0,1,0.08558440304881675,33
438,0,955,332,623,0,0,0,1.0,1,1.0,1,1.0,1,0.1120352866212708,32
439,0,955,332,623,0,0,0,1.0,1,1.0,1,1.0,1,0.06899180566708024,34
440,4,959,334,625,0,0,0,1.0,1,1.0,1,1.0,1,0.10950321251660508,34
441,0,959,334,625,0,0,0,1.0,1,1.0,1,1.0,1,0.12455662046239235,35
442,3,962,335,627,0,0,0,1.0,1,1.0,1,1.0,1,0.12890120034571956,37
443,4,966,338,628,0,0,0,1.0,1,1.0,1,1.0,1,0.1628881678424937,37
444,2,968,338,630,0,0,0,1.0,1,1.0,1,1.0,1,0.1763303147052826,38
445,6,974,340,634,0,0,0,1.0,1,1.0,1,1.0,1,0.2329355664161583,39
446,4,978,341,637,0,0,0,1.0,1,1.0,1,1.0,1,0.18923392791381083,39
447,4,982,342,640,0,0,0,1.0,1,1.0,1,1.0,1,0.20143015865376793,41
448,0,982,342,640,0,0,0,1.0,1,1.0,1,1.0,1,0.20143015865376793,41
449,0,982,342,640,0,0,0,1.0,1,1.0,1,1.0,1,0.22655814383220912,40
450,1,983,342,641,0,0,0,1.0,1,1.0,1,1.0,1,0.2485732202518136,40
451,2,985,342,643,0,0,0,1.0,1,1.0,1,1.0,1,0.20329024725494343,41
452,2,987,342,645,0,0,0,1.0,1,1.0,1,1.0,1,0.16411532936513035,41
453,0,987,342,645,0,0,0,1.0,1,1.0,1,1.0,1,0.1754094360848269,40
454,1,988,342,646,0,0,0,1.0,1,1.0,1,1.0,1,0.1654930925807207,41
455,5,993,344,649,0,0,0,1.0,1,1.0,1,1.0,1,0.16628699425690388,41
456,5,998,344,654,0,0,0,1.0,1,1.0,1,1.0,1,0.07909245292648091,43
457,3,1001,345,656,0,0,0,1.0,1,1.0,1,1.0,1,0.0941927587893954,43
458,2,1003,345,658,0,0,0,1.0,1,1.0,1,1.0,1,0.07957508287380984,43
459,1,1004,345,659,0,0,0,1.0,1,1.0,1,1.0,1,0.1072981182434132,44
460,2,1006,345,661,0,0,0,1.0,1,1.0,1,1.0,1,0.07480479983469507,47
461,0,1006,345,661,0,0,0,1.0,1,1.0,1,1.0,1,0.08048213091495782,48
462,3,1009,347,662,0,0,0,1.0,1,1.0,1,1.0,1,0.14001009790752106,49
463,1,1010,347,663,0,0,0,1.0,1,1.0,1,1.0,1,0.08169954535730947,47
464,4,1014,350,664,0,0,0,1.0,1,1.0,1,1.0,1,0.0912711994850259,48
465,1,1015,351,664,0,0,0,1.0,1,1.0,1,1.0,1,0.07504855929713754,47
466,3,1018,354,664,0,0,0,1.0,1,1.0,1,1.0,1,0.08712389990983524,46
467,1,1019,355,664,0,0,0,1.0,1,1.0,1,1.0,1,0.11584496050627188,44
468,3,1022,357,665,0,0,0,1.0,1,1.0,1,1.0,1,0.12021925598812068,41
469,1,1023,358,665,0,0,0,1.0,1,1.0,1,1.0,1,0.09719256144061159,40
470,3,1026,360,666,0,0,0,1.0,1,1.0,1,1.0,1,0.1782785182205395,39
471,6,1032,363,669,0,0,0,1.0,1,1.0,1,1.0,1,0.18183846459453193,38
472,4,1036,366,670,0,0,0,1.0,1,1.0,1,1.0,1,0.2630380688521139,36
473,5,1041,367,674,0,0,0,1.0,1,1.0,1,1.0,1,0.2585848242270438,36
474,1,1042,368,674,0,0,0,1.0,1,1.0,1,1.0,1,0.29372763270282976,34
475,2,1044,369,675,0,0,0,1.0,1,1.0,1,1.0,1,0.2766026835102426,34
476,3,1047,369,678,0,0,0,1.0,1,1.0,1,1.0,1,0.21585064386397287,32
477,1,1048,370,678,0,0,0,1.0,1,1.0,1,1.0,1,0.2695089373102568,32
478,0,1048,370,678,0,0,0,1.0,1,1.0,1,1.0,1,0.23515770721382187,30
479,1,1049,371,678,0,0,0,1.0,1,1.0,1,1.0,1,0.24637024613873224,31
480,1,1050,371,679,0,0,0,1.0,1,1.0,1,1.0,1,0.24976059314492524,27
481,2,1052,371,681,0,0,0,1.0,1,1.0,1,1.0,1,0.18169373073083966,28
482,1,1053,371,682,0,0,0,1.0,1,1.0,1,1.0,1,0.16500879626257053,28
483,3,1056,372,684,0,0,0,1.0,1,1.0,1,1.0,1,0.12896009501792444,29
484,0,1056,372,684,0,0,0,1.0,1,1.0,1,1.0,1,0.12896009501792444,29
485,2,1058,372,686,0,0,0,1.0,1,1.0,1,1.0,1,0.11688091877579958,29
486,2,1060,373,687,0,0,0,1.0,1,1.0,1,1.0,1,0.09658029901331854,31
487,2,1062,373,689,0,0,0,1.0,1,1.0,1,1.0,1,0.0968088772178223,33
488,1,1063,374,689,0,0,0,1.0,1,1.0,1,1.0,1,0.09162691316015602,34
489,2,1065,375,690,0,0,0,1.0,1,1.0,1,1.0,1,0.12486901464896034,34
490,3,1068,375,693,0,0,0,1.0,1,1.0,1,1.0,1,0.13111108119108253,34
491,1,1069,376,693,0,0,0,1.0,1,1.0,1,1.0,1,0.17465212266517455,34
492,0,1069,376,693,0,0,0,1.0,1,1.0,1,1.0,1,0.17465212266517455,34
493,4,1073,377,696,0,0,0,1.0,1,1.0,1,1.0,1,0.15150434252676187,34
494,2,1075,379,696,0,0,0,1.0,1,1.0,1,1.0,1,0.21049132315175093,36
495,0,1075,379,696,0,0,0,1.0,1,1.0,1,1.0,1,0.21049132315175093,36
496,3,1078,379,699,0,0,0,1.0,1,1.0,1,1.0,1,0.1275587625838529,37
497,3,1081,380,701,0,0,0,1.0,1,1.0,1,1.0,1,0.11526398932159392,39
498,3,1084,381,703,0,0,0,1.0,1,1.0,1,1.0,1,0.15035528013926916,40
499,3,1087,381,706,0,0,0,1.0,1,1.0,1,1.0,1,0.12214483079116133,40
500,8,1095,381,714,0,0,0,1.0,1,1.0,1,1.0,1,0.13276931426510288,42
501,1,1096,381,715,0,0,0,1.0,1,1.0,1,1.0,1,0.12080499173647041,42
502,2,1098,383,715,0,0,0,1.0,1,1.0,1,1.0,1,0.21389467013155716,42
503,2,1100,384,716,0,0,0,1.0,1,1.0,1,1.0,1,0.2020491456647342,41
504,3,1103,386,717,0,0,0,1.0,1,1.0,1,1.0,1,0.24280443070085486,42
505,0,1103,386,717,0,0,0,1.0,1,1.0,1,1.0,1,0.25888795183375307,38
506,7,1110,386,724,0,0,0,1.0,1,1.0,1,1.0,1,0.14502563434726676,37
507,1,1111,387,724,0,0,0,1.0,1,1.0,1,1.0,1,0.1761841686406997,35
508,4,1115,390,725,0,0,0,1.0,1,1.0,1,1.0,1,0.19926717396100438,35
509,3,1118,391,727,0,0,0,1.0,1,1.0,1,1.0,1,0.19043661398460635,34
510,3,1121,392,729,0,0,0,1.0,1,1.0,1,1.0,1,0.17027667459221044,34
511,3,1124,394,730,0,0,0,1.0,1,1.0,1,1.0,1,0.1744774078105933,32
512,2,1126,395,731,0,0,0,1.0,1,1.0,1,1.0,1,0.18665285685100128,30
513,1,1127,395,732,0,0,0,1.0,1,1.0,1,1.0,1,0.14431896527458324,31
514,1,1128,395,733,0,0,0,1.0,1,1.0,1,1.0,1,0.1297185352920553,31
515,1,1129,395,734,0,0,0,1.0,1,1.0,1,1.0,1,0.1450431845581426,32
516,1,1130,395,735,0,0,0,1.0,1,1.0,1,1.0,1,0.11339623474366474,31
517,3,1133,397,736,0,0,0,1.0,1,1.0,1,1.0,1,0.08851536679410352,32
518,0,1133,397,736,0,0,0,1.0,1,1.0,1,1.0,1,0.08615802510305755,31
519,1,1134,398,736,0,0,0,1.0,1,1.0,1,1.0,1,0.1278024430892587,31
520,1,1135,398,737,0,0,0,1.0,1,1.0,1,1.0,1,0.13929417348900022,33
521,3,1138,398,740,0,0,0,1.0,1,1.0,1,1.0,1,0.05992478129983117,34
522,2,1140,400,740,0,0,0,1.0,1,1.0,1,1.0,1,0.09870231400723475,34
523,0,1140,400,740,0,0,0,1.0,1,1.0,1,1.0,1,0.0827085740375529,33
524,1,1141,400,741,0,0,0,1.0,1,1.0,1,1.0,1,0.09192185147762048,34
525,0,1141,400,741,0,0,0,1.0,1,1.0,1,1.0,1,0.10274926035755239,32
526,2,1143,402,741,0,0,0,1.0,1,1.0,1,1.0,1,0.16695353727636986,32
527,4,1147,403,744,0,0,0,1.0,1,1.0,1,1.0,1,0.1492112678627427,31
528,1,1148,404,744,0,0,0,1.0,1,1.0,1,1.0,1,0.17327866473297115,31
529,0,1148,404,744,0,0,0,1.0,1,1.0,1,1.0,1,0.18426771349435467,30
530,1,1149,405,744,0,0,0,1.0,1,1.0,1,1.0,1,0.18784352450925054,30
531,1,1150,405,745,0,0,0,1.0,1,1.0,1,1.0,1,0.1882154130785396,32
532,3,1153,407,746,0,0,0,1.0,1,1.0,1,1.0,1,0.18530665216876674,32
533,1,1154,407,747,0,0,0,1.0,1,1.0,1,1.0,1,0.16003571757899304,34
534,1,1155,408,747,0,0,0,1.0,1,1.0,1,1.0,1,0.16179610793608226,34
535,2,1157,409,748,0,0,0,1.0,1,1.0,1,1.0,1,0.21242498655553893,37
536,2,1159,409,750,0,0,0,1.0,1,1.0,1,1.0,1,0.19221708126873926,37
537,2,1161,411,750,0,0,0,1.0,1,1.0,1,1.0,1,0.27472592325632644,37
538,3,1164,411,753,0,0,0,1.0,1,1.0,1,1.0,1,0.2367189981645913,38
539,2,1166,411,755,0,0,0,1.0,1,1.0,1,1.0,1,0.24058140426032132,38
540,0,1166,411,755,0,0,0,1.0,1,1.0,1,1.0,1,0.24058140426032132,38
541,0,1166,411,755,0,0,0,1.0,1,1.0,1,1.0,1,0.22722297898839153,39
542,2,1168,412,756,0,0,0,1.0,1,1.0,1,1.0,1,0.19542852155832724,40
543,1,1169,413,756,0,0,0,1.0,1,1.0,1,1.0,1,0.23510612652560373,37
544,5,1174,415,759,0,0,0,1.0,1,1.0,1,1.0,1,0.25225876758104654,35
545,1,1175,416,759,0,0,0,1.0,1,1.0,1,1.0,1,0.21133935004721627,35
546,7,1182,420,762,0,0,0,1.0,1,1.0,1,1.0,1,0.18764892109372436,35
547,3,1185,421,764,0,0,0,1.0,1,1.0,1,1.0,1,0.15436092346532898,34
548,2,1187,423,764,0,0,0,1.0,1,1.0,1,1.0,1,0.24842189936810918,34
549,3,1190,425,765,0,0,0,1.0,1,1.0,1,1.0,1,0.3185959377803256,31
550,2,1192,425,767,0,0,0,1.0,1,1.0,1,1.0,1,0.2672294524597857,30
551,3,1195,426,769,0,0,0,1.0,1,1.0,1,1.0,1,0.2240954833739175,31
552,1,1196,426,770,0,0,0,1.0,1,1.0,1,1.0,1,0.12706656076647943,29
553,1,1197,426,771,0,0,0,1.0,1,1.0,1,1.0,1,0.10762032562543776,30
554,1,1198,426,772,0,0,0,1.0,1,1.0,1,1.0,1,0.08107021819813329,30
555,1,1199,426,773,0,0,0,1.0,1,1.0,1,1.0,1,0.10869171790393871,30
556,2,1201,427,774,0,0,0,1.0,1,1.0,1,1.0,1,0.12402871983188045,31
557,0,1201,427,774,0,0,0,1.0,1,1.0,1,1.0,1,0.16008674218946534,31
558,0,1201,427,774,0,0,0,1.0,1,1.0,1,1.0,1,0.16008674218946534,31
559,1,1202,428,774,0,0,0,1.0,1,1.0,1,1.0,1,0.12097789415618346,31
560,1,1203,428,775,0,0,0,1.0,1,1.0,1,1.0,1,0.0978157716933375,32
561,3,1206,429,777,0,0,0,1.0,1,1.0,1,1.0,1,0.1196554697148097,33
562,0,1206,429,777,0,0,0,1.0,1,1.0,1,1.0,1,0.1196554697148097,33
563,3,1209,431,778,0,0,0,1.0,1,1.0,1,1.0,1,0.17799026267558013,33
564,0,1209,431,778,0,0,0,1.0,1,1.0,1,1.0,1,0.1839889246458655,34
565,0,1209,431,778,0,0,0,1.0,1,1.0,1,1.0,1,0.18477319924834215,35
566,3,1212,432,780,0,0,0,1.0,1,1.0,1,1.0,1,0.1246193015726479,36
567,3,1215,435,780,0,0,0,1.0,1,1.0,1,1.0,1,0.17219183233314325,37
568,8,1223,438,785,0,0,0,1.0,1,1.0,1,1.0,1,0.24045657087061184,36
569,2,1225,438,787,0,0,0,1.0,1,1.0,1,1.0,1,0.23194743580153,37
570,2,1227,438,789,0,0,0,1.0,1,1.0,1,1.0,1,0.21956513666518368,38
571,3,1230,439,791,0,0,0,1.0,1,1.0,1,1.0,1,0.19194726842876317,38
572,2,1232,439,793,0,0,0,1.0,1,1.0,1,1.0,1,0.15242177329698045,39
573,0,1232,439,793,0,0,0,1.0,1,1.0,1,1.0,1,0.15242177329698045,39
574,0,1232,439,793,0,0,0,1.0,1,1.0,1,1.0,1,0.1626512816439471,41
575,3,1235,440,795,0,0,0,1.0,1,1.0,1,1.0,1,0.15889590785430005,41
576,3,1238,440,798,0,0,0,1.0,1,1.0,1,1.0,1,0.08420494577198015,42
577,0,1238,440,798,0,0,0,1.0,1,1.0,1,1.0,1,0.08420494577198015,42
578,0,1238,440,798,0,0,0,1.0,1,1.0,1,1.0,1,0.08153794097106676,41
579,0,1238,440,798,0,0,0,1.0,1,1.0,1,1.0,1,0.09155059407314502,42
580,3,1241,442,799,0,0,0,1.0,1,1.0,1,1.0,1,0.15874435401703557,43
581,6,1247,446,801,0,0,0,1.0,1,1.0,1,1.0,1,0.1544996797798983,42
582,4,1251,447,804,0,0,0,1.0,1,1.0,1,1.0,1,0.14486354654969888,41
583,4,1255,449,806,0,0,0,1.0,1,1.0,1,1.0,1,0.11149322153533579,40
584,1,1256,450,806,0,0,0,1.0,1,1.0,1,1.0,1,0.1855495593253857,38
585,4,1260,452,808,0,0,0,1.0,1,1.0,1,1.0,1,0.15543499020836873,38
586,5,1265,454,811,0,0,0,1.0,1,1.0,1,1.0,1,0.07433335132306047,37
587,4,1269,457,812,0,0,0,1.0,1,1.0,1,1.0,1,0.10345203557083525,35
588,1,1270,458,812,0,0,0,1.0,1,1.0,1,1.0,1,0.10390190559009184,35
589,0,1270,458,812,0,0,0,1.0,1,1.0,1,1.0,1,0.10313692168852852,34
590,2,1272,459,813,0,0,0,1.0,1,1.0,1,1.0,1,0.13569241419472985,36
591,2,1274,459,815,0,0,0,1.0,1,1.0,1,1.0,1,0.1320473694527994,35
592,5,1279,461,818,0,0,0,1.0,1,1.0,1,1.0,1,0.1646797491003883,37
593,3,1282,462,820,0,0,0,1.0,1,1.0,1,1.0,1,0.12955992556740342,36
594,3,1285,463,822,0,0,0,1.0,1,1.0,1,1.0,1,0.16170459416237953,35
595,1,1286,464,822,0,0,0,1.0,1,1.0,1,1.0,1,0.17642530764820133,34
596,4,1290,465,825,0,0,0,1.0,1,1.0,1,1.0,1,0.1684824059992824,34
597,1,1291,466,825,0,0,0,1.0,1,1.0,1,1.0,1,0.20867143215699363,33
598,0,1291,466,825,0,0,0,1.0,1,1.0,1,1.0,1,0.22602659482208176,33
599,3,1294,468,826,0,0,0,1.0,1,1.0,1,1.0,1,0.227448212195017,33
600,4,1298,469,829,0,0,0,1.0,1,1.0,1,1.0,1,0.18854440636706613,33
601,3,1301,470,831,0,0,0,1.0,1,1.0,1,1.0,1,0.12834041155620884,34
602,1,1302,470,832,0,0,0,1.0,1,1.0,1,1.0,1,0.12361858410064047,35
603,0,1302,470,832,0,0,0,1.0,1,1.0,1,1.0,1,0.1514065163485256,35
604,0,1302,470,832,0,0,0,1.0,1,1.0,1,1.0,1,0.15039141177373758,35
605,1,1303,470,833,0,0,0,1.0,1,1.0,1,1.0,1,0.15487580671879295,35
606,1,1304,470,834,0,0,0,1.0,1,1.0,1,1.0,1,0.16617298217282075,35
607,1,1305,471,834,0,0,0,1.0,1,1.0,1,1.0,1,0.19887542968490382,35
608,3,1308,471,837,0,0,0,1.0,1,1.0,1,1.0,1,0.1789202427999773,36
609,3,1311,472,839,0,0,0,1.0,1,1.0,1,1.0,1,0.15658737826092708,37
610,0,1311,472,839,0,0,0,1.0,1,1.0,1,1.0,1,0.15658737826092708,37
611,3,1314,473,841,0,0,0,1.0,1,1.0,1,1.0,1,0.10553259715297555,39
612,0,1314,473,841,0,0,0,1.0,1,1.0,1,1.0,1,0.10553259715297555,39
613,1,1315,474,841,0,0,0,1.0,1,1.0,1,1.0,1,0.1293568230365117,39
614,2,1317,475,842,0,0,0,1.0,1,1.0,1,1.0,1,0.17340480479080195,39
615,1,1318,475,843,0,0,0,1.0,1,1.0,1,1.0,1,0.16633032145744175,39
616,7,1325,476,849,0,0,0,1.0,1,1.0,1,1.0,1,0.10135269690086793,38
617,0,1325,476,849,0,0,0,1.0,1,1.0,1,1.0,1,0.11221400584687202,39
618,1,1326,477,849,0,0,0,1.0,1,1.0,1,1.0,1,0.15363154945770316,40
619,2,1328,477,851,0,0,0,1.0,1,1.0,1,1.0,1,0.1040359105239132,39
620,0,1328,477,851,0,0,0,1.0,1,1.0,1,1.0,1,0.09608777837461151,38
621,3,1331,479,852,0,0,0,1.0,1,1.0,1,1.0,1,0.1255139469986066,38
622,1,1332,480,852,0,0,0,1.0,1,1.0,1,1.0,1,0.10915217312897167,38
623,2,1334,482,852,0,0,0,1.0,1,1.0,1,1.0,1,0.1560474808672231,37
624,4,1338,484,854,0,0,0,1.0,1,1.0,1,1.0,1,0.1929894178249244,33
625,1,1339,485,854,0,0,0,1.0,1,1.0,1,1.0,1,0.15101747482074812,32
626,6,1345,488,857,0,0,0,1.0,1,1.0,1,1.0,1,0.13960468896227576,31
627,2,1347,489,858,0,0,0,1.0,1,1.0,1,1.0,1,0.186862212706964,30
628,3,1350,490,860,0,0,0,1.0,1,1.0,1,1.0,1,0.22321477483711885,32
629,3,1353,491,862,0,0,0,1.0,1,1.0,1,1.0,1,0.24510992954843489,29
630,1,1354,491,863,0,0,0,1.0,1,1.0,1,1.0,1,0.2349231229167396,29
631,2,1356,493,863,0,0,0,1.0,1,1.0,1,1.0,1,0.2813102942669275,25
632,0,1356,493,863,0,0,0,1.0,1,1.0,1,1.0,1,0.28195559432590317,24
633,1,1357,494,863,0,0,0,1.0,1,1.0,1,1.0,1,0.2625202681129439,23
634,0,1357,494,863,0,0,0,1.0,1,1.0,1,1.0,1,0.2625202681129439,23
635,3,1360,495,865,0,0,0,1.0,1,1.0,1,1.0,1,0.15095882386869694,22
636,0,1360,495,865,0,0,0,1.0,1,1.0,1,1.0,1,0.20494073481021505,22
637,1,1361,496,865,0,0,0,1.0,1,1.0,1,1.0,1,0.19443276525577727,23
638,1,1362,497,865,0,0,0,1.0,1,1.0,1,1.0,1,0.2481705107201568,23
639,2,1364,497,867,0,0,0,1.0,1,1.0,1,1.0,1,0.27094670494529116,24
640,2,1366,498,868,0,0,0,1.0,1,1.0,1,1.0,1,0.2986865527740513,24
641,5,1371,498,873,0,0,0,1.0,1,1.0,1,1.0,1,0.2698611581888054,25
642,1,1372,498,874,0,0,0,1.0,1,1.0,1,1.0,1,0.14892822267393407,26
643,3,1375,498,877,0,0,0,1.0,1,1.0,1,1.0,1,0.14527392216176263,28
644,3,1378,498,880,0,0,0,1.0,1,1.0,1,1.0,1,0.13725159543837495,28
645,5,1383,498,885,0,0,0,1.0,1,1.0,1,1.0,1,0.1561739539167274,28
646,2,1385,498,887,0,0,0,1.0,1,1.0,1,1.0,1,0.12521232912208208,29
647,5,1390,500,890,0,0,0,1.0,1,1.0,1,1.0,1,0.23752639045540508,30
648,3,1393,500,893,0,0,0,1.0,1,1.0,1,1.0,1,0.22455264056272478,30
649,6,1399,501,898,0,0,0,1.0,1,1.0,1,1.0,1,0.23291924741579345,31
650,3,1402,501,901,0,0,0,1.0,1,1.0,1,1.0,1,0.1996486879422415,31
651,4,1406,503,903,0,0,0,1.0,1,1.0,1,1.0,1,0.1569734956840355,32
652,0,1406,503,903,0,0,0,1.0,1,1.0,1,1.0,1,0.1569734956840355,32
653,1,1407,503,904,0,0,0,1.0,1,1.0,1,1.0,1,0.12356871850167504,33
654,1,1408,503,905,0,0,0,1.0,1,1.0,1,1.0,1,0.11859617366500512,33
655,2,1410,504,906,0,0,0,1.0,1,1.0,1,1.0,1,0.12886868318243277,36
656,5,1415,506,909,0,0,0,1.0,1,1.0,1,1.0,1,0.13242049312533669,36
657,1,1416,507,909,0,0,0,1.0,1,1.0,1,1.0,1,0.16935456512468702,35
658,0,1416,507,909,0,0,0,1.0,1,1.0,1,1.0,1,0.21787196881073895,33
659,3,1419,509,910,0,0,0,1.0,1,1.0,1,1.0,1,0.23620515559176822,35
660,1,1420,509,911,0,0,0,1.0,1,1.0,1,1.0,1,0.23594976645679694,34
661,4,1424,510,914,0,0,0,1.0,1,1.0,1,1.0,1,0.17026206801278182,33
662,1,1425,511,914,0,0,0,1.0,1,1.0,1,1.0,1,0.19597222184779828,31
663,3,1428,512,916,0,0,0,1.0,1,1.0,1,1.0,1,0.17364223358660882,29
664,2,1430,514,916,0,0,0,1.0,1,1.0,1,1.0,1,0.27429274536115583,27
665,3,1433,515,918,0,0,0,1.0,1,1.0,1,1.0,1,0.15315297668585623,27
666,0,1433,515,918,0,0,0,1.0,1,1.0,1,1.0,1,0.1295667471031493,28
667,1,1434,516,918,0,0,0,1.0,1,1.0,1,1.0,1,0.13350057587085057,26
668,3,1437,519,918,0,0,0,1.0,1,1.0,1,1.0,1,0.2146158180258241,26
669,2,1439,521,918,0,0,0,1.0,1,1.0,1,1.0,1,0.1657610136078455,25
670,0,1439,521,918,0,0,0,1.0,1,1.0,1,1.0,1,0.1757074103212507,24
671,3,1442,522,920,0,0,0,1.0,1,1.0,1,1.0,1,0.12218358111953226,24
672,0,1442,522,920,0,0,0,1.0,1,1.0,1,1.0,1,0.14270769281886506,25
673,0,1442,522,920,0,0,0,1.0,1,1.0,1,1.0,1,0.14270769281886506,25
674,0,1442,522,920,0,0,0,1.0,1,1.0,1,1.0,1,0.14270769281886506,25
675,5,1447,525,922,0,0,0,1.0,1,1.0,1,1.0,1,0.17247033646680557,26
676,1,1448,526,922,0,0,0,1.0,1,1.0,1,1.0,1,0.14772263427770835,27
677,1,1449,526,923,0,0,0,1.0,1,1.0,1,1.0,1,0.14736185072954133,28
678,1,1450,527,923,0,0,0,1.0,1,1.0,1,1.0,1,0.1323910845767502,28
679,0,1450,527,923,0,0,0,1.0,1,1.0,1,1.0,1,0.16897814392394453,30
680,0,1450,527,923,0,0,0,1.0,1,1.0,1,1.0,1,0.19222318084178477,29
681,3,1453,528,925,0,0,0,1.0,1,1.0,1,1.0,1,0.16887193443830922,29
682,1,1454,528,926,0,0,0,1.0,1,1.0,1,1.0,1,0.14130747194047744,30
683,0,1454,528,926,0,0,0,1.0,1,1.0,1,1.0,1,0.14130747194047744,30
684,0,1454,528,926,0,0,0,1.0,1,1.0,1,1.0,1,0.16334525386186,31
685,0,1454,528,926,0,0,0,1.0,1,1.0,1,1.0,1,0.18019980498186103,30
686,3,1457,530,927,0,0,0,1.0,1,1.0,1,1.0,1,0.1819973793581641,30
687,3,1460,531,929,0,0,0,1.0,1,1.0,1,1.0,1,0.18279451606376979,30
688,2,1462,531,931,0,0,0,1.0,1,1.0,1,1.0,1,0.10636839383244923,31
689,2,1464,533,931,0,0,0,1.0,1,1.0,1,1.0,1,0.20663292764526967,32
690,2,1466,533,933,0,0,0,1.0,1,1.0,1,1.0,1,0.19756831943966147,32
691,0,1466,533,933,0,0,0,1.0,1,1.0,1,1.0,1,0.19756831943966147,32
692,2,1468,535,933,0,0,0,1.0,1,1.0,1,1.0,1,0.21514593818311323,32
693,1,1469,536,933,0,0,0,1.0,1,1.0,1,1.0,1,0.21843445489359867,34
694,5,1474,537,937,0,0,0,1.0,1,1.0,1,1.0,1,0.23973845203299793,36
695,1,1475,537,938,0,0,0,1.0,1,1.0,1,1.0,1,0.22522610400885465,34
696,7,1482,538,944,0,0,0,1.0,1,1.0,1,1.0,1,0.12847788081366474,33
697,2,1484,538,946,0,0,0,1.0,1,1.0,1,1.0,1,0.11657915436741643,33
698,1,1485,539,946,0,0,0,1.0,1,1.0,1,1.0,1,0.1894132553963512,34
699,2,1487,540,947,0,0,0,1.0,1,1.0,1,1.0,1,0.23470504977165088,33
700,2,1489,540,949,0,0,0,1.0,1,1.0,1,1.0,1,0.23442555776475313,32
701,5,1494,540,954,0,0,0,1.0,1,1.0,1,1.0,1,0.166331546021761,33
702,4,1498,542,956,0,0,0,1.0,1,1.0,1,1.0,1,0.20428435120402377,34
703,0,1498,542,956,0,0,0,1.0,1,1.0,1,1.0,1,0.1842297899838014,32
704,1,1499,542,957,0,0,0,1.0,1,1.0,1,1.0,1,0.14358391659536532,31
705,6,1505,545,960,0,0,0,1.0,1,1.0,1,1.0,1,0.21327454051296138,33
706,1,1506,546,960,0,0,0,1.0,1,1.0,1,1.0,1,0.249300440905746,33
707,1,1507,546,961,0,0,0,1.0,1,1.0,1,1.0,1,0.21103685764816887,31
708,2,1509,548,961,0,0,0,1.0,1,1.0,1,1.0,1,0.28842844427213243,31
709,2,1511,549,962,0,0,0,1.0,1,1.0,1,1.0,1,0.26014240835319247,30
710,0,1511,549,962,0,0,0,1.0,1,1.0,1,1.0,1,0.26014240835319247,30
711,0,1511,549,962,0,0,0,1.0,1,1.0,1,1.0,1,0.2533081302727755,30
712,2,1513,549,964,0,0,0,1.0,1,1.0,1,1.0,1,0.19588913746278794,30
713,1,1514,549,965,0,0,0,1.0,1,1.0,1,1.0,1,0.1962294389667994,31
714,1,1515,550,965,0,0,0,1.0,1,1.0,1,1.0,1,0.23335023035206845,31
715,0,1515,550,965,0,0,0,1.0,1,1.0,1,1.0,1,0.2612939617780143,30
716,1,1516,551,965,0,0,0,1.0,1,1.0,1,1.0,1,0.2678646511472253,31
717,2,1518,551,967,0,0,0,1.0,1,1.0,1,1.0,1,0.2463064903701958,32
718,1,1519,551,968,0,0,0,1.0,1,1.0,1,1.0,1,0.1966057587357875,32
719,2,1521,552,969,0,0,0,1.0,1,1.0,1,1.0,1,0.228231625791242,32
720,1,1522,552,970,0,0,0,1.0,1,1.0,1,1.0,1,0.18513697696677373,34
721,0,1522,552,970,0,0,0,1.0,1,1.0,1,1.0,1,0.18513697696677373,34
722,0,1522,552,970,0,0,0,1.0,1,1.0,1,1.0,1,0.18513697696677373,34
723,0,1522,552,970,0,0,0,1.0,1,1.0,1,1.0,1,0.18691548712343176,35
724,4,1526,554,972,0,0,0,1.0,1,1.0,1,1.0,1,0.22304573686068233,36
725,2,1528,554,974,0,0,0,1.0,1,1.0,1,1.0,1,0.18096308779837159,37
726,0,1528,554,974,0,0,0,1.0,1,1.0,1,1.0,1,0.18096308779837159,37
727,0,1528,554,974,0,0,0,1.0,1,1.0,1,1.0,1,0.19784885706866684,38
728,2,1530,554,976,0,0,0,1.0,1,1.0,1,1.0,1,0.1705613935468566,39
729,0,1530,554,976,0,0,0,1.0,1,1.0,1,1.0,1,0.1705613935468566,39
730,3,1533,555,978,0,0,0,1.0,1,1.0,1,1.0,1,0.15760069790797715,40
731,1,1534,556,978,0,0,0,1.0,1,1.0,1,1.0,1,0.1329227200567439,40
732,0,1534,556,978,0,0,0,1.0,1,1.0,1,1.0,1,0.15682090173139876,41
733,0,1534,556,978,0,0,0,1.0,1,1.0,1,1.0,1,0.09784581467608651,41
734,1,1535,557,978,0,0,0,1.0,1,1.0,1,1.0,1,0.11291650707346564,42
735,1,1536,558,978,0,0,0,1.0,1,1.0,1,1.0,1,0.11679789039686343,42
736,2,1538,558,980,0,0,0,1.0,1,1.0,1,1.0,1,0.1466465511117354,41
737,1,1539,559,980,0,0,0,1.0,1,1.0,1,1.0,1,0.1877209747515865,41
738,1,1540,559,981,0,0,0,1.0,1,1.0,1,1.0,1,0.18751343283622648,39
739,0,1540,559,981,0,0,0,1.0,1,1.0,1,1.0,1,0.18751343283622648,39
740,2,1542,560,982,0,0,0,1.0,1,1.0,1,1.0,1,0.20907157655716838,39
741,4,1546,560,986,0,0,0,1.0,1,1.0,1,1.0,1,0.11451649405195216,38
742,1,1547,561,986,0,0,0,1.0,1,1.0,1,1.0,1,0.13391069014778545,39
743,4,1551,564,987,0,0,0,1.0,1,1.0,1,1.0,1,0.1342025441936331,39
744,5,1556,566,990,0,0,0,1.0,1,1.0,1,1.0,1,0.1833488719398084,39
745,1,1557,566,991,0,0,0,1.0,1,1.0,1,1.0,1,0.15135307597858003,39
746,7,1564,569,995,0,0,0,1.0,1,1.0,1,1.0,1,0.04543797862725166,40
747,1,1565,570,995,0,0,0,1.0,1,1.0,1,1.0,1,0.05684458307408908,41
748,3,1568,573,995,0,0,0,1.0,1,1.0,1,1.0,1,0.13681153423422854,41
749,4,1572,574,998,0,0,0,1.0,1,1.0,1,1.0,1,0.1038092255792234,41
750,2,1574,574,1000,0,0,0,1.0,1,1.0,1,1.0,1,0.10032365256652914,39
751,0,1574,574,1000,0,0,0,1.0,1,1.0,1,1.0,1,0.10914035091246678,41
752,2,1576,576,1000,0,0,0,1.0,1,1.0,1,1.0,1,0.13067740597715422,41
753,1,1577,576,1001,0,0,0,1.0,1,1.0,1,1.0,1,0.11932224822012916,41
754,5,1582,579,1003,0,0,0,1.0,1,1.0,1,1.0,1,0.15424870653922593,41
755,2,1584,579,1005,0,0,0,1.0,1,1.0,1,1.0,1,0.17785205646404256,41
756,3,1587,579,1008,0,0,0,1.0,1,1.0,1,1.0,1,0.12506436713187138,41
757,3,1590,581,1009,0,0,0,1.0,1,1.0,1,1.0,1,0.2128689052599145,39
758,1,1591,581,1010,0,0,0,1.0,1,1.0,1,1.0,1,0.15754972497786618,39
759,0,1591,581,1010,0,0,0,1.0,1,1.0,1,1.0,1,0.1571689191678592,39
760,2,1593,581,1012,0,0,0,1.0,1,1.0,1,1.0,1,0.14024161304700958,40
761,1,1594,581,1013,0,0,0,1.0,1,1.0,1,1.0,1,0.11470277637046888,41
762,0,1594,581,1013,0,0,0,1.0,1,1.0,1,1.0,1,0.1193301020234196,42
763,1,1595,581,1014,0,0,0,1.0,1,1.0,1,1.0,1,0.12493293846457672,43
764,0,1595,581,1014,0,0,0,1.0,1,1.0,1,1.0,1,0.12493293846457672,43
765,0,1595,581,1014,0,0,0,1.0,1,1.0,1,1.0,1,0.09621819362657165,45
766,1,1596,582,1014,0,0,0,1.0,1,1.0,1,1.0,1,0.11412732961835093,45
767,1,1597,582,1015,0,0,0,1.0,1,1.0,1,1.0,1,0.10270647566376122,46
768,0,1597,582,1015,0,0,0,1.0,1,1.0,1,1.0,1,0.10333011627768024,45
769,1,1598,583,1015,0,0,0,1.0,1,1.0,1,1.0,1,0.13345466922233415,46
770,1,1599,584,1015,0,0,0,1.0,1,1.0,1,1.0,1,0.12526337661701878,47
771,5,1604,586,1018,0,0,0,1.0,1,1.0,1,1.0,1,0.14147571973465106,47
772,0,1604,586,1018,0,0,0,1.0,1,1.0,1,1.0,1,0.12884843057773712,46
773,2,1606,588,1018,0,0,0,1.0,1,1.0,1,1.0,1,0.15994780657619947,45
774,0,1606,588,1018,0,0,0,1.0,1,1.0,1,1.0,1,0.14023326240629191,45
775,2,1608,590,1018,0,0,0,1.0,1,1.0,1,1.0,1,0.16093439195722029,45
776,6,1614,590,1024,0,0,0,1.0,1,1.0,1,1.0,1,0.09468121498019123,43
777,0,1614,590,1024,0,0,0,1.0,1,1.0,1,1.0,1,0.09166984579694845,44
778,2,1616,592,1024,0,0,0,1.0,1,1.0,1,1.0,1,0.14640957013517955,45
779,1,1617,592,1025,0,0,0,1.0,1,1.0,1,1.0,1,0.14514956469652066,45
780,3,1620,593,1027,0,0,0,1.0,1,1.0,1,1.0,1,0.17950131487870513,45
781,4,1624,593,1031,0,0,0,1.0,1,1.0,1,1.0,1,0.10745969777415884,46
782,2,1626,593,1033,0,0,0,1.0,1,1.0,1,1.0,1,0.1217275022721259,47
783,2,1628,593,1035,0,0,0,1.0,1,1.0,1,1.0,1,0.07869854658857961,46
784,1,1629,593,1036,0,0,0,1.0,1,1.0,1,1.0,1,0.0818360449768982,45
785,0,1629,593,1036,0,0,0,1.0,1,1.0,1,1.0,1,0.10205825358397272,43
786,2,1631,593,1038,0,0,0,1.0,1,1.0,1,1.0,1,0.06756731655167177,43
787,2,1633,595,1038,0,0,0,1.0,1,1.0,1,1.0,1,0.11899569930796228,43
788,3,1636,596,1040,0,0,0,1.0,1,1.0,1,1.0,1,0.17527866143271809,44
789,4,1640,597,1043,0,0,0,1.0,1,1.0,1,1.0,1,0.17662732761462788,46
790,7,1647,598,1049,0,0,0,1.0,1,1.0,1,1.0,1,0.14030252910889549,46
791,2,1649,599,1050,0,0,0,1.0,1,1.0,1,1.0,1,0.11758283219846798,46
792,1,1650,599,1051,0,0,0,1.0,1,1.0,1,1.0,1,0.09651269886611742,47
793,0,1650,599,1051,0,0,0,1.0,1,1.0,1,1.0,1,0.1186620175466452,48
794,0,1650,599,1051,0,0,0,1.0,1,1.0,1,1.0,1,0.11482943850777814,48
795,0,1650,599,1051,0,0,0,1.0,1,1.0,1,1.0,1,0.1189628857279847,47
796,3,1653,600,1053,0,0,0,1.0,1,1.0,1,1.0,1,0.16972875347650657,45
797,3,1656,601,1055,0,0,0,1.0,1,1.0,1,1.0,1,0.1742014542376284,47
798,5,1661,602,1059,0,0,0,1.0,1,1.0,1,1.0,1,0.1317349000871173,48
799,4,1665,603,1062,0,0,0,1.0,1,1.0,1,1.0,1,0.10355126322505279,48
800,2,1667,605,1062,0,0,0,1.0,1,1.0,1,1.0,1,0.11344126669643509,48
801,1,1668,606,1062,0,0,0,1.0,1,1.0,1,1.0,1,0.10448881300761759,49
802,4,1672,608,1064,0,0,0,1.0,1,1.0,1,1.0,1,0.13950812465360563,50
803,1,1673,608,1065,0,0,0,1.0,1,1.0,1,1.0,1,0.12951004202700062,50
804,0,1673,608,1065,0,0,0,1.0,1,1.0,1,1.0,1,0.12951004202700062,50
805,1,1674,609,1065,0,0,0,1.0,1,1.0,1,1.0,1,0.14931892231485625,50
806,0,1674,609,1065,0,0,0,1.0,1,1.0,1,1.0,1,0.14730453921796316,51
807,0,1674,609,1065,0,0,0,1.0,1,1.0,1,1.0,1,0.14730453921796316,51
808,1,1675,609,1066,0,0,0,1.0,1,1.0,1,1.0,1,0.15170306103278206,53
809,1,1676,609,1067,0,0,0,1.0,1,1.0,1,1.0,1,0.091452498429375,51
810,0,1676,609,1067,0,0,0,1.0,1,1.0,1,1.0,1,0.09723986854049356,52
811,3,1679,610,1069,0,0,0,1.0,1,1.0,1,1.0,1,0.0922675644475099,50
812,1,1680,611,1069,0,0,0,1.0,1,1.0,1,1.0,1,0.10908170167441333,51
813,2,1682,613,1069,0,0,0,1.0,1,1.0,1,1.0,1,0.16230238031093033,51
814,4,1686,615,1071,0,0,0,1.0,1,1.0,1,1.0,1,0.2027257355779358,52
815,2,1688,616,1072,0,0,0,1.0,1,1.0,1,1.0,1,0.17514430670072936,50
816,2,1690,616,1074,0,0,0,1.0,1,1.0,1,1.0,1,0.15437165919189305,50
817,1,1691,616,1075,0,0,0,1.0,1,1.0,1,1.0,1,0.14802695971437171,49
818,3,1694,618,1076,0,0,0,1.0,1,1.0,1,1.0,1,0.16129584069229166,49
819,0,1694,618,1076,0,0,0,1.0,1,1.0,1,1.0,1,0.15451096167292921,50
820,1,1695,618,1077,0,0,0,1.0,1,1.0,1,1.0,1,0.1636162295123214,49
821,1,1696,618,1078,0,0,0,1.0,1,1.0,1,1.0,1,0.16331210996837422,49
822,2,1698,619,1079,0,0,0,1.0,1,1.0,1,1.0,1,0.1440646878574056,49
823,3,1701,621,1080,0,0,0,1.0,1,1.0,1,1.0,1,0.16511889836096313,47
824,5,1706,625,1081,0,0,0,1.0,1,1.0,1,1.0,1,0.1329079960339582,45
825,0,1706,625,1081,0,0,0,1.0,1,1.0,1,1.0,1,0.13554198594041866,43
826,2,1708,627,1081,0,0,0,1.0,1,1.0,1,1.0,1,0.11728876660017178,44
827,2,1710,628,1082,0,0,0,1.0,1,1.0,1,1.0,1,0.1205937133748947,43
828,2,1712,630,1082,0,0,0,1.0,1,1.0,1,1.0,1,0.18855267698082132,43
829,4,1716,632,1084,0,0,0,1.0,1,1.0,1,1.0,1,0.14867860482546288,45
830,1,1717,632,1085,0,0,0,1.0,1,1.0,1,1.0,1,0.1612463369687332,46
831,8,1725,634,1091,0,0,0,1.0,1,1.0,1,1.0,1,0.11044982269665708,48
832,2,1727,635,1092,0,0,0,1.0,1,1.0,1,1.0,1,0.08749954639324914,47
833,1,1728,635,1093,0,0,0,1.0,1,1.0,1,1.0,1,0.1024774727129821,47
834,2,1730,636,1094,0,0,0,1.0,1,1.0,1,1.0,1,0.13608093413689099,46
835,3,1733,636,1097,0,0,0,1.0,1,1.0,1,1.0,1,0.14879523258538396,45
836,2,1735,637,1098,0,0,0,1.0,1,1.0,1,1.0,1,0.11076861967343732,46
837,2,1737,638,1099,0,0,0,1.0,1,1.0,1,1.0,1,0.11860194192362074,46
838,1,1738,638,1100,0,0,0,1.0,1,1.0,1,1.0,1,0.11982951819828963,45
839,3,1741,639,1102,0,0,0,1.0,1,1.0,1,1.0,1,0.13900297527560695,46
840,1,1742,639,1103,0,0,0,1.0,1,1.0,1,1.0,1,0.14364350247705873,46
841,5,1747,640,1107,0,0,0,1.0,1,1.0,1,1.0,1,0.14671445197991936,46
842,4,1751,641,1110,0,0,0,1.0,1,1.0,1,1.0,1,0.12459931937655341,46
843,1,1752,641,1111,0,0,0,1.0,1,1.0,1,1.0,1,0.10506393936574404,46
844,4,1756,644,1112,0,0,0,1.0,1,1.0,1,1.0,1,0.1678632442649536,47
845,9,1765,646,1119,0,0,0,1.0,1,1.0,1,1.0,1,0.2216425767531492,48
846,3,1768,646,1122,0,0,0,1.0,1,1.0,1,1.0,1,0.16274247176217121,47
847,1,1769,646,1123,0,0,0,1.0,1,1.0,1,1.0,1,0.16732100787158558,48
848,0,1769,646,1123,0,0,0,1.0,1,1.0,1,1.0,1,0.1580402738001254,48
849,2,1771,647,1124,0,0,0,1.0,1,1.0,1,1.0,1,0.20171855728204394,48
850,0,1771,647,1124,0,0,0,1.0,1,1.0,1,1.0,1,0.1911100253695422,46
851,3,1774,647,1127,0,0,0,1.0,1,1.0,1,1.0,1,0.14607384644403199,45
852,1,1775,648,1127,0,0,0,1.0,1,1.0,1,1.0,1,0.1547712068916468,44
853,2,1777,649,1128,0,0,0,1.0,1,1.0,1,1.0,1,0.13196599834088799,44
854,5,1782,651,1131,0,0,0,1.0,1,1.0,1,1.0,1,0.10255437714723688,45
855,1,1783,651,1132,0,0,0,1.0,1,1.0,1,1.0,1,0.08228886750467061,46
856,0,1783,651,1132,0,0,0,1.0,1,1.0,1,1.0,1,0.08228886750467061,46
857,0,1783,651,1132,0,0,0,1.0,1,1.0,1,1.0,1,0.0864232837967342,47
858,0,1783,651,1132,0,0,0,1.0,1,1.0,1,1.0,1,0.09912983340280171,48
859,0,1783,651,1132,0,0,0,1.0,1,1.0,1,1.0,1,0.09912983340280171,48
860,0,1783,651,1132,0,0,0,1.0,1,1.0,1,1.0,1,0.10821434583275888,49
861,3,1786,652,1134,0,0,0,1.0,1,1.0,1,1.0,1,0.11861886633908879,49
862,2,1788,653,1135,0,0,0,1.0,1,1.0,1,1.0,1,0.1293155832980606,49
863,1,1789,654,1135,0,0,0,1.0,1,1.0,1,1.0,1,0.14777044880931997,48
864,7,1796,656,1140,0,0,0,1.0,1,1.0,1,1.0,1,0.1345672023557451,49
865,3,1799,657,1142,0,0,0,1.0,1,1.0,1,1.0,1,0.13891532583135183,48
866,5,1804,658,1146,0,0,0,1.0,1,1.0,1,1.0,1,0.06330425802301723,50
867,2,1806,658,1148,0,0,0,1.0,1,1.0,1,1.0,1,0.06747419382434501,50
868,4,1810,661,1149,0,0,0,1.0,1,1.0,1,1.0,1,0.06789165983909196,51
869,0,1810,661,1149,0,0,0,1.0,1,1.0,1,1.0,1,0.05914422643215532,49
870,1,1811,662,1149,0,0,0,1.0,1,1.0,1,1.0,1,0.09625699742079886,49
871,3,1814,664,1150,0,0,0,1.0,1,1.0,1,1.0,1,0.09838663629808109,49
872,0,1814,664,1150,0,0,0,1.0,1,1.0,1,1.0,1,0.1171829290784515,48
873,4,1818,667,1151,0,0,0,1.0,1,1.0,1,1.0,1,0.16947182105823605,49
874,1,1819,667,1152,0,0,0,1.0,1,1.0,1,1.0,1,0.1517162743941684,49
875,4,1823,668,1155,0,0,0,1.0,1,1.0,1,1.0,1,0.1606270451753883,50
876,4,1827,668,1159,0,0,0,1.0,1,1.0,1,1.0,1,0.14192672185757835,50
877,3,1830,670,1160,0,0,0,1.0,1,1.0,1,1.0,1,0.11900883052879926,50
878,3,1833,670,1163,0,0,0,1.0,1,1.0,1,1.0,1,0.11183562033348325,49
879,2,1835,672,1163,0,0,0,1.0,1,1.0,1,1.0,1,0.1291882838854892,49
880,1,1836,672,1164,0,0,0,1.0,1,1.0,1,1.0,1,0.14047774466975943,48
881,9,1845,674,1171,0,0,0,1.0,1,1.0,1,1.0,1,0.0842111119803752,49
882,1,1846,674,1172,0,0,0,1.0,1,1.0,1,1.0,1,0.12092027286008067,48
883,9,1855,675,1180,0,0,0,1.0,1,1.0,1,1.0,1,0.1344905978145159,50
884,4,1859,676,1183,0,0,0,1.0,1,1.0,1,1.0,1,0.14467190924287396,50
885,5,1864,677,1187,0,0,0,1.0,1,1.0,1,1.0,1,0.16242145875223116,49
886,5,1869,678,1191,0,0,0,1.0,1,1.0,1,1.0,1,0.0953057878413101,49
887,0,1869,678,1191,0,0,0,1.0,1,1.0,1,1.0,1,0.09435154460941043,49
888,1,1870,679,1191,0,0,0,1.0,1,1.0,1,1.0,1,0.10898097947713432,47
889,0,1870,679,1191,0,0,0,1.0,1,1.0,1,1.0,1,0.11432378952237815,46
890,0,1870,679,1191,0,0,0,1.0,1,1.0,1,1.0,1,0.16556408263999461,44
891,6,1876,681,1195,0,0,0,1.0,1,1.0,1,1.0,1,0.15407011651306043,45
892,3,1879,682,1197,0,0,0,1.0,1,1.0,1,1.0,1,0.11246757981791997,45
893,0,1879,682,1197,0,0,0,1.0,1,1.0,1,1.0,1,0.11246757981791997,45
894,1,1880,682,1198,0,0,0,1.0,1,1.0,1,1.0,1,0.12579757360206864,44
895,1,1881,683,1198,0,0,0,1.0,1,1.0,1,1.0,1,0.13581777801555403,45
896,4,1885,684,1201,0,0,0,1.0,1,1.0,1,1.0,1,0.09827715377828646,44
897,0,1885,684,1201,0,0,0,1.0,1,1.0,1,1.0,1,0.09827715377828646,44
898,2,1887,684,1203,0,0,0,1.0,1,1.0,1,1.0,1,0.10605448434852846,45
899,0,1887,684,1203,0,0,0,1.0,1,1.0,1,1.0,1,0.1338723914008205,44
900,3,1890,684,1206,0,0,0,1.0,1,1.0,1,1.0,1,0.0965329713771938,46
901,1,1891,684,1207,0,0,0,1.0,1,1.0,1,1.0,1,0.08793072943996975,45
902,2,1893,686,1207,0,0,0,1.0,1,1.0,1,1.0,1,0.12264031381524482,45
903,2,1895,687,1208,0,0,0,1.0,1,1.0,1,1.0,1,0.14095794784087032,44
904,2,1897,688,1209,0,0,0,1.0,1,1.0,1,1.0,1,0.15624266072979212,45
905,2,1899,689,1210,0,0,0,1.0,1,1.0,1,1.0,1,0.18644222365955676,45
906,3,1902,689,1213,0,0,0,1.0,1,1.0,1,1.0,1,0.14326132577756168,45
907,6,1908,691,1217,0,0,0,1.0,1,1.0,1,1.0,1,0.13407190598584362,46
908,3,1911,691,1220,0,0,0,1.0,1,1.0,1,1.0,1,0.13907453027427963,46
909,8,1919,694,1225,0,0,0,1.0,1,1.0,1,1.0,1,0.18218988143837145,46
910,3,1922,694,1228,0,0,0,1.0,1,1.0,1,1.0,1,0.14709072085493843,44
911,5,1927,694,1233,0,0,0,1.0,1,1.0,1,1.0,1,0.08543258177747894,45
912,1,1928,694,1234,0,0,0,1.0,1,1.0,1,1.0,1,0.09000482093281684,44
913,1,1929,694,1235,0,0,0,1.0,1,1.0,1,1.0,1,0.08341984649232756,45
914,3,1932,696,1236,0,0,0,1.0,1,1.0,1,1.0,1,0.09832309965058578,45
915,4,1936,697,1239,0,0,0,1.0,1,1.0,1,1.0,1,0.1185766392183183,45
916,2,1938,697,1241,0,0,0,1.0,1,1.0,1,1.0,1,0.07078435954137725,45
917,0,1938,697,1241,0,0,0,1.0,1,1.0,1,1.0,1,0.09020158499689965,46
918,2,1940,698,1242,0,0,0,1.0,1,1.0,1,1.0,1,0.0847022299002626,47
919,1,1941,699,1242,0,0,0,1.0,1,1.0,1,1.0,1,0.10561416966325811,47
920,0,1941,699,1242,0,0,0,1.0,1,1.0,1,1.0,1,0.10561416966325811,47
921,6,1947,701,1246,0,0,0,1.0,1,1.0,1,1.0,1,0.09313433685191043,49
922,1,1948,702,1246,0,0,0,1.0,1,1.0,1,1.0,1,0.0778913055989871,49
923,2,1950,704,1246,0,0,0,1.0,1,1.0,1,1.0,1,0.14498000826949609,47
924,1,1951,705,1246,0,0,0,1.0,1,1.0,1,1.0,1,0.17000208176794782,47
925,2,1953,706,1247,0,0,0,1.0,1,1.0,1,1.0,1,0.12337878006887613,47
926,5,1958,707,1251,0,0,0,1.0,1,1.0,1,1.0,1,0.0811671776069667,46
927,2,1960,708,1252,0,0,0,1.0,1,1.0,1,1.0,1,0.15427718319781203,45
928,0,1960,708,1252,0,0,0,1.0,1,1.0,1,1.0,1,0.19487712461459816,43
929,0,1960,708,1252,0,0,0,1.0,1,1.0,1,1.0,1,0.21627648526836427,42
930,0,1960,708,1252,0,0,0,1.0,1,1.0,1,1.0,1,0.23824999699458563,41
931,7,1967,709,1258,0,0,0,1.0,1,1.0,1,1.0,1,0.13930543100491496,40
932,0,1967,709,1258,0,0,0,1.0,1,1.0,1,1.0,1,0.13930543100491496,40
933,2,1969,711,1258,0,0,0,1.0,1,1.0,1,1.0,1,0.24648014398449503,39
934,6,1975,712,1263,0,0,0,1.0,1,1.0,1,1.0,1,0.23520664494867285,39
935,8,1983,714,1269,0,0,0,1.0,1,1.0,1,1.0,1,0.2860273925354456,41
936,9,1992,714,1278,0,0,0,1.0,1,1.0,1,1.0,1,0.14659488333435386,42
937,2,1994,714,1280,0,0,0,1.0,1,1.0,1,1.0,1,0.14181558534590624,43
938,2,1996,714,1282,0,0,0,1.0,1,1.0,1,1.0,1,0.17335873056171128,44
939,4,2000,714,1286,0,0,0,1.0,1,1.0,1,1.0,1,0.1717703270327277,46
940,5,2005,714,1291,0,0,0,1.0,1,1.0,1,1.0,1,0.15669026057169563,46
941,2,2007,715,1292,0,0,0,1.0,1,1.0,1,1.0,1,0.16125260718332032,46
942,1,2008,716,1292,0,0,0,1.0,1,1.0,1,1.0,1,0.166263021651284,46
943,1,2009,716,1293,0,0,0,1.0,1,1.0,1,1.0,1,0.13460656659052206,45
944,0,2009,716,1293,0,0,0,1.0,1,1.0,1,1.0,1,0.13172750293391575,45
945,1,2010,716,1294,0,0,0,1.0,1,1.0,1,1.0,1,0.18369023456139147,44
946,4,2014,718,1296,0,0,0,1.0,1,1.0,1,1.0,1,0.13737178507468195,46
947,1,2015,718,1297,0,0,0,1.0,1,1.0,1,1.0,1,0.10894311234003894,44
948,5,2020,720,1300,0,0,0,1.0,1,1.0,1,1.0,1,0.14491484226191925,44
949,4,2024,721,1303,0,0,0,1.0,1,1.0,1,1.0,1,0.2001619681621507,44
950,0,2024,721,1303,0,0,0,1.0,1,1.0,1,1.0,1,0.2232543795878185,43
951,6,2030,721,1309,0,0,0,1.0,1,1.0,1,1.0,1,0.19889299218345471,42
952,0,2030,721,1309,0,0,0,1.0,1,1.0,1,1.0,1,0.19889299218345471,42
953,0,2030,721,1309,0,0,0,1.0,1,1.0,1,1.0,1,0.1952142818294371,41
954,1,2031,722,1309,0,0,0,1.0,1,1.0,1,1.0,1,0.20771409324936616,40
955,0,2031,722,1309,0,0,0,1.0,1,1.0,1,1.0,1,0.21172873011450855,42
956,5,2036,723,1313,0,0,0,1.0,1,1.0,1,1.0,1,0.16095908692488303,43
957,1,2037,723,1314,0,0,0,1.0,1,1.0,1,1.0,1,0.14408963220766868,42
958,0,2037,723,1314,0,0,0,1.0,1,1.0,1,1.0,1,0.18490802847508542,43
959,0,2037,723,1314,0,0,0,1.0,1,1.0,1,1.0,1,0.19704943901917496,45
960,3,2040,724,1316,0,0,0,1.0,1,1.0,1,1.0,1,0.1939719953378834,47
961,2,2042,725,1317,0,0,0,1.0,1,1.0,1,1.0,1,0.1832821652242113,45
962,0,2042,725,1317,0,0,0,1.0,1,1.0,1,1.0,1,0.18354318875966774,45
963,2,2044,726,1318,0,0,0,1.0,1,1.0,1,1.0,1,0.20176317209110176,44
964,1,2045,727,1318,0,0,0,1.0,1,1.0,1,1.0,1,0.2384439012895403,44
965,2,2047,727,1320,0,0,0,1.0,1,1.0,1,1.0,1,0.1811300374351911,45
966,3,2050,728,1322,0,0,0,1.0,1,1.0,1,1.0,1,0.1732954636765755,43
967,0,2050,728,1322,0,0,0,1.0,1,1.0,1,1.0,1,0.1732954636765755,43
968,2,2052,728,1324,0,0,0,1.0,1,1.0,1,1.0,1,0.15334355189371515,43
969,1,2053,729,1324,0,0,0,1.0,1,1.0,1,1.0,1,0.18058612775131358,42
970,1,2054,729,1325,0,0,0,1.0,1,1.0,1,1.0,1,0.19988602577637038,42
971,2,2056,729,1327,0,0,0,1.0,1,1.0,1,1.0,1,0.15604070628064554,42
972,1,2057,729,1328,0,0,0,1.0,1,1.0,1,1.0,1,0.15178100568112424,42
973,1,2058,729,1329,0,0,0,1.0,1,1.0,1,1.0,1,0.1515732069174698,43
974,0,2058,729,1329,0,0,0,1.0,1,1.0,1,1.0,1,0.1515732069174698,43
975,1,2059,729,1330,0,0,0,1.0,1,1.0,1,1.0,1,0.14260613226769614,43
976,3,2062,730,1332,0,0,0,1.0,1,1.0,1,1.0,1,0.14470086671585777,45
977,0,2062,730,1332,0,0,0,1.0,1,1.0,1,1.0,1,0.16331888231209257,44
978,1,2063,730,1333,0,0,0,1.0,1,1.0,1,1.0,1,0.13400346722521878,44
979,2,2065,730,1335,0,0,0,1.0,1,1.0,1,1.0,1,0.17223487937939141,45
980,2,2067,731,1336,0,0,0,1.0,1,1.0,1,1.0,1,0.1652359431486939,45
981,1,2068,732,1336,0,0,0,1.0,1,1.0,1,1.0,1,0.17226293488089137,45
982,4,2072,735,1337,0,0,0,1.0,1,1.0,1,1.0,1,0.2578861667359514,46
983,5,2077,738,1339,0,0,0,1.0,1,1.0,1,1.0,1,0.24743428064791473,45
984,3,2080,739,1341,0,0,0,1.0,1,1.0,1,1.0,1,0.2015741614606916,45
985,4,2084,742,1342,0,0,0,1.0,1,1.0,1,1.0,1,0.26227174782666574,45
986,7,2091,744,1347,0,0,0,1.0,1,1.0,1,1.0,1,0.210057605008449,44
987,2,2093,745,1348,0,0,0,1.0,1,1.0,1,1.0,1,0.2250795250642533,45
988,5,2098,747,1351,0,0,0,1.0,1,1.0,1,1.0,1,0.20210879481027694,44
989,3,2101,748,1353,0,0,0,1.0,1,1.0,1,1.0,1,0.18950854796431893,43
990,3,2104,750,1354,0,0,0,1.0,1,1.0,1,1.0,1,0.19235599622358582,42
991,0,2104,750,1354,0,0,0,1.0,1,1.0,1,1.0,1,0.17227442555429248,42
992,1,2105,750,1355,0,0,0,1.0,1,1.0,1,1.0,1,0.15727126210722875,43
993,3,2108,752,1356,0,0,0,1.0,1,1.0,1,1.0,1,0.1972008279161706,43
994,0,2108,752,1356,0,0,0,1.0,1,1.0,1,1.0,1,0.21933789867363704,43
995,1,2109,752,1357,0,0,0,1.0,1,1.0,1,1.0,1,0.18275748561623215,43
996,1,2110,752,1358,0,0,0,1.0,1,1.0,1,1.0,1,0.18337419836009905,44
997,0,2110,752,1358,0,0,0,1.0,1,1.0,1,1.0,1,0.18337419836009905,44
998,1,2111,752,1359,0,0,0,1.0,1,1.0,1,1.0,1,0.1857715716079421,45
999,0,2111,752,1359,0,0,0,1.0,1,1.0,1,1.0,1,0.1990387777886773,42
1000,1,2112,752,1360,0,0,0,1.0,1,1.0,1,1.0,1,0.17556878049851146,43
1001,1,2113,752,1361,0,0,0,1.0,1,1.0,1,1.0,1,0.1588400138553108,42
1002,0,2113,752,1361,0,0,0,1.0,1,1.0,1,1.0,1,0.15742789824346942,43
1003,1,2114,752,1362,0,0,0,1.0,1,1.0,1,1.0,1,0.13116927971733366,43
1004,0,2114,752,1362,0,0,0,1.0,1,1.0,1,1.0,1,0.13116927971733366,43
1005,0,2114,752,1362,0,0,0,1.0,1,1.0,1,1.0,1,0.1455688335126616,44
1006,2,2116,752,1364,0,0,0,1.0,1,1.0,1,1.0,1,0.14926740694538201,46
1007,0,2116,752,1364,0,0,0,1.0,1,1.0,1,1.0,1,0.14926740694538201,46
1008,1,2117,752,1365,0,0,0,1.0,1,1.0,1,1.0,1,0.14967769047037066,47
1009,0,2117,752,1365,0,0,0,1.0,1,1.0,1,1.0,1,0.13588403938583493,48
1010,1,2118,753,1365,0,0,0,1.0,1,1.0,1,1.0,1,0.1747702636750194,48
1011,2,2120,753,1367,0,0,0,1.0,1,1.0,1,1.0,1,0.14798032174517664,48
1012,2,2122,755,1367,0,0,0,1.0,1,1.0,1,1.0,1,0.1636732328559633,49
1013,0,2122,755,1367,0,0,0,1.0,1,1.0,1,1.0,1,0.1490436100747463,50
1014,1,2123,756,1367,0,0,0,1.0,1,1.0,1,1.0,1,0.16285001969703278,50
1015,1,2124,756,1368,0,0,0,1.0,1,1.0,1,1.0,1,0.16455670332011116,51
1016,2,2126,758,1368,0,0,0,1.0,1,1.0,1,1.0,1,0.16438175568735433,51
1017,2,2128,758,1370,0,0,0,1.0,1,1.0,1,1.0,1,0.15334465631448999,52
1018,4,2132,759,1373,0,0,0,1.0,1,1.0,1,1.0,1,0.13755613445566586,52
1019,3,2135,760,1375,0,0,0,1.0,1,1.0,1,1.0,1,0.14394570773350093,52
1020,0,2135,760,1375,0,0,0,1.0,1,1.0,1,1.0,1,0.12423089532256525,53
1021,5,2140,760,1380,0,0,0,1.0,1,1.0,1,1.0,1,0.0738011918339697,53
1022,2,2142,760,1382,0,0,0,1.0,1,1.0,1,1.0,1,0.0828900258768706,54
1023,2,2144,761,1383,0,0,0,1.0,1,1.0,1,1.0,1,0.0919815809261343,55
1024,3,2147,761,1386,0,0,0,1.0,1,1.0,1,1.0,1,0.09175925550563167,55
1025,2,2149,761,1388,0,0,0,1.0,1,1.0,1,1.0,1,0.09011917281822009,56
1026,5,2154,763,1391,0,0,0,1.0,1,1.0,1,1.0,1,0.10475850799761548,57
1027,0,2154,763,1391,0,0,0,1.0,1,1.0,1,1.0,1,0.11357064539136892,58
1028,3,2157,765,1392,0,0,0,1.0,1,1.0,1,1.0,1,0.13912782922873715,58
1029,2,2159,766,1393,0,0,0,1.0,1,1.0,1,1.0,1,0.1497002414334842,59
1030,5,2164,767,1397,0,0,0,1.0,1,1.0,1,1.0,1,0.17458261914388115,60
1031,9,2173,768,1405,0,0,0,1.0,1,1.0,1,1.0,1,0.11969903639156745,60
1032,2,2175,769,1406,0,0,0,1.0,1,1.0,1,1.0,1,0.11391167323210385,61
1033,3,2178,769,1409,0,0,0,1.0,1,1.0,1,1.0,1,0.1247580896774044,60
1034,2,2180,771,1409,0,0,0,1.0,1,1.0,1,1.0,1,0.10647774536912194,60
1035,1,2181,772,1409,0,0,0,1.0,1,1.0,1,1.0,1,0.12499679580727349,59
1036,3,2184,773,1411,0,0,0,1.0,1,1.0,1,1.0,1,0.08701839929985994,60
1037,3,2187,774,1413,0,0,0,1.0,1,1.0,1,1.0,1,0.07088077363034369,59
1038,1,2188,775,1413,0,0,0,1.0,1,1.0,1,1.0,1,0.0909460778394141,60
1039,6,2194,776,1418,0,0,0,1.0,1,1.0,1,1.0,1,0.0833833362144865,60
1040,3,2197,777,1420,0,0,0,1.0,1,1.0,1,1.0,1,0.09443304069658717,58
1041,4,2201,780,1421,0,0,0,1.0,1,1.0,1,1.0,1,0.0882565723815274,56
1042,1,2202,780,1422,0,0,0,1.0,1,1.0,1,1.0,1,0.07878701542900554,55
1043,1,2203,780,1423,0,0,0,1.0,1,1.0,1,1.0,1,0.07032117231303195,55
1044,1,2204,781,1423,0,0,0,1.0,1,1.0,1,1.0,1,0.09082231340578137,52
1045,0,2204,781,1423,0,0,0,1.0,1,1.0,1,1.0,1,0.09560531328636272,52
1046,4,2208,782,1426,0,0,0,1.0,1,1.0,1,1.0,1,0.08202908282860723,53
1047,0,2208,782,1426,0,0,0,1.0,1,1.0,1,1.0,1,0.0821689051290809,54
1048,2,2210,784,1426,0,0,0,1.0,1,1.0,1,1.0,1,0.12892201842440898,56
1049,1,2211,785,1426,0,0,0,1.0,1,1.0,1,1.0,1,0.11856064130636987,55
1050,0,2211,785,1426,0,0,0,1.0,1,1.0,1,1.0,1,0.12667385415373922,56
1051,1,2212,786,1426,0,0,0,1.0,1,1.0,1,1.0,1,0.10847912283627838,55
1052,3,2215,786,1429,0,0,0,1.0,1,1.0,1,1.0,1,0.07861660590914823,56
1053,0,2215,786,1429,0,0,0,1.0,1,1.0,1,1.0,1,0.07861660590914823,56
1054,1,2216,786,1430,0,0,0,1.0,1,1.0,1,1.0,1,0.06995952322661622,57
1055,2,2218,786,1432,0,0,0,1.0,1,1.0,1,1.0,1,0.07223196439588152,58
1056,0,2218,786,1432,0,0,0,1.0,1,1.0,1,1.0,1,0.08007787659282305,59
1057,3,2221,787,1434,0,0,0,1.0,1,1.0,1,1.0,1,0.08326375846130278,60
1058,2,2223,788,1435,0,0,0,1.0,1,1.0,1,1.0,1,0.10769322194217527,60
1059,0,2223,788,1435,0,0,0,1.0,1,1.0,1,1.0,1,0.10769322194217527,60
1060,2,2225,790,1435,0,0,0,1.0,1,1.0,1,1.0,1,0.15908958901673761,60
1061,9,2234,794,1440,0,0,0,1.0,1,1.0,1,1.0,1,0.14784244566320082,59
1062,4,2238,796,1442,0,0,0,1.0,1,1.0,1,1.0,1,0.1581061508146302,59
1063,1,2239,797,1442,0,0,0,1.0,1,1.0,1,1.0,1,0.1731735103539046,58
1064,6,2245,800,1445,0,0,0,1.0,1,1.0,1,1.0,1,0.15267625082,58
1065,5,2250,804,1446,0,0,0,1.0,1,1.0,1,1.0,1,0.14301353074188633,60
1066,5,2255,805,1450,0,0,0,1.0,1,1.0,1,1.0,1,0.10735453111537738,58
1067,4,2259,807,1452,0,0,0,1.0,1,1.0,1,1.0,1,0.14239140966154845,59
1068,1,2260,808,1452,0,0,0,1.0,1,1.0,1,1.0,1,0.13841068883441116,59
1069,1,2261,809,1452,0,0,0,1.0,1,1.0,1,1.0,1,0.1664209493107216,58
1070,4,2265,810,1455,0,0,0,1.0,1,1.0,1,1.0,1,0.14795185861691068,58
1071,6,2271,812,1459,0,0,0,1.0,1,1.0,1,1.0,1,0.16837289610573378,57
1072,2,2273,812,1461,0,0,0,1.0,1,1.0,1,1.0,1,0.14376241701189849,56
1073,2,2275,813,1462,0,0,0,1.0,1,1.0,1,1.0,1,0.17860393710811343,54
1074,2,2277,814,1463,0,0,0,1.0,1,1.0,1,1.0,1,0.16152543312379358,54
1075,1,2278,815,1463,0,0,0,1.0,1,1.0,1,1.0,1,0.15341924505067794,51
1076,4,2282,816,1466,0,0,0,1.0,1,1.0,1,1.0,1,0.11032721642207995,51
1077,4,2286,816,1470,0,0,0,1.0,1,1.0,1,1.0,1,0.06438769809789349,51
1078,1,2287,817,1470,0,0,0,1.0,1,1.0,1,1.0,1,0.10513854382135984,52
1079,9,2296,821,1475,0,0,0,1.0,1,1.0,1,1.0,1,0.12242296005501094,51
1080,5,2301,822,1479,0,0,0,1.0,1,1.0,1,1.0,1,0.12876024557444884,51
1081,0,2301,822,1479,0,0,0,1.0,1,1.0,1,1.0,1,0.13856059970919699,48
1082,2,2303,824,1479,0,0,0,1.0,1,1.0,1,1.0,1,0.18359748033531154,47
1083,2,2305,825,1480,0,0,0,1.0,1,1.0,1,1.0,1,0.20728366950598423,46
1084,1,2306,825,1481,0,0,0,1.0,1,1.0,1,1.0,1,0.18609335718395933,45
1085,2,2308,826,1482,0,0,0,1.0,1,1.0,1,1.0,1,0.1847171508319281,46
1086,1,2309,826,1483,0,0,0,1.0,1,1.0,1,1.0,1,0.1411690384782385,45
1087,0,2309,826,1483,0,0,0,1.0,1,1.0,1,1.0,1,0.17167870866350146,44
1088,1,2310,826,1484,0,0,0,1.0,1,1.0,1,1.0,1,0.15101837961370004,45
1089,2,2312,827,1485,0,0,0,1.0,1,1.0,1,1.0,1,0.1351255825614114,46
1090,1,2313,827,1486,0,0,0,1.0,1,1.0,1,1.0,1,0.13862086050683015,47
1091,2,2315,828,1487,0,0,0,1.0,1,1.0,1,1.0,1,0.15059512337198191,47
1092,1,2316,828,1488,0,0,0,1.0,1,1.0,1,1.0,1,0.13566298055103215,48
1093,0,2316,828,1488,0,0,0,1.0,1,1.0,1,1.0,1,0.13566298055103215,48
1094,4,2320,830,1490,0,0,0,1.0,1,1.0,1,1.0,1,0.15144510626268748,48
1095,1,2321,830,1491,0,0,0,1.0,1,1.0,1,1.0,1,0.15623029610763467,49
1096,2,2323,831,1492,0,0,0,1.0,1,1.0,1,1.0,1,0.15107219848145922,49
1097,2,2325,833,1492,0,0,0,1.0,1,1.0,1,1.0,1,0.17111983691795002,50
1098,2,2327,833,1494,0,0,0,1.0,1,1.0,1,1.0,1,0.15540152632042242,51
1099,1,2328,833,1495,0,0,0,1.0,1,1.0,1,1.0,1,0.12656053622335597,54
1100,2,2330,835,1495,0,0,0,1.0,1,1.0,1,1.0,1,0.13431157137698616,54
1101,3,2333,836,1497,0,0,0,1.0,1,1.0,1,1.0,1,0.11689606855597626,54
1102,1,2334,837,1497,0,0,0,1.0,1,1.0,1,1.0,1,0.10541601086731432,54
1103,1,2335,837,1498,0,0,0,1.0,1,1.0,1,1.0,1,0.07274295218317907,53
1104,1,2336,838,1498,0,0,0,1.0,1,1.0,1,1.0,1,0.08483695755105677,53
1105,1,2337,838,1499,0,0,0,1.0,1,1.0,1,1.0,1,0.09651424440318634,52
1106,3,2340,839,1501,0,0,0,1.0,1,1.0,1,1.0,1,0.06128746995588501,52
1107,2,2342,841,1501,0,0,0,1.0,1,1.0,1,1.0,1,0.10796778246286083,52
1108,3,2345,843,1502,0,0,0,1.0,1,1.0,1,1.0,1,0.11209031092158703,51
1109,3,2348,845,1503,0,0,0,1.0,1,1.0,1,1.0,1,0.1441622313905811,49
1110,2,2350,846,1504,0,0,0,1.0,1,1.0,1,1.0,1,0.15745492683004259,48
1111,3,2353,848,1505,0,0,0,1.0,1,1.0,1,1.0,1,0.18349159625130468,47
1112,1,2354,849,1505,0,0,0,1.0,1,1.0,1,1.0,1,0.23367340365146907,46
1113,3,2357,851,1506,0,0,0,1.0,1,1.0,1,1.0,1,0.24673017111722476,43
1114,3,2360,852,1508,0,0,0,1.0,1,1.0,1,1.0,1,0.24145205245349988,41
1115,0,2360,852,1508,0,0,0,1.0,1,1.0,1,1.0,1,0.24868076051616686,40
1116,4,2364,854,1510,0,0,0,1.0,1,1.0,1,1.0,1,0.23963695177362762,39
1117,6,2370,858,1512,0,0,0,1.0,1,1.0,1,1.0,1,0.2516034703850689,40
1118,4,2374,860,1514,0,0,0,1.0,1,1.0,1,1.0,1,0.2866132555760344,40
1119,4,2378,860,1518,0,0,0,1.0,1,1.0,1,1.0,1,0.25642494403133426,40
1120,2,2380,860,1520,0,0,0,1.0,1,1.0,1,1.0,1,0.25642494403133426,40
1121,6,2386,860,1526,0,0,0,1.0,1,1.0,1,1.0,1,0.15589040298154425,40
1122,0,2386,860,1526,0,0,0,1.0,1,1.0,1,1.0,1,0.1645714571482498,41
1123,4,2390,862,1528,0,0,0,1.0,1,1.0,1,1.0,1,0.192242686018864,41
1124,0,2390,862,1528,0,0,0,1.0,1,1.0,1,1.0,1,0.192242686018864,41
1125,4,2394,863,1531,0,0,0,1.0,1,1.0,1,1.0,1,0.23365473215396365,41
1126,0,2394,863,1531,0,0,0,1.0,1,1.0,1,1.0,1,0.20484307617244094,41
1127,1,2395,863,1532,0,0,0,1.0,1,1.0,1,1.0,1,0.1977715172751711,41
1128,1,2396,863,1533,0,0,0,1.0,1,1.0,1,1.0,1,0.2034050409136293,42
1129,0,2396,863,1533,0,0,0,1.0,1,1.0,1,1.0,1,0.2034050409136293,42
1130,0,2396,863,1533,0,0,0,1.0,1,1.0,1,1.0,1,0.2034050409136293,42
1131,3,2399,863,1536,0,0,0,1.0,1,1.0,1,1.0,1,0.19867390895558865,42
1132,2,2401,864,1537,0,0,0,1.0,1,1.0,1,1.0,1,0.12587119539385747,43
1133,2,2403,864,1539,0,0,0,1.0,1,1.0,1,1.0,1,0.12224648309831519,45
1134,0,2403,864,1539,0,0,0,1.0,1,1.0,1,1.0,1,0.1309175472584076,46
1135,0,2403,864,1539,0,0,0,1.0,1,1.0,1,1.0,1,0.14589464438975658,45
1136,2,2405,864,1541,0,0,0,1.0,1,1.0,1,1.0,1,0.12685993549899263,48
1137,4,2409,864,1545,0,0,0,1.0,1,1.0,1,1.0,1,0.13666943908663312,49
1138,0,2409,864,1545,0,0,0,1.0,1,1.0,1,1.0,1,0.13666943908663312,49
1139,1,2410,864,1546,0,0,0,1.0,1,1.0,1,1.0,1,0.15826534646217463,49
1140,2,2412,864,1548,0,0,0,1.0,1,1.0,1,1.0,1,0.13814178548585776,49
1141,3,2415,865,1550,0,0,0,1.0,1,1.0,1,1.0,1,0.18428894277626137,48
1142,4,2419,868,1551,0,0,0,1.0,1,1.0,1,1.0,1,0.14805540012802618,48
1143,5,2424,872,1552,0,0,0,1.0,1,1.0,1,1.0,1,0.16789748778940392,48
1144,3,2427,874,1553,0,0,0,1.0,1,1.0,1,1.0,1,0.149151361422257,48
1145,3,2430,876,1554,0,0,0,1.0,1,1.0,1,1.0,1,0.1762476880870068,48
1146,7,2437,879,1558,0,0,0,1.0,1,1.0,1,1.0,1,0.1106741630326226,48
1147,0,2437,879,1558,0,0,0,1.0,1,1.0,1,1.0,1,0.15752650097354667,46
1148,3,2440,881,1559,0,0,0,1.0,1,1.0,1,1.0,1,0.13001738566800544,46
1149,0,2440,881,1559,0,0,0,1.0,1,1.0,1,1.0,1,0.2165228153039523,45
1150,2,2442,882,1560,0,0,0,1.0,1,1.0,1,1.0,1,0.20430660206283782,46
1151,5,2447,884,1563,0,0,0,1.0,1,1.0,1,1.0,1,0.18286459658956042,44
1152,0,2447,884,1563,0,0,0,1.0,1,1.0,1,1.0,1,0.15481328043163647,44
1153,4,2451,887,1564,0,0,0,1.0,1,1.0,1,1.0,1,0.19382808344283298,43
1154,2,2453,887,1566,0,0,0,1.0,1,1.0,1,1.0,1,0.17311005277612648,43
1155,3,2456,888,1568,0,0,0,1.0,1,1.0,1,1.0,1,0.20401513887428083,43
1156,4,2460,888,1572,0,0,0,1.0,1,1.0,1,1.0,1,0.12833147042223333,42
1157,0,2460,888,1572,0,0,0,1.0,1,1.0,1,1.0,1,0.13018285514831196,42
1158,0,2460,888,1572,0,0,0,1.0,1,1.0,1,1.0,1,0.11830448691554893,41
1159,0,2460,888,1572,0,0,0,1.0,1,1.0,1,1.0,1,0.11947290240049487,41
1160,0,2460,888,1572,0,0,0,1.0,1,1.0,1,1.0,1,0.11947290240049487,41
1161,0,2460,888,1572,0,0,0,1.0,1,1.0,1,1.0,1,0.13118808236067495,42
1162,0,2460,888,1572,0,0,0,1.0,1,1.0,1,1.0,1,0.11872356934610989,43
1163,0,2460,888,1572,0,0,0,1.0,1,1.0,1,1.0,1,0.11872356934610989,43
1164,0,2460,888,1572,0,0,0,1.0,1,1.0,1,1.0,1,0.10620502797639601,44
1165,0,2460,888,1572,0,0,0,1.0,1,1.0,1,1.0,1,0.10620502797639601,44
1166,2,2462,889,1573,0,0,0,1.0,1,1.0,1,1.0,1,0.14097668064709262,46
1167,1,2463,890,1573,0,0,0,1.0,1,1.0,1,1.0,1,0.14472054398255677,46
1168,2,2465,890,1575,0,0,0,1.0,1,1.0,1,1.0,1,0.1208846189458946,47
1169,1,2466,891,1575,0,0,0,1.0,1,1.0,1,1.0,1,0.097656859295512,46
1170,0,2466,891,1575,0,0,0,1.0,1,1.0,1,1.0,1,0.10220936637054699,48
1171,4,2470,893,1577,0,0,0,1.0,1,1.0,1,1.0,1,0.12042393992020901,49
1172,0,2470,893,1577,0,0,0,1.0,1,1.0,1,1.0,1,0.12042393992020901,49
1173,0,2470,893,1577,0,0,0,1.0,1,1.0,1,1.0,1,0.12042393992020901,49
1174,1,2471,894,1577,0,0,0,1.0,1,1.0,1,1.0,1,0.14023708512718425,49
1175,1,2472,894,1578,0,0,0,1.0,1,1.0,1,1.0,1,0.1406804977989325,50
1176,2,2474,894,1580,0,0,0,1.0,1,1.0,1,1.0,1,0.1355098090640369,52
1177,4,2478,896,1582,0,0,0,1.0,1,1.0,1,1.0,1,0.15453467792147388,52
1178,0,2478,896,1582,0,0,0,1.0,1,1.0,1,1.0,1,0.15453467792147388,52
1179,2,2480,897,1583,0,0,0,1.0,1,1.0,1,1.0,1,0.13998986408588046,53
1180,1,2481,897,1584,0,0,0,1.0,1,1.0,1,1.0,1,0.13756644745607083,54
1181,1,2482,897,1585,0,0,0,1.0,1,1.0,1,1.0,1,0.12519425869547507,55
1182,4,2486,900,1586,0,0,0,1.0,1,1.0,1,1.0,1,0.1838829286483295,55
1183,2,2488,902,1586,0,0,0,1.0,1,1.0,1,1.0,1,0.1687873615157028,53
1184,1,2489,902,1587,0,0,0,1.0,1,1.0,1,1.0,1,0.15294493572008105,54
1185,1,2490,902,1588,0,0,0,1.0,1,1.0,1,1.0,1,0.16131849802866155,53
1186,5,2495,903,1592,0,0,0,1.0,1,1.0,1,1.0,1,0.16053241939139037,54
1187,3,2498,903,1595,0,0,0,1.0,1,1.0,1,1.0,1,0.15053683652430325,55
1188,0,2498,903,1595,0,0,0,1.0,1,1.0,1,1.0,1,0.15053683652430325,55
1189,4,2502,904,1598,0,0,0,1.0,1,1.0,1,1.0,1,0.1612624556303843,54
1190,5,2507,905,1602,0,0,0,1.0,1,1.0,1,1.0,1,0.14716811276660727,55
1191,2,2509,906,1603,0,0,0,1.0,1,1.0,1,1.0,1,0.11872021963791637,54
1192,6,2515,909,1606,0,0,0,1.0,1,1.0,1,1.0,1,0.1566728306374313,52
1193,1,2516,909,1607,0,0,0,1.0,1,1.0,1,1.0,1,0.1512456582548096,53
1194,3,2519,910,1609,0,0,0,1.0,1,1.0,1,1.0,1,0.18874907645369235,53
1195,4,2523,911,1612,0,0,0,1.0,1,1.0,1,1.0,1,0.1713355175458573,54
1196,8,2531,911,1620,0,0,0,1.0,1,1.0,1,1.0,1,0.10702062989273456,56
1197,5,2536,912,1624,0,0,0,1.0,1,1.0,1,1.0,1,0.1200895021063114,56
1198,5,2541,913,1628,0,0,0,1.0,1,1.0,1,1.0,1,0.12867094044643645,58
1199,5,2546,914,1632,0,0,0,1.0,1,1.0,1,1.0,1,0.13358373886971298,58
1200,5,2551,914,1637,0,0,0,1.0,1,1.0,1,1.0,1,0.12010189713917471,58
1201,4,2555,916,1639,0,0,0,1.0,1,1.0,1,1.0,1,0.12330321860263206,58
1202,0,2555,916,1639,0,0,0,1.0,1,1.0,1,1.0,1,0.11009759240388707,60
1203,1,2556,916,1640,0,0,0,1.0,1,1.0,1,1.0,1,0.10269169832191614,58
1204,1,2557,917,1640,0,0,0,1.0,1,1.0,1,1.0,1,0.1204518954135986,59
1205,1,2558,918,1640,0,0,0,1.0,1,1.0,1,1.0,1,0.14445881739109442,59
1206,4,2562,918,1644,0,0,0,1.0,1,1.0,1,1.0,1,0.11913911568572333,58
1207,0,2562,918,1644,0,0,0,1.0,1,1.0,1,1.0,1,0.1314536845615781,60
1208,0,2562,918,1644,0,0,0,1.0,1,1.0,1,1.0,1,0.1314536845615781,60
1209,2,2564,918,1646,0,0,0,1.0,1,1.0,1,1.0,1,0.12553229335578464,61
1210,0,2564,918,1646,0,0,0,1.0,1,1.0,1,1.0,1,0.12553229335578464,61
1211,1,2565,918,1647,0,0,0,1.0,1,1.0,1,1.0,1,0.09934937373984042,63
1212,0,2565,918,1647,0,0,0,1.0,1,1.0,1,1.0,1,0.09934937373984042,63
1213,1,2566,919,1647,0,0,0,1.0,1,1.0,1,1.0,1,0.10917943546724315,63
1214,0,2566,919,1647,0,0,0,1.0,1,1.0,1,1.0,1,0.12923318334672765,62
1215,3,2569,919,1650,0,0,0,1.0,1,1.0,1,1.0,1,0.09797423218562812,63
1216,6,2575,920,1655,0,0,0,1.0,1,1.0,1,1.0,1,0.1120025541282396,64
1217,1,2576,920,1656,0,0,0,1.0,1,1.0,1,1.0,1,0.11783653212688229,65
1218,0,2576,920,1656,0,0,0,1.0,1,1.0,1,1.0,1,0.13375111105116685,64
1219,0,2576,920,1656,0,0,0,1.0,1,1.0,1,1.0,1,0.14399303227954272,65
1220,2,2578,921,1657,0,0,0,1.0,1,1.0,1,1.0,1,0.15011842830979294,64
1221,3,2581,921,1660,0,0,0,1.0,1,1.0,1,1.0,1,0.12932827264794577,65
1222,3,2584,922,1662,0,0,0,1.0,1,1.0,1,1.0,1,0.10090748061191937,66
1223,3,2587,924,1663,0,0,0,1.0,1,1.0,1,1.0,1,0.08714576889332264,64
1224,3,2590,926,1664,0,0,0,1.0,1,1.0,1,1.0,1,0.0952089376314365,66
1225,6,2596,930,1666,0,0,0,1.0,1,1.0,1,1.0,1,0.0916969111334276,66
1226,5,2601,931,1670,0,0,0,1.0,1,1.0,1,1.0,1,0.08277537066211295,68
1227,3,2604,933,1671,0,0,0,1.0,1,1.0,1,1.0,1,0.06316985684074268,64
1228,1,2605,934,1671,0,0,0,1.0,1,1.0,1,1.0,1,0.09021836770632158,62
1229,1,2606,935,1671,0,0,0,1.0,1,1.0,1,1.0,1,0.08733312965375759,61
1230,1,2607,936,1671,0,0,0,1.0,1,1.0,1,1.0,1,0.09986723422628699,58
1231,3,2610,937,1673,0,0,0,1.0,1,1.0,1,1.0,1,0.07700650328676391,57
1232,1,2611,938,1673,0,0,0,1.0,1,1.0,1,1.0,1,0.14971218473078926,53
1233,1,2612,939,1673,0,0,0,1.0,1,1.0,1,1.0,1,0.16015246704418173,53
1234,0,2612,939,1673,0,0,0,1.0,1,1.0,1,1.0,1,0.14119747728372165,54
1235,2,2614,939,1675,0,0,0,1.0,1,1.0,1,1.0,1,0.13635543749057707,55
1236,3,2617,940,1677,0,0,0,1.0,1,1.0,1,1.0,1,0.13212179171308497,55
1237,4,2621,941,1680,0,0,0,1.0,1,1.0,1,1.0,1,0.09998285191205585,55
1238,0,2621,941,1680,0,0,0,1.0,1,1.0,1,1.0,1,0.10012673488448225,54
1239,1,2622,941,1681,0,0,0,1.0,1,1.0,1,1.0,1,0.12703526631982764,55
1240,0,2622,941,1681,0,0,0,1.0,1,1.0,1,1.0,1,0.12703526631982764,55
1241,6,2628,943,1685,0,0,0,1.0,1,1.0,1,1.0,1,0.09765021852388066,54
1242,0,2628,943,1685,0,0,0,1.0,1,1.0,1,1.0,1,0.10536197935896005,54
1243,5,2633,945,1688,0,0,0,1.0,1,1.0,1,1.0,1,0.15389145691216213,55
1244,5,2638,945,1693,0,0,0,1.0,1,1.0,1,1.0,1,0.16772797472133155,55
1245,6,2644,945,1699,0,0,0,1.0,1,1.0,1,1.0,1,0.19045119414305317,55
1246,3,2647,945,1702,0,0,0,1.0,1,1.0,1,1.0,1,0.135670832583077,55
1247,1,2648,945,1703,0,0,0,1.0,1,1.0,1,1.0,1,0.1358437627132832,57
1248,0,2648,945,1703,0,0,0,1.0,1,1.0,1,1.0,1,0.14903304594237607,56
1249,3,2651,948,1703,0,0,0,1.0,1,1.0,1,1.0,1,0.1733480031966064,56
1250,2,2653,950,1703,0,0,0,1.0,1,1.0,1,1.0,1,0.18472737660891392,56
1251,8,2661,950,1711,0,0,0,1.0,1,1.0,1,1.0,1,0.14059267404330095,58
1252,3,2664,952,1712,0,0,0,1.0,1,1.0,1,1.0,1,0.12549323853427666,58
1253,4,2668,953,1715,0,0,0,1.0,1,1.0,1,1.0,1,0.14825155282952687,58
1254,2,2670,953,1717,0,0,0,1.0,1,1.0,1,1.0,1,0.1447569459280917,60
1255,3,2673,953,1720,0,0,0,1.0,1,1.0,1,1.0,1,0.14425316438332164,61
1256,2,2675,953,1722,0,0,0,1.0,1,1.0,1,1.0,1,0.11950437262450095,61
1257,4,2679,955,1724,0,0,0,1.0,1,1.0,1,1.0,1,0.1464158502471854,62
1258,1,2680,955,1725,0,0,0,1.0,1,1.0,1,1.0,1,0.14241136015744757,63
1259,0,2680,955,1725,0,0,0,1.0,1,1.0,1,1.0,1,0.14241136015744757,63
1260,1,2681,955,1726,0,0,0,1.0,1,1.0,1,1.0,1,0.15271860364850703,63
1261,5,2686,955,1731,0,0,0,1.0,1,1.0,1,1.0,1,0.08457555126793266,63
1262,2,2688,957,1731,0,0,0,1.0,1,1.0,1,1.0,1,0.10837460856294488,64
1263,6,2694,958,1736,0,0,0,1.0,1,1.0,1,1.0,1,0.08237475413165676,63
1264,2,2696,959,1737,0,0,0,1.0,1,1.0,1,1.0,1,0.08572961522920283,63
1265,5,2701,961,1740,0,0,0,1.0,1,1.0,1,1.0,1,0.15792312329222252,60
1266,9,2710,965,1745,0,0,0,1.0,1,1.0,1,1.0,1,0.10391136908612435,61
1267,4,2714,968,1746,0,0,0,1.0,1,1.0,1,1.0,1,0.08016733339802379,58
1268,4,2718,971,1747,0,0,0,1.0,1,1.0,1,1.0,1,0.10425238074894463,54
1269,1,2719,972,1747,0,0,0,1.0,1,1.0,1,1.0,1,0.07940103730036399,54
1270,0,2719,972,1747,0,0,0,1.0,1,1.0,1,1.0,1,0.0750128884689395,51
1271,0,2719,972,1747,0,0,0,1.0,1,1.0,1,1.0,1,0.09302885251854068,50
1272,1,2720,973,1747,0,0,0,1.0,1,1.0,1,1.0,1,0.09469005440731865,47
1273,1,2721,974,1747,0,0,0,1.0,1,1.0,1,1.0,1,0.09715488029867059,47
1274,1,2722,975,1747,0,0,0,1.0,1,1.0,1,1.0,1,0.12453972654936062,49
1275,3,2725,977,1748,0,0,0,1.0,1,1.0,1,1.0,1,0.12026382215791165,48
1276,4,2729,977,1752,0,0,0,1.0,1,1.0,1,1.0,1,0.10792840557569734,49
1277,4,2733,980,1753,0,0,0,1.0,1,1.0,1,1.0,1,0.10405775691175122,50
1278,2,2735,980,1755,0,0,0,1.0,1,1.0,1,1.0,1,0.0926479179155842,51
1279,1,2736,981,1755,0,0,0,1.0,1,1.0,1,1.0,1,0.13706282390156854,51
1280,3,2739,981,1758,0,0,0,1.0,1,1.0,1,1.0,1,0.11630656044398657,52
1281,2,2741,981,1760,0,0,0,1.0,1,1.0,1,1.0,1,0.10423214714269852,52
1282,1,2742,982,1760,0,0,0,1.0,1,1.0,1,1.0,1,0.1145612755366526,52
1283,0,2742,982,1760,0,0,0,1.0,1,1.0,1,1.0,1,0.1145612755366526,52
1284,2,2744,984,1760,0,0,0,1.0,1,1.0,1,1.0,1,0.1478540976068329,52
1285,1,2745,984,1761,0,0,0,1.0,1,1.0,1,1.0,1,0.14873590957751462,51
1286,3,2748,984,1764,0,0,0,1.0,1,1.0,1,1.0,1,0.12953808125858307,52
1287,2,2750,985,1765,0,0,0,1.0,1,1.0,1,1.0,1,0.14954982614360274,54
1288,1,2751,985,1766,0,0,0,1.0,1,1.0,1,1.0,1,0.12509170842623155,55
1289,1,2752,985,1767,0,0,0,1.0,1,1.0,1,1.0,1,0.11487887653674553,56
1290,2,2754,986,1768,0,0,0,1.0,1,1.0,1,1.0,1,0.11042578940291058,57
1291,6,2760,986,1774,0,0,0,1.0,1,1.0,1,1.0,1,0.052282322712640016,58
1292,4,2764,988,1776,0,0,0,1.0,1,1.0,1,1.0,1,0.08549471453954338,59
1293,4,2768,988,1780,0,0,0,1.0,1,1.0,1,1.0,1,0.08853277678532366,59
1294,4,2772,988,1784,0,0,0,1.0,1,1.0,1,1.0,1,0.08912098098316802,59
1295,6,2778,989,1789,0,0,0,1.0,1,1.0,1,1.0,1,0.09474288538351092,59
1296,3,2781,989,1792,0,0,0,1.0,1,1.0,1,1.0,1,0.06534368318073092,59
1297,1,2782,990,1792,0,0,0,1.0,1,1.0,1,1.0,1,0.08059725234335832,61
1298,2,2784,990,1794,0,0,0,1.0,1,1.0,1,1.0,1,0.07403064458993655,61
1299,0,2784,990,1794,0,0,0,1.0,1,1.0,1,1.0,1,0.08495858462791953,60
1300,0,2784,990,1794,0,0,0,1.0,1,1.0,1,1.0,1,0.08113815550465417,59
1301,2,2786,991,1795,0,0,0,1.0,1,1.0,1,1.0,1,0.10221891935789408,59
1302,2,2788,993,1795,0,0,0,1.0,1,1.0,1,1.0,1,0.09027315574503851,59
1303,7,2795,998,1797,0,0,0,1.0,1,1.0,1,1.0,1,0.17916453104680577,55
1304,5,2800,1003,1797,0,0,0,1.0,1,1.0,1,1.0,1,0.1658325584328203,56
1305,4,2804,1006,1798,0,0,0,1.0,1,1.0,1,1.0,1,0.22770973870136021,54
1306,7,2811,1007,1804,0,0,0,1.0,1,1.0,1,1.0,1,0.15144173034882508,53
1307,3,2814,1008,1806,0,0,0,1.0,1,1.0,1,1.0,1,0.16177234348259156,52
1308,2,2816,1008,1808,0,0,0,1.0,1,1.0,1,1.0,1,0.16800882864438108,52
1309,5,2821,1009,1812,0,0,0,1.0,1,1.0,1,1.0,1,0.17846239838754646,54
1310,5,2826,1011,1815,0,0,0,1.0,1,1.0,1,1.0,1,0.19322505951399885,52
1311,7,2833,1012,1821,0,0,0,1.0,1,1.0,1,1.0,1,0.13547477546219472,51
1312,5,2838,1015,1823,0,0,0,1.0,1,1.0,1,1.0,1,0.18281122191659233,49
1313,0,2838,1015,1823,0,0,0,1.0,1,1.0,1,1.0,1,0.15553300997579952,47
1314,1,2839,1016,1823,0,0,0,1.0,1,1.0,1,1.0,1,0.176887330817843,46
1315,1,2840,1016,1824,0,0,0,1.0,1,1.0,1,1.0,1,0.1378937910873134,45
1316,4,2844,1018,1826,0,0,0,1.0,1,1.0,1,1.0,1,0.14714004078535575,46
1317,2,2846,1018,1828,0,0,0,1.0,1,1.0,1,1.0,1,0.1495433609651489,45
1318,3,2849,1019,1830,0,0,0,1.0,1,1.0,1,1.0,1,0.158951607412504,46
1319,3,2852,1019,1833,0,0,0,1.0,1,1.0,1,1.0,1,0.11860085170520865,46
1320,2,2854,1019,1835,0,0,0,1.0,1,1.0,1,1.0,1,0.11860085170520865,46
1321,1,2855,1019,1836,0,0,0,1.0,1,1.0,1,1.0,1,0.08680198814553491,48
1322,1,2856,1020,1836,0,0,0,1.0,1,1.0,1,1.0,1,0.0944945903621613,49
1323,0,2856,1020,1836,0,0,0,1.0,1,1.0,1,1.0,1,0.11268872907340617,49
1324,3,2859,1021,1838,0,0,0,1.0,1,1.0,1,1.0,1,0.12251549608773989,50
1325,0,2859,1021,1838,0,0,0,1.0,1,1.0,1,1.0,1,0.14005602657763855,49
1326,9,2868,1023,1845,0,0,0,1.0,1,1.0,1,1.0,1,0.11858811732967389,50
1327,0,2868,1023,1845,0,0,0,1.0,1,1.0,1,1.0,1,0.13242027725056166,50
1328,0,2868,1023,1845,0,0,0,1.0,1,1.0,1,1.0,1,0.1590617264175618,49
1329,0,2868,1023,1845,0,0,0,1.0,1,1.0,1,1.0,1,0.15769395687935506,50
1330,1,2869,1024,1845,0,0,0,1.0,1,1.0,1,1.0,1,0.1413433918137795,50
1331,3,2872,1025,1847,0,0,0,1.0,1,1.0,1,1.0,1,0.15424687875834375,50
1332,1,2873,1026,1847,0,0,0,1.0,1,1.0,1,1.0,1,0.13972547339131788,51
1333,3,2876,1027,1849,0,0,0,1.0,1,1.0,1,1.0,1,0.15142316694319846,52
1334,1,2877,1027,1850,0,0,0,1.0,1,1.0,1,1.0,1,0.15073392742113023,54
1335,0,2877,1027,1850,0,0,0,1.0,1,1.0,1,1.0,1,0.15073392742113023,54
1336,5,2882,1027,1855,0,0,0,1.0,1,1.0,1,1.0,1,0.13218785799175956,56
1337,4,2886,1028,1858,0,0,0,1.0,1,1.0,1,1.0,1,0.1647930606151442,57
1338,1,2887,1029,1858,0,0,0,1.0,1,1.0,1,1.0,1,0.16602102872150443,57
1339,4,2891,1031,1860,0,0,0,1.0,1,1.0,1,1.0,1,0.2305770166706768,58
1340,7,2898,1031,1867,0,0,0,1.0,1,1.0,1,1.0,1,0.23502051494827922,59
1341,3,2901,1031,1870,0,0,0,1.0,1,1.0,1,1.0,1,0.1775047354860072,57
1342,6,2907,1034,1873,0,0,0,1.0,1,1.0,1,1.0,1,0.17532322952443324,57
1343,0,2907,1034,1873,0,0,0,1.0,1,1.0,1,1.0,1,0.15310468887211656,55
1344,4,2911,1036,1875,0,0,0,1.0,1,1.0,1,1.0,1,0.166735447262206,54
1345,1,2912,1036,1876,0,0,0,1.0,1,1.0,1,1.0,1,0.1634987004851261,53
1346,5,2917,1036,1881,0,0,0,1.0,1,1.0,1,1.0,1,0.11596566766974348,53
1347,1,2918,1037,1881,0,0,0,1.0,1,1.0,1,1.0,1,0.14274737627828007,51
1348,3,2921,1039,1882,0,0,0,1.0,1,1.0,1,1.0,1,0.12366365946514897,52
1349,0,2921,1039,1882,0,0,0,1.0,1,1.0,1,1.0,1,0.14687885385220287,50
1350,2,2923,1041,1882,0,0,0,1.0,1,1.0,1,1.0,1,0.12966008203106263,51
1351,5,2928,1041,1887,0,0,0,1.0,1,1.0,1,1.0,1,0.11239755925959534,50
1352,1,2929,1041,1888,0,0,0,1.0,1,1.0,1,1.0,1,0.09921586110291512,50
1353,1,2930,1042,1888,0,0,0,1.0,1,1.0,1,1.0,1,0.08895218548635488,50
1354,1,2931,1043,1888,0,0,0,1.0,1,1.0,1,1.0,1,0.13550683318653656,51
1355,3,2934,1045,1889,0,0,0,1.0,1,1.0,1,1.0,1,0.13230860193310065,53
1356,3,2937,1046,1891,0,0,0,1.0,1,1.0,1,1.0,1,0.12494819235295539,52
1357,3,2940,1046,1894,0,0,0,1.0,1,1.0,1,1.0,1,0.13567957646417875,52
1358,4,2944,1046,1898,0,0,0,1.0,1,1.0,1,1.0,1,0.06477151590647565,53
1359,4,2948,1047,1901,0,0,0,1.0,1,1.0,1,1.0,1,0.09756811739217167,54
1360,5,2953,1048,1905,0,0,0,1.0,1,1.0,1,1.0,1,0.09352002549757901,55
1361,2,2955,1049,1906,0,0,0,1.0,1,1.0,1,1.0,1,0.07747650947566578,55
1362,1,2956,1049,1907,0,0,0,1.0,1,1.0,1,1.0,1,0.053704073843222455,56
1363,0,2956,1049,1907,0,0,0,1.0,1,1.0,1,1.0,1,0.053704073843222455,56
1364,0,2956,1049,1907,0,0,0,1.0,1,1.0,1,1.0,1,0.06361658311773588,55
1365,1,2957,1050,1907,0,0,0,1.0,1,1.0,1,1.0,1,0.09582477469692163,56
1366,3,2960,1052,1908,0,0,0,1.0,1,1.0,1,1.0,1,0.1297711584801934,57
1367,1,2961,1052,1909,0,0,0,1.0,1,1.0,1,1.0,1,0.13438588826462072,57
1368,3,2964,1052,1912,0,0,0,1.0,1,1.0,1,1.0,1,0.11294220934600609,58
1369,4,2968,1055,1913,0,0,0,1.0,1,1.0,1,1.0,1,0.1303531755341555,59
1370,1,2969,1056,1913,0,0,0,1.0,1,1.0,1,1.0,1,0.1358003048016315,60
1371,5,2974,1056,1918,0,0,0,1.0,1,1.0,1,1.0,1,0.07268470690930728,59
1372,2,2976,1058,1918,0,0,0,1.0,1,1.0,1,1.0,1,0.11210642193488593,59
1373,1,2977,1058,1919,0,0,0,1.0,1,1.0,1,1.0,1,0.10041870637255146,59
1374,1,2978,1059,1919,0,0,0,1.0,1,1.0,1,1.0,1,0.12064089689452127,59
1375,1,2979,1059,1920,0,0,0,1.0,1,1.0,1,1.0,1,0.11813014667859636,62
1376,3,2982,1059,1923,0,0,0,1.0,1,1.0,1,1.0,1,0.10634875701969411,61
1377,2,2984,1060,1924,0,0,0,1.0,1,1.0,1,1.0,1,0.11122206147384486,63
1378,0,2984,1060,1924,0,0,0,1.0,1,1.0,1,1.0,1,0.12435391170921505,62
1379,4,2988,1062,1926,0,0,0,1.0,1,1.0,1,1.0,1,0.16883529540319356,61
1380,1,2989,1063,1926,0,0,0,1.0,1,1.0,1,1.0,1,0.17145877612016183,60
1381,4,2993,1063,1930,0,0,0,1.0,1,1.0,1,1.0,1,0.14755127465584966,58
1382,1,2994,1064,1930,0,0,0,1.0,1,1.0,1,1.0,1,0.1346698146223292,56
1383,1,2995,1065,1930,0,0,0,1.0,1,1.0,1,1.0,1,0.13041028180077952,57
1384,3,2998,1066,1932,0,0,0,1.0,1,1.0,1,1.0,1,0.13916284854503155,55
1385,2,3000,1068,1932,0,0,0,1.0,1,1.0,1,1.0,1,0.15569020149666593,55
1386,6,3006,1069,1937,0,0,0,1.0,1,1.0,1,1.0,1,0.1031433199874146,54
1387,1,3007,1070,1937,0,0,0,1.0,1,1.0,1,1.0,1,0.10558229208179953,53
1388,3,3010,1072,1938,0,0,0,1.0,1,1.0,1,1.0,1,0.1288360986302232,52
1389,2,3012,1072,1940,0,0,0,1.0,1,1.0,1,1.0,1,0.12853037973966774,52
1390,2,3014,1072,1942,0,0,0,1.0,1,1.0,1,1.0,1,0.11196675535713324,51
1391,2,3016,1072,1944,0,0,0,1.0,1,1.0,1,1.0,1,0.09774006670161947,52
1392,1,3017,1073,1944,0,0,0,1.0,1,1.0,1,1.0,1,0.09781552794190454,51
1393,2,3019,1074,1945,0,0,0,1.0,1,1.0,1,1.0,1,0.10646676004966625,51
1394,1,3020,1074,1946,0,0,0,1.0,1,1.0,1,1.0,1,0.11547780209444687,52
1395,1,3021,1074,1947,0,0,0,1.0,1,1.0,1,1.0,1,0.1249905102215897,52
1396,6,3027,1076,1951,0,0,0,1.0,1,1.0,1,1.0,1,0.12548259871151318,53
1397,2,3029,1076,1953,0,0,0,1.0,1,1.0,1,1.0,1,0.12673453343216104,56
1398,1,3030,1077,1953,0,0,0,1.0,1,1.0,1,1.0,1,0.14982948503685306,56
1399,1,3031,1077,1954,0,0,0,1.0,1,1.0,1,1.0,1,0.13228206606179643,57
1400,2,3033,1078,1955,0,0,0,1.0,1,1.0,1,1.0,1,0.11559403581954192,57
1401,3,3036,1078,1958,0,0,0,1.0,1,1.0,1,1.0,1,0.09549631064938324,57
1402,3,3039,1080,1959,0,0,0,1.0,1,1.0,1,1.0,1,0.12237841971533078,57
1403,2,3041,1080,1961,0,0,0,1.0,1,1.0,1,1.0,1,0.1289147733006409,56
1404,2,3043,1080,1963,0,0,0,1.0,1,1.0,1,1.0,1,0.1264347233316888,58
1405,2,3045,1081,1964,0,0,0,1.0,1,1.0,1,1.0,1,0.17762838842596093,58
1406,2,3047,1081,1966,0,0,0,1.0,1,1.0,1,1.0,1,0.15660672205134885,58
1407,0,3047,1081,1966,0,0,0,1.0,1,1.0,1,1.0,1,0.1663975635043705,57
1408,3,3050,1081,1969,0,0,0,1.0,1,1.0,1,1.0,1,0.15643778681719053,58
1409,1,3051,1081,1970,0,0,0,1.0,1,1.0,1,1.0,1,0.14851170496098295,57
1410,0,3051,1081,1970,0,0,0,1.0,1,1.0,1,1.0,1,0.14851170496098295,57
1411,1,3052,1081,1971,0,0,0,1.0,1,1.0,1,1.0,1,0.16236607402385472,56
1412,0,3052,1081,1971,0,0,0,1.0,1,1.0,1,1.0,1,0.16628983989203164,55
1413,1,3053,1081,1972,0,0,0,1.0,1,1.0,1,1.0,1,0.15697555800917945,57
1414,1,3054,1081,1973,0,0,0,1.0,1,1.0,1,1.0,1,0.14469379724989714,57
1415,2,3056,1081,1975,0,0,0,1.0,1,1.0,1,1.0,1,0.12477050220495887,60
1416,1,3057,1082,1975,0,0,0,1.0,1,1.0,1,1.0,1,0.12150209949681953,61
1417,1,3058,1083,1975,0,0,0,1.0,1,1.0,1,1.0,1,0.10933512423747771,59
1418,1,3059,1083,1976,0,0,0,1.0,1,1.0,1,1.0,1,0.12559240126563753,60
1419,4,3063,1084,1979,0,0,0,1.0,1,1.0,1,1.0,1,0.11898071856973019,59
1420,2,3065,1084,1981,0,0,0,1.0,1,1.0,1,1.0,1,0.09596476054454234,58
1421,0,3065,1084,1981,0,0,0,1.0,1,1.0,1,1.0,1,0.08856727910055147,57
1422,1,3066,1085,1981,0,0,0,1.0,1,1.0,1,1.0,1,0.09597174967389407,57
1423,2,3068,1086,1982,0,0,0,1.0,1,1.0,1,1.0,1,0.1027872367744712,56
1424,1,3069,1087,1982,0,0,0,1.0,1,1.0,1,1.0,1,0.10759055040499525,57
1425,3,3072,1089,1983,0,0,0,1.0,1,1.0,1,1.0,1,0.1113716501836,54
1426,3,3075,1090,1985,0,0,0,1.0,1,1.0,1,1.0,1,0.10778842295429789,54
1427,4,3079,1092,1987,0,0,0,1.0,1,1.0,1,1.0,1,0.13965456508798513,53
1428,3,3082,1094,1988,0,0,0,1.0,1,1.0,1,1.0,1,0.12555160969020185,52
1429,0,3082,1094,1988,0,0,0,1.0,1,1.0,1,1.0,1,0.12555160969020185,52
1430,2,3084,1096,1988,0,0,0,1.0,1,1.0,1,1.0,1,0.1525395409892401,51
1431,0,3084,1096,1988,0,0,0,1.0,1,1.0,1,1.0,1,0.15245682498517069,51
1432,5,3089,1098,1991,0,0,0,1.0,1,1.0,1,1.0,1,0.11477186733136902,52
1433,3,3092,1099,1993,0,0,0,1.0,1,1.0,1,1.0,1,0.1194532133096051,52
1434,4,3096,1101,1995,0,0,0,1.0,1,1.0,1,1.0,1,0.15546716314884165,52
1435,3,3099,1104,1995,0,0,0,1.0,1,1.0,1,1.0,1,0.1750823932204157,50
1436,8,3107,1108,1999,0,0,0,1.0,1,1.0,1,1.0,1,0.15025076437742219,50
1437,0,3107,1108,1999,0,0,0,1.0,1,1.0,1,1.0,1,0.1615576180450981,49
1438,3,3110,1110,2000,0,0,0,1.0,1,1.0,1,1.0,1,0.2068495428722775,49
1439,2,3112,1110,2002,0,0,0,1.0,1,1.0,1,1.0,1,0.1993849795294525,50
1440,5,3117,1113,2004,0,0,0,1.0,1,1.0,1,1.0,1,0.2189905944509867,50
1441,4,3121,1113,2008,0,0,0,1.0,1,1.0,1,1.0,1,0.1537927053820358,51
1442,0,3121,1113,2008,0,0,0,1.0,1,1.0,1,1.0,1,0.17723228801734744,50
1443,2,3123,1113,2010,0,0,0,1.0,1,1.0,1,1.0,1,0.16456363023260567,51
1444,0,3123,1113,2010,0,0,0,1.0,1,1.0,1,1.0,1,0.16456363023260567,51
1445,1,3124,1114,2010,0,0,0,1.0,1,1.0,1,1.0,1,0.18299356208049075,51
1446,2,3126,1114,2012,0,0,0,1.0,1,1.0,1,1.0,1,0.16112698919465032,51
1447,1,3127,1114,2013,0,0,0,1.0,1,1.0,1,1.0,1,0.15115595407331725,51
1448,1,3128,1115,2013,0,0,0,1.0,1,1.0,1,1.0,1,0.141761076447352,51
1449,0,3128,1115,2013,0,0,0,1.0,1,1.0,1,1.0,1,0.141761076447352,51
1450,3,3131,1115,2016,0,0,0,1.0,1,1.0,1,1.0,1,0.11785732616779032,52
1451,3,3134,1115,2019,0,0,0,1.0,1,1.0,1,1.0,1,0.09096415279218778,54
1452,4,3138,1116,2022,0,0,0,1.0,1,1.0,1,1.0,1,0.09073376474854233,56
1453,3,3141,1117,2024,0,0,0,1.0,1,1.0,1,1.0,1,0.13253920458251586,56
1454,8,3149,1119,2030,0,0,0,1.0,1,1.0,1,1.0,1,0.12178594379864886,58
1455,5,3154,1121,2033,0,0,0,1.0,1,1.0,1,1.0,1,0.1621397449059582,55
1456,2,3156,1121,2035,0,0,0,1.0,1,1.0,1,1.0,1,0.1523073706711517,56
1457,2,3158,1122,2036,0,0,0,1.0,1,1.0,1,1.0,1,0.19046063491864312,54
1458,3,3161,1124,2037,0,0,0,1.0,1,1.0,1,1.0,1,0.18476729556324642,52
1459,1,3162,1124,2038,0,0,0,1.0,1,1.0,1,1.0,1,0.1777937702238274,52
1460,0,3162,1124,2038,0,0,0,1.0,1,1.0,1,1.0,1,0.1638021886501469,50
1461,1,3163,1124,2039,0,0,0,1.0,1,1.0,1,1.0,1,0.15273181456234564,53
1462,5,3168,1128,2040,0,0,0,1.0,1,1.0,1,1.0,1,0.16698552329766936,51
1463,2,3170,1129,2041,0,0,0,1.0,1,1.0,1,1.0,1,0.17384786599322996,51
1464,2,3172,1131,2041,0,0,0,1.0,1,1.0,1,1.0,1,0.20321772848914701,51
1465,0,3172,1131,2041,0,0,0,1.0,1,1.0,1,1.0,1,0.22572442938275897,49
1466,8,3180,1134,2046,0,0,0,1.0,1,1.0,1,1.0,1,0.15599663777653364,49
1467,3,3183,1135,2048,0,0,0,1.0,1,1.0,1,1.0,1,0.1908259167641848,47
1468,3,3186,1137,2049,0,0,0,1.0,1,1.0,1,1.0,1,0.19146155707112017,48
1469,3,3189,1139,2050,0,0,0,1.0,1,1.0,1,1.0,1,0.22481986809553772,47
1470,5,3194,1139,2055,0,0,0,1.0,1,1.0,1,1.0,1,0.1953105613877861,49
1471,4,3198,1139,2059,0,0,0,1.0,1,1.0,1,1.0,1,0.16967680979069333,48
1472,0,3198,1139,2059,0,0,0,1.0,1,1.0,1,1.0,1,0.16025367708547353,48
1473,0,3198,1139,2059,0,0,0,1.0,1,1.0,1,1.0,1,0.17069403674706013,49
1474,1,3199,1139,2060,0,0,0,1.0,1,1.0,1,1.0,1,0.1538286201872648,49
1475,0,3199,1139,2060,0,0,0,1.0,1,1.0,1,1.0,1,0.1538286201872648,49
1476,3,3202,1140,2062,0,0,0,1.0,1,1.0,1,1.0,1,0.1420638669032421,51
1477,2,3204,1141,2063,0,0,0,1.0,1,1.0,1,1.0,1,0.13838237288047606,51
1478,1,3205,1141,2064,0,0,0,1.0,1,1.0,1,1.0,1,0.10189325823129868,52
1479,2,3207,1142,2065,0,0,0,1.0,1,1.0,1,1.0,1,0.1519529591465477,53
1480,3,3210,1142,2068,0,0,0,1.0,1,1.0,1,1.0,1,0.14796352881983513,53
1481,3,3213,1142,2071,0,0,0,1.0,1,1.0,1,1.0,1,0.11258574890740516,53
1482,0,3213,1142,2071,0,0,0,1.0,1,1.0,1,1.0,1,0.1297125664393891,52
1483,1,3214,1142,2072,0,0,0,1.0,1,1.0,1,1.0,1,0.11604020889400468,52
1484,0,3214,1142,2072,0,0,0,1.0,1,1.0,1,1.0,1,0.1412604050053551,53
1485,0,3214,1142,2072,0,0,0,1.0,1,1.0,1,1.0,1,0.1412604050053551,53
1486,2,3216,1142,2074,0,0,0,1.0,1,1.0,1,1.0,1,0.15715160277429652,54
1487,2,3218,1143,2075,0,0,0,1.0,1,1.0,1,1.0,1,0.1591772309624621,55
1488,1,3219,1143,2076,0,0,0,1.0,1,1.0,1,1.0,1,0.15896287858913447,57
1489,3,3222,1145,2077,0,0,0,1.0,1,1.0,1,1.0,1,0.1434027633195913,58
1490,3,3225,1145,2080,0,0,0,1.0,1,1.0,1,1.0,1,0.13808383682369058,58
1491,7,3232,1147,2085,0,0,0,1.0,1,1.0,1,1.0,1,0.13549099619463795,59
1492,2,3234,1147,2087,0,0,0,1.0,1,1.0,1,1.0,1,0.152373414061728,59
1493,8,3242,1150,2092,0,0,0,1.0,1,1.0,1,1.0,1,0.1609805867096526,58
1494,3,3245,1151,2094,0,0,0,1.0,1,1.0,1,1.0,1,0.19045620423546628,58
1495,10,3255,1154,2101,0,0,0,1.0,1,1.0,1,1.0,1,0.22570564266076829,57
1496,6,3261,1154,2107,0,0,0,1.0,1,1.0,1,1.0,1,0.13534647157227692,59
1497,0,3261,1154,2107,0,0,0,1.0,1,1.0,1,1.0,1,0.1319891999044675,58
1498,0,3261,1154,2107,0,0,0,1.0,1,1.0,1,1.0,1,0.1319891999044675,58
1499,1,3262,1154,2108,0,0,0,1.0,1,1.0,1,1.0,1,0.13476276963500586,56
1500,1,3263,1155,2108,0,0,0,1.0,1,1.0,1,1.0,1,0.1383016623215661,57
1501,2,3265,1155,2110,0,0,0,1.0,1,1.0,1,1.0,1,0.11983869950725706,55
1502,1,3266,1156,2110,0,0,0,1.0,1,1.0,1,1.0,1,0.13195484579493313,55
1503,2,3268,1157,2111,0,0,0,1.0,1,1.0,1,1.0,1,0.13264501704718296,54
1504,2,3270,1158,2112,0,0,0,1.0,1,1.0,1,1.0,1,0.1178465579174469,55
1505,2,3272,1160,2112,0,0,0,1.0,1,1.0,1,1.0,1,0.11717653781610897,53
1506,7,3279,1162,2117,0,0,0,1.0,1,1.0,1,1.0,1,0.09036231268472275,55
1507,0,3279,1162,2117,0,0,0,1.0,1,1.0,1,1.0,1,0.09748123057658262,53
1508,3,3282,1164,2118,0,0,0,1.0,1,1.0,1,1.0,1,0.10827954671132882,53
1509,0,3282,1164,2118,0,0,0,1.0,1,1.0,1,1.0,1,0.11671089590837867,52
1510,2,3284,1166,2118,0,0,0,1.0,1,1.0,1,1.0,1,0.14662529764319993,50
1511,3,3287,1166,2121,0,0,0,1.0,1,1.0,1,1.0,1,0.10248120280283982,49
1512,5,3292,1169,2123,0,0,0,1.0,1,1.0,1,1.0,1,0.12575861758583742,48
1513,2,3294,1170,2124,0,0,0,1.0,1,1.0,1,1.0,1,0.14320154216546227,47
1514,1,3295,1171,2124,0,0,0,1.0,1,1.0,1,1.0,1,0.11843175594167414,48
1515,1,3296,1171,2125,0,0,0,1.0,1,1.0,1,1.0,1,0.1256149336743324,48
1516,3,3299,1171,2128,0,0,0,1.0,1,1.0,1,1.0,1,0.11306813804265335,47
1517,2,3301,1171,2130,0,0,0,1.0,1,1.0,1,1.0,1,0.10363667549987926,48
1518,1,3302,1171,2131,0,0,0,1.0,1,1.0,1,1.0,1,0.09399156924999716,48
1519,0,3302,1171,2131,0,0,0,1.0,1,1.0,1,1.0,1,0.10348008055207943,47
1520,2,3304,1173,2131,0,0,0,1.0,1,1.0,1,1.0,1,0.1427486837308023,48
1521,3,3307,1173,2134,0,0,0,1.0,1,1.0,1,1.0,1,0.09105130170068074,49
1522,1,3308,1173,2135,0,0,0,1.0,1,1.0,1,1.0,1,0.0880388088298861,48
1523,3,3311,1173,2138,0,0,0,1.0,1,1.0,1,1.0,1,0.067235402679334,49
1524,1,3312,1174,2138,0,0,0,1.0,1,1.0,1,1.0,1,0.08409342033500532,49
1525,2,3314,1175,2139,0,0,0,1.0,1,1.0,1,1.0,1,0.136160400559588,51
1526,2,3316,1175,2141,0,0,0,1.0,1,1.0,1,1.0,1,0.09743387951572618,52
1527,3,3319,1176,2143,0,0,0,1.0,1,1.0,1,1.0,1,0.14195787333069435,54
1528,3,3322,1177,2145,0,0,0,1.0,1,1.0,1,1.0,1,0.15127798501107065,54
1529,3,3325,1177,2148,0,0,0,1.0,1,1.0,1,1.0,1,0.1456375060935194,54
1530,1,3326,1177,2149,0,0,0,1.0,1,1.0,1,1.0,1,0.18603048501737285,54
1531,5,3331,1177,2154,0,0,0,1.0,1,1.0,1,1.0,1,0.11595151153810793,54
1532,1,3332,1177,2155,0,0,0,1.0,1,1.0,1,1.0,1,0.11595694023909947,54
1533,1,3333,1177,2156,0,0,0,1.0,1,1.0,1,1.0,1,0.11783927770449673,54
1534,1,3334,1177,2157,0,0,0,1.0,1,1.0,1,1.0,1,0.09770837561577733,54
1535,1,3335,1177,2158,0,0,0,1.0,1,1.0,1,1.0,1,0.09150437654680733,54
1536,2,3337,1177,2160,0,0,0,1.0,1,1.0,1,1.0,1,0.08476733317575441,55
1537,0,3337,1177,2160,0,0,0,1.0,1,1.0,1,1.0,1,0.08817976308690562,53
1538,2,3339,1177,2162,0,0,0,1.0,1,1.0,1,1.0,1,0.05365569875890757,54
1539,0,3339,1177,2162,0,0,0,1.0,1,1.0,1,1.0,1,0.07610925888748127,54
1540,2,3341,1178,2163,0,0,0,1.0,1,1.0,1,1.0,1,0.0754049492598422,54
1541,0,3341,1178,2163,0,0,0,1.0,1,1.0,1,1.0,1,0.07789391812091893,54
1542,3,3344,1180,2164,0,0,0,1.0,1,1.0,1,1.0,1,0.11578268200953627,57
1543,6,3350,1183,2167,0,0,0,1.0,1,1.0,1,1.0,1,0.11877904192592292,55
1544,3,3353,1184,2169,0,0,0,1.0,1,1.0,1,1.0,1,0.11145756211997442,54
1545,4,3357,1185,2172,0,0,0,1.0,1,1.0,1,1.0,1,0.09179442754618782,54
1546,4,3361,1187,2174,0,0,0,1.0,1,1.0,1,1.0,1,0.07742349145372283,53
1547,1,3362,1188,2174,0,0,0,1.0,1,1.0,1,1.0,1,0.07757625619962509,53
1548,4,3366,1190,2176,0,0,0,1.0,1,1.0,1,1.0,1,0.07492325817108018,54
1549,1,3367,1191,2176,0,0,0,1.0,1,1.0,1,1.0,1,0.08860125837084569,52
1550,6,3373,1197,2176,0,0,0,1.0,1,1.0,1,1.0,1,0.15904818206213478,52
1551,10,3383,1200,2183,0,0,0,1.0,1,1.0,1,1.0,1,0.1330808126362984,52
1552,11,3394,1204,2190,0,0,0,1.0,1,1.0,1,1.0,1,0.14127027353447746,51
1553,8,3402,1205,2197,0,0,0,1.0,1,1.0,1,1.0,1,0.14784757054648306,51
1554,6,3408,1207,2201,0,0,0,1.0,1,1.0,1,1.0,1,0.2211494191462741,51
1555,4,3412,1208,2204,0,0,0,1.0,1,1.0,1,1.0,1,0.19799401210209144,50
1556,8,3420,1209,2211,0,0,0,1.0,1,1.0,1,1.0,1,0.1059634567425206,51
1557,3,3423,1211,2212,0,0,0,1.0,1,1.0,1,1.0,1,0.13563977283505374,51
1558,1,3424,1212,2212,0,0,0,1.0,1,1.0,1,1.0,1,0.12254336030632512,52
1559,3,3427,1212,2215,0,0,0,1.0,1,1.0,1,1.0,1,0.10092855934268756,53
1560,5,3432,1213,2219,0,0,0,1.0,1,1.0,1,1.0,1,0.13852251388086334,51
1561,4,3436,1213,2223,0,0,0,1.0,1,1.0,1,1.0,1,0.07502499567952367,51
1562,0,3436,1213,2223,0,0,0,1.0,1,1.0,1,1.0,1,0.0853846127518223,52
1563,0,3436,1213,2223,0,0,0,1.0,1,1.0,1,1.0,1,0.0853846127518223,52
1564,0,3436,1213,2223,0,0,0,1.0,1,1.0,1,1.0,1,0.11017073193867975,51
1565,2,3438,1214,2224,0,0,0,1.0,1,1.0,1,1.0,1,0.08023321794334727,53
1566,1,3439,1214,2225,0,0,0,1.0,1,1.0,1,1.0,1,0.10241905721651572,53
1567,0,3439,1214,2225,0,0,0,1.0,1,1.0,1,1.0,1,0.13100206288396934,52
1568,2,3441,1215,2226,0,0,0,1.0,1,1.0,1,1.0,1,0.1324742274565717,52
1569,2,3443,1216,2227,0,0,0,1.0,1,1.0,1,1.0,1,0.1155909165789973,49
1570,1,3444,1216,2228,0,0,0,1.0,1,1.0,1,1.0,1,0.09422895837546046,48
1571,4,3448,1216,2232,0,0,0,1.0,1,1.0,1,1.0,1,0.06201953576817097,46
1572,0,3448,1216,2232,0,0,0,1.0,1,1.0,1,1.0,1,0.07301224654635224,47
1573,2,3450,1217,2233,0,0,0,1.0,1,1.0,1,1.0,1,0.042201383406862567,48
1574,0,3450,1217,2233,0,0,0,1.0,1,1.0,1,1.0,1,0.08464931413234744,46
1575,2,3452,1219,2233,0,0,0,1.0,1,1.0,1,1.0,1,0.1378752473142857,47
1576,12,3464,1223,2241,0,0,0,1.0,1,1.0,1,1.0,1,0.11589008225556113,46
1577,1,3465,1223,2242,0,0,0,1.0,1,1.0,1,1.0,1,0.09330032336609748,45
1578,0,3465,1223,2242,0,0,0,1.0,1,1.0,1,1.0,1,0.09262072935358318,44
1579,1,3466,1224,2242,0,0,0,1.0,1,1.0,1,1.0,1,0.11793685879587162,43
1580,0,3466,1224,2242,0,0,0,1.0,1,1.0,1,1.0,1,0.11793685879587162,43
1581,2,3468,1225,2243,0,0,0,1.0,1,1.0,1,1.0,1,0.1683785628295152,42
1582,0,3468,1225,2243,0,0,0,1.0,1,1.0,1,1.0,1,0.1683785628295152,42
1583,2,3470,1226,2244,0,0,0,1.0,1,1.0,1,1.0,1,0.1609340190542605,43
1584,2,3472,1228,2244,0,0,0,1.0,1,1.0,1,1.0,1,0.15580206786940734,41
1585,3,3475,1230,2245,0,0,0,1.0,1,1.0,1,1.0,1,0.1238977150146482,43
1586,2,3477,1231,2246,0,0,0,1.0,1,1.0,1,1.0,1,0.09356423169075884,42
1587,0,3477,1231,2246,0,0,0,1.0,1,1.0,1,1.0,1,0.09520700545345541,42
1588,5,3482,1234,2248,0,0,0,1.0,1,1.0,1,1.0,1,0.1556392020636376,42
1589,3,3485,1235,2250,0,0,0,1.0,1,1.0,1,1.0,1,0.1540777624744948,42
1590,4,3489,1236,2253,0,0,0,1.0,1,1.0,1,1.0,1,0.22278043464519098,41
1591,6,3495,1237,2258,0,0,0,1.0,1,1.0,1,1.0,1,0.14385041657194764,40
1592,2,3497,1238,2259,0,0,0,1.0,1,1.0,1,1.0,1,0.15278693999437865,39
1593,2,3499,1240,2259,0,0,0,1.0,1,1.0,1,1.0,1,0.2110097987064205,39
1594,1,3500,1240,2260,0,0,0,1.0,1,1.0,1,1.0,1,0.18638448495498305,39
1595,3,3503,1242,2261,0,0,0,1.0,1,1.0,1,1.0,1,0.20107797059414137,42
1596,0,3503,1242,2261,0,0,0,1.0,1,1.0,1,1.0,1,0.2015034627744715,41
1597,1,3504,1242,2262,0,0,0,1.0,1,1.0,1,1.0,1,0.19175328116230245,41
1598,2,3506,1242,2264,0,0,0,1.0,1,1.0,1,1.0,1,0.17253190695901527,39
1599,0,3506,1242,2264,0,0,0,1.0,1,1.0,1,1.0,1,0.17253190695901527,39
1600,4,3510,1245,2265,0,0,0,1.0,1,1.0,1,1.0,1,0.16641129951955294,40
1601,5,3515,1246,2269,0,0,0,1.0,1,1.0,1,1.0,1,0.15313721961882,41
1602,2,3517,1247,2270,0,0,0,1.0,1,1.0,1,1.0,1,0.12787458617591643,41
1603,5,3522,1248,2274,0,0,0,1.0,1,1.0,1,1.0,1,0.15752268672048783,43
1604,1,3523,1248,2275,0,0,0,1.0,1,1.0,1,1.0,1,0.17430170063520992,43
1605,2,3525,1249,2276,0,0,0,1.0,1,1.0,1,1.0,1,0.19376675549837888,44
1606,6,3531,1251,2280,0,0,0,1.0,1,1.0,1,1.0,1,0.11424719958132343,44
1607,5,3536,1252,2284,0,0,0,1.0,1,1.0,1,1.0,1,0.09861188488764223,42
1608,4,3540,1253,2287,0,0,0,1.0,1,1.0,1,1.0,1,0.16310760210117242,41
1609,4,3544,1253,2291,0,0,0,1.0,1,1.0,1,1.0,1,0.15418453183378583,39
1610,5,3549,1253,2296,0,0,0,1.0,1,1.0,1,1.0,1,0.18583712527256135,39
1611,3,3552,1253,2299,0,0,0,1.0,1,1.0,1,1.0,1,0.12809354661597744,40
1612,0,3552,1253,2299,0,0,0,1.0,1,1.0,1,1.0,1,0.13095552940912727,39
1613,1,3553,1254,2299,0,0,0,1.0,1,1.0,1,1.0,1,0.19108228222304044,41
1614,2,3555,1254,2301,0,0,0,1.0,1,1.0,1,1.0,1,0.12464108067424236,41
1615,2,3557,1254,2303,0,0,0,1.0,1,1.0,1,1.0,1,0.1686954281443046,41
1616,4,3561,1255,2306,0,0,0,1.0,1,1.0,1,1.0,1,0.14417879717302215,43
1617,2,3563,1256,2307,0,0,0,1.0,1,1.0,1,1.0,1,0.15638507959394626,44
1618,1,3564,1256,2308,0,0,0,1.0,1,1.0,1,1.0,1,0.14369010103712213,44
1619,1,3565,1257,2308,0,0,0,1.0,1,1.0,1,1.0,1,0.17942945780496647,44
1620,2,3567,1258,2309,0,0,0,1.0,1,1.0,1,1.0,1,0.19691670750069304,45
1621,3,3570,1258,2312,0,0,0,1.0,1,1.0,1,1.0,1,0.1452006074469262,44
1622,2,3572,1260,2312,0,0,0,1.0,1,1.0,1,1.0,1,0.1556290265181644,44
1623,2,3574,1261,2313,0,0,0,1.0,1,1.0,1,1.0,1,0.1654765095209078,43
1624,4,3578,1262,2316,0,0,0,1.0,1,1.0,1,1.0,1,0.10971906703221741,43
1625,1,3579,1263,2316,0,0,0,1.0,1,1.0,1,1.0,1,0.13590195363961377,43
1626,3,3582,1264,2318,0,0,0,1.0,1,1.0,1,1.0,1,0.1468458491607788,42
1627,2,3584,1265,2319,0,0,0,1.0,1,1.0,1,1.0,1,0.12792977246510723,42
1628,4,3588,1266,2322,0,0,0,1.0,1,1.0,1,1.0,1,0.10312487766807764,42
1629,1,3589,1266,2323,0,0,0,1.0,1,1.0,1,1.0,1,0.10287340727323772,41
1630,3,3592,1269,2323,0,0,0,1.0,1,1.0,1,1.0,1,0.11469500847312589,41
1631,2,3594,1271,2323,0,0,0,1.0,1,1.0,1,1.0,1,0.16059817990915437,40
1632,1,3595,1271,2324,0,0,0,1.0,1,1.0,1,1.0,1,0.15688615491595018,39
1633,1,3596,1271,2325,0,0,0,1.0,1,1.0,1,1.0,1,0.13032533934299764,39
1634,0,3596,1271,2325,0,0,0,1.0,1,1.0,1,1.0,1,0.13032533934299764,39
1635,3,3599,1272,2327,0,0,0,1.0,1,1.0,1,1.0,1,0.1542857181797123,40
1636,4,3603,1272,2331,0,0,0,1.0,1,1.0,1,1.0,1,0.08597693064425792,41
1637,2,3605,1273,2332,0,0,0,1.0,1,1.0,1,1.0,1,0.10396999486543951,41
1638,4,3609,1274,2335,0,0,0,1.0,1,1.0,1,1.0,1,0.10611032970238633,42
1639,4,3613,1275,2338,0,0,0,1.0,1,1.0,1,1.0,1,0.1295444351792801,43
1640,4,3617,1275,2342,0,0,0,1.0,1,1.0,1,1.0,1,0.1295444351792801,43
1641,3,3620,1276,2344,0,0,0,1.0,1,1.0,1,1.0,1,0.08779759437232629,44
1642,5,3625,1278,2347,0,0,0,1.0,1,1.0,1,1.0,1,0.11444749876387932,45
1643,3,3628,1280,2348,0,0,0,1.0,1,1.0,1,1.0,1,0.1294406114083248,44
1644,2,3630,1281,2349,0,0,0,1.0,1,1.0,1,1.0,1,0.15523357283218805,45
1645,2,3632,1282,2350,0,0,0,1.0,1,1.0,1,1.0,1,0.1410192459469748,44
1646,3,3635,1283,2352,0,0,0,1.0,1,1.0,1,1.0,1,0.111814879972565,43
1647,2,3637,1285,2352,0,0,0,1.0,1,1.0,1,1.0,1,0.15902552272249887,43
1648,1,3638,1285,2353,0,0,0,1.0,1,1.0,1,1.0,1,0.18636528653134116,42
1649,1,3639,1285,2354,0,0,0,1.0,1,1.0,1,1.0,1,0.18804244249618046,41
1650,0,3639,1285,2354,0,0,0,1.0,1,1.0,1,1.0,1,0.18804244249618046,41
1651,3,3642,1285,2357,0,0,0,1.0,1,1.0,1,1.0,1,0.16100909693273396,40
1652,0,3642,1285,2357,0,0,0,1.0,1,1.0,1,1.0,1,0.17821244565329322,39
1653,1,3643,1285,2358,0,0,0,1.0,1,1.0,1,1.0,1,0.18061036607731515,39
1654,0,3643,1285,2358,0,0,0,1.0,1,1.0,1,1.0,1,0.18061036607731515,39
1655,4,3647,1287,2360,0,0,0,1.0,1,1.0,1,1.0,1,0.23223034601515433,40
1656,3,3650,1287,2363,0,0,0,1.0,1,1.0,1,1.0,1,0.18484753798629477,40
1657,0,3650,1287,2363,0,0,0,1.0,1,1.0,1,1.0,1,0.18484753798629477,40
1658,1,3651,1287,2364,0,0,0,1.0,1,1.0,1,1.0,1,0.15150375273624345,40
1659,5,3656,1288,2368,0,0,0,1.0,1,1.0,1,1.0,1,0.10203431262169473,40
1660,4,3660,1290,2370,0,0,0,1.0,1,1.0,1,1.0,1,0.12139056877032874,41
1661,2,3662,1292,2370,0,0,0,1.0,1,1.0,1,1.0,1,0.12100322679338436,42
1662,3,3665,1293,2372,0,0,0,1.0,1,1.0,1,1.0,1,0.12554130394482643,44
1663,1,3666,1294,2372,0,0,0,1.0,1,1.0,1,1.0,1,0.14041010372525412,43
1664,4,3670,1296,2374,0,0,0,1.0,1,1.0,1,1.0,1,0.12770870342125923,42
1665,2,3672,1297,2375,0,0,0,1.0,1,1.0,1,1.0,1,0.12192954938394424,42
1666,8,3680,1302,2378,0,0,0,1.0,1,1.0,1,1.0,1,0.19385524170990556,43
1667,5,3685,1305,2380,0,0,0,1.0,1,1.0,1,1.0,1,0.19437434258363165,40
1668,1,3686,1305,2381,0,0,0,1.0,1,1.0,1,1.0,1,0.13613999029166396,40
1669,1,3687,1306,2381,0,0,0,1.0,1,1.0,1,1.0,1,0.11957686156573795,40
1670,0,3687,1306,2381,0,0,0,1.0,1,1.0,1,1.0,1,0.1160395620452154,39
1671,2,3689,1306,2383,0,0,0,1.0,1,1.0,1,1.0,1,0.08366956629643339,39
1672,1,3690,1307,2383,0,0,0,1.0,1,1.0,1,1.0,1,0.12260029101634191,38
1673,2,3692,1308,2384,0,0,0,1.0,1,1.0,1,1.0,1,0.11030771661882902,38
1674,1,3693,1308,2385,0,0,0,1.0,1,1.0,1,1.0,1,0.11056341555483666,38
1675,2,3695,1310,2385,0,0,0,1.0,1,1.0,1,1.0,1,0.1468862998066895,39
1676,0,3695,1310,2385,0,0,0,1.0,1,1.0,1,1.0,1,0.13997039398939362,39
1677,1,3696,1310,2386,0,0,0,1.0,1,1.0,1,1.0,1,0.11879192364186052,40
1678,0,3696,1310,2386,0,0,0,1.0,1,1.0,1,1.0,1,0.11883348318991142,39
1679,2,3698,1312,2386,0,0,0,1.0,1,1.0,1,1.0,1,0.1826617757228106,39
1680,2,3700,1312,2388,0,0,0,1.0,1,1.0,1,1.0,1,0.15621076611037327,40
1681,1,3701,1312,2389,0,0,0,1.0,1,1.0,1,1.0,1,0.13563709820800326,41
1682,1,3702,1312,2390,0,0,0,1.0,1,1.0,1,1.0,1,0.11629231579617966,40
1683,5,3707,1314,2393,0,0,0,1.0,1,1.0,1,1.0,1,0.12087955407307567,43
1684,1,3708,1315,2393,0,0,0,1.0,1,1.0,1,1.0,1,0.1554809106656354,42
1685,1,3709,1316,2393,0,0,0,1.0,1,1.0,1,1.0,1,0.1451822173948018,41
1686,2,3711,1316,2395,0,0,0,1.0,1,1.0,1,1.0,1,0.12672694596860135,39
1687,3,3714,1318,2396,0,0,0,1.0,1,1.0,1,1.0,1,0.18939336546721566,41
1688,4,3718,1321,2397,0,0,0,1.0,1,1.0,1,1.0,1,0.17651926379405924,39
1689,4,3722,1324,2398,0,0,0,1.0,1,1.0,1,1.0,1,0.18545053793853447,37
1690,1,3723,1324,2399,0,0,0,1.0,1,1.0,1,1.0,1,0.17268330475311722,36
1691,5,3728,1327,2401,0,0,0,1.0,1,1.0,1,1.0,1,0.24202387404775844,36
1692,1,3729,1327,2402,0,0,0,1.0,1,1.0,1,1.0,1,0.17624304125755197,34
1693,0,3729,1327,2402,0,0,0,1.0,1,1.0,1,1.0,1,0.15353125029616807,33
1694,1,3730,1328,2402,0,0,0,1.0,1,1.0,1,1.0,1,0.15853828605376302,32
1695,0,3730,1328,2402,0,0,0,1.0,1,1.0,1,1.0,1,0.2132485130571406,32
1696,2,3732,1328,2404,0,0,0,1.0,1,1.0,1,1.0,1,0.20692824950244396,34
1697,0,3732,1328,2404,0,0,0,1.0,1,1.0,1,1.0,1,0.20692824950244396,34
1698,2,3734,1330,2404,0,0,0,1.0,1,1.0,1,1.0,1,0.2500406823965176,36
1699,5,3739,1332,2407,0,0,0,1.0,1,1.0,1,1.0,1,0.23792973005783466,36
1700,2,3741,1332,2409,0,0,0,1.0,1,1.0,1,1.0,1,0.22457300122886484,37
1701,2,3743,1333,2410,0,0,0,1.0,1,1.0,1,1.0,1,0.21878523519164284,39
1702,1,3744,1334,2410,0,0,0,1.0,1,1.0,1,1.0,1,0.2392939294588359,39
1703,4,3748,1336,2412,0,0,0,1.0,1,1.0,1,1.0,1,0.22181857234872498,38
1704,4,3752,1339,2413,0,0,0,1.0,1,1.0,1,1.0,1,0.1870691831115229,38
1705,1,3753,1339,2414,0,0,0,1.0,1,1.0,1,1.0,1,0.17735099685951755,37
1706,3,3756,1341,2415,0,0,0,1.0,1,1.0,1,1.0,1,0.16875966518389698,37
1707,2,3758,1342,2416,0,0,0,1.0,1,1.0,1,1.0,1,0.16242306738678028,36
1708,1,3759,1342,2417,0,0,0,1.0,1,1.0,1,1.0,1,0.1574673413808201,34
1709,3,3762,1344,2418,0,0,0,1.0,1,1.0,1,1.0,1,0.17105642225581996,34
1710,0,3762,1344,2418,0,0,0,1.0,1,1.0,1,1.0,1,0.23369760665593847,33
1711,5,3767,1346,2421,0,0,0,1.0,1,1.0,1,1.0,1,0.21968557180180764,32
1712,3,3770,1347,2423,0,0,0,1.0,1,1.0,1,1.0,1,0.2576836200881693,31
1713,6,3776,1348,2428,0,0,0,1.0,1,1.0,1,1.0,1,0.2707530429422229,32
1714,3,3779,1348,2431,0,0,0,1.0,1,1.0,1,1.0,1,0.30182783810370206,32
1715,5,3784,1348,2436,0,0,0,1.0,1,1.0,1,1.0,1,0.2567861991213558,32
1716,3,3787,1349,2438,0,0,0,1.0,1,1.0,1,1.0,1,0.26039974552073064,34
1717,3,3790,1349,2441,0,0,0,1.0,1,1.0,1,1.0,1,0.20211703380844964,34
1718,1,3791,1349,2442,0,0,0,1.0,1,1.0,1,1.0,1,0.2228725169638842,34
1719,0,3791,1349,2442,0,0,0,1.0,1,1.0,1,1.0,1,0.2228725169638842,34
1720,1,3792,1350,2442,0,0,0,1.0,1,1.0,1,1.0,1,0.2298595132188983,34
1721,1,3793,1350,2443,0,0,0,1.0,1,1.0,1,1.0,1,0.20883253342600241,35
1722,1,3794,1350,2444,0,0,0,1.0,1,1.0,1,1.0,1,0.18445552834255657,35
1723,0,3794,1350,2444,0,0,0,1.0,1,1.0,1,1.0,1,0.19438013251964587,34
1724,1,3795,1350,2445,0,0,0,1.0,1,1.0,1,1.0,1,0.18427110862239315,33
1725,0,3795,1350,2445,0,0,0,1.0,1,1.0,1,1.0,1,0.20299731492828735,35
1726,3,3798,1350,2448,0,0,0,1.0,1,1.0,1,1.0,1,0.15009502358680857,34
1727,2,3800,1351,2449,0,0,0,1.0,1,1.0,1,1.0,1,0.14782641742433986,34
1728,1,3801,1351,2450,0,0,0,1.0,1,1.0,1,1.0,1,0.11920650847243489,35
1729,0,3801,1351,2450,0,0,0,1.0,1,1.0,1,1.0,1,0.12524179963404292,35
1730,3,3804,1352,2452,0,0,0,1.0,1,1.0,1,1.0,1,0.15295977974959118,35
1731,0,3804,1352,2452,0,0,0,1.0,1,1.0,1,1.0,1,0.1569975277349251,35
1732,1,3805,1352,2453,0,0,0,1.0,1,1.0,1,1.0,1,0.13772424779729897,35
1733,0,3805,1352,2453,0,0,0,1.0,1,1.0,1,1.0,1,0.18434734723327015,33
1734,4,3809,1354,2455,0,0,0,1.0,1,1.0,1,1.0,1,0.18005374253591777,34
1735,1,3810,1354,2456,0,0,0,1.0,1,1.0,1,1.0,1,0.22569163078398338,33
1736,7,3817,1356,2461,0,0,0,1.0,1,1.0,1,1.0,1,0.14416508470201914,33
1737,1,3818,1356,2462,0,0,0,1.0,1,1.0,1,1.0,1,0.14829978042069125,35
1738,3,3821,1357,2464,0,0,0,1.0,1,1.0,1,1.0,1,0.12146450988915786,36
1739,1,3822,1358,2464,0,0,0,1.0,1,1.0,1,1.0,1,0.13224788191246972,36
1740,3,3825,1358,2467,0,0,0,1.0,1,1.0,1,1.0,1,0.12177740530743542,37
1741,4,3829,1358,2471,0,0,0,1.0,1,1.0,1,1.0,1,0.06848831854257345,36
1742,0,3829,1358,2471,0,0,0,1.0,1,1.0,1,1.0,1,0.06848831854257345,36
1743,1,3830,1359,2471,0,0,0,1.0,1,1.0,1,1.0,1,0.10191402361527596,37
1744,1,3831,1359,2472,0,0,0,1.0,1,1.0,1,1.0,1,0.1123667988749493,37
1745,5,3836,1361,2475,0,0,0,1.0,1,1.0,1,1.0,1,0.18584094207444787,38
1746,3,3839,1361,2478,0,0,0,1.0,1,1.0,1,1.0,1,0.12802610215536958,38
1747,0,3839,1361,2478,0,0,0,1.0,1,1.0,1,1.0,1,0.13715476590602382,37
1748,0,3839,1361,2478,0,0,0,1.0,1,1.0,1,1.0,1,0.12757259259112136,38
1749,0,3839,1361,2478,0,0,0,1.0,1,1.0,1,1.0,1,0.12757259259112136,38
1750,3,3842,1362,2480,0,0,0,1.0,1,1.0,1,1.0,1,0.13107465153886255,39
1751,1,3843,1362,2481,0,0,0,1.0,1,1.0,1,1.0,1,0.092286202181087,41
1752,1,3844,1363,2481,0,0,0,1.0,1,1.0,1,1.0,1,0.12905825988063807,41
1753,2,3846,1364,2482,0,0,0,1.0,1,1.0,1,1.0,1,0.1235941326555012,41
1754,0,3846,1364,2482,0,0,0,1.0,1,1.0,1,1.0,1,0.11935712051344566,40
1755,3,3849,1365,2484,0,0,0,1.0,1,1.0,1,1.0,1,0.13964046898752566,41
1756,2,3851,1365,2486,0,0,0,1.0,1,1.0,1,1.0,1,0.10431412205257987,41
1757,1,3852,1366,2486,0,0,0,1.0,1,1.0,1,1.0,1,0.14081828740629143,40
1758,1,3853,1367,2486,0,0,0,1.0,1,1.0,1,1.0,1,0.1691072276553994,41
1759,3,3856,1369,2487,0,0,0,1.0,1,1.0,1,1.0,1,0.2478071394042371,38
1760,3,3859,1370,2489,0,0,0,1.0,1,1.0,1,1.0,1,0.2615555111932613,38
1761,4,3863,1372,2491,0,0,0,1.0,1,1.0,1,1.0,1,0.2514201316412437,37
1762,3,3866,1372,2494,0,0,0,1.0,1,1.0,1,1.0,1,0.2131602946391132,37
1763,1,3867,1372,2495,0,0,0,1.0,1,1.0,1,1.0,1,0.18729289100578048,37
1764,2,3869,1373,2496,0,0,0,1.0,1,1.0,1,1.0,1,0.19385532681718967,36
1765,3,3872,1374,2498,0,0,0,1.0,1,1.0,1,1.0,1,0.2160227904226559,36
1766,3,3875,1375,2500,0,0,0,1.0,1,1.0,1,1.0,1,0.1748061406598996,37
1767,2,3877,1376,2501,0,0,0,1.0,1,1.0,1,1.0,1,0.1484590356572507,37
1768,4,3881,1377,2504,0,0,0,1.0,1,1.0,1,1.0,1,0.17964772153383468,37
1769,4,3885,1378,2507,0,0,0,1.0,1,1.0,1,1.0,1,0.20729833560833247,38
1770,4,3889,1378,2511,0,0,0,1.0,1,1.0,1,1.0,1,0.20728780480308673,39
1771,3,3892,1378,2514,0,0,0,1.0,1,1.0,1,1.0,1,0.1744775541135123,39
1772,0,3892,1378,2514,0,0,0,1.0,1,1.0,1,1.0,1,0.1744775541135123,39
1773,0,3892,1378,2514,0,0,0,1.0,1,1.0,1,1.0,1,0.16163916319920624,41
1774,0,3892,1378,2514,0,0,0,1.0,1,1.0,1,1.0,1,0.16163916319920624,41
1775,1,3893,1378,2515,0,0,0,1.0,1,1.0,1,1.0,1,0.13594941825027668,42
1776,1,3894,1378,2516,0,0,0,1.0,1,1.0,1,1.0,1,0.11871890022492984,43
1777,0,3894,1378,2516,0,0,0,1.0,1,1.0,1,1.0,1,0.11871890022492984,43
1778,1,3895,1378,2517,0,0,0,1.0,1,1.0,1,1.0,1,0.11237957161349026,44
1779,1,3896,1378,2518,0,0,0,1.0,1,1.0,1,1.0,1,0.11722521300787055,46
1780,0,3896,1378,2518,0,0,0,1.0,1,1.0,1,1.0,1,0.11722521300787055,46
1781,1,3897,1378,2519,0,0,0,1.0,1,1.0,1,1.0,1,0.103249752398166,46
1782,1,3898,1378,2520,0,0,0,1.0,1,1.0,1,1.0,1,0.11938680233715987,46
1783,1,3899,1379,2520,0,0,0,1.0,1,1.0,1,1.0,1,0.11579466482406767,44
1784,2,3901,1381,2520,0,0,0,1.0,1,1.0,1,1.0,1,0.13517964142690544,45
1785,1,3902,1381,2521,0,0,0,1.0,1,1.0,1,1.0,1,0.13234812600485785,42
1786,6,3908,1384,2524,0,0,0,1.0,1,1.0,1,1.0,1,0.19280948853220437,43
1787,2,3910,1385,2525,0,0,0,1.0,1,1.0,1,1.0,1,0.16094376421006035,41
1788,4,3914,1386,2528,0,0,0,1.0,1,1.0,1,1.0,1,0.18282462842916253,41
1789,7,3921,1387,2534,0,0,0,1.0,1,1.0,1,1.0,1,0.13509601506042626,41
1790,2,3923,1388,2535,0,0,0,1.0,1,1.0,1,1.0,1,0.15093215497808354,41
1791,4,3927,1389,2538,0,0,0,1.0,1,1.0,1,1.0,1,0.10924392335124487,40
1792,1,3928,1389,2539,0,0,0,1.0,1,1.0,1,1.0,1,0.09648263795871233,40
1793,3,3931,1390,2541,0,0,0,1.0,1,1.0,1,1.0,1,0.1278109577884436,41
1794,4,3935,1392,2543,0,0,0,1.0,1,1.0,1,1.0,1,0.15361405973068754,41
1795,3,3938,1394,2544,0,0,0,1.0,1,1.0,1,1.0,1,0.22768420098627865,40
1796,7,3945,1396,2549,0,0,0,1.0,1,1.0,1,1.0,1,0.13619440085393536,40
1797,1,3946,1397,2549,0,0,0,1.0,1,1.0,1,1.0,1,0.1724226779629682,37
1798,2,3948,1398,2550,0,0,0,1.0,1,1.0,1,1.0,1,0.1902106753274416,37
1799,4,3952,1400,2552,0,0,0,1.0,1,1.0,1,1.0,1,0.25837266301084094,36
1800,2,3954,1400,2554,0,0,0,1.0,1,1.0,1,1.0,1,0.2628799761584831,36
1801,3,3957,1400,2557,0,0,0,1.0,1,1.0,1,1.0,1,0.21669790617972298,34
1802,0,3957,1400,2557,0,0,0,1.0,1,1.0,1,1.0,1,0.19104721179805476,33
1803,2,3959,1401,2558,0,0,0,1.0,1,1.0,1,1.0,1,0.16389803694623203,33
1804,0,3959,1401,2558,0,0,0,1.0,1,1.0,1,1.0,1,0.16389803694623203,33
1805,0,3959,1401,2558,0,0,0,1.0,1,1.0,1,1.0,1,0.1620863813731887,35
1806,4,3963,1403,2560,0,0,0,1.0,1,1.0,1,1.0,1,0.16006024712982586,35
1807,2,3965,1403,2562,0,0,0,1.0,1,1.0,1,1.0,1,0.1411947211602876,35
1808,3,3968,1404,2564,0,0,0,1.0,1,1.0,1,1.0,1,0.13316740793843018,36
1809,1,3969,1404,2565,0,0,0,1.0,1,1.0,1,1.0,1,0.15235418885906796,36
1810,0,3969,1404,2565,0,0,0,1.0,1,1.0,1,1.0,1,0.14624676747168278,35
1811,3,3972,1404,2568,0,0,0,1.0,1,1.0,1,1.0,1,0.1604463412849709,36
1812,1,3973,1404,2569,0,0,0,1.0,1,1.0,1,1.0,1,0.15093195186828373,36
1813,1,3974,1405,2569,0,0,0,1.0,1,1.0,1,1.0,1,0.16503311902543466,36
1814,3,3977,1407,2570,0,0,0,1.0,1,1.0,1,1.0,1,0.2528771566694523,34
1815,1,3978,1407,2571,0,0,0,1.0,1,1.0,1,1.0,1,0.2402238605089235,35
1816,6,3984,1407,2577,0,0,0,1.0,1,1.0,1,1.0,1,0.17348588229364753,34
1817,0,3984,1407,2577,0,0,0,1.0,1,1.0,1,1.0,1,0.17348588229364753,34
1818,0,3984,1407,2577,0,0,0,1.0,1,1.0,1,1.0,1,0.17348588229364753,34
1819,3,3987,1408,2579,0,0,0,1.0,1,1.0,1,1.0,1,0.14827107857174773,35
1820,2,3989,1409,2580,0,0,0,1.0,1,1.0,1,1.0,1,0.16409942763190982,36
1821,2,3991,1409,2582,0,0,0,1.0,1,1.0,1,1.0,1,0.12976960789959763,36
1822,0,3991,1409,2582,0,0,0,1.0,1,1.0,1,1.0,1,0.140028928696437,37
1823,6,3997,1411,2586,0,0,0,1.0,1,1.0,1,1.0,1,0.11136210184556411,38
1824,1,3998,1412,2586,0,0,0,1.0,1,1.0,1,1.0,1,0.13250749663948716,37
1825,3,4001,1414,2587,0,0,0,1.0,1,1.0,1,1.0,1,0.2065767549381291,36
1826,3,4004,1415,2589,0,0,0,1.0,1,1.0,1,1.0,1,0.11712280546658484,35
1827,1,4005,1416,2589,0,0,0,1.0,1,1.0,1,1.0,1,0.14020016718552564,35
1828,1,4006,1416,2590,0,0,0,1.0,1,1.0,1,1.0,1,0.1186572744431735,33
1829,1,4007,1416,2591,0,0,0,1.0,1,1.0,1,1.0,1,0.15650799234120194,32
1830,2,4009,1418,2591,0,0,0,1.0,1,1.0,1,1.0,1,0.17881665889500656,32
1831,3,4012,1419,2593,0,0,0,1.0,1,1.0,1,1.0,1,0.20464974146199985,30
1832,1,4013,1420,2593,0,0,0,1.0,1,1.0,1,1.0,1,0.24167662614410612,30
1833,3,4016,1420,2596,0,0,0,1.0,1,1.0,1,1.0,1,0.15525649054181603,29
1834,2,4018,1422,2596,0,0,0,1.0,1,1.0,1,1.0,1,0.19355747661588205,28
1835,4,4022,1423,2599,0,0,0,1.0,1,1.0,1,1.0,1,0.2808705117044064,28
1836,4,4026,1424,2602,0,0,0,1.0,1,1.0,1,1.0,1,0.23272878604271238,29
1837,1,4027,1424,2603,0,0,0,1.0,1,1.0,1,1.0,1,0.30043525860008774,28
1838,1,4028,1425,2603,0,0,0,1.0,1,1.0,1,1.0,1,0.2919356741107144,28
1839,2,4030,1427,2603,0,0,0,1.0,1,1.0,1,1.0,1,0.3292047635348966,27
1840,1,4031,1427,2604,0,0,0,1.0,1,1.0,1,1.0,1,0.37433898959275497,26
1841,4,4035,1427,2608,0,0,0,1.0,1,1.0,1,1.0,1,0.23386122931479694,25
1842,3,4038,1427,2611,0,0,0,1.0,1,1.0,1,1.0,1,0.210636994928558,26
1843,2,4040,1427,2613,0,0,0,1.0,1,1.0,1,1.0,1,0.20986958905905753,26
1844,4,4044,1428,2616,0,0,0,1.0,1,1.0,1,1.0,1,0.19568371769046936,26
1845,2,4046,1428,2618,0,0,0,1.0,1,1.0,1,1.0,1,0.18670004133244683,26
1846,1,4047,1428,2619,0,0,0,1.0,1,1.0,1,1.0,1,0.15795889426857762,26
1847,0,4047,1428,2619,0,0,0,1.0,1,1.0,1,1.0,1,0.15795889426857762,26
1848,1,4048,1429,2619,0,0,0,1.0,1,1.0,1,1.0,1,0.15925011931109156,27
1849,0,4048,1429,2619,0,0,0,1.0,1,1.0,1,1.0,1,0.15925011931109156,27
1850,0,4048,1429,2619,0,0,0,1.0,1,1.0,1,1.0,1,0.1762680531446115,28
1851,0,4048,1429,2619,0,0,0,1.0,1,1.0,1,1.0,1,0.1762680531446115,28
1852,0,4048,1429,2619,0,0,0,1.0,1,1.0,1,1.0,1,0.1762680531446115,28
1853,0,4048,1429,2619,0,0,0,1.0,1,1.0,1,1.0,1,0.2078077181845482,27
1854,1,4049,1429,2620,0,0,0,1.0,1,1.0,1,1.0,1,0.2109297412153149,28
1855,0,4049,1429,2620,0,0,0,1.0,1,1.0,1,1.0,1,0.2109297412153149,28
1856,0,4049,1429,2620,0,0,0,1.0,1,1.0,1,1.0,1,0.23527514163161156,30
1857,1,4050,1430,2620,0,0,0,1.0,1,1.0,1,1.0,1,0.2846003297258663,31
1858,4,4054,1431,2623,0,0,0,1.0,1,1.0,1,1.0,1,0.2765654402852764,31
1859,2,4056,1431,2625,0,0,0,1.0,1,1.0,1,1.0,1,0.2765654402852764,31
1860,1,4057,1431,2626,0,0,0,1.0,1,1.0,1,1.0,1,0.2786437832420765,31
1861,2,4059,1432,2627,0,0,0,1.0,1,1.0,1,1.0,1,0.27887080085364585,31
1862,0,4059,1432,2627,0,0,0,1.0,1,1.0,1,1.0,1,0.27887080085364585,31
1863,2,4061,1433,2628,0,0,0,1.0,1,1.0,1,1.0,1,0.2713512746557549,31
1864,5,4066,1436,2630,0,0,0,1.0,1,1.0,1,1.0,1,0.2878806790311335,30
1865,1,4067,1436,2631,0,0,0,1.0,1,1.0,1,1.0,1,0.27492628583453593,27
1866,3,4070,1438,2632,0,0,0,1.0,1,1.0,1,1.0,1,0.3064276577449875,28
1867,1,4071,1439,2632,0,0,0,1.0,1,1.0,1,1.0,1,0.3062673412722227,26
1868,1,4072,1440,2632,0,0,0,1.0,1,1.0,1,1.0,1,0.3323573704952281,26
1869,0,4072,1440,2632,0,0,0,1.0,1,1.0,1,1.0,1,0.3335725054399506,25
1870,3,4075,1441,2634,0,0,0,1.0,1,1.0,1,1.0,1,0.30902957868937053,25
1871,6,4081,1441,2640,0,0,0,1.0,1,1.0,1,1.0,1,0.16905039833105281,26
1872,0,4081,1441,2640,0,0,0,1.0,1,1.0,1,1.0,1,0.16407762100211803,25
1873,0,4081,1441,2640,0,0,0,1.0,1,1.0,1,1.0,1,0.21395564428221606,23
1874,1,4082,1442,2640,0,0,0,1.0,1,1.0,1,1.0,1,0.1960959104169643,23
1875,1,4083,1442,2641,0,0,0,1.0,1,1.0,1,1.0,1,0.22683725307055538,21
1876,3,4086,1443,2643,0,0,0,1.0,1,1.0,1,1.0,1,0.19096154261598208,24
1877,1,4087,1443,2644,0,0,0,1.0,1,1.0,1,1.0,1,0.16793418614691594,24
1878,0,4087,1443,2644,0,0,0,1.0,1,1.0,1,1.0,1,0.16930045356109305,26
1879,0,4087,1443,2644,0,0,0,1.0,1,1.0,1,1.0,1,0.16930045356109305,26
1880,0,4087,1443,2644,0,0,0,1.0,1,1.0,1,1.0,1,0.16930045356109305,26
1881,1,4088,1444,2644,0,0,0,1.0,1,1.0,1,1.0,1,0.17459306108124661,26
1882,0,4088,1444,2644,0,0,0,1.0,1,1.0,1,1.0,1,0.19062641590190318,25
1883,0,4088,1444,2644,0,0,0,1.0,1,1.0,1,1.0,1,0.19062641590190318,25
1884,0,4088,1444,2644,0,0,0,1.0,1,1.0,1,1.0,1,0.19062641590190318,25
1885,0,4088,1444,2644,0,0,0,1.0,1,1.0,1,1.0,1,0.19062641590190318,25
1886,0,4088,1444,2644,0,0,0,1.0,1,1.0,1,1.0,1,0.16691122338445158,26
1887,0,4088,1444,2644,0,0,0,1.0,1,1.0,1,1.0,1,0.16691122338445158,26
1888,1,4089,1445,2644,0,0,0,1.0,1,1.0,1,1.0,1,0.21778695776299528,27
1889,0,4089,1445,2644,0,0,0,1.0,1,1.0,1,1.0,1,0.22983488709768116,28
1890,0,4089,1445,2644,0,0,0,1.0,1,1.0,1,1.0,1,0.22983488709768116,28
1891,2,4091,1445,2646,0,0,0,1.0,1,1.0,1,1.0,1,0.21414628457789825,29
1892,0,4091,1445,2646,0,0,0,1.0,1,1.0,1,1.0,1,0.21414628457789825,29
1893,0,4091,1445,2646,0,0,0,1.0,1,1.0,1,1.0,1,0.21414628457789825,29
1894,1,4092,1445,2647,0,0,0,1.0,1,1.0,1,1.0,1,0.19641420672015103,29
1895,1,4093,1445,2648,0,0,0,1.0,1,1.0,1,1.0,1,0.2104348043518255,31
1896,1,4094,1445,2649,0,0,0,1.0,1,1.0,1,1.0,1,0.1843275458305556,31
1897,0,4094,1445,2649,0,0,0,1.0,1,1.0,1,1.0,1,0.1843275458305556,31
1898,0,4094,1445,2649,0,0,0,1.0,1,1.0,1,1.0,1,0.1843275458305556,31
1899,1,4095,1445,2650,0,0,0,1.0,1,1.0,1,1.0,1,0.20289313759041927,32
1900,0,4095,1445,2650,0,0,0,1.0,1,1.0,1,1.0,1,0.20289313759041927,32
1901,0,4095,1445,2650,0,0,0,1.0,1,1.0,1,1.0,1,0.20289313759041927,32
1902,1,4096,1446,2650,0,0,0,1.0,1,1.0,1,1.0,1,0.2283928771008326,32
1903,0,4096,1446,2650,0,0,0,1.0,1,1.0,1,1.0,1,0.2283928771008326,32
1904,1,4097,1446,2651,0,0,0,1.0,1,1.0,1,1.0,1,0.19296326356271906,34
1905,0,4097,1446,2651,0,0,0,1.0,1,1.0,1,1.0,1,0.19296326356271906,34
1906,0,4097,1446,2651,0,0,0,1.0,1,1.0,1,1.0,1,0.19779357504054504,35
1907,0,4097,1446,2651,0,0,0,1.0,1,1.0,1,1.0,1,0.1984922403434458,36
1908,0,4097,1446,2651,0,0,0,1.0,1,1.0,1,1.0,1,0.1984922403434458,36
1909,1,4098,1446,2652,0,0,0,1.0,1,1.0,1,1.0,1,0.19935032845825146,37
1910,2,4100,1447,2653,0,0,0,1.0,1,1.0,1,1.0,1,0.22912102322522537,38
1911,3,4103,1447,2656,0,0,0,1.0,1,1.0,1,1.0,1,0.16797064989922572,37
1912,1,4104,1447,2657,0,0,0,1.0,1,1.0,1,1.0,1,0.12863584919371682,37
1913,1,4105,1448,2657,0,0,0,1.0,1,1.0,1,1.0,1,0.14675603746436347,36
1914,0,4105,1448,2657,0,0,0,1.0,1,1.0,1,1.0,1,0.18963643551365567,37
1915,0,4105,1448,2657,0,0,0,1.0,1,1.0,1,1.0,1,0.18963643551365567,37
1916,3,4108,1449,2659,0,0,0,1.0,1,1.0,1,1.0,1,0.13385502184519116,39
1917,2,4110,1450,2660,0,0,0,1.0,1,1.0,1,1.0,1,0.13711154348281582,38
1918,0,4110,1450,2660,0,0,0,1.0,1,1.0,1,1.0,1,0.16383451204782531,38
1919,2,4112,1451,2661,0,0,0,1.0,1,1.0,1,1.0,1,0.23167073265505533,38
1920,5,4117,1452,2665,0,0,0,1.0,1,1.0,1,1.0,1,0.26401138448354317,39
1921,3,4120,1452,2668,0,0,0,1.0,1,1.0,1,1.0,1,0.1996265356545511,38
1922,2,4122,1453,2669,0,0,0,1.0,1,1.0,1,1.0,1,0.17940929664027513,39
1923,2,4124,1455,2669,0,0,0,1.0,1,1.0,1,1.0,1,0.22706403582423257,40
1924,1,4125,1455,2670,0,0,0,1.0,1,1.0,1,1.0,1,0.2151743105710104,40
1925,3,4128,1456,2672,0,0,0,1.0,1,1.0,1,1.0,1,0.21133775720409886,40
1926,6,4134,1456,2678,0,0,0,1.0,1,1.0,1,1.0,1,0.11344385698095709,40
1927,2,4136,1456,2680,0,0,0,1.0,1,1.0,1,1.0,1,0.1375799225633402,41
1928,2,4138,1457,2681,0,0,0,1.0,1,1.0,1,1.0,1,0.12113324979545344,41
1929,2,4140,1457,2683,0,0,0,1.0,1,1.0,1,1.0,1,0.1184765436484591,40
1930,2,4142,1458,2684,0,0,0,1.0,1,1.0,1,1.0,1,0.11254547245859826,40
1931,2,4144,1459,2685,0,0,0,1.0,1,1.0,1,1.0,1,0.10901282627897485,40
1932,0,4144,1459,2685,0,0,0,1.0,1,1.0,1,1.0,1,0.10901282627897485,40
1933,0,4144,1459,2685,0,0,0,1.0,1,1.0,1,1.0,1,0.12704205646476716,42
1934,1,4145,1459,2686,0,0,0,1.0,1,1.0,1,1.0,1,0.12947932701098772,44
1935,0,4145,1459,2686,0,0,0,1.0,1,1.0,1,1.0,1,0.12947932701098772,44
1936,3,4148,1459,2689,0,0,0,1.0,1,1.0,1,1.0,1,0.11159365714199214,46
1937,2,4150,1460,2690,0,0,0,1.0,1,1.0,1,1.0,1,0.09814066529386765,47
1938,0,4150,1460,2690,0,0,0,1.0,1,1.0,1,1.0,1,0.09814066529386765,47
1939,1,4151,1460,2691,0,0,0,1.0,1,1.0,1,1.0,1,0.10371534988494646,47
1940,0,4151,1460,2691,0,0,0,1.0,1,1.0,1,1.0,1,0.10371534988494646,47
1941,2,4153,1461,2692,0,0,0,1.0,1,1.0,1,1.0,1,0.10730078463533588,47
1942,5,4158,1463,2695,0,0,0,1.0,1,1.0,1,1.0,1,0.16135863305569328,49
1943,3,4161,1464,2697,0,0,0,1.0,1,1.0,1,1.0,1,0.13033910829643555,47
1944,6,4167,1467,2700,0,0,0,1.0,1,1.0,1,1.0,1,0.16191578702097137,47
1945,7,4174,1470,2704,0,0,0,1.0,1,1.0,1,1.0,1,0.15268290971955578,45
1946,5,4179,1472,2707,0,0,0,1.0,1,1.0,1,1.0,1,0.137714334066153,45
1947,5,4184,1474,2710,0,0,0,1.0,1,1.0,1,1.0,1,0.1703636793878018,45
1948,4,4188,1476,2712,0,0,0,1.0,1,1.0,1,1.0,1,0.1811415828409422,45
1949,5,4193,1478,2715,0,0,0,1.0,1,1.0,1,1.0,1,0.1931648089131965,42
1950,1,4194,1478,2716,0,0,0,1.0,1,1.0,1,1.0,1,0.19206338451347985,42
1951,5,4199,1479,2720,0,0,0,1.0,1,1.0,1,1.0,1,0.1104342713207535,38
1952,3,4202,1482,2720,0,0,0,1.0,1,1.0,1,1.0,1,0.2047771382537171,36
1953,1,4203,1483,2720,0,0,0,1.0,1,1.0,1,1.0,1,0.2196682911592306,35
1954,4,4207,1484,2723,0,0,0,1.0,1,1.0,1,1.0,1,0.2667247040937977,32
1955,0,4207,1484,2723,0,0,0,1.0,1,1.0,1,1.0,1,0.22542842447009068,33
1956,6,4213,1485,2728,0,0,0,1.0,1,1.0,1,1.0,1,0.1575649877847758,31
1957,3,4216,1485,2731,0,0,0,1.0,1,1.0,1,1.0,1,0.15101776689918905,33
1958,3,4219,1487,2732,0,0,0,1.0,1,1.0,1,1.0,1,0.19800209581496545,34
1959,1,4220,1487,2733,0,0,0,1.0,1,1.0,1,1.0,1,0.1880335775487705,35
1960,9,4229,1488,2741,0,0,0,1.0,1,1.0,1,1.0,1,0.19407776303265356,36
1961,3,4232,1490,2742,0,0,0,1.0,1,1.0,1,1.0,1,0.17704884580107005,36
1962,0,4232,1490,2742,0,0,0,1.0,1,1.0,1,1.0,1,0.16196318771245388,35
1963,0,4232,1490,2742,0,0,0,1.0,1,1.0,1,1.0,1,0.169136841255834,36
1964,0,4232,1490,2742,0,0,0,1.0,1,1.0,1,1.0,1,0.19448107850139815,35
1965,1,4233,1490,2743,0,0,0,1.0,1,1.0,1,1.0,1,0.1567593058670028,36
1966,3,4236,1492,2744,0,0,0,1.0,1,1.0,1,1.0,1,0.191557619505877,36
1967,3,4239,1494,2745,0,0,0,1.0,1,1.0,1,1.0,1,0.19053536938767163,36
1968,2,4241,1494,2747,0,0,0,1.0,1,1.0,1,1.0,1,0.1812300663418008,37
1969,3,4244,1495,2749,0,0,0,1.0,1,1.0,1,1.0,1,0.14795647621943014,37
1970,1,4245,1495,2750,0,0,0,1.0,1,1.0,1,1.0,1,0.15306325154241274,38
1971,1,4246,1495,2751,0,0,0,1.0,1,1.0,1,1.0,1,0.1576213413922139,37
1972,1,4247,1496,2751,0,0,0,1.0,1,1.0,1,1.0,1,0.16817132694345957,37
1973,1,4248,1497,2751,0,0,0,1.0,1,1.0,1,1.0,1,0.20837550332108476,37
1974,0,4248,1497,2751,0,0,0,1.0,1,1.0,1,1.0,1,0.22441382735944754,38
1975,2,4250,1498,2752,0,0,0,1.0,1,1.0,1,1.0,1,0.19852644039424186,37
1976,4,4254,1498,2756,0,0,0,1.0,1,1.0,1,1.0,1,0.170473575900576,39
1977,0,4254,1498,2756,0,0,0,1.0,1,1.0,1,1.0,1,0.1678995779387297,42
1978,1,4255,1499,2756,0,0,0,1.0,1,1.0,1,1.0,1,0.16939803310535248,42
1979,0,4255,1499,2756,0,0,0,1.0,1,1.0,1,1.0,1,0.16939803310535248,42
1980,1,4256,1499,2757,0,0,0,1.0,1,1.0,1,1.0,1,0.15481497669476302,43
1981,1,4257,1499,2758,0,0,0,1.0,1,1.0,1,1.0,1,0.14151604185443314,44
1982,2,4259,1501,2758,0,0,0,1.0,1,1.0,1,1.0,1,0.14183921378321623,44
1983,1,4260,1502,2758,0,0,0,1.0,1,1.0,1,1.0,1,0.15625141567275322,44
1984,2,4262,1503,2759,0,0,0,1.0,1,1.0,1,1.0,1,0.12514735445277914,42
1985,3,4265,1505,2760,0,0,0,1.0,1,1.0,1,1.0,1,0.21133678833111535,41
1986,2,4267,1505,2762,0,0,0,1.0,1,1.0,1,1.0,1,0.12036385418171884,40
1987,2,4269,1506,2763,0,0,0,1.0,1,1.0,1,1.0,1,0.129633429619553,37
1988,1,4270,1507,2763,0,0,0,1.0,1,1.0,1,1.0,1,0.1704032194487957,35
1989,2,4272,1508,2764,0,0,0,1.0,1,1.0,1,1.0,1,0.179139004299383,32
1990,1,4273,1509,2764,0,0,0,1.0,1,1.0,1,1.0,1,0.16031946054777743,31
1991,1,4274,1510,2764,0,0,0,1.0,1,1.0,1,1.0,1,0.13053083818632483,32
1992,3,4277,1513,2764,0,0,0,1.0,1,1.0,1,1.0,1,0.2330912754495763,32
1993,3,4280,1514,2766,0,0,0,1.0,1,1.0,1,1.0,1,0.2075019940334974,32
1994,0,4280,1514,2766,0,0,0,1.0,1,1.0,1,1.0,1,0.1985441565255793,31
1995,0,4280,1514,2766,0,0,0,1.0,1,1.0,1,1.0,1,0.23886519856328173,32
1996,3,4283,1514,2769,0,0,0,1.0,1,1.0,1,1.0,1,0.18488170634289944,32
1997,0,4283,1514,2769,0,0,0,1.0,1,1.0,1,1.0,1,0.22726993137998278,31
1998,0,4283,1514,2769,0,0,0,1.0,1,1.0,1,1.0,1,0.2018867507713226,32
1999,1,4284,1515,2769,0,0,0,1.0,1,1.0,1,1.0,1,0.20634542988627513,31
2000,0,4284,1515,2769,0,0,0,1.0,1,1.0,1,1.0,1,0.19789548202923607,30
2001,4,4288,1515,2773,0,0,0,1.0,1,1.0,1,1.0,1,0.12973057981475347,29
2002,3,4291,1515,2776,0,0,0,1.0,1,1.0,1,1.0,1,0.12381755460332847,31
2003,3,4294,1516,2778,0,0,0,1.0,1,1.0,1,1.0,1,0.17131583748296492,33
2004,4,4298,1517,2781,0,0,0,1.0,1,1.0,1,1.0,1,0.21999061228760988,34
2005,5,4303,1517,2786,0,0,0,1.0,1,1.0,1,1.0,1,0.19112905573916353,35
2006,4,4307,1519,2788,0,0,0,1.0,1,1.0,1,1.0,1,0.17779467445554847,36
2007,1,4308,1519,2789,0,0,0,1.0,1,1.0,1,1.0,1,0.15023963098881984,36
2008,1,4309,1520,2789,0,0,0,1.0,1,1.0,1,1.0,1,0.1583396106779743,36
2009,3,4312,1520,2792,0,0,0,1.0,1,1.0,1,1.0,1,0.12184488028141677,37
2010,3,4315,1521,2794,0,0,0,1.0,1,1.0,1,1.0,1,0.10950469507598917,37
2011,0,4315,1521,2794,0,0,0,1.0,1,1.0,1,1.0,1,0.10950469507598917,37
2012,0,4315,1521,2794,0,0,0,1.0,1,1.0,1,1.0,1,0.10950469507598917,37
2013,1,4316,1521,2795,0,0,0,1.0,1,1.0,1,1.0,1,0.11566650156644742,39
2014,2,4318,1521,2797,0,0,0,1.0,1,1.0,1,1.0,1,0.13638625447190564,39
2015,2,4320,1521,2799,0,0,0,1.0,1,1.0,1,1.0,1,0.13638625447190564,39
2016,1,4321,1521,2800,0,0,0,1.0,1,1.0,1,1.0,1,0.10633891441585229,41
2017,0,4321,1521,2800,0,0,0,1.0,1,1.0,1,1.0,1,0.10633891441585229,41
2018,2,4323,1522,2801,0,0,0,1.0,1,1.0,1,1.0,1,0.12782886571963983,42
2019,0,4323,1522,2801,0,0,0,1.0,1,1.0,1,1.0,1,0.1114869958584828,43
2020,4,4327,1525,2802,0,0,0,1.0,1,1.0,1,1.0,1,0.14058332613109337,43
2021,2,4329,1525,2804,0,0,0,1.0,1,1.0,1,1.0,1,0.08659956074240058,43
2022,1,4330,1526,2804,0,0,0,1.0,1,1.0,1,1.0,1,0.102490804434175,44
2023,7,4337,1530,2807,0,0,0,1.0,1,1.0,1,1.0,1,0.1931734391573578,42
2024,0,4337,1530,2807,0,0,0,1.0,1,1.0,1,1.0,1,0.19777598416842046,41
2025,3,4340,1533,2807,0,0,0,1.0,1,1.0,1,1.0,1,0.1925631700359883,39
2026,5,4345,1534,2811,0,0,0,1.0,1,1.0,1,1.0,1,0.15993720013675436,39
2027,5,4350,1537,2813,0,0,0,1.0,1,1.0,1,1.0,1,0.23109422031684854,38
2028,1,4351,1537,2814,0,0,0,1.0,1,1.0,1,1.0,1,0.19559086323451036,37
2029,0,4351,1537,2814,0,0,0,1.0,1,1.0,1,1.0,1,0.1686158947376643,35
2030,1,4352,1538,2814,0,0,0,1.0,1,1.0,1,1.0,1,0.17934737394609646,32
2031,4,4356,1539,2817,0,0,0,1.0,1,1.0,1,1.0,1,0.2089147285907795,34
2032,4,4360,1540,2820,0,0,0,1.0,1,1.0,1,1.0,1,0.28203668819367855,35
2033,5,4365,1544,2821,0,0,0,1.0,1,1.0,1,1.0,1,0.20421866814969192,35
2034,2,4367,1544,2823,0,0,0,1.0,1,1.0,1,1.0,1,0.20207109082368754,35
2035,3,4370,1545,2825,0,0,0,1.0,1,1.0,1,1.0,1,0.2011514225078308,36
2036,2,4372,1545,2827,0,0,0,1.0,1,1.0,1,1.0,1,0.16843031344416376,35
2037,3,4375,1547,2828,0,0,0,1.0,1,1.0,1,1.0,1,0.22296439543540889,36
2038,1,4376,1547,2829,0,0,0,1.0,1,1.0,1,1.0,1,0.20799983333603178,38
2039,2,4378,1548,2830,0,0,0,1.0,1,1.0,1,1.0,1,0.17578306236763286,38
2040,0,4378,1548,2830,0,0,0,1.0,1,1.0,1,1.0,1,0.16907410144221172,37
2041,1,4379,1549,2830,0,0,0,1.0,1,1.0,1,1.0,1,0.23207217515897374,38
2042,1,4380,1549,2831,0,0,0,1.0,1,1.0,1,1.0,1,0.20434051541977735,38
2043,1,4381,1550,2831,0,0,0,1.0,1,1.0,1,1.0,1,0.19302070435800506,38
2044,1,4382,1550,2832,0,0,0,1.0,1,1.0,1,1.0,1,0.1643449048243351,39
2045,0,4382,1550,2832,0,0,0,1.0,1,1.0,1,1.0,1,0.1714116927118184,40
2046,1,4383,1550,2833,0,0,0,1.0,1,1.0,1,1.0,1,0.1500718523030349,41
2047,1,4384,1551,2833,0,0,0,1.0,1,1.0,1,1.0,1,0.15385788881205162,41
2048,3,4387,1551,2836,0,0,0,1.0,1,1.0,1,1.0,1,0.1194671224315732,43
2049,2,4389,1552,2837,0,0,0,1.0,1,1.0,1,1.0,1,0.1394596810827999,43
2050,1,4390,1552,2838,0,0,0,1.0,1,1.0,1,1.0,1,0.1390443106956472,43
2051,4,4394,1553,2841,0,0,0,1.0,1,1.0,1,1.0,1,0.14114003770669073,43
2052,0,4394,1553,2841,0,0,0,1.0,1,1.0,1,1.0,1,0.1420497243061944,44
2053,0,4394,1553,2841,0,0,0,1.0,1,1.0,1,1.0,1,0.15460804203436437,43
2054,3,4397,1554,2843,0,0,0,1.0,1,1.0,1,1.0,1,0.14790267215916852,44
2055,1,4398,1554,2844,0,0,0,1.0,1,1.0,1,1.0,1,0.13983719860710594,43
2056,2,4400,1554,2846,0,0,0,1.0,1,1.0,1,1.0,1,0.09704985050447683,44
2057,1,4401,1554,2847,0,0,0,1.0,1,1.0,1,1.0,1,0.1064539966802205,44
2058,1,4402,1555,2847,0,0,0,1.0,1,1.0,1,1.0,1,0.08596668704594095,44
2059,1,4403,1556,2847,0,0,0,1.0,1,1.0,1,1.0,1,0.09639922160937839,45
2060,3,4406,1556,2850,0,0,0,1.0,1,1.0,1,1.0,1,0.10257994980616966,46
2061,3,4409,1557,2852,0,0,0,1.0,1,1.0,1,1.0,1,0.09000893515060672,48
2062,3,4412,1560,2852,0,0,0,1.0,1,1.0,1,1.0,1,0.15927353288002272,48
2063,2,4414,1560,2854,0,0,0,1.0,1,1.0,1,1.0,1,0.10076044694667258,45
2064,1,4415,1561,2854,0,0,0,1.0,1,1.0,1,1.0,1,0.1452157096117776,44
2065,2,4417,1562,2855,0,0,0,1.0,1,1.0,1,1.0,1,0.13047175574309325,42
2066,6,4423,1567,2856,0,0,0,1.0,1,1.0,1,1.0,1,0.19206572643348394,42
2067,2,4425,1567,2858,0,0,0,1.0,1,1.0,1,1.0,1,0.16823477459064118,38
2068,0,4425,1567,2858,0,0,0,1.0,1,1.0,1,1.0,1,0.1767213708156791,37
2069,1,4426,1568,2858,0,0,0,1.0,1,1.0,1,1.0,1,0.18842060092811805,35
2070,2,4428,1570,2858,0,0,0,1.0,1,1.0,1,1.0,1,0.22709389388267237,35
2071,3,4431,1570,2861,0,0,0,1.0,1,1.0,1,1.0,1,0.17909333566786848,34
2072,4,4435,1571,2864,0,0,0,1.0,1,1.0,1,1.0,1,0.22311349989214288,35
2073,2,4437,1572,2865,0,0,0,1.0,1,1.0,1,1.0,1,0.1835648185488713,37
2074,1,4438,1572,2866,0,0,0,1.0,1,1.0,1,1.0,1,0.1408982286475633,36
2075,2,4440,1572,2868,0,0,0,1.0,1,1.0,1,1.0,1,0.14280251704273017,38
2076,1,4441,1572,2869,0,0,0,1.0,1,1.0,1,1.0,1,0.09135008956079893,37
2077,0,4441,1572,2869,0,0,0,1.0,1,1.0,1,1.0,1,0.09135008956079893,37
2078,0,4441,1572,2869,0,0,0,1.0,1,1.0,1,1.0,1,0.09135008956079893,37
2079,3,4444,1574,2870,0,0,0,1.0,1,1.0,1,1.0,1,0.11354914292007906,37
2080,1,4445,1575,2870,0,0,0,1.0,1,1.0,1,1.0,1,0.14842092681385585,36
2081,4,4449,1576,2873,0,0,0,1.0,1,1.0,1,1.0,1,0.12613869778688616,37
2082,3,4452,1578,2874,0,0,0,1.0,1,1.0,1,1.0,1,0.12272744867137637,38
2083,3,4455,1579,2876,0,0,0,1.0,1,1.0,1,1.0,1,0.12454740955134422,39
2084,1,4456,1579,2877,0,0,0,1.0,1,1.0,1,1.0,1,0.11623351066806317,41
2085,1,4457,1580,2877,0,0,0,1.0,1,1.0,1,1.0,1,0.1491526968733288,41
2086,3,4460,1580,2880,0,0,0,1.0,1,1.0,1,1.0,1,0.11575117295796987,44
2087,0,4460,1580,2880,0,0,0,1.0,1,1.0,1,1.0,1,0.11575117295796987,44
2088,0,4460,1580,2880,0,0,0,1.0,1,1.0,1,1.0,1,0.12287352819207772,45
2089,0,4460,1580,2880,0,0,0,1.0,1,1.0,1,1.0,1,0.1141479384303989,46
2090,2,4462,1580,2882,0,0,0,1.0,1,1.0,1,1.0,1,0.10762554629361401,47
2091,4,4466,1581,2885,0,0,0,1.0,1,1.0,1,1.0,1,0.10313575476610283,48
2092,1,4467,1582,2885,0,0,0,1.0,1,1.0,1,1.0,1,0.10039682813325845,48
2093,0,4467,1582,2885,0,0,0,1.0,1,1.0,1,1.0,1,0.10039682813325845,48
2094,0,4467,1582,2885,0,0,0,1.0,1,1.0,1,1.0,1,0.09723243971970498,47
2095,0,4467,1582,2885,0,0,0,1.0,1,1.0,1,1.0,1,0.11908396000078207,49
2096,2,4469,1583,2886,0,0,0,1.0,1,1.0,1,1.0,1,0.12416477113670227,50
2097,0,4469,1583,2886,0,0,0,1.0,1,1.0,1,1.0,1,0.12416477113670227,50
2098,3,4472,1585,2887,0,0,0,1.0,1,1.0,1,1.0,1,0.16395268772108784,51
2099,0,4472,1585,2887,0,0,0,1.0,1,1.0,1,1.0,1,0.17379179359227348,50
2100,4,4476,1588,2888,0,0,0,1.0,1,1.0,1,1.0,1,0.20357732959090452,49
2101,7,4483,1588,2895,0,0,0,1.0,1,1.0,1,1.0,1,0.1671875504990161,48
2102,5,4488,1592,2896,0,0,0,1.0,1,1.0,1,1.0,1,0.21623593729209162,49
2103,1,4489,1593,2896,0,0,0,1.0,1,1.0,1,1.0,1,0.19696731561408526,44
2104,5,4494,1595,2899,0,0,0,1.0,1,1.0,1,1.0,1,0.22868935256930317,42
2105,4,4498,1598,2900,0,0,0,1.0,1,1.0,1,1.0,1,0.26793681123147495,40
2106,9,4507,1600,2907,0,0,0,1.0,1,1.0,1,1.0,1,0.22557709869235712,39
2107,3,4510,1601,2909,0,0,0,1.0,1,1.0,1,1.0,1,0.21700164651340206,37
2108,4,4514,1602,2912,0,0,0,1.0,1,1.0,1,1.0,1,0.21421111514844524,37
2109,4,4518,1603,2915,0,0,0,1.0,1,1.0,1,1.0,1,0.27271370951088153,36
2110,4,4522,1603,2919,0,0,0,1.0,1,1.0,1,1.0,1,0.23686632690535983,35
2111,5,4527,1603,2924,0,0,0,1.0,1,1.0,1,1.0,1,0.16015110606069388,35
2112,1,4528,1604,2924,0,0,0,1.0,1,1.0,1,1.0,1,0.1446008169499688,35
2113,2,4530,1604,2926,0,0,0,1.0,1,1.0,1,1.0,1,0.14945365648657832,35
2114,3,4533,1604,2929,0,0,0,1.0,1,1.0,1,1.0,1,0.1549178775407774,36
2115,4,4537,1605,2932,0,0,0,1.0,1,1.0,1,1.0,1,0.19022688562747656,37
2116,5,4542,1606,2936,0,0,0,1.0,1,1.0,1,1.0,1,0.1507380591643229,39
2117,1,4543,1606,2937,0,0,0,1.0,1,1.0,1,1.0,1,0.10789311577099527,39
2118,1,4544,1607,2937,0,0,0,1.0,1,1.0,1,1.0,1,0.1646870429215049,41
2119,2,4546,1608,2938,0,0,0,1.0,1,1.0,1,1.0,1,0.1648245438364558,42
2120,3,4549,1608,2941,0,0,0,1.0,1,1.0,1,1.0,1,0.12199051342423997,42
2121,0,4549,1608,2941,0,0,0,1.0,1,1.0,1,1.0,1,0.12199051342423997,42
2122,2,4551,1608,2943,0,0,0,1.0,1,1.0,1,1.0,1,0.10528805236827843,43
2123,1,4552,1608,2944,0,0,0,1.0,1,1.0,1,1.0,1,0.13815164210007053,42
2124,0,4552,1608,2944,0,0,0,1.0,1,1.0,1,1.0,1,0.13815164210007053,42
2125,0,4552,1608,2944,0,0,0,1.0,1,1.0,1,1.0,1,0.15652441664112823,41
2126,1,4553,1608,2945,0,0,0,1.0,1,1.0,1,1.0,1,0.14004876961787777,41
2127,0,4553,1608,2945,0,0,0,1.0,1,1.0,1,1.0,1,0.14004876961787777,41
2128,1,4554,1608,2946,0,0,0,1.0,1,1.0,1,1.0,1,0.12089693919526266,42
2129,1,4555,1608,2947,0,0,0,1.0,1,1.0,1,1.0,1,0.1291356771876754,43
2130,0,4555,1608,2947,0,0,0,1.0,1,1.0,1,1.0,1,0.13760918770626468,45
2131,3,4558,1608,2950,0,0,0,1.0,1,1.0,1,1.0,1,0.14555898471277387,44
2132,2,4560,1608,2952,0,0,0,1.0,1,1.0,1,1.0,1,0.0913576747735563,44
2133,4,4564,1609,2955,0,0,0,1.0,1,1.0,1,1.0,1,0.1426518748791925,45
2134,1,4565,1609,2956,0,0,0,1.0,1,1.0,1,1.0,1,0.16146252311296477,45
2135,4,4569,1610,2959,0,0,0,1.0,1,1.0,1,1.0,1,0.1348318997783813,46
2136,2,4571,1610,2961,0,0,0,1.0,1,1.0,1,1.0,1,0.08997801402185004,47
2137,3,4574,1611,2963,0,0,0,1.0,1,1.0,1,1.0,1,0.10350089650161298,47
2138,0,4574,1611,2963,0,0,0,1.0,1,1.0,1,1.0,1,0.10449577320326571,45
2139,1,4575,1612,2963,0,0,0,1.0,1,1.0,1,1.0,1,0.08616407973766885,45
2140,2,4577,1614,2963,0,0,0,1.0,1,1.0,1,1.0,1,0.12376435317248471,44
2141,3,4580,1615,2965,0,0,0,1.0,1,1.0,1,1.0,1,0.11060910781198044,45
2142,2,4582,1617,2965,0,0,0,1.0,1,1.0,1,1.0,1,0.1584524657194624,46
2143,1,4583,1617,2966,0,0,0,1.0,1,1.0,1,1.0,1,0.12230435105941838,46
2144,5,4588,1618,2970,0,0,0,1.0,1,1.0,1,1.0,1,0.1288355323070375,48
2145,3,4591,1621,2970,0,0,0,1.0,1,1.0,1,1.0,1,0.1649324482052649,46
2146,5,4596,1623,2973,0,0,0,1.0,1,1.0,1,1.0,1,0.12452919157643103,45
2147,5,4601,1626,2975,0,0,0,1.0,1,1.0,1,1.0,1,0.12328904004607481,44
2148,6,4607,1628,2979,0,0,0,1.0,1,1.0,1,1.0,1,0.16038603866252243,44
2149,5,4612,1630,2982,0,0,0,1.0,1,1.0,1,1.0,1,0.24438655170482926,42
2150,4,4616,1630,2986,0,0,0,1.0,1,1.0,1,1.0,1,0.22234938055732134,40
2151,7,4623,1632,2991,0,0,0,1.0,1,1.0,1,1.0,1,0.2093833697866048,39
2152,4,4627,1633,2994,0,0,0,1.0,1,1.0,1,1.0,1,0.19628856336461656,40
2153,4,4631,1634,2997,0,0,0,1.0,1,1.0,1,1.0,1,0.19474547916410612,42
2154,3,4634,1634,3000,0,0,0,1.0,1,1.0,1,1.0,1,0.21381991102180808,42
2155,6,4640,1635,3005,0,0,0,1.0,1,1.0,1,1.0,1,0.20367302412111649,41
2156,3,4643,1635,3008,0,0,0,1.0,1,1.0,1,1.0,1,0.11476750110341008,40
2157,2,4645,1636,3009,0,0,0,1.0,1,1.0,1,1.0,1,0.12483431505582596,40
2158,2,4647,1637,3010,0,0,0,1.0,1,1.0,1,1.0,1,0.0818712944948188,38
2159,0,4647,1637,3010,0,0,0,1.0,1,1.0,1,1.0,1,0.07692331762171158,38
2160,2,4649,1638,3011,0,0,0,1.0,1,1.0,1,1.0,1,0.10509358924321338,38
2161,0,4649,1638,3011,0,0,0,1.0,1,1.0,1,1.0,1,0.10509358924321338,38
2162,3,4652,1640,3012,0,0,0,1.0,1,1.0,1,1.0,1,0.15228828056005905,38
2163,1,4653,1640,3013,0,0,0,1.0,1,1.0,1,1.0,1,0.10589460072255268,40
2164,4,4657,1641,3016,0,0,0,1.0,1,1.0,1,1.0,1,0.14149478578922237,41
2165,2,4659,1642,3017,0,0,0,1.0,1,1.0,1,1.0,1,0.15036968171369477,42
2166,2,4661,1642,3019,0,0,0,1.0,1,1.0,1,1.0,1,0.13242612946311833,42
2167,2,4663,1642,3021,0,0,0,1.0,1,1.0,1,1.0,1,0.10570342021738326,43
2168,0,4663,1642,3021,0,0,0,1.0,1,1.0,1,1.0,1,0.07800906956541691,43
2169,1,4664,1642,3022,0,0,0,1.0,1,1.0,1,1.0,1,0.09217818078954057,45
2170,1,4665,1643,3022,0,0,0,1.0,1,1.0,1,1.0,1,0.07084490941461717,46
2171,0,4665,1643,3022,0,0,0,1.0,1,1.0,1,1.0,1,0.08700962945561472,48
2172,0,4665,1643,3022,0,0,0,1.0,1,1.0,1,1.0,1,0.10145864019255423,49
2173,6,4671,1646,3025,0,0,0,1.0,1,1.0,1,1.0,1,0.0990757736166166,49
2174,1,4672,1647,3025,0,0,0,1.0,1,1.0,1,1.0,1,0.10544353235891717,49
2175,1,4673,1647,3026,0,0,0,1.0,1,1.0,1,1.0,1,0.11571028892080826,49
2176,6,4679,1648,3031,0,0,0,1.0,1,1.0,1,1.0,1,0.07246327638276981,51
2177,4,4683,1650,3033,0,0,0,1.0,1,1.0,1,1.0,1,0.07446750094584204,51
2178,2,4685,1652,3033,0,0,0,1.0,1,1.0,1,1.0,1,0.118446318776215,50
2179,1,4686,1652,3034,0,0,0,1.0,1,1.0,1,1.0,1,0.11634723564975827,49
2180,2,4688,1653,3035,0,0,0,1.0,1,1.0,1,1.0,1,0.15708803816482222,47
2181,6,4694,1656,3038,0,0,0,1.0,1,1.0,1,1.0,1,0.13731275724189546,47
2182,4,4698,1658,3040,0,0,0,1.0,1,1.0,1,1.0,1,0.14883540472056056,45
2183,0,4698,1658,3040,0,0,0,1.0,1,1.0,1,1.0,1,0.13664110089398612,44
2184,4,4702,1661,3041,0,0,0,1.0,1,1.0,1,1.0,1,0.17985826906422608,43
2185,2,4704,1663,3041,0,0,0,1.0,1,1.0,1,1.0,1,0.18948065698326877,40
2186,7,4711,1664,3047,0,0,0,1.0,1,1.0,1,1.0,1,0.10568651076508091,38
2187,2,4713,1666,3047,0,0,0,1.0,1,1.0,1,1.0,1,0.14405005777992794,35
2188,4,4717,1669,3048,0,0,0,1.0,1,1.0,1,1.0,1,0.18920956252971763,34
2189,2,4719,1670,3049,0,0,0,1.0,1,1.0,1,1.0,1,0.1854778682257251,31
2190,4,4723,1673,3050,0,0,0,1.0,1,1.0,1,1.0,1,0.23091073713241705,29
2191,1,4724,1673,3051,0,0,0,1.0,1,1.0,1,1.0,1,0.2166826905508024,28
2192,4,4728,1675,3053,0,0,0,1.0,1,1.0,1,1.0,1,0.2457347571928053,29
2193,1,4729,1675,3054,0,0,0,1.0,1,1.0,1,1.0,1,0.24530290899137425,28
2194,0,4729,1675,3054,0,0,0,1.0,1,1.0,1,1.0,1,0.24623649525388766,27
2195,4,4733,1678,3055,0,0,0,1.0,1,1.0,1,1.0,1,0.31758893656823156,27
2196,2,4735,1678,3057,0,0,0,1.0,1,1.0,1,1.0,1,0.2855104800956517,27
2197,2,4737,1678,3059,0,0,0,1.0,1,1.0,1,1.0,1,0.2260880507554788,27
2198,0,4737,1678,3059,0,0,0,1.0,1,1.0,1,1.0,1,0.18955984879465165,28
2199,1,4738,1678,3060,0,0,0,1.0,1,1.0,1,1.0,1,0.1951812403229186,29
2200,2,4740,1679,3061,0,0,0,1.0,1,1.0,1,1.0,1,0.21831642792232178,31
2201,2,4742,1680,3062,0,0,0,1.0,1,1.0,1,1.0,1,0.17987640076696337,32
2202,0,4742,1680,3062,0,0,0,1.0,1,1.0,1,1.0,1,0.22141644291677554,31
2203,0,4742,1680,3062,0,0,0,1.0,1,1.0,1,1.0,1,0.20313010131652232,32
2204,1,4743,1680,3063,0,0,0,1.0,1,1.0,1,1.0,1,0.22697386127363486,32
2205,2,4745,1681,3064,0,0,0,1.0,1,1.0,1,1.0,1,0.22720010571458807,33
2206,7,4752,1682,3070,0,0,0,1.0,1,1.0,1,1.0,1,0.2500511402200308,32
2207,4,4756,1682,3074,0,0,0,1.0,1,1.0,1,1.0,1,0.2309104524375364,33
2208,7,4763,1682,3081,0,0,0,1.0,1,1.0,1,1.0,1,0.22705062993153663,35
2209,10,4773,1683,3090,0,0,0,1.0,1,1.0,1,1.0,1,0.21185116242793156,36
2210,5,4778,1683,3095,0,0,0,1.0,1,1.0,1,1.0,1,0.3143249149230823,35
2211,5,4783,1683,3100,0,0,0,1.0,1,1.0,1,1.0,1,0.2129926461191149,36
2212,3,4786,1684,3102,0,0,0,1.0,1,1.0,1,1.0,1,0.16750182984864417,37
2213,0,4786,1684,3102,0,0,0,1.0,1,1.0,1,1.0,1,0.16750182984864417,37
2214,0,4786,1684,3102,0,0,0,1.0,1,1.0,1,1.0,1,0.15122243803130705,39
2215,2,4788,1685,3103,0,0,0,1.0,1,1.0,1,1.0,1,0.20252000714506196,36
2216,6,4794,1687,3107,0,0,0,1.0,1,1.0,1,1.0,1,0.10034597123380208,37
2217,1,4795,1688,3107,0,0,0,1.0,1,1.0,1,1.0,1,0.10213227321920633,35
2218,1,4796,1689,3107,0,0,0,1.0,1,1.0,1,1.0,1,0.12641925311187394,35
2219,0,4796,1689,3107,0,0,0,1.0,1,1.0,1,1.0,1,0.12188075642007125,33
2220,0,4796,1689,3107,0,0,0,1.0,1,1.0,1,1.0,1,0.1779326223080102,31
2221,5,4801,1690,3111,0,0,0,1.0,1,1.0,1,1.0,1,0.06542907077659811,31
2222,0,4801,1690,3111,0,0,0,1.0,1,1.0,1,1.0,1,0.09792636723179196,30
2223,2,4803,1692,3111,0,0,0,1.0,1,1.0,1,1.0,1,0.1606753138794195,28
2224,3,4806,1695,3111,0,0,0,1.0,1,1.0,1,1.0,1,0.2554888919706389,29
2225,2,4808,1697,3111,0,0,0,1.0,1,1.0,1,1.0,1,0.26293753686217314,28
2226,8,4816,1698,3118,0,0,0,1.0,1,1.0,1,1.0,1,0.16800628850823923,30
2227,2,4818,1698,3120,0,0,0,1.0,1,1.0,1,1.0,1,0.2358158027933177,28
2228,3,4821,1699,3122,0,0,0,1.0,1,1.0,1,1.0,1,0.2772040033759219,29
2229,2,4823,1700,3123,0,0,0,1.0,1,1.0,1,1.0,1,0.22819396828283806,28
2230,2,4825,1700,3125,0,0,0,1.0,1,1.0,1,1.0,1,0.22461691910845447,28
2231,0,4825,1700,3125,0,0,0,1.0,1,1.0,1,1.0,1,0.23876190678926562,27
2232,2,4827,1700,3127,0,0,0,1.0,1,1.0,1,1.0,1,0.2176509180652508,27
2233,3,4830,1702,3128,0,0,0,1.0,1,1.0,1,1.0,1,0.24425965792062482,28
2234,1,4831,1703,3128,0,0,0,1.0,1,1.0,1,1.0,1,0.20975711834652563,26
2235,1,4832,1704,3128,0,0,0,1.0,1,1.0,1,1.0,1,0.20154892874797878,26
2236,2,4834,1705,3129,0,0,0,1.0,1,1.0,1,1.0,1,0.27598446914258895,26
2237,1,4835,1706,3129,0,0,0,1.0,1,1.0,1,1.0,1,0.2586692267066392,26
2238,2,4837,1707,3130,0,0,0,1.0,1,1.0,1,1.0,1,0.24881221280518495,27
2239,2,4839,1708,3131,0,0,0,1.0,1,1.0,1,1.0,1,0.2643826393997855,28
2240,3,4842,1709,3133,0,0,0,1.0,1,1.0,1,1.0,1,0.19578420357560286,30
2241,3,4845,1710,3135,0,0,0,1.0,1,1.0,1,1.0,1,0.17854850656784294,29
2242,2,4847,1710,3137,0,0,0,1.0,1,1.0,1,1.0,1,0.171418978697884,29
2243,2,4849,1711,3138,0,0,0,1.0,1,1.0,1,1.0,1,0.15305764316614093,29
2244,0,4849,1711,3138,0,0,0,1.0,1,1.0,1,1.0,1,0.15305764316614093,29
2245,3,4852,1712,3140,0,0,0,1.0,1,1.0,1,1.0,1,0.19908679836040694,30
2246,3,4855,1712,3143,0,0,0,1.0,1,1.0,1,1.0,1,0.13652909736676633,33
2247,0,4855,1712,3143,0,0,0,1.0,1,1.0,1,1.0,1,0.10483859377860992,34
2248,0,4855,1712,3143,0,0,0,1.0,1,1.0,1,1.0,1,0.10483859377860992,34
2249,0,4855,1712,3143,0,0,0,1.0,1,1.0,1,1.0,1,0.12045933478657996,35
2250,0,4855,1712,3143,0,0,0,1.0,1,1.0,1,1.0,1,0.12045933478657996,35
2251,1,4856,1712,3144,0,0,0,1.0,1,1.0,1,1.0,1,0.12499193637612695,36
2252,1,4857,1713,3144,0,0,0,1.0,1,1.0,1,1.0,1,0.1640044760765233,37
2253,1,4858,1714,3144,0,0,0,1.0,1,1.0,1,1.0,1,0.23257429438247965,35
2254,0,4858,1714,3144,0,0,0,1.0,1,1.0,1,1.0,1,0.23627178087804515,33
2255,3,4861,1714,3147,0,0,0,1.0,1,1.0,1,1.0,1,0.1999595082931499,35
2256,7,4868,1716,3152,0,0,0,1.0,1,1.0,1,1.0,1,0.13599477665241558,34
2257,5,4873,1719,3154,0,0,0,1.0,1,1.0,1,1.0,1,0.15772686263923888,36
2258,4,4877,1720,3157,0,0,0,1.0,1,1.0,1,1.0,1,0.19710508533144358,35
2259,5,4882,1720,3162,0,0,0,1.0,1,1.0,1,1.0,1,0.1640043213936497,35
2260,0,4882,1720,3162,0,0,0,1.0,1,1.0,1,1.0,1,0.18202009582786602,33
2261,2,4884,1720,3164,0,0,0,1.0,1,1.0,1,1.0,1,0.15702942970749012,33
2262,1,4885,1721,3164,0,0,0,1.0,1,1.0,1,1.0,1,0.24551816960547848,32
2263,3,4888,1723,3165,0,0,0,1.0,1,1.0,1,1.0,1,0.2652161256851625,31
2264,2,4890,1725,3165,0,0,0,1.0,1,1.0,1,1.0,1,0.31406730283374196,30
2265,0,4890,1725,3165,0,0,0,1.0,1,1.0,1,1.0,1,0.2640218740770544,29
2266,6,4896,1728,3168,0,0,0,1.0,1,1.0,1,1.0,1,0.3425804876098459,30
2267,0,4896,1728,3168,0,0,0,1.0,1,1.0,1,1.0,1,0.28380623718253667,29
2268,5,4901,1729,3172,0,0,0,1.0,1,1.0,1,1.0,1,0.20401000241829353,30
2269,1,4902,1729,3173,0,0,0,1.0,1,1.0,1,1.0,1,0.1612920670866483,31
2270,1,4903,1730,3173,0,0,0,1.0,1,1.0,1,1.0,1,0.17188066245753975,31
2271,4,4907,1733,3174,0,0,0,1.0,1,1.0,1,1.0,1,0.16583568555728417,31
2272,2,4909,1735,3174,0,0,0,1.0,1,1.0,1,1.0,1,0.16589739997358577,31
2273,2,4911,1737,3174,0,0,0,1.0,1,1.0,1,1.0,1,0.28175905438508936,30
2274,2,4913,1737,3176,0,0,0,1.0,1,1.0,1,1.0,1,0.22260946936884476,31
2275,0,4913,1737,3176,0,0,0,1.0,1,1.0,1,1.0,1,0.2293201727197729,32
2276,4,4917,1739,3178,0,0,0,1.0,1,1.0,1,1.0,1,0.16401349700472595,31
2277,0,4917,1739,3178,0,0,0,1.0,1,1.0,1,1.0,1,0.16746590179619059,31
2278,1,4918,1739,3179,0,0,0,1.0,1,1.0,1,1.0,1,0.16562329250867672,32
2279,1,4919,1739,3180,0,0,0,1.0,1,1.0,1,1.0,1,0.12315530032210448,32
2280,2,4921,1739,3182,0,0,0,1.0,1,1.0,1,1.0,1,0.1231048178681409,33
2281,0,4921,1739,3182,0,0,0,1.0,1,1.0,1,1.0,1,0.1405692666378949,34
2282,0,4921,1739,3182,0,0,0,1.0,1,1.0,1,1.0,1,0.1405692666378949,34
2283,0,4921,1739,3182,0,0,0,1.0,1,1.0,1,1.0,1,0.1405692666378949,34
2284,1,4922,1740,3182,0,0,0,1.0,1,1.0,1,1.0,1,0.16385346916405405,34
2285,1,4923,1740,3183,0,0,0,1.0,1,1.0,1,1.0,1,0.1509044329265647,35
2286,1,4924,1740,3184,0,0,0,1.0,1,1.0,1,1.0,1,0.12850926659935877,34
2287,1,4925,1741,3184,0,0,0,1.0,1,1.0,1,1.0,1,0.11294875069364421,35
2288,0,4925,1741,3184,0,0,0,1.0,1,1.0,1,1.0,1,0.1681631998353359,35
2289,4,4929,1742,3187,0,0,0,1.0,1,1.0,1,1.0,1,0.17577543050751043,37
2290,4,4933,1744,3189,0,0,0,1.0,1,1.0,1,1.0,1,0.2649445089188182,37
2291,5,4938,1745,3193,0,0,0,1.0,1,1.0,1,1.0,1,0.1923250659354274,35
2292,0,4938,1745,3193,0,0,0,1.0,1,1.0,1,1.0,1,0.19707673425165362,35
2293,2,4940,1747,3193,0,0,0,1.0,1,1.0,1,1.0,1,0.2394542587103111,34
2294,1,4941,1747,3194,0,0,0,1.0,1,1.0,1,1.0,1,0.23040359751738942,33
2295,2,4943,1749,3194,0,0,0,1.0,1,1.0,1,1.0,1,0.2544983542928455,34
2296,3,4946,1749,3197,0,0,0,1.0,1,1.0,1,1.0,1,0.13357360488317124,33
2297,0,4946,1749,3197,0,0,0,1.0,1,1.0,1,1.0,1,0.15403565035420036,32
2298,0,4946,1749,3197,0,0,0,1.0,1,1.0,1,1.0,1,0.1523709341817792,32
2299,0,4946,1749,3197,0,0,0,1.0,1,1.0,1,1.0,1,0.133081651893909,33
2300,0,4946,1749,3197,0,0,0,1.0,1,1.0,1,1.0,1,0.133081651893909,33
2301,2,4948,1751,3197,0,0,0,1.0,1,1.0,1,1.0,1,0.1892101687124583,33
2302,3,4951,1752,3199,0,0,0,1.0,1,1.0,1,1.0,1,0.20125451120667184,34
2303,4,4955,1755,3200,0,0,0,1.0,1,1.0,1,1.0,1,0.20989445071450974,34
2304,3,4958,1757,3201,0,0,0,1.0,1,1.0,1,1.0,1,0.21253859960719051,33
2305,4,4962,1759,3203,0,0,0,1.0,1,1.0,1,1.0,1,0.24767352713843485,33
2306,5,4967,1761,3206,0,0,0,1.0,1,1.0,1,1.0,1,0.20190524319121603,33
2307,1,4968,1761,3207,0,0,0,1.0,1,1.0,1,1.0,1,0.1652461120329132,35
2308,0,4968,1761,3207,0,0,0,1.0,1,1.0,1,1.0,1,0.15017396600606484,34
2309,2,4970,1762,3208,0,0,0,1.0,1,1.0,1,1.0,1,0.16464513696793207,34
2310,1,4971,1762,3209,0,0,0,1.0,1,1.0,1,1.0,1,0.11187203248911462,34
2311,1,4972,1763,3209,0,0,0,1.0,1,1.0,1,1.0,1,0.15461333449475617,35
2312,6,4978,1766,3212,0,0,0,1.0,1,1.0,1,1.0,1,0.1457172579619886,34
2313,3,4981,1767,3214,0,0,0,1.0,1,1.0,1,1.0,1,0.2164395161738109,35
2314,0,4981,1767,3214,0,0,0,1.0,1,1.0,1,1.0,1,0.20608224850663515,35
2315,3,4984,1767,3217,0,0,0,1.0,1,1.0,1,1.0,1,0.12868909901319267,34
2316,3,4987,1769,3218,0,0,0,1.0,1,1.0,1,1.0,1,0.16889984226855553,35
2317,0,4987,1769,3218,0,0,0,1.0,1,1.0,1,1.0,1,0.19453678001932784,32
2318,1,4988,1769,3219,0,0,0,1.0,1,1.0,1,1.0,1,0.1775551892687249,32
2319,0,4988,1769,3219,0,0,0,1.0,1,1.0,1,1.0,1,0.1775551892687249,32
2320,0,4988,1769,3219,0,0,0,1.0,1,1.0,1,1.0,1,0.18416025113259435,32
2321,2,4990,1769,3221,0,0,0,1.0,1,1.0,1,1.0,1,0.1495479507088042,33
2322,0,4990,1769,3221,0,0,0,1.0,1,1.0,1,1.0,1,0.1495479507088042,33
2323,0,4990,1769,3221,0,0,0,1.0,1,1.0,1,1.0,1,0.1495479507088042,33
2324,3,4993,1771,3222,0,0,0,1.0,1,1.0,1,1.0,1,0.17707000390077,34
2325,3,4996,1771,3225,0,0,0,1.0,1,1.0,1,1.0,1,0.1472313798546707,35
2326,1,4997,1772,3225,0,0,0,1.0,1,1.0,1,1.0,1,0.15426007205565564,35
2327,0,4997,1772,3225,0,0,0,1.0,1,1.0,1,1.0,1,0.17481497686358577,36
2328,1,4998,1773,3225,0,0,0,1.0,1,1.0,1,1.0,1,0.24947423284126022,37
2329,1,4999,1773,3226,0,0,0,1.0,1,1.0,1,1.0,1,0.25517780036247606,37
2330,2,5001,1773,3228,0,0,0,1.0,1,1.0,1,1.0,1,0.24755760336912,38
2331,5,5006,1773,3233,0,0,0,1.0,1,1.0,1,1.0,1,0.16299974184217167,40
2332,1,5007,1773,3234,0,0,0,1.0,1,1.0,1,1.0,1,0.17066191150782647,40
2333,1,5008,1773,3235,0,0,0,1.0,1,1.0,1,1.0,1,0.17746475997363695,41
2334,1,5009,1773,3236,0,0,0,1.0,1,1.0,1,1.0,1,0.18490687662870608,41
2335,2,5011,1773,3238,0,0,0,1.0,1,1.0,1,1.0,1,0.18490687662870608,41
2336,1,5012,1773,3239,0,0,0,1.0,1,1.0,1,1.0,1,0.16444985874258444,41
2337,3,5015,1773,3242,0,0,0,1.0,1,1.0,1,1.0,1,0.10818711515528191,42
2338,1,5016,1773,3243,0,0,0,1.0,1,1.0,1,1.0,1,0.10748888183039956,43
2339,0,5016,1773,3243,0,0,0,1.0,1,1.0,1,1.0,1,0.10748888183039956,43
2340,3,5019,1773,3246,0,0,0,1.0,1,1.0,1,1.0,1,0.09515544324150205,45
2341,1,5020,1773,3247,0,0,0,1.0,1,1.0,1,1.0,1,0.09349221483195995,45
2342,3,5023,1774,3249,0,0,0,1.0,1,1.0,1,1.0,1,0.11235572462868308,46
2343,1,5024,1775,3249,0,0,0,1.0,1,1.0,1,1.0,1,0.12863783184016664,45
2344,4,5028,1778,3250,0,0,0,1.0,1,1.0,1,1.0,1,0.1645879286619171,44
2345,2,5030,1778,3252,0,0,0,1.0,1,1.0,1,1.0,1,0.09424722032131401,44
2346,1,5031,1779,3252,0,0,0,1.0,1,1.0,1,1.0,1,0.1132880070967515,44
2347,2,5033,1779,3254,0,0,0,1.0,1,1.0,1,1.0,1,0.09248224261302458,44
2348,1,5034,1779,3255,0,0,0,1.0,1,1.0,1,1.0,1,0.07322693297087803,45
2349,0,5034,1779,3255,0,0,0,1.0,1,1.0,1,1.0,1,0.09431911804874879,46
2350,2,5036,1780,3256,0,0,0,1.0,1,1.0,1,1.0,1,0.13725532632370996,47
2351,3,5039,1780,3259,0,0,0,1.0,1,1.0,1,1.0,1,0.08892368879211868,47
2352,1,5040,1781,3259,0,0,0,1.0,1,1.0,1,1.0,1,0.07751943510854357,47
2353,0,5040,1781,3259,0,0,0,1.0,1,1.0,1,1.0,1,0.09166285837582687,46
2354,3,5043,1784,3259,0,0,0,1.0,1,1.0,1,1.0,1,0.09185298743504487,47
2355,0,5043,1784,3259,0,0,0,1.0,1,1.0,1,1.0,1,0.09185298743504487,47
2356,4,5047,1786,3261,0,0,0,1.0,1,1.0,1,1.0,1,0.05446226154655388,47
2357,1,5048,1787,3261,0,0,0,1.0,1,1.0,1,1.0,1,0.09658478706602402,47
2358,0,5048,1787,3261,0,0,0,1.0,1,1.0,1,1.0,1,0.07070609507797408,48
2359,1,5049,1788,3261,0,0,0,1.0,1,1.0,1,1.0,1,0.1001335958208883,49
2360,0,5049,1788,3261,0,0,0,1.0,1,1.0,1,1.0,1,0.1001335958208883,49
2361,2,5051,1790,3261,0,0,0,1.0,1,1.0,1,1.0,1,0.10996608513849859,50
2362,1,5052,1790,3262,0,0,0,1.0,1,1.0,1,1.0,1,0.11226142150463446,51
2363,1,5053,1790,3263,0,0,0,1.0,1,1.0,1,1.0,1,0.10287515724577218,51
2364,1,5054,1790,3264,0,0,0,1.0,1,1.0,1,1.0,1,0.0903622964959063,52
2365,5,5059,1793,3266,0,0,0,1.0,1,1.0,1,1.0,1,0.11689993513501647,53
2366,8,5067,1794,3273,0,0,0,1.0,1,1.0,1,1.0,1,0.07473939294548226,54
2367,1,5068,1795,3273,0,0,0,1.0,1,1.0,1,1.0,1,0.09132431148615827,52
2368,4,5072,1798,3274,0,0,0,1.0,1,1.0,1,1.0,1,0.1459681470661853,51
2369,3,5075,1800,3275,0,0,0,1.0,1,1.0,1,1.0,1,0.13036750022770302,51
2370,3,5078,1802,3276,0,0,0,1.0,1,1.0,1,1.0,1,0.14904042925186453,52
2371,7,5085,1803,3282,0,0,0,1.0,1,1.0,1,1.0,1,0.044180908643633277,52
2372,2,5087,1805,3282,0,0,0,1.0,1,1.0,1,1.0,1,0.12359692998404546,49
2373,0,5087,1805,3282,0,0,0,1.0,1,1.0,1,1.0,1,0.10263048993865873,47
2374,2,5089,1806,3283,0,0,0,1.0,1,1.0,1,1.0,1,0.07667334278860527,45
2375,0,5089,1806,3283,0,0,0,1.0,1,1.0,1,1.0,1,0.0963449700741403,45
2376,2,5091,1806,3285,0,0,0,1.0,1,1.0,1,1.0,1,0.08086875567770933,43
2377,1,5092,1806,3286,0,0,0,1.0,1,1.0,1,1.0,1,0.07003053439371425,44
2378,0,5092,1806,3286,0,0,0,1.0,1,1.0,1,1.0,1,0.08915047426450722,43
2379,0,5092,1806,3286,0,0,0,1.0,1,1.0,1,1.0,1,0.08915047426450722,43
2380,0,5092,1806,3286,0,0,0,1.0,1,1.0,1,1.0,1,0.08915047426450722,43
2381,2,5094,1807,3287,0,0,0,1.0,1,1.0,1,1.0,1,0.122318361191688,44
2382,3,5097,1808,3289,0,0,0,1.0,1,1.0,1,1.0,1,0.06684848194227096,44
2383,2,5099,1809,3290,0,0,0,1.0,1,1.0,1,1.0,1,0.11129952219144197,45
2384,6,5105,1812,3293,0,0,0,1.0,1,1.0,1,1.0,1,0.153283041454583,45
2385,2,5107,1813,3294,0,0,0,1.0,1,1.0,1,1.0,1,0.12197019874183111,45
2386,5,5112,1815,3297,0,0,0,1.0,1,1.0,1,1.0,1,0.11790414574079454,46
2387,4,5116,1817,3299,0,0,0,1.0,1,1.0,1,1.0,1,0.12201910073316481,44
2388,5,5121,1819,3302,0,0,0,1.0,1,1.0,1,1.0,1,0.10276753699659344,44
2389,2,5123,1819,3304,0,0,0,1.0,1,1.0,1,1.0,1,0.10273578261301165,43
2390,5,5128,1822,3306,0,0,0,1.0,1,1.0,1,1.0,1,0.06669053474241371,44
2391,0,5128,1822,3306,0,0,0,1.0,1,1.0,1,1.0,1,0.06470222846884915,43
2392,3,5131,1824,3307,0,0,0,1.0,1,1.0,1,1.0,1,0.11868679250266519,44
2393,2,5133,1825,3308,0,0,0,1.0,1,1.0,1,1.0,1,0.1190721381964075,45
2394,3,5136,1827,3309,0,0,0,1.0,1,1.0,1,1.0,1,0.14043285171388722,44
2395,2,5138,1827,3311,0,0,0,1.0,1,1.0,1,1.0,1,0.10587497090680247,44
2396,4,5142,1829,3313,0,0,0,1.0,1,1.0,1,1.0,1,0.09852514791798392,45
2397,0,5142,1829,3313,0,0,0,1.0,1,1.0,1,1.0,1,0.11864259182219841,44
2398,1,5143,1830,3313,0,0,0,1.0,1,1.0,1,1.0,1,0.15103844297441923,44
2399,1,5144,1830,3314,0,0,0,1.0,1,1.0,1,1.0,1,0.13890880631737906,45
2400,0,5144,1830,3314,0,0,0,1.0,1,1.0,1,1.0,1,0.13890880631737906,45
2401,4,5148,1830,3318,0,0,0,1.0,1,1.0,1,1.0,1,0.10477685809812178,46
2402,2,5150,1830,3320,0,0,0,1.0,1,1.0,1,1.0,1,0.09543514313499109,47
2403,9,5159,1831,3328,0,0,0,1.0,1,1.0,1,1.0,1,0.14409145250021294,48
2404,4,5163,1832,3331,0,0,0,1.0,1,1.0,1,1.0,1,0.13989424480052537,47
2405,3,5166,1832,3334,0,0,0,1.0,1,1.0,1,1.0,1,0.15933217793374105,45
2406,4,5170,1833,3337,0,0,0,1.0,1,1.0,1,1.0,1,0.11107257495378421,45
2407,0,5170,1833,3337,0,0,0,1.0,1,1.0,1,1.0,1,0.14019239859491478,42
2408,0,5170,1833,3337,0,0,0,1.0,1,1.0,1,1.0,1,0.15741654588210505,41
2409,1,5171,1833,3338,0,0,0,1.0,1,1.0,1,1.0,1,0.17145500123351384,41
2410,1,5172,1833,3339,0,0,0,1.0,1,1.0,1,1.0,1,0.23530138746175816,40
2411,9,5181,1835,3346,0,0,0,1.0,1,1.0,1,1.0,1,0.15855758039817516,40
2412,2,5183,1836,3347,0,0,0,1.0,1,1.0,1,1.0,1,0.20699539604182493,38
2413,4,5187,1839,3348,0,0,0,1.0,1,1.0,1,1.0,1,0.23398331896101707,38
2414,1,5188,1840,3348,0,0,0,1.0,1,1.0,1,1.0,1,0.21280314276030576,36
2415,0,5188,1840,3348,0,0,0,1.0,1,1.0,1,1.0,1,0.22799729192880547,36
2416,7,5195,1841,3354,0,0,0,1.0,1,1.0,1,1.0,1,0.1293669864230184,35
2417,3,5198,1842,3356,0,0,0,1.0,1,1.0,1,1.0,1,0.15827958410098905,33
2418,1,5199,1842,3357,0,0,0,1.0,1,1.0,1,1.0,1,0.13761869571319663,33
2419,0,5199,1842,3357,0,0,0,1.0,1,1.0,1,1.0,1,0.1791399267697735,33
2420,3,5202,1842,3360,0,0,0,1.0,1,1.0,1,1.0,1,0.2074953618969106,34
2421,2,5204,1842,3362,0,0,0,1.0,1,1.0,1,1.0,1,0.173441434369596,34
2422,6,5210,1847,3363,0,0,0,1.0,1,1.0,1,1.0,1,0.1505803892467668,35
2423,4,5214,1849,3365,0,0,0,1.0,1,1.0,1,1.0,1,0.1659122862109967,36
2424,4,5218,1851,3367,0,0,0,1.0,1,1.0,1,1.0,1,0.24450810062381925,35
2425,5,5223,1853,3370,0,0,0,1.0,1,1.0,1,1.0,1,0.2000116733672419,33
2426,2,5225,1853,3372,0,0,0,1.0,1,1.0,1,1.0,1,0.1647075348909689,34
2427,4,5229,1854,3375,0,0,0,1.0,1,1.0,1,1.0,1,0.14730735921106147,34
2428,4,5233,1856,3377,0,0,0,1.0,1,1.0,1,1.0,1,0.1607593594872693,34
2429,3,5236,1857,3379,0,0,0,1.0,1,1.0,1,1.0,1,0.16951775416862683,34
2430,0,5236,1857,3379,0,0,0,1.0,1,1.0,1,1.0,1,0.19143589988394913,33
2431,1,5237,1857,3380,0,0,0,1.0,1,1.0,1,1.0,1,0.17011357631419385,33
2432,2,5239,1857,3382,0,0,0,1.0,1,1.0,1,1.0,1,0.185946574754091,33
2433,0,5239,1857,3382,0,0,0,1.0,1,1.0,1,1.0,1,0.147364432743304,34
2434,1,5240,1857,3383,0,0,0,1.0,1,1.0,1,1.0,1,0.12514969077209512,34
2435,3,5243,1859,3384,0,0,0,1.0,1,1.0,1,1.0,1,0.07298314839396085,34
2436,0,5243,1859,3384,0,0,0,1.0,1,1.0,1,1.0,1,0.09294927911932935,33
2437,0,5243,1859,3384,0,0,0,1.0,1,1.0,1,1.0,1,0.09294927911932935,33
2438,2,5245,1861,3384,0,0,0,1.0,1,1.0,1,1.0,1,0.0963740211644844,34
2439,0,5245,1861,3384,0,0,0,1.0,1,1.0,1,1.0,1,0.10429737816205378,35
2440,0,5245,1861,3384,0,0,0,1.0,1,1.0,1,1.0,1,0.10429737816205378,35
2441,3,5248,1863,3385,0,0,0,1.0,1,1.0,1,1.0,1,0.13164534255048688,35
2442,1,5249,1863,3386,0,0,0,1.0,1,1.0,1,1.0,1,0.14451057784611696,35
2443,3,5252,1865,3387,0,0,0,1.0,1,1.0,1,1.0,1,0.15586946916519787,35
2444,0,5252,1865,3387,0,0,0,1.0,1,1.0,1,1.0,1,0.1926675301437028,34
2445,2,5254,1866,3388,0,0,0,1.0,1,1.0,1,1.0,1,0.21725450377973946,33
2446,5,5259,1867,3392,0,0,0,1.0,1,1.0,1,1.0,1,0.14050657681007733,30
2447,1,5260,1867,3393,0,0,0,1.0,1,1.0,1,1.0,1,0.1361137557511575,29
2448,3,5263,1868,3395,0,0,0,1.0,1,1.0,1,1.0,1,0.18112197160064267,27
2449,1,5264,1868,3396,0,0,0,1.0,1,1.0,1,1.0,1,0.2181872933653089,26
2450,3,5267,1870,3397,0,0,0,1.0,1,1.0,1,1.0,1,0.27645477543854063,28
2451,5,5272,1870,3402,0,0,0,1.0,1,1.0,1,1.0,1,0.09604989880357795,28
2452,0,5272,1870,3402,0,0,0,1.0,1,1.0,1,1.0,1,0.11391913505614525,29
2453,1,5273,1871,3402,0,0,0,1.0,1,1.0,1,1.0,1,0.13735031510770232,30
2454,2,5275,1872,3403,0,0,0,1.0,1,1.0,1,1.0,1,0.17261000311252817,32
2455,3,5278,1873,3405,0,0,0,1.0,1,1.0,1,1.0,1,0.17612295479446957,33
2456,3,5281,1873,3408,0,0,0,1.0,1,1.0,1,1.0,1,0.09482710739805005,34
2457,2,5283,1874,3409,0,0,0,1.0,1,1.0,1,1.0,1,0.13300057670528884,34
2458,4,5287,1875,3412,0,0,0,1.0,1,1.0,1,1.0,1,0.15832861359191155,36
2459,1,5288,1875,3413,0,0,0,1.0,1,1.0,1,1.0,1,0.1664957139588933,36
2460,3,5291,1877,3414,0,0,0,1.0,1,1.0,1,1.0,1,0.1569764172871728,37
2461,0,5291,1877,3414,0,0,0,1.0,1,1.0,1,1.0,1,0.1569764172871728,37
2462,8,5299,1880,3419,0,0,0,1.0,1,1.0,1,1.0,1,0.1605427555284368,38
2463,3,5302,1881,3421,0,0,0,1.0,1,1.0,1,1.0,1,0.11426926968789541,38
2464,2,5304,1882,3422,0,0,0,1.0,1,1.0,1,1.0,1,0.11264599570570022,37
2465,1,5305,1882,3423,0,0,0,1.0,1,1.0,1,1.0,1,0.10331158553787527,36
2466,4,5309,1885,3424,0,0,0,1.0,1,1.0,1,1.0,1,0.11916307670213076,36
2467,0,5309,1885,3424,0,0,0,1.0,1,1.0,1,1.0,1,0.13506033265050776,34
2468,3,5312,1887,3425,0,0,0,1.0,1,1.0,1,1.0,1,0.16730259467971942,33
2469,0,5312,1887,3425,0,0,0,1.0,1,1.0,1,1.0,1,0.1722825428269426,32
2470,2,5314,1889,3425,0,0,0,1.0,1,1.0,1,1.0,1,0.2561103119740686,33
2471,2,5316,1889,3427,0,0,0,1.0,1,1.0,1,1.0,1,0.2525309698057284,31
2472,2,5318,1889,3429,0,0,0,1.0,1,1.0,1,1.0,1,0.1863178802456232,32
2473,1,5319,1889,3430,0,0,0,1.0,1,1.0,1,1.0,1,0.1924042066781666,31
2474,4,5323,1890,3433,0,0,0,1.0,1,1.0,1,1.0,1,0.1792200712846927,33
2475,2,5325,1891,3434,0,0,0,1.0,1,1.0,1,1.0,1,0.18079828096947895,33
2476,0,5325,1891,3434,0,0,0,1.0,1,1.0,1,1.0,1,0.18079828096947895,33
2477,1,5326,1892,3434,0,0,0,1.0,1,1.0,1,1.0,1,0.20491415699494822,33
2478,1,5327,1893,3434,0,0,0,1.0,1,1.0,1,1.0,1,0.17931736902435041,33
2479,7,5334,1896,3438,0,0,0,1.0,1,1.0,1,1.0,1,0.18367265151857431,33
2480,3,5337,1898,3439,0,0,0,1.0,1,1.0,1,1.0,1,0.17926367539172633,34
2481,6,5343,1901,3442,0,0,0,1.0,1,1.0,1,1.0,1,0.16357061769107412,33
2482,3,5346,1902,3444,0,0,0,1.0,1,1.0,1,1.0,1,0.1473989775798426,34
2483,2,5348,1902,3446,0,0,0,1.0,1,1.0,1,1.0,1,0.10573415110525015,33
2484,3,5351,1903,3448,0,0,0,1.0,1,1.0,1,1.0,1,0.18625337974871112,32
2485,0,5351,1903,3448,0,0,0,1.0,1,1.0,1,1.0,1,0.19677934644939235,31
2486,4,5355,1904,3451,0,0,0,1.0,1,1.0,1,1.0,1,0.12717587149809373,29
2487,1,5356,1904,3452,0,0,0,1.0,1,1.0,1,1.0,1,0.109113674995338,29
2488,0,5356,1904,3452,0,0,0,1.0,1,1.0,1,1.0,1,0.11962163560512938,30
2489,0,5356,1904,3452,0,0,0,1.0,1,1.0,1,1.0,1,0.14158657701103278,29
2490,2,5358,1906,3452,0,0,0,1.0,1,1.0,1,1.0,1,0.21857204765785268,30
2491,2,5360,1906,3454,0,0,0,1.0,1,1.0,1,1.0,1,0.14803101854911013,30
2492,1,5361,1907,3454,0,0,0,1.0,1,1.0,1,1.0,1,0.1950998008577232,29
2493,1,5362,1907,3455,0,0,0,1.0,1,1.0,1,1.0,1,0.1504537521546368,29
2494,0,5362,1907,3455,0,0,0,1.0,1,1.0,1,1.0,1,0.18028843387690316,28
2495,1,5363,1908,3455,0,0,0,1.0,1,1.0,1,1.0,1,0.23125690776487925,29
2496,1,5364,1908,3456,0,0,0,1.0,1,1.0,1,1.0,1,0.17521263747714402,28
2497,0,5364,1908,3456,0,0,0,1.0,1,1.0,1,1.0,1,0.21696630391090713,28
2498,0,5364,1908,3456,0,0,0,1.0,1,1.0,1,1.0,1,0.245837567556216,29
2499,2,5366,1909,3457,0,0,0,1.0,1,1.0,1,1.0,1,0.23513793660773744,30
2500,3,5369,1911,3458,0,0,0,1.0,1,1.0,1,1.0,1,0.21672692996138637,29
2501,7,5376,1913,3463,0,0,0,1.0,1,1.0,1,1.0,1,0.14962883885894215,33
2502,5,5381,1915,3466,0,0,0,1.0,1,1.0,1,1.0,1,0.14766791054586526,33
2503,2,5383,1916,3467,0,0,0,1.0,1,1.0,1,1.0,1,0.1619449283013565,31
2504,4,5387,1919,3468,0,0,0,1.0,1,1.0,1,1.0,1,0.2213062605605329,31
2505,2,5389,1920,3469,0,0,0,1.0,1,1.0,1,1.0,1,0.1912437427289922,32
2506,6,5395,1924,3471,0,0,0,1.0,1,1.0,1,1.0,1,0.17781345267856463,31
2507,1,5396,1925,3471,0,0,0,1.0,1,1.0,1,1.0,1,0.14218003869743598,29
2508,1,5397,1926,3471,0,0,0,1.0,1,1.0,1,1.0,1,0.1608744225891006,31
2509,0,5397,1926,3471,0,0,0,1.0,1,1.0,1,1.0,1,0.13716012039261047,30
2510,2,5399,1927,3472,0,0,0,1.0,1,1.0,1,1.0,1,0.18757246311302433,31
2511,5,5404,1927,3477,0,0,0,1.0,1,1.0,1,1.0,1,0.10306983213550239,32
2512,2,5406,1928,3478,0,0,0,1.0,1,1.0,1,1.0,1,0.10467211771661929,32
2513,2,5408,1929,3479,0,0,0,1.0,1,1.0,1,1.0,1,0.09737568453481998,34
2514,1,5409,1929,3480,0,0,0,1.0,1,1.0,1,1.0,1,0.11182900789938446,35
2515,4,5413,1931,3482,0,0,0,1.0,1,1.0,1,1.0,1,0.18659148139279694,35
2516,5,5418,1932,3486,0,0,0,1.0,1,1.0,1,1.0,1,0.15125795936029926,34
2517,2,5420,1933,3487,0,0,0,1.0,1,1.0,1,1.0,1,0.1478426315174962,34
2518,3,5423,1935,3488,0,0,0,1.0,1,1.0,1,1.0,1,0.20115471727433584,33
2519,0,5423,1935,3488,0,0,0,1.0,1,1.0,1,1.0,1,0.18462212215265286,32
2520,2,5425,1936,3489,0,0,0,1.0,1,1.0,1,1.0,1,0.27919876695387186,31
2521,3,5428,1937,3491,0,0,0,1.0,1,1.0,1,1.0,1,0.20418119205357477,31
2522,1,5429,1938,3491,0,0,0,1.0,1,1.0,1,1.0,1,0.27117939651607414,30
2523,1,5430,1938,3492,0,0,0,1.0,1,1.0,1,1.0,1,0.2767866206182334,30
2524,0,5430,1938,3492,0,0,0,1.0,1,1.0,1,1.0,1,0.307913538839537,29
2525,3,5433,1938,3495,0,0,0,1.0,1,1.0,1,1.0,1,0.21986617134670083,29
2526,1,5434,1938,3496,0,0,0,1.0,1,1.0,1,1.0,1,0.2571339208923424,27
2527,2,5436,1938,3498,0,0,0,1.0,1,1.0,1,1.0,1,0.19750970953058955,28
2528,0,5436,1938,3498,0,0,0,1.0,1,1.0,1,1.0,1,0.19750970953058955,28
2529,1,5437,1938,3499,0,0,0,1.0,1,1.0,1,1.0,1,0.17646857316238912,28
2530,0,5437,1938,3499,0,0,0,1.0,1,1.0,1,1.0,1,0.19295172756009554,29
2531,3,5440,1938,3502,0,0,0,1.0,1,1.0,1,1.0,1,0.14154242546687074,30
2532,0,5440,1938,3502,0,0,0,1.0,1,1.0,1,1.0,1,0.15670403709833,31
2533,0,5440,1938,3502,0,0,0,1.0,1,1.0,1,1.0,1,0.15670403709833,31
2534,1,5441,1938,3503,0,0,0,1.0,1,1.0,1,1.0,1,0.13314216719810584,31
2535,1,5442,1938,3504,0,0,0,1.0,1,1.0,1,1.0,1,0.10710993922257644,31
2536,2,5444,1939,3505,0,0,0,1.0,1,1.0,1,1.0,1,0.1372043639302815,32
2537,1,5445,1940,3505,0,0,0,1.0,1,1.0,1,1.0,1,0.13960934127139946,33
2538,2,5447,1941,3506,0,0,0,1.0,1,1.0,1,1.0,1,0.15782369889065667,35
2539,2,5449,1942,3507,0,0,0,1.0,1,1.0,1,1.0,1,0.1787111100307252,37
2540,5,5454,1943,3511,0,0,0,1.0,1,1.0,1,1.0,1,0.21250804218390343,38
2541,4,5458,1944,3514,0,0,0,1.0,1,1.0,1,1.0,1,0.1741501564829894,39
2542,1,5459,1945,3514,0,0,0,1.0,1,1.0,1,1.0,1,0.17463587312565357,38
2543,4,5463,1947,3516,0,0,0,1.0,1,1.0,1,1.0,1,0.17360492885092338,41
2544,3,5466,1949,3517,0,0,0,1.0,1,1.0,1,1.0,1,0.14117719564980816,39
2545,4,5470,1950,3520,0,0,0,1.0,1,1.0,1,1.0,1,0.14372118725472482,40
2546,2,5472,1950,3522,0,0,0,1.0,1,1.0,1,1.0,1,0.10827740617357348,38
2547,3,5475,1953,3522,0,0,0,1.0,1,1.0,1,1.0,1,0.1400255025920085,38
2548,0,5475,1953,3522,0,0,0,1.0,1,1.0,1,1.0,1,0.1750506912971515,35
2549,3,5478,1956,3522,0,0,0,1.0,1,1.0,1,1.0,1,0.21849611433347482,35
2550,2,5480,1957,3523,0,0,0,1.0,1,1.0,1,1.0,1,0.2309601872014518,33
2551,5,5485,1959,3526,0,0,0,1.0,1,1.0,1,1.0,1,0.22646736490646865,31
2552,0,5485,1959,3526,0,0,0,1.0,1,1.0,1,1.0,1,0.24434275149158355,30
2553,0,5485,1959,3526,0,0,0,1.0,1,1.0,1,1.0,1,0.24434275149158355,30
2554,2,5487,1959,3528,0,0,0,1.0,1,1.0,1,1.0,1,0.16928003558102095,32
2555,1,5488,1959,3529,0,0,0,1.0,1,1.0,1,1.0,1,0.1740509864626094,32
2556,1,5489,1959,3530,0,0,0,1.0,1,1.0,1,1.0,1,0.143680749863929,32
2557,0,5489,1959,3530,0,0,0,1.0,1,1.0,1,1.0,1,0.19180265710942596,30
2558,2,5491,1961,3530,0,0,0,1.0,1,1.0,1,1.0,1,0.20715685713626464,31
2559,1,5492,1961,3531,0,0,0,1.0,1,1.0,1,1.0,1,0.18264590124073768,30
2560,0,5492,1961,3531,0,0,0,1.0,1,1.0,1,1.0,1,0.18264590124073768,30
2561,1,5493,1961,3532,0,0,0,1.0,1,1.0,1,1.0,1,0.14052289543293733,30
2562,0,5493,1961,3532,0,0,0,1.0,1,1.0,1,1.0,1,0.15901620703705358,33
2563,0,5493,1961,3532,0,0,0,1.0,1,1.0,1,1.0,1,0.15901620703705358,33
2564,1,5494,1961,3533,0,0,0,1.0,1,1.0,1,1.0,1,0.14351144270890293,33
2565,1,5495,1962,3533,0,0,0,1.0,1,1.0,1,1.0,1,0.10857836357216694,33
2566,0,5495,1962,3533,0,0,0,1.0,1,1.0,1,1.0,1,0.13321276502063176,35
2567,2,5497,1963,3534,0,0,0,1.0,1,1.0,1,1.0,1,0.14333959177785296,36
2568,2,5499,1963,3536,0,0,0,1.0,1,1.0,1,1.0,1,0.15303370880368258,37
2569,1,5500,1963,3537,0,0,0,1.0,1,1.0,1,1.0,1,0.14127137732495396,37
2570,0,5500,1963,3537,0,0,0,1.0,1,1.0,1,1.0,1,0.17690988714858344,37
2571,2,5502,1963,3539,0,0,0,1.0,1,1.0,1,1.0,1,0.15072780805033228,37
2572,0,5502,1963,3539,0,0,0,1.0,1,1.0,1,1.0,1,0.1449664347246353,39
2573,0,5502,1963,3539,0,0,0,1.0,1,1.0,1,1.0,1,0.1449664347246353,39
2574,0,5502,1963,3539,0,0,0,1.0,1,1.0,1,1.0,1,0.16452344830899227,38
2575,0,5502,1963,3539,0,0,0,1.0,1,1.0,1,1.0,1,0.16452344830899227,38
2576,0,5502,1963,3539,0,0,0,1.0,1,1.0,1,1.0,1,0.17741189718706138,37
2577,2,5504,1963,3541,0,0,0,1.0,1,1.0,1,1.0,1,0.15860972420629552,39
2578,2,5506,1963,3543,0,0,0,1.0,1,1.0,1,1.0,1,0.14130341748160274,40
2579,0,5506,1963,3543,0,0,0,1.0,1,1.0,1,1.0,1,0.1385788704736308,41
2580,2,5508,1963,3545,0,0,0,1.0,1,1.0,1,1.0,1,0.13021130791033234,42
2581,2,5510,1963,3547,0,0,0,1.0,1,1.0,1,1.0,1,0.11823941383069321,43
2582,2,5512,1964,3548,0,0,0,1.0,1,1.0,1,1.0,1,0.10853435162046214,43
2583,2,5514,1965,3549,0,0,0,1.0,1,1.0,1,1.0,1,0.12404034278268525,43
2584,0,5514,1965,3549,0,0,0,1.0,1,1.0,1,1.0,1,0.10046453867708625,43
2585,1,5515,1966,3549,0,0,0,1.0,1,1.0,1,1.0,1,0.1527660217072791,44
2586,2,5517,1966,3551,0,0,0,1.0,1,1.0,1,1.0,1,0.07669825432276982,43
2587,7,5524,1969,3555,0,0,0,1.0,1,1.0,1,1.0,1,0.13350097024364865,44
2588,2,5526,1969,3557,0,0,0,1.0,1,1.0,1,1.0,1,0.0864454255930206,44
2589,4,5530,1970,3560,0,0,0,1.0,1,1.0,1,1.0,1,0.0893820604795867,44
2590,2,5532,1970,3562,0,0,0,1.0,1,1.0,1,1.0,1,0.0893820604795867,44
2591,0,5532,1970,3562,0,0,0,1.0,1,1.0,1,1.0,1,0.0893820604795867,44
2592,1,5533,1971,3562,0,0,0,1.0,1,1.0,1,1.0,1,0.10714699725458222,44
2593,1,5534,1972,3562,0,0,0,1.0,1,1.0,1,1.0,1,0.08039315877088657,43
2594,4,5538,1975,3563,0,0,0,1.0,1,1.0,1,1.0,1,0.12823228301235537,48
2595,0,5538,1975,3563,0,0,0,1.0,1,1.0,1,1.0,1,0.15903260425653418,45
2596,11,5549,1978,3571,0,0,0,1.0,1,1.0,1,1.0,1,0.1266538615515014,46
2597,4,5553,1979,3574,0,0,0,1.0,1,1.0,1,1.0,1,0.11071263403737806,45
2598,1,5554,1979,3575,0,0,0,1.0,1,1.0,1,1.0,1,0.0979379055313891,45
2599,5,5559,1982,3577,0,0,0,1.0,1,1.0,1,1.0,1,0.13075339162691557,45
2600,3,5562,1982,3580,0,0,0,1.0,1,1.0,1,1.0,1,0.17023548418206255,48
2601,6,5568,1984,3584,0,0,0,1.0,1,1.0,1,1.0,1,0.09297962372662305,47
2602,1,5569,1984,3585,0,0,0,1.0,1,1.0,1,1.0,1,0.11216306091080053,48
2603,0,5569,1984,3585,0,0,0,1.0,1,1.0,1,1.0,1,0.11216306091080053,48
2604,0,5569,1984,3585,0,0,0,1.0,1,1.0,1,1.0,1,0.12435480978959727,47
2605,1,5570,1985,3585,0,0,0,1.0,1,1.0,1,1.0,1,0.14365955818859186,47
2606,3,5573,1985,3588,0,0,0,1.0,1,1.0,1,1.0,1,0.08726623462062091,46
2607,3,5576,1986,3590,0,0,0,1.0,1,1.0,1,1.0,1,0.11527881531034521,45
2608,1,5577,1986,3591,0,0,0,1.0,1,1.0,1,1.0,1,0.07665574884156794,45
2609,1,5578,1987,3591,0,0,0,1.0,1,1.0,1,1.0,1,0.09209426386467987,44
2610,1,5579,1988,3591,0,0,0,1.0,1,1.0,1,1.0,1,0.13225864225485542,45
2611,5,5584,1991,3593,0,0,0,1.0,1,1.0,1,1.0,1,0.08753251888036512,46
2612,0,5584,1991,3593,0,0,0,1.0,1,1.0,1,1.0,1,0.10563679249668219,47
2613,4,5588,1993,3595,0,0,0,1.0,1,1.0,1,1.0,1,0.13563873657652337,48
2614,2,5590,1994,3596,0,0,0,1.0,1,1.0,1,1.0,1,0.17150935558579128,48
2615,2,5592,1996,3596,0,0,0,1.0,1,1.0,1,1.0,1,0.18989521131370565,49
2616,5,5597,1997,3600,0,0,0,1.0,1,1.0,1,1.0,1,0.17150825288437802,49
2617,2,5599,1997,3602,0,0,0,1.0,1,1.0,1,1.0,1,0.15898727349036507,48
2618,2,5601,1997,3604,0,0,0,1.0,1,1.0,1,1.0,1,0.17126282113432115,47
2619,3,5604,1997,3607,0,0,0,1.0,1,1.0,1,1.0,1,0.1472561691675972,50
2620,4,5608,1997,3611,0,0,0,1.0,1,1.0,1,1.0,1,0.1417524881895029,51
2621,6,5614,1998,3616,0,0,0,1.0,1,1.0,1,1.0,1,0.09344658207162279,52
2622,0,5614,1998,3616,0,0,0,1.0,1,1.0,1,1.0,1,0.0825062108551271,52
2623,3,5617,1999,3618,0,0,0,1.0,1,1.0,1,1.0,1,0.10086112819908555,53
2624,4,5621,2001,3620,0,0,0,1.0,1,1.0,1,1.0,1,0.13064209254817263,51
2625,4,5625,2001,3624,0,0,0,1.0,1,1.0,1,1.0,1,0.12156053487392851,50
2626,7,5632,2004,3628,0,0,0,1.0,1,1.0,1,1.0,1,0.11861498836773189,49
2627,2,5634,2004,3630,0,0,0,1.0,1,1.0,1,1.0,1,0.1268661599838343,48
2628,4,5638,2007,3631,0,0,0,1.0,1,1.0,1,1.0,1,0.17752274779577956,48
2629,3,5641,2008,3633,0,0,0,1.0,1,1.0,1,1.0,1,0.15202780349851408,47
2630,3,5644,2008,3636,0,0,0,1.0,1,1.0,1,1.0,1,0.14509890459605576,47
2631,3,5647,2008,3639,0,0,0,1.0,1,1.0,1,1.0,1,0.10319462884062325,47
2632,2,5649,2009,3640,0,0,0,1.0,1,1.0,1,1.0,1,0.10832767264220124,47
2633,0,5649,2009,3640,0,0,0,1.0,1,1.0,1,1.0,1,0.09904311743888994,44
2634,0,5649,2009,3640,0,0,0,1.0,1,1.0,1,1.0,1,0.09892053129652018,44
2635,5,5654,2011,3643,0,0,0,1.0,1,1.0,1,1.0,1,0.1262903277001659,45
2636,2,5656,2012,3644,0,0,0,1.0,1,1.0,1,1.0,1,0.11439446914862572,40
2637,7,5663,2018,3645,0,0,0,1.0,1,1.0,1,1.0,1,0.2277769465244507,41
2638,6,5669,2020,3649,0,0,0,1.0,1,1.0,1,1.0,1,0.13776711889994245,38
2639,3,5672,2020,3652,0,0,0,1.0,1,1.0,1,1.0,1,0.09788572162570809,39
2640,1,5673,2021,3652,0,0,0,1.0,1,1.0,1,1.0,1,0.13951728456904242,38
2641,5,5678,2024,3654,0,0,0,1.0,1,1.0,1,1.0,1,0.15354292409034268,37
2642,5,5683,2027,3656,0,0,0,1.0,1,1.0,1,1.0,1,0.2225121378412358,38
2643,2,5685,2027,3658,0,0,0,1.0,1,1.0,1,1.0,1,0.1657461822612914,37
2644,1,5686,2027,3659,0,0,0,1.0,1,1.0,1,1.0,1,0.171511060334226,36
2645,1,5687,2028,3659,0,0,0,1.0,1,1.0,1,1.0,1,0.1843065559345741,35
2646,2,5689,2028,3661,0,0,0,1.0,1,1.0,1,1.0,1,0.1484870754370352,35
2647,2,5691,2029,3662,0,0,0,1.0,1,1.0,1,1.0,1,0.12949364294913754,35
2648,0,5691,2029,3662,0,0,0,1.0,1,1.0,1,1.0,1,0.10550911740922164,36
2649,0,5691,2029,3662,0,0,0,1.0,1,1.0,1,1.0,1,0.1135964723088679,37
2650,2,5693,2029,3664,0,0,0,1.0,1,1.0,1,1.0,1,0.09278571302554663,39
2651,0,5693,2029,3664,0,0,0,1.0,1,1.0,1,1.0,1,0.09278571302554663,39
2652,0,5693,2029,3664,0,0,0,1.0,1,1.0,1,1.0,1,0.09278571302554663,39
2653,0,5693,2029,3664,0,0,0,1.0,1,1.0,1,1.0,1,0.09278571302554663,39
2654,1,5694,2029,3665,0,0,0,1.0,1,1.0,1,1.0,1,0.08828849883948958,40
2655,0,5694,2029,3665,0,0,0,1.0,1,1.0,1,1.0,1,0.08828849883948958,40
2656,2,5696,2030,3666,0,0,0,1.0,1,1.0,1,1.0,1,0.11400130212373495,39
2657,1,5697,2030,3667,0,0,0,1.0,1,1.0,1,1.0,1,0.13138078418723856,40
2658,3,5700,2031,3669,0,0,0,1.0,1,1.0,1,1.0,1,0.21177495166947083,41
2659,7,5707,2034,3673,0,0,0,1.0,1,1.0,1,1.0,1,0.25865759438335345,41
2660,4,5711,2035,3676,0,0,0,1.0,1,1.0,1,1.0,1,0.27033899078522006,40
2661,8,5719,2035,3684,0,0,0,1.0,1,1.0,1,1.0,1,0.14252250325168256,40
2662,4,5723,2037,3686,0,0,0,1.0,1,1.0,1,1.0,1,0.15770187705474956,42
2663,4,5727,2039,3688,0,0,0,1.0,1,1.0,1,1.0,1,0.07357562692506207,41
2664,0,5727,2039,3688,0,0,0,1.0,1,1.0,1,1.0,1,0.07262720484432347,42
2665,5,5732,2040,3692,0,0,0,1.0,1,1.0,1,1.0,1,0.12498602403432856,43
2666,9,5741,2043,3698,0,0,0,1.0,1,1.0,1,1.0,1,0.17105655701196074,44
2667,6,5747,2045,3702,0,0,0,1.0,1,1.0,1,1.0,1,0.20507298879720975,42
2668,8,5755,2047,3708,0,0,0,1.0,1,1.0,1,1.0,1,0.22222881705282932,41
2669,6,5761,2048,3713,0,0,0,1.0,1,1.0,1,1.0,1,0.2555898381523068,42
2670,5,5766,2048,3718,0,0,0,1.0,1,1.0,1,1.0,1,0.26331115003881045,40
2671,5,5771,2050,3721,0,0,0,1.0,1,1.0,1,1.0,1,0.24793086656324162,39
2672,0,5771,2050,3721,0,0,0,1.0,1,1.0,1,1.0,1,0.27792666995630244,36
2673,3,5774,2051,3723,0,0,0,1.0,1,1.0,1,1.0,1,0.26745750957938225,35
2674,3,5777,2051,3726,0,0,0,1.0,1,1.0,1,1.0,1,0.22097611347833662,33
2675,3,5780,2051,3729,0,0,0,1.0,1,1.0,1,1.0,1,0.20200557120597187,34
2676,4,5784,2051,3733,0,0,0,1.0,1,1.0,1,1.0,1,0.09357057521965202,32
2677,1,5785,2052,3733,0,0,0,1.0,1,1.0,1,1.0,1,0.08656032265877779,33
2678,1,5786,2052,3734,0,0,0,1.0,1,1.0,1,1.0,1,0.09330693174156468,33
2679,2,5788,2053,3735,0,0,0,1.0,1,1.0,1,1.0,1,0.05836251899572473,32
2680,0,5788,2053,3735,0,0,0,1.0,1,1.0,1,1.0,1,0.05836251899572473,32
2681,1,5789,2053,3736,0,0,0,1.0,1,1.0,1,1.0,1,0.1082927853329072,32
2682,2,5791,2054,3737,0,0,0,1.0,1,1.0,1,1.0,1,0.0911943022518204,33
2683,0,5791,2054,3737,0,0,0,1.0,1,1.0,1,1.0,1,0.0950094598623801,32
2684,0,5791,2054,3737,0,0,0,1.0,1,1.0,1,1.0,1,0.14726484867688475,31
2685,0,5791,2054,3737,0,0,0,1.0,1,1.0,1,1.0,1,0.14726484867688475,31
2686,0,5791,2054,3737,0,0,0,1.0,1,1.0,1,1.0,1,0.18521483099683164,30
2687,0,5791,2054,3737,0,0,0,1.0,1,1.0,1,1.0,1,0.18521483099683164,30
2688,2,5793,2056,3737,0,0,0,1.0,1,1.0,1,1.0,1,0.2960644034774659,30
2689,2,5795,2057,3738,0,0,0,1.0,1,1.0,1,1.0,1,0.2244266111719221,31
2690,2,5797,2058,3739,0,0,0,1.0,1,1.0,1,1.0,1,0.20021124112852623,31
2691,6,5803,2060,3743,0,0,0,1.0,1,1.0,1,1.0,1,0.13941493741057265,32
2692,3,5806,2062,3744,0,0,0,1.0,1,1.0,1,1.0,1,0.1663197921189455,32
2693,2,5808,2063,3745,0,0,0,1.0,1,1.0,1,1.0,1,0.15806376778423947,33
2694,0,5808,2063,3745,0,0,0,1.0,1,1.0,1,1.0,1,0.15978964410453336,34
2695,2,5810,2063,3747,0,0,0,1.0,1,1.0,1,1.0,1,0.16745623337799873,35
2696,3,5813,2063,3750,0,0,0,1.0,1,1.0,1,1.0,1,0.09036490184746267,35
2697,0,5813,2063,3750,0,0,0,1.0,1,1.0,1,1.0,1,0.09036490184746267,35
2698,0,5813,2063,3750,0,0,0,1.0,1,1.0,1,1.0,1,0.08747833266679246,36
2699,1,5814,2063,3751,0,0,0,1.0,1,1.0,1,1.0,1,0.12663209217805227,36
2700,2,5816,2065,3751,0,0,0,1.0,1,1.0,1,1.0,1,0.15817647754486588,37
2701,1,5817,2066,3751,0,0,0,1.0,1,1.0,1,1.0,1,0.18735114510898104,37
2702,7,5824,2068,3756,0,0,0,1.0,1,1.0,1,1.0,1,0.19013102055189987,37
2703,1,5825,2069,3756,0,0,0,1.0,1,1.0,1,1.0,1,0.19476004499130245,38
2704,2,5827,2070,3757,0,0,0,1.0,1,1.0,1,1.0,1,0.2043073608010523,37
2705,2,5829,2071,3758,0,0,0,1.0,1,1.0,1,1.0,1,0.16929131494633667,36
2706,2,5831,2072,3759,0,0,0,1.0,1,1.0,1,1.0,1,0.1818129996057671,36
2707,2,5833,2073,3760,0,0,0,1.0,1,1.0,1,1.0,1,0.20718829740697897,35
2708,7,5840,2076,3764,0,0,0,1.0,1,1.0,1,1.0,1,0.14745070020002066,36
2709,1,5841,2077,3764,0,0,0,1.0,1,1.0,1,1.0,1,0.1434864816502996,32
2710,1,5842,2078,3764,0,0,0,1.0,1,1.0,1,1.0,1,0.12753092170766425,29
2711,0,5842,2078,3764,0,0,0,1.0,1,1.0,1,1.0,1,0.11100974973405027,29
2712,1,5843,2079,3764,0,0,0,1.0,1,1.0,1,1.0,1,0.21903427886448884,28
2713,0,5843,2079,3764,0,0,0,1.0,1,1.0,1,1.0,1,0.1985833151898751,28
2714,1,5844,2080,3764,0,0,0,1.0,1,1.0,1,1.0,1,0.22796860784384107,26
2715,1,5845,2081,3764,0,0,0,1.0,1,1.0,1,1.0,1,0.25217640836585586,24
2716,2,5847,2081,3766,0,0,0,1.0,1,1.0,1,1.0,1,0.2175271508693251,24
2717,4,5851,2082,3769,0,0,0,1.0,1,1.0,1,1.0,1,0.22410727766628227,25
2718,4,5855,2083,3772,0,0,0,1.0,1,1.0,1,1.0,1,0.22169294991133842,25
2719,2,5857,2085,3772,0,0,0,1.0,1,1.0,1,1.0,1,0.25679324086606087,25
2720,3,5860,2086,3774,0,0,0,1.0,1,1.0,1,1.0,1,0.3010985660236105,25
2721,4,5864,2088,3776,0,0,0,1.0,1,1.0,1,1.0,1,0.20874403467937966,25
2722,3,5867,2089,3778,0,0,0,1.0,1,1.0,1,1.0,1,0.1849750308946037,26
2723,0,5867,2089,3778,0,0,0,1.0,1,1.0,1,1.0,1,0.1849750308946037,26
2724,2,5869,2089,3780,0,0,0,1.0,1,1.0,1,1.0,1,0.1586673113420144,27
2725,1,5870,2089,3781,0,0,0,1.0,1,1.0,1,1.0,1,0.13400860431073375,28
2726,2,5872,2090,3782,0,0,0,1.0,1,1.0,1,1.0,1,0.13336151901349977,28
2727,0,5872,2090,3782,0,0,0,1.0,1,1.0,1,1.0,1,0.16471970631737998,29
2728,1,5873,2091,3782,0,0,0,1.0,1,1.0,1,1.0,1,0.20930023732944997,29
2729,1,5874,2092,3782,0,0,0,1.0,1,1.0,1,1.0,1,0.24133539835788356,29
2730,0,5874,2092,3782,0,0,0,1.0,1,1.0,1,1.0,1,0.24133539835788356,29
2731,3,5877,2093,3784,0,0,0,1.0,1,1.0,1,1.0,1,0.24387934561582802,30
2732,2,5879,2094,3785,0,0,0,1.0,1,1.0,1,1.0,1,0.24464807924338414,29
2733,1,5880,2094,3786,0,0,0,1.0,1,1.0,1,1.0,1,0.22450283758661954,29
2734,0,5880,2094,3786,0,0,0,1.0,1,1.0,1,1.0,1,0.22450283758661954,29
2735,1,5881,2094,3787,0,0,0,1.0,1,1.0,1,1.0,1,0.2343309692077711,29
2736,5,5886,2096,3790,0,0,0,1.0,1,1.0,1,1.0,1,0.20667755034496227,30
2737,0,5886,2096,3790,0,0,0,1.0,1,1.0,1,1.0,1,0.2220618182074104,30
2738,1,5887,2097,3790,0,0,0,1.0,1,1.0,1,1.0,1,0.2341455469928268,30
2739,1,5888,2098,3790,0,0,0,1.0,1,1.0,1,1.0,1,0.2516387071381188,29
2740,0,5888,2098,3790,0,0,0,1.0,1,1.0,1,1.0,1,0.2516387071381188,29
2741,6,5894,2099,3795,0,0,0,1.0,1,1.0,1,1.0,1,0.15985369791903975,28
2742,1,5895,2100,3795,0,0,0,1.0,1,1.0,1,1.0,1,0.15745492077751996,28
2743,1,5896,2100,3796,0,0,0,1.0,1,1.0,1,1.0,1,0.1613798829892276,29
2744,3,5899,2101,3798,0,0,0,1.0,1,1.0,1,1.0,1,0.1205834540005483,27
2745,3,5902,2102,3800,0,0,0,1.0,1,1.0,1,1.0,1,0.1395625411891384,25
2746,3,5905,2104,3801,0,0,0,1.0,1,1.0,1,1.0,1,0.12351061774927215,25
2747,2,5907,2106,3801,0,0,0,1.0,1,1.0,1,1.0,1,0.20447745871437373,23
2748,2,5909,2106,3803,0,0,0,1.0,1,1.0,1,1.0,1,0.18622445907342897,22
2749,0,5909,2106,3803,0,0,0,1.0,1,1.0,1,1.0,1,0.33579908182964896,19
2750,1,5910,2107,3803,0,0,0,1.0,1,1.0,1,1.0,1,0.3020719557077272,18
2751,3,5913,2107,3806,0,0,0,1.0,1,1.0,1,1.0,1,0.19251964502877156,16
2752,0,5913,2107,3806,0,0,0,1.0,1,1.0,1,1.0,1,0.2078517672199078,15
2753,0,5913,2107,3806,0,0,0,1.0,1,1.0,1,1.0,1,0.2078517672199078,15
2754,0,5913,2107,3806,0,0,0,1.0,1,1.0,1,1.0,1,0.2078517672199078,15
2755,0,5913,2107,3806,0,0,0,1.0,1,1.0,1,1.0,1,0.2078517672199078,15
2756,0,5913,2107,3806,0,0,0,1.0,1,1.0,1,1.0,1,0.22608991703664036,16
2757,0,5913,2107,3806,0,0,0,1.0,1,1.0,1,1.0,1,0.24943502592188752,17
2758,0,5913,2107,3806,0,0,0,1.0,1,1.0,1,1.0,1,0.24943502592188752,17
2759,1,5914,2107,3807,0,0,0,1.0,1,1.0,1,1.0,1,0.2188743964190722,18
2760,0,5914,2107,3807,0,0,0,1.0,1,1.0,1,1.0,1,0.2188743964190722,18
2761,0,5914,2107,3807,0,0,0,1.0,1,1.0,1,1.0,1,0.2188743964190722,18
2762,0,5914,2107,3807,0,0,0,1.0,1,1.0,1,1.0,1,0.2188743964190722,18
2763,0,5914,2107,3807,0,0,0,1.0,1,1.0,1,1.0,1,0.21535574088426335,17
2764,1,5915,2108,3807,0,0,0,1.0,1,1.0,1,1.0,1,0.2392979667379643,17
2765,0,5915,2108,3807,0,0,0,1.0,1,1.0,1,1.0,1,0.25369001670927854,18
2766,0,5915,2108,3807,0,0,0,1.0,1,1.0,1,1.0,1,0.25369001670927854,18
2767,1,5916,2108,3808,0,0,0,1.0,1,1.0,1,1.0,1,0.21174255725791602,18
2768,0,5916,2108,3808,0,0,0,1.0,1,1.0,1,1.0,1,0.21174255725791602,18
2769,2,5918,2110,3808,0,0,0,1.0,1,1.0,1,1.0,1,0.31756912240046486,18
2770,1,5919,2110,3809,0,0,0,1.0,1,1.0,1,1.0,1,0.2598907995754844,18
2771,1,5920,2110,3810,0,0,0,1.0,1,1.0,1,1.0,1,0.19388515351785818,18
2772,0,5920,2110,3810,0,0,0,1.0,1,1.0,1,1.0,1,0.19388515351785818,18
2773,0,5920,2110,3810,0,0,0,1.0,1,1.0,1,1.0,1,0.19388515351785818,18
2774,3,5923,2111,3812,0,0,0,1.0,1,1.0,1,1.0,1,0.23359424195165346,20
2775,1,5924,2112,3812,0,0,0,1.0,1,1.0,1,1.0,1,0.24219830202352965,21
2776,2,5926,2112,3814,0,0,0,1.0,1,1.0,1,1.0,1,0.13093800655553306,21
2777,1,5927,2112,3815,0,0,0,1.0,1,1.0,1,1.0,1,0.10948552165211435,22
2778,1,5928,2113,3815,0,0,0,1.0,1,1.0,1,1.0,1,0.07455036764431085,24
2779,4,5932,2115,3817,0,0,0,1.0,1,1.0,1,1.0,1,0.1349428884994668,24
2780,1,5933,2115,3818,0,0,0,1.0,1,1.0,1,1.0,1,0.081951293369604,24
2781,0,5933,2115,3818,0,0,0,1.0,1,1.0,1,1.0,1,0.081951293369604,24
2782,0,5933,2115,3818,0,0,0,1.0,1,1.0,1,1.0,1,0.081951293369604,24
2783,0,5933,2115,3818,0,0,0,1.0,1,1.0,1,1.0,1,0.081951293369604,24
2784,0,5933,2115,3818,0,0,0,1.0,1,1.0,1,1.0,1,0.1422269071326217,24
2785,1,5934,2116,3818,0,0,0,1.0,1,1.0,1,1.0,1,0.1469948584631009,22
2786,0,5934,2116,3818,0,0,0,1.0,1,1.0,1,1.0,1,0.1899565075012349,22
2787,0,5934,2116,3818,0,0,0,1.0,1,1.0,1,1.0,1,0.17799181001732106,21
2788,0,5934,2116,3818,0,0,0,1.0,1,1.0,1,1.0,1,0.1801559113196531,20
2789,1,5935,2117,3818,0,0,0,1.0,1,1.0,1,1.0,1,0.19877261856782866,20
2790,0,5935,2117,3818,0,0,0,1.0,1,1.0,1,1.0,1,0.22882988633167978,21
2791,1,5936,2118,3818,0,0,0,1.0,1,1.0,1,1.0,1,0.2734395814342041,21
2792,0,5936,2118,3818,0,0,0,1.0,1,1.0,1,1.0,1,0.2734395814342041,21
2793,0,5936,2118,3818,0,0,0,1.0,1,1.0,1,1.0,1,0.2962430185746939,18
2794,0,5936,2118,3818,0,0,0,1.0,1,1.0,1,1.0,1,0.2962430185746939,18
2795,0,5936,2118,3818,0,0,0,1.0,1,1.0,1,1.0,1,0.29376343098058905,20
2796,2,5938,2119,3819,0,0,0,1.0,1,1.0,1,1.0,1,0.25703383934485124,21
2797,2,5940,2119,3821,0,0,0,1.0,1,1.0,1,1.0,1,0.17120159144747088,21
2798,0,5940,2119,3821,0,0,0,1.0,1,1.0,1,1.0,1,0.17120159144747088,21
2799,1,5941,2119,3822,0,0,0,1.0,1,1.0,1,1.0,1,0.16135369011415415,22
2800,0,5941,2119,3822,0,0,0,1.0,1,1.0,1,1.0,1,0.16135369011415415,22
2801,2,5943,2121,3822,0,0,0,1.0,1,1.0,1,1.0,1,0.22426160255116367,22
2802,1,5944,2121,3823,0,0,0,1.0,1,1.0,1,1.0,1,0.15898154403432102,22
2803,1,5945,2122,3823,0,0,0,1.0,1,1.0,1,1.0,1,0.22623825458562555,22
2804,0,5945,2122,3823,0,0,0,1.0,1,1.0,1,1.0,1,0.24778222702540328,23
2805,0,5945,2122,3823,0,0,0,1.0,1,1.0,1,1.0,1,0.24778222702540328,23
2806,1,5946,2122,3824,0,0,0,1.0,1,1.0,1,1.0,1,0.2223343734521768,23
2807,0,5946,2122,3824,0,0,0,1.0,1,1.0,1,1.0,1,0.22713283828142888,24
2808,1,5947,2122,3825,0,0,0,1.0,1,1.0,1,1.0,1,0.21542591422076418,24
2809,0,5947,2122,3825,0,0,0,1.0,1,1.0,1,1.0,1,0.23370017464968065,25
2810,1,5948,2122,3826,0,0,0,1.0,1,1.0,1,1.0,1,0.22150907336654288,24
2811,2,5950,2122,3828,0,0,0,1.0,1,1.0,1,1.0,1,0.13782612850096196,26
2812,1,5951,2123,3828,0,0,0,1.0,1,1.0,1,1.0,1,0.17756495837515865,26
2813,0,5951,2123,3828,0,0,0,1.0,1,1.0,1,1.0,1,0.19962705364674946,27
2814,2,5953,2124,3829,0,0,0,1.0,1,1.0,1,1.0,1,0.22468355833671386,29
2815,3,5956,2124,3832,0,0,0,1.0,1,1.0,1,1.0,1,0.21218197772631678,29
2816,1,5957,2124,3833,0,0,0,1.0,1,1.0,1,1.0,1,0.18825285572428138,29
2817,2,5959,2125,3834,0,0,0,1.0,1,1.0,1,1.0,1,0.22449168835956207,29
2818,1,5960,2125,3835,0,0,0,1.0,1,1.0,1,1.0,1,0.24843011630946302,29
2819,0,5960,2125,3835,0,0,0,1.0,1,1.0,1,1.0,1,0.2522937103234898,30
2820,3,5963,2126,3837,0,0,0,1.0,1,1.0,1,1.0,1,0.22932271795066067,30
2821,2,5965,2127,3838,0,0,0,1.0,1,1.0,1,1.0,1,0.20494867740751072,31
2822,5,5970,2131,3839,0,0,0,1.0,1,1.0,1,1.0,1,0.1973376909982971,30
2823,1,5971,2132,3839,0,0,0,1.0,1,1.0,1,1.0,1,0.2034847940599234,27
2824,4,5975,2133,3842,0,0,0,1.0,1,1.0,1,1.0,1,0.152187409365081,28
2825,1,5976,2134,3842,0,0,0,1.0,1,1.0,1,1.0,1,0.16027657683911273,28
2826,2,5978,2135,3843,0,0,0,1.0,1,1.0,1,1.0,1,0.18335304273317554,27
2827,3,5981,2135,3846,0,0,0,1.0,1,1.0,1,1.0,1,0.17194829734592695,28
2828,1,5982,2135,3847,0,0,0,1.0,1,1.0,1,1.0,1,0.16988553249710536,28
2829,0,5982,2135,3847,0,0,0,1.0,1,1.0,1,1.0,1,0.17595024977918264,27
2830,1,5983,2136,3847,0,0,0,1.0,1,1.0,1,1.0,1,0.20296590362889502,27
2831,1,5984,2136,3848,0,0,0,1.0,1,1.0,1,1.0,1,0.16769273634890672,27
2832,4,5988,2138,3850,0,0,0,1.0,1,1.0,1,1.0,1,0.2030307847302905,27
2833,0,5988,2138,3850,0,0,0,1.0,1,1.0,1,1.0,1,0.24199653012343728,26
2834,1,5989,2139,3850,0,0,0,1.0,1,1.0,1,1.0,1,0.206522796701862,26
2835,1,5990,2140,3850,0,0,0,1.0,1,1.0,1,1.0,1,0.18543749854416355,25
2836,1,5991,2140,3851,0,0,0,1.0,1,1.0,1,1.0,1,0.19582601593468402,27
2837,2,5993,2141,3852,0,0,0,1.0,1,1.0,1,1.0,1,0.16247434304653857,27
2838,0,5993,2141,3852,0,0,0,1.0,1,1.0,1,1.0,1,0.16247434304653857,27
2839,0,5993,2141,3852,0,0,0,1.0,1,1.0,1,1.0,1,0.19067146220326367,29
2840,0,5993,2141,3852,0,0,0,1.0,1,1.0,1,1.0,1,0.19067146220326367,29
2841,2,5995,2142,3853,0,0,0,1.0,1,1.0,1,1.0,1,0.1751421664738366,31
2842,0,5995,2142,3853,0,0,0,1.0,1,1.0,1,1.0,1,0.1751421664738366,31
2843,5,6000,2143,3857,0,0,0,1.0,1,1.0,1,1.0,1,0.22921082109659574,32
2844,5,6005,2144,3861,0,0,0,1.0,1,1.0,1,1.0,1,0.26720765398987395,33
2845,6,6011,2144,3867,0,0,0,1.0,1,1.0,1,1.0,1,0.2584034312430846,32
2846,3,6014,2144,3870,0,0,0,1.0,1,1.0,1,1.0,1,0.20828923690023338,33
2847,6,6020,2146,3874,0,0,0,1.0,1,1.0,1,1.0,1,0.22645265661752884,32
2848,2,6022,2147,3875,0,0,0,1.0,1,1.0,1,1.0,1,0.2477213456910054,33
2849,0,6022,2147,3875,0,0,0,1.0,1,1.0,1,1.0,1,0.2556468327434863,34
2850,0,6022,2147,3875,0,0,0,1.0,1,1.0,1,1.0,1,0.2556468327434863,34
2851,3,6025,2147,3878,0,0,0,1.0,1,1.0,1,1.0,1,0.21527988957484964,34
2852,5,6030,2150,3880,0,0,0,1.0,1,1.0,1,1.0,1,0.17656359936166616,35
2853,1,6031,2151,3880,0,0,0,1.0,1,1.0,1,1.0,1,0.1947403068063251,36
2854,3,6034,2151,3883,0,0,0,1.0,1,1.0,1,1.0,1,0.18140259811162557,37
2855,1,6035,2152,3883,0,0,0,1.0,1,1.0,1,1.0,1,0.15543918622345748,38
2856,1,6036,2152,3884,0,0,0,1.0,1,1.0,1,1.0,1,0.1463723961611797,38
2857,2,6038,2153,3885,0,0,0,1.0,1,1.0,1,1.0,1,0.11096600447679522,39
2858,0,6038,2153,3885,0,0,0,1.0,1,1.0,1,1.0,1,0.12413802880493449,40
2859,1,6039,2154,3885,0,0,0,1.0,1,1.0,1,1.0,1,0.1483519626312061,40
2860,1,6040,2154,3886,0,0,0,1.0,1,1.0,1,1.0,1,0.12212771021411403,40
2861,2,6042,2155,3887,0,0,0,1.0,1,1.0,1,1.0,1,0.08444689119511442,38
2862,3,6045,2157,3888,0,0,0,1.0,1,1.0,1,1.0,1,0.13566844424799143,38
2863,3,6048,2158,3890,0,0,0,1.0,1,1.0,1,1.0,1,0.16653900668985708,38
2864,4,6052,2161,3891,0,0,0,1.0,1,1.0,1,1.0,1,0.20856152626849186,36
2865,6,6058,2165,3893,0,0,0,1.0,1,1.0,1,1.0,1,0.3130774919322928,34
2866,5,6063,2165,3898,0,0,0,1.0,1,1.0,1,1.0,1,0.1258458020192144,31
2867,1,6064,2165,3899,0,0,0,1.0,1,1.0,1,1.0,1,0.09051628078580773,30
2868,3,6067,2168,3899,0,0,0,1.0,1,1.0,1,1.0,1,0.11741321095008149,27
2869,1,6068,2169,3899,0,0,0,1.0,1,1.0,1,1.0,1,0.16310426499484598,27
2870,1,6069,2170,3899,0,0,0,1.0,1,1.0,1,1.0,1,0.1424355192020899,25
2871,2,6071,2172,3899,0,0,0,1.0,1,1.0,1,1.0,1,0.2711670624672804,25
2872,1,6072,2172,3900,0,0,0,1.0,1,1.0,1,1.0,1,0.18612409090262236,23
2873,2,6074,2174,3900,0,0,0,1.0,1,1.0,1,1.0,1,0.27325506705004804,24
2874,3,6077,2175,3902,0,0,0,1.0,1,1.0,1,1.0,1,0.27248549737263467,24
2875,1,6078,2175,3903,0,0,0,1.0,1,1.0,1,1.0,1,0.22301916195943,23
2876,4,6082,2176,3906,0,0,0,1.0,1,1.0,1,1.0,1,0.1718751760046517,24
2877,1,6083,2177,3906,0,0,0,1.0,1,1.0,1,1.0,1,0.2385256561497216,24
2878,2,6085,2178,3907,0,0,0,1.0,1,1.0,1,1.0,1,0.20850205706426478,24
2879,2,6087,2179,3908,0,0,0,1.0,1,1.0,1,1.0,1,0.20984762528753814,25
2880,0,6087,2179,3908,0,0,0,1.0,1,1.0,1,1.0,1,0.23251153797006227,26
2881,0,6087,2179,3908,0,0,0,1.0,1,1.0,1,1.0,1,0.23251153797006227,26
2882,0,6087,2179,3908,0,0,0,1.0,1,1.0,1,1.0,1,0.20863022954452062,27
2883,2,6089,2179,3910,0,0,0,1.0,1,1.0,1,1.0,1,0.17199388033972843,28
2884,2,6091,2180,3911,0,0,0,1.0,1,1.0,1,1.0,1,0.22986062709870156,29
2885,1,6092,2180,3912,0,0,0,1.0,1,1.0,1,1.0,1,0.21293078421381803,31
2886,3,6095,2181,3914,0,0,0,1.0,1,1.0,1,1.0,1,0.15437534348828455,31
2887,1,6096,2182,3914,0,0,0,1.0,1,1.0,1,1.0,1,0.151819339556493,33
2888,1,6097,2182,3915,0,0,0,1.0,1,1.0,1,1.0,1,0.17186474210114366,34
2889,1,6098,2182,3916,0,0,0,1.0,1,1.0,1,1.0,1,0.14664180782782021,35
2890,1,6099,2183,3916,0,0,0,1.0,1,1.0,1,1.0,1,0.1646241617877166,35
2891,1,6100,2184,3916,0,0,0,1.0,1,1.0,1,1.0,1,0.1922902418060468,35
2892,1,6101,2185,3916,0,0,0,1.0,1,1.0,1,1.0,1,0.20544287874671482,35
2893,1,6102,2185,3917,0,0,0,1.0,1,1.0,1,1.0,1,0.19239928897762784,37
2894,0,6102,2185,3917,0,0,0,1.0,1,1.0,1,1.0,1,0.19239928897762784,37
2895,0,6102,2185,3917,0,0,0,1.0,1,1.0,1,1.0,1,0.19239928897762784,37
2896,2,6104,2186,3918,0,0,0,1.0,1,1.0,1,1.0,1,0.22195295422038627,38
2897,0,6104,2186,3918,0,0,0,1.0,1,1.0,1,1.0,1,0.2566698857773653,37
2898,4,6108,2187,3921,0,0,0,1.0,1,1.0,1,1.0,1,0.2328862561679277,38
2899,1,6109,2188,3921,0,0,0,1.0,1,1.0,1,1.0,1,0.23654517079699394,37
2900,0,6109,2188,3921,0,0,0,1.0,1,1.0,1,1.0,1,0.2349870110650106,36
2901,0,6109,2188,3921,0,0,0,1.0,1,1.0,1,1.0,1,0.22149265418939026,37
2902,2,6111,2189,3922,0,0,0,1.0,1,1.0,1,1.0,1,0.21572644759135798,35
2903,0,6111,2189,3922,0,0,0,1.0,1,1.0,1,1.0,1,0.2075279908973508,35
2904,0,6111,2189,3922,0,0,0,1.0,1,1.0,1,1.0,1,0.21606693087933054,33
2905,1,6112,2189,3923,0,0,0,1.0,1,1.0,1,1.0,1,0.19229757519137672,34
2906,2,6114,2191,3923,0,0,0,1.0,1,1.0,1,1.0,1,0.23747929036168713,34
2907,1,6115,2191,3924,0,0,0,1.0,1,1.0,1,1.0,1,0.2166146433904775,35
2908,1,6116,2191,3925,0,0,0,1.0,1,1.0,1,1.0,1,0.22229458973329091,36
2909,3,6119,2191,3928,0,0,0,1.0,1,1.0,1,1.0,1,0.218530493537111,38
2910,0,6119,2191,3928,0,0,0,1.0,1,1.0,1,1.0,1,0.218530493537111,38
2911,2,6121,2192,3929,0,0,0,1.0,1,1.0,1,1.0,1,0.18125065420255632,37
2912,0,6121,2192,3929,0,0,0,1.0,1,1.0,1,1.0,1,0.18125065420255632,37
2913,0,6121,2192,3929,0,0,0,1.0,1,1.0,1,1.0,1,0.1967641061764205,38
2914,0,6121,2192,3929,0,0,0,1.0,1,1.0,1,1.0,1,0.1967641061764205,38
2915,1,6122,2193,3929,0,0,0,1.0,1,1.0,1,1.0,1,0.22474710574438858,39
2916,1,6123,2193,3930,0,0,0,1.0,1,1.0,1,1.0,1,0.2117579094655844,40
2917,3,6126,2195,3931,0,0,0,1.0,1,1.0,1,1.0,1,0.2151142973367109,41
2918,5,6131,2197,3934,0,0,0,1.0,1,1.0,1,1.0,1,0.21115877799248767,41
2919,1,6132,2197,3935,0,0,0,1.0,1,1.0,1,1.0,1,0.2021694740056775,41
2920,0,6132,2197,3935,0,0,0,1.0,1,1.0,1,1.0,1,0.22805699462194962,43
2921,1,6133,2197,3936,0,0,0,1.0,1,1.0,1,1.0,1,0.20959654266223685,42
2922,3,6136,2198,3938,0,0,0,1.0,1,1.0,1,1.0,1,0.1983967259119656,43
2923,2,6138,2198,3940,0,0,0,1.0,1,1.0,1,1.0,1,0.2032700675376634,44
2924,2,6140,2198,3942,0,0,0,1.0,1,1.0,1,1.0,1,0.19498476241927176,45
2925,5,6145,2198,3947,0,0,0,1.0,1,1.0,1,1.0,1,0.13338272264872456,45
2926,2,6147,2198,3949,0,0,0,1.0,1,1.0,1,1.0,1,0.09723041588734384,47
2927,3,6150,2199,3951,0,0,0,1.0,1,1.0,1,1.0,1,0.12187130079473926,47
2928,3,6153,2200,3953,0,0,0,1.0,1,1.0,1,1.0,1,0.11907474836331655,48
2929,0,6153,2200,3953,0,0,0,1.0,1,1.0,1,1.0,1,0.11907474836331655,48
2930,0,6153,2200,3953,0,0,0,1.0,1,1.0,1,1.0,1,0.1253733001307782,50
2931,2,6155,2200,3955,0,0,0,1.0,1,1.0,1,1.0,1,0.12202447156121972,51
2932,0,6155,2200,3955,0,0,0,1.0,1,1.0,1,1.0,1,0.12202447156121972,51
2933,1,6156,2201,3955,0,0,0,1.0,1,1.0,1,1.0,1,0.12656572246042613,52
2934,1,6157,2202,3955,0,0,0,1.0,1,1.0,1,1.0,1,0.12939741347468217,52
2935,0,6157,2202,3955,0,0,0,1.0,1,1.0,1,1.0,1,0.14670450491621417,51
2936,1,6158,2202,3956,0,0,0,1.0,1,1.0,1,1.0,1,0.12208374530612623,49
2937,0,6158,2202,3956,0,0,0,1.0,1,1.0,1,1.0,1,0.13090796686014386,50
2938,1,6159,2202,3957,0,0,0,1.0,1,1.0,1,1.0,1,0.1209603011413473,50
2939,0,6159,2202,3957,0,0,0,1.0,1,1.0,1,1.0,1,0.13052080338979505,51
2940,4,6163,2203,3960,0,0,0,1.0,1,1.0,1,1.0,1,0.12494808367613491,52
2941,3,6166,2203,3963,0,0,0,1.0,1,1.0,1,1.0,1,0.10680434039245924,53
2942,3,6169,2205,3964,0,0,0,1.0,1,1.0,1,1.0,1,0.14052594759056497,52
2943,2,6171,2207,3964,0,0,0,1.0,1,1.0,1,1.0,1,0.15381101500195288,51
2944,5,6176,2209,3967,0,0,0,1.0,1,1.0,1,1.0,1,0.13511552465959817,52
2945,1,6177,2210,3967,0,0,0,1.0,1,1.0,1,1.0,1,0.14920080767665464,50
2946,8,6185,2213,3972,0,0,0,1.0,1,1.0,1,1.0,1,0.14919051457610275,51
2947,4,6189,2215,3974,0,0,0,1.0,1,1.0,1,1.0,1,0.16849450511687314,50
2948,4,6193,2216,3977,0,0,0,1.0,1,1.0,1,1.0,1,0.1084089962981541,50
2949,2,6195,2216,3979,0,0,0,1.0,1,1.0,1,1.0,1,0.0975493564886905,49
2950,1,6196,2216,3980,0,0,0,1.0,1,1.0,1,1.0,1,0.0940548508913578,48
2951,0,6196,2216,3980,0,0,0,1.0,1,1.0,1,1.0,1,0.10076836130923336,48
2952,0,6196,2216,3980,0,0,0,1.0,1,1.0,1,1.0,1,0.13174620261203004,46
2953,0,6196,2216,3980,0,0,0,1.0,1,1.0,1,1.0,1,0.13174620261203004,46
2954,3,6199,2217,3982,0,0,0,1.0,1,1.0,1,1.0,1,0.13144551600662457,48
2955,1,6200,2217,3983,0,0,0,1.0,1,1.0,1,1.0,1,0.10473044816119392,48
2956,1,6201,2217,3984,0,0,0,1.0,1,1.0,1,1.0,1,0.10139514289380908,47
2957,2,6203,2219,3984,0,0,0,1.0,1,1.0,1,1.0,1,0.13789557628612664,48
2958,1,6204,2219,3985,0,0,0,1.0,1,1.0,1,1.0,1,0.1414447449969287,49
2959,2,6206,2221,3985,0,0,0,1.0,1,1.0,1,1.0,1,0.17487732395933592,49
2960,2,6208,2221,3987,0,0,0,1.0,1,1.0,1,1.0,1,0.17344803155080546,49
2961,13,6221,2224,3997,0,0,0,1.0,1,1.0,1,1.0,1,0.11605637368983851,51
2962,2,6223,2224,3999,0,0,0,1.0,1,1.0,1,1.0,1,0.10528985606432478,51
2963,1,6224,2224,4000,0,0,0,1.0,1,1.0,1,1.0,1,0.08895418966587267,51
2964,1,6225,2224,4001,0,0,0,1.0,1,1.0,1,1.0,1,0.07595500921644664,52
2965,5,6230,2224,4006,0,0,0,1.0,1,1.0,1,1.0,1,0.12063894279423881,53
2966,2,6232,2224,4008,0,0,0,1.0,1,1.0,1,1.0,1,0.08231206866993314,53
2967,0,6232,2224,4008,0,0,0,1.0,1,1.0,1,1.0,1,0.08436943390518717,53
2968,0,6232,2224,4008,0,0,0,1.0,1,1.0,1,1.0,1,0.07904467152608893,54
2969,0,6232,2224,4008,0,0,0,1.0,1,1.0,1,1.0,1,0.0689881711006123,55
2970,0,6232,2224,4008,0,0,0,1.0,1,1.0,1,1.0,1,0.0689881711006123,55
2971,0,6232,2224,4008,0,0,0,1.0,1,1.0,1,1.0,1,0.0689881711006123,55
2972,0,6232,2224,4008,0,0,0,1.0,1,1.0,1,1.0,1,0.0689881711006123,55
2973,1,6233,2225,4008,0,0,0,1.0,1,1.0,1,1.0,1,0.1113194001623593,55
2974,1,6234,2225,4009,0,0,0,1.0,1,1.0,1,1.0,1,0.09483856873156693,56
2975,0,6234,2225,4009,0,0,0,1.0,1,1.0,1,1.0,1,0.10173790601874826,55
2976,1,6235,2225,4010,0,0,0,1.0,1,1.0,1,1.0,1,0.09742290038525957,57
2977,2,6237,2225,4012,0,0,0,1.0,1,1.0,1,1.0,1,0.09581862846349522,59
2978,5,6242,2228,4014,0,0,0,1.0,1,1.0,1,1.0,1,0.11856125728364435,59
2979,4,6246,2229,4017,0,0,0,1.0,1,1.0,1,1.0,1,0.12899384477083292,59
2980,2,6248,2230,4018,0,0,0,1.0,1,1.0,1,1.0,1,0.1118161510426748,59
2981,2,6250,2231,4019,0,0,0,1.0,1,1.0,1,1.0,1,0.11150285555976364,59
2982,2,6252,2231,4021,0,0,0,1.0,1,1.0,1,1.0,1,0.10328103256741603,61
2983,7,6259,2235,4024,0,0,0,1.0,1,1.0,1,1.0,1,0.13757549750794765,61
2984,8,6267,2239,4028,0,0,0,1.0,1,1.0,1,1.0,1,0.12780322377921982,61
2985,2,6269,2240,4029,0,0,0,1.0,1,1.0,1,1.0,1,0.1015251636205304,57
2986,10,6279,2243,4036,0,0,0,1.0,1,1.0,1,1.0,1,0.12420488971678359,58
2987,6,6285,2245,4040,0,0,0,1.0,1,1.0,1,1.0,1,0.12549249858893732,56
2988,1,6286,2246,4040,0,0,0,1.0,1,1.0,1,1.0,1,0.10672859099836053,55
2989,6,6292,2250,4042,0,0,0,1.0,1,1.0,1,1.0,1,0.14767686733377403,53
2990,1,6293,2250,4043,0,0,0,1.0,1,1.0,1,1.0,1,0.16471011186542373,52
2991,5,6298,2251,4047,0,0,0,1.0,1,1.0,1,1.0,1,0.1009168028129093,54
2992,2,6300,2252,4048,0,0,0,1.0,1,1.0,1,1.0,1,0.11561248959266986,55
2993,1,6301,2252,4049,0,0,0,1.0,1,1.0,1,1.0,1,0.14881187460853784,53
2994,3,6304,2253,4051,0,0,0,1.0,1,1.0,1,1.0,1,0.13079451476049797,53
2995,3,6307,2253,4054,0,0,0,1.0,1,1.0,1,1.0,1,0.08614757781171134,51
2996,1,6308,2253,4055,0,0,0,1.0,1,1.0,1,1.0,1,0.0878070533214676,52
2997,2,6310,2255,4055,0,0,0,1.0,1,1.0,1,1.0,1,0.13353698709683312,50
2998,2,6312,2256,4056,0,0,0,1.0,1,1.0,1,1.0,1,0.10183244524817946,51
2999,0,6312,2256,4056,0,0,0,1.0,1,1.0,1,1.0,1,0.10215124978883194,48
3000,0,6312,2256,4056,0,0,0,1.0,1,1.0,1,1.0,1,0.10215124978883194,48
3001,1,6313,2256,4057,0,0,0,1.0,1,1.0,1,1.0,1,0.07458002074665152,49
3002,0,6313,2256,4057,0,0,0,1.0,1,1.0,1,1.0,1,0.0925818433663368,50
3003,1,6314,2256,4058,0,0,0,1.0,1,1.0,1,1.0,1,0.08986681364702892,50
3004,1,6315,2257,4058,0,0,0,1.0,1,1.0,1,1.0,1,0.08420982736939563,51
3005,1,6316,2257,4059,0,0,0,1.0,1,1.0,1,1.0,1,0.09567905499157268,50
3006,2,6318,2257,4061,0,0,0,1.0,1,1.0,1,1.0,1,0.0794709022360916,51
3007,0,6318,2257,4061,0,0,0,1.0,1,1.0,1,1.0,1,0.09815036423972819,51
3008,3,6321,2258,4063,0,0,0,1.0,1,1.0,1,1.0,1,0.12546083686567228,53
3009,0,6321,2258,4063,0,0,0,1.0,1,1.0,1,1.0,1,0.12213124632403705,52
3010,0,6321,2258,4063,0,0,0,1.0,1,1.0,1,1.0,1,0.12213124632403705,52
3011,2,6323,2258,4065,0,0,0,1.0,1,1.0,1,1.0,1,0.09422602488382084,51
3012,4,6327,2261,4066,0,0,0,1.0,1,1.0,1,1.0,1,0.10814553657183684,54
3013,3,6330,2262,4068,0,0,0,1.0,1,1.0,1,1.0,1,0.12743577918481724,52
3014,3,6333,2264,4069,0,0,0,1.0,1,1.0,1,1.0,1,0.14027872996065135,51
3015,1,6334,2265,4069,0,0,0,1.0,1,1.0,1,1.0,1,0.1399776741506682,50
3016,9,6343,2268,4075,0,0,0,1.0,1,1.0,1,1.0,1,0.12015208917879579,50
3017,10,6353,2273,4080,0,0,0,1.0,1,1.0,1,1.0,1,0.13610070943345648,48
3018,2,6355,2275,4080,0,0,0,1.0,1,1.0,1,1.0,1,0.12671238133555562,48
3019,2,6357,2276,4081,0,0,0,1.0,1,1.0,1,1.0,1,0.1442779032594605,47
3020,1,6358,2277,4081,0,0,0,1.0,1,1.0,1,1.0,1,0.16622422762132275,47
3021,7,6365,2280,4085,0,0,0,1.0,1,1.0,1,1.0,1,0.1136562193247294,46
3022,3,6368,2282,4086,0,0,0,1.0,1,1.0,1,1.0,1,0.1880089446219469,45
3023,4,6372,2284,4088,0,0,0,1.0,1,1.0,1,1.0,1,0.07867753790288944,41
3024,5,6377,2287,4090,0,0,0,1.0,1,1.0,1,1.0,1,0.17378371685172367,43
3025,6,6383,2289,4094,0,0,0,1.0,1,1.0,1,1.0,1,0.16236718209967899,39
3026,4,6387,2290,4097,0,0,0,1.0,1,1.0,1,1.0,1,0.17216646599078564,38
3027,2,6389,2291,4098,0,0,0,1.0,1,1.0,1,1.0,1,0.19422923669206446,38
3028,1,6390,2292,4098,0,0,0,1.0,1,1.0,1,1.0,1,0.2315766773890331,38
3029,2,6392,2293,4099,0,0,0,1.0,1,1.0,1,1.0,1,0.20065357556576238,37
3030,2,6394,2293,4101,0,0,0,1.0,1,1.0,1,1.0,1,0.16083590241266166,38
3031,5,6399,2294,4105,0,0,0,1.0,1,1.0,1,1.0,1,0.08574167578790229,39
3032,4,6403,2296,4107,0,0,0,1.0,1,1.0,1,1.0,1,0.0964204146165964,39
3033,0,6403,2296,4107,0,0,0,1.0,1,1.0,1,1.0,1,0.10169883291799219,39
3034,0,6403,2296,4107,0,0,0,1.0,1,1.0,1,1.0,1,0.1170939182508053,38
3035,0,6403,2296,4107,0,0,0,1.0,1,1.0,1,1.0,1,0.11061755349718717,39
3036,3,6406,2296,4110,0,0,0,1.0,1,1.0,1,1.0,1,0.06053111843244181,39
3037,1,6407,2296,4111,0,0,0,1.0,1,1.0,1,1.0,1,0.06579681502814906,39
3038,1,6408,2297,4111,0,0,0,1.0,1,1.0,1,1.0,1,0.06280567294837466,40
3039,0,6408,2297,4111,0,0,0,1.0,1,1.0,1,1.0,1,0.07856221233464716,41
3040,2,6410,2299,4111,0,0,0,1.0,1,1.0,1,1.0,1,0.10495028622256274,42
3041,2,6412,2300,4112,0,0,0,1.0,1,1.0,1,1.0,1,0.12843037351209924,43
3042,5,6417,2302,4115,0,0,0,1.0,1,1.0,1,1.0,1,0.12921357041788142,45
3043,5,6422,2304,4118,0,0,0,1.0,1,1.0,1,1.0,1,0.11651962537896844,45
3044,0,6422,2304,4118,0,0,0,1.0,1,1.0,1,1.0,1,0.11651962537896844,45
3045,0,6422,2304,4118,0,0,0,1.0,1,1.0,1,1.0,1,0.11651962537896844,45
3046,2,6424,2304,4120,0,0,0,1.0,1,1.0,1,1.0,1,0.08442538982310316,46
3047,2,6426,2306,4120,0,0,0,1.0,1,1.0,1,1.0,1,0.13815043789317827,46
3048,3,6429,2306,4123,0,0,0,1.0,1,1.0,1,1.0,1,0.11898864285672484,49
3049,2,6431,2306,4125,0,0,0,1.0,1,1.0,1,1.0,1,0.12184382311545439,50
3050,3,6434,2306,4128,0,0,0,1.0,1,1.0,1,1.0,1,0.12314310190531891,50
3051,1,6435,2306,4129,0,0,0,1.0,1,1.0,1,1.0,1,0.12431001939364068,50
3052,0,6435,2306,4129,0,0,0,1.0,1,1.0,1,1.0,1,0.12431001939364068,50
3053,2,6437,2308,4129,0,0,0,1.0,1,1.0,1,1.0,1,0.10046747876570691,49
3054,1,6438,2309,4129,0,0,0,1.0,1,1.0,1,1.0,1,0.1426472632511423,47
3055,2,6440,2310,4130,0,0,0,1.0,1,1.0,1,1.0,1,0.13146502796091958,48
3056,3,6443,2310,4133,0,0,0,1.0,1,1.0,1,1.0,1,0.1676404418340868,47
3057,6,6449,2311,4138,0,0,0,1.0,1,1.0,1,1.0,1,0.1503921734738936,48
3058,3,6452,2312,4140,0,0,0,1.0,1,1.0,1,1.0,1,0.17314549858789788,46
3059,0,6452,2312,4140,0,0,0,1.0,1,1.0,1,1.0,1,0.19926770777767686,44
3060,0,6452,2312,4140,0,0,0,1.0,1,1.0,1,1.0,1,0.19760025984326027,44
3061,4,6456,2312,4144,0,0,0,1.0,1,1.0,1,1.0,1,0.20365807793113108,42
3062,2,6458,2312,4146,0,0,0,1.0,1,1.0,1,1.0,1,0.17048890219250967,42
3063,3,6461,2313,4148,0,0,0,1.0,1,1.0,1,1.0,1,0.180390079309296,41
3064,5,6466,2316,4150,0,0,0,1.0,1,1.0,1,1.0,1,0.10805542771691887,42
3065,3,6469,2317,4152,0,0,0,1.0,1,1.0,1,1.0,1,0.097341679195835,40
3066,4,6473,2320,4153,0,0,0,1.0,1,1.0,1,1.0,1,0.11404311856947637,42
3067,5,6478,2325,4153,0,0,0,1.0,1,1.0,1,1.0,1,0.19251199682849235,40
3068,3,6481,2326,4155,0,0,0,1.0,1,1.0,1,1.0,1,0.20496584257086223,39
3069,0,6481,2326,4155,0,0,0,1.0,1,1.0,1,1.0,1,0.18554691634595538,38
3070,2,6483,2326,4157,0,0,0,1.0,1,1.0,1,1.0,1,0.199783272939587,39
3071,4,6487,2326,4161,0,0,0,1.0,1,1.0,1,1.0,1,0.1014582797513114,39
3072,3,6490,2327,4163,0,0,0,1.0,1,1.0,1,1.0,1,0.13117329166531255,40
3073,1,6491,2328,4163,0,0,0,1.0,1,1.0,1,1.0,1,0.20359322353712866,38
3074,0,6491,2328,4163,0,0,0,1.0,1,1.0,1,1.0,1,0.20025750512993465,38
3075,3,6494,2329,4165,0,0,0,1.0,1,1.0,1,1.0,1,0.18727934438364757,41
3076,3,6497,2329,4168,0,0,0,1.0,1,1.0,1,1.0,1,0.09430046847729716,42
3077,2,6499,2331,4168,0,0,0,1.0,1,1.0,1,1.0,1,0.15290526261048099,42
3078,1,6500,2331,4169,0,0,0,1.0,1,1.0,1,1.0,1,0.12759379470131982,42
3079,0,6500,2331,4169,0,0,0,1.0,1,1.0,1,1.0,1,0.12759379470131982,42
3080,2,6502,2332,4170,0,0,0,1.0,1,1.0,1,1.0,1,0.1486771021030954,43
3081,1,6503,2332,4171,0,0,0,1.0,1,1.0,1,1.0,1,0.14873797337239347,44
3082,1,6504,2333,4171,0,0,0,1.0,1,1.0,1,1.0,1,0.16795046081216375,45
3083,3,6507,2334,4173,0,0,0,1.0,1,1.0,1,1.0,1,0.17543582925293122,45
3084,1,6508,2335,4173,0,0,0,1.0,1,1.0,1,1.0,1,0.1781728962389668,45
3085,2,6510,2335,4175,0,0,0,1.0,1,1.0,1,1.0,1,0.16276454367412446,46
3086,0,6510,2335,4175,0,0,0,1.0,1,1.0,1,1.0,1,0.16276454367412446,46
3087,0,6510,2335,4175,0,0,0,1.0,1,1.0,1,1.0,1,0.16024204638116155,47
3088,3,6513,2336,4177,0,0,0,1.0,1,1.0,1,1.0,1,0.17036174777099966,48
3089,1,6514,2337,4177,0,0,0,1.0,1,1.0,1,1.0,1,0.1655782866546557,46
3090,0,6514,2337,4177,0,0,0,1.0,1,1.0,1,1.0,1,0.16824403660672543,46
3091,2,6516,2337,4179,0,0,0,1.0,1,1.0,1,1.0,1,0.16256075972705242,46
3092,2,6518,2339,4179,0,0,0,1.0,1,1.0,1,1.0,1,0.1840446432007923,47
3093,4,6522,2340,4182,0,0,0,1.0,1,1.0,1,1.0,1,0.14527575194117218,47
3094,2,6524,2340,4184,0,0,0,1.0,1,1.0,1,1.0,1,0.13970190086071962,45
3095,2,6526,2341,4185,0,0,0,1.0,1,1.0,1,1.0,1,0.1219162164144686,46
3096,2,6528,2341,4187,0,0,0,1.0,1,1.0,1,1.0,1,0.0961125139073315,46
3097,2,6530,2343,4187,0,0,0,1.0,1,1.0,1,1.0,1,0.1531798479401275,47
3098,2,6532,2343,4189,0,0,0,1.0,1,1.0,1,1.0,1,0.11582790463181859,47
3099,0,6532,2343,4189,0,0,0,1.0,1,1.0,1,1.0,1,0.11582790463181859,47
3100,0,6532,2343,4189,0,0,0,1.0,1,1.0,1,1.0,1,0.11582790463181859,47
3101,3,6535,2343,4192,0,0,0,1.0,1,1.0,1,1.0,1,0.0627083916971866,48
3102,1,6536,2344,4192,0,0,0,1.0,1,1.0,1,1.0,1,0.0792570708309365,48
3103,2,6538,2345,4193,0,0,0,1.0,1,1.0,1,1.0,1,0.11547755165765937,49
3104,3,6541,2347,4194,0,0,0,1.0,1,1.0,1,1.0,1,0.17461617755805142,48
3105,3,6544,2348,4196,0,0,0,1.0,1,1.0,1,1.0,1,0.14427182545963413,45
3106,7,6551,2349,4202,0,0,0,1.0,1,1.0,1,1.0,1,0.16159903072401013,46
3107,2,6553,2349,4204,0,0,0,1.0,1,1.0,1,1.0,1,0.18459995847598598,44
3108,1,6554,2349,4205,0,0,0,1.0,1,1.0,1,1.0,1,0.15498489314713215,45
3109,1,6555,2349,4206,0,0,0,1.0,1,1.0,1,1.0,1,0.18790419434113134,44
3110,6,6561,2352,4209,0,0,0,1.0,1,1.0,1,1.0,1,0.17165631912974302,46
3111,4,6565,2353,4212,0,0,0,1.0,1,1.0,1,1.0,1,0.12552173354713886,46
3112,1,6566,2353,4213,0,0,0,1.0,1,1.0,1,1.0,1,0.13491998125893587,47
3113,2,6568,2354,4214,0,0,0,1.0,1,1.0,1,1.0,1,0.11016137702620535,48
3114,0,6568,2354,4214,0,0,0,1.0,1,1.0,1,1.0,1,0.12393594592917154,48
3115,2,6570,2354,4216,0,0,0,1.0,1,1.0,1,1.0,1,0.11584718990720475,49
3116,2,6572,2354,4218,0,0,0,1.0,1,1.0,1,1.0,1,0.12686616525789077,48
3117,1,6573,2355,4218,0,0,0,1.0,1,1.0,1,1.0,1,0.1609554138227262,49
3118,0,6573,2355,4218,0,0,0,1.0,1,1.0,1,1.0,1,0.17381757820882957,50
3119,2,6575,2355,4220,0,0,0,1.0,1,1.0,1,1.0,1,0.15876547823774723,50
3120,2,6577,2355,4222,0,0,0,1.0,1,1.0,1,1.0,1,0.15968495991388976,50
3121,2,6579,2355,4224,0,0,0,1.0,1,1.0,1,1.0,1,0.15108900019461566,50
3122,0,6579,2355,4224,0,0,0,1.0,1,1.0,1,1.0,1,0.15108900019461566,50
3123,1,6580,2356,4224,0,0,0,1.0,1,1.0,1,1.0,1,0.13699018059667398,51
3124,1,6581,2357,4224,0,0,0,1.0,1,1.0,1,1.0,1,0.14910946956186844,51
3125,1,6582,2358,4224,0,0,0,1.0,1,1.0,1,1.0,1,0.15330339765579992,51
3126,6,6588,2359,4229,0,0,0,1.0,1,1.0,1,1.0,1,0.08692826920949083,54
3127,1,6589,2359,4230,0,0,0,1.0,1,1.0,1,1.0,1,0.08490371497059146,53
3128,2,6591,2360,4231,0,0,0,1.0,1,1.0,1,1.0,1,0.08655009680328457,52
3129,1,6592,2361,4231,0,0,0,1.0,1,1.0,1,1.0,1,0.08356091919630565,51
3130,1,6593,2362,4231,0,0,0,1.0,1,1.0,1,1.0,1,0.1281112144549567,50
3131,5,6598,2364,4234,0,0,0,1.0,1,1.0,1,1.0,1,0.11105944554016356,50
3132,2,6600,2366,4234,0,0,0,1.0,1,1.0,1,1.0,1,0.15388398024536742,49
3133,2,6602,2366,4236,0,0,0,1.0,1,1.0,1,1.0,1,0.10633225508114236,49
3134,1,6603,2366,4237,0,0,0,1.0,1,1.0,1,1.0,1,0.11347529823588655,46
3135,1,6604,2367,4237,0,0,0,1.0,1,1.0,1,1.0,1,0.142419294557491,47
3136,4,6608,2368,4240,0,0,0,1.0,1,1.0,1,1.0,1,0.07358176255905632,46
3137,1,6609,2369,4240,0,0,0,1.0,1,1.0,1,1.0,1,0.10545048075392485,49
3138,0,6609,2369,4240,0,0,0,1.0,1,1.0,1,1.0,1,0.10545048075392485,49
3139,3,6612,2371,4241,0,0,0,1.0,1,1.0,1,1.0,1,0.15822898732759735,50
3140,1,6613,2371,4242,0,0,0,1.0,1,1.0,1,1.0,1,0.15975681367941025,51
3141,3,6616,2372,4244,0,0,0,1.0,1,1.0,1,1.0,1,0.14397544092286613,50
3142,0,6616,2372,4244,0,0,0,1.0,1,1.0,1,1.0,1,0.14397544092286613,50
3143,2,6618,2373,4245,0,0,0,1.0,1,1.0,1,1.0,1,0.16255816604379408,49
3144,2,6620,2374,4246,0,0,0,1.0,1,1.0,1,1.0,1,0.18103795759820246,49
3145,2,6622,2375,4247,0,0,0,1.0,1,1.0,1,1.0,1,0.24237030366369233,48
3146,10,6632,2377,4255,0,0,0,1.0,1,1.0,1,1.0,1,0.15396855696427778,49
3147,3,6635,2377,4258,0,0,0,1.0,1,1.0,1,1.0,1,0.10681232993937764,48
3148,2,6637,2378,4259,0,0,0,1.0,1,1.0,1,1.0,1,0.0720086796602752,48
3149,0,6637,2378,4259,0,0,0,1.0,1,1.0,1,1.0,1,0.0627348516036809,47
3150,0,6637,2378,4259,0,0,0,1.0,1,1.0,1,1.0,1,0.0627348516036809,47
3151,1,6638,2379,4259,0,0,0,1.0,1,1.0,1,1.0,1,0.0755438445790293,48
3152,0,6638,2379,4259,0,0,0,1.0,1,1.0,1,1.0,1,0.07346194151633974,47
3153,1,6639,2380,4259,0,0,0,1.0,1,1.0,1,1.0,1,0.09325052706607073,47
3154,2,6641,2381,4260,0,0,0,1.0,1,1.0,1,1.0,1,0.0900982072465506,48
3155,0,6641,2381,4260,0,0,0,1.0,1,1.0,1,1.0,1,0.08737379686889911,48
3156,3,6644,2382,4262,0,0,0,1.0,1,1.0,1,1.0,1,0.0681387430425243,48
3157,0,6644,2382,4262,0,0,0,1.0,1,1.0,1,1.0,1,0.0996644911491756,48
3158,2,6646,2383,4263,0,0,0,1.0,1,1.0,1,1.0,1,0.10713491105639807,48
3159,1,6647,2383,4264,0,0,0,1.0,1,1.0,1,1.0,1,0.12088130686216964,49
3160,2,6649,2384,4265,0,0,0,1.0,1,1.0,1,1.0,1,0.13818078659885727,51
3161,1,6650,2384,4266,0,0,0,1.0,1,1.0,1,1.0,1,0.10195666141811524,52
3162,1,6651,2385,4266,0,0,0,1.0,1,1.0,1,1.0,1,0.10121880450817085,51
3163,4,6655,2386,4269,0,0,0,1.0,1,1.0,1,1.0,1,0.0855856328680476,51
3164,2,6657,2387,4270,0,0,0,1.0,1,1.0,1,1.0,1,0.08797585340862842,52
3165,2,6659,2389,4270,0,0,0,1.0,1,1.0,1,1.0,1,0.09248868376622255,50
3166,5,6664,2392,4272,0,0,0,1.0,1,1.0,1,1.0,1,0.104391851962352,50
3167,1,6665,2393,4272,0,0,0,1.0,1,1.0,1,1.0,1,0.0779030913895136,49
3168,1,6666,2394,4272,0,0,0,1.0,1,1.0,1,1.0,1,0.08183785551849376,47
3169,0,6666,2394,4272,0,0,0,1.0,1,1.0,1,1.0,1,0.09084163475788316,48
3170,1,6667,2395,4272,0,0,0,1.0,1,1.0,1,1.0,1,0.1343962157322619,47
3171,6,6673,2397,4276,0,0,0,1.0,1,1.0,1,1.0,1,0.14270876843088612,47
3172,2,6675,2398,4277,0,0,0,1.0,1,1.0,1,1.0,1,0.1661573137304214,46
3173,1,6676,2399,4277,0,0,0,1.0,1,1.0,1,1.0,1,0.14183160114238283,45
3174,4,6680,2400,4280,0,0,0,1.0,1,1.0,1,1.0,1,0.18252386387571617,43
3175,3,6683,2401,4282,0,0,0,1.0,1,1.0,1,1.0,1,0.19602950370887984,43
3176,7,6690,2401,4289,0,0,0,1.0,1,1.0,1,1.0,1,0.10941393417047181,44
3177,4,6694,2402,4292,0,0,0,1.0,1,1.0,1,1.0,1,0.12279046365650399,44
3178,1,6695,2402,4293,0,0,0,1.0,1,1.0,1,1.0,1,0.10366399827566128,47
3179,7,6702,2404,4298,0,0,0,1.0,1,1.0,1,1.0,1,0.14525946254830954,48
3180,3,6705,2404,4301,0,0,0,1.0,1,1.0,1,1.0,1,0.11704301914542317,48
3181,1,6706,2404,4302,0,0,0,1.0,1,1.0,1,1.0,1,0.10639220764425031,48
3182,2,6708,2405,4303,0,0,0,1.0,1,1.0,1,1.0,1,0.11612686887999271,51
3183,3,6711,2407,4304,0,0,0,1.0,1,1.0,1,1.0,1,0.12477746415679535,50
3184,3,6714,2409,4305,0,0,0,1.0,1,1.0,1,1.0,1,0.18825895161122355,50
3185,5,6719,2409,4310,0,0,0,1.0,1,1.0,1,1.0,1,0.21054608905509128,48
3186,8,6727,2409,4318,0,0,0,1.0,1,1.0,1,1.0,1,0.1490904088379762,48
3187,6,6733,2409,4324,0,0,0,1.0,1,1.0,1,1.0,1,0.14910408910534242,48
3188,4,6737,2410,4327,0,0,0,1.0,1,1.0,1,1.0,1,0.13392578132647504,48
3189,5,6742,2410,4332,0,0,0,1.0,1,1.0,1,1.0,1,0.13444672308564573,49
3190,10,6752,2410,4342,0,0,0,1.0,1,1.0,1,1.0,1,0.17688153361046619,51
3191,4,6756,2410,4346,0,0,0,1.0,1,1.0,1,1.0,1,0.11793705607800473,52
3192,0,6756,2410,4346,0,0,0,1.0,1,1.0,1,1.0,1,0.11793705607800473,52
3193,1,6757,2410,4347,0,0,0,1.0,1,1.0,1,1.0,1,0.11649490409768967,52
3194,6,6763,2411,4352,0,0,0,1.0,1,1.0,1,1.0,1,0.12591318990206163,54
3195,0,6763,2411,4352,0,0,0,1.0,1,1.0,1,1.0,1,0.12591318990206163,54
3196,4,6767,2412,4355,0,0,0,1.0,1,1.0,1,1.0,1,0.10094187727033327,54
3197,1,6768,2412,4356,0,0,0,1.0,1,1.0,1,1.0,1,0.11634262798601568,54
3198,3,6771,2412,4359,0,0,0,1.0,1,1.0,1,1.0,1,0.08103508307342579,54
3199,0,6771,2412,4359,0,0,0,1.0,1,1.0,1,1.0,1,0.07268318200066667,56
3200,4,6775,2413,4362,0,0,0,1.0,1,1.0,1,1.0,1,0.09274989316446897,56
3201,2,6777,2413,4364,0,0,0,1.0,1,1.0,1,1.0,1,0.07890190586710538,56
3202,0,6777,2413,4364,0,0,0,1.0,1,1.0,1,1.0,1,0.08622321026452745,57
3203,2,6779,2413,4366,0,0,0,1.0,1,1.0,1,1.0,1,0.056075779271781735,56
3204,3,6782,2416,4366,0,0,0,1.0,1,1.0,1,1.0,1,0.12694599736870704,55
3205,0,6782,2416,4366,0,0,0,1.0,1,1.0,1,1.0,1,0.1233230147889632,54
3206,5,6787,2419,4368,0,0,0,1.0,1,1.0,1,1.0,1,0.18081527205603903,56
3207,4,6791,2420,4371,0,0,0,1.0,1,1.0,1,1.0,1,0.15570540934290694,54
3208,2,6793,2421,4372,0,0,0,1.0,1,1.0,1,1.0,1,0.1535107499486606,53
3209,1,6794,2421,4373,0,0,0,1.0,1,1.0,1,1.0,1,0.13722944155500136,54
3210,0,6794,2421,4373,0,0,0,1.0,1,1.0,1,1.0,1,0.15572341706322596,53
3211,3,6797,2422,4375,0,0,0,1.0,1,1.0,1,1.0,1,0.16169890700922573,53
3212,0,6797,2422,4375,0,0,0,1.0,1,1.0,1,1.0,1,0.17170662777438622,54
3213,0,6797,2422,4375,0,0,0,1.0,1,1.0,1,1.0,1,0.1697615330822473,54
3214,2,6799,2422,4377,0,0,0,1.0,1,1.0,1,1.0,1,0.1675325856905752,55
3215,1,6800,2423,4377,0,0,0,1.0,1,1.0,1,1.0,1,0.17476860989283483,55
3216,2,6802,2423,4379,0,0,0,1.0,1,1.0,1,1.0,1,0.15694487396242623,55
3217,5,6807,2426,4381,0,0,0,1.0,1,1.0,1,1.0,1,0.21019532972125907,54
3218,1,6808,2426,4382,0,0,0,1.0,1,1.0,1,1.0,1,0.20405703340844544,54
3219,2,6810,2426,4384,0,0,0,1.0,1,1.0,1,1.0,1,0.19737521018997722,55
3220,2,6812,2426,4386,0,0,0,1.0,1,1.0,1,1.0,1,0.17289982192557948,56
3221,4,6816,2427,4389,0,0,0,1.0,1,1.0,1,1.0,1,0.14882049530643088,57
3222,2,6818,2429,4389,0,0,0,1.0,1,1.0,1,1.0,1,0.15100666591964323,57
3223,1,6819,2429,4390,0,0,0,1.0,1,1.0,1,1.0,1,0.15515568531065724,56
3224,3,6822,2431,4391,0,0,0,1.0,1,1.0,1,1.0,1,0.1672356480775901,58
3225,6,6828,2432,4396,0,0,0,1.0,1,1.0,1,1.0,1,0.1172673295241547,55
3226,3,6831,2433,4398,0,0,0,1.0,1,1.0,1,1.0,1,0.11894331708847838,54
3227,2,6833,2435,4398,0,0,0,1.0,1,1.0,1,1.0,1,0.12641664701852937,53
3228,4,6837,2438,4399,0,0,0,1.0,1,1.0,1,1.0,1,0.19066620009353738,52
3229,6,6843,2442,4401,0,0,0,1.0,1,1.0,1,1.0,1,0.17642084596901325,52
3230,3,6846,2444,4402,0,0,0,1.0,1,1.0,1,1.0,1,0.18878324865681786,50
3231,7,6853,2447,4406,0,0,0,1.0,1,1.0,1,1.0,1,0.16209266162541475,50
3232,1,6854,2448,4406,0,0,0,1.0,1,1.0,1,1.0,1,0.17785897895208064,50
3233,2,6856,2449,4407,0,0,0,1.0,1,1.0,1,1.0,1,0.1691238135447497,50
3234,2,6858,2451,4407,0,0,0,1.0,1,1.0,1,1.0,1,0.20618959227180875,49
3235,2,6860,2452,4408,0,0,0,1.0,1,1.0,1,1.0,1,0.20517271676424295,49
3236,3,6863,2452,4411,0,0,0,1.0,1,1.0,1,1.0,1,0.1781403507891594,51
3237,3,6866,2454,4412,0,0,0,1.0,1,1.0,1,1.0,1,0.20882728504832168,53
3238,1,6867,2454,4413,0,0,0,1.0,1,1.0,1,1.0,1,0.20161076684840948,53
3239,0,6867,2454,4413,0,0,0,1.0,1,1.0,1,1.0,1,0.20161076684840948,53
3240,0,6867,2454,4413,0,0,0,1.0,1,1.0,1,1.0,1,0.2077797890162497,53
3241,4,6871,2454,4417,0,0,0,1.0,1,1.0,1,1.0,1,0.18326171329387744,53
3242,1,6872,2454,4418,0,0,0,1.0,1,1.0,1,1.0,1,0.17762066983219146,53
3243,1,6873,2454,4419,0,0,0,1.0,1,1.0,1,1.0,1,0.1572910708018174,56
3244,3,6876,2454,4422,0,0,0,1.0,1,1.0,1,1.0,1,0.16188927215098356,57
3245,3,6879,2454,4425,0,0,0,1.0,1,1.0,1,1.0,1,0.15395823807489936,59
3246,3,6882,2454,4428,0,0,0,1.0,1,1.0,1,1.0,1,0.13536098010696448,59
3247,2,6884,2455,4429,0,0,0,1.0,1,1.0,1,1.0,1,0.14254154647721012,59
3248,1,6885,2456,4429,0,0,0,1.0,1,1.0,1,1.0,1,0.14200418848630875,59
3249,0,6885,2456,4429,0,0,0,1.0,1,1.0,1,1.0,1,0.16508565514198537,58
3250,0,6885,2456,4429,0,0,0,1.0,1,1.0,1,1.0,1,0.16508565514198537,58
3251,5,6890,2457,4433,0,0,0,1.0,1,1.0,1,1.0,1,0.1393351862933345,57
3252,0,6890,2457,4433,0,0,0,1.0,1,1.0,1,1.0,1,0.15688893972928397,57
3253,0,6890,2457,4433,0,0,0,1.0,1,1.0,1,1.0,1,0.17283846511869705,56
3254,2,6892,2458,4434,0,0,0,1.0,1,1.0,1,1.0,1,0.1626451400041996,57
3255,1,6893,2458,4435,0,0,0,1.0,1,1.0,1,1.0,1,0.16406032742751347,57
3256,3,6896,2458,4438,0,0,0,1.0,1,1.0,1,1.0,1,0.1272572097092657,57
3257,1,6897,2458,4439,0,0,0,1.0,1,1.0,1,1.0,1,0.11569752913400312,57
3258,1,6898,2458,4440,0,0,0,1.0,1,1.0,1,1.0,1,0.12195760238438066,58
3259,1,6899,2459,4440,0,0,0,1.0,1,1.0,1,1.0,1,0.13899972759763524,59
3260,8,6907,2459,4448,0,0,0,1.0,1,1.0,1,1.0,1,0.0941078066958168,60
3261,5,6912,2462,4450,0,0,0,1.0,1,1.0,1,1.0,1,0.13285056301094625,60
3262,4,6916,2465,4451,0,0,0,1.0,1,1.0,1,1.0,1,0.13735575005102005,61
3263,5,6921,2468,4453,0,0,0,1.0,1,1.0,1,1.0,1,0.14607753562929765,62
3264,7,6928,2473,4455,0,0,0,1.0,1,1.0,1,1.0,1,0.1732350677704841,60
3265,3,6931,2476,4455,0,0,0,1.0,1,1.0,1,1.0,1,0.1561978372382717,58
3266,10,6941,2479,4462,0,0,0,1.0,1,1.0,1,1.0,1,0.0660437469488898,59
3267,4,6945,2481,4464,0,0,0,1.0,1,1.0,1,1.0,1,0.07157675053240983,60
3268,5,6950,2485,4465,0,0,0,1.0,1,1.0,1,1.0,1,0.09940190490417244,58
3269,3,6953,2485,4468,0,0,0,1.0,1,1.0,1,1.0,1,0.07956201982494855,57
3270,2,6955,2486,4469,0,0,0,1.0,1,1.0,1,1.0,1,0.1027417359011459,56
3271,4,6959,2487,4472,0,0,0,1.0,1,1.0,1,1.0,1,0.07003214316046384,55
3272,0,6959,2487,4472,0,0,0,1.0,1,1.0,1,1.0,1,0.07065761196553931,55
3273,4,6963,2489,4474,0,0,0,1.0,1,1.0,1,1.0,1,0.10352792016039174,55
3274,3,6966,2491,4475,0,0,0,1.0,1,1.0,1,1.0,1,0.09395737089210328,55
3275,2,6968,2492,4476,0,0,0,1.0,1,1.0,1,1.0,1,0.1199268657155204,55
3276,6,6974,2493,4481,0,0,0,1.0,1,1.0,1,1.0,1,0.09907298919930253,55
3277,4,6978,2494,4484,0,0,0,1.0,1,1.0,1,1.0,1,0.0637777285492047,57
3278,0,6978,2494,4484,0,0,0,1.0,1,1.0,1,1.0,1,0.06418235785949537,56
3279,0,6978,2494,4484,0,0,0,1.0,1,1.0,1,1.0,1,0.0442246930402876,54
3280,4,6982,2496,4486,0,0,0,1.0,1,1.0,1,1.0,1,0.08121907503480799,53
3281,3,6985,2497,4488,0,0,0,1.0,1,1.0,1,1.0,1,0.08400311997792652,52
3282,0,6985,2497,4488,0,0,0,1.0,1,1.0,1,1.0,1,0.09493113830152444,50
3283,3,6988,2499,4489,0,0,0,1.0,1,1.0,1,1.0,1,0.09406235958761747,50
3284,1,6989,2500,4489,0,0,0,1.0,1,1.0,1,1.0,1,0.1551215145580209,47
3285,0,6989,2500,4489,0,0,0,1.0,1,1.0,1,1.0,1,0.13769882128114636,48
3286,5,6994,2502,4492,0,0,0,1.0,1,1.0,1,1.0,1,0.07935312891287238,46
3287,8,7002,2505,4497,0,0,0,1.0,1,1.0,1,1.0,1,0.1697205374480544,46
3288,2,7004,2505,4499,0,0,0,1.0,1,1.0,1,1.0,1,0.15720524168675948,46
3289,4,7008,2506,4502,0,0,0,1.0,1,1.0,1,1.0,1,0.14026719775915422,48
3290,3,7011,2507,4504,0,0,0,1.0,1,1.0,1,1.0,1,0.1467442864701336,48
3291,7,7018,2509,4509,0,0,0,1.0,1,1.0,1,1.0,1,0.061771899293102575,50
3292,2,7020,2510,4510,0,0,0,1.0,1,1.0,1,1.0,1,0.08016134607966183,50
3293,2,7022,2510,4512,0,0,0,1.0,1,1.0,1,1.0,1,0.07827439270747719,51
3294,2,7024,2510,4514,0,0,0,1.0,1,1.0,1,1.0,1,0.07013054440532338,50
3295,2,7026,2512,4514,0,0,0,1.0,1,1.0,1,1.0,1,0.08262854133984611,50
3296,0,7026,2512,4514,0,0,0,1.0,1,1.0,1,1.0,1,0.08262854133984611,50
3297,1,7027,2513,4514,0,0,0,1.0,1,1.0,1,1.0,1,0.10710556456047918,51
3298,3,7030,2515,4515,0,0,0,1.0,1,1.0,1,1.0,1,0.12250192170135049,52
3299,4,7034,2516,4518,0,0,0,1.0,1,1.0,1,1.0,1,0.08553620284191753,53
3300,0,7034,2516,4518,0,0,0,1.0,1,1.0,1,1.0,1,0.08553620284191753,53
3301,4,7038,2518,4520,0,0,0,1.0,1,1.0,1,1.0,1,0.09797662563940743,53
3302,5,7043,2521,4522,0,0,0,1.0,1,1.0,1,1.0,1,0.11281650682774098,53
3303,0,7043,2521,4522,0,0,0,1.0,1,1.0,1,1.0,1,0.10602164942907653,52
3304,5,7048,2524,4524,0,0,0,1.0,1,1.0,1,1.0,1,0.12913547568638575,52
3305,1,7049,2525,4524,0,0,0,1.0,1,1.0,1,1.0,1,0.16798273440338715,51
3306,4,7053,2527,4526,0,0,0,1.0,1,1.0,1,1.0,1,0.10534852400094967,51
3307,4,7057,2527,4530,0,0,0,1.0,1,1.0,1,1.0,1,0.08435228604089888,48
3308,2,7059,2529,4530,0,0,0,1.0,1,1.0,1,1.0,1,0.10357308109179773,48
3309,2,7061,2530,4531,0,0,0,1.0,1,1.0,1,1.0,1,0.12856627693581377,48
3310,1,7062,2530,4532,0,0,0,1.0,1,1.0,1,1.0,1,0.15152406274814714,47
3311,5,7067,2532,4535,0,0,0,1.0,1,1.0,1,1.0,1,0.10961460993170771,49
3312,2,7069,2533,4536,0,0,0,1.0,1,1.0,1,1.0,1,0.16211933607725526,48
3313,5,7074,2534,4540,0,0,0,1.0,1,1.0,1,1.0,1,0.17654648039235993,49
3314,5,7079,2535,4544,0,0,0,1.0,1,1.0,1,1.0,1,0.23392868939294403,47
3315,4,7083,2536,4547,0,0,0,1.0,1,1.0,1,1.0,1,0.26335094656323266,47
3316,6,7089,2536,4553,0,0,0,1.0,1,1.0,1,1.0,1,0.18549910211597706,47
3317,0,7089,2536,4553,0,0,0,1.0,1,1.0,1,1.0,1,0.15569329500668858,46
3318,5,7094,2538,4556,0,0,0,1.0,1,1.0,1,1.0,1,0.17146452217856673,45
3319,1,7095,2538,4557,0,0,0,1.0,1,1.0,1,1.0,1,0.18550978020491057,44
3320,2,7097,2538,4559,0,0,0,1.0,1,1.0,1,1.0,1,0.20664616473215036,43
3321,8,7105,2539,4566,0,0,0,1.0,1,1.0,1,1.0,1,0.12841375529799842,43
3322,2,7107,2539,4568,0,0,0,1.0,1,1.0,1,1.0,1,0.13163497443684763,40
3323,3,7110,2540,4570,0,0,0,1.0,1,1.0,1,1.0,1,0.13972597866390535,40
3324,1,7111,2541,4570,0,0,0,1.0,1,1.0,1,1.0,1,0.14177131774890328,40
3325,5,7116,2543,4573,0,0,0,1.0,1,1.0,1,1.0,1,0.16000183820840358,40
3326,1,7117,2544,4573,0,0,0,1.0,1,1.0,1,1.0,1,0.11361787697176262,41
3327,0,7117,2544,4573,0,0,0,1.0,1,1.0,1,1.0,1,0.14034485159421056,39
3328,5,7122,2548,4574,0,0,0,1.0,1,1.0,1,1.0,1,0.19405940303233415,41
3329,3,7125,2550,4575,0,0,0,1.0,1,1.0,1,1.0,1,0.19306094377767657,39
3330,3,7128,2551,4577,0,0,0,1.0,1,1.0,1,1.0,1,0.20021080675706754,40
3331,0,7128,2551,4577,0,0,0,1.0,1,1.0,1,1.0,1,0.1565232594290857,38
3332,0,7128,2551,4577,0,0,0,1.0,1,1.0,1,1.0,1,0.19654458895082075,38
3333,0,7128,2551,4577,0,0,0,1.0,1,1.0,1,1.0,1,0.19654458895082075,38
3334,3,7131,2551,4580,0,0,0,1.0,1,1.0,1,1.0,1,0.15955496693119844,40
3335,2,7133,2551,4582,0,0,0,1.0,1,1.0,1,1.0,1,0.13299531961235347,40
3336,0,7133,2551,4582,0,0,0,1.0,1,1.0,1,1.0,1,0.1307204852459568,39
3337,1,7134,2551,4583,0,0,0,1.0,1,1.0,1,1.0,1,0.09046736370296793,40
3338,6,7140,2553,4587,0,0,0,1.0,1,1.0,1,1.0,1,0.12408604841013629,41
3339,1,7141,2554,4587,0,0,0,1.0,1,1.0,1,1.0,1,0.16606495800848114,42
3340,6,7147,2556,4591,0,0,0,1.0,1,1.0,1,1.0,1,0.14349792195204325,43
3341,2,7149,2556,4593,0,0,0,1.0,1,1.0,1,1.0,1,0.11275839267412364,43
3342,2,7151,2557,4594,0,0,0,1.0,1,1.0,1,1.0,1,0.17515808856142168,44
3343,4,7155,2559,4596,0,0,0,1.0,1,1.0,1,1.0,1,0.17101906156797225,44
3344,5,7160,2561,4599,0,0,0,1.0,1,1.0,1,1.0,1,0.19670116648044472,44
3345,1,7161,2561,4600,0,0,0,1.0,1,1.0,1,1.0,1,0.20228271635261896,43
3346,0,7161,2561,4600,0,0,0,1.0,1,1.0,1,1.0,1,0.22676865492515072,42
3347,2,7163,2561,4602,0,0,0,1.0,1,1.0,1,1.0,1,0.1964775097136492,44
3348,0,7163,2561,4602,0,0,0,1.0,1,1.0,1,1.0,1,0.20952127526354059,45
3349,2,7165,2562,4603,0,0,0,1.0,1,1.0,1,1.0,1,0.19299163570923816,45
3350,0,7165,2562,4603,0,0,0,1.0,1,1.0,1,1.0,1,0.17292082025925662,46
3351,4,7169,2563,4606,0,0,0,1.0,1,1.0,1,1.0,1,0.1568806927032668,47
3352,2,7171,2563,4608,0,0,0,1.0,1,1.0,1,1.0,1,0.1301404402816351,47
3353,2,7173,2563,4610,0,0,0,1.0,1,1.0,1,1.0,1,0.1454189003127985,48
3354,0,7173,2563,4610,0,0,0,1.0,1,1.0,1,1.0,1,0.1454189003127985,48
3355,1,7174,2563,4611,0,0,0,1.0,1,1.0,1,1.0,1,0.14488516232094473,48
3356,1,7175,2563,4612,0,0,0,1.0,1,1.0,1,1.0,1,0.10972770583866734,48
3357,1,7176,2564,4612,0,0,0,1.0,1,1.0,1,1.0,1,0.1104757081980626,47
3358,3,7179,2566,4613,0,0,0,1.0,1,1.0,1,1.0,1,0.16259244372985268,46
3359,2,7181,2567,4614,0,0,0,1.0,1,1.0,1,1.0,1,0.17341668207314187,45
3360,2,7183,2569,4614,0,0,0,1.0,1,1.0,1,1.0,1,0.20558828616920263,44
3361,4,7187,2569,4618,0,0,0,1.0,1,1.0,1,1.0,1,0.15049598154015426,43
3362,1,7188,2569,4619,0,0,0,1.0,1,1.0,1,1.0,1,0.1401330242699593,42
3363,0,7188,2569,4619,0,0,0,1.0,1,1.0,1,1.0,1,0.14133866903630407,41
3364,2,7190,2570,4620,0,0,0,1.0,1,1.0,1,1.0,1,0.13876153408509662,41
3365,3,7193,2571,4622,0,0,0,1.0,1,1.0,1,1.0,1,0.16277469503416817,41
3366,3,7196,2572,4624,0,0,0,1.0,1,1.0,1,1.0,1,0.13355989040372518,40
3367,1,7197,2572,4625,0,0,0,1.0,1,1.0,1,1.0,1,0.11550698684263146,39
3368,0,7197,2572,4625,0,0,0,1.0,1,1.0,1,1.0,1,0.11550698684263146,39
3369,2,7199,2573,4626,0,0,0,1.0,1,1.0,1,1.0,1,0.10944293577146992,40
3370,2,7201,2575,4626,0,0,0,1.0,1,1.0,1,1.0,1,0.10232983060027888,41
3371,1,7202,2576,4626,0,0,0,1.0,1,1.0,1,1.0,1,0.12239206471081734,41
3372,4,7206,2578,4628,0,0,0,1.0,1,1.0,1,1.0,1,0.128346895392264,40
3373,2,7208,2578,4630,0,0,0,1.0,1,1.0,1,1.0,1,0.1130037461703807,41
3374,1,7209,2578,4631,0,0,0,1.0,1,1.0,1,1.0,1,0.09782126064516378,42
3375,1,7210,2578,4632,0,0,0,1.0,1,1.0,1,1.0,1,0.09491146469746525,44
3376,3,7213,2579,4634,0,0,0,1.0,1,1.0,1,1.0,1,0.09317005323219262,46
3377,3,7216,2579,4637,0,0,0,1.0,1,1.0,1,1.0,1,0.11910596669620813,47
3378,2,7218,2580,4638,0,0,0,1.0,1,1.0,1,1.0,1,0.11219577420517621,48
3379,3,7221,2580,4641,0,0,0,1.0,1,1.0,1,1.0,1,0.0909908075164686,48
3380,4,7225,2582,4643,0,0,0,1.0,1,1.0,1,1.0,1,0.13347542310684926,48
3381,4,7229,2582,4647,0,0,0,1.0,1,1.0,1,1.0,1,0.0932907530059083,48
3382,1,7230,2583,4647,0,0,0,1.0,1,1.0,1,1.0,1,0.12531641421450118,49
3383,0,7230,2583,4647,0,0,0,1.0,1,1.0,1,1.0,1,0.10016555080198106,47
3384,1,7231,2584,4647,0,0,0,1.0,1,1.0,1,1.0,1,0.15387792086353452,48
3385,0,7231,2584,4647,0,0,0,1.0,1,1.0,1,1.0,1,0.12111566427993299,47
3386,7,7238,2586,4652,0,0,0,1.0,1,1.0,1,1.0,1,0.17526238491003956,49
3387,2,7240,2586,4654,0,0,0,1.0,1,1.0,1,1.0,1,0.1745126725264431,48
3388,5,7245,2587,4658,0,0,0,1.0,1,1.0,1,1.0,1,0.20889744979841302,48
3389,11,7256,2587,4669,0,0,0,1.0,1,1.0,1,1.0,1,0.1893380638883684,50
3390,4,7260,2587,4673,0,0,0,1.0,1,1.0,1,1.0,1,0.1672395284438569,51
3391,3,7263,2587,4676,0,0,0,1.0,1,1.0,1,1.0,1,0.12679071006031684,51
3392,4,7267,2587,4680,0,0,0,1.0,1,1.0,1,1.0,1,0.10912144165256417,52
3393,2,7269,2588,4681,0,0,0,1.0,1,1.0,1,1.0,1,0.11016738634175746,52
3394,1,7270,2589,4681,0,0,0,1.0,1,1.0,1,1.0,1,0.13342142150936023,52
3395,1,7271,2589,4682,0,0,0,1.0,1,1.0,1,1.0,1,0.11770670181094375,50
3396,1,7272,2589,4683,0,0,0,1.0,1,1.0,1,1.0,1,0.0918321854303938,49
3397,0,7272,2589,4683,0,0,0,1.0,1,1.0,1,1.0,1,0.10552585542561964,49
3398,0,7272,2589,4683,0,0,0,1.0,1,1.0,1,1.0,1,0.1070998058519113,48
3399,1,7273,2590,4683,0,0,0,1.0,1,1.0,1,1.0,1,0.12901110671936236,49
3400,2,7275,2591,4684,0,0,0,1.0,1,1.0,1,1.0,1,0.11107354076484725,50
3401,1,7276,2591,4685,0,0,0,1.0,1,1.0,1,1.0,1,0.10606370314572539,51
3402,1,7277,2592,4685,0,0,0,1.0,1,1.0,1,1.0,1,0.14710487702005065,51
3403,3,7280,2593,4687,0,0,0,1.0,1,1.0,1,1.0,1,0.11064977671369947,51
3404,1,7281,2593,4688,0,0,0,1.0,1,1.0,1,1.0,1,0.10240903496614982,51
3405,1,7282,2594,4688,0,0,0,1.0,1,1.0,1,1.0,1,0.12114053054355914,51
3406,1,7283,2594,4689,0,0,0,1.0,1,1.0,1,1.0,1,0.10638282749139755,51
3407,0,7283,2594,4689,0,0,0,1.0,1,1.0,1,1.0,1,0.11667613131403182,52
3408,1,7284,2594,4690,0,0,0,1.0,1,1.0,1,1.0,1,0.1251250702873044,53
3409,1,7285,2594,4691,0,0,0,1.0,1,1.0,1,1.0,1,0.11022950646917369,54
3410,2,7287,2596,4691,0,0,0,1.0,1,1.0,1,1.0,1,0.11261570511838433,54
3411,1,7288,2596,4692,0,0,0,1.0,1,1.0,1,1.0,1,0.10814957455595901,54
3412,4,7292,2597,4695,0,0,0,1.0,1,1.0,1,1.0,1,0.11379909055581472,55
3413,3,7295,2598,4697,0,0,0,1.0,1,1.0,1,1.0,1,0.11256881068651604,55
3414,2,7297,2598,4699,0,0,0,1.0,1,1.0,1,1.0,1,0.1237180170917019,55
3415,5,7302,2600,4702,0,0,0,1.0,1,1.0,1,1.0,1,0.14283034064501998,56
3416,4,7306,2600,4706,0,0,0,1.0,1,1.0,1,1.0,1,0.11632489494395687,55
3417,4,7310,2602,4708,0,0,0,1.0,1,1.0,1,1.0,1,0.14403392603265286,56
3418,1,7311,2603,4708,0,0,0,1.0,1,1.0,1,1.0,1,0.1538363115213915,55
3419,0,7311,2603,4708,0,0,0,1.0,1,1.0,1,1.0,1,0.16735371677718222,56
3420,0,7311,2603,4708,0,0,0,1.0,1,1.0,1,1.0,1,0.18010345110481946,55
3421,4,7315,2604,4711,0,0,0,1.0,1,1.0,1,1.0,1,0.1440246904757329,57
3422,1,7316,2605,4711,0,0,0,1.0,1,1.0,1,1.0,1,0.15531995214413,56
3423,2,7318,2606,4712,0,0,0,1.0,1,1.0,1,1.0,1,0.13378855123922748,56
3424,3,7321,2607,4714,0,0,0,1.0,1,1.0,1,1.0,1,0.1339427966457099,56
3425,3,7324,2609,4715,0,0,0,1.0,1,1.0,1,1.0,1,0.14252550453598592,56
3426,5,7329,2609,4720,0,0,0,1.0,1,1.0,1,1.0,1,0.1268460076594223,55
3427,2,7331,2610,4721,0,0,0,1.0,1,1.0,1,1.0,1,0.15625741167321383,55
3428,2,7333,2611,4722,0,0,0,1.0,1,1.0,1,1.0,1,0.13108317815656448,55
3429,3,7336,2612,4724,0,0,0,1.0,1,1.0,1,1.0,1,0.12663540552579544,54
3430,2,7338,2612,4726,0,0,0,1.0,1,1.0,1,1.0,1,0.1095087456824917,56
3431,0,7338,2612,4726,0,0,0,1.0,1,1.0,1,1.0,1,0.086284974605241,54
3432,6,7344,2615,4729,0,0,0,1.0,1,1.0,1,1.0,1,0.08713771088412564,56
3433,3,7347,2618,4729,0,0,0,1.0,1,1.0,1,1.0,1,0.07979913426640242,53
3434,0,7347,2618,4729,0,0,0,1.0,1,1.0,1,1.0,1,0.07672400995778592,51
3435,2,7349,2620,4729,0,0,0,1.0,1,1.0,1,1.0,1,0.09432944626083468,51
3436,2,7351,2621,4730,0,0,0,1.0,1,1.0,1,1.0,1,0.08848273503712673,51
3437,2,7353,2622,4731,0,0,0,1.0,1,1.0,1,1.0,1,0.06663395067201744,53
3438,1,7354,2622,4732,0,0,0,1.0,1,1.0,1,1.0,1,0.1109747145697572,52
3439,1,7355,2622,4733,0,0,0,1.0,1,1.0,1,1.0,1,0.104448145355024,54
3440,4,7359,2623,4736,0,0,0,1.0,1,1.0,1,1.0,1,0.10150816072984621,52
3441,2,7361,2623,4738,0,0,0,1.0,1,1.0,1,1.0,1,0.07220662534875232,53
3442,2,7363,2625,4738,0,0,0,1.0,1,1.0,1,1.0,1,0.12249375343846966,53
3443,2,7365,2626,4739,0,0,0,1.0,1,1.0,1,1.0,1,0.146179043380636,53
3444,0,7365,2626,4739,0,0,0,1.0,1,1.0,1,1.0,1,0.15913518702264098,52
3445,6,7371,2629,4742,0,0,0,1.0,1,1.0,1,1.0,1,0.18399854249092681,53
3446,9,7380,2631,4749,0,0,0,1.0,1,1.0,1,1.0,1,0.14786841535278397,53
3447,1,7381,2631,4750,0,0,0,1.0,1,1.0,1,1.0,1,0.15340288333734958,53
3448,2,7383,2631,4752,0,0,0,1.0,1,1.0,1,1.0,1,0.1305118661378597,52
3449,1,7384,2631,4753,0,0,0,1.0,1,1.0,1,1.0,1,0.1008289300954904,52
3450,1,7385,2632,4753,0,0,0,1.0,1,1.0,1,1.0,1,0.1275663708009881,52
3451,3,7388,2634,4754,0,0,0,1.0,1,1.0,1,1.0,1,0.07931987534995004,54
3452,4,7392,2636,4756,0,0,0,1.0,1,1.0,1,1.0,1,0.1074130628044932,54
3453,4,7396,2638,4758,0,0,0,1.0,1,1.0,1,1.0,1,0.12427910143476589,54
3454,3,7399,2638,4761,0,0,0,1.0,1,1.0,1,1.0,1,0.1159833162174111,57
3455,2,7401,2638,4763,0,0,0,1.0,1,1.0,1,1.0,1,0.12262987423816014,57
3456,3,7404,2638,4766,0,0,0,1.0,1,1.0,1,1.0,1,0.09742768705319478,58
3457,0,7404,2638,4766,0,0,0,1.0,1,1.0,1,1.0,1,0.11747614816252125,57
3458,4,7408,2638,4770,0,0,0,1.0,1,1.0,1,1.0,1,0.11832992097052356,57
3459,2,7410,2638,4772,0,0,0,1.0,1,1.0,1,1.0,1,0.12012527176705833,57
3460,3,7413,2638,4775,0,0,0,1.0,1,1.0,1,1.0,1,0.14017688233106151,58
3461,5,7418,2638,4780,0,0,0,1.0,1,1.0,1,1.0,1,0.08305948347413972,59
3462,0,7418,2638,4780,0,0,0,1.0,1,1.0,1,1.0,1,0.08305948347413972,59
3463,0,7418,2638,4780,0,0,0,1.0,1,1.0,1,1.0,1,0.08305948347413972,59
3464,1,7419,2638,4781,0,0,0,1.0,1,1.0,1,1.0,1,0.07380622607401745,59
3465,2,7421,2638,4783,0,0,0,1.0,1,1.0,1,1.0,1,0.0973083974552012,57
3466,2,7423,2639,4784,0,0,0,1.0,1,1.0,1,1.0,1,0.07742708337797603,57
3467,4,7427,2641,4786,0,0,0,1.0,1,1.0,1,1.0,1,0.15356903697318586,57
3468,4,7431,2642,4789,0,0,0,1.0,1,1.0,1,1.0,1,0.09836177747681787,57
3469,4,7435,2645,4790,0,0,0,1.0,1,1.0,1,1.0,1,0.11472689196986345,53
3470,5,7440,2650,4790,0,0,0,1.0,1,1.0,1,1.0,1,0.2003271611257962,50
3471,7,7447,2650,4797,0,0,0,1.0,1,1.0,1,1.0,1,0.09094377847019153,49
3472,0,7447,2650,4797,0,0,0,1.0,1,1.0,1,1.0,1,0.11460354584756831,47
3473,3,7450,2653,4797,0,0,0,1.0,1,1.0,1,1.0,1,0.15397086556266765,45
3474,0,7450,2653,4797,0,0,0,1.0,1,1.0,1,1.0,1,0.12808267919750174,42
3475,2,7452,2655,4797,0,0,0,1.0,1,1.0,1,1.0,1,0.21935035581339235,43
3476,5,7457,2656,4801,0,0,0,1.0,1,1.0,1,1.0,1,0.1700200136954398,41
3477,6,7463,2660,4803,0,0,0,1.0,1,1.0,1,1.0,1,0.14624059875990733,42
3478,3,7466,2660,4806,0,0,0,1.0,1,1.0,1,1.0,1,0.12299617800155686,40
3479,5,7471,2662,4809,0,0,0,1.0,1,1.0,1,1.0,1,0.16584243016343478,40
3480,6,7477,2664,4813,0,0,0,1.0,1,1.0,1,1.0,1,0.2023609177706227,40
3481,5,7482,2664,4818,0,0,0,1.0,1,1.0,1,1.0,1,0.1733448044672555,40
3482,3,7485,2664,4821,0,0,0,1.0,1,1.0,1,1.0,1,0.1555594277789355,40
3483,3,7488,2664,4824,0,0,0,1.0,1,1.0,1,1.0,1,0.14185288667140333,39
3484,4,7492,2664,4828,0,0,0,1.0,1,1.0,1,1.0,1,0.14185288667140333,39
3485,5,7497,2664,4833,0,0,0,1.0,1,1.0,1,1.0,1,0.17698081354516934,40
3486,5,7502,2664,4838,0,0,0,1.0,1,1.0,1,1.0,1,0.11756979020368923,41
3487,1,7503,2664,4839,0,0,0,1.0,1,1.0,1,1.0,1,0.11672601092679637,41
3488,0,7503,2664,4839,0,0,0,1.0,1,1.0,1,1.0,1,0.09698807522439835,42
3489,2,7505,2664,4841,0,0,0,1.0,1,1.0,1,1.0,1,0.10465781058427154,44
3490,1,7506,2664,4842,0,0,0,1.0,1,1.0,1,1.0,1,0.09426911525572697,44
3491,1,7507,2664,4843,0,0,0,1.0,1,1.0,1,1.0,1,0.08618146369576145,45
3492,1,7508,2665,4843,0,0,0,1.0,1,1.0,1,1.0,1,0.09507398914918688,45
3493,1,7509,2666,4843,0,0,0,1.0,1,1.0,1,1.0,1,0.10955334827651307,45
3494,0,7509,2666,4843,0,0,0,1.0,1,1.0,1,1.0,1,0.10955334827651307,45
3495,1,7510,2667,4843,0,0,0,1.0,1,1.0,1,1.0,1,0.1373798055019223,45
3496,7,7517,2667,4850,0,0,0,1.0,1,1.0,1,1.0,1,0.07335171592945752,46
3497,4,7521,2668,4853,0,0,0,1.0,1,1.0,1,1.0,1,0.0862073742382903,47
3498,3,7524,2669,4855,0,0,0,1.0,1,1.0,1,1.0,1,0.12973936328147706,48
3499,1,7525,2669,4856,0,0,0,1.0,1,1.0,1,1.0,1,0.16570182529553956,47
3500,5,7530,2669,4861,0,0,0,1.0,1,1.0,1,1.0,1,0.16598356729377656,50
3501,3,7533,2670,4863,0,0,0,1.0,1,1.0,1,1.0,1,0.16550999069414732,50
3502,1,7534,2670,4864,0,0,0,1.0,1,1.0,1,1.0,1,0.1663854251441541,50
3503,3,7537,2672,4865,0,0,0,1.0,1,1.0,1,1.0,1,0.19196401321126064,50
3504,4,7541,2676,4865,0,0,0,1.0,1,1.0,1,1.0,1,0.2934030554073305,47
3505,4,7545,2677,4868,0,0,0,1.0,1,1.0,1,1.0,1,0.2887901645243801,48
3506,9,7554,2678,4876,0,0,0,1.0,1,1.0,1,1.0,1,0.18029088308272082,49
3507,3,7557,2678,4879,0,0,0,1.0,1,1.0,1,1.0,1,0.1619357206836336,46
3508,4,7561,2680,4881,0,0,0,1.0,1,1.0,1,1.0,1,0.20648419888348069,47
3509,1,7562,2680,4882,0,0,0,1.0,1,1.0,1,1.0,1,0.16884452807569053,44
3510,3,7565,2681,4884,0,0,0,1.0,1,1.0,1,1.0,1,0.20299087892386222,45
3511,3,7568,2682,4886,0,0,0,1.0,1,1.0,1,1.0,1,0.16788684242860835,44
3512,0,7568,2682,4886,0,0,0,1.0,1,1.0,1,1.0,1,0.15877408239676302,42
3513,0,7568,2682,4886,0,0,0,1.0,1,1.0,1,1.0,1,0.15877408239676302,42
3514,0,7568,2682,4886,0,0,0,1.0,1,1.0,1,1.0,1,0.1676981269492695,42
3515,5,7573,2683,4890,0,0,0,1.0,1,1.0,1,1.0,1,0.10672810097247315,42
3516,0,7573,2683,4890,0,0,0,1.0,1,1.0,1,1.0,1,0.09800951380571878,41
3517,0,7573,2683,4890,0,0,0,1.0,1,1.0,1,1.0,1,0.0906249718748209,44
3518,0,7573,2683,4890,0,0,0,1.0,1,1.0,1,1.0,1,0.11154352490794912,43
3519,2,7575,2685,4890,0,0,0,1.0,1,1.0,1,1.0,1,0.14909543772832612,44
3520,5,7580,2685,4895,0,0,0,1.0,1,1.0,1,1.0,1,0.1306065824423337,45
3521,0,7580,2685,4895,0,0,0,1.0,1,1.0,1,1.0,1,0.1306065824423337,45
3522,0,7580,2685,4895,0,0,0,1.0,1,1.0,1,1.0,1,0.12183953951694537,46
3523,0,7580,2685,4895,0,0,0,1.0,1,1.0,1,1.0,1,0.12183953951694537,46
3524,1,7581,2685,4896,0,0,0,1.0,1,1.0,1,1.0,1,0.1007260537141235,47
3525,1,7582,2685,4897,0,0,0,1.0,1,1.0,1,1.0,1,0.11643349457298938,48
3526,0,7582,2685,4897,0,0,0,1.0,1,1.0,1,1.0,1,0.11448513837555763,49
3527,4,7586,2687,4899,0,0,0,1.0,1,1.0,1,1.0,1,0.14386466788508456,49
3528,3,7589,2688,4901,0,0,0,1.0,1,1.0,1,1.0,1,0.1401732765239013,51
3529,0,7589,2688,4901,0,0,0,1.0,1,1.0,1,1.0,1,0.1401732765239013,51
3530,2,7591,2689,4902,0,0,0,1.0,1,1.0,1,1.0,1,0.14722321953698955,52
3531,3,7594,2689,4905,0,0,0,1.0,1,1.0,1,1.0,1,0.12276865106747005,52
3532,0,7594,2689,4905,0,0,0,1.0,1,1.0,1,1.0,1,0.12276865106747005,52
3533,0,7594,2689,4905,0,0,0,1.0,1,1.0,1,1.0,1,0.12276865106747005,52
3534,0,7594,2689,4905,0,0,0,1.0,1,1.0,1,1.0,1,0.12276865106747005,52
3535,0,7594,2689,4905,0,0,0,1.0,1,1.0,1,1.0,1,0.12276865106747005,52
3536,2,7596,2689,4907,0,0,0,1.0,1,1.0,1,1.0,1,0.1296796215661181,54
3537,0,7596,2689,4907,0,0,0,1.0,1,1.0,1,1.0,1,0.12706665270549777,55
3538,1,7597,2689,4908,0,0,0,1.0,1,1.0,1,1.0,1,0.11614564104252056,55
3539,1,7598,2689,4909,0,0,0,1.0,1,1.0,1,1.0,1,0.1000020250014107,58
3540,5,7603,2691,4912,0,0,0,1.0,1,1.0,1,1.0,1,0.11847326384511035,59
3541,1,7604,2691,4913,0,0,0,1.0,1,1.0,1,1.0,1,0.10481872271162572,59
3542,0,7604,2691,4913,0,0,0,1.0,1,1.0,1,1.0,1,0.12226590675262673,61
3543,5,7609,2693,4916,0,0,0,1.0,1,1.0,1,1.0,1,0.11304315560217779,62
3544,2,7611,2695,4916,0,0,0,1.0,1,1.0,1,1.0,1,0.12125011121839828,59
3545,3,7614,2698,4916,0,0,0,1.0,1,1.0,1,1.0,1,0.1476061129597149,59
3546,6,7620,2700,4920,0,0,0,1.0,1,1.0,1,1.0,1,0.09551836811050422,57
3547,2,7622,2702,4920,0,0,0,1.0,1,1.0,1,1.0,1,0.11530563363679153,53
3548,2,7624,2703,4921,0,0,0,1.0,1,1.0,1,1.0,1,0.11400195286514701,53
3549,1,7625,2704,4921,0,0,0,1.0,1,1.0,1,1.0,1,0.1288496107293439,52
3550,1,7626,2705,4921,0,0,0,1.0,1,1.0,1,1.0,1,0.12044802883173757,51
3551,1,7627,2706,4921,0,0,0,1.0,1,1.0,1,1.0,1,0.1342562047686438,51
3552,1,7628,2707,4921,0,0,0,1.0,1,1.0,1,1.0,1,0.1580328674750534,51
3553,0,7628,2707,4921,0,0,0,1.0,1,1.0,1,1.0,1,0.16142633317452923,49
3554,0,7628,2707,4921,0,0,0,1.0,1,1.0,1,1.0,1,0.16142633317452923,49
3555,4,7632,2707,4925,0,0,0,1.0,1,1.0,1,1.0,1,0.15186503438664786,51
3556,4,7636,2707,4929,0,0,0,1.0,1,1.0,1,1.0,1,0.0897657494215867,51
3557,3,7639,2708,4931,0,0,0,1.0,1,1.0,1,1.0,1,0.0912892031309883,52
3558,1,7640,2709,4931,0,0,0,1.0,1,1.0,1,1.0,1,0.12327027102901326,52
3559,6,7646,2711,4935,0,0,0,1.0,1,1.0,1,1.0,1,0.10268321881954169,52
3560,1,7647,2711,4936,0,0,0,1.0,1,1.0,1,1.0,1,0.059036702884214004,53
3561,2,7649,2712,4937,0,0,0,1.0,1,1.0,1,1.0,1,0.055521675029581725,54
3562,3,7652,2713,4939,0,0,0,1.0,1,1.0,1,1.0,1,0.07345936493616301,54
3563,3,7655,2714,4941,0,0,0,1.0,1,1.0,1,1.0,1,0.11587505512848847,55
3564,1,7656,2714,4942,0,0,0,1.0,1,1.0,1,1.0,1,0.09434145881941497,57
3565,0,7656,2714,4942,0,0,0,1.0,1,1.0,1,1.0,1,0.10875141112686032,56
3566,2,7658,2714,4944,0,0,0,1.0,1,1.0,1,1.0,1,0.0900347169879681,57
3567,0,7658,2714,4944,0,0,0,1.0,1,1.0,1,1.0,1,0.0900347169879681,57
3568,2,7660,2715,4945,0,0,0,1.0,1,1.0,1,1.0,1,0.09855947169203572,57
3569,0,7660,2715,4945,0,0,0,1.0,1,1.0,1,1.0,1,0.09855947169203572,57
3570,6,7666,2718,4948,0,0,0,1.0,1,1.0,1,1.0,1,0.17700999835753314,59
3571,3,7669,2718,4951,0,0,0,1.0,1,1.0,1,1.0,1,0.14500822139930983,60
3572,3,7672,2719,4953,0,0,0,1.0,1,1.0,1,1.0,1,0.13024500843046036,61
3573,2,7674,2719,4955,0,0,0,1.0,1,1.0,1,1.0,1,0.12327843724019769,62
3574,3,7677,2719,4958,0,0,0,1.0,1,1.0,1,1.0,1,0.0987769966034576,63
3575,5,7682,2720,4962,0,0,0,1.0,1,1.0,1,1.0,1,0.12270375873833675,63
3576,4,7686,2722,4964,0,0,0,1.0,1,1.0,1,1.0,1,0.14804314753036696,63
3577,2,7688,2722,4966,0,0,0,1.0,1,1.0,1,1.0,1,0.12588871889210698,64
3578,0,7688,2722,4966,0,0,0,1.0,1,1.0,1,1.0,1,0.12900727678327273,64
3579,0,7688,2722,4966,0,0,0,1.0,1,1.0,1,1.0,1,0.12900727678327273,64
3580,1,7689,2722,4967,0,0,0,1.0,1,1.0,1,1.0,1,0.13505251713358876,65
3581,2,7691,2722,4969,0,0,0,1.0,1,1.0,1,1.0,1,0.11019125796467187,68
3582,4,7695,2725,4970,0,0,0,1.0,1,1.0,1,1.0,1,0.1224169843781351,68
3583,2,7697,2727,4970,0,0,0,1.0,1,1.0,1,1.0,1,0.12996517673841748,65
3584,4,7701,2731,4970,0,0,0,1.0,1,1.0,1,1.0,1,0.1706633759567664,64
3585,1,7702,2732,4970,0,0,0,1.0,1,1.0,1,1.0,1,0.15048466555993956,64
3586,8,7710,2735,4975,0,0,0,1.0,1,1.0,1,1.0,1,0.1136420472991936,65
3587,1,7711,2736,4975,0,0,0,1.0,1,1.0,1,1.0,1,0.0927169099721119,64
3588,1,7712,2737,4975,0,0,0,1.0,1,1.0,1,1.0,1,0.11855324139671924,62
3589,4,7716,2740,4976,0,0,0,1.0,1,1.0,1,1.0,1,0.14826988309536585,63
3590,1,7717,2741,4976,0,0,0,1.0,1,1.0,1,1.0,1,0.14818757330550186,63
3591,5,7722,2741,4981,0,0,0,1.0,1,1.0,1,1.0,1,0.08221371609702291,62
3592,1,7723,2742,4981,0,0,0,1.0,1,1.0,1,1.0,1,0.08822300119998078,59
3593,3,7726,2744,4982,0,0,0,1.0,1,1.0,1,1.0,1,0.08992558886976347,58
3594,1,7727,2744,4983,0,0,0,1.0,1,1.0,1,1.0,1,0.08961249470387934,57
3595,2,7729,2745,4984,0,0,0,1.0,1,1.0,1,1.0,1,0.09169053609168011,59
3596,0,7729,2745,4984,0,0,0,1.0,1,1.0,1,1.0,1,0.07596726959118104,57
3597,2,7731,2747,4984,0,0,0,1.0,1,1.0,1,1.0,1,0.08774290477213093,57
3598,2,7733,2749,4984,0,0,0,1.0,1,1.0,1,1.0,1,0.10378937547348009,57
3599,5,7738,2751,4987,0,0,0,1.0,1,1.0,1,1.0,1,0.13130434051115852,58
3600,1,7739,2751,4988,0,0,0,1.0,1,1.0,1,1.0,1,0.13067759949388907,58
3601,6,7745,2752,4993,0,0,0,1.0,1,1.0,1,1.0,1,0.0787875145992411,58
3602,4,7749,2753,4996,0,0,0,1.0,1,1.0,1,1.0,1,0.06257853221833279,60
3603,3,7752,2753,4999,0,0,0,1.0,1,1.0,1,1.0,1,0.06207326008368999,60
3604,2,7754,2753,5001,0,0,0,1.0,1,1.0,1,1.0,1,0.06207326008368999,60
3605,1,7755,2753,5002,0,0,0,1.0,1,1.0,1,1.0,1,0.08530028843664454,61
3606,3,7758,2755,5003,0,0,0,1.0,1,1.0,1,1.0,1,0.07783508064912173,63
3607,4,7762,2756,5006,0,0,0,1.0,1,1.0,1,1.0,1,0.08837941459642845,63
3608,2,7764,2756,5008,0,0,0,1.0,1,1.0,1,1.0,1,0.08793281228025944,64
3609,5,7769,2757,5012,0,0,0,1.0,1,1.0,1,1.0,1,0.12375055310836428,66
3610,5,7774,2758,5016,0,0,0,1.0,1,1.0,1,1.0,1,0.11919839549957198,67
3611,5,7779,2760,5019,0,0,0,1.0,1,1.0,1,1.0,1,0.10927432037411375,67
3612,1,7780,2761,5019,0,0,0,1.0,1,1.0,1,1.0,1,0.10751241116904378,66
3613,2,7782,2762,5020,0,0,0,1.0,1,1.0,1,1.0,1,0.11045445956296708,66
3614,2,7784,2764,5020,0,0,0,1.0,1,1.0,1,1.0,1,0.10454622156412535,65
3615,0,7784,2764,5020,0,0,0,1.0,1,1.0,1,1.0,1,0.10567594152987501,65
3616,4,7788,2764,5024,0,0,0,1.0,1,1.0,1,1.0,1,0.0739260098549886,65
3617,4,7792,2765,5027,0,0,0,1.0,1,1.0,1,1.0,1,0.10888326888709175,66
3618,2,7794,2765,5029,0,0,0,1.0,1,1.0,1,1.0,1,0.07934333212766123,66
3619,2,7796,2766,5030,0,0,0,1.0,1,1.0,1,1.0,1,0.11991692959145632,65
3620,3,7799,2766,5033,0,0,0,1.0,1,1.0,1,1.0,1,0.11329352543861147,66
3621,5,7804,2766,5038,0,0,0,1.0,1,1.0,1,1.0,1,0.06208932212365694,65
3622,1,7805,2766,5039,0,0,0,1.0,1,1.0,1,1.0,1,0.033719422246875144,65
3623,3,7808,2768,5040,0,0,0,1.0,1,1.0,1,1.0,1,0.08461896952219351,62
3624,1,7809,2769,5040,0,0,0,1.0,1,1.0,1,1.0,1,0.09091310579294819,62
3625,1,7810,2770,5040,0,0,0,1.0,1,1.0,1,1.0,1,0.0877862249108347,61
3626,7,7817,2772,5045,0,0,0,1.0,1,1.0,1,1.0,1,0.08965962690052288,58
3627,6,7823,2774,5049,0,0,0,1.0,1,1.0,1,1.0,1,0.0942787081513238,58
3628,5,7828,2776,5052,0,0,0,1.0,1,1.0,1,1.0,1,0.0659425379434709,57
3629,4,7832,2779,5053,0,0,0,1.0,1,1.0,1,1.0,1,0.05283950391479855,57
3630,3,7835,2781,5054,0,0,0,1.0,1,1.0,1,1.0,1,0.11391713890743078,56
3631,5,7840,2785,5055,0,0,0,1.0,1,1.0,1,1.0,1,0.10099629059553658,54
3632,2,7842,2786,5056,0,0,0,1.0,1,1.0,1,1.0,1,0.09473517253603991,52
3633,5,7847,2789,5058,0,0,0,1.0,1,1.0,1,1.0,1,0.13443463097072403,52
3634,3,7850,2790,5060,0,0,0,1.0,1,1.0,1,1.0,1,0.14062165997697842,49
3635,1,7851,2790,5061,0,0,0,1.0,1,1.0,1,1.0,1,0.14874983044664988,47
3636,6,7857,2792,5065,0,0,0,1.0,1,1.0,1,1.0,1,0.13527811759165656,48
3637,1,7858,2792,5066,0,0,0,1.0,1,1.0,1,1.0,1,0.1682714575534529,49
3638,1,7859,2792,5067,0,0,0,1.0,1,1.0,1,1.0,1,0.17007424758981665,50
3639,7,7866,2793,5073,0,0,0,1.0,1,1.0,1,1.0,1,0.1718374936891912,52
3640,5,7871,2794,5077,0,0,0,1.0,1,1.0,1,1.0,1,0.15759155771074163,52
3641,4,7875,2795,5080,0,0,0,1.0,1,1.0,1,1.0,1,0.11369121887966645,52
3642,0,7875,2795,5080,0,0,0,1.0,1,1.0,1,1.0,1,0.11369121887966645,52
3643,0,7875,2795,5080,0,0,0,1.0,1,1.0,1,1.0,1,0.11369121887966645,52
3644,0,7875,2795,5080,0,0,0,1.0,1,1.0,1,1.0,1,0.11369121887966645,52
3645,0,7875,2795,5080,0,0,0,1.0,1,1.0,1,1.0,1,0.10424967603862205,53
3646,1,7876,2795,5081,0,0,0,1.0,1,1.0,1,1.0,1,0.09227180411882288,53
3647,1,7877,2795,5082,0,0,0,1.0,1,1.0,1,1.0,1,0.09821864021200652,55
3648,5,7882,2795,5087,0,0,0,1.0,1,1.0,1,1.0,1,0.10392378176434622,57
3649,4,7886,2795,5091,0,0,0,1.0,1,1.0,1,1.0,1,0.10184945623176271,57
3650,3,7889,2795,5094,0,0,0,1.0,1,1.0,1,1.0,1,0.11440350275627603,59
3651,2,7891,2795,5096,0,0,0,1.0,1,1.0,1,1.0,1,0.08301979455499424,59
3652,0,7891,2795,5096,0,0,0,1.0,1,1.0,1,1.0,1,0.08301979455499424,59
3653,0,7891,2795,5096,0,0,0,1.0,1,1.0,1,1.0,1,0.08301979455499424,59
3654,0,7891,2795,5096,0,0,0,1.0,1,1.0,1,1.0,1,0.08301979455499424,59
3655,5,7896,2795,5101,0,0,0,1.0,1,1.0,1,1.0,1,0.061007258711995235,62
3656,0,7896,2795,5101,0,0,0,1.0,1,1.0,1,1.0,1,0.061007258711995235,62
3657,1,7897,2796,5101,0,0,0,1.0,1,1.0,1,1.0,1,0.09538034547014622,63
3658,1,7898,2796,5102,0,0,0,1.0,1,1.0,1,1.0,1,0.09402368522339524,63
3659,2,7900,2797,5103,0,0,0,1.0,1,1.0,1,1.0,1,0.11486005061611314,62
3660,6,7906,2802,5104,0,0,0,1.0,1,1.0,1,1.0,1,0.1870530351836661,62
3661,5,7911,2802,5109,0,0,0,1.0,1,1.0,1,1.0,1,0.11328530311072661,61
3662,4,7915,2805,5110,0,0,0,1.0,1,1.0,1,1.0,1,0.130105051988555,60
3663,4,7919,2808,5111,0,0,0,1.0,1,1.0,1,1.0,1,0.14454088410717347,61
3664,0,7919,2808,5111,0,0,0,1.0,1,1.0,1,1.0,1,0.13321624166633156,58
3665,0,7919,2808,5111,0,0,0,1.0,1,1.0,1,1.0,1,0.13321624166633156,58
3666,4,7923,2809,5114,0,0,0,1.0,1,1.0,1,1.0,1,0.0972178467539009,58
3667,5,7928,2811,5117,0,0,0,1.0,1,1.0,1,1.0,1,0.11439055295906819,58
3668,6,7934,2811,5123,0,0,0,1.0,1,1.0,1,1.0,1,0.1062597027808068,58
3669,4,7938,2812,5126,0,0,0,1.0,1,1.0,1,1.0,1,0.12832738912759245,57
3670,2,7940,2813,5127,0,0,0,1.0,1,1.0,1,1.0,1,0.140044179809547,56
3671,5,7945,2814,5131,0,0,0,1.0,1,1.0,1,1.0,1,0.11825068774988219,57
3672,4,7949,2816,5133,0,0,0,1.0,1,1.0,1,1.0,1,0.15059771468391397,57
3673,0,7949,2816,5133,0,0,0,1.0,1,1.0,1,1.0,1,0.1375349744266852,58
3674,0,7949,2816,5133,0,0,0,1.0,1,1.0,1,1.0,1,0.14996395856244857,57
3675,1,7950,2816,5134,0,0,0,1.0,1,1.0,1,1.0,1,0.14082676144689413,58
3676,3,7953,2817,5136,0,0,0,1.0,1,1.0,1,1.0,1,0.14082145010946415,59
3677,3,7956,2818,5138,0,0,0,1.0,1,1.0,1,1.0,1,0.13868860000148572,60
3678,3,7959,2818,5141,0,0,0,1.0,1,1.0,1,1.0,1,0.1189197505366449,62
3679,0,7959,2818,5141,0,0,0,1.0,1,1.0,1,1.0,1,0.1189197505366449,62
3680,0,7959,2818,5141,0,0,0,1.0,1,1.0,1,1.0,1,0.10122925015743132,63
3681,1,7960,2818,5142,0,0,0,1.0,1,1.0,1,1.0,1,0.10210570365644615,64
3682,0,7960,2818,5142,0,0,0,1.0,1,1.0,1,1.0,1,0.10210570365644615,64
3683,0,7960,2818,5142,0,0,0,1.0,1,1.0,1,1.0,1,0.10210570365644615,64
3684,2,7962,2819,5143,0,0,0,1.0,1,1.0,1,1.0,1,0.11939421158174626,64
3685,1,7963,2819,5144,0,0,0,1.0,1,1.0,1,1.0,1,0.1214253342284179,64
3686,0,7963,2819,5144,0,0,0,1.0,1,1.0,1,1.0,1,0.11478915952204102,65
3687,0,7963,2819,5144,0,0,0,1.0,1,1.0,1,1.0,1,0.11478915952204102,65
3688,1,7964,2819,5145,0,0,0,1.0,1,1.0,1,1.0,1,0.12509592045722326,66
3689,0,7964,2819,5145,0,0,0,1.0,1,1.0,1,1.0,1,0.12509592045722326,66
3690,3,7967,2819,5148,0,0,0,1.0,1,1.0,1,1.0,1,0.10968472383944422,67
3691,2,7969,2819,5150,0,0,0,1.0,1,1.0,1,1.0,1,0.08465239009647817,68
3692,1,7970,2819,5151,0,0,0,1.0,1,1.0,1,1.0,1,0.07077754858254247,69
3693,0,7970,2819,5151,0,0,0,1.0,1,1.0,1,1.0,1,0.07851073514296246,69
3694,2,7972,2820,5152,0,0,0,1.0,1,1.0,1,1.0,1,0.09588837434009848,70
3695,1,7973,2820,5153,0,0,0,1.0,1,1.0,1,1.0,1,0.1010041758997668,70
3696,0,7973,2820,5153,0,0,0,1.0,1,1.0,1,1.0,1,0.09025351339710343,71
3697,4,7977,2820,5157,0,0,0,1.0,1,1.0,1,1.0,1,0.07559492825258857,70
3698,1,7978,2820,5158,0,0,0,1.0,1,1.0,1,1.0,1,0.06486057378017428,70
3699,1,7979,2821,5158,0,0,0,1.0,1,1.0,1,1.0,1,0.09659670220647576,70
3700,4,7983,2825,5158,0,0,0,1.0,1,1.0,1,1.0,1,0.10913116202730047,68
3701,5,7988,2828,5160,0,0,0,1.0,1,1.0,1,1.0,1,0.14603181489359593,69
3702,1,7989,2828,5161,0,0,0,1.0,1,1.0,1,1.0,1,0.13395138596714912,69
3703,1,7990,2828,5162,0,0,0,1.0,1,1.0,1,1.0,1,0.14055127906301593,70
3704,2,7992,2829,5163,0,0,0,1.0,1,1.0,1,1.0,1,0.14001783780736501,69
3705,1,7993,2829,5164,0,0,0,1.0,1,1.0,1,1.0,1,0.11009703445976413,69
3706,4,7997,2831,5166,0,0,0,1.0,1,1.0,1,1.0,1,0.12277899796623125,69
3707,0,7997,2831,5166,0,0,0,1.0,1,1.0,1,1.0,1,0.11031529724785985,67
3708,1,7998,2831,5167,0,0,0,1.0,1,1.0,1,1.0,1,0.0955568087453119,67
3709,1,7999,2831,5168,0,0,0,1.0,1,1.0,1,1.0,1,0.0883788546968123,67
3710,0,7999,2831,5168,0,0,0,1.0,1,1.0,1,1.0,1,0.088557805348674,67
3711,2,8001,2831,5170,0,0,0,1.0,1,1.0,1,1.0,1,0.06852532901983609,68
3712,0,8001,2831,5170,0,0,0,1.0,1,1.0,1,1.0,1,0.06852532901983609,68
3713,2,8003,2833,5170,0,0,0,1.0,1,1.0,1,1.0,1,0.08477881477168565,68
3714,0,8003,2833,5170,0,0,0,1.0,1,1.0,1,1.0,1,0.10060703257506119,67
3715,2,8005,2834,5171,0,0,0,1.0,1,1.0,1,1.0,1,0.10330619914873461,68
3716,3,8008,2834,5174,0,0,0,1.0,1,1.0,1,1.0,1,0.08477072941542099,67
3717,2,8010,2834,5176,0,0,0,1.0,1,1.0,1,1.0,1,0.088518488711356,68
3718,0,8010,2834,5176,0,0,0,1.0,1,1.0,1,1.0,1,0.1070865470724485,68
3719,3,8013,2836,5177,0,0,0,1.0,1,1.0,1,1.0,1,0.16660544688515286,68
3720,0,8013,2836,5177,0,0,0,1.0,1,1.0,1,1.0,1,0.16660544688515286,68
3721,6,8019,2838,5181,0,0,0,1.0,1,1.0,1,1.0,1,0.11772413775415021,70
3722,1,8020,2838,5182,0,0,0,1.0,1,1.0,1,1.0,1,0.12613031244694534,71
3723,1,8021,2838,5183,0,0,0,1.0,1,1.0,1,1.0,1,0.11503911746737491,71
3724,0,8021,2838,5183,0,0,0,1.0,1,1.0,1,1.0,1,0.10637431158053699,72
3725,2,8023,2840,5183,0,0,0,1.0,1,1.0,1,1.0,1,0.12490804366680289,72
3726,4,8027,2841,5186,0,0,0,1.0,1,1.0,1,1.0,1,0.10913128446766525,71
3727,1,8028,2842,5186,0,0,0,1.0,1,1.0,1,1.0,1,0.13066679461927572,71
3728,2,8030,2842,5188,0,0,0,1.0,1,1.0,1,1.0,1,0.1221998176704745,70
3729,2,8032,2843,5189,0,0,0,1.0,1,1.0,1,1.0,1,0.11540357822250255,70
3730,2,8034,2844,5190,0,0,0,1.0,1,1.0,1,1.0,1,0.13508947637305793,71
3731,0,8034,2844,5190,0,0,0,1.0,1,1.0,1,1.0,1,0.13508947637305793,71
3732,0,8034,2844,5190,0,0,0,1.0,1,1.0,1,1.0,1,0.12913340551398886,72
3733,0,8034,2844,5190,0,0,0,1.0,1,1.0,1,1.0,1,0.13192904544341633,73
3734,4,8038,2846,5192,0,0,0,1.0,1,1.0,1,1.0,1,0.15531480674924467,74
3735,2,8040,2847,5193,0,0,0,1.0,1,1.0,1,1.0,1,0.1387952917262389,72
3736,1,8041,2847,5194,0,0,0,1.0,1,1.0,1,1.0,1,0.1128896526561758,72
3737,1,8042,2847,5195,0,0,0,1.0,1,1.0,1,1.0,1,0.09973685156886167,73
3738,0,8042,2847,5195,0,0,0,1.0,1,1.0,1,1.0,1,0.11619194606355521,72
3739,1,8043,2847,5196,0,0,0,1.0,1,1.0,1,1.0,1,0.10936400944588605,73
3740,0,8043,2847,5196,0,0,0,1.0,1,1.0,1,1.0,1,0.12212040713299954,70
3741,0,8043,2847,5196,0,0,0,1.0,1,1.0,1,1.0,1,0.12212040713299954,70
3742,1,8044,2848,5196,0,0,0,1.0,1,1.0,1,1.0,1,0.12047509629737191,70
3743,1,8045,2848,5197,0,0,0,1.0,1,1.0,1,1.0,1,0.12177942948924926,69
3744,6,8051,2851,5200,0,0,0,1.0,1,1.0,1,1.0,1,0.1500170214209673,69
3745,3,8054,2852,5202,0,0,0,1.0,1,1.0,1,1.0,1,0.12117566648543651,68
3746,3,8057,2853,5204,0,0,0,1.0,1,1.0,1,1.0,1,0.12276541374542783,66
3747,0,8057,2853,5204,0,0,0,1.0,1,1.0,1,1.0,1,0.12253723341097639,66
3748,3,8060,2853,5207,0,0,0,1.0,1,1.0,1,1.0,1,0.07990391663010603,65
3749,1,8061,2853,5208,0,0,0,1.0,1,1.0,1,1.0,1,0.08643507697480365,64
3750,0,8061,2853,5208,0,0,0,1.0,1,1.0,1,1.0,1,0.09962440917931051,63
3751,1,8062,2853,5209,0,0,0,1.0,1,1.0,1,1.0,1,0.08228675631925318,64
3752,4,8066,2856,5210,0,0,0,1.0,1,1.0,1,1.0,1,0.0943090846834213,64
3753,6,8072,2858,5214,0,0,0,1.0,1,1.0,1,1.0,1,0.11067215983116045,65
3754,4,8076,2861,5215,0,0,0,1.0,1,1.0,1,1.0,1,0.14250494965581578,65
3755,4,8080,2863,5217,0,0,0,1.0,1,1.0,1,1.0,1,0.17890680437860199,65
3756,9,8089,2864,5225,0,0,0,1.0,1,1.0,1,1.0,1,0.14518319599519258,65
3757,5,8094,2864,5230,0,0,0,1.0,1,1.0,1,1.0,1,0.1315410528036977,65
3758,4,8098,2864,5234,0,0,0,1.0,1,1.0,1,1.0,1,0.1412341906389095,64
3759,4,8102,2864,5238,0,0,0,1.0,1,1.0,1,1.0,1,0.14291102064564362,64
3760,4,8106,2864,5242,0,0,0,1.0,1,1.0,1,1.0,1,0.15924256755760016,63
3761,5,8111,2865,5246,0,0,0,1.0,1,1.0,1,1.0,1,0.10687710676220864,63
3762,1,8112,2865,5247,0,0,0,1.0,1,1.0,1,1.0,1,0.11128873830279176,65
3763,3,8115,2866,5249,0,0,0,1.0,1,1.0,1,1.0,1,0.1064641103127319,65
3764,4,8119,2866,5253,0,0,0,1.0,1,1.0,1,1.0,1,0.10055948249416928,66
3765,0,8119,2866,5253,0,0,0,1.0,1,1.0,1,1.0,1,0.1142187043381541,67
3766,3,8122,2867,5255,0,0,0,1.0,1,1.0,1,1.0,1,0.11756359617381555,67
3767,1,8123,2868,5255,0,0,0,1.0,1,1.0,1,1.0,1,0.11868640202979247,68
3768,3,8126,2871,5255,0,0,0,1.0,1,1.0,1,1.0,1,0.17275427078739009,67
3769,6,8132,2871,5261,0,0,0,1.0,1,1.0,1,1.0,1,0.1393780428469888,69
3770,2,8134,2871,5263,0,0,0,1.0,1,1.0,1,1.0,1,0.13219046388026975,69
3771,4,8138,2871,5267,0,0,0,1.0,1,1.0,1,1.0,1,0.09826323874600894,69
3772,1,8139,2871,5268,0,0,0,1.0,1,1.0,1,1.0,1,0.09677876487987055,70
3773,1,8140,2871,5269,0,0,0,1.0,1,1.0,1,1.0,1,0.11327519989652825,68
3774,4,8144,2873,5271,0,0,0,1.0,1,1.0,1,1.0,1,0.11768854434069471,68
3775,2,8146,2874,5272,0,0,0,1.0,1,1.0,1,1.0,1,0.13912348750459605,68
3776,6,8152,2875,5277,0,0,0,1.0,1,1.0,1,1.0,1,0.1104807553089822,66
3777,0,8152,2875,5277,0,0,0,1.0,1,1.0,1,1.0,1,0.10679744523089653,65
3778,0,8152,2875,5277,0,0,0,1.0,1,1.0,1,1.0,1,0.10214968344813999,65
3779,2,8154,2877,5277,0,0,0,1.0,1,1.0,1,1.0,1,0.12485588917879202,65
3780,2,8156,2879,5277,0,0,0,1.0,1,1.0,1,1.0,1,0.139360956877258,64
3781,3,8159,2879,5280,0,0,0,1.0,1,1.0,1,1.0,1,0.11163798321146508,64
3782,2,8161,2879,5282,0,0,0,1.0,1,1.0,1,1.0,1,0.09606225447511553,67
3783,1,8162,2880,5282,0,0,0,1.0,1,1.0,1,1.0,1,0.0928712277251957,65
3784,2,8164,2881,5283,0,0,0,1.0,1,1.0,1,1.0,1,0.09233527596030043,65
3785,3,8167,2883,5284,0,0,0,1.0,1,1.0,1,1.0,1,0.13957626701712236,63
3786,3,8170,2883,5287,0,0,0,1.0,1,1.0,1,1.0,1,0.10888465514444694,66
3787,2,8172,2884,5288,0,0,0,1.0,1,1.0,1,1.0,1,0.1317543509583819,65
3788,3,8175,2885,5290,0,0,0,1.0,1,1.0,1,1.0,1,0.12086895360252718,65
3789,5,8180,2887,5293,0,0,0,1.0,1,1.0,1,1.0,1,0.14718207404207465,65
3790,0,8180,2887,5293,0,0,0,1.0,1,1.0,1,1.0,1,0.1537588296836154,64
3791,2,8182,2889,5293,0,0,0,1.0,1,1.0,1,1.0,1,0.1703867921795782,64
3792,2,8184,2890,5294,0,0,0,1.0,1,1.0,1,1.0,1,0.1640381336031559,65
3793,5,8189,2891,5298,0,0,0,1.0,1,1.0,1,1.0,1,0.17280400371166402,68
3794,4,8193,2892,5301,0,0,0,1.0,1,1.0,1,1.0,1,0.17028372391845759,68
3795,3,8196,2892,5304,0,0,0,1.0,1,1.0,1,1.0,1,0.1355638904731716,69
3796,2,8198,2892,5306,0,0,0,1.0,1,1.0,1,1.0,1,0.11881060701020787,69
3797,2,8200,2892,5308,0,0,0,1.0,1,1.0,1,1.0,1,0.13052201715648834,70
3798,0,8200,2892,5308,0,0,0,1.0,1,1.0,1,1.0,1,0.13052201715648834,70
3799,1,8201,2892,5309,0,0,0,1.0,1,1.0,1,1.0,1,0.1314346311896136,69
3800,1,8202,2892,5310,0,0,0,1.0,1,1.0,1,1.0,1,0.10948717045066647,69
3801,1,8203,2892,5311,0,0,0,1.0,1,1.0,1,1.0,1,0.11227432887770233,67
3802,3,8206,2893,5313,0,0,0,1.0,1,1.0,1,1.0,1,0.10711792631843454,67
3803,3,8209,2893,5316,0,0,0,1.0,1,1.0,1,1.0,1,0.1010407919163472,69
3804,2,8211,2893,5318,0,0,0,1.0,1,1.0,1,1.0,1,0.09077364996239312,70
3805,3,8214,2894,5320,0,0,0,1.0,1,1.0,1,1.0,1,0.10144219383299434,71
3806,0,8214,2894,5320,0,0,0,1.0,1,1.0,1,1.0,1,0.10144219383299434,71
3807,2,8216,2895,5321,0,0,0,1.0,1,1.0,1,1.0,1,0.11197061037777128,72
3808,1,8217,2895,5322,0,0,0,1.0,1,1.0,1,1.0,1,0.10999845545369659,72
3809,1,8218,2896,5322,0,0,0,1.0,1,1.0,1,1.0,1,0.1241442615963084,72
3810,4,8222,2898,5324,0,0,0,1.0,1,1.0,1,1.0,1,0.1562286390276435,72
3811,3,8225,2898,5327,0,0,0,1.0,1,1.0,1,1.0,1,0.13036130859812375,71
3812,1,8226,2898,5328,0,0,0,1.0,1,1.0,1,1.0,1,0.12116282640426825,72
3813,0,8226,2898,5328,0,0,0,1.0,1,1.0,1,1.0,1,0.16522438546726967,71
3814,1,8227,2899,5328,0,0,0,1.0,1,1.0,1,1.0,1,0.16596254755586812,72
3815,1,8228,2899,5329,0,0,0,1.0,1,1.0,1,1.0,1,0.16083847414295502,71
3816,4,8232,2900,5332,0,0,0,1.0,1,1.0,1,1.0,1,0.16343986203440117,69
3817,6,8238,2902,5336,0,0,0,1.0,1,1.0,1,1.0,1,0.1728509885352601,72
3818,4,8242,2902,5340,0,0,0,1.0,1,1.0,1,1.0,1,0.15716509574431764,72
3819,2,8244,2903,5341,0,0,0,1.0,1,1.0,1,1.0,1,0.1781767931779816,72
3820,3,8247,2903,5344,0,0,0,1.0,1,1.0,1,1.0,1,0.16904140815030289,72
3821,4,8251,2904,5347,0,0,0,1.0,1,1.0,1,1.0,1,0.17373073137749467,72
3822,0,8251,2904,5347,0,0,0,1.0,1,1.0,1,1.0,1,0.17109272975392353,69
3823,4,8255,2906,5349,0,0,0,1.0,1,1.0,1,1.0,1,0.1740146109560151,69
3824,2,8257,2907,5350,0,0,0,1.0,1,1.0,1,1.0,1,0.17320586882036107,65
3825,1,8258,2908,5350,0,0,0,1.0,1,1.0,1,1.0,1,0.1743327552768496,64
3826,4,8262,2908,5354,0,0,0,1.0,1,1.0,1,1.0,1,0.15875038356082732,65
3827,1,8263,2908,5355,0,0,0,1.0,1,1.0,1,1.0,1,0.1583538352320797,64
3828,2,8265,2909,5356,0,0,0,1.0,1,1.0,1,1.0,1,0.12084955858120783,65
3829,7,8272,2912,5360,0,0,0,1.0,1,1.0,1,1.0,1,0.11221822432402234,65
3830,0,8272,2912,5360,0,0,0,1.0,1,1.0,1,1.0,1,0.12558435159761708,64
3831,6,8278,2913,5365,0,0,0,1.0,1,1.0,1,1.0,1,0.129820640883075,63
3832,2,8280,2914,5366,0,0,0,1.0,1,1.0,1,1.0,1,0.125613197948156,64
3833,6,8286,2916,5370,0,0,0,1.0,1,1.0,1,1.0,1,0.13463923728089802,64
3834,3,8289,2918,5371,0,0,0,1.0,1,1.0,1,1.0,1,0.17630437031950438,63
3835,4,8293,2919,5374,0,0,0,1.0,1,1.0,1,1.0,1,0.1535411974831686,63
3836,2,8295,2920,5375,0,0,0,1.0,1,1.0,1,1.0,1,0.13327761437020935,63
3837,3,8298,2922,5376,0,0,0,1.0,1,1.0,1,1.0,1,0.16432925166940632,62
3838,2,8300,2923,5377,0,0,0,1.0,1,1.0,1,1.0,1,0.16754252881601386,62
3839,5,8305,2925,5380,0,0,0,1.0,1,1.0,1,1.0,1,0.17203944415411104,60
3840,2,8307,2925,5382,0,0,0,1.0,1,1.0,1,1.0,1,0.19549840096282908,62
3841,6,8313,2926,5387,0,0,0,1.0,1,1.0,1,1.0,1,0.15907355384066346,62
3842,0,8313,2926,5387,0,0,0,1.0,1,1.0,1,1.0,1,0.14226255374735614,63
3843,1,8314,2926,5388,0,0,0,1.0,1,1.0,1,1.0,1,0.14383075553412403,64
3844,2,8316,2926,5390,0,0,0,1.0,1,1.0,1,1.0,1,0.13517416254587183,65
3845,5,8321,2926,5395,0,0,0,1.0,1,1.0,1,1.0,1,0.11009978656612342,66
3846,4,8325,2926,5399,0,0,0,1.0,1,1.0,1,1.0,1,0.11522752171244523,67
3847,1,8326,2926,5400,0,0,0,1.0,1,1.0,1,1.0,1,0.11303102985546637,67
3848,3,8329,2927,5402,0,0,0,1.0,1,1.0,1,1.0,1,0.0890495877712856,67
3849,2,8331,2927,5404,0,0,0,1.0,1,1.0,1,1.0,1,0.1096464347926795,67
3850,4,8335,2929,5406,0,0,0,1.0,1,1.0,1,1.0,1,0.08661128844055435,68
3851,0,8335,2929,5406,0,0,0,1.0,1,1.0,1,1.0,1,0.08661128844055435,68
3852,3,8338,2930,5408,0,0,0,1.0,1,1.0,1,1.0,1,0.09896356029914095,70
3853,1,8339,2931,5408,0,0,0,1.0,1,1.0,1,1.0,1,0.11250237108575634,70
3854,0,8339,2931,5408,0,0,0,1.0,1,1.0,1,1.0,1,0.11250237108575634,70
3855,0,8339,2931,5408,0,0,0,1.0,1,1.0,1,1.0,1,0.1172868688030079,69
3856,7,8346,2933,5413,0,0,0,1.0,1,1.0,1,1.0,1,0.11475086316882178,70
3857,2,8348,2935,5413,0,0,0,1.0,1,1.0,1,1.0,1,0.14994685999535057,68
3858,3,8351,2936,5415,0,0,0,1.0,1,1.0,1,1.0,1,0.14687154045579706,67
3859,1,8352,2936,5416,0,0,0,1.0,1,1.0,1,1.0,1,0.14328995396740846,66
3860,4,8356,2937,5419,0,0,0,1.0,1,1.0,1,1.0,1,0.1529668930480233,66
3861,2,8358,2937,5421,0,0,0,1.0,1,1.0,1,1.0,1,0.14495910070960794,66
3862,4,8362,2939,5423,0,0,0,1.0,1,1.0,1,1.0,1,0.15681391616478702,66
3863,2,8364,2939,5425,0,0,0,1.0,1,1.0,1,1.0,1,0.12975844972973669,63
3864,5,8369,2942,5427,0,0,0,1.0,1,1.0,1,1.0,1,0.13097158474418524,63
3865,1,8370,2943,5427,0,0,0,1.0,1,1.0,1,1.0,1,0.12337423407946935,61
3866,3,8373,2944,5429,0,0,0,1.0,1,1.0,1,1.0,1,0.10969394744137874,61
3867,1,8374,2945,5429,0,0,0,1.0,1,1.0,1,1.0,1,0.1103197877156481,60
3868,2,8376,2947,5429,0,0,0,1.0,1,1.0,1,1.0,1,0.13388736943175406,59
3869,2,8378,2948,5430,0,0,0,1.0,1,1.0,1,1.0,1,0.12652058408535902,61
3870,2,8380,2948,5432,0,0,0,1.0,1,1.0,1,1.0,1,0.10162874469828487,61
3871,3,8383,2948,5435,0,0,0,1.0,1,1.0,1,1.0,1,0.09611399478368056,64
3872,1,8384,2948,5436,0,0,0,1.0,1,1.0,1,1.0,1,0.0826207796174453,63
3873,0,8384,2948,5436,0,0,0,1.0,1,1.0,1,1.0,1,0.0968663279903404,62
3874,2,8386,2949,5437,0,0,0,1.0,1,1.0,1,1.0,1,0.0946640869662668,63
3875,3,8389,2951,5438,0,0,0,1.0,1,1.0,1,1.0,1,0.100742979355044,61
3876,5,8394,2951,5443,0,0,0,1.0,1,1.0,1,1.0,1,0.0645886971674519,62
3877,0,8394,2951,5443,0,0,0,1.0,1,1.0,1,1.0,1,0.08765172623386891,63
3878,1,8395,2952,5443,0,0,0,1.0,1,1.0,1,1.0,1,0.1103185271986984,63
3879,2,8397,2953,5444,0,0,0,1.0,1,1.0,1,1.0,1,0.09969472257575725,63
3880,2,8399,2955,5444,0,0,0,1.0,1,1.0,1,1.0,1,0.1324772138896153,65
3881,6,8405,2956,5449,0,0,0,1.0,1,1.0,1,1.0,1,0.10184023586729421,65
3882,0,8405,2956,5449,0,0,0,1.0,1,1.0,1,1.0,1,0.0915203856361119,66
3883,0,8405,2956,5449,0,0,0,1.0,1,1.0,1,1.0,1,0.0915203856361119,66
3884,0,8405,2956,5449,0,0,0,1.0,1,1.0,1,1.0,1,0.0915203856361119,66
3885,1,8406,2957,5449,0,0,0,1.0,1,1.0,1,1.0,1,0.11253483111712421,66
3886,3,8409,2959,5450,0,0,0,1.0,1,1.0,1,1.0,1,0.12361530379990802,65
3887,2,8411,2959,5452,0,0,0,1.0,1,1.0,1,1.0,1,0.10154846884282408,65
3888,1,8412,2960,5452,0,0,0,1.0,1,1.0,1,1.0,1,0.12251568797975733,66
3889,1,8413,2960,5453,0,0,0,1.0,1,1.0,1,1.0,1,0.1161884254822892,64
3890,2,8415,2962,5453,0,0,0,1.0,1,1.0,1,1.0,1,0.1279299634698758,63
3891,5,8420,2963,5457,0,0,0,1.0,1,1.0,1,1.0,1,0.10948422582639454,66
3892,4,8424,2963,5461,0,0,0,1.0,1,1.0,1,1.0,1,0.08596757509544799,67
3893,3,8427,2964,5463,0,0,0,1.0,1,1.0,1,1.0,1,0.09581756574037366,66
3894,3,8430,2964,5466,0,0,0,1.0,1,1.0,1,1.0,1,0.11453760306785635,67
3895,3,8433,2964,5469,0,0,0,1.0,1,1.0,1,1.0,1,0.11861031459835214,66
3896,1,8434,2964,5470,0,0,0,1.0,1,1.0,1,1.0,1,0.10662117930174914,66
3897,1,8435,2964,5471,0,0,0,1.0,1,1.0,1,1.0,1,0.10511155549376996,65
3898,6,8441,2968,5473,0,0,0,1.0,1,1.0,1,1.0,1,0.13020760258199932,65
3899,1,8442,2969,5473,0,0,0,1.0,1,1.0,1,1.0,1,0.12930725527641626,64
3900,2,8444,2970,5474,0,0,0,1.0,1,1.0,1,1.0,1,0.1516430107715467,63
3901,5,8449,2974,5475,0,0,0,1.0,1,1.0,1,1.0,1,0.12208929618343657,63
3902,2,8451,2974,5477,0,0,0,1.0,1,1.0,1,1.0,1,0.1202725167898119,64
3903,0,8451,2974,5477,0,0,0,1.0,1,1.0,1,1.0,1,0.1202725167898119,64
3904,2,8453,2976,5477,0,0,0,1.0,1,1.0,1,1.0,1,0.11161640462068408,63
3905,0,8453,2976,5477,0,0,0,1.0,1,1.0,1,1.0,1,0.12797493664698842,63
3906,3,8456,2978,5478,0,0,0,1.0,1,1.0,1,1.0,1,0.1204706791257585,64
3907,4,8460,2980,5480,0,0,0,1.0,1,1.0,1,1.0,1,0.13965328079164405,64
3908,1,8461,2980,5481,0,0,0,1.0,1,1.0,1,1.0,1,0.1308792261173694,63
3909,1,8462,2981,5481,0,0,0,1.0,1,1.0,1,1.0,1,0.13576475380020062,62
3910,0,8462,2981,5481,0,0,0,1.0,1,1.0,1,1.0,1,0.1502530615974407,62
3911,7,8469,2982,5487,0,0,0,1.0,1,1.0,1,1.0,1,0.1336380820110002,64
3912,5,8474,2983,5491,0,0,0,1.0,1,1.0,1,1.0,1,0.11134280360359676,64
3913,1,8475,2983,5492,0,0,0,1.0,1,1.0,1,1.0,1,0.10646710499853337,65
3914,1,8476,2983,5493,0,0,0,1.0,1,1.0,1,1.0,1,0.12490986379609163,65
3915,0,8476,2983,5493,0,0,0,1.0,1,1.0,1,1.0,1,0.11909439712808699,66
3916,4,8480,2984,5496,0,0,0,1.0,1,1.0,1,1.0,1,0.10381055270866585,66
3917,1,8481,2984,5497,0,0,0,1.0,1,1.0,1,1.0,1,0.0971830908834047,66
3918,1,8482,2984,5498,0,0,0,1.0,1,1.0,1,1.0,1,0.09805914490574989,67
3919,2,8484,2985,5499,0,0,0,1.0,1,1.0,1,1.0,1,0.09711472018686468,68
3920,0,8484,2985,5499,0,0,0,1.0,1,1.0,1,1.0,1,0.09485632289290263,69
3921,1,8485,2985,5500,0,0,0,1.0,1,1.0,1,1.0,1,0.09467422001832765,68
3922,3,8488,2988,5500,0,0,0,1.0,1,1.0,1,1.0,1,0.14500875804499633,68
3923,2,8490,2988,5502,0,0,0,1.0,1,1.0,1,1.0,1,0.14872125431662342,69
3924,2,8492,2989,5503,0,0,0,1.0,1,1.0,1,1.0,1,0.16076153375433444,69
3925,4,8496,2991,5505,0,0,0,1.0,1,1.0,1,1.0,1,0.17690565199542213,67
3926,5,8501,2991,5510,0,0,0,1.0,1,1.0,1,1.0,1,0.13286084682835186,67
3927,2,8503,2991,5512,0,0,0,1.0,1,1.0,1,1.0,1,0.14355012767636835,65
3928,3,8506,2993,5513,0,0,0,1.0,1,1.0,1,1.0,1,0.1451945650347862,65
3929,1,8507,2994,5513,0,0,0,1.0,1,1.0,1,1.0,1,0.15309071419600462,64
3930,0,8507,2994,5513,0,0,0,1.0,1,1.0,1,1.0,1,0.1715683240556224,64
3931,2,8509,2994,5515,0,0,0,1.0,1,1.0,1,1.0,1,0.15634008480589873,62
3932,1,8510,2994,5516,0,0,0,1.0,1,1.0,1,1.0,1,0.14574080048409327,62
3933,1,8511,2994,5517,0,0,0,1.0,1,1.0,1,1.0,1,0.14064020903713262,62
3934,1,8512,2994,5518,0,0,0,1.0,1,1.0,1,1.0,1,0.1192537098444996,61
3935,2,8514,2995,5519,0,0,0,1.0,1,1.0,1,1.0,1,0.13514298476238987,64
3936,2,8516,2996,5520,0,0,0,1.0,1,1.0,1,1.0,1,0.16364137820315008,65
3937,4,8520,2997,5523,0,0,0,1.0,1,1.0,1,1.0,1,0.1772944065271578,66
3938,3,8523,2998,5525,0,0,0,1.0,1,1.0,1,1.0,1,0.19011162283550131,66
3939,3,8526,2998,5528,0,0,0,1.0,1,1.0,1,1.0,1,0.17375574409526873,67
3940,2,8528,2999,5529,0,0,0,1.0,1,1.0,1,1.0,1,0.17920316000634057,69
3941,9,8537,2999,5538,0,0,0,1.0,1,1.0,1,1.0,1,0.12211901003042219,69
3942,7,8544,3000,5544,0,0,0,1.0,1,1.0,1,1.0,1,0.12281806855904041,69
3943,5,8549,3001,5548,0,0,0,1.0,1,1.0,1,1.0,1,0.12937246692071327,68
3944,2,8551,3001,5550,0,0,0,1.0,1,1.0,1,1.0,1,0.1411176752577806,68
3945,4,8555,3003,5552,0,0,0,1.0,1,1.0,1,1.0,1,0.16692183594145726,67
3946,5,8560,3004,5556,0,0,0,1.0,1,1.0,1,1.0,1,0.13784040933692626,67
3947,1,8561,3004,5557,0,0,0,1.0,1,1.0,1,1.0,1,0.14035781779405904,66
3948,1,8562,3005,5557,0,0,0,1.0,1,1.0,1,1.0,1,0.15442051297287346,67
3949,5,8567,3007,5560,0,0,0,1.0,1,1.0,1,1.0,1,0.18811078803501718,66
3950,1,8568,3007,5561,0,0,0,1.0,1,1.0,1,1.0,1,0.18217698693728898,65
3951,11,8579,3007,5572,0,0,0,1.0,1,1.0,1,1.0,1,0.1286152938164286,65
3952,2,8581,3008,5573,0,0,0,1.0,1,1.0,1,1.0,1,0.13073606618577138,65
3953,2,8583,3008,5575,0,0,0,1.0,1,1.0,1,1.0,1,0.14479063640657505,65
3954,3,8586,3008,5578,0,0,0,1.0,1,1.0,1,1.0,1,0.1423626574455058,64
3955,0,8586,3008,5578,0,0,0,1.0,1,1.0,1,1.0,1,0.16762879193279415,64
3956,3,8589,3009,5580,0,0,0,1.0,1,1.0,1,1.0,1,0.14564537084663856,63
3957,0,8589,3009,5580,0,0,0,1.0,1,1.0,1,1.0,1,0.14564537084663856,63
3958,0,8589,3009,5580,0,0,0,1.0,1,1.0,1,1.0,1,0.1561525089088997,63
3959,0,8589,3009,5580,0,0,0,1.0,1,1.0,1,1.0,1,0.16004216891306516,62
3960,0,8589,3009,5580,0,0,0,1.0,1,1.0,1,1.0,1,0.16004216891306516,62
3961,6,8595,3011,5584,0,0,0,1.0,1,1.0,1,1.0,1,0.10575734178449311,64
3962,0,8595,3011,5584,0,0,0,1.0,1,1.0,1,1.0,1,0.10575734178449311,64
3963,3,8598,3012,5586,0,0,0,1.0,1,1.0,1,1.0,1,0.10898771975048048,62
3964,2,8600,3013,5587,0,0,0,1.0,1,1.0,1,1.0,1,0.12120145791537161,63
3965,1,8601,3013,5588,0,0,0,1.0,1,1.0,1,1.0,1,0.11833424348814653,63
3966,3,8604,3014,5590,0,0,0,1.0,1,1.0,1,1.0,1,0.13275207922321006,62
3967,2,8606,3014,5592,0,0,0,1.0,1,1.0,1,1.0,1,0.14661658307682454,64
3968,5,8611,3015,5596,0,0,0,1.0,1,1.0,1,1.0,1,0.1488179503806734,63
3969,3,8614,3016,5598,0,0,0,1.0,1,1.0,1,1.0,1,0.15305877984681976,63
3970,3,8617,3016,5601,0,0,0,1.0,1,1.0,1,1.0,1,0.13094256790287948,65
3971,2,8619,3016,5603,0,0,0,1.0,1,1.0,1,1.0,1,0.10916248450994152,65
3972,2,8621,3017,5604,0,0,0,1.0,1,1.0,1,1.0,1,0.10341656693267152,66
3973,1,8622,3018,5604,0,0,0,1.0,1,1.0,1,1.0,1,0.10903754870376882,66
3974,2,8624,3020,5604,0,0,0,1.0,1,1.0,1,1.0,1,0.14231271526705744,66
3975,2,8626,3021,5605,0,0,0,1.0,1,1.0,1,1.0,1,0.13271729708527844,66
3976,4,8630,3022,5608,0,0,0,1.0,1,1.0,1,1.0,1,0.13070046762812276,66
3977,1,8631,3023,5608,0,0,0,1.0,1,1.0,1,1.0,1,0.13503201528651337,64
3978,2,8633,3024,5609,0,0,0,1.0,1,1.0,1,1.0,1,0.15111187771884643,63
3979,4,8637,3025,5612,0,0,0,1.0,1,1.0,1,1.0,1,0.18080737705932443,63
3980,4,8641,3026,5615,0,0,0,1.0,1,1.0,1,1.0,1,0.1620429721109596,63
3981,7,8648,3027,5621,0,0,0,1.0,1,1.0,1,1.0,1,0.11687307994993724,64
3982,4,8652,3028,5624,0,0,0,1.0,1,1.0,1,1.0,1,0.12610310678270267,65
3983,2,8654,3028,5626,0,0,0,1.0,1,1.0,1,1.0,1,0.09386448809346244,64
3984,2,8656,3029,5627,0,0,0,1.0,1,1.0,1,1.0,1,0.09492883159233305,65
3985,3,8659,3032,5627,0,0,0,1.0,1,1.0,1,1.0,1,0.1198258569373553,64
3986,2,8661,3032,5629,0,0,0,1.0,1,1.0,1,1.0,1,0.10923705289960507,63
3987,1,8662,3033,5629,0,0,0,1.0,1,1.0,1,1.0,1,0.11533611897234548,63
3988,2,8664,3033,5631,0,0,0,1.0,1,1.0,1,1.0,1,0.08143021552080296,63
3989,1,8665,3034,5631,0,0,0,1.0,1,1.0,1,1.0,1,0.09703473639363706,63
3990,1,8666,3035,5631,0,0,0,1.0,1,1.0,1,1.0,1,0.11818023485704487,62
3991,3,8669,3035,5634,0,0,0,1.0,1,1.0,1,1.0,1,0.08170074780995906,62
3992,4,8673,3035,5638,0,0,0,1.0,1,1.0,1,1.0,1,0.06253364268948122,65
3993,2,8675,3036,5639,0,0,0,1.0,1,1.0,1,1.0,1,0.07469958679915835,65
3994,4,8679,3037,5642,0,0,0,1.0,1,1.0,1,1.0,1,0.08503521382216106,64
3995,4,8683,3037,5646,0,0,0,1.0,1,1.0,1,1.0,1,0.08375455616819896,64
3996,4,8687,3037,5650,0,0,0,1.0,1,1.0,1,1.0,1,0.06884403983683102,67
3997,0,8687,3037,5650,0,0,0,1.0,1,1.0,1,1.0,1,0.07038491803048331,69
3998,1,8688,3038,5650,0,0,0,1.0,1,1.0,1,1.0,1,0.08221972585822765,69
3999,1,8689,3039,5650,0,0,0,1.0,1,1.0,1,1.0,1,0.0747333341062286,69
4000,1,8690,3039,5651,0,0,0,1.0,1,1.0,1,1.0,1,0.0726267696245872,69
4001,1,8691,3039,5652,0,0,0,1.0,1,1.0,1,1.0,1,0.058425367149101126,68
4002,2,8693,3040,5653,0,0,0,1.0,1,1.0,1,1.0,1,0.08590792515135316,68
4003,3,8696,3042,5654,0,0,0,1.0,1,1.0,1,1.0,1,0.112305930408589,68
4004,4,8700,3044,5656,0,0,0,1.0,1,1.0,1,1.0,1,0.1297379731517537,67
4005,2,8702,3044,5658,0,0,0,1.0,1,1.0,1,1.0,1,0.1297379731517537,67
4006,6,8708,3046,5662,0,0,0,1.0,1,1.0,1,1.0,1,0.08085233493972675,67
4007,0,8708,3046,5662,0,0,0,1.0,1,1.0,1,1.0,1,0.08085233493972675,67
4008,7,8715,3050,5665,0,0,0,1.0,1,1.0,1,1.0,1,0.111988855290046,67
4009,2,8717,3051,5666,0,0,0,1.0,1,1.0,1,1.0,1,0.12197352707764324,67
4010,3,8720,3052,5668,0,0,0,1.0,1,1.0,1,1.0,1,0.16407027773582064,66
4011,5,8725,3053,5672,0,0,0,1.0,1,1.0,1,1.0,1,0.12034841168698687,66
4012,2,8727,3054,5673,0,0,0,1.0,1,1.0,1,1.0,1,0.14595798783427982,66
4013,1,8728,3055,5673,0,0,0,1.0,1,1.0,1,1.0,1,0.14780549540654767,66
4014,3,8731,3058,5673,0,0,0,1.0,1,1.0,1,1.0,1,0.17587599631417294,66
4015,0,8731,3058,5673,0,0,0,1.0,1,1.0,1,1.0,1,0.1972589542747421,64
4016,6,8737,3059,5678,0,0,0,1.0,1,1.0,1,1.0,1,0.20305197214706727,64
4017,3,8740,3059,5681,0,0,0,1.0,1,1.0,1,1.0,1,0.1781832104870056,66
4018,1,8741,3059,5682,0,0,0,1.0,1,1.0,1,1.0,1,0.17829583263636184,67
4019,2,8743,3061,5682,0,0,0,1.0,1,1.0,1,1.0,1,0.20984623553710988,67
4020,0,8743,3061,5682,0,0,0,1.0,1,1.0,1,1.0,1,0.22435474566156913,66
4021,4,8747,3063,5684,0,0,0,1.0,1,1.0,1,1.0,1,0.22302020774838113,66
4022,2,8749,3063,5686,0,0,0,1.0,1,1.0,1,1.0,1,0.22443277862563532,66
4023,4,8753,3066,5687,0,0,0,1.0,1,1.0,1,1.0,1,0.21751346872221436,66
4024,1,8754,3066,5688,0,0,0,1.0,1,1.0,1,1.0,1,0.23021511785175483,66
4025,1,8755,3067,5688,0,0,0,1.0,1,1.0,1,1.0,1,0.22949148869396252,66
4026,10,8765,3069,5696,0,0,0,1.0,1,1.0,1,1.0,1,0.17778330166589895,66
4027,2,8767,3070,5697,0,0,0,1.0,1,1.0,1,1.0,1,0.17146690961175673,64
4028,6,8773,3072,5701,0,0,0,1.0,1,1.0,1,1.0,1,0.19995050235681047,63
4029,2,8775,3072,5703,0,0,0,1.0,1,1.0,1,1.0,1,0.17313740801375954,62
4030,6,8781,3073,5708,0,0,0,1.0,1,1.0,1,1.0,1,0.17787943845204898,63
4031,3,8784,3074,5710,0,0,0,1.0,1,1.0,1,1.0,1,0.1604837554013121,62
4032,2,8786,3076,5710,0,0,0,1.0,1,1.0,1,1.0,1,0.18567336492776618,62
4033,6,8792,3077,5715,0,0,0,1.0,1,1.0,1,1.0,1,0.16894329222822346,61
4034,2,8794,3078,5716,0,0,0,1.0,1,1.0,1,1.0,1,0.18307851943181086,60
4035,1,8795,3079,5716,0,0,0,1.0,1,1.0,1,1.0,1,0.2001462761373989,59
4036,6,8801,3082,5719,0,0,0,1.0,1,1.0,1,1.0,1,0.1558247193488074,58
4037,5,8806,3084,5722,0,0,0,1.0,1,1.0,1,1.0,1,0.13223616131548757,59
4038,5,8811,3085,5726,0,0,0,1.0,1,1.0,1,1.0,1,0.14332559567147893,58
4039,4,8815,3087,5728,0,0,0,1.0,1,1.0,1,1.0,1,0.19937088760205215,56
4040,1,8816,3087,5729,0,0,0,1.0,1,1.0,1,1.0,1,0.2245980500332823,55
4041,3,8819,3088,5731,0,0,0,1.0,1,1.0,1,1.0,1,0.21474738617495842,54
4042,4,8823,3089,5734,0,0,0,1.0,1,1.0,1,1.0,1,0.20381117186885553,56
4043,4,8827,3091,5736,0,0,0,1.0,1,1.0,1,1.0,1,0.23865265124649118,56
4044,3,8830,3092,5738,0,0,0,1.0,1,1.0,1,1.0,1,0.2889065937295109,56
4045,4,8834,3093,5741,0,0,0,1.0,1,1.0,1,1.0,1,0.27234826677919816,57
4046,2,8836,3093,5743,0,0,0,1.0,1,1.0,1,1.0,1,0.2588916931231727,59
4047,2,8838,3094,5744,0,0,0,1.0,1,1.0,1,1.0,1,0.26414352198949925,59
4048,1,8839,3094,5745,0,0,0,1.0,1,1.0,1,1.0,1,0.25836975840512894,59
4049,1,8840,3094,5746,0,0,0,1.0,1,1.0,1,1.0,1,0.2441595426806472,60
4050,1,8841,3094,5747,0,0,0,1.0,1,1.0,1,1.0,1,0.2387924756659526,60
4051,1,8842,3094,5748,0,0,0,1.0,1,1.0,1,1.0,1,0.23212614998605588,60
4052,0,8842,3094,5748,0,0,0,1.0,1,1.0,1,1.0,1,0.23212614998605588,60
4053,0,8842,3094,5748,0,0,0,1.0,1,1.0,1,1.0,1,0.23212614998605588,60
4054,1,8843,3095,5748,0,0,0,1.0,1,1.0,1,1.0,1,0.2333870158824362,61
4055,1,8844,3095,5749,0,0,0,1.0,1,1.0,1,1.0,1,0.21986041760359623,61
4056,1,8845,3095,5750,0,0,0,1.0,1,1.0,1,1.0,1,0.22549794970762593,62
4057,0,8845,3095,5750,0,0,0,1.0,1,1.0,1,1.0,1,0.22946664725556884,63
4058,3,8848,3095,5753,0,0,0,1.0,1,1.0,1,1.0,1,0.22583297780745842,64
4059,0,8848,3095,5753,0,0,0,1.0,1,1.0,1,1.0,1,0.24056577660918824,63
4060,0,8848,3095,5753,0,0,0,1.0,1,1.0,1,1.0,1,0.24056577660918824,63
4061,1,8849,3095,5754,0,0,0,1.0,1,1.0,1,1.0,1,0.23973447370197457,63
4062,1,8850,3096,5754,0,0,0,1.0,1,1.0,1,1.0,1,0.23172584900654444,65
4063,1,8851,3096,5755,0,0,0,1.0,1,1.0,1,1.0,1,0.19577371579644817,64
4064,3,8854,3098,5756,0,0,0,1.0,1,1.0,1,1.0,1,0.19787588259009004,65
4065,2,8856,3099,5757,0,0,0,1.0,1,1.0,1,1.0,1,0.17325677886081944,64
4066,5,8861,3101,5760,0,0,0,1.0,1,1.0,1,1.0,1,0.15957515750138515,64
4067,6,8867,3105,5762,0,0,0,1.0,1,1.0,1,1.0,1,0.18501177090452273,63
4068,5,8872,3106,5766,0,0,0,1.0,1,1.0,1,1.0,1,0.171089741149046,64
4069,3,8875,3107,5768,0,0,0,1.0,1,1.0,1,1.0,1,0.1767748568501352,62
4070,2,8877,3109,5768,0,0,0,1.0,1,1.0,1,1.0,1,0.17758895160590618,61
4071,9,8886,3111,5775,0,0,0,1.0,1,1.0,1,1.0,1,0.14502627694452774,61
4072,7,8893,3114,5779,0,0,0,1.0,1,1.0,1,1.0,1,0.14216093578249903,60
4073,7,8900,3115,5785,0,0,0,1.0,1,1.0,1,1.0,1,0.13083896702900571,60
4074,6,8906,3119,5787,0,0,0,1.0,1,1.0,1,1.0,1,0.20095101357557732,60
4075,3,8909,3120,5789,0,0,0,1.0,1,1.0,1,1.0,1,0.15781571168098188,59
4076,5,8914,3120,5794,0,0,0,1.0,1,1.0,1,1.0,1,0.1134810030468983,60
4077,1,8915,3120,5795,0,0,0,1.0,1,1.0,1,1.0,1,0.11680034219492783,61
4078,0,8915,3120,5795,0,0,0,1.0,1,1.0,1,1.0,1,0.13313160362541088,60
4079,0,8915,3120,5795,0,0,0,1.0,1,1.0,1,1.0,1,0.16395849119221986,58
4080,1,8916,3121,5795,0,0,0,1.0,1,1.0,1,1.0,1,0.18076808945510847,56
4081,3,8919,3121,5798,0,0,0,1.0,1,1.0,1,1.0,1,0.15779674302806113,56
4082,0,8919,3121,5798,0,0,0,1.0,1,1.0,1,1.0,1,0.18213873736440148,55
4083,1,8920,3122,5798,0,0,0,1.0,1,1.0,1,1.0,1,0.20282728839591083,55
4084,2,8922,3123,5799,0,0,0,1.0,1,1.0,1,1.0,1,0.21428788051691544,55
4085,3,8925,3123,5802,0,0,0,1.0,1,1.0,1,1.0,1,0.17021552785586982,56
4086,5,8930,3124,5806,0,0,0,1.0,1,1.0,1,1.0,1,0.11762109698551093,57
4087,2,8932,3125,5807,0,0,0,1.0,1,1.0,1,1.0,1,0.1526398226107046,57
4088,0,8932,3125,5807,0,0,0,1.0,1,1.0,1,1.0,1,0.1649120319908172,57
4089,1,8933,3125,5808,0,0,0,1.0,1,1.0,1,1.0,1,0.1785289464157093,56
4090,1,8934,3125,5809,0,0,0,1.0,1,1.0,1,1.0,1,0.1855675373262131,56
4091,2,8936,3125,5811,0,0,0,1.0,1,1.0,1,1.0,1,0.1961065189187608,56
4092,2,8938,3125,5813,0,0,0,1.0,1,1.0,1,1.0,1,0.15897632471593987,57
4093,3,8941,3126,5815,0,0,0,1.0,1,1.0,1,1.0,1,0.13338631507178322,58
4094,4,8945,3127,5818,0,0,0,1.0,1,1.0,1,1.0,1,0.11927281902921086,57
4095,1,8946,3127,5819,0,0,0,1.0,1,1.0,1,1.0,1,0.1170682325335578,57
4096,2,8948,3127,5821,0,0,0,1.0,1,1.0,1,1.0,1,0.089776135649081,59
4097,1,8949,3128,5821,0,0,0,1.0,1,1.0,1,1.0,1,0.11054341935640197,59
4098,0,8949,3128,5821,0,0,0,1.0,1,1.0,1,1.0,1,0.11054341935640197,59
4099,1,8950,3129,5821,0,0,0,1.0,1,1.0,1,1.0,1,0.12010539404802419,60
4100,4,8954,3130,5824,0,0,0,1.0,1,1.0,1,1.0,1,0.14143431250189006,60
4101,6,8960,3131,5829,0,0,0,1.0,1,1.0,1,1.0,1,0.07603741317352317,60
4102,6,8966,3136,5830,0,0,0,1.0,1,1.0,1,1.0,1,0.1335737441388625,60
4103,0,8966,3136,5830,0,0,0,1.0,1,1.0,1,1.0,1,0.1382340235905108,58
4104,3,8969,3137,5832,0,0,0,1.0,1,1.0,1,1.0,1,0.10688993096193122,60
4105,2,8971,3138,5833,0,0,0,1.0,1,1.0,1,1.0,1,0.10126876145258504,59
4106,4,8975,3139,5836,0,0,0,1.0,1,1.0,1,1.0,1,0.09132998131193684,61
4107,0,8975,3139,5836,0,0,0,1.0,1,1.0,1,1.0,1,0.1016462304205313,59
4108,1,8976,3139,5837,0,0,0,1.0,1,1.0,1,1.0,1,0.09775781830224571,60
4109,0,8976,3139,5837,0,0,0,1.0,1,1.0,1,1.0,1,0.09193230334889264,59
4110,2,8978,3140,5838,0,0,0,1.0,1,1.0,1,1.0,1,0.1044138974588787,60
4111,3,8981,3140,5841,0,0,0,1.0,1,1.0,1,1.0,1,0.07904713670684872,61
4112,1,8982,3140,5842,0,0,0,1.0,1,1.0,1,1.0,1,0.05013396727443021,60
4113,2,8984,3141,5843,0,0,0,1.0,1,1.0,1,1.0,1,0.07424177291748597,61
4114,0,8984,3141,5843,0,0,0,1.0,1,1.0,1,1.0,1,0.07238553494112954,62
4115,2,8986,3142,5844,0,0,0,1.0,1,1.0,1,1.0,1,0.12613856028149706,60
4116,6,8992,3143,5849,0,0,0,1.0,1,1.0,1,1.0,1,0.08617469365433283,59
4117,6,8998,3148,5850,0,0,0,1.0,1,1.0,1,1.0,1,0.10939996725791085,56
4118,0,8998,3148,5850,0,0,0,1.0,1,1.0,1,1.0,1,0.10766089481755484,55
4119,1,8999,3148,5851,0,0,0,1.0,1,1.0,1,1.0,1,0.1031692293956711,53
4120,2,9001,3150,5851,0,0,0,1.0,1,1.0,1,1.0,1,0.09719309585975547,52
4121,6,9007,3154,5853,0,0,0,1.0,1,1.0,1,1.0,1,0.11203649876231787,53
4122,1,9008,3155,5853,0,0,0,1.0,1,1.0,1,1.0,1,0.11408601159495929,52
4123,2,9010,3157,5853,0,0,0,1.0,1,1.0,1,1.0,1,0.11136961023421425,51
4124,2,9012,3159,5853,0,0,0,1.0,1,1.0,1,1.0,1,0.17170287268365086,51
4125,3,9015,3160,5855,0,0,0,1.0,1,1.0,1,1.0,1,0.1590842610759678,50
4126,7,9022,3161,5861,0,0,0,1.0,1,1.0,1,1.0,1,0.09730741517897153,50
4127,0,9022,3161,5861,0,0,0,1.0,1,1.0,1,1.0,1,0.09305269030073568,49
4128,0,9022,3161,5861,0,0,0,1.0,1,1.0,1,1.0,1,0.09305269030073568,49
4129,0,9022,3161,5861,0,0,0,1.0,1,1.0,1,1.0,1,0.09305269030073568,49
4130,1,9023,3162,5861,0,0,0,1.0,1,1.0,1,1.0,1,0.10433429805898352,50
4131,3,9026,3163,5863,0,0,0,1.0,1,1.0,1,1.0,1,0.09201793398971138,50
4132,0,9026,3163,5863,0,0,0,1.0,1,1.0,1,1.0,1,0.09201793398971138,50
4133,1,9027,3163,5864,0,0,0,1.0,1,1.0,1,1.0,1,0.08381454664464723,51
4134,1,9028,3163,5865,0,0,0,1.0,1,1.0,1,1.0,1,0.04179000939329635,53
4135,0,9028,3163,5865,0,0,0,1.0,1,1.0,1,1.0,1,0.05469421310056953,54
4136,0,9028,3163,5865,0,0,0,1.0,1,1.0,1,1.0,1,0.05469421310056953,54
4137,3,9031,3165,5866,0,0,0,1.0,1,1.0,1,1.0,1,0.10957570916473129,55
4138,1,9032,3165,5867,0,0,0,1.0,1,1.0,1,1.0,1,0.08023517394930597,54
4139,0,9032,3165,5867,0,0,0,1.0,1,1.0,1,1.0,1,0.08023517394930597,54
4140,1,9033,3166,5867,0,0,0,1.0,1,1.0,1,1.0,1,0.10347350909599477,55
4141,1,9034,3166,5868,0,0,0,1.0,1,1.0,1,1.0,1,0.1041754896584673,55
4142,0,9034,3166,5868,0,0,0,1.0,1,1.0,1,1.0,1,0.1041754896584673,55
4143,3,9037,3168,5869,0,0,0,1.0,1,1.0,1,1.0,1,0.1463201138426696,53
4144,5,9042,3170,5872,0,0,0,1.0,1,1.0,1,1.0,1,0.1581974049823745,52
4145,4,9046,3172,5874,0,0,0,1.0,1,1.0,1,1.0,1,0.16525834072608167,51
4146,3,9049,3173,5876,0,0,0,1.0,1,1.0,1,1.0,1,0.15212600535292853,51
4147,4,9053,3176,5877,0,0,0,1.0,1,1.0,1,1.0,1,0.16447585904785073,50
4148,5,9058,3177,5881,0,0,0,1.0,1,1.0,1,1.0,1,0.13280909106696034,52
4149,0,9058,3177,5881,0,0,0,1.0,1,1.0,1,1.0,1,0.12957304479105247,53
4150,2,9060,3179,5881,0,0,0,1.0,1,1.0,1,1.0,1,0.1390358442445333,53
4151,2,9062,3180,5882,0,0,0,1.0,1,1.0,1,1.0,1,0.13625055276029127,53
4152,3,9065,3181,5884,0,0,0,1.0,1,1.0,1,1.0,1,0.10946228353767984,54
4153,1,9066,3182,5884,0,0,0,1.0,1,1.0,1,1.0,1,0.12810406770718583,51
4154,0,9066,3182,5884,0,0,0,1.0,1,1.0,1,1.0,1,0.12810406770718583,51
4155,4,9070,3185,5885,0,0,0,1.0,1,1.0,1,1.0,1,0.155711018360613,51
4156,1,9071,3186,5885,0,0,0,1.0,1,1.0,1,1.0,1,0.15561686555440565,52
4157,2,9073,3186,5887,0,0,0,1.0,1,1.0,1,1.0,1,0.1382975276421621,52
4158,3,9076,3188,5888,0,0,0,1.0,1,1.0,1,1.0,1,0.16182761074004004,52
4159,1,9077,3189,5888,0,0,0,1.0,1,1.0,1,1.0,1,0.1505440791007569,52
4160,3,9080,3191,5889,0,0,0,1.0,1,1.0,1,1.0,1,0.17167015815022196,50
4161,1,9081,3191,5890,0,0,0,1.0,1,1.0,1,1.0,1,0.15151332837778278,50
4162,1,9082,3192,5890,0,0,0,1.0,1,1.0,1,1.0,1,0.16231774649282732,51
4163,1,9083,3192,5891,0,0,0,1.0,1,1.0,1,1.0,1,0.195562385042066,48
4164,4,9087,3194,5893,0,0,0,1.0,1,1.0,1,1.0,1,0.21177612536557103,50
4165,1,9088,3194,5894,0,0,0,1.0,1,1.0,1,1.0,1,0.211799675267588,49
4166,2,9090,3195,5895,0,0,0,1.0,1,1.0,1,1.0,1,0.17676825120511203,50
4167,0,9090,3195,5895,0,0,0,1.0,1,1.0,1,1.0,1,0.17698046743665616,50
4168,1,9091,3195,5896,0,0,0,1.0,1,1.0,1,1.0,1,0.1847627485902567,50
4169,1,9092,3196,5896,0,0,0,1.0,1,1.0,1,1.0,1,0.1913470050644884,51
4170,4,9096,3197,5899,0,0,0,1.0,1,1.0,1,1.0,1,0.1970541294699391,50
4171,3,9099,3199,5900,0,0,0,1.0,1,1.0,1,1.0,1,0.22506722315746241,50
4172,1,9100,3199,5901,0,0,0,1.0,1,1.0,1,1.0,1,0.2291175692062916,49
4173,1,9101,3200,5901,0,0,0,1.0,1,1.0,1,1.0,1,0.25269088696425307,48
4174,0,9101,3200,5901,0,0,0,1.0,1,1.0,1,1.0,1,0.25269088696425307,48
4175,2,9103,3200,5903,0,0,0,1.0,1,1.0,1,1.0,1,0.21019473190936194,48
4176,3,9106,3200,5906,0,0,0,1.0,1,1.0,1,1.0,1,0.20305812487719457,50
4177,2,9108,3200,5908,0,0,0,1.0,1,1.0,1,1.0,1,0.18921000667027166,52
4178,2,9110,3200,5910,0,0,0,1.0,1,1.0,1,1.0,1,0.16544160220490453,53
4179,1,9111,3201,5910,0,0,0,1.0,1,1.0,1,1.0,1,0.1701992359350464,54
4180,3,9114,3201,5913,0,0,0,1.0,1,1.0,1,1.0,1,0.16534659749461378,55
4181,2,9116,3201,5915,0,0,0,1.0,1,1.0,1,1.0,1,0.12206410949947104,56
4182,1,9117,3202,5915,0,0,0,1.0,1,1.0,1,1.0,1,0.13545834379113608,56
4183,4,9121,3202,5919,0,0,0,1.0,1,1.0,1,1.0,1,0.08422514865887443,57
4184,1,9122,3203,5919,0,0,0,1.0,1,1.0,1,1.0,1,0.09828417499856167,57
4185,0,9122,3203,5919,0,0,0,1.0,1,1.0,1,1.0,1,0.11785860406018198,54
4186,4,9126,3204,5922,0,0,0,1.0,1,1.0,1,1.0,1,0.08221882738474792,55
4187,1,9127,3205,5922,0,0,0,1.0,1,1.0,1,1.0,1,0.09785367931675165,53
4188,1,9128,3205,5923,0,0,0,1.0,1,1.0,1,1.0,1,0.09692899091196029,53
4189,1,9129,3205,5924,0,0,0,1.0,1,1.0,1,1.0,1,0.11894518825902173,53
4190,2,9131,3207,5924,0,0,0,1.0,1,1.0,1,1.0,1,0.13804070003428132,53
4191,3,9134,3207,5927,0,0,0,1.0,1,1.0,1,1.0,1,0.10733333364427805,51
4192,2,9136,3209,5927,0,0,0,1.0,1,1.0,1,1.0,1,0.15292495577073884,51
4193,3,9139,3210,5929,0,0,0,1.0,1,1.0,1,1.0,1,0.13362319423012567,50
4194,2,9141,3210,5931,0,0,0,1.0,1,1.0,1,1.0,1,0.15285914870465256,50
4195,6,9147,3213,5934,0,0,0,1.0,1,1.0,1,1.0,1,0.19667169086808944,50
4196,8,9155,3215,5940,0,0,0,1.0,1,1.0,1,1.0,1,0.10908684646961923,51
4197,2,9157,3216,5941,0,0,0,1.0,1,1.0,1,1.0,1,0.11732749908608435,50
4198,1,9158,3216,5942,0,0,0,1.0,1,1.0,1,1.0,1,0.1082648546214415,48
4199,1,9159,3216,5943,0,0,0,1.0,1,1.0,1,1.0,1,0.16295313618210386,48
4200,1,9160,3216,5944,0,0,0,1.0,1,1.0,1,1.0,1,0.19268305948814593,48
4201,3,9163,3216,5947,0,0,0,1.0,1,1.0,1,1.0,1,0.18192590543509288,47
4202,0,9163,3216,5947,0,0,0,1.0,1,1.0,1,1.0,1,0.18192590543509288,47
4203,0,9163,3216,5947,0,0,0,1.0,1,1.0,1,1.0,1,0.18192590543509288,47
4204,4,9167,3218,5949,0,0,0,1.0,1,1.0,1,1.0,1,0.22710906030907577,48
4205,2,9169,3219,5950,0,0,0,1.0,1,1.0,1,1.0,1,0.25381437965861015,49
4206,3,9172,3219,5953,0,0,0,1.0,1,1.0,1,1.0,1,0.23561346939623676,49
4207,0,9172,3219,5953,0,0,0,1.0,1,1.0,1,1.0,1,0.23500164346730232,48
4208,2,9174,3221,5953,0,0,0,1.0,1,1.0,1,1.0,1,0.2518299080221076,49
4209,2,9176,3221,5955,0,0,0,1.0,1,1.0,1,1.0,1,0.21975560814518674,51
4210,0,9176,3221,5955,0,0,0,1.0,1,1.0,1,1.0,1,0.22665584367350533,52
4211,4,9180,3221,5959,0,0,0,1.0,1,1.0,1,1.0,1,0.1897896439753808,53
4212,1,9181,3222,5959,0,0,0,1.0,1,1.0,1,1.0,1,0.21043011762226882,53
4213,1,9182,3222,5960,0,0,0,1.0,1,1.0,1,1.0,1,0.19372055042039518,54
4214,3,9185,3223,5962,0,0,0,1.0,1,1.0,1,1.0,1,0.21582334574118972,54
4215,2,9187,3224,5963,0,0,0,1.0,1,1.0,1,1.0,1,0.2131246891541185,54
4216,3,9190,3224,5966,0,0,0,1.0,1,1.0,1,1.0,1,0.20132739928326357,53
4217,4,9194,3225,5969,0,0,0,1.0,1,1.0,1,1.0,1,0.21788531000474926,54
4218,3,9197,3226,5971,0,0,0,1.0,1,1.0,1,1.0,1,0.22516118333766036,53
4219,0,9197,3226,5971,0,0,0,1.0,1,1.0,1,1.0,1,0.22516118333766036,53
4220,0,9197,3226,5971,0,0,0,1.0,1,1.0,1,1.0,1,0.24006231539384829,53
4221,2,9199,3226,5973,0,0,0,1.0,1,1.0,1,1.0,1,0.21582867734538305,54
4222,6,9205,3230,5975,0,0,0,1.0,1,1.0,1,1.0,1,0.23993353122261596,55
4223,2,9207,3231,5976,0,0,0,1.0,1,1.0,1,1.0,1,0.21487124987635853,56
4224,4,9211,3234,5977,0,0,0,1.0,1,1.0,1,1.0,1,0.217092104813509,55
4225,1,9212,3235,5977,0,0,0,1.0,1,1.0,1,1.0,1,0.20650346968682748,53
4226,4,9216,3237,5979,0,0,0,1.0,1,1.0,1,1.0,1,0.19946742651159405,54
4227,1,9217,3238,5979,0,0,0,1.0,1,1.0,1,1.0,1,0.1925540584519816,52
4228,3,9220,3240,5980,0,0,0,1.0,1,1.0,1,1.0,1,0.19571541003465676,51
4229,2,9222,3241,5981,0,0,0,1.0,1,1.0,1,1.0,1,0.20048916621008386,48
4230,2,9224,3242,5982,0,0,0,1.0,1,1.0,1,1.0,1,0.20876900591542666,48
4231,3,9227,3242,5985,0,0,0,1.0,1,1.0,1,1.0,1,0.16892552629260554,48
4232,3,9230,3243,5987,0,0,0,1.0,1,1.0,1,1.0,1,0.15239583308510152,48
4233,0,9230,3243,5987,0,0,0,1.0,1,1.0,1,1.0,1,0.12676840785323565,48
4234,1,9231,3244,5987,0,0,0,1.0,1,1.0,1,1.0,1,0.1433976182581733,49
4235,0,9231,3244,5987,0,0,0,1.0,1,1.0,1,1.0,1,0.12465240670678683,47
4236,5,9236,3245,5991,0,0,0,1.0,1,1.0,1,1.0,1,0.07757566033136354,47
4237,1,9237,3245,5992,0,0,0,1.0,1,1.0,1,1.0,1,0.08568411419226396,48
4238,2,9239,3245,5994,0,0,0,1.0,1,1.0,1,1.0,1,0.11093870021157745,47
4239,0,9239,3245,5994,0,0,0,1.0,1,1.0,1,1.0,1,0.1015475006752624,48
4240,1,9240,3246,5994,0,0,0,1.0,1,1.0,1,1.0,1,0.10943194908679511,47
4241,1,9241,3246,5995,0,0,0,1.0,1,1.0,1,1.0,1,0.11595664138082197,49
4242,2,9243,3247,5996,0,0,0,1.0,1,1.0,1,1.0,1,0.11173310195990872,49
4243,2,9245,3248,5997,0,0,0,1.0,1,1.0,1,1.0,1,0.12560637765905133,50
4244,2,9247,3248,5999,0,0,0,1.0,1,1.0,1,1.0,1,0.1320497246639719,51
4245,1,9248,3248,6000,0,0,0,1.0,1,1.0,1,1.0,1,0.16930994224199708,51
4246,6,9254,3248,6006,0,0,0,1.0,1,1.0,1,1.0,1,0.13442911180283718,51
4247,5,9259,3248,6011,0,0,0,1.0,1,1.0,1,1.0,1,0.12156354702323183,52
4248,4,9263,3249,6014,0,0,0,1.0,1,1.0,1,1.0,1,0.134345748693148,52
4249,3,9266,3249,6017,0,0,0,1.0,1,1.0,1,1.0,1,0.11792599636925508,52
4250,3,9269,3251,6018,0,0,0,1.0,1,1.0,1,1.0,1,0.15090550034521363,52
4251,8,9277,3253,6024,0,0,0,1.0,1,1.0,1,1.0,1,0.08984845151508716,53
4252,1,9278,3254,6024,0,0,0,1.0,1,1.0,1,1.0,1,0.09075100739531936,53
4253,0,9278,3254,6024,0,0,0,1.0,1,1.0,1,1.0,1,0.09014656468694313,54
4254,1,9279,3254,6025,0,0,0,1.0,1,1.0,1,1.0,1,0.08523136097721741,54
4255,1,9280,3255,6025,0,0,0,1.0,1,1.0,1,1.0,1,0.11169716463555089,55
4256,5,9285,3256,6029,0,0,0,1.0,1,1.0,1,1.0,1,0.09916761897329536,57
4257,5,9290,3257,6033,0,0,0,1.0,1,1.0,1,1.0,1,0.1312505944638931,57
4258,1,9291,3257,6034,0,0,0,1.0,1,1.0,1,1.0,1,0.12894647790938288,57
4259,1,9292,3257,6035,0,0,0,1.0,1,1.0,1,1.0,1,0.1574547854287153,57
4260,1,9293,3257,6036,0,0,0,1.0,1,1.0,1,1.0,1,0.14225173206220754,58
4261,4,9297,3257,6040,0,0,0,1.0,1,1.0,1,1.0,1,0.08427526588584808,59
4262,2,9299,3258,6041,0,0,0,1.0,1,1.0,1,1.0,1,0.08032644828120285,60
4263,3,9302,3261,6041,0,0,0,1.0,1,1.0,1,1.0,1,0.10821301746923973,59
4264,3,9305,3263,6042,0,0,0,1.0,1,1.0,1,1.0,1,0.1491390834599624,58
4265,3,9308,3264,6044,0,0,0,1.0,1,1.0,1,1.0,1,0.10510015514026336,58
4266,3,9311,3265,6046,0,0,0,1.0,1,1.0,1,1.0,1,0.07986884531458607,58
4267,1,9312,3266,6046,0,0,0,1.0,1,1.0,1,1.0,1,0.0859689152585636,55
4268,1,9313,3267,6046,0,0,0,1.0,1,1.0,1,1.0,1,0.10341496704046388,55
4269,2,9315,3269,6046,0,0,0,1.0,1,1.0,1,1.0,1,0.1400067924502341,50
4270,2,9317,3271,6046,0,0,0,1.0,1,1.0,1,1.0,1,0.21045901681505647,47
4271,6,9323,3272,6051,0,0,0,1.0,1,1.0,1,1.0,1,0.1552866109819726,47
4272,1,9324,3272,6052,0,0,0,1.0,1,1.0,1,1.0,1,0.15100688907853266,46
4273,6,9330,3274,6056,0,0,0,1.0,1,1.0,1,1.0,1,0.17798899662884057,47
4274,3,9333,3275,6058,0,0,0,1.0,1,1.0,1,1.0,1,0.16285066985908725,45
4275,4,9337,3278,6059,0,0,0,1.0,1,1.0,1,1.0,1,0.1240742577829823,44
4276,6,9343,3280,6063,0,0,0,1.0,1,1.0,1,1.0,1,0.11616383964042573,43
4277,1,9344,3281,6063,0,0,0,1.0,1,1.0,1,1.0,1,0.14980317508749882,42
4278,4,9348,3282,6066,0,0,0,1.0,1,1.0,1,1.0,1,0.1669750651310764,43
4279,2,9350,3282,6068,0,0,0,1.0,1,1.0,1,1.0,1,0.1468566249835304,42
4280,3,9353,3285,6068,0,0,0,1.0,1,1.0,1,1.0,1,0.21322281147338368,44
4281,7,9360,3286,6074,0,0,0,1.0,1,1.0,1,1.0,1,0.1431660421597056,44
4282,3,9363,3286,6077,0,0,0,1.0,1,1.0,1,1.0,1,0.15423260875741265,44
4283,5,9368,3286,6082,0,0,0,1.0,1,1.0,1,1.0,1,0.1383800190691865,45
4284,6,9374,3286,6088,0,0,0,1.0,1,1.0,1,1.0,1,0.1358101256677098,45
4285,5,9379,3286,6093,0,0,0,1.0,1,1.0,1,1.0,1,0.17770252097598055,47
4286,7,9386,3286,6100,0,0,0,1.0,1,1.0,1,1.0,1,0.06495069817684104,47
4287,0,9386,3286,6100,0,0,0,1.0,1,1.0,1,1.0,1,0.09244096469566675,49
4288,0,9386,3286,6100,0,0,0,1.0,1,1.0,1,1.0,1,0.09244096469566675,49
4289,1,9387,3286,6101,0,0,0,1.0,1,1.0,1,1.0,1,0.09327790900805259,50
4290,0,9387,3286,6101,0,0,0,1.0,1,1.0,1,1.0,1,0.10250529354332341,51
4291,2,9389,3287,6102,0,0,0,1.0,1,1.0,1,1.0,1,0.10577865541202597,50
4292,4,9393,3288,6105,0,0,0,1.0,1,1.0,1,1.0,1,0.10820058787036807,51
4293,1,9394,3289,6105,0,0,0,1.0,1,1.0,1,1.0,1,0.12779532168837618,51
4294,1,9395,3290,6105,0,0,0,1.0,1,1.0,1,1.0,1,0.17677629544962845,50
4295,2,9397,3291,6106,0,0,0,1.0,1,1.0,1,1.0,1,0.19003914923677032,50
4296,11,9408,3291,6117,0,0,0,1.0,1,1.0,1,1.0,1,0.15378849385171253,49
4297,2,9410,3291,6119,0,0,0,1.0,1,1.0,1,1.0,1,0.13571024380508173,49
4298,3,9413,3291,6122,0,0,0,1.0,1,1.0,1,1.0,1,0.1281818085943646,49
4299,2,9415,3291,6124,0,0,0,1.0,1,1.0,1,1.0,1,0.1291475774854589,48
4300,3,9418,3292,6126,0,0,0,1.0,1,1.0,1,1.0,1,0.15654257927558043,49
4301,11,9429,3293,6136,0,0,0,1.0,1,1.0,1,1.0,1,0.04754311499615621,50
4302,3,9432,3294,6138,0,0,0,1.0,1,1.0,1,1.0,1,0.10526720841501475,51
4303,3,9435,3295,6140,0,0,0,1.0,1,1.0,1,1.0,1,0.12136198668088431,51
4304,8,9443,3297,6146,0,0,0,1.0,1,1.0,1,1.0,1,0.12891282956334232,51
4305,7,9450,3298,6152,0,0,0,1.0,1,1.0,1,1.0,1,0.13837096264159687,49
4306,6,9456,3300,6156,0,0,0,1.0,1,1.0,1,1.0,1,0.08731614176995658,49
4307,3,9459,3301,6158,0,0,0,1.0,1,1.0,1,1.0,1,0.10325387054367341,46
4308,0,9459,3301,6158,0,0,0,1.0,1,1.0,1,1.0,1,0.10130809122138004,44
4309,2,9461,3302,6159,0,0,0,1.0,1,1.0,1,1.0,1,0.148467851950511,44
4310,0,9461,3302,6159,0,0,0,1.0,1,1.0,1,1.0,1,0.19272201429296731,42
4311,7,9468,3304,6164,0,0,0,1.0,1,1.0,1,1.0,1,0.1140825570800636,42
4312,0,9468,3304,6164,0,0,0,1.0,1,1.0,1,1.0,1,0.09995246161650384,40
4313,5,9473,3308,6165,0,0,0,1.0,1,1.0,1,1.0,1,0.15070424662082713,40
4314,1,9474,3308,6166,0,0,0,1.0,1,1.0,1,1.0,1,0.12263873416560417,36
4315,1,9475,3309,6166,0,0,0,1.0,1,1.0,1,1.0,1,0.17844183618415732,37
4316,5,9480,3311,6169,0,0,0,1.0,1,1.0,1,1.0,1,0.167042035655281,37
4317,1,9481,3312,6169,0,0,0,1.0,1,1.0,1,1.0,1,0.1858471326299847,36
4318,1,9482,3313,6169,0,0,0,1.0,1,1.0,1,1.0,1,0.19232680781599712,34
4319,1,9483,3314,6169,0,0,0,1.0,1,1.0,1,1.0,1,0.20831981990189904,34
4320,1,9484,3314,6170,0,0,0,1.0,1,1.0,1,1.0,1,0.19062081039668866,34
4321,1,9485,3314,6171,0,0,0,1.0,1,1.0,1,1.0,1,0.22696652562445704,35
4322,0,9485,3314,6171,0,0,0,1.0,1,1.0,1,1.0,1,0.22696652562445704,35
4323,0,9485,3314,6171,0,0,0,1.0,1,1.0,1,1.0,1,0.22696652562445704,35
4324,1,9486,3314,6172,0,0,0,1.0,1,1.0,1,1.0,1,0.19518955292260037,34
4325,2,9488,3315,6173,0,0,0,1.0,1,1.0,1,1.0,1,0.15147374787567777,34
4326,2,9490,3316,6174,0,0,0,1.0,1,1.0,1,1.0,1,0.16666143248901144,36
4327,0,9490,3316,6174,0,0,0,1.0,1,1.0,1,1.0,1,0.16691016848373266,35
4328,1,9491,3317,6174,0,0,0,1.0,1,1.0,1,1.0,1,0.17763448617387656,35
4329,7,9498,3319,6179,0,0,0,1.0,1,1.0,1,1.0,1,0.15562592112921955,38
4330,5,9503,3320,6183,0,0,0,1.0,1,1.0,1,1.0,1,0.147249194291356,38
4331,1,9504,3320,6184,0,0,0,1.0,1,1.0,1,1.0,1,0.13891177980211006,39
4332,1,9505,3320,6185,0,0,0,1.0,1,1.0,1,1.0,1,0.1358095421452896,40
4333,1,9506,3320,6186,0,0,0,1.0,1,1.0,1,1.0,1,0.09811609649059842,41
4334,1,9507,3320,6187,0,0,0,1.0,1,1.0,1,1.0,1,0.1023471555194061,41
4335,2,9509,3321,6188,0,0,0,1.0,1,1.0,1,1.0,1,0.09295859724287321,42
4336,2,9511,3321,6190,0,0,0,1.0,1,1.0,1,1.0,1,0.04580075067185467,43
4337,2,9513,3322,6191,0,0,0,1.0,1,1.0,1,1.0,1,0.07528829554036846,44
4338,1,9514,3322,6192,0,0,0,1.0,1,1.0,1,1.0,1,0.04969393778384904,44
4339,3,9517,3322,6195,0,0,0,1.0,1,1.0,1,1.0,1,0.07326499284002633,46
4340,5,9522,3322,6200,0,0,0,1.0,1,1.0,1,1.0,1,0.10726366866461692,47
4341,1,9523,3322,6201,0,0,0,1.0,1,1.0,1,1.0,1,0.09416835110364337,47
4342,6,9529,3326,6203,0,0,0,1.0,1,1.0,1,1.0,1,0.11576563090062784,47
4343,1,9530,3326,6204,0,0,0,1.0,1,1.0,1,1.0,1,0.11732172306077898,42
4344,3,9533,3329,6204,0,0,0,1.0,1,1.0,1,1.0,1,0.12088734036157517,42
4345,3,9536,3332,6204,0,0,0,1.0,1,1.0,1,1.0,1,0.20600193274305936,39
4346,3,9539,3333,6206,0,0,0,1.0,1,1.0,1,1.0,1,0.18956644893431654,37
4347,2,9541,3335,6206,0,0,0,1.0,1,1.0,1,1.0,1,0.25094761007252997,37
4348,7,9548,3338,6210,0,0,0,1.0,1,1.0,1,1.0,1,0.2133099201769394,38
4349,3,9551,3338,6213,0,0,0,1.0,1,1.0,1,1.0,1,0.21092405595773214,36
4350,2,9553,3339,6214,0,0,0,1.0,1,1.0,1,1.0,1,0.2035464308258042,37
4351,1,9554,3340,6214,0,0,0,1.0,1,1.0,1,1.0,1,0.2081588810786722,35
4352,2,9556,3341,6215,0,0,0,1.0,1,1.0,1,1.0,1,0.2273929884126363,34
4353,1,9557,3341,6216,0,0,0,1.0,1,1.0,1,1.0,1,0.23605691401468737,34
4354,1,9558,3341,6217,0,0,0,1.0,1,1.0,1,1.0,1,0.2395400601818942,32
4355,0,9558,3341,6217,0,0,0,1.0,1,1.0,1,1.0,1,0.2628700660950474,32
4356,5,9563,3343,6220,0,0,0,1.0,1,1.0,1,1.0,1,0.23249914818467987,34
4357,2,9565,3343,6222,0,0,0,1.0,1,1.0,1,1.0,1,0.16730669042788793,35
4358,2,9567,3344,6223,0,0,0,1.0,1,1.0,1,1.0,1,0.1936332064087323,35
4359,3,9570,3344,6226,0,0,0,1.0,1,1.0,1,1.0,1,0.21200220379742155,37
4360,7,9577,3344,6233,0,0,0,1.0,1,1.0,1,1.0,1,0.2138037163878153,38
4361,6,9583,3344,6239,0,0,0,1.0,1,1.0,1,1.0,1,0.07992632495498762,39
4362,2,9585,3346,6239,0,0,0,1.0,1,1.0,1,1.0,1,0.09362486258441906,38
4363,0,9585,3346,6239,0,0,0,1.0,1,1.0,1,1.0,1,0.09362486258441906,38
4364,3,9588,3347,6241,0,0,0,1.0,1,1.0,1,1.0,1,0.14803812336336214,39
4365,4,9592,3347,6245,0,0,0,1.0,1,1.0,1,1.0,1,0.2199712816970894,39
4366,6,9598,3347,6251,0,0,0,1.0,1,1.0,1,1.0,1,0.1177334352965974,39
4367,1,9599,3347,6252,0,0,0,1.0,1,1.0,1,1.0,1,0.13879766137049546,41
4368,3,9602,3348,6254,0,0,0,1.0,1,1.0,1,1.0,1,0.15735576438089327,41
4369,4,9606,3348,6258,0,0,0,1.0,1,1.0,1,1.0,1,0.05771948846215047,42
4370,0,9606,3348,6258,0,0,0,1.0,1,1.0,1,1.0,1,0.05771948846215047,42
4371,0,9606,3348,6258,0,0,0,1.0,1,1.0,1,1.0,1,0.07919242914691277,43
4372,3,9609,3349,6260,0,0,0,1.0,1,1.0,1,1.0,1,0.06319155986528845,43
4373,0,9609,3349,6260,0,0,0,1.0,1,1.0,1,1.0,1,0.06319155986528845,43
4374,2,9611,3350,6261,0,0,0,1.0,1,1.0,1,1.0,1,0.10551497945253699,44
4375,1,9612,3351,6261,0,0,0,1.0,1,1.0,1,1.0,1,0.09863075589323118,45
4376,1,9613,3351,6262,0,0,0,1.0,1,1.0,1,1.0,1,0.0844947266242825,46
4377,2,9615,3352,6263,0,0,0,1.0,1,1.0,1,1.0,1,0.10714676514708886,47
4378,2,9617,3353,6264,0,0,0,1.0,1,1.0,1,1.0,1,0.1329411582862666,49
4379,4,9621,3356,6265,0,0,0,1.0,1,1.0,1,1.0,1,0.17072847589012397,51
4380,3,9624,3357,6267,0,0,0,1.0,1,1.0,1,1.0,1,0.17003330568240654,50
4381,3,9627,3357,6270,0,0,0,1.0,1,1.0,1,1.0,1,0.12910286409215294,49
4382,4,9631,3360,6271,0,0,0,1.0,1,1.0,1,1.0,1,0.22095285134309087,47
4383,2,9633,3362,6271,0,0,0,1.0,1,1.0,1,1.0,1,0.2234659044089061,47
4384,2,9635,3363,6272,0,0,0,1.0,1,1.0,1,1.0,1,0.24829081066488282,44
4385,2,9637,3364,6273,0,0,0,1.0,1,1.0,1,1.0,1,0.20604232701293074,42
4386,5,9642,3365,6277,0,0,0,1.0,1,1.0,1,1.0,1,0.2290184779671972,41
4387,1,9643,3365,6278,0,0,0,1.0,1,1.0,1,1.0,1,0.20059375564832718,39
4388,2,9645,3365,6280,0,0,0,1.0,1,1.0,1,1.0,1,0.21435782627306008,39
4389,4,9649,3367,6282,0,0,0,1.0,1,1.0,1,1.0,1,0.2534595861914458,38
4390,1,9650,3367,6283,0,0,0,1.0,1,1.0,1,1.0,1,0.2500172712372903,38
4391,7,9657,3367,6290,0,0,0,1.0,1,1.0,1,1.0,1,0.10970705137804981,39
4392,0,9657,3367,6290,0,0,0,1.0,1,1.0,1,1.0,1,0.10970705137804981,39
4393,0,9657,3367,6290,0,0,0,1.0,1,1.0,1,1.0,1,0.12441514517857771,40
4394,0,9657,3367,6290,0,0,0,1.0,1,1.0,1,1.0,1,0.14246196513081566,39
4395,0,9657,3367,6290,0,0,0,1.0,1,1.0,1,1.0,1,0.14246196513081566,39
4396,2,9659,3367,6292,0,0,0,1.0,1,1.0,1,1.0,1,0.15830275418069809,39
4397,4,9663,3368,6295,0,0,0,1.0,1,1.0,1,1.0,1,0.1678808157291968,38
4398,0,9663,3368,6295,0,0,0,1.0,1,1.0,1,1.0,1,0.17938526820830258,39
4399,1,9664,3368,6296,0,0,0,1.0,1,1.0,1,1.0,1,0.18266969296635238,42
4400,3,9667,3368,6299,0,0,0,1.0,1,1.0,1,1.0,1,0.15927256974218987,43
4401,1,9668,3368,6300,0,0,0,1.0,1,1.0,1,1.0,1,0.0961558947394656,44
4402,0,9668,3368,6300,0,0,0,1.0,1,1.0,1,1.0,1,0.0961558947394656,44
4403,0,9668,3368,6300,0,0,0,1.0,1,1.0,1,1.0,1,0.09002111045312464,45
4404,0,9668,3368,6300,0,0,0,1.0,1,1.0,1,1.0,1,0.09002111045312464,45
4405,0,9668,3368,6300,0,0,0,1.0,1,1.0,1,1.0,1,0.07995680864416148,46
4406,0,9668,3368,6300,0,0,0,1.0,1,1.0,1,1.0,1,0.07995680864416148,46
4407,0,9668,3368,6300,0,0,0,1.0,1,1.0,1,1.0,1,0.07995680864416148,46
4408,0,9668,3368,6300,0,0,0,1.0,1,1.0,1,1.0,1,0.09264653620612404,47
4409,2,9670,3369,6301,0,0,0,1.0,1,1.0,1,1.0,1,0.12990726921841197,48
4410,0,9670,3369,6301,0,0,0,1.0,1,1.0,1,1.0,1,0.12990726921841197,48
4411,2,9672,3369,6303,0,0,0,1.0,1,1.0,1,1.0,1,0.11507541071212508,50
4412,1,9673,3369,6304,0,0,0,1.0,1,1.0,1,1.0,1,0.09871374733035647,50
4413,0,9673,3369,6304,0,0,0,1.0,1,1.0,1,1.0,1,0.12312402206914803,50
4414,0,9673,3369,6304,0,0,0,1.0,1,1.0,1,1.0,1,0.13405620397666107,51
4415,1,9674,3369,6305,0,0,0,1.0,1,1.0,1,1.0,1,0.12144902624005613,51
4416,2,9676,3370,6306,0,0,0,1.0,1,1.0,1,1.0,1,0.13209905622296494,51
4417,2,9678,3372,6306,0,0,0,1.0,1,1.0,1,1.0,1,0.12239241848064712,51
4418,0,9678,3372,6306,0,0,0,1.0,1,1.0,1,1.0,1,0.15517889065808432,51
4419,1,9679,3372,6307,0,0,0,1.0,1,1.0,1,1.0,1,0.15033781215320272,50
4420,2,9681,3373,6308,0,0,0,1.0,1,1.0,1,1.0,1,0.17092222593974055,50
4421,4,9685,3373,6312,0,0,0,1.0,1,1.0,1,1.0,1,0.1261230035507098,52
4422,0,9685,3373,6312,0,0,0,1.0,1,1.0,1,1.0,1,0.1332742773026675,51
4423,1,9686,3373,6313,0,0,0,1.0,1,1.0,1,1.0,1,0.12203632768525227,51
4424,2,9688,3373,6315,0,0,0,1.0,1,1.0,1,1.0,1,0.1366159394515154,53
4425,1,9689,3373,6316,0,0,0,1.0,1,1.0,1,1.0,1,0.140299362365307,54
4426,4,9693,3374,6319,0,0,0,1.0,1,1.0,1,1.0,1,0.09347311536608409,55
4427,0,9693,3374,6319,0,0,0,1.0,1,1.0,1,1.0,1,0.09347311536608409,55
4428,0,9693,3374,6319,0,0,0,1.0,1,1.0,1,1.0,1,0.09347311536608409,55
4429,2,9695,3374,6321,0,0,0,1.0,1,1.0,1,1.0,1,0.09757553422867825,56
4430,0,9695,3374,6321,0,0,0,1.0,1,1.0,1,1.0,1,0.09061545751388773,55
4431,3,9698,3374,6324,0,0,0,1.0,1,1.0,1,1.0,1,0.07236064624803276,56
4432,0,9698,3374,6324,0,0,0,1.0,1,1.0,1,1.0,1,0.07236064624803276,56
4433,1,9699,3374,6325,0,0,0,1.0,1,1.0,1,1.0,1,0.07616449416370184,57
4434,2,9701,3375,6326,0,0,0,1.0,1,1.0,1,1.0,1,0.08201077736228811,56
4435,1,9702,3376,6326,0,0,0,1.0,1,1.0,1,1.0,1,0.08757820986920585,56
4436,5,9707,3378,6329,0,0,0,1.0,1,1.0,1,1.0,1,0.06834799220765134,55
4437,0,9707,3378,6329,0,0,0,1.0,1,1.0,1,1.0,1,0.07021754319496068,54
4438,2,9709,3380,6329,0,0,0,1.0,1,1.0,1,1.0,1,0.11868105004755218,54
4439,0,9709,3380,6329,0,0,0,1.0,1,1.0,1,1.0,1,0.1582038765751207,55
4440,1,9710,3381,6329,0,0,0,1.0,1,1.0,1,1.0,1,0.17001075125437312,55
4441,5,9715,3383,6332,0,0,0,1.0,1,1.0,1,1.0,1,0.12581209404906643,59
4442,4,9719,3384,6335,0,0,0,1.0,1,1.0,1,1.0,1,0.08902319585906913,61
4443,2,9721,3385,6336,0,0,0,1.0,1,1.0,1,1.0,1,0.10615714208389536,60
4444,5,9726,3385,6341,0,0,0,1.0,1,1.0,1,1.0,1,0.09482732013515642,61
4445,2,9728,3385,6343,0,0,0,1.0,1,1.0,1,1.0,1,0.08954879678428168,61
4446,2,9730,3385,6345,0,0,0,1.0,1,1.0,1,1.0,1,0.09507782624575735,62
4447,0,9730,3385,6345,0,0,0,1.0,1,1.0,1,1.0,1,0.09958939591701571,63
4448,3,9733,3385,6348,0,0,0,1.0,1,1.0,1,1.0,1,0.08177428856977764,63
4449,2,9735,3385,6350,0,0,0,1.0,1,1.0,1,1.0,1,0.08302157551815079,63
4450,0,9735,3385,6350,0,0,0,1.0,1,1.0,1,1.0,1,0.09881495447393053,62
4451,1,9736,3386,6350,0,0,0,1.0,1,1.0,1,1.0,1,0.12163644548260383,63
4452,0,9736,3386,6350,0,0,0,1.0,1,1.0,1,1.0,1,0.12823278504171456,64
4453,1,9737,3386,6351,0,0,0,1.0,1,1.0,1,1.0,1,0.11707549997912342,65
4454,0,9737,3386,6351,0,0,0,1.0,1,1.0,1,1.0,1,0.11917492668986653,66
4455,1,9738,3386,6352,0,0,0,1.0,1,1.0,1,1.0,1,0.11837959033572225,67
4456,5,9743,3387,6356,0,0,0,1.0,1,1.0,1,1.0,1,0.1145907812526673,67
4457,1,9744,3387,6357,0,0,0,1.0,1,1.0,1,1.0,1,0.10446346083275608,65
4458,1,9745,3387,6358,0,0,0,1.0,1,1.0,1,1.0,1,0.127808521129817,65
4459,8,9753,3391,6362,0,0,0,1.0,1,1.0,1,1.0,1,0.13587868144395476,64
4460,2,9755,3391,6364,0,0,0,1.0,1,1.0,1,1.0,1,0.15336173812313184,63
4461,4,9759,3393,6366,0,0,0,1.0,1,1.0,1,1.0,1,0.17126325857477098,62
4462,5,9764,3397,6367,0,0,0,1.0,1,1.0,1,1.0,1,0.19045432255847583,61
4463,2,9766,3398,6368,0,0,0,1.0,1,1.0,1,1.0,1,0.2193382344085969,61
4464,4,9770,3401,6369,0,0,0,1.0,1,1.0,1,1.0,1,0.23591023688240878,58
4465,3,9773,3402,6371,0,0,0,1.0,1,1.0,1,1.0,1,0.21995903976915362,57
4466,6,9779,3403,6376,0,0,0,1.0,1,1.0,1,1.0,1,0.16725528191161543,54
4467,3,9782,3405,6377,0,0,0,1.0,1,1.0,1,1.0,1,0.16240077870916655,52
4468,1,9783,3405,6378,0,0,0,1.0,1,1.0,1,1.0,1,0.16085149390631912,52
4469,1,9784,3406,6378,0,0,0,1.0,1,1.0,1,1.0,1,0.149658369848319,51
4470,4,9788,3409,6379,0,0,0,1.0,1,1.0,1,1.0,1,0.13380546556072798,51
4471,3,9791,3411,6380,0,0,0,1.0,1,1.0,1,1.0,1,0.1034511883703106,50
4472,1,9792,3412,6380,0,0,0,1.0,1,1.0,1,1.0,1,0.09631634948587305,48
4473,0,9792,3412,6380,0,0,0,1.0,1,1.0,1,1.0,1,0.1016225552094399,47
4474,3,9795,3414,6381,0,0,0,1.0,1,1.0,1,1.0,1,0.12843471563213293,49
4475,1,9796,3415,6381,0,0,0,1.0,1,1.0,1,1.0,1,0.19535483378926463,47
4476,6,9802,3417,6385,0,0,0,1.0,1,1.0,1,1.0,1,0.15581421871959986,49
4477,3,9805,3418,6387,0,0,0,1.0,1,1.0,1,1.0,1,0.12177641665690972,48
4478,2,9807,3418,6389,0,0,0,1.0,1,1.0,1,1.0,1,0.10230827070252864,48
4479,0,9807,3418,6389,0,0,0,1.0,1,1.0,1,1.0,1,0.10230827070252864,48
4480,2,9809,3418,6391,0,0,0,1.0,1,1.0,1,1.0,1,0.131490248534781,49
4481,4,9813,3418,6395,0,0,0,1.0,1,1.0,1,1.0,1,0.09036728173301763,49
4482,0,9813,3418,6395,0,0,0,1.0,1,1.0,1,1.0,1,0.09036728173301763,49
4483,1,9814,3418,6396,0,0,0,1.0,1,1.0,1,1.0,1,0.05289522529266195,50
4484,4,9818,3420,6398,0,0,0,1.0,1,1.0,1,1.0,1,0.05758704396335752,52
4485,3,9821,3420,6401,0,0,0,1.0,1,1.0,1,1.0,1,0.07093216032517476,53
4486,3,9824,3421,6403,0,0,0,1.0,1,1.0,1,1.0,1,0.07420167414376397,55
4487,2,9826,3423,6403,0,0,0,1.0,1,1.0,1,1.0,1,0.07664424148135084,55
4488,1,9827,3424,6403,0,0,0,1.0,1,1.0,1,1.0,1,0.11191213136285434,54
4489,0,9827,3424,6403,0,0,0,1.0,1,1.0,1,1.0,1,0.13894036331432774,53
4490,0,9827,3424,6403,0,0,0,1.0,1,1.0,1,1.0,1,0.13894036331432774,53
4491,2,9829,3424,6405,0,0,0,1.0,1,1.0,1,1.0,1,0.1157210922459409,52
4492,2,9831,3425,6406,0,0,0,1.0,1,1.0,1,1.0,1,0.09603196801084084,52
4493,3,9834,3426,6408,0,0,0,1.0,1,1.0,1,1.0,1,0.11575997878669435,52
4494,3,9837,3427,6410,0,0,0,1.0,1,1.0,1,1.0,1,0.1012799358492722,53
4495,2,9839,3428,6411,0,0,0,1.0,1,1.0,1,1.0,1,0.1189876280897786,50
4496,4,9843,3431,6412,0,0,0,1.0,1,1.0,1,1.0,1,0.13646151064398213,51
4497,4,9847,3433,6414,0,0,0,1.0,1,1.0,1,1.0,1,0.11330055985957309,50
4498,2,9849,3435,6414,0,0,0,1.0,1,1.0,1,1.0,1,0.14118900139811755,49
4499,1,9850,3435,6415,0,0,0,1.0,1,1.0,1,1.0,1,0.16079299405650116,48
4500,3,9853,3437,6416,0,0,0,1.0,1,1.0,1,1.0,1,0.197635240474735,48
4501,7,9860,3438,6422,0,0,0,1.0,1,1.0,1,1.0,1,0.14820068819168225,48
4502,2,9862,3439,6423,0,0,0,1.0,1,1.0,1,1.0,1,0.17664377184085464,49
4503,5,9867,3442,6425,0,0,0,1.0,1,1.0,1,1.0,1,0.15648276853238619,49
4504,2,9869,3443,6426,0,0,0,1.0,1,1.0,1,1.0,1,0.21080884588213264,45
4505,3,9872,3445,6427,0,0,0,1.0,1,1.0,1,1.0,1,0.20971145994518242,46
4506,6,9878,3447,6431,0,0,0,1.0,1,1.0,1,1.0,1,0.1823007420021845,45
4507,2,9880,3447,6433,0,0,0,1.0,1,1.0,1,1.0,1,0.13527771591547982,45
4508,3,9883,3449,6434,0,0,0,1.0,1,1.0,1,1.0,1,0.15666137529729146,43
4509,1,9884,3450,6434,0,0,0,1.0,1,1.0,1,1.0,1,0.13747978522733795,41
4510,0,9884,3450,6434,0,0,0,1.0,1,1.0,1,1.0,1,0.15380184949773085,42
4511,3,9887,3450,6437,0,0,0,1.0,1,1.0,1,1.0,1,0.11934492274365416,41
4512,0,9887,3450,6437,0,0,0,1.0,1,1.0,1,1.0,1,0.11934492274365416,41
4513,1,9888,3450,6438,0,0,0,1.0,1,1.0,1,1.0,1,0.09459230542419739,41
4514,5,9893,3454,6439,0,0,0,1.0,1,1.0,1,1.0,1,0.07828462025785417,42
4515,0,9893,3454,6439,0,0,0,1.0,1,1.0,1,1.0,1,0.06905444742150903,41
4516,1,9894,3454,6440,0,0,0,1.0,1,1.0,1,1.0,1,0.11473924492796188,42
4517,1,9895,3455,6440,0,0,0,1.0,1,1.0,1,1.0,1,0.12152886403373651,43
4518,0,9895,3455,6440,0,0,0,1.0,1,1.0,1,1.0,1,0.12001716711127414,42
4519,2,9897,3456,6441,0,0,0,1.0,1,1.0,1,1.0,1,0.1506973305819648,42
4520,1,9898,3456,6442,0,0,0,1.0,1,1.0,1,1.0,1,0.1785484422021672,42
4521,3,9901,3457,6444,0,0,0,1.0,1,1.0,1,1.0,1,0.15345741606470006,42
4522,1,9902,3458,6444,0,0,0,1.0,1,1.0,1,1.0,1,0.14800908845651706,42
4523,0,9902,3458,6444,0,0,0,1.0,1,1.0,1,1.0,1,0.14800908845651706,42
4524,5,9907,3460,6447,0,0,0,1.0,1,1.0,1,1.0,1,0.16097895995437422,43
4525,5,9912,3461,6451,0,0,0,1.0,1,1.0,1,1.0,1,0.18214996317394058,46
4526,6,9918,3463,6455,0,0,0,1.0,1,1.0,1,1.0,1,0.12931935401157146,46
4527,5,9923,3465,6458,0,0,0,1.0,1,1.0,1,1.0,1,0.1628077539903011,47
4528,4,9927,3465,6462,0,0,0,1.0,1,1.0,1,1.0,1,0.14186458076550734,49
4529,1,9928,3465,6463,0,0,0,1.0,1,1.0,1,1.0,1,0.1227367314874653,50
4530,0,9928,3465,6463,0,0,0,1.0,1,1.0,1,1.0,1,0.12600125058029482,51
4531,2,9930,3466,6464,0,0,0,1.0,1,1.0,1,1.0,1,0.11498576608209858,51
4532,3,9933,3468,6465,0,0,0,1.0,1,1.0,1,1.0,1,0.15335679804855493,51
4533,1,9934,3468,6466,0,0,0,1.0,1,1.0,1,1.0,1,0.14186022758626612,50
4534,1,9935,3468,6467,0,0,0,1.0,1,1.0,1,1.0,1,0.12160815469982848,51
4535,1,9936,3469,6467,0,0,0,1.0,1,1.0,1,1.0,1,0.13797673776135308,50
4536,0,9936,3469,6467,0,0,0,1.0,1,1.0,1,1.0,1,0.16460598720382286,48
4537,2,9938,3469,6469,0,0,0,1.0,1,1.0,1,1.0,1,0.13461399320280695,49
4538,3,9941,3469,6472,0,0,0,1.0,1,1.0,1,1.0,1,0.15296912475202118,48
4539,3,9944,3470,6474,0,0,0,1.0,1,1.0,1,1.0,1,0.18197902846489133,50
4540,1,9945,3470,6475,0,0,0,1.0,1,1.0,1,1.0,1,0.1490867664497421,49
4541,3,9948,3472,6476,0,0,0,1.0,1,1.0,1,1.0,1,0.1594431078570501,49
4542,3,9951,3474,6477,0,0,0,1.0,1,1.0,1,1.0,1,0.20241710489711598,47
4543,2,9953,3475,6478,0,0,0,1.0,1,1.0,1,1.0,1,0.18247052774603847,45
4544,1,9954,3476,6478,0,0,0,1.0,1,1.0,1,1.0,1,0.1911517168710363,45
4545,4,9958,3478,6480,0,0,0,1.0,1,1.0,1,1.0,1,0.224721915811701,43
4546,6,9964,3479,6485,0,0,0,1.0,1,1.0,1,1.0,1,0.15201921584920186,43
4547,0,9964,3479,6485,0,0,0,1.0,1,1.0,1,1.0,1,0.1465294581125074,41
4548,2,9966,3480,6486,0,0,0,1.0,1,1.0,1,1.0,1,0.15541957288844657,42
4549,0,9966,3480,6486,0,0,0,1.0,1,1.0,1,1.0,1,0.13867335558083813,41
4550,4,9970,3483,6487,0,0,0,1.0,1,1.0,1,1.0,1,0.14173830988373398,41
4551,2,9972,3484,6488,0,0,0,1.0,1,1.0,1,1.0,1,0.1111806350271375,39
4552,0,9972,3484,6488,0,0,0,1.0,1,1.0,1,1.0,1,0.10990566055369962,38
4553,1,9973,3485,6488,0,0,0,1.0,1,1.0,1,1.0,1,0.13044547211357108,39
4554,1,9974,3486,6488,0,0,0,1.0,1,1.0,1,1.0,1,0.16491910347132752,38
4555,1,9975,3487,6488,0,0,0,1.0,1,1.0,1,1.0,1,0.20245794173191828,37
4556,6,9981,3490,6491,0,0,0,1.0,1,1.0,1,1.0,1,0.18316799487981456,36
4557,2,9983,3490,6493,0,0,0,1.0,1,1.0,1,1.0,1,0.17444798984893659,38
4558,2,9985,3491,6494,0,0,0,1.0,1,1.0,1,1.0,1,0.22080769009493845,39
4559,6,9991,3492,6499,0,0,0,1.0,1,1.0,1,1.0,1,0.28095918128855735,38
4560,10,10001,3492,6509,0,0,0,1.0,1,1.0,1,1.0,1,0.2400280912165942,41
4561,3,10004,3492,6512,0,0,0,1.0,1,1.0,1,1.0,1,0.19871576203659805,41
4562,1,10005,3492,6513,0,0,0,1.0,1,1.0,1,1.0,1,0.18857110784427658,43
4563,0,10005,3492,6513,0,0,0,1.0,1,1.0,1,1.0,1,0.2013661665081109,42
4564,2,10007,3492,6515,0,0,0,1.0,1,1.0,1,1.0,1,0.18812288749914602,43
4565,5,10012,3492,6520,0,0,0,1.0,1,1.0,1,1.0,1,0.13375018012723533,44
4566,1,10013,3492,6521,0,0,0,1.0,1,1.0,1,1.0,1,0.11258807093228032,45
4567,3,10016,3493,6523,0,0,0,1.0,1,1.0,1,1.0,1,0.10132224275417795,47
4568,1,10017,3493,6524,0,0,0,1.0,1,1.0,1,1.0,1,0.11244939744838077,47
4569,2,10019,3494,6525,0,0,0,1.0,1,1.0,1,1.0,1,0.09488314082843531,49
4570,1,10020,3495,6525,0,0,0,1.0,1,1.0,1,1.0,1,0.1066773195084951,49
4571,5,10025,3496,6529,0,0,0,1.0,1,1.0,1,1.0,1,0.12127652559187266,48
4572,2,10027,3496,6531,0,0,0,1.0,1,1.0,1,1.0,1,0.09644158578175611,48
4573,4,10031,3497,6534,0,0,0,1.0,1,1.0,1,1.0,1,0.12139585480050785,48
4574,0,10031,3497,6534,0,0,0,1.0,1,1.0,1,1.0,1,0.126852130184901,50
4575,3,10034,3498,6536,0,0,0,1.0,1,1.0,1,1.0,1,0.15168331131272939,51
4576,1,10035,3498,6537,0,0,0,1.0,1,1.0,1,1.0,1,0.1677908857960472,48
4577,2,10037,3498,6539,0,0,0,1.0,1,1.0,1,1.0,1,0.13675528466077766,47
4578,2,10039,3499,6540,0,0,0,1.0,1,1.0,1,1.0,1,0.16528082677470504,46
4579,2,10041,3499,6542,0,0,0,1.0,1,1.0,1,1.0,1,0.16363603369066784,46
4580,1,10042,3499,6543,0,0,0,1.0,1,1.0,1,1.0,1,0.13485567614195595,47
4581,1,10043,3500,6543,0,0,0,1.0,1,1.0,1,1.0,1,0.15836061330812928,47
4582,2,10045,3500,6545,0,0,0,1.0,1,1.0,1,1.0,1,0.15168084750407856,48
4583,0,10045,3500,6545,0,0,0,1.0,1,1.0,1,1.0,1,0.15168084750407856,48
4584,0,10045,3500,6545,0,0,0,1.0,1,1.0,1,1.0,1,0.16399245356174247,50
4585,1,10046,3501,6545,0,0,0,1.0,1,1.0,1,1.0,1,0.18410490655217454,50
4586,0,10046,3501,6545,0,0,0,1.0,1,1.0,1,1.0,1,0.18410490655217454,50
4587,0,10046,3501,6545,0,0,0,1.0,1,1.0,1,1.0,1,0.18410490655217454,50
4588,0,10046,3501,6545,0,0,0,1.0,1,1.0,1,1.0,1,0.18410490655217454,50
4589,0,10046,3501,6545,0,0,0,1.0,1,1.0,1,1.0,1,0.1956725712176422,52
4590,0,10046,3501,6545,0,0,0,1.0,1,1.0,1,1.0,1,0.1956725712176422,52
4591,3,10049,3501,6548,0,0,0,1.0,1,1.0,1,1.0,1,0.1636350832306409,53
4592,2,10051,3501,6550,0,0,0,1.0,1,1.0,1,1.0,1,0.17210964226371997,54
4593,1,10052,3501,6551,0,0,0,1.0,1,1.0,1,1.0,1,0.14610844156834482,56
4594,1,10053,3501,6552,0,0,0,1.0,1,1.0,1,1.0,1,0.14629082690553244,57
4595,3,10056,3501,6555,0,0,0,1.0,1,1.0,1,1.0,1,0.13326809327762898,56
4596,2,10058,3501,6557,0,0,0,1.0,1,1.0,1,1.0,1,0.11191670895727805,56
4597,0,10058,3501,6557,0,0,0,1.0,1,1.0,1,1.0,1,0.11191670895727805,56
4598,5,10063,3503,6560,0,0,0,1.0,1,1.0,1,1.0,1,0.12853593525226964,57
4599,0,10063,3503,6560,0,0,0,1.0,1,1.0,1,1.0,1,0.10285274441214204,59
4600,0,10063,3503,6560,0,0,0,1.0,1,1.0,1,1.0,1,0.11623193720249102,60
4601,4,10067,3505,6562,0,0,0,1.0,1,1.0,1,1.0,1,0.11895524587222735,60
4602,2,10069,3506,6563,0,0,0,1.0,1,1.0,1,1.0,1,0.1125883206492224,62
4603,2,10071,3506,6565,0,0,0,1.0,1,1.0,1,1.0,1,0.10959510411607705,62
4604,0,10071,3506,6565,0,0,0,1.0,1,1.0,1,1.0,1,0.10453644031371684,63
4605,0,10071,3506,6565,0,0,0,1.0,1,1.0,1,1.0,1,0.10453644031371684,63
4606,2,10073,3506,6567,0,0,0,1.0,1,1.0,1,1.0,1,0.08107355602581423,64
4607,0,10073,3506,6567,0,0,0,1.0,1,1.0,1,1.0,1,0.06833247855369196,65
4608,3,10076,3507,6569,0,0,0,1.0,1,1.0,1,1.0,1,0.1008695246332399,66
4609,2,10078,3508,6570,0,0,0,1.0,1,1.0,1,1.0,1,0.11627568396062846,65
4610,0,10078,3508,6570,0,0,0,1.0,1,1.0,1,1.0,1,0.11615042466418687,63
4611,1,10079,3508,6571,0,0,0,1.0,1,1.0,1,1.0,1,0.11448244929765898,64
4612,0,10079,3508,6571,0,0,0,1.0,1,1.0,1,1.0,1,0.14283054860186253,62
4613,1,10080,3509,6571,0,0,0,1.0,1,1.0,1,1.0,1,0.16836714963939542,63
4614,2,10082,3511,6571,0,0,0,1.0,1,1.0,1,1.0,1,0.14555766850817226,61
4615,1,10083,3512,6571,0,0,0,1.0,1,1.0,1,1.0,1,0.1944379053587504,59
4616,6,10089,3514,6575,0,0,0,1.0,1,1.0,1,1.0,1,0.15359147589068706,58
4617,0,10089,3514,6575,0,0,0,1.0,1,1.0,1,1.0,1,0.17159912436636643,58
4618,3,10092,3515,6577,0,0,0,1.0,1,1.0,1,1.0,1,0.16746781423472343,57
4619,1,10093,3516,6577,0,0,0,1.0,1,1.0,1,1.0,1,0.18389985129668715,57
4620,0,10093,3516,6577,0,0,0,1.0,1,1.0,1,1.0,1,0.18389985129668715,57
4621,5,10098,3517,6581,0,0,0,1.0,1,1.0,1,1.0,1,0.14317728360206167,59
4622,1,10099,3518,6581,0,0,0,1.0,1,1.0,1,1.0,1,0.16831349574380894,60
4623,2,10101,3519,6582,0,0,0,1.0,1,1.0,1,1.0,1,0.17725965583311146,59
4624,2,10103,3520,6583,0,0,0,1.0,1,1.0,1,1.0,1,0.16257983677843119,59
4625,1,10104,3521,6583,0,0,0,1.0,1,1.0,1,1.0,1,0.16675561350642362,57
4626,7,10111,3523,6588,0,0,0,1.0,1,1.0,1,1.0,1,0.09527497901603203,56
4627,0,10111,3523,6588,0,0,0,1.0,1,1.0,1,1.0,1,0.09673639577001834,56
4628,0,10111,3523,6588,0,0,0,1.0,1,1.0,1,1.0,1,0.123619680258163,56
4629,2,10113,3524,6589,0,0,0,1.0,1,1.0,1,1.0,1,0.14701228183387463,56
4630,2,10115,3525,6590,0,0,0,1.0,1,1.0,1,1.0,1,0.13396989099396947,57
4631,2,10117,3525,6592,0,0,0,1.0,1,1.0,1,1.0,1,0.16369715227321946,56
4632,5,10122,3526,6596,0,0,0,1.0,1,1.0,1,1.0,1,0.16942219136630676,57
4633,0,10122,3526,6596,0,0,0,1.0,1,1.0,1,1.0,1,0.15427012680409866,58
4634,0,10122,3526,6596,0,0,0,1.0,1,1.0,1,1.0,1,0.15427012680409866,58
4635,3,10125,3526,6599,0,0,0,1.0,1,1.0,1,1.0,1,0.12131449588612499,59
4636,0,10125,3526,6599,0,0,0,1.0,1,1.0,1,1.0,1,0.10351764316550036,60
4637,0,10125,3526,6599,0,0,0,1.0,1,1.0,1,1.0,1,0.10351764316550036,60
4638,1,10126,3526,6600,0,0,0,1.0,1,1.0,1,1.0,1,0.10232227493019323,61
4639,3,10129,3527,6602,0,0,0,1.0,1,1.0,1,1.0,1,0.09873091142893345,62
4640,0,10129,3527,6602,0,0,0,1.0,1,1.0,1,1.0,1,0.11495936751329876,63
4641,2,10131,3528,6603,0,0,0,1.0,1,1.0,1,1.0,1,0.10549396349040346,63
4642,0,10131,3528,6603,0,0,0,1.0,1,1.0,1,1.0,1,0.11210672523378923,62
4643,4,10135,3531,6604,0,0,0,1.0,1,1.0,1,1.0,1,0.12106062925372985,63
4644,1,10136,3532,6604,0,0,0,1.0,1,1.0,1,1.0,1,0.14795728033193226,62
4645,2,10138,3533,6605,0,0,0,1.0,1,1.0,1,1.0,1,0.1661911579093159,63
4646,7,10145,3536,6609,0,0,0,1.0,1,1.0,1,1.0,1,0.1575573927591705,63
4647,3,10148,3537,6611,0,0,0,1.0,1,1.0,1,1.0,1,0.19037054896759645,62
4648,6,10154,3538,6616,0,0,0,1.0,1,1.0,1,1.0,1,0.1717059695949008,63
4649,0,10154,3538,6616,0,0,0,1.0,1,1.0,1,1.0,1,0.17529524289544768,61
4650,0,10154,3538,6616,0,0,0,1.0,1,1.0,1,1.0,1,0.1568001994840537,63
4651,4,10158,3539,6619,0,0,0,1.0,1,1.0,1,1.0,1,0.1472940116225553,62
4652,0,10158,3539,6619,0,0,0,1.0,1,1.0,1,1.0,1,0.15112285402515283,59
4653,1,10159,3540,6619,0,0,0,1.0,1,1.0,1,1.0,1,0.1702517303615783,60
4654,4,10163,3542,6621,0,0,0,1.0,1,1.0,1,1.0,1,0.18312586985119678,60
4655,1,10164,3542,6622,0,0,0,1.0,1,1.0,1,1.0,1,0.18500554908930897,60
4656,7,10171,3543,6628,0,0,0,1.0,1,1.0,1,1.0,1,0.16998425784329563,61
4657,5,10176,3545,6631,0,0,0,1.0,1,1.0,1,1.0,1,0.16638638651753718,62
4658,0,10176,3545,6631,0,0,0,1.0,1,1.0,1,1.0,1,0.16638638651753718,62
4659,1,10177,3546,6631,0,0,0,1.0,1,1.0,1,1.0,1,0.16929917423412064,61
4660,2,10179,3548,6631,0,0,0,1.0,1,1.0,1,1.0,1,0.22563417797085533,61
4661,4,10183,3548,6635,0,0,0,1.0,1,1.0,1,1.0,1,0.1978963237334326,61
4662,1,10184,3549,6635,0,0,0,1.0,1,1.0,1,1.0,1,0.18674074109348066,62
4663,3,10187,3549,6638,0,0,0,1.0,1,1.0,1,1.0,1,0.1472025178969324,61
4664,4,10191,3551,6640,0,0,0,1.0,1,1.0,1,1.0,1,0.15067724223813178,62
4665,4,10195,3553,6642,0,0,0,1.0,1,1.0,1,1.0,1,0.16589046095705143,61
4666,6,10201,3554,6647,0,0,0,1.0,1,1.0,1,1.0,1,0.10836412358732446,61
4667,1,10202,3555,6647,0,0,0,1.0,1,1.0,1,1.0,1,0.12932996704399588,59
4668,2,10204,3557,6647,0,0,0,1.0,1,1.0,1,1.0,1,0.12797022658107599,59
4669,2,10206,3557,6649,0,0,0,1.0,1,1.0,1,1.0,1,0.14758106314057398,58
4670,3,10209,3560,6649,0,0,0,1.0,1,1.0,1,1.0,1,0.16660270864824972,57
4671,5,10214,3560,6654,0,0,0,1.0,1,1.0,1,1.0,1,0.12880509639210133,55
4672,2,10216,3561,6655,0,0,0,1.0,1,1.0,1,1.0,1,0.14832042678239094,56
4673,0,10216,3561,6655,0,0,0,1.0,1,1.0,1,1.0,1,0.13531801069834223,58
4674,3,10219,3563,6656,0,0,0,1.0,1,1.0,1,1.0,1,0.13338326568709194,58
4675,2,10221,3563,6658,0,0,0,1.0,1,1.0,1,1.0,1,0.13162506362137416,57
4676,4,10225,3564,6661,0,0,0,1.0,1,1.0,1,1.0,1,0.12620202673395722,58
4677,1,10226,3564,6662,0,0,0,1.0,1,1.0,1,1.0,1,0.11909529877200935,57
4678,0,10226,3564,6662,0,0,0,1.0,1,1.0,1,1.0,1,0.11909529877200935,57
4679,0,10226,3564,6662,0,0,0,1.0,1,1.0,1,1.0,1,0.11909529877200935,57
4680,1,10227,3564,6663,0,0,0,1.0,1,1.0,1,1.0,1,0.10359280145478073,59
4681,2,10229,3566,6663,0,0,0,1.0,1,1.0,1,1.0,1,0.12219179698926379,60
4682,1,10230,3567,6663,0,0,0,1.0,1,1.0,1,1.0,1,0.1536009308531278,60
4683,2,10232,3567,6665,0,0,0,1.0,1,1.0,1,1.0,1,0.1335374913252143,60
4684,2,10234,3569,6665,0,0,0,1.0,1,1.0,1,1.0,1,0.19647257537748264,60
4685,5,10239,3571,6668,0,0,0,1.0,1,1.0,1,1.0,1,0.19570668734339067,59
4686,8,10247,3573,6674,0,0,0,1.0,1,1.0,1,1.0,1,0.15072057116136284,60
4687,2,10249,3574,6675,0,0,0,1.0,1,1.0,1,1.0,1,0.16326046416892812,59
4688,2,10251,3574,6677,0,0,0,1.0,1,1.0,1,1.0,1,0.13618620666260264,59
4689,0,10251,3574,6677,0,0,0,1.0,1,1.0,1,1.0,1,0.13964866312731314,59
4690,1,10252,3575,6677,0,0,0,1.0,1,1.0,1,1.0,1,0.17461290121859538,58
4691,5,10257,3576,6681,0,0,0,1.0,1,1.0,1,1.0,1,0.15219448312553496,57
4692,3,10260,3576,6684,0,0,0,1.0,1,1.0,1,1.0,1,0.15128269557772425,58
4693,1,10261,3576,6685,0,0,0,1.0,1,1.0,1,1.0,1,0.1474384729105657,57
4694,2,10263,3577,6686,0,0,0,1.0,1,1.0,1,1.0,1,0.17271488297893453,57
4695,0,10263,3577,6686,0,0,0,1.0,1,1.0,1,1.0,1,0.19131504018625445,56
4696,2,10265,3578,6687,0,0,0,1.0,1,1.0,1,1.0,1,0.20296419270862226,57
4697,2,10267,3578,6689,0,0,0,1.0,1,1.0,1,1.0,1,0.19218826841676115,58
4698,5,10272,3579,6693,0,0,0,1.0,1,1.0,1,1.0,1,0.1791201004551901,59
4699,1,10273,3579,6694,0,0,0,1.0,1,1.0,1,1.0,1,0.18770045380540173,58
4700,0,10273,3579,6694,0,0,0,1.0,1,1.0,1,1.0,1,0.17762751612711353,59
4701,4,10277,3579,6698,0,0,0,1.0,1,1.0,1,1.0,1,0.14760187335846067,60
4702,2,10279,3579,6700,0,0,0,1.0,1,1.0,1,1.0,1,0.1292480426434943,61
4703,1,10280,3580,6700,0,0,0,1.0,1,1.0,1,1.0,1,0.13794233679435552,59
4704,4,10284,3583,6701,0,0,0,1.0,1,1.0,1,1.0,1,0.1435663568974363,58
4705,4,10288,3585,6703,0,0,0,1.0,1,1.0,1,1.0,1,0.16918593178259528,58
4706,7,10295,3587,6708,0,0,0,1.0,1,1.0,1,1.0,1,0.15472579766420666,60
4707,1,10296,3588,6708,0,0,0,1.0,1,1.0,1,1.0,1,0.16525742778175456,57
4708,1,10297,3589,6708,0,0,0,1.0,1,1.0,1,1.0,1,0.18867922682898244,57
4709,1,10298,3590,6708,0,0,0,1.0,1,1.0,1,1.0,1,0.21172158436504035,55
4710,1,10299,3591,6708,0,0,0,1.0,1,1.0,1,1.0,1,0.2533752157543821,53
4711,7,10306,3593,6713,0,0,0,1.0,1,1.0,1,1.0,1,0.17189397431325376,52
4712,5,10311,3596,6715,0,0,0,1.0,1,1.0,1,1.0,1,0.20759701642583628,52
4713,1,10312,3597,6715,0,0,0,1.0,1,1.0,1,1.0,1,0.21629019241472372,51
4714,0,10312,3597,6715,0,0,0,1.0,1,1.0,1,1.0,1,0.20678386356146453,50
4715,0,10312,3597,6715,0,0,0,1.0,1,1.0,1,1.0,1,0.20678386356146453,50
4716,3,10315,3597,6718,0,0,0,1.0,1,1.0,1,1.0,1,0.17263609983607708,49
4717,3,10318,3598,6720,0,0,0,1.0,1,1.0,1,1.0,1,0.19867100096764279,49
4718,4,10322,3598,6724,0,0,0,1.0,1,1.0,1,1.0,1,0.1749143285421416,50
4719,3,10325,3598,6727,0,0,0,1.0,1,1.0,1,1.0,1,0.14601411606471001,49
4720,2,10327,3598,6729,0,0,0,1.0,1,1.0,1,1.0,1,0.14601411606471001,49
4721,3,10330,3598,6732,0,0,0,1.0,1,1.0,1,1.0,1,0.12609202198832237,50
4722,2,10332,3598,6734,0,0,0,1.0,1,1.0,1,1.0,1,0.10430376803183646,51
4723,1,10333,3598,6735,0,0,0,1.0,1,1.0,1,1.0,1,0.10981813525666596,50
4724,2,10335,3598,6737,0,0,0,1.0,1,1.0,1,1.0,1,0.11401640017295897,50
4725,0,10335,3598,6737,0,0,0,1.0,1,1.0,1,1.0,1,0.10968890534809253,52
4726,0,10335,3598,6737,0,0,0,1.0,1,1.0,1,1.0,1,0.12865822647260447,51
4727,1,10336,3598,6738,0,0,0,1.0,1,1.0,1,1.0,1,0.11451816157976004,52
4728,1,10337,3599,6738,0,0,0,1.0,1,1.0,1,1.0,1,0.14013532253233463,52
4729,1,10338,3600,6738,0,0,0,1.0,1,1.0,1,1.0,1,0.16750130951784287,52
4730,1,10339,3601,6738,0,0,0,1.0,1,1.0,1,1.0,1,0.21292878175058647,50
4731,7,10346,3604,6742,0,0,0,1.0,1,1.0,1,1.0,1,0.226838074001325,51
4732,4,10350,3605,6745,0,0,0,1.0,1,1.0,1,1.0,1,0.23737016213406956,52
4733,7,10357,3605,6752,0,0,0,1.0,1,1.0,1,1.0,1,0.2072412591663064,53
4734,5,10362,3606,6756,0,0,0,1.0,1,1.0,1,1.0,1,0.21116790119401707,53
4735,3,10365,3607,6758,0,0,0,1.0,1,1.0,1,1.0,1,0.21893524181103757,53
4736,4,10369,3607,6762,0,0,0,1.0,1,1.0,1,1.0,1,0.18768888642837653,55
4737,1,10370,3607,6763,0,0,0,1.0,1,1.0,1,1.0,1,0.1951949707377623,57
4738,2,10372,3607,6765,0,0,0,1.0,1,1.0,1,1.0,1,0.17122237969442036,57
4739,3,10375,3607,6768,0,0,0,1.0,1,1.0,1,1.0,1,0.15788657259667888,57
4740,0,10375,3607,6768,0,0,0,1.0,1,1.0,1,1.0,1,0.15788657259667888,57
4741,0,10375,3607,6768,0,0,0,1.0,1,1.0,1,1.0,1,0.1642677947997601,58
4742,4,10379,3609,6770,0,0,0,1.0,1,1.0,1,1.0,1,0.16081547144773717,58
4743,0,10379,3609,6770,0,0,0,1.0,1,1.0,1,1.0,1,0.1465291174402982,56
4744,3,10382,3611,6771,0,0,0,1.0,1,1.0,1,1.0,1,0.1479674716808365,57
4745,4,10386,3612,6774,0,0,0,1.0,1,1.0,1,1.0,1,0.10559672638360021,56
4746,6,10392,3615,6777,0,0,0,1.0,1,1.0,1,1.0,1,0.0761283207665819,56
4747,1,10393,3616,6777,0,0,0,1.0,1,1.0,1,1.0,1,0.10376903695232105,55
4748,2,10395,3617,6778,0,0,0,1.0,1,1.0,1,1.0,1,0.10012180835440318,55
4749,5,10400,3619,6781,0,0,0,1.0,1,1.0,1,1.0,1,0.08474635651028692,54
4750,1,10401,3620,6781,0,0,0,1.0,1,1.0,1,1.0,1,0.10474635230198996,53
4751,4,10405,3622,6783,0,0,0,1.0,1,1.0,1,1.0,1,0.1279184919052527,53
4752,1,10406,3623,6783,0,0,0,1.0,1,1.0,1,1.0,1,0.09298690589009341,53
4753,2,10408,3624,6784,0,0,0,1.0,1,1.0,1,1.0,1,0.12179991174181008,52
4754,2,10410,3625,6785,0,0,0,1.0,1,1.0,1,1.0,1,0.13698783939685144,52
4755,1,10411,3625,6786,0,0,0,1.0,1,1.0,1,1.0,1,0.12087681590437507,51
4756,1,10412,3625,6787,0,0,0,1.0,1,1.0,1,1.0,1,0.1086795724586447,52
4757,0,10412,3625,6787,0,0,0,1.0,1,1.0,1,1.0,1,0.12167466382376309,51
4758,0,10412,3625,6787,0,0,0,1.0,1,1.0,1,1.0,1,0.12167466382376309,51
4759,1,10413,3626,6787,0,0,0,1.0,1,1.0,1,1.0,1,0.12922897808213807,51
4760,2,10415,3627,6788,0,0,0,1.0,1,1.0,1,1.0,1,0.15429493745003858,52
4761,7,10422,3628,6794,0,0,0,1.0,1,1.0,1,1.0,1,0.12377990256936745,50
4762,5,10427,3629,6798,0,0,0,1.0,1,1.0,1,1.0,1,0.10578311476116649,51
4763,1,10428,3630,6798,0,0,0,1.0,1,1.0,1,1.0,1,0.12215932788088285,51
4764,7,10435,3633,6802,0,0,0,1.0,1,1.0,1,1.0,1,0.10148451220887979,53
4765,3,10438,3634,6804,0,0,0,1.0,1,1.0,1,1.0,1,0.11309417592840015,53
4766,3,10441,3636,6805,0,0,0,1.0,1,1.0,1,1.0,1,0.13355598876779248,55
4767,1,10442,3637,6805,0,0,0,1.0,1,1.0,1,1.0,1,0.11757988378703622,56
4768,0,10442,3637,6805,0,0,0,1.0,1,1.0,1,1.0,1,0.10069433159389626,56
4769,0,10442,3637,6805,0,0,0,1.0,1,1.0,1,1.0,1,0.10069433159389626,56
4770,0,10442,3637,6805,0,0,0,1.0,1,1.0,1,1.0,1,0.10069433159389626,56
4771,1,10443,3637,6806,0,0,0,1.0,1,1.0,1,1.0,1,0.08919879933520507,55
4772,2,10445,3638,6807,0,0,0,1.0,1,1.0,1,1.0,1,0.09454498050496554,56
4773,0,10445,3638,6807,0,0,0,1.0,1,1.0,1,1.0,1,0.09454498050496554,56
4774,0,10445,3638,6807,0,0,0,1.0,1,1.0,1,1.0,1,0.06565022041366898,58
4775,2,10447,3640,6807,0,0,0,1.0,1,1.0,1,1.0,1,0.08136459572069572,59
4776,0,10447,3640,6807,0,0,0,1.0,1,1.0,1,1.0,1,0.08136459572069572,59
4777,2,10449,3641,6808,0,0,0,1.0,1,1.0,1,1.0,1,0.09134523421620223,60
4778,0,10449,3641,6808,0,0,0,1.0,1,1.0,1,1.0,1,0.09134523421620223,60
4779,1,10450,3641,6809,0,0,0,1.0,1,1.0,1,1.0,1,0.08695844165215987,61
4780,2,10452,3642,6810,0,0,0,1.0,1,1.0,1,1.0,1,0.10528195026153289,63
4781,2,10454,3642,6812,0,0,0,1.0,1,1.0,1,1.0,1,0.09584436734328179,62
4782,4,10458,3644,6814,0,0,0,1.0,1,1.0,1,1.0,1,0.11737120229749902,63
4783,3,10461,3646,6815,0,0,0,1.0,1,1.0,1,1.0,1,0.1073537686586324,62
4784,7,10468,3650,6818,0,0,0,1.0,1,1.0,1,1.0,1,0.13406618575277926,62
4785,6,10474,3653,6821,0,0,0,1.0,1,1.0,1,1.0,1,0.10519278697630034,62
4786,8,10482,3657,6825,0,0,0,1.0,1,1.0,1,1.0,1,0.08060370628640447,63
4787,4,10486,3659,6827,0,0,0,1.0,1,1.0,1,1.0,1,0.10490099215196591,62
4788,3,10489,3662,6827,0,0,0,1.0,1,1.0,1,1.0,1,0.13175519307335193,62
4789,3,10492,3663,6829,0,0,0,1.0,1,1.0,1,1.0,1,0.1317651532558928,60
4790,5,10497,3666,6831,0,0,0,1.0,1,1.0,1,1.0,1,0.133372039820242,61
4791,6,10503,3667,6836,0,0,0,1.0,1,1.0,1,1.0,1,0.09976948980768038,60
4792,6,10509,3669,6840,0,0,0,1.0,1,1.0,1,1.0,1,0.10101117290779905,60
4793,7,10516,3672,6844,0,0,0,1.0,1,1.0,1,1.0,1,0.16029120634636912,61
4794,6,10522,3674,6848,0,0,0,1.0,1,1.0,1,1.0,1,0.16439947147315664,59
4795,9,10531,3675,6856,0,0,0,1.0,1,1.0,1,1.0,1,0.13255899936946536,61
4796,5,10536,3676,6860,0,0,0,1.0,1,1.0,1,1.0,1,0.0820775619730314,59
4797,1,10537,3676,6861,0,0,0,1.0,1,1.0,1,1.0,1,0.1004089622277996,58
4798,2,10539,3677,6862,0,0,0,1.0,1,1.0,1,1.0,1,0.08001524450110026,59
4799,0,10539,3677,6862,0,0,0,1.0,1,1.0,1,1.0,1,0.07635251673960892,57
4800,1,10540,3677,6863,0,0,0,1.0,1,1.0,1,1.0,1,0.08675807615126474,58
4801,5,10545,3679,6866,0,0,0,1.0,1,1.0,1,1.0,1,0.05005075230294486,57
4802,1,10546,3680,6866,0,0,0,1.0,1,1.0,1,1.0,1,0.07232332044496856,57
4803,1,10547,3681,6866,0,0,0,1.0,1,1.0,1,1.0,1,0.0952917074784139,56
4804,2,10549,3681,6868,0,0,0,1.0,1,1.0,1,1.0,1,0.08872425198405172,54
4805,1,10550,3681,6869,0,0,0,1.0,1,1.0,1,1.0,1,0.08703008702857828,56
4806,1,10551,3681,6870,0,0,0,1.0,1,1.0,1,1.0,1,0.07125708795135656,55
4807,2,10553,3682,6871,0,0,0,1.0,1,1.0,1,1.0,1,0.04475070211326926,54
4808,1,10554,3683,6871,0,0,0,1.0,1,1.0,1,1.0,1,0.080385648660583,53
4809,1,10555,3684,6871,0,0,0,1.0,1,1.0,1,1.0,1,0.06746606584958097,53
4810,0,10555,3684,6871,0,0,0,1.0,1,1.0,1,1.0,1,0.08457696811490581,51
4811,1,10556,3684,6872,0,0,0,1.0,1,1.0,1,1.0,1,0.07132911478284433,52
4812,1,10557,3684,6873,0,0,0,1.0,1,1.0,1,1.0,1,0.09681090766119795,52
4813,1,10558,3684,6874,0,0,0,1.0,1,1.0,1,1.0,1,0.09639166457617163,52
4814,4,10562,3686,6876,0,0,0,1.0,1,1.0,1,1.0,1,0.13586721048647732,53
4815,5,10567,3689,6878,0,0,0,1.0,1,1.0,1,1.0,1,0.12000879049908113,54
4816,3,10570,3690,6880,0,0,0,1.0,1,1.0,1,1.0,1,0.07289589938976371,54
4817,5,10575,3694,6881,0,0,0,1.0,1,1.0,1,1.0,1,0.17106631298620187,55
4818,2,10577,3694,6883,0,0,0,1.0,1,1.0,1,1.0,1,0.1399149556387939,55
4819,2,10579,3695,6884,0,0,0,1.0,1,1.0,1,1.0,1,0.1558786180571411,55
4820,4,10583,3697,6886,0,0,0,1.0,1,1.0,1,1.0,1,0.1741913574269753,55
4821,5,10588,3699,6889,0,0,0,1.0,1,1.0,1,1.0,1,0.13443837855846635,55
4822,1,10589,3700,6889,0,0,0,1.0,1,1.0,1,1.0,1,0.14085127715987955,54
4823,4,10593,3701,6892,0,0,0,1.0,1,1.0,1,1.0,1,0.07654340903096044,54
4824,4,10597,3703,6894,0,0,0,1.0,1,1.0,1,1.0,1,0.0703478644910081,55
4825,3,10600,3705,6895,0,0,0,1.0,1,1.0,1,1.0,1,0.10145063354421213,53
4826,3,10603,3706,6897,0,0,0,1.0,1,1.0,1,1.0,1,0.06711869112151271,54
4827,1,10604,3706,6898,0,0,0,1.0,1,1.0,1,1.0,1,0.09394439455774393,53
4828,3,10607,3708,6899,0,0,0,1.0,1,1.0,1,1.0,1,0.07719634779185115,54
4829,0,10607,3708,6899,0,0,0,1.0,1,1.0,1,1.0,1,0.07489932021032727,54
4830,0,10607,3708,6899,0,0,0,1.0,1,1.0,1,1.0,1,0.0814937093575287,53
4831,3,10610,3709,6901,0,0,0,1.0,1,1.0,1,1.0,1,0.08081336296641443,52
4832,0,10610,3709,6901,0,0,0,1.0,1,1.0,1,1.0,1,0.09536145625596185,50
4833,2,10612,3709,6903,0,0,0,1.0,1,1.0,1,1.0,1,0.08782545061448417,51
4834,2,10614,3711,6903,0,0,0,1.0,1,1.0,1,1.0,1,0.15388810838023687,51
4835,0,10614,3711,6903,0,0,0,1.0,1,1.0,1,1.0,1,0.13908564250325187,50
4836,7,10621,3712,6909,0,0,0,1.0,1,1.0,1,1.0,1,0.10763620038678641,50
4837,2,10623,3713,6910,0,0,0,1.0,1,1.0,1,1.0,1,0.16861683221629742,46
4838,1,10624,3713,6911,0,0,0,1.0,1,1.0,1,1.0,1,0.1446567793216409,47
4839,1,10625,3714,6911,0,0,0,1.0,1,1.0,1,1.0,1,0.15252436338635958,45
4840,1,10626,3715,6911,0,0,0,1.0,1,1.0,1,1.0,1,0.19219868904202622,45
4841,7,10633,3716,6917,0,0,0,1.0,1,1.0,1,1.0,1,0.13578316544936406,43
4842,5,10638,3718,6920,0,0,0,1.0,1,1.0,1,1.0,1,0.1893543741812614,43
4843,8,10646,3719,6927,0,0,0,1.0,1,1.0,1,1.0,1,0.19845593367219894,44
4844,2,10648,3719,6929,0,0,0,1.0,1,1.0,1,1.0,1,0.1759163378150527,43
4845,3,10651,3721,6930,0,0,0,1.0,1,1.0,1,1.0,1,0.2168476635445461,44
4846,4,10655,3721,6934,0,0,0,1.0,1,1.0,1,1.0,1,0.1596983903613331,43
4847,4,10659,3724,6935,0,0,0,1.0,1,1.0,1,1.0,1,0.21254424347258735,42
4848,0,10659,3724,6935,0,0,0,1.0,1,1.0,1,1.0,1,0.20046197025465368,41
4849,0,10659,3724,6935,0,0,0,1.0,1,1.0,1,1.0,1,0.15552267274894724,41
4850,2,10661,3724,6937,0,0,0,1.0,1,1.0,1,1.0,1,0.1748786014661059,41
4851,2,10663,3724,6939,0,0,0,1.0,1,1.0,1,1.0,1,0.1347634768886089,41
4852,0,10663,3724,6939,0,0,0,1.0,1,1.0,1,1.0,1,0.1494294656573285,43
4853,2,10665,3726,6939,0,0,0,1.0,1,1.0,1,1.0,1,0.17926026015237043,44
4854,2,10667,3726,6941,0,0,0,1.0,1,1.0,1,1.0,1,0.15911828287524957,45
4855,0,10667,3726,6941,0,0,0,1.0,1,1.0,1,1.0,1,0.16273708088020492,44
4856,2,10669,3727,6942,0,0,0,1.0,1,1.0,1,1.0,1,0.16824858061125444,44
4857,1,10670,3727,6943,0,0,0,1.0,1,1.0,1,1.0,1,0.15661125323569336,44
4858,0,10670,3727,6943,0,0,0,1.0,1,1.0,1,1.0,1,0.1755298221861252,45
4859,0,10670,3727,6943,0,0,0,1.0,1,1.0,1,1.0,1,0.18736230555398375,46
4860,0,10670,3727,6943,0,0,0,1.0,1,1.0,1,1.0,1,0.18736230555398375,46
4861,3,10673,3727,6946,0,0,0,1.0,1,1.0,1,1.0,1,0.14229826985297783,46
4862,3,10676,3727,6949,0,0,0,1.0,1,1.0,1,1.0,1,0.08846362523169232,47
4863,1,10677,3728,6949,0,0,0,1.0,1,1.0,1,1.0,1,0.10616174229362843,47
4864,0,10677,3728,6949,0,0,0,1.0,1,1.0,1,1.0,1,0.10746783862353751,47
4865,5,10682,3729,6953,0,0,0,1.0,1,1.0,1,1.0,1,0.09457770251458766,48
4866,1,10683,3730,6953,0,0,0,1.0,1,1.0,1,1.0,1,0.11600501251908672,49
4867,3,10686,3730,6956,0,0,0,1.0,1,1.0,1,1.0,1,0.08182203181268756,50
4868,1,10687,3731,6956,0,0,0,1.0,1,1.0,1,1.0,1,0.10089043306693063,50
4869,0,10687,3731,6956,0,0,0,1.0,1,1.0,1,1.0,1,0.10089043306693063,50
4870,4,10691,3732,6959,0,0,0,1.0,1,1.0,1,1.0,1,0.11670209439338022,52
4871,3,10694,3732,6962,0,0,0,1.0,1,1.0,1,1.0,1,0.07565055996994266,52
4872,1,10695,3733,6962,0,0,0,1.0,1,1.0,1,1.0,1,0.09864055999314464,53
4873,2,10697,3734,6963,0,0,0,1.0,1,1.0,1,1.0,1,0.11468838328761874,55
4874,2,10699,3736,6963,0,0,0,1.0,1,1.0,1,1.0,1,0.16229688264687384,56
4875,2,10701,3737,6964,0,0,0,1.0,1,1.0,1,1.0,1,0.1329263257352501,55
4876,6,10707,3739,6968,0,0,0,1.0,1,1.0,1,1.0,1,0.12366683150099472,55
4877,4,10711,3740,6971,0,0,0,1.0,1,1.0,1,1.0,1,0.13757969839823736,54
4878,2,10713,3741,6972,0,0,0,1.0,1,1.0,1,1.0,1,0.1404434393777721,53
4879,5,10718,3744,6974,0,0,0,1.0,1,1.0,1,1.0,1,0.2567173301291208,54
4880,4,10722,3744,6978,0,0,0,1.0,1,1.0,1,1.0,1,0.21225538969741858,54
4881,2,10724,3744,6980,0,0,0,1.0,1,1.0,1,1.0,1,0.15602928080826353,53
4882,2,10726,3745,6981,0,0,0,1.0,1,1.0,1,1.0,1,0.16695140461779287,53
4883,0,10726,3745,6981,0,0,0,1.0,1,1.0,1,1.0,1,0.16306548959328632,53
4884,2,10728,3746,6982,0,0,0,1.0,1,1.0,1,1.0,1,0.16407479440057618,51
4885,1,10729,3747,6982,0,0,0,1.0,1,1.0,1,1.0,1,0.17768541836687501,50
4886,1,10730,3747,6983,0,0,0,1.0,1,1.0,1,1.0,1,0.19115738688517053,48
4887,0,10730,3747,6983,0,0,0,1.0,1,1.0,1,1.0,1,0.19115738688517053,48
4888,1,10731,3748,6983,0,0,0,1.0,1,1.0,1,1.0,1,0.20431903222326414,48
4889,0,10731,3748,6983,0,0,0,1.0,1,1.0,1,1.0,1,0.20431903222326414,48
4890,0,10731,3748,6983,0,0,0,1.0,1,1.0,1,1.0,1,0.1987762834268469,49
4891,1,10732,3749,6983,0,0,0,1.0,1,1.0,1,1.0,1,0.2226045215834801,50
4892,1,10733,3749,6984,0,0,0,1.0,1,1.0,1,1.0,1,0.20336245718567347,49
4893,1,10734,3749,6985,0,0,0,1.0,1,1.0,1,1.0,1,0.19615055698093303,50
4894,1,10735,3749,6986,0,0,0,1.0,1,1.0,1,1.0,1,0.17575172574118145,51
4895,0,10735,3749,6986,0,0,0,1.0,1,1.0,1,1.0,1,0.17188140508911406,52
4896,3,10738,3749,6989,0,0,0,1.0,1,1.0,1,1.0,1,0.1304907515755058,53
4897,2,10740,3749,6991,0,0,0,1.0,1,1.0,1,1.0,1,0.1304907515755058,53
4898,1,10741,3749,6992,0,0,0,1.0,1,1.0,1,1.0,1,0.1286729479302729,53
4899,2,10743,3750,6993,0,0,0,1.0,1,1.0,1,1.0,1,0.11536821595666154,55
4900,1,10744,3751,6993,0,0,0,1.0,1,1.0,1,1.0,1,0.11372536392947452,55
4901,2,10746,3752,6994,0,0,0,1.0,1,1.0,1,1.0,1,0.08359602559120935,56
4902,2,10748,3754,6994,0,0,0,1.0,1,1.0,1,1.0,1,0.14111681550889218,58
4903,2,10750,3755,6995,0,0,0,1.0,1,1.0,1,1.0,1,0.12170935928226649,58
4904,3,10753,3757,6996,0,0,0,1.0,1,1.0,1,1.0,1,0.12657033471473184,57
4905,1,10754,3758,6996,0,0,0,1.0,1,1.0,1,1.0,1,0.15713327644337508,54
4906,6,10760,3760,7000,0,0,0,1.0,1,1.0,1,1.0,1,0.14476508938258076,55
4907,0,10760,3760,7000,0,0,0,1.0,1,1.0,1,1.0,1,0.13415605165022298,52
4908,3,10763,3761,7002,0,0,0,1.0,1,1.0,1,1.0,1,0.14747553760672516,53
4909,1,10764,3761,7003,0,0,0,1.0,1,1.0,1,1.0,1,0.1306125523056653,52
4910,1,10765,3761,7004,0,0,0,1.0,1,1.0,1,1.0,1,0.12729946796305822,53
4911,1,10766,3761,7005,0,0,0,1.0,1,1.0,1,1.0,1,0.12133741205961203,55
4912,1,10767,3762,7005,0,0,0,1.0,1,1.0,1,1.0,1,0.14854506558377775,54
4913,1,10768,3762,7006,0,0,0,1.0,1,1.0,1,1.0,1,0.12094641718122738,53
4914,1,10769,3763,7006,0,0,0,1.0,1,1.0,1,1.0,1,0.11239829712737533,53
4915,3,10772,3765,7007,0,0,0,1.0,1,1.0,1,1.0,1,0.10302325065214721,54
4916,1,10773,3765,7008,0,0,0,1.0,1,1.0,1,1.0,1,0.10786989709832243,52
4917,1,10774,3765,7009,0,0,0,1.0,1,1.0,1,1.0,1,0.10066532003906721,52
4918,2,10776,3767,7009,0,0,0,1.0,1,1.0,1,1.0,1,0.14611302347609262,51
4919,0,10776,3767,7009,0,0,0,1.0,1,1.0,1,1.0,1,0.1656484478761784,50
4920,0,10776,3767,7009,0,0,0,1.0,1,1.0,1,1.0,1,0.1624539910158274,51
4921,1,10777,3767,7010,0,0,0,1.0,1,1.0,1,1.0,1,0.14635370271368853,51
4922,3,10780,3768,7012,0,0,0,1.0,1,1.0,1,1.0,1,0.15887889146202078,53
4923,1,10781,3768,7013,0,0,0,1.0,1,1.0,1,1.0,1,0.14284599291310646,53
4924,0,10781,3768,7013,0,0,0,1.0,1,1.0,1,1.0,1,0.1408018731602057,55
4925,2,10783,3770,7013,0,0,0,1.0,1,1.0,1,1.0,1,0.11865645987066079,56
4926,1,10784,3770,7014,0,0,0,1.0,1,1.0,1,1.0,1,0.0942251144109263,55
4927,2,10786,3772,7014,0,0,0,1.0,1,1.0,1,1.0,1,0.09850030261516747,55
4928,0,10786,3772,7014,0,0,0,1.0,1,1.0,1,1.0,1,0.09850030261516747,55
4929,0,10786,3772,7014,0,0,0,1.0,1,1.0,1,1.0,1,0.08949785935565635,56
4930,4,10790,3773,7017,0,0,0,1.0,1,1.0,1,1.0,1,0.06760449682469749,58
4931,0,10790,3773,7017,0,0,0,1.0,1,1.0,1,1.0,1,0.07213675498950074,59
4932,3,10793,3775,7018,0,0,0,1.0,1,1.0,1,1.0,1,0.12437623757667196,60
4933,0,10793,3775,7018,0,0,0,1.0,1,1.0,1,1.0,1,0.12437623757667196,60
4934,0,10793,3775,7018,0,0,0,1.0,1,1.0,1,1.0,1,0.12437623757667196,60
4935,0,10793,3775,7018,0,0,0,1.0,1,1.0,1,1.0,1,0.12437623757667196,60
4936,1,10794,3775,7019,0,0,0,1.0,1,1.0,1,1.0,1,0.11845238274619668,61
4937,2,10796,3775,7021,0,0,0,1.0,1,1.0,1,1.0,1,0.11223619451860851,62
4938,1,10797,3775,7022,0,0,0,1.0,1,1.0,1,1.0,1,0.09070663379220965,62
4939,4,10801,3778,7023,0,0,0,1.0,1,1.0,1,1.0,1,0.11711509793486131,64
4940,4,10805,3778,7027,0,0,0,1.0,1,1.0,1,1.0,1,0.08952922471067898,67
4941,1,10806,3778,7028,0,0,0,1.0,1,1.0,1,1.0,1,0.086288011764419,66
4942,1,10807,3779,7028,0,0,0,1.0,1,1.0,1,1.0,1,0.09552321985225087,67
4943,0,10807,3779,7028,0,0,0,1.0,1,1.0,1,1.0,1,0.10702460050647748,65
4944,3,10810,3782,7028,0,0,0,1.0,1,1.0,1,1.0,1,0.13915741115228145,65
4945,2,10812,3783,7029,0,0,0,1.0,1,1.0,1,1.0,1,0.11565329267271357,62
4946,2,10814,3784,7030,0,0,0,1.0,1,1.0,1,1.0,1,0.09960840654066697,61
4947,1,10815,3785,7030,0,0,0,1.0,1,1.0,1,1.0,1,0.10046743943530444,59
4948,4,10819,3789,7030,0,0,0,1.0,1,1.0,1,1.0,1,0.1434566048968155,59
4949,1,10820,3789,7031,0,0,0,1.0,1,1.0,1,1.0,1,0.1212426478057903,57
4950,10,10830,3796,7034,0,0,0,1.0,1,1.0,1,1.0,1,0.14467578507641726,58
4951,4,10834,3799,7035,0,0,0,1.0,1,1.0,1,1.0,1,0.11992086206410171,55
4952,2,10836,3801,7035,0,0,0,1.0,1,1.0,1,1.0,1,0.1557023663071,53
4953,5,10841,3805,7036,0,0,0,1.0,1,1.0,1,1.0,1,0.19533488424894963,54
4954,1,10842,3805,7037,0,0,0,1.0,1,1.0,1,1.0,1,0.15424041913972464,52
4955,1,10843,3806,7037,0,0,0,1.0,1,1.0,1,1.0,1,0.17236696056320835,51
4956,5,10848,3806,7042,0,0,0,1.0,1,1.0,1,1.0,1,0.09433818764599436,47
4957,2,10850,3806,7044,0,0,0,1.0,1,1.0,1,1.0,1,0.10169320477413804,48
4958,1,10851,3806,7045,0,0,0,1.0,1,1.0,1,1.0,1,0.08018420826884651,47
4959,2,10853,3806,7047,0,0,0,1.0,1,1.0,1,1.0,1,0.08018420826884651,47
4960,2,10855,3806,7049,0,0,0,1.0,1,1.0,1,1.0,1,0.08922207389527836,48
4961,3,10858,3808,7050,0,0,0,1.0,1,1.0,1,1.0,1,0.10792802553660066,49
4962,0,10858,3808,7050,0,0,0,1.0,1,1.0,1,1.0,1,0.10792802553660066,49
4963,0,10858,3808,7050,0,0,0,1.0,1,1.0,1,1.0,1,0.12054906024713989,51
4964,4,10862,3811,7051,0,0,0,1.0,1,1.0,1,1.0,1,0.15648504367472388,51
4965,3,10865,3811,7054,0,0,0,1.0,1,1.0,1,1.0,1,0.1478576093788252,51
4966,5,10870,3811,7059,0,0,0,1.0,1,1.0,1,1.0,1,0.042171626562415396,51
4967,1,10871,3812,7059,0,0,0,1.0,1,1.0,1,1.0,1,0.08185851333688467,51
4968,2,10873,3813,7060,0,0,0,1.0,1,1.0,1,1.0,1,0.09997030414695936,52
4969,4,10877,3815,7062,0,0,0,1.0,1,1.0,1,1.0,1,0.10939146332014303,53
4970,4,10881,3816,7065,0,0,0,1.0,1,1.0,1,1.0,1,0.13263711785737195,54
4971,7,10888,3816,7072,0,0,0,1.0,1,1.0,1,1.0,1,0.11412296417903357,55
4972,2,10890,3816,7074,0,0,0,1.0,1,1.0,1,1.0,1,0.1169561887083437,56
4973,3,10893,3817,7076,0,0,0,1.0,1,1.0,1,1.0,1,0.13250806132298357,57
4974,4,10897,3817,7080,0,0,0,1.0,1,1.0,1,1.0,1,0.14192022683039668,56
4975,4,10901,3817,7084,0,0,0,1.0,1,1.0,1,1.0,1,0.12618718340696364,57
4976,4,10905,3818,7087,0,0,0,1.0,1,1.0,1,1.0,1,0.09919666968382818,57
4977,1,10906,3818,7088,0,0,0,1.0,1,1.0,1,1.0,1,0.07018435673333386,57
4978,2,10908,3820,7088,0,0,0,1.0,1,1.0,1,1.0,1,0.09662612688212206,58
4979,1,10909,3821,7088,0,0,0,1.0,1,1.0,1,1.0,1,0.13303833507595544,58
4980,1,10910,3821,7089,0,0,0,1.0,1,1.0,1,1.0,1,0.1591370993746221,59
4981,10,10920,3822,7098,0,0,0,1.0,1,1.0,1,1.0,1,0.11455232856688852,60
4982,1,10921,3822,7099,0,0,0,1.0,1,1.0,1,1.0,1,0.10212332991147907,61
4983,12,10933,3825,7108,0,0,0,1.0,1,1.0,1,1.0,1,0.13186329693058382,61
4984,6,10939,3827,7112,0,0,0,1.0,1,1.0,1,1.0,1,0.1006274621955176,59
4985,3,10942,3827,7115,0,0,0,1.0,1,1.0,1,1.0,1,0.06988170675181092,58
4986,1,10943,3827,7116,0,0,0,1.0,1,1.0,1,1.0,1,0.05702646397922634,59
4987,3,10946,3829,7117,0,0,0,1.0,1,1.0,1,1.0,1,0.07542685829280898,58
4988,1,10947,3830,7117,0,0,0,1.0,1,1.0,1,1.0,1,0.08800623089737468,57
4989,0,10947,3830,7117,0,0,0,1.0,1,1.0,1,1.0,1,0.09943315582619391,54
4990,3,10950,3831,7119,0,0,0,1.0,1,1.0,1,1.0,1,0.09747306567497006,53
4991,6,10956,3836,7120,0,0,0,1.0,1,1.0,1,1.0,1,0.15983137273758485,52
4992,5,10961,3838,7123,0,0,0,1.0,1,1.0,1,1.0,1,0.16896291329590682,48
4993,2,10963,3839,7124,0,0,0,1.0,1,1.0,1,1.0,1,0.1799460250551148,48
4994,4,10967,3840,7127,0,0,0,1.0,1,1.0,1,1.0,1,0.16772801990070058,45
4995,2,10969,3841,7128,0,0,0,1.0,1,1.0,1,1.0,1,0.22112348636271542,45
4996,7,10976,3844,7132,0,0,0,1.0,1,1.0,1,1.0,1,0.18477646341876006,45
4997,4,10980,3845,7135,0,0,0,1.0,1,1.0,1,1.0,1,0.18984112527134067,42
4998,4,10984,3846,7138,0,0,0,1.0,1,1.0,1,1.0,1,0.16970845717789196,44
4999,0,10984,3846,7138,0,0,0,1.0,1,1.0,1,1.0,1,0.16639564997737924,44
5000,0,10984,3846,7138,0,0,0,1.0,1,1.0,1,1.0,1,0.18033244754769082,42
5001,2,10986,3846,7140,0,0,0,1.0,1,1.0,1,1.0,1,0.16055544642325045,42
5002,0,10986,3846,7140,0,0,0,1.0,1,1.0,1,1.0,1,0.16374265230210377,41
5003,4,10990,3847,7143,0,0,0,1.0,1,1.0,1,1.0,1,0.20051655810118196,41
5004,0,10990,3847,7143,0,0,0,1.0,1,1.0,1,1.0,1,0.20193705435537382,41
5005,0,10990,3847,7143,0,0,0,1.0,1,1.0,1,1.0,1,0.20193705435537382,41
5006,1,10991,3847,7144,0,0,0,1.0,1,1.0,1,1.0,1,0.1848540836210193,42
5007,0,10991,3847,7144,0,0,0,1.0,1,1.0,1,1.0,1,0.1862405948922621,43
5008,4,10995,3848,7147,0,0,0,1.0,1,1.0,1,1.0,1,0.16424015972575956,46
5009,0,10995,3848,7147,0,0,0,1.0,1,1.0,1,1.0,1,0.16424015972575956,46
5010,0,10995,3848,7147,0,0,0,1.0,1,1.0,1,1.0,1,0.1787357528215182,46
5011,4,10999,3848,7151,0,0,0,1.0,1,1.0,1,1.0,1,0.12875826222939593,47
5012,0,10999,3848,7151,0,0,0,1.0,1,1.0,1,1.0,1,0.12704691298633655,48
5013,0,10999,3848,7151,0,0,0,1.0,1,1.0,1,1.0,1,0.12704691298633655,48
5014,1,11000,3848,7152,0,0,0,1.0,1,1.0,1,1.0,1,0.11974133296633348,49
5015,1,11001,3848,7153,0,0,0,1.0,1,1.0,1,1.0,1,0.09637209354526871,50
5016,4,11005,3850,7155,0,0,0,1.0,1,1.0,1,1.0,1,0.1397839153437115,51
5017,1,11006,3850,7156,0,0,0,1.0,1,1.0,1,1.0,1,0.12286524606722536,51
5018,0,11006,3850,7156,0,0,0,1.0,1,1.0,1,1.0,1,0.12286524606722536,51
5019,3,11009,3853,7156,0,0,0,1.0,1,1.0,1,1.0,1,0.16231273417100406,51
5020,0,11009,3853,7156,0,0,0,1.0,1,1.0,1,1.0,1,0.16231273417100406,51
5021,4,11013,3854,7159,0,0,0,1.0,1,1.0,1,1.0,1,0.10973996047623981,52
5022,0,11013,3854,7159,0,0,0,1.0,1,1.0,1,1.0,1,0.10973996047623981,52
5023,6,11019,3857,7162,0,0,0,1.0,1,1.0,1,1.0,1,0.0992818408132361,52
5024,4,11023,3860,7163,0,0,0,1.0,1,1.0,1,1.0,1,0.1514013176159861,51
5025,0,11023,3860,7163,0,0,0,1.0,1,1.0,1,1.0,1,0.1332915930024364,50
5026,6,11029,3861,7168,0,0,0,1.0,1,1.0,1,1.0,1,0.11308293589123641,49
5027,3,11032,3863,7169,0,0,0,1.0,1,1.0,1,1.0,1,0.15403923541462322,47
5028,4,11036,3865,7171,0,0,0,1.0,1,1.0,1,1.0,1,0.17992510571503148,47
5029,5,11041,3867,7174,0,0,0,1.0,1,1.0,1,1.0,1,0.23491583774675587,46
5030,3,11044,3867,7177,0,0,0,1.0,1,1.0,1,1.0,1,0.23384632495866153,48
5031,7,11051,3868,7183,0,0,0,1.0,1,1.0,1,1.0,1,0.17928645572418844,46
5032,2,11053,3869,7184,0,0,0,1.0,1,1.0,1,1.0,1,0.19388874821846486,46
5033,2,11055,3870,7185,0,0,0,1.0,1,1.0,1,1.0,1,0.18518076566929242,47
5034,6,11061,3871,7190,0,0,0,1.0,1,1.0,1,1.0,1,0.1817634986110937,48
5035,1,11062,3871,7191,0,0,0,1.0,1,1.0,1,1.0,1,0.1715328020377734,47
5036,2,11064,3871,7193,0,0,0,1.0,1,1.0,1,1.0,1,0.15056292238483948,47
5037,0,11064,3871,7193,0,0,0,1.0,1,1.0,1,1.0,1,0.14931868520623004,47
5038,3,11067,3872,7195,0,0,0,1.0,1,1.0,1,1.0,1,0.13707259225795465,48
5039,1,11068,3872,7196,0,0,0,1.0,1,1.0,1,1.0,1,0.10446098846942456,47
5040,0,11068,3872,7196,0,0,0,1.0,1,1.0,1,1.0,1,0.1168998471899301,48
5041,0,11068,3872,7196,0,0,0,1.0,1,1.0,1,1.0,1,0.12271941268364263,49
5042,3,11071,3872,7199,0,0,0,1.0,1,1.0,1,1.0,1,0.10597590510640206,50
5043,0,11071,3872,7199,0,0,0,1.0,1,1.0,1,1.0,1,0.09003682499873379,51
5044,0,11071,3872,7199,0,0,0,1.0,1,1.0,1,1.0,1,0.09003682499873379,51
5045,0,11071,3872,7199,0,0,0,1.0,1,1.0,1,1.0,1,0.09003682499873379,51
5046,4,11075,3874,7201,0,0,0,1.0,1,1.0,1,1.0,1,0.07598049397300931,52
5047,0,11075,3874,7201,0,0,0,1.0,1,1.0,1,1.0,1,0.08767826889280735,52
5048,0,11075,3874,7201,0,0,0,1.0,1,1.0,1,1.0,1,0.08767826889280735,52
5049,0,11075,3874,7201,0,0,0,1.0,1,1.0,1,1.0,1,0.12946957050768085,52
5050,3,11078,3875,7203,0,0,0,1.0,1,1.0,1,1.0,1,0.12188607824416124,55
5051,3,11081,3875,7206,0,0,0,1.0,1,1.0,1,1.0,1,0.11291484526995851,55
5052,0,11081,3875,7206,0,0,0,1.0,1,1.0,1,1.0,1,0.11291484526995851,55
5053,1,11082,3875,7207,0,0,0,1.0,1,1.0,1,1.0,1,0.10590509481278088,54
5054,1,11083,3876,7207,0,0,0,1.0,1,1.0,1,1.0,1,0.11685634483254632,54
5055,1,11084,3876,7208,0,0,0,1.0,1,1.0,1,1.0,1,0.12139153774440965,54
5056,1,11085,3876,7209,0,0,0,1.0,1,1.0,1,1.0,1,0.12209650566753422,55
5057,1,11086,3876,7210,0,0,0,1.0,1,1.0,1,1.0,1,0.12390426591216634,56
5058,6,11092,3878,7214,0,0,0,1.0,1,1.0,1,1.0,1,0.09558156003950531,58
5059,3,11095,3878,7217,0,0,0,1.0,1,1.0,1,1.0,1,0.06529772025712978,58
5060,2,11097,3880,7217,0,0,0,1.0,1,1.0,1,1.0,1,0.09040736307298071,59
5061,2,11099,3880,7219,0,0,0,1.0,1,1.0,1,1.0,1,0.06149928762312679,58
5062,1,11100,3881,7219,0,0,0,1.0,1,1.0,1,1.0,1,0.07553177025028235,58
5063,5,11105,3885,7220,0,0,0,1.0,1,1.0,1,1.0,1,0.11251625261759475,57
5064,5,11110,3887,7223,0,0,0,1.0,1,1.0,1,1.0,1,0.1379018120392009,57
5065,3,11113,3888,7225,0,0,0,1.0,1,1.0,1,1.0,1,0.12901618779642945,56
5066,6,11119,3891,7228,0,0,0,1.0,1,1.0,1,1.0,1,0.18929972676871357,55
5067,2,11121,3892,7229,0,0,0,1.0,1,1.0,1,1.0,1,0.17211432863716072,54
5068,5,11126,3894,7232,0,0,0,1.0,1,1.0,1,1.0,1,0.17629460294007368,54
5069,6,11132,3895,7237,0,0,0,1.0,1,1.0,1,1.0,1,0.14903715888543992,53
5070,4,11136,3895,7241,0,0,0,1.0,1,1.0,1,1.0,1,0.15267074335480288,53
5071,2,11138,3895,7243,0,0,0,1.0,1,1.0,1,1.0,1,0.10267224212189992,53
5072,0,11138,3895,7243,0,0,0,1.0,1,1.0,1,1.0,1,0.08515817079903999,53
5073,1,11139,3896,7243,0,0,0,1.0,1,1.0,1,1.0,1,0.09439386604142938,53
5074,1,11140,3896,7244,0,0,0,1.0,1,1.0,1,1.0,1,0.0858991426079249,52
5075,0,11140,3896,7244,0,0,0,1.0,1,1.0,1,1.0,1,0.0858991426079249,52
5076,2,11142,3896,7246,0,0,0,1.0,1,1.0,1,1.0,1,0.06081470185923547,55
5077,4,11146,3897,7249,0,0,0,1.0,1,1.0,1,1.0,1,0.11543805554528122,55
5078,2,11148,3897,7251,0,0,0,1.0,1,1.0,1,1.0,1,0.11543805554528122,55
5079,1,11149,3897,7252,0,0,0,1.0,1,1.0,1,1.0,1,0.11942425481441467,54
5080,5,11154,3898,7256,0,0,0,1.0,1,1.0,1,1.0,1,0.14210738516488158,55
5081,4,11158,3898,7260,0,0,0,1.0,1,1.0,1,1.0,1,0.10226229995956064,57
5082,1,11159,3898,7261,0,0,0,1.0,1,1.0,1,1.0,1,0.09853528613517536,57
5083,5,11164,3899,7265,0,0,0,1.0,1,1.0,1,1.0,1,0.12148605156746002,58
5084,2,11166,3899,7267,0,0,0,1.0,1,1.0,1,1.0,1,0.12148605156746002,58
5085,1,11167,3899,7268,0,0,0,1.0,1,1.0,1,1.0,1,0.09000734992487304,59
5086,4,11171,3899,7272,0,0,0,1.0,1,1.0,1,1.0,1,0.08900752730892236,60
5087,5,11176,3902,7274,0,0,0,1.0,1,1.0,1,1.0,1,0.12913441795108255,61
5088,4,11180,3903,7277,0,0,0,1.0,1,1.0,1,1.0,1,0.1504329571336543,62
5089,8,11188,3905,7283,0,0,0,1.0,1,1.0,1,1.0,1,0.14516948689574924,63
5090,4,11192,3905,7287,0,0,0,1.0,1,1.0,1,1.0,1,0.15039977852865077,63
5091,8,11200,3907,7293,0,0,0,1.0,1,1.0,1,1.0,1,0.14584752928703534,63
5092,3,11203,3908,7295,0,0,0,1.0,1,1.0,1,1.0,1,0.15836917447712653,63
5093,4,11207,3909,7298,0,0,0,1.0,1,1.0,1,1.0,1,0.13308714275617614,63
5094,5,11212,3912,7300,0,0,0,1.0,1,1.0,1,1.0,1,0.13518724117771122,64
5095,4,11216,3913,7303,0,0,0,1.0,1,1.0,1,1.0,1,0.13773586170769603,64
5096,5,11221,3914,7307,0,0,0,1.0,1,1.0,1,1.0,1,0.10265326005159536,67
5097,1,11222,3914,7308,0,0,0,1.0,1,1.0,1,1.0,1,0.10417103498416241,67
5098,4,11226,3914,7312,0,0,0,1.0,1,1.0,1,1.0,1,0.08827628950561192,68
5099,3,11229,3914,7315,0,0,0,1.0,1,1.0,1,1.0,1,0.0969553309431139,70
5100,2,11231,3914,7317,0,0,0,1.0,1,1.0,1,1.0,1,0.10140152922851572,71
5101,3,11234,3915,7319,0,0,0,1.0,1,1.0,1,1.0,1,0.08478836941739616,71
5102,2,11236,3916,7320,0,0,0,1.0,1,1.0,1,1.0,1,0.09310555910808348,70
5103,0,11236,3916,7320,0,0,0,1.0,1,1.0,1,1.0,1,0.07765222380852368,67
5104,3,11239,3919,7320,0,0,0,1.0,1,1.0,1,1.0,1,0.13036326520454575,67
5105,2,11241,3920,7321,0,0,0,1.0,1,1.0,1,1.0,1,0.11042266103758622,63
5106,7,11248,3923,7325,0,0,0,1.0,1,1.0,1,1.0,1,0.07986183681960031,63
5107,6,11254,3928,7326,0,0,0,1.0,1,1.0,1,1.0,1,0.104362162541278,60
5108,2,11256,3929,7327,0,0,0,1.0,1,1.0,1,1.0,1,0.1095962722300508,56
5109,9,11265,3933,7332,0,0,0,1.0,1,1.0,1,1.0,1,0.14378054025421824,56
5110,2,11267,3935,7332,0,0,0,1.0,1,1.0,1,1.0,1,0.16693677807976764,52
5111,12,11279,3941,7338,0,0,0,1.0,1,1.0,1,1.0,1,0.12264494233830303,51
5112,5,11284,3943,7341,0,0,0,1.0,1,1.0,1,1.0,1,0.1581940492340105,50
5113,2,11286,3945,7341,0,0,0,1.0,1,1.0,1,1.0,1,0.22734635979350595,48
5114,3,11289,3946,7343,0,0,0,1.0,1,1.0,1,1.0,1,0.20737268598090255,46
5115,2,11291,3946,7345,0,0,0,1.0,1,1.0,1,1.0,1,0.21855942214109558,44
5116,6,11297,3948,7349,0,0,0,1.0,1,1.0,1,1.0,1,0.15474180776161203,44
5117,5,11302,3948,7354,0,0,0,1.0,1,1.0,1,1.0,1,0.12738986966442886,46
5118,4,11306,3948,7358,0,0,0,1.0,1,1.0,1,1.0,1,0.11384438103496845,46
5119,6,11312,3948,7364,0,0,0,1.0,1,1.0,1,1.0,1,0.126289809896856,46
5120,5,11317,3948,7369,0,0,0,1.0,1,1.0,1,1.0,1,0.12589993468198743,46
5121,4,11321,3949,7372,0,0,0,1.0,1,1.0,1,1.0,1,0.10085312648439125,46
5122,2,11323,3950,7373,0,0,0,1.0,1,1.0,1,1.0,1,0.0784273802864938,46
5123,5,11328,3952,7376,0,0,0,1.0,1,1.0,1,1.0,1,0.13494215039755825,45
5124,3,11331,3953,7378,0,0,0,1.0,1,1.0,1,1.0,1,0.14940352248485114,47
5125,6,11337,3953,7384,0,0,0,1.0,1,1.0,1,1.0,1,0.19106195048672833,50
5126,8,11345,3954,7391,0,0,0,1.0,1,1.0,1,1.0,1,0.08617620185287812,50
5127,4,11349,3955,7394,0,0,0,1.0,1,1.0,1,1.0,1,0.07984614100860558,52
5128,2,11351,3956,7395,0,0,0,1.0,1,1.0,1,1.0,1,0.06473286664554133,53
5129,0,11351,3956,7395,0,0,0,1.0,1,1.0,1,1.0,1,0.07723978623229412,55
5130,1,11352,3957,7395,0,0,0,1.0,1,1.0,1,1.0,1,0.10552627525124401,55
5131,0,11352,3957,7395,0,0,0,1.0,1,1.0,1,1.0,1,0.09535819951288259,54
5132,1,11353,3957,7396,0,0,0,1.0,1,1.0,1,1.0,1,0.10474216866405672,54
5133,0,11353,3957,7396,0,0,0,1.0,1,1.0,1,1.0,1,0.10474216866405672,54
5134,0,11353,3957,7396,0,0,0,1.0,1,1.0,1,1.0,1,0.10730594731982092,53
5135,2,11355,3957,7398,0,0,0,1.0,1,1.0,1,1.0,1,0.09623844905843366,54
5136,1,11356,3957,7399,0,0,0,1.0,1,1.0,1,1.0,1,0.10662943478027294,54
5137,2,11358,3957,7401,0,0,0,1.0,1,1.0,1,1.0,1,0.079968227915489,54
5138,3,11361,3958,7403,0,0,0,1.0,1,1.0,1,1.0,1,0.1108698586394117,54
5139,0,11361,3958,7403,0,0,0,1.0,1,1.0,1,1.0,1,0.09783134248074163,55
5140,3,11364,3961,7403,0,0,0,1.0,1,1.0,1,1.0,1,0.1255047577092787,55
5141,2,11366,3961,7405,0,0,0,1.0,1,1.0,1,1.0,1,0.10285055972896585,53
5142,6,11372,3964,7408,0,0,0,1.0,1,1.0,1,1.0,1,0.07325410421314729,54
5143,4,11376,3966,7410,0,0,0,1.0,1,1.0,1,1.0,1,0.07181327949815751,52
5144,3,11379,3968,7411,0,0,0,1.0,1,1.0,1,1.0,1,0.14125702353824546,50
5145,1,11380,3969,7411,0,0,0,1.0,1,1.0,1,1.0,1,0.11845279478101858,49
5146,3,11383,3969,7414,0,0,0,1.0,1,1.0,1,1.0,1,0.0738568596975993,49
5147,2,11385,3971,7414,0,0,0,1.0,1,1.0,1,1.0,1,0.0993481991131991,46
5148,1,11386,3972,7414,0,0,0,1.0,1,1.0,1,1.0,1,0.08587599245554112,46
5149,1,11387,3973,7414,0,0,0,1.0,1,1.0,1,1.0,1,0.0748803905880266,45
5150,6,11393,3975,7418,0,0,0,1.0,1,1.0,1,1.0,1,0.12574852612418597,47
5151,3,11396,3975,7421,0,0,0,1.0,1,1.0,1,1.0,1,0.11090220309266205,46
5152,4,11400,3979,7421,0,0,0,1.0,1,1.0,1,1.0,1,0.1789846991360394,46
5153,1,11401,3979,7422,0,0,0,1.0,1,1.0,1,1.0,1,0.16155851189770304,45
5154,2,11403,3980,7423,0,0,0,1.0,1,1.0,1,1.0,1,0.21213944315062444,47
5155,4,11407,3981,7426,0,0,0,1.0,1,1.0,1,1.0,1,0.21208291375136976,47
5156,7,11414,3982,7432,0,0,0,1.0,1,1.0,1,1.0,1,0.14069743149670066,47
5157,0,11414,3982,7432,0,0,0,1.0,1,1.0,1,1.0,1,0.14602600493279744,46
5158,0,11414,3982,7432,0,0,0,1.0,1,1.0,1,1.0,1,0.14056325808084158,47
5159,1,11415,3982,7433,0,0,0,1.0,1,1.0,1,1.0,1,0.12397452120521014,49
5160,1,11416,3982,7434,0,0,0,1.0,1,1.0,1,1.0,1,0.11177902720873317,48
5161,0,11416,3982,7434,0,0,0,1.0,1,1.0,1,1.0,1,0.11177902720873317,48
5162,0,11416,3982,7434,0,0,0,1.0,1,1.0,1,1.0,1,0.09678812047161657,49
5163,2,11418,3983,7435,0,0,0,1.0,1,1.0,1,1.0,1,0.11871099743594372,51
5164,0,11418,3983,7435,0,0,0,1.0,1,1.0,1,1.0,1,0.11871099743594372,51
5165,3,11421,3984,7437,0,0,0,1.0,1,1.0,1,1.0,1,0.11365730100274224,52
5166,2,11423,3985,7438,0,0,0,1.0,1,1.0,1,1.0,1,0.10475569185770484,52
5167,3,11426,3987,7439,0,0,0,1.0,1,1.0,1,1.0,1,0.12121537309399966,52
5168,1,11427,3987,7440,0,0,0,1.0,1,1.0,1,1.0,1,0.10047451661953061,52
5169,1,11428,3988,7440,0,0,0,1.0,1,1.0,1,1.0,1,0.11248664309040174,53
5170,2,11430,3988,7442,0,0,0,1.0,1,1.0,1,1.0,1,0.10108795768039432,53
5171,2,11432,3988,7444,0,0,0,1.0,1,1.0,1,1.0,1,0.05714152491747453,52
5172,1,11433,3989,7444,0,0,0,1.0,1,1.0,1,1.0,1,0.0845408385320401,53
5173,2,11435,3989,7446,0,0,0,1.0,1,1.0,1,1.0,1,0.07929758667739498,54
5174,2,11437,3990,7447,0,0,0,1.0,1,1.0,1,1.0,1,0.0788333996463881,56
5175,3,11440,3991,7449,0,0,0,1.0,1,1.0,1,1.0,1,0.084857989589747,58
5176,2,11442,3992,7450,0,0,0,1.0,1,1.0,1,1.0,1,0.08565157692602295,58
5177,2,11444,3992,7452,0,0,0,1.0,1,1.0,1,1.0,1,0.05990521586682916,59
5178,1,11445,3993,7452,0,0,0,1.0,1,1.0,1,1.0,1,0.08284840844363042,57
5179,1,11446,3994,7452,0,0,0,1.0,1,1.0,1,1.0,1,0.07621999354809801,58
5180,1,11447,3995,7452,0,0,0,1.0,1,1.0,1,1.0,1,0.07653658731957447,56
5181,2,11449,3997,7452,0,0,0,1.0,1,1.0,1,1.0,1,0.10457914852693014,57
5182,4,11453,3998,7455,0,0,0,1.0,1,1.0,1,1.0,1,0.0844389291039332,56
5183,0,11453,3998,7455,0,0,0,1.0,1,1.0,1,1.0,1,0.09301745631762216,57
5184,3,11456,4001,7455,0,0,0,1.0,1,1.0,1,1.0,1,0.13191507025121846,56
5185,0,11456,4001,7455,0,0,0,1.0,1,1.0,1,1.0,1,0.135120702541915,56
5186,6,11462,4004,7458,0,0,0,1.0,1,1.0,1,1.0,1,0.13239843776300875,54
5187,1,11463,4004,7459,0,0,0,1.0,1,1.0,1,1.0,1,0.12591163373296133,51
5188,3,11466,4005,7461,0,0,0,1.0,1,1.0,1,1.0,1,0.11513483536148111,50
5189,0,11466,4005,7461,0,0,0,1.0,1,1.0,1,1.0,1,0.12825910436737134,49
5190,2,11468,4007,7461,0,0,0,1.0,1,1.0,1,1.0,1,0.1540780729255623,50
5191,4,11472,4007,7465,0,0,0,1.0,1,1.0,1,1.0,1,0.06453948023161102,50
5192,2,11474,4009,7465,0,0,0,1.0,1,1.0,1,1.0,1,0.11021460355894769,49
5193,3,11477,4010,7467,0,0,0,1.0,1,1.0,1,1.0,1,0.11167123929461477,50
5194,6,11483,4011,7472,0,0,0,1.0,1,1.0,1,1.0,1,0.13268263491336013,51
5195,3,11486,4011,7475,0,0,0,1.0,1,1.0,1,1.0,1,0.12760936271195708,51
5196,1,11487,4011,7476,0,0,0,1.0,1,1.0,1,1.0,1,0.11711066268732379,51
5197,0,11487,4011,7476,0,0,0,1.0,1,1.0,1,1.0,1,0.11711066268732379,51
5198,0,11487,4011,7476,0,0,0,1.0,1,1.0,1,1.0,1,0.11711066268732379,51
5199,1,11488,4011,7477,0,0,0,1.0,1,1.0,1,1.0,1,0.1024269890130849,54
5200,1,11489,4012,7477,0,0,0,1.0,1,1.0,1,1.0,1,0.08367513453101907,54
5201,4,11493,4014,7479,0,0,0,1.0,1,1.0,1,1.0,1,0.07422381231812579,55
5202,0,11493,4014,7479,0,0,0,1.0,1,1.0,1,1.0,1,0.10030245071313772,56
5203,0,11493,4014,7479,0,0,0,1.0,1,1.0,1,1.0,1,0.10030245071313772,56
5204,4,11497,4014,7483,0,0,0,1.0,1,1.0,1,1.0,1,0.09598983337340265,58
5205,0,11497,4014,7483,0,0,0,1.0,1,1.0,1,1.0,1,0.09598983337340265,58
5206,0,11497,4014,7483,0,0,0,1.0,1,1.0,1,1.0,1,0.09598983337340265,58
5207,3,11500,4015,7485,0,0,0,1.0,1,1.0,1,1.0,1,0.09617399975500197,59
5208,1,11501,4015,7486,0,0,0,1.0,1,1.0,1,1.0,1,0.08809514545038663,58
5209,0,11501,4015,7486,0,0,0,1.0,1,1.0,1,1.0,1,0.08809514545038663,58
5210,0,11501,4015,7486,0,0,0,1.0,1,1.0,1,1.0,1,0.10072112737683153,57
5211,2,11503,4016,7487,0,0,0,1.0,1,1.0,1,1.0,1,0.08577216526484384,57
5212,1,11504,4016,7488,0,0,0,1.0,1,1.0,1,1.0,1,0.09760852588739186,59
5213,2,11506,4018,7488,0,0,0,1.0,1,1.0,1,1.0,1,0.13658192585697454,59
5214,7,11513,4020,7493,0,0,0,1.0,1,1.0,1,1.0,1,0.14643272441383184,59
5215,3,11516,4021,7495,0,0,0,1.0,1,1.0,1,1.0,1,0.17119122669221962,58
5216,3,11519,4021,7498,0,0,0,1.0,1,1.0,1,1.0,1,0.13838018180876427,59
5217,1,11520,4021,7499,0,0,0,1.0,1,1.0,1,1.0,1,0.12072058548542823,58
5218,3,11523,4024,7499,0,0,0,1.0,1,1.0,1,1.0,1,0.17071980448862534,58
5219,1,11524,4024,7500,0,0,0,1.0,1,1.0,1,1.0,1,0.13808784095948565,57
5220,3,11527,4026,7501,0,0,0,1.0,1,1.0,1,1.0,1,0.17650706238250388,56
5221,5,11532,4028,7504,0,0,0,1.0,1,1.0,1,1.0,1,0.15476750142347412,58
5222,6,11538,4030,7508,0,0,0,1.0,1,1.0,1,1.0,1,0.12441931850413797,56
5223,0,11538,4030,7508,0,0,0,1.0,1,1.0,1,1.0,1,0.13222295151317537,55
5224,1,11539,4031,7508,0,0,0,1.0,1,1.0,1,1.0,1,0.12276143723319066,56
5225,0,11539,4031,7508,0,0,0,1.0,1,1.0,1,1.0,1,0.13455444948464476,55
5226,2,11541,4033,7508,0,0,0,1.0,1,1.0,1,1.0,1,0.11719951526543877,55
5227,2,11543,4034,7509,0,0,0,1.0,1,1.0,1,1.0,1,0.15406652582171776,53
5228,0,11543,4034,7509,0,0,0,1.0,1,1.0,1,1.0,1,0.14641010996177184,51
5229,3,11546,4035,7511,0,0,0,1.0,1,1.0,1,1.0,1,0.14691826619373555,51
5230,2,11548,4036,7512,0,0,0,1.0,1,1.0,1,1.0,1,0.16432515722593388,51
5231,6,11554,4038,7516,0,0,0,1.0,1,1.0,1,1.0,1,0.12054544509134175,52
5232,2,11556,4039,7517,0,0,0,1.0,1,1.0,1,1.0,1,0.13561062539085753,52
5233,1,11557,4039,7518,0,0,0,1.0,1,1.0,1,1.0,1,0.14497897317806951,53
5234,3,11560,4040,7520,0,0,0,1.0,1,1.0,1,1.0,1,0.1773869043990713,53
5235,1,11561,4041,7520,0,0,0,1.0,1,1.0,1,1.0,1,0.17719864740571595,53
5236,5,11566,4043,7523,0,0,0,1.0,1,1.0,1,1.0,1,0.1486716468321057,52
5237,4,11570,4043,7527,0,0,0,1.0,1,1.0,1,1.0,1,0.15638767823928149,52
5238,3,11573,4045,7528,0,0,0,1.0,1,1.0,1,1.0,1,0.1581783083603894,52
5239,2,11575,4045,7530,0,0,0,1.0,1,1.0,1,1.0,1,0.16611795523066844,51
5240,3,11578,4045,7533,0,0,0,1.0,1,1.0,1,1.0,1,0.16892037465453377,53
5241,2,11580,4045,7535,0,0,0,1.0,1,1.0,1,1.0,1,0.1675952325639492,53
5242,2,11582,4046,7536,0,0,0,1.0,1,1.0,1,1.0,1,0.1680569004717499,51
5243,3,11585,4048,7537,0,0,0,1.0,1,1.0,1,1.0,1,0.20437756212528752,51
5244,3,11588,4049,7539,0,0,0,1.0,1,1.0,1,1.0,1,0.19650311718600783,52
5245,5,11593,4050,7543,0,0,0,1.0,1,1.0,1,1.0,1,0.1742628411410771,53
5246,1,11594,4050,7544,0,0,0,1.0,1,1.0,1,1.0,1,0.16998024213100485,53
5247,4,11598,4052,7546,0,0,0,1.0,1,1.0,1,1.0,1,0.19413980407004594,54
5248,2,11600,4053,7547,0,0,0,1.0,1,1.0,1,1.0,1,0.17701573936344517,54
5249,3,11603,4054,7549,0,0,0,1.0,1,1.0,1,1.0,1,0.14399047548212296,55
5250,1,11604,4054,7550,0,0,0,1.0,1,1.0,1,1.0,1,0.15788772984862626,57
5251,2,11606,4054,7552,0,0,0,1.0,1,1.0,1,1.0,1,0.13078604471257743,58
5252,0,11606,4054,7552,0,0,0,1.0,1,1.0,1,1.0,1,0.13078604471257743,58
5253,3,11609,4057,7552,0,0,0,1.0,1,1.0,1,1.0,1,0.17882918965448097,58
5254,1,11610,4057,7553,0,0,0,1.0,1,1.0,1,1.0,1,0.18055005504580451,59
5255,4,11614,4059,7555,0,0,0,1.0,1,1.0,1,1.0,1,0.18652475226692716,58
5256,4,11618,4059,7559,0,0,0,1.0,1,1.0,1,1.0,1,0.19757803499824464,58
5257,4,11622,4059,7563,0,0,0,1.0,1,1.0,1,1.0,1,0.1591420518674995,57
5258,0,11622,4059,7563,0,0,0,1.0,1,1.0,1,1.0,1,0.15953260148433288,55
5259,3,11625,4060,7565,0,0,0,1.0,1,1.0,1,1.0,1,0.14379964825286884,56
5260,1,11626,4060,7566,0,0,0,1.0,1,1.0,1,1.0,1,0.14946132964461464,55
5261,1,11627,4060,7567,0,0,0,1.0,1,1.0,1,1.0,1,0.14854300668834725,54
5262,1,11628,4061,7567,0,0,0,1.0,1,1.0,1,1.0,1,0.1614578067590215,54
5263,3,11631,4063,7568,0,0,0,1.0,1,1.0,1,1.0,1,0.1727930214935428,55
5264,2,11633,4065,7568,0,0,0,1.0,1,1.0,1,1.0,1,0.2217180305577624,53
5265,7,11640,4070,7570,0,0,0,1.0,1,1.0,1,1.0,1,0.23152332672469572,52
5266,2,11642,4070,7572,0,0,0,1.0,1,1.0,1,1.0,1,0.22112064866902195,49
5267,6,11648,4072,7576,0,0,0,1.0,1,1.0,1,1.0,1,0.18721086011278396,49
5268,1,11649,4072,7577,0,0,0,1.0,1,1.0,1,1.0,1,0.1659820099096595,46
5269,2,11651,4073,7578,0,0,0,1.0,1,1.0,1,1.0,1,0.15613886660986956,45
5270,3,11654,4074,7580,0,0,0,1.0,1,1.0,1,1.0,1,0.13220230143761114,46
5271,5,11659,4076,7583,0,0,0,1.0,1,1.0,1,1.0,1,0.1023144280919432,46
5272,1,11660,4077,7583,0,0,0,1.0,1,1.0,1,1.0,1,0.12164248465087034,45
5273,2,11662,4079,7583,0,0,0,1.0,1,1.0,1,1.0,1,0.14151939184417864,45
5274,2,11664,4080,7584,0,0,0,1.0,1,1.0,1,1.0,1,0.12770206016340907,45
5275,3,11667,4083,7584,0,0,0,1.0,1,1.0,1,1.0,1,0.20311133509987156,46
5276,7,11674,4086,7588,0,0,0,1.0,1,1.0,1,1.0,1,0.21740431955995232,45
5277,6,11680,4086,7594,0,0,0,1.0,1,1.0,1,1.0,1,0.22202935649317027,45
5278,7,11687,4088,7599,0,0,0,1.0,1,1.0,1,1.0,1,0.26412805060014993,44
5279,6,11693,4088,7605,0,0,0,1.0,1,1.0,1,1.0,1,0.22789343412165505,45
5280,5,11698,4088,7610,0,0,0,1.0,1,1.0,1,1.0,1,0.2809953553581722,46
5281,4,11702,4088,7614,0,0,0,1.0,1,1.0,1,1.0,1,0.22564623111210236,46
5282,2,11704,4089,7615,0,0,0,1.0,1,1.0,1,1.0,1,0.23813094677746652,47
5283,4,11708,4089,7619,0,0,0,1.0,1,1.0,1,1.0,1,0.17891665837238135,48
5284,1,11709,4089,7620,0,0,0,1.0,1,1.0,1,1.0,1,0.1820143810635468,48
5285,0,11709,4089,7620,0,0,0,1.0,1,1.0,1,1.0,1,0.16638468282605257,48
5286,2,11711,4089,7622,0,0,0,1.0,1,1.0,1,1.0,1,0.1418634803963092,50
5287,0,11711,4089,7622,0,0,0,1.0,1,1.0,1,1.0,1,0.1418634803963092,50
5288,1,11712,4089,7623,0,0,0,1.0,1,1.0,1,1.0,1,0.12366736454161281,51
5289,1,11713,4089,7624,0,0,0,1.0,1,1.0,1,1.0,1,0.11515702740487092,51
5290,0,11713,4089,7624,0,0,0,1.0,1,1.0,1,1.0,1,0.12283227037180804,52
5291,0,11713,4089,7624,0,0,0,1.0,1,1.0,1,1.0,1,0.14925859316315274,52
5292,2,11715,4090,7625,0,0,0,1.0,1,1.0,1,1.0,1,0.1557046576260989,53
5293,1,11716,4091,7625,0,0,0,1.0,1,1.0,1,1.0,1,0.20897844825170142,51
5294,2,11718,4092,7626,0,0,0,1.0,1,1.0,1,1.0,1,0.20541915969074923,50
5295,0,11718,4092,7626,0,0,0,1.0,1,1.0,1,1.0,1,0.22909882582005228,49
5296,3,11721,4093,7628,0,0,0,1.0,1,1.0,1,1.0,1,0.1942616834067165,48
5297,0,11721,4093,7628,0,0,0,1.0,1,1.0,1,1.0,1,0.23515246746585983,46
5298,0,11721,4093,7628,0,0,0,1.0,1,1.0,1,1.0,1,0.23627814435190236,46
5299,0,11721,4093,7628,0,0,0,1.0,1,1.0,1,1.0,1,0.24597183104228365,47
5300,0,11721,4093,7628,0,0,0,1.0,1,1.0,1,1.0,1,0.21970652347536657,48
5301,1,11722,4093,7629,0,0,0,1.0,1,1.0,1,1.0,1,0.21094932679201897,48
5302,5,11727,4096,7631,0,0,0,1.0,1,1.0,1,1.0,1,0.23109415350879908,49
5303,2,11729,4097,7632,0,0,0,1.0,1,1.0,1,1.0,1,0.2101697420022929,48
5304,1,11730,4097,7633,0,0,0,1.0,1,1.0,1,1.0,1,0.19825310521911557,48
5305,1,11731,4098,7633,0,0,0,1.0,1,1.0,1,1.0,1,0.20513422738368045,47
5306,4,11735,4099,7636,0,0,0,1.0,1,1.0,1,1.0,1,0.17860932344060762,48
5307,1,11736,4099,7637,0,0,0,1.0,1,1.0,1,1.0,1,0.16037959580781014,48
5308,2,11738,4100,7638,0,0,0,1.0,1,1.0,1,1.0,1,0.1563693276477684,47
5309,1,11739,4101,7638,0,0,0,1.0,1,1.0,1,1.0,1,0.19082018671976725,46
5310,2,11741,4102,7639,0,0,0,1.0,1,1.0,1,1.0,1,0.18505356232994177,46
5311,4,11745,4103,7642,0,0,0,1.0,1,1.0,1,1.0,1,0.1692838924791905,46
5312,1,11746,4104,7642,0,0,0,1.0,1,1.0,1,1.0,1,0.2062156747078368,46
5313,2,11748,4104,7644,0,0,0,1.0,1,1.0,1,1.0,1,0.15160398953136553,46
5314,0,11748,4104,7644,0,0,0,1.0,1,1.0,1,1.0,1,0.15160398953136553,46
5315,3,11751,4105,7646,0,0,0,1.0,1,1.0,1,1.0,1,0.18931610088293604,47
5316,10,11761,4105,7656,0,0,0,1.0,1,1.0,1,1.0,1,0.1201970106579169,48
5317,5,11766,4107,7659,0,0,0,1.0,1,1.0,1,1.0,1,0.17280842389463963,49
5318,10,11776,4110,7666,0,0,0,1.0,1,1.0,1,1.0,1,0.2142390194874852,49
5319,7,11783,4110,7673,0,0,0,1.0,1,1.0,1,1.0,1,0.16845099357961235,50
5320,9,11792,4110,7682,0,0,0,1.0,1,1.0,1,1.0,1,0.18470952312790195,51
5321,5,11797,4110,7687,0,0,0,1.0,1,1.0,1,1.0,1,0.06597299855757634,52
5322,1,11798,4110,7688,0,0,0,1.0,1,1.0,1,1.0,1,0.04985177606702127,53
5323,1,11799,4110,7689,0,0,0,1.0,1,1.0,1,1.0,1,0.0857955364389161,53
5324,6,11805,4111,7694,0,0,0,1.0,1,1.0,1,1.0,1,0.08177412588142761,55
5325,2,11807,4112,7695,0,0,0,1.0,1,1.0,1,1.0,1,0.10170555467940155,55
5326,0,11807,4112,7695,0,0,0,1.0,1,1.0,1,1.0,1,0.10170555467940155,55
5327,0,11807,4112,7695,0,0,0,1.0,1,1.0,1,1.0,1,0.10577859324123033,56
5328,4,11811,4113,7698,0,0,0,1.0,1,1.0,1,1.0,1,0.11149642892933975,57
5329,1,11812,4113,7699,0,0,0,1.0,1,1.0,1,1.0,1,0.08312910625855674,57
5330,0,11812,4113,7699,0,0,0,1.0,1,1.0,1,1.0,1,0.09727613041318225,56
5331,0,11812,4113,7699,0,0,0,1.0,1,1.0,1,1.0,1,0.10996922158711717,57
5332,0,11812,4113,7699,0,0,0,1.0,1,1.0,1,1.0,1,0.11783870874328332,58
5333,2,11814,4113,7701,0,0,0,1.0,1,1.0,1,1.0,1,0.10102555235099712,59
5334,1,11815,4114,7701,0,0,0,1.0,1,1.0,1,1.0,1,0.11188745318084384,59
5335,0,11815,4114,7701,0,0,0,1.0,1,1.0,1,1.0,1,0.12512136632708837,58
5336,2,11817,4114,7703,0,0,0,1.0,1,1.0,1,1.0,1,0.10789329267310162,59
5337,3,11820,4115,7705,0,0,0,1.0,1,1.0,1,1.0,1,0.07284956573015279,60
5338,1,11821,4115,7706,0,0,0,1.0,1,1.0,1,1.0,1,0.06232375210317904,60
5339,0,11821,4115,7706,0,0,0,1.0,1,1.0,1,1.0,1,0.06232375210317904,60
5340,2,11823,4117,7706,0,0,0,1.0,1,1.0,1,1.0,1,0.09689251224653544,60
5341,2,11825,4118,7707,0,0,0,1.0,1,1.0,1,1.0,1,0.10133147736376098,61
5342,2,11827,4120,7707,0,0,0,1.0,1,1.0,1,1.0,1,0.15189292023817383,59
5343,3,11830,4121,7709,0,0,0,1.0,1,1.0,1,1.0,1,0.1330149485807502,58
5344,3,11833,4123,7710,0,0,0,1.0,1,1.0,1,1.0,1,0.19816001847160866,58
5345,0,11833,4123,7710,0,0,0,1.0,1,1.0,1,1.0,1,0.18037260628875063,54
5346,5,11838,4123,7715,0,0,0,1.0,1,1.0,1,1.0,1,0.10450525748109829,54
5347,4,11842,4126,7716,0,0,0,1.0,1,1.0,1,1.0,1,0.11152866210150829,54
5348,4,11846,4127,7719,0,0,0,1.0,1,1.0,1,1.0,1,0.09523088510398327,55
5349,4,11850,4129,7721,0,0,0,1.0,1,1.0,1,1.0,1,0.13582996583785986,56
5350,5,11855,4130,7725,0,0,0,1.0,1,1.0,1,1.0,1,0.14869498877651405,56
5351,6,11861,4131,7730,0,0,0,1.0,1,1.0,1,1.0,1,0.10092396952015187,57
5352,3,11864,4132,7732,0,0,0,1.0,1,1.0,1,1.0,1,0.10238180534027667,57
5353,2,11866,4133,7733,0,0,0,1.0,1,1.0,1,1.0,1,0.11530867458339099,57
5354,0,11866,4133,7733,0,0,0,1.0,1,1.0,1,1.0,1,0.12294937722341802,56
5355,1,11867,4134,7733,0,0,0,1.0,1,1.0,1,1.0,1,0.12004300652142974,57
5356,1,11868,4134,7734,0,0,0,1.0,1,1.0,1,1.0,1,0.11097793119054736,56
5357,0,11868,4134,7734,0,0,0,1.0,1,1.0,1,1.0,1,0.12974807785635895,56
5358,1,11869,4134,7735,0,0,0,1.0,1,1.0,1,1.0,1,0.11862567576910131,57
5359,1,11870,4135,7735,0,0,0,1.0,1,1.0,1,1.0,1,0.13413975813981985,57
5360,0,11870,4135,7735,0,0,0,1.0,1,1.0,1,1.0,1,0.16469842842685925,55
5361,4,11874,4136,7738,0,0,0,1.0,1,1.0,1,1.0,1,0.1315904812521994,56
5362,1,11875,4137,7738,0,0,0,1.0,1,1.0,1,1.0,1,0.12954210868444202,57
5363,0,11875,4137,7738,0,0,0,1.0,1,1.0,1,1.0,1,0.12954210868444202,57
5364,0,11875,4137,7738,0,0,0,1.0,1,1.0,1,1.0,1,0.1413723141901206,58
5365,1,11876,4137,7739,0,0,0,1.0,1,1.0,1,1.0,1,0.12608545845875405,59
5366,6,11882,4138,7744,0,0,0,1.0,1,1.0,1,1.0,1,0.09108090504194892,60
5367,1,11883,4139,7744,0,0,0,1.0,1,1.0,1,1.0,1,0.10014048127001939,60
5368,1,11884,4140,7744,0,0,0,1.0,1,1.0,1,1.0,1,0.10684841968508094,58
5369,1,11885,4140,7745,0,0,0,1.0,1,1.0,1,1.0,1,0.07798722642666958,58
5370,1,11886,4141,7745,0,0,0,1.0,1,1.0,1,1.0,1,0.08495169533802575,57
5371,3,11889,4143,7746,0,0,0,1.0,1,1.0,1,1.0,1,0.09967203145624244,56
5372,3,11892,4146,7746,0,0,0,1.0,1,1.0,1,1.0,1,0.12687955551217614,55
5373,3,11895,4149,7746,0,0,0,1.0,1,1.0,1,1.0,1,0.16595522123098608,54
5374,2,11897,4150,7747,0,0,0,1.0,1,1.0,1,1.0,1,0.18518579028139434,53
5375,3,11900,4152,7748,0,0,0,1.0,1,1.0,1,1.0,1,0.21523695548758545,52
5376,6,11906,4152,7754,0,0,0,1.0,1,1.0,1,1.0,1,0.10288069999107602,52
5377,3,11909,4154,7755,0,0,0,1.0,1,1.0,1,1.0,1,0.11506267565530857,51
5378,4,11913,4156,7757,0,0,0,1.0,1,1.0,1,1.0,1,0.13018373205014608,52
5379,2,11915,4156,7759,0,0,0,1.0,1,1.0,1,1.0,1,0.12335779240555886,50
5380,3,11918,4156,7762,0,0,0,1.0,1,1.0,1,1.0,1,0.13093371589894925,51
5381,1,11919,4156,7763,0,0,0,1.0,1,1.0,1,1.0,1,0.09875549590899792,50
5382,0,11919,4156,7763,0,0,0,1.0,1,1.0,1,1.0,1,0.1108425980715154,48
5383,1,11920,4156,7764,0,0,0,1.0,1,1.0,1,1.0,1,0.08316253503548139,48
5384,1,11921,4156,7765,0,0,0,1.0,1,1.0,1,1.0,1,0.06793094697378335,48
5385,0,11921,4156,7765,0,0,0,1.0,1,1.0,1,1.0,1,0.07936509946721541,47
5386,1,11922,4157,7765,0,0,0,1.0,1,1.0,1,1.0,1,0.12049951613104472,48
5387,0,11922,4157,7765,0,0,0,1.0,1,1.0,1,1.0,1,0.1252174543066198,48
5388,1,11923,4158,7765,0,0,0,1.0,1,1.0,1,1.0,1,0.0968029361195105,48
5389,0,11923,4158,7765,0,0,0,1.0,1,1.0,1,1.0,1,0.08749900101403837,50
5390,4,11927,4160,7767,0,0,0,1.0,1,1.0,1,1.0,1,0.1151281201820008,52
5391,4,11931,4162,7769,0,0,0,1.0,1,1.0,1,1.0,1,0.13912559029508165,52
5392,1,11932,4162,7770,0,0,0,1.0,1,1.0,1,1.0,1,0.13377705907115953,51
5393,4,11936,4166,7770,0,0,0,1.0,1,1.0,1,1.0,1,0.19993839425079105,50
5394,3,11939,4167,7772,0,0,0,1.0,1,1.0,1,1.0,1,0.17629976772907513,50
5395,2,11941,4169,7772,0,0,0,1.0,1,1.0,1,1.0,1,0.19510634293704782,49
5396,5,11946,4171,7775,0,0,0,1.0,1,1.0,1,1.0,1,0.1548445314892762,48
5397,3,11949,4174,7775,0,0,0,1.0,1,1.0,1,1.0,1,0.163688010017112,48
5398,0,11949,4174,7775,0,0,0,1.0,1,1.0,1,1.0,1,0.18536499448256338,46
5399,2,11951,4175,7776,0,0,0,1.0,1,1.0,1,1.0,1,0.18098697501070604,46
5400,5,11956,4177,7779,0,0,0,1.0,1,1.0,1,1.0,1,0.16784715836785996,48
5401,4,11960,4177,7783,0,0,0,1.0,1,1.0,1,1.0,1,0.12515729434824785,49
5402,0,11960,4177,7783,0,0,0,1.0,1,1.0,1,1.0,1,0.0,0
