,SuccessfulHandoverCount,TotalSuccessfulHandoverCount,TotalSuccessfulHandoverCountRange,TotalSuccessfulHandoverCountLoadBalancing,TotalSuccessfulHandoverCountOverload,FailedHandoverCount,TotalFailedHandoverCount,AvgQoS,MinQoS,AvgQoS_LoadBased,MinQoS_LoadBased,AvgQoS_RangeBased,MinQoS_RangeBased,GiniLoad,VehicleCount
0,0,0,0,0,0,0,0,1.0,1,1.0,1,1.0,1,0.0,0
1,21,21,0,21,0,0,0,1.0,1,1.0,1,1.0,1,0.22146556179179222,30
2,17,38,0,38,0,0,0,1.0,1,1.0,1,1.0,1,0.23998861497877716,32
3,27,65,0,65,0,0,0,1.0,1,1.0,1,1.0,1,0.2620816184555264,33
4,17,82,0,82,0,0,0,1.0,1,1.0,1,1.0,1,0.35352239171283606,34
5,22,104,0,104,0,0,0,1.0,1,1.0,1,1.0,1,0.196849394705507,36
6,25,129,0,129,0,0,0,1.0,1,1.0,1,1.0,1,0.21903722715494114,38
7,24,153,0,153,0,0,0,1.0,1,1.0,1,1.0,1,0.31430864430525995,40
8,30,183,0,183,0,0,0,1.0,1,1.0,1,1.0,1,0.3103557848312988,40
9,17,200,0,200,0,0,0,1.0,1,1.0,1,1.0,1,0.2522280148115324,40
10,19,219,0,219,0,0,0,1.0,1,1.0,1,1.0,1,0.2770191379986778,41
11,23,242,0,242,0,0,0,1.0,1,1.0,1,1.0,1,0.23657421908609366,40
12,25,267,1,266,0,0,0,1.0,1,1.0,1,1.0,1,0.26315073363494645,39
13,19,286,2,284,0,0,0,1.0,1,1.0,1,1.0,1,0.2562581926293568,37
14,13,299,2,297,0,0,0,1.0,1,1.0,1,1.0,1,0.2763904504277505,35
15,16,315,2,313,0,0,0,1.0,1,1.0,1,1.0,1,0.22587897245928776,36
16,7,322,2,320,0,0,0,1.0,1,1.0,1,1.0,1,0.09459336866155442,34
17,1,323,2,321,0,0,0,1.0,1,1.0,1,1.0,1,0.1267897485622323,33
18,1,324,2,322,0,0,0,1.0,1,1.0,1,1.0,1,0.142535714614012,34
19,1,325,3,322,0,0,0,1.0,1,1.0,1,1.0,1,0.16444916228507678,34
20,1,326,3,323,0,0,0,1.0,1,1.0,1,1.0,1,0.12985946047355856,34
21,2,328,3,325,0,0,0,1.0,1,1.0,1,1.0,1,0.160858745368197,36
22,0,328,3,325,0,0,0,1.0,1,1.0,1,1.0,1,0.18768927472300603,35
23,4,332,4,328,0,0,0,1.0,1,1.0,1,1.0,1,0.20084618361188977,35
24,3,335,4,331,0,0,0,1.0,1,1.0,1,1.0,1,0.13402278599783626,35
25,7,342,9,333,0,0,0,1.0,1,1.0,1,1.0,1,0.21116215674623728,35
26,3,345,10,335,0,0,0,1.0,1,1.0,1,1.0,1,0.19829568253153768,36
27,5,350,10,340,0,0,0,1.0,1,1.0,1,1.0,1,0.14631154754073894,34
28,7,357,12,345,0,0,0,1.0,1,1.0,1,1.0,1,0.1756672887863557,35
29,2,359,13,346,0,0,0,1.0,1,1.0,1,1.0,1,0.14343903177443018,33
30,3,362,14,348,0,0,0,1.0,1,1.0,1,1.0,1,0.19206412393906983,33
31,7,369,16,353,0,0,0,1.0,1,1.0,1,1.0,1,0.15774710536674544,33
32,1,370,17,353,0,0,0,1.0,1,1.0,1,1.0,1,0.20839749631035376,32
33,2,372,17,355,0,0,0,1.0,1,1.0,1,1.0,1,0.22090378043292364,33
34,4,376,19,357,0,0,0,1.0,1,1.0,1,1.0,1,0.22928664833323312,33
35,2,378,19,359,0,0,0,1.0,1,1.0,1,1.0,1,0.21501614216909198,35
36,4,382,19,363,0,0,0,1.0,1,1.0,1,1.0,1,0.22756372296517055,36
37,4,386,20,366,0,0,0,1.0,1,1.0,1,1.0,1,0.18311915022963093,37
38,0,386,20,366,0,0,0,1.0,1,1.0,1,1.0,1,0.19584808050201793,36
39,3,389,21,368,0,0,0,1.0,1,1.0,1,1.0,1,0.1822020336636761,38
40,1,390,21,369,0,0,0,1.0,1,1.0,1,1.0,1,0.18608881242546588,40
41,3,393,21,372,0,0,0,1.0,1,1.0,1,1.0,1,0.19963637781668747,40
42,4,397,22,375,0,0,0,1.0,1,1.0,1,1.0,1,0.20920890570528217,40
43,6,403,23,380,0,0,0,1.0,1,1.0,1,1.0,1,0.22787747847213013,43
44,3,406,23,383,0,0,0,1.0,1,1.0,1,1.0,1,0.184182944122537,43
45,4,410,24,386,0,0,0,1.0,1,1.0,1,1.0,1,0.19877955996500749,44
46,1,411,24,387,0,0,0,1.0,1,1.0,1,1.0,1,0.18461288808829662,44
47,0,411,24,387,0,0,0,1.0,1,1.0,1,1.0,1,0.18461288808829662,44
48,1,412,25,387,0,0,0,1.0,1,1.0,1,1.0,1,0.22431278473692765,44
49,0,412,25,387,0,0,0,1.0,1,1.0,1,1.0,1,0.24044283380295464,41
50,2,414,27,387,0,0,0,1.0,1,1.0,1,1.0,1,0.21738007897904427,40
51,0,414,27,387,0,0,0,1.0,1,1.0,1,1.0,1,0.24189394510555412,38
52,1,415,28,387,0,0,0,1.0,1,1.0,1,1.0,1,0.2518512451600602,37
53,3,418,28,390,0,0,0,1.0,1,1.0,1,1.0,1,0.2372704229725672,38
54,0,418,28,390,0,0,0,1.0,1,1.0,1,1.0,1,0.2746064959704566,38
55,3,421,30,391,0,0,0,1.0,1,1.0,1,1.0,1,0.2728891362710617,38
56,4,425,31,394,0,0,0,1.0,1,1.0,1,1.0,1,0.27346610595884235,38
57,4,429,31,398,0,0,0,1.0,1,1.0,1,1.0,1,0.25638533573976596,38
58,4,433,34,399,0,0,0,1.0,1,1.0,1,1.0,1,0.2696286743399504,38
59,4,437,34,403,0,0,0,1.0,1,1.0,1,1.0,1,0.29246041245303556,40
60,3,440,35,405,0,0,0,1.0,1,1.0,1,1.0,1,0.2781759680080585,40
61,3,443,35,408,0,0,0,1.0,1,1.0,1,1.0,1,0.23775983400613493,40
62,0,443,35,408,0,0,0,1.0,1,1.0,1,1.0,1,0.23910966606577228,42
63,1,444,35,409,0,0,0,1.0,1,1.0,1,1.0,1,0.2391985924822811,40
64,0,444,35,409,0,0,0,1.0,1,1.0,1,1.0,1,0.22162231338364338,41
65,2,446,36,410,0,0,0,1.0,1,1.0,1,1.0,1,0.19426006871747606,41
66,1,447,37,410,0,0,0,1.0,1,1.0,1,1.0,1,0.20080681272828216,41
67,5,452,37,415,0,0,0,1.0,1,1.0,1,1.0,1,0.16325167229446397,41
68,5,457,37,420,0,0,0,1.0,1,1.0,1,1.0,1,0.1309135156161912,41
69,2,459,38,421,0,0,0,1.0,1,1.0,1,1.0,1,0.12463956774306854,41
70,1,460,38,422,0,0,0,1.0,1,1.0,1,1.0,1,0.13232194644818232,42
71,1,461,39,422,0,0,0,1.0,1,1.0,1,1.0,1,0.12259427729436209,44
72,4,465,40,425,0,0,0,1.0,1,1.0,1,1.0,1,0.11826174432595875,44
73,3,468,40,428,0,0,0,1.0,1,1.0,1,1.0,1,0.12773169368718418,46
74,2,470,40,430,0,0,0,1.0,1,1.0,1,1.0,1,0.15748601322993797,44
75,0,470,40,430,0,0,0,1.0,1,1.0,1,1.0,1,0.15748601322993797,44
76,3,473,41,432,0,0,0,1.0,1,1.0,1,1.0,1,0.1836671140283839,45
77,1,474,41,433,0,0,0,1.0,1,1.0,1,1.0,1,0.14377740311591733,44
78,1,475,42,433,0,0,0,1.0,1,1.0,1,1.0,1,0.21160218444623305,44
79,2,477,43,434,0,0,0,1.0,1,1.0,1,1.0,1,0.22672470340613446,43
80,1,478,44,434,0,0,0,1.0,1,1.0,1,1.0,1,0.23446931900225304,43
81,6,484,47,437,0,0,0,1.0,1,1.0,1,1.0,1,0.32029651814393956,44
82,3,487,48,439,0,0,0,1.0,1,1.0,1,1.0,1,0.2967819190908817,45
83,5,492,49,443,0,0,0,1.0,1,1.0,1,1.0,1,0.28873692252104377,45
84,0,492,49,443,0,0,0,1.0,1,1.0,1,1.0,1,0.28873692252104377,45
85,1,493,50,443,0,0,0,1.0,1,1.0,1,1.0,1,0.29181634417250496,45
86,0,493,50,443,0,0,0,1.0,1,1.0,1,1.0,1,0.29181634417250496,45
87,0,493,50,443,0,0,0,1.0,1,1.0,1,1.0,1,0.2972673686972573,44
88,0,493,50,443,0,0,0,1.0,1,1.0,1,1.0,1,0.29163145900949433,45
89,2,495,50,445,0,0,0,1.0,1,1.0,1,1.0,1,0.3004403269389284,46
90,1,496,50,446,0,0,0,1.0,1,1.0,1,1.0,1,0.30408370551713726,44
91,6,502,51,451,0,0,0,1.0,1,1.0,1,1.0,1,0.22570161524183674,45
92,1,503,51,452,0,0,0,1.0,1,1.0,1,1.0,1,0.22533544935037253,46
93,0,503,51,452,0,0,0,1.0,1,1.0,1,1.0,1,0.22533544935037253,46
94,0,503,51,452,0,0,0,1.0,1,1.0,1,1.0,1,0.22533544935037253,46
95,3,506,51,455,0,0,0,1.0,1,1.0,1,1.0,1,0.19833099409957033,46
96,2,508,52,456,0,0,0,1.0,1,1.0,1,1.0,1,0.19204158318320771,46
97,0,508,52,456,0,0,0,1.0,1,1.0,1,1.0,1,0.18737698761492888,47
98,0,508,52,456,0,0,0,1.0,1,1.0,1,1.0,1,0.18737698761492888,47
99,0,508,52,456,0,0,0,1.0,1,1.0,1,1.0,1,0.20345851508868984,46
100,0,508,52,456,0,0,0,1.0,1,1.0,1,1.0,1,0.22070553302408827,48
101,3,511,53,458,0,0,0,1.0,1,1.0,1,1.0,1,0.22057954929725254,49
102,4,515,54,461,0,0,0,1.0,1,1.0,1,1.0,1,0.22600579967413145,49
103,2,517,54,463,0,0,0,1.0,1,1.0,1,1.0,1,0.2099380872865748,48
104,5,522,56,466,0,0,0,1.0,1,1.0,1,1.0,1,0.23755285227556072,49
105,5,527,58,469,0,0,0,1.0,1,1.0,1,1.0,1,0.2236227411077043,48
106,8,535,60,475,0,0,0,1.0,1,1.0,1,1.0,1,0.14928044902149423,48
107,4,539,62,477,0,0,0,1.0,1,1.0,1,1.0,1,0.13605330491274786,47
108,2,541,62,479,0,0,0,1.0,1,1.0,1,1.0,1,0.11923461513499913,47
109,4,545,64,481,0,0,0,1.0,1,1.0,1,1.0,1,0.11332547656366823,47
110,2,547,65,482,0,0,0,1.0,1,1.0,1,1.0,1,0.14807051214340805,47
111,4,551,67,484,0,0,0,1.0,1,1.0,1,1.0,1,0.1066069750594654,46
112,5,556,70,486,0,0,0,1.0,1,1.0,1,1.0,1,0.1466206722070984,46
113,5,561,72,489,0,0,0,1.0,1,1.0,1,1.0,1,0.22415830601115982,45
114,7,568,73,495,0,0,0,1.0,1,1.0,1,1.0,1,0.17693372308636532,46
115,6,574,74,500,0,0,0,1.0,1,1.0,1,1.0,1,0.20592181560828404,47
116,8,582,75,507,0,0,0,1.0,1,1.0,1,1.0,1,0.19412179188864923,48
117,9,591,77,514,0,0,0,1.0,1,1.0,1,1.0,1,0.21947131227453695,48
118,6,597,77,520,0,0,0,1.0,1,1.0,1,1.0,1,0.2180219816498141,49
119,7,604,77,527,0,0,0,1.0,1,1.0,1,1.0,1,0.23915422406847447,50
120,5,609,77,532,0,0,0,1.0,1,1.0,1,1.0,1,0.2077807135637796,51
121,8,617,77,540,0,0,0,1.0,1,1.0,1,1.0,1,0.12520862664133825,51
122,0,617,77,540,0,0,0,1.0,1,1.0,1,1.0,1,0.12520862664133825,51
123,2,619,77,542,0,0,0,1.0,1,1.0,1,1.0,1,0.12585695750546685,51
124,4,623,78,545,0,0,0,1.0,1,1.0,1,1.0,1,0.11388566094204891,51
125,3,626,78,548,0,0,0,1.0,1,1.0,1,1.0,1,0.16436708442395098,50
126,9,635,81,554,0,0,0,1.0,1,1.0,1,1.0,1,0.10176559810686736,52
127,2,637,81,556,0,0,0,1.0,1,1.0,1,1.0,1,0.1180052285686171,50
128,0,637,81,556,0,0,0,1.0,1,1.0,1,1.0,1,0.1180052285686171,50
129,8,645,82,563,0,0,0,1.0,1,1.0,1,1.0,1,0.11553133113825316,52
130,3,648,83,565,0,0,0,1.0,1,1.0,1,1.0,1,0.1284983195930533,52
131,6,654,83,571,0,0,0,1.0,1,1.0,1,1.0,1,0.09708127382109107,54
132,6,660,83,577,0,0,0,1.0,1,1.0,1,1.0,1,0.09753848113786245,54
133,3,663,83,580,0,0,0,1.0,1,1.0,1,1.0,1,0.10192495315272901,52
134,8,671,83,588,0,0,0,1.0,1,1.0,1,1.0,1,0.12516655296014292,52
135,7,678,86,592,0,0,0,1.0,1,1.0,1,1.0,1,0.1866075295822831,51
136,6,684,87,597,0,0,0,1.0,1,1.0,1,1.0,1,0.10398652968092677,51
137,3,687,87,600,0,0,0,1.0,1,1.0,1,1.0,1,0.09404817020575139,50
138,0,687,87,600,0,0,0,1.0,1,1.0,1,1.0,1,0.07783333303577,52
139,0,687,87,600,0,0,0,1.0,1,1.0,1,1.0,1,0.07717224551366192,51
140,1,688,88,600,0,0,0,1.0,1,1.0,1,1.0,1,0.09331654508077193,51
141,2,690,89,601,0,0,0,1.0,1,1.0,1,1.0,1,0.10671488712519304,50
142,5,695,91,604,0,0,0,1.0,1,1.0,1,1.0,1,0.08860695257064947,51
143,0,695,91,604,0,0,0,1.0,1,1.0,1,1.0,1,0.09370002933940992,48
144,5,700,94,606,0,0,0,1.0,1,1.0,1,1.0,1,0.15030993429027178,49
145,3,703,94,609,0,0,0,1.0,1,1.0,1,1.0,1,0.12426007280747563,47
146,4,707,97,610,0,0,0,1.0,1,1.0,1,1.0,1,0.1589590204591532,49
147,2,709,98,611,0,0,0,1.0,1,1.0,1,1.0,1,0.15149821441493827,46
148,1,710,98,612,0,0,0,1.0,1,1.0,1,1.0,1,0.15114830870313611,47
149,3,713,101,612,0,0,0,1.0,1,1.0,1,1.0,1,0.17757771880071266,46
150,1,714,102,612,0,0,0,1.0,1,1.0,1,1.0,1,0.17750964115039652,47
151,7,721,104,617,0,0,0,1.0,1,1.0,1,1.0,1,0.12817432110626306,46
152,2,723,105,618,0,0,0,1.0,1,1.0,1,1.0,1,0.1912115433129083,45
153,5,728,105,623,0,0,0,1.0,1,1.0,1,1.0,1,0.1321256772315779,46
154,2,730,105,625,0,0,0,1.0,1,1.0,1,1.0,1,0.1361804857268093,44
155,7,737,108,629,0,0,0,1.0,1,1.0,1,1.0,1,0.13476360381885358,45
156,2,739,109,630,0,0,0,1.0,1,1.0,1,1.0,1,0.16286360911412756,43
157,1,740,109,631,0,0,0,1.0,1,1.0,1,1.0,1,0.15196325296471316,42
158,2,742,109,633,0,0,0,1.0,1,1.0,1,1.0,1,0.14124592843077088,43
159,6,748,110,638,0,0,0,1.0,1,1.0,1,1.0,1,0.1766422311950974,44
160,2,750,111,639,0,0,0,1.0,1,1.0,1,1.0,1,0.1920371126017941,44
161,3,753,112,641,0,0,0,1.0,1,1.0,1,1.0,1,0.20228587612615662,44
162,2,755,113,642,0,0,0,1.0,1,1.0,1,1.0,1,0.19997827223764264,44
163,7,762,118,644,0,0,0,1.0,1,1.0,1,1.0,1,0.2652760138560376,44
164,4,766,118,648,0,0,0,1.0,1,1.0,1,1.0,1,0.235915573129507,44
165,2,768,119,649,0,0,0,1.0,1,1.0,1,1.0,1,0.19801685061806748,43
166,6,774,120,654,0,0,0,1.0,1,1.0,1,1.0,1,0.12656858342847155,43
167,0,774,120,654,0,0,0,1.0,1,1.0,1,1.0,1,0.1262175236827082,42
168,0,774,120,654,0,0,0,1.0,1,1.0,1,1.0,1,0.17034717237587388,40
169,3,777,120,657,0,0,0,1.0,1,1.0,1,1.0,1,0.1503894565956455,41
170,3,780,122,658,0,0,0,1.0,1,1.0,1,1.0,1,0.18366461229573885,39
171,3,783,124,659,0,0,0,1.0,1,1.0,1,1.0,1,0.1715553971095702,39
172,2,785,124,661,0,0,0,1.0,1,1.0,1,1.0,1,0.14270985792992485,38
173,6,791,128,663,0,0,0,1.0,1,1.0,1,1.0,1,0.1912265407881642,38
174,4,795,128,667,0,0,0,1.0,1,1.0,1,1.0,1,0.09154470767159545,37
175,3,798,130,668,0,0,0,1.0,1,1.0,1,1.0,1,0.13966187139976544,36
176,3,801,131,670,0,0,0,1.0,1,1.0,1,1.0,1,0.1517660990497393,36
177,3,804,132,672,0,0,0,1.0,1,1.0,1,1.0,1,0.16001146916932935,38
178,3,807,132,675,0,0,0,1.0,1,1.0,1,1.0,1,0.17323323498830082,39
179,3,810,132,678,0,0,0,1.0,1,1.0,1,1.0,1,0.17540771763312962,40
180,4,814,132,682,0,0,0,1.0,1,1.0,1,1.0,1,0.17540771763312962,40
181,3,817,133,684,0,0,0,1.0,1,1.0,1,1.0,1,0.1479889789025027,39
182,2,819,135,684,0,0,0,1.0,1,1.0,1,1.0,1,0.15813303425129288,40
183,3,822,136,686,0,0,0,1.0,1,1.0,1,1.0,1,0.16691319539160718,40
184,1,823,137,686,0,0,0,1.0,1,1.0,1,1.0,1,0.2412400210557585,38
185,3,826,138,688,0,0,0,1.0,1,1.0,1,1.0,1,0.23053296470523743,38
186,3,829,139,690,0,0,0,1.0,1,1.0,1,1.0,1,0.20472952331270425,37
187,4,833,141,692,0,0,0,1.0,1,1.0,1,1.0,1,0.2519242549396217,36
188,4,837,143,694,0,0,0,1.0,1,1.0,1,1.0,1,0.23705910094131677,36
189,3,840,144,696,0,0,0,1.0,1,1.0,1,1.0,1,0.21159932197302614,36
190,2,842,145,697,0,0,0,1.0,1,1.0,1,1.0,1,0.2478483973990952,36
191,1,843,146,697,0,0,0,1.0,1,1.0,1,1.0,1,0.24445656861013187,37
192,3,846,147,699,0,0,0,1.0,1,1.0,1,1.0,1,0.26315687206957394,37
193,1,847,147,700,0,0,0,1.0,1,1.0,1,1.0,1,0.24738830290086886,38
194,1,848,147,701,0,0,0,1.0,1,1.0,1,1.0,1,0.2700653196424432,39
195,7,855,149,706,0,0,0,1.0,1,1.0,1,1.0,1,0.2458123780084289,40
196,5,860,150,710,0,0,0,1.0,1,1.0,1,1.0,1,0.13893435608146934,40
197,3,863,150,713,0,0,0,1.0,1,1.0,1,1.0,1,0.1826148375815846,40
198,1,864,150,714,0,0,0,1.0,1,1.0,1,1.0,1,0.15967939719438676,40
199,3,867,151,716,0,0,0,1.0,1,1.0,1,1.0,1,0.17626654638661932,40
200,1,868,151,717,0,0,0,1.0,1,1.0,1,1.0,1,0.15106252493969274,40
201,4,872,153,719,0,0,0,1.0,1,1.0,1,1.0,1,0.1363024557228869,39
202,1,873,153,720,0,0,0,1.0,1,1.0,1,1.0,1,0.14195212451110206,40
203,3,876,155,721,0,0,0,1.0,1,1.0,1,1.0,1,0.15486089100314182,39
204,4,880,157,723,0,0,0,1.0,1,1.0,1,1.0,1,0.12989889121812287,38
205,2,882,159,723,0,0,0,1.0,1,1.0,1,1.0,1,0.12704100557693307,37
206,0,882,159,723,0,0,0,1.0,1,1.0,1,1.0,1,0.1159536817109156,36
207,1,883,159,724,0,0,0,1.0,1,1.0,1,1.0,1,0.14825873565133588,37
208,3,886,159,727,0,0,0,1.0,1,1.0,1,1.0,1,0.1822484255409995,36
209,4,890,161,729,0,0,0,1.0,1,1.0,1,1.0,1,0.21053123553129807,36
210,2,892,161,731,0,0,0,1.0,1,1.0,1,1.0,1,0.2342773740395623,36
211,5,897,162,735,0,0,0,1.0,1,1.0,1,1.0,1,0.22682025819977403,34
212,4,901,163,738,0,0,0,1.0,1,1.0,1,1.0,1,0.23155021517726726,34
213,4,905,164,741,0,0,0,1.0,1,1.0,1,1.0,1,0.29431372569821934,36
214,3,908,164,744,0,0,0,1.0,1,1.0,1,1.0,1,0.22662889655410245,35
215,2,910,164,746,0,0,0,1.0,1,1.0,1,1.0,1,0.158449905790712,35
216,1,911,164,747,0,0,0,1.0,1,1.0,1,1.0,1,0.14620398008902577,37
217,3,914,165,749,0,0,0,1.0,1,1.0,1,1.0,1,0.1473913214284034,37
218,5,919,167,752,0,0,0,1.0,1,1.0,1,1.0,1,0.15830183226905212,37
219,2,921,168,753,0,0,0,1.0,1,1.0,1,1.0,1,0.21623904910836106,37
220,3,924,169,755,0,0,0,1.0,1,1.0,1,1.0,1,0.17393390951556975,38
221,3,927,169,758,0,0,0,1.0,1,1.0,1,1.0,1,0.15791292154265532,39
222,5,932,170,762,0,0,0,1.0,1,1.0,1,1.0,1,0.12539479668331976,39
223,4,936,171,765,0,0,0,1.0,1,1.0,1,1.0,1,0.16872432558329153,40
224,5,941,173,768,0,0,0,1.0,1,1.0,1,1.0,1,0.1653819808969716,40
225,5,946,173,773,0,0,0,1.0,1,1.0,1,1.0,1,0.20132915011903124,39
226,7,953,178,775,0,0,0,1.0,1,1.0,1,1.0,1,0.1668893953547478,39
227,5,958,179,779,0,0,0,1.0,1,1.0,1,1.0,1,0.17882810086432027,39
228,2,960,180,780,0,0,0,1.0,1,1.0,1,1.0,1,0.1579095734774446,38
229,5,965,180,785,0,0,0,1.0,1,1.0,1,1.0,1,0.1506714340650443,39
230,3,968,181,787,0,0,0,1.0,1,1.0,1,1.0,1,0.11307411626860477,38
231,3,971,182,789,0,0,0,1.0,1,1.0,1,1.0,1,0.15268418859281577,38
232,2,973,183,790,0,0,0,1.0,1,1.0,1,1.0,1,0.15530524986708755,37
233,1,974,184,790,0,0,0,1.0,1,1.0,1,1.0,1,0.18335856355502236,36
234,0,974,184,790,0,0,0,1.0,1,1.0,1,1.0,1,0.21160310586434322,34
235,3,977,187,790,0,0,0,1.0,1,1.0,1,1.0,1,0.29312728124563814,34
236,0,977,187,790,0,0,0,1.0,1,1.0,1,1.0,1,0.30747833053012175,33
237,0,977,187,790,0,0,0,1.0,1,1.0,1,1.0,1,0.33000834409975793,32
238,1,978,188,790,0,0,0,1.0,1,1.0,1,1.0,1,0.3584904943635176,32
239,2,980,189,791,0,0,0,1.0,1,1.0,1,1.0,1,0.3158939269928079,31
240,0,980,189,791,0,0,0,1.0,1,1.0,1,1.0,1,0.38871968784707817,28
241,4,984,190,794,0,0,0,1.0,1,1.0,1,1.0,1,0.29483127996890846,27
242,3,987,190,797,0,0,0,1.0,1,1.0,1,1.0,1,0.23466132328437625,29
243,0,987,190,797,0,0,0,1.0,1,1.0,1,1.0,1,0.2496181825867405,28
244,0,987,190,797,0,0,0,1.0,1,1.0,1,1.0,1,0.24329097114061818,28
245,3,990,191,799,0,0,0,1.0,1,1.0,1,1.0,1,0.21672712016799636,27
246,1,991,192,799,0,0,0,1.0,1,1.0,1,1.0,1,0.22646534133820162,25
247,3,994,193,801,0,0,0,1.0,1,1.0,1,1.0,1,0.23861142246778128,26
248,1,995,193,802,0,0,0,1.0,1,1.0,1,1.0,1,0.2273154298709851,27
249,2,997,193,804,0,0,0,1.0,1,1.0,1,1.0,1,0.218494097952981,26
250,1,998,193,805,0,0,0,1.0,1,1.0,1,1.0,1,0.24951067680758476,27
251,6,1004,194,810,0,0,0,1.0,1,1.0,1,1.0,1,0.2527100175111917,28
252,3,1007,194,813,0,0,0,1.0,1,1.0,1,1.0,1,0.22392502756485425,28
253,4,1011,196,815,0,0,0,1.0,1,1.0,1,1.0,1,0.2713894112484131,28
254,3,1014,196,818,0,0,0,1.0,1,1.0,1,1.0,1,0.2935673986869865,29
255,3,1017,196,821,0,0,0,1.0,1,1.0,1,1.0,1,0.2673889370615856,30
256,3,1020,196,824,0,0,0,1.0,1,1.0,1,1.0,1,0.19338064435342855,30
257,1,1021,196,825,0,0,0,1.0,1,1.0,1,1.0,1,0.1769881069989919,32
258,1,1022,197,825,0,0,0,1.0,1,1.0,1,1.0,1,0.2007872368168859,32
259,0,1022,197,825,0,0,0,1.0,1,1.0,1,1.0,1,0.2007872368168859,32
260,0,1022,197,825,0,0,0,1.0,1,1.0,1,1.0,1,0.1686050603752771,34
261,0,1022,197,825,0,0,0,1.0,1,1.0,1,1.0,1,0.1827402247085827,35
262,2,1024,198,826,0,0,0,1.0,1,1.0,1,1.0,1,0.22621240087040925,36
263,0,1024,198,826,0,0,0,1.0,1,1.0,1,1.0,1,0.2324712523535049,34
264,1,1025,199,826,0,0,0,1.0,1,1.0,1,1.0,1,0.2523370030592783,34
265,0,1025,199,826,0,0,0,1.0,1,1.0,1,1.0,1,0.2650466937099289,33
266,3,1028,200,828,0,0,0,1.0,1,1.0,1,1.0,1,0.23438892260800887,34
267,0,1028,200,828,0,0,0,1.0,1,1.0,1,1.0,1,0.24737049332167727,33
268,0,1028,200,828,0,0,0,1.0,1,1.0,1,1.0,1,0.26800204497412833,34
269,1,1029,200,829,0,0,0,1.0,1,1.0,1,1.0,1,0.2744609754391883,34
270,4,1033,200,833,0,0,0,1.0,1,1.0,1,1.0,1,0.25670488980872974,36
271,2,1035,200,835,0,0,0,1.0,1,1.0,1,1.0,1,0.1953076348564009,36
272,1,1036,200,836,0,0,0,1.0,1,1.0,1,1.0,1,0.2072380295008692,38
273,0,1036,200,836,0,0,0,1.0,1,1.0,1,1.0,1,0.2072380295008692,38
274,3,1039,201,838,0,0,0,1.0,1,1.0,1,1.0,1,0.18214766539105104,38
275,3,1042,202,840,0,0,0,1.0,1,1.0,1,1.0,1,0.20236898369723863,38
276,2,1044,203,841,0,0,0,1.0,1,1.0,1,1.0,1,0.19815875174615588,39
277,3,1047,204,843,0,0,0,1.0,1,1.0,1,1.0,1,0.1839712208795345,38
278,1,1048,204,844,0,0,0,1.0,1,1.0,1,1.0,1,0.14901780233492962,38
279,0,1048,204,844,0,0,0,1.0,1,1.0,1,1.0,1,0.11460421532597047,38
280,2,1050,206,844,0,0,0,1.0,1,1.0,1,1.0,1,0.16936153846099103,38
281,1,1051,206,845,0,0,0,1.0,1,1.0,1,1.0,1,0.14833844664678578,38
282,2,1053,206,847,0,0,0,1.0,1,1.0,1,1.0,1,0.11924585248000048,38
283,4,1057,207,850,0,0,0,1.0,1,1.0,1,1.0,1,0.16762133395006257,38
284,3,1060,207,853,0,0,0,1.0,1,1.0,1,1.0,1,0.14859366692979128,39
285,2,1062,208,854,0,0,0,1.0,1,1.0,1,1.0,1,0.20523460384782724,39
286,3,1065,208,857,0,0,0,1.0,1,1.0,1,1.0,1,0.15856316058680253,39
287,3,1068,209,859,0,0,0,1.0,1,1.0,1,1.0,1,0.21147342443707973,39
288,3,1071,210,861,0,0,0,1.0,1,1.0,1,1.0,1,0.1914624632628472,39
289,0,1071,210,861,0,0,0,1.0,1,1.0,1,1.0,1,0.1914624632628472,39
290,4,1075,211,864,0,0,0,1.0,1,1.0,1,1.0,1,0.17553546500195324,39
291,2,1077,211,866,0,0,0,1.0,1,1.0,1,1.0,1,0.2218721337550049,39
292,2,1079,211,868,0,0,0,1.0,1,1.0,1,1.0,1,0.22349282751490798,40
293,7,1086,213,873,0,0,0,1.0,1,1.0,1,1.0,1,0.2397342826864564,41
294,4,1090,213,877,0,0,0,1.0,1,1.0,1,1.0,1,0.261006538607618,40
295,8,1098,215,883,0,0,0,1.0,1,1.0,1,1.0,1,0.27188972486925705,42
296,5,1103,217,886,0,0,0,1.0,1,1.0,1,1.0,1,0.3452022382011395,42
297,11,1114,217,897,0,0,0,1.0,1,1.0,1,1.0,1,0.3259927379067917,43
298,7,1121,217,904,0,0,0,1.0,1,1.0,1,1.0,1,0.27947675107664777,44
299,8,1129,218,911,0,0,0,1.0,1,1.0,1,1.0,1,0.2821002368835777,44
300,9,1138,218,920,0,0,0,1.0,1,1.0,1,1.0,1,0.2370461091080541,45
301,9,1147,220,927,0,0,0,1.0,1,1.0,1,1.0,1,0.13692358395564197,47
302,5,1152,221,931,0,0,0,1.0,1,1.0,1,1.0,1,0.1970305311424867,46
303,6,1158,223,935,0,0,0,1.0,1,1.0,1,1.0,1,0.17475697015647032,45
304,4,1162,225,937,0,0,0,1.0,1,1.0,1,1.0,1,0.17027933221580824,45
305,1,1163,225,938,0,0,0,1.0,1,1.0,1,1.0,1,0.17413149210100506,43
306,4,1167,226,941,0,0,0,1.0,1,1.0,1,1.0,1,0.2222918491630075,44
307,7,1174,229,945,0,0,0,1.0,1,1.0,1,1.0,1,0.23638953281210257,42
308,2,1176,229,947,0,0,0,1.0,1,1.0,1,1.0,1,0.22477457000310783,41
309,3,1179,229,950,0,0,0,1.0,1,1.0,1,1.0,1,0.23452039406454978,42
310,6,1185,229,956,0,0,0,1.0,1,1.0,1,1.0,1,0.25276452735532684,41
311,3,1188,229,959,0,0,0,1.0,1,1.0,1,1.0,1,0.25237442991816633,41
312,6,1194,230,964,0,0,0,1.0,1,1.0,1,1.0,1,0.25554439711869475,44
313,5,1199,230,969,0,0,0,1.0,1,1.0,1,1.0,1,0.252443921477068,43
314,4,1203,231,972,0,0,0,1.0,1,1.0,1,1.0,1,0.26618730427557047,43
315,6,1209,232,977,0,0,0,1.0,1,1.0,1,1.0,1,0.24377409581009116,43
316,6,1215,232,983,0,0,0,1.0,1,1.0,1,1.0,1,0.15563253296514365,43
317,1,1216,232,984,0,0,0,1.0,1,1.0,1,1.0,1,0.14925587392897166,44
318,4,1220,233,987,0,0,0,1.0,1,1.0,1,1.0,1,0.17762190333527914,45
319,1,1221,233,988,0,0,0,1.0,1,1.0,1,1.0,1,0.1188332503624369,46
320,3,1224,235,989,0,0,0,1.0,1,1.0,1,1.0,1,0.1938102713670234,45
321,2,1226,235,991,0,0,0,1.0,1,1.0,1,1.0,1,0.1763704811116565,44
322,2,1228,235,993,0,0,0,1.0,1,1.0,1,1.0,1,0.2085260652419167,42
323,1,1229,235,994,0,0,0,1.0,1,1.0,1,1.0,1,0.19194304508976262,42
324,2,1231,235,996,0,0,0,1.0,1,1.0,1,1.0,1,0.20694560392205336,43
325,2,1233,236,997,0,0,0,1.0,1,1.0,1,1.0,1,0.18298337090428748,43
326,1,1234,236,998,0,0,0,1.0,1,1.0,1,1.0,1,0.15576160346879225,43
327,3,1237,238,999,0,0,0,1.0,1,1.0,1,1.0,1,0.18555284825994284,44
328,3,1240,239,1001,0,0,0,1.0,1,1.0,1,1.0,1,0.21257708470242223,44
329,2,1242,239,1003,0,0,0,1.0,1,1.0,1,1.0,1,0.2015664008095794,45
330,1,1243,239,1004,0,0,0,1.0,1,1.0,1,1.0,1,0.2030104783495327,46
331,3,1246,239,1007,0,0,0,1.0,1,1.0,1,1.0,1,0.14707227398719722,46
332,2,1248,239,1009,0,0,0,1.0,1,1.0,1,1.0,1,0.13658440637602284,47
333,1,1249,239,1010,0,0,0,1.0,1,1.0,1,1.0,1,0.13481817341606164,48
334,0,1249,239,1010,0,0,0,1.0,1,1.0,1,1.0,1,0.13481817341606164,48
335,0,1249,239,1010,0,0,0,1.0,1,1.0,1,1.0,1,0.13353490401883827,49
336,3,1252,239,1013,0,0,0,1.0,1,1.0,1,1.0,1,0.12533862023538173,50
337,4,1256,240,1016,0,0,0,1.0,1,1.0,1,1.0,1,0.11972886053049502,51
338,4,1260,240,1020,0,0,0,1.0,1,1.0,1,1.0,1,0.09501614973227619,51
339,2,1262,240,1022,0,0,0,1.0,1,1.0,1,1.0,1,0.11124449274075779,51
340,3,1265,241,1024,0,0,0,1.0,1,1.0,1,1.0,1,0.11391592649809386,51
341,1,1266,242,1024,0,0,0,1.0,1,1.0,1,1.0,1,0.11895034859426155,51
342,4,1270,243,1027,0,0,0,1.0,1,1.0,1,1.0,1,0.10050623658807986,51
343,4,1274,243,1031,0,0,0,1.0,1,1.0,1,1.0,1,0.1297866846792289,51
344,4,1278,243,1035,0,0,0,1.0,1,1.0,1,1.0,1,0.14190417431157729,50
345,2,1280,243,1037,0,0,0,1.0,1,1.0,1,1.0,1,0.13768522586240825,50
346,4,1284,244,1040,0,0,0,1.0,1,1.0,1,1.0,1,0.1468950339381162,50
347,3,1287,244,1043,0,0,0,1.0,1,1.0,1,1.0,1,0.13525688289144852,51
348,2,1289,245,1044,0,0,0,1.0,1,1.0,1,1.0,1,0.12527448253983314,52
349,3,1292,248,1044,0,0,0,1.0,1,1.0,1,1.0,1,0.13557813568188642,54
350,2,1294,248,1046,0,0,0,1.0,1,1.0,1,1.0,1,0.14063176631405708,54
351,2,1296,250,1046,0,0,0,1.0,1,1.0,1,1.0,1,0.1724471747415613,54
352,0,1296,250,1046,0,0,0,1.0,1,1.0,1,1.0,1,0.1748550232899928,56
353,1,1297,250,1047,0,0,0,1.0,1,1.0,1,1.0,1,0.14906826989384075,54
354,1,1298,251,1047,0,0,0,1.0,1,1.0,1,1.0,1,0.1762142322761954,53
355,2,1300,252,1048,0,0,0,1.0,1,1.0,1,1.0,1,0.15068242371057097,54
356,1,1301,253,1048,0,0,0,1.0,1,1.0,1,1.0,1,0.17654502769039448,54
357,4,1305,257,1048,0,0,0,1.0,1,1.0,1,1.0,1,0.21910062240260825,53
358,4,1309,257,1052,0,0,0,1.0,1,1.0,1,1.0,1,0.1870133317208738,49
359,0,1309,257,1052,0,0,0,1.0,1,1.0,1,1.0,1,0.17749299460717347,48
360,1,1310,257,1053,0,0,0,1.0,1,1.0,1,1.0,1,0.1666342233116482,47
361,3,1313,257,1056,0,0,0,1.0,1,1.0,1,1.0,1,0.11227553883926333,46
362,0,1313,257,1056,0,0,0,1.0,1,1.0,1,1.0,1,0.11187145879212246,46
363,1,1314,257,1057,0,0,0,1.0,1,1.0,1,1.0,1,0.10679217293623655,47
364,4,1318,258,1060,0,0,0,1.0,1,1.0,1,1.0,1,0.08684695395508635,47
365,2,1320,259,1061,0,0,0,1.0,1,1.0,1,1.0,1,0.14142843842339417,47
366,3,1323,260,1063,0,0,0,1.0,1,1.0,1,1.0,1,0.18647825903200185,50
367,5,1328,260,1068,0,0,0,1.0,1,1.0,1,1.0,1,0.1511036649831157,50
368,4,1332,260,1072,0,0,0,1.0,1,1.0,1,1.0,1,0.12621182458378055,51
369,4,1336,260,1076,0,0,0,1.0,1,1.0,1,1.0,1,0.14225936969681052,51
370,4,1340,260,1080,0,0,0,1.0,1,1.0,1,1.0,1,0.14286917801972546,51
371,8,1348,261,1087,0,0,0,1.0,1,1.0,1,1.0,1,0.1716238049674878,52
372,5,1353,261,1092,0,0,0,1.0,1,1.0,1,1.0,1,0.176486424324588,53
373,9,1362,263,1099,0,0,0,1.0,1,1.0,1,1.0,1,0.18473126999140002,53
374,7,1369,263,1106,0,0,0,1.0,1,1.0,1,1.0,1,0.18493605840442762,53
375,10,1379,267,1112,0,0,0,1.0,1,1.0,1,1.0,1,0.1661396593220478,53
376,8,1387,269,1118,0,0,0,1.0,1,1.0,1,1.0,1,0.06787128000528547,53
377,2,1389,270,1119,0,0,0,1.0,1,1.0,1,1.0,1,0.07939280123323675,53
378,0,1389,270,1119,0,0,0,1.0,1,1.0,1,1.0,1,0.07939280123323675,53
379,2,1391,271,1120,0,0,0,1.0,1,1.0,1,1.0,1,0.10118520493874174,54
380,2,1393,271,1122,0,0,0,1.0,1,1.0,1,1.0,1,0.10415570119007936,54
381,1,1394,272,1122,0,0,0,1.0,1,1.0,1,1.0,1,0.13502378979570392,54
382,1,1395,273,1122,0,0,0,1.0,1,1.0,1,1.0,1,0.12027636183005298,55
383,2,1397,274,1123,0,0,0,1.0,1,1.0,1,1.0,1,0.14825421382254453,55
384,3,1400,275,1125,0,0,0,1.0,1,1.0,1,1.0,1,0.15059894447072744,54
385,2,1402,276,1126,0,0,0,1.0,1,1.0,1,1.0,1,0.1599615190485366,52
386,5,1407,278,1129,0,0,0,1.0,1,1.0,1,1.0,1,0.14903980804867692,52
387,3,1410,280,1130,0,0,0,1.0,1,1.0,1,1.0,1,0.11919726648530087,50
388,6,1416,283,1133,0,0,0,1.0,1,1.0,1,1.0,1,0.08494291331469812,52
389,2,1418,285,1133,0,0,0,1.0,1,1.0,1,1.0,1,0.1303237470178556,51
390,2,1420,287,1133,0,0,0,1.0,1,1.0,1,1.0,1,0.14219383644629488,50
391,9,1429,290,1139,0,0,0,1.0,1,1.0,1,1.0,1,0.12672303635542462,49
392,5,1434,291,1143,0,0,0,1.0,1,1.0,1,1.0,1,0.17135926628942905,47
393,9,1443,294,1149,0,0,0,1.0,1,1.0,1,1.0,1,0.2736329764765088,47
394,11,1454,297,1157,0,0,0,1.0,1,1.0,1,1.0,1,0.30350656718945945,48
395,5,1459,298,1161,0,0,0,1.0,1,1.0,1,1.0,1,0.24913390433559932,46
396,8,1467,299,1168,0,0,0,1.0,1,1.0,1,1.0,1,0.2795489867549772,43
397,3,1470,299,1171,0,0,0,1.0,1,1.0,1,1.0,1,0.3288866754177916,42
398,6,1476,300,1176,0,0,0,1.0,1,1.0,1,1.0,1,0.35636526159951953,40
399,5,1481,301,1180,0,0,0,1.0,1,1.0,1,1.0,1,0.32123053071449253,39
400,4,1485,302,1183,0,0,0,1.0,1,1.0,1,1.0,1,0.3362003376265785,38
401,4,1489,302,1187,0,0,0,1.0,1,1.0,1,1.0,1,0.3294145328630256,37
402,8,1497,303,1194,0,0,0,1.0,1,1.0,1,1.0,1,0.31501738731186124,36
403,7,1504,304,1200,0,0,0,1.0,1,1.0,1,1.0,1,0.32477943440829904,38
404,6,1510,306,1204,0,0,0,1.0,1,1.0,1,1.0,1,0.28919626138145543,39
405,7,1517,306,1211,0,0,0,1.0,1,1.0,1,1.0,1,0.34106119532481416,40
406,9,1526,306,1220,0,0,0,1.0,1,1.0,1,1.0,1,0.19602289530630182,41
407,1,1527,306,1221,0,0,0,1.0,1,1.0,1,1.0,1,0.17291987097371483,42
408,0,1527,306,1221,0,0,0,1.0,1,1.0,1,1.0,1,0.17091857289012694,43
409,0,1527,306,1221,0,0,0,1.0,1,1.0,1,1.0,1,0.17831167021854524,44
410,2,1529,306,1223,0,0,0,1.0,1,1.0,1,1.0,1,0.15727644200774074,46
411,1,1530,307,1223,0,0,0,1.0,1,1.0,1,1.0,1,0.18365962828054694,46
412,2,1532,307,1225,0,0,0,1.0,1,1.0,1,1.0,1,0.15360756872472492,47
413,0,1532,307,1225,0,0,0,1.0,1,1.0,1,1.0,1,0.15360756872472492,47
414,3,1535,307,1228,0,0,0,1.0,1,1.0,1,1.0,1,0.16333893803265562,47
415,4,1539,307,1232,0,0,0,1.0,1,1.0,1,1.0,1,0.1422448874593218,48
416,0,1539,307,1232,0,0,0,1.0,1,1.0,1,1.0,1,0.14128543728917972,49
417,1,1540,307,1233,0,0,0,1.0,1,1.0,1,1.0,1,0.1302145091414215,49
418,3,1543,308,1235,0,0,0,1.0,1,1.0,1,1.0,1,0.1249646286198401,50
419,1,1544,308,1236,0,0,0,1.0,1,1.0,1,1.0,1,0.108816179617119,50
420,4,1548,309,1239,0,0,0,1.0,1,1.0,1,1.0,1,0.10686981216910545,50
421,0,1548,309,1239,0,0,0,1.0,1,1.0,1,1.0,1,0.10686981216910545,50
422,0,1548,309,1239,0,0,0,1.0,1,1.0,1,1.0,1,0.12946915618580604,50
423,1,1549,310,1239,0,0,0,1.0,1,1.0,1,1.0,1,0.15587774934977688,51
424,1,1550,310,1240,0,0,0,1.0,1,1.0,1,1.0,1,0.1492928500156697,49
425,0,1550,310,1240,0,0,0,1.0,1,1.0,1,1.0,1,0.16815555999437756,48
426,4,1554,311,1243,0,0,0,1.0,1,1.0,1,1.0,1,0.14768837591859615,50
427,3,1557,312,1245,0,0,0,1.0,1,1.0,1,1.0,1,0.15998950238795212,48
428,7,1564,316,1248,0,0,0,1.0,1,1.0,1,1.0,1,0.18255395842091668,49
429,1,1565,316,1249,0,0,0,1.0,1,1.0,1,1.0,1,0.17778846214887264,45
430,3,1568,318,1250,0,0,0,1.0,1,1.0,1,1.0,1,0.16950706518404998,44
431,2,1570,320,1250,0,0,0,1.0,1,1.0,1,1.0,1,0.20119001639992906,42
432,1,1571,321,1250,0,0,0,1.0,1,1.0,1,1.0,1,0.23016375772697903,40
433,1,1572,322,1250,0,0,0,1.0,1,1.0,1,1.0,1,0.2809685173269129,39
434,2,1574,323,1251,0,0,0,1.0,1,1.0,1,1.0,1,0.24810543142221256,39
435,1,1575,324,1251,0,0,0,1.0,1,1.0,1,1.0,1,0.29055580686657917,38
436,12,1587,324,1263,0,0,0,1.0,1,1.0,1,1.0,1,0.1527381893295835,38
437,7,1594,324,1270,0,0,0,1.0,1,1.0,1,1.0,1,0.14650984672754852,39
438,4,1598,324,1274,0,0,0,1.0,1,1.0,1,1.0,1,0.150078988195594,38
439,2,1600,324,1276,0,0,0,1.0,1,1.0,1,1.0,1,0.18589527935740408,39
440,2,1602,324,1278,0,0,0,1.0,1,1.0,1,1.0,1,0.17161400944148475,39
441,6,1608,325,1283,0,0,0,1.0,1,1.0,1,1.0,1,0.1826419515950928,41
442,9,1617,325,1292,0,0,0,1.0,1,1.0,1,1.0,1,0.17903165415159455,42
443,7,1624,325,1299,0,0,0,1.0,1,1.0,1,1.0,1,0.15160691475879073,42
444,3,1627,325,1302,0,0,0,1.0,1,1.0,1,1.0,1,0.142674248666325,43
445,7,1634,325,1309,0,0,0,1.0,1,1.0,1,1.0,1,0.1587935829820149,44
446,7,1641,325,1316,0,0,0,1.0,1,1.0,1,1.0,1,0.1480124452248245,44
447,5,1646,325,1321,0,0,0,1.0,1,1.0,1,1.0,1,0.20138255962755613,47
448,11,1657,327,1330,0,0,0,1.0,1,1.0,1,1.0,1,0.22177702065444646,46
449,4,1661,327,1334,0,0,0,1.0,1,1.0,1,1.0,1,0.21427888212462132,46
450,4,1665,327,1338,0,0,0,1.0,1,1.0,1,1.0,1,0.23930596731691015,46
451,12,1677,327,1350,0,0,0,1.0,1,1.0,1,1.0,1,0.16903451540273728,47
452,5,1682,327,1355,0,0,0,1.0,1,1.0,1,1.0,1,0.17020911232413935,47
453,2,1684,327,1357,0,0,0,1.0,1,1.0,1,1.0,1,0.17861694311068513,47
454,5,1689,327,1362,0,0,0,1.0,1,1.0,1,1.0,1,0.13789840363094236,46
455,4,1693,327,1366,0,0,0,1.0,1,1.0,1,1.0,1,0.14565781236627756,47
456,5,1698,327,1371,0,0,0,1.0,1,1.0,1,1.0,1,0.1087213499242713,49
457,5,1703,327,1376,0,0,0,1.0,1,1.0,1,1.0,1,0.16979249233330282,50
458,7,1710,327,1383,0,0,0,1.0,1,1.0,1,1.0,1,0.15575942617786553,50
459,6,1716,327,1389,0,0,0,1.0,1,1.0,1,1.0,1,0.10978549748375711,52
460,10,1726,327,1399,0,0,0,1.0,1,1.0,1,1.0,1,0.12007857998468888,53
461,9,1735,327,1408,0,0,0,1.0,1,1.0,1,1.0,1,0.11980540334853748,54
462,5,1740,327,1413,0,0,0,1.0,1,1.0,1,1.0,1,0.10357088484760243,54
463,13,1753,329,1424,0,0,0,1.0,1,1.0,1,1.0,1,0.1160702722556361,55
464,10,1763,330,1433,0,0,0,1.0,1,1.0,1,1.0,1,0.1211112699586127,56
465,14,1777,330,1447,0,0,0,1.0,1,1.0,1,1.0,1,0.09407332832002092,54
466,2,1779,332,1447,0,0,0,1.0,1,1.0,1,1.0,1,0.11613441033859717,54
467,4,1783,334,1449,0,0,0,1.0,1,1.0,1,1.0,1,0.18226018699180588,51
468,3,1786,336,1450,0,0,0,1.0,1,1.0,1,1.0,1,0.18511027147165407,51
469,5,1791,338,1453,0,0,0,1.0,1,1.0,1,1.0,1,0.1742620989386162,48
470,2,1793,340,1453,0,0,0,1.0,1,1.0,1,1.0,1,0.15868809993202315,47
471,2,1795,342,1453,0,0,0,1.0,1,1.0,1,1.0,1,0.19981446278325607,44
472,6,1801,346,1455,0,0,0,1.0,1,1.0,1,1.0,1,0.16821887525598386,43
473,2,1803,348,1455,0,0,0,1.0,1,1.0,1,1.0,1,0.21658704628526365,41
474,1,1804,349,1455,0,0,0,1.0,1,1.0,1,1.0,1,0.2310615777451134,39
475,2,1806,351,1455,0,0,0,1.0,1,1.0,1,1.0,1,0.2257575394203878,40
476,3,1809,354,1455,0,0,0,1.0,1,1.0,1,1.0,1,0.2917985596975548,38
477,1,1810,355,1455,0,0,0,1.0,1,1.0,1,1.0,1,0.3488299853252412,35
478,0,1810,355,1455,0,0,0,1.0,1,1.0,1,1.0,1,0.3387272108231405,35
479,2,1812,356,1456,0,0,0,1.0,1,1.0,1,1.0,1,0.3795874963645672,32
480,0,1812,356,1456,0,0,0,1.0,1,1.0,1,1.0,1,0.39887482278438785,32
481,9,1821,356,1465,0,0,0,1.0,1,1.0,1,1.0,1,0.2515290040355018,33
482,7,1828,357,1471,0,0,0,1.0,1,1.0,1,1.0,1,0.23946209614196484,34
483,3,1831,358,1473,0,0,0,1.0,1,1.0,1,1.0,1,0.23539930808228063,32
484,7,1838,359,1479,0,0,0,1.0,1,1.0,1,1.0,1,0.23020951222133756,33
485,5,1843,359,1484,0,0,0,1.0,1,1.0,1,1.0,1,0.24993724608653892,34
486,3,1846,359,1487,0,0,0,1.0,1,1.0,1,1.0,1,0.2668592750179596,36
487,1,1847,359,1488,0,0,0,1.0,1,1.0,1,1.0,1,0.2848355672582022,36
488,6,1853,359,1494,0,0,0,1.0,1,1.0,1,1.0,1,0.29512821062545236,37
489,8,1861,361,1500,0,0,0,1.0,1,1.0,1,1.0,1,0.28326528786439303,38
490,3,1864,362,1502,0,0,0,1.0,1,1.0,1,1.0,1,0.2813868318975696,38
491,2,1866,362,1504,0,0,0,1.0,1,1.0,1,1.0,1,0.2886807678655836,37
492,7,1873,362,1511,0,0,0,1.0,1,1.0,1,1.0,1,0.27815562295886126,37
493,5,1878,362,1516,0,0,0,1.0,1,1.0,1,1.0,1,0.261529508364463,37
494,6,1884,363,1521,0,0,0,1.0,1,1.0,1,1.0,1,0.2693422160704406,39
495,5,1889,363,1526,0,0,0,1.0,1,1.0,1,1.0,1,0.21496465592036246,40
496,7,1896,363,1533,0,0,0,1.0,1,1.0,1,1.0,1,0.20228361190900343,40
497,8,1904,363,1541,0,0,0,1.0,1,1.0,1,1.0,1,0.17598360477571937,43
498,7,1911,363,1548,0,0,0,1.0,1,1.0,1,1.0,1,0.09009746267989889,43
499,4,1915,364,1551,0,0,0,1.0,1,1.0,1,1.0,1,0.2153539416352924,44
500,11,1926,364,1562,0,0,0,1.0,1,1.0,1,1.0,1,0.2112599679217274,45
501,10,1936,364,1572,0,0,0,1.0,1,1.0,1,1.0,1,0.2112599679217274,45
502,8,1944,365,1579,0,0,0,1.0,1,1.0,1,1.0,1,0.14310046947091193,45
503,15,1959,367,1592,0,0,0,1.0,1,1.0,1,1.0,1,0.15479650729373481,46
504,12,1971,368,1603,0,0,0,1.0,1,1.0,1,1.0,1,0.21263489580507752,47
505,14,1985,370,1615,0,0,0,1.0,1,1.0,1,1.0,1,0.2759471047779432,42
506,17,2002,373,1629,0,0,0,1.0,1,1.0,1,1.0,1,0.3333910733737532,41
507,8,2010,373,1637,0,0,0,1.0,1,1.0,1,1.0,1,0.3071780391661541,38
508,7,2017,374,1643,0,0,0,1.0,1,1.0,1,1.0,1,0.37677145552925134,38
509,9,2026,374,1652,0,0,0,1.0,1,1.0,1,1.0,1,0.35387518105974186,37
510,14,2040,374,1666,0,0,0,1.0,1,1.0,1,1.0,1,0.345260844508935,36
511,7,2047,375,1672,0,0,0,1.0,1,1.0,1,1.0,1,0.19681341410583855,34
512,0,2047,375,1672,0,0,0,1.0,1,1.0,1,1.0,1,0.1903506492164284,32
513,0,2047,375,1672,0,0,0,1.0,1,1.0,1,1.0,1,0.1903506492164284,32
514,1,2048,375,1673,0,0,0,1.0,1,1.0,1,1.0,1,0.136692547330348,35
515,4,2052,375,1677,0,0,0,1.0,1,1.0,1,1.0,1,0.11945078823220986,35
516,0,2052,375,1677,0,0,0,1.0,1,1.0,1,1.0,1,0.09545849577235166,36
517,3,2055,375,1680,0,0,0,1.0,1,1.0,1,1.0,1,0.091546511543248,36
518,2,2057,375,1682,0,0,0,1.0,1,1.0,1,1.0,1,0.11085526212488969,39
519,4,2061,375,1686,0,0,0,1.0,1,1.0,1,1.0,1,0.11015803607840369,39
520,7,2068,376,1692,0,0,0,1.0,1,1.0,1,1.0,1,0.2264101543430733,39
521,10,2078,376,1702,0,0,0,1.0,1,1.0,1,1.0,1,0.23350399541549433,40
522,8,2086,376,1710,0,0,0,1.0,1,1.0,1,1.0,1,0.18982127191000467,40
523,6,2092,376,1716,0,0,0,1.0,1,1.0,1,1.0,1,0.19950843235603255,41
524,9,2101,376,1725,0,0,0,1.0,1,1.0,1,1.0,1,0.21676413216358362,41
525,6,2107,377,1730,0,0,0,1.0,1,1.0,1,1.0,1,0.1699452897787587,40
526,7,2114,378,1736,0,0,0,1.0,1,1.0,1,1.0,1,0.15051500319164957,40
527,4,2118,379,1739,0,0,0,1.0,1,1.0,1,1.0,1,0.19439071050668888,40
528,4,2122,380,1742,0,0,0,1.0,1,1.0,1,1.0,1,0.1342660054002427,40
529,1,2123,380,1743,0,0,0,1.0,1,1.0,1,1.0,1,0.12798038260441066,39
530,1,2124,380,1744,0,0,0,1.0,1,1.0,1,1.0,1,0.1456207598593101,39
531,1,2125,380,1745,0,0,0,1.0,1,1.0,1,1.0,1,0.18225080815775815,39
532,3,2128,381,1747,0,0,0,1.0,1,1.0,1,1.0,1,0.19653740110982088,40
533,9,2137,383,1754,0,0,0,1.0,1,1.0,1,1.0,1,0.1789102954640193,40
534,5,2142,383,1759,0,0,0,1.0,1,1.0,1,1.0,1,0.1944020745493834,42
535,7,2149,383,1766,0,0,0,1.0,1,1.0,1,1.0,1,0.21746642075901765,42
536,7,2156,383,1773,0,0,0,1.0,1,1.0,1,1.0,1,0.2246888683320045,43
537,5,2161,383,1778,0,0,0,1.0,1,1.0,1,1.0,1,0.24396354807056372,43
538,9,2170,384,1786,0,0,0,1.0,1,1.0,1,1.0,1,0.2824641916463453,44
539,11,2181,384,1797,0,0,0,1.0,1,1.0,1,1.0,1,0.25312288121339427,44
540,5,2186,384,1802,0,0,0,1.0,1,1.0,1,1.0,1,0.23937837749269433,44
541,6,2192,384,1808,0,0,0,1.0,1,1.0,1,1.0,1,0.13911386567529696,45
542,2,2194,384,1810,0,0,0,1.0,1,1.0,1,1.0,1,0.08418635757802166,46
543,2,2196,385,1811,0,0,0,1.0,1,1.0,1,1.0,1,0.14567011544038924,43
544,4,2200,387,1813,0,0,0,1.0,1,1.0,1,1.0,1,0.20450480429976714,42
545,3,2203,388,1815,0,0,0,1.0,1,1.0,1,1.0,1,0.18144542739319935,43
546,1,2204,388,1816,0,0,0,1.0,1,1.0,1,1.0,1,0.1771933371800279,41
547,2,2206,388,1818,0,0,0,1.0,1,1.0,1,1.0,1,0.2153191403509549,40
548,5,2211,391,1820,0,0,0,1.0,1,1.0,1,1.0,1,0.2346802608816352,40
549,4,2215,392,1823,0,0,0,1.0,1,1.0,1,1.0,1,0.27195572992829864,39
550,3,2218,392,1826,0,0,0,1.0,1,1.0,1,1.0,1,0.2431594488732017,38
551,3,2221,392,1829,0,0,0,1.0,1,1.0,1,1.0,1,0.22880714526455534,38
552,1,2222,392,1830,0,0,0,1.0,1,1.0,1,1.0,1,0.2172544515445618,39
553,2,2224,392,1832,0,0,0,1.0,1,1.0,1,1.0,1,0.22282371670256237,38
554,2,2226,392,1834,0,0,0,1.0,1,1.0,1,1.0,1,0.2443057702723371,39
555,1,2227,392,1835,0,0,0,1.0,1,1.0,1,1.0,1,0.2500002178588886,39
556,10,2237,392,1845,0,0,0,1.0,1,1.0,1,1.0,1,0.15279632685242564,40
557,1,2238,392,1846,0,0,0,1.0,1,1.0,1,1.0,1,0.1478999779212978,40
558,0,2238,392,1846,0,0,0,1.0,1,1.0,1,1.0,1,0.1478999779212978,40
559,1,2239,392,1847,0,0,0,1.0,1,1.0,1,1.0,1,0.13821355331383703,40
560,1,2240,392,1848,0,0,0,1.0,1,1.0,1,1.0,1,0.13145641652888712,41
561,1,2241,392,1849,0,0,0,1.0,1,1.0,1,1.0,1,0.13282916435887487,42
562,5,2246,393,1853,0,0,0,1.0,1,1.0,1,1.0,1,0.16709904777370232,42
563,6,2252,395,1857,0,0,0,1.0,1,1.0,1,1.0,1,0.24434747167742238,42
564,5,2257,395,1862,0,0,0,1.0,1,1.0,1,1.0,1,0.25472602441526176,43
565,5,2262,397,1865,0,0,0,1.0,1,1.0,1,1.0,1,0.2867753892034907,44
566,10,2272,397,1875,0,0,0,1.0,1,1.0,1,1.0,1,0.30523826901551576,45
567,5,2277,398,1879,0,0,0,1.0,1,1.0,1,1.0,1,0.3220405046430956,45
568,7,2284,398,1886,0,0,0,1.0,1,1.0,1,1.0,1,0.2572317066205319,46
569,13,2297,399,1898,0,0,0,1.0,1,1.0,1,1.0,1,0.29191697866495975,47
570,11,2308,399,1909,0,0,0,1.0,1,1.0,1,1.0,1,0.24273349164560873,48
571,6,2314,400,1914,0,0,0,1.0,1,1.0,1,1.0,1,0.21302404891585047,48
572,0,2314,400,1914,0,0,0,1.0,1,1.0,1,1.0,1,0.22885880068712627,47
573,6,2320,400,1920,0,0,0,1.0,1,1.0,1,1.0,1,0.19425755056877553,49
574,2,2322,400,1922,0,0,0,1.0,1,1.0,1,1.0,1,0.19425755056877553,49
575,3,2325,400,1925,0,0,0,1.0,1,1.0,1,1.0,1,0.16567937361696353,50
576,2,2327,400,1927,0,0,0,1.0,1,1.0,1,1.0,1,0.18106265036748997,51
577,2,2329,400,1929,0,0,0,1.0,1,1.0,1,1.0,1,0.1721777701919727,51
578,3,2332,400,1932,0,0,0,1.0,1,1.0,1,1.0,1,0.15479615441623892,51
579,2,2334,402,1932,0,0,0,1.0,1,1.0,1,1.0,1,0.19337108286584864,52
580,2,2336,402,1934,0,0,0,1.0,1,1.0,1,1.0,1,0.16733802125669045,52
581,1,2337,402,1935,0,0,0,1.0,1,1.0,1,1.0,1,0.16145307749885848,52
582,3,2340,402,1938,0,0,0,1.0,1,1.0,1,1.0,1,0.12828479061197925,53
583,3,2343,403,1940,0,0,0,1.0,1,1.0,1,1.0,1,0.10425078819910638,51
584,6,2349,405,1944,0,0,0,1.0,1,1.0,1,1.0,1,0.10792355305345055,51
585,5,2354,407,1947,0,0,0,1.0,1,1.0,1,1.0,1,0.12939119988605266,49
586,1,2355,407,1948,0,0,0,1.0,1,1.0,1,1.0,1,0.08340653253230361,49
587,2,2357,408,1949,0,0,0,1.0,1,1.0,1,1.0,1,0.09752588689827754,48
588,3,2360,409,1951,0,0,0,1.0,1,1.0,1,1.0,1,0.13328167853549203,46
589,7,2367,412,1955,0,0,0,1.0,1,1.0,1,1.0,1,0.2142133278402241,48
590,5,2372,412,1960,0,0,0,1.0,1,1.0,1,1.0,1,0.19296706028090366,47
591,4,2376,413,1963,0,0,0,1.0,1,1.0,1,1.0,1,0.22859049412552493,48
592,4,2380,414,1966,0,0,0,1.0,1,1.0,1,1.0,1,0.22695118509263168,47
593,1,2381,415,1966,0,0,0,1.0,1,1.0,1,1.0,1,0.2438690592296046,45
594,3,2384,416,1968,0,0,0,1.0,1,1.0,1,1.0,1,0.25511832388625705,44
595,5,2389,418,1971,0,0,0,1.0,1,1.0,1,1.0,1,0.27707323074225887,43
596,6,2395,421,1974,0,0,0,1.0,1,1.0,1,1.0,1,0.2975409418646041,44
597,2,2397,421,1976,0,0,0,1.0,1,1.0,1,1.0,1,0.29482762542019963,43
598,3,2400,422,1978,0,0,0,1.0,1,1.0,1,1.0,1,0.2760342938811038,45
599,3,2403,424,1979,0,0,0,1.0,1,1.0,1,1.0,1,0.305524753548146,44
600,2,2405,424,1981,0,0,0,1.0,1,1.0,1,1.0,1,0.30025906494193244,44
601,5,2410,426,1984,0,0,0,1.0,1,1.0,1,1.0,1,0.1979269198095566,45
602,5,2415,426,1989,0,0,0,1.0,1,1.0,1,1.0,1,0.16531208806622225,46
603,3,2418,426,1992,0,0,0,1.0,1,1.0,1,1.0,1,0.1839226176763827,46
604,4,2422,427,1995,0,0,0,1.0,1,1.0,1,1.0,1,0.15028353813466924,47
605,1,2423,427,1996,0,0,0,1.0,1,1.0,1,1.0,1,0.13997969483221592,47
606,0,2423,427,1996,0,0,0,1.0,1,1.0,1,1.0,1,0.15133196749121675,47
607,2,2425,427,1998,0,0,0,1.0,1,1.0,1,1.0,1,0.15637156757312629,48
608,1,2426,427,1999,0,0,0,1.0,1,1.0,1,1.0,1,0.14592890919181617,47
609,4,2430,427,2003,0,0,0,1.0,1,1.0,1,1.0,1,0.12532331179259978,48
610,2,2432,427,2005,0,0,0,1.0,1,1.0,1,1.0,1,0.10939412253653537,48
611,5,2437,427,2010,0,0,0,1.0,1,1.0,1,1.0,1,0.1376287817736488,49
612,1,2438,427,2011,0,0,0,1.0,1,1.0,1,1.0,1,0.12543313729898817,50
613,5,2443,428,2015,0,0,0,1.0,1,1.0,1,1.0,1,0.14702867968960856,50
614,5,2448,428,2020,0,0,0,1.0,1,1.0,1,1.0,1,0.1610909714331488,50
615,5,2453,429,2024,0,0,0,1.0,1,1.0,1,1.0,1,0.14534556214547684,50
616,4,2457,429,2028,0,0,0,1.0,1,1.0,1,1.0,1,0.10535474630113192,50
617,4,2461,429,2032,0,0,0,1.0,1,1.0,1,1.0,1,0.10329429276517559,52
618,5,2466,429,2037,0,0,0,1.0,1,1.0,1,1.0,1,0.10551708556775004,52
619,4,2470,429,2041,0,0,0,1.0,1,1.0,1,1.0,1,0.0918533945172957,50
620,2,2472,429,2043,0,0,0,1.0,1,1.0,1,1.0,1,0.1231897787919284,50
621,2,2474,429,2045,0,0,0,1.0,1,1.0,1,1.0,1,0.13583261112143147,49
622,2,2476,429,2047,0,0,0,1.0,1,1.0,1,1.0,1,0.11823953717712395,49
623,8,2484,430,2054,0,0,0,1.0,1,1.0,1,1.0,1,0.1348304958445662,48
624,5,2489,432,2057,0,0,0,1.0,1,1.0,1,1.0,1,0.15706789994997966,46
625,1,2490,433,2057,0,0,0,1.0,1,1.0,1,1.0,1,0.14665698453123127,45
626,1,2491,434,2057,0,0,0,1.0,1,1.0,1,1.0,1,0.19423287170650358,44
627,8,2499,439,2060,0,0,0,1.0,1,1.0,1,1.0,1,0.24954210425276083,44
628,7,2506,441,2065,0,0,0,1.0,1,1.0,1,1.0,1,0.2741619220886276,44
629,2,2508,441,2067,0,0,0,1.0,1,1.0,1,1.0,1,0.29977391444769214,41
630,4,2512,443,2069,0,0,0,1.0,1,1.0,1,1.0,1,0.2903603753988837,40
631,6,2518,445,2073,0,0,0,1.0,1,1.0,1,1.0,1,0.22501515850657858,38
632,3,2521,447,2074,0,0,0,1.0,1,1.0,1,1.0,1,0.19878158742095658,38
633,2,2523,448,2075,0,0,0,1.0,1,1.0,1,1.0,1,0.2231331577896862,36
634,0,2523,448,2075,0,0,0,1.0,1,1.0,1,1.0,1,0.20568771725204701,35
635,2,2525,449,2076,0,0,0,1.0,1,1.0,1,1.0,1,0.1740987363099826,35
636,1,2526,449,2077,0,0,0,1.0,1,1.0,1,1.0,1,0.20158545808518838,36
637,2,2528,449,2079,0,0,0,1.0,1,1.0,1,1.0,1,0.23808727635579077,35
638,3,2531,449,2082,0,0,0,1.0,1,1.0,1,1.0,1,0.30261264994874776,34
639,5,2536,450,2086,0,0,0,1.0,1,1.0,1,1.0,1,0.23745338527004517,36
640,2,2538,450,2088,0,0,0,1.0,1,1.0,1,1.0,1,0.2852441487725243,37
641,4,2542,450,2092,0,0,0,1.0,1,1.0,1,1.0,1,0.2852441487725243,37
642,3,2545,450,2095,0,0,0,1.0,1,1.0,1,1.0,1,0.22986549036494164,38
643,1,2546,450,2096,0,0,0,1.0,1,1.0,1,1.0,1,0.21924471474009807,39
644,2,2548,451,2097,0,0,0,1.0,1,1.0,1,1.0,1,0.22169055570216048,39
645,3,2551,451,2100,0,0,0,1.0,1,1.0,1,1.0,1,0.2340785297033708,39
646,10,2561,453,2108,0,0,0,1.0,1,1.0,1,1.0,1,0.15113063041252378,40
647,0,2561,453,2108,0,0,0,1.0,1,1.0,1,1.0,1,0.15113063041252378,40
648,1,2562,454,2108,0,0,0,1.0,1,1.0,1,1.0,1,0.1700685832994083,40
649,3,2565,454,2111,0,0,0,1.0,1,1.0,1,1.0,1,0.17935032383815627,40
650,4,2569,455,2114,0,0,0,1.0,1,1.0,1,1.0,1,0.2148631524766796,41
651,6,2575,455,2120,0,0,0,1.0,1,1.0,1,1.0,1,0.17242462884162765,42
652,4,2579,455,2124,0,0,0,1.0,1,1.0,1,1.0,1,0.167361829044073,41
653,4,2583,455,2128,0,0,0,1.0,1,1.0,1,1.0,1,0.167361829044073,41
654,7,2590,457,2133,0,0,0,1.0,1,1.0,1,1.0,1,0.18977449730641,42
655,6,2596,457,2139,0,0,0,1.0,1,1.0,1,1.0,1,0.1913284662938354,45
656,7,2603,460,2143,0,0,0,1.0,1,1.0,1,1.0,1,0.243420366402009,45
657,5,2608,460,2148,0,0,0,1.0,1,1.0,1,1.0,1,0.17951731040622637,43
658,5,2613,461,2152,0,0,0,1.0,1,1.0,1,1.0,1,0.2215071320230685,43
659,5,2618,462,2156,0,0,0,1.0,1,1.0,1,1.0,1,0.22574259204003447,43
660,7,2625,464,2161,0,0,0,1.0,1,1.0,1,1.0,1,0.2774753913979464,43
661,4,2629,465,2164,0,0,0,1.0,1,1.0,1,1.0,1,0.2130783526394223,41
662,2,2631,466,2165,0,0,0,1.0,1,1.0,1,1.0,1,0.1486760588264983,40
663,0,2631,466,2165,0,0,0,1.0,1,1.0,1,1.0,1,0.15296031764570703,39
664,3,2634,468,2166,0,0,0,1.0,1,1.0,1,1.0,1,0.13068822558300247,36
665,2,2636,468,2168,0,0,0,1.0,1,1.0,1,1.0,1,0.11673078750866363,36
666,5,2641,471,2170,0,0,0,1.0,1,1.0,1,1.0,1,0.13778238020760317,36
667,2,2643,472,2171,0,0,0,1.0,1,1.0,1,1.0,1,0.14212693254574293,35
668,3,2646,475,2171,0,0,0,1.0,1,1.0,1,1.0,1,0.17290458654431687,34
669,3,2649,478,2171,0,0,0,1.0,1,1.0,1,1.0,1,0.2596244945615173,34
670,1,2650,479,2171,0,0,0,1.0,1,1.0,1,1.0,1,0.2713678124668082,32
671,2,2652,479,2173,0,0,0,1.0,1,1.0,1,1.0,1,0.2560961754511461,33
672,3,2655,479,2176,0,0,0,1.0,1,1.0,1,1.0,1,0.2888673361674413,32
673,3,2658,479,2179,0,0,0,1.0,1,1.0,1,1.0,1,0.3176808043441908,32
674,4,2662,481,2181,0,0,0,1.0,1,1.0,1,1.0,1,0.32102613005302283,32
675,5,2667,482,2185,0,0,0,1.0,1,1.0,1,1.0,1,0.3324650006316397,34
676,11,2678,482,2196,0,0,0,1.0,1,1.0,1,1.0,1,0.10227332820752222,35
677,5,2683,482,2201,0,0,0,1.0,1,1.0,1,1.0,1,0.2057526867276282,35
678,3,2686,482,2204,0,0,0,1.0,1,1.0,1,1.0,1,0.13076033007726784,35
679,5,2691,483,2208,0,0,0,1.0,1,1.0,1,1.0,1,0.16877333086763377,36
680,3,2694,484,2210,0,0,0,1.0,1,1.0,1,1.0,1,0.18809489797965911,37
681,5,2699,484,2215,0,0,0,1.0,1,1.0,1,1.0,1,0.22145935109771098,37
682,3,2702,484,2218,0,0,0,1.0,1,1.0,1,1.0,1,0.20408187631614028,37
683,7,2709,485,2224,0,0,0,1.0,1,1.0,1,1.0,1,0.20938981192819098,38
684,10,2719,486,2233,0,0,0,1.0,1,1.0,1,1.0,1,0.14754144761781457,39
685,3,2722,486,2236,0,0,0,1.0,1,1.0,1,1.0,1,0.16706209837548358,38
686,8,2730,487,2243,0,0,0,1.0,1,1.0,1,1.0,1,0.19185266804711326,37
687,5,2735,488,2247,0,0,0,1.0,1,1.0,1,1.0,1,0.21504096642155737,38
688,7,2742,488,2254,0,0,0,1.0,1,1.0,1,1.0,1,0.24728085280478254,37
689,11,2753,490,2263,0,0,0,1.0,1,1.0,1,1.0,1,0.2609631477873483,39
690,8,2761,490,2271,0,0,0,1.0,1,1.0,1,1.0,1,0.23714472977692555,38
691,2,2763,491,2272,0,0,0,1.0,1,1.0,1,1.0,1,0.17590068528320663,38
692,2,2765,492,2273,0,0,0,1.0,1,1.0,1,1.0,1,0.1534645004094797,38
693,3,2768,493,2275,0,0,0,1.0,1,1.0,1,1.0,1,0.1783666614190047,40
694,0,2768,493,2275,0,0,0,1.0,1,1.0,1,1.0,1,0.17823828062419986,42
695,3,2771,495,2276,0,0,0,1.0,1,1.0,1,1.0,1,0.186010982317786,40
696,6,2777,497,2280,0,0,0,1.0,1,1.0,1,1.0,1,0.21788927446460646,39
697,2,2779,497,2282,0,0,0,1.0,1,1.0,1,1.0,1,0.22055101543240363,39
698,2,2781,498,2283,0,0,0,1.0,1,1.0,1,1.0,1,0.19941735982002007,37
699,0,2781,498,2283,0,0,0,1.0,1,1.0,1,1.0,1,0.2080836426182944,37
700,1,2782,498,2284,0,0,0,1.0,1,1.0,1,1.0,1,0.24886367295213052,37
701,0,2782,498,2284,0,0,0,1.0,1,1.0,1,1.0,1,0.24886367295213052,37
702,2,2784,499,2285,0,0,0,1.0,1,1.0,1,1.0,1,0.25423994729231886,38
703,4,2788,502,2286,0,0,0,1.0,1,1.0,1,1.0,1,0.27481636966406087,36
704,4,2792,504,2288,0,0,0,1.0,1,1.0,1,1.0,1,0.31438958857978566,36
705,4,2796,506,2290,0,0,0,1.0,1,1.0,1,1.0,1,0.2996585904458244,36
706,11,2807,510,2297,0,0,0,1.0,1,1.0,1,1.0,1,0.2723810758753901,35
707,5,2812,511,2301,0,0,0,1.0,1,1.0,1,1.0,1,0.26120044839731293,36
708,6,2818,512,2306,0,0,0,1.0,1,1.0,1,1.0,1,0.22463128168055846,36
709,3,2821,513,2308,0,0,0,1.0,1,1.0,1,1.0,1,0.21455922000483865,34
710,3,2824,514,2310,0,0,0,1.0,1,1.0,1,1.0,1,0.24939899089336215,34
711,1,2825,514,2311,0,0,0,1.0,1,1.0,1,1.0,1,0.25498615297198457,34
712,3,2828,514,2314,0,0,0,1.0,1,1.0,1,1.0,1,0.24664217696125396,35
713,6,2834,516,2318,0,0,0,1.0,1,1.0,1,1.0,1,0.21791868333949255,34
714,2,2836,517,2319,0,0,0,1.0,1,1.0,1,1.0,1,0.2090241194293485,34
715,5,2841,518,2323,0,0,0,1.0,1,1.0,1,1.0,1,0.19601734611462066,35
716,2,2843,518,2325,0,0,0,1.0,1,1.0,1,1.0,1,0.217666852555988,33
717,3,2846,519,2327,0,0,0,1.0,1,1.0,1,1.0,1,0.2864858029001535,33
718,4,2850,520,2330,0,0,0,1.0,1,1.0,1,1.0,1,0.29040300730402735,32
719,6,2856,520,2336,0,0,0,1.0,1,1.0,1,1.0,1,0.28177208249182617,32
720,1,2857,521,2336,0,0,0,1.0,1,1.0,1,1.0,1,0.2849679117087216,33
721,3,2860,521,2339,0,0,0,1.0,1,1.0,1,1.0,1,0.22650128126298846,33
722,0,2860,521,2339,0,0,0,1.0,1,1.0,1,1.0,1,0.24207557361930004,34
723,2,2862,521,2341,0,0,0,1.0,1,1.0,1,1.0,1,0.19030754266601765,34
724,5,2867,522,2345,0,0,0,1.0,1,1.0,1,1.0,1,0.18115503801953692,36
725,2,2869,522,2347,0,0,0,1.0,1,1.0,1,1.0,1,0.14824030711212136,36
726,0,2869,522,2347,0,0,0,1.0,1,1.0,1,1.0,1,0.14824030711212136,36
727,1,2870,522,2348,0,0,0,1.0,1,1.0,1,1.0,1,0.15510399894704543,36
728,1,2871,522,2349,0,0,0,1.0,1,1.0,1,1.0,1,0.14509623627663007,37
729,1,2872,522,2350,0,0,0,1.0,1,1.0,1,1.0,1,0.17134324208833318,37
730,0,2872,522,2350,0,0,0,1.0,1,1.0,1,1.0,1,0.16266056464908837,38
731,0,2872,522,2350,0,0,0,1.0,1,1.0,1,1.0,1,0.1833457867530359,39
732,2,2874,522,2352,0,0,0,1.0,1,1.0,1,1.0,1,0.1515397280147994,41
733,4,2878,524,2354,0,0,0,1.0,1,1.0,1,1.0,1,0.22477043151216783,39
734,3,2881,524,2357,0,0,0,1.0,1,1.0,1,1.0,1,0.16556860628461245,39
735,3,2884,525,2359,0,0,0,1.0,1,1.0,1,1.0,1,0.19571914881528749,39
736,12,2896,525,2371,0,0,0,1.0,1,1.0,1,1.0,1,0.12270732880819646,38
737,6,2902,525,2377,0,0,0,1.0,1,1.0,1,1.0,1,0.06791528793518349,39
738,1,2903,525,2378,0,0,0,1.0,1,1.0,1,1.0,1,0.13475017394832114,37
739,2,2905,525,2380,0,0,0,1.0,1,1.0,1,1.0,1,0.12765652295973545,37
740,1,2906,525,2381,0,0,0,1.0,1,1.0,1,1.0,1,0.15495347425559844,35
741,1,2907,525,2382,0,0,0,1.0,1,1.0,1,1.0,1,0.17258581769466802,33
742,1,2908,525,2383,0,0,0,1.0,1,1.0,1,1.0,1,0.1622862670815195,35
743,5,2913,529,2384,0,0,0,1.0,1,1.0,1,1.0,1,0.2692174963246094,35
744,5,2918,531,2387,0,0,0,1.0,1,1.0,1,1.0,1,0.21170269397023833,34
745,5,2923,532,2391,0,0,0,1.0,1,1.0,1,1.0,1,0.17945005857103932,34
746,3,2926,534,2392,0,0,0,1.0,1,1.0,1,1.0,1,0.19726887582603092,33
747,1,2927,534,2393,0,0,0,1.0,1,1.0,1,1.0,1,0.23734657193028758,32
748,1,2928,534,2394,0,0,0,1.0,1,1.0,1,1.0,1,0.1746648743361321,33
749,1,2929,535,2394,0,0,0,1.0,1,1.0,1,1.0,1,0.18745811983500021,33
750,6,2935,536,2399,0,0,0,1.0,1,1.0,1,1.0,1,0.18155561373484275,34
751,6,2941,537,2404,0,0,0,1.0,1,1.0,1,1.0,1,0.08980030751021693,36
752,1,2942,538,2404,0,0,0,1.0,1,1.0,1,1.0,1,0.09240916382013334,35
753,2,2944,539,2405,0,0,0,1.0,1,1.0,1,1.0,1,0.14415484691522762,37
754,5,2949,540,2409,0,0,0,1.0,1,1.0,1,1.0,1,0.1421881569916214,37
755,1,2950,541,2409,0,0,0,1.0,1,1.0,1,1.0,1,0.12382669117849283,35
756,1,2951,541,2410,0,0,0,1.0,1,1.0,1,1.0,1,0.14588319945306838,36
757,2,2953,541,2412,0,0,0,1.0,1,1.0,1,1.0,1,0.12986803214006823,35
758,2,2955,541,2414,0,0,0,1.0,1,1.0,1,1.0,1,0.14388978508574915,36
759,4,2959,542,2417,0,0,0,1.0,1,1.0,1,1.0,1,0.18497666302181875,37
760,2,2961,542,2419,0,0,0,1.0,1,1.0,1,1.0,1,0.15930961264794669,36
761,2,2963,542,2421,0,0,0,1.0,1,1.0,1,1.0,1,0.15930961264794669,36
762,2,2965,542,2423,0,0,0,1.0,1,1.0,1,1.0,1,0.17877723416799116,37
763,2,2967,542,2425,0,0,0,1.0,1,1.0,1,1.0,1,0.1877493298665014,38
764,1,2968,542,2426,0,0,0,1.0,1,1.0,1,1.0,1,0.17499958617710917,38
765,1,2969,542,2427,0,0,0,1.0,1,1.0,1,1.0,1,0.1877493298665014,38
766,2,2971,542,2429,0,0,0,1.0,1,1.0,1,1.0,1,0.1468877491500409,40
767,1,2972,542,2430,0,0,0,1.0,1,1.0,1,1.0,1,0.16079720299777966,41
768,6,2978,543,2435,0,0,0,1.0,1,1.0,1,1.0,1,0.1325530373418268,41
769,2,2980,543,2437,0,0,0,1.0,1,1.0,1,1.0,1,0.11288548801309943,42
770,2,2982,543,2439,0,0,0,1.0,1,1.0,1,1.0,1,0.12210333066921483,41
771,5,2987,543,2444,0,0,0,1.0,1,1.0,1,1.0,1,0.1484848167468943,41
772,4,2991,545,2446,0,0,0,1.0,1,1.0,1,1.0,1,0.19882920685988428,41
773,5,2996,545,2451,0,0,0,1.0,1,1.0,1,1.0,1,0.12598705020093276,41
774,9,3005,547,2458,0,0,0,1.0,1,1.0,1,1.0,1,0.19292858603708163,42
775,4,3009,547,2462,0,0,0,1.0,1,1.0,1,1.0,1,0.1780791323059497,42
776,5,3014,547,2467,0,0,0,1.0,1,1.0,1,1.0,1,0.17033015299566304,42
777,5,3019,547,2472,0,0,0,1.0,1,1.0,1,1.0,1,0.17882266446685113,42
778,6,3025,547,2478,0,0,0,1.0,1,1.0,1,1.0,1,0.19305346479398972,44
779,4,3029,548,2481,0,0,0,1.0,1,1.0,1,1.0,1,0.1774542368325927,44
780,5,3034,549,2485,0,0,0,1.0,1,1.0,1,1.0,1,0.1763627488062669,44
781,3,3037,549,2488,0,0,0,1.0,1,1.0,1,1.0,1,0.1136459063137382,46
782,4,3041,551,2490,0,0,0,1.0,1,1.0,1,1.0,1,0.13136521918590638,45
783,1,3042,551,2491,0,0,0,1.0,1,1.0,1,1.0,1,0.0997388926441165,44
784,1,3043,552,2491,0,0,0,1.0,1,1.0,1,1.0,1,0.1431660756036536,44
785,3,3046,552,2494,0,0,0,1.0,1,1.0,1,1.0,1,0.10623628991623753,43
786,2,3048,553,2495,0,0,0,1.0,1,1.0,1,1.0,1,0.08372668048929226,43
787,0,3048,553,2495,0,0,0,1.0,1,1.0,1,1.0,1,0.08372668048929226,43
788,2,3050,554,2496,0,0,0,1.0,1,1.0,1,1.0,1,0.12753905016341577,45
789,1,3051,555,2496,0,0,0,1.0,1,1.0,1,1.0,1,0.09958443302187074,46
790,0,3051,555,2496,0,0,0,1.0,1,1.0,1,1.0,1,0.12726608554677124,45
791,0,3051,555,2496,0,0,0,1.0,1,1.0,1,1.0,1,0.14724488203455172,46
792,2,3053,556,2497,0,0,0,1.0,1,1.0,1,1.0,1,0.17319779511923517,46
793,0,3053,556,2497,0,0,0,1.0,1,1.0,1,1.0,1,0.17319779511923517,46
794,9,3062,557,2505,0,0,0,1.0,1,1.0,1,1.0,1,0.21474269189411838,47
795,6,3068,557,2511,0,0,0,1.0,1,1.0,1,1.0,1,0.19793009321769123,47
796,5,3073,558,2515,0,0,0,1.0,1,1.0,1,1.0,1,0.13324152779185425,46
797,1,3074,558,2516,0,0,0,1.0,1,1.0,1,1.0,1,0.15601102101345954,47
798,4,3078,559,2519,0,0,0,1.0,1,1.0,1,1.0,1,0.1345938754919981,48
799,2,3080,560,2520,0,0,0,1.0,1,1.0,1,1.0,1,0.10349777546741616,48
800,1,3081,561,2520,0,0,0,1.0,1,1.0,1,1.0,1,0.1211849842241263,48
801,0,3081,561,2520,0,0,0,1.0,1,1.0,1,1.0,1,0.13367201083836638,49
802,1,3082,562,2520,0,0,0,1.0,1,1.0,1,1.0,1,0.12874734620281597,50
803,0,3082,562,2520,0,0,0,1.0,1,1.0,1,1.0,1,0.11834681361099254,49
804,2,3084,564,2520,0,0,0,1.0,1,1.0,1,1.0,1,0.13682999599752188,50
805,1,3085,564,2521,0,0,0,1.0,1,1.0,1,1.0,1,0.12341359580711563,50
806,0,3085,564,2521,0,0,0,1.0,1,1.0,1,1.0,1,0.12341359580711563,50
807,2,3087,566,2521,0,0,0,1.0,1,1.0,1,1.0,1,0.20156921773090467,51
808,4,3091,567,2524,0,0,0,1.0,1,1.0,1,1.0,1,0.1899139994198138,51
809,4,3095,568,2527,0,0,0,1.0,1,1.0,1,1.0,1,0.12822124488239137,51
810,2,3097,568,2529,0,0,0,1.0,1,1.0,1,1.0,1,0.14045922864309118,52
811,1,3098,568,2530,0,0,0,1.0,1,1.0,1,1.0,1,0.10887484398749167,50
812,1,3099,569,2530,0,0,0,1.0,1,1.0,1,1.0,1,0.1284763804413965,48
813,4,3103,570,2533,0,0,0,1.0,1,1.0,1,1.0,1,0.0928618155473005,49
814,0,3103,570,2533,0,0,0,1.0,1,1.0,1,1.0,1,0.10173889048297602,48
815,3,3106,572,2534,0,0,0,1.0,1,1.0,1,1.0,1,0.14027901605640197,48
816,1,3107,573,2534,0,0,0,1.0,1,1.0,1,1.0,1,0.1512724138522858,46
817,0,3107,573,2534,0,0,0,1.0,1,1.0,1,1.0,1,0.2179308625443413,44
818,1,3108,573,2535,0,0,0,1.0,1,1.0,1,1.0,1,0.18801204281750375,46
819,0,3108,573,2535,0,0,0,1.0,1,1.0,1,1.0,1,0.20504274561799976,44
820,0,3108,573,2535,0,0,0,1.0,1,1.0,1,1.0,1,0.20869119564218425,44
821,0,3108,573,2535,0,0,0,1.0,1,1.0,1,1.0,1,0.20869119564218425,44
822,2,3110,575,2535,0,0,0,1.0,1,1.0,1,1.0,1,0.240664875689746,44
823,2,3112,577,2535,0,0,0,1.0,1,1.0,1,1.0,1,0.19699894734453263,42
824,5,3117,582,2535,0,0,0,1.0,1,1.0,1,1.0,1,0.2651412660639896,42
825,3,3120,584,2536,0,0,0,1.0,1,1.0,1,1.0,1,0.2403689815170146,40
826,8,3128,588,2540,0,0,0,1.0,1,1.0,1,1.0,1,0.1989908571373347,41
827,4,3132,590,2542,0,0,0,1.0,1,1.0,1,1.0,1,0.12788857023211012,40
828,1,3133,591,2542,0,0,0,1.0,1,1.0,1,1.0,1,0.11524598924071094,40
829,1,3134,592,2542,0,0,0,1.0,1,1.0,1,1.0,1,0.1567154252891717,42
830,7,3141,595,2546,0,0,0,1.0,1,1.0,1,1.0,1,0.17633788113061116,42
831,5,3146,596,2550,0,0,0,1.0,1,1.0,1,1.0,1,0.15344188091663633,43
832,5,3151,598,2553,0,0,0,1.0,1,1.0,1,1.0,1,0.14147934056916597,42
833,3,3154,598,2556,0,0,0,1.0,1,1.0,1,1.0,1,0.15952866494846932,41
834,2,3156,600,2556,0,0,0,1.0,1,1.0,1,1.0,1,0.18242041903639386,41
835,2,3158,600,2558,0,0,0,1.0,1,1.0,1,1.0,1,0.18403236517487703,41
836,2,3160,600,2560,0,0,0,1.0,1,1.0,1,1.0,1,0.1590780242140918,40
837,1,3161,600,2561,0,0,0,1.0,1,1.0,1,1.0,1,0.1614252636545222,41
838,2,3163,600,2563,0,0,0,1.0,1,1.0,1,1.0,1,0.14046374329004077,41
839,2,3165,601,2564,0,0,0,1.0,1,1.0,1,1.0,1,0.1372851802650262,41
840,1,3166,602,2564,0,0,0,1.0,1,1.0,1,1.0,1,0.1926336792757796,42
841,3,3169,602,2567,0,0,0,1.0,1,1.0,1,1.0,1,0.11394945339521201,42
842,3,3172,603,2569,0,0,0,1.0,1,1.0,1,1.0,1,0.10356027926666343,42
843,4,3176,604,2572,0,0,0,1.0,1,1.0,1,1.0,1,0.09213692291909614,42
844,1,3177,604,2573,0,0,0,1.0,1,1.0,1,1.0,1,0.12396526582612963,42
845,8,3185,605,2580,0,0,0,1.0,1,1.0,1,1.0,1,0.15648181691816498,44
846,6,3191,606,2585,0,0,0,1.0,1,1.0,1,1.0,1,0.20522994436208947,44
847,5,3196,606,2590,0,0,0,1.0,1,1.0,1,1.0,1,0.19909783638712478,42
848,5,3201,606,2595,0,0,0,1.0,1,1.0,1,1.0,1,0.23039725217017748,43
849,6,3207,606,2601,0,0,0,1.0,1,1.0,1,1.0,1,0.2535744046735024,43
850,4,3211,606,2605,0,0,0,1.0,1,1.0,1,1.0,1,0.2922425640166194,41
851,4,3215,607,2608,0,0,0,1.0,1,1.0,1,1.0,1,0.29798393211583185,40
852,6,3221,608,2613,0,0,0,1.0,1,1.0,1,1.0,1,0.29433079537455004,40
853,6,3227,609,2618,0,0,0,1.0,1,1.0,1,1.0,1,0.2931496491910284,40
854,5,3232,610,2622,0,0,0,1.0,1,1.0,1,1.0,1,0.2517499988835331,40
855,5,3237,611,2626,0,0,0,1.0,1,1.0,1,1.0,1,0.2512424336925005,41
856,7,3244,611,2633,0,0,0,1.0,1,1.0,1,1.0,1,0.11414029154768629,41
857,1,3245,611,2634,0,0,0,1.0,1,1.0,1,1.0,1,0.12141711679211604,42
858,1,3246,611,2635,0,0,0,1.0,1,1.0,1,1.0,1,0.11558404688537248,43
859,2,3248,611,2637,0,0,0,1.0,1,1.0,1,1.0,1,0.11558404688537248,43
860,1,3249,612,2637,0,0,0,1.0,1,1.0,1,1.0,1,0.12406674571056561,44
861,4,3253,614,2639,0,0,0,1.0,1,1.0,1,1.0,1,0.11099539524383693,44
862,0,3253,614,2639,0,0,0,1.0,1,1.0,1,1.0,1,0.11099539524383693,44
863,2,3255,615,2640,0,0,0,1.0,1,1.0,1,1.0,1,0.16332634634075768,44
864,6,3261,617,2644,0,0,0,1.0,1,1.0,1,1.0,1,0.1641696037182288,44
865,7,3268,618,2650,0,0,0,1.0,1,1.0,1,1.0,1,0.231000349677435,43
866,9,3277,622,2655,0,0,0,1.0,1,1.0,1,1.0,1,0.25781477097196076,45
867,2,3279,622,2657,0,0,0,1.0,1,1.0,1,1.0,1,0.19844118915163944,44
868,4,3283,622,2661,0,0,0,1.0,1,1.0,1,1.0,1,0.1793314515481904,45
869,1,3284,623,2661,0,0,0,1.0,1,1.0,1,1.0,1,0.20829603899962595,44
870,0,3284,623,2661,0,0,0,1.0,1,1.0,1,1.0,1,0.20829603899962595,44
871,9,3293,623,2670,0,0,0,1.0,1,1.0,1,1.0,1,0.17176351619600927,43
872,3,3296,623,2673,0,0,0,1.0,1,1.0,1,1.0,1,0.1015326537835928,43
873,5,3301,624,2677,0,0,0,1.0,1,1.0,1,1.0,1,0.13648034946394896,43
874,6,3307,626,2681,0,0,0,1.0,1,1.0,1,1.0,1,0.151594751372176,46
875,3,3310,626,2684,0,0,0,1.0,1,1.0,1,1.0,1,0.15471425781427142,43
876,4,3314,626,2688,0,0,0,1.0,1,1.0,1,1.0,1,0.1506638712786676,44
877,5,3319,626,2693,0,0,0,1.0,1,1.0,1,1.0,1,0.2093027961149283,44
878,3,3322,626,2696,0,0,0,1.0,1,1.0,1,1.0,1,0.21865391296780168,44
879,6,3328,627,2701,0,0,0,1.0,1,1.0,1,1.0,1,0.18031290823199225,44
880,8,3336,628,2708,0,0,0,1.0,1,1.0,1,1.0,1,0.25249556473459844,44
881,3,3339,628,2711,0,0,0,1.0,1,1.0,1,1.0,1,0.23246282849201783,43
882,9,3348,629,2719,0,0,0,1.0,1,1.0,1,1.0,1,0.18538961286543548,45
883,5,3353,629,2724,0,0,0,1.0,1,1.0,1,1.0,1,0.1547436529013565,45
884,3,3356,629,2727,0,0,0,1.0,1,1.0,1,1.0,1,0.20702150880084477,45
885,4,3360,629,2731,0,0,0,1.0,1,1.0,1,1.0,1,0.17301607464130223,43
886,7,3367,632,2735,0,0,0,1.0,1,1.0,1,1.0,1,0.16714749421904093,43
887,6,3373,633,2740,0,0,0,1.0,1,1.0,1,1.0,1,0.18197558380172077,41
888,6,3379,634,2745,0,0,0,1.0,1,1.0,1,1.0,1,0.19697490091796155,40
889,4,3383,634,2749,0,0,0,1.0,1,1.0,1,1.0,1,0.17013162033837773,40
890,1,3384,634,2750,0,0,0,1.0,1,1.0,1,1.0,1,0.21906800902288373,38
891,0,3384,634,2750,0,0,0,1.0,1,1.0,1,1.0,1,0.19937191360543396,39
892,1,3385,634,2751,0,0,0,1.0,1,1.0,1,1.0,1,0.1968041123353573,39
893,1,3386,635,2751,0,0,0,1.0,1,1.0,1,1.0,1,0.22798105401034605,37
894,2,3388,636,2752,0,0,0,1.0,1,1.0,1,1.0,1,0.2579255184881089,36
895,2,3390,637,2753,0,0,0,1.0,1,1.0,1,1.0,1,0.30084034737407017,37
896,6,3396,639,2757,0,0,0,1.0,1,1.0,1,1.0,1,0.3139574990197165,36
897,1,3397,640,2757,0,0,0,1.0,1,1.0,1,1.0,1,0.30394836111999834,36
898,0,3397,640,2757,0,0,0,1.0,1,1.0,1,1.0,1,0.3211908979976502,35
899,3,3400,641,2759,0,0,0,1.0,1,1.0,1,1.0,1,0.3010377265852518,35
900,3,3403,641,2762,0,0,0,1.0,1,1.0,1,1.0,1,0.3431456612219237,36
901,5,3408,642,2766,0,0,0,1.0,1,1.0,1,1.0,1,0.2929573543837023,36
902,5,3413,645,2768,0,0,0,1.0,1,1.0,1,1.0,1,0.329089526754299,36
903,3,3416,645,2771,0,0,0,1.0,1,1.0,1,1.0,1,0.2541623360153903,35
904,4,3420,647,2773,0,0,0,1.0,1,1.0,1,1.0,1,0.23878551247063126,37
905,1,3421,647,2774,0,0,0,1.0,1,1.0,1,1.0,1,0.22391987540910635,36
906,3,3424,647,2777,0,0,0,1.0,1,1.0,1,1.0,1,0.21489635892472078,37
907,4,3428,649,2779,0,0,0,1.0,1,1.0,1,1.0,1,0.2181119288463333,37
908,4,3432,651,2781,0,0,0,1.0,1,1.0,1,1.0,1,0.23939872813966942,36
909,2,3434,651,2783,0,0,0,1.0,1,1.0,1,1.0,1,0.21678558141568408,36
910,4,3438,653,2785,0,0,0,1.0,1,1.0,1,1.0,1,0.21200790094631775,37
911,3,3441,655,2786,0,0,0,1.0,1,1.0,1,1.0,1,0.24501630145555411,36
912,6,3447,657,2790,0,0,0,1.0,1,1.0,1,1.0,1,0.294865377328802,34
913,4,3451,659,2792,0,0,0,1.0,1,1.0,1,1.0,1,0.30298458464340217,34
914,6,3457,659,2798,0,0,0,1.0,1,1.0,1,1.0,1,0.32105525147442754,33
915,2,3459,659,2800,0,0,0,1.0,1,1.0,1,1.0,1,0.31593071880217377,33
916,7,3466,659,2807,0,0,0,1.0,1,1.0,1,1.0,1,0.1855235079574017,34
917,3,3469,659,2810,0,0,0,1.0,1,1.0,1,1.0,1,0.16838291397739763,34
918,2,3471,659,2812,0,0,0,1.0,1,1.0,1,1.0,1,0.14569850854534142,36
919,2,3473,659,2814,0,0,0,1.0,1,1.0,1,1.0,1,0.1670158468127853,36
920,7,3480,660,2820,0,0,0,1.0,1,1.0,1,1.0,1,0.1705200697353156,37
921,2,3482,660,2822,0,0,0,1.0,1,1.0,1,1.0,1,0.1841983547640979,37
922,5,3487,661,2826,0,0,0,1.0,1,1.0,1,1.0,1,0.1592476829656713,38
923,9,3496,662,2834,0,0,0,1.0,1,1.0,1,1.0,1,0.19121979318893137,36
924,6,3502,662,2840,0,0,0,1.0,1,1.0,1,1.0,1,0.18577215122704333,35
925,8,3510,663,2847,0,0,0,1.0,1,1.0,1,1.0,1,0.1869380581406206,35
926,9,3519,664,2855,0,0,0,1.0,1,1.0,1,1.0,1,0.2147343845370307,34
927,4,3523,664,2859,0,0,0,1.0,1,1.0,1,1.0,1,0.22474483542826298,32
928,6,3529,664,2865,0,0,0,1.0,1,1.0,1,1.0,1,0.25150858106402163,32
929,7,3536,665,2871,0,0,0,1.0,1,1.0,1,1.0,1,0.2196111199477646,31
930,5,3541,666,2875,0,0,0,1.0,1,1.0,1,1.0,1,0.2550981368183924,30
931,5,3546,667,2879,0,0,0,1.0,1,1.0,1,1.0,1,0.16539452599538831,29
932,1,3547,667,2880,0,0,0,1.0,1,1.0,1,1.0,1,0.1646636663107261,29
933,0,3547,667,2880,0,0,0,1.0,1,1.0,1,1.0,1,0.1646636663107261,29
934,1,3548,667,2881,0,0,0,1.0,1,1.0,1,1.0,1,0.15287281258151253,29
935,1,3549,667,2882,0,0,0,1.0,1,1.0,1,1.0,1,0.16171001249754943,31
936,2,3551,668,2883,0,0,0,1.0,1,1.0,1,1.0,1,0.203171073598323,31
937,3,3554,669,2885,0,0,0,1.0,1,1.0,1,1.0,1,0.22439895402550492,34
938,3,3557,669,2888,0,0,0,1.0,1,1.0,1,1.0,1,0.2123918431527415,33
939,7,3564,670,2894,0,0,0,1.0,1,1.0,1,1.0,1,0.20208799886444004,36
940,5,3569,670,2899,0,0,0,1.0,1,1.0,1,1.0,1,0.23147654360987796,36
941,2,3571,670,2901,0,0,0,1.0,1,1.0,1,1.0,1,0.2711216920780183,36
942,5,3576,671,2905,0,0,0,1.0,1,1.0,1,1.0,1,0.20860548381663593,36
943,6,3582,672,2910,0,0,0,1.0,1,1.0,1,1.0,1,0.20516453876522972,35
944,5,3587,674,2913,0,0,0,1.0,1,1.0,1,1.0,1,0.21876554767966785,35
945,5,3592,674,2918,0,0,0,1.0,1,1.0,1,1.0,1,0.17402716965740314,33
946,7,3599,676,2923,0,0,0,1.0,1,1.0,1,1.0,1,0.20449757040428498,36
947,1,3600,676,2924,0,0,0,1.0,1,1.0,1,1.0,1,0.18183310729429103,34
948,1,3601,677,2924,0,0,0,1.0,1,1.0,1,1.0,1,0.20184679705761482,33
949,2,3603,678,2925,0,0,0,1.0,1,1.0,1,1.0,1,0.27386890678716147,34
950,1,3604,678,2926,0,0,0,1.0,1,1.0,1,1.0,1,0.2878305241845178,33
951,1,3605,678,2927,0,0,0,1.0,1,1.0,1,1.0,1,0.29921892820720336,33
952,1,3606,678,2928,0,0,0,1.0,1,1.0,1,1.0,1,0.30239281069876006,32
953,0,3606,678,2928,0,0,0,1.0,1,1.0,1,1.0,1,0.30239281069876006,32
954,1,3607,678,2929,0,0,0,1.0,1,1.0,1,1.0,1,0.28934282296190467,31
955,1,3608,678,2930,0,0,0,1.0,1,1.0,1,1.0,1,0.32638572811827893,32
956,2,3610,678,2932,0,0,0,1.0,1,1.0,1,1.0,1,0.3176392888125656,32
957,4,3614,678,2936,0,0,0,1.0,1,1.0,1,1.0,1,0.24454362758484688,33
958,3,3617,678,2939,0,0,0,1.0,1,1.0,1,1.0,1,0.26018815855335237,35
959,3,3620,678,2942,0,0,0,1.0,1,1.0,1,1.0,1,0.2512032656963415,36
960,4,3624,678,2946,0,0,0,1.0,1,1.0,1,1.0,1,0.23717409810632148,38
961,5,3629,680,2949,0,0,0,1.0,1,1.0,1,1.0,1,0.20877996953010405,37
962,1,3630,681,2949,0,0,0,1.0,1,1.0,1,1.0,1,0.2298508065117163,35
963,2,3632,681,2951,0,0,0,1.0,1,1.0,1,1.0,1,0.17533291409790103,35
964,1,3633,681,2952,0,0,0,1.0,1,1.0,1,1.0,1,0.1979764208914646,34
965,1,3634,681,2953,0,0,0,1.0,1,1.0,1,1.0,1,0.2033662182982706,35
966,2,3636,681,2955,0,0,0,1.0,1,1.0,1,1.0,1,0.18307524463267674,34
967,0,3636,681,2955,0,0,0,1.0,1,1.0,1,1.0,1,0.18369476245960095,35
968,0,3636,681,2955,0,0,0,1.0,1,1.0,1,1.0,1,0.19722614027019272,36
969,1,3637,682,2955,0,0,0,1.0,1,1.0,1,1.0,1,0.2264973027561021,35
970,0,3637,682,2955,0,0,0,1.0,1,1.0,1,1.0,1,0.26264143433218684,34
971,1,3638,682,2956,0,0,0,1.0,1,1.0,1,1.0,1,0.2897466743959905,35
972,1,3639,683,2956,0,0,0,1.0,1,1.0,1,1.0,1,0.2964172985862411,35
973,1,3640,683,2957,0,0,0,1.0,1,1.0,1,1.0,1,0.2632576337975425,36
974,0,3640,683,2957,0,0,0,1.0,1,1.0,1,1.0,1,0.25570923711818316,35
975,0,3640,683,2957,0,0,0,1.0,1,1.0,1,1.0,1,0.23314376419310476,36
976,4,3644,684,2960,0,0,0,1.0,1,1.0,1,1.0,1,0.20069129390928628,38
977,1,3645,685,2960,0,0,0,1.0,1,1.0,1,1.0,1,0.22344563028119827,38
978,2,3647,686,2961,0,0,0,1.0,1,1.0,1,1.0,1,0.22305478869615228,38
979,3,3650,686,2964,0,0,0,1.0,1,1.0,1,1.0,1,0.18188882582526877,39
980,2,3652,688,2964,0,0,0,1.0,1,1.0,1,1.0,1,0.2155549342046507,39
981,5,3657,689,2968,0,0,0,1.0,1,1.0,1,1.0,1,0.2216800237694685,40
982,6,3663,691,2972,0,0,0,1.0,1,1.0,1,1.0,1,0.2078303125552838,40
983,0,3663,691,2972,0,0,0,1.0,1,1.0,1,1.0,1,0.17206460681642266,38
984,0,3663,691,2972,0,0,0,1.0,1,1.0,1,1.0,1,0.14829461204076175,39
985,4,3667,693,2974,0,0,0,1.0,1,1.0,1,1.0,1,0.1687926697840152,38
986,1,3668,694,2974,0,0,0,1.0,1,1.0,1,1.0,1,0.19533125443520874,38
987,3,3671,695,2976,0,0,0,1.0,1,1.0,1,1.0,1,0.15847656494285842,38
988,1,3672,696,2976,0,0,0,1.0,1,1.0,1,1.0,1,0.1983586858503652,38
989,0,3672,696,2976,0,0,0,1.0,1,1.0,1,1.0,1,0.1892890968225612,38
990,0,3672,696,2976,0,0,0,1.0,1,1.0,1,1.0,1,0.1892890968225612,38
991,4,3676,697,2979,0,0,0,1.0,1,1.0,1,1.0,1,0.16629320425058067,40
992,0,3676,697,2979,0,0,0,1.0,1,1.0,1,1.0,1,0.14149426646569144,39
993,1,3677,698,2979,0,0,0,1.0,1,1.0,1,1.0,1,0.13708960332785236,38
994,0,3677,698,2979,0,0,0,1.0,1,1.0,1,1.0,1,0.1358502709038178,39
995,0,3677,698,2979,0,0,0,1.0,1,1.0,1,1.0,1,0.1303235015267136,41
996,0,3677,698,2979,0,0,0,1.0,1,1.0,1,1.0,1,0.1464248404506496,40
997,1,3678,698,2980,0,0,0,1.0,1,1.0,1,1.0,1,0.12600001334485492,41
998,1,3679,699,2980,0,0,0,1.0,1,1.0,1,1.0,1,0.17981037125932167,40
999,1,3680,699,2981,0,0,0,1.0,1,1.0,1,1.0,1,0.1786964257562107,40
1000,0,3680,699,2981,0,0,0,1.0,1,1.0,1,1.0,1,0.1786964257562107,40
1001,1,3681,699,2982,0,0,0,1.0,1,1.0,1,1.0,1,0.1752426677093139,39
1002,0,3681,699,2982,0,0,0,1.0,1,1.0,1,1.0,1,0.1752426677093139,39
1003,0,3681,699,2982,0,0,0,1.0,1,1.0,1,1.0,1,0.1752426677093139,39
1004,0,3681,699,2982,0,0,0,1.0,1,1.0,1,1.0,1,0.1752426677093139,39
1005,0,3681,699,2982,0,0,0,1.0,1,1.0,1,1.0,1,0.17430244642057996,40
1006,3,3684,700,2984,0,0,0,1.0,1,1.0,1,1.0,1,0.1492311704965879,41
1007,1,3685,700,2985,0,0,0,1.0,1,1.0,1,1.0,1,0.1777883406554292,42
1008,1,3686,701,2985,0,0,0,1.0,1,1.0,1,1.0,1,0.20951140212510502,43
1009,1,3687,701,2986,0,0,0,1.0,1,1.0,1,1.0,1,0.2234393825075392,44
1010,2,3689,701,2988,0,0,0,1.0,1,1.0,1,1.0,1,0.19649437339689846,44
1011,4,3693,701,2992,0,0,0,1.0,1,1.0,1,1.0,1,0.17810657577271888,44
1012,3,3696,702,2994,0,0,0,1.0,1,1.0,1,1.0,1,0.2251229386312207,46
1013,5,3701,702,2999,0,0,0,1.0,1,1.0,1,1.0,1,0.179945515294064,46
1014,5,3706,703,3003,0,0,0,1.0,1,1.0,1,1.0,1,0.1941750212585554,46
1015,2,3708,703,3005,0,0,0,1.0,1,1.0,1,1.0,1,0.1828582289409052,46
1016,1,3709,703,3006,0,0,0,1.0,1,1.0,1,1.0,1,0.18912998545699533,47
1017,3,3712,703,3009,0,0,0,1.0,1,1.0,1,1.0,1,0.180589686000392,47
1018,2,3714,703,3011,0,0,0,1.0,1,1.0,1,1.0,1,0.14755840034254727,48
1019,5,3719,704,3015,0,0,0,1.0,1,1.0,1,1.0,1,0.1505451311525231,49
1020,4,3723,704,3019,0,0,0,1.0,1,1.0,1,1.0,1,0.13257032220075285,51
1021,6,3729,705,3024,0,0,0,1.0,1,1.0,1,1.0,1,0.078715676889778,51
1022,1,3730,706,3024,0,0,0,1.0,1,1.0,1,1.0,1,0.09287493602285715,52
1023,1,3731,706,3025,0,0,0,1.0,1,1.0,1,1.0,1,0.10949189769740317,52
1024,2,3733,706,3027,0,0,0,1.0,1,1.0,1,1.0,1,0.07409468680610996,52
1025,1,3734,706,3028,0,0,0,1.0,1,1.0,1,1.0,1,0.0894371289942899,54
1026,1,3735,707,3028,0,0,0,1.0,1,1.0,1,1.0,1,0.10263371678421532,54
1027,6,3741,709,3032,0,0,0,1.0,1,1.0,1,1.0,1,0.11676545162887021,55
1028,4,3745,711,3034,0,0,0,1.0,1,1.0,1,1.0,1,0.13836503891806398,56
1029,3,3748,711,3037,0,0,0,1.0,1,1.0,1,1.0,1,0.12074540993202837,56
1030,5,3753,713,3040,0,0,0,1.0,1,1.0,1,1.0,1,0.14778860981590686,57
1031,1,3754,713,3041,0,0,0,1.0,1,1.0,1,1.0,1,0.1572162220217901,58
1032,2,3756,713,3043,0,0,0,1.0,1,1.0,1,1.0,1,0.1388084777509615,58
1033,2,3758,713,3045,0,0,0,1.0,1,1.0,1,1.0,1,0.14629780061190534,57
1034,4,3762,715,3047,0,0,0,1.0,1,1.0,1,1.0,1,0.16483046545204869,57
1035,5,3767,717,3050,0,0,0,1.0,1,1.0,1,1.0,1,0.1807749260230904,57
1036,8,3775,719,3056,0,0,0,1.0,1,1.0,1,1.0,1,0.11995604363365452,59
1037,3,3778,722,3056,0,0,0,1.0,1,1.0,1,1.0,1,0.18266505651280732,57
1038,3,3781,723,3058,0,0,0,1.0,1,1.0,1,1.0,1,0.17542531203998468,59
1039,2,3783,725,3058,0,0,0,1.0,1,1.0,1,1.0,1,0.15073005943887335,57
1040,1,3784,726,3058,0,0,0,1.0,1,1.0,1,1.0,1,0.1776086591304646,56
1041,3,3787,728,3059,0,0,0,1.0,1,1.0,1,1.0,1,0.20171011453192556,54
1042,0,3787,728,3059,0,0,0,1.0,1,1.0,1,1.0,1,0.16928000490617645,52
1043,0,3787,728,3059,0,0,0,1.0,1,1.0,1,1.0,1,0.16928000490617645,52
1044,1,3788,729,3059,0,0,0,1.0,1,1.0,1,1.0,1,0.16897876948457624,50
1045,3,3791,729,3062,0,0,0,1.0,1,1.0,1,1.0,1,0.1475956139761704,51
1046,1,3792,730,3062,0,0,0,1.0,1,1.0,1,1.0,1,0.1323317276808353,50
1047,0,3792,730,3062,0,0,0,1.0,1,1.0,1,1.0,1,0.11703688225466366,50
1048,1,3793,731,3062,0,0,0,1.0,1,1.0,1,1.0,1,0.1460334213992489,50
1049,3,3796,734,3062,0,0,0,1.0,1,1.0,1,1.0,1,0.16757808674838123,50
1050,0,3796,734,3062,0,0,0,1.0,1,1.0,1,1.0,1,0.16757808674838123,50
1051,6,3802,734,3068,0,0,0,1.0,1,1.0,1,1.0,1,0.1323750152855169,50
1052,5,3807,735,3072,0,0,0,1.0,1,1.0,1,1.0,1,0.15142880930954836,51
1053,2,3809,735,3074,0,0,0,1.0,1,1.0,1,1.0,1,0.13468461802380163,51
1054,2,3811,735,3076,0,0,0,1.0,1,1.0,1,1.0,1,0.13355478360928716,53
1055,5,3816,735,3081,0,0,0,1.0,1,1.0,1,1.0,1,0.13893880888085183,54
1056,5,3821,735,3086,0,0,0,1.0,1,1.0,1,1.0,1,0.16687043237374546,54
1057,9,3830,736,3094,0,0,0,1.0,1,1.0,1,1.0,1,0.10323469336427932,55
1058,4,3834,737,3097,0,0,0,1.0,1,1.0,1,1.0,1,0.16002866814238786,54
1059,6,3840,739,3101,0,0,0,1.0,1,1.0,1,1.0,1,0.19307890309656828,53
1060,3,3843,739,3104,0,0,0,1.0,1,1.0,1,1.0,1,0.17495548388681903,53
1061,6,3849,742,3107,0,0,0,1.0,1,1.0,1,1.0,1,0.22711856130747338,53
1062,7,3856,745,3111,0,0,0,1.0,1,1.0,1,1.0,1,0.20260989559502526,54
1063,5,3861,745,3116,0,0,0,1.0,1,1.0,1,1.0,1,0.25354811952419015,53
1064,6,3867,747,3120,0,0,0,1.0,1,1.0,1,1.0,1,0.24514980960335314,55
1065,6,3873,747,3126,0,0,0,1.0,1,1.0,1,1.0,1,0.28753474729401535,54
1066,14,3887,749,3138,0,0,0,1.0,1,1.0,1,1.0,1,0.12188343694280605,55
1067,2,3889,750,3139,0,0,0,1.0,1,1.0,1,1.0,1,0.13565600728653768,55
1068,1,3890,750,3140,0,0,0,1.0,1,1.0,1,1.0,1,0.13617120526008666,55
1069,3,3893,751,3142,0,0,0,1.0,1,1.0,1,1.0,1,0.1910411014882219,55
1070,3,3896,751,3145,0,0,0,1.0,1,1.0,1,1.0,1,0.15973489928008677,54
1071,4,3900,752,3148,0,0,0,1.0,1,1.0,1,1.0,1,0.16246355897204753,55
1072,2,3902,752,3150,0,0,0,1.0,1,1.0,1,1.0,1,0.15544612806296776,54
1073,5,3907,754,3153,0,0,0,1.0,1,1.0,1,1.0,1,0.1284937620860638,54
1074,3,3910,755,3155,0,0,0,1.0,1,1.0,1,1.0,1,0.1372101951791542,52
1075,0,3910,755,3155,0,0,0,1.0,1,1.0,1,1.0,1,0.12854444547846344,51
1076,2,3912,756,3156,0,0,0,1.0,1,1.0,1,1.0,1,0.1725904227150556,52
1077,2,3914,757,3157,0,0,0,1.0,1,1.0,1,1.0,1,0.15598968356234674,49
1078,2,3916,759,3157,0,0,0,1.0,1,1.0,1,1.0,1,0.1809399934077371,48
1079,2,3918,761,3157,0,0,0,1.0,1,1.0,1,1.0,1,0.21660837277898604,47
1080,2,3920,763,3157,0,0,0,1.0,1,1.0,1,1.0,1,0.24900847113904126,47
1081,11,3931,764,3167,0,0,0,1.0,1,1.0,1,1.0,1,0.16067611469843687,45
1082,3,3934,765,3169,0,0,0,1.0,1,1.0,1,1.0,1,0.23869127901700654,42
1083,8,3942,766,3176,0,0,0,1.0,1,1.0,1,1.0,1,0.24352274415745312,42
1084,3,3945,766,3179,0,0,0,1.0,1,1.0,1,1.0,1,0.26645039362122924,40
1085,7,3952,766,3186,0,0,0,1.0,1,1.0,1,1.0,1,0.2099511641264756,43
1086,9,3961,766,3195,0,0,0,1.0,1,1.0,1,1.0,1,0.2170203970879128,41
1087,3,3964,766,3198,0,0,0,1.0,1,1.0,1,1.0,1,0.2450119914061171,41
1088,3,3967,766,3201,0,0,0,1.0,1,1.0,1,1.0,1,0.23030827360989303,41
1089,4,3971,768,3203,0,0,0,1.0,1,1.0,1,1.0,1,0.21822987591843954,42
1090,5,3976,768,3208,0,0,0,1.0,1,1.0,1,1.0,1,0.1840923597392568,43
1091,8,3984,769,3215,0,0,0,1.0,1,1.0,1,1.0,1,0.24000114964735564,43
1092,9,3993,770,3223,0,0,0,1.0,1,1.0,1,1.0,1,0.21528886210537077,43
1093,8,4001,771,3230,0,0,0,1.0,1,1.0,1,1.0,1,0.20994096024719489,43
1094,3,4004,772,3232,0,0,0,1.0,1,1.0,1,1.0,1,0.22290579669061306,43
1095,3,4007,772,3235,0,0,0,1.0,1,1.0,1,1.0,1,0.20077026512955037,44
1096,5,4012,772,3240,0,0,0,1.0,1,1.0,1,1.0,1,0.12509705395354923,44
1097,4,4016,774,3242,0,0,0,1.0,1,1.0,1,1.0,1,0.16360249036016578,45
1098,1,4017,774,3243,0,0,0,1.0,1,1.0,1,1.0,1,0.17748430270139637,46
1099,1,4018,775,3243,0,0,0,1.0,1,1.0,1,1.0,1,0.18825260979040845,48
1100,4,4022,775,3247,0,0,0,1.0,1,1.0,1,1.0,1,0.13735813459243407,49
1101,0,4022,775,3247,0,0,0,1.0,1,1.0,1,1.0,1,0.13735813459243407,49
1102,4,4026,777,3249,0,0,0,1.0,1,1.0,1,1.0,1,0.10757407689578546,50
1103,3,4029,777,3252,0,0,0,1.0,1,1.0,1,1.0,1,0.11470088657495604,48
1104,4,4033,780,3253,0,0,0,1.0,1,1.0,1,1.0,1,0.10154052773931692,50
1105,5,4038,782,3256,0,0,0,1.0,1,1.0,1,1.0,1,0.1372646405991023,48
1106,3,4041,783,3258,0,0,0,1.0,1,1.0,1,1.0,1,0.15109549804707822,48
1107,2,4043,783,3260,0,0,0,1.0,1,1.0,1,1.0,1,0.16776094926521537,47
1108,3,4046,784,3262,0,0,0,1.0,1,1.0,1,1.0,1,0.16236373292453607,47
1109,3,4049,786,3263,0,0,0,1.0,1,1.0,1,1.0,1,0.17572567781790957,46
1110,3,4052,787,3265,0,0,0,1.0,1,1.0,1,1.0,1,0.2523763767162695,43
1111,13,4065,788,3277,0,0,0,1.0,1,1.0,1,1.0,1,0.09963429632647709,44
1112,5,4070,790,3280,0,0,0,1.0,1,1.0,1,1.0,1,0.14459033959783832,43
1113,5,4075,791,3284,0,0,0,1.0,1,1.0,1,1.0,1,0.15639310093672573,39
1114,2,4077,791,3286,0,0,0,1.0,1,1.0,1,1.0,1,0.15639310093672573,39
1115,3,4080,792,3288,0,0,0,1.0,1,1.0,1,1.0,1,0.14705054360113048,37
1116,4,4084,794,3290,0,0,0,1.0,1,1.0,1,1.0,1,0.07221789032819907,37
1117,5,4089,796,3293,0,0,0,1.0,1,1.0,1,1.0,1,0.1596959961571326,36
1118,3,4092,797,3295,0,0,0,1.0,1,1.0,1,1.0,1,0.19540966869950385,36
1119,3,4095,798,3297,0,0,0,1.0,1,1.0,1,1.0,1,0.2211972674382614,36
1120,5,4100,798,3302,0,0,0,1.0,1,1.0,1,1.0,1,0.22692224857482135,36
1121,8,4108,800,3308,0,0,0,1.0,1,1.0,1,1.0,1,0.22707316552224188,36
1122,3,4111,800,3311,0,0,0,1.0,1,1.0,1,1.0,1,0.19277534573593014,37
1123,4,4115,800,3315,0,0,0,1.0,1,1.0,1,1.0,1,0.25384333658467784,37
1124,6,4121,800,3321,0,0,0,1.0,1,1.0,1,1.0,1,0.19277534573593014,37
1125,7,4128,801,3327,0,0,0,1.0,1,1.0,1,1.0,1,0.21163597286750507,38
1126,6,4134,802,3332,0,0,0,1.0,1,1.0,1,1.0,1,0.21228801374611087,38
1127,5,4139,802,3337,0,0,0,1.0,1,1.0,1,1.0,1,0.1621923515677015,39
1128,1,4140,802,3338,0,0,0,1.0,1,1.0,1,1.0,1,0.16853438620517186,39
1129,1,4141,802,3339,0,0,0,1.0,1,1.0,1,1.0,1,0.15509921331621224,39
1130,2,4143,803,3340,0,0,0,1.0,1,1.0,1,1.0,1,0.17192250835666653,39
1131,0,4143,803,3340,0,0,0,1.0,1,1.0,1,1.0,1,0.17192250835666653,39
1132,0,4143,803,3340,0,0,0,1.0,1,1.0,1,1.0,1,0.17192250835666653,39
1133,2,4145,803,3342,0,0,0,1.0,1,1.0,1,1.0,1,0.14499598289789703,42
1134,0,4145,803,3342,0,0,0,1.0,1,1.0,1,1.0,1,0.14499598289789703,42
1135,7,4152,804,3348,0,0,0,1.0,1,1.0,1,1.0,1,0.17092177418272753,44
1136,10,4162,805,3357,0,0,0,1.0,1,1.0,1,1.0,1,0.12279637877417669,46
1137,4,4166,805,3361,0,0,0,1.0,1,1.0,1,1.0,1,0.14745585299434216,45
1138,8,4174,805,3369,0,0,0,1.0,1,1.0,1,1.0,1,0.19041580026956528,46
1139,11,4185,806,3379,0,0,0,1.0,1,1.0,1,1.0,1,0.24610199550950307,47
1140,8,4193,806,3387,0,0,0,1.0,1,1.0,1,1.0,1,0.2209916980846594,46
1141,4,4197,806,3391,0,0,0,1.0,1,1.0,1,1.0,1,0.13309010174906843,45
1142,3,4200,808,3392,0,0,0,1.0,1,1.0,1,1.0,1,0.1783724983161813,45
1143,3,4203,808,3395,0,0,0,1.0,1,1.0,1,1.0,1,0.13701224547543842,43
1144,1,4204,808,3396,0,0,0,1.0,1,1.0,1,1.0,1,0.11063840708950166,45
1145,5,4209,810,3399,0,0,0,1.0,1,1.0,1,1.0,1,0.08791895564619666,44
1146,4,4213,811,3402,0,0,0,1.0,1,1.0,1,1.0,1,0.11778624345417629,45
1147,3,4216,814,3402,0,0,0,1.0,1,1.0,1,1.0,1,0.15938051297972167,44
1148,3,4219,817,3402,0,0,0,1.0,1,1.0,1,1.0,1,0.2165887102098796,43
1149,5,4224,819,3405,0,0,0,1.0,1,1.0,1,1.0,1,0.21479271073882109,42
1150,6,4230,820,3410,0,0,0,1.0,1,1.0,1,1.0,1,0.1900774063524642,45
1151,1,4231,820,3411,0,0,0,1.0,1,1.0,1,1.0,1,0.2163215549250417,40
1152,3,4234,822,3412,0,0,0,1.0,1,1.0,1,1.0,1,0.17041863569705706,41
1153,3,4237,824,3413,0,0,0,1.0,1,1.0,1,1.0,1,0.21749755606163138,38
1154,1,4238,825,3413,0,0,0,1.0,1,1.0,1,1.0,1,0.18371510673702818,37
1155,3,4241,827,3414,0,0,0,1.0,1,1.0,1,1.0,1,0.21240967531699562,38
1156,5,4246,828,3418,0,0,0,1.0,1,1.0,1,1.0,1,0.19998743796550572,38
1157,0,4246,828,3418,0,0,0,1.0,1,1.0,1,1.0,1,0.21419498590575964,37
1158,0,4246,828,3418,0,0,0,1.0,1,1.0,1,1.0,1,0.1949563497888704,36
1159,0,4246,828,3418,0,0,0,1.0,1,1.0,1,1.0,1,0.18095448801548344,35
1160,4,4250,830,3420,0,0,0,1.0,1,1.0,1,1.0,1,0.23887384282787208,35
1161,3,4253,830,3423,0,0,0,1.0,1,1.0,1,1.0,1,0.21850743857415658,36
1162,4,4257,830,3427,0,0,0,1.0,1,1.0,1,1.0,1,0.21508199999637367,37
1163,2,4259,830,3429,0,0,0,1.0,1,1.0,1,1.0,1,0.24788348578536595,37
1164,4,4263,830,3433,0,0,0,1.0,1,1.0,1,1.0,1,0.23640377470441315,38
1165,5,4268,830,3438,0,0,0,1.0,1,1.0,1,1.0,1,0.25506699580484654,38
1166,3,4271,830,3441,0,0,0,1.0,1,1.0,1,1.0,1,0.23929385232683084,40
1167,8,4279,835,3444,0,0,0,1.0,1,1.0,1,1.0,1,0.26267618980801605,40
1168,4,4283,835,3448,0,0,0,1.0,1,1.0,1,1.0,1,0.22031827243230312,40
1169,6,4289,836,3453,0,0,0,1.0,1,1.0,1,1.0,1,0.28902646016982286,41
1170,2,4291,836,3455,0,0,0,1.0,1,1.0,1,1.0,1,0.26361285695841014,41
1171,13,4304,836,3468,0,0,0,1.0,1,1.0,1,1.0,1,0.10434316529641945,43
1172,7,4311,836,3475,0,0,0,1.0,1,1.0,1,1.0,1,0.09262253355106932,43
1173,2,4313,836,3477,0,0,0,1.0,1,1.0,1,1.0,1,0.13718956640896215,43
1174,1,4314,836,3478,0,0,0,1.0,1,1.0,1,1.0,1,0.12415347489823293,43
1175,3,4317,836,3481,0,0,0,1.0,1,1.0,1,1.0,1,0.10767688399263844,44
1176,2,4319,836,3483,0,0,0,1.0,1,1.0,1,1.0,1,0.1452203593451053,45
1177,4,4323,836,3487,0,0,0,1.0,1,1.0,1,1.0,1,0.1452203593451053,45
1178,2,4325,836,3489,0,0,0,1.0,1,1.0,1,1.0,1,0.12305845216655721,45
1179,2,4327,837,3490,0,0,0,1.0,1,1.0,1,1.0,1,0.15137249914903367,46
1180,4,4331,837,3494,0,0,0,1.0,1,1.0,1,1.0,1,0.1902070737657672,47
1181,8,4339,837,3502,0,0,0,1.0,1,1.0,1,1.0,1,0.1902089984386542,48
1182,8,4347,839,3508,0,0,0,1.0,1,1.0,1,1.0,1,0.22193488290851257,48
1183,5,4352,839,3513,0,0,0,1.0,1,1.0,1,1.0,1,0.18241238567413676,46
1184,7,4359,842,3517,0,0,0,1.0,1,1.0,1,1.0,1,0.12996463105689057,47
1185,2,4361,843,3518,0,0,0,1.0,1,1.0,1,1.0,1,0.1491596229154717,44
1186,1,4362,843,3519,0,0,0,1.0,1,1.0,1,1.0,1,0.16331104060830612,47
1187,2,4364,844,3520,0,0,0,1.0,1,1.0,1,1.0,1,0.19186279424919014,49
1188,0,4364,844,3520,0,0,0,1.0,1,1.0,1,1.0,1,0.19359527407514399,50
1189,0,4364,844,3520,0,0,0,1.0,1,1.0,1,1.0,1,0.19894828584502033,48
1190,3,4367,846,3521,0,0,0,1.0,1,1.0,1,1.0,1,0.2402225023300704,48
1191,1,4368,846,3522,0,0,0,1.0,1,1.0,1,1.0,1,0.21236699344793916,46
1192,5,4373,847,3526,0,0,0,1.0,1,1.0,1,1.0,1,0.23448188927534544,46
1193,5,4378,847,3531,0,0,0,1.0,1,1.0,1,1.0,1,0.20387828176100456,45
1194,1,4379,847,3532,0,0,0,1.0,1,1.0,1,1.0,1,0.18922054974554003,45
1195,1,4380,848,3532,0,0,0,1.0,1,1.0,1,1.0,1,0.21881933881725804,47
1196,4,4384,848,3536,0,0,0,1.0,1,1.0,1,1.0,1,0.200283181746032,48
1197,4,4388,848,3540,0,0,0,1.0,1,1.0,1,1.0,1,0.17151970722832455,49
1198,1,4389,849,3540,0,0,0,1.0,1,1.0,1,1.0,1,0.1826087533785872,49
1199,3,4392,849,3543,0,0,0,1.0,1,1.0,1,1.0,1,0.19909248171507013,50
1200,8,4400,850,3550,0,0,0,1.0,1,1.0,1,1.0,1,0.1638567510798191,50
1201,5,4405,850,3555,0,0,0,1.0,1,1.0,1,1.0,1,0.10700460377759154,50
1202,1,4406,851,3555,0,0,0,1.0,1,1.0,1,1.0,1,0.10250998763530755,51
1203,0,4406,851,3555,0,0,0,1.0,1,1.0,1,1.0,1,0.09088916769270877,52
1204,0,4406,851,3555,0,0,0,1.0,1,1.0,1,1.0,1,0.09088916769270877,52
1205,1,4407,852,3555,0,0,0,1.0,1,1.0,1,1.0,1,0.1411056744475345,53
1206,0,4407,852,3555,0,0,0,1.0,1,1.0,1,1.0,1,0.1411056744475345,53
1207,2,4409,852,3557,0,0,0,1.0,1,1.0,1,1.0,1,0.1386701027500794,55
1208,2,4411,853,3558,0,0,0,1.0,1,1.0,1,1.0,1,0.1270799538614047,56
1209,2,4413,853,3560,0,0,0,1.0,1,1.0,1,1.0,1,0.14023738251979032,55
1210,2,4415,854,3561,0,0,0,1.0,1,1.0,1,1.0,1,0.14872819214053126,55
1211,3,4418,854,3564,0,0,0,1.0,1,1.0,1,1.0,1,0.13703187748189216,57
1212,4,4422,855,3567,0,0,0,1.0,1,1.0,1,1.0,1,0.14004942259873154,57
1213,2,4424,855,3569,0,0,0,1.0,1,1.0,1,1.0,1,0.16042248861569322,57
1214,11,4435,858,3577,0,0,0,1.0,1,1.0,1,1.0,1,0.1988332707786912,57
1215,8,4443,858,3585,0,0,0,1.0,1,1.0,1,1.0,1,0.18424357057373575,59
1216,5,4448,858,3590,0,0,0,1.0,1,1.0,1,1.0,1,0.14712198011498057,61
1217,0,4448,858,3590,0,0,0,1.0,1,1.0,1,1.0,1,0.14712198011498057,61
1218,2,4450,858,3592,0,0,0,1.0,1,1.0,1,1.0,1,0.1570847705699902,61
1219,2,4452,860,3592,0,0,0,1.0,1,1.0,1,1.0,1,0.14601190604779304,61
1220,3,4455,860,3595,0,0,0,1.0,1,1.0,1,1.0,1,0.1498283279152934,60
1221,2,4457,860,3597,0,0,0,1.0,1,1.0,1,1.0,1,0.16762122498942159,61
1222,3,4460,860,3600,0,0,0,1.0,1,1.0,1,1.0,1,0.16741710025460863,61
1223,4,4464,862,3602,0,0,0,1.0,1,1.0,1,1.0,1,0.1733063642112271,59
1224,5,4469,865,3604,0,0,0,1.0,1,1.0,1,1.0,1,0.16602587166603272,60
1225,6,4475,867,3608,0,0,0,1.0,1,1.0,1,1.0,1,0.18825483343107005,60
1226,6,4481,869,3612,0,0,0,1.0,1,1.0,1,1.0,1,0.18261461647110308,61
1227,6,4487,871,3616,0,0,0,1.0,1,1.0,1,1.0,1,0.16993343841897904,59
1228,4,4491,872,3619,0,0,0,1.0,1,1.0,1,1.0,1,0.21537551465292168,58
1229,5,4496,873,3623,0,0,0,1.0,1,1.0,1,1.0,1,0.22704044088766565,57
1230,6,4502,875,3627,0,0,0,1.0,1,1.0,1,1.0,1,0.19207767944099063,55
1231,9,4511,877,3634,0,0,0,1.0,1,1.0,1,1.0,1,0.097259562069256,54
1232,3,4514,879,3635,0,0,0,1.0,1,1.0,1,1.0,1,0.1373655748405876,51
1233,4,4518,881,3637,0,0,0,1.0,1,1.0,1,1.0,1,0.14176876331378524,49
1234,2,4520,882,3638,0,0,0,1.0,1,1.0,1,1.0,1,0.1446877059401052,49
1235,2,4522,883,3639,0,0,0,1.0,1,1.0,1,1.0,1,0.1718887660482257,48
1236,5,4527,883,3644,0,0,0,1.0,1,1.0,1,1.0,1,0.1458662966849919,49
1237,3,4530,884,3646,0,0,0,1.0,1,1.0,1,1.0,1,0.18284056672009527,48
1238,5,4535,884,3651,0,0,0,1.0,1,1.0,1,1.0,1,0.12812197856508897,47
1239,0,4535,884,3651,0,0,0,1.0,1,1.0,1,1.0,1,0.11330822454783793,48
1240,2,4537,884,3653,0,0,0,1.0,1,1.0,1,1.0,1,0.11702582885885274,49
1241,5,4542,887,3655,0,0,0,1.0,1,1.0,1,1.0,1,0.1708987130067709,49
1242,2,4544,887,3657,0,0,0,1.0,1,1.0,1,1.0,1,0.19012236672638158,49
1243,4,4548,887,3661,0,0,0,1.0,1,1.0,1,1.0,1,0.19594865093686006,50
1244,4,4552,887,3665,0,0,0,1.0,1,1.0,1,1.0,1,0.20433128358249375,50
1245,4,4556,887,3669,0,0,0,1.0,1,1.0,1,1.0,1,0.20696304705908,51
1246,7,4563,887,3676,0,0,0,1.0,1,1.0,1,1.0,1,0.15121315993736387,52
1247,1,4564,888,3676,0,0,0,1.0,1,1.0,1,1.0,1,0.14215801652462035,52
1248,5,4569,889,3680,0,0,0,1.0,1,1.0,1,1.0,1,0.17221261921800843,51
1249,2,4571,890,3681,0,0,0,1.0,1,1.0,1,1.0,1,0.13199874861044375,51
1250,4,4575,893,3682,0,0,0,1.0,1,1.0,1,1.0,1,0.17182131859160188,51
1251,2,4577,893,3684,0,0,0,1.0,1,1.0,1,1.0,1,0.1388499541046436,53
1252,3,4580,896,3684,0,0,0,1.0,1,1.0,1,1.0,1,0.14420287087699593,52
1253,1,4581,896,3685,0,0,0,1.0,1,1.0,1,1.0,1,0.14005655667137887,52
1254,0,4581,896,3685,0,0,0,1.0,1,1.0,1,1.0,1,0.122425177366368,53
1255,0,4581,896,3685,0,0,0,1.0,1,1.0,1,1.0,1,0.13136937552126168,55
1256,3,4584,896,3688,0,0,0,1.0,1,1.0,1,1.0,1,0.11134403772665971,55
1257,4,4588,896,3692,0,0,0,1.0,1,1.0,1,1.0,1,0.11060914486568034,57
1258,3,4591,896,3695,0,0,0,1.0,1,1.0,1,1.0,1,0.11391772148563716,57
1259,3,4594,896,3698,0,0,0,1.0,1,1.0,1,1.0,1,0.1389444551846608,57
1260,4,4598,896,3702,0,0,0,1.0,1,1.0,1,1.0,1,0.120764041633057,56
1261,6,4604,898,3706,0,0,0,1.0,1,1.0,1,1.0,1,0.11821028823331853,57
1262,2,4606,898,3708,0,0,0,1.0,1,1.0,1,1.0,1,0.11745716825240644,58
1263,3,4609,900,3709,0,0,0,1.0,1,1.0,1,1.0,1,0.1409091722466663,58
1264,4,4613,901,3712,0,0,0,1.0,1,1.0,1,1.0,1,0.10571931109271684,57
1265,3,4616,904,3712,0,0,0,1.0,1,1.0,1,1.0,1,0.09900227048751038,56
1266,1,4617,905,3712,0,0,0,1.0,1,1.0,1,1.0,1,0.11976768581815597,55
1267,3,4620,908,3712,0,0,0,1.0,1,1.0,1,1.0,1,0.1491607693816407,53
1268,3,4623,911,3712,0,0,0,1.0,1,1.0,1,1.0,1,0.1775217365310825,52
1269,2,4625,913,3712,0,0,0,1.0,1,1.0,1,1.0,1,0.19956555211323265,51
1270,1,4626,913,3713,0,0,0,1.0,1,1.0,1,1.0,1,0.1968556727689636,47
1271,2,4628,915,3713,0,0,0,1.0,1,1.0,1,1.0,1,0.2134309494653619,46
1272,2,4630,916,3714,0,0,0,1.0,1,1.0,1,1.0,1,0.22390615554680615,43
1273,0,4630,916,3714,0,0,0,1.0,1,1.0,1,1.0,1,0.21202249668902817,44
1274,3,4633,918,3715,0,0,0,1.0,1,1.0,1,1.0,1,0.2529959778453743,44
1275,4,4637,920,3717,0,0,0,1.0,1,1.0,1,1.0,1,0.23730547882366856,45
1276,9,4646,922,3724,0,0,0,1.0,1,1.0,1,1.0,1,0.1567746369467526,43
1277,3,4649,924,3725,0,0,0,1.0,1,1.0,1,1.0,1,0.1441749635383404,44
1278,3,4652,925,3727,0,0,0,1.0,1,1.0,1,1.0,1,0.16908096610013273,45
1279,1,4653,925,3728,0,0,0,1.0,1,1.0,1,1.0,1,0.14087634898935203,47
1280,1,4654,925,3729,0,0,0,1.0,1,1.0,1,1.0,1,0.10362446722690644,47
1281,0,4654,925,3729,0,0,0,1.0,1,1.0,1,1.0,1,0.10362446722690644,47
1282,1,4655,926,3729,0,0,0,1.0,1,1.0,1,1.0,1,0.11817938685321619,46
1283,0,4655,926,3729,0,0,0,1.0,1,1.0,1,1.0,1,0.11817938685321619,46
1284,0,4655,926,3729,0,0,0,1.0,1,1.0,1,1.0,1,0.11817938685321619,46
1285,5,4660,927,3733,0,0,0,1.0,1,1.0,1,1.0,1,0.16855218460848823,46
1286,4,4664,927,3737,0,0,0,1.0,1,1.0,1,1.0,1,0.18425242684012091,45
1287,5,4669,928,3741,0,0,0,1.0,1,1.0,1,1.0,1,0.1963936369443155,49
1288,5,4674,928,3746,0,0,0,1.0,1,1.0,1,1.0,1,0.20751541260205075,49
1289,7,4681,928,3753,0,0,0,1.0,1,1.0,1,1.0,1,0.21911189491265137,52
1290,8,4689,930,3759,0,0,0,1.0,1,1.0,1,1.0,1,0.17088982401031116,52
1291,6,4695,930,3765,0,0,0,1.0,1,1.0,1,1.0,1,0.0898425314456185,52
1292,2,4697,930,3767,0,0,0,1.0,1,1.0,1,1.0,1,0.08925791159851794,53
1293,0,4697,930,3767,0,0,0,1.0,1,1.0,1,1.0,1,0.08925791159851794,53
1294,2,4699,931,3768,0,0,0,1.0,1,1.0,1,1.0,1,0.06961741996684653,53
1295,2,4701,931,3770,0,0,0,1.0,1,1.0,1,1.0,1,0.07995024832726802,54
1296,2,4703,931,3772,0,0,0,1.0,1,1.0,1,1.0,1,0.07415848839632105,55
1297,0,4703,931,3772,0,0,0,1.0,1,1.0,1,1.0,1,0.09316378766416213,54
1298,0,4703,931,3772,0,0,0,1.0,1,1.0,1,1.0,1,0.1065311001916766,55
1299,1,4704,931,3773,0,0,0,1.0,1,1.0,1,1.0,1,0.134867474249929,54
1300,3,4707,932,3775,0,0,0,1.0,1,1.0,1,1.0,1,0.14891685528528126,55
1301,4,4711,933,3778,0,0,0,1.0,1,1.0,1,1.0,1,0.14890063721752497,54
1302,3,4714,935,3779,0,0,0,1.0,1,1.0,1,1.0,1,0.1759503937139553,54
1303,3,4717,936,3781,0,0,0,1.0,1,1.0,1,1.0,1,0.18142527670699693,50
1304,5,4722,939,3783,0,0,0,1.0,1,1.0,1,1.0,1,0.18096085429407316,51
1305,3,4725,940,3785,0,0,0,1.0,1,1.0,1,1.0,1,0.14006080048928723,48
1306,5,4730,943,3787,0,0,0,1.0,1,1.0,1,1.0,1,0.15033144093496834,48
1307,0,4730,943,3787,0,0,0,1.0,1,1.0,1,1.0,1,0.12489554920725897,48
1308,2,4732,945,3787,0,0,0,1.0,1,1.0,1,1.0,1,0.19790309602273337,46
1309,4,4736,947,3789,0,0,0,1.0,1,1.0,1,1.0,1,0.18662999483357787,47
1310,0,4736,947,3789,0,0,0,1.0,1,1.0,1,1.0,1,0.14908190939419802,46
1311,2,4738,949,3789,0,0,0,1.0,1,1.0,1,1.0,1,0.17278824738084772,46
1312,2,4740,951,3789,0,0,0,1.0,1,1.0,1,1.0,1,0.18725390966317745,45
1313,0,4740,951,3789,0,0,0,1.0,1,1.0,1,1.0,1,0.20692854132668656,44
1314,2,4742,952,3790,0,0,0,1.0,1,1.0,1,1.0,1,0.2057493254580967,42
1315,1,4743,953,3790,0,0,0,1.0,1,1.0,1,1.0,1,0.24675267769924908,40
1316,1,4744,953,3791,0,0,0,1.0,1,1.0,1,1.0,1,0.2097690784045907,42
1317,3,4747,955,3792,0,0,0,1.0,1,1.0,1,1.0,1,0.25046762706776377,42
1318,1,4748,955,3793,0,0,0,1.0,1,1.0,1,1.0,1,0.2344803756745428,42
1319,1,4749,956,3793,0,0,0,1.0,1,1.0,1,1.0,1,0.2681591287107161,42
1320,0,4749,956,3793,0,0,0,1.0,1,1.0,1,1.0,1,0.2681591287107161,42
1321,8,4757,956,3801,0,0,0,1.0,1,1.0,1,1.0,1,0.12159896701220685,45
1322,3,4760,956,3804,0,0,0,1.0,1,1.0,1,1.0,1,0.1148851881845769,45
1323,5,4765,957,3808,0,0,0,1.0,1,1.0,1,1.0,1,0.15812039714354606,46
1324,2,4767,957,3810,0,0,0,1.0,1,1.0,1,1.0,1,0.1448611405970174,45
1325,2,4769,958,3811,0,0,0,1.0,1,1.0,1,1.0,1,0.17968638423098407,46
1326,1,4770,958,3812,0,0,0,1.0,1,1.0,1,1.0,1,0.1896840047174677,45
1327,3,4773,958,3815,0,0,0,1.0,1,1.0,1,1.0,1,0.22142897947623855,46
1328,4,4777,958,3819,0,0,0,1.0,1,1.0,1,1.0,1,0.22468439176583835,47
1329,5,4782,958,3824,0,0,0,1.0,1,1.0,1,1.0,1,0.20383825521502488,47
1330,2,4784,958,3826,0,0,0,1.0,1,1.0,1,1.0,1,0.21871126596224566,46
1331,1,4785,958,3827,0,0,0,1.0,1,1.0,1,1.0,1,0.21489889382789884,46
1332,5,4790,958,3832,0,0,0,1.0,1,1.0,1,1.0,1,0.21086357751707221,49
1333,6,4796,958,3838,0,0,0,1.0,1,1.0,1,1.0,1,0.17184103058127073,50
1334,2,4798,958,3840,0,0,0,1.0,1,1.0,1,1.0,1,0.20868656051848003,50
1335,2,4800,958,3842,0,0,0,1.0,1,1.0,1,1.0,1,0.19597754063527947,52
1336,4,4804,959,3845,0,0,0,1.0,1,1.0,1,1.0,1,0.1429356260635047,53
1337,4,4808,960,3848,0,0,0,1.0,1,1.0,1,1.0,1,0.1520336783439571,54
1338,5,4813,963,3850,0,0,0,1.0,1,1.0,1,1.0,1,0.20670813390921458,54
1339,3,4816,964,3852,0,0,0,1.0,1,1.0,1,1.0,1,0.22451988321427216,54
1340,1,4817,964,3853,0,0,0,1.0,1,1.0,1,1.0,1,0.20392373942410702,53
1341,0,4817,964,3853,0,0,0,1.0,1,1.0,1,1.0,1,0.18896594263834082,53
1342,1,4818,965,3853,0,0,0,1.0,1,1.0,1,1.0,1,0.17984497371932961,52
1343,1,4819,966,3853,0,0,0,1.0,1,1.0,1,1.0,1,0.18876693911386433,50
1344,4,4823,969,3854,0,0,0,1.0,1,1.0,1,1.0,1,0.23321563457421376,51
1345,4,4827,969,3858,0,0,0,1.0,1,1.0,1,1.0,1,0.1911330236865995,50
1346,10,4837,973,3864,0,0,0,1.0,1,1.0,1,1.0,1,0.1423988082697025,50
1347,1,4838,973,3865,0,0,0,1.0,1,1.0,1,1.0,1,0.1364145217729545,48
1348,2,4840,973,3867,0,0,0,1.0,1,1.0,1,1.0,1,0.1394652142302255,49
1349,3,4843,973,3870,0,0,0,1.0,1,1.0,1,1.0,1,0.18329405719063085,48
1350,3,4846,974,3872,0,0,0,1.0,1,1.0,1,1.0,1,0.16157162845587117,49
1351,7,4853,974,3879,0,0,0,1.0,1,1.0,1,1.0,1,0.07603570743298824,48
1352,2,4855,975,3880,0,0,0,1.0,1,1.0,1,1.0,1,0.07281809158391073,49
1353,1,4856,975,3881,0,0,0,1.0,1,1.0,1,1.0,1,0.05789362006827908,49
1354,1,4857,976,3881,0,0,0,1.0,1,1.0,1,1.0,1,0.11593914527907014,49
1355,4,4861,976,3885,0,0,0,1.0,1,1.0,1,1.0,1,0.0891041639957795,50
1356,3,4864,976,3888,0,0,0,1.0,1,1.0,1,1.0,1,0.10027910670210348,50
1357,6,4870,977,3893,0,0,0,1.0,1,1.0,1,1.0,1,0.09571995588242119,50
1358,4,4874,978,3896,0,0,0,1.0,1,1.0,1,1.0,1,0.12221059736403497,51
1359,3,4877,978,3899,0,0,0,1.0,1,1.0,1,1.0,1,0.11666295526236051,53
1360,3,4880,978,3902,0,0,0,1.0,1,1.0,1,1.0,1,0.08849903223407303,54
1361,3,4883,978,3905,0,0,0,1.0,1,1.0,1,1.0,1,0.13041163353562213,54
1362,6,4889,979,3910,0,0,0,1.0,1,1.0,1,1.0,1,0.10369011349379746,55
1363,5,4894,979,3915,0,0,0,1.0,1,1.0,1,1.0,1,0.08799262567977555,55
1364,5,4899,979,3920,0,0,0,1.0,1,1.0,1,1.0,1,0.12525593586327016,55
1365,12,4911,983,3928,0,0,0,1.0,1,1.0,1,1.0,1,0.12800436782047508,56
1366,5,4916,984,3932,0,0,0,1.0,1,1.0,1,1.0,1,0.08709596842664344,56
1367,1,4917,984,3933,0,0,0,1.0,1,1.0,1,1.0,1,0.0680939481413046,56
1368,1,4918,984,3934,0,0,0,1.0,1,1.0,1,1.0,1,0.06638752744956877,58
1369,2,4920,985,3935,0,0,0,1.0,1,1.0,1,1.0,1,0.09091371369831076,59
1370,1,4921,985,3936,0,0,0,1.0,1,1.0,1,1.0,1,0.08834737466636942,59
1371,4,4925,985,3940,0,0,0,1.0,1,1.0,1,1.0,1,0.07679592626032286,59
1372,1,4926,986,3940,0,0,0,1.0,1,1.0,1,1.0,1,0.08227918754510588,59
1373,0,4926,986,3940,0,0,0,1.0,1,1.0,1,1.0,1,0.08227918754510588,59
1374,4,4930,988,3942,0,0,0,1.0,1,1.0,1,1.0,1,0.11654799106756089,60
1375,2,4932,988,3944,0,0,0,1.0,1,1.0,1,1.0,1,0.11880367607898926,61
1376,4,4936,988,3948,0,0,0,1.0,1,1.0,1,1.0,1,0.13944594951444783,61
1377,4,4940,989,3951,0,0,0,1.0,1,1.0,1,1.0,1,0.15883539025864551,61
1378,5,4945,989,3956,0,0,0,1.0,1,1.0,1,1.0,1,0.1693450786177139,61
1379,7,4952,990,3962,0,0,0,1.0,1,1.0,1,1.0,1,0.1910274725768567,60
1380,4,4956,990,3966,0,0,0,1.0,1,1.0,1,1.0,1,0.18523072893557416,60
1381,6,4962,991,3971,0,0,0,1.0,1,1.0,1,1.0,1,0.14280078243196256,58
1382,6,4968,993,3975,0,0,0,1.0,1,1.0,1,1.0,1,0.18153513637119303,58
1383,4,4972,995,3977,0,0,0,1.0,1,1.0,1,1.0,1,0.13887588704425605,57
1384,4,4976,997,3979,0,0,0,1.0,1,1.0,1,1.0,1,0.14982547197957885,54
1385,2,4978,997,3981,0,0,0,1.0,1,1.0,1,1.0,1,0.18450536883872734,52
1386,7,4985,999,3986,0,0,0,1.0,1,1.0,1,1.0,1,0.21030949256784193,51
1387,3,4988,1000,3988,0,0,0,1.0,1,1.0,1,1.0,1,0.20284144046678934,51
1388,4,4992,1004,3988,0,0,0,1.0,1,1.0,1,1.0,1,0.163706481105699,52
1389,2,4994,1004,3990,0,0,0,1.0,1,1.0,1,1.0,1,0.1881632728088577,50
1390,2,4996,1005,3991,0,0,0,1.0,1,1.0,1,1.0,1,0.1701034106992486,51
1391,0,4996,1005,3991,0,0,0,1.0,1,1.0,1,1.0,1,0.19911222267211345,50
1392,2,4998,1007,3991,0,0,0,1.0,1,1.0,1,1.0,1,0.1797637973749037,50
1393,0,4998,1007,3991,0,0,0,1.0,1,1.0,1,1.0,1,0.20742186676782887,49
1394,4,5002,1009,3993,0,0,0,1.0,1,1.0,1,1.0,1,0.18264704028839598,50
1395,1,5003,1009,3994,0,0,0,1.0,1,1.0,1,1.0,1,0.20619520434391997,51
1396,5,5008,1009,3999,0,0,0,1.0,1,1.0,1,1.0,1,0.1611799415691571,52
1397,4,5012,1009,4003,0,0,0,1.0,1,1.0,1,1.0,1,0.1620602439573398,52
1398,2,5014,1009,4005,0,0,0,1.0,1,1.0,1,1.0,1,0.16522283510749483,53
1399,5,5019,1010,4009,0,0,0,1.0,1,1.0,1,1.0,1,0.17242342735859315,54
1400,5,5024,1011,4013,0,0,0,1.0,1,1.0,1,1.0,1,0.1790995488380498,54
1401,5,5029,1013,4016,0,0,0,1.0,1,1.0,1,1.0,1,0.19857992313687045,54
1402,3,5032,1014,4018,0,0,0,1.0,1,1.0,1,1.0,1,0.18070570634900038,53
1403,2,5034,1014,4020,0,0,0,1.0,1,1.0,1,1.0,1,0.2069102497133145,52
1404,6,5040,1014,4026,0,0,0,1.0,1,1.0,1,1.0,1,0.21776683668415922,53
1405,4,5044,1015,4029,0,0,0,1.0,1,1.0,1,1.0,1,0.2517119015948564,52
1406,4,5048,1015,4033,0,0,0,1.0,1,1.0,1,1.0,1,0.2539050494872007,53
1407,8,5056,1016,4040,0,0,0,1.0,1,1.0,1,1.0,1,0.2654718345355412,54
1408,3,5059,1016,4043,0,0,0,1.0,1,1.0,1,1.0,1,0.2773584250672374,53
1409,8,5067,1016,4051,0,0,0,1.0,1,1.0,1,1.0,1,0.2677883749749551,55
1410,4,5071,1016,4055,0,0,0,1.0,1,1.0,1,1.0,1,0.2874476033629856,54
1411,12,5083,1016,4067,0,0,0,1.0,1,1.0,1,1.0,1,0.18276601646374294,54
1412,2,5085,1016,4069,0,0,0,1.0,1,1.0,1,1.0,1,0.19581279637366422,53
1413,0,5085,1016,4069,0,0,0,1.0,1,1.0,1,1.0,1,0.19575878119583692,54
1414,1,5086,1016,4070,0,0,0,1.0,1,1.0,1,1.0,1,0.19244682993942386,55
1415,3,5089,1017,4072,0,0,0,1.0,1,1.0,1,1.0,1,0.16387255808150833,57
1416,7,5096,1018,4078,0,0,0,1.0,1,1.0,1,1.0,1,0.16608340922033607,59
1417,7,5103,1020,4083,0,0,0,1.0,1,1.0,1,1.0,1,0.1873380174484602,58
1418,5,5108,1020,4088,0,0,0,1.0,1,1.0,1,1.0,1,0.18020467397082796,57
1419,6,5114,1022,4092,0,0,0,1.0,1,1.0,1,1.0,1,0.18867951597742916,56
1420,3,5117,1022,4095,0,0,0,1.0,1,1.0,1,1.0,1,0.21432548022864428,54
1421,4,5121,1022,4099,0,0,0,1.0,1,1.0,1,1.0,1,0.20173835370824772,55
1422,1,5122,1022,4100,0,0,0,1.0,1,1.0,1,1.0,1,0.1499856979040634,52
1423,7,5129,1024,4105,0,0,0,1.0,1,1.0,1,1.0,1,0.17876016681987425,52
1424,4,5133,1025,4108,0,0,0,1.0,1,1.0,1,1.0,1,0.18706224173745645,51
1425,4,5137,1025,4112,0,0,0,1.0,1,1.0,1,1.0,1,0.23642769659218135,50
1426,8,5145,1027,4118,0,0,0,1.0,1,1.0,1,1.0,1,0.0904090874615496,50
1427,1,5146,1027,4119,0,0,0,1.0,1,1.0,1,1.0,1,0.11609251898809639,48
1428,3,5149,1029,4120,0,0,0,1.0,1,1.0,1,1.0,1,0.1506564686147718,48
1429,4,5153,1029,4124,0,0,0,1.0,1,1.0,1,1.0,1,0.17438873154197967,48
1430,5,5158,1030,4128,0,0,0,1.0,1,1.0,1,1.0,1,0.18456533050005056,48
1431,4,5162,1030,4132,0,0,0,1.0,1,1.0,1,1.0,1,0.15343669144932498,48
1432,4,5166,1030,4136,0,0,0,1.0,1,1.0,1,1.0,1,0.13169468990017943,50
1433,2,5168,1030,4138,0,0,0,1.0,1,1.0,1,1.0,1,0.13686768281659525,51
1434,7,5175,1031,4144,0,0,0,1.0,1,1.0,1,1.0,1,0.17591018544431358,51
1435,3,5178,1031,4147,0,0,0,1.0,1,1.0,1,1.0,1,0.1389617071692277,50
1436,7,5185,1033,4152,0,0,0,1.0,1,1.0,1,1.0,1,0.17041821355428505,51
1437,7,5192,1033,4159,0,0,0,1.0,1,1.0,1,1.0,1,0.13722600631934806,51
1438,7,5199,1034,4165,0,0,0,1.0,1,1.0,1,1.0,1,0.1507170617576552,51
1439,8,5207,1036,4171,0,0,0,1.0,1,1.0,1,1.0,1,0.1929370096192422,50
1440,10,5217,1038,4179,0,0,0,1.0,1,1.0,1,1.0,1,0.23725385064949026,51
1441,7,5224,1038,4186,0,0,0,1.0,1,1.0,1,1.0,1,0.16562231924399898,51
1442,4,5228,1038,4190,0,0,0,1.0,1,1.0,1,1.0,1,0.10989138382734012,52
1443,3,5231,1038,4193,0,0,0,1.0,1,1.0,1,1.0,1,0.11716921195614763,53
1444,2,5233,1038,4195,0,0,0,1.0,1,1.0,1,1.0,1,0.11722891839558196,54
1445,2,5235,1038,4197,0,0,0,1.0,1,1.0,1,1.0,1,0.09916064577225844,54
1446,2,5237,1038,4199,0,0,0,1.0,1,1.0,1,1.0,1,0.12561172372582097,54
1447,2,5239,1038,4201,0,0,0,1.0,1,1.0,1,1.0,1,0.1076976312872897,55
1448,1,5240,1038,4202,0,0,0,1.0,1,1.0,1,1.0,1,0.10766189435903979,55
1449,0,5240,1038,4202,0,0,0,1.0,1,1.0,1,1.0,1,0.10766189435903979,55
1450,2,5242,1038,4204,0,0,0,1.0,1,1.0,1,1.0,1,0.10990221578362679,57
1451,2,5244,1038,4206,0,0,0,1.0,1,1.0,1,1.0,1,0.10990221578362679,57
1452,1,5245,1038,4207,0,0,0,1.0,1,1.0,1,1.0,1,0.09380829525635648,57
1453,3,5248,1039,4209,0,0,0,1.0,1,1.0,1,1.0,1,0.1201522797272117,57
1454,5,5253,1041,4212,0,0,0,1.0,1,1.0,1,1.0,1,0.1563451892733272,58
1455,5,5258,1041,4217,0,0,0,1.0,1,1.0,1,1.0,1,0.1343512274482151,56
1456,6,5264,1043,4221,0,0,0,1.0,1,1.0,1,1.0,1,0.10697594108826086,55
1457,0,5264,1043,4221,0,0,0,1.0,1,1.0,1,1.0,1,0.1331831140603815,54
1458,2,5266,1044,4222,0,0,0,1.0,1,1.0,1,1.0,1,0.10894301976858577,53
1459,1,5267,1045,4222,0,0,0,1.0,1,1.0,1,1.0,1,0.11273442677350022,52
1460,2,5269,1046,4223,0,0,0,1.0,1,1.0,1,1.0,1,0.10830401555239696,51
1461,3,5272,1049,4223,0,0,0,1.0,1,1.0,1,1.0,1,0.13180358381176635,51
1462,2,5274,1051,4223,0,0,0,1.0,1,1.0,1,1.0,1,0.11301604725258894,51
1463,5,5279,1053,4226,0,0,0,1.0,1,1.0,1,1.0,1,0.17471931682695754,52
1464,2,5281,1055,4226,0,0,0,1.0,1,1.0,1,1.0,1,0.16094542254482044,52
1465,6,5287,1057,4230,0,0,0,1.0,1,1.0,1,1.0,1,0.16788871185702933,51
1466,5,5292,1062,4230,0,0,0,1.0,1,1.0,1,1.0,1,0.1724394954159031,50
1467,2,5294,1064,4230,0,0,0,1.0,1,1.0,1,1.0,1,0.21102206722125913,48
1468,6,5300,1069,4231,0,0,0,1.0,1,1.0,1,1.0,1,0.16459048766575987,48
1469,4,5304,1070,4234,0,0,0,1.0,1,1.0,1,1.0,1,0.21321162489587347,48
1470,1,5305,1071,4234,0,0,0,1.0,1,1.0,1,1.0,1,0.20329292408594338,48
1471,6,5311,1073,4238,0,0,0,1.0,1,1.0,1,1.0,1,0.16151100600380539,45
1472,3,5314,1073,4241,0,0,0,1.0,1,1.0,1,1.0,1,0.1336113228325272,45
1473,3,5317,1074,4243,0,0,0,1.0,1,1.0,1,1.0,1,0.14537627930108873,46
1474,3,5320,1074,4246,0,0,0,1.0,1,1.0,1,1.0,1,0.09062518017210137,46
1475,0,5320,1074,4246,0,0,0,1.0,1,1.0,1,1.0,1,0.09062518017210137,46
1476,1,5321,1074,4247,0,0,0,1.0,1,1.0,1,1.0,1,0.09989096987743105,47
1477,2,5323,1074,4249,0,0,0,1.0,1,1.0,1,1.0,1,0.09989096987743105,47
1478,1,5324,1074,4250,0,0,0,1.0,1,1.0,1,1.0,1,0.1356636883612367,47
1479,0,5324,1074,4250,0,0,0,1.0,1,1.0,1,1.0,1,0.13158820426404544,48
1480,1,5325,1075,4250,0,0,0,1.0,1,1.0,1,1.0,1,0.16154256540330075,47
1481,1,5326,1076,4250,0,0,0,1.0,1,1.0,1,1.0,1,0.1700611582210163,47
1482,2,5328,1077,4251,0,0,0,1.0,1,1.0,1,1.0,1,0.18373568817980573,46
1483,3,5331,1078,4253,0,0,0,1.0,1,1.0,1,1.0,1,0.17596978948184616,47
1484,0,5331,1078,4253,0,0,0,1.0,1,1.0,1,1.0,1,0.1904122734568846,47
1485,2,5333,1078,4255,0,0,0,1.0,1,1.0,1,1.0,1,0.22040906967377782,47
1486,7,5340,1079,4261,0,0,0,1.0,1,1.0,1,1.0,1,0.15896569969399893,49
1487,1,5341,1080,4261,0,0,0,1.0,1,1.0,1,1.0,1,0.13409738528598852,49
1488,2,5343,1081,4262,0,0,0,1.0,1,1.0,1,1.0,1,0.12508420154131483,51
1489,2,5345,1082,4263,0,0,0,1.0,1,1.0,1,1.0,1,0.12303338798758776,52
1490,4,5349,1083,4266,0,0,0,1.0,1,1.0,1,1.0,1,0.12829029928700486,52
1491,1,5350,1084,4266,0,0,0,1.0,1,1.0,1,1.0,1,0.15703093392220158,53
1492,6,5356,1087,4269,0,0,0,1.0,1,1.0,1,1.0,1,0.18963891161795918,53
1493,5,5361,1090,4271,0,0,0,1.0,1,1.0,1,1.0,1,0.16955457754885084,52
1494,2,5363,1092,4271,0,0,0,1.0,1,1.0,1,1.0,1,0.18639488908425,50
1495,5,5368,1094,4274,0,0,0,1.0,1,1.0,1,1.0,1,0.21308715876883533,50
1496,9,5377,1096,4281,0,0,0,1.0,1,1.0,1,1.0,1,0.1818008060305792,52
1497,4,5381,1097,4284,0,0,0,1.0,1,1.0,1,1.0,1,0.23992223959472792,51
1498,5,5386,1097,4289,0,0,0,1.0,1,1.0,1,1.0,1,0.19292952215455833,50
1499,3,5389,1097,4292,0,0,0,1.0,1,1.0,1,1.0,1,0.14458401832683707,50
1500,7,5396,1098,4298,0,0,0,1.0,1,1.0,1,1.0,1,0.13851811287393967,49
1501,3,5399,1098,4301,0,0,0,1.0,1,1.0,1,1.0,1,0.11842383318182449,47
1502,4,5403,1100,4303,0,0,0,1.0,1,1.0,1,1.0,1,0.12047820491571401,47
1503,1,5404,1100,4304,0,0,0,1.0,1,1.0,1,1.0,1,0.0802425844393108,47
1504,1,5405,1101,4304,0,0,0,1.0,1,1.0,1,1.0,1,0.07555259239173082,48
1505,2,5407,1102,4305,0,0,0,1.0,1,1.0,1,1.0,1,0.054979685206747564,47
1506,0,5407,1102,4305,0,0,0,1.0,1,1.0,1,1.0,1,0.060183948435775896,47
1507,1,5408,1103,4305,0,0,0,1.0,1,1.0,1,1.0,1,0.07327874512450516,45
1508,2,5410,1105,4305,0,0,0,1.0,1,1.0,1,1.0,1,0.09209574933674988,45
1509,3,5413,1108,4305,0,0,0,1.0,1,1.0,1,1.0,1,0.11958443158000735,44
1510,2,5415,1110,4305,0,0,0,1.0,1,1.0,1,1.0,1,0.16172774917230437,42
1511,1,5416,1111,4305,0,0,0,1.0,1,1.0,1,1.0,1,0.18818298074897313,40
1512,6,5422,1115,4307,0,0,0,1.0,1,1.0,1,1.0,1,0.25775541973010674,39
1513,3,5425,1115,4310,0,0,0,1.0,1,1.0,1,1.0,1,0.2366338755020148,39
1514,3,5428,1115,4313,0,0,0,1.0,1,1.0,1,1.0,1,0.2353525634330125,38
1515,3,5431,1116,4315,0,0,0,1.0,1,1.0,1,1.0,1,0.23347210827149598,39
1516,6,5437,1116,4321,0,0,0,1.0,1,1.0,1,1.0,1,0.21553213642454702,39
1517,2,5439,1117,4322,0,0,0,1.0,1,1.0,1,1.0,1,0.22097765253525029,39
1518,4,5443,1118,4325,0,0,0,1.0,1,1.0,1,1.0,1,0.2100321453033781,39
1519,3,5446,1118,4328,0,0,0,1.0,1,1.0,1,1.0,1,0.1957003544491436,39
1520,4,5450,1120,4330,0,0,0,1.0,1,1.0,1,1.0,1,0.2409606662172178,39
1521,6,5456,1121,4335,0,0,0,1.0,1,1.0,1,1.0,1,0.22425775048346597,40
1522,5,5461,1122,4339,0,0,0,1.0,1,1.0,1,1.0,1,0.27021569537085754,40
1523,8,5469,1122,4347,0,0,0,1.0,1,1.0,1,1.0,1,0.21059537836308334,41
1524,6,5475,1123,4352,0,0,0,1.0,1,1.0,1,1.0,1,0.26612586834452406,42
1525,9,5484,1124,4360,0,0,0,1.0,1,1.0,1,1.0,1,0.2826063782644592,45
1526,9,5493,1124,4369,0,0,0,1.0,1,1.0,1,1.0,1,0.2746382210291034,46
1527,4,5497,1124,4373,0,0,0,1.0,1,1.0,1,1.0,1,0.26332183901896106,46
1528,9,5506,1124,4382,0,0,0,1.0,1,1.0,1,1.0,1,0.2508978055556113,47
1529,6,5512,1124,4388,0,0,0,1.0,1,1.0,1,1.0,1,0.27095980995009233,47
1530,4,5516,1124,4392,0,0,0,1.0,1,1.0,1,1.0,1,0.24467468951815813,48
1531,7,5523,1124,4399,0,0,0,1.0,1,1.0,1,1.0,1,0.1401404523414586,46
1532,1,5524,1124,4400,0,0,0,1.0,1,1.0,1,1.0,1,0.13622912169935383,47
1533,2,5526,1124,4402,0,0,0,1.0,1,1.0,1,1.0,1,0.13138050246603497,46
1534,2,5528,1124,4404,0,0,0,1.0,1,1.0,1,1.0,1,0.1277932407586678,47
1535,4,5532,1124,4408,0,0,0,1.0,1,1.0,1,1.0,1,0.1277932407586678,47
1536,3,5535,1124,4411,0,0,0,1.0,1,1.0,1,1.0,1,0.13006540800438732,48
1537,0,5535,1124,4411,0,0,0,1.0,1,1.0,1,1.0,1,0.1516068156083377,46
1538,2,5537,1124,4413,0,0,0,1.0,1,1.0,1,1.0,1,0.16258801540335974,47
1539,1,5538,1124,4414,0,0,0,1.0,1,1.0,1,1.0,1,0.1585393593751091,47
1540,1,5539,1125,4414,0,0,0,1.0,1,1.0,1,1.0,1,0.15767218747400616,47
1541,1,5540,1125,4415,0,0,0,1.0,1,1.0,1,1.0,1,0.13200126351263666,47
1542,4,5544,1128,4416,0,0,0,1.0,1,1.0,1,1.0,1,0.16850891468851845,50
1543,3,5547,1129,4418,0,0,0,1.0,1,1.0,1,1.0,1,0.1507322929658821,47
1544,7,5554,1132,4422,0,0,0,1.0,1,1.0,1,1.0,1,0.19615532755260714,48
1545,7,5561,1133,4428,0,0,0,1.0,1,1.0,1,1.0,1,0.14941442254182027,47
1546,4,5565,1134,4431,0,0,0,1.0,1,1.0,1,1.0,1,0.11706965923206944,47
1547,2,5567,1134,4433,0,0,0,1.0,1,1.0,1,1.0,1,0.10605371685450551,47
1548,4,5571,1137,4434,0,0,0,1.0,1,1.0,1,1.0,1,0.07960310601873297,47
1549,4,5575,1140,4435,0,0,0,1.0,1,1.0,1,1.0,1,0.06871375322115593,46
1550,2,5577,1142,4435,0,0,0,1.0,1,1.0,1,1.0,1,0.15425412939012106,44
1551,7,5584,1145,4439,0,0,0,1.0,1,1.0,1,1.0,1,0.22665684102625264,45
1552,5,5589,1147,4442,0,0,0,1.0,1,1.0,1,1.0,1,0.20340211906989047,43
1553,2,5591,1148,4443,0,0,0,1.0,1,1.0,1,1.0,1,0.1851743053854351,43
1554,3,5594,1149,4445,0,0,0,1.0,1,1.0,1,1.0,1,0.27838763862902577,41
1555,6,5600,1150,4450,0,0,0,1.0,1,1.0,1,1.0,1,0.28415831110545187,44
1556,6,5606,1152,4454,0,0,0,1.0,1,1.0,1,1.0,1,0.2941427366938391,45
1557,6,5612,1153,4459,0,0,0,1.0,1,1.0,1,1.0,1,0.31550395211033355,45
1558,6,5618,1153,4465,0,0,0,1.0,1,1.0,1,1.0,1,0.23108003650379957,46
1559,4,5622,1154,4468,0,0,0,1.0,1,1.0,1,1.0,1,0.1895125639115135,47
1560,0,5622,1154,4468,0,0,0,1.0,1,1.0,1,1.0,1,0.2203502349271687,46
1561,7,5629,1154,4475,0,0,0,1.0,1,1.0,1,1.0,1,0.09469062905250437,47
1562,4,5633,1154,4479,0,0,0,1.0,1,1.0,1,1.0,1,0.08087971877200353,47
1563,1,5634,1154,4480,0,0,0,1.0,1,1.0,1,1.0,1,0.07512092922052209,47
1564,0,5634,1154,4480,0,0,0,1.0,1,1.0,1,1.0,1,0.07512092922052209,47
1565,1,5635,1154,4481,0,0,0,1.0,1,1.0,1,1.0,1,0.133607299207346,48
1566,4,5639,1156,4483,0,0,0,1.0,1,1.0,1,1.0,1,0.14080948209845356,48
1567,1,5640,1156,4484,0,0,0,1.0,1,1.0,1,1.0,1,0.1750735273454086,48
1568,1,5641,1157,4484,0,0,0,1.0,1,1.0,1,1.0,1,0.18691805689771915,48
1569,0,5641,1157,4484,0,0,0,1.0,1,1.0,1,1.0,1,0.1861372805266166,45
1570,1,5642,1157,4485,0,0,0,1.0,1,1.0,1,1.0,1,0.20503762492245667,44
1571,7,5649,1161,4488,0,0,0,1.0,1,1.0,1,1.0,1,0.26739988758614747,42
1572,5,5654,1161,4493,0,0,0,1.0,1,1.0,1,1.0,1,0.24546011411863616,43
1573,3,5657,1161,4496,0,0,0,1.0,1,1.0,1,1.0,1,0.20767236501770386,43
1574,3,5660,1163,4497,0,0,0,1.0,1,1.0,1,1.0,1,0.22161057366431042,42
1575,8,5668,1165,4503,0,0,0,1.0,1,1.0,1,1.0,1,0.27645421082883115,43
1576,10,5678,1167,4511,0,0,0,1.0,1,1.0,1,1.0,1,0.13322613252568996,41
1577,1,5679,1168,4511,0,0,0,1.0,1,1.0,1,1.0,1,0.18606363892362346,40
1578,0,5679,1168,4511,0,0,0,1.0,1,1.0,1,1.0,1,0.19130917865403088,40
1579,1,5680,1169,4511,0,0,0,1.0,1,1.0,1,1.0,1,0.23355507857766258,40
1580,3,5683,1169,4514,0,0,0,1.0,1,1.0,1,1.0,1,0.22210914473275803,40
1581,1,5684,1169,4515,0,0,0,1.0,1,1.0,1,1.0,1,0.21713303523878633,40
1582,4,5688,1171,4517,0,0,0,1.0,1,1.0,1,1.0,1,0.21875919913544134,40
1583,1,5689,1171,4518,0,0,0,1.0,1,1.0,1,1.0,1,0.23154194173871595,38
1584,5,5694,1174,4520,0,0,0,1.0,1,1.0,1,1.0,1,0.219677097982211,39
1585,5,5699,1177,4522,0,0,0,1.0,1,1.0,1,1.0,1,0.21155617489678605,38
1586,4,5703,1180,4523,0,0,0,1.0,1,1.0,1,1.0,1,0.22120269903663836,38
1587,1,5704,1181,4523,0,0,0,1.0,1,1.0,1,1.0,1,0.21423044343202574,37
1588,5,5709,1185,4524,0,0,0,1.0,1,1.0,1,1.0,1,0.18577958076071274,39
1589,3,5712,1186,4526,0,0,0,1.0,1,1.0,1,1.0,1,0.21362243464771527,37
1590,6,5718,1188,4530,0,0,0,1.0,1,1.0,1,1.0,1,0.21177872392072078,37
1591,11,5729,1190,4539,0,0,0,1.0,1,1.0,1,1.0,1,0.17145515431461728,36
1592,6,5735,1190,4545,0,0,0,1.0,1,1.0,1,1.0,1,0.24536581843938968,34
1593,10,5745,1192,4553,0,0,0,1.0,1,1.0,1,1.0,1,0.30557721710897134,33
1594,6,5751,1192,4559,0,0,0,1.0,1,1.0,1,1.0,1,0.3052780987099498,31
1595,12,5763,1193,4570,0,0,0,1.0,1,1.0,1,1.0,1,0.3004739124337728,34
1596,5,5768,1193,4575,0,0,0,1.0,1,1.0,1,1.0,1,0.3061359434975554,33
1597,6,5774,1193,4581,0,0,0,1.0,1,1.0,1,1.0,1,0.2588812960149071,33
1598,10,5784,1193,4591,0,0,0,1.0,1,1.0,1,1.0,1,0.24748799458431356,33
1599,4,5788,1193,4595,0,0,0,1.0,1,1.0,1,1.0,1,0.2861586394436748,33
1600,7,5795,1194,4601,0,0,0,1.0,1,1.0,1,1.0,1,0.34570533926819763,34
1601,10,5805,1194,4611,0,0,0,1.0,1,1.0,1,1.0,1,0.23499668761328715,35
1602,8,5813,1194,4619,0,0,0,1.0,1,1.0,1,1.0,1,0.2545908664762393,36
1603,11,5824,1195,4629,0,0,0,1.0,1,1.0,1,1.0,1,0.25530075090451404,38
1604,13,5837,1195,4642,0,0,0,1.0,1,1.0,1,1.0,1,0.2696004689705113,38
1605,12,5849,1195,4654,0,0,0,1.0,1,1.0,1,1.0,1,0.2613537635037847,38
1606,6,5855,1195,4660,0,0,0,1.0,1,1.0,1,1.0,1,0.12298852261412548,39
1607,2,5857,1195,4662,0,0,0,1.0,1,1.0,1,1.0,1,0.11539970205484935,37
1608,1,5858,1195,4663,0,0,0,1.0,1,1.0,1,1.0,1,0.14323359208098604,36
1609,1,5859,1195,4664,0,0,0,1.0,1,1.0,1,1.0,1,0.13456731122191312,34
1610,7,5866,1196,4670,0,0,0,1.0,1,1.0,1,1.0,1,0.1572755984689339,34
1611,5,5871,1196,4675,0,0,0,1.0,1,1.0,1,1.0,1,0.1436047217796351,35
1612,4,5875,1196,4679,0,0,0,1.0,1,1.0,1,1.0,1,0.17721649140186396,33
1613,4,5879,1196,4683,0,0,0,1.0,1,1.0,1,1.0,1,0.19674856566421486,34
1614,5,5884,1196,4688,0,0,0,1.0,1,1.0,1,1.0,1,0.15835822410771963,35
1615,2,5886,1197,4689,0,0,0,1.0,1,1.0,1,1.0,1,0.17173645264527476,35
1616,4,5890,1197,4693,0,0,0,1.0,1,1.0,1,1.0,1,0.18621068016696926,37
1617,5,5895,1197,4698,0,0,0,1.0,1,1.0,1,1.0,1,0.15226211443146642,38
1618,3,5898,1197,4701,0,0,0,1.0,1,1.0,1,1.0,1,0.14147238219265695,38
1619,1,5899,1197,4702,0,0,0,1.0,1,1.0,1,1.0,1,0.13216703947532218,38
1620,3,5902,1198,4704,0,0,0,1.0,1,1.0,1,1.0,1,0.17900625366232112,39
1621,3,5905,1200,4705,0,0,0,1.0,1,1.0,1,1.0,1,0.15152642784826909,37
1622,0,5905,1200,4705,0,0,0,1.0,1,1.0,1,1.0,1,0.18148559198101583,37
1623,2,5907,1202,4705,0,0,0,1.0,1,1.0,1,1.0,1,0.17676179464098868,37
1624,2,5909,1204,4705,0,0,0,1.0,1,1.0,1,1.0,1,0.19075679170426385,37
1625,0,5909,1204,4705,0,0,0,1.0,1,1.0,1,1.0,1,0.20222725150958681,35
1626,1,5910,1205,4705,0,0,0,1.0,1,1.0,1,1.0,1,0.2335066933342463,35
1627,3,5913,1206,4707,0,0,0,1.0,1,1.0,1,1.0,1,0.19800363792403336,34
1628,3,5916,1208,4708,0,0,0,1.0,1,1.0,1,1.0,1,0.22091464896144444,35
1629,5,5921,1211,4710,0,0,0,1.0,1,1.0,1,1.0,1,0.3139167532396315,34
1630,0,5921,1211,4710,0,0,0,1.0,1,1.0,1,1.0,1,0.28666182407600943,32
1631,0,5921,1211,4710,0,0,0,1.0,1,1.0,1,1.0,1,0.2976744226241637,33
1632,3,5924,1212,4712,0,0,0,1.0,1,1.0,1,1.0,1,0.31743029441779197,32
1633,8,5932,1214,4718,0,0,0,1.0,1,1.0,1,1.0,1,0.20997094365171473,31
1634,0,5932,1214,4718,0,0,0,1.0,1,1.0,1,1.0,1,0.20997094365171473,31
1635,0,5932,1214,4718,0,0,0,1.0,1,1.0,1,1.0,1,0.24531625220997047,31
1636,6,5938,1214,4724,0,0,0,1.0,1,1.0,1,1.0,1,0.11462806078009925,33
1637,0,5938,1214,4724,0,0,0,1.0,1,1.0,1,1.0,1,0.11462806078009925,33
1638,2,5940,1214,4726,0,0,0,1.0,1,1.0,1,1.0,1,0.12845209182044628,36
1639,2,5942,1214,4728,0,0,0,1.0,1,1.0,1,1.0,1,0.08233911292790796,36
1640,2,5944,1214,4730,0,0,0,1.0,1,1.0,1,1.0,1,0.08193355181792626,36
1641,2,5946,1214,4732,0,0,0,1.0,1,1.0,1,1.0,1,0.11587825420359527,38
1642,1,5947,1215,4732,0,0,0,1.0,1,1.0,1,1.0,1,0.17535114042243283,37
1643,3,5950,1215,4735,0,0,0,1.0,1,1.0,1,1.0,1,0.16283230121566822,37
1644,8,5958,1217,4741,0,0,0,1.0,1,1.0,1,1.0,1,0.24578193486450664,38
1645,8,5966,1217,4749,0,0,0,1.0,1,1.0,1,1.0,1,0.2946436335638321,36
1646,5,5971,1218,4753,0,0,0,1.0,1,1.0,1,1.0,1,0.2501306917103261,37
1647,6,5977,1218,4759,0,0,0,1.0,1,1.0,1,1.0,1,0.3082397320072123,35
1648,7,5984,1219,4765,0,0,0,1.0,1,1.0,1,1.0,1,0.39087544268633545,38
1649,6,5990,1220,4770,0,0,0,1.0,1,1.0,1,1.0,1,0.3046339784349352,35
1650,4,5994,1220,4774,0,0,0,1.0,1,1.0,1,1.0,1,0.40401206585674565,34
1651,6,6000,1220,4780,0,0,0,1.0,1,1.0,1,1.0,1,0.27783121996729504,32
1652,4,6004,1220,4784,0,0,0,1.0,1,1.0,1,1.0,1,0.1636732716443139,33
1653,2,6006,1220,4786,0,0,0,1.0,1,1.0,1,1.0,1,0.14453969043492598,33
1654,0,6006,1220,4786,0,0,0,1.0,1,1.0,1,1.0,1,0.14786596506289976,34
1655,4,6010,1220,4790,0,0,0,1.0,1,1.0,1,1.0,1,0.1568803642222612,35
1656,3,6013,1220,4793,0,0,0,1.0,1,1.0,1,1.0,1,0.17471481812124026,35
1657,6,6019,1220,4799,0,0,0,1.0,1,1.0,1,1.0,1,0.12191231787214907,36
1658,4,6023,1220,4803,0,0,0,1.0,1,1.0,1,1.0,1,0.11495926606302803,36
1659,3,6026,1220,4806,0,0,0,1.0,1,1.0,1,1.0,1,0.11111467309762382,36
1660,7,6033,1222,4811,0,0,0,1.0,1,1.0,1,1.0,1,0.1691010709262228,38
1661,7,6040,1222,4818,0,0,0,1.0,1,1.0,1,1.0,1,0.10673901789425647,38
1662,8,6048,1225,4823,0,0,0,1.0,1,1.0,1,1.0,1,0.12209925694089374,39
1663,11,6059,1226,4833,0,0,0,1.0,1,1.0,1,1.0,1,0.18203206491482446,40
1664,8,6067,1226,4841,0,0,0,1.0,1,1.0,1,1.0,1,0.15635247389359871,39
1665,5,6072,1227,4845,0,0,0,1.0,1,1.0,1,1.0,1,0.19341217611891495,40
1666,2,6074,1227,4847,0,0,0,1.0,1,1.0,1,1.0,1,0.17073503185368077,40
1667,3,6077,1228,4849,0,0,0,1.0,1,1.0,1,1.0,1,0.16481179415490904,40
1668,3,6080,1228,4852,0,0,0,1.0,1,1.0,1,1.0,1,0.1624311707495093,41
1669,1,6081,1228,4853,0,0,0,1.0,1,1.0,1,1.0,1,0.17008836597828939,40
1670,4,6085,1230,4855,0,0,0,1.0,1,1.0,1,1.0,1,0.1815689194666167,40
1671,3,6088,1230,4858,0,0,0,1.0,1,1.0,1,1.0,1,0.16748885939792477,41
1672,1,6089,1231,4858,0,0,0,1.0,1,1.0,1,1.0,1,0.164445725713669,40
1673,0,6089,1231,4858,0,0,0,1.0,1,1.0,1,1.0,1,0.1713653553492012,39
1674,2,6091,1233,4858,0,0,0,1.0,1,1.0,1,1.0,1,0.18894935700803334,40
1675,0,6091,1233,4858,0,0,0,1.0,1,1.0,1,1.0,1,0.18937755373920298,38
1676,2,6093,1234,4859,0,0,0,1.0,1,1.0,1,1.0,1,0.19782429541108612,39
1677,0,6093,1234,4859,0,0,0,1.0,1,1.0,1,1.0,1,0.19779557092869604,39
1678,1,6094,1234,4860,0,0,0,1.0,1,1.0,1,1.0,1,0.184509932826509,39
1679,0,6094,1234,4860,0,0,0,1.0,1,1.0,1,1.0,1,0.184509932826509,39
1680,1,6095,1235,4860,0,0,0,1.0,1,1.0,1,1.0,1,0.23974346994117562,41
1681,12,6107,1237,4870,0,0,0,1.0,1,1.0,1,1.0,1,0.12468887539138138,41
1682,6,6113,1237,4876,0,0,0,1.0,1,1.0,1,1.0,1,0.12072528508877975,43
1683,8,6121,1238,4883,0,0,0,1.0,1,1.0,1,1.0,1,0.12078223304872689,43
1684,7,6128,1240,4888,0,0,0,1.0,1,1.0,1,1.0,1,0.16090581564732032,42
1685,6,6134,1240,4894,0,0,0,1.0,1,1.0,1,1.0,1,0.14813632640110683,41
1686,9,6143,1241,4902,0,0,0,1.0,1,1.0,1,1.0,1,0.1981174976776864,41
1687,10,6153,1245,4908,0,0,0,1.0,1,1.0,1,1.0,1,0.2801699794244065,40
1688,10,6163,1247,4916,0,0,0,1.0,1,1.0,1,1.0,1,0.24638628677060861,39
1689,7,6170,1247,4923,0,0,0,1.0,1,1.0,1,1.0,1,0.304447908613638,38
1690,8,6178,1248,4930,0,0,0,1.0,1,1.0,1,1.0,1,0.31480437563527036,38
1691,8,6186,1249,4937,0,0,0,1.0,1,1.0,1,1.0,1,0.32449229909158533,36
1692,10,6196,1250,4946,0,0,0,1.0,1,1.0,1,1.0,1,0.3575190442343856,36
1693,6,6202,1251,4951,0,0,0,1.0,1,1.0,1,1.0,1,0.3979382039386462,35
1694,7,6209,1252,4957,0,0,0,1.0,1,1.0,1,1.0,1,0.3664931464050565,33
1695,7,6216,1252,4964,0,0,0,1.0,1,1.0,1,1.0,1,0.3546000426543759,34
1696,8,6224,1253,4971,0,0,0,1.0,1,1.0,1,1.0,1,0.23195113946522875,35
1697,1,6225,1253,4972,0,0,0,1.0,1,1.0,1,1.0,1,0.2360322732805924,36
1698,2,6227,1254,4973,0,0,0,1.0,1,1.0,1,1.0,1,0.2118315411965331,38
1699,3,6230,1255,4975,0,0,0,1.0,1,1.0,1,1.0,1,0.1937676760315516,38
1700,2,6232,1255,4977,0,0,0,1.0,1,1.0,1,1.0,1,0.15473053045578278,39
1701,2,6234,1255,4979,0,0,0,1.0,1,1.0,1,1.0,1,0.14584379980424267,40
1702,4,6238,1257,4981,0,0,0,1.0,1,1.0,1,1.0,1,0.21141023694349853,41
1703,3,6241,1258,4983,0,0,0,1.0,1,1.0,1,1.0,1,0.18408124274275414,41
1704,7,6248,1260,4988,0,0,0,1.0,1,1.0,1,1.0,1,0.17954761415250756,41
1705,3,6251,1260,4991,0,0,0,1.0,1,1.0,1,1.0,1,0.177563693557395,40
1706,3,6254,1261,4993,0,0,0,1.0,1,1.0,1,1.0,1,0.2149316779451652,40
1707,7,6261,1262,4999,0,0,0,1.0,1,1.0,1,1.0,1,0.17690656493221674,39
1708,3,6264,1262,5002,0,0,0,1.0,1,1.0,1,1.0,1,0.20256151663154784,39
1709,4,6268,1262,5006,0,0,0,1.0,1,1.0,1,1.0,1,0.21013359657712524,38
1710,8,6276,1263,5013,0,0,0,1.0,1,1.0,1,1.0,1,0.22030378746871257,39
1711,4,6280,1263,5017,0,0,0,1.0,1,1.0,1,1.0,1,0.12215300215052405,38
1712,0,6280,1263,5017,0,0,0,1.0,1,1.0,1,1.0,1,0.12215300215052405,38
1713,0,6280,1263,5017,0,0,0,1.0,1,1.0,1,1.0,1,0.15119038458752226,37
1714,1,6281,1264,5017,0,0,0,1.0,1,1.0,1,1.0,1,0.1871981696803668,38
1715,4,6285,1265,5020,0,0,0,1.0,1,1.0,1,1.0,1,0.16151749439629323,40
1716,1,6286,1265,5021,0,0,0,1.0,1,1.0,1,1.0,1,0.1797898056378535,39
1717,1,6287,1266,5021,0,0,0,1.0,1,1.0,1,1.0,1,0.1889970204840417,38
1718,1,6288,1266,5022,0,0,0,1.0,1,1.0,1,1.0,1,0.21368783308542103,38
1719,0,6288,1266,5022,0,0,0,1.0,1,1.0,1,1.0,1,0.21368783308542103,38
1720,1,6289,1266,5023,0,0,0,1.0,1,1.0,1,1.0,1,0.1808246464930963,41
1721,1,6290,1267,5023,0,0,0,1.0,1,1.0,1,1.0,1,0.1722470344578056,39
1722,0,6290,1267,5023,0,0,0,1.0,1,1.0,1,1.0,1,0.167363146349584,40
1723,0,6290,1267,5023,0,0,0,1.0,1,1.0,1,1.0,1,0.17543420847603633,38
1724,1,6291,1268,5023,0,0,0,1.0,1,1.0,1,1.0,1,0.19034737027060203,37
1725,3,6294,1269,5025,0,0,0,1.0,1,1.0,1,1.0,1,0.18329325149622108,38
1726,3,6297,1270,5027,0,0,0,1.0,1,1.0,1,1.0,1,0.1462684697730576,37
1727,1,6298,1270,5028,0,0,0,1.0,1,1.0,1,1.0,1,0.12310494080809092,37
1728,0,6298,1270,5028,0,0,0,1.0,1,1.0,1,1.0,1,0.13299376268195465,35
1729,0,6298,1270,5028,0,0,0,1.0,1,1.0,1,1.0,1,0.16172867974629768,37
1730,1,6299,1271,5028,0,0,0,1.0,1,1.0,1,1.0,1,0.19345164863209596,37
1731,1,6300,1271,5029,0,0,0,1.0,1,1.0,1,1.0,1,0.1710148287251541,37
1732,2,6302,1271,5031,0,0,0,1.0,1,1.0,1,1.0,1,0.1843000376767107,37
1733,4,6306,1273,5033,0,0,0,1.0,1,1.0,1,1.0,1,0.15846622954111506,36
1734,0,6306,1273,5033,0,0,0,1.0,1,1.0,1,1.0,1,0.1789349568421143,35
1735,2,6308,1275,5033,0,0,0,1.0,1,1.0,1,1.0,1,0.17185155031386257,34
1736,1,6309,1275,5034,0,0,0,1.0,1,1.0,1,1.0,1,0.1398250248815591,35
1737,4,6313,1279,5034,0,0,0,1.0,1,1.0,1,1.0,1,0.19366990436401607,36
1738,3,6316,1280,5036,0,0,0,1.0,1,1.0,1,1.0,1,0.2211283727444367,37
1739,5,6321,1282,5039,0,0,0,1.0,1,1.0,1,1.0,1,0.20289727584460118,38
1740,2,6323,1282,5041,0,0,0,1.0,1,1.0,1,1.0,1,0.23375072438365652,37
1741,3,6326,1282,5044,0,0,0,1.0,1,1.0,1,1.0,1,0.14659167804674805,38
1742,5,6331,1284,5047,0,0,0,1.0,1,1.0,1,1.0,1,0.1397902699079554,39
1743,6,6337,1286,5051,0,0,0,1.0,1,1.0,1,1.0,1,0.1476274316813095,37
1744,3,6340,1288,5052,0,0,0,1.0,1,1.0,1,1.0,1,0.16362462004584966,38
1745,3,6343,1288,5055,0,0,0,1.0,1,1.0,1,1.0,1,0.1964947973475498,37
1746,5,6348,1288,5060,0,0,0,1.0,1,1.0,1,1.0,1,0.14079622229472624,38
1747,5,6353,1289,5064,0,0,0,1.0,1,1.0,1,1.0,1,0.14780738677147642,38
1748,4,6357,1290,5067,0,0,0,1.0,1,1.0,1,1.0,1,0.17364342102983102,38
1749,7,6364,1290,5074,0,0,0,1.0,1,1.0,1,1.0,1,0.20029191381108483,37
1750,4,6368,1290,5078,0,0,0,1.0,1,1.0,1,1.0,1,0.19931076167133083,39
1751,6,6374,1290,5084,0,0,0,1.0,1,1.0,1,1.0,1,0.19577344470214783,38
1752,5,6379,1291,5088,0,0,0,1.0,1,1.0,1,1.0,1,0.23384793114836072,39
1753,3,6382,1291,5091,0,0,0,1.0,1,1.0,1,1.0,1,0.23106467925124763,40
1754,15,6397,1292,5105,0,0,0,1.0,1,1.0,1,1.0,1,0.2195498948160361,41
1755,4,6401,1292,5109,0,0,0,1.0,1,1.0,1,1.0,1,0.2039182838294367,41
1756,5,6406,1293,5113,0,0,0,1.0,1,1.0,1,1.0,1,0.12245553671052048,42
1757,3,6409,1294,5115,0,0,0,1.0,1,1.0,1,1.0,1,0.12921688180225047,42
1758,5,6414,1296,5118,0,0,0,1.0,1,1.0,1,1.0,1,0.17124368104083176,42
1759,5,6419,1296,5123,0,0,0,1.0,1,1.0,1,1.0,1,0.21518762193044436,39
1760,12,6431,1298,5133,0,0,0,1.0,1,1.0,1,1.0,1,0.26202300976952414,39
1761,7,6438,1301,5137,0,0,0,1.0,1,1.0,1,1.0,1,0.2850242957068077,38
1762,11,6449,1301,5148,0,0,0,1.0,1,1.0,1,1.0,1,0.2830744861622587,37
1763,5,6454,1301,5153,0,0,0,1.0,1,1.0,1,1.0,1,0.27720280838870204,37
1764,6,6460,1301,5159,0,0,0,1.0,1,1.0,1,1.0,1,0.2814305366218377,36
1765,8,6468,1303,5165,0,0,0,1.0,1,1.0,1,1.0,1,0.2794382689408905,37
1766,4,6472,1303,5169,0,0,0,1.0,1,1.0,1,1.0,1,0.21612197544366105,36
1767,6,6478,1303,5175,0,0,0,1.0,1,1.0,1,1.0,1,0.21612197544366105,36
1768,3,6481,1303,5178,0,0,0,1.0,1,1.0,1,1.0,1,0.24752183893751614,36
1769,7,6488,1304,5184,0,0,0,1.0,1,1.0,1,1.0,1,0.2641300334946797,38
1770,6,6494,1304,5190,0,0,0,1.0,1,1.0,1,1.0,1,0.2641300334946797,38
1771,5,6499,1304,5195,0,0,0,1.0,1,1.0,1,1.0,1,0.1278521115484603,38
1772,1,6500,1304,5196,0,0,0,1.0,1,1.0,1,1.0,1,0.14066008401066443,40
1773,1,6501,1305,5196,0,0,0,1.0,1,1.0,1,1.0,1,0.17775515062577038,40
1774,1,6502,1305,5197,0,0,0,1.0,1,1.0,1,1.0,1,0.16242026551346914,40
1775,1,6503,1305,5198,0,0,0,1.0,1,1.0,1,1.0,1,0.15831767511757502,41
1776,0,6503,1305,5198,0,0,0,1.0,1,1.0,1,1.0,1,0.1329602761063026,43
1777,1,6504,1305,5199,0,0,0,1.0,1,1.0,1,1.0,1,0.12478373522978098,44
1778,0,6504,1305,5199,0,0,0,1.0,1,1.0,1,1.0,1,0.12478373522978098,44
1779,0,6504,1305,5199,0,0,0,1.0,1,1.0,1,1.0,1,0.12478373522978098,44
1780,1,6505,1305,5200,0,0,0,1.0,1,1.0,1,1.0,1,0.1154611874714168,46
1781,1,6506,1305,5201,0,0,0,1.0,1,1.0,1,1.0,1,0.10829460303472785,46
1782,2,6508,1307,5201,0,0,0,1.0,1,1.0,1,1.0,1,0.14290195079083365,45
1783,3,6511,1309,5202,0,0,0,1.0,1,1.0,1,1.0,1,0.15120161338242472,44
1784,3,6514,1311,5203,0,0,0,1.0,1,1.0,1,1.0,1,0.16937620680603582,44
1785,5,6519,1312,5207,0,0,0,1.0,1,1.0,1,1.0,1,0.1738130981844373,42
1786,7,6526,1314,5212,0,0,0,1.0,1,1.0,1,1.0,1,0.14470615644843896,42
1787,3,6529,1314,5215,0,0,0,1.0,1,1.0,1,1.0,1,0.16385431275882809,41
1788,3,6532,1314,5218,0,0,0,1.0,1,1.0,1,1.0,1,0.12850987688945664,41
1789,0,6532,1314,5218,0,0,0,1.0,1,1.0,1,1.0,1,0.1274113295005153,41
1790,4,6536,1317,5219,0,0,0,1.0,1,1.0,1,1.0,1,0.15922384396950623,41
1791,5,6541,1319,5222,0,0,0,1.0,1,1.0,1,1.0,1,0.13692516109205738,41
1792,0,6541,1319,5222,0,0,0,1.0,1,1.0,1,1.0,1,0.12583727648506762,43
1793,4,6545,1321,5224,0,0,0,1.0,1,1.0,1,1.0,1,0.11360469026532853,43
1794,3,6548,1322,5226,0,0,0,1.0,1,1.0,1,1.0,1,0.20169200067706178,41
1795,5,6553,1325,5228,0,0,0,1.0,1,1.0,1,1.0,1,0.17484685191480523,41
1796,5,6558,1326,5232,0,0,0,1.0,1,1.0,1,1.0,1,0.16762600831306929,40
1797,1,6559,1327,5232,0,0,0,1.0,1,1.0,1,1.0,1,0.1832904335345195,38
1798,0,6559,1327,5232,0,0,0,1.0,1,1.0,1,1.0,1,0.1832904335345195,38
1799,3,6562,1330,5232,0,0,0,1.0,1,1.0,1,1.0,1,0.17609522774378303,37
1800,1,6563,1331,5232,0,0,0,1.0,1,1.0,1,1.0,1,0.22813953417438637,35
1801,7,6570,1331,5239,0,0,0,1.0,1,1.0,1,1.0,1,0.10305044520438848,34
1802,3,6573,1331,5242,0,0,0,1.0,1,1.0,1,1.0,1,0.11222987776026591,33
1803,2,6575,1331,5244,0,0,0,1.0,1,1.0,1,1.0,1,0.11222987776026591,33
1804,3,6578,1332,5246,0,0,0,1.0,1,1.0,1,1.0,1,0.14442139613324723,33
1805,2,6580,1332,5248,0,0,0,1.0,1,1.0,1,1.0,1,0.13804617750672768,35
1806,6,6586,1333,5253,0,0,0,1.0,1,1.0,1,1.0,1,0.17643625286615836,36
1807,4,6590,1333,5257,0,0,0,1.0,1,1.0,1,1.0,1,0.24444952379637827,35
1808,4,6594,1334,5260,0,0,0,1.0,1,1.0,1,1.0,1,0.17530546557413113,37
1809,5,6599,1334,5265,0,0,0,1.0,1,1.0,1,1.0,1,0.15167201898265945,35
1810,6,6605,1335,5270,0,0,0,1.0,1,1.0,1,1.0,1,0.2117100968981371,36
1811,5,6610,1336,5274,0,0,0,1.0,1,1.0,1,1.0,1,0.24899284664501256,34
1812,3,6613,1336,5277,0,0,0,1.0,1,1.0,1,1.0,1,0.24077161056557822,36
1813,5,6618,1336,5282,0,0,0,1.0,1,1.0,1,1.0,1,0.25969751630941906,35
1814,4,6622,1336,5286,0,0,0,1.0,1,1.0,1,1.0,1,0.30689127042109093,36
1815,6,6628,1337,5291,0,0,0,1.0,1,1.0,1,1.0,1,0.27520506617796914,35
1816,5,6633,1338,5295,0,0,0,1.0,1,1.0,1,1.0,1,0.18123149425912172,35
1817,0,6633,1338,5295,0,0,0,1.0,1,1.0,1,1.0,1,0.18123149425912172,35
1818,3,6636,1338,5298,0,0,0,1.0,1,1.0,1,1.0,1,0.15425422415443826,36
1819,2,6638,1339,5299,0,0,0,1.0,1,1.0,1,1.0,1,0.14091020963131362,37
1820,3,6641,1339,5302,0,0,0,1.0,1,1.0,1,1.0,1,0.15518603846783652,37
1821,2,6643,1340,5303,0,0,0,1.0,1,1.0,1,1.0,1,0.1893708965210153,38
1822,3,6646,1342,5304,0,0,0,1.0,1,1.0,1,1.0,1,0.18888160761143966,37
1823,1,6647,1343,5304,0,0,0,1.0,1,1.0,1,1.0,1,0.23450044490127653,36
1824,3,6650,1345,5305,0,0,0,1.0,1,1.0,1,1.0,1,0.2415852475105228,36
1825,3,6653,1346,5307,0,0,0,1.0,1,1.0,1,1.0,1,0.2800231299451122,34
1826,2,6655,1347,5308,0,0,0,1.0,1,1.0,1,1.0,1,0.25303249535486294,35
1827,3,6658,1349,5309,0,0,0,1.0,1,1.0,1,1.0,1,0.2631299300414648,34
1828,6,6664,1351,5313,0,0,0,1.0,1,1.0,1,1.0,1,0.29949664932103237,33
1829,2,6666,1352,5314,0,0,0,1.0,1,1.0,1,1.0,1,0.27879487274137565,31
1830,2,6668,1353,5315,0,0,0,1.0,1,1.0,1,1.0,1,0.28962846969564543,31
1831,7,6675,1355,5320,0,0,0,1.0,1,1.0,1,1.0,1,0.18186472820209065,30
1832,0,6675,1355,5320,0,0,0,1.0,1,1.0,1,1.0,1,0.175786472010656,29
1833,1,6676,1356,5320,0,0,0,1.0,1,1.0,1,1.0,1,0.20554953045959176,28
1834,1,6677,1357,5320,0,0,0,1.0,1,1.0,1,1.0,1,0.16927959761706007,27
1835,2,6679,1359,5320,0,0,0,1.0,1,1.0,1,1.0,1,0.2449261305005393,26
1836,4,6683,1361,5322,0,0,0,1.0,1,1.0,1,1.0,1,0.2008745262496951,26
1837,2,6685,1362,5323,0,0,0,1.0,1,1.0,1,1.0,1,0.24978678327598822,25
1838,2,6687,1362,5325,0,0,0,1.0,1,1.0,1,1.0,1,0.20860807955441046,25
1839,0,6687,1362,5325,0,0,0,1.0,1,1.0,1,1.0,1,0.26477217117325774,24
1840,1,6688,1362,5326,0,0,0,1.0,1,1.0,1,1.0,1,0.2413997482708445,23
1841,1,6689,1362,5327,0,0,0,1.0,1,1.0,1,1.0,1,0.22295498151239215,22
1842,0,6689,1362,5327,0,0,0,1.0,1,1.0,1,1.0,1,0.22291996186047086,23
1843,2,6691,1363,5328,0,0,0,1.0,1,1.0,1,1.0,1,0.24412529319266052,23
1844,2,6693,1364,5329,0,0,0,1.0,1,1.0,1,1.0,1,0.22916498570102925,23
1845,4,6697,1366,5331,0,0,0,1.0,1,1.0,1,1.0,1,0.2665442788706887,23
1846,4,6701,1367,5334,0,0,0,1.0,1,1.0,1,1.0,1,0.17234032750013206,23
1847,0,6701,1367,5334,0,0,0,1.0,1,1.0,1,1.0,1,0.15742773544223018,24
1848,0,6701,1367,5334,0,0,0,1.0,1,1.0,1,1.0,1,0.15742773544223018,24
1849,0,6701,1367,5334,0,0,0,1.0,1,1.0,1,1.0,1,0.17391259741650666,25
1850,0,6701,1367,5334,0,0,0,1.0,1,1.0,1,1.0,1,0.17391259741650666,25
1851,0,6701,1367,5334,0,0,0,1.0,1,1.0,1,1.0,1,0.17391259741650666,25
1852,0,6701,1367,5334,0,0,0,1.0,1,1.0,1,1.0,1,0.17391259741650666,25
1853,2,6703,1367,5336,0,0,0,1.0,1,1.0,1,1.0,1,0.20506550770352658,25
1854,3,6706,1368,5338,0,0,0,1.0,1,1.0,1,1.0,1,0.24270775650655713,25
1855,2,6708,1368,5340,0,0,0,1.0,1,1.0,1,1.0,1,0.2593175991460649,26
1856,1,6709,1368,5341,0,0,0,1.0,1,1.0,1,1.0,1,0.2590821082338968,27
1857,3,6712,1368,5344,0,0,0,1.0,1,1.0,1,1.0,1,0.30150271521024347,28
1858,3,6715,1369,5346,0,0,0,1.0,1,1.0,1,1.0,1,0.3047562338139269,28
1859,2,6717,1369,5348,0,0,0,1.0,1,1.0,1,1.0,1,0.3047562338139269,28
1860,1,6718,1369,5349,0,0,0,1.0,1,1.0,1,1.0,1,0.2732776184560971,28
1861,3,6721,1369,5352,0,0,0,1.0,1,1.0,1,1.0,1,0.2092694143417799,28
1862,0,6721,1369,5352,0,0,0,1.0,1,1.0,1,1.0,1,0.2092694143417799,28
1863,1,6722,1370,5352,0,0,0,1.0,1,1.0,1,1.0,1,0.24130635169280693,29
1864,1,6723,1371,5352,0,0,0,1.0,1,1.0,1,1.0,1,0.2296899824333327,27
1865,2,6725,1372,5353,0,0,0,1.0,1,1.0,1,1.0,1,0.203700819535385,26
1866,1,6726,1373,5353,0,0,0,1.0,1,1.0,1,1.0,1,0.24457082995819038,26
1867,0,6726,1373,5353,0,0,0,1.0,1,1.0,1,1.0,1,0.24457082995819038,26
1868,0,6726,1373,5353,0,0,0,1.0,1,1.0,1,1.0,1,0.24457082995819038,26
1869,0,6726,1373,5353,0,0,0,1.0,1,1.0,1,1.0,1,0.24457082995819038,26
1870,1,6727,1373,5354,0,0,0,1.0,1,1.0,1,1.0,1,0.2521272202743896,27
1871,1,6728,1374,5354,0,0,0,1.0,1,1.0,1,1.0,1,0.2449194904171651,27
1872,0,6728,1374,5354,0,0,0,1.0,1,1.0,1,1.0,1,0.2725363429783793,25
1873,0,6728,1374,5354,0,0,0,1.0,1,1.0,1,1.0,1,0.2725363429783793,25
1874,0,6728,1374,5354,0,0,0,1.0,1,1.0,1,1.0,1,0.3299621202536724,25
1875,0,6728,1374,5354,0,0,0,1.0,1,1.0,1,1.0,1,0.3299621202536724,25
1876,2,6730,1374,5356,0,0,0,1.0,1,1.0,1,1.0,1,0.2409846955044905,26
1877,0,6730,1374,5356,0,0,0,1.0,1,1.0,1,1.0,1,0.23898067972606998,27
1878,3,6733,1376,5357,0,0,0,1.0,1,1.0,1,1.0,1,0.2561922725854963,28
1879,1,6734,1376,5358,0,0,0,1.0,1,1.0,1,1.0,1,0.2192740289821633,29
1880,1,6735,1376,5359,0,0,0,1.0,1,1.0,1,1.0,1,0.2022307789773773,29
1881,0,6735,1376,5359,0,0,0,1.0,1,1.0,1,1.0,1,0.2022307789773773,29
1882,0,6735,1376,5359,0,0,0,1.0,1,1.0,1,1.0,1,0.19488910207000087,28
1883,0,6735,1376,5359,0,0,0,1.0,1,1.0,1,1.0,1,0.19488910207000087,28
1884,0,6735,1376,5359,0,0,0,1.0,1,1.0,1,1.0,1,0.19488910207000087,28
1885,0,6735,1376,5359,0,0,0,1.0,1,1.0,1,1.0,1,0.19488910207000087,28
1886,0,6735,1376,5359,0,0,0,1.0,1,1.0,1,1.0,1,0.20203903814214255,29
1887,0,6735,1376,5359,0,0,0,1.0,1,1.0,1,1.0,1,0.20203903814214255,29
1888,4,6739,1376,5363,0,0,0,1.0,1,1.0,1,1.0,1,0.19652193956306144,31
1889,5,6744,1376,5368,0,0,0,1.0,1,1.0,1,1.0,1,0.2177365203703043,31
1890,3,6747,1376,5371,0,0,0,1.0,1,1.0,1,1.0,1,0.21376737627593573,31
1891,3,6750,1376,5374,0,0,0,1.0,1,1.0,1,1.0,1,0.16428972586644594,32
1892,0,6750,1376,5374,0,0,0,1.0,1,1.0,1,1.0,1,0.16428972586644594,32
1893,0,6750,1376,5374,0,0,0,1.0,1,1.0,1,1.0,1,0.16428972586644594,32
1894,0,6750,1376,5374,0,0,0,1.0,1,1.0,1,1.0,1,0.14812378436330703,33
1895,0,6750,1376,5374,0,0,0,1.0,1,1.0,1,1.0,1,0.1778790886316256,35
1896,1,6751,1376,5375,0,0,0,1.0,1,1.0,1,1.0,1,0.1628978104919475,34
1897,0,6751,1376,5375,0,0,0,1.0,1,1.0,1,1.0,1,0.1628978104919475,34
1898,0,6751,1376,5375,0,0,0,1.0,1,1.0,1,1.0,1,0.1628978104919475,34
1899,0,6751,1376,5375,0,0,0,1.0,1,1.0,1,1.0,1,0.1628978104919475,34
1900,1,6752,1376,5376,0,0,0,1.0,1,1.0,1,1.0,1,0.18494525503849815,35
1901,0,6752,1376,5376,0,0,0,1.0,1,1.0,1,1.0,1,0.18494525503849815,35
1902,0,6752,1376,5376,0,0,0,1.0,1,1.0,1,1.0,1,0.18494525503849815,35
1903,0,6752,1376,5376,0,0,0,1.0,1,1.0,1,1.0,1,0.18494525503849815,35
1904,0,6752,1376,5376,0,0,0,1.0,1,1.0,1,1.0,1,0.18494525503849815,35
1905,3,6755,1376,5379,0,0,0,1.0,1,1.0,1,1.0,1,0.174891129086552,37
1906,2,6757,1376,5381,0,0,0,1.0,1,1.0,1,1.0,1,0.13963077137314653,37
1907,1,6758,1376,5382,0,0,0,1.0,1,1.0,1,1.0,1,0.13732993513953443,39
1908,0,6758,1376,5382,0,0,0,1.0,1,1.0,1,1.0,1,0.13732993513953443,39
1909,2,6760,1376,5384,0,0,0,1.0,1,1.0,1,1.0,1,0.1593440595182172,41
1910,1,6761,1376,5385,0,0,0,1.0,1,1.0,1,1.0,1,0.14070088546194962,41
1911,4,6765,1377,5388,0,0,0,1.0,1,1.0,1,1.0,1,0.21690934485461924,40
1912,8,6773,1379,5394,0,0,0,1.0,1,1.0,1,1.0,1,0.2910716783423494,39
1913,7,6780,1380,5400,0,0,0,1.0,1,1.0,1,1.0,1,0.27480797265746554,40
1914,6,6786,1380,5406,0,0,0,1.0,1,1.0,1,1.0,1,0.24090865037967663,41
1915,7,6793,1381,5412,0,0,0,1.0,1,1.0,1,1.0,1,0.27891795727017893,42
1916,7,6800,1383,5417,0,0,0,1.0,1,1.0,1,1.0,1,0.3081967869882093,42
1917,8,6808,1385,5423,0,0,0,1.0,1,1.0,1,1.0,1,0.33586783247660007,41
1918,7,6815,1387,5428,0,0,0,1.0,1,1.0,1,1.0,1,0.3597852389254321,38
1919,4,6819,1387,5432,0,0,0,1.0,1,1.0,1,1.0,1,0.35154362226081,38
1920,4,6823,1387,5436,0,0,0,1.0,1,1.0,1,1.0,1,0.3644823204177103,38
1921,6,6829,1387,5442,0,0,0,1.0,1,1.0,1,1.0,1,0.24171055216100343,39
1922,2,6831,1387,5444,0,0,0,1.0,1,1.0,1,1.0,1,0.21099856407211598,40
1923,3,6834,1387,5447,0,0,0,1.0,1,1.0,1,1.0,1,0.15230120923839843,41
1924,7,6841,1389,5452,0,0,0,1.0,1,1.0,1,1.0,1,0.20568182863463172,41
1925,7,6848,1389,5459,0,0,0,1.0,1,1.0,1,1.0,1,0.17071937436292942,41
1926,4,6852,1389,5463,0,0,0,1.0,1,1.0,1,1.0,1,0.1563224603523529,41
1927,3,6855,1389,5466,0,0,0,1.0,1,1.0,1,1.0,1,0.18927387298100412,41
1928,7,6862,1390,5472,0,0,0,1.0,1,1.0,1,1.0,1,0.1387875619059668,42
1929,2,6864,1390,5474,0,0,0,1.0,1,1.0,1,1.0,1,0.15379997416723573,41
1930,4,6868,1390,5478,0,0,0,1.0,1,1.0,1,1.0,1,0.15379997416723573,41
1931,4,6872,1390,5482,0,0,0,1.0,1,1.0,1,1.0,1,0.15379997416723573,41
1932,4,6876,1390,5486,0,0,0,1.0,1,1.0,1,1.0,1,0.15379997416723573,41
1933,5,6881,1390,5491,0,0,0,1.0,1,1.0,1,1.0,1,0.15543784723339144,43
1934,3,6884,1390,5494,0,0,0,1.0,1,1.0,1,1.0,1,0.1871247978157824,44
1935,5,6889,1390,5499,0,0,0,1.0,1,1.0,1,1.0,1,0.13997707864972994,45
1936,4,6893,1390,5503,0,0,0,1.0,1,1.0,1,1.0,1,0.09820499703153937,48
1937,1,6894,1390,5504,0,0,0,1.0,1,1.0,1,1.0,1,0.08503662162449831,48
1938,2,6896,1391,5505,0,0,0,1.0,1,1.0,1,1.0,1,0.08992100906678019,48
1939,1,6897,1391,5506,0,0,0,1.0,1,1.0,1,1.0,1,0.08649622385000369,48
1940,0,6897,1391,5506,0,0,0,1.0,1,1.0,1,1.0,1,0.08649622385000369,48
1941,0,6897,1391,5506,0,0,0,1.0,1,1.0,1,1.0,1,0.08649622385000369,48
1942,3,6900,1393,5507,0,0,0,1.0,1,1.0,1,1.0,1,0.15888260883178063,49
1943,3,6903,1394,5509,0,0,0,1.0,1,1.0,1,1.0,1,0.11086612316770063,48
1944,5,6908,1397,5511,0,0,0,1.0,1,1.0,1,1.0,1,0.13620684699104085,47
1945,1,6909,1398,5511,0,0,0,1.0,1,1.0,1,1.0,1,0.1524146184408568,46
1946,3,6912,1399,5513,0,0,0,1.0,1,1.0,1,1.0,1,0.14942719887786612,46
1947,5,6917,1403,5514,0,0,0,1.0,1,1.0,1,1.0,1,0.2866842788714637,45
1948,5,6922,1406,5516,0,0,0,1.0,1,1.0,1,1.0,1,0.24477523973959783,46
1949,2,6924,1408,5516,0,0,0,1.0,1,1.0,1,1.0,1,0.26369919957618965,42
1950,0,6924,1408,5516,0,0,0,1.0,1,1.0,1,1.0,1,0.2679261176340434,40
1951,6,6930,1411,5519,0,0,0,1.0,1,1.0,1,1.0,1,0.21066514582220913,39
1952,2,6932,1412,5520,0,0,0,1.0,1,1.0,1,1.0,1,0.18921736108072035,35
1953,1,6933,1413,5520,0,0,0,1.0,1,1.0,1,1.0,1,0.16567402403241147,36
1954,3,6936,1414,5522,0,0,0,1.0,1,1.0,1,1.0,1,0.2389626504946649,34
1955,4,6940,1416,5524,0,0,0,1.0,1,1.0,1,1.0,1,0.16173370143872964,35
1956,1,6941,1417,5524,0,0,0,1.0,1,1.0,1,1.0,1,0.2021052781012119,37
1957,2,6943,1418,5525,0,0,0,1.0,1,1.0,1,1.0,1,0.17729225109552865,37
1958,1,6944,1418,5526,0,0,0,1.0,1,1.0,1,1.0,1,0.15309529549934997,39
1959,1,6945,1419,5526,0,0,0,1.0,1,1.0,1,1.0,1,0.19029988115598215,41
1960,2,6947,1421,5526,0,0,0,1.0,1,1.0,1,1.0,1,0.25461273618261565,40
1961,4,6951,1421,5530,0,0,0,1.0,1,1.0,1,1.0,1,0.20959857213245328,41
1962,0,6951,1421,5530,0,0,0,1.0,1,1.0,1,1.0,1,0.23716910695009988,40
1963,2,6953,1421,5532,0,0,0,1.0,1,1.0,1,1.0,1,0.24171796797005884,41
1964,0,6953,1421,5532,0,0,0,1.0,1,1.0,1,1.0,1,0.25900270385220353,40
1965,0,6953,1421,5532,0,0,0,1.0,1,1.0,1,1.0,1,0.24251228722291737,41
1966,6,6959,1421,5538,0,0,0,1.0,1,1.0,1,1.0,1,0.1496620587873766,41
1967,3,6962,1422,5540,0,0,0,1.0,1,1.0,1,1.0,1,0.13321349831566767,42
1968,0,6962,1422,5540,0,0,0,1.0,1,1.0,1,1.0,1,0.15978162146216052,42
1969,0,6962,1422,5540,0,0,0,1.0,1,1.0,1,1.0,1,0.16709812063316878,43
1970,2,6964,1422,5542,0,0,0,1.0,1,1.0,1,1.0,1,0.16289221162909132,42
1971,0,6964,1422,5542,0,0,0,1.0,1,1.0,1,1.0,1,0.16289221162909132,42
1972,0,6964,1422,5542,0,0,0,1.0,1,1.0,1,1.0,1,0.16289221162909132,42
1973,0,6964,1422,5542,0,0,0,1.0,1,1.0,1,1.0,1,0.17562172038803328,43
1974,0,6964,1422,5542,0,0,0,1.0,1,1.0,1,1.0,1,0.1976328566021,43
1975,1,6965,1422,5543,0,0,0,1.0,1,1.0,1,1.0,1,0.16476572191745775,43
1976,1,6966,1423,5543,0,0,0,1.0,1,1.0,1,1.0,1,0.13642124770810976,43
1977,5,6971,1423,5548,0,0,0,1.0,1,1.0,1,1.0,1,0.14606917173226577,48
1978,7,6978,1426,5552,0,0,0,1.0,1,1.0,1,1.0,1,0.13143635119182512,48
1979,3,6981,1427,5554,0,0,0,1.0,1,1.0,1,1.0,1,0.15473753429144288,49
1980,3,6984,1427,5557,0,0,0,1.0,1,1.0,1,1.0,1,0.15036733932954596,50
1981,4,6988,1429,5559,0,0,0,1.0,1,1.0,1,1.0,1,0.13044951160190715,50
1982,2,6990,1430,5560,0,0,0,1.0,1,1.0,1,1.0,1,0.12733887346806494,50
1983,2,6992,1431,5561,0,0,0,1.0,1,1.0,1,1.0,1,0.13913170424794452,49
1984,1,6993,1432,5561,0,0,0,1.0,1,1.0,1,1.0,1,0.12583349968929397,48
1985,0,6993,1432,5561,0,0,0,1.0,1,1.0,1,1.0,1,0.1191109572126189,46
1986,0,6993,1432,5561,0,0,0,1.0,1,1.0,1,1.0,1,0.1191109572126189,46
1987,2,6995,1434,5561,0,0,0,1.0,1,1.0,1,1.0,1,0.11667787515167617,42
1988,2,6997,1435,5562,0,0,0,1.0,1,1.0,1,1.0,1,0.15141155826722089,40
1989,4,7001,1439,5562,0,0,0,1.0,1,1.0,1,1.0,1,0.1615799868232086,38
1990,1,7002,1439,5563,0,0,0,1.0,1,1.0,1,1.0,1,0.10526133450803725,38
1991,2,7004,1441,5563,0,0,0,1.0,1,1.0,1,1.0,1,0.15272565995797233,38
1992,2,7006,1442,5564,0,0,0,1.0,1,1.0,1,1.0,1,0.17571913131613126,39
1993,2,7008,1444,5564,0,0,0,1.0,1,1.0,1,1.0,1,0.2795905624938566,38
1994,1,7009,1445,5564,0,0,0,1.0,1,1.0,1,1.0,1,0.23732627303762416,37
1995,5,7014,1448,5566,0,0,0,1.0,1,1.0,1,1.0,1,0.2696364935395831,37
1996,7,7021,1449,5572,0,0,0,1.0,1,1.0,1,1.0,1,0.16269858600427584,37
1997,4,7025,1450,5575,0,0,0,1.0,1,1.0,1,1.0,1,0.17725483851875765,35
1998,1,7026,1450,5576,0,0,0,1.0,1,1.0,1,1.0,1,0.17235983173996017,34
1999,3,7029,1451,5578,0,0,0,1.0,1,1.0,1,1.0,1,0.16857153512498413,35
2000,2,7031,1451,5580,0,0,0,1.0,1,1.0,1,1.0,1,0.192416076165398,34
2001,4,7035,1451,5584,0,0,0,1.0,1,1.0,1,1.0,1,0.1796644359863261,35
2002,6,7041,1452,5589,0,0,0,1.0,1,1.0,1,1.0,1,0.26973162971937087,36
2003,4,7045,1452,5593,0,0,0,1.0,1,1.0,1,1.0,1,0.21497880570439074,37
2004,5,7050,1452,5598,0,0,0,1.0,1,1.0,1,1.0,1,0.21155750846557395,38
2005,1,7051,1452,5599,0,0,0,1.0,1,1.0,1,1.0,1,0.22110509935137082,38
2006,1,7052,1452,5600,0,0,0,1.0,1,1.0,1,1.0,1,0.21155750846557395,38
2007,3,7055,1453,5602,0,0,0,1.0,1,1.0,1,1.0,1,0.2181642393036721,40
2008,4,7059,1454,5605,0,0,0,1.0,1,1.0,1,1.0,1,0.1910365656978199,40
2009,2,7061,1455,5606,0,0,0,1.0,1,1.0,1,1.0,1,0.21160240035196204,41
2010,1,7062,1455,5607,0,0,0,1.0,1,1.0,1,1.0,1,0.20242973632008662,41
2011,5,7067,1455,5612,0,0,0,1.0,1,1.0,1,1.0,1,0.11478560124256844,41
2012,2,7069,1456,5613,0,0,0,1.0,1,1.0,1,1.0,1,0.11991280358022197,41
2013,4,7073,1456,5617,0,0,0,1.0,1,1.0,1,1.0,1,0.13175242067125625,43
2014,1,7074,1456,5618,0,0,0,1.0,1,1.0,1,1.0,1,0.15886107525279022,43
2015,2,7076,1456,5620,0,0,0,1.0,1,1.0,1,1.0,1,0.15933771102758196,43
2016,3,7079,1456,5623,0,0,0,1.0,1,1.0,1,1.0,1,0.16291752386875089,44
2017,6,7085,1456,5629,0,0,0,1.0,1,1.0,1,1.0,1,0.16230934193116756,45
2018,5,7090,1457,5633,0,0,0,1.0,1,1.0,1,1.0,1,0.15810164256910017,46
2019,3,7093,1458,5635,0,0,0,1.0,1,1.0,1,1.0,1,0.19606239380759968,47
2020,5,7098,1460,5638,0,0,0,1.0,1,1.0,1,1.0,1,0.14786866634775447,47
2021,3,7101,1460,5641,0,0,0,1.0,1,1.0,1,1.0,1,0.1141901335702573,47
2022,4,7105,1460,5645,0,0,0,1.0,1,1.0,1,1.0,1,0.14987691060783453,48
2023,5,7110,1463,5647,0,0,0,1.0,1,1.0,1,1.0,1,0.13240703029316903,48
2024,5,7115,1466,5649,0,0,0,1.0,1,1.0,1,1.0,1,0.13839790904733598,45
2025,8,7123,1468,5655,0,0,0,1.0,1,1.0,1,1.0,1,0.261975531943228,42
2026,8,7131,1470,5661,0,0,0,1.0,1,1.0,1,1.0,1,0.14034899396137934,44
2027,1,7132,1470,5662,0,0,0,1.0,1,1.0,1,1.0,1,0.12043243779301137,40
2028,0,7132,1470,5662,0,0,0,1.0,1,1.0,1,1.0,1,0.15152708712273277,39
2029,2,7134,1471,5663,0,0,0,1.0,1,1.0,1,1.0,1,0.16884307867998571,37
2030,3,7137,1472,5665,0,0,0,1.0,1,1.0,1,1.0,1,0.21087617653542365,34
2031,4,7141,1473,5668,0,0,0,1.0,1,1.0,1,1.0,1,0.22349576022785905,35
2032,5,7146,1474,5672,0,0,0,1.0,1,1.0,1,1.0,1,0.275302890367134,34
2033,4,7150,1476,5674,0,0,0,1.0,1,1.0,1,1.0,1,0.31693334223716074,36
2034,2,7152,1476,5676,0,0,0,1.0,1,1.0,1,1.0,1,0.31181923824996494,34
2035,4,7156,1476,5680,0,0,0,1.0,1,1.0,1,1.0,1,0.3153224969643332,35
2036,2,7158,1476,5682,0,0,0,1.0,1,1.0,1,1.0,1,0.30709180616624976,34
2037,2,7160,1476,5684,0,0,0,1.0,1,1.0,1,1.0,1,0.2979190626794027,35
2038,2,7162,1476,5686,0,0,0,1.0,1,1.0,1,1.0,1,0.2970078205828717,36
2039,4,7166,1477,5689,0,0,0,1.0,1,1.0,1,1.0,1,0.29209154170198875,38
2040,2,7168,1477,5691,0,0,0,1.0,1,1.0,1,1.0,1,0.30107491479946424,38
2041,7,7175,1477,5698,0,0,0,1.0,1,1.0,1,1.0,1,0.18453443584060747,39
2042,1,7176,1477,5699,0,0,0,1.0,1,1.0,1,1.0,1,0.16594162894098174,39
2043,1,7177,1477,5700,0,0,0,1.0,1,1.0,1,1.0,1,0.16253628683979268,39
2044,0,7177,1477,5700,0,0,0,1.0,1,1.0,1,1.0,1,0.16253628683979268,39
2045,4,7181,1477,5704,0,0,0,1.0,1,1.0,1,1.0,1,0.11689942612210323,41
2046,1,7182,1477,5705,0,0,0,1.0,1,1.0,1,1.0,1,0.1435823224174288,42
2047,1,7183,1477,5706,0,0,0,1.0,1,1.0,1,1.0,1,0.10906384646959927,42
2048,2,7185,1477,5708,0,0,0,1.0,1,1.0,1,1.0,1,0.08508026104615898,43
2049,8,7193,1478,5715,0,0,0,1.0,1,1.0,1,1.0,1,0.0747364592994087,44
2050,5,7198,1478,5720,0,0,0,1.0,1,1.0,1,1.0,1,0.13995370343003075,44
2051,6,7204,1479,5725,0,0,0,1.0,1,1.0,1,1.0,1,0.2039882032864655,45
2052,10,7214,1479,5735,0,0,0,1.0,1,1.0,1,1.0,1,0.15671635009690796,45
2053,5,7219,1479,5740,0,0,0,1.0,1,1.0,1,1.0,1,0.1535066580845014,45
2054,5,7224,1479,5745,0,0,0,1.0,1,1.0,1,1.0,1,0.1502246196036816,46
2055,10,7234,1480,5754,0,0,0,1.0,1,1.0,1,1.0,1,0.19168955863451956,46
2056,5,7239,1480,5759,0,0,0,1.0,1,1.0,1,1.0,1,0.11257498875336154,46
2057,4,7243,1483,5760,0,0,0,1.0,1,1.0,1,1.0,1,0.11829150645976105,47
2058,2,7245,1485,5760,0,0,0,1.0,1,1.0,1,1.0,1,0.15160621501192964,47
2059,3,7248,1485,5763,0,0,0,1.0,1,1.0,1,1.0,1,0.14116422681024654,48
2060,4,7252,1486,5766,0,0,0,1.0,1,1.0,1,1.0,1,0.15213490860134435,50
2061,3,7255,1486,5769,0,0,0,1.0,1,1.0,1,1.0,1,0.1710040191207024,51
2062,7,7262,1489,5773,0,0,0,1.0,1,1.0,1,1.0,1,0.16713004351168223,49
2063,7,7269,1491,5778,0,0,0,1.0,1,1.0,1,1.0,1,0.14660938833279566,48
2064,4,7273,1493,5780,0,0,0,1.0,1,1.0,1,1.0,1,0.15603511524992317,45
2065,4,7277,1494,5783,0,0,0,1.0,1,1.0,1,1.0,1,0.1749576896900198,44
2066,6,7283,1496,5787,0,0,0,1.0,1,1.0,1,1.0,1,0.19853440290876176,42
2067,4,7287,1497,5790,0,0,0,1.0,1,1.0,1,1.0,1,0.19506069935181733,41
2068,4,7291,1498,5793,0,0,0,1.0,1,1.0,1,1.0,1,0.23080076097710003,40
2069,4,7295,1498,5797,0,0,0,1.0,1,1.0,1,1.0,1,0.21097974876019135,40
2070,3,7298,1499,5799,0,0,0,1.0,1,1.0,1,1.0,1,0.23956242450399434,40
2071,8,7306,1501,5805,0,0,0,1.0,1,1.0,1,1.0,1,0.19568982418064537,40
2072,5,7311,1501,5810,0,0,0,1.0,1,1.0,1,1.0,1,0.18780553877062175,41
2073,5,7316,1502,5814,0,0,0,1.0,1,1.0,1,1.0,1,0.20655240700809588,41
2074,3,7319,1502,5817,0,0,0,1.0,1,1.0,1,1.0,1,0.19035995296409475,41
2075,5,7324,1503,5821,0,0,0,1.0,1,1.0,1,1.0,1,0.2055137284783603,41
2076,8,7332,1503,5829,0,0,0,1.0,1,1.0,1,1.0,1,0.19816750186668725,41
2077,6,7338,1504,5834,0,0,0,1.0,1,1.0,1,1.0,1,0.19445191757762292,40
2078,8,7346,1505,5841,0,0,0,1.0,1,1.0,1,1.0,1,0.22216556029592954,40
2079,6,7352,1505,5847,0,0,0,1.0,1,1.0,1,1.0,1,0.2069342231601713,39
2080,2,7354,1505,5849,0,0,0,1.0,1,1.0,1,1.0,1,0.19547246930967385,38
2081,1,7355,1505,5850,0,0,0,1.0,1,1.0,1,1.0,1,0.13079471506570733,40
2082,6,7361,1506,5855,0,0,0,1.0,1,1.0,1,1.0,1,0.1621281108953576,41
2083,4,7365,1507,5858,0,0,0,1.0,1,1.0,1,1.0,1,0.1894778423206741,40
2084,13,7378,1509,5869,0,0,0,1.0,1,1.0,1,1.0,1,0.29052260486511366,42
2085,12,7390,1510,5880,0,0,0,1.0,1,1.0,1,1.0,1,0.2620915859352561,42
2086,5,7395,1511,5884,0,0,0,1.0,1,1.0,1,1.0,1,0.11150006441548699,43
2087,3,7398,1512,5886,0,0,0,1.0,1,1.0,1,1.0,1,0.12259710319624194,45
2088,7,7405,1513,5892,0,0,0,1.0,1,1.0,1,1.0,1,0.13043117253804656,46
2089,3,7408,1513,5895,0,0,0,1.0,1,1.0,1,1.0,1,0.11055655006227456,47
2090,6,7414,1513,5901,0,0,0,1.0,1,1.0,1,1.0,1,0.1506493577637535,49
2091,7,7421,1513,5908,0,0,0,1.0,1,1.0,1,1.0,1,0.11206599023164368,49
2092,7,7428,1513,5915,0,0,0,1.0,1,1.0,1,1.0,1,0.1340427331973165,49
2093,7,7435,1513,5922,0,0,0,1.0,1,1.0,1,1.0,1,0.09515091359760462,49
2094,7,7442,1513,5929,0,0,0,1.0,1,1.0,1,1.0,1,0.12546304260093308,49
2095,2,7444,1513,5931,0,0,0,1.0,1,1.0,1,1.0,1,0.08521233782089624,49
2096,3,7447,1513,5934,0,0,0,1.0,1,1.0,1,1.0,1,0.058019901486464374,51
2097,5,7452,1513,5939,0,0,0,1.0,1,1.0,1,1.0,1,0.10096782092339292,51
2098,5,7457,1513,5944,0,0,0,1.0,1,1.0,1,1.0,1,0.05156744169890694,52
2099,2,7459,1513,5946,0,0,0,1.0,1,1.0,1,1.0,1,0.10419890630956688,51
2100,4,7463,1513,5950,0,0,0,1.0,1,1.0,1,1.0,1,0.10278374510616012,51
2101,2,7465,1513,5952,0,0,0,1.0,1,1.0,1,1.0,1,0.08468955844255881,48
2102,4,7469,1515,5954,0,0,0,1.0,1,1.0,1,1.0,1,0.12089577187746357,49
2103,2,7471,1516,5955,0,0,0,1.0,1,1.0,1,1.0,1,0.16373739617958208,48
2104,1,7472,1517,5955,0,0,0,1.0,1,1.0,1,1.0,1,0.20023560599977486,43
2105,2,7474,1518,5956,0,0,0,1.0,1,1.0,1,1.0,1,0.2124423747510882,42
2106,1,7475,1518,5957,0,0,0,1.0,1,1.0,1,1.0,1,0.17785925351721737,40
2107,0,7475,1518,5957,0,0,0,1.0,1,1.0,1,1.0,1,0.17912822008736892,39
2108,2,7477,1520,5957,0,0,0,1.0,1,1.0,1,1.0,1,0.15672820256592743,38
2109,0,7477,1520,5957,0,0,0,1.0,1,1.0,1,1.0,1,0.14828342149245985,37
2110,2,7479,1522,5957,0,0,0,1.0,1,1.0,1,1.0,1,0.17753200899739602,38
2111,1,7480,1523,5957,0,0,0,1.0,1,1.0,1,1.0,1,0.2140307058593359,37
2112,3,7483,1525,5958,0,0,0,1.0,1,1.0,1,1.0,1,0.1926325129736996,36
2113,0,7483,1525,5958,0,0,0,1.0,1,1.0,1,1.0,1,0.1946471239524465,36
2114,0,7483,1525,5958,0,0,0,1.0,1,1.0,1,1.0,1,0.16789997475282353,36
2115,0,7483,1525,5958,0,0,0,1.0,1,1.0,1,1.0,1,0.1601069308027876,35
2116,5,7488,1527,5961,0,0,0,1.0,1,1.0,1,1.0,1,0.17952870986804714,37
2117,3,7491,1528,5963,0,0,0,1.0,1,1.0,1,1.0,1,0.08663724775681558,38
2118,0,7491,1528,5963,0,0,0,1.0,1,1.0,1,1.0,1,0.09089540979496648,40
2119,1,7492,1529,5963,0,0,0,1.0,1,1.0,1,1.0,1,0.10015882420908304,40
2120,1,7493,1530,5963,0,0,0,1.0,1,1.0,1,1.0,1,0.13002557301566245,41
2121,2,7495,1530,5965,0,0,0,1.0,1,1.0,1,1.0,1,0.0960876480383544,41
2122,1,7496,1530,5966,0,0,0,1.0,1,1.0,1,1.0,1,0.10511923551962724,42
2123,0,7496,1530,5966,0,0,0,1.0,1,1.0,1,1.0,1,0.11513670544142174,43
2124,0,7496,1530,5966,0,0,0,1.0,1,1.0,1,1.0,1,0.11542200931944617,41
2125,0,7496,1530,5966,0,0,0,1.0,1,1.0,1,1.0,1,0.11542200931944617,41
2126,0,7496,1530,5966,0,0,0,1.0,1,1.0,1,1.0,1,0.13663584981878416,40
2127,0,7496,1530,5966,0,0,0,1.0,1,1.0,1,1.0,1,0.13663584981878416,40
2128,0,7496,1530,5966,0,0,0,1.0,1,1.0,1,1.0,1,0.15874820409627222,41
2129,0,7496,1530,5966,0,0,0,1.0,1,1.0,1,1.0,1,0.1686708036894734,42
2130,5,7501,1530,5971,0,0,0,1.0,1,1.0,1,1.0,1,0.15172541658007146,45
2131,1,7502,1530,5972,0,0,0,1.0,1,1.0,1,1.0,1,0.13625028830924868,45
2132,2,7504,1530,5974,0,0,0,1.0,1,1.0,1,1.0,1,0.11857734909962325,46
2133,1,7505,1531,5974,0,0,0,1.0,1,1.0,1,1.0,1,0.13182245192459377,46
2134,3,7508,1532,5976,0,0,0,1.0,1,1.0,1,1.0,1,0.12843494385857754,47
2135,2,7510,1533,5977,0,0,0,1.0,1,1.0,1,1.0,1,0.11307967628484043,47
2136,5,7515,1535,5980,0,0,0,1.0,1,1.0,1,1.0,1,0.16694870551841295,47
2137,3,7518,1535,5983,0,0,0,1.0,1,1.0,1,1.0,1,0.16344210418671498,49
2138,6,7524,1535,5989,0,0,0,1.0,1,1.0,1,1.0,1,0.108665686719357,49
2139,2,7526,1536,5990,0,0,0,1.0,1,1.0,1,1.0,1,0.15361674400295136,47
2140,2,7528,1536,5992,0,0,0,1.0,1,1.0,1,1.0,1,0.16552727091904276,48
2141,3,7531,1537,5994,0,0,0,1.0,1,1.0,1,1.0,1,0.16108606710313597,47
2142,1,7532,1537,5995,0,0,0,1.0,1,1.0,1,1.0,1,0.14642715973423717,47
2143,4,7536,1537,5999,0,0,0,1.0,1,1.0,1,1.0,1,0.15656613312280743,48
2144,5,7541,1540,6001,0,0,0,1.0,1,1.0,1,1.0,1,0.20933990176466188,48
2145,3,7544,1541,6003,0,0,0,1.0,1,1.0,1,1.0,1,0.20351168268728587,46
2146,9,7553,1543,6010,0,0,0,1.0,1,1.0,1,1.0,1,0.15004739184928123,47
2147,2,7555,1544,6011,0,0,0,1.0,1,1.0,1,1.0,1,0.12574237072801275,48
2148,1,7556,1544,6012,0,0,0,1.0,1,1.0,1,1.0,1,0.1454168695582453,46
2149,6,7562,1548,6014,0,0,0,1.0,1,1.0,1,1.0,1,0.1415133282602046,46
2150,5,7567,1550,6017,0,0,0,1.0,1,1.0,1,1.0,1,0.15702580455081236,46
2151,2,7569,1550,6019,0,0,0,1.0,1,1.0,1,1.0,1,0.12530301879463415,44
2152,4,7573,1551,6022,0,0,0,1.0,1,1.0,1,1.0,1,0.1008194212202396,45
2153,3,7576,1552,6024,0,0,0,1.0,1,1.0,1,1.0,1,0.10409115025958249,48
2154,0,7576,1552,6024,0,0,0,1.0,1,1.0,1,1.0,1,0.12467234037930522,47
2155,3,7579,1554,6025,0,0,0,1.0,1,1.0,1,1.0,1,0.18202752271703496,48
2156,2,7581,1555,6026,0,0,0,1.0,1,1.0,1,1.0,1,0.2055744567223715,45
2157,0,7581,1555,6026,0,0,0,1.0,1,1.0,1,1.0,1,0.21363068188498477,43
2158,1,7582,1556,6026,0,0,0,1.0,1,1.0,1,1.0,1,0.18631565027382307,43
2159,3,7585,1558,6027,0,0,0,1.0,1,1.0,1,1.0,1,0.1935101680903646,43
2160,0,7585,1558,6027,0,0,0,1.0,1,1.0,1,1.0,1,0.17334192203227763,41
2161,2,7587,1559,6028,0,0,0,1.0,1,1.0,1,1.0,1,0.13422841314184186,41
2162,4,7591,1561,6030,0,0,0,1.0,1,1.0,1,1.0,1,0.10313740640510435,42
2163,6,7597,1563,6034,0,0,0,1.0,1,1.0,1,1.0,1,0.06497338856306017,43
2164,2,7599,1564,6035,0,0,0,1.0,1,1.0,1,1.0,1,0.13556474547533592,44
2165,0,7599,1564,6035,0,0,0,1.0,1,1.0,1,1.0,1,0.13556474547533592,44
2166,1,7600,1564,6036,0,0,0,1.0,1,1.0,1,1.0,1,0.11974471603457217,46
2167,1,7601,1565,6036,0,0,0,1.0,1,1.0,1,1.0,1,0.144457844515922,46
2168,0,7601,1565,6036,0,0,0,1.0,1,1.0,1,1.0,1,0.1287970000831454,45
2169,3,7604,1565,6039,0,0,0,1.0,1,1.0,1,1.0,1,0.0899844584476314,49
2170,1,7605,1565,6040,0,0,0,1.0,1,1.0,1,1.0,1,0.09915924902324992,49
2171,1,7606,1565,6041,0,0,0,1.0,1,1.0,1,1.0,1,0.09607274385771386,51
2172,0,7606,1565,6041,0,0,0,1.0,1,1.0,1,1.0,1,0.09392628815781111,52
2173,0,7606,1565,6041,0,0,0,1.0,1,1.0,1,1.0,1,0.09392628815781111,52
2174,7,7613,1567,6046,0,0,0,1.0,1,1.0,1,1.0,1,0.10379242965222357,52
2175,4,7617,1568,6049,0,0,0,1.0,1,1.0,1,1.0,1,0.1756238113179282,53
2176,6,7623,1568,6055,0,0,0,1.0,1,1.0,1,1.0,1,0.10579842453494946,54
2177,6,7629,1569,6060,0,0,0,1.0,1,1.0,1,1.0,1,0.11068278374027354,55
2178,1,7630,1570,6060,0,0,0,1.0,1,1.0,1,1.0,1,0.08247645212193168,54
2179,3,7633,1572,6061,0,0,0,1.0,1,1.0,1,1.0,1,0.12641694285069438,52
2180,4,7637,1574,6063,0,0,0,1.0,1,1.0,1,1.0,1,0.15934945499921072,51
2181,2,7639,1575,6064,0,0,0,1.0,1,1.0,1,1.0,1,0.18296966806986678,49
2182,5,7644,1577,6067,0,0,0,1.0,1,1.0,1,1.0,1,0.22106000203193646,49
2183,4,7648,1579,6069,0,0,0,1.0,1,1.0,1,1.0,1,0.18660058675743044,46
2184,2,7650,1580,6070,0,0,0,1.0,1,1.0,1,1.0,1,0.18862361439028538,45
2185,6,7656,1584,6072,0,0,0,1.0,1,1.0,1,1.0,1,0.17861562377793888,44
2186,2,7658,1585,6073,0,0,0,1.0,1,1.0,1,1.0,1,0.21590398321644544,42
2187,5,7663,1589,6074,0,0,0,1.0,1,1.0,1,1.0,1,0.2456707747059574,40
2188,3,7666,1590,6076,0,0,0,1.0,1,1.0,1,1.0,1,0.22835385354386753,38
2189,0,7666,1590,6076,0,0,0,1.0,1,1.0,1,1.0,1,0.25680017882400985,36
2190,2,7668,1592,6076,0,0,0,1.0,1,1.0,1,1.0,1,0.2779900557038275,34
2191,8,7676,1593,6083,0,0,0,1.0,1,1.0,1,1.0,1,0.13478937756211043,34
2192,1,7677,1594,6083,0,0,0,1.0,1,1.0,1,1.0,1,0.1391983341680623,33
2193,0,7677,1594,6083,0,0,0,1.0,1,1.0,1,1.0,1,0.14267943368063318,32
2194,1,7678,1595,6083,0,0,0,1.0,1,1.0,1,1.0,1,0.13908124223695562,32
2195,0,7678,1595,6083,0,0,0,1.0,1,1.0,1,1.0,1,0.14132347883979704,31
2196,3,7681,1597,6084,0,0,0,1.0,1,1.0,1,1.0,1,0.1882184428798127,32
2197,1,7682,1598,6084,0,0,0,1.0,1,1.0,1,1.0,1,0.23948433925103363,31
2198,2,7684,1599,6085,0,0,0,1.0,1,1.0,1,1.0,1,0.2275829008197507,31
2199,2,7686,1600,6086,0,0,0,1.0,1,1.0,1,1.0,1,0.23128144030533476,32
2200,1,7687,1600,6087,0,0,0,1.0,1,1.0,1,1.0,1,0.26346147804060327,35
2201,2,7689,1600,6089,0,0,0,1.0,1,1.0,1,1.0,1,0.2539146994087413,36
2202,5,7694,1604,6090,0,0,0,1.0,1,1.0,1,1.0,1,0.20302777911953024,36
2203,6,7700,1605,6095,0,0,0,1.0,1,1.0,1,1.0,1,0.20275234409454662,37
2204,2,7702,1606,6096,0,0,0,1.0,1,1.0,1,1.0,1,0.1697179544886247,36
2205,6,7708,1607,6101,0,0,0,1.0,1,1.0,1,1.0,1,0.17573886979999068,37
2206,1,7709,1607,6102,0,0,0,1.0,1,1.0,1,1.0,1,0.1488567049353967,35
2207,6,7715,1609,6106,0,0,0,1.0,1,1.0,1,1.0,1,0.09874736285459045,37
2208,1,7716,1610,6106,0,0,0,1.0,1,1.0,1,1.0,1,0.14741810341120715,36
2209,0,7716,1610,6106,0,0,0,1.0,1,1.0,1,1.0,1,0.17438443672764753,35
2210,0,7716,1610,6106,0,0,0,1.0,1,1.0,1,1.0,1,0.20052724131677319,38
2211,0,7716,1610,6106,0,0,0,1.0,1,1.0,1,1.0,1,0.23021793074468935,37
2212,3,7719,1610,6109,0,0,0,1.0,1,1.0,1,1.0,1,0.2114161975600722,38
2213,3,7722,1611,6111,0,0,0,1.0,1,1.0,1,1.0,1,0.1833033119418331,38
2214,3,7725,1611,6114,0,0,0,1.0,1,1.0,1,1.0,1,0.11495598751706727,39
2215,0,7725,1611,6114,0,0,0,1.0,1,1.0,1,1.0,1,0.10154226882552288,39
2216,2,7727,1613,6114,0,0,0,1.0,1,1.0,1,1.0,1,0.17020032140985866,39
2217,1,7728,1614,6114,0,0,0,1.0,1,1.0,1,1.0,1,0.14983258648869313,38
2218,3,7731,1616,6115,0,0,0,1.0,1,1.0,1,1.0,1,0.23302144971265876,37
2219,2,7733,1616,6117,0,0,0,1.0,1,1.0,1,1.0,1,0.20931657464427014,36
2220,3,7736,1616,6120,0,0,0,1.0,1,1.0,1,1.0,1,0.23047963872881821,34
2221,7,7743,1618,6125,0,0,0,1.0,1,1.0,1,1.0,1,0.1407546010110362,35
2222,2,7745,1619,6126,0,0,0,1.0,1,1.0,1,1.0,1,0.13973954250250398,33
2223,3,7748,1620,6128,0,0,0,1.0,1,1.0,1,1.0,1,0.12926584538903382,34
2224,1,7749,1621,6128,0,0,0,1.0,1,1.0,1,1.0,1,0.16871588066316395,32
2225,4,7753,1622,6131,0,0,0,1.0,1,1.0,1,1.0,1,0.22199282970065468,33
2226,2,7755,1623,6132,0,0,0,1.0,1,1.0,1,1.0,1,0.22676081591900787,32
2227,2,7757,1624,6133,0,0,0,1.0,1,1.0,1,1.0,1,0.2371327401428482,31
2228,2,7759,1625,6134,0,0,0,1.0,1,1.0,1,1.0,1,0.24939289675568496,32
2229,2,7761,1626,6135,0,0,0,1.0,1,1.0,1,1.0,1,0.19619903820964904,32
2230,0,7761,1626,6135,0,0,0,1.0,1,1.0,1,1.0,1,0.218348546854768,31
2231,0,7761,1626,6135,0,0,0,1.0,1,1.0,1,1.0,1,0.1993802380044333,32
2232,2,7763,1627,6136,0,0,0,1.0,1,1.0,1,1.0,1,0.18764557325799572,32
2233,1,7764,1627,6137,0,0,0,1.0,1,1.0,1,1.0,1,0.19449380472507483,31
2234,2,7766,1628,6138,0,0,0,1.0,1,1.0,1,1.0,1,0.2202276541708817,32
2235,1,7767,1628,6139,0,0,0,1.0,1,1.0,1,1.0,1,0.26636935703767506,31
2236,5,7772,1629,6143,0,0,0,1.0,1,1.0,1,1.0,1,0.1594500553326598,31
2237,4,7776,1631,6145,0,0,0,1.0,1,1.0,1,1.0,1,0.22927645450476467,31
2238,2,7778,1631,6147,0,0,0,1.0,1,1.0,1,1.0,1,0.22017137306336712,31
2239,3,7781,1631,6150,0,0,0,1.0,1,1.0,1,1.0,1,0.2226574634628548,31
2240,2,7783,1631,6152,0,0,0,1.0,1,1.0,1,1.0,1,0.2274823595887829,32
2241,4,7787,1632,6155,0,0,0,1.0,1,1.0,1,1.0,1,0.22643429986627117,32
2242,4,7791,1633,6158,0,0,0,1.0,1,1.0,1,1.0,1,0.17533706585736003,34
2243,3,7794,1634,6160,0,0,0,1.0,1,1.0,1,1.0,1,0.1614068301068802,34
2244,2,7796,1634,6162,0,0,0,1.0,1,1.0,1,1.0,1,0.2366183612222564,36
2245,4,7800,1634,6166,0,0,0,1.0,1,1.0,1,1.0,1,0.2366183612222564,36
2246,5,7805,1634,6171,0,0,0,1.0,1,1.0,1,1.0,1,0.16233516937048062,39
2247,2,7807,1634,6173,0,0,0,1.0,1,1.0,1,1.0,1,0.16899510749559427,40
2248,4,7811,1634,6177,0,0,0,1.0,1,1.0,1,1.0,1,0.16899510749559427,40
2249,5,7816,1634,6182,0,0,0,1.0,1,1.0,1,1.0,1,0.18362974846873323,41
2250,3,7819,1634,6185,0,0,0,1.0,1,1.0,1,1.0,1,0.16254910697859268,41
2251,2,7821,1634,6187,0,0,0,1.0,1,1.0,1,1.0,1,0.16123009653891693,42
2252,1,7822,1634,6188,0,0,0,1.0,1,1.0,1,1.0,1,0.14788648751130823,41
2253,0,7822,1634,6188,0,0,0,1.0,1,1.0,1,1.0,1,0.15978179955279115,40
2254,1,7823,1635,6188,0,0,0,1.0,1,1.0,1,1.0,1,0.19702458941586876,39
2255,2,7825,1636,6189,0,0,0,1.0,1,1.0,1,1.0,1,0.20414906041338038,39
2256,3,7828,1638,6190,0,0,0,1.0,1,1.0,1,1.0,1,0.2444478438502855,40
2257,2,7830,1639,6191,0,0,0,1.0,1,1.0,1,1.0,1,0.22910753189994956,40
2258,2,7832,1641,6191,0,0,0,1.0,1,1.0,1,1.0,1,0.21551272737867125,39
2259,5,7837,1643,6194,0,0,0,1.0,1,1.0,1,1.0,1,0.16286799802064003,41
2260,1,7838,1644,6194,0,0,0,1.0,1,1.0,1,1.0,1,0.18938243000835522,38
2261,3,7841,1646,6195,0,0,0,1.0,1,1.0,1,1.0,1,0.22080444692558854,38
2262,1,7842,1646,6196,0,0,0,1.0,1,1.0,1,1.0,1,0.2833448616348475,36
2263,1,7843,1647,6196,0,0,0,1.0,1,1.0,1,1.0,1,0.2860744808704111,35
2264,2,7845,1649,6196,0,0,0,1.0,1,1.0,1,1.0,1,0.31416635223672335,33
2265,2,7847,1650,6197,0,0,0,1.0,1,1.0,1,1.0,1,0.30282235725965895,33
2266,10,7857,1652,6205,0,0,0,1.0,1,1.0,1,1.0,1,0.20428804513469223,33
2267,7,7864,1655,6209,0,0,0,1.0,1,1.0,1,1.0,1,0.16059481589346844,33
2268,4,7868,1657,6211,0,0,0,1.0,1,1.0,1,1.0,1,0.1560284507432765,35
2269,4,7872,1659,6213,0,0,0,1.0,1,1.0,1,1.0,1,0.18269434778698737,36
2270,5,7877,1660,6217,0,0,0,1.0,1,1.0,1,1.0,1,0.1254868076209834,34
2271,6,7883,1661,6222,0,0,0,1.0,1,1.0,1,1.0,1,0.15729327839520335,34
2272,4,7887,1662,6225,0,0,0,1.0,1,1.0,1,1.0,1,0.2099683198097616,33
2273,5,7892,1663,6229,0,0,0,1.0,1,1.0,1,1.0,1,0.21864573941160012,32
2274,5,7897,1664,6233,0,0,0,1.0,1,1.0,1,1.0,1,0.2729797711936477,32
2275,3,7900,1664,6236,0,0,0,1.0,1,1.0,1,1.0,1,0.28794568693833184,32
2276,7,7907,1665,6242,0,0,0,1.0,1,1.0,1,1.0,1,0.29485266748161204,31
2277,4,7911,1666,6245,0,0,0,1.0,1,1.0,1,1.0,1,0.31597664305950046,30
2278,6,7917,1666,6251,0,0,0,1.0,1,1.0,1,1.0,1,0.29323179843001024,33
2279,6,7923,1666,6257,0,0,0,1.0,1,1.0,1,1.0,1,0.30881563122374395,33
2280,5,7928,1666,6262,0,0,0,1.0,1,1.0,1,1.0,1,0.2934656928568837,35
2281,7,7935,1666,6269,0,0,0,1.0,1,1.0,1,1.0,1,0.1996156598022754,36
2282,0,7935,1666,6269,0,0,0,1.0,1,1.0,1,1.0,1,0.1996156598022754,36
2283,0,7935,1666,6269,0,0,0,1.0,1,1.0,1,1.0,1,0.1996156598022754,36
2284,1,7936,1666,6270,0,0,0,1.0,1,1.0,1,1.0,1,0.1805016791165995,36
2285,2,7938,1666,6272,0,0,0,1.0,1,1.0,1,1.0,1,0.162592918822458,37
2286,3,7941,1668,6273,0,0,0,1.0,1,1.0,1,1.0,1,0.17531603998264508,38
2287,0,7941,1668,6273,0,0,0,1.0,1,1.0,1,1.0,1,0.17321715969171417,38
2288,4,7945,1669,6276,0,0,0,1.0,1,1.0,1,1.0,1,0.14373251003307777,40
2289,2,7947,1669,6278,0,0,0,1.0,1,1.0,1,1.0,1,0.1851940466771392,40
2290,1,7948,1669,6279,0,0,0,1.0,1,1.0,1,1.0,1,0.19364725727648274,39
2291,1,7949,1669,6280,0,0,0,1.0,1,1.0,1,1.0,1,0.165592715902317,37
2292,1,7950,1669,6281,0,0,0,1.0,1,1.0,1,1.0,1,0.18511275782268352,35
2293,1,7951,1669,6282,0,0,0,1.0,1,1.0,1,1.0,1,0.20307836395909992,35
2294,4,7955,1669,6286,0,0,0,1.0,1,1.0,1,1.0,1,0.15055683898000366,35
2295,4,7959,1670,6289,0,0,0,1.0,1,1.0,1,1.0,1,0.1585370127235069,36
2296,0,7959,1670,6289,0,0,0,1.0,1,1.0,1,1.0,1,0.17770939342388814,34
2297,2,7961,1670,6291,0,0,0,1.0,1,1.0,1,1.0,1,0.17110910073683858,35
2298,1,7962,1671,6291,0,0,0,1.0,1,1.0,1,1.0,1,0.18818893605445364,34
2299,3,7965,1673,6292,0,0,0,1.0,1,1.0,1,1.0,1,0.21771282902677974,35
2300,1,7966,1673,6293,0,0,0,1.0,1,1.0,1,1.0,1,0.18056522574516176,35
2301,0,7966,1673,6293,0,0,0,1.0,1,1.0,1,1.0,1,0.18056522574516176,35
2302,3,7969,1675,6294,0,0,0,1.0,1,1.0,1,1.0,1,0.16869075368215017,37
2303,0,7969,1675,6294,0,0,0,1.0,1,1.0,1,1.0,1,0.12405625793315336,35
2304,2,7971,1677,6294,0,0,0,1.0,1,1.0,1,1.0,1,0.20128108196856948,36
2305,0,7971,1677,6294,0,0,0,1.0,1,1.0,1,1.0,1,0.21951540367155942,34
2306,1,7972,1677,6295,0,0,0,1.0,1,1.0,1,1.0,1,0.1924549728350546,35
2307,2,7974,1677,6297,0,0,0,1.0,1,1.0,1,1.0,1,0.21159370511686088,35
2308,2,7976,1678,6298,0,0,0,1.0,1,1.0,1,1.0,1,0.16675633935936615,35
2309,1,7977,1678,6299,0,0,0,1.0,1,1.0,1,1.0,1,0.16828314377067655,34
2310,4,7981,1679,6302,0,0,0,1.0,1,1.0,1,1.0,1,0.19539879109869124,36
2311,2,7983,1679,6304,0,0,0,1.0,1,1.0,1,1.0,1,0.1690143445269803,38
2312,4,7987,1682,6305,0,0,0,1.0,1,1.0,1,1.0,1,0.2093529727430333,39
2313,2,7989,1682,6307,0,0,0,1.0,1,1.0,1,1.0,1,0.15698053915981958,39
2314,2,7991,1683,6308,0,0,0,1.0,1,1.0,1,1.0,1,0.1969422430797124,39
2315,5,7996,1685,6311,0,0,0,1.0,1,1.0,1,1.0,1,0.11919790295372482,40
2316,0,7996,1685,6311,0,0,0,1.0,1,1.0,1,1.0,1,0.11919790295372482,40
2317,4,8000,1686,6314,0,0,0,1.0,1,1.0,1,1.0,1,0.1467490205365382,41
2318,3,8003,1687,6316,0,0,0,1.0,1,1.0,1,1.0,1,0.16371625649239224,41
2319,2,8005,1687,6318,0,0,0,1.0,1,1.0,1,1.0,1,0.16601109316322168,41
2320,2,8007,1687,6320,0,0,0,1.0,1,1.0,1,1.0,1,0.20020468593596294,42
2321,4,8011,1688,6323,0,0,0,1.0,1,1.0,1,1.0,1,0.15153915592752015,43
2322,2,8013,1688,6325,0,0,0,1.0,1,1.0,1,1.0,1,0.12917428875046436,42
2323,3,8016,1689,6327,0,0,0,1.0,1,1.0,1,1.0,1,0.2007265262573578,43
2324,8,8024,1689,6335,0,0,0,1.0,1,1.0,1,1.0,1,0.2133820346179696,44
2325,6,8030,1690,6340,0,0,0,1.0,1,1.0,1,1.0,1,0.2236457919078233,44
2326,6,8036,1690,6346,0,0,0,1.0,1,1.0,1,1.0,1,0.12711380497088187,45
2327,3,8039,1690,6349,0,0,0,1.0,1,1.0,1,1.0,1,0.10241350474836217,45
2328,2,8041,1690,6351,0,0,0,1.0,1,1.0,1,1.0,1,0.08776616817505545,46
2329,1,8042,1690,6352,0,0,0,1.0,1,1.0,1,1.0,1,0.10626030909191429,45
2330,3,8045,1691,6354,0,0,0,1.0,1,1.0,1,1.0,1,0.11424043911062196,47
2331,6,8051,1691,6360,0,0,0,1.0,1,1.0,1,1.0,1,0.05881638163615389,48
2332,1,8052,1691,6361,0,0,0,1.0,1,1.0,1,1.0,1,0.1025100819002698,48
2333,2,8054,1691,6363,0,0,0,1.0,1,1.0,1,1.0,1,0.09788751292724227,49
2334,1,8055,1691,6364,0,0,0,1.0,1,1.0,1,1.0,1,0.11314743941371318,47
2335,3,8058,1692,6366,0,0,0,1.0,1,1.0,1,1.0,1,0.14215556741319388,46
2336,3,8061,1692,6369,0,0,0,1.0,1,1.0,1,1.0,1,0.13504153567942184,46
2337,2,8063,1692,6371,0,0,0,1.0,1,1.0,1,1.0,1,0.17937476732379362,45
2338,6,8069,1692,6377,0,0,0,1.0,1,1.0,1,1.0,1,0.173189047501863,44
2339,7,8076,1692,6384,0,0,0,1.0,1,1.0,1,1.0,1,0.18101805381001887,45
2340,6,8082,1692,6390,0,0,0,1.0,1,1.0,1,1.0,1,0.22758243256680247,44
2341,7,8089,1692,6397,0,0,0,1.0,1,1.0,1,1.0,1,0.08226240260674955,45
2342,0,8089,1692,6397,0,0,0,1.0,1,1.0,1,1.0,1,0.0791310274997232,47
2343,2,8091,1693,6398,0,0,0,1.0,1,1.0,1,1.0,1,0.11790472095517392,46
2344,3,8094,1693,6401,0,0,0,1.0,1,1.0,1,1.0,1,0.10670216810326247,46
2345,1,8095,1693,6402,0,0,0,1.0,1,1.0,1,1.0,1,0.12899609468890597,45
2346,0,8095,1693,6402,0,0,0,1.0,1,1.0,1,1.0,1,0.11857970943885737,46
2347,0,8095,1693,6402,0,0,0,1.0,1,1.0,1,1.0,1,0.12572577231887455,47
2348,3,8098,1695,6403,0,0,0,1.0,1,1.0,1,1.0,1,0.17387481051194836,49
2349,6,8104,1696,6408,0,0,0,1.0,1,1.0,1,1.0,1,0.19362274072526886,49
2350,4,8108,1696,6412,0,0,0,1.0,1,1.0,1,1.0,1,0.1913189623610569,50
2351,7,8115,1697,6418,0,0,0,1.0,1,1.0,1,1.0,1,0.19816778881340993,50
2352,4,8119,1697,6422,0,0,0,1.0,1,1.0,1,1.0,1,0.19834832419741183,51
2353,8,8127,1697,6430,0,0,0,1.0,1,1.0,1,1.0,1,0.17554160387741258,51
2354,8,8135,1697,6438,0,0,0,1.0,1,1.0,1,1.0,1,0.1838547468112196,51
2355,3,8138,1698,6440,0,0,0,1.0,1,1.0,1,1.0,1,0.19353941209857964,50
2356,4,8142,1699,6443,0,0,0,1.0,1,1.0,1,1.0,1,0.14551959616538424,50
2357,3,8145,1701,6444,0,0,0,1.0,1,1.0,1,1.0,1,0.15038622674080238,49
2358,1,8146,1701,6445,0,0,0,1.0,1,1.0,1,1.0,1,0.16702856711033062,51
2359,3,8149,1701,6448,0,0,0,1.0,1,1.0,1,1.0,1,0.16861665501926978,51
2360,4,8153,1702,6451,0,0,0,1.0,1,1.0,1,1.0,1,0.1673966158188743,51
2361,3,8156,1702,6454,0,0,0,1.0,1,1.0,1,1.0,1,0.18118384815904523,52
2362,5,8161,1702,6459,0,0,0,1.0,1,1.0,1,1.0,1,0.1246555085399289,53
2363,2,8163,1703,6460,0,0,0,1.0,1,1.0,1,1.0,1,0.13738477273617633,54
2364,4,8167,1704,6463,0,0,0,1.0,1,1.0,1,1.0,1,0.11710036747141496,55
2365,7,8174,1707,6467,0,0,0,1.0,1,1.0,1,1.0,1,0.15375598216441094,53
2366,3,8177,1709,6468,0,0,0,1.0,1,1.0,1,1.0,1,0.1464223537778177,53
2367,5,8182,1712,6470,0,0,0,1.0,1,1.0,1,1.0,1,0.252427873405389,51
2368,6,8188,1714,6474,0,0,0,1.0,1,1.0,1,1.0,1,0.2747695155898156,50
2369,6,8194,1715,6479,0,0,0,1.0,1,1.0,1,1.0,1,0.32002202595757157,47
2370,3,8197,1715,6482,0,0,0,1.0,1,1.0,1,1.0,1,0.2938391815853051,48
2371,11,8208,1717,6491,0,0,0,1.0,1,1.0,1,1.0,1,0.20307097554644385,49
2372,2,8210,1717,6493,0,0,0,1.0,1,1.0,1,1.0,1,0.21709189229271847,48
2373,2,8212,1717,6495,0,0,0,1.0,1,1.0,1,1.0,1,0.21370555574004474,49
2374,0,8212,1717,6495,0,0,0,1.0,1,1.0,1,1.0,1,0.2076714676249855,50
2375,0,8212,1717,6495,0,0,0,1.0,1,1.0,1,1.0,1,0.2076714676249855,50
2376,3,8215,1717,6498,0,0,0,1.0,1,1.0,1,1.0,1,0.1795932019805889,50
2377,0,8215,1717,6498,0,0,0,1.0,1,1.0,1,1.0,1,0.19343347578423042,49
2378,0,8215,1717,6498,0,0,0,1.0,1,1.0,1,1.0,1,0.19343347578423042,49
2379,3,8218,1718,6500,0,0,0,1.0,1,1.0,1,1.0,1,0.20598561639648558,50
2380,8,8226,1719,6507,0,0,0,1.0,1,1.0,1,1.0,1,0.21795934925736915,50
2381,7,8233,1720,6513,0,0,0,1.0,1,1.0,1,1.0,1,0.23262642409949733,51
2382,4,8237,1720,6517,0,0,0,1.0,1,1.0,1,1.0,1,0.2306192002655401,51
2383,9,8246,1720,6526,0,0,0,1.0,1,1.0,1,1.0,1,0.20053788511358986,52
2384,7,8253,1722,6531,0,0,0,1.0,1,1.0,1,1.0,1,0.14145600437555975,52
2385,5,8258,1723,6535,0,0,0,1.0,1,1.0,1,1.0,1,0.15067211811283948,51
2386,6,8264,1724,6540,0,0,0,1.0,1,1.0,1,1.0,1,0.1295056103275084,52
2387,3,8267,1725,6542,0,0,0,1.0,1,1.0,1,1.0,1,0.15374189627163665,49
2388,0,8267,1725,6542,0,0,0,1.0,1,1.0,1,1.0,1,0.16402381382680126,48
2389,2,8269,1726,6543,0,0,0,1.0,1,1.0,1,1.0,1,0.1397503473120278,48
2390,1,8270,1727,6543,0,0,0,1.0,1,1.0,1,1.0,1,0.1322247470452593,49
2391,3,8273,1729,6544,0,0,0,1.0,1,1.0,1,1.0,1,0.2150650183199019,48
2392,3,8276,1731,6545,0,0,0,1.0,1,1.0,1,1.0,1,0.23021373339015372,49
2393,6,8282,1732,6550,0,0,0,1.0,1,1.0,1,1.0,1,0.173063342891902,50
2394,3,8285,1734,6551,0,0,0,1.0,1,1.0,1,1.0,1,0.19109311463515744,50
2395,3,8288,1735,6553,0,0,0,1.0,1,1.0,1,1.0,1,0.19757525327224262,49
2396,2,8290,1736,6554,0,0,0,1.0,1,1.0,1,1.0,1,0.18593224913678424,50
2397,6,8296,1738,6558,0,0,0,1.0,1,1.0,1,1.0,1,0.18753407933884847,51
2398,4,8300,1739,6561,0,0,0,1.0,1,1.0,1,1.0,1,0.22302662247560084,49
2399,1,8301,1739,6562,0,0,0,1.0,1,1.0,1,1.0,1,0.22955949503531303,50
2400,3,8304,1740,6564,0,0,0,1.0,1,1.0,1,1.0,1,0.2438779532210517,51
2401,7,8311,1740,6571,0,0,0,1.0,1,1.0,1,1.0,1,0.14126929469798477,50
2402,1,8312,1740,6572,0,0,0,1.0,1,1.0,1,1.0,1,0.13795989853698937,51
2403,0,8312,1740,6572,0,0,0,1.0,1,1.0,1,1.0,1,0.13284121497447016,52
2404,2,8314,1740,6574,0,0,0,1.0,1,1.0,1,1.0,1,0.1032392677687397,53
2405,0,8314,1740,6574,0,0,0,1.0,1,1.0,1,1.0,1,0.09849080648634675,52
2406,1,8315,1741,6574,0,0,0,1.0,1,1.0,1,1.0,1,0.1183747266797434,52
2407,1,8316,1742,6574,0,0,0,1.0,1,1.0,1,1.0,1,0.16568416093938718,51
2408,0,8316,1742,6574,0,0,0,1.0,1,1.0,1,1.0,1,0.16286073794380485,50
2409,2,8318,1742,6576,0,0,0,1.0,1,1.0,1,1.0,1,0.18370739568888314,50
2410,1,8319,1743,6576,0,0,0,1.0,1,1.0,1,1.0,1,0.2504415383871505,49
2411,2,8321,1743,6578,0,0,0,1.0,1,1.0,1,1.0,1,0.2337684112688267,48
2412,2,8323,1743,6580,0,0,0,1.0,1,1.0,1,1.0,1,0.22449607619850925,47
2413,0,8323,1743,6580,0,0,0,1.0,1,1.0,1,1.0,1,0.20514341535085787,47
2414,7,8330,1744,6586,0,0,0,1.0,1,1.0,1,1.0,1,0.26144126926362565,47
2415,4,8334,1744,6590,0,0,0,1.0,1,1.0,1,1.0,1,0.23081178080168663,46
2416,7,8341,1744,6597,0,0,0,1.0,1,1.0,1,1.0,1,0.1630101898385637,47
2417,4,8345,1745,6600,0,0,0,1.0,1,1.0,1,1.0,1,0.140358790827049,46
2418,4,8349,1747,6602,0,0,0,1.0,1,1.0,1,1.0,1,0.1700493966777125,48
2419,0,8349,1747,6602,0,0,0,1.0,1,1.0,1,1.0,1,0.17772082823634167,47
2420,3,8352,1747,6605,0,0,0,1.0,1,1.0,1,1.0,1,0.14873830998003545,49
2421,7,8359,1747,6612,0,0,0,1.0,1,1.0,1,1.0,1,0.17410126214924077,50
2422,6,8365,1749,6616,0,0,0,1.0,1,1.0,1,1.0,1,0.14631164937215788,50
2423,3,8368,1749,6619,0,0,0,1.0,1,1.0,1,1.0,1,0.15161399075088416,51
2424,9,8377,1753,6624,0,0,0,1.0,1,1.0,1,1.0,1,0.19271498669325293,50
2425,4,8381,1753,6628,0,0,0,1.0,1,1.0,1,1.0,1,0.19899663052726765,48
2426,9,8390,1756,6634,0,0,0,1.0,1,1.0,1,1.0,1,0.18641969865779845,51
2427,6,8396,1757,6639,0,0,0,1.0,1,1.0,1,1.0,1,0.2190984829707323,50
2428,10,8406,1758,6648,0,0,0,1.0,1,1.0,1,1.0,1,0.1826895967035732,49
2429,7,8413,1759,6654,0,0,0,1.0,1,1.0,1,1.0,1,0.19087170410000354,49
2430,4,8417,1759,6658,0,0,0,1.0,1,1.0,1,1.0,1,0.2590394755962735,46
2431,6,8423,1761,6662,0,0,0,1.0,1,1.0,1,1.0,1,0.19044099390864033,45
2432,4,8427,1762,6665,0,0,0,1.0,1,1.0,1,1.0,1,0.2739929313527516,44
2433,4,8431,1763,6668,0,0,0,1.0,1,1.0,1,1.0,1,0.1967019778352724,45
2434,1,8432,1763,6669,0,0,0,1.0,1,1.0,1,1.0,1,0.17482265252296195,44
2435,2,8434,1763,6671,0,0,0,1.0,1,1.0,1,1.0,1,0.14535255846518225,44
2436,0,8434,1763,6671,0,0,0,1.0,1,1.0,1,1.0,1,0.14535255846518225,44
2437,2,8436,1765,6671,0,0,0,1.0,1,1.0,1,1.0,1,0.17677328729662856,45
2438,1,8437,1766,6671,0,0,0,1.0,1,1.0,1,1.0,1,0.20225732019465728,45
2439,3,8440,1767,6673,0,0,0,1.0,1,1.0,1,1.0,1,0.16663062080668825,46
2440,3,8443,1768,6675,0,0,0,1.0,1,1.0,1,1.0,1,0.1814275831405089,45
2441,3,8446,1769,6677,0,0,0,1.0,1,1.0,1,1.0,1,0.21347809454947878,45
2442,4,8450,1769,6681,0,0,0,1.0,1,1.0,1,1.0,1,0.19496160472670107,46
2443,3,8453,1769,6684,0,0,0,1.0,1,1.0,1,1.0,1,0.19980170670897096,45
2444,5,8458,1771,6687,0,0,0,1.0,1,1.0,1,1.0,1,0.1952474807983628,46
2445,1,8459,1771,6688,0,0,0,1.0,1,1.0,1,1.0,1,0.20866493087862978,44
2446,8,8467,1774,6693,0,0,0,1.0,1,1.0,1,1.0,1,0.1411244237700555,44
2447,0,8467,1774,6693,0,0,0,1.0,1,1.0,1,1.0,1,0.17552763214618583,42
2448,2,8469,1776,6693,0,0,0,1.0,1,1.0,1,1.0,1,0.22203792332081174,41
2449,2,8471,1776,6695,0,0,0,1.0,1,1.0,1,1.0,1,0.20368892709925485,40
2450,2,8473,1777,6696,0,0,0,1.0,1,1.0,1,1.0,1,0.162706745173297,42
2451,1,8474,1778,6696,0,0,0,1.0,1,1.0,1,1.0,1,0.19378962946189443,43
2452,1,8475,1779,6696,0,0,0,1.0,1,1.0,1,1.0,1,0.18632993260017686,43
2453,1,8476,1779,6697,0,0,0,1.0,1,1.0,1,1.0,1,0.18827266814058188,45
2454,5,8481,1780,6701,0,0,0,1.0,1,1.0,1,1.0,1,0.19817546477869288,47
2455,2,8483,1780,6703,0,0,0,1.0,1,1.0,1,1.0,1,0.19987082987718857,48
2456,1,8484,1781,6703,0,0,0,1.0,1,1.0,1,1.0,1,0.19927933638547082,49
2457,0,8484,1781,6703,0,0,0,1.0,1,1.0,1,1.0,1,0.20228973138963935,48
2458,1,8485,1781,6704,0,0,0,1.0,1,1.0,1,1.0,1,0.19223827871362723,49
2459,2,8487,1781,6706,0,0,0,1.0,1,1.0,1,1.0,1,0.14769259359838643,49
2460,1,8488,1782,6706,0,0,0,1.0,1,1.0,1,1.0,1,0.15905178817982465,50
2461,2,8490,1783,6707,0,0,0,1.0,1,1.0,1,1.0,1,0.17658118271244977,50
2462,3,8493,1785,6708,0,0,0,1.0,1,1.0,1,1.0,1,0.20392538041313904,51
2463,8,8501,1789,6712,0,0,0,1.0,1,1.0,1,1.0,1,0.2124562542436005,51
2464,1,8502,1790,6712,0,0,0,1.0,1,1.0,1,1.0,1,0.20706681008370648,50
2465,2,8504,1792,6712,0,0,0,1.0,1,1.0,1,1.0,1,0.22155014918220312,49
2466,2,8506,1794,6712,0,0,0,1.0,1,1.0,1,1.0,1,0.2284047319408283,49
2467,1,8507,1795,6712,0,0,0,1.0,1,1.0,1,1.0,1,0.22444117453502313,48
2468,1,8508,1796,6712,0,0,0,1.0,1,1.0,1,1.0,1,0.24663512751317945,47
2469,1,8509,1797,6712,0,0,0,1.0,1,1.0,1,1.0,1,0.23467682828374947,46
2470,1,8510,1798,6712,0,0,0,1.0,1,1.0,1,1.0,1,0.26163907657068497,44
2471,0,8510,1798,6712,0,0,0,1.0,1,1.0,1,1.0,1,0.2729085788018613,44
2472,3,8513,1798,6715,0,0,0,1.0,1,1.0,1,1.0,1,0.302001591405676,44
2473,1,8514,1798,6716,0,0,0,1.0,1,1.0,1,1.0,1,0.29992330709479936,43
2474,4,8518,1802,6716,0,0,0,1.0,1,1.0,1,1.0,1,0.2994303134412617,44
2475,1,8519,1803,6716,0,0,0,1.0,1,1.0,1,1.0,1,0.294120613571872,46
2476,12,8531,1803,6728,0,0,0,1.0,1,1.0,1,1.0,1,0.06592532072948039,46
2477,1,8532,1804,6728,0,0,0,1.0,1,1.0,1,1.0,1,0.07839043327337583,46
2478,1,8533,1805,6728,0,0,0,1.0,1,1.0,1,1.0,1,0.12406646305571277,46
2479,2,8535,1806,6729,0,0,0,1.0,1,1.0,1,1.0,1,0.09082099665239461,46
2480,2,8537,1806,6731,0,0,0,1.0,1,1.0,1,1.0,1,0.10628256139749377,47
2481,1,8538,1807,6731,0,0,0,1.0,1,1.0,1,1.0,1,0.10847205611879442,47
2482,3,8541,1808,6733,0,0,0,1.0,1,1.0,1,1.0,1,0.11527653328055444,45
2483,2,8543,1808,6735,0,0,0,1.0,1,1.0,1,1.0,1,0.10964889274161789,45
2484,1,8544,1809,6735,0,0,0,1.0,1,1.0,1,1.0,1,0.1199851852088335,46
2485,3,8547,1810,6737,0,0,0,1.0,1,1.0,1,1.0,1,0.1308264825187768,44
2486,2,8549,1810,6739,0,0,0,1.0,1,1.0,1,1.0,1,0.11769093139665093,43
2487,2,8551,1811,6740,0,0,0,1.0,1,1.0,1,1.0,1,0.14597276568869966,44
2488,2,8553,1812,6741,0,0,0,1.0,1,1.0,1,1.0,1,0.13956078074650569,45
2489,5,8558,1814,6744,0,0,0,1.0,1,1.0,1,1.0,1,0.18013651880535667,44
2490,2,8560,1816,6744,0,0,0,1.0,1,1.0,1,1.0,1,0.19399048966267426,44
2491,4,8564,1816,6748,0,0,0,1.0,1,1.0,1,1.0,1,0.13395009979011557,44
2492,1,8565,1817,6748,0,0,0,1.0,1,1.0,1,1.0,1,0.1502721612925719,44
2493,0,8565,1817,6748,0,0,0,1.0,1,1.0,1,1.0,1,0.17354534957549747,42
2494,1,8566,1818,6748,0,0,0,1.0,1,1.0,1,1.0,1,0.19652347919198826,42
2495,3,8569,1819,6750,0,0,0,1.0,1,1.0,1,1.0,1,0.20495907506861466,42
2496,0,8569,1819,6750,0,0,0,1.0,1,1.0,1,1.0,1,0.20495907506861466,42
2497,2,8571,1819,6752,0,0,0,1.0,1,1.0,1,1.0,1,0.2174475286970679,44
2498,3,8574,1820,6754,0,0,0,1.0,1,1.0,1,1.0,1,0.21343561751915133,43
2499,1,8575,1820,6755,0,0,0,1.0,1,1.0,1,1.0,1,0.2322213619910777,43
2500,3,8578,1820,6758,0,0,0,1.0,1,1.0,1,1.0,1,0.20925067328375388,44
2501,4,8582,1821,6761,0,0,0,1.0,1,1.0,1,1.0,1,0.21472816466050504,46
2502,5,8587,1824,6763,0,0,0,1.0,1,1.0,1,1.0,1,0.2182089134225849,47
2503,3,8590,1825,6765,0,0,0,1.0,1,1.0,1,1.0,1,0.21600935099817575,47
2504,4,8594,1827,6767,0,0,0,1.0,1,1.0,1,1.0,1,0.2644689839885743,46
2505,6,8600,1829,6771,0,0,0,1.0,1,1.0,1,1.0,1,0.22186904805533753,46
2506,7,8607,1830,6777,0,0,0,1.0,1,1.0,1,1.0,1,0.16479994346865745,45
2507,0,8607,1830,6777,0,0,0,1.0,1,1.0,1,1.0,1,0.18586024141436333,45
2508,4,8611,1832,6779,0,0,0,1.0,1,1.0,1,1.0,1,0.14465907299088449,46
2509,5,8616,1835,6781,0,0,0,1.0,1,1.0,1,1.0,1,0.14147503191193037,45
2510,6,8622,1836,6786,0,0,0,1.0,1,1.0,1,1.0,1,0.1392517383952678,46
2511,4,8626,1836,6790,0,0,0,1.0,1,1.0,1,1.0,1,0.14124331125794162,47
2512,2,8628,1836,6792,0,0,0,1.0,1,1.0,1,1.0,1,0.124332240399718,47
2513,2,8630,1836,6794,0,0,0,1.0,1,1.0,1,1.0,1,0.11692430048840396,48
2514,6,8636,1837,6799,0,0,0,1.0,1,1.0,1,1.0,1,0.1614763236133107,48
2515,4,8640,1838,6802,0,0,0,1.0,1,1.0,1,1.0,1,0.16888884602928517,49
2516,4,8644,1839,6805,0,0,0,1.0,1,1.0,1,1.0,1,0.1890192460273296,49
2517,9,8653,1842,6811,0,0,0,1.0,1,1.0,1,1.0,1,0.15598940547743495,49
2518,2,8655,1842,6813,0,0,0,1.0,1,1.0,1,1.0,1,0.16722637012663688,48
2519,3,8658,1842,6816,0,0,0,1.0,1,1.0,1,1.0,1,0.1587757918339224,48
2520,0,8658,1842,6816,0,0,0,1.0,1,1.0,1,1.0,1,0.17070626169293546,46
2521,8,8666,1845,6821,0,0,0,1.0,1,1.0,1,1.0,1,0.11119076341328579,47
2522,1,8667,1846,6821,0,0,0,1.0,1,1.0,1,1.0,1,0.12207321704492152,45
2523,4,8671,1847,6824,0,0,0,1.0,1,1.0,1,1.0,1,0.12272410942546272,44
2524,0,8671,1847,6824,0,0,0,1.0,1,1.0,1,1.0,1,0.16273815225766028,42
2525,1,8672,1848,6824,0,0,0,1.0,1,1.0,1,1.0,1,0.1884322029256015,42
2526,0,8672,1848,6824,0,0,0,1.0,1,1.0,1,1.0,1,0.19781141269927174,41
2527,1,8673,1849,6824,0,0,0,1.0,1,1.0,1,1.0,1,0.21515015956750186,41
2528,0,8673,1849,6824,0,0,0,1.0,1,1.0,1,1.0,1,0.2082190174148441,41
2529,3,8676,1849,6827,0,0,0,1.0,1,1.0,1,1.0,1,0.22743410767280683,42
2530,2,8678,1849,6829,0,0,0,1.0,1,1.0,1,1.0,1,0.21738676971728307,41
2531,0,8678,1849,6829,0,0,0,1.0,1,1.0,1,1.0,1,0.21738676971728307,41
2532,1,8679,1849,6830,0,0,0,1.0,1,1.0,1,1.0,1,0.1937165029083326,43
2533,0,8679,1849,6830,0,0,0,1.0,1,1.0,1,1.0,1,0.1937165029083326,43
2534,0,8679,1849,6830,0,0,0,1.0,1,1.0,1,1.0,1,0.1937165029083326,43
2535,5,8684,1850,6834,0,0,0,1.0,1,1.0,1,1.0,1,0.2238380974175098,44
2536,3,8687,1850,6837,0,0,0,1.0,1,1.0,1,1.0,1,0.17336155162434727,44
2537,2,8689,1851,6838,0,0,0,1.0,1,1.0,1,1.0,1,0.20948823856597557,45
2538,5,8694,1851,6843,0,0,0,1.0,1,1.0,1,1.0,1,0.1949889832973295,48
2539,3,8697,1852,6845,0,0,0,1.0,1,1.0,1,1.0,1,0.18793001521704047,48
2540,4,8701,1854,6847,0,0,0,1.0,1,1.0,1,1.0,1,0.21457382830648217,50
2541,6,8707,1854,6853,0,0,0,1.0,1,1.0,1,1.0,1,0.18944224590551334,52
2542,4,8711,1856,6855,0,0,0,1.0,1,1.0,1,1.0,1,0.20583995472614938,52
2543,3,8714,1858,6856,0,0,0,1.0,1,1.0,1,1.0,1,0.2158991124648862,51
2544,7,8721,1861,6860,0,0,0,1.0,1,1.0,1,1.0,1,0.2237119119867649,51
2545,3,8724,1861,6863,0,0,0,1.0,1,1.0,1,1.0,1,0.17942491200767166,50
2546,2,8726,1862,6864,0,0,0,1.0,1,1.0,1,1.0,1,0.1740297356949336,50
2547,1,8727,1863,6864,0,0,0,1.0,1,1.0,1,1.0,1,0.19606101050652966,47
2548,0,8727,1863,6864,0,0,0,1.0,1,1.0,1,1.0,1,0.19634965939961235,46
2549,2,8729,1865,6864,0,0,0,1.0,1,1.0,1,1.0,1,0.1919954219895716,46
2550,2,8731,1867,6864,0,0,0,1.0,1,1.0,1,1.0,1,0.18846313805031847,44
2551,4,8735,1867,6868,0,0,0,1.0,1,1.0,1,1.0,1,0.14452741357347973,43
2552,0,8735,1867,6868,0,0,0,1.0,1,1.0,1,1.0,1,0.16512469797277085,43
2553,1,8736,1867,6869,0,0,0,1.0,1,1.0,1,1.0,1,0.1491266347156827,44
2554,1,8737,1868,6869,0,0,0,1.0,1,1.0,1,1.0,1,0.13460181722412318,45
2555,3,8740,1869,6871,0,0,0,1.0,1,1.0,1,1.0,1,0.15240693990302923,44
2556,1,8741,1869,6872,0,0,0,1.0,1,1.0,1,1.0,1,0.1303256736435311,44
2557,2,8743,1870,6873,0,0,0,1.0,1,1.0,1,1.0,1,0.12316933756689831,41
2558,2,8745,1871,6874,0,0,0,1.0,1,1.0,1,1.0,1,0.14808254231532053,40
2559,0,8745,1871,6874,0,0,0,1.0,1,1.0,1,1.0,1,0.17088059962036084,41
2560,1,8746,1871,6875,0,0,0,1.0,1,1.0,1,1.0,1,0.15838938867469277,41
2561,1,8747,1871,6876,0,0,0,1.0,1,1.0,1,1.0,1,0.163642050854881,43
2562,0,8747,1871,6876,0,0,0,1.0,1,1.0,1,1.0,1,0.17325896051168485,44
2563,0,8747,1871,6876,0,0,0,1.0,1,1.0,1,1.0,1,0.17325896051168485,44
2564,6,8753,1874,6879,0,0,0,1.0,1,1.0,1,1.0,1,0.22331171045906528,44
2565,5,8758,1877,6881,0,0,0,1.0,1,1.0,1,1.0,1,0.24629565031426762,45
2566,4,8762,1879,6883,0,0,0,1.0,1,1.0,1,1.0,1,0.26036696547302635,46
2567,5,8767,1879,6888,0,0,0,1.0,1,1.0,1,1.0,1,0.24002495978774593,48
2568,3,8770,1879,6891,0,0,0,1.0,1,1.0,1,1.0,1,0.2234952185543351,48
2569,1,8771,1879,6892,0,0,0,1.0,1,1.0,1,1.0,1,0.23250979228565363,49
2570,2,8773,1879,6894,0,0,0,1.0,1,1.0,1,1.0,1,0.22558651596803395,48
2571,4,8777,1879,6898,0,0,0,1.0,1,1.0,1,1.0,1,0.20393667753848788,48
2572,4,8781,1879,6902,0,0,0,1.0,1,1.0,1,1.0,1,0.17068905792578515,49
2573,4,8785,1879,6906,0,0,0,1.0,1,1.0,1,1.0,1,0.15559982744389983,50
2574,6,8791,1880,6911,0,0,0,1.0,1,1.0,1,1.0,1,0.17493293037130564,49
2575,2,8793,1880,6913,0,0,0,1.0,1,1.0,1,1.0,1,0.1521528081959671,48
2576,2,8795,1880,6915,0,0,0,1.0,1,1.0,1,1.0,1,0.1542929470087221,48
2577,2,8797,1880,6917,0,0,0,1.0,1,1.0,1,1.0,1,0.17637466229870652,50
2578,1,8798,1880,6918,0,0,0,1.0,1,1.0,1,1.0,1,0.17478275647838215,50
2579,5,8803,1880,6923,0,0,0,1.0,1,1.0,1,1.0,1,0.1306356688412377,51
2580,1,8804,1880,6924,0,0,0,1.0,1,1.0,1,1.0,1,0.14944949305539185,52
2581,4,8808,1880,6928,0,0,0,1.0,1,1.0,1,1.0,1,0.11515989200238155,51
2582,1,8809,1880,6929,0,0,0,1.0,1,1.0,1,1.0,1,0.11372704439561095,51
2583,1,8810,1881,6929,0,0,0,1.0,1,1.0,1,1.0,1,0.12197236349834978,51
2584,1,8811,1882,6929,0,0,0,1.0,1,1.0,1,1.0,1,0.12292069466720879,51
2585,0,8811,1882,6929,0,0,0,1.0,1,1.0,1,1.0,1,0.10650284741694915,50
2586,2,8813,1884,6929,0,0,0,1.0,1,1.0,1,1.0,1,0.1732114420871947,50
2587,3,8816,1885,6931,0,0,0,1.0,1,1.0,1,1.0,1,0.0910067060179572,48
2588,4,8820,1887,6933,0,0,0,1.0,1,1.0,1,1.0,1,0.12209610691370718,50
2589,3,8823,1888,6935,0,0,0,1.0,1,1.0,1,1.0,1,0.12173843577696898,48
2590,1,8824,1889,6935,0,0,0,1.0,1,1.0,1,1.0,1,0.10453133120488017,47
2591,1,8825,1890,6935,0,0,0,1.0,1,1.0,1,1.0,1,0.09587711402669562,47
2592,2,8827,1892,6935,0,0,0,1.0,1,1.0,1,1.0,1,0.10656046492590227,47
2593,1,8828,1893,6935,0,0,0,1.0,1,1.0,1,1.0,1,0.12546495062656826,47
2594,8,8836,1898,6938,0,0,0,1.0,1,1.0,1,1.0,1,0.17572747085196935,49
2595,3,8839,1900,6939,0,0,0,1.0,1,1.0,1,1.0,1,0.13699772463390927,48
2596,6,8845,1901,6944,0,0,0,1.0,1,1.0,1,1.0,1,0.10457149459630181,47
2597,2,8847,1902,6945,0,0,0,1.0,1,1.0,1,1.0,1,0.10667687215197268,48
2598,1,8848,1903,6945,0,0,0,1.0,1,1.0,1,1.0,1,0.10958276678457039,48
2599,0,8848,1903,6945,0,0,0,1.0,1,1.0,1,1.0,1,0.10094737423783827,49
2600,3,8851,1904,6947,0,0,0,1.0,1,1.0,1,1.0,1,0.11724788232787173,52
2601,2,8853,1905,6948,0,0,0,1.0,1,1.0,1,1.0,1,0.1316414571841004,51
2602,2,8855,1906,6949,0,0,0,1.0,1,1.0,1,1.0,1,0.1535010444283276,52
2603,2,8857,1906,6951,0,0,0,1.0,1,1.0,1,1.0,1,0.1643920685382047,53
2604,1,8858,1906,6952,0,0,0,1.0,1,1.0,1,1.0,1,0.150107946066932,53
2605,3,8861,1906,6955,0,0,0,1.0,1,1.0,1,1.0,1,0.17257383559247338,52
2606,5,8866,1906,6960,0,0,0,1.0,1,1.0,1,1.0,1,0.1770404650477309,52
2607,3,8869,1906,6963,0,0,0,1.0,1,1.0,1,1.0,1,0.1837530694156272,52
2608,4,8873,1906,6967,0,0,0,1.0,1,1.0,1,1.0,1,0.1837530694156272,52
2609,2,8875,1907,6968,0,0,0,1.0,1,1.0,1,1.0,1,0.17191441319866363,53
2610,5,8880,1907,6973,0,0,0,1.0,1,1.0,1,1.0,1,0.17745263596291097,54
2611,6,8886,1909,6977,0,0,0,1.0,1,1.0,1,1.0,1,0.10675077200980877,54
2612,3,8889,1911,6978,0,0,0,1.0,1,1.0,1,1.0,1,0.1414278213994033,56
2613,7,8896,1914,6982,0,0,0,1.0,1,1.0,1,1.0,1,0.10856358585862,56
2614,7,8903,1915,6988,0,0,0,1.0,1,1.0,1,1.0,1,0.1253367813041329,56
2615,5,8908,1916,6992,0,0,0,1.0,1,1.0,1,1.0,1,0.1300555005496683,57
2616,8,8916,1916,7000,0,0,0,1.0,1,1.0,1,1.0,1,0.1451919931072922,57
2617,6,8922,1917,7005,0,0,0,1.0,1,1.0,1,1.0,1,0.15538829754930908,58
2618,4,8926,1918,7008,0,0,0,1.0,1,1.0,1,1.0,1,0.1393686082740294,58
2619,10,8936,1918,7018,0,0,0,1.0,1,1.0,1,1.0,1,0.14572809401753442,58
2620,8,8944,1918,7026,0,0,0,1.0,1,1.0,1,1.0,1,0.11892738885192453,60
2621,4,8948,1918,7030,0,0,0,1.0,1,1.0,1,1.0,1,0.13499591977519473,59
2622,11,8959,1919,7040,0,0,0,1.0,1,1.0,1,1.0,1,0.14465687927002732,60
2623,8,8967,1920,7047,0,0,0,1.0,1,1.0,1,1.0,1,0.1629045850220376,59
2624,12,8979,1925,7054,0,0,0,1.0,1,1.0,1,1.0,1,0.21321638633406512,58
2625,15,8994,1928,7066,0,0,0,1.0,1,1.0,1,1.0,1,0.25118668758000773,58
2626,10,9004,1930,7074,0,0,0,1.0,1,1.0,1,1.0,1,0.12472545751035546,57
2627,1,9005,1930,7075,0,0,0,1.0,1,1.0,1,1.0,1,0.09676323399569677,55
2628,1,9006,1931,7075,0,0,0,1.0,1,1.0,1,1.0,1,0.12029457257653033,55
2629,1,9007,1931,7076,0,0,0,1.0,1,1.0,1,1.0,1,0.11722140166157227,54
2630,5,9012,1932,7080,0,0,0,1.0,1,1.0,1,1.0,1,0.1374116787832225,55
2631,1,9013,1932,7081,0,0,0,1.0,1,1.0,1,1.0,1,0.139880167956046,55
2632,3,9016,1932,7084,0,0,0,1.0,1,1.0,1,1.0,1,0.15863260398108478,55
2633,2,9018,1933,7085,0,0,0,1.0,1,1.0,1,1.0,1,0.16143502028871898,53
2634,5,9023,1935,7088,0,0,0,1.0,1,1.0,1,1.0,1,0.215712110594556,52
2635,5,9028,1935,7093,0,0,0,1.0,1,1.0,1,1.0,1,0.22677561063424184,52
2636,12,9040,1938,7102,0,0,0,1.0,1,1.0,1,1.0,1,0.26376841016346825,51
2637,7,9047,1939,7108,0,0,0,1.0,1,1.0,1,1.0,1,0.2003658331538885,50
2638,10,9057,1942,7115,0,0,0,1.0,1,1.0,1,1.0,1,0.24155430632484887,48
2639,3,9060,1942,7118,0,0,0,1.0,1,1.0,1,1.0,1,0.2200987565434508,48
2640,6,9066,1944,7122,0,0,0,1.0,1,1.0,1,1.0,1,0.25555930281901945,46
2641,12,9078,1946,7132,0,0,0,1.0,1,1.0,1,1.0,1,0.12458895592997107,46
2642,5,9083,1949,7134,0,0,0,1.0,1,1.0,1,1.0,1,0.16389799405217867,47
2643,4,9087,1949,7138,0,0,0,1.0,1,1.0,1,1.0,1,0.15079208803315858,45
2644,3,9090,1951,7139,0,0,0,1.0,1,1.0,1,1.0,1,0.17985547394920218,44
2645,4,9094,1952,7142,0,0,0,1.0,1,1.0,1,1.0,1,0.15215981393029548,42
2646,2,9096,1952,7144,0,0,0,1.0,1,1.0,1,1.0,1,0.12841282763831066,43
2647,1,9097,1953,7144,0,0,0,1.0,1,1.0,1,1.0,1,0.15751105947871866,40
2648,5,9102,1956,7146,0,0,0,1.0,1,1.0,1,1.0,1,0.20199071095747548,41
2649,6,9108,1957,7151,0,0,0,1.0,1,1.0,1,1.0,1,0.1943498117812878,43
2650,6,9114,1957,7157,0,0,0,1.0,1,1.0,1,1.0,1,0.218108069271506,43
2651,9,9123,1957,7166,0,0,0,1.0,1,1.0,1,1.0,1,0.17194376675363257,44
2652,8,9131,1958,7173,0,0,0,1.0,1,1.0,1,1.0,1,0.18991136424465146,44
2653,6,9137,1958,7179,0,0,0,1.0,1,1.0,1,1.0,1,0.18991136424465146,44
2654,7,9144,1958,7186,0,0,0,1.0,1,1.0,1,1.0,1,0.1889792328710826,45
2655,6,9150,1958,7192,0,0,0,1.0,1,1.0,1,1.0,1,0.1889792328710826,45
2656,7,9157,1958,7199,0,0,0,1.0,1,1.0,1,1.0,1,0.10807734495887945,45
2657,2,9159,1958,7201,0,0,0,1.0,1,1.0,1,1.0,1,0.11052256555954176,45
2658,3,9162,1959,7203,0,0,0,1.0,1,1.0,1,1.0,1,0.1353247626839954,47
2659,2,9164,1959,7205,0,0,0,1.0,1,1.0,1,1.0,1,0.14106375482903274,46
2660,3,9167,1959,7208,0,0,0,1.0,1,1.0,1,1.0,1,0.15070979884352412,46
2661,2,9169,1959,7210,0,0,0,1.0,1,1.0,1,1.0,1,0.16393845446706837,46
2662,7,9176,1960,7216,0,0,0,1.0,1,1.0,1,1.0,1,0.11455473322536631,47
2663,3,9179,1960,7219,0,0,0,1.0,1,1.0,1,1.0,1,0.08685169588741493,46
2664,4,9183,1963,7220,0,0,0,1.0,1,1.0,1,1.0,1,0.07923900281448117,45
2665,2,9185,1965,7220,0,0,0,1.0,1,1.0,1,1.0,1,0.11375098383959259,47
2666,3,9188,1966,7222,0,0,0,1.0,1,1.0,1,1.0,1,0.17538755032862366,47
2667,2,9190,1967,7223,0,0,0,1.0,1,1.0,1,1.0,1,0.25152850382601494,45
2668,7,9197,1971,7226,0,0,0,1.0,1,1.0,1,1.0,1,0.18133289250764528,45
2669,1,9198,1972,7226,0,0,0,1.0,1,1.0,1,1.0,1,0.22345145435870073,45
2670,6,9204,1974,7230,0,0,0,1.0,1,1.0,1,1.0,1,0.16569635871999155,45
2671,3,9207,1974,7233,0,0,0,1.0,1,1.0,1,1.0,1,0.12272770270584706,41
2672,2,9209,1976,7233,0,0,0,1.0,1,1.0,1,1.0,1,0.12156636303475474,40
2673,2,9211,1976,7235,0,0,0,1.0,1,1.0,1,1.0,1,0.10932800382968255,39
2674,4,9215,1978,7237,0,0,0,1.0,1,1.0,1,1.0,1,0.125059269824707,37
2675,2,9217,1980,7237,0,0,0,1.0,1,1.0,1,1.0,1,0.15385107802652898,35
2676,0,9217,1980,7237,0,0,0,1.0,1,1.0,1,1.0,1,0.19421624126025192,34
2677,1,9218,1981,7237,0,0,0,1.0,1,1.0,1,1.0,1,0.2749336618978825,32
2678,6,9224,1983,7241,0,0,0,1.0,1,1.0,1,1.0,1,0.3010859215198487,33
2679,1,9225,1984,7241,0,0,0,1.0,1,1.0,1,1.0,1,0.34366059759577827,33
2680,6,9231,1988,7243,0,0,0,1.0,1,1.0,1,1.0,1,0.3310169051759515,33
2681,1,9232,1989,7243,0,0,0,1.0,1,1.0,1,1.0,1,0.24738069180569092,32
2682,3,9235,1990,7245,0,0,0,1.0,1,1.0,1,1.0,1,0.18917642856916678,32
2683,1,9236,1991,7245,0,0,0,1.0,1,1.0,1,1.0,1,0.16879470160812066,32
2684,0,9236,1991,7245,0,0,0,1.0,1,1.0,1,1.0,1,0.1890677750754251,31
2685,1,9237,1992,7245,0,0,0,1.0,1,1.0,1,1.0,1,0.24291709303617748,30
2686,4,9241,1993,7248,0,0,0,1.0,1,1.0,1,1.0,1,0.1374360881216006,29
2687,0,9241,1993,7248,0,0,0,1.0,1,1.0,1,1.0,1,0.14968505802834797,28
2688,0,9241,1993,7248,0,0,0,1.0,1,1.0,1,1.0,1,0.14968505802834797,28
2689,1,9242,1993,7249,0,0,0,1.0,1,1.0,1,1.0,1,0.22778149778365958,29
2690,1,9243,1993,7250,0,0,0,1.0,1,1.0,1,1.0,1,0.21463512085065503,29
2691,2,9245,1995,7250,0,0,0,1.0,1,1.0,1,1.0,1,0.18294971196339269,29
2692,2,9247,1995,7252,0,0,0,1.0,1,1.0,1,1.0,1,0.23861304459925312,31
2693,1,9248,1996,7252,0,0,0,1.0,1,1.0,1,1.0,1,0.26270418021206954,32
2694,3,9251,1996,7255,0,0,0,1.0,1,1.0,1,1.0,1,0.24278349650903652,32
2695,0,9251,1996,7255,0,0,0,1.0,1,1.0,1,1.0,1,0.23284922357570703,33
2696,0,9251,1996,7255,0,0,0,1.0,1,1.0,1,1.0,1,0.23284922357570703,33
2697,2,9253,1998,7255,0,0,0,1.0,1,1.0,1,1.0,1,0.2053288146081151,34
2698,2,9255,1999,7256,0,0,0,1.0,1,1.0,1,1.0,1,0.2282151292695047,34
2699,1,9256,1999,7257,0,0,0,1.0,1,1.0,1,1.0,1,0.20343940140880482,36
2700,5,9261,2000,7261,0,0,0,1.0,1,1.0,1,1.0,1,0.1991682668488456,36
2701,3,9264,2000,7264,0,0,0,1.0,1,1.0,1,1.0,1,0.12487227267364448,36
2702,1,9265,2001,7264,0,0,0,1.0,1,1.0,1,1.0,1,0.1789311584731566,36
2703,5,9270,2003,7267,0,0,0,1.0,1,1.0,1,1.0,1,0.13481422182527125,38
2704,0,9270,2003,7267,0,0,0,1.0,1,1.0,1,1.0,1,0.16029247678297226,37
2705,4,9274,2005,7269,0,0,0,1.0,1,1.0,1,1.0,1,0.2120381487290506,36
2706,2,9276,2007,7269,0,0,0,1.0,1,1.0,1,1.0,1,0.2356872319326476,34
2707,0,9276,2007,7269,0,0,0,1.0,1,1.0,1,1.0,1,0.23404749376287032,36
2708,2,9278,2009,7269,0,0,0,1.0,1,1.0,1,1.0,1,0.24425949315938436,36
2709,0,9278,2009,7269,0,0,0,1.0,1,1.0,1,1.0,1,0.2526915990621866,33
2710,3,9281,2012,7269,0,0,0,1.0,1,1.0,1,1.0,1,0.2730515125294287,32
2711,2,9283,2014,7269,0,0,0,1.0,1,1.0,1,1.0,1,0.2539630730532257,29
2712,0,9283,2014,7269,0,0,0,1.0,1,1.0,1,1.0,1,0.26394615290634005,28
2713,1,9284,2014,7270,0,0,0,1.0,1,1.0,1,1.0,1,0.24331080342470826,28
2714,0,9284,2014,7270,0,0,0,1.0,1,1.0,1,1.0,1,0.25990050866325143,25
2715,2,9286,2015,7271,0,0,0,1.0,1,1.0,1,1.0,1,0.3146918979956831,24
2716,6,9292,2017,7275,0,0,0,1.0,1,1.0,1,1.0,1,0.26483560806163564,23
2717,3,9295,2018,7277,0,0,0,1.0,1,1.0,1,1.0,1,0.27348419468876956,24
2718,3,9298,2018,7280,0,0,0,1.0,1,1.0,1,1.0,1,0.16988581956844298,24
2719,4,9302,2018,7284,0,0,0,1.0,1,1.0,1,1.0,1,0.20519315905802385,25
2720,3,9305,2019,7286,0,0,0,1.0,1,1.0,1,1.0,1,0.2676644182901898,25
2721,6,9311,2021,7290,0,0,0,1.0,1,1.0,1,1.0,1,0.2602612208378814,26
2722,3,9314,2022,7292,0,0,0,1.0,1,1.0,1,1.0,1,0.3396898016324689,26
2723,2,9316,2023,7293,0,0,0,1.0,1,1.0,1,1.0,1,0.3346717601251889,26
2724,4,9320,2024,7296,0,0,0,1.0,1,1.0,1,1.0,1,0.2354458386282439,27
2725,2,9322,2024,7298,0,0,0,1.0,1,1.0,1,1.0,1,0.23784665315075107,27
2726,2,9324,2024,7300,0,0,0,1.0,1,1.0,1,1.0,1,0.2435416673318847,28
2727,2,9326,2024,7302,0,0,0,1.0,1,1.0,1,1.0,1,0.23011218173493697,29
2728,5,9331,2024,7307,0,0,0,1.0,1,1.0,1,1.0,1,0.18580376875212276,28
2729,3,9334,2024,7310,0,0,0,1.0,1,1.0,1,1.0,1,0.2087368386277985,28
2730,3,9337,2024,7313,0,0,0,1.0,1,1.0,1,1.0,1,0.2325647593540157,29
2731,3,9340,2024,7316,0,0,0,1.0,1,1.0,1,1.0,1,0.1658901159844512,30
2732,0,9340,2024,7316,0,0,0,1.0,1,1.0,1,1.0,1,0.1925199478980391,29
2733,0,9340,2024,7316,0,0,0,1.0,1,1.0,1,1.0,1,0.1925199478980391,29
2734,0,9340,2024,7316,0,0,0,1.0,1,1.0,1,1.0,1,0.1925199478980391,29
2735,0,9340,2024,7316,0,0,0,1.0,1,1.0,1,1.0,1,0.1925199478980391,29
2736,1,9341,2024,7317,0,0,0,1.0,1,1.0,1,1.0,1,0.1749420511387099,30
2737,0,9341,2024,7317,0,0,0,1.0,1,1.0,1,1.0,1,0.1749420511387099,30
2738,1,9342,2025,7317,0,0,0,1.0,1,1.0,1,1.0,1,0.19861241291559614,29
2739,0,9342,2025,7317,0,0,0,1.0,1,1.0,1,1.0,1,0.20408980770881005,30
2740,0,9342,2025,7317,0,0,0,1.0,1,1.0,1,1.0,1,0.23067991229992232,29
2741,0,9342,2025,7317,0,0,0,1.0,1,1.0,1,1.0,1,0.23067991229992232,29
2742,1,9343,2026,7317,0,0,0,1.0,1,1.0,1,1.0,1,0.22736336473409866,29
2743,3,9346,2027,7319,0,0,0,1.0,1,1.0,1,1.0,1,0.24645525993535597,30
2744,4,9350,2029,7321,0,0,0,1.0,1,1.0,1,1.0,1,0.31789760042192045,28
2745,1,9351,2029,7322,0,0,0,1.0,1,1.0,1,1.0,1,0.2674894115182369,27
2746,6,9357,2031,7326,0,0,0,1.0,1,1.0,1,1.0,1,0.23902136729923232,26
2747,2,9359,2032,7327,0,0,0,1.0,1,1.0,1,1.0,1,0.29004954179039155,22
2748,0,9359,2032,7327,0,0,0,1.0,1,1.0,1,1.0,1,0.29815491329547034,22
2749,0,9359,2032,7327,0,0,0,1.0,1,1.0,1,1.0,1,0.32621803483868983,20
2750,0,9359,2032,7327,0,0,0,1.0,1,1.0,1,1.0,1,0.42865991397721864,17
2751,0,9359,2032,7327,0,0,0,1.0,1,1.0,1,1.0,1,0.42865991397721864,17
2752,0,9359,2032,7327,0,0,0,1.0,1,1.0,1,1.0,1,0.41123852288372065,16
2753,1,9360,2033,7327,0,0,0,1.0,1,1.0,1,1.0,1,0.46113886715075153,16
2754,1,9361,2033,7328,0,0,0,1.0,1,1.0,1,1.0,1,0.417715279015589,16
2755,0,9361,2033,7328,0,0,0,1.0,1,1.0,1,1.0,1,0.417715279015589,16
2756,0,9361,2033,7328,0,0,0,1.0,1,1.0,1,1.0,1,0.4177920438381888,17
2757,2,9363,2033,7330,0,0,0,1.0,1,1.0,1,1.0,1,0.34833700451157373,18
2758,0,9363,2033,7330,0,0,0,1.0,1,1.0,1,1.0,1,0.34833700451157373,18
2759,0,9363,2033,7330,0,0,0,1.0,1,1.0,1,1.0,1,0.36779211632204534,19
2760,0,9363,2033,7330,0,0,0,1.0,1,1.0,1,1.0,1,0.37787575584592953,18
2761,1,9364,2033,7331,0,0,0,1.0,1,1.0,1,1.0,1,0.3321468468325521,18
2762,0,9364,2033,7331,0,0,0,1.0,1,1.0,1,1.0,1,0.3321468468325521,18
2763,0,9364,2033,7331,0,0,0,1.0,1,1.0,1,1.0,1,0.3321468468325521,18
2764,0,9364,2033,7331,0,0,0,1.0,1,1.0,1,1.0,1,0.3321468468325521,18
2765,1,9365,2034,7331,0,0,0,1.0,1,1.0,1,1.0,1,0.36877481929586137,18
2766,0,9365,2034,7331,0,0,0,1.0,1,1.0,1,1.0,1,0.36877481929586137,18
2767,0,9365,2034,7331,0,0,0,1.0,1,1.0,1,1.0,1,0.4258560180763314,17
2768,0,9365,2034,7331,0,0,0,1.0,1,1.0,1,1.0,1,0.4258560180763314,17
2769,0,9365,2034,7331,0,0,0,1.0,1,1.0,1,1.0,1,0.4258560180763314,17
2770,0,9365,2034,7331,0,0,0,1.0,1,1.0,1,1.0,1,0.4258560180763314,17
2771,0,9365,2034,7331,0,0,0,1.0,1,1.0,1,1.0,1,0.4258560180763314,17
2772,0,9365,2034,7331,0,0,0,1.0,1,1.0,1,1.0,1,0.4258560180763314,17
2773,2,9367,2035,7332,0,0,0,1.0,1,1.0,1,1.0,1,0.45974520826210946,17
2774,1,9368,2035,7333,0,0,0,1.0,1,1.0,1,1.0,1,0.41130937871440737,18
2775,4,9372,2036,7336,0,0,0,1.0,1,1.0,1,1.0,1,0.44191423223972054,20
2776,3,9375,2036,7339,0,0,0,1.0,1,1.0,1,1.0,1,0.33654131951954397,21
2777,1,9376,2036,7340,0,0,0,1.0,1,1.0,1,1.0,1,0.30652776729856146,21
2778,2,9378,2037,7341,0,0,0,1.0,1,1.0,1,1.0,1,0.29037503201266174,21
2779,2,9380,2037,7343,0,0,0,1.0,1,1.0,1,1.0,1,0.28600409064297305,22
2780,3,9383,2038,7345,0,0,0,1.0,1,1.0,1,1.0,1,0.3211712319457097,22
2781,2,9385,2038,7347,0,0,0,1.0,1,1.0,1,1.0,1,0.27534338701787137,22
2782,2,9387,2040,7347,0,0,0,1.0,1,1.0,1,1.0,1,0.27662448563469705,23
2783,1,9388,2041,7347,0,0,0,1.0,1,1.0,1,1.0,1,0.2751630236716415,22
2784,2,9390,2042,7348,0,0,0,1.0,1,1.0,1,1.0,1,0.32176583891310734,21
2785,0,9390,2042,7348,0,0,0,1.0,1,1.0,1,1.0,1,0.2821698226318822,19
2786,1,9391,2043,7348,0,0,0,1.0,1,1.0,1,1.0,1,0.3445518328744247,19
2787,0,9391,2043,7348,0,0,0,1.0,1,1.0,1,1.0,1,0.23493000094933245,20
2788,0,9391,2043,7348,0,0,0,1.0,1,1.0,1,1.0,1,0.23493000094933245,20
2789,0,9391,2043,7348,0,0,0,1.0,1,1.0,1,1.0,1,0.22459806659711876,19
2790,1,9392,2043,7349,0,0,0,1.0,1,1.0,1,1.0,1,0.21937151414086598,20
2791,0,9392,2043,7349,0,0,0,1.0,1,1.0,1,1.0,1,0.21937151414086598,20
2792,0,9392,2043,7349,0,0,0,1.0,1,1.0,1,1.0,1,0.21937151414086598,20
2793,1,9393,2043,7350,0,0,0,1.0,1,1.0,1,1.0,1,0.16483687461190957,19
2794,0,9393,2043,7350,0,0,0,1.0,1,1.0,1,1.0,1,0.1725851505358434,20
2795,0,9393,2043,7350,0,0,0,1.0,1,1.0,1,1.0,1,0.18326824639776687,21
2796,2,9395,2044,7351,0,0,0,1.0,1,1.0,1,1.0,1,0.17048160697952347,22
2797,0,9395,2044,7351,0,0,0,1.0,1,1.0,1,1.0,1,0.13931229798482758,21
2798,1,9396,2045,7351,0,0,0,1.0,1,1.0,1,1.0,1,0.17262232914561887,21
2799,0,9396,2045,7351,0,0,0,1.0,1,1.0,1,1.0,1,0.15511810034442813,20
2800,0,9396,2045,7351,0,0,0,1.0,1,1.0,1,1.0,1,0.15511810034442813,20
2801,0,9396,2045,7351,0,0,0,1.0,1,1.0,1,1.0,1,0.15511810034442813,20
2802,1,9397,2045,7352,0,0,0,1.0,1,1.0,1,1.0,1,0.11155433755192545,20
2803,1,9398,2046,7352,0,0,0,1.0,1,1.0,1,1.0,1,0.17504455008590009,21
2804,1,9399,2046,7353,0,0,0,1.0,1,1.0,1,1.0,1,0.1295306412628017,22
2805,2,9401,2046,7355,0,0,0,1.0,1,1.0,1,1.0,1,0.15797876143661166,22
2806,3,9404,2048,7356,0,0,0,1.0,1,1.0,1,1.0,1,0.18262062437445925,23
2807,3,9407,2050,7357,0,0,0,1.0,1,1.0,1,1.0,1,0.2140610117976506,24
2808,3,9410,2051,7359,0,0,0,1.0,1,1.0,1,1.0,1,0.2501135950360416,24
2809,1,9411,2051,7360,0,0,0,1.0,1,1.0,1,1.0,1,0.23007928691379786,26
2810,3,9414,2051,7363,0,0,0,1.0,1,1.0,1,1.0,1,0.14441344049416993,26
2811,1,9415,2051,7364,0,0,0,1.0,1,1.0,1,1.0,1,0.14306629759158593,27
2812,3,9418,2051,7367,0,0,0,1.0,1,1.0,1,1.0,1,0.1630398094946259,27
2813,0,9418,2051,7367,0,0,0,1.0,1,1.0,1,1.0,1,0.15867971627230373,28
2814,3,9421,2052,7369,0,0,0,1.0,1,1.0,1,1.0,1,0.20899759443678917,29
2815,2,9423,2052,7371,0,0,0,1.0,1,1.0,1,1.0,1,0.15772546310365082,30
2816,3,9426,2053,7373,0,0,0,1.0,1,1.0,1,1.0,1,0.1298612420604078,31
2817,1,9427,2053,7374,0,0,0,1.0,1,1.0,1,1.0,1,0.15424818968603776,31
2818,4,9431,2054,7377,0,0,0,1.0,1,1.0,1,1.0,1,0.11838531157237403,32
2819,1,9432,2054,7378,0,0,0,1.0,1,1.0,1,1.0,1,0.09587546344879173,32
2820,3,9435,2054,7381,0,0,0,1.0,1,1.0,1,1.0,1,0.10891296472934334,33
2821,1,9436,2055,7381,0,0,0,1.0,1,1.0,1,1.0,1,0.1674372709548992,34
2822,3,9439,2057,7382,0,0,0,1.0,1,1.0,1,1.0,1,0.20756072157919253,35
2823,1,9440,2058,7382,0,0,0,1.0,1,1.0,1,1.0,1,0.23375548441586938,31
2824,1,9441,2059,7382,0,0,0,1.0,1,1.0,1,1.0,1,0.29374206515374085,33
2825,0,9441,2059,7382,0,0,0,1.0,1,1.0,1,1.0,1,0.2558377074375398,31
2826,1,9442,2059,7383,0,0,0,1.0,1,1.0,1,1.0,1,0.2088292750938755,31
2827,3,9445,2061,7384,0,0,0,1.0,1,1.0,1,1.0,1,0.18814497033310384,32
2828,6,9451,2063,7388,0,0,0,1.0,1,1.0,1,1.0,1,0.21987819759919588,33
2829,2,9453,2065,7388,0,0,0,1.0,1,1.0,1,1.0,1,0.2642165271619637,33
2830,5,9458,2066,7392,0,0,0,1.0,1,1.0,1,1.0,1,0.20566801985893676,32
2831,2,9460,2067,7393,0,0,0,1.0,1,1.0,1,1.0,1,0.27294399362078364,31
2832,1,9461,2068,7393,0,0,0,1.0,1,1.0,1,1.0,1,0.2600730479081615,30
2833,0,9461,2068,7393,0,0,0,1.0,1,1.0,1,1.0,1,0.25420618801863,29
2834,4,9465,2071,7394,0,0,0,1.0,1,1.0,1,1.0,1,0.29595530921600655,29
2835,5,9470,2073,7397,0,0,0,1.0,1,1.0,1,1.0,1,0.3934629798685389,27
2836,7,9477,2073,7404,0,0,0,1.0,1,1.0,1,1.0,1,0.1880394182838386,27
2837,1,9478,2073,7405,0,0,0,1.0,1,1.0,1,1.0,1,0.17839864779754105,28
2838,5,9483,2074,7409,0,0,0,1.0,1,1.0,1,1.0,1,0.21934174046626945,29
2839,5,9488,2074,7414,0,0,0,1.0,1,1.0,1,1.0,1,0.2427447371288931,29
2840,4,9492,2074,7418,0,0,0,1.0,1,1.0,1,1.0,1,0.229902921705932,29
2841,8,9500,2074,7426,0,0,0,1.0,1,1.0,1,1.0,1,0.1642148604003324,31
2842,5,9505,2074,7431,0,0,0,1.0,1,1.0,1,1.0,1,0.19313495355207846,32
2843,4,9509,2074,7435,0,0,0,1.0,1,1.0,1,1.0,1,0.16172065691724677,32
2844,9,9518,2076,7442,0,0,0,1.0,1,1.0,1,1.0,1,0.2130355088950754,33
2845,8,9526,2076,7450,0,0,0,1.0,1,1.0,1,1.0,1,0.25061487110221914,34
2846,6,9532,2076,7456,0,0,0,1.0,1,1.0,1,1.0,1,0.2569517709247726,34
2847,8,9540,2077,7463,0,0,0,1.0,1,1.0,1,1.0,1,0.19227053466189434,35
2848,9,9549,2077,7472,0,0,0,1.0,1,1.0,1,1.0,1,0.22187476466915762,37
2849,6,9555,2078,7477,0,0,0,1.0,1,1.0,1,1.0,1,0.27696396429361125,37
2850,11,9566,2078,7488,0,0,0,1.0,1,1.0,1,1.0,1,0.2882805196488673,37
2851,5,9571,2079,7492,0,0,0,1.0,1,1.0,1,1.0,1,0.2112174571469246,38
2852,0,9571,2079,7492,0,0,0,1.0,1,1.0,1,1.0,1,0.248527770467613,36
2853,0,9571,2079,7492,0,0,0,1.0,1,1.0,1,1.0,1,0.2666546516918848,36
2854,1,9572,2079,7493,0,0,0,1.0,1,1.0,1,1.0,1,0.2683768411265177,37
2855,2,9574,2080,7494,0,0,0,1.0,1,1.0,1,1.0,1,0.2783628692396153,37
2856,0,9574,2080,7494,0,0,0,1.0,1,1.0,1,1.0,1,0.2707746828879403,38
2857,5,9579,2080,7499,0,0,0,1.0,1,1.0,1,1.0,1,0.19198953182282252,39
2858,6,9585,2083,7502,0,0,0,1.0,1,1.0,1,1.0,1,0.1951479660681018,39
2859,4,9589,2083,7506,0,0,0,1.0,1,1.0,1,1.0,1,0.21367533488735005,39
2860,2,9591,2083,7508,0,0,0,1.0,1,1.0,1,1.0,1,0.18652923090837253,40
2861,2,9593,2083,7510,0,0,0,1.0,1,1.0,1,1.0,1,0.1611844774728518,38
2862,5,9598,2086,7512,0,0,0,1.0,1,1.0,1,1.0,1,0.22631503788435894,38
2863,6,9604,2087,7517,0,0,0,1.0,1,1.0,1,1.0,1,0.1590261376207613,37
2864,7,9611,2090,7521,0,0,0,1.0,1,1.0,1,1.0,1,0.2233164700862174,35
2865,3,9614,2091,7523,0,0,0,1.0,1,1.0,1,1.0,1,0.22542267891463932,33
2866,3,9617,2092,7525,0,0,0,1.0,1,1.0,1,1.0,1,0.19591210527228783,31
2867,2,9619,2094,7525,0,0,0,1.0,1,1.0,1,1.0,1,0.22975033310430695,30
2868,3,9622,2095,7527,0,0,0,1.0,1,1.0,1,1.0,1,0.2006889204693951,31
2869,11,9633,2099,7534,0,0,0,1.0,1,1.0,1,1.0,1,0.24549795781910191,30
2870,1,9634,2099,7535,0,0,0,1.0,1,1.0,1,1.0,1,0.28783964461243694,26
2871,1,9635,2099,7536,0,0,0,1.0,1,1.0,1,1.0,1,0.2575387145967541,27
2872,0,9635,2099,7536,0,0,0,1.0,1,1.0,1,1.0,1,0.2595692690140161,25
2873,0,9635,2099,7536,0,0,0,1.0,1,1.0,1,1.0,1,0.27088942619532563,24
2874,1,9636,2100,7536,0,0,0,1.0,1,1.0,1,1.0,1,0.2547260529020692,25
2875,0,9636,2100,7536,0,0,0,1.0,1,1.0,1,1.0,1,0.27909856126112764,26
2876,1,9637,2100,7537,0,0,0,1.0,1,1.0,1,1.0,1,0.2575504618275877,28
2877,0,9637,2100,7537,0,0,0,1.0,1,1.0,1,1.0,1,0.23345785451002024,29
2878,1,9638,2101,7537,0,0,0,1.0,1,1.0,1,1.0,1,0.20160916071967375,31
2879,0,9638,2101,7537,0,0,0,1.0,1,1.0,1,1.0,1,0.20160916071967375,31
2880,2,9640,2102,7538,0,0,0,1.0,1,1.0,1,1.0,1,0.17612809361785392,32
2881,1,9641,2102,7539,0,0,0,1.0,1,1.0,1,1.0,1,0.1634648496322181,31
2882,0,9641,2102,7539,0,0,0,1.0,1,1.0,1,1.0,1,0.1634648496322181,31
2883,2,9643,2102,7541,0,0,0,1.0,1,1.0,1,1.0,1,0.15194815378750096,32
2884,2,9645,2103,7542,0,0,0,1.0,1,1.0,1,1.0,1,0.153764426647733,32
2885,2,9647,2104,7543,0,0,0,1.0,1,1.0,1,1.0,1,0.18164867568403928,33
2886,1,9648,2104,7544,0,0,0,1.0,1,1.0,1,1.0,1,0.19967927384636167,34
2887,5,9653,2104,7549,0,0,0,1.0,1,1.0,1,1.0,1,0.1944642928228111,34
2888,3,9656,2104,7552,0,0,0,1.0,1,1.0,1,1.0,1,0.16850830826357993,34
2889,1,9657,2105,7552,0,0,0,1.0,1,1.0,1,1.0,1,0.17734553311884443,37
2890,1,9658,2105,7553,0,0,0,1.0,1,1.0,1,1.0,1,0.14363788268567543,37
2891,2,9660,2106,7554,0,0,0,1.0,1,1.0,1,1.0,1,0.18775825527622664,37
2892,0,9660,2106,7554,0,0,0,1.0,1,1.0,1,1.0,1,0.18775825527622664,37
2893,3,9663,2107,7556,0,0,0,1.0,1,1.0,1,1.0,1,0.18507855275853854,38
2894,3,9666,2107,7559,0,0,0,1.0,1,1.0,1,1.0,1,0.2013223644016724,39
2895,3,9669,2108,7561,0,0,0,1.0,1,1.0,1,1.0,1,0.2138545339180564,40
2896,7,9676,2109,7567,0,0,0,1.0,1,1.0,1,1.0,1,0.13276387026104425,41
2897,1,9677,2109,7568,0,0,0,1.0,1,1.0,1,1.0,1,0.0970943356260975,41
2898,3,9680,2111,7569,0,0,0,1.0,1,1.0,1,1.0,1,0.13500716014214445,41
2899,2,9682,2112,7570,0,0,0,1.0,1,1.0,1,1.0,1,0.1905701701859725,39
2900,7,9689,2114,7575,0,0,0,1.0,1,1.0,1,1.0,1,0.24343534250348503,40
2901,1,9690,2114,7576,0,0,0,1.0,1,1.0,1,1.0,1,0.19656847667525354,40
2902,2,9692,2116,7576,0,0,0,1.0,1,1.0,1,1.0,1,0.2648710214821048,38
2903,1,9693,2116,7577,0,0,0,1.0,1,1.0,1,1.0,1,0.20130195972815856,36
2904,0,9693,2116,7577,0,0,0,1.0,1,1.0,1,1.0,1,0.20314385030936896,36
2905,1,9694,2116,7578,0,0,0,1.0,1,1.0,1,1.0,1,0.14790827194923814,35
2906,1,9695,2116,7579,0,0,0,1.0,1,1.0,1,1.0,1,0.1550979099284027,36
2907,1,9696,2116,7580,0,0,0,1.0,1,1.0,1,1.0,1,0.16015223010487561,37
2908,2,9698,2118,7580,0,0,0,1.0,1,1.0,1,1.0,1,0.17657285844037734,38
2909,1,9699,2119,7580,0,0,0,1.0,1,1.0,1,1.0,1,0.1848062672495775,37
2910,2,9701,2120,7581,0,0,0,1.0,1,1.0,1,1.0,1,0.1961351002274462,37
2911,3,9704,2120,7584,0,0,0,1.0,1,1.0,1,1.0,1,0.22688289898461605,36
2912,5,9709,2122,7587,0,0,0,1.0,1,1.0,1,1.0,1,0.22936380789428798,36
2913,4,9713,2122,7591,0,0,0,1.0,1,1.0,1,1.0,1,0.20316188268381366,36
2914,1,9714,2122,7592,0,0,0,1.0,1,1.0,1,1.0,1,0.21244658487026027,38
2915,1,9715,2122,7593,0,0,0,1.0,1,1.0,1,1.0,1,0.17955754258583997,37
2916,3,9718,2123,7595,0,0,0,1.0,1,1.0,1,1.0,1,0.12648642696350473,39
2917,3,9721,2125,7596,0,0,0,1.0,1,1.0,1,1.0,1,0.12217484193605416,40
2918,7,9728,2128,7600,0,0,0,1.0,1,1.0,1,1.0,1,0.2031338285259169,40
2919,5,9733,2129,7604,0,0,0,1.0,1,1.0,1,1.0,1,0.2035648547968912,42
2920,5,9738,2129,7609,0,0,0,1.0,1,1.0,1,1.0,1,0.19413052706201303,42
2921,5,9743,2129,7614,0,0,0,1.0,1,1.0,1,1.0,1,0.2003647374997409,42
2922,6,9749,2129,7620,0,0,0,1.0,1,1.0,1,1.0,1,0.20472137244820507,43
2923,4,9753,2129,7624,0,0,0,1.0,1,1.0,1,1.0,1,0.21712598479994177,45
2924,8,9761,2132,7629,0,0,0,1.0,1,1.0,1,1.0,1,0.2228639571467525,46
2925,13,9774,2132,7642,0,0,0,1.0,1,1.0,1,1.0,1,0.18981583869763272,46
2926,3,9777,2132,7645,0,0,0,1.0,1,1.0,1,1.0,1,0.14052919380404116,46
2927,3,9780,2133,7647,0,0,0,1.0,1,1.0,1,1.0,1,0.13526824069824084,48
2928,3,9783,2133,7650,0,0,0,1.0,1,1.0,1,1.0,1,0.13812867255255956,48
2929,1,9784,2133,7651,0,0,0,1.0,1,1.0,1,1.0,1,0.13353674245502048,48
2930,7,9791,2133,7658,0,0,0,1.0,1,1.0,1,1.0,1,0.12168974499264518,50
2931,3,9794,2133,7661,0,0,0,1.0,1,1.0,1,1.0,1,0.10627037355430365,51
2932,3,9797,2133,7664,0,0,0,1.0,1,1.0,1,1.0,1,0.11866470396926246,52
2933,5,9802,2134,7668,0,0,0,1.0,1,1.0,1,1.0,1,0.13099605120884616,53
2934,4,9806,2134,7672,0,0,0,1.0,1,1.0,1,1.0,1,0.1128267436620851,54
2935,4,9810,2134,7676,0,0,0,1.0,1,1.0,1,1.0,1,0.1046276107798245,53
2936,4,9814,2134,7680,0,0,0,1.0,1,1.0,1,1.0,1,0.08721646830974875,53
2937,1,9815,2134,7681,0,0,0,1.0,1,1.0,1,1.0,1,0.10401960312584306,51
2938,3,9818,2135,7683,0,0,0,1.0,1,1.0,1,1.0,1,0.1212746784822136,53
2939,1,9819,2135,7684,0,0,0,1.0,1,1.0,1,1.0,1,0.12587069149901545,52
2940,5,9824,2137,7687,0,0,0,1.0,1,1.0,1,1.0,1,0.15412966809344303,52
2941,0,9824,2137,7687,0,0,0,1.0,1,1.0,1,1.0,1,0.14893864856239872,50
2942,0,9824,2137,7687,0,0,0,1.0,1,1.0,1,1.0,1,0.16364610122172682,50
2943,2,9826,2138,7688,0,0,0,1.0,1,1.0,1,1.0,1,0.13275568151286624,49
2944,2,9828,2139,7689,0,0,0,1.0,1,1.0,1,1.0,1,0.10933826015477797,48
2945,1,9829,2140,7689,0,0,0,1.0,1,1.0,1,1.0,1,0.12711094872229803,48
2946,4,9833,2144,7689,0,0,0,1.0,1,1.0,1,1.0,1,0.12956790756709324,47
2947,3,9836,2145,7691,0,0,0,1.0,1,1.0,1,1.0,1,0.15598970831761427,47
2948,3,9839,2146,7693,0,0,0,1.0,1,1.0,1,1.0,1,0.15878320445170055,48
2949,1,9840,2146,7694,0,0,0,1.0,1,1.0,1,1.0,1,0.17181564484274506,48
2950,2,9842,2147,7695,0,0,0,1.0,1,1.0,1,1.0,1,0.16862826457500193,48
2951,2,9844,2147,7697,0,0,0,1.0,1,1.0,1,1.0,1,0.18512326970425827,50
2952,1,9845,2147,7698,0,0,0,1.0,1,1.0,1,1.0,1,0.18787506916958605,50
2953,2,9847,2147,7700,0,0,0,1.0,1,1.0,1,1.0,1,0.19618823053297169,51
2954,2,9849,2147,7702,0,0,0,1.0,1,1.0,1,1.0,1,0.19618823053297169,51
2955,3,9852,2148,7704,0,0,0,1.0,1,1.0,1,1.0,1,0.2085701706827525,51
2956,10,9862,2149,7713,0,0,0,1.0,1,1.0,1,1.0,1,0.14450383567246783,51
2957,3,9865,2149,7716,0,0,0,1.0,1,1.0,1,1.0,1,0.13466765318295082,52
2958,2,9867,2149,7718,0,0,0,1.0,1,1.0,1,1.0,1,0.1021257163543761,52
2959,6,9873,2152,7721,0,0,0,1.0,1,1.0,1,1.0,1,0.17535855230600633,53
2960,3,9876,2152,7724,0,0,0,1.0,1,1.0,1,1.0,1,0.16316585139918585,52
2961,4,9880,2152,7728,0,0,0,1.0,1,1.0,1,1.0,1,0.18231288437983642,53
2962,4,9884,2152,7732,0,0,0,1.0,1,1.0,1,1.0,1,0.19412006641738663,54
2963,5,9889,2153,7736,0,0,0,1.0,1,1.0,1,1.0,1,0.2047170683445225,55
2964,8,9897,2153,7744,0,0,0,1.0,1,1.0,1,1.0,1,0.20655624872870076,55
2965,4,9901,2153,7748,0,0,0,1.0,1,1.0,1,1.0,1,0.22973691689985237,55
2966,7,9908,2154,7754,0,0,0,1.0,1,1.0,1,1.0,1,0.17908239231705766,55
2967,6,9914,2154,7760,0,0,0,1.0,1,1.0,1,1.0,1,0.1765553300102422,56
2968,8,9922,2154,7768,0,0,0,1.0,1,1.0,1,1.0,1,0.17566690576463098,56
2969,5,9927,2155,7772,0,0,0,1.0,1,1.0,1,1.0,1,0.21307528487903446,55
2970,10,9937,2156,7781,0,0,0,1.0,1,1.0,1,1.0,1,0.1973245808522249,57
2971,6,9943,2156,7787,0,0,0,1.0,1,1.0,1,1.0,1,0.15881593034868483,56
2972,3,9946,2156,7790,0,0,0,1.0,1,1.0,1,1.0,1,0.1599956209212501,57
2973,3,9949,2156,7793,0,0,0,1.0,1,1.0,1,1.0,1,0.12978943315905925,59
2974,3,9952,2157,7795,0,0,0,1.0,1,1.0,1,1.0,1,0.1331652680637005,60
2975,3,9955,2158,7797,0,0,0,1.0,1,1.0,1,1.0,1,0.13318311708228178,58
2976,2,9957,2159,7798,0,0,0,1.0,1,1.0,1,1.0,1,0.15086751581959137,59
2977,3,9960,2160,7800,0,0,0,1.0,1,1.0,1,1.0,1,0.12988540618834093,59
2978,5,9965,2161,7804,0,0,0,1.0,1,1.0,1,1.0,1,0.11300238408297154,58
2979,1,9966,2162,7804,0,0,0,1.0,1,1.0,1,1.0,1,0.11825173881868395,57
2980,0,9966,2162,7804,0,0,0,1.0,1,1.0,1,1.0,1,0.11519124653999514,56
2981,1,9967,2163,7804,0,0,0,1.0,1,1.0,1,1.0,1,0.14234951457662826,56
2982,1,9968,2164,7804,0,0,0,1.0,1,1.0,1,1.0,1,0.1383907533670849,57
2983,1,9969,2165,7804,0,0,0,1.0,1,1.0,1,1.0,1,0.15945764892710163,57
2984,3,9972,2168,7804,0,0,0,1.0,1,1.0,1,1.0,1,0.18409449279276244,56
2985,4,9976,2170,7806,0,0,0,1.0,1,1.0,1,1.0,1,0.1723572520586914,55
2986,13,9989,2174,7815,0,0,0,1.0,1,1.0,1,1.0,1,0.08732371738318771,55
2987,1,9990,2174,7816,0,0,0,1.0,1,1.0,1,1.0,1,0.11726517712322718,51
2988,1,9991,2175,7816,0,0,0,1.0,1,1.0,1,1.0,1,0.1036906685046815,52
2989,0,9991,2175,7816,0,0,0,1.0,1,1.0,1,1.0,1,0.1309743568508701,50
2990,2,9993,2176,7817,0,0,0,1.0,1,1.0,1,1.0,1,0.12505475197522928,50
2991,0,9993,2176,7817,0,0,0,1.0,1,1.0,1,1.0,1,0.10560296708094255,50
2992,2,9995,2177,7818,0,0,0,1.0,1,1.0,1,1.0,1,0.15574852054446836,50
2993,3,9998,2177,7821,0,0,0,1.0,1,1.0,1,1.0,1,0.16307339943389182,51
2994,4,10002,2179,7823,0,0,0,1.0,1,1.0,1,1.0,1,0.18143038274816525,51
2995,1,10003,2179,7824,0,0,0,1.0,1,1.0,1,1.0,1,0.19132914497930234,51
2996,2,10005,2179,7826,0,0,0,1.0,1,1.0,1,1.0,1,0.2007054082558008,52
2997,3,10008,2180,7828,0,0,0,1.0,1,1.0,1,1.0,1,0.20698338509869033,52
2998,2,10010,2182,7828,0,0,0,1.0,1,1.0,1,1.0,1,0.2520933433922227,51
2999,1,10011,2182,7829,0,0,0,1.0,1,1.0,1,1.0,1,0.25548282609597,51
3000,2,10013,2183,7830,0,0,0,1.0,1,1.0,1,1.0,1,0.23506601336743527,52
3001,8,10021,2183,7838,0,0,0,1.0,1,1.0,1,1.0,1,0.1349496353218242,52
3002,2,10023,2184,7839,0,0,0,1.0,1,1.0,1,1.0,1,0.15564912153565563,53
3003,2,10025,2184,7841,0,0,0,1.0,1,1.0,1,1.0,1,0.15399159362679257,54
3004,2,10027,2184,7843,0,0,0,1.0,1,1.0,1,1.0,1,0.15885373411021717,55
3005,8,10035,2184,7851,0,0,0,1.0,1,1.0,1,1.0,1,0.12361082017005999,56
3006,4,10039,2185,7854,0,0,0,1.0,1,1.0,1,1.0,1,0.1356530985652077,57
3007,5,10044,2185,7859,0,0,0,1.0,1,1.0,1,1.0,1,0.14405707630236042,58
3008,7,10051,2188,7863,0,0,0,1.0,1,1.0,1,1.0,1,0.18731192512928527,59
3009,4,10055,2188,7867,0,0,0,1.0,1,1.0,1,1.0,1,0.17057844385587484,59
3010,7,10062,2188,7874,0,0,0,1.0,1,1.0,1,1.0,1,0.11196996624954794,59
3011,1,10063,2188,7875,0,0,0,1.0,1,1.0,1,1.0,1,0.1273741017793928,59
3012,4,10067,2188,7879,0,0,0,1.0,1,1.0,1,1.0,1,0.1164642764239513,61
3013,5,10072,2189,7883,0,0,0,1.0,1,1.0,1,1.0,1,0.17736814404740645,59
3014,3,10075,2189,7886,0,0,0,1.0,1,1.0,1,1.0,1,0.17112885808384093,60
3015,5,10080,2190,7890,0,0,0,1.0,1,1.0,1,1.0,1,0.18424684355911242,58
3016,11,10091,2191,7900,0,0,0,1.0,1,1.0,1,1.0,1,0.1245974098726812,57
3017,4,10095,2194,7901,0,0,0,1.0,1,1.0,1,1.0,1,0.14729423361570515,58
3018,5,10100,2194,7906,0,0,0,1.0,1,1.0,1,1.0,1,0.17148539111004796,55
3019,5,10105,2194,7911,0,0,0,1.0,1,1.0,1,1.0,1,0.15141630793905148,56
3020,4,10109,2194,7915,0,0,0,1.0,1,1.0,1,1.0,1,0.20862063241831183,55
3021,8,10117,2195,7922,0,0,0,1.0,1,1.0,1,1.0,1,0.21938301690868545,55
3022,10,10127,2197,7930,0,0,0,1.0,1,1.0,1,1.0,1,0.27020306142211686,55
3023,4,10131,2197,7934,0,0,0,1.0,1,1.0,1,1.0,1,0.2535029836661772,54
3024,11,10142,2199,7943,0,0,0,1.0,1,1.0,1,1.0,1,0.2472869763456775,54
3025,7,10149,2202,7947,0,0,0,1.0,1,1.0,1,1.0,1,0.23881958904131723,54
3026,7,10156,2202,7954,0,0,0,1.0,1,1.0,1,1.0,1,0.21934307810921458,53
3027,8,10164,2204,7960,0,0,0,1.0,1,1.0,1,1.0,1,0.16521970796796226,53
3028,7,10171,2206,7965,0,0,0,1.0,1,1.0,1,1.0,1,0.1966696138627792,51
3029,4,10175,2206,7969,0,0,0,1.0,1,1.0,1,1.0,1,0.21182062160858187,51
3030,9,10184,2209,7975,0,0,0,1.0,1,1.0,1,1.0,1,0.21445097957116302,52
3031,10,10194,2209,7985,0,0,0,1.0,1,1.0,1,1.0,1,0.16303013037393624,51
3032,3,10197,2209,7988,0,0,0,1.0,1,1.0,1,1.0,1,0.12276854893937772,50
3033,3,10200,2209,7991,0,0,0,1.0,1,1.0,1,1.0,1,0.1663273657850474,52
3034,5,10205,2209,7996,0,0,0,1.0,1,1.0,1,1.0,1,0.13888906362875886,51
3035,4,10209,2209,8000,0,0,0,1.0,1,1.0,1,1.0,1,0.12078166255483562,51
3036,6,10215,2209,8006,0,0,0,1.0,1,1.0,1,1.0,1,0.16754599879947776,53
3037,10,10225,2209,8016,0,0,0,1.0,1,1.0,1,1.0,1,0.1698976836710188,52
3038,8,10233,2209,8024,0,0,0,1.0,1,1.0,1,1.0,1,0.1628352957744812,52
3039,6,10239,2209,8030,0,0,0,1.0,1,1.0,1,1.0,1,0.12276996939635614,54
3040,6,10245,2210,8035,0,0,0,1.0,1,1.0,1,1.0,1,0.1957921409026481,55
3041,7,10252,2210,8042,0,0,0,1.0,1,1.0,1,1.0,1,0.13605730580583025,56
3042,12,10264,2211,8053,0,0,0,1.0,1,1.0,1,1.0,1,0.1859310202582107,56
3043,11,10275,2212,8063,0,0,0,1.0,1,1.0,1,1.0,1,0.19549667808511934,57
3044,14,10289,2213,8076,0,0,0,1.0,1,1.0,1,1.0,1,0.1671695954964373,57
3045,13,10302,2213,8089,0,0,0,1.0,1,1.0,1,1.0,1,0.1636275993147575,56
3046,7,10309,2215,8094,0,0,0,1.0,1,1.0,1,1.0,1,0.10411753438647582,57
3047,1,10310,2215,8095,0,0,0,1.0,1,1.0,1,1.0,1,0.10676873964896998,56
3048,3,10313,2215,8098,0,0,0,1.0,1,1.0,1,1.0,1,0.09151447589692324,58
3049,3,10316,2217,8099,0,0,0,1.0,1,1.0,1,1.0,1,0.1423855441093483,59
3050,2,10318,2217,8101,0,0,0,1.0,1,1.0,1,1.0,1,0.12220641402998718,60
3051,4,10322,2219,8103,0,0,0,1.0,1,1.0,1,1.0,1,0.11882143915242312,59
3052,3,10325,2220,8105,0,0,0,1.0,1,1.0,1,1.0,1,0.12924754331307153,58
3053,5,10330,2222,8108,0,0,0,1.0,1,1.0,1,1.0,1,0.21138286837523995,57
3054,3,10333,2222,8111,0,0,0,1.0,1,1.0,1,1.0,1,0.18563211509918304,55
3055,3,10336,2222,8114,0,0,0,1.0,1,1.0,1,1.0,1,0.16710840067866453,54
3056,5,10341,2224,8117,0,0,0,1.0,1,1.0,1,1.0,1,0.2415368932215009,55
3057,8,10349,2224,8125,0,0,0,1.0,1,1.0,1,1.0,1,0.25237118188569985,54
3058,9,10358,2224,8134,0,0,0,1.0,1,1.0,1,1.0,1,0.2864596659776053,55
3059,10,10368,2224,8144,0,0,0,1.0,1,1.0,1,1.0,1,0.2727005756830936,56
3060,10,10378,2224,8154,0,0,0,1.0,1,1.0,1,1.0,1,0.2875864561231032,56
3061,12,10390,2224,8166,0,0,0,1.0,1,1.0,1,1.0,1,0.1727667890981609,56
3062,2,10392,2226,8166,0,0,0,1.0,1,1.0,1,1.0,1,0.17589127999813928,57
3063,1,10393,2226,8167,0,0,0,1.0,1,1.0,1,1.0,1,0.15096390057017303,55
3064,3,10396,2229,8167,0,0,0,1.0,1,1.0,1,1.0,1,0.16705662455425435,56
3065,3,10399,2230,8169,0,0,0,1.0,1,1.0,1,1.0,1,0.1443224128263881,55
3066,2,10401,2231,8170,0,0,0,1.0,1,1.0,1,1.0,1,0.14699920060459287,55
3067,4,10405,2232,8173,0,0,0,1.0,1,1.0,1,1.0,1,0.12347959371651517,54
3068,5,10410,2235,8175,0,0,0,1.0,1,1.0,1,1.0,1,0.16984527904566632,53
3069,5,10415,2237,8178,0,0,0,1.0,1,1.0,1,1.0,1,0.1810946234269674,51
3070,1,10416,2237,8179,0,0,0,1.0,1,1.0,1,1.0,1,0.18773163630163767,50
3071,6,10422,2238,8184,0,0,0,1.0,1,1.0,1,1.0,1,0.189890892062708,51
3072,5,10427,2238,8189,0,0,0,1.0,1,1.0,1,1.0,1,0.18243871022222063,53
3073,6,10433,2238,8195,0,0,0,1.0,1,1.0,1,1.0,1,0.17374155791927492,51
3074,2,10435,2238,8197,0,0,0,1.0,1,1.0,1,1.0,1,0.18516755027923154,50
3075,7,10442,2239,8203,0,0,0,1.0,1,1.0,1,1.0,1,0.20025283764064974,52
3076,9,10451,2240,8211,0,0,0,1.0,1,1.0,1,1.0,1,0.11177143413153456,53
3077,3,10454,2240,8214,0,0,0,1.0,1,1.0,1,1.0,1,0.13319719840930924,52
3078,4,10458,2240,8218,0,0,0,1.0,1,1.0,1,1.0,1,0.10946111062442425,53
3079,1,10459,2240,8219,0,0,0,1.0,1,1.0,1,1.0,1,0.10309819230567055,53
3080,3,10462,2241,8221,0,0,0,1.0,1,1.0,1,1.0,1,0.13707171530743667,52
3081,3,10465,2242,8223,0,0,0,1.0,1,1.0,1,1.0,1,0.15841657184082086,54
3082,5,10470,2245,8225,0,0,0,1.0,1,1.0,1,1.0,1,0.1915391460909868,54
3083,2,10472,2245,8227,0,0,0,1.0,1,1.0,1,1.0,1,0.17838711586455636,54
3084,3,10475,2246,8229,0,0,0,1.0,1,1.0,1,1.0,1,0.20695874472399012,55
3085,6,10481,2248,8233,0,0,0,1.0,1,1.0,1,1.0,1,0.22912167327749325,55
3086,7,10488,2248,8240,0,0,0,1.0,1,1.0,1,1.0,1,0.2146750276497515,56
3087,13,10501,2248,8253,0,0,0,1.0,1,1.0,1,1.0,1,0.24069591695694337,57
3088,13,10514,2248,8266,0,0,0,1.0,1,1.0,1,1.0,1,0.23292596098052645,56
3089,9,10523,2248,8275,0,0,0,1.0,1,1.0,1,1.0,1,0.21904687863174624,55
3090,4,10527,2248,8279,0,0,0,1.0,1,1.0,1,1.0,1,0.2366701037496575,54
3091,5,10532,2248,8284,0,0,0,1.0,1,1.0,1,1.0,1,0.2169676165096108,53
3092,2,10534,2248,8286,0,0,0,1.0,1,1.0,1,1.0,1,0.15059731480291177,56
3093,3,10537,2249,8288,0,0,0,1.0,1,1.0,1,1.0,1,0.15921685787620554,56
3094,2,10539,2249,8290,0,0,0,1.0,1,1.0,1,1.0,1,0.16839240890094484,58
3095,4,10543,2249,8294,0,0,0,1.0,1,1.0,1,1.0,1,0.1476521305803282,59
3096,1,10544,2249,8295,0,0,0,1.0,1,1.0,1,1.0,1,0.15917328262385,60
3097,4,10548,2250,8298,0,0,0,1.0,1,1.0,1,1.0,1,0.1682382416965326,60
3098,4,10552,2250,8302,0,0,0,1.0,1,1.0,1,1.0,1,0.17417399415789478,58
3099,2,10554,2250,8304,0,0,0,1.0,1,1.0,1,1.0,1,0.1833865805401288,57
3100,1,10555,2250,8305,0,0,0,1.0,1,1.0,1,1.0,1,0.18160328890828376,57
3101,2,10557,2251,8306,0,0,0,1.0,1,1.0,1,1.0,1,0.17947540950107546,58
3102,5,10562,2253,8309,0,0,0,1.0,1,1.0,1,1.0,1,0.1961902845252408,59
3103,3,10565,2253,8312,0,0,0,1.0,1,1.0,1,1.0,1,0.1726237376701784,58
3104,8,10573,2256,8317,0,0,0,1.0,1,1.0,1,1.0,1,0.16223103542125086,58
3105,2,10575,2256,8319,0,0,0,1.0,1,1.0,1,1.0,1,0.15404375873490916,56
3106,6,10581,2259,8322,0,0,0,1.0,1,1.0,1,1.0,1,0.17068314339923477,57
3107,7,10588,2261,8327,0,0,0,1.0,1,1.0,1,1.0,1,0.10094362844187635,55
3108,2,10590,2262,8328,0,0,0,1.0,1,1.0,1,1.0,1,0.09791470720689588,55
3109,3,10593,2264,8329,0,0,0,1.0,1,1.0,1,1.0,1,0.09580353217084081,54
3110,3,10596,2266,8330,0,0,0,1.0,1,1.0,1,1.0,1,0.11002081925380573,54
3111,2,10598,2266,8332,0,0,0,1.0,1,1.0,1,1.0,1,0.07654447223518296,54
3112,8,10606,2271,8335,0,0,0,1.0,1,1.0,1,1.0,1,0.0785858144640717,56
3113,5,10611,2276,8335,0,0,0,1.0,1,1.0,1,1.0,1,0.08806185784979456,55
3114,4,10615,2278,8337,0,0,0,1.0,1,1.0,1,1.0,1,0.09260253048235141,54
3115,1,10616,2279,8337,0,0,0,1.0,1,1.0,1,1.0,1,0.09582668766837071,56
3116,1,10617,2279,8338,0,0,0,1.0,1,1.0,1,1.0,1,0.0754359763826522,56
3117,2,10619,2279,8340,0,0,0,1.0,1,1.0,1,1.0,1,0.10337690123059606,58
3118,2,10621,2280,8341,0,0,0,1.0,1,1.0,1,1.0,1,0.10933132655911665,57
3119,2,10623,2281,8342,0,0,0,1.0,1,1.0,1,1.0,1,0.10453728229800109,57
3120,0,10623,2281,8342,0,0,0,1.0,1,1.0,1,1.0,1,0.10145312488724274,56
3121,3,10626,2283,8343,0,0,0,1.0,1,1.0,1,1.0,1,0.08612688391730558,57
3122,0,10626,2283,8343,0,0,0,1.0,1,1.0,1,1.0,1,0.08612688391730558,57
3123,0,10626,2283,8343,0,0,0,1.0,1,1.0,1,1.0,1,0.08612688391730558,57
3124,0,10626,2283,8343,0,0,0,1.0,1,1.0,1,1.0,1,0.07604763515503069,59
3125,2,10628,2284,8344,0,0,0,1.0,1,1.0,1,1.0,1,0.0848389672149188,61
3126,2,10630,2285,8345,0,0,0,1.0,1,1.0,1,1.0,1,0.09249263302187016,60
3127,2,10632,2286,8346,0,0,0,1.0,1,1.0,1,1.0,1,0.06486695961257408,58
3128,2,10634,2287,8347,0,0,0,1.0,1,1.0,1,1.0,1,0.11256381224331996,58
3129,1,10635,2287,8348,0,0,0,1.0,1,1.0,1,1.0,1,0.10266578088081352,56
3130,0,10635,2287,8348,0,0,0,1.0,1,1.0,1,1.0,1,0.15175694456044603,56
3131,4,10639,2288,8351,0,0,0,1.0,1,1.0,1,1.0,1,0.15374093982625894,55
3132,2,10641,2290,8351,0,0,0,1.0,1,1.0,1,1.0,1,0.1726882865472913,53
3133,1,10642,2290,8352,0,0,0,1.0,1,1.0,1,1.0,1,0.1547339129997864,52
3134,2,10644,2292,8352,0,0,0,1.0,1,1.0,1,1.0,1,0.17103188172404282,52
3135,1,10645,2293,8352,0,0,0,1.0,1,1.0,1,1.0,1,0.1630442787788358,53
3136,7,10652,2296,8356,0,0,0,1.0,1,1.0,1,1.0,1,0.1077073719904143,54
3137,4,10656,2297,8359,0,0,0,1.0,1,1.0,1,1.0,1,0.09787238634448855,55
3138,6,10662,2300,8362,0,0,0,1.0,1,1.0,1,1.0,1,0.15203701500129774,57
3139,7,10669,2301,8368,0,0,0,1.0,1,1.0,1,1.0,1,0.14673269561985555,56
3140,4,10673,2303,8370,0,0,0,1.0,1,1.0,1,1.0,1,0.12443772243394022,56
3141,5,10678,2305,8373,0,0,0,1.0,1,1.0,1,1.0,1,0.15853916832337678,56
3142,2,10680,2305,8375,0,0,0,1.0,1,1.0,1,1.0,1,0.15853916832337678,56
3143,1,10681,2306,8375,0,0,0,1.0,1,1.0,1,1.0,1,0.1458546725482121,56
3144,2,10683,2307,8376,0,0,0,1.0,1,1.0,1,1.0,1,0.15106336023077166,54
3145,6,10689,2308,8381,0,0,0,1.0,1,1.0,1,1.0,1,0.12146600168594564,55
3146,2,10691,2309,8382,0,0,0,1.0,1,1.0,1,1.0,1,0.15520204800200263,53
3147,5,10696,2309,8387,0,0,0,1.0,1,1.0,1,1.0,1,0.14981713664487886,54
3148,5,10701,2311,8390,0,0,0,1.0,1,1.0,1,1.0,1,0.14077408696345892,54
3149,6,10707,2312,8395,0,0,0,1.0,1,1.0,1,1.0,1,0.13918501287769228,53
3150,5,10712,2312,8400,0,0,0,1.0,1,1.0,1,1.0,1,0.13571784210887883,53
3151,6,10718,2312,8406,0,0,0,1.0,1,1.0,1,1.0,1,0.10434600406309948,53
3152,1,10719,2313,8406,0,0,0,1.0,1,1.0,1,1.0,1,0.07719100856450901,54
3153,2,10721,2313,8408,0,0,0,1.0,1,1.0,1,1.0,1,0.10235943015069257,53
3154,4,10725,2314,8411,0,0,0,1.0,1,1.0,1,1.0,1,0.1379674125276377,55
3155,1,10726,2314,8412,0,0,0,1.0,1,1.0,1,1.0,1,0.1265217714097248,56
3156,2,10728,2314,8414,0,0,0,1.0,1,1.0,1,1.0,1,0.15533529408202193,56
3157,4,10732,2314,8418,0,0,0,1.0,1,1.0,1,1.0,1,0.1538010023691588,56
3158,4,10736,2314,8422,0,0,0,1.0,1,1.0,1,1.0,1,0.14973150372309904,57
3159,3,10739,2315,8424,0,0,0,1.0,1,1.0,1,1.0,1,0.1595221383467293,56
3160,3,10742,2315,8427,0,0,0,1.0,1,1.0,1,1.0,1,0.18569946512132268,58
3161,7,10749,2315,8434,0,0,0,1.0,1,1.0,1,1.0,1,0.17296335565191912,59
3162,4,10753,2315,8438,0,0,0,1.0,1,1.0,1,1.0,1,0.1790988999039056,59
3163,11,10764,2317,8447,0,0,0,1.0,1,1.0,1,1.0,1,0.21277633818443004,59
3164,8,10772,2317,8455,0,0,0,1.0,1,1.0,1,1.0,1,0.17498627814494072,60
3165,7,10779,2317,8462,0,0,0,1.0,1,1.0,1,1.0,1,0.19070757111354683,58
3166,7,10786,2317,8469,0,0,0,1.0,1,1.0,1,1.0,1,0.11009871191156358,59
3167,1,10787,2318,8469,0,0,0,1.0,1,1.0,1,1.0,1,0.09107212520094629,57
3168,1,10788,2318,8470,0,0,0,1.0,1,1.0,1,1.0,1,0.07770669623916471,58
3169,2,10790,2320,8470,0,0,0,1.0,1,1.0,1,1.0,1,0.11185158406335644,57
3170,3,10793,2320,8473,0,0,0,1.0,1,1.0,1,1.0,1,0.10680019607423863,55
3171,6,10799,2324,8475,0,0,0,1.0,1,1.0,1,1.0,1,0.18015245395986593,56
3172,1,10800,2324,8476,0,0,0,1.0,1,1.0,1,1.0,1,0.19511283115643732,54
3173,5,10805,2325,8480,0,0,0,1.0,1,1.0,1,1.0,1,0.21009586647655956,53
3174,3,10808,2326,8482,0,0,0,1.0,1,1.0,1,1.0,1,0.22370970098338644,53
3175,4,10812,2327,8485,0,0,0,1.0,1,1.0,1,1.0,1,0.20874903767576977,52
3176,2,10814,2328,8486,0,0,0,1.0,1,1.0,1,1.0,1,0.19341931612405178,53
3177,5,10819,2331,8488,0,0,0,1.0,1,1.0,1,1.0,1,0.26744640164256467,52
3178,4,10823,2331,8492,0,0,0,1.0,1,1.0,1,1.0,1,0.22475727272580176,53
3179,2,10825,2331,8494,0,0,0,1.0,1,1.0,1,1.0,1,0.19513002187427458,54
3180,2,10827,2331,8496,0,0,0,1.0,1,1.0,1,1.0,1,0.20342746055147648,54
3181,10,10837,2331,8506,0,0,0,1.0,1,1.0,1,1.0,1,0.08434598827180222,55
3182,1,10838,2331,8507,0,0,0,1.0,1,1.0,1,1.0,1,0.09216233527125234,54
3183,5,10843,2332,8511,0,0,0,1.0,1,1.0,1,1.0,1,0.12101390831368172,56
3184,6,10849,2333,8516,0,0,0,1.0,1,1.0,1,1.0,1,0.12320337580636471,54
3185,5,10854,2335,8519,0,0,0,1.0,1,1.0,1,1.0,1,0.1077127245490752,53
3186,4,10858,2337,8521,0,0,0,1.0,1,1.0,1,1.0,1,0.14858798592411498,52
3187,1,10859,2337,8522,0,0,0,1.0,1,1.0,1,1.0,1,0.15432604286134022,50
3188,5,10864,2339,8525,0,0,0,1.0,1,1.0,1,1.0,1,0.20194532465940943,50
3189,7,10871,2340,8531,0,0,0,1.0,1,1.0,1,1.0,1,0.2151176118216316,49
3190,8,10879,2341,8538,0,0,0,1.0,1,1.0,1,1.0,1,0.2359629163691096,50
3191,12,10891,2343,8548,0,0,0,1.0,1,1.0,1,1.0,1,0.2521561112494311,49
3192,7,10898,2343,8555,0,0,0,1.0,1,1.0,1,1.0,1,0.24736009164687456,49
3193,5,10903,2343,8560,0,0,0,1.0,1,1.0,1,1.0,1,0.2548981536136807,49
3194,8,10911,2345,8566,0,0,0,1.0,1,1.0,1,1.0,1,0.3017903767855349,50
3195,9,10920,2345,8575,0,0,0,1.0,1,1.0,1,1.0,1,0.30811759406944733,49
3196,8,10928,2345,8583,0,0,0,1.0,1,1.0,1,1.0,1,0.21568890821155573,49
3197,1,10929,2345,8584,0,0,0,1.0,1,1.0,1,1.0,1,0.1787942198384983,50
3198,2,10931,2345,8586,0,0,0,1.0,1,1.0,1,1.0,1,0.15715689746003142,50
3199,3,10934,2345,8589,0,0,0,1.0,1,1.0,1,1.0,1,0.12890851125647246,52
3200,7,10941,2345,8596,0,0,0,1.0,1,1.0,1,1.0,1,0.12176645674356168,53
3201,5,10946,2345,8601,0,0,0,1.0,1,1.0,1,1.0,1,0.12825867347180514,55
3202,8,10954,2347,8607,0,0,0,1.0,1,1.0,1,1.0,1,0.16599735050291273,55
3203,8,10962,2347,8615,0,0,0,1.0,1,1.0,1,1.0,1,0.1397827539669635,53
3204,9,10971,2348,8623,0,0,0,1.0,1,1.0,1,1.0,1,0.15872131270401668,53
3205,9,10980,2349,8631,0,0,0,1.0,1,1.0,1,1.0,1,0.2206404612704342,53
3206,8,10988,2349,8639,0,0,0,1.0,1,1.0,1,1.0,1,0.20411296991040798,52
3207,12,11000,2351,8649,0,0,0,1.0,1,1.0,1,1.0,1,0.258758116066301,53
3208,15,11015,2351,8664,0,0,0,1.0,1,1.0,1,1.0,1,0.2502538458109532,51
3209,12,11027,2351,8676,0,0,0,1.0,1,1.0,1,1.0,1,0.27871080347317956,52
3210,15,11042,2351,8691,0,0,0,1.0,1,1.0,1,1.0,1,0.26872673277069614,49
3211,10,11052,2351,8701,0,0,0,1.0,1,1.0,1,1.0,1,0.16227498537808946,48
3212,4,11056,2351,8705,0,0,0,1.0,1,1.0,1,1.0,1,0.1987947849176998,48
3213,7,11063,2351,8712,0,0,0,1.0,1,1.0,1,1.0,1,0.17098551172997947,49
3214,9,11072,2351,8721,0,0,0,1.0,1,1.0,1,1.0,1,0.16986919591582886,51
3215,4,11076,2351,8725,0,0,0,1.0,1,1.0,1,1.0,1,0.18278261257073336,51
3216,5,11081,2351,8730,0,0,0,1.0,1,1.0,1,1.0,1,0.21085563409942504,51
3217,5,11086,2352,8734,0,0,0,1.0,1,1.0,1,1.0,1,0.15516129110195392,51
3218,5,11091,2352,8739,0,0,0,1.0,1,1.0,1,1.0,1,0.1689338661468176,51
3219,4,11095,2352,8743,0,0,0,1.0,1,1.0,1,1.0,1,0.18130538675457097,52
3220,2,11097,2352,8745,0,0,0,1.0,1,1.0,1,1.0,1,0.15057638035554421,52
3221,7,11104,2352,8752,0,0,0,1.0,1,1.0,1,1.0,1,0.17501128320181675,54
3222,5,11109,2352,8757,0,0,0,1.0,1,1.0,1,1.0,1,0.14762709751033595,54
3223,7,11116,2352,8764,0,0,0,1.0,1,1.0,1,1.0,1,0.18357633235920381,56
3224,5,11121,2353,8768,0,0,0,1.0,1,1.0,1,1.0,1,0.13926560146289063,57
3225,10,11131,2353,8778,0,0,0,1.0,1,1.0,1,1.0,1,0.10178480794804615,58
3226,1,11132,2353,8779,0,0,0,1.0,1,1.0,1,1.0,1,0.08034954783259707,58
3227,0,11132,2353,8779,0,0,0,1.0,1,1.0,1,1.0,1,0.08034954783259707,58
3228,0,11132,2353,8779,0,0,0,1.0,1,1.0,1,1.0,1,0.08034954783259707,58
3229,3,11135,2355,8780,0,0,0,1.0,1,1.0,1,1.0,1,0.13509002795656835,60
3230,2,11137,2355,8782,0,0,0,1.0,1,1.0,1,1.0,1,0.13772902205261667,61
3231,1,11138,2355,8783,0,0,0,1.0,1,1.0,1,1.0,1,0.1495583333818654,61
3232,1,11139,2355,8784,0,0,0,1.0,1,1.0,1,1.0,1,0.13772902205261667,61
3233,6,11145,2355,8790,0,0,0,1.0,1,1.0,1,1.0,1,0.12270330904552985,63
3234,2,11147,2356,8791,0,0,0,1.0,1,1.0,1,1.0,1,0.15865049073749324,64
3235,4,11151,2356,8795,0,0,0,1.0,1,1.0,1,1.0,1,0.1468909599302959,65
3236,4,11155,2356,8799,0,0,0,1.0,1,1.0,1,1.0,1,0.15455628229335194,66
3237,2,11157,2356,8801,0,0,0,1.0,1,1.0,1,1.0,1,0.16437801398894827,67
3238,4,11161,2356,8805,0,0,0,1.0,1,1.0,1,1.0,1,0.1382856401273231,67
3239,8,11169,2356,8813,0,0,0,1.0,1,1.0,1,1.0,1,0.1624731581321012,69
3240,12,11181,2356,8825,0,0,0,1.0,1,1.0,1,1.0,1,0.18302296128495502,69
3241,7,11188,2358,8830,0,0,0,1.0,1,1.0,1,1.0,1,0.11299662616975331,68
3242,2,11190,2359,8831,0,0,0,1.0,1,1.0,1,1.0,1,0.1472826806800651,67
3243,4,11194,2360,8834,0,0,0,1.0,1,1.0,1,1.0,1,0.10092325267828846,68
3244,4,11198,2360,8838,0,0,0,1.0,1,1.0,1,1.0,1,0.12769168568038625,68
3245,3,11201,2360,8841,0,0,0,1.0,1,1.0,1,1.0,1,0.09615809714635738,69
3246,3,11204,2360,8844,0,0,0,1.0,1,1.0,1,1.0,1,0.10458130255466948,68
3247,2,11206,2360,8846,0,0,0,1.0,1,1.0,1,1.0,1,0.1357456374846433,68
3248,2,11208,2361,8847,0,0,0,1.0,1,1.0,1,1.0,1,0.1197436959412743,68
3249,2,11210,2361,8849,0,0,0,1.0,1,1.0,1,1.0,1,0.12592101802721384,69
3250,1,11211,2361,8850,0,0,0,1.0,1,1.0,1,1.0,1,0.11623307174870577,69
3251,2,11213,2362,8851,0,0,0,1.0,1,1.0,1,1.0,1,0.11230029641796413,68
3252,0,11213,2362,8851,0,0,0,1.0,1,1.0,1,1.0,1,0.09567265936865554,68
3253,1,11214,2363,8851,0,0,0,1.0,1,1.0,1,1.0,1,0.11021199481058634,69
3254,1,11215,2364,8851,0,0,0,1.0,1,1.0,1,1.0,1,0.12517364330017966,69
3255,1,11216,2364,8852,0,0,0,1.0,1,1.0,1,1.0,1,0.1298603005696604,70
3256,4,11220,2365,8855,0,0,0,1.0,1,1.0,1,1.0,1,0.1075328150717453,70
3257,3,11223,2365,8858,0,0,0,1.0,1,1.0,1,1.0,1,0.08200954100508419,71
3258,2,11225,2367,8858,0,0,0,1.0,1,1.0,1,1.0,1,0.11639277500156639,72
3259,5,11230,2368,8862,0,0,0,1.0,1,1.0,1,1.0,1,0.09879967091969558,71
3260,5,11235,2371,8864,0,0,0,1.0,1,1.0,1,1.0,1,0.11221511443784453,72
3261,3,11238,2371,8867,0,0,0,1.0,1,1.0,1,1.0,1,0.09591142559127819,74
3262,0,11238,2371,8867,0,0,0,1.0,1,1.0,1,1.0,1,0.1015305514954812,73
3263,4,11242,2373,8869,0,0,0,1.0,1,1.0,1,1.0,1,0.1192997281101887,73
3264,5,11247,2375,8872,0,0,0,1.0,1,1.0,1,1.0,1,0.1488154846516231,71
3265,3,11250,2375,8875,0,0,0,1.0,1,1.0,1,1.0,1,0.12453600515853186,70
3266,3,11253,2377,8876,0,0,0,1.0,1,1.0,1,1.0,1,0.13126597295116427,69
3267,3,11256,2378,8878,0,0,0,1.0,1,1.0,1,1.0,1,0.1485743331056803,69
3268,3,11259,2381,8878,0,0,0,1.0,1,1.0,1,1.0,1,0.17673722910764175,68
3269,8,11267,2384,8883,0,0,0,1.0,1,1.0,1,1.0,1,0.22247271858283812,68
3270,4,11271,2384,8887,0,0,0,1.0,1,1.0,1,1.0,1,0.23424952489829406,67
3271,7,11278,2384,8894,0,0,0,1.0,1,1.0,1,1.0,1,0.18230038716955915,66
3272,1,11279,2385,8894,0,0,0,1.0,1,1.0,1,1.0,1,0.16597721693706205,67
3273,6,11285,2385,8900,0,0,0,1.0,1,1.0,1,1.0,1,0.1593878434294304,66
3274,2,11287,2386,8901,0,0,0,1.0,1,1.0,1,1.0,1,0.1431042481023264,68
3275,1,11288,2386,8902,0,0,0,1.0,1,1.0,1,1.0,1,0.14697851827671832,68
3276,2,11290,2386,8904,0,0,0,1.0,1,1.0,1,1.0,1,0.13391997102933367,69
3277,2,11292,2387,8905,0,0,0,1.0,1,1.0,1,1.0,1,0.16123151044890852,68
3278,4,11296,2387,8909,0,0,0,1.0,1,1.0,1,1.0,1,0.15637297828319421,69
3279,3,11299,2388,8911,0,0,0,1.0,1,1.0,1,1.0,1,0.1651166403092476,67
3280,3,11302,2388,8914,0,0,0,1.0,1,1.0,1,1.0,1,0.15248760395232583,66
3281,4,11306,2389,8917,0,0,0,1.0,1,1.0,1,1.0,1,0.14624694036728297,67
3282,3,11309,2389,8920,0,0,0,1.0,1,1.0,1,1.0,1,0.14966514876074627,66
3283,4,11313,2390,8923,0,0,0,1.0,1,1.0,1,1.0,1,0.15888101386905887,67
3284,2,11315,2390,8925,0,0,0,1.0,1,1.0,1,1.0,1,0.13859593320112745,66
3285,2,11317,2391,8926,0,0,0,1.0,1,1.0,1,1.0,1,0.15226185382337934,66
3286,3,11320,2391,8929,0,0,0,1.0,1,1.0,1,1.0,1,0.12003173207691752,63
3287,2,11322,2392,8930,0,0,0,1.0,1,1.0,1,1.0,1,0.16097877491515772,61
3288,3,11325,2392,8933,0,0,0,1.0,1,1.0,1,1.0,1,0.17643522769445838,63
3289,1,11326,2392,8934,0,0,0,1.0,1,1.0,1,1.0,1,0.1804512641606487,62
3290,4,11330,2393,8937,0,0,0,1.0,1,1.0,1,1.0,1,0.1784284111258286,63
3291,4,11334,2394,8940,0,0,0,1.0,1,1.0,1,1.0,1,0.2081505692110713,62
3292,4,11338,2395,8943,0,0,0,1.0,1,1.0,1,1.0,1,0.20867608030069465,63
3293,1,11339,2395,8944,0,0,0,1.0,1,1.0,1,1.0,1,0.234413473357333,65
3294,1,11340,2395,8945,0,0,0,1.0,1,1.0,1,1.0,1,0.21590723553135305,65
3295,0,11340,2395,8945,0,0,0,1.0,1,1.0,1,1.0,1,0.21590723553135305,65
3296,0,11340,2395,8945,0,0,0,1.0,1,1.0,1,1.0,1,0.21590723553135305,65
3297,2,11342,2396,8946,0,0,0,1.0,1,1.0,1,1.0,1,0.1978793669029877,66
3298,0,11342,2396,8946,0,0,0,1.0,1,1.0,1,1.0,1,0.1978793669029877,66
3299,2,11344,2396,8948,0,0,0,1.0,1,1.0,1,1.0,1,0.19119091906755034,67
3300,3,11347,2398,8949,0,0,0,1.0,1,1.0,1,1.0,1,0.2022491098226451,67
3301,6,11353,2399,8954,0,0,0,1.0,1,1.0,1,1.0,1,0.17030862606293112,68
3302,2,11355,2399,8956,0,0,0,1.0,1,1.0,1,1.0,1,0.16948174280549838,67
3303,1,11356,2400,8956,0,0,0,1.0,1,1.0,1,1.0,1,0.1641347540705017,67
3304,3,11359,2401,8958,0,0,0,1.0,1,1.0,1,1.0,1,0.16508552572263735,67
3305,3,11362,2401,8961,0,0,0,1.0,1,1.0,1,1.0,1,0.16305177125478892,69
3306,1,11363,2401,8962,0,0,0,1.0,1,1.0,1,1.0,1,0.14566770540029556,70
3307,1,11364,2401,8963,0,0,0,1.0,1,1.0,1,1.0,1,0.12795413500132122,70
3308,1,11365,2401,8964,0,0,0,1.0,1,1.0,1,1.0,1,0.12331801603045604,70
3309,2,11367,2401,8966,0,0,0,1.0,1,1.0,1,1.0,1,0.13297193903790916,72
3310,0,11367,2401,8966,0,0,0,1.0,1,1.0,1,1.0,1,0.14711945750082292,74
3311,0,11367,2401,8966,0,0,0,1.0,1,1.0,1,1.0,1,0.14711945750082292,74
3312,0,11367,2401,8966,0,0,0,1.0,1,1.0,1,1.0,1,0.14711945750082292,74
3313,2,11369,2401,8968,0,0,0,1.0,1,1.0,1,1.0,1,0.14229295521126453,75
3314,3,11372,2401,8971,0,0,0,1.0,1,1.0,1,1.0,1,0.15239177008053442,76
3315,4,11376,2402,8974,0,0,0,1.0,1,1.0,1,1.0,1,0.18005663542690495,75
3316,8,11384,2404,8980,0,0,0,1.0,1,1.0,1,1.0,1,0.14634630016922126,76
3317,1,11385,2405,8980,0,0,0,1.0,1,1.0,1,1.0,1,0.15846237319134607,73
3318,3,11388,2407,8981,0,0,0,1.0,1,1.0,1,1.0,1,0.19435948634660308,72
3319,2,11390,2408,8982,0,0,0,1.0,1,1.0,1,1.0,1,0.2200009055228665,71
3320,3,11393,2409,8984,0,0,0,1.0,1,1.0,1,1.0,1,0.18332569941708482,70
3321,3,11396,2410,8986,0,0,0,1.0,1,1.0,1,1.0,1,0.19255454860499516,69
3322,2,11398,2412,8986,0,0,0,1.0,1,1.0,1,1.0,1,0.18341721386403348,68
3323,0,11398,2412,8986,0,0,0,1.0,1,1.0,1,1.0,1,0.18331996120063432,69
3324,3,11401,2414,8987,0,0,0,1.0,1,1.0,1,1.0,1,0.17398176141257038,69
3325,1,11402,2414,8988,0,0,0,1.0,1,1.0,1,1.0,1,0.18354403219715404,70
3326,3,11405,2417,8988,0,0,0,1.0,1,1.0,1,1.0,1,0.19309651706279343,69
3327,2,11407,2419,8988,0,0,0,1.0,1,1.0,1,1.0,1,0.18330424353965827,70
3328,2,11409,2420,8989,0,0,0,1.0,1,1.0,1,1.0,1,0.1968533113484436,73
3329,3,11412,2421,8991,0,0,0,1.0,1,1.0,1,1.0,1,0.21283895571652228,72
3330,2,11414,2422,8992,0,0,0,1.0,1,1.0,1,1.0,1,0.2165472005531263,72
3331,8,11422,2424,8998,0,0,0,1.0,1,1.0,1,1.0,1,0.21283245498508852,72
3332,3,11425,2424,9001,0,0,0,1.0,1,1.0,1,1.0,1,0.18678486566785907,73
3333,0,11425,2424,9001,0,0,0,1.0,1,1.0,1,1.0,1,0.183124576169496,72
3334,2,11427,2424,9003,0,0,0,1.0,1,1.0,1,1.0,1,0.16451929348223457,73
3335,1,11428,2425,9003,0,0,0,1.0,1,1.0,1,1.0,1,0.19555501314447196,74
3336,3,11431,2425,9006,0,0,0,1.0,1,1.0,1,1.0,1,0.1809507586286718,74
3337,2,11433,2425,9008,0,0,0,1.0,1,1.0,1,1.0,1,0.16568045423638728,74
3338,1,11434,2425,9009,0,0,0,1.0,1,1.0,1,1.0,1,0.16356323680914686,74
3339,3,11437,2427,9010,0,0,0,1.0,1,1.0,1,1.0,1,0.1802138505298016,75
3340,0,11437,2427,9010,0,0,0,1.0,1,1.0,1,1.0,1,0.19396251083986624,75
3341,1,11438,2427,9011,0,0,0,1.0,1,1.0,1,1.0,1,0.1890102199590916,76
3342,4,11442,2427,9015,0,0,0,1.0,1,1.0,1,1.0,1,0.1868807023413335,76
3343,6,11448,2429,9019,0,0,0,1.0,1,1.0,1,1.0,1,0.16808473838551977,75
3344,7,11455,2430,9025,0,0,0,1.0,1,1.0,1,1.0,1,0.1702350947045978,75
3345,4,11459,2431,9028,0,0,0,1.0,1,1.0,1,1.0,1,0.17873539498956967,72
3346,8,11467,2432,9035,0,0,0,1.0,1,1.0,1,1.0,1,0.14942754828050603,73
3347,1,11468,2433,9035,0,0,0,1.0,1,1.0,1,1.0,1,0.14546415128985254,73
3348,0,11468,2433,9035,0,0,0,1.0,1,1.0,1,1.0,1,0.15891488434175055,73
3349,3,11471,2434,9037,0,0,0,1.0,1,1.0,1,1.0,1,0.16031264701902148,74
3350,8,11479,2436,9043,0,0,0,1.0,1,1.0,1,1.0,1,0.16569563431421888,73
3351,4,11483,2437,9046,0,0,0,1.0,1,1.0,1,1.0,1,0.16535288391722278,72
3352,1,11484,2438,9046,0,0,0,1.0,1,1.0,1,1.0,1,0.17420690056390664,72
3353,3,11487,2440,9047,0,0,0,1.0,1,1.0,1,1.0,1,0.2002160843416911,72
3354,4,11491,2441,9050,0,0,0,1.0,1,1.0,1,1.0,1,0.22621872661874048,70
3355,6,11497,2442,9055,0,0,0,1.0,1,1.0,1,1.0,1,0.25908965903800757,69
3356,10,11507,2445,9062,0,0,0,1.0,1,1.0,1,1.0,1,0.2734812427192567,69
3357,8,11515,2446,9069,0,0,0,1.0,1,1.0,1,1.0,1,0.2894891677186514,68
3358,8,11523,2446,9077,0,0,0,1.0,1,1.0,1,1.0,1,0.27413036430000104,68
3359,6,11529,2447,9082,0,0,0,1.0,1,1.0,1,1.0,1,0.2585083443343613,66
3360,7,11536,2449,9087,0,0,0,1.0,1,1.0,1,1.0,1,0.2780635197894913,65
3361,8,11544,2449,9095,0,0,0,1.0,1,1.0,1,1.0,1,0.21042265942227373,64
3362,0,11544,2449,9095,0,0,0,1.0,1,1.0,1,1.0,1,0.21042265942227373,64
3363,0,11544,2449,9095,0,0,0,1.0,1,1.0,1,1.0,1,0.20418341982005525,65
3364,3,11547,2449,9098,0,0,0,1.0,1,1.0,1,1.0,1,0.18924737028203475,66
3365,1,11548,2449,9099,0,0,0,1.0,1,1.0,1,1.0,1,0.19038951772279541,68
3366,0,11548,2449,9099,0,0,0,1.0,1,1.0,1,1.0,1,0.20178002720109822,66
3367,3,11551,2449,9102,0,0,0,1.0,1,1.0,1,1.0,1,0.18283248243170197,68
3368,6,11557,2450,9107,0,0,0,1.0,1,1.0,1,1.0,1,0.14233256434277738,68
3369,2,11559,2450,9109,0,0,0,1.0,1,1.0,1,1.0,1,0.15525424672519328,69
3370,2,11561,2450,9111,0,0,0,1.0,1,1.0,1,1.0,1,0.14298802758703685,71
3371,2,11563,2450,9113,0,0,0,1.0,1,1.0,1,1.0,1,0.13634880634999613,71
3372,6,11569,2451,9118,0,0,0,1.0,1,1.0,1,1.0,1,0.14524760566016146,71
3373,4,11573,2451,9122,0,0,0,1.0,1,1.0,1,1.0,1,0.1434333246560991,72
3374,4,11577,2451,9126,0,0,0,1.0,1,1.0,1,1.0,1,0.15890264581196903,72
3375,5,11582,2452,9130,0,0,0,1.0,1,1.0,1,1.0,1,0.1308951423674009,73
3376,3,11585,2452,9133,0,0,0,1.0,1,1.0,1,1.0,1,0.10487596412742563,75
3377,1,11586,2453,9133,0,0,0,1.0,1,1.0,1,1.0,1,0.09516414083248409,77
3378,0,11586,2453,9133,0,0,0,1.0,1,1.0,1,1.0,1,0.09516414083248409,77
3379,4,11590,2456,9134,0,0,0,1.0,1,1.0,1,1.0,1,0.13037840774797668,77
3380,4,11594,2456,9138,0,0,0,1.0,1,1.0,1,1.0,1,0.14399441937470117,76
3381,5,11599,2458,9141,0,0,0,1.0,1,1.0,1,1.0,1,0.13263820313120245,76
3382,1,11600,2459,9141,0,0,0,1.0,1,1.0,1,1.0,1,0.14733517804436835,78
3383,3,11603,2460,9143,0,0,0,1.0,1,1.0,1,1.0,1,0.13772587075811835,77
3384,6,11609,2464,9145,0,0,0,1.0,1,1.0,1,1.0,1,0.17521665908945566,77
3385,1,11610,2464,9146,0,0,0,1.0,1,1.0,1,1.0,1,0.17736748439720207,75
3386,1,11611,2465,9146,0,0,0,1.0,1,1.0,1,1.0,1,0.18163857424100405,76
3387,1,11612,2466,9146,0,0,0,1.0,1,1.0,1,1.0,1,0.17962359160933788,75
3388,4,11616,2466,9150,0,0,0,1.0,1,1.0,1,1.0,1,0.1872069927344356,76
3389,3,11619,2467,9152,0,0,0,1.0,1,1.0,1,1.0,1,0.16689318828088442,77
3390,1,11620,2467,9153,0,0,0,1.0,1,1.0,1,1.0,1,0.1732250334564159,76
3391,3,11623,2468,9155,0,0,0,1.0,1,1.0,1,1.0,1,0.13440592542210086,77
3392,2,11625,2468,9157,0,0,0,1.0,1,1.0,1,1.0,1,0.13253799721252188,78
3393,2,11627,2468,9159,0,0,0,1.0,1,1.0,1,1.0,1,0.11630927715505616,76
3394,1,11628,2469,9159,0,0,0,1.0,1,1.0,1,1.0,1,0.13809736715380697,75
3395,4,11632,2469,9163,0,0,0,1.0,1,1.0,1,1.0,1,0.12584979512670375,73
3396,0,11632,2469,9163,0,0,0,1.0,1,1.0,1,1.0,1,0.12584979512670375,73
3397,0,11632,2469,9163,0,0,0,1.0,1,1.0,1,1.0,1,0.11955519218059164,74
3398,0,11632,2469,9163,0,0,0,1.0,1,1.0,1,1.0,1,0.11955519218059164,74
3399,3,11635,2472,9163,0,0,0,1.0,1,1.0,1,1.0,1,0.15565936272102282,75
3400,5,11640,2473,9167,0,0,0,1.0,1,1.0,1,1.0,1,0.177360732938302,75
3401,5,11645,2474,9171,0,0,0,1.0,1,1.0,1,1.0,1,0.13820281136676488,77
3402,4,11649,2475,9174,0,0,0,1.0,1,1.0,1,1.0,1,0.18051237888076638,77
3403,5,11654,2476,9178,0,0,0,1.0,1,1.0,1,1.0,1,0.17868337326711245,78
3404,2,11656,2477,9179,0,0,0,1.0,1,1.0,1,1.0,1,0.15833196556680232,78
3405,2,11658,2478,9180,0,0,0,1.0,1,1.0,1,1.0,1,0.15886941627026163,78
3406,10,11668,2479,9189,0,0,0,1.0,1,1.0,1,1.0,1,0.08488296044873057,78
3407,3,11671,2480,9191,0,0,0,1.0,1,1.0,1,1.0,1,0.08979876316540329,78
3408,4,11675,2480,9195,0,0,0,1.0,1,1.0,1,1.0,1,0.09291997318614256,79
3409,4,11679,2480,9199,0,0,0,1.0,1,1.0,1,1.0,1,0.0930050463397695,81
3410,5,11684,2480,9204,0,0,0,1.0,1,1.0,1,1.0,1,0.10253506240408362,82
3411,4,11688,2480,9208,0,0,0,1.0,1,1.0,1,1.0,1,0.10294206625576084,84
3412,5,11693,2480,9213,0,0,0,1.0,1,1.0,1,1.0,1,0.09726405470201391,84
3413,1,11694,2480,9214,0,0,0,1.0,1,1.0,1,1.0,1,0.09605543763948937,84
3414,2,11696,2480,9216,0,0,0,1.0,1,1.0,1,1.0,1,0.09605543763948937,84
3415,5,11701,2482,9219,0,0,0,1.0,1,1.0,1,1.0,1,0.1011638014823712,85
3416,9,11710,2484,9226,0,0,0,1.0,1,1.0,1,1.0,1,0.10782189533392993,85
3417,7,11717,2484,9233,0,0,0,1.0,1,1.0,1,1.0,1,0.11601902016467924,86
3418,12,11729,2485,9244,0,0,0,1.0,1,1.0,1,1.0,1,0.13222045594146542,86
3419,14,11743,2487,9256,0,0,0,1.0,1,1.0,1,1.0,1,0.15708449361290402,87
3420,10,11753,2488,9265,0,0,0,1.0,1,1.0,1,1.0,1,0.143823728928467,88
3421,7,11760,2489,9271,0,0,0,1.0,1,1.0,1,1.0,1,0.13594865578148896,89
3422,5,11765,2489,9276,0,0,0,1.0,1,1.0,1,1.0,1,0.13255889470622828,90
3423,4,11769,2489,9280,0,0,0,1.0,1,1.0,1,1.0,1,0.11953612834743622,90
3424,3,11772,2489,9283,0,0,0,1.0,1,1.0,1,1.0,1,0.1187321032997729,91
3425,3,11775,2490,9285,0,0,0,1.0,1,1.0,1,1.0,1,0.10754929719508677,90
3426,3,11778,2491,9287,0,0,0,1.0,1,1.0,1,1.0,1,0.11827746426573275,92
3427,6,11784,2491,9293,0,0,0,1.0,1,1.0,1,1.0,1,0.11810343410509896,92
3428,5,11789,2491,9298,0,0,0,1.0,1,1.0,1,1.0,1,0.1197540712252947,91
3429,7,11796,2492,9304,0,0,0,1.0,1,1.0,1,1.0,1,0.12493324769419509,91
3430,12,11808,2497,9311,0,0,0,1.0,1,1.0,1,1.0,1,0.12747293487931577,91
3431,4,11812,2497,9315,0,0,0,1.0,1,1.0,1,1.0,1,0.13761519180585266,90
3432,5,11817,2498,9319,0,0,0,1.0,1,1.0,1,1.0,1,0.12114689342337352,91
3433,7,11824,2498,9326,0,0,0,1.0,1,1.0,1,1.0,1,0.12703310637840612,90
3434,4,11828,2499,9329,0,0,0,1.0,1,1.0,1,1.0,1,0.15556162265192058,89
3435,6,11834,2499,9335,0,0,0,1.0,1,1.0,1,1.0,1,0.15868423648699703,88
3436,8,11842,2499,9343,0,0,0,1.0,1,1.0,1,1.0,1,0.11244514913234237,86
3437,3,11845,2500,9345,0,0,0,1.0,1,1.0,1,1.0,1,0.10921388784337609,86
3438,1,11846,2500,9346,0,0,0,1.0,1,1.0,1,1.0,1,0.10806866731981882,87
3439,1,11847,2501,9346,0,0,0,1.0,1,1.0,1,1.0,1,0.13070365504134135,86
3440,3,11850,2501,9349,0,0,0,1.0,1,1.0,1,1.0,1,0.1333644740515985,86
3441,1,11851,2502,9349,0,0,0,1.0,1,1.0,1,1.0,1,0.12364097110508418,85
3442,2,11853,2503,9350,0,0,0,1.0,1,1.0,1,1.0,1,0.1389976441888726,85
3443,4,11857,2504,9353,0,0,0,1.0,1,1.0,1,1.0,1,0.12865148844099228,85
3444,7,11864,2506,9358,0,0,0,1.0,1,1.0,1,1.0,1,0.13259786509413216,85
3445,5,11869,2507,9362,0,0,0,1.0,1,1.0,1,1.0,1,0.1689101103611712,84
3446,8,11877,2509,9368,0,0,0,1.0,1,1.0,1,1.0,1,0.174829321370224,85
3447,5,11882,2509,9373,0,0,0,1.0,1,1.0,1,1.0,1,0.18571888055179409,85
3448,12,11894,2512,9382,0,0,0,1.0,1,1.0,1,1.0,1,0.20981698294196544,85
3449,5,11899,2513,9386,0,0,0,1.0,1,1.0,1,1.0,1,0.23227400602117693,84
3450,5,11904,2514,9390,0,0,0,1.0,1,1.0,1,1.0,1,0.2059662552386508,84
3451,7,11911,2515,9396,0,0,0,1.0,1,1.0,1,1.0,1,0.1638172822275948,85
3452,0,11911,2515,9396,0,0,0,1.0,1,1.0,1,1.0,1,0.158748466514028,86
3453,2,11913,2515,9398,0,0,0,1.0,1,1.0,1,1.0,1,0.14118814290735013,85
3454,2,11915,2515,9400,0,0,0,1.0,1,1.0,1,1.0,1,0.1255847875307083,88
3455,2,11917,2516,9401,0,0,0,1.0,1,1.0,1,1.0,1,0.1347117095456174,88
3456,5,11922,2517,9405,0,0,0,1.0,1,1.0,1,1.0,1,0.14035416857630026,88
3457,4,11926,2518,9408,0,0,0,1.0,1,1.0,1,1.0,1,0.1389406604279754,89
3458,2,11928,2518,9410,0,0,0,1.0,1,1.0,1,1.0,1,0.14633632166686514,88
3459,0,11928,2518,9410,0,0,0,1.0,1,1.0,1,1.0,1,0.14633632166686514,88
3460,0,11928,2518,9410,0,0,0,1.0,1,1.0,1,1.0,1,0.13680297065763047,89
3461,0,11928,2518,9410,0,0,0,1.0,1,1.0,1,1.0,1,0.13680297065763047,89
3462,2,11930,2519,9411,0,0,0,1.0,1,1.0,1,1.0,1,0.14427196921227414,90
3463,3,11933,2519,9414,0,0,0,1.0,1,1.0,1,1.0,1,0.12527764177990894,89
3464,3,11936,2520,9416,0,0,0,1.0,1,1.0,1,1.0,1,0.12541131599635932,88
3465,2,11938,2520,9418,0,0,0,1.0,1,1.0,1,1.0,1,0.14088980310455956,87
3466,4,11942,2521,9421,0,0,0,1.0,1,1.0,1,1.0,1,0.10575960429716355,87
3467,1,11943,2522,9421,0,0,0,1.0,1,1.0,1,1.0,1,0.11476153140761937,87
3468,3,11946,2523,9423,0,0,0,1.0,1,1.0,1,1.0,1,0.1363146186609555,88
3469,2,11948,2524,9424,0,0,0,1.0,1,1.0,1,1.0,1,0.146935911045131,85
3470,2,11950,2524,9426,0,0,0,1.0,1,1.0,1,1.0,1,0.14078007629007028,86
3471,3,11953,2525,9428,0,0,0,1.0,1,1.0,1,1.0,1,0.1650311473198496,84
3472,3,11956,2526,9430,0,0,0,1.0,1,1.0,1,1.0,1,0.159121670187298,83
3473,0,11956,2526,9430,0,0,0,1.0,1,1.0,1,1.0,1,0.1681872502150674,81
3474,0,11956,2526,9430,0,0,0,1.0,1,1.0,1,1.0,1,0.14539110979607006,80
3475,3,11959,2527,9432,0,0,0,1.0,1,1.0,1,1.0,1,0.15803908293734156,82
3476,3,11962,2528,9434,0,0,0,1.0,1,1.0,1,1.0,1,0.13895487324892242,81
3477,6,11968,2531,9437,0,0,0,1.0,1,1.0,1,1.0,1,0.1616837506444419,83
3478,2,11970,2532,9438,0,0,0,1.0,1,1.0,1,1.0,1,0.16475924911194456,83
3479,2,11972,2533,9439,0,0,0,1.0,1,1.0,1,1.0,1,0.15830194551833954,83
3480,1,11973,2534,9439,0,0,0,1.0,1,1.0,1,1.0,1,0.14856993221184314,83
3481,9,11982,2536,9446,0,0,0,1.0,1,1.0,1,1.0,1,0.11818402003591003,83
3482,7,11989,2539,9450,0,0,0,1.0,1,1.0,1,1.0,1,0.12909604155221263,83
3483,5,11994,2542,9452,0,0,0,1.0,1,1.0,1,1.0,1,0.12125513352778454,82
3484,3,11997,2543,9454,0,0,0,1.0,1,1.0,1,1.0,1,0.14570648696018365,82
3485,4,12001,2544,9457,0,0,0,1.0,1,1.0,1,1.0,1,0.15813632241135164,83
3486,1,12002,2544,9458,0,0,0,1.0,1,1.0,1,1.0,1,0.15010129994406932,83
3487,4,12006,2544,9462,0,0,0,1.0,1,1.0,1,1.0,1,0.1617743341485822,84
3488,4,12010,2544,9466,0,0,0,1.0,1,1.0,1,1.0,1,0.15661061326643513,84
3489,3,12013,2544,9469,0,0,0,1.0,1,1.0,1,1.0,1,0.16425515389046075,84
3490,4,12017,2544,9473,0,0,0,1.0,1,1.0,1,1.0,1,0.16425515389046075,84
3491,3,12020,2544,9476,0,0,0,1.0,1,1.0,1,1.0,1,0.14176780098899358,86
3492,5,12025,2545,9480,0,0,0,1.0,1,1.0,1,1.0,1,0.1548719363967511,86
3493,4,12029,2545,9484,0,0,0,1.0,1,1.0,1,1.0,1,0.1548719363967511,86
3494,2,12031,2545,9486,0,0,0,1.0,1,1.0,1,1.0,1,0.1376558507205953,86
3495,2,12033,2545,9488,0,0,0,1.0,1,1.0,1,1.0,1,0.15105058562393092,87
3496,8,12041,2545,9496,0,0,0,1.0,1,1.0,1,1.0,1,0.10374055667950344,88
3497,2,12043,2545,9498,0,0,0,1.0,1,1.0,1,1.0,1,0.08035673653698783,89
3498,0,12043,2545,9498,0,0,0,1.0,1,1.0,1,1.0,1,0.09021941282842658,89
3499,2,12045,2546,9499,0,0,0,1.0,1,1.0,1,1.0,1,0.08499630904793067,91
3500,1,12046,2546,9500,0,0,0,1.0,1,1.0,1,1.0,1,0.0823961949249421,90
3501,0,12046,2546,9500,0,0,0,1.0,1,1.0,1,1.0,1,0.0823961949249421,90
3502,1,12047,2546,9501,0,0,0,1.0,1,1.0,1,1.0,1,0.07909221055023936,91
3503,5,12052,2547,9505,0,0,0,1.0,1,1.0,1,1.0,1,0.09454939322587173,91
3504,2,12054,2549,9505,0,0,0,1.0,1,1.0,1,1.0,1,0.13161657594425066,89
3505,4,12058,2551,9507,0,0,0,1.0,1,1.0,1,1.0,1,0.14998931800131926,87
3506,5,12063,2553,9510,0,0,0,1.0,1,1.0,1,1.0,1,0.1600504750585064,87
3507,5,12068,2556,9512,0,0,0,1.0,1,1.0,1,1.0,1,0.15061299573522266,84
3508,4,12072,2559,9513,0,0,0,1.0,1,1.0,1,1.0,1,0.1747735793294,83
3509,4,12076,2561,9515,0,0,0,1.0,1,1.0,1,1.0,1,0.1873461466420639,80
3510,3,12079,2561,9518,0,0,0,1.0,1,1.0,1,1.0,1,0.1706589691289199,78
3511,12,12091,2563,9528,0,0,0,1.0,1,1.0,1,1.0,1,0.14209051888915875,77
3512,2,12093,2564,9529,0,0,0,1.0,1,1.0,1,1.0,1,0.13776438067076377,74
3513,3,12096,2565,9531,0,0,0,1.0,1,1.0,1,1.0,1,0.17826550325357798,76
3514,3,12099,2566,9533,0,0,0,1.0,1,1.0,1,1.0,1,0.1456325986103745,76
3515,3,12102,2567,9535,0,0,0,1.0,1,1.0,1,1.0,1,0.14831906520288857,75
3516,3,12105,2568,9537,0,0,0,1.0,1,1.0,1,1.0,1,0.16995760924814182,73
3517,8,12113,2571,9542,0,0,0,1.0,1,1.0,1,1.0,1,0.16058746084532702,74
3518,2,12115,2571,9544,0,0,0,1.0,1,1.0,1,1.0,1,0.18521734619837238,74
3519,4,12119,2571,9548,0,0,0,1.0,1,1.0,1,1.0,1,0.19852660396348,73
3520,5,12124,2571,9553,0,0,0,1.0,1,1.0,1,1.0,1,0.1645830365593425,74
3521,3,12127,2571,9556,0,0,0,1.0,1,1.0,1,1.0,1,0.19041694846519128,75
3522,1,12128,2571,9557,0,0,0,1.0,1,1.0,1,1.0,1,0.19340661980118581,75
3523,1,12129,2571,9558,0,0,0,1.0,1,1.0,1,1.0,1,0.19041694846519128,75
3524,2,12131,2571,9560,0,0,0,1.0,1,1.0,1,1.0,1,0.1734231217436,75
3525,2,12133,2571,9562,0,0,0,1.0,1,1.0,1,1.0,1,0.17974179930427925,75
3526,15,12148,2572,9576,0,0,0,1.0,1,1.0,1,1.0,1,0.10783285710592058,76
3527,7,12155,2574,9581,0,0,0,1.0,1,1.0,1,1.0,1,0.11424236822759748,77
3528,3,12158,2574,9584,0,0,0,1.0,1,1.0,1,1.0,1,0.141478711068821,77
3529,4,12162,2574,9588,0,0,0,1.0,1,1.0,1,1.0,1,0.14151060372813387,78
3530,2,12164,2574,9590,0,0,0,1.0,1,1.0,1,1.0,1,0.16904363849748164,78
3531,5,12169,2575,9594,0,0,0,1.0,1,1.0,1,1.0,1,0.17776526885934615,79
3532,5,12174,2576,9598,0,0,0,1.0,1,1.0,1,1.0,1,0.200676803480805,79
3533,12,12186,2578,9608,0,0,0,1.0,1,1.0,1,1.0,1,0.22447018468214167,79
3534,10,12196,2579,9617,0,0,0,1.0,1,1.0,1,1.0,1,0.19918207812793368,80
3535,10,12206,2579,9627,0,0,0,1.0,1,1.0,1,1.0,1,0.20118528002819094,81
3536,9,12215,2579,9636,0,0,0,1.0,1,1.0,1,1.0,1,0.20681487432341317,82
3537,6,12221,2579,9642,0,0,0,1.0,1,1.0,1,1.0,1,0.18624589892508273,82
3538,11,12232,2579,9653,0,0,0,1.0,1,1.0,1,1.0,1,0.18813356040168705,83
3539,6,12238,2579,9659,0,0,0,1.0,1,1.0,1,1.0,1,0.1846277902540361,83
3540,9,12247,2580,9667,0,0,0,1.0,1,1.0,1,1.0,1,0.1878488081335731,85
3541,6,12253,2580,9673,0,0,0,1.0,1,1.0,1,1.0,1,0.11091914769140993,85
3542,7,12260,2580,9680,0,0,0,1.0,1,1.0,1,1.0,1,0.08272001444590503,88
3543,0,12260,2580,9680,0,0,0,1.0,1,1.0,1,1.0,1,0.09123046052354375,87
3544,1,12261,2580,9681,0,0,0,1.0,1,1.0,1,1.0,1,0.08548191044018306,87
3545,4,12265,2582,9683,0,0,0,1.0,1,1.0,1,1.0,1,0.08320313562600654,85
3546,3,12268,2583,9685,0,0,0,1.0,1,1.0,1,1.0,1,0.08467232853019584,83
3547,2,12270,2583,9687,0,0,0,1.0,1,1.0,1,1.0,1,0.1176211929538289,82
3548,4,12274,2584,9690,0,0,0,1.0,1,1.0,1,1.0,1,0.10852645209936121,82
3549,6,12280,2585,9695,0,0,0,1.0,1,1.0,1,1.0,1,0.12794923574693517,81
3550,4,12284,2586,9698,0,0,0,1.0,1,1.0,1,1.0,1,0.0952807442008326,79
3551,2,12286,2586,9700,0,0,0,1.0,1,1.0,1,1.0,1,0.1008463887799557,80
3552,3,12289,2587,9702,0,0,0,1.0,1,1.0,1,1.0,1,0.10170454040603005,78
3553,3,12292,2587,9705,0,0,0,1.0,1,1.0,1,1.0,1,0.09625002732258936,79
3554,0,12292,2587,9705,0,0,0,1.0,1,1.0,1,1.0,1,0.12141429370114167,77
3555,5,12297,2588,9709,0,0,0,1.0,1,1.0,1,1.0,1,0.1265124689259384,77
3556,6,12303,2588,9715,0,0,0,1.0,1,1.0,1,1.0,1,0.08928203804429707,76
3557,2,12305,2588,9717,0,0,0,1.0,1,1.0,1,1.0,1,0.09385150808620679,76
3558,3,12308,2589,9719,0,0,0,1.0,1,1.0,1,1.0,1,0.12031808150412726,76
3559,3,12311,2589,9722,0,0,0,1.0,1,1.0,1,1.0,1,0.10907830551453139,76
3560,5,12316,2590,9726,0,0,0,1.0,1,1.0,1,1.0,1,0.0933321841105439,78
3561,4,12320,2591,9729,0,0,0,1.0,1,1.0,1,1.0,1,0.08924608859139271,79
3562,4,12324,2592,9732,0,0,0,1.0,1,1.0,1,1.0,1,0.09955562294375057,79
3563,2,12326,2592,9734,0,0,0,1.0,1,1.0,1,1.0,1,0.09955562294375057,79
3564,8,12334,2593,9741,0,0,0,1.0,1,1.0,1,1.0,1,0.11471316360024354,80
3565,11,12345,2593,9752,0,0,0,1.0,1,1.0,1,1.0,1,0.1257378151460081,83
3566,14,12359,2595,9764,0,0,0,1.0,1,1.0,1,1.0,1,0.17195372456660443,84
3567,11,12370,2595,9775,0,0,0,1.0,1,1.0,1,1.0,1,0.16044249754254655,84
3568,11,12381,2595,9786,0,0,0,1.0,1,1.0,1,1.0,1,0.16587577828917435,84
3569,12,12393,2595,9798,0,0,0,1.0,1,1.0,1,1.0,1,0.1644985237573403,84
3570,18,12411,2597,9814,0,0,0,1.0,1,1.0,1,1.0,1,0.15535645508351517,87
3571,9,12420,2599,9821,0,0,0,1.0,1,1.0,1,1.0,1,0.09589827688911998,86
3572,6,12426,2601,9825,0,0,0,1.0,1,1.0,1,1.0,1,0.08273933198304281,87
3573,4,12430,2603,9827,0,0,0,1.0,1,1.0,1,1.0,1,0.11490178991434674,87
3574,8,12438,2605,9833,0,0,0,1.0,1,1.0,1,1.0,1,0.14443040143761318,88
3575,4,12442,2605,9837,0,0,0,1.0,1,1.0,1,1.0,1,0.11311234510611005,88
3576,9,12451,2606,9845,0,0,0,1.0,1,1.0,1,1.0,1,0.11841343185244146,90
3577,5,12456,2606,9850,0,0,0,1.0,1,1.0,1,1.0,1,0.11007770735429037,90
3578,8,12464,2606,9858,0,0,0,1.0,1,1.0,1,1.0,1,0.11564805966499404,91
3579,9,12473,2607,9866,0,0,0,1.0,1,1.0,1,1.0,1,0.1115849562240586,91
3580,6,12479,2607,9872,0,0,0,1.0,1,1.0,1,1.0,1,0.12601055538945513,91
3581,12,12491,2609,9882,0,0,0,1.0,1,1.0,1,1.0,1,0.13054534407695126,91
3582,7,12498,2610,9888,0,0,0,1.0,1,1.0,1,1.0,1,0.13091346831353257,92
3583,6,12504,2611,9893,0,0,0,1.0,1,1.0,1,1.0,1,0.1562490974547661,88
3584,5,12509,2612,9897,0,0,0,1.0,1,1.0,1,1.0,1,0.15766767432942386,87
3585,6,12515,2613,9902,0,0,0,1.0,1,1.0,1,1.0,1,0.16914049151364674,84
3586,9,12524,2613,9911,0,0,0,1.0,1,1.0,1,1.0,1,0.12005317978914472,83
3587,0,12524,2613,9911,0,0,0,1.0,1,1.0,1,1.0,1,0.11866472090534125,82
3588,4,12528,2615,9913,0,0,0,1.0,1,1.0,1,1.0,1,0.10080568718135781,81
3589,7,12535,2620,9915,0,0,0,1.0,1,1.0,1,1.0,1,0.11544982494075234,80
3590,2,12537,2621,9916,0,0,0,1.0,1,1.0,1,1.0,1,0.11455496316064372,78
3591,5,12542,2622,9920,0,0,0,1.0,1,1.0,1,1.0,1,0.1250349309242893,77
3592,2,12544,2623,9921,0,0,0,1.0,1,1.0,1,1.0,1,0.13817410768932567,75
3593,2,12546,2624,9922,0,0,0,1.0,1,1.0,1,1.0,1,0.14746496249326477,76
3594,5,12551,2625,9926,0,0,0,1.0,1,1.0,1,1.0,1,0.16850752067290417,74
3595,3,12554,2626,9928,0,0,0,1.0,1,1.0,1,1.0,1,0.16371328110846167,74
3596,3,12557,2627,9930,0,0,0,1.0,1,1.0,1,1.0,1,0.16178595164734008,73
3597,5,12562,2628,9934,0,0,0,1.0,1,1.0,1,1.0,1,0.15345367547792255,73
3598,4,12566,2630,9936,0,0,0,1.0,1,1.0,1,1.0,1,0.15580808480383807,73
3599,3,12569,2630,9939,0,0,0,1.0,1,1.0,1,1.0,1,0.1526165238383961,73
3600,3,12572,2630,9942,0,0,0,1.0,1,1.0,1,1.0,1,0.15854805625125928,74
3601,17,12589,2633,9956,0,0,0,1.0,1,1.0,1,1.0,1,0.09910561688984805,75
3602,2,12591,2633,9958,0,0,0,1.0,1,1.0,1,1.0,1,0.08715582290779891,76
3603,8,12599,2636,9963,0,0,0,1.0,1,1.0,1,1.0,1,0.13336088263634574,77
3604,12,12611,2638,9973,0,0,0,1.0,1,1.0,1,1.0,1,0.14210959117614683,78
3605,11,12622,2640,9982,0,0,0,1.0,1,1.0,1,1.0,1,0.11086465962048685,77
3606,9,12631,2641,9990,0,0,0,1.0,1,1.0,1,1.0,1,0.11736923650102146,79
3607,6,12637,2642,9995,0,0,0,1.0,1,1.0,1,1.0,1,0.14391692165072853,79
3608,6,12643,2642,10001,0,0,0,1.0,1,1.0,1,1.0,1,0.11732056378741672,79
3609,7,12650,2642,10008,0,0,0,1.0,1,1.0,1,1.0,1,0.12857642525456622,79
3610,9,12659,2645,10014,0,0,0,1.0,1,1.0,1,1.0,1,0.09735010116830846,80
3611,10,12669,2646,10023,0,0,0,1.0,1,1.0,1,1.0,1,0.08466802136661893,80
3612,13,12682,2648,10034,0,0,0,1.0,1,1.0,1,1.0,1,0.13032360067912213,79
3613,8,12690,2648,10042,0,0,0,1.0,1,1.0,1,1.0,1,0.14004893963912618,79
3614,7,12697,2650,10047,0,0,0,1.0,1,1.0,1,1.0,1,0.12224282102900624,78
3615,6,12703,2650,10053,0,0,0,1.0,1,1.0,1,1.0,1,0.1136914785728002,79
3616,8,12711,2652,10059,0,0,0,1.0,1,1.0,1,1.0,1,0.09628420986825613,79
3617,3,12714,2654,10060,0,0,0,1.0,1,1.0,1,1.0,1,0.1072322720872921,80
3618,8,12722,2654,10068,0,0,0,1.0,1,1.0,1,1.0,1,0.12014290710718653,82
3619,5,12727,2654,10073,0,0,0,1.0,1,1.0,1,1.0,1,0.13801195679785794,82
3620,7,12734,2654,10080,0,0,0,1.0,1,1.0,1,1.0,1,0.13410153314900652,81
3621,9,12743,2654,10089,0,0,0,1.0,1,1.0,1,1.0,1,0.14225645647987362,83
3622,10,12753,2654,10099,0,0,0,1.0,1,1.0,1,1.0,1,0.133450986988268,81
3623,11,12764,2657,10107,0,0,0,1.0,1,1.0,1,1.0,1,0.18211760898628,81
3624,11,12775,2658,10117,0,0,0,1.0,1,1.0,1,1.0,1,0.17617725137493837,79
3625,11,12786,2661,10125,0,0,0,1.0,1,1.0,1,1.0,1,0.2058948276338582,80
3626,7,12793,2661,10132,0,0,0,1.0,1,1.0,1,1.0,1,0.15396237503820942,78
3627,13,12806,2663,10143,0,0,0,1.0,1,1.0,1,1.0,1,0.15371169848605468,78
3628,9,12815,2664,10151,0,0,0,1.0,1,1.0,1,1.0,1,0.1416191071074915,77
3629,5,12820,2664,10156,0,0,0,1.0,1,1.0,1,1.0,1,0.15333383597051742,76
3630,8,12828,2665,10163,0,0,0,1.0,1,1.0,1,1.0,1,0.15417152702013315,77
3631,12,12840,2666,10174,0,0,0,1.0,1,1.0,1,1.0,1,0.05881359567345879,75
3632,4,12844,2668,10176,0,0,0,1.0,1,1.0,1,1.0,1,0.11429691611915044,74
3633,8,12852,2669,10183,0,0,0,1.0,1,1.0,1,1.0,1,0.09536872442607798,75
3634,2,12854,2670,10184,0,0,0,1.0,1,1.0,1,1.0,1,0.12217278567031568,74
3635,2,12856,2670,10186,0,0,0,1.0,1,1.0,1,1.0,1,0.12217278567031568,74
3636,5,12861,2670,10191,0,0,0,1.0,1,1.0,1,1.0,1,0.12455801846183624,74
3637,4,12865,2670,10195,0,0,0,1.0,1,1.0,1,1.0,1,0.13293273018495924,74
3638,3,12868,2670,10198,0,0,0,1.0,1,1.0,1,1.0,1,0.1366837269596019,75
3639,5,12873,2671,10202,0,0,0,1.0,1,1.0,1,1.0,1,0.16749967876317445,76
3640,5,12878,2672,10206,0,0,0,1.0,1,1.0,1,1.0,1,0.13320442146224437,76
3641,3,12881,2673,10208,0,0,0,1.0,1,1.0,1,1.0,1,0.16364694958352816,75
3642,8,12889,2675,10214,0,0,0,1.0,1,1.0,1,1.0,1,0.21096197739241004,75
3643,8,12897,2675,10222,0,0,0,1.0,1,1.0,1,1.0,1,0.1941308663709644,74
3644,8,12905,2675,10230,0,0,0,1.0,1,1.0,1,1.0,1,0.19816005604312112,74
3645,4,12909,2676,10233,0,0,0,1.0,1,1.0,1,1.0,1,0.17763969269083835,74
3646,9,12918,2676,10242,0,0,0,1.0,1,1.0,1,1.0,1,0.1017681237537938,75
3647,0,12918,2676,10242,0,0,0,1.0,1,1.0,1,1.0,1,0.1031490698876813,77
3648,3,12921,2676,10245,0,0,0,1.0,1,1.0,1,1.0,1,0.09671823289776056,78
3649,4,12925,2676,10249,0,0,0,1.0,1,1.0,1,1.0,1,0.09173069285252601,80
3650,3,12928,2676,10252,0,0,0,1.0,1,1.0,1,1.0,1,0.09950710368450678,81
3651,1,12929,2677,10252,0,0,0,1.0,1,1.0,1,1.0,1,0.0909840448553727,81
3652,1,12930,2678,10252,0,0,0,1.0,1,1.0,1,1.0,1,0.12066853833169422,83
3653,4,12934,2678,10256,0,0,0,1.0,1,1.0,1,1.0,1,0.12126376884068893,83
3654,6,12940,2678,10262,0,0,0,1.0,1,1.0,1,1.0,1,0.11649788582421734,83
3655,1,12941,2678,10263,0,0,0,1.0,1,1.0,1,1.0,1,0.11797683072149685,84
3656,5,12946,2678,10268,0,0,0,1.0,1,1.0,1,1.0,1,0.10467576824269452,85
3657,6,12952,2678,10274,0,0,0,1.0,1,1.0,1,1.0,1,0.11758548948057677,86
3658,12,12964,2678,10286,0,0,0,1.0,1,1.0,1,1.0,1,0.11581546504177476,87
3659,10,12974,2679,10295,0,0,0,1.0,1,1.0,1,1.0,1,0.13333395477211968,87
3660,11,12985,2680,10305,0,0,0,1.0,1,1.0,1,1.0,1,0.13400418669493322,86
3661,7,12992,2682,10310,0,0,0,1.0,1,1.0,1,1.0,1,0.14286689780210876,86
3662,2,12994,2682,10312,0,0,0,1.0,1,1.0,1,1.0,1,0.12610205799479846,83
3663,6,13000,2685,10315,0,0,0,1.0,1,1.0,1,1.0,1,0.1519064016561801,85
3664,1,13001,2686,10315,0,0,0,1.0,1,1.0,1,1.0,1,0.13718852465714243,82
3665,1,13002,2686,10316,0,0,0,1.0,1,1.0,1,1.0,1,0.12017576476787076,81
3666,4,13006,2689,10317,0,0,0,1.0,1,1.0,1,1.0,1,0.12548946799191862,79
3667,2,13008,2690,10318,0,0,0,1.0,1,1.0,1,1.0,1,0.14540369954613608,79
3668,1,13009,2691,10318,0,0,0,1.0,1,1.0,1,1.0,1,0.13488598405461236,77
3669,1,13010,2692,10318,0,0,0,1.0,1,1.0,1,1.0,1,0.1308404902541289,75
3670,2,13012,2694,10318,0,0,0,1.0,1,1.0,1,1.0,1,0.1724334719042642,76
3671,2,13014,2695,10319,0,0,0,1.0,1,1.0,1,1.0,1,0.13580919471281291,74
3672,1,13015,2696,10319,0,0,0,1.0,1,1.0,1,1.0,1,0.13347809244375267,75
3673,4,13019,2698,10321,0,0,0,1.0,1,1.0,1,1.0,1,0.1621103520009488,75
3674,2,13021,2699,10322,0,0,0,1.0,1,1.0,1,1.0,1,0.16902647595744064,75
3675,0,13021,2699,10322,0,0,0,1.0,1,1.0,1,1.0,1,0.17049007627704652,75
3676,9,13030,2700,10330,0,0,0,1.0,1,1.0,1,1.0,1,0.10449001824218879,75
3677,0,13030,2700,10330,0,0,0,1.0,1,1.0,1,1.0,1,0.11025170694053267,75
3678,1,13031,2701,10330,0,0,0,1.0,1,1.0,1,1.0,1,0.13082844027312504,77
3679,3,13034,2702,10332,0,0,0,1.0,1,1.0,1,1.0,1,0.1463354123476864,78
3680,3,13037,2702,10335,0,0,0,1.0,1,1.0,1,1.0,1,0.1376889875869544,80
3681,3,13040,2702,10338,0,0,0,1.0,1,1.0,1,1.0,1,0.1427578258519564,81
3682,4,13044,2702,10342,0,0,0,1.0,1,1.0,1,1.0,1,0.14512970297330968,81
3683,4,13048,2703,10345,0,0,0,1.0,1,1.0,1,1.0,1,0.14806163094935465,81
3684,1,13049,2703,10346,0,0,0,1.0,1,1.0,1,1.0,1,0.15413282690776214,81
3685,1,13050,2703,10347,0,0,0,1.0,1,1.0,1,1.0,1,0.14806163094935465,81
3686,2,13052,2703,10349,0,0,0,1.0,1,1.0,1,1.0,1,0.14806163094935465,81
3687,3,13055,2703,10352,0,0,0,1.0,1,1.0,1,1.0,1,0.1558163503085038,82
3688,7,13062,2703,10359,0,0,0,1.0,1,1.0,1,1.0,1,0.16580756835041688,84
3689,5,13067,2703,10364,0,0,0,1.0,1,1.0,1,1.0,1,0.17399309806917465,84
3690,12,13079,2703,10376,0,0,0,1.0,1,1.0,1,1.0,1,0.1697357816633378,85
3691,8,13087,2703,10384,0,0,0,1.0,1,1.0,1,1.0,1,0.12030658993408824,86
3692,3,13090,2703,10387,0,0,0,1.0,1,1.0,1,1.0,1,0.12148804139628504,86
3693,1,13091,2703,10388,0,0,0,1.0,1,1.0,1,1.0,1,0.1217436085994743,86
3694,1,13092,2703,10389,0,0,0,1.0,1,1.0,1,1.0,1,0.12164587940811519,86
3695,1,13093,2704,10389,0,0,0,1.0,1,1.0,1,1.0,1,0.13654623027895021,86
3696,2,13095,2705,10390,0,0,0,1.0,1,1.0,1,1.0,1,0.11748029756530719,87
3697,2,13097,2707,10390,0,0,0,1.0,1,1.0,1,1.0,1,0.1262533319168583,85
3698,1,13098,2708,10390,0,0,0,1.0,1,1.0,1,1.0,1,0.1253101271769331,85
3699,1,13099,2709,10390,0,0,0,1.0,1,1.0,1,1.0,1,0.12355065632767082,85
3700,3,13102,2712,10390,0,0,0,1.0,1,1.0,1,1.0,1,0.1377662286757374,84
3701,2,13104,2713,10391,0,0,0,1.0,1,1.0,1,1.0,1,0.15125648545664203,85
3702,4,13108,2715,10393,0,0,0,1.0,1,1.0,1,1.0,1,0.14819459150656472,85
3703,2,13110,2715,10395,0,0,0,1.0,1,1.0,1,1.0,1,0.14819459150656472,85
3704,3,13113,2716,10397,0,0,0,1.0,1,1.0,1,1.0,1,0.1527254256159259,85
3705,2,13115,2716,10399,0,0,0,1.0,1,1.0,1,1.0,1,0.1461786059827698,86
3706,4,13119,2718,10401,0,0,0,1.0,1,1.0,1,1.0,1,0.14969797281985928,86
3707,4,13123,2720,10403,0,0,0,1.0,1,1.0,1,1.0,1,0.15763835668381246,85
3708,1,13124,2720,10404,0,0,0,1.0,1,1.0,1,1.0,1,0.1479737425301064,84
3709,0,13124,2720,10404,0,0,0,1.0,1,1.0,1,1.0,1,0.15055686822985007,85
3710,0,13124,2720,10404,0,0,0,1.0,1,1.0,1,1.0,1,0.14604063948891,84
3711,2,13126,2720,10406,0,0,0,1.0,1,1.0,1,1.0,1,0.13076033720209568,85
3712,0,13126,2720,10406,0,0,0,1.0,1,1.0,1,1.0,1,0.13076033720209568,85
3713,0,13126,2720,10406,0,0,0,1.0,1,1.0,1,1.0,1,0.13076033720209568,85
3714,2,13128,2721,10407,0,0,0,1.0,1,1.0,1,1.0,1,0.1375925171024795,85
3715,1,13129,2722,10407,0,0,0,1.0,1,1.0,1,1.0,1,0.1356588522822061,85
3716,2,13131,2723,10408,0,0,0,1.0,1,1.0,1,1.0,1,0.1399227587357603,84
3717,1,13132,2723,10409,0,0,0,1.0,1,1.0,1,1.0,1,0.13459442512910866,86
3718,2,13134,2723,10411,0,0,0,1.0,1,1.0,1,1.0,1,0.14644237343793842,85
3719,4,13138,2725,10413,0,0,0,1.0,1,1.0,1,1.0,1,0.13176215864677737,84
3720,1,13139,2725,10414,0,0,0,1.0,1,1.0,1,1.0,1,0.16829396742714006,84
3721,9,13148,2728,10420,0,0,0,1.0,1,1.0,1,1.0,1,0.13364348845254295,85
3722,4,13152,2728,10424,0,0,0,1.0,1,1.0,1,1.0,1,0.12118223872679704,85
3723,4,13156,2728,10428,0,0,0,1.0,1,1.0,1,1.0,1,0.1257807154597167,85
3724,2,13158,2728,10430,0,0,0,1.0,1,1.0,1,1.0,1,0.11540443327042707,86
3725,3,13161,2729,10432,0,0,0,1.0,1,1.0,1,1.0,1,0.13351870735198101,86
3726,2,13163,2729,10434,0,0,0,1.0,1,1.0,1,1.0,1,0.12977437459710814,86
3727,1,13164,2729,10435,0,0,0,1.0,1,1.0,1,1.0,1,0.13192593977078243,86
3728,1,13165,2730,10435,0,0,0,1.0,1,1.0,1,1.0,1,0.15169102860943115,86
3729,2,13167,2730,10437,0,0,0,1.0,1,1.0,1,1.0,1,0.15141247081595577,86
3730,0,13167,2730,10437,0,0,0,1.0,1,1.0,1,1.0,1,0.1608526327147005,85
3731,2,13169,2730,10439,0,0,0,1.0,1,1.0,1,1.0,1,0.1650337384272674,86
3732,3,13172,2731,10441,0,0,0,1.0,1,1.0,1,1.0,1,0.17263308685390727,87
3733,3,13175,2732,10443,0,0,0,1.0,1,1.0,1,1.0,1,0.173949984564074,87
3734,0,13175,2732,10443,0,0,0,1.0,1,1.0,1,1.0,1,0.173949984564074,87
3735,4,13179,2734,10445,0,0,0,1.0,1,1.0,1,1.0,1,0.17179817181592566,86
3736,8,13187,2734,10453,0,0,0,1.0,1,1.0,1,1.0,1,0.12667476130987612,87
3737,4,13191,2736,10455,0,0,0,1.0,1,1.0,1,1.0,1,0.13509142985191228,87
3738,3,13194,2738,10456,0,0,0,1.0,1,1.0,1,1.0,1,0.13247115146528804,87
3739,4,13198,2738,10460,0,0,0,1.0,1,1.0,1,1.0,1,0.1172895251879892,88
3740,4,13202,2741,10461,0,0,0,1.0,1,1.0,1,1.0,1,0.1422189806002413,87
3741,2,13204,2741,10463,0,0,0,1.0,1,1.0,1,1.0,1,0.13155427875272363,87
3742,2,13206,2742,10464,0,0,0,1.0,1,1.0,1,1.0,1,0.11693500573981071,86
3743,0,13206,2742,10464,0,0,0,1.0,1,1.0,1,1.0,1,0.1330071309712361,84
3744,0,13206,2742,10464,0,0,0,1.0,1,1.0,1,1.0,1,0.14798094758132516,83
3745,2,13208,2743,10465,0,0,0,1.0,1,1.0,1,1.0,1,0.16132429140346327,83
3746,4,13212,2744,10468,0,0,0,1.0,1,1.0,1,1.0,1,0.17819429610092385,83
3747,5,13217,2747,10470,0,0,0,1.0,1,1.0,1,1.0,1,0.18973008209199677,81
3748,1,13218,2747,10471,0,0,0,1.0,1,1.0,1,1.0,1,0.1864121734048956,81
3749,0,13218,2747,10471,0,0,0,1.0,1,1.0,1,1.0,1,0.1914631557962102,80
3750,1,13219,2747,10472,0,0,0,1.0,1,1.0,1,1.0,1,0.19517585063687728,79
3751,11,13230,2750,10480,0,0,0,1.0,1,1.0,1,1.0,1,0.2047259506795868,80
3752,12,13242,2751,10491,0,0,0,1.0,1,1.0,1,1.0,1,0.21713939248694053,80
3753,15,13257,2755,10502,0,0,0,1.0,1,1.0,1,1.0,1,0.21692156980623017,81
3754,7,13264,2756,10508,0,0,0,1.0,1,1.0,1,1.0,1,0.20645241632246156,81
3755,12,13276,2758,10518,0,0,0,1.0,1,1.0,1,1.0,1,0.24599707291078812,80
3756,7,13283,2759,10524,0,0,0,1.0,1,1.0,1,1.0,1,0.23109908723292583,79
3757,12,13295,2759,10536,0,0,0,1.0,1,1.0,1,1.0,1,0.23381839368642038,80
3758,7,13302,2759,10543,0,0,0,1.0,1,1.0,1,1.0,1,0.26115767781599686,79
3759,9,13311,2759,10552,0,0,0,1.0,1,1.0,1,1.0,1,0.2565768051975056,79
3760,12,13323,2759,10564,0,0,0,1.0,1,1.0,1,1.0,1,0.2565768051975056,79
3761,12,13335,2759,10576,0,0,0,1.0,1,1.0,1,1.0,1,0.2748063056643576,78
3762,10,13345,2759,10586,0,0,0,1.0,1,1.0,1,1.0,1,0.27053693190025907,80
3763,8,13353,2759,10594,0,0,0,1.0,1,1.0,1,1.0,1,0.26528441457666535,80
3764,9,13362,2761,10601,0,0,0,1.0,1,1.0,1,1.0,1,0.2918524052243597,80
3765,15,13377,2762,10615,0,0,0,1.0,1,1.0,1,1.0,1,0.2939099642711755,81
3766,16,13393,2765,10628,0,0,0,1.0,1,1.0,1,1.0,1,0.20359811780133885,83
3767,6,13399,2765,10634,0,0,0,1.0,1,1.0,1,1.0,1,0.19212898580647295,83
3768,9,13408,2765,10643,0,0,0,1.0,1,1.0,1,1.0,1,0.17789437968537966,84
3769,11,13419,2765,10654,0,0,0,1.0,1,1.0,1,1.0,1,0.14233571638375048,86
3770,4,13423,2765,10658,0,0,0,1.0,1,1.0,1,1.0,1,0.15705704900294581,87
3771,5,13428,2767,10661,0,0,0,1.0,1,1.0,1,1.0,1,0.1599247736249908,87
3772,6,13434,2767,10667,0,0,0,1.0,1,1.0,1,1.0,1,0.16040968465047736,88
3773,7,13441,2767,10674,0,0,0,1.0,1,1.0,1,1.0,1,0.2054007143260519,85
3774,11,13452,2768,10684,0,0,0,1.0,1,1.0,1,1.0,1,0.22194801829309924,85
3775,11,13463,2769,10694,0,0,0,1.0,1,1.0,1,1.0,1,0.24628233790547302,83
3776,12,13475,2770,10705,0,0,0,1.0,1,1.0,1,1.0,1,0.22664783872303093,82
3777,7,13482,2771,10711,0,0,0,1.0,1,1.0,1,1.0,1,0.22250224709557995,81
3778,7,13489,2772,10717,0,0,0,1.0,1,1.0,1,1.0,1,0.20352235055493548,81
3779,11,13500,2775,10725,0,0,0,1.0,1,1.0,1,1.0,1,0.22749896013290236,80
3780,8,13508,2776,10732,0,0,0,1.0,1,1.0,1,1.0,1,0.22646971845757155,80
3781,8,13516,2776,10740,0,0,0,1.0,1,1.0,1,1.0,1,0.15404365557593608,80
3782,0,13516,2776,10740,0,0,0,1.0,1,1.0,1,1.0,1,0.15404365557593608,80
3783,4,13520,2777,10743,0,0,0,1.0,1,1.0,1,1.0,1,0.14984202181455913,80
3784,1,13521,2778,10743,0,0,0,1.0,1,1.0,1,1.0,1,0.1561723810003094,79
3785,2,13523,2779,10744,0,0,0,1.0,1,1.0,1,1.0,1,0.1706494533376337,77
3786,1,13524,2779,10745,0,0,0,1.0,1,1.0,1,1.0,1,0.15562171368680167,78
3787,1,13525,2780,10745,0,0,0,1.0,1,1.0,1,1.0,1,0.17202023524861934,77
3788,3,13528,2782,10746,0,0,0,1.0,1,1.0,1,1.0,1,0.16745756517094787,78
3789,3,13531,2783,10748,0,0,0,1.0,1,1.0,1,1.0,1,0.1781761545004624,77
3790,4,13535,2784,10751,0,0,0,1.0,1,1.0,1,1.0,1,0.19427819453914436,77
3791,3,13538,2786,10752,0,0,0,1.0,1,1.0,1,1.0,1,0.19367254905438816,77
3792,1,13539,2786,10753,0,0,0,1.0,1,1.0,1,1.0,1,0.17292405369612202,78
3793,2,13541,2787,10754,0,0,0,1.0,1,1.0,1,1.0,1,0.18171929384639834,80
3794,5,13546,2787,10759,0,0,0,1.0,1,1.0,1,1.0,1,0.17183775404602222,82
3795,3,13549,2787,10762,0,0,0,1.0,1,1.0,1,1.0,1,0.18336054665393045,83
3796,8,13557,2787,10770,0,0,0,1.0,1,1.0,1,1.0,1,0.13273940529856876,83
3797,5,13562,2787,10775,0,0,0,1.0,1,1.0,1,1.0,1,0.1275586195214754,82
3798,5,13567,2787,10780,0,0,0,1.0,1,1.0,1,1.0,1,0.13489252009432082,82
3799,2,13569,2787,10782,0,0,0,1.0,1,1.0,1,1.0,1,0.13523956993837552,83
3800,2,13571,2787,10784,0,0,0,1.0,1,1.0,1,1.0,1,0.1600189778290352,83
3801,4,13575,2788,10787,0,0,0,1.0,1,1.0,1,1.0,1,0.14968115884632963,83
3802,4,13579,2788,10791,0,0,0,1.0,1,1.0,1,1.0,1,0.16388195521546317,82
3803,8,13587,2788,10799,0,0,0,1.0,1,1.0,1,1.0,1,0.14825664433681765,84
3804,7,13594,2789,10805,0,0,0,1.0,1,1.0,1,1.0,1,0.16736069073479234,84
3805,11,13605,2790,10815,0,0,0,1.0,1,1.0,1,1.0,1,0.1682883228028817,86
3806,5,13610,2791,10819,0,0,0,1.0,1,1.0,1,1.0,1,0.18117365851877454,86
3807,4,13614,2791,10823,0,0,0,1.0,1,1.0,1,1.0,1,0.16421693269352503,86
3808,9,13623,2792,10831,0,0,0,1.0,1,1.0,1,1.0,1,0.15147174787358805,85
3809,6,13629,2792,10837,0,0,0,1.0,1,1.0,1,1.0,1,0.1443531960385044,85
3810,5,13634,2792,10842,0,0,0,1.0,1,1.0,1,1.0,1,0.1683003497835109,85
3811,5,13639,2794,10845,0,0,0,1.0,1,1.0,1,1.0,1,0.1454855076988707,84
3812,2,13641,2795,10846,0,0,0,1.0,1,1.0,1,1.0,1,0.14652271956503088,83
3813,3,13644,2795,10849,0,0,0,1.0,1,1.0,1,1.0,1,0.12083207715199096,82
3814,2,13646,2797,10849,0,0,0,1.0,1,1.0,1,1.0,1,0.1359842774949093,81
3815,1,13647,2797,10850,0,0,0,1.0,1,1.0,1,1.0,1,0.1215484802021988,82
3816,3,13650,2797,10853,0,0,0,1.0,1,1.0,1,1.0,1,0.07751931043770184,81
3817,4,13654,2797,10857,0,0,0,1.0,1,1.0,1,1.0,1,0.07761979480666943,81
3818,1,13655,2798,10857,0,0,0,1.0,1,1.0,1,1.0,1,0.10220155327948079,81
3819,3,13658,2800,10858,0,0,0,1.0,1,1.0,1,1.0,1,0.1311116245440195,82
3820,8,13666,2800,10866,0,0,0,1.0,1,1.0,1,1.0,1,0.12002494593799058,84
3821,3,13669,2802,10867,0,0,0,1.0,1,1.0,1,1.0,1,0.1533197528755091,84
3822,3,13672,2802,10870,0,0,0,1.0,1,1.0,1,1.0,1,0.14254697474845113,82
3823,4,13676,2804,10872,0,0,0,1.0,1,1.0,1,1.0,1,0.173293057480577,81
3824,2,13678,2805,10873,0,0,0,1.0,1,1.0,1,1.0,1,0.194043097483182,78
3825,1,13679,2805,10874,0,0,0,1.0,1,1.0,1,1.0,1,0.19335096984866681,76
3826,9,13688,2806,10882,0,0,0,1.0,1,1.0,1,1.0,1,0.16645712849914268,76
3827,2,13690,2806,10884,0,0,0,1.0,1,1.0,1,1.0,1,0.16526170036529686,75
3828,0,13690,2806,10884,0,0,0,1.0,1,1.0,1,1.0,1,0.1763566962077962,74
3829,0,13690,2806,10884,0,0,0,1.0,1,1.0,1,1.0,1,0.18862180333866646,74
3830,0,13690,2806,10884,0,0,0,1.0,1,1.0,1,1.0,1,0.18862180333866646,74
3831,4,13694,2808,10886,0,0,0,1.0,1,1.0,1,1.0,1,0.19053229174475808,74
3832,0,13694,2808,10886,0,0,0,1.0,1,1.0,1,1.0,1,0.20033487023951652,73
3833,3,13697,2810,10887,0,0,0,1.0,1,1.0,1,1.0,1,0.21140238204013953,73
3834,4,13701,2811,10890,0,0,0,1.0,1,1.0,1,1.0,1,0.21645030116765906,74
3835,4,13705,2813,10892,0,0,0,1.0,1,1.0,1,1.0,1,0.20200001915097013,75
3836,5,13710,2814,10896,0,0,0,1.0,1,1.0,1,1.0,1,0.22880636138716026,75
3837,13,13723,2815,10908,0,0,0,1.0,1,1.0,1,1.0,1,0.21386473325386568,78
3838,8,13731,2816,10915,0,0,0,1.0,1,1.0,1,1.0,1,0.21857932681401246,78
3839,6,13737,2816,10921,0,0,0,1.0,1,1.0,1,1.0,1,0.2087534759984093,79
3840,14,13751,2817,10934,0,0,0,1.0,1,1.0,1,1.0,1,0.22696619926660114,82
3841,20,13771,2817,10954,0,0,0,1.0,1,1.0,1,1.0,1,0.1379271342889847,82
3842,5,13776,2817,10959,0,0,0,1.0,1,1.0,1,1.0,1,0.13279495127805221,82
3843,3,13779,2817,10962,0,0,0,1.0,1,1.0,1,1.0,1,0.1360520757235729,82
3844,6,13785,2818,10967,0,0,0,1.0,1,1.0,1,1.0,1,0.12595966457984079,83
3845,4,13789,2818,10971,0,0,0,1.0,1,1.0,1,1.0,1,0.12248703968938468,84
3846,7,13796,2818,10978,0,0,0,1.0,1,1.0,1,1.0,1,0.13327419043016944,85
3847,4,13800,2818,10982,0,0,0,1.0,1,1.0,1,1.0,1,0.11899296632089082,84
3848,7,13807,2819,10988,0,0,0,1.0,1,1.0,1,1.0,1,0.11140805892440206,84
3849,6,13813,2819,10994,0,0,0,1.0,1,1.0,1,1.0,1,0.12064916558490181,83
3850,2,13815,2819,10996,0,0,0,1.0,1,1.0,1,1.0,1,0.13008645914003647,80
3851,2,13817,2819,10998,0,0,0,1.0,1,1.0,1,1.0,1,0.12075114448275609,80
3852,1,13818,2820,10998,0,0,0,1.0,1,1.0,1,1.0,1,0.16390815269040768,79
3853,1,13819,2820,10999,0,0,0,1.0,1,1.0,1,1.0,1,0.1434256744654872,79
3854,5,13824,2822,11002,0,0,0,1.0,1,1.0,1,1.0,1,0.141465264753786,78
3855,4,13828,2823,11005,0,0,0,1.0,1,1.0,1,1.0,1,0.15508625555978334,78
3856,8,13836,2824,11012,0,0,0,1.0,1,1.0,1,1.0,1,0.12849451792352795,80
3857,2,13838,2825,11013,0,0,0,1.0,1,1.0,1,1.0,1,0.11905183509880995,81
3858,2,13840,2827,11013,0,0,0,1.0,1,1.0,1,1.0,1,0.134902991552135,81
3859,3,13843,2827,11016,0,0,0,1.0,1,1.0,1,1.0,1,0.1409880127614481,83
3860,5,13848,2828,11020,0,0,0,1.0,1,1.0,1,1.0,1,0.17136974956755055,82
3861,5,13853,2828,11025,0,0,0,1.0,1,1.0,1,1.0,1,0.1778889200441585,84
3862,5,13858,2830,11028,0,0,0,1.0,1,1.0,1,1.0,1,0.18817275943223624,85
3863,4,13862,2830,11032,0,0,0,1.0,1,1.0,1,1.0,1,0.17735674998948653,84
3864,3,13865,2830,11035,0,0,0,1.0,1,1.0,1,1.0,1,0.17885026507862406,83
3865,6,13871,2831,11040,0,0,0,1.0,1,1.0,1,1.0,1,0.187924203838466,82
3866,7,13878,2831,11047,0,0,0,1.0,1,1.0,1,1.0,1,0.16802353692111058,81
3867,3,13881,2832,11049,0,0,0,1.0,1,1.0,1,1.0,1,0.1511429117621547,81
3868,5,13886,2833,11053,0,0,0,1.0,1,1.0,1,1.0,1,0.16356148621532118,81
3869,5,13891,2835,11056,0,0,0,1.0,1,1.0,1,1.0,1,0.15561922552782337,81
3870,1,13892,2835,11057,0,0,0,1.0,1,1.0,1,1.0,1,0.15898390384679947,80
3871,10,13902,2839,11063,0,0,0,1.0,1,1.0,1,1.0,1,0.12794227506302258,82
3872,2,13904,2840,11064,0,0,0,1.0,1,1.0,1,1.0,1,0.13140419856332017,81
3873,1,13905,2841,11064,0,0,0,1.0,1,1.0,1,1.0,1,0.13972955654596422,81
3874,3,13908,2843,11065,0,0,0,1.0,1,1.0,1,1.0,1,0.13855016294640515,78
3875,4,13912,2843,11069,0,0,0,1.0,1,1.0,1,1.0,1,0.1078597870551667,77
3876,1,13913,2843,11070,0,0,0,1.0,1,1.0,1,1.0,1,0.1087465779599635,78
3877,0,13913,2843,11070,0,0,0,1.0,1,1.0,1,1.0,1,0.12602950580338085,75
3878,2,13915,2845,11070,0,0,0,1.0,1,1.0,1,1.0,1,0.12571060023614794,75
3879,1,13916,2845,11071,0,0,0,1.0,1,1.0,1,1.0,1,0.13377675842756498,73
3880,0,13916,2845,11071,0,0,0,1.0,1,1.0,1,1.0,1,0.1311615261852743,74
3881,1,13917,2846,11071,0,0,0,1.0,1,1.0,1,1.0,1,0.1557238692138351,75
3882,3,13920,2846,11074,0,0,0,1.0,1,1.0,1,1.0,1,0.13759271394638314,76
3883,2,13922,2846,11076,0,0,0,1.0,1,1.0,1,1.0,1,0.13774512965334365,77
3884,4,13926,2848,11078,0,0,0,1.0,1,1.0,1,1.0,1,0.11869789891712193,78
3885,3,13929,2850,11079,0,0,0,1.0,1,1.0,1,1.0,1,0.12010572235697467,78
3886,7,13936,2850,11086,0,0,0,1.0,1,1.0,1,1.0,1,0.08754445376037193,79
3887,7,13943,2852,11091,0,0,0,1.0,1,1.0,1,1.0,1,0.09203959308028332,78
3888,7,13950,2854,11096,0,0,0,1.0,1,1.0,1,1.0,1,0.12663739871008076,80
3889,10,13960,2854,11106,0,0,0,1.0,1,1.0,1,1.0,1,0.1320354951789454,82
3890,13,13973,2856,11117,0,0,0,1.0,1,1.0,1,1.0,1,0.13796587724376128,82
3891,14,13987,2858,11129,0,0,0,1.0,1,1.0,1,1.0,1,0.15680675071696937,85
3892,15,14002,2860,11142,0,0,0,1.0,1,1.0,1,1.0,1,0.183342221188349,87
3893,13,14015,2860,11155,0,0,0,1.0,1,1.0,1,1.0,1,0.17936410544946538,86
3894,6,14021,2860,11161,0,0,0,1.0,1,1.0,1,1.0,1,0.15842810219379586,87
3895,13,14034,2861,11173,0,0,0,1.0,1,1.0,1,1.0,1,0.1690031873629727,87
3896,13,14047,2861,11186,0,0,0,1.0,1,1.0,1,1.0,1,0.1529565821756713,85
3897,10,14057,2862,11195,0,0,0,1.0,1,1.0,1,1.0,1,0.16821044473855723,85
3898,10,14067,2862,11205,0,0,0,1.0,1,1.0,1,1.0,1,0.16921186400709265,86
3899,10,14077,2862,11215,0,0,0,1.0,1,1.0,1,1.0,1,0.14778604772109538,86
3900,8,14085,2862,11223,0,0,0,1.0,1,1.0,1,1.0,1,0.15096248863753647,86
3901,11,14096,2863,11233,0,0,0,1.0,1,1.0,1,1.0,1,0.0819857805479621,86
3902,3,14099,2864,11235,0,0,0,1.0,1,1.0,1,1.0,1,0.0768699518272064,87
3903,2,14101,2864,11237,0,0,0,1.0,1,1.0,1,1.0,1,0.07108617806404269,87
3904,1,14102,2865,11237,0,0,0,1.0,1,1.0,1,1.0,1,0.06572764785673303,85
3905,0,14102,2865,11237,0,0,0,1.0,1,1.0,1,1.0,1,0.06818663427713015,84
3906,5,14107,2866,11241,0,0,0,1.0,1,1.0,1,1.0,1,0.048023218334086945,86
3907,3,14110,2867,11243,0,0,0,1.0,1,1.0,1,1.0,1,0.102877882388879,84
3908,2,14112,2867,11245,0,0,0,1.0,1,1.0,1,1.0,1,0.09582132700532814,83
3909,6,14118,2869,11249,0,0,0,1.0,1,1.0,1,1.0,1,0.11902664879821045,81
3910,4,14122,2871,11251,0,0,0,1.0,1,1.0,1,1.0,1,0.11552349707580915,82
3911,8,14130,2874,11256,0,0,0,1.0,1,1.0,1,1.0,1,0.14678425621378735,81
3912,6,14136,2874,11262,0,0,0,1.0,1,1.0,1,1.0,1,0.1728165881426129,80
3913,4,14140,2875,11265,0,0,0,1.0,1,1.0,1,1.0,1,0.17299548757832697,80
3914,5,14145,2875,11270,0,0,0,1.0,1,1.0,1,1.0,1,0.18325081268581264,81
3915,8,14153,2877,11276,0,0,0,1.0,1,1.0,1,1.0,1,0.2033498749423581,81
3916,18,14171,2878,11293,0,0,0,1.0,1,1.0,1,1.0,1,0.10577260525259072,81
3917,4,14175,2878,11297,0,0,0,1.0,1,1.0,1,1.0,1,0.0827278243404812,82
3918,10,14185,2878,11307,0,0,0,1.0,1,1.0,1,1.0,1,0.0959878122118984,85
3919,5,14190,2878,11312,0,0,0,1.0,1,1.0,1,1.0,1,0.1138063375079048,85
3920,8,14198,2878,11320,0,0,0,1.0,1,1.0,1,1.0,1,0.12008867546938184,85
3921,8,14206,2879,11327,0,0,0,1.0,1,1.0,1,1.0,1,0.1172003031332523,88
3922,5,14211,2879,11332,0,0,0,1.0,1,1.0,1,1.0,1,0.11108256516336816,88
3923,6,14217,2879,11338,0,0,0,1.0,1,1.0,1,1.0,1,0.10040858261685509,89
3924,8,14225,2879,11346,0,0,0,1.0,1,1.0,1,1.0,1,0.11465721915968498,90
3925,5,14230,2879,11351,0,0,0,1.0,1,1.0,1,1.0,1,0.11257406606230898,88
3926,6,14236,2880,11356,0,0,0,1.0,1,1.0,1,1.0,1,0.11232302193265126,89
3927,6,14242,2880,11362,0,0,0,1.0,1,1.0,1,1.0,1,0.10186006540195543,89
3928,8,14250,2880,11370,0,0,0,1.0,1,1.0,1,1.0,1,0.11655652483081627,88
3929,10,14260,2882,11378,0,0,0,1.0,1,1.0,1,1.0,1,0.14615444279284728,88
3930,6,14266,2882,11384,0,0,0,1.0,1,1.0,1,1.0,1,0.16533086687093512,87
3931,17,14283,2884,11399,0,0,0,1.0,1,1.0,1,1.0,1,0.12270676134437819,86
3932,5,14288,2885,11403,0,0,0,1.0,1,1.0,1,1.0,1,0.10378882858203584,85
3933,3,14291,2885,11406,0,0,0,1.0,1,1.0,1,1.0,1,0.1121208455429634,84
3934,2,14293,2885,11408,0,0,0,1.0,1,1.0,1,1.0,1,0.09994966128361772,85
3935,5,14298,2886,11412,0,0,0,1.0,1,1.0,1,1.0,1,0.10984425991166591,84
3936,5,14303,2887,11416,0,0,0,1.0,1,1.0,1,1.0,1,0.1260788091783703,84
3937,4,14307,2887,11420,0,0,0,1.0,1,1.0,1,1.0,1,0.1342954189722298,82
3938,4,14311,2888,11423,0,0,0,1.0,1,1.0,1,1.0,1,0.1431683885788568,82
3939,5,14316,2888,11428,0,0,0,1.0,1,1.0,1,1.0,1,0.08471958113630744,84
3940,8,14324,2889,11435,0,0,0,1.0,1,1.0,1,1.0,1,0.13845885716129167,84
3941,5,14329,2889,11440,0,0,0,1.0,1,1.0,1,1.0,1,0.09779577725277916,85
3942,8,14337,2890,11447,0,0,0,1.0,1,1.0,1,1.0,1,0.1351920555895897,85
3943,5,14342,2890,11452,0,0,0,1.0,1,1.0,1,1.0,1,0.1024670830293769,84
3944,10,14352,2894,11458,0,0,0,1.0,1,1.0,1,1.0,1,0.1497310641382103,83
3945,8,14360,2895,11465,0,0,0,1.0,1,1.0,1,1.0,1,0.15603956966315585,83
3946,10,14370,2896,11474,0,0,0,1.0,1,1.0,1,1.0,1,0.12358848625026711,83
3947,5,14375,2896,11479,0,0,0,1.0,1,1.0,1,1.0,1,0.08569271100209241,83
3948,3,14378,2897,11481,0,0,0,1.0,1,1.0,1,1.0,1,0.10093751136790825,84
3949,2,14380,2897,11483,0,0,0,1.0,1,1.0,1,1.0,1,0.11749215311671034,84
3950,4,14384,2898,11486,0,0,0,1.0,1,1.0,1,1.0,1,0.130237176922538,86
3951,11,14395,2898,11497,0,0,0,1.0,1,1.0,1,1.0,1,0.12829738415288197,87
3952,5,14400,2898,11502,0,0,0,1.0,1,1.0,1,1.0,1,0.11902038585001529,86
3953,4,14404,2899,11505,0,0,0,1.0,1,1.0,1,1.0,1,0.13735774798158,86
3954,4,14408,2899,11509,0,0,0,1.0,1,1.0,1,1.0,1,0.12134554248156809,85
3955,3,14411,2899,11512,0,0,0,1.0,1,1.0,1,1.0,1,0.13655546763292914,85
3956,4,14415,2899,11516,0,0,0,1.0,1,1.0,1,1.0,1,0.13480478578776475,84
3957,5,14420,2899,11521,0,0,0,1.0,1,1.0,1,1.0,1,0.14440261261214918,85
3958,3,14423,2900,11523,0,0,0,1.0,1,1.0,1,1.0,1,0.148006606144883,84
3959,1,14424,2900,11524,0,0,0,1.0,1,1.0,1,1.0,1,0.15432236631157362,83
3960,2,14426,2901,11525,0,0,0,1.0,1,1.0,1,1.0,1,0.18804186395030936,84
3961,15,14441,2903,11538,0,0,0,1.0,1,1.0,1,1.0,1,0.13671396680263193,83
3962,9,14450,2904,11546,0,0,0,1.0,1,1.0,1,1.0,1,0.10768865246304027,84
3963,5,14455,2905,11550,0,0,0,1.0,1,1.0,1,1.0,1,0.09181800533377599,81
3964,5,14460,2906,11554,0,0,0,1.0,1,1.0,1,1.0,1,0.11766783700180862,81
3965,3,14463,2906,11557,0,0,0,1.0,1,1.0,1,1.0,1,0.1311181107438358,81
3966,3,14466,2907,11559,0,0,0,1.0,1,1.0,1,1.0,1,0.13415827002292904,79
3967,4,14470,2909,11561,0,0,0,1.0,1,1.0,1,1.0,1,0.14598704570881765,81
3968,3,14473,2909,11564,0,0,0,1.0,1,1.0,1,1.0,1,0.12068265480637294,79
3969,11,14484,2914,11570,0,0,0,1.0,1,1.0,1,1.0,1,0.12685490369390467,79
3970,7,14491,2915,11576,0,0,0,1.0,1,1.0,1,1.0,1,0.16475694689421158,78
3971,7,14498,2916,11582,0,0,0,1.0,1,1.0,1,1.0,1,0.15727849778618191,77
3972,7,14505,2917,11588,0,0,0,1.0,1,1.0,1,1.0,1,0.1851761682920886,78
3973,5,14510,2917,11593,0,0,0,1.0,1,1.0,1,1.0,1,0.1524540531304784,77
3974,8,14518,2917,11601,0,0,0,1.0,1,1.0,1,1.0,1,0.14921830438349076,77
3975,9,14527,2920,11607,0,0,0,1.0,1,1.0,1,1.0,1,0.23237051857284552,76
3976,10,14537,2920,11617,0,0,0,1.0,1,1.0,1,1.0,1,0.1763338215181227,77
3977,3,14540,2920,11620,0,0,0,1.0,1,1.0,1,1.0,1,0.17063233906757308,78
3978,4,14544,2921,11623,0,0,0,1.0,1,1.0,1,1.0,1,0.15925581096562558,79
3979,2,14546,2921,11625,0,0,0,1.0,1,1.0,1,1.0,1,0.15836183833903747,79
3980,1,14547,2921,11626,0,0,0,1.0,1,1.0,1,1.0,1,0.15597207739495986,79
3981,4,14551,2922,11629,0,0,0,1.0,1,1.0,1,1.0,1,0.1695271679139776,83
3982,7,14558,2922,11636,0,0,0,1.0,1,1.0,1,1.0,1,0.15109309312817237,83
3983,6,14564,2923,11641,0,0,0,1.0,1,1.0,1,1.0,1,0.132070901220612,82
3984,7,14571,2923,11648,0,0,0,1.0,1,1.0,1,1.0,1,0.1462608731937051,83
3985,6,14577,2924,11653,0,0,0,1.0,1,1.0,1,1.0,1,0.1247772983632551,84
3986,5,14582,2924,11658,0,0,0,1.0,1,1.0,1,1.0,1,0.16570144640387055,83
3987,4,14586,2926,11660,0,0,0,1.0,1,1.0,1,1.0,1,0.16788022341327868,82
3988,9,14595,2928,11667,0,0,0,1.0,1,1.0,1,1.0,1,0.17794581970967574,83
3989,9,14604,2929,11675,0,0,0,1.0,1,1.0,1,1.0,1,0.20314002571746462,81
3990,14,14618,2929,11689,0,0,0,1.0,1,1.0,1,1.0,1,0.2003654397584891,81
3991,8,14626,2929,11697,0,0,0,1.0,1,1.0,1,1.0,1,0.15935507071240812,79
3992,2,14628,2930,11698,0,0,0,1.0,1,1.0,1,1.0,1,0.1544156700192301,81
3993,5,14633,2931,11702,0,0,0,1.0,1,1.0,1,1.0,1,0.13479770142778502,80
3994,0,14633,2931,11702,0,0,0,1.0,1,1.0,1,1.0,1,0.13479770142778502,80
3995,1,14634,2932,11702,0,0,0,1.0,1,1.0,1,1.0,1,0.13632968978033666,81
3996,1,14635,2932,11703,0,0,0,1.0,1,1.0,1,1.0,1,0.1600823927932964,80
3997,3,14638,2933,11705,0,0,0,1.0,1,1.0,1,1.0,1,0.1541967507930723,81
3998,4,14642,2934,11708,0,0,0,1.0,1,1.0,1,1.0,1,0.13706391918039976,82
3999,4,14646,2935,11711,0,0,0,1.0,1,1.0,1,1.0,1,0.14864271806599497,82
4000,5,14651,2937,11714,0,0,0,1.0,1,1.0,1,1.0,1,0.16173695414662065,82
4001,2,14653,2937,11716,0,0,0,1.0,1,1.0,1,1.0,1,0.14308842170867522,81
4002,3,14656,2938,11718,0,0,0,1.0,1,1.0,1,1.0,1,0.14456244129532064,81
4003,4,14660,2940,11720,0,0,0,1.0,1,1.0,1,1.0,1,0.15579059613597868,81
4004,4,14664,2942,11722,0,0,0,1.0,1,1.0,1,1.0,1,0.17961321746084724,80
4005,3,14667,2944,11723,0,0,0,1.0,1,1.0,1,1.0,1,0.18626198898270147,78
4006,8,14675,2945,11730,0,0,0,1.0,1,1.0,1,1.0,1,0.12307388730249472,76
4007,3,14678,2947,11731,0,0,0,1.0,1,1.0,1,1.0,1,0.12817547865001797,75
4008,1,14679,2947,11732,0,0,0,1.0,1,1.0,1,1.0,1,0.11434617766353102,74
4009,2,14681,2948,11733,0,0,0,1.0,1,1.0,1,1.0,1,0.12731864474372367,75
4010,3,14684,2948,11736,0,0,0,1.0,1,1.0,1,1.0,1,0.12317411568017214,75
4011,0,14684,2948,11736,0,0,0,1.0,1,1.0,1,1.0,1,0.1085479654617251,74
4012,1,14685,2949,11736,0,0,0,1.0,1,1.0,1,1.0,1,0.12591715662073558,74
4013,2,14687,2951,11736,0,0,0,1.0,1,1.0,1,1.0,1,0.1341823132248723,74
4014,2,14689,2952,11737,0,0,0,1.0,1,1.0,1,1.0,1,0.160890549994336,73
4015,1,14690,2952,11738,0,0,0,1.0,1,1.0,1,1.0,1,0.17112083036294093,74
4016,3,14693,2953,11740,0,0,0,1.0,1,1.0,1,1.0,1,0.1886912274153345,74
4017,7,14700,2953,11747,0,0,0,1.0,1,1.0,1,1.0,1,0.14082943260154687,78
4018,6,14706,2954,11752,0,0,0,1.0,1,1.0,1,1.0,1,0.16586733709061155,78
4019,6,14712,2954,11758,0,0,0,1.0,1,1.0,1,1.0,1,0.16636136165936258,78
4020,3,14715,2954,11761,0,0,0,1.0,1,1.0,1,1.0,1,0.18513540288258645,78
4021,6,14721,2955,11766,0,0,0,1.0,1,1.0,1,1.0,1,0.14693160980696146,78
4022,1,14722,2956,11766,0,0,0,1.0,1,1.0,1,1.0,1,0.1500463986998655,79
4023,1,14723,2957,11766,0,0,0,1.0,1,1.0,1,1.0,1,0.1462561347240734,78
4024,2,14725,2959,11766,0,0,0,1.0,1,1.0,1,1.0,1,0.14709982408076358,77
4025,0,14725,2959,11766,0,0,0,1.0,1,1.0,1,1.0,1,0.1483627190657004,76
4026,2,14727,2961,11766,0,0,0,1.0,1,1.0,1,1.0,1,0.13687848438538466,76
4027,3,14730,2963,11767,0,0,0,1.0,1,1.0,1,1.0,1,0.16194773228863396,75
4028,0,14730,2963,11767,0,0,0,1.0,1,1.0,1,1.0,1,0.16157581305667612,76
4029,2,14732,2964,11768,0,0,0,1.0,1,1.0,1,1.0,1,0.15849557281637144,75
4030,3,14735,2965,11770,0,0,0,1.0,1,1.0,1,1.0,1,0.1675268443215162,74
4031,5,14740,2967,11773,0,0,0,1.0,1,1.0,1,1.0,1,0.17248256874619838,73
4032,2,14742,2967,11775,0,0,0,1.0,1,1.0,1,1.0,1,0.16160678179175564,71
4033,2,14744,2968,11776,0,0,0,1.0,1,1.0,1,1.0,1,0.1620947430477236,73
4034,4,14748,2970,11778,0,0,0,1.0,1,1.0,1,1.0,1,0.14865322187239927,72
4035,3,14751,2970,11781,0,0,0,1.0,1,1.0,1,1.0,1,0.16038994422010402,71
4036,8,14759,2971,11788,0,0,0,1.0,1,1.0,1,1.0,1,0.11543016637647811,71
4037,3,14762,2972,11790,0,0,0,1.0,1,1.0,1,1.0,1,0.11938100788926563,70
4038,8,14770,2974,11796,0,0,0,1.0,1,1.0,1,1.0,1,0.14234322723144524,69
4039,5,14775,2975,11800,0,0,0,1.0,1,1.0,1,1.0,1,0.13489444583054958,68
4040,5,14780,2976,11804,0,0,0,1.0,1,1.0,1,1.0,1,0.14322534171393173,69
4041,3,14783,2977,11806,0,0,0,1.0,1,1.0,1,1.0,1,0.1916973269404927,67
4042,10,14793,2978,11815,0,0,0,1.0,1,1.0,1,1.0,1,0.23655657000244845,67
4043,11,14804,2979,11825,0,0,0,1.0,1,1.0,1,1.0,1,0.26790484913130136,66
4044,4,14808,2979,11829,0,0,0,1.0,1,1.0,1,1.0,1,0.25161799958629,65
4045,11,14819,2979,11840,0,0,0,1.0,1,1.0,1,1.0,1,0.24270056165415815,66
4046,15,14834,2981,11853,0,0,0,1.0,1,1.0,1,1.0,1,0.2619673158128122,68
4047,12,14846,2981,11865,0,0,0,1.0,1,1.0,1,1.0,1,0.2619673158128122,68
4048,7,14853,2981,11872,0,0,0,1.0,1,1.0,1,1.0,1,0.2552102692938437,69
4049,8,14861,2981,11880,0,0,0,1.0,1,1.0,1,1.0,1,0.2680939354118516,69
4050,5,14866,2981,11885,0,0,0,1.0,1,1.0,1,1.0,1,0.2542328304308141,69
4051,9,14875,2981,11894,0,0,0,1.0,1,1.0,1,1.0,1,0.18308842738689304,69
4052,4,14879,2981,11898,0,0,0,1.0,1,1.0,1,1.0,1,0.16452062977273113,69
4053,2,14881,2981,11900,0,0,0,1.0,1,1.0,1,1.0,1,0.16452062977273113,69
4054,1,14882,2981,11901,0,0,0,1.0,1,1.0,1,1.0,1,0.16378241719650896,70
4055,4,14886,2982,11904,0,0,0,1.0,1,1.0,1,1.0,1,0.13779911738103992,70
4056,2,14888,2982,11906,0,0,0,1.0,1,1.0,1,1.0,1,0.13176536168331876,70
4057,2,14890,2982,11908,0,0,0,1.0,1,1.0,1,1.0,1,0.11458165318350041,71
4058,2,14892,2982,11910,0,0,0,1.0,1,1.0,1,1.0,1,0.12006502716433813,71
4059,0,14892,2982,11910,0,0,0,1.0,1,1.0,1,1.0,1,0.12396425908781995,72
4060,0,14892,2982,11910,0,0,0,1.0,1,1.0,1,1.0,1,0.13458770127603942,71
4061,0,14892,2982,11910,0,0,0,1.0,1,1.0,1,1.0,1,0.12882334480357,72
4062,4,14896,2983,11913,0,0,0,1.0,1,1.0,1,1.0,1,0.12728031371283827,72
4063,6,14902,2984,11918,0,0,0,1.0,1,1.0,1,1.0,1,0.1493399651606069,72
4064,10,14912,2989,11923,0,0,0,1.0,1,1.0,1,1.0,1,0.14982511199853293,71
4065,5,14917,2990,11927,0,0,0,1.0,1,1.0,1,1.0,1,0.13970610254545276,70
4066,6,14923,2992,11931,0,0,0,1.0,1,1.0,1,1.0,1,0.13037465675203688,70
4067,4,14927,2993,11934,0,0,0,1.0,1,1.0,1,1.0,1,0.09686536965377764,68
4068,1,14928,2993,11935,0,0,0,1.0,1,1.0,1,1.0,1,0.09951154418560708,70
4069,1,14929,2993,11936,0,0,0,1.0,1,1.0,1,1.0,1,0.09250378802270304,68
4070,5,14934,2996,11938,0,0,0,1.0,1,1.0,1,1.0,1,0.11348895416688289,67
4071,4,14938,2996,11942,0,0,0,1.0,1,1.0,1,1.0,1,0.12757615530890068,68
4072,4,14942,2997,11945,0,0,0,1.0,1,1.0,1,1.0,1,0.12576390512387195,70
4073,8,14950,3002,11948,0,0,0,1.0,1,1.0,1,1.0,1,0.16998917130893457,70
4074,13,14963,3008,11955,0,0,0,1.0,1,1.0,1,1.0,1,0.19532212522107487,71
4075,8,14971,3010,11961,0,0,0,1.0,1,1.0,1,1.0,1,0.180705032457403,72
4076,9,14980,3011,11969,0,0,0,1.0,1,1.0,1,1.0,1,0.2212713780696847,73
4077,11,14991,3013,11978,0,0,0,1.0,1,1.0,1,1.0,1,0.24078245432434625,72
4078,9,15000,3016,11984,0,0,0,1.0,1,1.0,1,1.0,1,0.24605426423829424,71
4079,11,15011,3018,11993,0,0,0,1.0,1,1.0,1,1.0,1,0.26638266824254075,69
4080,13,15024,3019,12005,0,0,0,1.0,1,1.0,1,1.0,1,0.2913981799088549,67
4081,17,15041,3019,12022,0,0,0,1.0,1,1.0,1,1.0,1,0.17287077302455992,66
4082,4,15045,3019,12026,0,0,0,1.0,1,1.0,1,1.0,1,0.21231887397402202,65
4083,8,15053,3022,12031,0,0,0,1.0,1,1.0,1,1.0,1,0.23374962866937773,64
4084,5,15058,3024,12034,0,0,0,1.0,1,1.0,1,1.0,1,0.23391082940546387,64
4085,3,15061,3024,12037,0,0,0,1.0,1,1.0,1,1.0,1,0.2340415536113138,65
4086,3,15064,3025,12039,0,0,0,1.0,1,1.0,1,1.0,1,0.19090133453574745,66
4087,6,15070,3025,12045,0,0,0,1.0,1,1.0,1,1.0,1,0.1740630361841535,66
4088,3,15073,3026,12047,0,0,0,1.0,1,1.0,1,1.0,1,0.2284798102714346,65
4089,1,15074,3026,12048,0,0,0,1.0,1,1.0,1,1.0,1,0.22638969626001165,65
4090,6,15080,3026,12054,0,0,0,1.0,1,1.0,1,1.0,1,0.2505184849476741,65
4091,2,15082,3026,12056,0,0,0,1.0,1,1.0,1,1.0,1,0.23982007549571246,65
4092,2,15084,3026,12058,0,0,0,1.0,1,1.0,1,1.0,1,0.2620541468590614,64
4093,6,15090,3026,12064,0,0,0,1.0,1,1.0,1,1.0,1,0.23317407858569636,66
4094,3,15093,3027,12066,0,0,0,1.0,1,1.0,1,1.0,1,0.24235209401029922,65
4095,6,15099,3028,12071,0,0,0,1.0,1,1.0,1,1.0,1,0.2351870643699932,65
4096,10,15109,3028,12081,0,0,0,1.0,1,1.0,1,1.0,1,0.11856563497858734,67
4097,5,15114,3028,12086,0,0,0,1.0,1,1.0,1,1.0,1,0.11424650309066745,67
4098,6,15120,3029,12091,0,0,0,1.0,1,1.0,1,1.0,1,0.12713113351802263,68
4099,4,15124,3029,12095,0,0,0,1.0,1,1.0,1,1.0,1,0.14325169088163206,69
4100,3,15127,3029,12098,0,0,0,1.0,1,1.0,1,1.0,1,0.12818530507290962,70
4101,2,15129,3029,12100,0,0,0,1.0,1,1.0,1,1.0,1,0.14530204593380192,71
4102,3,15132,3030,12102,0,0,0,1.0,1,1.0,1,1.0,1,0.15260155711036028,71
4103,4,15136,3031,12105,0,0,0,1.0,1,1.0,1,1.0,1,0.1463070247863673,71
4104,5,15141,3034,12107,0,0,0,1.0,1,1.0,1,1.0,1,0.19105463724555416,69
4105,6,15147,3035,12112,0,0,0,1.0,1,1.0,1,1.0,1,0.20369111595935788,67
4106,3,15150,3036,12114,0,0,0,1.0,1,1.0,1,1.0,1,0.21576756033332536,68
4107,6,15156,3036,12120,0,0,0,1.0,1,1.0,1,1.0,1,0.18794229519842603,70
4108,9,15165,3036,12129,0,0,0,1.0,1,1.0,1,1.0,1,0.19688914824648646,70
4109,3,15168,3036,12132,0,0,0,1.0,1,1.0,1,1.0,1,0.2010488656088784,69
4110,11,15179,3037,12142,0,0,0,1.0,1,1.0,1,1.0,1,0.1825730463022658,71
4111,8,15187,3037,12150,0,0,0,1.0,1,1.0,1,1.0,1,0.12708169525429427,70
4112,4,15191,3037,12154,0,0,0,1.0,1,1.0,1,1.0,1,0.09776265552075494,72
4113,3,15194,3038,12156,0,0,0,1.0,1,1.0,1,1.0,1,0.09509015477838682,72
4114,9,15203,3040,12163,0,0,0,1.0,1,1.0,1,1.0,1,0.08919413086815091,72
4115,1,15204,3041,12163,0,0,0,1.0,1,1.0,1,1.0,1,0.09275636223052855,70
4116,3,15207,3042,12165,0,0,0,1.0,1,1.0,1,1.0,1,0.11694656106054302,67
4117,2,15209,3044,12165,0,0,0,1.0,1,1.0,1,1.0,1,0.15114396869108632,67
4118,1,15210,3044,12166,0,0,0,1.0,1,1.0,1,1.0,1,0.14892234869152776,66
4119,4,15214,3046,12168,0,0,0,1.0,1,1.0,1,1.0,1,0.1565805438247488,67
4120,2,15216,3047,12169,0,0,0,1.0,1,1.0,1,1.0,1,0.19744861877213377,64
4121,0,15216,3047,12169,0,0,0,1.0,1,1.0,1,1.0,1,0.19450498116665282,63
4122,3,15219,3050,12169,0,0,0,1.0,1,1.0,1,1.0,1,0.17443624673023783,63
4123,1,15220,3051,12169,0,0,0,1.0,1,1.0,1,1.0,1,0.18628553416922997,61
4124,4,15224,3054,12170,0,0,0,1.0,1,1.0,1,1.0,1,0.19481637239328345,62
4125,1,15225,3054,12171,0,0,0,1.0,1,1.0,1,1.0,1,0.1752681024164316,60
4126,7,15232,3056,12176,0,0,0,1.0,1,1.0,1,1.0,1,0.14682484275621188,59
4127,2,15234,3057,12177,0,0,0,1.0,1,1.0,1,1.0,1,0.13946617000759493,60
4128,2,15236,3058,12178,0,0,0,1.0,1,1.0,1,1.0,1,0.13290745999825826,60
4129,1,15237,3058,12179,0,0,0,1.0,1,1.0,1,1.0,1,0.1549348352326688,60
4130,3,15240,3061,12179,0,0,0,1.0,1,1.0,1,1.0,1,0.15371001207126067,61
4131,2,15242,3062,12180,0,0,0,1.0,1,1.0,1,1.0,1,0.13432393826144143,60
4132,0,15242,3062,12180,0,0,0,1.0,1,1.0,1,1.0,1,0.13432393826144143,60
4133,3,15245,3063,12182,0,0,0,1.0,1,1.0,1,1.0,1,0.16448643593890408,62
4134,2,15247,3064,12183,0,0,0,1.0,1,1.0,1,1.0,1,0.13439220692137158,63
4135,2,15249,3065,12184,0,0,0,1.0,1,1.0,1,1.0,1,0.12929094859980417,65
4136,2,15251,3065,12186,0,0,0,1.0,1,1.0,1,1.0,1,0.11573526626005567,65
4137,1,15252,3066,12186,0,0,0,1.0,1,1.0,1,1.0,1,0.11423042519467154,66
4138,0,15252,3066,12186,0,0,0,1.0,1,1.0,1,1.0,1,0.11374001007370496,67
4139,2,15254,3068,12186,0,0,0,1.0,1,1.0,1,1.0,1,0.14587154853789977,67
4140,2,15256,3068,12188,0,0,0,1.0,1,1.0,1,1.0,1,0.12360134853480191,66
4141,0,15256,3068,12188,0,0,0,1.0,1,1.0,1,1.0,1,0.11692361733403261,67
4142,0,15256,3068,12188,0,0,0,1.0,1,1.0,1,1.0,1,0.11692361733403261,67
4143,2,15258,3070,12188,0,0,0,1.0,1,1.0,1,1.0,1,0.13114574353904032,66
4144,0,15258,3070,12188,0,0,0,1.0,1,1.0,1,1.0,1,0.14280715820836898,64
4145,5,15263,3073,12190,0,0,0,1.0,1,1.0,1,1.0,1,0.1529231553222118,63
4146,4,15267,3076,12191,0,0,0,1.0,1,1.0,1,1.0,1,0.17414599229821037,62
4147,2,15269,3077,12192,0,0,0,1.0,1,1.0,1,1.0,1,0.1875410592946595,60
4148,7,15276,3082,12194,0,0,0,1.0,1,1.0,1,1.0,1,0.1723959482467158,62
4149,2,15278,3083,12195,0,0,0,1.0,1,1.0,1,1.0,1,0.17074637287689515,61
4150,2,15280,3085,12195,0,0,0,1.0,1,1.0,1,1.0,1,0.20009964025623933,60
4151,2,15282,3087,12195,0,0,0,1.0,1,1.0,1,1.0,1,0.210614434341022,60
4152,4,15286,3088,12198,0,0,0,1.0,1,1.0,1,1.0,1,0.22096811580564935,60
4153,1,15287,3089,12198,0,0,0,1.0,1,1.0,1,1.0,1,0.24754334311531895,58
4154,0,15287,3089,12198,0,0,0,1.0,1,1.0,1,1.0,1,0.24136687645267746,57
4155,2,15289,3091,12198,0,0,0,1.0,1,1.0,1,1.0,1,0.24881216114495858,57
4156,15,15304,3094,12210,0,0,0,1.0,1,1.0,1,1.0,1,0.17751902550229712,58
4157,6,15310,3094,12216,0,0,0,1.0,1,1.0,1,1.0,1,0.14002999299938737,57
4158,1,15311,3095,12216,0,0,0,1.0,1,1.0,1,1.0,1,0.15388787310482221,55
4159,0,15311,3095,12216,0,0,0,1.0,1,1.0,1,1.0,1,0.1528761839745413,57
4160,0,15311,3095,12216,0,0,0,1.0,1,1.0,1,1.0,1,0.12857075766556014,58
4161,2,15313,3095,12218,0,0,0,1.0,1,1.0,1,1.0,1,0.11685447508336134,58
4162,1,15314,3095,12219,0,0,0,1.0,1,1.0,1,1.0,1,0.1147766953959113,57
4163,1,15315,3096,12219,0,0,0,1.0,1,1.0,1,1.0,1,0.13229022738461826,58
4164,3,15318,3097,12221,0,0,0,1.0,1,1.0,1,1.0,1,0.1429879721300055,56
4165,3,15321,3098,12223,0,0,0,1.0,1,1.0,1,1.0,1,0.14661777245974383,58
4166,1,15322,3098,12224,0,0,0,1.0,1,1.0,1,1.0,1,0.14318855471088607,57
4167,1,15323,3098,12225,0,0,0,1.0,1,1.0,1,1.0,1,0.13641357177369567,57
4168,1,15324,3099,12225,0,0,0,1.0,1,1.0,1,1.0,1,0.14824441153916085,58
4169,1,15325,3100,12225,0,0,0,1.0,1,1.0,1,1.0,1,0.14337326298812786,58
4170,0,15325,3100,12225,0,0,0,1.0,1,1.0,1,1.0,1,0.15689911266648313,58
4171,1,15326,3100,12226,0,0,0,1.0,1,1.0,1,1.0,1,0.16209540567382047,57
4172,2,15328,3101,12227,0,0,0,1.0,1,1.0,1,1.0,1,0.13538017159978066,57
4173,1,15329,3102,12227,0,0,0,1.0,1,1.0,1,1.0,1,0.16885245953967473,56
4174,2,15331,3103,12228,0,0,0,1.0,1,1.0,1,1.0,1,0.18684395163644624,56
4175,2,15333,3103,12230,0,0,0,1.0,1,1.0,1,1.0,1,0.16117721517005307,55
4176,2,15335,3103,12232,0,0,0,1.0,1,1.0,1,1.0,1,0.16723695257464366,57
4177,2,15337,3104,12233,0,0,0,1.0,1,1.0,1,1.0,1,0.18294337331669433,58
4178,8,15345,3106,12239,0,0,0,1.0,1,1.0,1,1.0,1,0.21626785232154294,60
4179,9,15354,3107,12247,0,0,0,1.0,1,1.0,1,1.0,1,0.16960497716443373,61
4180,2,15356,3107,12249,0,0,0,1.0,1,1.0,1,1.0,1,0.1763616126534652,62
4181,2,15358,3107,12251,0,0,0,1.0,1,1.0,1,1.0,1,0.16618843977842282,63
4182,1,15359,3108,12251,0,0,0,1.0,1,1.0,1,1.0,1,0.16919269073184767,63
4183,1,15360,3108,12252,0,0,0,1.0,1,1.0,1,1.0,1,0.18230359386495762,63
4184,0,15360,3108,12252,0,0,0,1.0,1,1.0,1,1.0,1,0.19775624023114796,63
4185,1,15361,3108,12253,0,0,0,1.0,1,1.0,1,1.0,1,0.2272908072631694,61
4186,12,15373,3111,12262,0,0,0,1.0,1,1.0,1,1.0,1,0.13677528558914637,62
4187,3,15376,3112,12264,0,0,0,1.0,1,1.0,1,1.0,1,0.14463496288363697,60
4188,4,15380,3112,12268,0,0,0,1.0,1,1.0,1,1.0,1,0.12914597207432243,60
4189,2,15382,3112,12270,0,0,0,1.0,1,1.0,1,1.0,1,0.1331694975783164,60
4190,2,15384,3113,12271,0,0,0,1.0,1,1.0,1,1.0,1,0.15994667349604663,61
4191,2,15386,3114,12272,0,0,0,1.0,1,1.0,1,1.0,1,0.1518078483584232,59
4192,2,15388,3115,12273,0,0,0,1.0,1,1.0,1,1.0,1,0.15900133797997537,58
4193,0,15388,3115,12273,0,0,0,1.0,1,1.0,1,1.0,1,0.1589890345156346,57
4194,2,15390,3117,12273,0,0,0,1.0,1,1.0,1,1.0,1,0.16466255927930817,54
4195,1,15391,3118,12273,0,0,0,1.0,1,1.0,1,1.0,1,0.15081242609142337,55
4196,10,15401,3120,12281,0,0,0,1.0,1,1.0,1,1.0,1,0.14049808113992998,56
4197,3,15404,3121,12283,0,0,0,1.0,1,1.0,1,1.0,1,0.16385803466477192,55
4198,2,15406,3122,12284,0,0,0,1.0,1,1.0,1,1.0,1,0.20083367898106308,56
4199,3,15409,3124,12285,0,0,0,1.0,1,1.0,1,1.0,1,0.22817660399112227,55
4200,2,15411,3124,12287,0,0,0,1.0,1,1.0,1,1.0,1,0.19214222473515527,55
4201,4,15415,3124,12291,0,0,0,1.0,1,1.0,1,1.0,1,0.13606977200727252,56
4202,2,15417,3124,12293,0,0,0,1.0,1,1.0,1,1.0,1,0.13604628309612082,56
4203,3,15420,3124,12296,0,0,0,1.0,1,1.0,1,1.0,1,0.12953086250157006,57
4204,3,15423,3124,12299,0,0,0,1.0,1,1.0,1,1.0,1,0.11121355735489774,57
4205,3,15426,3124,12302,0,0,0,1.0,1,1.0,1,1.0,1,0.10329318666536005,58
4206,6,15432,3126,12306,0,0,0,1.0,1,1.0,1,1.0,1,0.11082540716734376,58
4207,3,15435,3126,12309,0,0,0,1.0,1,1.0,1,1.0,1,0.11586292789037038,58
4208,5,15440,3127,12313,0,0,0,1.0,1,1.0,1,1.0,1,0.1482904209678627,60
4209,4,15444,3129,12315,0,0,0,1.0,1,1.0,1,1.0,1,0.14204876594187346,61
4210,5,15449,3129,12320,0,0,0,1.0,1,1.0,1,1.0,1,0.12206211565751834,62
4211,3,15452,3129,12323,0,0,0,1.0,1,1.0,1,1.0,1,0.12287209059235327,63
4212,5,15457,3129,12328,0,0,0,1.0,1,1.0,1,1.0,1,0.10931481629884138,64
4213,5,15462,3129,12333,0,0,0,1.0,1,1.0,1,1.0,1,0.0845792744593121,65
4214,3,15465,3129,12336,0,0,0,1.0,1,1.0,1,1.0,1,0.12707367292561278,65
4215,4,15469,3129,12340,0,0,0,1.0,1,1.0,1,1.0,1,0.10454649885621396,65
4216,3,15472,3129,12343,0,0,0,1.0,1,1.0,1,1.0,1,0.09481230470365097,64
4217,2,15474,3130,12344,0,0,0,1.0,1,1.0,1,1.0,1,0.09845724804390536,65
4218,0,15474,3130,12344,0,0,0,1.0,1,1.0,1,1.0,1,0.09845724804390536,65
4219,1,15475,3131,12344,0,0,0,1.0,1,1.0,1,1.0,1,0.12139747450094647,65
4220,2,15477,3132,12345,0,0,0,1.0,1,1.0,1,1.0,1,0.12206138975085484,65
4221,2,15479,3133,12346,0,0,0,1.0,1,1.0,1,1.0,1,0.1417493262500482,67
4222,5,15484,3135,12349,0,0,0,1.0,1,1.0,1,1.0,1,0.1502317685415846,68
4223,4,15488,3137,12351,0,0,0,1.0,1,1.0,1,1.0,1,0.1631808538478795,68
4224,2,15490,3138,12352,0,0,0,1.0,1,1.0,1,1.0,1,0.17255509065737915,68
4225,3,15493,3139,12354,0,0,0,1.0,1,1.0,1,1.0,1,0.15608066019918643,66
4226,1,15494,3140,12354,0,0,0,1.0,1,1.0,1,1.0,1,0.16849565514697365,66
4227,1,15495,3141,12354,0,0,0,1.0,1,1.0,1,1.0,1,0.19119517672078418,66
4228,2,15497,3141,12356,0,0,0,1.0,1,1.0,1,1.0,1,0.20310000435831607,65
4229,2,15499,3142,12357,0,0,0,1.0,1,1.0,1,1.0,1,0.2102844076309305,65
4230,3,15502,3143,12359,0,0,0,1.0,1,1.0,1,1.0,1,0.22444636308736418,64
4231,8,15510,3143,12367,0,0,0,1.0,1,1.0,1,1.0,1,0.13985317042323495,64
4232,5,15515,3144,12371,0,0,0,1.0,1,1.0,1,1.0,1,0.12819095762857594,65
4233,4,15519,3144,12375,0,0,0,1.0,1,1.0,1,1.0,1,0.1232173631160755,64
4234,3,15522,3144,12378,0,0,0,1.0,1,1.0,1,1.0,1,0.13510695515400972,63
4235,4,15526,3145,12381,0,0,0,1.0,1,1.0,1,1.0,1,0.14765928783900464,63
4236,1,15527,3145,12382,0,0,0,1.0,1,1.0,1,1.0,1,0.1429553587665847,63
4237,4,15531,3146,12385,0,0,0,1.0,1,1.0,1,1.0,1,0.17660657392557655,65
4238,3,15534,3146,12388,0,0,0,1.0,1,1.0,1,1.0,1,0.17462791798926733,65
4239,5,15539,3146,12393,0,0,0,1.0,1,1.0,1,1.0,1,0.1911078697211305,65
4240,8,15547,3146,12401,0,0,0,1.0,1,1.0,1,1.0,1,0.17187450295577258,66
4241,6,15553,3146,12407,0,0,0,1.0,1,1.0,1,1.0,1,0.17187450295577258,66
4242,5,15558,3147,12411,0,0,0,1.0,1,1.0,1,1.0,1,0.14026517917772663,69
4243,8,15566,3147,12419,0,0,0,1.0,1,1.0,1,1.0,1,0.13781917940328167,71
4244,7,15573,3147,12426,0,0,0,1.0,1,1.0,1,1.0,1,0.13661591171722445,71
4245,4,15577,3147,12430,0,0,0,1.0,1,1.0,1,1.0,1,0.1542102903853588,73
4246,6,15583,3147,12436,0,0,0,1.0,1,1.0,1,1.0,1,0.10043681512539435,74
4247,1,15584,3147,12437,0,0,0,1.0,1,1.0,1,1.0,1,0.08897517537332776,74
4248,0,15584,3147,12437,0,0,0,1.0,1,1.0,1,1.0,1,0.08897517537332776,74
4249,0,15584,3147,12437,0,0,0,1.0,1,1.0,1,1.0,1,0.08897517537332776,74
4250,0,15584,3147,12437,0,0,0,1.0,1,1.0,1,1.0,1,0.08897517537332776,74
4251,1,15585,3148,12437,0,0,0,1.0,1,1.0,1,1.0,1,0.09926962659758248,75
4252,4,15589,3151,12438,0,0,0,1.0,1,1.0,1,1.0,1,0.1490478883727031,75
4253,4,15593,3151,12442,0,0,0,1.0,1,1.0,1,1.0,1,0.12914586568197253,76
4254,2,15595,3153,12442,0,0,0,1.0,1,1.0,1,1.0,1,0.15012316612024915,75
4255,3,15598,3155,12443,0,0,0,1.0,1,1.0,1,1.0,1,0.1549204407396477,76
4256,5,15603,3155,12448,0,0,0,1.0,1,1.0,1,1.0,1,0.15038505734289082,78
4257,5,15608,3156,12452,0,0,0,1.0,1,1.0,1,1.0,1,0.1312238870729131,78
4258,6,15614,3157,12457,0,0,0,1.0,1,1.0,1,1.0,1,0.1377240241335468,77
4259,6,15620,3158,12462,0,0,0,1.0,1,1.0,1,1.0,1,0.14721818322684743,78
4260,5,15625,3158,12467,0,0,0,1.0,1,1.0,1,1.0,1,0.1389036988707749,77
4261,5,15630,3158,12472,0,0,0,1.0,1,1.0,1,1.0,1,0.11077974167397894,76
4262,1,15631,3158,12473,0,0,0,1.0,1,1.0,1,1.0,1,0.12390282972979863,75
4263,2,15633,3160,12473,0,0,0,1.0,1,1.0,1,1.0,1,0.1310428989508296,74
4264,1,15634,3160,12474,0,0,0,1.0,1,1.0,1,1.0,1,0.142225209243386,74
4265,2,15636,3162,12474,0,0,0,1.0,1,1.0,1,1.0,1,0.1647288280068505,73
4266,1,15637,3163,12474,0,0,0,1.0,1,1.0,1,1.0,1,0.18868825045138685,71
4267,5,15642,3166,12476,0,0,0,1.0,1,1.0,1,1.0,1,0.2128689276844415,69
4268,2,15644,3167,12477,0,0,0,1.0,1,1.0,1,1.0,1,0.2268269737417399,67
4269,1,15645,3168,12477,0,0,0,1.0,1,1.0,1,1.0,1,0.2515530268429178,64
4270,0,15645,3168,12477,0,0,0,1.0,1,1.0,1,1.0,1,0.23653672198754594,63
4271,4,15649,3169,12480,0,0,0,1.0,1,1.0,1,1.0,1,0.2361882028311349,63
4272,1,15650,3170,12480,0,0,0,1.0,1,1.0,1,1.0,1,0.24903085045885084,62
4273,4,15654,3171,12483,0,0,0,1.0,1,1.0,1,1.0,1,0.25256235453483056,62
4274,1,15655,3171,12484,0,0,0,1.0,1,1.0,1,1.0,1,0.2393500988144155,62
4275,3,15658,3173,12485,0,0,0,1.0,1,1.0,1,1.0,1,0.21861357698963083,61
4276,10,15668,3173,12495,0,0,0,1.0,1,1.0,1,1.0,1,0.10133085056796574,62
4277,1,15669,3173,12496,0,0,0,1.0,1,1.0,1,1.0,1,0.11426017517715148,63
4278,2,15671,3173,12498,0,0,0,1.0,1,1.0,1,1.0,1,0.10233926146911759,64
4279,3,15674,3174,12500,0,0,0,1.0,1,1.0,1,1.0,1,0.1309560625665068,65
4280,3,15677,3175,12502,0,0,0,1.0,1,1.0,1,1.0,1,0.1308824254502297,65
4281,6,15683,3175,12508,0,0,0,1.0,1,1.0,1,1.0,1,0.13991813901773137,65
4282,14,15697,3178,12519,0,0,0,1.0,1,1.0,1,1.0,1,0.18325919864914944,66
4283,6,15703,3179,12524,0,0,0,1.0,1,1.0,1,1.0,1,0.2004870346818825,66
4284,12,15715,3180,12535,0,0,0,1.0,1,1.0,1,1.0,1,0.22782568812696827,66
4285,10,15725,3180,12545,0,0,0,1.0,1,1.0,1,1.0,1,0.22169837530047568,67
4286,8,15733,3180,12553,0,0,0,1.0,1,1.0,1,1.0,1,0.2171194368421388,67
4287,9,15742,3180,12562,0,0,0,1.0,1,1.0,1,1.0,1,0.21782328972410198,67
4288,13,15755,3181,12574,0,0,0,1.0,1,1.0,1,1.0,1,0.2208292886996789,68
4289,12,15767,3181,12586,0,0,0,1.0,1,1.0,1,1.0,1,0.23715378157903877,68
4290,12,15779,3181,12598,0,0,0,1.0,1,1.0,1,1.0,1,0.23680819327374925,70
4291,9,15788,3181,12607,0,0,0,1.0,1,1.0,1,1.0,1,0.1583227645929683,71
4292,1,15789,3181,12608,0,0,0,1.0,1,1.0,1,1.0,1,0.15356826389340367,71
4293,0,15789,3181,12608,0,0,0,1.0,1,1.0,1,1.0,1,0.15356826389340367,71
4294,2,15791,3182,12609,0,0,0,1.0,1,1.0,1,1.0,1,0.15182479454200037,71
4295,2,15793,3182,12611,0,0,0,1.0,1,1.0,1,1.0,1,0.15748972284569218,72
4296,4,15797,3182,12615,0,0,0,1.0,1,1.0,1,1.0,1,0.15803729862198973,73
4297,0,15797,3182,12615,0,0,0,1.0,1,1.0,1,1.0,1,0.15803729862198973,73
4298,1,15798,3182,12616,0,0,0,1.0,1,1.0,1,1.0,1,0.16762556451146576,74
4299,2,15800,3182,12618,0,0,0,1.0,1,1.0,1,1.0,1,0.1552427788937189,75
4300,4,15804,3183,12621,0,0,0,1.0,1,1.0,1,1.0,1,0.1580571477906295,75
4301,5,15809,3183,12626,0,0,0,1.0,1,1.0,1,1.0,1,0.16166201815217263,76
4302,5,15814,3185,12629,0,0,0,1.0,1,1.0,1,1.0,1,0.14314854824950368,76
4303,5,15819,3186,12633,0,0,0,1.0,1,1.0,1,1.0,1,0.16978892239651752,75
4304,7,15826,3188,12638,0,0,0,1.0,1,1.0,1,1.0,1,0.19030370961011273,75
4305,4,15830,3188,12642,0,0,0,1.0,1,1.0,1,1.0,1,0.19054650539884013,73
4306,12,15842,3190,12652,0,0,0,1.0,1,1.0,1,1.0,1,0.16293843410289094,74
4307,11,15853,3191,12662,0,0,0,1.0,1,1.0,1,1.0,1,0.14616124447883314,73
4308,6,15859,3191,12668,0,0,0,1.0,1,1.0,1,1.0,1,0.14969685795226892,71
4309,8,15867,3191,12676,0,0,0,1.0,1,1.0,1,1.0,1,0.1655894266264335,70
4310,9,15876,3193,12683,0,0,0,1.0,1,1.0,1,1.0,1,0.18404537452765296,69
4311,10,15886,3195,12691,0,0,0,1.0,1,1.0,1,1.0,1,0.14153731729954022,69
4312,8,15894,3196,12698,0,0,0,1.0,1,1.0,1,1.0,1,0.18328209570232193,66
4313,5,15899,3198,12701,0,0,0,1.0,1,1.0,1,1.0,1,0.17940396451912125,64
4314,6,15905,3198,12707,0,0,0,1.0,1,1.0,1,1.0,1,0.17988294428526408,61
4315,7,15912,3200,12712,0,0,0,1.0,1,1.0,1,1.0,1,0.19149417121210502,61
4316,5,15917,3202,12715,0,0,0,1.0,1,1.0,1,1.0,1,0.17784915392201703,60
4317,2,15919,3202,12717,0,0,0,1.0,1,1.0,1,1.0,1,0.1969955387998864,62
4318,4,15923,3204,12719,0,0,0,1.0,1,1.0,1,1.0,1,0.18975149993725282,59
4319,3,15926,3206,12720,0,0,0,1.0,1,1.0,1,1.0,1,0.23121176110775205,60
4320,1,15927,3206,12721,0,0,0,1.0,1,1.0,1,1.0,1,0.21840423162641273,60
4321,8,15935,3208,12727,0,0,0,1.0,1,1.0,1,1.0,1,0.1691308908278622,61
4322,0,15935,3208,12727,0,0,0,1.0,1,1.0,1,1.0,1,0.1691308908278622,61
4323,0,15935,3208,12727,0,0,0,1.0,1,1.0,1,1.0,1,0.1691308908278622,61
4324,2,15937,3209,12728,0,0,0,1.0,1,1.0,1,1.0,1,0.17856851589824513,60
4325,3,15940,3211,12729,0,0,0,1.0,1,1.0,1,1.0,1,0.19313905644557736,60
4326,4,15944,3213,12731,0,0,0,1.0,1,1.0,1,1.0,1,0.19084487493927962,61
4327,4,15948,3213,12735,0,0,0,1.0,1,1.0,1,1.0,1,0.1418061009681375,62
4328,1,15949,3213,12736,0,0,0,1.0,1,1.0,1,1.0,1,0.13793034047050012,62
4329,1,15950,3213,12737,0,0,0,1.0,1,1.0,1,1.0,1,0.12247379310509279,65
4330,2,15952,3213,12739,0,0,0,1.0,1,1.0,1,1.0,1,0.13431071230522273,65
4331,1,15953,3213,12740,0,0,0,1.0,1,1.0,1,1.0,1,0.12349438752374546,65
4332,4,15957,3214,12743,0,0,0,1.0,1,1.0,1,1.0,1,0.1298852730160743,66
4333,2,15959,3214,12745,0,0,0,1.0,1,1.0,1,1.0,1,0.13595756257647437,66
4334,4,15963,3216,12747,0,0,0,1.0,1,1.0,1,1.0,1,0.1527505079548458,66
4335,1,15964,3216,12748,0,0,0,1.0,1,1.0,1,1.0,1,0.16155208768709756,65
4336,8,15972,3217,12755,0,0,0,1.0,1,1.0,1,1.0,1,0.11217524587326771,67
4337,3,15975,3219,12756,0,0,0,1.0,1,1.0,1,1.0,1,0.1565263375850772,69
4338,2,15977,3219,12758,0,0,0,1.0,1,1.0,1,1.0,1,0.15570833770371545,70
4339,4,15981,3219,12762,0,0,0,1.0,1,1.0,1,1.0,1,0.16300525255009368,70
4340,4,15985,3219,12766,0,0,0,1.0,1,1.0,1,1.0,1,0.16041893016005365,71
4341,9,15994,3221,12773,0,0,0,1.0,1,1.0,1,1.0,1,0.1719044513581058,70
4342,6,16000,3222,12778,0,0,0,1.0,1,1.0,1,1.0,1,0.17045586858169745,71
4343,6,16006,3224,12782,0,0,0,1.0,1,1.0,1,1.0,1,0.17270484718419432,67
4344,10,16016,3227,12789,0,0,0,1.0,1,1.0,1,1.0,1,0.21216660963426445,67
4345,7,16023,3228,12795,0,0,0,1.0,1,1.0,1,1.0,1,0.24380813966768108,64
4346,13,16036,3232,12804,0,0,0,1.0,1,1.0,1,1.0,1,0.23415634314255374,64
4347,6,16042,3235,12807,0,0,0,1.0,1,1.0,1,1.0,1,0.260793280909705,62
4348,5,16047,3236,12811,0,0,0,1.0,1,1.0,1,1.0,1,0.26165044418080624,62
4349,7,16054,3236,12818,0,0,0,1.0,1,1.0,1,1.0,1,0.2691174220943902,61
4350,7,16061,3237,12824,0,0,0,1.0,1,1.0,1,1.0,1,0.2712968817178058,60
4351,10,16071,3241,12830,0,0,0,1.0,1,1.0,1,1.0,1,0.2131680829058013,60
4352,2,16073,3241,12832,0,0,0,1.0,1,1.0,1,1.0,1,0.24562726993987413,57
4353,2,16075,3242,12833,0,0,0,1.0,1,1.0,1,1.0,1,0.22941754868674072,55
4354,5,16080,3244,12836,0,0,0,1.0,1,1.0,1,1.0,1,0.20486538737281088,55
4355,0,16080,3244,12836,0,0,0,1.0,1,1.0,1,1.0,1,0.22161080797285695,53
4356,0,16080,3244,12836,0,0,0,1.0,1,1.0,1,1.0,1,0.20976229519981882,55
4357,4,16084,3245,12839,0,0,0,1.0,1,1.0,1,1.0,1,0.17576844582820292,55
4358,2,16086,3245,12841,0,0,0,1.0,1,1.0,1,1.0,1,0.17905871352480257,55
4359,0,16086,3245,12841,0,0,0,1.0,1,1.0,1,1.0,1,0.19918240545647792,54
4360,1,16087,3245,12842,0,0,0,1.0,1,1.0,1,1.0,1,0.1979464693187969,55
4361,0,16087,3245,12842,0,0,0,1.0,1,1.0,1,1.0,1,0.19048024896160712,54
4362,1,16088,3245,12843,0,0,0,1.0,1,1.0,1,1.0,1,0.15221527725836034,55
4363,1,16089,3246,12843,0,0,0,1.0,1,1.0,1,1.0,1,0.18319285689075857,55
4364,1,16090,3247,12843,0,0,0,1.0,1,1.0,1,1.0,1,0.2011920655964705,55
4365,1,16091,3248,12843,0,0,0,1.0,1,1.0,1,1.0,1,0.22397568559481795,54
4366,8,16099,3250,12849,0,0,0,1.0,1,1.0,1,1.0,1,0.12681546040651115,54
4367,2,16101,3251,12850,0,0,0,1.0,1,1.0,1,1.0,1,0.13771469806203906,57
4368,2,16103,3251,12852,0,0,0,1.0,1,1.0,1,1.0,1,0.1479223809654285,57
4369,2,16105,3251,12854,0,0,0,1.0,1,1.0,1,1.0,1,0.14629344371890313,58
4370,2,16107,3251,12856,0,0,0,1.0,1,1.0,1,1.0,1,0.15884052527895806,59
4371,3,16110,3251,12859,0,0,0,1.0,1,1.0,1,1.0,1,0.1164771804036577,60
4372,3,16113,3253,12860,0,0,0,1.0,1,1.0,1,1.0,1,0.14434216473723252,60
4373,1,16114,3253,12861,0,0,0,1.0,1,1.0,1,1.0,1,0.14235371896640958,60
4374,1,16115,3253,12862,0,0,0,1.0,1,1.0,1,1.0,1,0.16155038174441394,59
4375,3,16118,3253,12865,0,0,0,1.0,1,1.0,1,1.0,1,0.1657518962129327,60
4376,1,16119,3253,12866,0,0,0,1.0,1,1.0,1,1.0,1,0.19581823736088816,60
4377,7,16126,3255,12871,0,0,0,1.0,1,1.0,1,1.0,1,0.20749037020478645,61
4378,2,16128,3256,12872,0,0,0,1.0,1,1.0,1,1.0,1,0.19443208702116183,64
4379,5,16133,3257,12876,0,0,0,1.0,1,1.0,1,1.0,1,0.21435941188123495,64
4380,4,16137,3258,12879,0,0,0,1.0,1,1.0,1,1.0,1,0.23439055450246601,65
4381,7,16144,3259,12885,0,0,0,1.0,1,1.0,1,1.0,1,0.1951714135119518,64
4382,3,16147,3260,12887,0,0,0,1.0,1,1.0,1,1.0,1,0.20555644811809093,64
4383,4,16151,3261,12890,0,0,0,1.0,1,1.0,1,1.0,1,0.19700529085657692,64
4384,2,16153,3262,12891,0,0,0,1.0,1,1.0,1,1.0,1,0.24077694437371386,60
4385,2,16155,3262,12893,0,0,0,1.0,1,1.0,1,1.0,1,0.23634651430848652,58
4386,5,16160,3265,12895,0,0,0,1.0,1,1.0,1,1.0,1,0.2442784928566398,58
4387,4,16164,3266,12898,0,0,0,1.0,1,1.0,1,1.0,1,0.2401289648220478,55
4388,8,16172,3269,12903,0,0,0,1.0,1,1.0,1,1.0,1,0.21159681681968795,56
4389,1,16173,3269,12904,0,0,0,1.0,1,1.0,1,1.0,1,0.1998207053472445,55
4390,0,16173,3269,12904,0,0,0,1.0,1,1.0,1,1.0,1,0.1998207053472445,55
4391,2,16175,3270,12905,0,0,0,1.0,1,1.0,1,1.0,1,0.19206401080545854,56
4392,6,16181,3273,12908,0,0,0,1.0,1,1.0,1,1.0,1,0.17386396731111303,56
4393,2,16183,3274,12909,0,0,0,1.0,1,1.0,1,1.0,1,0.15621226886697864,55
4394,1,16184,3275,12909,0,0,0,1.0,1,1.0,1,1.0,1,0.15324279875038885,53
4395,1,16185,3276,12909,0,0,0,1.0,1,1.0,1,1.0,1,0.16671164165944613,53
4396,5,16190,3279,12911,0,0,0,1.0,1,1.0,1,1.0,1,0.1510272300368821,53
4397,1,16191,3280,12911,0,0,0,1.0,1,1.0,1,1.0,1,0.14671795277864236,50
4398,1,16192,3280,12912,0,0,0,1.0,1,1.0,1,1.0,1,0.1665068536997363,50
4399,0,16192,3280,12912,0,0,0,1.0,1,1.0,1,1.0,1,0.16774796527897184,52
4400,5,16197,3281,12916,0,0,0,1.0,1,1.0,1,1.0,1,0.1819288496229247,55
4401,2,16199,3281,12918,0,0,0,1.0,1,1.0,1,1.0,1,0.16394081138359928,56
4402,1,16200,3281,12919,0,0,0,1.0,1,1.0,1,1.0,1,0.1613893739140474,56
4403,8,16208,3283,12925,0,0,0,1.0,1,1.0,1,1.0,1,0.17080834963061756,57
4404,2,16210,3283,12927,0,0,0,1.0,1,1.0,1,1.0,1,0.17080834963061756,57
4405,2,16212,3283,12929,0,0,0,1.0,1,1.0,1,1.0,1,0.15262017807789216,58
4406,2,16214,3283,12931,0,0,0,1.0,1,1.0,1,1.0,1,0.16593442639549771,58
4407,2,16216,3283,12933,0,0,0,1.0,1,1.0,1,1.0,1,0.15288005980236094,58
4408,4,16220,3283,12937,0,0,0,1.0,1,1.0,1,1.0,1,0.16226198971959824,59
4409,5,16225,3283,12942,0,0,0,1.0,1,1.0,1,1.0,1,0.14080717511327293,59
4410,4,16229,3283,12946,0,0,0,1.0,1,1.0,1,1.0,1,0.14080717511327293,59
4411,1,16230,3283,12947,0,0,0,1.0,1,1.0,1,1.0,1,0.11411095224220237,62
4412,0,16230,3283,12947,0,0,0,1.0,1,1.0,1,1.0,1,0.11534256447551194,63
4413,1,16231,3284,12947,0,0,0,1.0,1,1.0,1,1.0,1,0.12292432889097672,63
4414,1,16232,3284,12948,0,0,0,1.0,1,1.0,1,1.0,1,0.1276875993076691,64
4415,5,16237,3285,12952,0,0,0,1.0,1,1.0,1,1.0,1,0.10790146571084673,64
4416,0,16237,3285,12952,0,0,0,1.0,1,1.0,1,1.0,1,0.10790146571084673,64
4417,1,16238,3285,12953,0,0,0,1.0,1,1.0,1,1.0,1,0.10718976101641212,65
4418,3,16241,3286,12955,0,0,0,1.0,1,1.0,1,1.0,1,0.12956598384779164,65
4419,1,16242,3286,12956,0,0,0,1.0,1,1.0,1,1.0,1,0.15986553457386285,62
4420,0,16242,3286,12956,0,0,0,1.0,1,1.0,1,1.0,1,0.17632481850824414,62
4421,0,16242,3286,12956,0,0,0,1.0,1,1.0,1,1.0,1,0.19009819096112243,65
4422,7,16249,3287,12962,0,0,0,1.0,1,1.0,1,1.0,1,0.17315116837690792,64
4423,2,16251,3287,12964,0,0,0,1.0,1,1.0,1,1.0,1,0.15739849138101067,63
4424,1,16252,3288,12964,0,0,0,1.0,1,1.0,1,1.0,1,0.16616939570092287,63
4425,7,16259,3290,12969,0,0,0,1.0,1,1.0,1,1.0,1,0.16068003177553225,63
4426,4,16263,3292,12971,0,0,0,1.0,1,1.0,1,1.0,1,0.13638040725252643,63
4427,2,16265,3293,12972,0,0,0,1.0,1,1.0,1,1.0,1,0.14577889503896072,62
4428,3,16268,3293,12975,0,0,0,1.0,1,1.0,1,1.0,1,0.1356343796985055,61
4429,4,16272,3296,12976,0,0,0,1.0,1,1.0,1,1.0,1,0.14464621599757171,62
4430,3,16275,3297,12978,0,0,0,1.0,1,1.0,1,1.0,1,0.1200491005460095,60
4431,3,16278,3299,12979,0,0,0,1.0,1,1.0,1,1.0,1,0.11705654520487287,59
4432,2,16280,3300,12980,0,0,0,1.0,1,1.0,1,1.0,1,0.10415078009937315,60
4433,5,16285,3302,12983,0,0,0,1.0,1,1.0,1,1.0,1,0.1304134596926767,61
4434,5,16290,3303,12987,0,0,0,1.0,1,1.0,1,1.0,1,0.12750896501744988,61
4435,2,16292,3304,12988,0,0,0,1.0,1,1.0,1,1.0,1,0.14195738819682618,61
4436,2,16294,3304,12990,0,0,0,1.0,1,1.0,1,1.0,1,0.14195738819682618,61
4437,4,16298,3307,12991,0,0,0,1.0,1,1.0,1,1.0,1,0.22694634994443566,61
4438,6,16304,3308,12996,0,0,0,1.0,1,1.0,1,1.0,1,0.192340687759724,62
4439,6,16310,3308,13002,0,0,0,1.0,1,1.0,1,1.0,1,0.18505823735957455,63
4440,4,16314,3308,13006,0,0,0,1.0,1,1.0,1,1.0,1,0.16045326362147805,64
4441,8,16322,3308,13014,0,0,0,1.0,1,1.0,1,1.0,1,0.0765424372222672,64
4442,4,16326,3311,13015,0,0,0,1.0,1,1.0,1,1.0,1,0.11720354103709255,67
4443,6,16332,3313,13019,0,0,0,1.0,1,1.0,1,1.0,1,0.13778682471519677,68
4444,6,16338,3313,13025,0,0,0,1.0,1,1.0,1,1.0,1,0.12178235229562523,69
4445,9,16347,3314,13033,0,0,0,1.0,1,1.0,1,1.0,1,0.15904981686475542,71
4446,8,16355,3314,13041,0,0,0,1.0,1,1.0,1,1.0,1,0.1533234536972221,71
4447,7,16362,3314,13048,0,0,0,1.0,1,1.0,1,1.0,1,0.1340782899961851,72
4448,6,16368,3314,13054,0,0,0,1.0,1,1.0,1,1.0,1,0.1400488292884205,71
4449,4,16372,3315,13057,0,0,0,1.0,1,1.0,1,1.0,1,0.12107788779907841,70
4450,3,16375,3315,13060,0,0,0,1.0,1,1.0,1,1.0,1,0.12152682372454192,69
4451,4,16379,3315,13064,0,0,0,1.0,1,1.0,1,1.0,1,0.12363676769453959,69
4452,3,16382,3315,13067,0,0,0,1.0,1,1.0,1,1.0,1,0.14075224042497847,70
4453,5,16387,3315,13072,0,0,0,1.0,1,1.0,1,1.0,1,0.18194225371964892,70
4454,7,16394,3317,13077,0,0,0,1.0,1,1.0,1,1.0,1,0.15993113191632397,71
4455,7,16401,3317,13084,0,0,0,1.0,1,1.0,1,1.0,1,0.15102944622676107,71
4456,7,16408,3319,13089,0,0,0,1.0,1,1.0,1,1.0,1,0.0816907279965232,71
4457,2,16410,3319,13091,0,0,0,1.0,1,1.0,1,1.0,1,0.08922719431539812,69
4458,3,16413,3320,13093,0,0,0,1.0,1,1.0,1,1.0,1,0.11515402986942792,70
4459,2,16415,3320,13095,0,0,0,1.0,1,1.0,1,1.0,1,0.13919250361258992,68
4460,3,16418,3322,13096,0,0,0,1.0,1,1.0,1,1.0,1,0.17546405957360478,68
4461,3,16421,3324,13097,0,0,0,1.0,1,1.0,1,1.0,1,0.16670703631148553,67
4462,2,16423,3326,13097,0,0,0,1.0,1,1.0,1,1.0,1,0.1773322642764192,66
4463,5,16428,3328,13100,0,0,0,1.0,1,1.0,1,1.0,1,0.20620107366233031,65
4464,2,16430,3330,13100,0,0,0,1.0,1,1.0,1,1.0,1,0.23166020492562284,62
4465,7,16437,3334,13103,0,0,0,1.0,1,1.0,1,1.0,1,0.25341217954689127,61
4466,0,16437,3334,13103,0,0,0,1.0,1,1.0,1,1.0,1,0.2512409812432876,60
4467,5,16442,3338,13104,0,0,0,1.0,1,1.0,1,1.0,1,0.22979978988635966,58
4468,0,16442,3338,13104,0,0,0,1.0,1,1.0,1,1.0,1,0.24093896825430774,57
4469,3,16445,3340,13105,0,0,0,1.0,1,1.0,1,1.0,1,0.2207319245734538,56
4470,4,16449,3343,13106,0,0,0,1.0,1,1.0,1,1.0,1,0.1985625869471022,55
4471,8,16457,3344,13113,0,0,0,1.0,1,1.0,1,1.0,1,0.13776263980450137,55
4472,4,16461,3346,13115,0,0,0,1.0,1,1.0,1,1.0,1,0.13965141305216508,55
4473,5,16466,3348,13118,0,0,0,1.0,1,1.0,1,1.0,1,0.18276774621898753,55
4474,4,16470,3350,13120,0,0,0,1.0,1,1.0,1,1.0,1,0.21246685887877836,55
4475,6,16476,3352,13124,0,0,0,1.0,1,1.0,1,1.0,1,0.22291923184423276,56
4476,5,16481,3352,13129,0,0,0,1.0,1,1.0,1,1.0,1,0.1962396517989201,56
4477,1,16482,3352,13130,0,0,0,1.0,1,1.0,1,1.0,1,0.20938558709539892,57
4478,3,16485,3352,13133,0,0,0,1.0,1,1.0,1,1.0,1,0.21078999248818978,55
4479,4,16489,3354,13135,0,0,0,1.0,1,1.0,1,1.0,1,0.2074148818680115,55
4480,0,16489,3354,13135,0,0,0,1.0,1,1.0,1,1.0,1,0.21460515149815845,54
4481,6,16495,3354,13141,0,0,0,1.0,1,1.0,1,1.0,1,0.19443619593227857,53
4482,5,16500,3355,13145,0,0,0,1.0,1,1.0,1,1.0,1,0.20508160293891717,54
4483,2,16502,3355,13147,0,0,0,1.0,1,1.0,1,1.0,1,0.21251952971610827,55
4484,5,16507,3356,13151,0,0,0,1.0,1,1.0,1,1.0,1,0.1801051214634015,57
4485,6,16513,3358,13155,0,0,0,1.0,1,1.0,1,1.0,1,0.1962052264983747,60
4486,6,16519,3359,13160,0,0,0,1.0,1,1.0,1,1.0,1,0.15979593822598476,60
4487,0,16519,3359,13160,0,0,0,1.0,1,1.0,1,1.0,1,0.15979593822598476,60
4488,0,16519,3359,13160,0,0,0,1.0,1,1.0,1,1.0,1,0.15979593822598476,60
4489,1,16520,3360,13160,0,0,0,1.0,1,1.0,1,1.0,1,0.17793857855450249,60
4490,1,16521,3360,13161,0,0,0,1.0,1,1.0,1,1.0,1,0.16276451888926446,60
4491,1,16522,3361,13161,0,0,0,1.0,1,1.0,1,1.0,1,0.16325519668283137,61
4492,4,16526,3362,13164,0,0,0,1.0,1,1.0,1,1.0,1,0.14402222500846856,61
4493,1,16527,3363,13164,0,0,0,1.0,1,1.0,1,1.0,1,0.1635395914238461,60
4494,2,16529,3363,13166,0,0,0,1.0,1,1.0,1,1.0,1,0.13918051988068386,61
4495,0,16529,3363,13166,0,0,0,1.0,1,1.0,1,1.0,1,0.14088131294432357,59
4496,2,16531,3363,13168,0,0,0,1.0,1,1.0,1,1.0,1,0.1452101685759179,60
4497,1,16532,3363,13169,0,0,0,1.0,1,1.0,1,1.0,1,0.141909721447101,59
4498,2,16534,3363,13171,0,0,0,1.0,1,1.0,1,1.0,1,0.15002380830722187,57
4499,3,16537,3365,13172,0,0,0,1.0,1,1.0,1,1.0,1,0.1461674336042895,58
4500,2,16539,3366,13173,0,0,0,1.0,1,1.0,1,1.0,1,0.17081420585514728,56
4501,7,16546,3368,13178,0,0,0,1.0,1,1.0,1,1.0,1,0.12041219299321818,57
4502,6,16552,3372,13180,0,0,0,1.0,1,1.0,1,1.0,1,0.14363827160886058,56
4503,2,16554,3372,13182,0,0,0,1.0,1,1.0,1,1.0,1,0.1289992253485535,54
4504,3,16557,3374,13183,0,0,0,1.0,1,1.0,1,1.0,1,0.13644075338346792,54
4505,1,16558,3374,13184,0,0,0,1.0,1,1.0,1,1.0,1,0.11807219412804774,51
4506,1,16559,3375,13184,0,0,0,1.0,1,1.0,1,1.0,1,0.11434222427707008,49
4507,2,16561,3377,13184,0,0,0,1.0,1,1.0,1,1.0,1,0.15886682585114748,48
4508,2,16563,3377,13186,0,0,0,1.0,1,1.0,1,1.0,1,0.15905138411412245,48
4509,0,16563,3377,13186,0,0,0,1.0,1,1.0,1,1.0,1,0.17806617078781517,46
4510,0,16563,3377,13186,0,0,0,1.0,1,1.0,1,1.0,1,0.19839368110948655,44
4511,1,16564,3378,13186,0,0,0,1.0,1,1.0,1,1.0,1,0.22530666899372645,45
4512,1,16565,3379,13186,0,0,0,1.0,1,1.0,1,1.0,1,0.23493026336223963,46
4513,3,16568,3380,13188,0,0,0,1.0,1,1.0,1,1.0,1,0.23338236485079752,45
4514,2,16570,3381,13189,0,0,0,1.0,1,1.0,1,1.0,1,0.18097673232695044,46
4515,4,16574,3381,13193,0,0,0,1.0,1,1.0,1,1.0,1,0.1671016535855037,48
4516,8,16582,3381,13201,0,0,0,1.0,1,1.0,1,1.0,1,0.08505798987328365,49
4517,2,16584,3382,13202,0,0,0,1.0,1,1.0,1,1.0,1,0.08947480180450665,50
4518,3,16587,3383,13204,0,0,0,1.0,1,1.0,1,1.0,1,0.0960079455381429,50
4519,1,16588,3384,13204,0,0,0,1.0,1,1.0,1,1.0,1,0.13376547904260272,49
4520,1,16589,3384,13205,0,0,0,1.0,1,1.0,1,1.0,1,0.1360732177675602,50
4521,0,16589,3384,13205,0,0,0,1.0,1,1.0,1,1.0,1,0.1360732177675602,50
4522,0,16589,3384,13205,0,0,0,1.0,1,1.0,1,1.0,1,0.1360732177675602,50
4523,3,16592,3385,13207,0,0,0,1.0,1,1.0,1,1.0,1,0.1370968567975027,51
4524,3,16595,3386,13209,0,0,0,1.0,1,1.0,1,1.0,1,0.14389912354721793,52
4525,4,16599,3387,13212,0,0,0,1.0,1,1.0,1,1.0,1,0.14237232671632735,53
4526,4,16603,3387,13216,0,0,0,1.0,1,1.0,1,1.0,1,0.11072460582156823,54
4527,2,16605,3388,13217,0,0,0,1.0,1,1.0,1,1.0,1,0.1289092843431687,55
4528,4,16609,3388,13221,0,0,0,1.0,1,1.0,1,1.0,1,0.13346838964730093,55
4529,4,16613,3388,13225,0,0,0,1.0,1,1.0,1,1.0,1,0.1389052874567374,55
4530,5,16618,3388,13230,0,0,0,1.0,1,1.0,1,1.0,1,0.10764300204145814,56
4531,4,16622,3391,13231,0,0,0,1.0,1,1.0,1,1.0,1,0.12114380975610825,56
4532,4,16626,3393,13233,0,0,0,1.0,1,1.0,1,1.0,1,0.11975398201699927,55
4533,0,16626,3393,13233,0,0,0,1.0,1,1.0,1,1.0,1,0.13980155649271145,54
4534,4,16630,3394,13236,0,0,0,1.0,1,1.0,1,1.0,1,0.15695642077088243,55
4535,3,16633,3394,13239,0,0,0,1.0,1,1.0,1,1.0,1,0.1255279164682062,52
4536,2,16635,3396,13239,0,0,0,1.0,1,1.0,1,1.0,1,0.14266994110752176,53
4537,3,16638,3397,13241,0,0,0,1.0,1,1.0,1,1.0,1,0.14522955597851284,52
4538,1,16639,3397,13242,0,0,0,1.0,1,1.0,1,1.0,1,0.1854246686557385,52
4539,5,16644,3399,13245,0,0,0,1.0,1,1.0,1,1.0,1,0.24239800082394303,53
4540,6,16650,3400,13250,0,0,0,1.0,1,1.0,1,1.0,1,0.22880469161371447,54
4541,4,16654,3400,13254,0,0,0,1.0,1,1.0,1,1.0,1,0.22258446314296065,53
4542,7,16661,3402,13259,0,0,0,1.0,1,1.0,1,1.0,1,0.20032332631659622,53
4543,5,16666,3403,13263,0,0,0,1.0,1,1.0,1,1.0,1,0.22165387207152606,53
4544,8,16674,3407,13267,0,0,0,1.0,1,1.0,1,1.0,1,0.22659059596779402,52
4545,5,16679,3407,13272,0,0,0,1.0,1,1.0,1,1.0,1,0.21614290564147343,50
4546,8,16687,3408,13279,0,0,0,1.0,1,1.0,1,1.0,1,0.1215005058634028,49
4547,3,16690,3409,13281,0,0,0,1.0,1,1.0,1,1.0,1,0.1281590272639756,49
4548,1,16691,3409,13282,0,0,0,1.0,1,1.0,1,1.0,1,0.12412065249094796,49
4549,4,16695,3409,13286,0,0,0,1.0,1,1.0,1,1.0,1,0.12433442708225403,50
4550,3,16698,3410,13288,0,0,0,1.0,1,1.0,1,1.0,1,0.1592048176095902,49
4551,2,16700,3411,13289,0,0,0,1.0,1,1.0,1,1.0,1,0.1296302376982752,49
4552,2,16702,3412,13290,0,0,0,1.0,1,1.0,1,1.0,1,0.1159879787704436,49
4553,2,16704,3413,13291,0,0,0,1.0,1,1.0,1,1.0,1,0.11280873805693986,49
4554,1,16705,3414,13291,0,0,0,1.0,1,1.0,1,1.0,1,0.12147612803623524,49
4555,0,16705,3414,13291,0,0,0,1.0,1,1.0,1,1.0,1,0.11156557357727152,48
4556,1,16706,3415,13291,0,0,0,1.0,1,1.0,1,1.0,1,0.10350387604615488,48
4557,2,16708,3417,13291,0,0,0,1.0,1,1.0,1,1.0,1,0.1380915813657551,49
4558,3,16711,3419,13292,0,0,0,1.0,1,1.0,1,1.0,1,0.13922035195074675,49
4559,0,16711,3419,13292,0,0,0,1.0,1,1.0,1,1.0,1,0.1684985218007152,50
4560,3,16714,3419,13295,0,0,0,1.0,1,1.0,1,1.0,1,0.1460734984988603,51
4561,2,16716,3419,13297,0,0,0,1.0,1,1.0,1,1.0,1,0.11318616440929963,52
4562,1,16717,3420,13297,0,0,0,1.0,1,1.0,1,1.0,1,0.13575835309864004,53
4563,1,16718,3420,13298,0,0,0,1.0,1,1.0,1,1.0,1,0.11878617136394118,52
4564,0,16718,3420,13298,0,0,0,1.0,1,1.0,1,1.0,1,0.11387500707987991,54
4565,0,16718,3420,13298,0,0,0,1.0,1,1.0,1,1.0,1,0.1280491726913097,55
4566,2,16720,3421,13299,0,0,0,1.0,1,1.0,1,1.0,1,0.0942553175186554,55
4567,1,16721,3422,13299,0,0,0,1.0,1,1.0,1,1.0,1,0.11878068564256222,56
4568,3,16724,3423,13301,0,0,0,1.0,1,1.0,1,1.0,1,0.11253239586178249,58
4569,2,16726,3423,13303,0,0,0,1.0,1,1.0,1,1.0,1,0.10884970514523461,59
4570,7,16733,3424,13309,0,0,0,1.0,1,1.0,1,1.0,1,0.09924435587368688,59
4571,3,16736,3424,13312,0,0,0,1.0,1,1.0,1,1.0,1,0.09671157093443733,57
4572,6,16742,3426,13316,0,0,0,1.0,1,1.0,1,1.0,1,0.1432437922994535,56
4573,5,16747,3427,13320,0,0,0,1.0,1,1.0,1,1.0,1,0.1665599025040563,56
4574,2,16749,3427,13322,0,0,0,1.0,1,1.0,1,1.0,1,0.20772103401378952,55
4575,2,16751,3427,13324,0,0,0,1.0,1,1.0,1,1.0,1,0.2257375869041094,55
4576,11,16762,3427,13335,0,0,0,1.0,1,1.0,1,1.0,1,0.15555336162381392,55
4577,2,16764,3427,13337,0,0,0,1.0,1,1.0,1,1.0,1,0.14500195810559496,54
4578,1,16765,3427,13338,0,0,0,1.0,1,1.0,1,1.0,1,0.16272331434208173,54
4579,4,16769,3427,13342,0,0,0,1.0,1,1.0,1,1.0,1,0.1536387324234026,54
4580,1,16770,3427,13343,0,0,0,1.0,1,1.0,1,1.0,1,0.15703743269017237,55
4581,3,16773,3429,13344,0,0,0,1.0,1,1.0,1,1.0,1,0.19194633267747108,56
4582,4,16777,3429,13348,0,0,0,1.0,1,1.0,1,1.0,1,0.15411529758626577,56
4583,1,16778,3430,13348,0,0,0,1.0,1,1.0,1,1.0,1,0.16131613889841223,57
4584,4,16782,3431,13351,0,0,0,1.0,1,1.0,1,1.0,1,0.1760768023815406,57
4585,2,16784,3431,13353,0,0,0,1.0,1,1.0,1,1.0,1,0.1760768023815406,57
4586,2,16786,3431,13355,0,0,0,1.0,1,1.0,1,1.0,1,0.1760768023815406,57
4587,2,16788,3431,13357,0,0,0,1.0,1,1.0,1,1.0,1,0.1760768023815406,57
4588,2,16790,3431,13359,0,0,0,1.0,1,1.0,1,1.0,1,0.17672567063334774,58
4589,2,16792,3431,13361,0,0,0,1.0,1,1.0,1,1.0,1,0.184955203347702,59
4590,2,16794,3431,13363,0,0,0,1.0,1,1.0,1,1.0,1,0.18891246768335895,60
4591,3,16797,3431,13366,0,0,0,1.0,1,1.0,1,1.0,1,0.15100443250248788,61
4592,1,16798,3431,13367,0,0,0,1.0,1,1.0,1,1.0,1,0.14082328160608126,62
4593,5,16803,3432,13371,0,0,0,1.0,1,1.0,1,1.0,1,0.1126613143824901,64
4594,5,16808,3432,13376,0,0,0,1.0,1,1.0,1,1.0,1,0.09036149044068838,64
4595,3,16811,3432,13379,0,0,0,1.0,1,1.0,1,1.0,1,0.08812733129941704,63
4596,2,16813,3432,13381,0,0,0,1.0,1,1.0,1,1.0,1,0.08922710919171435,63
4597,1,16814,3432,13382,0,0,0,1.0,1,1.0,1,1.0,1,0.09867862507321008,63
4598,3,16817,3433,13384,0,0,0,1.0,1,1.0,1,1.0,1,0.09767884475868005,65
4599,3,16820,3434,13386,0,0,0,1.0,1,1.0,1,1.0,1,0.12658205509845333,66
4600,5,16825,3435,13390,0,0,0,1.0,1,1.0,1,1.0,1,0.14216030730850693,67
4601,3,16828,3436,13392,0,0,0,1.0,1,1.0,1,1.0,1,0.16664951791387378,67
4602,8,16836,3436,13400,0,0,0,1.0,1,1.0,1,1.0,1,0.14190525285461997,69
4603,5,16841,3436,13405,0,0,0,1.0,1,1.0,1,1.0,1,0.16980175721772156,69
4604,6,16847,3436,13411,0,0,0,1.0,1,1.0,1,1.0,1,0.15970394719371958,69
4605,5,16852,3437,13415,0,0,0,1.0,1,1.0,1,1.0,1,0.14558773917808968,70
4606,5,16857,3437,13420,0,0,0,1.0,1,1.0,1,1.0,1,0.11699702651731385,70
4607,5,16862,3438,13424,0,0,0,1.0,1,1.0,1,1.0,1,0.11563491154327347,72
4608,1,16863,3438,13425,0,0,0,1.0,1,1.0,1,1.0,1,0.10675484706439663,73
4609,1,16864,3439,13425,0,0,0,1.0,1,1.0,1,1.0,1,0.10439643867119433,72
4610,2,16866,3439,13427,0,0,0,1.0,1,1.0,1,1.0,1,0.07590747448841671,72
4611,0,16866,3439,13427,0,0,0,1.0,1,1.0,1,1.0,1,0.07689359709909728,71
4612,2,16868,3440,13428,0,0,0,1.0,1,1.0,1,1.0,1,0.08563082822144555,70
4613,0,16868,3440,13428,0,0,0,1.0,1,1.0,1,1.0,1,0.08126490174632577,69
4614,1,16869,3441,13428,0,0,0,1.0,1,1.0,1,1.0,1,0.09221417972560286,68
4615,4,16873,3444,13429,0,0,0,1.0,1,1.0,1,1.0,1,0.10305571659837998,68
4616,0,16873,3444,13429,0,0,0,1.0,1,1.0,1,1.0,1,0.13554057867997624,65
4617,1,16874,3445,13429,0,0,0,1.0,1,1.0,1,1.0,1,0.12101021202550283,66
4618,1,16875,3446,13429,0,0,0,1.0,1,1.0,1,1.0,1,0.13545581860620456,66
4619,1,16876,3447,13429,0,0,0,1.0,1,1.0,1,1.0,1,0.1423992091900628,65
4620,1,16877,3447,13430,0,0,0,1.0,1,1.0,1,1.0,1,0.13879740465304027,65
4621,9,16886,3451,13435,0,0,0,1.0,1,1.0,1,1.0,1,0.1335257878398938,67
4622,1,16887,3452,13435,0,0,0,1.0,1,1.0,1,1.0,1,0.1385913823675882,65
4623,6,16893,3454,13439,0,0,0,1.0,1,1.0,1,1.0,1,0.1517019202645208,66
4624,3,16896,3455,13441,0,0,0,1.0,1,1.0,1,1.0,1,0.14404425252849032,65
4625,4,16900,3456,13444,0,0,0,1.0,1,1.0,1,1.0,1,0.14077764797520784,64
4626,2,16902,3458,13444,0,0,0,1.0,1,1.0,1,1.0,1,0.13288483968382828,63
4627,2,16904,3458,13446,0,0,0,1.0,1,1.0,1,1.0,1,0.1288870209030407,65
4628,0,16904,3458,13446,0,0,0,1.0,1,1.0,1,1.0,1,0.14321988044647702,64
4629,2,16906,3460,13446,0,0,0,1.0,1,1.0,1,1.0,1,0.13850034618168788,64
4630,2,16908,3460,13448,0,0,0,1.0,1,1.0,1,1.0,1,0.13850034618168788,64
4631,6,16914,3463,13451,0,0,0,1.0,1,1.0,1,1.0,1,0.18307158781168015,66
4632,1,16915,3463,13452,0,0,0,1.0,1,1.0,1,1.0,1,0.19179855189145906,65
4633,2,16917,3463,13454,0,0,0,1.0,1,1.0,1,1.0,1,0.17201473977181997,66
4634,3,16920,3464,13456,0,0,0,1.0,1,1.0,1,1.0,1,0.18004769615519833,66
4635,1,16921,3464,13457,0,0,0,1.0,1,1.0,1,1.0,1,0.17868019009392463,66
4636,5,16926,3464,13462,0,0,0,1.0,1,1.0,1,1.0,1,0.1297179127415188,66
4637,1,16927,3464,13463,0,0,0,1.0,1,1.0,1,1.0,1,0.10805267284018845,68
4638,0,16927,3464,13463,0,0,0,1.0,1,1.0,1,1.0,1,0.10805267284018845,68
4639,3,16930,3465,13465,0,0,0,1.0,1,1.0,1,1.0,1,0.09451055688526878,69
4640,1,16931,3465,13466,0,0,0,1.0,1,1.0,1,1.0,1,0.09524215319943823,69
4641,3,16934,3465,13469,0,0,0,1.0,1,1.0,1,1.0,1,0.08164802128584522,70
4642,0,16934,3465,13469,0,0,0,1.0,1,1.0,1,1.0,1,0.0912810673277326,69
4643,4,16938,3466,13472,0,0,0,1.0,1,1.0,1,1.0,1,0.09596691260239379,70
4644,2,16940,3467,13473,0,0,0,1.0,1,1.0,1,1.0,1,0.12896063985440148,69
4645,3,16943,3467,13476,0,0,0,1.0,1,1.0,1,1.0,1,0.13507705065357625,70
4646,4,16947,3468,13479,0,0,0,1.0,1,1.0,1,1.0,1,0.16123036869120844,68
4647,6,16953,3470,13483,0,0,0,1.0,1,1.0,1,1.0,1,0.17699989592656157,68
4648,2,16955,3470,13485,0,0,0,1.0,1,1.0,1,1.0,1,0.1743993045454299,67
4649,5,16960,3471,13489,0,0,0,1.0,1,1.0,1,1.0,1,0.16326385474892385,67
4650,1,16961,3471,13490,0,0,0,1.0,1,1.0,1,1.0,1,0.13627502733338884,67
4651,8,16969,3473,13496,0,0,0,1.0,1,1.0,1,1.0,1,0.14920070512384268,68
4652,2,16971,3474,13497,0,0,0,1.0,1,1.0,1,1.0,1,0.1661443994919244,66
4653,4,16975,3475,13500,0,0,0,1.0,1,1.0,1,1.0,1,0.14656546109836135,64
4654,0,16975,3475,13500,0,0,0,1.0,1,1.0,1,1.0,1,0.15891804579036778,65
4655,1,16976,3476,13500,0,0,0,1.0,1,1.0,1,1.0,1,0.17061785269115254,64
4656,4,16980,3477,13503,0,0,0,1.0,1,1.0,1,1.0,1,0.17788975663301868,65
4657,0,16980,3477,13503,0,0,0,1.0,1,1.0,1,1.0,1,0.1724939355488957,66
4658,2,16982,3479,13503,0,0,0,1.0,1,1.0,1,1.0,1,0.2169962058924788,65
4659,0,16982,3479,13503,0,0,0,1.0,1,1.0,1,1.0,1,0.2169962058924788,65
4660,5,16987,3481,13506,0,0,0,1.0,1,1.0,1,1.0,1,0.21449086675293416,66
4661,6,16993,3481,13512,0,0,0,1.0,1,1.0,1,1.0,1,0.2304925712565391,66
4662,4,16997,3482,13515,0,0,0,1.0,1,1.0,1,1.0,1,0.22064300018187746,68
4663,4,17001,3483,13518,0,0,0,1.0,1,1.0,1,1.0,1,0.20311328635971937,67
4664,4,17005,3484,13521,0,0,0,1.0,1,1.0,1,1.0,1,0.22959427573353783,67
4665,3,17008,3484,13524,0,0,0,1.0,1,1.0,1,1.0,1,0.21501274566919987,67
4666,9,17017,3484,13533,0,0,0,1.0,1,1.0,1,1.0,1,0.13991327232315695,67
4667,4,17021,3484,13537,0,0,0,1.0,1,1.0,1,1.0,1,0.1285068796031508,66
4668,3,17024,3486,13538,0,0,0,1.0,1,1.0,1,1.0,1,0.15285647781538708,66
4669,2,17026,3488,13538,0,0,0,1.0,1,1.0,1,1.0,1,0.15985862638331524,66
4670,0,17026,3488,13538,0,0,0,1.0,1,1.0,1,1.0,1,0.18140692699135605,64
4671,0,17026,3488,13538,0,0,0,1.0,1,1.0,1,1.0,1,0.18140692699135605,64
4672,3,17029,3490,13539,0,0,0,1.0,1,1.0,1,1.0,1,0.19511207877701572,64
4673,2,17031,3490,13541,0,0,0,1.0,1,1.0,1,1.0,1,0.1825738535491025,65
4674,3,17034,3492,13542,0,0,0,1.0,1,1.0,1,1.0,1,0.17762646249542252,66
4675,2,17036,3492,13544,0,0,0,1.0,1,1.0,1,1.0,1,0.1907211706444829,65
4676,4,17040,3493,13547,0,0,0,1.0,1,1.0,1,1.0,1,0.2016176717723082,65
4677,3,17043,3495,13548,0,0,0,1.0,1,1.0,1,1.0,1,0.18317152680098314,65
4678,0,17043,3495,13548,0,0,0,1.0,1,1.0,1,1.0,1,0.20377222148805182,64
4679,0,17043,3495,13548,0,0,0,1.0,1,1.0,1,1.0,1,0.19535433935194713,66
4680,1,17044,3496,13548,0,0,0,1.0,1,1.0,1,1.0,1,0.193531170755288,67
4681,7,17051,3497,13554,0,0,0,1.0,1,1.0,1,1.0,1,0.14800763052998794,67
4682,6,17057,3499,13558,0,0,0,1.0,1,1.0,1,1.0,1,0.16833710167631655,67
4683,5,17062,3500,13562,0,0,0,1.0,1,1.0,1,1.0,1,0.14894847488625573,67
4684,6,17068,3502,13566,0,0,0,1.0,1,1.0,1,1.0,1,0.1525980978521753,66
4685,2,17070,3502,13568,0,0,0,1.0,1,1.0,1,1.0,1,0.11786298793566109,65
4686,6,17076,3503,13573,0,0,0,1.0,1,1.0,1,1.0,1,0.13538429562628077,65
4687,7,17083,3504,13579,0,0,0,1.0,1,1.0,1,1.0,1,0.1505655685549716,65
4688,7,17090,3506,13584,0,0,0,1.0,1,1.0,1,1.0,1,0.23155004318483888,64
4689,10,17100,3507,13593,0,0,0,1.0,1,1.0,1,1.0,1,0.23428838791304024,65
4690,3,17103,3507,13596,0,0,0,1.0,1,1.0,1,1.0,1,0.20209245854588664,63
4691,12,17115,3511,13604,0,0,0,1.0,1,1.0,1,1.0,1,0.23871487939329591,64
4692,7,17122,3511,13611,0,0,0,1.0,1,1.0,1,1.0,1,0.2006102328048918,63
4693,4,17126,3512,13614,0,0,0,1.0,1,1.0,1,1.0,1,0.20009797446811817,64
4694,3,17129,3512,13617,0,0,0,1.0,1,1.0,1,1.0,1,0.21790228948316004,63
4695,9,17138,3512,13626,0,0,0,1.0,1,1.0,1,1.0,1,0.20437981293606594,62
4696,6,17144,3512,13632,0,0,0,1.0,1,1.0,1,1.0,1,0.14167790364951457,61
4697,3,17147,3512,13635,0,0,0,1.0,1,1.0,1,1.0,1,0.0983790144304501,63
4698,1,17148,3512,13636,0,0,0,1.0,1,1.0,1,1.0,1,0.09597218202945476,63
4699,3,17151,3512,13639,0,0,0,1.0,1,1.0,1,1.0,1,0.11157906774364883,65
4700,2,17153,3512,13641,0,0,0,1.0,1,1.0,1,1.0,1,0.1239938383804491,64
4701,2,17155,3513,13642,0,0,0,1.0,1,1.0,1,1.0,1,0.12774860416334807,64
4702,0,17155,3513,13642,0,0,0,1.0,1,1.0,1,1.0,1,0.13579011513510753,66
4703,1,17156,3513,13643,0,0,0,1.0,1,1.0,1,1.0,1,0.11838341553479384,65
4704,5,17161,3517,13644,0,0,0,1.0,1,1.0,1,1.0,1,0.1282175008493113,64
4705,3,17164,3518,13646,0,0,0,1.0,1,1.0,1,1.0,1,0.1643855353870759,65
4706,3,17167,3520,13647,0,0,0,1.0,1,1.0,1,1.0,1,0.19460701897235927,65
4707,3,17170,3521,13649,0,0,0,1.0,1,1.0,1,1.0,1,0.2214915842792838,63
4708,3,17173,3522,13651,0,0,0,1.0,1,1.0,1,1.0,1,0.21513175136480434,62
4709,7,17180,3524,13656,0,0,0,1.0,1,1.0,1,1.0,1,0.24022129125042713,61
4710,2,17182,3524,13658,0,0,0,1.0,1,1.0,1,1.0,1,0.2382356777162369,60
4711,12,17194,3525,13669,0,0,0,1.0,1,1.0,1,1.0,1,0.11935028010596653,59
4712,0,17194,3525,13669,0,0,0,1.0,1,1.0,1,1.0,1,0.1210794792391982,58
4713,4,17198,3526,13672,0,0,0,1.0,1,1.0,1,1.0,1,0.12064555116465586,58
4714,1,17199,3526,13673,0,0,0,1.0,1,1.0,1,1.0,1,0.11974060987911728,57
4715,2,17201,3526,13675,0,0,0,1.0,1,1.0,1,1.0,1,0.1300539204982109,57
4716,5,17206,3527,13679,0,0,0,1.0,1,1.0,1,1.0,1,0.11227271104412673,55
4717,6,17212,3528,13684,0,0,0,1.0,1,1.0,1,1.0,1,0.15825954795589642,57
4718,3,17215,3528,13687,0,0,0,1.0,1,1.0,1,1.0,1,0.15117024775470933,56
4719,9,17224,3529,13695,0,0,0,1.0,1,1.0,1,1.0,1,0.1075779197295401,56
4720,2,17226,3529,13697,0,0,0,1.0,1,1.0,1,1.0,1,0.08133716663529866,57
4721,3,17229,3529,13700,0,0,0,1.0,1,1.0,1,1.0,1,0.1636592559708492,57
4722,3,17232,3529,13703,0,0,0,1.0,1,1.0,1,1.0,1,0.09468294652607247,57
4723,4,17236,3530,13706,0,0,0,1.0,1,1.0,1,1.0,1,0.12931565758465405,57
4724,3,17239,3530,13709,0,0,0,1.0,1,1.0,1,1.0,1,0.10552691518160326,57
4725,1,17240,3531,13709,0,0,0,1.0,1,1.0,1,1.0,1,0.12841439126274423,57
4726,3,17243,3531,13712,0,0,0,1.0,1,1.0,1,1.0,1,0.11077744307973222,57
4727,0,17243,3531,13712,0,0,0,1.0,1,1.0,1,1.0,1,0.12795573077904152,56
4728,1,17244,3531,13713,0,0,0,1.0,1,1.0,1,1.0,1,0.14020230998679542,57
4729,1,17245,3531,13714,0,0,0,1.0,1,1.0,1,1.0,1,0.14585977750557383,56
4730,3,17248,3532,13716,0,0,0,1.0,1,1.0,1,1.0,1,0.1832277679784981,54
4731,2,17250,3532,13718,0,0,0,1.0,1,1.0,1,1.0,1,0.1866349794970732,54
4732,4,17254,3534,13720,0,0,0,1.0,1,1.0,1,1.0,1,0.2476938936256605,54
4733,6,17260,3534,13726,0,0,0,1.0,1,1.0,1,1.0,1,0.21130042918756242,55
4734,6,17266,3535,13731,0,0,0,1.0,1,1.0,1,1.0,1,0.2414918925425708,56
4735,7,17273,3537,13736,0,0,0,1.0,1,1.0,1,1.0,1,0.2740434647502682,56
4736,7,17280,3539,13741,0,0,0,1.0,1,1.0,1,1.0,1,0.33760434139185275,58
4737,6,17286,3539,13747,0,0,0,1.0,1,1.0,1,1.0,1,0.31694812383678533,59
4738,14,17300,3541,13759,0,0,0,1.0,1,1.0,1,1.0,1,0.35137919724672917,60
4739,15,17315,3541,13774,0,0,0,1.0,1,1.0,1,1.0,1,0.3294728651586482,60
4740,7,17322,3541,13781,0,0,0,1.0,1,1.0,1,1.0,1,0.33876988317697454,60
4741,10,17332,3542,13790,0,0,0,1.0,1,1.0,1,1.0,1,0.2434210125949991,61
4742,5,17337,3542,13795,0,0,0,1.0,1,1.0,1,1.0,1,0.2149676728673606,61
4743,2,17339,3542,13797,0,0,0,1.0,1,1.0,1,1.0,1,0.21485057213104158,60
4744,3,17342,3543,13799,0,0,0,1.0,1,1.0,1,1.0,1,0.18055299993471913,60
4745,2,17344,3543,13801,0,0,0,1.0,1,1.0,1,1.0,1,0.17625666263410852,59
4746,5,17349,3545,13804,0,0,0,1.0,1,1.0,1,1.0,1,0.18495391920158136,59
4747,7,17356,3546,13810,0,0,0,1.0,1,1.0,1,1.0,1,0.17210944694263267,58
4748,7,17363,3548,13815,0,0,0,1.0,1,1.0,1,1.0,1,0.11729818231519097,58
4749,7,17370,3548,13822,0,0,0,1.0,1,1.0,1,1.0,1,0.0808265736499959,58
4750,6,17376,3549,13827,0,0,0,1.0,1,1.0,1,1.0,1,0.1376095745651575,56
4751,4,17380,3550,13830,0,0,0,1.0,1,1.0,1,1.0,1,0.12394538456794851,58
4752,5,17385,3550,13835,0,0,0,1.0,1,1.0,1,1.0,1,0.1565773225046292,55
4753,6,17391,3550,13841,0,0,0,1.0,1,1.0,1,1.0,1,0.11157646172892625,55
4754,5,17396,3550,13846,0,0,0,1.0,1,1.0,1,1.0,1,0.12352530067021225,54
4755,6,17402,3550,13852,0,0,0,1.0,1,1.0,1,1.0,1,0.15030616475294625,54
4756,6,17408,3551,13857,0,0,0,1.0,1,1.0,1,1.0,1,0.0613080179814329,54
4757,2,17410,3551,13859,0,0,0,1.0,1,1.0,1,1.0,1,0.061102148370137,53
4758,3,17413,3551,13862,0,0,0,1.0,1,1.0,1,1.0,1,0.048836759909356695,53
4759,1,17414,3551,13863,0,0,0,1.0,1,1.0,1,1.0,1,0.041505356022514726,53
4760,2,17416,3552,13864,0,0,0,1.0,1,1.0,1,1.0,1,0.08155476831211714,53
4761,1,17417,3553,13864,0,0,0,1.0,1,1.0,1,1.0,1,0.10900381546410402,52
4762,7,17424,3556,13868,0,0,0,1.0,1,1.0,1,1.0,1,0.17982186186534793,54
4763,4,17428,3557,13871,0,0,0,1.0,1,1.0,1,1.0,1,0.22415862818023574,54
4764,5,17433,3558,13875,0,0,0,1.0,1,1.0,1,1.0,1,0.20151210777958287,55
4765,10,17443,3559,13884,0,0,0,1.0,1,1.0,1,1.0,1,0.23164079055722872,56
4766,9,17452,3560,13892,0,0,0,1.0,1,1.0,1,1.0,1,0.16763509010701452,58
4767,9,17461,3560,13901,0,0,0,1.0,1,1.0,1,1.0,1,0.1845044253365141,59
4768,11,17472,3561,13911,0,0,0,1.0,1,1.0,1,1.0,1,0.13913490847188728,60
4769,5,17477,3561,13916,0,0,0,1.0,1,1.0,1,1.0,1,0.1473097924936363,59
4770,9,17486,3561,13925,0,0,0,1.0,1,1.0,1,1.0,1,0.14829223028873134,60
4771,4,17490,3561,13929,0,0,0,1.0,1,1.0,1,1.0,1,0.12666560368722338,59
4772,1,17491,3562,13929,0,0,0,1.0,1,1.0,1,1.0,1,0.1414772898976632,59
4773,4,17495,3562,13933,0,0,0,1.0,1,1.0,1,1.0,1,0.10970647456301866,60
4774,3,17498,3563,13935,0,0,0,1.0,1,1.0,1,1.0,1,0.11121447621429306,60
4775,3,17501,3563,13938,0,0,0,1.0,1,1.0,1,1.0,1,0.09719553590901986,62
4776,6,17507,3563,13944,0,0,0,1.0,1,1.0,1,1.0,1,0.06454496391091515,63
4777,2,17509,3563,13946,0,0,0,1.0,1,1.0,1,1.0,1,0.07287398920261545,63
4778,3,17512,3563,13949,0,0,0,1.0,1,1.0,1,1.0,1,0.06526023321247151,63
4779,3,17515,3564,13951,0,0,0,1.0,1,1.0,1,1.0,1,0.08324692725811417,63
4780,4,17519,3564,13955,0,0,0,1.0,1,1.0,1,1.0,1,0.10433457679842781,65
4781,3,17522,3564,13958,0,0,0,1.0,1,1.0,1,1.0,1,0.09739777404529841,64
4782,3,17525,3564,13961,0,0,0,1.0,1,1.0,1,1.0,1,0.10310319833826107,65
4783,8,17533,3566,13967,0,0,0,1.0,1,1.0,1,1.0,1,0.08920559121764157,66
4784,11,17544,3569,13975,0,0,0,1.0,1,1.0,1,1.0,1,0.14114674301443347,64
4785,6,17550,3570,13980,0,0,0,1.0,1,1.0,1,1.0,1,0.18532741204996386,65
4786,11,17561,3573,13988,0,0,0,1.0,1,1.0,1,1.0,1,0.12001272571903156,66
4787,8,17569,3574,13995,0,0,0,1.0,1,1.0,1,1.0,1,0.12364561666670512,63
4788,5,17574,3576,13998,0,0,0,1.0,1,1.0,1,1.0,1,0.12265979285335732,63
4789,4,17578,3579,13999,0,0,0,1.0,1,1.0,1,1.0,1,0.1746544506440699,60
4790,6,17584,3581,14003,0,0,0,1.0,1,1.0,1,1.0,1,0.17060421083523344,61
4791,6,17590,3583,14007,0,0,0,1.0,1,1.0,1,1.0,1,0.22550090796477412,59
4792,2,17592,3584,14008,0,0,0,1.0,1,1.0,1,1.0,1,0.190749661671905,59
4793,5,17597,3585,14012,0,0,0,1.0,1,1.0,1,1.0,1,0.18940160312896231,61
4794,3,17600,3585,14015,0,0,0,1.0,1,1.0,1,1.0,1,0.21064384527939958,60
4795,5,17605,3586,14019,0,0,0,1.0,1,1.0,1,1.0,1,0.19466121916467408,61
4796,2,17607,3586,14021,0,0,0,1.0,1,1.0,1,1.0,1,0.21582504704998506,60
4797,7,17614,3589,14025,0,0,0,1.0,1,1.0,1,1.0,1,0.21563345429959427,61
4798,5,17619,3591,14028,0,0,0,1.0,1,1.0,1,1.0,1,0.2758770541284632,61
4799,4,17623,3591,14032,0,0,0,1.0,1,1.0,1,1.0,1,0.2485370654997321,59
4800,2,17625,3592,14033,0,0,0,1.0,1,1.0,1,1.0,1,0.2570987581757618,57
4801,10,17635,3592,14043,0,0,0,1.0,1,1.0,1,1.0,1,0.13404545482778724,58
4802,2,17637,3592,14045,0,0,0,1.0,1,1.0,1,1.0,1,0.13409878412517023,56
4803,4,17641,3592,14049,0,0,0,1.0,1,1.0,1,1.0,1,0.12179308330839307,57
4804,3,17644,3592,14052,0,0,0,1.0,1,1.0,1,1.0,1,0.14778153597181376,55
4805,7,17651,3595,14056,0,0,0,1.0,1,1.0,1,1.0,1,0.13743154239811192,56
4806,4,17655,3595,14060,0,0,0,1.0,1,1.0,1,1.0,1,0.16278340106891706,55
4807,5,17660,3595,14065,0,0,0,1.0,1,1.0,1,1.0,1,0.1610494144892013,53
4808,9,17669,3597,14072,0,0,0,1.0,1,1.0,1,1.0,1,0.19140335270105943,54
4809,8,17677,3597,14080,0,0,0,1.0,1,1.0,1,1.0,1,0.22931585293687265,53
4810,8,17685,3597,14088,0,0,0,1.0,1,1.0,1,1.0,1,0.22931585293687265,53
4811,4,17689,3597,14092,0,0,0,1.0,1,1.0,1,1.0,1,0.1620765664939634,54
4812,3,17692,3598,14094,0,0,0,1.0,1,1.0,1,1.0,1,0.19471694274173662,54
4813,5,17697,3599,14098,0,0,0,1.0,1,1.0,1,1.0,1,0.1627795523124515,55
4814,7,17704,3601,14103,0,0,0,1.0,1,1.0,1,1.0,1,0.15797362179847158,55
4815,7,17711,3601,14110,0,0,0,1.0,1,1.0,1,1.0,1,0.1737189810733405,56
4816,6,17717,3601,14116,0,0,0,1.0,1,1.0,1,1.0,1,0.09470588812154869,56
4817,5,17722,3602,14120,0,0,0,1.0,1,1.0,1,1.0,1,0.06329661168464977,58
4818,1,17723,3603,14120,0,0,0,1.0,1,1.0,1,1.0,1,0.08336249786148814,58
4819,0,17723,3603,14120,0,0,0,1.0,1,1.0,1,1.0,1,0.07773595986667589,58
4820,0,17723,3603,14120,0,0,0,1.0,1,1.0,1,1.0,1,0.07773595986667589,58
4821,0,17723,3603,14120,0,0,0,1.0,1,1.0,1,1.0,1,0.08914016535268493,58
4822,1,17724,3604,14120,0,0,0,1.0,1,1.0,1,1.0,1,0.08956161942390269,58
4823,2,17726,3605,14121,0,0,0,1.0,1,1.0,1,1.0,1,0.10795368724100898,57
4824,5,17731,3607,14124,0,0,0,1.0,1,1.0,1,1.0,1,0.15668017459180858,56
4825,4,17735,3607,14128,0,0,0,1.0,1,1.0,1,1.0,1,0.12128901882659603,57
4826,6,17741,3608,14133,0,0,0,1.0,1,1.0,1,1.0,1,0.13214099546346064,57
4827,3,17744,3608,14136,0,0,0,1.0,1,1.0,1,1.0,1,0.1555509765586276,56
4828,5,17749,3609,14140,0,0,0,1.0,1,1.0,1,1.0,1,0.14674428247135698,57
4829,5,17754,3610,14144,0,0,0,1.0,1,1.0,1,1.0,1,0.159008913481881,56
4830,3,17757,3611,14146,0,0,0,1.0,1,1.0,1,1.0,1,0.14443148720424046,57
4831,5,17762,3613,14149,0,0,0,1.0,1,1.0,1,1.0,1,0.14909326458669173,57
4832,2,17764,3613,14151,0,0,0,1.0,1,1.0,1,1.0,1,0.14550873373478146,55
4833,5,17769,3615,14154,0,0,0,1.0,1,1.0,1,1.0,1,0.13426773711915715,55
4834,3,17772,3617,14155,0,0,0,1.0,1,1.0,1,1.0,1,0.17023278645829928,55
4835,4,17776,3617,14159,0,0,0,1.0,1,1.0,1,1.0,1,0.14387689830518793,55
4836,1,17777,3617,14160,0,0,0,1.0,1,1.0,1,1.0,1,0.16219083838044046,55
4837,3,17780,3618,14162,0,0,0,1.0,1,1.0,1,1.0,1,0.1514866064034732,53
4838,3,17783,3619,14164,0,0,0,1.0,1,1.0,1,1.0,1,0.12109609601225382,54
4839,3,17786,3622,14164,0,0,0,1.0,1,1.0,1,1.0,1,0.13757642053808652,53
4840,4,17790,3623,14167,0,0,0,1.0,1,1.0,1,1.0,1,0.12327696741803823,52
4841,5,17795,3627,14168,0,0,0,1.0,1,1.0,1,1.0,1,0.13288892145266765,51
4842,1,17796,3628,14168,0,0,0,1.0,1,1.0,1,1.0,1,0.14330868497200233,50
4843,2,17798,3630,14168,0,0,0,1.0,1,1.0,1,1.0,1,0.16686870974416468,51
4844,0,17798,3630,14168,0,0,0,1.0,1,1.0,1,1.0,1,0.1538746493685563,50
4845,2,17800,3632,14168,0,0,0,1.0,1,1.0,1,1.0,1,0.199736805140558,49
4846,6,17806,3632,14174,0,0,0,1.0,1,1.0,1,1.0,1,0.12582428886928593,49
4847,1,17807,3633,14174,0,0,0,1.0,1,1.0,1,1.0,1,0.14866876671006365,48
4848,2,17809,3635,14174,0,0,0,1.0,1,1.0,1,1.0,1,0.16294956951839393,48
4849,2,17811,3636,14175,0,0,0,1.0,1,1.0,1,1.0,1,0.16710081228842508,48
4850,1,17812,3636,14176,0,0,0,1.0,1,1.0,1,1.0,1,0.15856305232464155,49
4851,1,17813,3636,14177,0,0,0,1.0,1,1.0,1,1.0,1,0.1372587452352436,49
4852,1,17814,3636,14178,0,0,0,1.0,1,1.0,1,1.0,1,0.17704598895390097,49
4853,5,17819,3637,14182,0,0,0,1.0,1,1.0,1,1.0,1,0.16422227185836086,50
4854,7,17826,3637,14189,0,0,0,1.0,1,1.0,1,1.0,1,0.15646748251791467,51
4855,3,17829,3637,14192,0,0,0,1.0,1,1.0,1,1.0,1,0.17787215911823598,51
4856,3,17832,3637,14195,0,0,0,1.0,1,1.0,1,1.0,1,0.1628609603893158,50
4857,3,17835,3637,14198,0,0,0,1.0,1,1.0,1,1.0,1,0.15419236559667565,51
4858,5,17840,3637,14203,0,0,0,1.0,1,1.0,1,1.0,1,0.13548098815850285,51
4859,8,17848,3637,14211,0,0,0,1.0,1,1.0,1,1.0,1,0.14385891103415346,52
4860,4,17852,3637,14215,0,0,0,1.0,1,1.0,1,1.0,1,0.14385891103415346,52
4861,4,17856,3637,14219,0,0,0,1.0,1,1.0,1,1.0,1,0.10730643132979815,53
4862,4,17860,3639,14221,0,0,0,1.0,1,1.0,1,1.0,1,0.10605782339910368,53
4863,0,17860,3639,14221,0,0,0,1.0,1,1.0,1,1.0,1,0.1104255973396994,51
4864,4,17864,3641,14223,0,0,0,1.0,1,1.0,1,1.0,1,0.09117062533343157,53
4865,3,17867,3641,14226,0,0,0,1.0,1,1.0,1,1.0,1,0.12962181940923345,52
4866,4,17871,3642,14229,0,0,0,1.0,1,1.0,1,1.0,1,0.1072808391837117,53
4867,3,17874,3643,14231,0,0,0,1.0,1,1.0,1,1.0,1,0.13034964615769126,51
4868,4,17878,3644,14234,0,0,0,1.0,1,1.0,1,1.0,1,0.14142402960640046,53
4869,4,17882,3644,14238,0,0,0,1.0,1,1.0,1,1.0,1,0.16270507873560658,53
4870,7,17889,3646,14243,0,0,0,1.0,1,1.0,1,1.0,1,0.15924791207648606,55
4871,6,17895,3647,14248,0,0,0,1.0,1,1.0,1,1.0,1,0.1812680301161308,55
4872,9,17904,3649,14255,0,0,0,1.0,1,1.0,1,1.0,1,0.20379963508071328,56
4873,2,17906,3650,14256,0,0,0,1.0,1,1.0,1,1.0,1,0.1970685258465907,56
4874,6,17912,3651,14261,0,0,0,1.0,1,1.0,1,1.0,1,0.16298039586004123,58
4875,4,17916,3651,14265,0,0,0,1.0,1,1.0,1,1.0,1,0.18859881749419666,56
4876,9,17925,3652,14273,0,0,0,1.0,1,1.0,1,1.0,1,0.10265219005235424,56
4877,3,17928,3652,14276,0,0,0,1.0,1,1.0,1,1.0,1,0.12097036287859969,54
4878,1,17929,3652,14277,0,0,0,1.0,1,1.0,1,1.0,1,0.1041312213606986,54
4879,10,17939,3655,14284,0,0,0,1.0,1,1.0,1,1.0,1,0.15249079204908225,54
4880,8,17947,3655,14292,0,0,0,1.0,1,1.0,1,1.0,1,0.16951955328905377,53
4881,8,17955,3655,14300,0,0,0,1.0,1,1.0,1,1.0,1,0.1581089402799978,54
4882,7,17962,3656,14306,0,0,0,1.0,1,1.0,1,1.0,1,0.162912262622107,52
4883,10,17972,3657,14315,0,0,0,1.0,1,1.0,1,1.0,1,0.20781111445308487,54
4884,8,17980,3657,14323,0,0,0,1.0,1,1.0,1,1.0,1,0.14093833826683394,52
4885,10,17990,3658,14332,0,0,0,1.0,1,1.0,1,1.0,1,0.19506910877915015,51
4886,4,17994,3658,14336,0,0,0,1.0,1,1.0,1,1.0,1,0.2676150788052954,50
4887,4,17998,3658,14340,0,0,0,1.0,1,1.0,1,1.0,1,0.1822300806614713,49
4888,4,18002,3658,14344,0,0,0,1.0,1,1.0,1,1.0,1,0.22506389053171968,48
4889,4,18006,3658,14348,0,0,0,1.0,1,1.0,1,1.0,1,0.1971590729891774,48
4890,3,18009,3658,14351,0,0,0,1.0,1,1.0,1,1.0,1,0.2606275532207429,48
4891,9,18018,3659,14359,0,0,0,1.0,1,1.0,1,1.0,1,0.1518438778787306,49
4892,2,18020,3659,14361,0,0,0,1.0,1,1.0,1,1.0,1,0.12280869208831227,51
4893,1,18021,3659,14362,0,0,0,1.0,1,1.0,1,1.0,1,0.10472845387250149,51
4894,0,18021,3659,14362,0,0,0,1.0,1,1.0,1,1.0,1,0.10814003918766948,52
4895,3,18024,3659,14365,0,0,0,1.0,1,1.0,1,1.0,1,0.09989303602336268,52
4896,2,18026,3659,14367,0,0,0,1.0,1,1.0,1,1.0,1,0.1013914916232045,51
4897,2,18028,3659,14369,0,0,0,1.0,1,1.0,1,1.0,1,0.12027023242630067,52
4898,3,18031,3659,14372,0,0,0,1.0,1,1.0,1,1.0,1,0.11117636700719569,52
4899,4,18035,3659,14376,0,0,0,1.0,1,1.0,1,1.0,1,0.11513615941448553,53
4900,4,18039,3659,14380,0,0,0,1.0,1,1.0,1,1.0,1,0.12507027058375642,54
4901,9,18048,3662,14386,0,0,0,1.0,1,1.0,1,1.0,1,0.1371364600451447,54
4902,5,18053,3663,14390,0,0,0,1.0,1,1.0,1,1.0,1,0.14242191304400934,55
4903,9,18062,3664,14398,0,0,0,1.0,1,1.0,1,1.0,1,0.16153569527591422,56
4904,5,18067,3665,14402,0,0,0,1.0,1,1.0,1,1.0,1,0.14727532627911039,55
4905,4,18071,3666,14405,0,0,0,1.0,1,1.0,1,1.0,1,0.12379783327135332,54
4906,5,18076,3666,14410,0,0,0,1.0,1,1.0,1,1.0,1,0.1229390835196411,54
4907,2,18078,3666,14412,0,0,0,1.0,1,1.0,1,1.0,1,0.12290686140341806,54
4908,2,18080,3666,14414,0,0,0,1.0,1,1.0,1,1.0,1,0.12224692434092742,53
4909,6,18086,3668,14418,0,0,0,1.0,1,1.0,1,1.0,1,0.15234876354832966,54
4910,5,18091,3668,14423,0,0,0,1.0,1,1.0,1,1.0,1,0.16504209271790768,55
4911,9,18100,3669,14431,0,0,0,1.0,1,1.0,1,1.0,1,0.16553845031484812,57
4912,9,18109,3672,14437,0,0,0,1.0,1,1.0,1,1.0,1,0.18222976060264387,57
4913,6,18115,3672,14443,0,0,0,1.0,1,1.0,1,1.0,1,0.13705754772269224,56
4914,6,18121,3674,14447,0,0,0,1.0,1,1.0,1,1.0,1,0.14107953169282464,56
4915,6,18127,3675,14452,0,0,0,1.0,1,1.0,1,1.0,1,0.11890205458335029,56
4916,1,18128,3675,14453,0,0,0,1.0,1,1.0,1,1.0,1,0.12492272307920983,54
4917,3,18131,3675,14456,0,0,0,1.0,1,1.0,1,1.0,1,0.1574142936590562,53
4918,5,18136,3676,14460,0,0,0,1.0,1,1.0,1,1.0,1,0.18014354659157045,52
4919,3,18139,3676,14463,0,0,0,1.0,1,1.0,1,1.0,1,0.1838067518462293,49
4920,5,18144,3676,14468,0,0,0,1.0,1,1.0,1,1.0,1,0.1876046085081976,49
4921,8,18152,3677,14475,0,0,0,1.0,1,1.0,1,1.0,1,0.1446758879348278,50
4922,2,18154,3677,14477,0,0,0,1.0,1,1.0,1,1.0,1,0.12716789974840945,50
4923,6,18160,3678,14482,0,0,0,1.0,1,1.0,1,1.0,1,0.12452538790596313,52
4924,4,18164,3678,14486,0,0,0,1.0,1,1.0,1,1.0,1,0.12452292256863563,53
4925,1,18165,3678,14487,0,0,0,1.0,1,1.0,1,1.0,1,0.10607987889335548,54
4926,2,18167,3678,14489,0,0,0,1.0,1,1.0,1,1.0,1,0.10607987889335548,54
4927,3,18170,3680,14490,0,0,0,1.0,1,1.0,1,1.0,1,0.10805847123150282,54
4928,2,18172,3680,14492,0,0,0,1.0,1,1.0,1,1.0,1,0.10805847123150282,54
4929,1,18173,3680,14493,0,0,0,1.0,1,1.0,1,1.0,1,0.10194014186342194,55
4930,7,18180,3681,14499,0,0,0,1.0,1,1.0,1,1.0,1,0.14148588973510445,58
4931,5,18185,3681,14504,0,0,0,1.0,1,1.0,1,1.0,1,0.13917733535782892,58
4932,5,18190,3682,14508,0,0,0,1.0,1,1.0,1,1.0,1,0.14780449322898795,59
4933,6,18196,3683,14513,0,0,0,1.0,1,1.0,1,1.0,1,0.17865609170972543,59
4934,6,18202,3684,14518,0,0,0,1.0,1,1.0,1,1.0,1,0.1842188197924566,59
4935,10,18212,3684,14528,0,0,0,1.0,1,1.0,1,1.0,1,0.1370404634336923,59
4936,5,18217,3685,14532,0,0,0,1.0,1,1.0,1,1.0,1,0.14010186498588298,59
4937,1,18218,3685,14533,0,0,0,1.0,1,1.0,1,1.0,1,0.14368757298791773,61
4938,2,18220,3685,14535,0,0,0,1.0,1,1.0,1,1.0,1,0.14854384887687824,62
4939,2,18222,3686,14536,0,0,0,1.0,1,1.0,1,1.0,1,0.1430881960204092,63
4940,5,18227,3686,14541,0,0,0,1.0,1,1.0,1,1.0,1,0.16664574194370255,65
4941,4,18231,3687,14544,0,0,0,1.0,1,1.0,1,1.0,1,0.17554331462805528,65
4942,10,18241,3690,14551,0,0,0,1.0,1,1.0,1,1.0,1,0.2078448608288938,67
4943,14,18255,3691,14564,0,0,0,1.0,1,1.0,1,1.0,1,0.18234931488674047,66
4944,8,18263,3693,14570,0,0,0,1.0,1,1.0,1,1.0,1,0.19634639829288844,63
4945,7,18270,3693,14577,0,0,0,1.0,1,1.0,1,1.0,1,0.2235595425254197,61
4946,8,18278,3695,14583,0,0,0,1.0,1,1.0,1,1.0,1,0.1829411449926133,60
4947,3,18281,3695,14586,0,0,0,1.0,1,1.0,1,1.0,1,0.16405522152038438,58
4948,2,18283,3696,14587,0,0,0,1.0,1,1.0,1,1.0,1,0.1932852263199769,57
4949,4,18287,3697,14590,0,0,0,1.0,1,1.0,1,1.0,1,0.17957211535018555,56
4950,7,18294,3698,14596,0,0,0,1.0,1,1.0,1,1.0,1,0.19075496839243616,57
4951,10,18304,3699,14605,0,0,0,1.0,1,1.0,1,1.0,1,0.09967888393131137,55
4952,3,18307,3701,14606,0,0,0,1.0,1,1.0,1,1.0,1,0.14294315151633852,55
4953,1,18308,3701,14607,0,0,0,1.0,1,1.0,1,1.0,1,0.12911808805332575,54
4954,2,18310,3701,14609,0,0,0,1.0,1,1.0,1,1.0,1,0.1341294021313604,54
4955,3,18313,3701,14612,0,0,0,1.0,1,1.0,1,1.0,1,0.13032605822741455,52
4956,1,18314,3701,14613,0,0,0,1.0,1,1.0,1,1.0,1,0.13413614885297753,52
4957,4,18318,3702,14616,0,0,0,1.0,1,1.0,1,1.0,1,0.11554010559406233,53
4958,2,18320,3703,14617,0,0,0,1.0,1,1.0,1,1.0,1,0.11334488488704278,52
4959,1,18321,3704,14617,0,0,0,1.0,1,1.0,1,1.0,1,0.14623737858849858,51
4960,4,18325,3704,14621,0,0,0,1.0,1,1.0,1,1.0,1,0.14361184530599186,53
4961,4,18329,3704,14625,0,0,0,1.0,1,1.0,1,1.0,1,0.14361184530599186,53
4962,4,18333,3704,14629,0,0,0,1.0,1,1.0,1,1.0,1,0.15834288482507777,55
4963,3,18336,3705,14631,0,0,0,1.0,1,1.0,1,1.0,1,0.14627460226612687,54
4964,3,18339,3706,14633,0,0,0,1.0,1,1.0,1,1.0,1,0.14056846007826662,54
4965,4,18343,3708,14635,0,0,0,1.0,1,1.0,1,1.0,1,0.20345442045642514,54
4966,11,18354,3710,14644,0,0,0,1.0,1,1.0,1,1.0,1,0.13297551583750528,54
4967,7,18361,3713,14648,0,0,0,1.0,1,1.0,1,1.0,1,0.12573453063124604,55
4968,0,18361,3713,14648,0,0,0,1.0,1,1.0,1,1.0,1,0.12573453063124604,55
4969,3,18364,3713,14651,0,0,0,1.0,1,1.0,1,1.0,1,0.12395759016172031,57
4970,1,18365,3713,14652,0,0,0,1.0,1,1.0,1,1.0,1,0.12960712560705612,56
4971,3,18368,3713,14655,0,0,0,1.0,1,1.0,1,1.0,1,0.13884615049468,57
4972,2,18370,3713,14657,0,0,0,1.0,1,1.0,1,1.0,1,0.14565288999803946,57
4973,5,18375,3714,14661,0,0,0,1.0,1,1.0,1,1.0,1,0.1724200212850124,60
4974,3,18378,3714,14664,0,0,0,1.0,1,1.0,1,1.0,1,0.15921090494351556,58
4975,10,18388,3715,14673,0,0,0,1.0,1,1.0,1,1.0,1,0.17284076191315742,59
4976,6,18394,3715,14679,0,0,0,1.0,1,1.0,1,1.0,1,0.10908144199885834,59
4977,5,18399,3716,14683,0,0,0,1.0,1,1.0,1,1.0,1,0.11813426873479223,59
4978,5,18404,3716,14688,0,0,0,1.0,1,1.0,1,1.0,1,0.1237802752645802,59
4979,3,18407,3716,14691,0,0,0,1.0,1,1.0,1,1.0,1,0.11129172597313812,61
4980,9,18416,3718,14698,0,0,0,1.0,1,1.0,1,1.0,1,0.08584095423874774,62
4981,3,18419,3719,14700,0,0,0,1.0,1,1.0,1,1.0,1,0.0708832668261514,62
4982,6,18425,3722,14703,0,0,0,1.0,1,1.0,1,1.0,1,0.060103800343129454,63
4983,1,18426,3723,14703,0,0,0,1.0,1,1.0,1,1.0,1,0.08374489802480747,63
4984,1,18427,3724,14703,0,0,0,1.0,1,1.0,1,1.0,1,0.10293906863841894,61
4985,0,18427,3724,14703,0,0,0,1.0,1,1.0,1,1.0,1,0.08178712364348108,59
4986,2,18429,3725,14704,0,0,0,1.0,1,1.0,1,1.0,1,0.09296803232712642,62
4987,1,18430,3726,14704,0,0,0,1.0,1,1.0,1,1.0,1,0.09493287936766795,60
4988,6,18436,3728,14708,0,0,0,1.0,1,1.0,1,1.0,1,0.07353856171241976,59
4989,4,18440,3730,14710,0,0,0,1.0,1,1.0,1,1.0,1,0.07882556094126607,57
4990,1,18441,3730,14711,0,0,0,1.0,1,1.0,1,1.0,1,0.09859288584270168,55
4991,4,18445,3733,14712,0,0,0,1.0,1,1.0,1,1.0,1,0.09412837477365467,54
4992,2,18447,3735,14712,0,0,0,1.0,1,1.0,1,1.0,1,0.14891206370265425,52
4993,2,18449,3736,14713,0,0,0,1.0,1,1.0,1,1.0,1,0.14680631577174227,51
4994,2,18451,3738,14713,0,0,0,1.0,1,1.0,1,1.0,1,0.14597199967118,49
4995,1,18452,3739,14713,0,0,0,1.0,1,1.0,1,1.0,1,0.18678602990427046,48
4996,9,18461,3743,14718,0,0,0,1.0,1,1.0,1,1.0,1,0.10776597817774547,48
4997,1,18462,3743,14719,0,0,0,1.0,1,1.0,1,1.0,1,0.06113184865091343,46
4998,3,18465,3743,14722,0,0,0,1.0,1,1.0,1,1.0,1,0.06039541642263783,48
4999,8,18473,3746,14727,0,0,0,1.0,1,1.0,1,1.0,1,0.12340523293363882,48
5000,2,18475,3747,14728,0,0,0,1.0,1,1.0,1,1.0,1,0.13540691317123627,47
5001,1,18476,3747,14729,0,0,0,1.0,1,1.0,1,1.0,1,0.15184228284983872,45
5002,6,18482,3749,14733,0,0,0,1.0,1,1.0,1,1.0,1,0.16980613720034202,46
5003,5,18487,3749,14738,0,0,0,1.0,1,1.0,1,1.0,1,0.2219498240778688,46
5004,6,18493,3750,14743,0,0,0,1.0,1,1.0,1,1.0,1,0.21756493495978463,46
5005,5,18498,3750,14748,0,0,0,1.0,1,1.0,1,1.0,1,0.24494546294248914,45
5006,4,18502,3750,14752,0,0,0,1.0,1,1.0,1,1.0,1,0.23298459745692537,45
5007,6,18508,3750,14758,0,0,0,1.0,1,1.0,1,1.0,1,0.29687825782770105,46
5008,6,18514,3750,14764,0,0,0,1.0,1,1.0,1,1.0,1,0.20354688985957606,49
5009,8,18522,3750,14772,0,0,0,1.0,1,1.0,1,1.0,1,0.24868014175685216,49
5010,5,18527,3750,14777,0,0,0,1.0,1,1.0,1,1.0,1,0.27936897245776365,50
5011,6,18533,3751,14782,0,0,0,1.0,1,1.0,1,1.0,1,0.1897721414481757,51
5012,2,18535,3751,14784,0,0,0,1.0,1,1.0,1,1.0,1,0.17166977393127494,52
5013,0,18535,3751,14784,0,0,0,1.0,1,1.0,1,1.0,1,0.17166977393127494,52
5014,0,18535,3751,14784,0,0,0,1.0,1,1.0,1,1.0,1,0.1788440774071218,53
5015,2,18537,3751,14786,0,0,0,1.0,1,1.0,1,1.0,1,0.15398642099778356,54
5016,4,18541,3752,14789,0,0,0,1.0,1,1.0,1,1.0,1,0.1464693497538536,55
5017,3,18544,3752,14792,0,0,0,1.0,1,1.0,1,1.0,1,0.14935265117833138,55
5018,5,18549,3752,14797,0,0,0,1.0,1,1.0,1,1.0,1,0.15152376477421045,56
5019,5,18554,3752,14802,0,0,0,1.0,1,1.0,1,1.0,1,0.14538401897132897,56
5020,5,18559,3752,14807,0,0,0,1.0,1,1.0,1,1.0,1,0.14428154728374964,55
5021,2,18561,3752,14809,0,0,0,1.0,1,1.0,1,1.0,1,0.1499517540590461,56
5022,3,18564,3754,14810,0,0,0,1.0,1,1.0,1,1.0,1,0.15164167078234594,56
5023,2,18566,3754,14812,0,0,0,1.0,1,1.0,1,1.0,1,0.11522522824954304,55
5024,2,18568,3756,14812,0,0,0,1.0,1,1.0,1,1.0,1,0.12133468650766861,55
5025,2,18570,3758,14812,0,0,0,1.0,1,1.0,1,1.0,1,0.13896793527978663,53
5026,6,18576,3761,14815,0,0,0,1.0,1,1.0,1,1.0,1,0.11707662286769692,52
5027,3,18579,3763,14816,0,0,0,1.0,1,1.0,1,1.0,1,0.15712827923655132,51
5028,10,18589,3767,14822,0,0,0,1.0,1,1.0,1,1.0,1,0.22378477991119322,51
5029,5,18594,3769,14825,0,0,0,1.0,1,1.0,1,1.0,1,0.29188287245719463,50
5030,4,18598,3770,14828,0,0,0,1.0,1,1.0,1,1.0,1,0.23190263222590143,49
5031,7,18605,3770,14835,0,0,0,1.0,1,1.0,1,1.0,1,0.20033882830954355,49
5032,4,18609,3770,14839,0,0,0,1.0,1,1.0,1,1.0,1,0.20656666979526084,48
5033,5,18614,3772,14842,0,0,0,1.0,1,1.0,1,1.0,1,0.24340455628247626,50
5034,7,18621,3772,14849,0,0,0,1.0,1,1.0,1,1.0,1,0.2278600120156774,49
5035,5,18626,3773,14853,0,0,0,1.0,1,1.0,1,1.0,1,0.22580317496661312,49
5036,7,18633,3774,14859,0,0,0,1.0,1,1.0,1,1.0,1,0.22383417984182472,47
5037,5,18638,3775,14863,0,0,0,1.0,1,1.0,1,1.0,1,0.23217486780383903,47
5038,8,18646,3775,14871,0,0,0,1.0,1,1.0,1,1.0,1,0.24333385675156383,47
5039,7,18653,3775,14878,0,0,0,1.0,1,1.0,1,1.0,1,0.2111526898797378,48
5040,3,18656,3775,14881,0,0,0,1.0,1,1.0,1,1.0,1,0.2045292451506415,48
5041,6,18662,3775,14887,0,0,0,1.0,1,1.0,1,1.0,1,0.09345111400980124,48
5042,1,18663,3775,14888,0,0,0,1.0,1,1.0,1,1.0,1,0.07910076569288346,50
5043,2,18665,3775,14890,0,0,0,1.0,1,1.0,1,1.0,1,0.08008388364948811,51
5044,2,18667,3775,14892,0,0,0,1.0,1,1.0,1,1.0,1,0.08008388364948811,51
5045,2,18669,3775,14894,0,0,0,1.0,1,1.0,1,1.0,1,0.09035974735126223,52
5046,1,18670,3775,14895,0,0,0,1.0,1,1.0,1,1.0,1,0.08708977755908037,51
5047,1,18671,3775,14896,0,0,0,1.0,1,1.0,1,1.0,1,0.0824158703559415,51
5048,3,18674,3775,14899,0,0,0,1.0,1,1.0,1,1.0,1,0.06790723206117923,52
5049,0,18674,3775,14899,0,0,0,1.0,1,1.0,1,1.0,1,0.0740759105692577,54
5050,2,18676,3775,14901,0,0,0,1.0,1,1.0,1,1.0,1,0.08678622090984447,56
5051,1,18677,3775,14902,0,0,0,1.0,1,1.0,1,1.0,1,0.08944916879957494,55
5052,0,18677,3775,14902,0,0,0,1.0,1,1.0,1,1.0,1,0.08944916879957494,55
5053,0,18677,3775,14902,0,0,0,1.0,1,1.0,1,1.0,1,0.08944916879957494,55
5054,0,18677,3775,14902,0,0,0,1.0,1,1.0,1,1.0,1,0.08944916879957494,55
5055,2,18679,3775,14904,0,0,0,1.0,1,1.0,1,1.0,1,0.0907656674799551,55
5056,3,18682,3776,14906,0,0,0,1.0,1,1.0,1,1.0,1,0.09690396348639158,56
5057,1,18683,3776,14907,0,0,0,1.0,1,1.0,1,1.0,1,0.09435909071572585,58
5058,0,18683,3776,14907,0,0,0,1.0,1,1.0,1,1.0,1,0.10594093268975865,59
5059,0,18683,3776,14907,0,0,0,1.0,1,1.0,1,1.0,1,0.10594093268975865,59
5060,1,18684,3776,14908,0,0,0,1.0,1,1.0,1,1.0,1,0.07894348805476295,59
5061,2,18686,3777,14909,0,0,0,1.0,1,1.0,1,1.0,1,0.08620287574265684,59
5062,1,18687,3778,14909,0,0,0,1.0,1,1.0,1,1.0,1,0.11105328319404348,59
5063,2,18689,3779,14910,0,0,0,1.0,1,1.0,1,1.0,1,0.13854590708611259,59
5064,7,18696,3783,14913,0,0,0,1.0,1,1.0,1,1.0,1,0.1774108936870491,57
5065,3,18699,3785,14914,0,0,0,1.0,1,1.0,1,1.0,1,0.18426429666035501,55
5066,1,18700,3786,14914,0,0,0,1.0,1,1.0,1,1.0,1,0.19800156841307498,55
5067,3,18703,3787,14916,0,0,0,1.0,1,1.0,1,1.0,1,0.1962369869125701,54
5068,2,18705,3787,14918,0,0,0,1.0,1,1.0,1,1.0,1,0.1871611121810088,54
5069,1,18706,3788,14918,0,0,0,1.0,1,1.0,1,1.0,1,0.19054656095305586,54
5070,0,18706,3788,14918,0,0,0,1.0,1,1.0,1,1.0,1,0.19260415177925624,52
5071,7,18713,3790,14923,0,0,0,1.0,1,1.0,1,1.0,1,0.15487478778800207,54
5072,1,18714,3790,14924,0,0,0,1.0,1,1.0,1,1.0,1,0.1249725170243348,52
5073,2,18716,3790,14926,0,0,0,1.0,1,1.0,1,1.0,1,0.13281274361300682,51
5074,6,18722,3791,14931,0,0,0,1.0,1,1.0,1,1.0,1,0.13163497602066318,52
5075,4,18726,3791,14935,0,0,0,1.0,1,1.0,1,1.0,1,0.127740089279859,53
5076,4,18730,3791,14939,0,0,0,1.0,1,1.0,1,1.0,1,0.127740089279859,53
5077,5,18735,3792,14943,0,0,0,1.0,1,1.0,1,1.0,1,0.1507593385925548,56
5078,7,18742,3792,14950,0,0,0,1.0,1,1.0,1,1.0,1,0.11871707501410061,55
5079,1,18743,3792,14951,0,0,0,1.0,1,1.0,1,1.0,1,0.12063979285228324,56
5080,3,18746,3792,14954,0,0,0,1.0,1,1.0,1,1.0,1,0.12671884521209806,57
5081,5,18751,3792,14959,0,0,0,1.0,1,1.0,1,1.0,1,0.12297183782107209,58
5082,4,18755,3792,14963,0,0,0,1.0,1,1.0,1,1.0,1,0.12439137581946616,58
5083,5,18760,3792,14968,0,0,0,1.0,1,1.0,1,1.0,1,0.12877293989976532,59
5084,8,18768,3793,14975,0,0,0,1.0,1,1.0,1,1.0,1,0.14962279649156354,59
5085,11,18779,3795,14984,0,0,0,1.0,1,1.0,1,1.0,1,0.1756706020745334,60
5086,6,18785,3795,14990,0,0,0,1.0,1,1.0,1,1.0,1,0.07837023314536594,61
5087,2,18787,3795,14992,0,0,0,1.0,1,1.0,1,1.0,1,0.05228034336272856,62
5088,3,18790,3795,14995,0,0,0,1.0,1,1.0,1,1.0,1,0.04771122510671213,64
5089,1,18791,3795,14996,0,0,0,1.0,1,1.0,1,1.0,1,0.05279458908071044,64
5090,0,18791,3795,14996,0,0,0,1.0,1,1.0,1,1.0,1,0.05279458908071044,64
5091,7,18798,3799,14999,0,0,0,1.0,1,1.0,1,1.0,1,0.1190118464584722,64
5092,4,18802,3801,15001,0,0,0,1.0,1,1.0,1,1.0,1,0.1300105447932634,64
5093,2,18804,3801,15003,0,0,0,1.0,1,1.0,1,1.0,1,0.13109259233805012,64
5094,3,18807,3803,15004,0,0,0,1.0,1,1.0,1,1.0,1,0.1371993113477179,65
5095,5,18812,3805,15007,0,0,0,1.0,1,1.0,1,1.0,1,0.14520284516352316,66
5096,10,18822,3806,15016,0,0,0,1.0,1,1.0,1,1.0,1,0.14467396833735416,66
5097,8,18830,3807,15023,0,0,0,1.0,1,1.0,1,1.0,1,0.13781362338237502,67
5098,6,18836,3807,15029,0,0,0,1.0,1,1.0,1,1.0,1,0.1336951850013141,67
5099,9,18845,3808,15037,0,0,0,1.0,1,1.0,1,1.0,1,0.1299205280537207,70
5100,5,18850,3809,15041,0,0,0,1.0,1,1.0,1,1.0,1,0.11668040993072,71
5101,6,18856,3809,15047,0,0,0,1.0,1,1.0,1,1.0,1,0.0849128543969697,72
5102,3,18859,3811,15048,0,0,0,1.0,1,1.0,1,1.0,1,0.08711201760631798,72
5103,2,18861,3813,15048,0,0,0,1.0,1,1.0,1,1.0,1,0.10940116273767159,70
5104,2,18863,3815,15048,0,0,0,1.0,1,1.0,1,1.0,1,0.10948990881680828,67
5105,5,18868,3816,15052,0,0,0,1.0,1,1.0,1,1.0,1,0.10590759129960986,66
5106,4,18872,3819,15053,0,0,0,1.0,1,1.0,1,1.0,1,0.14186589657752288,64
5107,3,18875,3821,15054,0,0,0,1.0,1,1.0,1,1.0,1,0.1465473111861249,61
5108,1,18876,3822,15054,0,0,0,1.0,1,1.0,1,1.0,1,0.14794158793986584,57
5109,3,18879,3824,15055,0,0,0,1.0,1,1.0,1,1.0,1,0.18729160022073604,55
5110,3,18882,3825,15057,0,0,0,1.0,1,1.0,1,1.0,1,0.1507981964067531,53
5111,2,18884,3827,15057,0,0,0,1.0,1,1.0,1,1.0,1,0.2074705065458808,52
5112,3,18887,3830,15057,0,0,0,1.0,1,1.0,1,1.0,1,0.1688375095156311,52
5113,3,18890,3832,15058,0,0,0,1.0,1,1.0,1,1.0,1,0.19400191427165675,49
5114,4,18894,3836,15058,0,0,0,1.0,1,1.0,1,1.0,1,0.2298869022182994,49
5115,1,18895,3836,15059,0,0,0,1.0,1,1.0,1,1.0,1,0.2218503675203118,48
5116,11,18906,3838,15068,0,0,0,1.0,1,1.0,1,1.0,1,0.1601109658286411,47
5117,5,18911,3838,15073,0,0,0,1.0,1,1.0,1,1.0,1,0.15691215473450024,48
5118,6,18917,3839,15078,0,0,0,1.0,1,1.0,1,1.0,1,0.1880696235799552,49
5119,4,18921,3839,15082,0,0,0,1.0,1,1.0,1,1.0,1,0.17519911973769922,49
5120,3,18924,3840,15084,0,0,0,1.0,1,1.0,1,1.0,1,0.20122610292428503,48
5121,6,18930,3841,15089,0,0,0,1.0,1,1.0,1,1.0,1,0.1827926633070931,48
5122,4,18934,3842,15092,0,0,0,1.0,1,1.0,1,1.0,1,0.24499372664842575,46
5123,5,18939,3842,15097,0,0,0,1.0,1,1.0,1,1.0,1,0.2169426865714646,46
5124,3,18942,3842,15100,0,0,0,1.0,1,1.0,1,1.0,1,0.23007260229493035,47
5125,6,18948,3842,15106,0,0,0,1.0,1,1.0,1,1.0,1,0.21825600909565726,49
5126,6,18954,3842,15112,0,0,0,1.0,1,1.0,1,1.0,1,0.20146094472823642,49
5127,9,18963,3843,15120,0,0,0,1.0,1,1.0,1,1.0,1,0.1845429828930928,51
5128,7,18970,3844,15126,0,0,0,1.0,1,1.0,1,1.0,1,0.20747787860908137,53
5129,8,18978,3844,15134,0,0,0,1.0,1,1.0,1,1.0,1,0.20047987285350224,55
5130,8,18986,3845,15141,0,0,0,1.0,1,1.0,1,1.0,1,0.1871257961277044,55
5131,5,18991,3845,15146,0,0,0,1.0,1,1.0,1,1.0,1,0.14935482261215094,55
5132,3,18994,3845,15149,0,0,0,1.0,1,1.0,1,1.0,1,0.13922106815952634,55
5133,0,18994,3845,15149,0,0,0,1.0,1,1.0,1,1.0,1,0.1356596250861241,56
5134,0,18994,3845,15149,0,0,0,1.0,1,1.0,1,1.0,1,0.16461485769446463,56
5135,3,18997,3847,15150,0,0,0,1.0,1,1.0,1,1.0,1,0.1705007315181298,56
5136,2,18999,3847,15152,0,0,0,1.0,1,1.0,1,1.0,1,0.1509791091697341,55
5137,3,19002,3847,15155,0,0,0,1.0,1,1.0,1,1.0,1,0.1423047570817304,55
5138,2,19004,3847,15157,0,0,0,1.0,1,1.0,1,1.0,1,0.1370665932328619,54
5139,3,19007,3847,15160,0,0,0,1.0,1,1.0,1,1.0,1,0.13469161857434722,54
5140,4,19011,3847,15164,0,0,0,1.0,1,1.0,1,1.0,1,0.13632576288609305,54
5141,2,19013,3848,15165,0,0,0,1.0,1,1.0,1,1.0,1,0.1113334187432797,53
5142,7,19020,3851,15169,0,0,0,1.0,1,1.0,1,1.0,1,0.13814263233446367,55
5143,5,19025,3853,15172,0,0,0,1.0,1,1.0,1,1.0,1,0.1055482028499594,54
5144,5,19030,3856,15174,0,0,0,1.0,1,1.0,1,1.0,1,0.15037520528350423,50
5145,0,19030,3856,15174,0,0,0,1.0,1,1.0,1,1.0,1,0.16071496608151672,51
5146,6,19036,3858,15178,0,0,0,1.0,1,1.0,1,1.0,1,0.11648237142631841,48
5147,6,19042,3860,15182,0,0,0,1.0,1,1.0,1,1.0,1,0.10368801974143989,49
5148,4,19046,3861,15185,0,0,0,1.0,1,1.0,1,1.0,1,0.05839328082639802,47
5149,1,19047,3861,15186,0,0,0,1.0,1,1.0,1,1.0,1,0.11186083025435915,46
5150,4,19051,3864,15187,0,0,0,1.0,1,1.0,1,1.0,1,0.10373739217027084,46
5151,3,19054,3865,15189,0,0,0,1.0,1,1.0,1,1.0,1,0.1594235644398096,45
5152,5,19059,3867,15192,0,0,0,1.0,1,1.0,1,1.0,1,0.17200351083737359,45
5153,7,19066,3869,15197,0,0,0,1.0,1,1.0,1,1.0,1,0.22041367210287785,45
5154,5,19071,3871,15200,0,0,0,1.0,1,1.0,1,1.0,1,0.24171922061055084,45
5155,3,19074,3871,15203,0,0,0,1.0,1,1.0,1,1.0,1,0.23782940020750684,44
5156,3,19077,3873,15204,0,0,0,1.0,1,1.0,1,1.0,1,0.2563070501550682,44
5157,0,19077,3873,15204,0,0,0,1.0,1,1.0,1,1.0,1,0.2620785091371761,42
5158,1,19078,3873,15205,0,0,0,1.0,1,1.0,1,1.0,1,0.22290998317407074,43
5159,0,19078,3873,15205,0,0,0,1.0,1,1.0,1,1.0,1,0.26001390792430384,43
5160,1,19079,3873,15206,0,0,0,1.0,1,1.0,1,1.0,1,0.24318123538282685,43
5161,5,19084,3873,15211,0,0,0,1.0,1,1.0,1,1.0,1,0.16536918741824472,43
5162,0,19084,3873,15211,0,0,0,1.0,1,1.0,1,1.0,1,0.15329248606869167,44
5163,3,19087,3873,15214,0,0,0,1.0,1,1.0,1,1.0,1,0.12387060567210818,46
5164,2,19089,3874,15215,0,0,0,1.0,1,1.0,1,1.0,1,0.10737769189958446,46
5165,2,19091,3875,15216,0,0,0,1.0,1,1.0,1,1.0,1,0.12630905762191064,46
5166,4,19095,3876,15219,0,0,0,1.0,1,1.0,1,1.0,1,0.13015879786077839,47
5167,3,19098,3877,15221,0,0,0,1.0,1,1.0,1,1.0,1,0.12254531553809138,47
5168,3,19101,3877,15224,0,0,0,1.0,1,1.0,1,1.0,1,0.13149058332334454,47
5169,0,19101,3877,15224,0,0,0,1.0,1,1.0,1,1.0,1,0.13149058332334454,47
5170,2,19103,3878,15225,0,0,0,1.0,1,1.0,1,1.0,1,0.1390223723940717,48
5171,4,19107,3879,15228,0,0,0,1.0,1,1.0,1,1.0,1,0.14671823276559995,48
5172,1,19108,3879,15229,0,0,0,1.0,1,1.0,1,1.0,1,0.13595096288271735,49
5173,2,19110,3879,15231,0,0,0,1.0,1,1.0,1,1.0,1,0.1387382401973166,49
5174,2,19112,3880,15232,0,0,0,1.0,1,1.0,1,1.0,1,0.1699555713021084,52
5175,7,19119,3880,15239,0,0,0,1.0,1,1.0,1,1.0,1,0.14200325201397562,53
5176,4,19123,3880,15243,0,0,0,1.0,1,1.0,1,1.0,1,0.07519945849622049,54
5177,4,19127,3883,15244,0,0,0,1.0,1,1.0,1,1.0,1,0.13051132148441186,54
5178,6,19133,3884,15249,0,0,0,1.0,1,1.0,1,1.0,1,0.12840680084902717,55
5179,3,19136,3885,15251,0,0,0,1.0,1,1.0,1,1.0,1,0.11955340838847632,53
5180,2,19138,3886,15252,0,0,0,1.0,1,1.0,1,1.0,1,0.1578899527845974,52
5181,2,19140,3886,15254,0,0,0,1.0,1,1.0,1,1.0,1,0.1268300380668282,52
5182,3,19143,3887,15256,0,0,0,1.0,1,1.0,1,1.0,1,0.10732331202902148,52
5183,9,19152,3889,15263,0,0,0,1.0,1,1.0,1,1.0,1,0.16016911626518032,52
5184,5,19157,3890,15267,0,0,0,1.0,1,1.0,1,1.0,1,0.16348398290930627,52
5185,6,19163,3892,15271,0,0,0,1.0,1,1.0,1,1.0,1,0.20977032490425698,50
5186,6,19169,3895,15274,0,0,0,1.0,1,1.0,1,1.0,1,0.2235514951230708,48
5187,4,19173,3896,15277,0,0,0,1.0,1,1.0,1,1.0,1,0.22695619589999128,46
5188,1,19174,3896,15278,0,0,0,1.0,1,1.0,1,1.0,1,0.2366645893826688,44
5189,2,19176,3896,15280,0,0,0,1.0,1,1.0,1,1.0,1,0.22720278751385264,44
5190,5,19181,3897,15284,0,0,0,1.0,1,1.0,1,1.0,1,0.23729357220518524,45
5191,4,19185,3897,15288,0,0,0,1.0,1,1.0,1,1.0,1,0.19460391246679296,45
5192,3,19188,3898,15290,0,0,0,1.0,1,1.0,1,1.0,1,0.1814077788089459,45
5193,2,19190,3898,15292,0,0,0,1.0,1,1.0,1,1.0,1,0.16925146321303045,45
5194,1,19191,3898,15293,0,0,0,1.0,1,1.0,1,1.0,1,0.1598635784471772,45
5195,3,19194,3898,15296,0,0,0,1.0,1,1.0,1,1.0,1,0.1531385002296883,46
5196,1,19195,3898,15297,0,0,0,1.0,1,1.0,1,1.0,1,0.14494837675927627,46
5197,1,19196,3899,15297,0,0,0,1.0,1,1.0,1,1.0,1,0.17109635481737073,46
5198,2,19198,3899,15299,0,0,0,1.0,1,1.0,1,1.0,1,0.1639889087118975,47
5199,5,19203,3900,15303,0,0,0,1.0,1,1.0,1,1.0,1,0.21450696139967151,49
5200,3,19206,3901,15305,0,0,0,1.0,1,1.0,1,1.0,1,0.20037421297168792,49
5201,4,19210,3903,15307,0,0,0,1.0,1,1.0,1,1.0,1,0.2209062929295239,50
5202,4,19214,3903,15311,0,0,0,1.0,1,1.0,1,1.0,1,0.20851659673959638,52
5203,4,19218,3903,15315,0,0,0,1.0,1,1.0,1,1.0,1,0.20851659673959638,52
5204,2,19220,3903,15317,0,0,0,1.0,1,1.0,1,1.0,1,0.18075144039721042,54
5205,4,19224,3903,15321,0,0,0,1.0,1,1.0,1,1.0,1,0.18075144039721042,54
5206,6,19230,3903,15327,0,0,0,1.0,1,1.0,1,1.0,1,0.1131604687620585,55
5207,1,19231,3903,15328,0,0,0,1.0,1,1.0,1,1.0,1,0.08459580724116454,54
5208,0,19231,3903,15328,0,0,0,1.0,1,1.0,1,1.0,1,0.08459580724116454,54
5209,2,19233,3903,15330,0,0,0,1.0,1,1.0,1,1.0,1,0.08232264866590573,54
5210,0,19233,3903,15330,0,0,0,1.0,1,1.0,1,1.0,1,0.08232264866590573,54
5211,1,19234,3903,15331,0,0,0,1.0,1,1.0,1,1.0,1,0.07908936544631337,56
5212,0,19234,3903,15331,0,0,0,1.0,1,1.0,1,1.0,1,0.06467677871246813,57
5213,3,19237,3906,15331,0,0,0,1.0,1,1.0,1,1.0,1,0.15115072355107906,57
5214,5,19242,3908,15334,0,0,0,1.0,1,1.0,1,1.0,1,0.2034238792816725,58
5215,5,19247,3908,15339,0,0,0,1.0,1,1.0,1,1.0,1,0.18411603771485868,57
5216,4,19251,3909,15342,0,0,0,1.0,1,1.0,1,1.0,1,0.16776641068488415,57
5217,4,19255,3910,15345,0,0,0,1.0,1,1.0,1,1.0,1,0.16150282752411202,56
5218,8,19263,3913,15350,0,0,0,1.0,1,1.0,1,1.0,1,0.190091871004429,56
5219,8,19271,3913,15358,0,0,0,1.0,1,1.0,1,1.0,1,0.16674892576885703,54
5220,10,19281,3914,15367,0,0,0,1.0,1,1.0,1,1.0,1,0.19443019256055757,53
5221,3,19284,3914,15370,0,0,0,1.0,1,1.0,1,1.0,1,0.12297766719550479,52
5222,2,19286,3915,15371,0,0,0,1.0,1,1.0,1,1.0,1,0.1296945104721443,52
5223,1,19287,3916,15371,0,0,0,1.0,1,1.0,1,1.0,1,0.1389133206229709,52
5224,1,19288,3917,15371,0,0,0,1.0,1,1.0,1,1.0,1,0.14738020667691806,52
5225,0,19288,3917,15371,0,0,0,1.0,1,1.0,1,1.0,1,0.16502769193350836,50
5226,0,19288,3917,15371,0,0,0,1.0,1,1.0,1,1.0,1,0.16715643806326536,51
5227,4,19292,3920,15372,0,0,0,1.0,1,1.0,1,1.0,1,0.19743581700942703,49
5228,0,19292,3920,15372,0,0,0,1.0,1,1.0,1,1.0,1,0.22221846072560353,48
5229,3,19295,3921,15374,0,0,0,1.0,1,1.0,1,1.0,1,0.18854035710728445,49
5230,1,19296,3921,15375,0,0,0,1.0,1,1.0,1,1.0,1,0.20738701762929335,49
5231,2,19298,3922,15376,0,0,0,1.0,1,1.0,1,1.0,1,0.17414548064569532,49
5232,3,19301,3924,15377,0,0,0,1.0,1,1.0,1,1.0,1,0.11522454661322706,51
5233,1,19302,3925,15377,0,0,0,1.0,1,1.0,1,1.0,1,0.15725950477931483,51
5234,7,19309,3928,15381,0,0,0,1.0,1,1.0,1,1.0,1,0.14100855260358897,52
5235,0,19309,3928,15381,0,0,0,1.0,1,1.0,1,1.0,1,0.14346490225006864,52
5236,3,19312,3928,15384,0,0,0,1.0,1,1.0,1,1.0,1,0.09154514459989535,52
5237,3,19315,3929,15386,0,0,0,1.0,1,1.0,1,1.0,1,0.09860760508833696,53
5238,1,19316,3929,15387,0,0,0,1.0,1,1.0,1,1.0,1,0.10465362674484308,53
5239,0,19316,3929,15387,0,0,0,1.0,1,1.0,1,1.0,1,0.10465362674484308,53
5240,5,19321,3931,15390,0,0,0,1.0,1,1.0,1,1.0,1,0.10669078400880495,55
5241,4,19325,3931,15394,0,0,0,1.0,1,1.0,1,1.0,1,0.10699992915143079,56
5242,7,19332,3931,15401,0,0,0,1.0,1,1.0,1,1.0,1,0.11907138850518866,54
5243,6,19338,3932,15406,0,0,0,1.0,1,1.0,1,1.0,1,0.11208955747209703,55
5244,7,19345,3935,15410,0,0,0,1.0,1,1.0,1,1.0,1,0.1925675323439206,55
5245,8,19353,3936,15417,0,0,0,1.0,1,1.0,1,1.0,1,0.21464533969388888,55
5246,13,19366,3938,15428,0,0,0,1.0,1,1.0,1,1.0,1,0.27434743971640296,55
5247,13,19379,3939,15440,0,0,0,1.0,1,1.0,1,1.0,1,0.289235948188442,54
5248,12,19391,3939,15452,0,0,0,1.0,1,1.0,1,1.0,1,0.2916719595671938,53
5249,11,19402,3939,15463,0,0,0,1.0,1,1.0,1,1.0,1,0.2843833367877154,55
5250,13,19415,3940,15475,0,0,0,1.0,1,1.0,1,1.0,1,0.25076530811045566,55
5251,9,19424,3941,15483,0,0,0,1.0,1,1.0,1,1.0,1,0.07944468557893421,57
5252,0,19424,3941,15483,0,0,0,1.0,1,1.0,1,1.0,1,0.08566807252128764,58
5253,5,19429,3942,15487,0,0,0,1.0,1,1.0,1,1.0,1,0.08353051512762152,59
5254,5,19434,3943,15491,0,0,0,1.0,1,1.0,1,1.0,1,0.09508284173486255,59
5255,5,19439,3943,15496,0,0,0,1.0,1,1.0,1,1.0,1,0.09960195230023021,58
5256,6,19445,3945,15500,0,0,0,1.0,1,1.0,1,1.0,1,0.10386228350819154,59
5257,7,19452,3946,15506,0,0,0,1.0,1,1.0,1,1.0,1,0.10646454559658779,58
5258,5,19457,3947,15510,0,0,0,1.0,1,1.0,1,1.0,1,0.16404126246141545,56
5259,3,19460,3947,15513,0,0,0,1.0,1,1.0,1,1.0,1,0.15778459943218553,56
5260,2,19462,3947,15515,0,0,0,1.0,1,1.0,1,1.0,1,0.15673376474421793,55
5261,2,19464,3947,15517,0,0,0,1.0,1,1.0,1,1.0,1,0.13927475967691155,54
5262,5,19469,3947,15522,0,0,0,1.0,1,1.0,1,1.0,1,0.11693772071489178,54
5263,6,19475,3949,15526,0,0,0,1.0,1,1.0,1,1.0,1,0.15637685556169165,53
5264,4,19479,3950,15529,0,0,0,1.0,1,1.0,1,1.0,1,0.17738691204733942,51
5265,1,19480,3950,15530,0,0,0,1.0,1,1.0,1,1.0,1,0.16737820394553768,50
5266,7,19487,3953,15534,0,0,0,1.0,1,1.0,1,1.0,1,0.08861373294970493,49
5267,3,19490,3953,15537,0,0,0,1.0,1,1.0,1,1.0,1,0.10532267809923959,48
5268,2,19492,3953,15539,0,0,0,1.0,1,1.0,1,1.0,1,0.11681292616976546,47
5269,1,19493,3953,15540,0,0,0,1.0,1,1.0,1,1.0,1,0.17099790955364474,45
5270,2,19495,3954,15541,0,0,0,1.0,1,1.0,1,1.0,1,0.13372710496289114,47
5271,2,19497,3954,15543,0,0,0,1.0,1,1.0,1,1.0,1,0.1946775303822717,45
5272,6,19503,3958,15545,0,0,0,1.0,1,1.0,1,1.0,1,0.12837349072952225,46
5273,3,19506,3958,15548,0,0,0,1.0,1,1.0,1,1.0,1,0.18390492636648548,44
5274,3,19509,3959,15550,0,0,0,1.0,1,1.0,1,1.0,1,0.19670174601909787,44
5275,2,19511,3960,15551,0,0,0,1.0,1,1.0,1,1.0,1,0.23585156164649507,46
5276,3,19514,3961,15553,0,0,0,1.0,1,1.0,1,1.0,1,0.21161551678855092,46
5277,1,19515,3962,15553,0,0,0,1.0,1,1.0,1,1.0,1,0.19941213130928284,46
5278,3,19518,3964,15554,0,0,0,1.0,1,1.0,1,1.0,1,0.23751981737623362,46
5279,7,19525,3965,15560,0,0,0,1.0,1,1.0,1,1.0,1,0.2142504747316413,47
5280,9,19534,3967,15567,0,0,0,1.0,1,1.0,1,1.0,1,0.2834511628695584,47
5281,9,19543,3967,15576,0,0,0,1.0,1,1.0,1,1.0,1,0.1382125309429105,48
5282,4,19547,3969,15578,0,0,0,1.0,1,1.0,1,1.0,1,0.15506180755963064,48
5283,4,19551,3970,15581,0,0,0,1.0,1,1.0,1,1.0,1,0.19938368827620817,49
5284,5,19556,3970,15586,0,0,0,1.0,1,1.0,1,1.0,1,0.19007720491361502,49
5285,2,19558,3970,15588,0,0,0,1.0,1,1.0,1,1.0,1,0.15127604343662024,50
5286,4,19562,3970,15592,0,0,0,1.0,1,1.0,1,1.0,1,0.16390595891827892,51
5287,4,19566,3970,15596,0,0,0,1.0,1,1.0,1,1.0,1,0.16390595891827892,51
5288,3,19569,3970,15599,0,0,0,1.0,1,1.0,1,1.0,1,0.14848020766562298,51
5289,4,19573,3970,15603,0,0,0,1.0,1,1.0,1,1.0,1,0.1520791025916786,53
5290,7,19580,3970,15610,0,0,0,1.0,1,1.0,1,1.0,1,0.13695159791734296,53
5291,2,19582,3971,15611,0,0,0,1.0,1,1.0,1,1.0,1,0.1523052305400876,53
5292,4,19586,3971,15615,0,0,0,1.0,1,1.0,1,1.0,1,0.18623546172503597,53
5293,4,19590,3972,15618,0,0,0,1.0,1,1.0,1,1.0,1,0.20996878258560728,53
5294,6,19596,3973,15623,0,0,0,1.0,1,1.0,1,1.0,1,0.15526288393859458,54
5295,5,19601,3974,15627,0,0,0,1.0,1,1.0,1,1.0,1,0.2073603985075756,52
5296,5,19606,3974,15632,0,0,0,1.0,1,1.0,1,1.0,1,0.12364216870203255,49
5297,2,19608,3974,15634,0,0,0,1.0,1,1.0,1,1.0,1,0.10923230562499033,49
5298,0,19608,3974,15634,0,0,0,1.0,1,1.0,1,1.0,1,0.10808205114620668,49
5299,3,19611,3976,15635,0,0,0,1.0,1,1.0,1,1.0,1,0.12321276651994255,50
5300,1,19612,3976,15636,0,0,0,1.0,1,1.0,1,1.0,1,0.12282451270915724,48
5301,2,19614,3977,15637,0,0,0,1.0,1,1.0,1,1.0,1,0.1554355915677742,46
5302,1,19615,3977,15638,0,0,0,1.0,1,1.0,1,1.0,1,0.15068107393864194,47
5303,2,19617,3978,15639,0,0,0,1.0,1,1.0,1,1.0,1,0.13213757474299906,46
5304,2,19619,3980,15639,0,0,0,1.0,1,1.0,1,1.0,1,0.17574879695759132,45
5305,1,19620,3980,15640,0,0,0,1.0,1,1.0,1,1.0,1,0.1626889268430345,44
5306,2,19622,3982,15640,0,0,0,1.0,1,1.0,1,1.0,1,0.19789162375018626,42
5307,1,19623,3982,15641,0,0,0,1.0,1,1.0,1,1.0,1,0.20743461873595145,42
5308,1,19624,3983,15641,0,0,0,1.0,1,1.0,1,1.0,1,0.22480303342173624,43
5309,2,19626,3984,15642,0,0,0,1.0,1,1.0,1,1.0,1,0.22386453994683592,41
5310,1,19627,3985,15642,0,0,0,1.0,1,1.0,1,1.0,1,0.2660420801078686,41
5311,4,19631,3987,15644,0,0,0,1.0,1,1.0,1,1.0,1,0.19988973503066734,42
5312,2,19633,3987,15646,0,0,0,1.0,1,1.0,1,1.0,1,0.17590724891736237,43
5313,4,19637,3987,15650,0,0,0,1.0,1,1.0,1,1.0,1,0.12219499208315464,44
5314,2,19639,3987,15652,0,0,0,1.0,1,1.0,1,1.0,1,0.15181129815706862,44
5315,2,19641,3989,15652,0,0,0,1.0,1,1.0,1,1.0,1,0.1395272486174633,45
5316,4,19645,3989,15656,0,0,0,1.0,1,1.0,1,1.0,1,0.1264842698500946,46
5317,5,19650,3990,15660,0,0,0,1.0,1,1.0,1,1.0,1,0.16595315305459224,46
5318,4,19654,3991,15663,0,0,0,1.0,1,1.0,1,1.0,1,0.12169801559300603,46
5319,6,19660,3991,15669,0,0,0,1.0,1,1.0,1,1.0,1,0.21083392072086557,47
5320,8,19668,3992,15676,0,0,0,1.0,1,1.0,1,1.0,1,0.18573154707398762,48
5321,7,19675,3993,15682,0,0,0,1.0,1,1.0,1,1.0,1,0.1700980206160324,49
5322,7,19682,3993,15689,0,0,0,1.0,1,1.0,1,1.0,1,0.20876189599283487,49
5323,11,19693,3993,15700,0,0,0,1.0,1,1.0,1,1.0,1,0.18649582452772226,51
5324,8,19701,3993,15708,0,0,0,1.0,1,1.0,1,1.0,1,0.20285156053743114,53
5325,12,19713,3994,15719,0,0,0,1.0,1,1.0,1,1.0,1,0.2183024028476027,53
5326,6,19719,3994,15725,0,0,0,1.0,1,1.0,1,1.0,1,0.15223910185162212,53
5327,3,19722,3994,15728,0,0,0,1.0,1,1.0,1,1.0,1,0.1623020600707916,53
5328,5,19727,3995,15732,0,0,0,1.0,1,1.0,1,1.0,1,0.13116246761255745,54
5329,2,19729,3996,15733,0,0,0,1.0,1,1.0,1,1.0,1,0.15561456140683133,53
5330,6,19735,3997,15738,0,0,0,1.0,1,1.0,1,1.0,1,0.1758766666528043,52
5331,3,19738,3997,15741,0,0,0,1.0,1,1.0,1,1.0,1,0.18569135064318834,51
5332,2,19740,3997,15743,0,0,0,1.0,1,1.0,1,1.0,1,0.17114866421653482,52
5333,2,19742,3998,15744,0,0,0,1.0,1,1.0,1,1.0,1,0.20026662095850428,53
5334,3,19745,3998,15747,0,0,0,1.0,1,1.0,1,1.0,1,0.1878314603769837,54
5335,5,19750,3998,15752,0,0,0,1.0,1,1.0,1,1.0,1,0.1763946615715025,55
5336,3,19753,3998,15755,0,0,0,1.0,1,1.0,1,1.0,1,0.16552139006067537,54
5337,8,19761,3999,15762,0,0,0,1.0,1,1.0,1,1.0,1,0.18770860379220486,55
5338,9,19770,3999,15771,0,0,0,1.0,1,1.0,1,1.0,1,0.1674067498795683,55
5339,4,19774,3999,15775,0,0,0,1.0,1,1.0,1,1.0,1,0.16774701699785902,55
5340,3,19777,3999,15778,0,0,0,1.0,1,1.0,1,1.0,1,0.17878686390566406,55
5341,6,19783,3999,15784,0,0,0,1.0,1,1.0,1,1.0,1,0.1536597724725304,54
5342,2,19785,4000,15785,0,0,0,1.0,1,1.0,1,1.0,1,0.14139953621212745,55
5343,3,19788,4001,15787,0,0,0,1.0,1,1.0,1,1.0,1,0.12817931635070423,54
5344,2,19790,4002,15788,0,0,0,1.0,1,1.0,1,1.0,1,0.13561773885538822,55
5345,1,19791,4003,15788,0,0,0,1.0,1,1.0,1,1.0,1,0.1278593887206264,53
5346,4,19795,4006,15789,0,0,0,1.0,1,1.0,1,1.0,1,0.14506578852716823,53
5347,7,19802,4008,15794,0,0,0,1.0,1,1.0,1,1.0,1,0.12739130749923702,51
5348,3,19805,4009,15796,0,0,0,1.0,1,1.0,1,1.0,1,0.15835580855849068,53
5349,5,19810,4011,15799,0,0,0,1.0,1,1.0,1,1.0,1,0.1361484748462563,52
5350,2,19812,4011,15801,0,0,0,1.0,1,1.0,1,1.0,1,0.15594804150798292,50
5351,2,19814,4012,15802,0,0,0,1.0,1,1.0,1,1.0,1,0.1296025358942493,52
5352,4,19818,4014,15804,0,0,0,1.0,1,1.0,1,1.0,1,0.1455757858676716,49
5353,2,19820,4014,15806,0,0,0,1.0,1,1.0,1,1.0,1,0.1455757858676716,49
5354,3,19823,4015,15808,0,0,0,1.0,1,1.0,1,1.0,1,0.14591399941031186,49
5355,3,19826,4015,15811,0,0,0,1.0,1,1.0,1,1.0,1,0.16739382199326347,48
5356,8,19834,4016,15818,0,0,0,1.0,1,1.0,1,1.0,1,0.09645960087561169,49
5357,2,19836,4016,15820,0,0,0,1.0,1,1.0,1,1.0,1,0.11200377279781483,47
5358,2,19838,4017,15821,0,0,0,1.0,1,1.0,1,1.0,1,0.13758422413342006,48
5359,3,19841,4017,15824,0,0,0,1.0,1,1.0,1,1.0,1,0.09602749386670363,48
5360,1,19842,4018,15824,0,0,0,1.0,1,1.0,1,1.0,1,0.0917800425056081,48
5361,0,19842,4018,15824,0,0,0,1.0,1,1.0,1,1.0,1,0.08766978295985353,50
5362,0,19842,4018,15824,0,0,0,1.0,1,1.0,1,1.0,1,0.08766978295985353,50
5363,1,19843,4019,15824,0,0,0,1.0,1,1.0,1,1.0,1,0.09623088368972581,50
5364,0,19843,4019,15824,0,0,0,1.0,1,1.0,1,1.0,1,0.08991343930355304,51
5365,0,19843,4019,15824,0,0,0,1.0,1,1.0,1,1.0,1,0.110880043998102,52
5366,2,19845,4020,15825,0,0,0,1.0,1,1.0,1,1.0,1,0.13012208166144187,52
5367,8,19853,4022,15831,0,0,0,1.0,1,1.0,1,1.0,1,0.19491778492597725,54
5368,13,19866,4022,15844,0,0,0,1.0,1,1.0,1,1.0,1,0.16798306525513695,55
5369,4,19870,4022,15848,0,0,0,1.0,1,1.0,1,1.0,1,0.13121752397932776,53
5370,5,19875,4022,15853,0,0,0,1.0,1,1.0,1,1.0,1,0.13576019274695336,54
5371,3,19878,4023,15855,0,0,0,1.0,1,1.0,1,1.0,1,0.13101000491600967,53
5372,3,19881,4026,15855,0,0,0,1.0,1,1.0,1,1.0,1,0.2198465231299547,53
5373,5,19886,4027,15859,0,0,0,1.0,1,1.0,1,1.0,1,0.19548957286742877,52
5374,3,19889,4028,15861,0,0,0,1.0,1,1.0,1,1.0,1,0.18184297887555284,51
5375,3,19892,4028,15864,0,0,0,1.0,1,1.0,1,1.0,1,0.11859937097971243,52
5376,2,19894,4029,15865,0,0,0,1.0,1,1.0,1,1.0,1,0.15131290862841584,51
5377,1,19895,4029,15866,0,0,0,1.0,1,1.0,1,1.0,1,0.12719747106100537,52
5378,1,19896,4030,15866,0,0,0,1.0,1,1.0,1,1.0,1,0.1436372826247861,50
5379,1,19897,4031,15866,0,0,0,1.0,1,1.0,1,1.0,1,0.137153187054568,50
5380,2,19899,4031,15868,0,0,0,1.0,1,1.0,1,1.0,1,0.16381093577013808,52
5381,3,19902,4031,15871,0,0,0,1.0,1,1.0,1,1.0,1,0.16305673522839323,52
5382,4,19906,4032,15874,0,0,0,1.0,1,1.0,1,1.0,1,0.15277771698018258,52
5383,2,19908,4032,15876,0,0,0,1.0,1,1.0,1,1.0,1,0.14603437394821533,51
5384,4,19912,4034,15878,0,0,0,1.0,1,1.0,1,1.0,1,0.10307220791201742,52
5385,3,19915,4035,15880,0,0,0,1.0,1,1.0,1,1.0,1,0.14592192036688947,51
5386,5,19920,4037,15883,0,0,0,1.0,1,1.0,1,1.0,1,0.12281324569359649,52
5387,4,19924,4037,15887,0,0,0,1.0,1,1.0,1,1.0,1,0.11059857083743757,53
5388,2,19926,4037,15889,0,0,0,1.0,1,1.0,1,1.0,1,0.10902671467594077,54
5389,6,19932,4039,15893,0,0,0,1.0,1,1.0,1,1.0,1,0.12241537437640887,55
5390,6,19938,4041,15897,0,0,0,1.0,1,1.0,1,1.0,1,0.15604589898081223,56
5391,5,19943,4041,15902,0,0,0,1.0,1,1.0,1,1.0,1,0.1795810566567316,56
5392,9,19952,4042,15910,0,0,0,1.0,1,1.0,1,1.0,1,0.1601006229687696,56
5393,8,19960,4042,15918,0,0,0,1.0,1,1.0,1,1.0,1,0.14969567747168966,54
5394,5,19965,4044,15921,0,0,0,1.0,1,1.0,1,1.0,1,0.15904212369114543,53
5395,4,19969,4046,15923,0,0,0,1.0,1,1.0,1,1.0,1,0.16486059228066086,53
5396,4,19973,4046,15927,0,0,0,1.0,1,1.0,1,1.0,1,0.14251632673569725,54
5397,3,19976,4046,15930,0,0,0,1.0,1,1.0,1,1.0,1,0.1644506249497705,53
5398,2,19978,4047,15931,0,0,0,1.0,1,1.0,1,1.0,1,0.15524973719815746,53
5399,6,19984,4050,15934,0,0,0,1.0,1,1.0,1,1.0,1,0.17550352625032895,55
5400,5,19989,4051,15938,0,0,0,1.0,1,1.0,1,1.0,1,0.156330032008837,55
5401,13,20002,4053,15949,0,0,0,1.0,1,1.0,1,1.0,1,0.1367933058926314,56
5402,0,20002,4053,15949,0,0,0,1.0,1,1.0,1,1.0,1,0.0,0
