,SuccessfulHandoverCount,TotalSuccessfulHandoverCount,TotalSuccessfulHandoverCountRange,TotalSuccessfulHandoverCountLoadBalancing,TotalSuccessfulHandoverCountOverload,FailedHandoverCount,TotalFailedHandoverCount,AvgQoS,MinQoS,AvgQoS_LoadBased,MinQoS_LoadBased,AvgQoS_RangeBased,MinQoS_RangeBased,GiniLoad,VehicleCount
0,0,0,0,0,0,0,0,1.0,1,1.0,1,1.0,1,0.0,0
1,21,21,0,21,0,0,0,1.0,1,1.0,1,1.0,1,0.22146569632253624,30
2,17,38,0,38,0,0,0,1.0,1,1.0,1,1.0,1,0.23998874993324257,32
3,27,65,0,65,0,0,0,1.0,1,1.0,1,1.0,1,0.2620817621096988,33
4,4,69,0,69,0,0,0,1.0,1,1.0,1,1.0,1,0.19808108990675097,34
5,3,72,0,72,0,0,0,1.0,1,1.0,1,1.0,1,0.16001850468371565,36
6,3,75,0,75,0,0,0,1.0,1,1.0,1,1.0,1,0.1674626375590579,38
7,1,76,0,76,0,0,0,1.0,1,1.0,1,1.0,1,0.15439748796802036,40
8,0,76,0,76,0,0,0,1.0,1,1.0,1,1.0,1,0.15439748796802036,40
9,0,76,0,76,0,0,0,1.0,1,1.0,1,1.0,1,0.15439748796802036,40
10,0,76,0,76,0,0,0,1.0,1,1.0,1,1.0,1,0.1629872055543452,41
11,0,76,0,76,0,0,0,1.0,1,1.0,1,1.0,1,0.16852619362418336,40
12,2,78,1,77,0,0,0,1.0,1,1.0,1,1.0,1,0.10036927994897162,39
13,4,82,4,78,0,0,0,1.0,1,1.0,1,1.0,1,0.15611723909418782,37
14,1,83,4,79,0,0,0,1.0,1,1.0,1,1.0,1,0.16656726551506493,35
15,2,85,4,81,0,0,0,1.0,1,1.0,1,1.0,1,0.15171421138343202,36
16,2,87,5,82,0,0,0,1.0,1,1.0,1,1.0,1,0.18612875858090736,34
17,0,87,5,82,0,0,0,1.0,1,1.0,1,1.0,1,0.21007994519656406,33
18,0,87,5,82,0,0,0,1.0,1,1.0,1,1.0,1,0.22668910107988785,34
19,1,88,6,82,0,0,0,1.0,1,1.0,1,1.0,1,0.25037501481250657,34
20,0,88,6,82,0,0,0,1.0,1,1.0,1,1.0,1,0.22556051544142533,34
21,2,90,7,83,0,0,0,1.0,1,1.0,1,1.0,1,0.24046913944555393,36
22,5,95,7,88,0,0,0,1.0,1,1.0,1,1.0,1,0.19512218512556948,35
23,3,98,9,89,0,0,0,1.0,1,1.0,1,1.0,1,0.21499046607152983,35
24,1,99,10,89,0,0,0,1.0,1,1.0,1,1.0,1,0.16010515486240415,35
25,5,104,13,91,0,0,0,1.0,1,1.0,1,1.0,1,0.21426005979620072,35
26,4,108,15,93,0,0,0,1.0,1,1.0,1,1.0,1,0.2186390696828505,36
27,4,112,16,96,0,0,0,1.0,1,1.0,1,1.0,1,0.20597913948321175,34
28,10,122,18,104,0,0,0,1.0,1,1.0,1,1.0,1,0.08043926682630323,35
29,0,122,18,104,0,0,0,1.0,1,1.0,1,1.0,1,0.14003196780171223,33
30,3,125,19,106,0,0,0,1.0,1,1.0,1,1.0,1,0.0678983488021993,33
31,2,127,20,107,0,0,0,1.0,1,1.0,1,1.0,1,0.13955831362652527,33
32,0,127,20,107,0,0,0,1.0,1,1.0,1,1.0,1,0.16297720842228347,32
33,3,130,20,110,0,0,0,1.0,1,1.0,1,1.0,1,0.1241115800968091,33
34,1,131,20,111,0,0,0,1.0,1,1.0,1,1.0,1,0.09422108862760781,33
35,0,131,20,111,0,0,0,1.0,1,1.0,1,1.0,1,0.11311568387111834,35
36,4,135,22,113,0,0,0,1.0,1,1.0,1,1.0,1,0.20167705363951957,36
37,2,137,22,115,0,0,0,1.0,1,1.0,1,1.0,1,0.14921503057198385,37
38,1,138,23,115,0,0,0,1.0,1,1.0,1,1.0,1,0.16997103602300934,36
39,2,140,23,117,0,0,0,1.0,1,1.0,1,1.0,1,0.1859864362909025,38
40,2,142,23,119,0,0,0,1.0,1,1.0,1,1.0,1,0.10426836628554555,40
41,0,142,23,119,0,0,0,1.0,1,1.0,1,1.0,1,0.10426836628554555,40
42,2,144,25,119,0,0,0,1.0,1,1.0,1,1.0,1,0.14124596811138132,40
43,2,146,26,120,0,0,0,1.0,1,1.0,1,1.0,1,0.168440527955857,43
44,0,146,26,120,0,0,0,1.0,1,1.0,1,1.0,1,0.168440527955857,43
45,1,147,27,120,0,0,0,1.0,1,1.0,1,1.0,1,0.18335498989222107,44
46,1,148,27,121,0,0,0,1.0,1,1.0,1,1.0,1,0.16423658979340666,44
47,3,151,29,122,0,0,0,1.0,1,1.0,1,1.0,1,0.18462153782197202,44
48,3,154,30,124,0,0,0,1.0,1,1.0,1,1.0,1,0.20130412478750667,44
49,0,154,30,124,0,0,0,1.0,1,1.0,1,1.0,1,0.17914144586983835,41
50,1,155,31,124,0,0,0,1.0,1,1.0,1,1.0,1,0.15731419525595786,40
51,0,155,31,124,0,0,0,1.0,1,1.0,1,1.0,1,0.1536668384274478,38
52,1,156,31,125,0,0,0,1.0,1,1.0,1,1.0,1,0.1459671502073442,37
53,0,156,31,125,0,0,0,1.0,1,1.0,1,1.0,1,0.17402444071351345,38
54,0,156,31,125,0,0,0,1.0,1,1.0,1,1.0,1,0.1897212324418893,38
55,4,160,33,127,0,0,0,1.0,1,1.0,1,1.0,1,0.19089852732733795,38
56,3,163,33,130,0,0,0,1.0,1,1.0,1,1.0,1,0.18759550699407762,38
57,3,166,34,132,0,0,0,1.0,1,1.0,1,1.0,1,0.1969607341190127,38
58,3,169,36,133,0,0,0,1.0,1,1.0,1,1.0,1,0.1782037231971908,38
59,2,171,37,134,0,0,0,1.0,1,1.0,1,1.0,1,0.21323695593353426,40
60,1,172,38,134,0,0,0,1.0,1,1.0,1,1.0,1,0.22394573509686624,40
61,2,174,38,136,0,0,0,1.0,1,1.0,1,1.0,1,0.21172711998709567,40
62,4,178,39,139,0,0,0,1.0,1,1.0,1,1.0,1,0.15422131112908494,42
63,1,179,39,140,0,0,0,1.0,1,1.0,1,1.0,1,0.15587796249051586,40
64,0,179,39,140,0,0,0,1.0,1,1.0,1,1.0,1,0.14538967580998938,41
65,1,180,40,140,0,0,0,1.0,1,1.0,1,1.0,1,0.15899532039587597,41
66,0,180,40,140,0,0,0,1.0,1,1.0,1,1.0,1,0.1592797883077349,41
67,0,180,40,140,0,0,0,1.0,1,1.0,1,1.0,1,0.1592797883077349,41
68,1,181,40,141,0,0,0,1.0,1,1.0,1,1.0,1,0.12753106644628817,41
69,3,184,42,142,0,0,0,1.0,1,1.0,1,1.0,1,0.1737210178621881,41
70,3,187,42,145,0,0,0,1.0,1,1.0,1,1.0,1,0.1489740286547609,42
71,1,188,43,145,0,0,0,1.0,1,1.0,1,1.0,1,0.1516417516005418,44
72,3,191,43,148,0,0,0,1.0,1,1.0,1,1.0,1,0.09518560906275843,44
73,0,191,43,148,0,0,0,1.0,1,1.0,1,1.0,1,0.11325851512497585,46
74,0,191,43,148,0,0,0,1.0,1,1.0,1,1.0,1,0.12916836793728592,44
75,1,192,44,148,0,0,0,1.0,1,1.0,1,1.0,1,0.14148473888361077,44
76,5,197,46,151,0,0,0,1.0,1,1.0,1,1.0,1,0.12558261941955287,45
77,0,197,46,151,0,0,0,1.0,1,1.0,1,1.0,1,0.10578063341162772,44
78,1,198,47,151,0,0,0,1.0,1,1.0,1,1.0,1,0.1620320330469826,44
79,3,201,48,153,0,0,0,1.0,1,1.0,1,1.0,1,0.17106137326894671,43
80,1,202,49,153,0,0,0,1.0,1,1.0,1,1.0,1,0.1780176504414903,43
81,3,205,51,154,0,0,0,1.0,1,1.0,1,1.0,1,0.25050943703298395,44
82,6,211,54,157,0,0,0,1.0,1,1.0,1,1.0,1,0.24323460559393195,45
83,6,217,56,161,0,0,0,1.0,1,1.0,1,1.0,1,0.2382014766136454,45
84,1,218,56,162,0,0,0,1.0,1,1.0,1,1.0,1,0.24203904568287055,45
85,3,221,56,165,0,0,0,1.0,1,1.0,1,1.0,1,0.19916483491500567,45
86,2,223,56,167,0,0,0,1.0,1,1.0,1,1.0,1,0.15600654522868784,45
87,0,223,56,167,0,0,0,1.0,1,1.0,1,1.0,1,0.1735960669619441,44
88,0,223,56,167,0,0,0,1.0,1,1.0,1,1.0,1,0.16605412641139866,45
89,1,224,57,167,0,0,0,1.0,1,1.0,1,1.0,1,0.18843278722029883,46
90,0,224,57,167,0,0,0,1.0,1,1.0,1,1.0,1,0.2113233380872685,44
91,2,226,57,169,0,0,0,1.0,1,1.0,1,1.0,1,0.18211998513264618,45
92,0,226,57,169,0,0,0,1.0,1,1.0,1,1.0,1,0.18664736389994663,46
93,1,227,57,170,0,0,0,1.0,1,1.0,1,1.0,1,0.1810372170648366,46
94,0,227,57,170,0,0,0,1.0,1,1.0,1,1.0,1,0.1810372170648366,46
95,1,228,57,171,0,0,0,1.0,1,1.0,1,1.0,1,0.1898527941709743,46
96,0,228,57,171,0,0,0,1.0,1,1.0,1,1.0,1,0.1898527941709743,46
97,1,229,57,172,0,0,0,1.0,1,1.0,1,1.0,1,0.17171141800686243,47
98,0,229,57,172,0,0,0,1.0,1,1.0,1,1.0,1,0.17171141800686243,47
99,0,229,57,172,0,0,0,1.0,1,1.0,1,1.0,1,0.18696645704249065,46
100,2,231,58,173,0,0,0,1.0,1,1.0,1,1.0,1,0.20400531271301964,48
101,3,234,59,175,0,0,0,1.0,1,1.0,1,1.0,1,0.20068084119282922,49
102,1,235,60,175,0,0,0,1.0,1,1.0,1,1.0,1,0.2098336252445462,49
103,5,240,61,179,0,0,0,1.0,1,1.0,1,1.0,1,0.11830250891555454,48
104,2,242,63,179,0,0,0,1.0,1,1.0,1,1.0,1,0.14088545600354505,49
105,5,247,65,182,0,0,0,1.0,1,1.0,1,1.0,1,0.11035096160589454,48
106,3,250,67,183,0,0,0,1.0,1,1.0,1,1.0,1,0.10316878170522342,48
107,2,252,69,183,0,0,0,1.0,1,1.0,1,1.0,1,0.16414334062928962,47
108,1,253,70,183,0,0,0,1.0,1,1.0,1,1.0,1,0.1536503820362366,47
109,4,257,72,185,0,0,0,1.0,1,1.0,1,1.0,1,0.14094278835641671,47
110,2,259,72,187,0,0,0,1.0,1,1.0,1,1.0,1,0.11716067078506177,47
111,2,261,72,189,0,0,0,1.0,1,1.0,1,1.0,1,0.0877149477343068,46
112,3,264,74,190,0,0,0,1.0,1,1.0,1,1.0,1,0.08995906433378403,46
113,5,269,76,193,0,0,0,1.0,1,1.0,1,1.0,1,0.11102441293930627,45
114,0,269,76,193,0,0,0,1.0,1,1.0,1,1.0,1,0.10440898295152308,46
115,3,272,77,195,0,0,0,1.0,1,1.0,1,1.0,1,0.11967343884435175,47
116,0,272,77,195,0,0,0,1.0,1,1.0,1,1.0,1,0.10649221539351773,48
117,2,274,79,195,0,0,0,1.0,1,1.0,1,1.0,1,0.11241499602869921,48
118,0,274,79,195,0,0,0,1.0,1,1.0,1,1.0,1,0.11820965840956714,49
119,1,275,80,195,0,0,0,1.0,1,1.0,1,1.0,1,0.13417303730172825,50
120,1,276,80,196,0,0,0,1.0,1,1.0,1,1.0,1,0.11228128754004911,51
121,0,276,80,196,0,0,0,1.0,1,1.0,1,1.0,1,0.11228128754004911,51
122,0,276,80,196,0,0,0,1.0,1,1.0,1,1.0,1,0.11228128754004911,51
123,0,276,80,196,0,0,0,1.0,1,1.0,1,1.0,1,0.11228128754004911,51
124,0,276,80,196,0,0,0,1.0,1,1.0,1,1.0,1,0.11228128754004911,51
125,0,276,80,196,0,0,0,1.0,1,1.0,1,1.0,1,0.1674013031475287,50
126,3,279,82,197,0,0,0,1.0,1,1.0,1,1.0,1,0.15533949902309907,52
127,8,287,83,204,0,0,0,1.0,1,1.0,1,1.0,1,0.1526703072767759,50
128,3,290,83,207,0,0,0,1.0,1,1.0,1,1.0,1,0.1672683310179888,50
129,7,297,83,214,0,0,0,1.0,1,1.0,1,1.0,1,0.18687979214162878,52
130,7,304,84,220,0,0,0,1.0,1,1.0,1,1.0,1,0.1445752136194113,52
131,4,308,85,223,0,0,0,1.0,1,1.0,1,1.0,1,0.13548825324536823,54
132,7,315,86,229,0,0,0,1.0,1,1.0,1,1.0,1,0.12613877818082264,54
133,4,319,86,233,0,0,0,1.0,1,1.0,1,1.0,1,0.058914237542102586,52
134,0,319,86,233,0,0,0,1.0,1,1.0,1,1.0,1,0.05891303480339128,52
135,4,323,90,233,0,0,0,1.0,1,1.0,1,1.0,1,0.11576152343692783,51
136,4,327,91,236,0,0,0,1.0,1,1.0,1,1.0,1,0.06937878013305238,51
137,2,329,91,238,0,0,0,1.0,1,1.0,1,1.0,1,0.05450042389094789,50
138,2,331,92,239,0,0,0,1.0,1,1.0,1,1.0,1,0.062117066779889984,52
139,1,332,93,239,0,0,0,1.0,1,1.0,1,1.0,1,0.07475779222374405,51
140,2,334,94,240,0,0,0,1.0,1,1.0,1,1.0,1,0.067227526443712,51
141,1,335,95,240,0,0,0,1.0,1,1.0,1,1.0,1,0.09674047287043921,50
142,1,336,96,240,0,0,0,1.0,1,1.0,1,1.0,1,0.11492477277352048,51
143,0,336,96,240,0,0,0,1.0,1,1.0,1,1.0,1,0.12727293284575136,48
144,2,338,98,240,0,0,0,1.0,1,1.0,1,1.0,1,0.16231859819760114,49
145,5,343,100,243,0,0,0,1.0,1,1.0,1,1.0,1,0.13958483404677705,47
146,3,346,102,244,0,0,0,1.0,1,1.0,1,1.0,1,0.11028822472289676,49
147,1,347,102,245,0,0,0,1.0,1,1.0,1,1.0,1,0.15110930857015803,46
148,2,349,103,246,0,0,0,1.0,1,1.0,1,1.0,1,0.10484044949227653,47
149,1,350,104,246,0,0,0,1.0,1,1.0,1,1.0,1,0.10781165641822398,46
150,0,350,104,246,0,0,0,1.0,1,1.0,1,1.0,1,0.0902547537736288,47
151,1,351,105,246,0,0,0,1.0,1,1.0,1,1.0,1,0.09799191973607187,46
152,0,351,105,246,0,0,0,1.0,1,1.0,1,1.0,1,0.1215971010186204,45
153,0,351,105,246,0,0,0,1.0,1,1.0,1,1.0,1,0.1320074389465398,46
154,1,352,105,247,0,0,0,1.0,1,1.0,1,1.0,1,0.1465393001248792,44
155,3,355,108,247,0,0,0,1.0,1,1.0,1,1.0,1,0.1832393555304774,45
156,5,360,109,251,0,0,0,1.0,1,1.0,1,1.0,1,0.15489713846644368,43
157,4,364,110,254,0,0,0,1.0,1,1.0,1,1.0,1,0.11455888316156443,42
158,2,366,110,256,0,0,0,1.0,1,1.0,1,1.0,1,0.105444921013582,43
159,1,367,111,256,0,0,0,1.0,1,1.0,1,1.0,1,0.17046234454672876,44
160,3,370,111,259,0,0,0,1.0,1,1.0,1,1.0,1,0.0962373892148492,44
161,3,373,114,259,0,0,0,1.0,1,1.0,1,1.0,1,0.13612441718256355,44
162,2,375,115,260,0,0,0,1.0,1,1.0,1,1.0,1,0.16056157350003913,44
163,8,383,121,262,0,0,0,1.0,1,1.0,1,1.0,1,0.18756357176579344,44
164,3,386,122,264,0,0,0,1.0,1,1.0,1,1.0,1,0.15892828586975138,44
165,2,388,124,264,0,0,0,1.0,1,1.0,1,1.0,1,0.10410128309198813,43
166,2,390,124,266,0,0,0,1.0,1,1.0,1,1.0,1,0.11905705524315184,43
167,0,390,124,266,0,0,0,1.0,1,1.0,1,1.0,1,0.11587559406816134,42
168,1,391,125,266,0,0,0,1.0,1,1.0,1,1.0,1,0.1689098136660184,40
169,5,396,127,269,0,0,0,1.0,1,1.0,1,1.0,1,0.13926390716164777,41
170,1,397,127,270,0,0,0,1.0,1,1.0,1,1.0,1,0.16473546568590347,39
171,5,402,128,274,0,0,0,1.0,1,1.0,1,1.0,1,0.08035099079828209,39
172,0,402,128,274,0,0,0,1.0,1,1.0,1,1.0,1,0.07283010593288972,38
173,3,405,130,275,0,0,0,1.0,1,1.0,1,1.0,1,0.17988844041776214,38
174,1,406,130,276,0,0,0,1.0,1,1.0,1,1.0,1,0.12220244875179383,37
175,1,407,131,276,0,0,0,1.0,1,1.0,1,1.0,1,0.13235560472927402,36
176,0,407,131,276,0,0,0,1.0,1,1.0,1,1.0,1,0.13439970221772823,36
177,2,409,133,276,0,0,0,1.0,1,1.0,1,1.0,1,0.14641973450955273,38
178,3,412,134,278,0,0,0,1.0,1,1.0,1,1.0,1,0.16318944762055826,39
179,3,415,134,281,0,0,0,1.0,1,1.0,1,1.0,1,0.12208651214775879,40
180,1,416,135,281,0,0,0,1.0,1,1.0,1,1.0,1,0.10749240908787953,40
181,0,416,135,281,0,0,0,1.0,1,1.0,1,1.0,1,0.12645782921582605,39
182,2,418,137,281,0,0,0,1.0,1,1.0,1,1.0,1,0.1459503098874985,40
183,2,420,139,281,0,0,0,1.0,1,1.0,1,1.0,1,0.20085414090732823,40
184,0,420,139,281,0,0,0,1.0,1,1.0,1,1.0,1,0.1869774013422825,38
185,2,422,139,283,0,0,0,1.0,1,1.0,1,1.0,1,0.14768854842480938,38
186,3,425,142,283,0,0,0,1.0,1,1.0,1,1.0,1,0.22053553528625058,37
187,6,431,144,287,0,0,0,1.0,1,1.0,1,1.0,1,0.15049463523452108,36
188,3,434,145,289,0,0,0,1.0,1,1.0,1,1.0,1,0.1753454109926708,36
189,4,438,146,292,0,0,0,1.0,1,1.0,1,1.0,1,0.1682511467992199,36
190,3,441,147,294,0,0,0,1.0,1,1.0,1,1.0,1,0.16772722317784017,36
191,1,442,148,294,0,0,0,1.0,1,1.0,1,1.0,1,0.17333168022524464,37
192,2,444,149,295,0,0,0,1.0,1,1.0,1,1.0,1,0.15778797006685213,37
193,2,446,149,297,0,0,0,1.0,1,1.0,1,1.0,1,0.09590200491994094,38
194,0,446,149,297,0,0,0,1.0,1,1.0,1,1.0,1,0.10065147169305344,39
195,2,448,150,298,0,0,0,1.0,1,1.0,1,1.0,1,0.10748661416632162,40
196,1,449,150,299,0,0,0,1.0,1,1.0,1,1.0,1,0.09563658852248319,40
197,2,451,150,301,0,0,0,1.0,1,1.0,1,1.0,1,0.10943839095723759,40
198,0,451,150,301,0,0,0,1.0,1,1.0,1,1.0,1,0.10943839095723759,40
199,1,452,151,301,0,0,0,1.0,1,1.0,1,1.0,1,0.10918136435943063,40
200,0,452,151,301,0,0,0,1.0,1,1.0,1,1.0,1,0.10918136435943063,40
201,1,453,152,301,0,0,0,1.0,1,1.0,1,1.0,1,0.1435964922945619,39
202,3,456,153,303,0,0,0,1.0,1,1.0,1,1.0,1,0.15351215494140688,40
203,3,459,155,304,0,0,0,1.0,1,1.0,1,1.0,1,0.17817651957540517,39
204,1,460,156,304,0,0,0,1.0,1,1.0,1,1.0,1,0.1352570697119114,38
205,1,461,157,304,0,0,0,1.0,1,1.0,1,1.0,1,0.14269096474660511,37
206,2,463,158,305,0,0,0,1.0,1,1.0,1,1.0,1,0.17970694438784124,36
207,3,466,159,307,0,0,0,1.0,1,1.0,1,1.0,1,0.1391885593752879,37
208,2,468,159,309,0,0,0,1.0,1,1.0,1,1.0,1,0.18978842295820378,36
209,1,469,160,309,0,0,0,1.0,1,1.0,1,1.0,1,0.2067247358916154,36
210,2,471,161,310,0,0,0,1.0,1,1.0,1,1.0,1,0.23521775884595705,36
211,1,472,161,311,0,0,0,1.0,1,1.0,1,1.0,1,0.236776125388951,34
212,2,474,162,312,0,0,0,1.0,1,1.0,1,1.0,1,0.2478608994505385,34
213,1,475,162,313,0,0,0,1.0,1,1.0,1,1.0,1,0.25813057923508986,36
214,2,477,162,315,0,0,0,1.0,1,1.0,1,1.0,1,0.2095635279234282,35
215,2,479,162,317,0,0,0,1.0,1,1.0,1,1.0,1,0.16329604936780764,35
216,2,481,162,319,0,0,0,1.0,1,1.0,1,1.0,1,0.15969960745202544,37
217,2,483,163,320,0,0,0,1.0,1,1.0,1,1.0,1,0.14909154449745435,37
218,3,486,166,320,0,0,0,1.0,1,1.0,1,1.0,1,0.17884461532243048,37
219,1,487,167,320,0,0,0,1.0,1,1.0,1,1.0,1,0.21282534680908716,37
220,4,491,168,323,0,0,0,1.0,1,1.0,1,1.0,1,0.1464435244655861,38
221,2,493,168,325,0,0,0,1.0,1,1.0,1,1.0,1,0.163044315949089,39
222,2,495,169,326,0,0,0,1.0,1,1.0,1,1.0,1,0.15155583754642343,39
223,2,497,170,327,0,0,0,1.0,1,1.0,1,1.0,1,0.16881466869747921,40
224,3,500,171,329,0,0,0,1.0,1,1.0,1,1.0,1,0.10650544306179592,40
225,1,501,172,329,0,0,0,1.0,1,1.0,1,1.0,1,0.14939715872166762,39
226,4,505,174,331,0,0,0,1.0,1,1.0,1,1.0,1,0.13920411713270148,39
227,2,507,175,332,0,0,0,1.0,1,1.0,1,1.0,1,0.19576921810323436,39
228,5,512,178,334,0,0,0,1.0,1,1.0,1,1.0,1,0.2100754387954251,38
229,6,518,180,338,0,0,0,1.0,1,1.0,1,1.0,1,0.1349179847697233,39
230,2,520,181,339,0,0,0,1.0,1,1.0,1,1.0,1,0.09781047085034937,38
231,4,524,183,341,0,0,0,1.0,1,1.0,1,1.0,1,0.1426833549819429,38
232,3,527,185,342,0,0,0,1.0,1,1.0,1,1.0,1,0.17219196297832084,37
233,0,527,185,342,0,0,0,1.0,1,1.0,1,1.0,1,0.16073003587843135,36
234,0,527,185,342,0,0,0,1.0,1,1.0,1,1.0,1,0.1785424353673493,34
235,3,530,187,343,0,0,0,1.0,1,1.0,1,1.0,1,0.22215403223316257,34
236,0,530,187,343,0,0,0,1.0,1,1.0,1,1.0,1,0.231267912713979,33
237,0,530,187,343,0,0,0,1.0,1,1.0,1,1.0,1,0.2553472823255503,32
238,3,533,187,346,0,0,0,1.0,1,1.0,1,1.0,1,0.2106126324292608,32
239,2,535,189,346,0,0,0,1.0,1,1.0,1,1.0,1,0.22765106878189492,31
240,1,536,189,347,0,0,0,1.0,1,1.0,1,1.0,1,0.27968588885882234,28
241,2,538,190,348,0,0,0,1.0,1,1.0,1,1.0,1,0.2752326444552198,27
242,1,539,190,349,0,0,0,1.0,1,1.0,1,1.0,1,0.26267040131099156,29
243,1,540,191,349,0,0,0,1.0,1,1.0,1,1.0,1,0.2419835606628888,28
244,1,541,191,350,0,0,0,1.0,1,1.0,1,1.0,1,0.19134898885401846,28
245,2,543,191,352,0,0,0,1.0,1,1.0,1,1.0,1,0.12673360062394542,27
246,2,545,193,352,0,0,0,1.0,1,1.0,1,1.0,1,0.14957792254642824,25
247,1,546,193,353,0,0,0,1.0,1,1.0,1,1.0,1,0.16314118495399618,26
248,0,546,193,353,0,0,0,1.0,1,1.0,1,1.0,1,0.17118721860799785,27
249,3,549,195,354,0,0,0,1.0,1,1.0,1,1.0,1,0.20763567803752106,26
250,1,550,195,355,0,0,0,1.0,1,1.0,1,1.0,1,0.20109473106264922,27
251,1,551,195,356,0,0,0,1.0,1,1.0,1,1.0,1,0.19299546234394452,28
252,1,552,196,356,0,0,0,1.0,1,1.0,1,1.0,1,0.24056056698435588,28
253,2,554,197,357,0,0,0,1.0,1,1.0,1,1.0,1,0.20197895234575133,28
254,2,556,198,358,0,0,0,1.0,1,1.0,1,1.0,1,0.22539332564986495,29
255,1,557,199,358,0,0,0,1.0,1,1.0,1,1.0,1,0.2816626852392925,30
256,1,558,199,359,0,0,0,1.0,1,1.0,1,1.0,1,0.24670282368292568,30
257,0,558,199,359,0,0,0,1.0,1,1.0,1,1.0,1,0.24610331089951842,32
258,0,558,199,359,0,0,0,1.0,1,1.0,1,1.0,1,0.24610331089951842,32
259,2,560,199,361,0,0,0,1.0,1,1.0,1,1.0,1,0.21962907161593373,32
260,2,562,199,363,0,0,0,1.0,1,1.0,1,1.0,1,0.14944049475496557,34
261,3,565,199,366,0,0,0,1.0,1,1.0,1,1.0,1,0.11444432831038012,35
262,4,569,201,368,0,0,0,1.0,1,1.0,1,1.0,1,0.16164987545466997,36
263,1,570,201,369,0,0,0,1.0,1,1.0,1,1.0,1,0.15860142595503526,34
264,1,571,202,369,0,0,0,1.0,1,1.0,1,1.0,1,0.17233078489218343,34
265,0,571,202,369,0,0,0,1.0,1,1.0,1,1.0,1,0.20375811525760573,33
266,2,573,202,371,0,0,0,1.0,1,1.0,1,1.0,1,0.1725817219896816,34
267,0,573,202,371,0,0,0,1.0,1,1.0,1,1.0,1,0.19253434965854152,33
268,1,574,202,372,0,0,0,1.0,1,1.0,1,1.0,1,0.191854518795659,34
269,0,574,202,372,0,0,0,1.0,1,1.0,1,1.0,1,0.191854518795659,34
270,0,574,202,372,0,0,0,1.0,1,1.0,1,1.0,1,0.20669273731661222,36
271,0,574,202,372,0,0,0,1.0,1,1.0,1,1.0,1,0.20669273731661222,36
272,1,575,202,373,0,0,0,1.0,1,1.0,1,1.0,1,0.21327454855007705,38
273,1,576,202,374,0,0,0,1.0,1,1.0,1,1.0,1,0.19449857180738483,38
274,6,582,204,378,0,0,0,1.0,1,1.0,1,1.0,1,0.19112968424503718,38
275,1,583,204,379,0,0,0,1.0,1,1.0,1,1.0,1,0.18431714170976632,38
276,1,584,204,380,0,0,0,1.0,1,1.0,1,1.0,1,0.18434659923699612,39
277,2,586,205,381,0,0,0,1.0,1,1.0,1,1.0,1,0.18302920311228776,38
278,1,587,205,382,0,0,0,1.0,1,1.0,1,1.0,1,0.17123299086866484,38
279,1,588,205,383,0,0,0,1.0,1,1.0,1,1.0,1,0.137733902268746,38
280,2,590,206,384,0,0,0,1.0,1,1.0,1,1.0,1,0.169746813738591,38
281,0,590,206,384,0,0,0,1.0,1,1.0,1,1.0,1,0.15259582974406083,38
282,0,590,206,384,0,0,0,1.0,1,1.0,1,1.0,1,0.13588221481794868,38
283,1,591,206,385,0,0,0,1.0,1,1.0,1,1.0,1,0.1275186320771087,38
284,0,591,206,385,0,0,0,1.0,1,1.0,1,1.0,1,0.1331421345966358,39
285,2,593,207,386,0,0,0,1.0,1,1.0,1,1.0,1,0.1513254257907005,39
286,1,594,207,387,0,0,0,1.0,1,1.0,1,1.0,1,0.14547879050923457,39
287,4,598,209,389,0,0,0,1.0,1,1.0,1,1.0,1,0.1804126706811928,39
288,1,599,209,390,0,0,0,1.0,1,1.0,1,1.0,1,0.16124374625043586,39
289,2,601,209,392,0,0,0,1.0,1,1.0,1,1.0,1,0.12752706472303474,39
290,2,603,210,393,0,0,0,1.0,1,1.0,1,1.0,1,0.12020713043428724,39
291,0,603,210,393,0,0,0,1.0,1,1.0,1,1.0,1,0.12020713043428724,39
292,2,605,211,394,0,0,0,1.0,1,1.0,1,1.0,1,0.12597669618619503,40
293,3,608,212,396,0,0,0,1.0,1,1.0,1,1.0,1,0.11444620267794868,41
294,3,611,213,398,0,0,0,1.0,1,1.0,1,1.0,1,0.10456778054572566,40
295,4,615,215,400,0,0,0,1.0,1,1.0,1,1.0,1,0.09465681547891554,42
296,2,617,217,400,0,0,0,1.0,1,1.0,1,1.0,1,0.11014031432299844,42
297,0,617,217,400,0,0,0,1.0,1,1.0,1,1.0,1,0.10991382453775565,43
298,2,619,218,401,0,0,0,1.0,1,1.0,1,1.0,1,0.13524589811241053,44
299,1,620,218,402,0,0,0,1.0,1,1.0,1,1.0,1,0.11278890255413127,44
300,6,626,218,408,0,0,0,1.0,1,1.0,1,1.0,1,0.05562533253512748,45
301,1,627,219,408,0,0,0,1.0,1,1.0,1,1.0,1,0.0885550246365138,47
302,3,630,220,410,0,0,0,1.0,1,1.0,1,1.0,1,0.08704772002348213,46
303,3,633,223,410,0,0,0,1.0,1,1.0,1,1.0,1,0.12490272846351771,45
304,5,638,226,412,0,0,0,1.0,1,1.0,1,1.0,1,0.166182414714378,45
305,0,638,226,412,0,0,0,1.0,1,1.0,1,1.0,1,0.1584212878077266,43
306,1,639,226,413,0,0,0,1.0,1,1.0,1,1.0,1,0.17894312863398099,44
307,7,646,227,419,0,0,0,1.0,1,1.0,1,1.0,1,0.09930784889878304,42
308,4,650,228,422,0,0,0,1.0,1,1.0,1,1.0,1,0.12685865121341397,41
309,1,651,228,423,0,0,0,1.0,1,1.0,1,1.0,1,0.12006314824865917,42
310,3,654,228,426,0,0,0,1.0,1,1.0,1,1.0,1,0.10276317277688467,41
311,0,654,228,426,0,0,0,1.0,1,1.0,1,1.0,1,0.10276317277688467,41
312,2,656,229,427,0,0,0,1.0,1,1.0,1,1.0,1,0.13186956982723258,44
313,0,656,229,427,0,0,0,1.0,1,1.0,1,1.0,1,0.1166955215996895,43
314,2,658,230,428,0,0,0,1.0,1,1.0,1,1.0,1,0.1120154267646618,43
315,1,659,230,429,0,0,0,1.0,1,1.0,1,1.0,1,0.09476265373775732,43
316,2,661,231,430,0,0,0,1.0,1,1.0,1,1.0,1,0.07968934965839188,43
317,0,661,231,430,0,0,0,1.0,1,1.0,1,1.0,1,0.09391493345996843,44
318,3,664,234,430,0,0,0,1.0,1,1.0,1,1.0,1,0.1841167321584364,45
319,4,668,234,434,0,0,0,1.0,1,1.0,1,1.0,1,0.14062030053262753,46
320,0,668,234,434,0,0,0,1.0,1,1.0,1,1.0,1,0.160661708125914,45
321,0,668,234,434,0,0,0,1.0,1,1.0,1,1.0,1,0.14659209954259692,44
322,1,669,234,435,0,0,0,1.0,1,1.0,1,1.0,1,0.13009025374904656,42
323,2,671,236,435,0,0,0,1.0,1,1.0,1,1.0,1,0.07446767886221957,42
324,0,671,236,435,0,0,0,1.0,1,1.0,1,1.0,1,0.07096457097817788,43
325,1,672,237,435,0,0,0,1.0,1,1.0,1,1.0,1,0.10454724028004503,43
326,0,672,237,435,0,0,0,1.0,1,1.0,1,1.0,1,0.10454724028004503,43
327,1,673,238,435,0,0,0,1.0,1,1.0,1,1.0,1,0.13794968324404375,44
328,1,674,239,435,0,0,0,1.0,1,1.0,1,1.0,1,0.14055667938291058,44
329,2,676,240,436,0,0,0,1.0,1,1.0,1,1.0,1,0.12465427240613251,45
330,1,677,240,437,0,0,0,1.0,1,1.0,1,1.0,1,0.11997868967653844,46
331,0,677,240,437,0,0,0,1.0,1,1.0,1,1.0,1,0.11997868967653844,46
332,1,678,240,438,0,0,0,1.0,1,1.0,1,1.0,1,0.09944799567955069,47
333,1,679,240,439,0,0,0,1.0,1,1.0,1,1.0,1,0.104585437525912,48
334,0,679,240,439,0,0,0,1.0,1,1.0,1,1.0,1,0.104585437525912,48
335,1,680,241,439,0,0,0,1.0,1,1.0,1,1.0,1,0.11685959502183928,49
336,2,682,241,441,0,0,0,1.0,1,1.0,1,1.0,1,0.10757876211213893,50
337,1,683,242,441,0,0,0,1.0,1,1.0,1,1.0,1,0.12011578578286332,51
338,1,684,243,441,0,0,0,1.0,1,1.0,1,1.0,1,0.14813001437349504,51
339,2,686,243,443,0,0,0,1.0,1,1.0,1,1.0,1,0.12536282226283152,51
340,3,689,244,445,0,0,0,1.0,1,1.0,1,1.0,1,0.11894411735216712,51
341,0,689,244,445,0,0,0,1.0,1,1.0,1,1.0,1,0.11904022397349534,51
342,1,690,245,445,0,0,0,1.0,1,1.0,1,1.0,1,0.14214782090329056,51
343,2,692,245,447,0,0,0,1.0,1,1.0,1,1.0,1,0.11914820209706378,51
344,1,693,246,447,0,0,0,1.0,1,1.0,1,1.0,1,0.13043976939175733,50
345,0,693,246,447,0,0,0,1.0,1,1.0,1,1.0,1,0.13043976939175733,50
346,5,698,249,449,0,0,0,1.0,1,1.0,1,1.0,1,0.18239035529850833,50
347,5,703,249,454,0,0,0,1.0,1,1.0,1,1.0,1,0.14942799849255065,51
348,5,708,250,458,0,0,0,1.0,1,1.0,1,1.0,1,0.16393420361187197,52
349,4,712,252,460,0,0,0,1.0,1,1.0,1,1.0,1,0.15767124744645625,54
350,6,718,252,466,0,0,0,1.0,1,1.0,1,1.0,1,0.14465050046302738,54
351,2,720,254,466,0,0,0,1.0,1,1.0,1,1.0,1,0.16569285141445103,54
352,1,721,254,467,0,0,0,1.0,1,1.0,1,1.0,1,0.16192998048736418,56
353,3,724,256,468,0,0,0,1.0,1,1.0,1,1.0,1,0.14914464709056957,54
354,1,725,256,469,0,0,0,1.0,1,1.0,1,1.0,1,0.11880888741058211,53
355,2,727,257,470,0,0,0,1.0,1,1.0,1,1.0,1,0.1047098217079433,54
356,1,728,258,470,0,0,0,1.0,1,1.0,1,1.0,1,0.12208503211879741,54
357,3,731,261,470,0,0,0,1.0,1,1.0,1,1.0,1,0.15676717855921649,53
358,5,736,261,475,0,0,0,1.0,1,1.0,1,1.0,1,0.09743521156423408,49
359,0,736,261,475,0,0,0,1.0,1,1.0,1,1.0,1,0.10487087257555168,48
360,1,737,261,476,0,0,0,1.0,1,1.0,1,1.0,1,0.11786344020919909,47
361,0,737,261,476,0,0,0,1.0,1,1.0,1,1.0,1,0.11180832735584609,46
362,0,737,261,476,0,0,0,1.0,1,1.0,1,1.0,1,0.11220570751133216,46
363,2,739,261,478,0,0,0,1.0,1,1.0,1,1.0,1,0.10196083975735055,47
364,0,739,261,478,0,0,0,1.0,1,1.0,1,1.0,1,0.10196083975735055,47
365,2,741,262,479,0,0,0,1.0,1,1.0,1,1.0,1,0.10971707576167371,47
366,6,747,264,483,0,0,0,1.0,1,1.0,1,1.0,1,0.12170538305517797,50
367,2,749,265,484,0,0,0,1.0,1,1.0,1,1.0,1,0.1143652144434827,50
368,1,750,265,485,0,0,0,1.0,1,1.0,1,1.0,1,0.0811571020401798,51
369,0,750,265,485,0,0,0,1.0,1,1.0,1,1.0,1,0.09860886770644063,51
370,1,751,265,486,0,0,0,1.0,1,1.0,1,1.0,1,0.07420180872436018,51
371,1,752,266,486,0,0,0,1.0,1,1.0,1,1.0,1,0.12753916723919392,52
372,1,753,266,487,0,0,0,1.0,1,1.0,1,1.0,1,0.1245951789612085,53
373,4,757,268,489,0,0,0,1.0,1,1.0,1,1.0,1,0.11865405637114047,53
374,4,761,269,492,0,0,0,1.0,1,1.0,1,1.0,1,0.12295006443427124,53
375,4,765,271,494,0,0,0,1.0,1,1.0,1,1.0,1,0.13622813438695447,53
376,4,769,271,498,0,0,0,1.0,1,1.0,1,1.0,1,0.09695203852398177,53
377,3,772,273,499,0,0,0,1.0,1,1.0,1,1.0,1,0.12350930614758193,53
378,3,775,274,501,0,0,0,1.0,1,1.0,1,1.0,1,0.13383862200278368,53
379,5,780,275,505,0,0,0,1.0,1,1.0,1,1.0,1,0.0918949231571222,54
380,0,780,275,505,0,0,0,1.0,1,1.0,1,1.0,1,0.0918949231571222,54
381,2,782,276,506,0,0,0,1.0,1,1.0,1,1.0,1,0.0943345914252816,54
382,1,783,277,506,0,0,0,1.0,1,1.0,1,1.0,1,0.1049217575819297,55
383,1,784,278,506,0,0,0,1.0,1,1.0,1,1.0,1,0.12486721907047084,55
384,0,784,278,506,0,0,0,1.0,1,1.0,1,1.0,1,0.13754306636864022,54
385,2,786,279,507,0,0,0,1.0,1,1.0,1,1.0,1,0.10912277260833433,52
386,3,789,280,509,0,0,0,1.0,1,1.0,1,1.0,1,0.10483550675636884,52
387,2,791,281,510,0,0,0,1.0,1,1.0,1,1.0,1,0.1077607418002519,50
388,4,795,282,513,0,0,0,1.0,1,1.0,1,1.0,1,0.09525034454472814,52
389,3,798,283,515,0,0,0,1.0,1,1.0,1,1.0,1,0.06813149007098727,51
390,3,801,285,516,0,0,0,1.0,1,1.0,1,1.0,1,0.0954593648000507,50
391,5,806,289,517,0,0,0,1.0,1,1.0,1,1.0,1,0.08767812319164445,49
392,1,807,290,517,0,0,0,1.0,1,1.0,1,1.0,1,0.14707625330351715,47
393,5,812,292,520,0,0,0,1.0,1,1.0,1,1.0,1,0.21284711587626987,47
394,12,824,295,529,0,0,0,1.0,1,1.0,1,1.0,1,0.13687287529343892,48
395,6,830,297,533,0,0,0,1.0,1,1.0,1,1.0,1,0.15884983803545902,46
396,3,833,299,534,0,0,0,1.0,1,1.0,1,1.0,1,0.2556921829449806,43
397,5,838,299,539,0,0,0,1.0,1,1.0,1,1.0,1,0.15596225639004005,42
398,0,838,299,539,0,0,0,1.0,1,1.0,1,1.0,1,0.15986496245256485,40
399,1,839,299,540,0,0,0,1.0,1,1.0,1,1.0,1,0.1323517560508116,39
400,3,842,300,542,0,0,0,1.0,1,1.0,1,1.0,1,0.0954177344298733,38
401,0,842,300,542,0,0,0,1.0,1,1.0,1,1.0,1,0.1212909555712996,37
402,0,842,300,542,0,0,0,1.0,1,1.0,1,1.0,1,0.13618964544987214,36
403,1,843,301,542,0,0,0,1.0,1,1.0,1,1.0,1,0.11613390718340673,38
404,2,845,302,543,0,0,0,1.0,1,1.0,1,1.0,1,0.1479227291647504,39
405,1,846,302,544,0,0,0,1.0,1,1.0,1,1.0,1,0.1372435206267045,40
406,3,849,303,546,0,0,0,1.0,1,1.0,1,1.0,1,0.14124025716579058,41
407,1,850,303,547,0,0,0,1.0,1,1.0,1,1.0,1,0.12792390837324444,42
408,3,853,304,549,0,0,0,1.0,1,1.0,1,1.0,1,0.13823331691675472,43
409,2,855,305,550,0,0,0,1.0,1,1.0,1,1.0,1,0.13123008965604105,44
410,1,856,305,551,0,0,0,1.0,1,1.0,1,1.0,1,0.13331819906068632,46
411,1,857,306,551,0,0,0,1.0,1,1.0,1,1.0,1,0.14646715190079782,46
412,1,858,306,552,0,0,0,1.0,1,1.0,1,1.0,1,0.12734739639885204,47
413,0,858,306,552,0,0,0,1.0,1,1.0,1,1.0,1,0.12734739639885204,47
414,1,859,306,553,0,0,0,1.0,1,1.0,1,1.0,1,0.10003807607353668,47
415,0,859,306,553,0,0,0,1.0,1,1.0,1,1.0,1,0.12063184073762481,48
416,3,862,308,554,0,0,0,1.0,1,1.0,1,1.0,1,0.1601146974905134,49
417,2,864,308,556,0,0,0,1.0,1,1.0,1,1.0,1,0.14440478210086502,49
418,3,867,309,558,0,0,0,1.0,1,1.0,1,1.0,1,0.14527492577340723,50
419,0,867,309,558,0,0,0,1.0,1,1.0,1,1.0,1,0.14527492577340723,50
420,1,868,309,559,0,0,0,1.0,1,1.0,1,1.0,1,0.1459554880099023,50
421,1,869,309,560,0,0,0,1.0,1,1.0,1,1.0,1,0.13320534035556839,50
422,0,869,309,560,0,0,0,1.0,1,1.0,1,1.0,1,0.15222895757796184,50
423,3,872,311,561,0,0,0,1.0,1,1.0,1,1.0,1,0.1732274757945237,51
424,3,875,312,563,0,0,0,1.0,1,1.0,1,1.0,1,0.15227960870541996,49
425,0,875,312,563,0,0,0,1.0,1,1.0,1,1.0,1,0.1683379102716742,48
426,4,879,313,566,0,0,0,1.0,1,1.0,1,1.0,1,0.11910854486458211,50
427,3,882,315,567,0,0,0,1.0,1,1.0,1,1.0,1,0.12398277587642649,48
428,6,888,318,570,0,0,0,1.0,1,1.0,1,1.0,1,0.1663184880203811,49
429,1,889,319,570,0,0,0,1.0,1,1.0,1,1.0,1,0.15350427702540345,45
430,6,895,321,574,0,0,0,1.0,1,1.0,1,1.0,1,0.13852551717734385,44
431,1,896,321,575,0,0,0,1.0,1,1.0,1,1.0,1,0.13269141395380468,42
432,1,897,322,575,0,0,0,1.0,1,1.0,1,1.0,1,0.17078778733896818,40
433,5,902,323,579,0,0,0,1.0,1,1.0,1,1.0,1,0.14327042725392913,39
434,4,906,324,582,0,0,0,1.0,1,1.0,1,1.0,1,0.0685110436520514,39
435,3,909,326,583,0,0,0,1.0,1,1.0,1,1.0,1,0.15174578654628676,38
436,1,910,326,584,0,0,0,1.0,1,1.0,1,1.0,1,0.1466356193567783,38
437,1,911,326,585,0,0,0,1.0,1,1.0,1,1.0,1,0.14391866065369666,39
438,0,911,326,585,0,0,0,1.0,1,1.0,1,1.0,1,0.15547038669721908,38
439,1,912,326,586,0,0,0,1.0,1,1.0,1,1.0,1,0.1549047178235771,39
440,0,912,326,586,0,0,0,1.0,1,1.0,1,1.0,1,0.1549047178235771,39
441,3,915,327,588,0,0,0,1.0,1,1.0,1,1.0,1,0.11025751936474636,41
442,3,918,328,590,0,0,0,1.0,1,1.0,1,1.0,1,0.11478775827393166,42
443,1,919,329,590,0,0,0,1.0,1,1.0,1,1.0,1,0.14103539057065495,42
444,0,919,329,590,0,0,0,1.0,1,1.0,1,1.0,1,0.13992641572831754,43
445,4,923,329,594,0,0,0,1.0,1,1.0,1,1.0,1,0.09248595964574272,44
446,2,925,329,596,0,0,0,1.0,1,1.0,1,1.0,1,0.12060463183958718,44
447,4,929,330,599,0,0,0,1.0,1,1.0,1,1.0,1,0.1686128888941215,47
448,3,932,330,602,0,0,0,1.0,1,1.0,1,1.0,1,0.14151852046287047,46
449,0,932,330,602,0,0,0,1.0,1,1.0,1,1.0,1,0.14151852046287047,46
450,0,932,330,602,0,0,0,1.0,1,1.0,1,1.0,1,0.14173746785621785,46
451,3,935,330,605,0,0,0,1.0,1,1.0,1,1.0,1,0.11334765654913721,47
452,0,935,330,605,0,0,0,1.0,1,1.0,1,1.0,1,0.1273972129318961,47
453,0,935,330,605,0,0,0,1.0,1,1.0,1,1.0,1,0.1273972129318961,47
454,2,937,330,607,0,0,0,1.0,1,1.0,1,1.0,1,0.092691228418098,46
455,3,940,331,609,0,0,0,1.0,1,1.0,1,1.0,1,0.08341655865132214,47
456,2,942,331,611,0,0,0,1.0,1,1.0,1,1.0,1,0.07731463728605782,49
457,0,942,331,611,0,0,0,1.0,1,1.0,1,1.0,1,0.07302468732250914,50
458,0,942,331,611,0,0,0,1.0,1,1.0,1,1.0,1,0.07302468732250914,50
459,0,942,331,611,0,0,0,1.0,1,1.0,1,1.0,1,0.06836650485299453,52
460,0,942,331,611,0,0,0,1.0,1,1.0,1,1.0,1,0.07284074528166634,53
461,2,944,331,613,0,0,0,1.0,1,1.0,1,1.0,1,0.05891204028708705,54
462,2,946,331,615,0,0,0,1.0,1,1.0,1,1.0,1,0.050849534134366804,54
463,4,950,333,617,0,0,0,1.0,1,1.0,1,1.0,1,0.04729392240340266,55
464,1,951,334,617,0,0,0,1.0,1,1.0,1,1.0,1,0.06976917699764601,56
465,1,952,335,617,0,0,0,1.0,1,1.0,1,1.0,1,0.06661010757222921,54
466,3,955,337,618,0,0,0,1.0,1,1.0,1,1.0,1,0.10532698418213404,54
467,3,958,339,619,0,0,0,1.0,1,1.0,1,1.0,1,0.12727147026685165,51
468,7,965,344,621,0,0,0,1.0,1,1.0,1,1.0,1,0.13327881929129326,51
469,4,969,345,624,0,0,0,1.0,1,1.0,1,1.0,1,0.06887635286211205,48
470,3,972,348,624,0,0,0,1.0,1,1.0,1,1.0,1,0.10200625967579745,47
471,4,976,352,624,0,0,0,1.0,1,1.0,1,1.0,1,0.1791343309358022,44
472,8,984,356,628,0,0,0,1.0,1,1.0,1,1.0,1,0.16899076077977102,43
473,1,985,356,629,0,0,0,1.0,1,1.0,1,1.0,1,0.15702996657255958,41
474,1,986,357,629,0,0,0,1.0,1,1.0,1,1.0,1,0.18851430706996314,39
475,5,991,358,633,0,0,0,1.0,1,1.0,1,1.0,1,0.13759257815400155,40
476,5,996,361,635,0,0,0,1.0,1,1.0,1,1.0,1,0.18763619374025087,38
477,2,998,362,636,0,0,0,1.0,1,1.0,1,1.0,1,0.2573439492177908,35
478,4,1002,362,640,0,0,0,1.0,1,1.0,1,1.0,1,0.1849770203893971,35
479,1,1003,363,640,0,0,0,1.0,1,1.0,1,1.0,1,0.2352843351144105,32
480,0,1003,363,640,0,0,0,1.0,1,1.0,1,1.0,1,0.275913034854321,32
481,2,1005,363,642,0,0,0,1.0,1,1.0,1,1.0,1,0.22714105650122893,33
482,1,1006,364,642,0,0,0,1.0,1,1.0,1,1.0,1,0.22699160729067072,34
483,1,1007,364,643,0,0,0,1.0,1,1.0,1,1.0,1,0.1991652653912154,32
484,2,1009,365,644,0,0,0,1.0,1,1.0,1,1.0,1,0.18766750956982772,33
485,3,1012,365,647,0,0,0,1.0,1,1.0,1,1.0,1,0.15536888379602698,34
486,2,1014,365,649,0,0,0,1.0,1,1.0,1,1.0,1,0.17007941779370128,36
487,2,1016,365,651,0,0,0,1.0,1,1.0,1,1.0,1,0.1378955477449712,36
488,0,1016,365,651,0,0,0,1.0,1,1.0,1,1.0,1,0.14691708582076402,37
489,5,1021,367,654,0,0,0,1.0,1,1.0,1,1.0,1,0.15578948063952397,38
490,1,1022,367,655,0,0,0,1.0,1,1.0,1,1.0,1,0.13839381029483988,38
491,0,1022,367,655,0,0,0,1.0,1,1.0,1,1.0,1,0.14773131836597456,37
492,0,1022,367,655,0,0,0,1.0,1,1.0,1,1.0,1,0.14773131836597456,37
493,2,1024,367,657,0,0,0,1.0,1,1.0,1,1.0,1,0.10178143553920968,37
494,6,1030,369,661,0,0,0,1.0,1,1.0,1,1.0,1,0.1408169126142789,39
495,3,1033,369,664,0,0,0,1.0,1,1.0,1,1.0,1,0.15653882543751185,40
496,3,1036,369,667,0,0,0,1.0,1,1.0,1,1.0,1,0.09205043586282385,40
497,1,1037,369,668,0,0,0,1.0,1,1.0,1,1.0,1,0.07047562080771336,43
498,1,1038,370,668,0,0,0,1.0,1,1.0,1,1.0,1,0.09099862256711044,43
499,3,1041,372,669,0,0,0,1.0,1,1.0,1,1.0,1,0.12333676137102073,44
500,1,1042,372,670,0,0,0,1.0,1,1.0,1,1.0,1,0.1424576764562732,45
501,2,1044,372,672,0,0,0,1.0,1,1.0,1,1.0,1,0.11601099487665523,45
502,1,1045,373,672,0,0,0,1.0,1,1.0,1,1.0,1,0.12471142449458879,45
503,4,1049,375,674,0,0,0,1.0,1,1.0,1,1.0,1,0.130922274012921,46
504,4,1053,377,676,0,0,0,1.0,1,1.0,1,1.0,1,0.14800299720497068,47
505,1,1054,377,677,0,0,0,1.0,1,1.0,1,1.0,1,0.1537245352954591,42
506,1,1055,378,677,0,0,0,1.0,1,1.0,1,1.0,1,0.16446444311285607,41
507,0,1055,378,677,0,0,0,1.0,1,1.0,1,1.0,1,0.17558021724221748,38
508,5,1060,380,680,0,0,0,1.0,1,1.0,1,1.0,1,0.18888371399755355,38
509,2,1062,380,682,0,0,0,1.0,1,1.0,1,1.0,1,0.23351585892802074,37
510,2,1064,380,684,0,0,0,1.0,1,1.0,1,1.0,1,0.23315466024717288,36
511,1,1065,380,685,0,0,0,1.0,1,1.0,1,1.0,1,0.19220878829019006,34
512,0,1065,380,685,0,0,0,1.0,1,1.0,1,1.0,1,0.17794199115829765,32
513,1,1066,380,686,0,0,0,1.0,1,1.0,1,1.0,1,0.11854592810620455,32
514,1,1067,380,687,0,0,0,1.0,1,1.0,1,1.0,1,0.09331624432199488,35
515,1,1068,380,688,0,0,0,1.0,1,1.0,1,1.0,1,0.07875170193749564,35
516,0,1068,380,688,0,0,0,1.0,1,1.0,1,1.0,1,0.08995527169338607,36
517,0,1068,380,688,0,0,0,1.0,1,1.0,1,1.0,1,0.08995527169338607,36
518,0,1068,380,688,0,0,0,1.0,1,1.0,1,1.0,1,0.1294822722936684,39
519,1,1069,381,688,0,0,0,1.0,1,1.0,1,1.0,1,0.14725735741678542,39
520,3,1072,382,690,0,0,0,1.0,1,1.0,1,1.0,1,0.16660956683920178,39
521,2,1074,383,691,0,0,0,1.0,1,1.0,1,1.0,1,0.11344134864485508,40
522,1,1075,383,692,0,0,0,1.0,1,1.0,1,1.0,1,0.1085171386729079,40
523,0,1075,383,692,0,0,0,1.0,1,1.0,1,1.0,1,0.12205260020678718,41
524,0,1075,383,692,0,0,0,1.0,1,1.0,1,1.0,1,0.12205260020678718,41
525,3,1078,385,693,0,0,0,1.0,1,1.0,1,1.0,1,0.14542573664072453,40
526,2,1080,386,694,0,0,0,1.0,1,1.0,1,1.0,1,0.17169800107245653,40
527,0,1080,386,694,0,0,0,1.0,1,1.0,1,1.0,1,0.17169800107245653,40
528,1,1081,387,694,0,0,0,1.0,1,1.0,1,1.0,1,0.15606293996910636,40
529,1,1082,387,695,0,0,0,1.0,1,1.0,1,1.0,1,0.1561144544917085,39
530,0,1082,387,695,0,0,0,1.0,1,1.0,1,1.0,1,0.1561144544917085,39
531,0,1082,387,695,0,0,0,1.0,1,1.0,1,1.0,1,0.17099755719009277,39
532,1,1083,388,695,0,0,0,1.0,1,1.0,1,1.0,1,0.23442817176037983,40
533,3,1086,388,698,0,0,0,1.0,1,1.0,1,1.0,1,0.19650828241362836,40
534,0,1086,388,698,0,0,0,1.0,1,1.0,1,1.0,1,0.21172759620568582,42
535,4,1090,389,701,0,0,0,1.0,1,1.0,1,1.0,1,0.2267261511239896,42
536,0,1090,389,701,0,0,0,1.0,1,1.0,1,1.0,1,0.23680364854324365,43
537,0,1090,389,701,0,0,0,1.0,1,1.0,1,1.0,1,0.23680364854324365,43
538,3,1093,389,704,0,0,0,1.0,1,1.0,1,1.0,1,0.1736728068268458,44
539,0,1093,389,704,0,0,0,1.0,1,1.0,1,1.0,1,0.1736728068268458,44
540,1,1094,390,704,0,0,0,1.0,1,1.0,1,1.0,1,0.18021499533110927,44
541,3,1097,391,706,0,0,0,1.0,1,1.0,1,1.0,1,0.142304514623737,45
542,2,1099,392,707,0,0,0,1.0,1,1.0,1,1.0,1,0.1472627391755159,46
543,4,1103,395,708,0,0,0,1.0,1,1.0,1,1.0,1,0.1988866180724114,43
544,3,1106,397,709,0,0,0,1.0,1,1.0,1,1.0,1,0.24450368842816914,42
545,5,1111,399,712,0,0,0,1.0,1,1.0,1,1.0,1,0.16169067136500634,43
546,3,1114,401,713,0,0,0,1.0,1,1.0,1,1.0,1,0.18903288496815981,41
547,1,1115,401,714,0,0,0,1.0,1,1.0,1,1.0,1,0.10551978334842244,40
548,4,1119,404,715,0,0,0,1.0,1,1.0,1,1.0,1,0.17018105537506245,40
549,2,1121,406,715,0,0,0,1.0,1,1.0,1,1.0,1,0.2157505310813796,39
550,4,1125,407,718,0,0,0,1.0,1,1.0,1,1.0,1,0.181022012789994,38
551,1,1126,407,719,0,0,0,1.0,1,1.0,1,1.0,1,0.11809403138291456,38
552,1,1127,408,719,0,0,0,1.0,1,1.0,1,1.0,1,0.153576588168511,39
553,0,1127,408,719,0,0,0,1.0,1,1.0,1,1.0,1,0.12888095072910813,38
554,2,1129,410,719,0,0,0,1.0,1,1.0,1,1.0,1,0.1789643590441489,39
555,0,1129,410,719,0,0,0,1.0,1,1.0,1,1.0,1,0.1860710099058859,39
556,4,1133,411,722,0,0,0,1.0,1,1.0,1,1.0,1,0.15609515065815388,40
557,2,1135,411,724,0,0,0,1.0,1,1.0,1,1.0,1,0.1484030561137692,40
558,2,1137,411,726,0,0,0,1.0,1,1.0,1,1.0,1,0.1038939534103637,40
559,1,1138,412,726,0,0,0,1.0,1,1.0,1,1.0,1,0.13722284778052285,40
560,3,1141,412,729,0,0,0,1.0,1,1.0,1,1.0,1,0.09118029712913435,41
561,0,1141,412,729,0,0,0,1.0,1,1.0,1,1.0,1,0.10530668604679448,42
562,1,1142,413,729,0,0,0,1.0,1,1.0,1,1.0,1,0.14078934456984638,42
563,2,1144,415,729,0,0,0,1.0,1,1.0,1,1.0,1,0.21162424106942374,42
564,0,1144,415,729,0,0,0,1.0,1,1.0,1,1.0,1,0.22309607057049585,43
565,3,1147,416,731,0,0,0,1.0,1,1.0,1,1.0,1,0.20732036463563938,44
566,1,1148,416,732,0,0,0,1.0,1,1.0,1,1.0,1,0.2010010987925105,45
567,0,1148,416,732,0,0,0,1.0,1,1.0,1,1.0,1,0.2010010987925105,45
568,2,1150,416,734,0,0,0,1.0,1,1.0,1,1.0,1,0.14682215930644546,46
569,3,1153,418,735,0,0,0,1.0,1,1.0,1,1.0,1,0.16852720349020883,47
570,1,1154,418,736,0,0,0,1.0,1,1.0,1,1.0,1,0.17034528256752784,48
571,5,1159,421,738,0,0,0,1.0,1,1.0,1,1.0,1,0.18349679584033654,48
572,0,1159,421,738,0,0,0,1.0,1,1.0,1,1.0,1,0.18918222467571352,47
573,2,1161,421,740,0,0,0,1.0,1,1.0,1,1.0,1,0.1700287382281712,49
574,2,1163,421,742,0,0,0,1.0,1,1.0,1,1.0,1,0.14229140178450853,49
575,2,1165,421,744,0,0,0,1.0,1,1.0,1,1.0,1,0.10044936959081231,50
576,0,1165,421,744,0,0,0,1.0,1,1.0,1,1.0,1,0.11722014983436929,51
577,2,1167,421,746,0,0,0,1.0,1,1.0,1,1.0,1,0.09664496334456911,51
578,0,1167,421,746,0,0,0,1.0,1,1.0,1,1.0,1,0.09664496334456911,51
579,1,1168,422,746,0,0,0,1.0,1,1.0,1,1.0,1,0.12073074817224595,52
580,2,1170,422,748,0,0,0,1.0,1,1.0,1,1.0,1,0.1196389223089557,52
581,4,1174,423,751,0,0,0,1.0,1,1.0,1,1.0,1,0.11546790236385224,52
582,4,1178,424,754,0,0,0,1.0,1,1.0,1,1.0,1,0.12581721414138267,53
583,4,1182,426,756,0,0,0,1.0,1,1.0,1,1.0,1,0.10179021605726582,51
584,5,1187,429,758,0,0,0,1.0,1,1.0,1,1.0,1,0.10601853325214199,51
585,1,1188,430,758,0,0,0,1.0,1,1.0,1,1.0,1,0.12894101826984208,49
586,5,1193,431,762,0,0,0,1.0,1,1.0,1,1.0,1,0.0893352335017586,49
587,1,1194,432,762,0,0,0,1.0,1,1.0,1,1.0,1,0.056335086121412185,48
588,0,1194,432,762,0,0,0,1.0,1,1.0,1,1.0,1,0.07421684168848326,46
589,2,1196,433,763,0,0,0,1.0,1,1.0,1,1.0,1,0.08799176175705985,48
590,1,1197,434,763,0,0,0,1.0,1,1.0,1,1.0,1,0.11142530132651463,47
591,5,1202,436,766,0,0,0,1.0,1,1.0,1,1.0,1,0.12417042288518856,48
592,6,1208,437,771,0,0,0,1.0,1,1.0,1,1.0,1,0.13756244074599647,47
593,1,1209,438,771,0,0,0,1.0,1,1.0,1,1.0,1,0.16776160419458638,45
594,3,1212,440,772,0,0,0,1.0,1,1.0,1,1.0,1,0.2064510470765905,44
595,3,1215,441,774,0,0,0,1.0,1,1.0,1,1.0,1,0.18617083271197848,43
596,1,1216,442,774,0,0,0,1.0,1,1.0,1,1.0,1,0.1925600485679963,44
597,0,1216,442,774,0,0,0,1.0,1,1.0,1,1.0,1,0.19462186238535603,43
598,2,1218,443,775,0,0,0,1.0,1,1.0,1,1.0,1,0.16164676925410845,45
599,3,1221,445,776,0,0,0,1.0,1,1.0,1,1.0,1,0.16031834505064763,44
600,0,1221,445,776,0,0,0,1.0,1,1.0,1,1.0,1,0.16031834505064763,44
601,2,1223,446,777,0,0,0,1.0,1,1.0,1,1.0,1,0.1639901491435784,45
602,4,1227,447,780,0,0,0,1.0,1,1.0,1,1.0,1,0.18379699935052216,46
603,3,1230,447,783,0,0,0,1.0,1,1.0,1,1.0,1,0.1574314363182619,46
604,3,1233,448,785,0,0,0,1.0,1,1.0,1,1.0,1,0.14707078592500772,47
605,0,1233,448,785,0,0,0,1.0,1,1.0,1,1.0,1,0.14707078592500772,47
606,0,1233,448,785,0,0,0,1.0,1,1.0,1,1.0,1,0.17309965249776316,47
607,3,1236,448,788,0,0,0,1.0,1,1.0,1,1.0,1,0.13864775253188988,48
608,1,1237,448,789,0,0,0,1.0,1,1.0,1,1.0,1,0.10751019775208749,47
609,2,1239,448,791,0,0,0,1.0,1,1.0,1,1.0,1,0.0748713460573552,48
610,0,1239,448,791,0,0,0,1.0,1,1.0,1,1.0,1,0.09650062836737829,48
611,3,1242,450,792,0,0,0,1.0,1,1.0,1,1.0,1,0.08036700134206269,49
612,1,1243,450,793,0,0,0,1.0,1,1.0,1,1.0,1,0.08397735474130752,50
613,0,1243,450,793,0,0,0,1.0,1,1.0,1,1.0,1,0.08397735474130752,50
614,1,1244,451,793,0,0,0,1.0,1,1.0,1,1.0,1,0.0947422617047083,50
615,1,1245,452,793,0,0,0,1.0,1,1.0,1,1.0,1,0.08615907120919362,50
616,0,1245,452,793,0,0,0,1.0,1,1.0,1,1.0,1,0.08615907120919362,50
617,1,1246,452,794,0,0,0,1.0,1,1.0,1,1.0,1,0.08351739800325107,52
618,0,1246,452,794,0,0,0,1.0,1,1.0,1,1.0,1,0.08351739800325107,52
619,1,1247,453,794,0,0,0,1.0,1,1.0,1,1.0,1,0.07900028893791071,50
620,2,1249,455,794,0,0,0,1.0,1,1.0,1,1.0,1,0.13004607199319343,50
621,3,1252,457,795,0,0,0,1.0,1,1.0,1,1.0,1,0.11022732262256424,49
622,3,1255,458,797,0,0,0,1.0,1,1.0,1,1.0,1,0.1314467393826147,49
623,2,1257,459,798,0,0,0,1.0,1,1.0,1,1.0,1,0.13123006518625582,48
624,9,1266,462,804,0,0,0,1.0,1,1.0,1,1.0,1,0.15021670267216572,46
625,4,1270,464,806,0,0,0,1.0,1,1.0,1,1.0,1,0.1573547387191151,45
626,2,1272,465,807,0,0,0,1.0,1,1.0,1,1.0,1,0.11712612506731819,44
627,1,1273,466,807,0,0,0,1.0,1,1.0,1,1.0,1,0.13953756766229283,44
628,2,1275,467,808,0,0,0,1.0,1,1.0,1,1.0,1,0.15346510078922498,44
629,0,1275,467,808,0,0,0,1.0,1,1.0,1,1.0,1,0.11242719761681262,41
630,1,1276,468,808,0,0,0,1.0,1,1.0,1,1.0,1,0.16606882732944994,40
631,5,1281,470,811,0,0,0,1.0,1,1.0,1,1.0,1,0.20786149672888468,38
632,6,1287,473,814,0,0,0,1.0,1,1.0,1,1.0,1,0.21265877323967675,38
633,0,1287,473,814,0,0,0,1.0,1,1.0,1,1.0,1,0.2511327615782637,36
634,0,1287,473,814,0,0,0,1.0,1,1.0,1,1.0,1,0.24059572585443714,35
635,1,1288,473,815,0,0,0,1.0,1,1.0,1,1.0,1,0.21267490023626845,35
636,2,1290,473,817,0,0,0,1.0,1,1.0,1,1.0,1,0.20081585245783443,36
637,1,1291,473,818,0,0,0,1.0,1,1.0,1,1.0,1,0.18786356337807122,35
638,0,1291,473,818,0,0,0,1.0,1,1.0,1,1.0,1,0.21423960592449268,34
639,3,1294,475,819,0,0,0,1.0,1,1.0,1,1.0,1,0.18243832992582987,36
640,3,1297,475,822,0,0,0,1.0,1,1.0,1,1.0,1,0.13739083812045075,37
641,0,1297,475,822,0,0,0,1.0,1,1.0,1,1.0,1,0.13739083812045075,37
642,0,1297,475,822,0,0,0,1.0,1,1.0,1,1.0,1,0.11986970151581902,38
643,1,1298,475,823,0,0,0,1.0,1,1.0,1,1.0,1,0.08945508089068756,39
644,1,1299,476,823,0,0,0,1.0,1,1.0,1,1.0,1,0.1070350022753821,39
645,0,1299,476,823,0,0,0,1.0,1,1.0,1,1.0,1,0.12648021906400322,39
646,4,1303,477,826,0,0,0,1.0,1,1.0,1,1.0,1,0.14088040948482536,40
647,0,1303,477,826,0,0,0,1.0,1,1.0,1,1.0,1,0.14088040948482536,40
648,1,1304,478,826,0,0,0,1.0,1,1.0,1,1.0,1,0.1571854410251732,40
649,2,1306,479,827,0,0,0,1.0,1,1.0,1,1.0,1,0.11714919959678609,40
650,5,1311,481,830,0,0,0,1.0,1,1.0,1,1.0,1,0.11786739470878345,41
651,1,1312,481,831,0,0,0,1.0,1,1.0,1,1.0,1,0.09913104172050577,42
652,0,1312,481,831,0,0,0,1.0,1,1.0,1,1.0,1,0.11181402090228659,41
653,0,1312,481,831,0,0,0,1.0,1,1.0,1,1.0,1,0.11181402090228659,41
654,0,1312,481,831,0,0,0,1.0,1,1.0,1,1.0,1,0.12117158668596122,42
655,2,1314,481,833,0,0,0,1.0,1,1.0,1,1.0,1,0.0887528071385803,45
656,5,1319,483,836,0,0,0,1.0,1,1.0,1,1.0,1,0.14226051178250165,45
657,2,1321,484,837,0,0,0,1.0,1,1.0,1,1.0,1,0.18804215007703684,43
658,3,1324,486,838,0,0,0,1.0,1,1.0,1,1.0,1,0.2097950590805709,43
659,4,1328,487,841,0,0,0,1.0,1,1.0,1,1.0,1,0.16076695897666377,43
660,4,1332,489,843,0,0,0,1.0,1,1.0,1,1.0,1,0.18246505186487863,43
661,1,1333,489,844,0,0,0,1.0,1,1.0,1,1.0,1,0.20778872746882407,41
662,2,1335,490,845,0,0,0,1.0,1,1.0,1,1.0,1,0.2491624858475564,40
663,3,1338,491,847,0,0,0,1.0,1,1.0,1,1.0,1,0.21120211932935049,39
664,7,1345,493,852,0,0,0,1.0,1,1.0,1,1.0,1,0.1775919594723581,36
665,1,1346,493,853,0,0,0,1.0,1,1.0,1,1.0,1,0.1675587590592171,36
666,3,1349,495,854,0,0,0,1.0,1,1.0,1,1.0,1,0.1790798479506885,36
667,1,1350,495,855,0,0,0,1.0,1,1.0,1,1.0,1,0.13803942651189324,35
668,2,1352,497,855,0,0,0,1.0,1,1.0,1,1.0,1,0.17685441681477465,34
669,4,1356,500,856,0,0,0,1.0,1,1.0,1,1.0,1,0.17538898518672147,34
670,7,1363,502,861,0,0,0,1.0,1,1.0,1,1.0,1,0.12956030262174834,32
671,5,1368,504,864,0,0,0,1.0,1,1.0,1,1.0,1,0.08117848200453483,33
672,0,1368,504,864,0,0,0,1.0,1,1.0,1,1.0,1,0.11274295134471958,32
673,1,1369,505,864,0,0,0,1.0,1,1.0,1,1.0,1,0.11796361754217403,32
674,1,1370,506,864,0,0,0,1.0,1,1.0,1,1.0,1,0.1672279926624822,32
675,2,1372,507,865,0,0,0,1.0,1,1.0,1,1.0,1,0.15956497189044308,34
676,2,1374,507,867,0,0,0,1.0,1,1.0,1,1.0,1,0.11898931386205441,35
677,1,1375,508,867,0,0,0,1.0,1,1.0,1,1.0,1,0.11310699092339672,35
678,0,1375,508,867,0,0,0,1.0,1,1.0,1,1.0,1,0.11310699092339672,35
679,4,1379,509,870,0,0,0,1.0,1,1.0,1,1.0,1,0.07122030339951113,36
680,0,1379,509,870,0,0,0,1.0,1,1.0,1,1.0,1,0.08141428212144707,37
681,1,1380,510,870,0,0,0,1.0,1,1.0,1,1.0,1,0.13233296944352202,37
682,3,1383,512,871,0,0,0,1.0,1,1.0,1,1.0,1,0.1362520486950423,37
683,1,1384,512,872,0,0,0,1.0,1,1.0,1,1.0,1,0.14142264528659404,38
684,4,1388,513,875,0,0,0,1.0,1,1.0,1,1.0,1,0.09531564663044813,39
685,0,1388,513,875,0,0,0,1.0,1,1.0,1,1.0,1,0.08885030713598141,38
686,0,1388,513,875,0,0,0,1.0,1,1.0,1,1.0,1,0.11876002525819415,37
687,1,1389,514,875,0,0,0,1.0,1,1.0,1,1.0,1,0.1448021770316356,38
688,1,1390,514,876,0,0,0,1.0,1,1.0,1,1.0,1,0.1626264519289442,37
689,1,1391,515,876,0,0,0,1.0,1,1.0,1,1.0,1,0.21460399057290866,39
690,1,1392,515,877,0,0,0,1.0,1,1.0,1,1.0,1,0.20872444813216487,38
691,2,1394,516,878,0,0,0,1.0,1,1.0,1,1.0,1,0.18272184332034708,38
692,1,1395,516,879,0,0,0,1.0,1,1.0,1,1.0,1,0.17159000167659771,38
693,3,1398,517,881,0,0,0,1.0,1,1.0,1,1.0,1,0.16584233716491817,40
694,3,1401,519,882,0,0,0,1.0,1,1.0,1,1.0,1,0.19697495141686291,42
695,2,1403,520,883,0,0,0,1.0,1,1.0,1,1.0,1,0.1593837689950165,40
696,6,1409,522,887,0,0,0,1.0,1,1.0,1,1.0,1,0.154235187999495,39
697,0,1409,522,887,0,0,0,1.0,1,1.0,1,1.0,1,0.15740314756779708,39
698,3,1412,523,889,0,0,0,1.0,1,1.0,1,1.0,1,0.1751691368299556,37
699,0,1412,523,889,0,0,0,1.0,1,1.0,1,1.0,1,0.1725522208904188,37
700,2,1414,523,891,0,0,0,1.0,1,1.0,1,1.0,1,0.18128066202839838,37
701,1,1415,524,891,0,0,0,1.0,1,1.0,1,1.0,1,0.18871485658207446,37
702,1,1416,524,892,0,0,0,1.0,1,1.0,1,1.0,1,0.18448437660625483,38
703,6,1422,528,894,0,0,0,1.0,1,1.0,1,1.0,1,0.22989857970485555,36
704,6,1428,530,898,0,0,0,1.0,1,1.0,1,1.0,1,0.16270382093888888,36
705,2,1430,532,898,0,0,0,1.0,1,1.0,1,1.0,1,0.15085097334088218,36
706,5,1435,536,899,0,0,0,1.0,1,1.0,1,1.0,1,0.1777555513227931,35
707,2,1437,537,900,0,0,0,1.0,1,1.0,1,1.0,1,0.18814369658071148,36
708,2,1439,538,901,0,0,0,1.0,1,1.0,1,1.0,1,0.1928092894941908,36
709,3,1442,538,904,0,0,0,1.0,1,1.0,1,1.0,1,0.1455031050146605,34
710,1,1443,539,904,0,0,0,1.0,1,1.0,1,1.0,1,0.15634393716924966,34
711,0,1443,539,904,0,0,0,1.0,1,1.0,1,1.0,1,0.1487408008837637,34
712,3,1446,540,906,0,0,0,1.0,1,1.0,1,1.0,1,0.17466127363510825,35
713,3,1449,542,907,0,0,0,1.0,1,1.0,1,1.0,1,0.21805085177330616,34
714,1,1450,542,908,0,0,0,1.0,1,1.0,1,1.0,1,0.1959155487204178,34
715,3,1453,542,911,0,0,0,1.0,1,1.0,1,1.0,1,0.11560261910334878,35
716,2,1455,543,912,0,0,0,1.0,1,1.0,1,1.0,1,0.11601176238261074,33
717,4,1459,545,914,0,0,0,1.0,1,1.0,1,1.0,1,0.13862001520046607,33
718,1,1460,545,915,0,0,0,1.0,1,1.0,1,1.0,1,0.116209974689827,32
719,0,1460,545,915,0,0,0,1.0,1,1.0,1,1.0,1,0.116209974689827,32
720,1,1461,546,915,0,0,0,1.0,1,1.0,1,1.0,1,0.1358214493239657,33
721,0,1461,546,915,0,0,0,1.0,1,1.0,1,1.0,1,0.1358214493239657,33
722,0,1461,546,915,0,0,0,1.0,1,1.0,1,1.0,1,0.15352784829129962,34
723,1,1462,546,916,0,0,0,1.0,1,1.0,1,1.0,1,0.12890057929862056,34
724,3,1465,546,919,0,0,0,1.0,1,1.0,1,1.0,1,0.12214889831921134,36
725,0,1465,546,919,0,0,0,1.0,1,1.0,1,1.0,1,0.12214889831921134,36
726,0,1465,546,919,0,0,0,1.0,1,1.0,1,1.0,1,0.12214889831921134,36
727,1,1466,546,920,0,0,0,1.0,1,1.0,1,1.0,1,0.10513031526702606,36
728,0,1466,546,920,0,0,0,1.0,1,1.0,1,1.0,1,0.12293879878277612,37
729,0,1466,546,920,0,0,0,1.0,1,1.0,1,1.0,1,0.1441030838240804,37
730,3,1469,546,923,0,0,0,1.0,1,1.0,1,1.0,1,0.07471404977626875,38
731,2,1471,547,924,0,0,0,1.0,1,1.0,1,1.0,1,0.12875574562719713,39
732,0,1471,547,924,0,0,0,1.0,1,1.0,1,1.0,1,0.12490242114544631,41
733,1,1472,548,924,0,0,0,1.0,1,1.0,1,1.0,1,0.06606807684489475,39
734,1,1473,549,924,0,0,0,1.0,1,1.0,1,1.0,1,0.1476691695069742,39
735,2,1475,551,924,0,0,0,1.0,1,1.0,1,1.0,1,0.1801198620039161,39
736,1,1476,551,925,0,0,0,1.0,1,1.0,1,1.0,1,0.15310479903928936,38
737,2,1478,553,925,0,0,0,1.0,1,1.0,1,1.0,1,0.22119398215483788,39
738,4,1482,553,929,0,0,0,1.0,1,1.0,1,1.0,1,0.21498651735997215,37
739,2,1484,553,931,0,0,0,1.0,1,1.0,1,1.0,1,0.14951083561662273,37
740,1,1485,554,931,0,0,0,1.0,1,1.0,1,1.0,1,0.2227927326321129,35
741,1,1486,554,932,0,0,0,1.0,1,1.0,1,1.0,1,0.21542299313656976,33
742,2,1488,555,933,0,0,0,1.0,1,1.0,1,1.0,1,0.200907991674489,35
743,2,1490,557,933,0,0,0,1.0,1,1.0,1,1.0,1,0.25027745487410674,35
744,2,1492,559,933,0,0,0,1.0,1,1.0,1,1.0,1,0.2153791532039451,34
745,5,1497,561,936,0,0,0,1.0,1,1.0,1,1.0,1,0.205217453636657,34
746,4,1501,563,938,0,0,0,1.0,1,1.0,1,1.0,1,0.18014705362277922,33
747,1,1502,563,939,0,0,0,1.0,1,1.0,1,1.0,1,0.16205877593807247,32
748,1,1503,563,940,0,0,0,1.0,1,1.0,1,1.0,1,0.14303580610324731,33
749,0,1503,563,940,0,0,0,1.0,1,1.0,1,1.0,1,0.14303580610324731,33
750,1,1504,564,940,0,0,0,1.0,1,1.0,1,1.0,1,0.1413538699482333,34
751,2,1506,565,941,0,0,0,1.0,1,1.0,1,1.0,1,0.14819629790356192,36
752,3,1509,568,941,0,0,0,1.0,1,1.0,1,1.0,1,0.1352008194775112,35
753,4,1513,570,943,0,0,0,1.0,1,1.0,1,1.0,1,0.21544050645546134,37
754,5,1518,571,947,0,0,0,1.0,1,1.0,1,1.0,1,0.09210289393224308,37
755,2,1520,572,948,0,0,0,1.0,1,1.0,1,1.0,1,0.10739719644639696,35
756,1,1521,572,949,0,0,0,1.0,1,1.0,1,1.0,1,0.09255398265652437,36
757,1,1522,572,950,0,0,0,1.0,1,1.0,1,1.0,1,0.12196904960980576,35
758,0,1522,572,950,0,0,0,1.0,1,1.0,1,1.0,1,0.08836301287966973,36
759,1,1523,573,950,0,0,0,1.0,1,1.0,1,1.0,1,0.08324402578136163,37
760,0,1523,573,950,0,0,0,1.0,1,1.0,1,1.0,1,0.11578067313005933,36
761,0,1523,573,950,0,0,0,1.0,1,1.0,1,1.0,1,0.11578067313005933,36
762,0,1523,573,950,0,0,0,1.0,1,1.0,1,1.0,1,0.12629526738004376,37
763,2,1525,573,952,0,0,0,1.0,1,1.0,1,1.0,1,0.11833643981703425,38
764,1,1526,573,953,0,0,0,1.0,1,1.0,1,1.0,1,0.08754465548454363,38
765,0,1526,573,953,0,0,0,1.0,1,1.0,1,1.0,1,0.08754465548454363,38
766,0,1526,573,953,0,0,0,1.0,1,1.0,1,1.0,1,0.06352773423026144,40
767,0,1526,573,953,0,0,0,1.0,1,1.0,1,1.0,1,0.08483105495812986,41
768,3,1529,575,954,0,0,0,1.0,1,1.0,1,1.0,1,0.11997241132643632,41
769,4,1533,576,957,0,0,0,1.0,1,1.0,1,1.0,1,0.11533509500110986,42
770,2,1535,576,959,0,0,0,1.0,1,1.0,1,1.0,1,0.12085999326995372,41
771,2,1537,576,961,0,0,0,1.0,1,1.0,1,1.0,1,0.14043780715836351,41
772,5,1542,577,965,0,0,0,1.0,1,1.0,1,1.0,1,0.1323020597834919,41
773,0,1542,577,965,0,0,0,1.0,1,1.0,1,1.0,1,0.1272971140578375,41
774,5,1547,579,968,0,0,0,1.0,1,1.0,1,1.0,1,0.19353228482393303,42
775,3,1550,579,971,0,0,0,1.0,1,1.0,1,1.0,1,0.13298653940107316,42
776,0,1550,579,971,0,0,0,1.0,1,1.0,1,1.0,1,0.13298653940107316,42
777,0,1550,579,971,0,0,0,1.0,1,1.0,1,1.0,1,0.13298653940107316,42
778,4,1554,580,974,0,0,0,1.0,1,1.0,1,1.0,1,0.12994386334720623,44
779,0,1554,580,974,0,0,0,1.0,1,1.0,1,1.0,1,0.12994386334720623,44
780,0,1554,580,974,0,0,0,1.0,1,1.0,1,1.0,1,0.12994386334720623,44
781,2,1556,580,976,0,0,0,1.0,1,1.0,1,1.0,1,0.09085265256082362,46
782,4,1560,582,978,0,0,0,1.0,1,1.0,1,1.0,1,0.14853027593459917,45
783,3,1563,583,980,0,0,0,1.0,1,1.0,1,1.0,1,0.16548630057382716,44
784,3,1566,583,983,0,0,0,1.0,1,1.0,1,1.0,1,0.1110359713992391,44
785,1,1567,584,983,0,0,0,1.0,1,1.0,1,1.0,1,0.12883407141992448,43
786,1,1568,585,983,0,0,0,1.0,1,1.0,1,1.0,1,0.1208684224970293,43
787,1,1569,585,984,0,0,0,1.0,1,1.0,1,1.0,1,0.09321534455833226,43
788,4,1573,587,986,0,0,0,1.0,1,1.0,1,1.0,1,0.14971214699942323,45
789,1,1574,588,986,0,0,0,1.0,1,1.0,1,1.0,1,0.14836780834113583,46
790,3,1577,588,989,0,0,0,1.0,1,1.0,1,1.0,1,0.13526660324918544,45
791,3,1580,589,991,0,0,0,1.0,1,1.0,1,1.0,1,0.11986403818657773,46
792,0,1580,589,991,0,0,0,1.0,1,1.0,1,1.0,1,0.12534410999498896,46
793,1,1581,590,991,0,0,0,1.0,1,1.0,1,1.0,1,0.12656005958760683,46
794,4,1585,591,994,0,0,0,1.0,1,1.0,1,1.0,1,0.13196589452739857,47
795,2,1587,591,996,0,0,0,1.0,1,1.0,1,1.0,1,0.10953136627728596,47
796,2,1589,592,997,0,0,0,1.0,1,1.0,1,1.0,1,0.11201762284521616,46
797,1,1590,593,997,0,0,0,1.0,1,1.0,1,1.0,1,0.15853454755273935,47
798,3,1593,595,998,0,0,0,1.0,1,1.0,1,1.0,1,0.18917706324886918,48
799,8,1601,595,1006,0,0,0,1.0,1,1.0,1,1.0,1,0.07487955640894678,48
800,2,1603,596,1007,0,0,0,1.0,1,1.0,1,1.0,1,0.091294963198097,48
801,1,1604,596,1008,0,0,0,1.0,1,1.0,1,1.0,1,0.10740309069664841,49
802,2,1606,596,1010,0,0,0,1.0,1,1.0,1,1.0,1,0.08944311048527544,50
803,0,1606,596,1010,0,0,0,1.0,1,1.0,1,1.0,1,0.09984420520237589,49
804,2,1608,596,1012,0,0,0,1.0,1,1.0,1,1.0,1,0.11164612996844665,50
805,0,1608,596,1012,0,0,0,1.0,1,1.0,1,1.0,1,0.11164612996844665,50
806,0,1608,596,1012,0,0,0,1.0,1,1.0,1,1.0,1,0.11164612996844665,50
807,2,1610,596,1014,0,0,0,1.0,1,1.0,1,1.0,1,0.09353599064746468,51
808,1,1611,597,1014,0,0,0,1.0,1,1.0,1,1.0,1,0.11549631496710026,51
809,3,1614,599,1015,0,0,0,1.0,1,1.0,1,1.0,1,0.11499930282016836,51
810,3,1617,600,1017,0,0,0,1.0,1,1.0,1,1.0,1,0.11533182502449923,52
811,2,1619,601,1018,0,0,0,1.0,1,1.0,1,1.0,1,0.10261800911421769,50
812,2,1621,603,1018,0,0,0,1.0,1,1.0,1,1.0,1,0.16475418061373295,48
813,3,1624,604,1020,0,0,0,1.0,1,1.0,1,1.0,1,0.17090795497954844,49
814,3,1627,604,1023,0,0,0,1.0,1,1.0,1,1.0,1,0.09789352480311289,48
815,3,1630,606,1024,0,0,0,1.0,1,1.0,1,1.0,1,0.1202388833741076,48
816,1,1631,607,1024,0,0,0,1.0,1,1.0,1,1.0,1,0.14708993930856926,46
817,3,1634,607,1027,0,0,0,1.0,1,1.0,1,1.0,1,0.14167872455100022,44
818,1,1635,607,1028,0,0,0,1.0,1,1.0,1,1.0,1,0.12586104666067172,46
819,1,1636,608,1028,0,0,0,1.0,1,1.0,1,1.0,1,0.14932817631344827,44
820,1,1637,608,1029,0,0,0,1.0,1,1.0,1,1.0,1,0.14951121847431365,44
821,1,1638,608,1030,0,0,0,1.0,1,1.0,1,1.0,1,0.11803484105419276,44
822,2,1640,610,1030,0,0,0,1.0,1,1.0,1,1.0,1,0.16471228497751278,44
823,3,1643,611,1032,0,0,0,1.0,1,1.0,1,1.0,1,0.10547105327244115,42
824,3,1646,614,1032,0,0,0,1.0,1,1.0,1,1.0,1,0.1320566575790788,42
825,2,1648,616,1032,0,0,0,1.0,1,1.0,1,1.0,1,0.15805771150600897,40
826,8,1656,620,1036,0,0,0,1.0,1,1.0,1,1.0,1,0.14266880782861674,41
827,5,1661,623,1038,0,0,0,1.0,1,1.0,1,1.0,1,0.19254403112062665,40
828,6,1667,626,1041,0,0,0,1.0,1,1.0,1,1.0,1,0.17165125201544537,40
829,4,1671,627,1044,0,0,0,1.0,1,1.0,1,1.0,1,0.1507715412641013,42
830,3,1674,628,1046,0,0,0,1.0,1,1.0,1,1.0,1,0.136982131038645,42
831,5,1679,629,1050,0,0,0,1.0,1,1.0,1,1.0,1,0.10904769685729859,43
832,2,1681,630,1051,0,0,0,1.0,1,1.0,1,1.0,1,0.08634683476303455,42
833,0,1681,630,1051,0,0,0,1.0,1,1.0,1,1.0,1,0.10440384030855815,41
834,2,1683,632,1051,0,0,0,1.0,1,1.0,1,1.0,1,0.1463384811989426,41
835,0,1683,632,1051,0,0,0,1.0,1,1.0,1,1.0,1,0.14177522509691212,41
836,0,1683,632,1051,0,0,0,1.0,1,1.0,1,1.0,1,0.12646662777879444,40
837,1,1684,632,1052,0,0,0,1.0,1,1.0,1,1.0,1,0.12269056133723874,41
838,2,1686,633,1053,0,0,0,1.0,1,1.0,1,1.0,1,0.12183736840718361,41
839,2,1688,634,1054,0,0,0,1.0,1,1.0,1,1.0,1,0.12795007364489103,41
840,3,1691,636,1055,0,0,0,1.0,1,1.0,1,1.0,1,0.18269190067870383,42
841,3,1694,637,1057,0,0,0,1.0,1,1.0,1,1.0,1,0.13709145242991055,42
842,1,1695,637,1058,0,0,0,1.0,1,1.0,1,1.0,1,0.13437279516042153,42
843,1,1696,638,1058,0,0,0,1.0,1,1.0,1,1.0,1,0.13723846558512176,42
844,0,1696,638,1058,0,0,0,1.0,1,1.0,1,1.0,1,0.15580898234719018,42
845,4,1700,638,1062,0,0,0,1.0,1,1.0,1,1.0,1,0.16298476766578568,44
846,2,1702,639,1063,0,0,0,1.0,1,1.0,1,1.0,1,0.17072175577395687,44
847,1,1703,640,1063,0,0,0,1.0,1,1.0,1,1.0,1,0.17867086105406582,42
848,3,1706,641,1065,0,0,0,1.0,1,1.0,1,1.0,1,0.19832490284929663,43
849,2,1708,641,1067,0,0,0,1.0,1,1.0,1,1.0,1,0.17301753434238085,43
850,5,1713,641,1072,0,0,0,1.0,1,1.0,1,1.0,1,0.1437554411243366,41
851,2,1715,642,1073,0,0,0,1.0,1,1.0,1,1.0,1,0.12650530304356955,40
852,1,1716,642,1074,0,0,0,1.0,1,1.0,1,1.0,1,0.14070261685940919,40
853,6,1722,643,1079,0,0,0,1.0,1,1.0,1,1.0,1,0.1325038415863787,40
854,4,1726,645,1081,0,0,0,1.0,1,1.0,1,1.0,1,0.16850991538725116,40
855,4,1730,646,1084,0,0,0,1.0,1,1.0,1,1.0,1,0.15379692183416505,41
856,3,1733,647,1086,0,0,0,1.0,1,1.0,1,1.0,1,0.13166816159290493,41
857,1,1734,648,1086,0,0,0,1.0,1,1.0,1,1.0,1,0.14486596577246832,42
858,2,1736,648,1088,0,0,0,1.0,1,1.0,1,1.0,1,0.08038156136212973,43
859,0,1736,648,1088,0,0,0,1.0,1,1.0,1,1.0,1,0.08038156136212973,43
860,0,1736,648,1088,0,0,0,1.0,1,1.0,1,1.0,1,0.09079550334195263,44
861,1,1737,649,1088,0,0,0,1.0,1,1.0,1,1.0,1,0.09615079606802875,44
862,0,1737,649,1088,0,0,0,1.0,1,1.0,1,1.0,1,0.09615079606802875,44
863,3,1740,651,1089,0,0,0,1.0,1,1.0,1,1.0,1,0.11993768334315737,44
864,5,1745,653,1092,0,0,0,1.0,1,1.0,1,1.0,1,0.12585399832465,44
865,2,1747,655,1092,0,0,0,1.0,1,1.0,1,1.0,1,0.10852154465209825,43
866,7,1754,658,1096,0,0,0,1.0,1,1.0,1,1.0,1,0.11291115985178946,45
867,2,1756,658,1098,0,0,0,1.0,1,1.0,1,1.0,1,0.14196438977274706,44
868,4,1760,659,1101,0,0,0,1.0,1,1.0,1,1.0,1,0.12345649158460571,45
869,6,1766,662,1104,0,0,0,1.0,1,1.0,1,1.0,1,0.12471900983381337,44
870,2,1768,663,1105,0,0,0,1.0,1,1.0,1,1.0,1,0.145284187706423,44
871,8,1776,664,1112,0,0,0,1.0,1,1.0,1,1.0,1,0.10281669059408101,43
872,1,1777,664,1113,0,0,0,1.0,1,1.0,1,1.0,1,0.06117128161356696,43
873,1,1778,665,1113,0,0,0,1.0,1,1.0,1,1.0,1,0.10167876900552648,43
874,1,1779,665,1114,0,0,0,1.0,1,1.0,1,1.0,1,0.08936913389473061,46
875,2,1781,666,1115,0,0,0,1.0,1,1.0,1,1.0,1,0.10282353986727875,43
876,0,1781,666,1115,0,0,0,1.0,1,1.0,1,1.0,1,0.11064571987880152,44
877,4,1785,666,1119,0,0,0,1.0,1,1.0,1,1.0,1,0.09252784958417583,44
878,0,1785,666,1119,0,0,0,1.0,1,1.0,1,1.0,1,0.09252784958417583,44
879,0,1785,666,1119,0,0,0,1.0,1,1.0,1,1.0,1,0.09252784958417583,44
880,2,1787,668,1119,0,0,0,1.0,1,1.0,1,1.0,1,0.1412848759276376,44
881,0,1787,668,1119,0,0,0,1.0,1,1.0,1,1.0,1,0.1259203925697039,43
882,2,1789,669,1120,0,0,0,1.0,1,1.0,1,1.0,1,0.10277796804338958,45
883,1,1790,669,1121,0,0,0,1.0,1,1.0,1,1.0,1,0.10971885223096857,45
884,3,1793,671,1122,0,0,0,1.0,1,1.0,1,1.0,1,0.13268435143914786,45
885,1,1794,672,1122,0,0,0,1.0,1,1.0,1,1.0,1,0.11742561671795189,43
886,6,1800,673,1127,0,0,0,1.0,1,1.0,1,1.0,1,0.1361454209896439,43
887,4,1804,675,1129,0,0,0,1.0,1,1.0,1,1.0,1,0.12634781282112115,41
888,1,1805,675,1130,0,0,0,1.0,1,1.0,1,1.0,1,0.11157936005631891,40
889,0,1805,675,1130,0,0,0,1.0,1,1.0,1,1.0,1,0.11157936005631891,40
890,1,1806,676,1130,0,0,0,1.0,1,1.0,1,1.0,1,0.08876081658998605,38
891,1,1807,677,1130,0,0,0,1.0,1,1.0,1,1.0,1,0.10408184011220217,39
892,6,1813,680,1133,0,0,0,1.0,1,1.0,1,1.0,1,0.16737875893531293,39
893,1,1814,680,1134,0,0,0,1.0,1,1.0,1,1.0,1,0.13463110693702107,37
894,2,1816,682,1134,0,0,0,1.0,1,1.0,1,1.0,1,0.21712016101201667,36
895,4,1820,682,1138,0,0,0,1.0,1,1.0,1,1.0,1,0.1608994573600957,37
896,3,1823,684,1139,0,0,0,1.0,1,1.0,1,1.0,1,0.21980969247262958,36
897,1,1824,685,1139,0,0,0,1.0,1,1.0,1,1.0,1,0.20512139770047297,36
898,2,1826,686,1140,0,0,0,1.0,1,1.0,1,1.0,1,0.19675836770050628,35
899,1,1827,687,1140,0,0,0,1.0,1,1.0,1,1.0,1,0.2160305269051532,35
900,0,1827,687,1140,0,0,0,1.0,1,1.0,1,1.0,1,0.2482479670444313,36
901,0,1827,687,1140,0,0,0,1.0,1,1.0,1,1.0,1,0.2482479670444313,36
902,6,1833,691,1142,0,0,0,1.0,1,1.0,1,1.0,1,0.3094405453524725,36
903,2,1835,691,1144,0,0,0,1.0,1,1.0,1,1.0,1,0.2707875630680662,35
904,4,1839,693,1146,0,0,0,1.0,1,1.0,1,1.0,1,0.20178091075855964,37
905,3,1842,695,1147,0,0,0,1.0,1,1.0,1,1.0,1,0.1946483746493121,36
906,3,1845,696,1149,0,0,0,1.0,1,1.0,1,1.0,1,0.17566510279941747,37
907,5,1850,698,1152,0,0,0,1.0,1,1.0,1,1.0,1,0.09219467384354965,37
908,6,1856,701,1155,0,0,0,1.0,1,1.0,1,1.0,1,0.1373227256334398,36
909,0,1856,701,1155,0,0,0,1.0,1,1.0,1,1.0,1,0.13513383574564716,36
910,2,1858,702,1156,0,0,0,1.0,1,1.0,1,1.0,1,0.14980340092172476,37
911,2,1860,703,1157,0,0,0,1.0,1,1.0,1,1.0,1,0.19907988989207606,36
912,1,1861,704,1157,0,0,0,1.0,1,1.0,1,1.0,1,0.18310272443024564,34
913,2,1863,704,1159,0,0,0,1.0,1,1.0,1,1.0,1,0.16543456861603592,34
914,2,1865,705,1160,0,0,0,1.0,1,1.0,1,1.0,1,0.1677481465696915,33
915,1,1866,705,1161,0,0,0,1.0,1,1.0,1,1.0,1,0.17867567221010078,33
916,2,1868,705,1163,0,0,0,1.0,1,1.0,1,1.0,1,0.14839854240306677,34
917,1,1869,706,1163,0,0,0,1.0,1,1.0,1,1.0,1,0.14395462451620686,34
918,3,1872,706,1166,0,0,0,1.0,1,1.0,1,1.0,1,0.12192642543258086,36
919,0,1872,706,1166,0,0,0,1.0,1,1.0,1,1.0,1,0.12192642543258086,36
920,0,1872,706,1166,0,0,0,1.0,1,1.0,1,1.0,1,0.12239149709156083,37
921,0,1872,706,1166,0,0,0,1.0,1,1.0,1,1.0,1,0.12239149709156083,37
922,2,1874,707,1167,0,0,0,1.0,1,1.0,1,1.0,1,0.11092370288801537,38
923,1,1875,708,1167,0,0,0,1.0,1,1.0,1,1.0,1,0.12325861123481975,36
924,2,1877,710,1167,0,0,0,1.0,1,1.0,1,1.0,1,0.16846564799655092,35
925,6,1883,711,1172,0,0,0,1.0,1,1.0,1,1.0,1,0.17600728117430064,35
926,3,1886,712,1174,0,0,0,1.0,1,1.0,1,1.0,1,0.11838277294245834,34
927,0,1886,712,1174,0,0,0,1.0,1,1.0,1,1.0,1,0.1450173580999189,32
928,1,1887,713,1174,0,0,0,1.0,1,1.0,1,1.0,1,0.19923930914278748,32
929,3,1890,715,1175,0,0,0,1.0,1,1.0,1,1.0,1,0.19549273567577338,31
930,1,1891,715,1176,0,0,0,1.0,1,1.0,1,1.0,1,0.1834923082515937,30
931,3,1894,716,1178,0,0,0,1.0,1,1.0,1,1.0,1,0.20644458479202418,29
932,0,1894,716,1178,0,0,0,1.0,1,1.0,1,1.0,1,0.20644458479202418,29
933,2,1896,716,1180,0,0,0,1.0,1,1.0,1,1.0,1,0.18347125955428345,29
934,0,1896,716,1180,0,0,0,1.0,1,1.0,1,1.0,1,0.18347125955428345,29
935,1,1897,716,1181,0,0,0,1.0,1,1.0,1,1.0,1,0.18646651234470984,31
936,2,1899,717,1182,0,0,0,1.0,1,1.0,1,1.0,1,0.1585751285463777,31
937,0,1899,717,1182,0,0,0,1.0,1,1.0,1,1.0,1,0.16711612522679853,34
938,0,1899,717,1182,0,0,0,1.0,1,1.0,1,1.0,1,0.17693274038067,33
939,2,1901,717,1184,0,0,0,1.0,1,1.0,1,1.0,1,0.1712068923793186,36
940,2,1903,717,1186,0,0,0,1.0,1,1.0,1,1.0,1,0.14414227442796398,36
941,3,1906,719,1187,0,0,0,1.0,1,1.0,1,1.0,1,0.18749469607820937,36
942,4,1910,720,1190,0,0,0,1.0,1,1.0,1,1.0,1,0.1756903603815696,36
943,4,1914,720,1194,0,0,0,1.0,1,1.0,1,1.0,1,0.08767704446931779,35
944,1,1915,721,1194,0,0,0,1.0,1,1.0,1,1.0,1,0.08107100396314565,35
945,2,1917,722,1195,0,0,0,1.0,1,1.0,1,1.0,1,0.11676135072677489,33
946,3,1920,724,1196,0,0,0,1.0,1,1.0,1,1.0,1,0.12726832821237047,36
947,1,1921,725,1196,0,0,0,1.0,1,1.0,1,1.0,1,0.17077549868349953,34
948,1,1922,726,1196,0,0,0,1.0,1,1.0,1,1.0,1,0.24128989388291278,33
949,5,1927,727,1200,0,0,0,1.0,1,1.0,1,1.0,1,0.2528098230387634,34
950,0,1927,727,1200,0,0,0,1.0,1,1.0,1,1.0,1,0.2807802691819868,33
951,0,1927,727,1200,0,0,0,1.0,1,1.0,1,1.0,1,0.2807802691819868,33
952,2,1929,727,1202,0,0,0,1.0,1,1.0,1,1.0,1,0.25919057201496337,32
953,0,1929,727,1202,0,0,0,1.0,1,1.0,1,1.0,1,0.25919057201496337,32
954,2,1931,727,1204,0,0,0,1.0,1,1.0,1,1.0,1,0.25066448067404895,31
955,1,1932,727,1205,0,0,0,1.0,1,1.0,1,1.0,1,0.2278114018652,32
956,2,1934,728,1206,0,0,0,1.0,1,1.0,1,1.0,1,0.1878266277557078,32
957,3,1937,728,1209,0,0,0,1.0,1,1.0,1,1.0,1,0.13022137941500556,33
958,0,1937,728,1209,0,0,0,1.0,1,1.0,1,1.0,1,0.14809473615071217,35
959,1,1938,729,1209,0,0,0,1.0,1,1.0,1,1.0,1,0.17139196561140796,36
960,1,1939,729,1210,0,0,0,1.0,1,1.0,1,1.0,1,0.15092847915843716,38
961,2,1941,731,1210,0,0,0,1.0,1,1.0,1,1.0,1,0.2244590569923662,37
962,3,1944,732,1212,0,0,0,1.0,1,1.0,1,1.0,1,0.3073697259005881,35
963,0,1944,732,1212,0,0,0,1.0,1,1.0,1,1.0,1,0.28789418528074623,35
964,5,1949,732,1217,0,0,0,1.0,1,1.0,1,1.0,1,0.16007232848250633,34
965,2,1951,732,1219,0,0,0,1.0,1,1.0,1,1.0,1,0.11676958981249812,35
966,3,1954,732,1222,0,0,0,1.0,1,1.0,1,1.0,1,0.1350866416951253,34
967,3,1957,733,1224,0,0,0,1.0,1,1.0,1,1.0,1,0.13220714185008023,35
968,0,1957,733,1224,0,0,0,1.0,1,1.0,1,1.0,1,0.11903950134458044,36
969,1,1958,734,1224,0,0,0,1.0,1,1.0,1,1.0,1,0.17204872146983916,35
970,3,1961,734,1227,0,0,0,1.0,1,1.0,1,1.0,1,0.13646287581744446,34
971,0,1961,734,1227,0,0,0,1.0,1,1.0,1,1.0,1,0.1286996801976219,35
972,1,1962,735,1227,0,0,0,1.0,1,1.0,1,1.0,1,0.11564115568635457,35
973,0,1962,735,1227,0,0,0,1.0,1,1.0,1,1.0,1,0.12861884135075943,36
974,0,1962,735,1227,0,0,0,1.0,1,1.0,1,1.0,1,0.1584488841816034,35
975,0,1962,735,1227,0,0,0,1.0,1,1.0,1,1.0,1,0.1351137234651816,36
976,2,1964,736,1228,0,0,0,1.0,1,1.0,1,1.0,1,0.16591346120170855,38
977,0,1964,736,1228,0,0,0,1.0,1,1.0,1,1.0,1,0.16591346120170855,38
978,0,1964,736,1228,0,0,0,1.0,1,1.0,1,1.0,1,0.16591346120170855,38
979,1,1965,736,1229,0,0,0,1.0,1,1.0,1,1.0,1,0.14754798212433956,39
980,1,1966,737,1229,0,0,0,1.0,1,1.0,1,1.0,1,0.16761057941248259,39
981,2,1968,738,1230,0,0,0,1.0,1,1.0,1,1.0,1,0.1801246220383401,40
982,6,1974,741,1233,0,0,0,1.0,1,1.0,1,1.0,1,0.18313077988099297,40
983,1,1975,742,1233,0,0,0,1.0,1,1.0,1,1.0,1,0.15820249242046552,38
984,1,1976,742,1234,0,0,0,1.0,1,1.0,1,1.0,1,0.1278740317361817,39
985,3,1979,745,1234,0,0,0,1.0,1,1.0,1,1.0,1,0.21311898003903643,38
986,4,1983,747,1236,0,0,0,1.0,1,1.0,1,1.0,1,0.22310957004131612,38
987,5,1988,749,1239,0,0,0,1.0,1,1.0,1,1.0,1,0.19936735224010085,38
988,3,1991,749,1242,0,0,0,1.0,1,1.0,1,1.0,1,0.1530195815380328,38
989,4,1995,749,1246,0,0,0,1.0,1,1.0,1,1.0,1,0.15295303933499751,38
990,2,1997,749,1248,0,0,0,1.0,1,1.0,1,1.0,1,0.13381754820508152,38
991,2,1999,750,1249,0,0,0,1.0,1,1.0,1,1.0,1,0.1103105453855859,40
992,1,2000,751,1249,0,0,0,1.0,1,1.0,1,1.0,1,0.12198203322103318,39
993,0,2000,751,1249,0,0,0,1.0,1,1.0,1,1.0,1,0.11003410392634483,38
994,0,2000,751,1249,0,0,0,1.0,1,1.0,1,1.0,1,0.1243591761549837,39
995,0,2000,751,1249,0,0,0,1.0,1,1.0,1,1.0,1,0.12523199167138183,41
996,0,2000,751,1249,0,0,0,1.0,1,1.0,1,1.0,1,0.14432453968176703,40
997,2,2002,751,1251,0,0,0,1.0,1,1.0,1,1.0,1,0.12145742680606865,41
998,2,2004,751,1253,0,0,0,1.0,1,1.0,1,1.0,1,0.08991103176651265,40
999,1,2005,751,1254,0,0,0,1.0,1,1.0,1,1.0,1,0.13523686941290183,40
1000,1,2006,752,1254,0,0,0,1.0,1,1.0,1,1.0,1,0.13072592969670654,40
1001,0,2006,752,1254,0,0,0,1.0,1,1.0,1,1.0,1,0.14580085653234265,39
1002,0,2006,752,1254,0,0,0,1.0,1,1.0,1,1.0,1,0.14580085653234265,39
1003,0,2006,752,1254,0,0,0,1.0,1,1.0,1,1.0,1,0.14580085653234265,39
1004,0,2006,752,1254,0,0,0,1.0,1,1.0,1,1.0,1,0.14580085653234265,39
1005,1,2007,752,1255,0,0,0,1.0,1,1.0,1,1.0,1,0.12491420496566004,40
1006,3,2010,753,1257,0,0,0,1.0,1,1.0,1,1.0,1,0.122948662517193,41
1007,1,2011,753,1258,0,0,0,1.0,1,1.0,1,1.0,1,0.11175916286526123,42
1008,1,2012,754,1258,0,0,0,1.0,1,1.0,1,1.0,1,0.12192689906899024,43
1009,0,2012,754,1258,0,0,0,1.0,1,1.0,1,1.0,1,0.12150242163844295,44
1010,0,2012,754,1258,0,0,0,1.0,1,1.0,1,1.0,1,0.12150242163844295,44
1011,1,2013,755,1258,0,0,0,1.0,1,1.0,1,1.0,1,0.15747876206633477,44
1012,6,2019,757,1262,0,0,0,1.0,1,1.0,1,1.0,1,0.14301971059499177,46
1013,1,2020,757,1263,0,0,0,1.0,1,1.0,1,1.0,1,0.12735957002141282,46
1014,3,2023,758,1265,0,0,0,1.0,1,1.0,1,1.0,1,0.15363024626353133,46
1015,0,2023,758,1265,0,0,0,1.0,1,1.0,1,1.0,1,0.15363024626353133,46
1016,1,2024,759,1265,0,0,0,1.0,1,1.0,1,1.0,1,0.170487571434059,47
1017,2,2026,759,1267,0,0,0,1.0,1,1.0,1,1.0,1,0.15594559713578948,47
1018,3,2029,759,1270,0,0,0,1.0,1,1.0,1,1.0,1,0.13437761454072839,48
1019,4,2033,760,1273,0,0,0,1.0,1,1.0,1,1.0,1,0.11279088546672024,49
1020,2,2035,760,1275,0,0,0,1.0,1,1.0,1,1.0,1,0.10965546959780595,51
1021,0,2035,760,1275,0,0,0,1.0,1,1.0,1,1.0,1,0.10965546959780595,51
1022,0,2035,760,1275,0,0,0,1.0,1,1.0,1,1.0,1,0.11167239170133882,52
1023,1,2036,760,1276,0,0,0,1.0,1,1.0,1,1.0,1,0.10934432008797547,52
1024,1,2037,761,1276,0,0,0,1.0,1,1.0,1,1.0,1,0.13978471936445153,52
1025,1,2038,761,1277,0,0,0,1.0,1,1.0,1,1.0,1,0.14131298541163517,54
1026,2,2040,762,1278,0,0,0,1.0,1,1.0,1,1.0,1,0.13430327967658828,54
1027,2,2042,763,1279,0,0,0,1.0,1,1.0,1,1.0,1,0.11065415649908768,55
1028,3,2045,764,1281,0,0,0,1.0,1,1.0,1,1.0,1,0.10196770232312405,56
1029,0,2045,764,1281,0,0,0,1.0,1,1.0,1,1.0,1,0.10196770232312405,56
1030,2,2047,764,1283,0,0,0,1.0,1,1.0,1,1.0,1,0.0988583268077486,57
1031,0,2047,764,1283,0,0,0,1.0,1,1.0,1,1.0,1,0.08519068933453863,58
1032,1,2048,765,1283,0,0,0,1.0,1,1.0,1,1.0,1,0.09573726042829736,58
1033,3,2051,766,1285,0,0,0,1.0,1,1.0,1,1.0,1,0.060459500345745855,57
1034,1,2052,767,1285,0,0,0,1.0,1,1.0,1,1.0,1,0.08973523452139263,57
1035,3,2055,769,1286,0,0,0,1.0,1,1.0,1,1.0,1,0.11635506645528412,57
1036,4,2059,770,1289,0,0,0,1.0,1,1.0,1,1.0,1,0.09548861195857997,59
1037,2,2061,772,1289,0,0,0,1.0,1,1.0,1,1.0,1,0.106629523699816,57
1038,8,2069,774,1295,0,0,0,1.0,1,1.0,1,1.0,1,0.10987651632606987,59
1039,6,2075,780,1295,0,0,0,1.0,1,1.0,1,1.0,1,0.13353126238244456,57
1040,4,2079,781,1298,0,0,0,1.0,1,1.0,1,1.0,1,0.15535697232050036,56
1041,0,2079,781,1298,0,0,0,1.0,1,1.0,1,1.0,1,0.14733907016486808,54
1042,2,2081,781,1300,0,0,0,1.0,1,1.0,1,1.0,1,0.09712193664845088,52
1043,1,2082,782,1300,0,0,0,1.0,1,1.0,1,1.0,1,0.11443907115213554,52
1044,1,2083,783,1300,0,0,0,1.0,1,1.0,1,1.0,1,0.10381223232782855,50
1045,6,2089,784,1305,0,0,0,1.0,1,1.0,1,1.0,1,0.09472214985791393,51
1046,3,2092,785,1307,0,0,0,1.0,1,1.0,1,1.0,1,0.10152862078693649,50
1047,1,2093,785,1308,0,0,0,1.0,1,1.0,1,1.0,1,0.08146389351808951,50
1048,1,2094,786,1308,0,0,0,1.0,1,1.0,1,1.0,1,0.08613863018584823,50
1049,1,2095,787,1308,0,0,0,1.0,1,1.0,1,1.0,1,0.11761700926253357,50
1050,0,2095,787,1308,0,0,0,1.0,1,1.0,1,1.0,1,0.11761700926253357,50
1051,1,2096,787,1309,0,0,0,1.0,1,1.0,1,1.0,1,0.08177459827391184,50
1052,2,2098,787,1311,0,0,0,1.0,1,1.0,1,1.0,1,0.09067672972943407,51
1053,0,2098,787,1311,0,0,0,1.0,1,1.0,1,1.0,1,0.09067672972943407,51
1054,1,2099,787,1312,0,0,0,1.0,1,1.0,1,1.0,1,0.07309136261364761,53
1055,2,2101,787,1314,0,0,0,1.0,1,1.0,1,1.0,1,0.036525016068071806,54
1056,0,2101,787,1314,0,0,0,1.0,1,1.0,1,1.0,1,0.07273233038290135,54
1057,3,2104,789,1315,0,0,0,1.0,1,1.0,1,1.0,1,0.10125223703865281,55
1058,1,2105,789,1316,0,0,0,1.0,1,1.0,1,1.0,1,0.09201739617788593,54
1059,3,2108,791,1317,0,0,0,1.0,1,1.0,1,1.0,1,0.16009109311883435,53
1060,3,2111,791,1320,0,0,0,1.0,1,1.0,1,1.0,1,0.11270130400423542,53
1061,2,2113,792,1321,0,0,0,1.0,1,1.0,1,1.0,1,0.136716874664028,53
1062,5,2118,797,1321,0,0,0,1.0,1,1.0,1,1.0,1,0.1265105745044299,54
1063,5,2123,797,1326,0,0,0,1.0,1,1.0,1,1.0,1,0.09241773390185146,53
1064,6,2129,801,1328,0,0,0,1.0,1,1.0,1,1.0,1,0.1311961703419222,55
1065,0,2129,801,1328,0,0,0,1.0,1,1.0,1,1.0,1,0.1763591872281554,54
1066,4,2133,803,1330,0,0,0,1.0,1,1.0,1,1.0,1,0.15033972946695898,55
1067,2,2135,804,1331,0,0,0,1.0,1,1.0,1,1.0,1,0.17398630007762755,55
1068,2,2137,805,1332,0,0,0,1.0,1,1.0,1,1.0,1,0.17408677387565813,55
1069,6,2143,806,1337,0,0,0,1.0,1,1.0,1,1.0,1,0.1459370563736504,55
1070,1,2144,806,1338,0,0,0,1.0,1,1.0,1,1.0,1,0.1585718320214583,54
1071,1,2145,806,1339,0,0,0,1.0,1,1.0,1,1.0,1,0.13449281238933378,55
1072,2,2147,807,1340,0,0,0,1.0,1,1.0,1,1.0,1,0.12441963715646534,54
1073,2,2149,808,1341,0,0,0,1.0,1,1.0,1,1.0,1,0.10954656323052299,54
1074,2,2151,810,1341,0,0,0,1.0,1,1.0,1,1.0,1,0.12619367297400624,52
1075,5,2156,812,1344,0,0,0,1.0,1,1.0,1,1.0,1,0.12687454682670798,51
1076,2,2158,812,1346,0,0,0,1.0,1,1.0,1,1.0,1,0.1402313557016555,52
1077,2,2160,814,1346,0,0,0,1.0,1,1.0,1,1.0,1,0.1092431185764259,49
1078,4,2164,816,1348,0,0,0,1.0,1,1.0,1,1.0,1,0.13664534598786235,48
1079,3,2167,818,1349,0,0,0,1.0,1,1.0,1,1.0,1,0.12895431057530382,47
1080,1,2168,819,1349,0,0,0,1.0,1,1.0,1,1.0,1,0.1664633213210159,47
1081,3,2171,820,1351,0,0,0,1.0,1,1.0,1,1.0,1,0.14752104638476002,45
1082,0,2171,820,1351,0,0,0,1.0,1,1.0,1,1.0,1,0.18750266339153446,42
1083,2,2173,822,1351,0,0,0,1.0,1,1.0,1,1.0,1,0.24044925042275503,42
1084,2,2175,822,1353,0,0,0,1.0,1,1.0,1,1.0,1,0.21027028339703366,40
1085,1,2176,822,1354,0,0,0,1.0,1,1.0,1,1.0,1,0.17802069768126286,43
1086,2,2178,822,1356,0,0,0,1.0,1,1.0,1,1.0,1,0.15098717922752247,41
1087,2,2180,822,1358,0,0,0,1.0,1,1.0,1,1.0,1,0.14989293092755926,41
1088,1,2181,822,1359,0,0,0,1.0,1,1.0,1,1.0,1,0.1350705172283029,41
1089,2,2183,824,1359,0,0,0,1.0,1,1.0,1,1.0,1,0.14023011448705586,42
1090,4,2187,824,1363,0,0,0,1.0,1,1.0,1,1.0,1,0.10352597569115214,43
1091,4,2191,826,1365,0,0,0,1.0,1,1.0,1,1.0,1,0.13147173093280973,43
1092,1,2192,826,1366,0,0,0,1.0,1,1.0,1,1.0,1,0.11758246212493025,43
1093,1,2193,827,1366,0,0,0,1.0,1,1.0,1,1.0,1,0.12697171768317103,43
1094,0,2193,827,1366,0,0,0,1.0,1,1.0,1,1.0,1,0.12697171768317103,43
1095,0,2193,827,1366,0,0,0,1.0,1,1.0,1,1.0,1,0.12186813699307941,44
1096,1,2194,828,1366,0,0,0,1.0,1,1.0,1,1.0,1,0.12760449033158547,44
1097,3,2197,830,1367,0,0,0,1.0,1,1.0,1,1.0,1,0.172612766130615,45
1098,0,2197,830,1367,0,0,0,1.0,1,1.0,1,1.0,1,0.17705572737530761,46
1099,2,2199,831,1368,0,0,0,1.0,1,1.0,1,1.0,1,0.20694374759929335,48
1100,1,2200,831,1369,0,0,0,1.0,1,1.0,1,1.0,1,0.1671599545281916,49
1101,0,2200,831,1369,0,0,0,1.0,1,1.0,1,1.0,1,0.1671599545281916,49
1102,4,2204,834,1370,0,0,0,1.0,1,1.0,1,1.0,1,0.176932903916911,50
1103,3,2207,835,1372,0,0,0,1.0,1,1.0,1,1.0,1,0.1442173766477726,48
1104,4,2211,839,1372,0,0,0,1.0,1,1.0,1,1.0,1,0.18579335675279485,50
1105,4,2215,841,1374,0,0,0,1.0,1,1.0,1,1.0,1,0.09463283407656312,48
1106,1,2216,841,1375,0,0,0,1.0,1,1.0,1,1.0,1,0.10544957506851364,48
1107,4,2220,842,1378,0,0,0,1.0,1,1.0,1,1.0,1,0.1273835724226083,47
1108,3,2223,843,1380,0,0,0,1.0,1,1.0,1,1.0,1,0.08309445473608035,47
1109,2,2225,845,1380,0,0,0,1.0,1,1.0,1,1.0,1,0.1079289582041487,46
1110,2,2227,846,1381,0,0,0,1.0,1,1.0,1,1.0,1,0.12543663122557752,43
1111,5,2232,848,1384,0,0,0,1.0,1,1.0,1,1.0,1,0.13385070684157144,44
1112,5,2237,851,1386,0,0,0,1.0,1,1.0,1,1.0,1,0.16092506705479986,43
1113,1,2238,852,1386,0,0,0,1.0,1,1.0,1,1.0,1,0.21068223237615108,39
1114,3,2241,852,1389,0,0,0,1.0,1,1.0,1,1.0,1,0.13968739469421176,39
1115,2,2243,853,1390,0,0,0,1.0,1,1.0,1,1.0,1,0.09910013150290153,37
1116,5,2248,855,1393,0,0,0,1.0,1,1.0,1,1.0,1,0.0793705448482579,37
1117,6,2254,858,1396,0,0,0,1.0,1,1.0,1,1.0,1,0.10421730163937665,36
1118,1,2255,859,1396,0,0,0,1.0,1,1.0,1,1.0,1,0.14008180906254364,36
1119,0,2255,859,1396,0,0,0,1.0,1,1.0,1,1.0,1,0.14008180906254364,36
1120,1,2256,859,1397,0,0,0,1.0,1,1.0,1,1.0,1,0.11148088239001207,36
1121,1,2257,860,1397,0,0,0,1.0,1,1.0,1,1.0,1,0.13787835643079185,36
1122,0,2257,860,1397,0,0,0,1.0,1,1.0,1,1.0,1,0.1658954565292602,37
1123,1,2258,861,1397,0,0,0,1.0,1,1.0,1,1.0,1,0.22449463728750385,37
1124,1,2259,861,1398,0,0,0,1.0,1,1.0,1,1.0,1,0.19171878552807156,37
1125,0,2259,861,1398,0,0,0,1.0,1,1.0,1,1.0,1,0.19818109799596212,38
1126,2,2261,862,1399,0,0,0,1.0,1,1.0,1,1.0,1,0.18082072646669498,38
1127,4,2265,862,1403,0,0,0,1.0,1,1.0,1,1.0,1,0.14929759596645792,39
1128,0,2265,862,1403,0,0,0,1.0,1,1.0,1,1.0,1,0.14929759596645792,39
1129,1,2266,862,1404,0,0,0,1.0,1,1.0,1,1.0,1,0.13444772233221575,39
1130,1,2267,862,1405,0,0,0,1.0,1,1.0,1,1.0,1,0.1239642289032832,39
1131,0,2267,862,1405,0,0,0,1.0,1,1.0,1,1.0,1,0.1239642289032832,39
1132,1,2268,863,1405,0,0,0,1.0,1,1.0,1,1.0,1,0.14617832499359965,39
1133,0,2268,863,1405,0,0,0,1.0,1,1.0,1,1.0,1,0.13664846257075963,42
1134,0,2268,863,1405,0,0,0,1.0,1,1.0,1,1.0,1,0.13664846257075963,42
1135,4,2272,864,1408,0,0,0,1.0,1,1.0,1,1.0,1,0.1782329216492707,44
1136,2,2274,865,1409,0,0,0,1.0,1,1.0,1,1.0,1,0.17205100906187912,46
1137,0,2274,865,1409,0,0,0,1.0,1,1.0,1,1.0,1,0.18772426834479072,45
1138,3,2277,866,1411,0,0,0,1.0,1,1.0,1,1.0,1,0.14984325828810574,46
1139,3,2280,867,1413,0,0,0,1.0,1,1.0,1,1.0,1,0.1689138584097756,47
1140,1,2281,867,1414,0,0,0,1.0,1,1.0,1,1.0,1,0.17059562462536396,46
1141,1,2282,867,1415,0,0,0,1.0,1,1.0,1,1.0,1,0.18059921677188093,45
1142,3,2285,869,1416,0,0,0,1.0,1,1.0,1,1.0,1,0.1805312129650705,45
1143,1,2286,869,1417,0,0,0,1.0,1,1.0,1,1.0,1,0.17359339579066413,43
1144,6,2292,871,1421,0,0,0,1.0,1,1.0,1,1.0,1,0.07164328372036015,45
1145,2,2294,872,1422,0,0,0,1.0,1,1.0,1,1.0,1,0.09787425075198766,44
1146,1,2295,873,1422,0,0,0,1.0,1,1.0,1,1.0,1,0.09713919719956554,45
1147,2,2297,874,1423,0,0,0,1.0,1,1.0,1,1.0,1,0.10982457739154673,44
1148,1,2298,875,1423,0,0,0,1.0,1,1.0,1,1.0,1,0.1212531414631773,43
1149,3,2301,876,1425,0,0,0,1.0,1,1.0,1,1.0,1,0.16151923713510807,42
1150,8,2309,878,1431,0,0,0,1.0,1,1.0,1,1.0,1,0.14049197788732512,45
1151,1,2310,879,1431,0,0,0,1.0,1,1.0,1,1.0,1,0.2033888492310383,40
1152,5,2315,882,1433,0,0,0,1.0,1,1.0,1,1.0,1,0.2042125448985403,41
1153,9,2324,884,1440,0,0,0,1.0,1,1.0,1,1.0,1,0.15205573869300643,38
1154,4,2328,884,1444,0,0,0,1.0,1,1.0,1,1.0,1,0.13395879465647081,37
1155,4,2332,884,1448,0,0,0,1.0,1,1.0,1,1.0,1,0.13999206570636152,38
1156,1,2333,885,1448,0,0,0,1.0,1,1.0,1,1.0,1,0.17921443869217338,38
1157,1,2334,885,1449,0,0,0,1.0,1,1.0,1,1.0,1,0.1527630203771385,37
1158,0,2334,885,1449,0,0,0,1.0,1,1.0,1,1.0,1,0.18246533783982619,36
1159,3,2337,885,1452,0,0,0,1.0,1,1.0,1,1.0,1,0.11597241610135749,35
1160,1,2338,885,1453,0,0,0,1.0,1,1.0,1,1.0,1,0.09901871737074702,35
1161,0,2338,885,1453,0,0,0,1.0,1,1.0,1,1.0,1,0.10726586052135285,36
1162,0,2338,885,1453,0,0,0,1.0,1,1.0,1,1.0,1,0.12121872046204148,37
1163,0,2338,885,1453,0,0,0,1.0,1,1.0,1,1.0,1,0.12121872046204148,37
1164,0,2338,885,1453,0,0,0,1.0,1,1.0,1,1.0,1,0.13069354063631597,38
1165,1,2339,886,1453,0,0,0,1.0,1,1.0,1,1.0,1,0.1371679694492956,38
1166,0,2339,886,1453,0,0,0,1.0,1,1.0,1,1.0,1,0.1343147336563628,40
1167,4,2343,888,1455,0,0,0,1.0,1,1.0,1,1.0,1,0.1254931192533624,40
1168,3,2346,888,1458,0,0,0,1.0,1,1.0,1,1.0,1,0.06866284338715949,40
1169,2,2348,889,1459,0,0,0,1.0,1,1.0,1,1.0,1,0.08528186391762821,41
1170,2,2350,890,1460,0,0,0,1.0,1,1.0,1,1.0,1,0.06618170004350905,41
1171,0,2350,890,1460,0,0,0,1.0,1,1.0,1,1.0,1,0.07799024492954262,43
1172,0,2350,890,1460,0,0,0,1.0,1,1.0,1,1.0,1,0.07799024492954262,43
1173,0,2350,890,1460,0,0,0,1.0,1,1.0,1,1.0,1,0.07799024492954262,43
1174,1,2351,891,1460,0,0,0,1.0,1,1.0,1,1.0,1,0.09805538652139793,43
1175,0,2351,891,1460,0,0,0,1.0,1,1.0,1,1.0,1,0.11237442532412013,44
1176,2,2353,892,1461,0,0,0,1.0,1,1.0,1,1.0,1,0.13100146829739576,45
1177,4,2357,894,1463,0,0,0,1.0,1,1.0,1,1.0,1,0.10950978677634299,45
1178,1,2358,894,1464,0,0,0,1.0,1,1.0,1,1.0,1,0.09864660359845194,45
1179,2,2360,895,1465,0,0,0,1.0,1,1.0,1,1.0,1,0.14216267575513947,46
1180,1,2361,895,1466,0,0,0,1.0,1,1.0,1,1.0,1,0.12136724039518124,47
1181,1,2362,895,1467,0,0,0,1.0,1,1.0,1,1.0,1,0.11375995146389516,48
1182,2,2364,897,1467,0,0,0,1.0,1,1.0,1,1.0,1,0.1416944569110985,48
1183,0,2364,897,1467,0,0,0,1.0,1,1.0,1,1.0,1,0.1331884401204564,46
1184,2,2366,899,1467,0,0,0,1.0,1,1.0,1,1.0,1,0.16281595631325155,47
1185,2,2368,900,1468,0,0,0,1.0,1,1.0,1,1.0,1,0.1857662946396083,44
1186,6,2374,900,1474,0,0,0,1.0,1,1.0,1,1.0,1,0.1140787032409496,47
1187,4,2378,901,1477,0,0,0,1.0,1,1.0,1,1.0,1,0.16962765669854507,49
1188,4,2382,902,1480,0,0,0,1.0,1,1.0,1,1.0,1,0.14877995715291795,50
1189,0,2382,902,1480,0,0,0,1.0,1,1.0,1,1.0,1,0.12216725058691684,48
1190,2,2384,904,1480,0,0,0,1.0,1,1.0,1,1.0,1,0.17033016437608414,48
1191,0,2384,904,1480,0,0,0,1.0,1,1.0,1,1.0,1,0.17877451855037985,46
1192,3,2387,905,1482,0,0,0,1.0,1,1.0,1,1.0,1,0.16958058442040316,46
1193,1,2388,905,1483,0,0,0,1.0,1,1.0,1,1.0,1,0.1728198637241606,45
1194,0,2388,905,1483,0,0,0,1.0,1,1.0,1,1.0,1,0.1728198637241606,45
1195,5,2393,906,1487,0,0,0,1.0,1,1.0,1,1.0,1,0.15177891390875942,47
1196,1,2394,906,1488,0,0,0,1.0,1,1.0,1,1.0,1,0.14700944519298573,48
1197,0,2394,906,1488,0,0,0,1.0,1,1.0,1,1.0,1,0.13116126376980888,49
1198,4,2398,907,1491,0,0,0,1.0,1,1.0,1,1.0,1,0.1097328995520813,49
1199,1,2399,907,1492,0,0,0,1.0,1,1.0,1,1.0,1,0.1262930116322926,50
1200,1,2400,908,1492,0,0,0,1.0,1,1.0,1,1.0,1,0.1372439098902772,50
1201,2,2402,908,1494,0,0,0,1.0,1,1.0,1,1.0,1,0.09342618683449831,50
1202,1,2403,909,1494,0,0,0,1.0,1,1.0,1,1.0,1,0.10123434561917889,51
1203,0,2403,909,1494,0,0,0,1.0,1,1.0,1,1.0,1,0.09836313632285942,52
1204,0,2403,909,1494,0,0,0,1.0,1,1.0,1,1.0,1,0.09836313632285942,52
1205,5,2408,910,1498,0,0,0,1.0,1,1.0,1,1.0,1,0.11042437091173193,53
1206,0,2408,910,1498,0,0,0,1.0,1,1.0,1,1.0,1,0.11042437091173193,53
1207,2,2410,910,1500,0,0,0,1.0,1,1.0,1,1.0,1,0.09977240104363413,55
1208,3,2413,911,1502,0,0,0,1.0,1,1.0,1,1.0,1,0.1060242414040774,56
1209,0,2413,911,1502,0,0,0,1.0,1,1.0,1,1.0,1,0.11677744117912003,55
1210,0,2413,911,1502,0,0,0,1.0,1,1.0,1,1.0,1,0.11677744117912003,55
1211,0,2413,911,1502,0,0,0,1.0,1,1.0,1,1.0,1,0.09804998591395268,57
1212,1,2414,912,1502,0,0,0,1.0,1,1.0,1,1.0,1,0.10756084043376632,57
1213,0,2414,912,1502,0,0,0,1.0,1,1.0,1,1.0,1,0.10756084043376632,57
1214,7,2421,916,1505,0,0,0,1.0,1,1.0,1,1.0,1,0.16806733558260264,57
1215,3,2424,916,1508,0,0,0,1.0,1,1.0,1,1.0,1,0.13184276601972764,59
1216,2,2426,916,1510,0,0,0,1.0,1,1.0,1,1.0,1,0.1240504155267507,61
1217,0,2426,916,1510,0,0,0,1.0,1,1.0,1,1.0,1,0.1240504155267507,61
1218,3,2429,917,1512,0,0,0,1.0,1,1.0,1,1.0,1,0.13917014598393115,61
1219,1,2430,918,1512,0,0,0,1.0,1,1.0,1,1.0,1,0.14179641614786015,61
1220,3,2433,920,1513,0,0,0,1.0,1,1.0,1,1.0,1,0.14439534018266975,60
1221,1,2434,920,1514,0,0,0,1.0,1,1.0,1,1.0,1,0.15398436300393523,61
1222,3,2437,920,1517,0,0,0,1.0,1,1.0,1,1.0,1,0.11365562056115439,61
1223,2,2439,921,1518,0,0,0,1.0,1,1.0,1,1.0,1,0.13140948261335228,59
1224,5,2444,922,1522,0,0,0,1.0,1,1.0,1,1.0,1,0.12427628612109226,60
1225,7,2451,923,1528,0,0,0,1.0,1,1.0,1,1.0,1,0.11505980503320427,60
1226,8,2459,925,1534,0,0,0,1.0,1,1.0,1,1.0,1,0.08420261865924739,61
1227,3,2462,926,1536,0,0,0,1.0,1,1.0,1,1.0,1,0.09022776219058903,59
1228,4,2466,927,1539,0,0,0,1.0,1,1.0,1,1.0,1,0.05894616600346023,58
1229,3,2469,927,1542,0,0,0,1.0,1,1.0,1,1.0,1,0.04523842802861315,57
1230,0,2469,927,1542,0,0,0,1.0,1,1.0,1,1.0,1,0.07109701916442833,55
1231,2,2471,927,1544,0,0,0,1.0,1,1.0,1,1.0,1,0.0723627488324106,54
1232,3,2474,930,1544,0,0,0,1.0,1,1.0,1,1.0,1,0.114780180077938,51
1233,2,2476,932,1544,0,0,0,1.0,1,1.0,1,1.0,1,0.1402208602703057,49
1234,8,2484,935,1549,0,0,0,1.0,1,1.0,1,1.0,1,0.14345907745950778,49
1235,1,2485,935,1550,0,0,0,1.0,1,1.0,1,1.0,1,0.1582854657362089,48
1236,2,2487,935,1552,0,0,0,1.0,1,1.0,1,1.0,1,0.16605470022058266,49
1237,9,2496,936,1560,0,0,0,1.0,1,1.0,1,1.0,1,0.15887115033107943,48
1238,0,2496,936,1560,0,0,0,1.0,1,1.0,1,1.0,1,0.17283600070129915,47
1239,2,2498,936,1562,0,0,0,1.0,1,1.0,1,1.0,1,0.14230101204645132,48
1240,4,2502,936,1566,0,0,0,1.0,1,1.0,1,1.0,1,0.11433522248020991,49
1241,2,2504,936,1568,0,0,0,1.0,1,1.0,1,1.0,1,0.11382063935740191,49
1242,1,2505,936,1569,0,0,0,1.0,1,1.0,1,1.0,1,0.12286782308135813,49
1243,2,2507,936,1571,0,0,0,1.0,1,1.0,1,1.0,1,0.10623942815961332,50
1244,1,2508,937,1571,0,0,0,1.0,1,1.0,1,1.0,1,0.14800001064029406,50
1245,5,2513,938,1575,0,0,0,1.0,1,1.0,1,1.0,1,0.13092140457157553,51
1246,5,2518,939,1579,0,0,0,1.0,1,1.0,1,1.0,1,0.1447962515811235,52
1247,0,2518,939,1579,0,0,0,1.0,1,1.0,1,1.0,1,0.1447962515811235,52
1248,2,2520,940,1580,0,0,0,1.0,1,1.0,1,1.0,1,0.17409836733801695,51
1249,3,2523,941,1582,0,0,0,1.0,1,1.0,1,1.0,1,0.14869374416547354,51
1250,1,2524,941,1583,0,0,0,1.0,1,1.0,1,1.0,1,0.1289280455492196,51
1251,3,2527,941,1586,0,0,0,1.0,1,1.0,1,1.0,1,0.10819792920629388,53
1252,3,2530,942,1588,0,0,0,1.0,1,1.0,1,1.0,1,0.08539459393855607,52
1253,0,2530,942,1588,0,0,0,1.0,1,1.0,1,1.0,1,0.08539459393855607,52
1254,0,2530,942,1588,0,0,0,1.0,1,1.0,1,1.0,1,0.09056472751799079,53
1255,1,2531,943,1588,0,0,0,1.0,1,1.0,1,1.0,1,0.1008932879366765,55
1256,0,2531,943,1588,0,0,0,1.0,1,1.0,1,1.0,1,0.1008932879366765,55
1257,2,2533,943,1590,0,0,0,1.0,1,1.0,1,1.0,1,0.10147345605505309,57
1258,1,2534,943,1591,0,0,0,1.0,1,1.0,1,1.0,1,0.09038399151629738,57
1259,1,2535,943,1592,0,0,0,1.0,1,1.0,1,1.0,1,0.09081480182851198,57
1260,0,2535,943,1592,0,0,0,1.0,1,1.0,1,1.0,1,0.08903334313411462,56
1261,0,2535,943,1592,0,0,0,1.0,1,1.0,1,1.0,1,0.08900558233430554,57
1262,0,2535,943,1592,0,0,0,1.0,1,1.0,1,1.0,1,0.10063973717876001,58
1263,4,2539,945,1594,0,0,0,1.0,1,1.0,1,1.0,1,0.09155596345409357,58
1264,1,2540,945,1595,0,0,0,1.0,1,1.0,1,1.0,1,0.10388729990151913,57
1265,7,2547,949,1598,0,0,0,1.0,1,1.0,1,1.0,1,0.1049757121206663,56
1266,2,2549,950,1599,0,0,0,1.0,1,1.0,1,1.0,1,0.1018981601083596,55
1267,6,2555,953,1602,0,0,0,1.0,1,1.0,1,1.0,1,0.10627495851300721,53
1268,5,2560,957,1603,0,0,0,1.0,1,1.0,1,1.0,1,0.17873538159763466,52
1269,3,2563,959,1604,0,0,0,1.0,1,1.0,1,1.0,1,0.17909744361334798,51
1270,2,2565,959,1606,0,0,0,1.0,1,1.0,1,1.0,1,0.12735342391093565,47
1271,0,2565,959,1606,0,0,0,1.0,1,1.0,1,1.0,1,0.14283776056817568,46
1272,1,2566,960,1606,0,0,0,1.0,1,1.0,1,1.0,1,0.13940068038774517,43
1273,5,2571,962,1609,0,0,0,1.0,1,1.0,1,1.0,1,0.12038224994384926,44
1274,1,2572,963,1609,0,0,0,1.0,1,1.0,1,1.0,1,0.12285548942508429,44
1275,2,2574,964,1610,0,0,0,1.0,1,1.0,1,1.0,1,0.10953028863436244,45
1276,1,2575,964,1611,0,0,0,1.0,1,1.0,1,1.0,1,0.0687994445707568,43
1277,2,2577,966,1611,0,0,0,1.0,1,1.0,1,1.0,1,0.100677275652442,44
1278,3,2580,969,1611,0,0,0,1.0,1,1.0,1,1.0,1,0.14870281330454563,45
1279,4,2584,969,1615,0,0,0,1.0,1,1.0,1,1.0,1,0.10271332861598766,47
1280,2,2586,969,1617,0,0,0,1.0,1,1.0,1,1.0,1,0.0941603049315224,47
1281,3,2589,969,1620,0,0,0,1.0,1,1.0,1,1.0,1,0.07678503522762042,47
1282,0,2589,969,1620,0,0,0,1.0,1,1.0,1,1.0,1,0.07524031074193686,46
1283,1,2590,970,1620,0,0,0,1.0,1,1.0,1,1.0,1,0.080864351082284,46
1284,0,2590,970,1620,0,0,0,1.0,1,1.0,1,1.0,1,0.080864351082284,46
1285,2,2592,970,1622,0,0,0,1.0,1,1.0,1,1.0,1,0.07325680351526956,46
1286,1,2593,971,1622,0,0,0,1.0,1,1.0,1,1.0,1,0.12475347915323502,45
1287,2,2595,971,1624,0,0,0,1.0,1,1.0,1,1.0,1,0.10982951899322636,49
1288,0,2595,971,1624,0,0,0,1.0,1,1.0,1,1.0,1,0.10982951899322636,49
1289,1,2596,971,1625,0,0,0,1.0,1,1.0,1,1.0,1,0.09646929424476204,52
1290,0,2596,971,1625,0,0,0,1.0,1,1.0,1,1.0,1,0.09646929424476204,52
1291,0,2596,971,1625,0,0,0,1.0,1,1.0,1,1.0,1,0.09646929424476204,52
1292,1,2597,971,1626,0,0,0,1.0,1,1.0,1,1.0,1,0.07904600818849866,53
1293,0,2597,971,1626,0,0,0,1.0,1,1.0,1,1.0,1,0.07904600818849866,53
1294,0,2597,971,1626,0,0,0,1.0,1,1.0,1,1.0,1,0.07904600818849866,53
1295,3,2600,972,1628,0,0,0,1.0,1,1.0,1,1.0,1,0.08688347705417844,54
1296,1,2601,972,1629,0,0,0,1.0,1,1.0,1,1.0,1,0.0764219105441821,55
1297,1,2602,972,1630,0,0,0,1.0,1,1.0,1,1.0,1,0.06889852786983579,54
1298,1,2603,972,1631,0,0,0,1.0,1,1.0,1,1.0,1,0.07428218959053703,55
1299,0,2603,972,1631,0,0,0,1.0,1,1.0,1,1.0,1,0.09230980695517758,54
1300,2,2605,973,1632,0,0,0,1.0,1,1.0,1,1.0,1,0.08652914967931853,55
1301,5,2610,976,1634,0,0,0,1.0,1,1.0,1,1.0,1,0.12511400015610502,54
1302,4,2614,978,1636,0,0,0,1.0,1,1.0,1,1.0,1,0.1440256867279636,54
1303,8,2622,980,1642,0,0,0,1.0,1,1.0,1,1.0,1,0.16777265689824894,50
1304,6,2628,985,1643,0,0,0,1.0,1,1.0,1,1.0,1,0.13318266216593624,51
1305,1,2629,986,1643,0,0,0,1.0,1,1.0,1,1.0,1,0.18978448241958923,48
1306,8,2637,990,1647,0,0,0,1.0,1,1.0,1,1.0,1,0.19990591827030477,48
1307,2,2639,991,1648,0,0,0,1.0,1,1.0,1,1.0,1,0.15556418370408992,48
1308,0,2639,991,1648,0,0,0,1.0,1,1.0,1,1.0,1,0.17810805809958616,46
1309,5,2644,992,1652,0,0,0,1.0,1,1.0,1,1.0,1,0.1556931201696783,47
1310,1,2645,992,1653,0,0,0,1.0,1,1.0,1,1.0,1,0.17690038269598513,46
1311,4,2649,995,1654,0,0,0,1.0,1,1.0,1,1.0,1,0.1921810216107427,46
1312,5,2654,997,1657,0,0,0,1.0,1,1.0,1,1.0,1,0.17583044422397776,45
1313,4,2658,998,1660,0,0,0,1.0,1,1.0,1,1.0,1,0.1779192676844729,44
1314,0,2658,998,1660,0,0,0,1.0,1,1.0,1,1.0,1,0.1881833943751299,42
1315,4,2662,999,1663,0,0,0,1.0,1,1.0,1,1.0,1,0.1657102381793597,40
1316,4,2666,999,1667,0,0,0,1.0,1,1.0,1,1.0,1,0.1189380790497086,42
1317,1,2667,999,1668,0,0,0,1.0,1,1.0,1,1.0,1,0.0920394118491363,42
1318,0,2667,999,1668,0,0,0,1.0,1,1.0,1,1.0,1,0.0920394118491363,42
1319,1,2668,1000,1668,0,0,0,1.0,1,1.0,1,1.0,1,0.12806474886035743,42
1320,0,2668,1000,1668,0,0,0,1.0,1,1.0,1,1.0,1,0.12806474886035743,42
1321,0,2668,1000,1668,0,0,0,1.0,1,1.0,1,1.0,1,0.12591416260898255,45
1322,1,2669,1000,1669,0,0,0,1.0,1,1.0,1,1.0,1,0.11527358823260409,45
1323,1,2670,1000,1670,0,0,0,1.0,1,1.0,1,1.0,1,0.10868543581397067,46
1324,0,2670,1000,1670,0,0,0,1.0,1,1.0,1,1.0,1,0.12689081389230442,45
1325,2,2672,1001,1671,0,0,0,1.0,1,1.0,1,1.0,1,0.11699675076527495,46
1326,1,2673,1002,1671,0,0,0,1.0,1,1.0,1,1.0,1,0.1713999340305144,45
1327,4,2677,1002,1675,0,0,0,1.0,1,1.0,1,1.0,1,0.13487705853822532,46
1328,1,2678,1002,1676,0,0,0,1.0,1,1.0,1,1.0,1,0.12967767082089182,47
1329,1,2679,1003,1676,0,0,0,1.0,1,1.0,1,1.0,1,0.13230030968124082,47
1330,3,2682,1003,1679,0,0,0,1.0,1,1.0,1,1.0,1,0.12716455168384877,46
1331,0,2682,1003,1679,0,0,0,1.0,1,1.0,1,1.0,1,0.12716455168384877,46
1332,1,2683,1003,1680,0,0,0,1.0,1,1.0,1,1.0,1,0.14752241069582903,49
1333,1,2684,1003,1681,0,0,0,1.0,1,1.0,1,1.0,1,0.14266376749372864,50
1334,2,2686,1005,1681,0,0,0,1.0,1,1.0,1,1.0,1,0.157592170312445,50
1335,2,2688,1005,1683,0,0,0,1.0,1,1.0,1,1.0,1,0.1617023949626342,52
1336,0,2688,1005,1683,0,0,0,1.0,1,1.0,1,1.0,1,0.14648092487992037,53
1337,4,2692,1006,1686,0,0,0,1.0,1,1.0,1,1.0,1,0.15347041994103885,54
1338,1,2693,1007,1686,0,0,0,1.0,1,1.0,1,1.0,1,0.17252782693273921,54
1339,4,2697,1008,1689,0,0,0,1.0,1,1.0,1,1.0,1,0.1751462748924371,54
1340,0,2697,1008,1689,0,0,0,1.0,1,1.0,1,1.0,1,0.18461372333731332,53
1341,0,2697,1008,1689,0,0,0,1.0,1,1.0,1,1.0,1,0.16833952468188096,53
1342,5,2702,1010,1692,0,0,0,1.0,1,1.0,1,1.0,1,0.12990689006987755,52
1343,0,2702,1010,1692,0,0,0,1.0,1,1.0,1,1.0,1,0.11810854146824842,50
1344,4,2706,1013,1693,0,0,0,1.0,1,1.0,1,1.0,1,0.16986243611998392,51
1345,4,2710,1013,1697,0,0,0,1.0,1,1.0,1,1.0,1,0.1169572279287742,50
1346,2,2712,1015,1697,0,0,0,1.0,1,1.0,1,1.0,1,0.1354648592430982,50
1347,0,2712,1015,1697,0,0,0,1.0,1,1.0,1,1.0,1,0.10818455298792758,48
1348,0,2712,1015,1697,0,0,0,1.0,1,1.0,1,1.0,1,0.11873565318754672,49
1349,0,2712,1015,1697,0,0,0,1.0,1,1.0,1,1.0,1,0.12819197568160803,48
1350,1,2713,1016,1697,0,0,0,1.0,1,1.0,1,1.0,1,0.12595474142121316,49
1351,0,2713,1016,1697,0,0,0,1.0,1,1.0,1,1.0,1,0.12119966531461146,48
1352,4,2717,1019,1698,0,0,0,1.0,1,1.0,1,1.0,1,0.11452028268167598,49
1353,2,2719,1019,1700,0,0,0,1.0,1,1.0,1,1.0,1,0.11165328824825102,49
1354,3,2722,1020,1702,0,0,0,1.0,1,1.0,1,1.0,1,0.0870189058559928,49
1355,0,2722,1020,1702,0,0,0,1.0,1,1.0,1,1.0,1,0.09030948156765617,50
1356,0,2722,1020,1702,0,0,0,1.0,1,1.0,1,1.0,1,0.09030948156765617,50
1357,3,2725,1022,1703,0,0,0,1.0,1,1.0,1,1.0,1,0.11027999016097606,50
1358,2,2727,1023,1704,0,0,0,1.0,1,1.0,1,1.0,1,0.1421427691793094,51
1359,3,2730,1024,1706,0,0,0,1.0,1,1.0,1,1.0,1,0.1651583769760663,53
1360,4,2734,1024,1710,0,0,0,1.0,1,1.0,1,1.0,1,0.12116125569966879,54
1361,0,2734,1024,1710,0,0,0,1.0,1,1.0,1,1.0,1,0.12116125569966879,54
1362,2,2736,1024,1712,0,0,0,1.0,1,1.0,1,1.0,1,0.11928568197070602,55
1363,1,2737,1024,1713,0,0,0,1.0,1,1.0,1,1.0,1,0.10348374437766292,55
1364,1,2738,1024,1714,0,0,0,1.0,1,1.0,1,1.0,1,0.12680475929802615,55
1365,4,2742,1026,1716,0,0,0,1.0,1,1.0,1,1.0,1,0.14461264629197507,56
1366,4,2746,1026,1720,0,0,0,1.0,1,1.0,1,1.0,1,0.1027672861037539,56
1367,0,2746,1026,1720,0,0,0,1.0,1,1.0,1,1.0,1,0.1027672861037539,56
1368,4,2750,1027,1723,0,0,0,1.0,1,1.0,1,1.0,1,0.10340173526519364,58
1369,1,2751,1027,1724,0,0,0,1.0,1,1.0,1,1.0,1,0.10281048392645203,59
1370,2,2753,1029,1724,0,0,0,1.0,1,1.0,1,1.0,1,0.10212240438656209,59
1371,1,2754,1029,1725,0,0,0,1.0,1,1.0,1,1.0,1,0.09518150745227208,59
1372,1,2755,1030,1725,0,0,0,1.0,1,1.0,1,1.0,1,0.10732964241587384,59
1373,3,2758,1030,1728,0,0,0,1.0,1,1.0,1,1.0,1,0.07400200250565427,59
1374,4,2762,1033,1729,0,0,0,1.0,1,1.0,1,1.0,1,0.11290138386354476,60
1375,6,2768,1034,1734,0,0,0,1.0,1,1.0,1,1.0,1,0.0693203369916882,61
1376,0,2768,1034,1734,0,0,0,1.0,1,1.0,1,1.0,1,0.0942495732539737,61
1377,3,2771,1037,1734,0,0,0,1.0,1,1.0,1,1.0,1,0.12368311253686108,61
1378,3,2774,1038,1736,0,0,0,1.0,1,1.0,1,1.0,1,0.12757846669171186,61
1379,2,2776,1038,1738,0,0,0,1.0,1,1.0,1,1.0,1,0.10931534336936156,60
1380,3,2779,1039,1740,0,0,0,1.0,1,1.0,1,1.0,1,0.11615925426863002,60
1381,0,2779,1039,1740,0,0,0,1.0,1,1.0,1,1.0,1,0.10998070963457521,58
1382,1,2780,1040,1740,0,0,0,1.0,1,1.0,1,1.0,1,0.1290687484430757,58
1383,5,2785,1043,1742,0,0,0,1.0,1,1.0,1,1.0,1,0.1540681190224975,57
1384,9,2794,1046,1748,0,0,0,1.0,1,1.0,1,1.0,1,0.12345424537744429,54
1385,3,2797,1047,1750,0,0,0,1.0,1,1.0,1,1.0,1,0.08803328992162382,52
1386,0,2797,1047,1750,0,0,0,1.0,1,1.0,1,1.0,1,0.0926951155983805,51
1387,4,2801,1048,1753,0,0,0,1.0,1,1.0,1,1.0,1,0.0929086997242139,51
1388,1,2802,1049,1753,0,0,0,1.0,1,1.0,1,1.0,1,0.0997837288363479,52
1389,0,2802,1049,1753,0,0,0,1.0,1,1.0,1,1.0,1,0.1310497295223002,50
1390,1,2803,1050,1753,0,0,0,1.0,1,1.0,1,1.0,1,0.12951122311169094,51
1391,0,2803,1050,1753,0,0,0,1.0,1,1.0,1,1.0,1,0.1191630570892514,50
1392,1,2804,1051,1753,0,0,0,1.0,1,1.0,1,1.0,1,0.09571898620979907,50
1393,0,2804,1051,1753,0,0,0,1.0,1,1.0,1,1.0,1,0.10554272325355432,49
1394,3,2807,1052,1755,0,0,0,1.0,1,1.0,1,1.0,1,0.136254102313608,50
1395,1,2808,1052,1756,0,0,0,1.0,1,1.0,1,1.0,1,0.12267391759967862,51
1396,0,2808,1052,1756,0,0,0,1.0,1,1.0,1,1.0,1,0.13903099135824987,52
1397,2,2810,1054,1756,0,0,0,1.0,1,1.0,1,1.0,1,0.14777884888533985,52
1398,0,2810,1054,1756,0,0,0,1.0,1,1.0,1,1.0,1,0.13257360868648824,53
1399,4,2814,1056,1758,0,0,0,1.0,1,1.0,1,1.0,1,0.1586894593451497,54
1400,1,2815,1057,1758,0,0,0,1.0,1,1.0,1,1.0,1,0.17443238905469183,54
1401,1,2816,1058,1758,0,0,0,1.0,1,1.0,1,1.0,1,0.16144708343519865,54
1402,1,2817,1059,1758,0,0,0,1.0,1,1.0,1,1.0,1,0.16939694831861624,53
1403,0,2817,1059,1758,0,0,0,1.0,1,1.0,1,1.0,1,0.1871056912865521,52
1404,1,2818,1059,1759,0,0,0,1.0,1,1.0,1,1.0,1,0.19011452385144484,53
1405,2,2820,1060,1760,0,0,0,1.0,1,1.0,1,1.0,1,0.22900177041316833,52
1406,2,2822,1060,1762,0,0,0,1.0,1,1.0,1,1.0,1,0.20292563715059722,53
1407,1,2823,1060,1763,0,0,0,1.0,1,1.0,1,1.0,1,0.20258960795536002,54
1408,1,2824,1060,1764,0,0,0,1.0,1,1.0,1,1.0,1,0.2032533236957146,53
1409,0,2824,1060,1764,0,0,0,1.0,1,1.0,1,1.0,1,0.2042790714141289,55
1410,0,2824,1060,1764,0,0,0,1.0,1,1.0,1,1.0,1,0.21564407468454366,54
1411,6,2830,1060,1770,0,0,0,1.0,1,1.0,1,1.0,1,0.1856085255156511,54
1412,0,2830,1060,1770,0,0,0,1.0,1,1.0,1,1.0,1,0.1751164979239493,53
1413,2,2832,1060,1772,0,0,0,1.0,1,1.0,1,1.0,1,0.14074851778143488,54
1414,3,2835,1060,1775,0,0,0,1.0,1,1.0,1,1.0,1,0.1280743674687457,55
1415,3,2838,1062,1776,0,0,0,1.0,1,1.0,1,1.0,1,0.1308255316155605,57
1416,3,2841,1063,1778,0,0,0,1.0,1,1.0,1,1.0,1,0.14812871488544474,59
1417,2,2843,1064,1779,0,0,0,1.0,1,1.0,1,1.0,1,0.14663413363636602,58
1418,3,2846,1065,1781,0,0,0,1.0,1,1.0,1,1.0,1,0.1158542392741019,57
1419,1,2847,1066,1781,0,0,0,1.0,1,1.0,1,1.0,1,0.14001332995529484,56
1420,1,2848,1067,1781,0,0,0,1.0,1,1.0,1,1.0,1,0.18925794923271758,54
1421,3,2851,1068,1783,0,0,0,1.0,1,1.0,1,1.0,1,0.1801604986523324,55
1422,1,2852,1068,1784,0,0,0,1.0,1,1.0,1,1.0,1,0.16409234699546282,52
1423,6,2858,1070,1788,0,0,0,1.0,1,1.0,1,1.0,1,0.13193483031486472,52
1424,4,2862,1073,1789,0,0,0,1.0,1,1.0,1,1.0,1,0.13870341449858112,51
1425,1,2863,1073,1790,0,0,0,1.0,1,1.0,1,1.0,1,0.12997243456811491,50
1426,5,2868,1075,1793,0,0,0,1.0,1,1.0,1,1.0,1,0.11734473194694879,50
1427,0,2868,1075,1793,0,0,0,1.0,1,1.0,1,1.0,1,0.1370529216836832,48
1428,2,2870,1077,1793,0,0,0,1.0,1,1.0,1,1.0,1,0.182096211215621,48
1429,1,2871,1077,1794,0,0,0,1.0,1,1.0,1,1.0,1,0.16826009339411535,48
1430,2,2873,1079,1794,0,0,0,1.0,1,1.0,1,1.0,1,0.17959205724747054,48
1431,1,2874,1079,1795,0,0,0,1.0,1,1.0,1,1.0,1,0.1635287616519729,48
1432,0,2874,1079,1795,0,0,0,1.0,1,1.0,1,1.0,1,0.14763253630204642,50
1433,2,2876,1080,1796,0,0,0,1.0,1,1.0,1,1.0,1,0.12463836067785176,51
1434,1,2877,1081,1796,0,0,0,1.0,1,1.0,1,1.0,1,0.11066062913403708,51
1435,7,2884,1083,1801,0,0,0,1.0,1,1.0,1,1.0,1,0.07902021264297183,50
1436,2,2886,1084,1802,0,0,0,1.0,1,1.0,1,1.0,1,0.10637061398672906,51
1437,0,2886,1084,1802,0,0,0,1.0,1,1.0,1,1.0,1,0.10637061398672906,51
1438,4,2890,1087,1803,0,0,0,1.0,1,1.0,1,1.0,1,0.1281070073390988,51
1439,4,2894,1090,1804,0,0,0,1.0,1,1.0,1,1.0,1,0.17578454358967785,50
1440,6,2900,1092,1808,0,0,0,1.0,1,1.0,1,1.0,1,0.1936628685690284,51
1441,2,2902,1092,1810,0,0,0,1.0,1,1.0,1,1.0,1,0.1600304281672432,51
1442,5,2907,1093,1814,0,0,0,1.0,1,1.0,1,1.0,1,0.142346108131066,52
1443,3,2910,1093,1817,0,0,0,1.0,1,1.0,1,1.0,1,0.12520552397325038,53
1444,0,2910,1093,1817,0,0,0,1.0,1,1.0,1,1.0,1,0.12297344112570861,54
1445,2,2912,1093,1819,0,0,0,1.0,1,1.0,1,1.0,1,0.09468880315247061,54
1446,0,2912,1093,1819,0,0,0,1.0,1,1.0,1,1.0,1,0.11540788136113385,54
1447,0,2912,1093,1819,0,0,0,1.0,1,1.0,1,1.0,1,0.10558751982556971,55
1448,0,2912,1093,1819,0,0,0,1.0,1,1.0,1,1.0,1,0.10558751982556971,55
1449,0,2912,1093,1819,0,0,0,1.0,1,1.0,1,1.0,1,0.10558751982556971,55
1450,3,2915,1093,1822,0,0,0,1.0,1,1.0,1,1.0,1,0.07294997466679258,57
1451,2,2917,1094,1823,0,0,0,1.0,1,1.0,1,1.0,1,0.06955049664339817,57
1452,0,2917,1094,1823,0,0,0,1.0,1,1.0,1,1.0,1,0.06955049664339817,57
1453,1,2918,1095,1823,0,0,0,1.0,1,1.0,1,1.0,1,0.09742789862982601,57
1454,3,2921,1097,1824,0,0,0,1.0,1,1.0,1,1.0,1,0.13371028102567728,58
1455,1,2922,1097,1825,0,0,0,1.0,1,1.0,1,1.0,1,0.11955199407100274,56
1456,3,2925,1098,1827,0,0,0,1.0,1,1.0,1,1.0,1,0.09332536885097574,55
1457,1,2926,1098,1828,0,0,0,1.0,1,1.0,1,1.0,1,0.10386111634792158,54
1458,2,2928,1100,1828,0,0,0,1.0,1,1.0,1,1.0,1,0.13801652132288852,53
1459,4,2932,1100,1832,0,0,0,1.0,1,1.0,1,1.0,1,0.0940689892309919,52
1460,0,2932,1100,1832,0,0,0,1.0,1,1.0,1,1.0,1,0.08663359035866863,51
1461,3,2935,1102,1833,0,0,0,1.0,1,1.0,1,1.0,1,0.10366437654910796,51
1462,3,2938,1103,1835,0,0,0,1.0,1,1.0,1,1.0,1,0.10880453347340224,51
1463,5,2943,1105,1838,0,0,0,1.0,1,1.0,1,1.0,1,0.14403934228758572,52
1464,5,2948,1108,1840,0,0,0,1.0,1,1.0,1,1.0,1,0.16437084982496605,52
1465,8,2956,1110,1846,0,0,0,1.0,1,1.0,1,1.0,1,0.13684803946765023,51
1466,4,2960,1113,1847,0,0,0,1.0,1,1.0,1,1.0,1,0.13988357667755702,50
1467,2,2962,1114,1848,0,0,0,1.0,1,1.0,1,1.0,1,0.15949010862883667,48
1468,4,2966,1116,1850,0,0,0,1.0,1,1.0,1,1.0,1,0.13225193099236288,48
1469,3,2969,1117,1852,0,0,0,1.0,1,1.0,1,1.0,1,0.11860201545151534,48
1470,1,2970,1118,1852,0,0,0,1.0,1,1.0,1,1.0,1,0.13664285663015005,48
1471,3,2973,1120,1853,0,0,0,1.0,1,1.0,1,1.0,1,0.1391080924051672,45
1472,1,2974,1120,1854,0,0,0,1.0,1,1.0,1,1.0,1,0.12669932907354495,45
1473,2,2976,1121,1855,0,0,0,1.0,1,1.0,1,1.0,1,0.12415082857039181,46
1474,3,2979,1121,1858,0,0,0,1.0,1,1.0,1,1.0,1,0.08809761815194604,46
1475,0,2979,1121,1858,0,0,0,1.0,1,1.0,1,1.0,1,0.08809761815194604,46
1476,2,2981,1122,1859,0,0,0,1.0,1,1.0,1,1.0,1,0.12017145838271663,47
1477,3,2984,1123,1861,0,0,0,1.0,1,1.0,1,1.0,1,0.07992681699044886,47
1478,0,2984,1123,1861,0,0,0,1.0,1,1.0,1,1.0,1,0.11830579933181648,47
1479,1,2985,1123,1862,0,0,0,1.0,1,1.0,1,1.0,1,0.11175789419399342,48
1480,1,2986,1124,1862,0,0,0,1.0,1,1.0,1,1.0,1,0.12928887289032684,47
1481,1,2987,1125,1862,0,0,0,1.0,1,1.0,1,1.0,1,0.13708337030237716,47
1482,2,2989,1126,1863,0,0,0,1.0,1,1.0,1,1.0,1,0.14463848441894211,46
1483,2,2991,1126,1865,0,0,0,1.0,1,1.0,1,1.0,1,0.12668860863621847,47
1484,0,2991,1126,1865,0,0,0,1.0,1,1.0,1,1.0,1,0.14527375815709279,47
1485,3,2994,1126,1868,0,0,0,1.0,1,1.0,1,1.0,1,0.15672932012626511,47
1486,1,2995,1126,1869,0,0,0,1.0,1,1.0,1,1.0,1,0.14729120175189084,49
1487,4,2999,1129,1870,0,0,0,1.0,1,1.0,1,1.0,1,0.127080164172757,49
1488,1,3000,1130,1870,0,0,0,1.0,1,1.0,1,1.0,1,0.1389981479086515,51
1489,4,3004,1131,1873,0,0,0,1.0,1,1.0,1,1.0,1,0.1264306243485382,52
1490,0,3004,1131,1873,0,0,0,1.0,1,1.0,1,1.0,1,0.1264306243485382,52
1491,5,3009,1135,1874,0,0,0,1.0,1,1.0,1,1.0,1,0.16588704486750677,53
1492,6,3015,1138,1877,0,0,0,1.0,1,1.0,1,1.0,1,0.13293915561198005,53
1493,3,3018,1140,1878,0,0,0,1.0,1,1.0,1,1.0,1,0.08667437093185487,52
1494,1,3019,1141,1878,0,0,0,1.0,1,1.0,1,1.0,1,0.068382548500186,50
1495,1,3020,1142,1878,0,0,0,1.0,1,1.0,1,1.0,1,0.08800030230443726,50
1496,4,3024,1143,1881,0,0,0,1.0,1,1.0,1,1.0,1,0.08210958915865628,52
1497,3,3027,1145,1882,0,0,0,1.0,1,1.0,1,1.0,1,0.1461853589717064,51
1498,2,3029,1146,1883,0,0,0,1.0,1,1.0,1,1.0,1,0.1646879691104231,50
1499,1,3030,1146,1884,0,0,0,1.0,1,1.0,1,1.0,1,0.10810047179638778,50
1500,1,3031,1147,1884,0,0,0,1.0,1,1.0,1,1.0,1,0.10590194407973881,49
1501,2,3033,1148,1885,0,0,0,1.0,1,1.0,1,1.0,1,0.10991191732965089,47
1502,2,3035,1150,1885,0,0,0,1.0,1,1.0,1,1.0,1,0.15395287415748024,47
1503,2,3037,1151,1886,0,0,0,1.0,1,1.0,1,1.0,1,0.1189006919077291,47
1504,4,3041,1153,1888,0,0,0,1.0,1,1.0,1,1.0,1,0.13359218357789782,48
1505,4,3045,1156,1889,0,0,0,1.0,1,1.0,1,1.0,1,0.11006090151555653,47
1506,1,3046,1157,1889,0,0,0,1.0,1,1.0,1,1.0,1,0.10760514875755038,47
1507,1,3047,1157,1890,0,0,0,1.0,1,1.0,1,1.0,1,0.10489750307889154,45
1508,2,3049,1158,1891,0,0,0,1.0,1,1.0,1,1.0,1,0.11513647924472063,45
1509,1,3050,1159,1891,0,0,0,1.0,1,1.0,1,1.0,1,0.10388347789366725,44
1510,4,3054,1162,1892,0,0,0,1.0,1,1.0,1,1.0,1,0.141661583913549,42
1511,2,3056,1163,1893,0,0,0,1.0,1,1.0,1,1.0,1,0.1727297096467704,40
1512,5,3061,1167,1894,0,0,0,1.0,1,1.0,1,1.0,1,0.23785982217793714,39
1513,4,3065,1167,1898,0,0,0,1.0,1,1.0,1,1.0,1,0.1481910857986978,39
1514,0,3065,1167,1898,0,0,0,1.0,1,1.0,1,1.0,1,0.16796796095143735,38
1515,3,3068,1167,1901,0,0,0,1.0,1,1.0,1,1.0,1,0.1309623489286312,39
1516,0,3068,1167,1901,0,0,0,1.0,1,1.0,1,1.0,1,0.1309623489286312,39
1517,2,3070,1169,1901,0,0,0,1.0,1,1.0,1,1.0,1,0.16355795946404156,39
1518,2,3072,1171,1901,0,0,0,1.0,1,1.0,1,1.0,1,0.1681523797408213,39
1519,3,3075,1171,1904,0,0,0,1.0,1,1.0,1,1.0,1,0.08164853974837331,39
1520,3,3078,1174,1904,0,0,0,1.0,1,1.0,1,1.0,1,0.1745504667824086,39
1521,3,3081,1175,1906,0,0,0,1.0,1,1.0,1,1.0,1,0.19470982812748203,40
1522,4,3085,1176,1909,0,0,0,1.0,1,1.0,1,1.0,1,0.14412608285827155,40
1523,0,3085,1176,1909,0,0,0,1.0,1,1.0,1,1.0,1,0.15887754245356966,41
1524,1,3086,1176,1910,0,0,0,1.0,1,1.0,1,1.0,1,0.15001423414010243,42
1525,2,3088,1176,1912,0,0,0,1.0,1,1.0,1,1.0,1,0.10364472769636768,45
1526,1,3089,1176,1913,0,0,0,1.0,1,1.0,1,1.0,1,0.10729828136116319,46
1527,0,3089,1176,1913,0,0,0,1.0,1,1.0,1,1.0,1,0.10729828136116319,46
1528,0,3089,1176,1913,0,0,0,1.0,1,1.0,1,1.0,1,0.10889359919832318,47
1529,1,3090,1176,1914,0,0,0,1.0,1,1.0,1,1.0,1,0.0773737041348705,47
1530,0,3090,1176,1914,0,0,0,1.0,1,1.0,1,1.0,1,0.08746688716396073,48
1531,2,3092,1176,1916,0,0,0,1.0,1,1.0,1,1.0,1,0.07767848345701836,46
1532,1,3093,1177,1916,0,0,0,1.0,1,1.0,1,1.0,1,0.11696236867315418,47
1533,0,3093,1177,1916,0,0,0,1.0,1,1.0,1,1.0,1,0.10342230704683299,46
1534,2,3095,1178,1917,0,0,0,1.0,1,1.0,1,1.0,1,0.1020141892519426,47
1535,0,3095,1178,1917,0,0,0,1.0,1,1.0,1,1.0,1,0.1020141892519426,47
1536,1,3096,1178,1918,0,0,0,1.0,1,1.0,1,1.0,1,0.10802582697624774,48
1537,2,3098,1178,1920,0,0,0,1.0,1,1.0,1,1.0,1,0.0890048248136975,46
1538,0,3098,1178,1920,0,0,0,1.0,1,1.0,1,1.0,1,0.10920867985647163,47
1539,2,3100,1179,1921,0,0,0,1.0,1,1.0,1,1.0,1,0.11409549481876845,47
1540,2,3102,1180,1922,0,0,0,1.0,1,1.0,1,1.0,1,0.10740445533381625,47
1541,0,3102,1180,1922,0,0,0,1.0,1,1.0,1,1.0,1,0.10772564175193543,47
1542,6,3108,1185,1923,0,0,0,1.0,1,1.0,1,1.0,1,0.2020979658746693,50
1543,7,3115,1187,1928,0,0,0,1.0,1,1.0,1,1.0,1,0.13991808293992192,47
1544,4,3119,1190,1929,0,0,0,1.0,1,1.0,1,1.0,1,0.1604072814523537,48
1545,3,3122,1191,1931,0,0,0,1.0,1,1.0,1,1.0,1,0.07782095940118267,47
1546,3,3125,1192,1933,0,0,0,1.0,1,1.0,1,1.0,1,0.06205262552742226,47
1547,1,3126,1192,1934,0,0,0,1.0,1,1.0,1,1.0,1,0.10167101319226085,47
1548,2,3128,1194,1934,0,0,0,1.0,1,1.0,1,1.0,1,0.10687579667377813,47
1549,6,3134,1199,1935,0,0,0,1.0,1,1.0,1,1.0,1,0.11614158249619512,46
1550,3,3137,1201,1936,0,0,0,1.0,1,1.0,1,1.0,1,0.1267848182490943,44
1551,5,3142,1206,1936,0,0,0,1.0,1,1.0,1,1.0,1,0.15980361056719156,45
1552,4,3146,1207,1939,0,0,0,1.0,1,1.0,1,1.0,1,0.08770182943713216,43
1553,2,3148,1208,1940,0,0,0,1.0,1,1.0,1,1.0,1,0.12746974543133452,43
1554,1,3149,1208,1941,0,0,0,1.0,1,1.0,1,1.0,1,0.09053478239734317,41
1555,3,3152,1210,1942,0,0,0,1.0,1,1.0,1,1.0,1,0.1111545884041621,44
1556,1,3153,1211,1942,0,0,0,1.0,1,1.0,1,1.0,1,0.12693755163724849,45
1557,0,3153,1211,1942,0,0,0,1.0,1,1.0,1,1.0,1,0.12693755163724849,45
1558,2,3155,1211,1944,0,0,0,1.0,1,1.0,1,1.0,1,0.08762282935856973,46
1559,1,3156,1212,1944,0,0,0,1.0,1,1.0,1,1.0,1,0.12282895183883805,47
1560,3,3159,1214,1945,0,0,0,1.0,1,1.0,1,1.0,1,0.0922932750984739,46
1561,2,3161,1215,1946,0,0,0,1.0,1,1.0,1,1.0,1,0.08865342890293335,47
1562,0,3161,1215,1946,0,0,0,1.0,1,1.0,1,1.0,1,0.09793048799925654,47
1563,0,3161,1215,1946,0,0,0,1.0,1,1.0,1,1.0,1,0.09793048799925654,47
1564,0,3161,1215,1946,0,0,0,1.0,1,1.0,1,1.0,1,0.09793048799925654,47
1565,1,3162,1215,1947,0,0,0,1.0,1,1.0,1,1.0,1,0.11837804369099293,48
1566,0,3162,1215,1947,0,0,0,1.0,1,1.0,1,1.0,1,0.11837804369099293,48
1567,3,3165,1215,1950,0,0,0,1.0,1,1.0,1,1.0,1,0.11536918433847075,48
1568,1,3166,1216,1950,0,0,0,1.0,1,1.0,1,1.0,1,0.14988808571923262,48
1569,2,3168,1217,1951,0,0,0,1.0,1,1.0,1,1.0,1,0.10786051964610195,45
1570,2,3170,1218,1952,0,0,0,1.0,1,1.0,1,1.0,1,0.08121814285736953,44
1571,4,3174,1221,1953,0,0,0,1.0,1,1.0,1,1.0,1,0.10817908062869457,42
1572,2,3176,1222,1954,0,0,0,1.0,1,1.0,1,1.0,1,0.13653421370213512,43
1573,3,3179,1223,1956,0,0,0,1.0,1,1.0,1,1.0,1,0.10937023762037143,43
1574,6,3185,1227,1958,0,0,0,1.0,1,1.0,1,1.0,1,0.15375429202022645,42
1575,3,3188,1228,1960,0,0,0,1.0,1,1.0,1,1.0,1,0.11465433944245608,43
1576,4,3192,1229,1963,0,0,0,1.0,1,1.0,1,1.0,1,0.10519760855437381,41
1577,2,3194,1231,1963,0,0,0,1.0,1,1.0,1,1.0,1,0.1532115031934181,40
1578,0,3194,1231,1963,0,0,0,1.0,1,1.0,1,1.0,1,0.16411287226355614,40
1579,2,3196,1231,1965,0,0,0,1.0,1,1.0,1,1.0,1,0.1182831658099064,40
1580,0,3196,1231,1965,0,0,0,1.0,1,1.0,1,1.0,1,0.1182831658099064,40
1581,0,3196,1231,1965,0,0,0,1.0,1,1.0,1,1.0,1,0.11847275980140674,40
1582,5,3201,1235,1966,0,0,0,1.0,1,1.0,1,1.0,1,0.1914734747911515,40
1583,1,3202,1235,1967,0,0,0,1.0,1,1.0,1,1.0,1,0.16496833661334726,38
1584,3,3205,1238,1967,0,0,0,1.0,1,1.0,1,1.0,1,0.22548460317043303,39
1585,6,3211,1240,1971,0,0,0,1.0,1,1.0,1,1.0,1,0.13336133085822685,38
1586,3,3214,1243,1971,0,0,0,1.0,1,1.0,1,1.0,1,0.18092772750941663,38
1587,1,3215,1244,1971,0,0,0,1.0,1,1.0,1,1.0,1,0.1549293959986957,37
1588,4,3219,1245,1974,0,0,0,1.0,1,1.0,1,1.0,1,0.08869107421299513,39
1589,4,3223,1248,1975,0,0,0,1.0,1,1.0,1,1.0,1,0.11074419090068613,37
1590,1,3224,1249,1975,0,0,0,1.0,1,1.0,1,1.0,1,0.15889503295106094,37
1591,8,3232,1252,1980,0,0,0,1.0,1,1.0,1,1.0,1,0.1586073622395688,36
1592,1,3233,1252,1981,0,0,0,1.0,1,1.0,1,1.0,1,0.17716423614788018,34
1593,0,3233,1252,1981,0,0,0,1.0,1,1.0,1,1.0,1,0.19119053895716046,33
1594,3,3236,1252,1984,0,0,0,1.0,1,1.0,1,1.0,1,0.1279411219550895,31
1595,2,3238,1253,1985,0,0,0,1.0,1,1.0,1,1.0,1,0.1794445950053163,34
1596,1,3239,1253,1986,0,0,0,1.0,1,1.0,1,1.0,1,0.13566387568661176,33
1597,0,3239,1253,1986,0,0,0,1.0,1,1.0,1,1.0,1,0.13566387568661176,33
1598,3,3242,1253,1989,0,0,0,1.0,1,1.0,1,1.0,1,0.0964714001145307,33
1599,0,3242,1253,1989,0,0,0,1.0,1,1.0,1,1.0,1,0.0964714001145307,33
1600,2,3244,1254,1990,0,0,0,1.0,1,1.0,1,1.0,1,0.09879057252910209,34
1601,2,3246,1255,1991,0,0,0,1.0,1,1.0,1,1.0,1,0.12685134975089182,35
1602,0,3246,1255,1991,0,0,0,1.0,1,1.0,1,1.0,1,0.12091443043762731,36
1603,2,3248,1256,1992,0,0,0,1.0,1,1.0,1,1.0,1,0.16420598250710128,38
1604,3,3251,1256,1995,0,0,0,1.0,1,1.0,1,1.0,1,0.11713965459904614,38
1605,1,3252,1256,1996,0,0,0,1.0,1,1.0,1,1.0,1,0.0789399622855174,38
1606,4,3256,1259,1997,0,0,0,1.0,1,1.0,1,1.0,1,0.1264868484310466,39
1607,1,3257,1260,1997,0,0,0,1.0,1,1.0,1,1.0,1,0.1299807749249585,37
1608,2,3259,1261,1998,0,0,0,1.0,1,1.0,1,1.0,1,0.15263959718706463,36
1609,2,3261,1261,2000,0,0,0,1.0,1,1.0,1,1.0,1,0.1226816101219452,34
1610,1,3262,1262,2000,0,0,0,1.0,1,1.0,1,1.0,1,0.1405409986510932,34
1611,1,3263,1262,2001,0,0,0,1.0,1,1.0,1,1.0,1,0.1344906984713508,35
1612,0,3263,1262,2001,0,0,0,1.0,1,1.0,1,1.0,1,0.13397818791515484,33
1613,3,3266,1264,2002,0,0,0,1.0,1,1.0,1,1.0,1,0.2062232397999635,34
1614,2,3268,1265,2003,0,0,0,1.0,1,1.0,1,1.0,1,0.1785486841737886,35
1615,1,3269,1265,2004,0,0,0,1.0,1,1.0,1,1.0,1,0.1500577352211238,35
1616,2,3271,1266,2005,0,0,0,1.0,1,1.0,1,1.0,1,0.175034242069581,37
1617,2,3273,1267,2006,0,0,0,1.0,1,1.0,1,1.0,1,0.17325818593324854,38
1618,2,3275,1267,2008,0,0,0,1.0,1,1.0,1,1.0,1,0.11964945473450816,38
1619,1,3276,1267,2009,0,0,0,1.0,1,1.0,1,1.0,1,0.13997740843582288,38
1620,2,3278,1268,2010,0,0,0,1.0,1,1.0,1,1.0,1,0.14545127460296958,39
1621,1,3279,1268,2011,0,0,0,1.0,1,1.0,1,1.0,1,0.1605451083282249,37
1622,4,3283,1271,2012,0,0,0,1.0,1,1.0,1,1.0,1,0.2363316807842088,37
1623,4,3287,1273,2014,0,0,0,1.0,1,1.0,1,1.0,1,0.20359210796986055,37
1624,4,3291,1275,2016,0,0,0,1.0,1,1.0,1,1.0,1,0.2335091881480934,37
1625,4,3295,1275,2020,0,0,0,1.0,1,1.0,1,1.0,1,0.18977332509245665,35
1626,1,3296,1275,2021,0,0,0,1.0,1,1.0,1,1.0,1,0.16040185496701265,35
1627,2,3298,1275,2023,0,0,0,1.0,1,1.0,1,1.0,1,0.13612200732450652,34
1628,1,3299,1276,2023,0,0,0,1.0,1,1.0,1,1.0,1,0.1686976256808522,35
1629,2,3301,1278,2023,0,0,0,1.0,1,1.0,1,1.0,1,0.21766545332371204,34
1630,2,3303,1278,2025,0,0,0,1.0,1,1.0,1,1.0,1,0.16311303162274443,32
1631,0,3303,1278,2025,0,0,0,1.0,1,1.0,1,1.0,1,0.18108055268611786,33
1632,1,3304,1279,2025,0,0,0,1.0,1,1.0,1,1.0,1,0.23011281232834768,32
1633,1,3305,1279,2026,0,0,0,1.0,1,1.0,1,1.0,1,0.20591498680556095,31
1634,0,3305,1279,2026,0,0,0,1.0,1,1.0,1,1.0,1,0.20591498680556095,31
1635,1,3306,1279,2027,0,0,0,1.0,1,1.0,1,1.0,1,0.20689264076415959,31
1636,0,3306,1279,2027,0,0,0,1.0,1,1.0,1,1.0,1,0.2037782690147125,33
1637,0,3306,1279,2027,0,0,0,1.0,1,1.0,1,1.0,1,0.2037782690147125,33
1638,4,3310,1279,2031,0,0,0,1.0,1,1.0,1,1.0,1,0.16211836683333952,36
1639,1,3311,1280,2031,0,0,0,1.0,1,1.0,1,1.0,1,0.13383127627534236,36
1640,1,3312,1281,2031,0,0,0,1.0,1,1.0,1,1.0,1,0.1735820605670317,36
1641,2,3314,1281,2033,0,0,0,1.0,1,1.0,1,1.0,1,0.15467583267222532,38
1642,0,3314,1281,2033,0,0,0,1.0,1,1.0,1,1.0,1,0.15423096360011496,37
1643,2,3316,1283,2033,0,0,0,1.0,1,1.0,1,1.0,1,0.1703937933854419,37
1644,1,3317,1284,2033,0,0,0,1.0,1,1.0,1,1.0,1,0.2266005903100972,38
1645,3,3320,1284,2036,0,0,0,1.0,1,1.0,1,1.0,1,0.1533645627212158,36
1646,2,3322,1286,2036,0,0,0,1.0,1,1.0,1,1.0,1,0.21716897133996232,37
1647,3,3325,1287,2038,0,0,0,1.0,1,1.0,1,1.0,1,0.24530023336734538,35
1648,2,3327,1287,2040,0,0,0,1.0,1,1.0,1,1.0,1,0.24657826538666258,38
1649,1,3328,1288,2040,0,0,0,1.0,1,1.0,1,1.0,1,0.2338936926136482,35
1650,0,3328,1288,2040,0,0,0,1.0,1,1.0,1,1.0,1,0.2461873163073664,34
1651,4,3332,1288,2044,0,0,0,1.0,1,1.0,1,1.0,1,0.23829837470057258,32
1652,4,3336,1288,2048,0,0,0,1.0,1,1.0,1,1.0,1,0.18623720874437494,33
1653,3,3339,1288,2051,0,0,0,1.0,1,1.0,1,1.0,1,0.15766317277095082,33
1654,1,3340,1288,2052,0,0,0,1.0,1,1.0,1,1.0,1,0.1593216913816022,34
1655,1,3341,1288,2053,0,0,0,1.0,1,1.0,1,1.0,1,0.12227900071582196,35
1656,0,3341,1288,2053,0,0,0,1.0,1,1.0,1,1.0,1,0.12227900071582196,35
1657,0,3341,1288,2053,0,0,0,1.0,1,1.0,1,1.0,1,0.13691195442627346,36
1658,1,3342,1289,2053,0,0,0,1.0,1,1.0,1,1.0,1,0.13157090661377738,36
1659,1,3343,1289,2054,0,0,0,1.0,1,1.0,1,1.0,1,0.10193494606210786,36
1660,4,3347,1292,2055,0,0,0,1.0,1,1.0,1,1.0,1,0.14843911354055342,38
1661,0,3347,1292,2055,0,0,0,1.0,1,1.0,1,1.0,1,0.14843911354055342,38
1662,3,3350,1295,2055,0,0,0,1.0,1,1.0,1,1.0,1,0.13180350008538408,39
1663,2,3352,1296,2056,0,0,0,1.0,1,1.0,1,1.0,1,0.1522610932005621,40
1664,1,3353,1297,2056,0,0,0,1.0,1,1.0,1,1.0,1,0.20165584262962774,39
1665,4,3357,1298,2059,0,0,0,1.0,1,1.0,1,1.0,1,0.15844088456784974,40
1666,3,3360,1299,2061,0,0,0,1.0,1,1.0,1,1.0,1,0.17847277399718164,40
1667,4,3364,1300,2064,0,0,0,1.0,1,1.0,1,1.0,1,0.15982440799968747,40
1668,2,3366,1302,2064,0,0,0,1.0,1,1.0,1,1.0,1,0.1499835475183816,41
1669,1,3367,1302,2065,0,0,0,1.0,1,1.0,1,1.0,1,0.09762101283699749,40
1670,1,3368,1303,2065,0,0,0,1.0,1,1.0,1,1.0,1,0.11939834025595561,40
1671,0,3368,1303,2065,0,0,0,1.0,1,1.0,1,1.0,1,0.11490318941802727,41
1672,2,3370,1304,2066,0,0,0,1.0,1,1.0,1,1.0,1,0.1275469510377522,40
1673,1,3371,1305,2066,0,0,0,1.0,1,1.0,1,1.0,1,0.16006637557314907,39
1674,1,3372,1306,2066,0,0,0,1.0,1,1.0,1,1.0,1,0.17478037880761865,40
1675,1,3373,1306,2067,0,0,0,1.0,1,1.0,1,1.0,1,0.13846244940602495,38
1676,0,3373,1306,2067,0,0,0,1.0,1,1.0,1,1.0,1,0.14446248758526783,39
1677,0,3373,1306,2067,0,0,0,1.0,1,1.0,1,1.0,1,0.14463256811434297,39
1678,1,3374,1306,2068,0,0,0,1.0,1,1.0,1,1.0,1,0.12330022405238325,39
1679,1,3375,1306,2069,0,0,0,1.0,1,1.0,1,1.0,1,0.10442943411086518,39
1680,5,3380,1309,2071,0,0,0,1.0,1,1.0,1,1.0,1,0.10388382882783823,41
1681,2,3382,1311,2071,0,0,0,1.0,1,1.0,1,1.0,1,0.1612255108766285,41
1682,2,3384,1311,2073,0,0,0,1.0,1,1.0,1,1.0,1,0.12228142197824916,43
1683,5,3389,1315,2074,0,0,0,1.0,1,1.0,1,1.0,1,0.1447032469188087,43
1684,2,3391,1316,2075,0,0,0,1.0,1,1.0,1,1.0,1,0.122665263587175,42
1685,2,3393,1317,2076,0,0,0,1.0,1,1.0,1,1.0,1,0.10507723560738148,41
1686,3,3396,1319,2077,0,0,0,1.0,1,1.0,1,1.0,1,0.10112308828058049,41
1687,0,3396,1319,2077,0,0,0,1.0,1,1.0,1,1.0,1,0.08080749213766496,40
1688,2,3398,1321,2077,0,0,0,1.0,1,1.0,1,1.0,1,0.1452446675714933,39
1689,2,3400,1322,2078,0,0,0,1.0,1,1.0,1,1.0,1,0.17214181522028976,38
1690,3,3403,1323,2080,0,0,0,1.0,1,1.0,1,1.0,1,0.12495016083377308,38
1691,0,3403,1323,2080,0,0,0,1.0,1,1.0,1,1.0,1,0.17776964883453358,36
1692,0,3403,1323,2080,0,0,0,1.0,1,1.0,1,1.0,1,0.1967609600241861,36
1693,3,3406,1324,2082,0,0,0,1.0,1,1.0,1,1.0,1,0.1538261267334048,35
1694,1,3407,1325,2082,0,0,0,1.0,1,1.0,1,1.0,1,0.18554946910525746,33
1695,0,3407,1325,2082,0,0,0,1.0,1,1.0,1,1.0,1,0.19900478184965842,34
1696,3,3410,1326,2084,0,0,0,1.0,1,1.0,1,1.0,1,0.207905104423625,35
1697,1,3411,1326,2085,0,0,0,1.0,1,1.0,1,1.0,1,0.20775584577809936,36
1698,2,3413,1328,2085,0,0,0,1.0,1,1.0,1,1.0,1,0.22667300457431985,38
1699,3,3416,1329,2087,0,0,0,1.0,1,1.0,1,1.0,1,0.19594036226868244,38
1700,1,3417,1329,2088,0,0,0,1.0,1,1.0,1,1.0,1,0.18750476763183466,39
1701,0,3417,1329,2088,0,0,0,1.0,1,1.0,1,1.0,1,0.1949233234977161,40
1702,4,3421,1331,2090,0,0,0,1.0,1,1.0,1,1.0,1,0.22887194021895776,41
1703,3,3424,1332,2092,0,0,0,1.0,1,1.0,1,1.0,1,0.2363274846145846,41
1704,5,3429,1334,2095,0,0,0,1.0,1,1.0,1,1.0,1,0.16555317049738072,41
1705,4,3433,1335,2098,0,0,0,1.0,1,1.0,1,1.0,1,0.09315417635245592,40
1706,4,3437,1336,2101,0,0,0,1.0,1,1.0,1,1.0,1,0.055790411153832785,40
1707,2,3439,1337,2102,0,0,0,1.0,1,1.0,1,1.0,1,0.14259705544292783,39
1708,3,3442,1338,2104,0,0,0,1.0,1,1.0,1,1.0,1,0.08455521208482455,39
1709,0,3442,1338,2104,0,0,0,1.0,1,1.0,1,1.0,1,0.10031309388126804,38
1710,4,3446,1340,2106,0,0,0,1.0,1,1.0,1,1.0,1,0.08266847567904176,39
1711,0,3446,1340,2106,0,0,0,1.0,1,1.0,1,1.0,1,0.09999896366058647,38
1712,1,3447,1341,2106,0,0,0,1.0,1,1.0,1,1.0,1,0.10935829852384421,38
1713,0,3447,1341,2106,0,0,0,1.0,1,1.0,1,1.0,1,0.12417041783459659,37
1714,3,3450,1343,2107,0,0,0,1.0,1,1.0,1,1.0,1,0.20365819471279284,38
1715,4,3454,1344,2110,0,0,0,1.0,1,1.0,1,1.0,1,0.14867800825343475,40
1716,0,3454,1344,2110,0,0,0,1.0,1,1.0,1,1.0,1,0.15460196546173818,39
1717,2,3456,1346,2110,0,0,0,1.0,1,1.0,1,1.0,1,0.14997998137058077,38
1718,0,3456,1346,2110,0,0,0,1.0,1,1.0,1,1.0,1,0.1754803238536716,38
1719,0,3456,1346,2110,0,0,0,1.0,1,1.0,1,1.0,1,0.1754803238536716,38
1720,3,3459,1347,2112,0,0,0,1.0,1,1.0,1,1.0,1,0.16618179549926995,41
1721,2,3461,1348,2113,0,0,0,1.0,1,1.0,1,1.0,1,0.13482097918729447,39
1722,2,3463,1350,2113,0,0,0,1.0,1,1.0,1,1.0,1,0.16756911912388694,40
1723,0,3463,1350,2113,0,0,0,1.0,1,1.0,1,1.0,1,0.13750827054130127,38
1724,0,3463,1350,2113,0,0,0,1.0,1,1.0,1,1.0,1,0.20134924833452203,37
1725,2,3465,1350,2115,0,0,0,1.0,1,1.0,1,1.0,1,0.20416951224386382,38
1726,1,3466,1350,2116,0,0,0,1.0,1,1.0,1,1.0,1,0.1472714474426953,37
1727,0,3466,1350,2116,0,0,0,1.0,1,1.0,1,1.0,1,0.1472714474426953,37
1728,0,3466,1350,2116,0,0,0,1.0,1,1.0,1,1.0,1,0.15915715117838836,35
1729,0,3466,1350,2116,0,0,0,1.0,1,1.0,1,1.0,1,0.15961499900025752,37
1730,4,3470,1351,2119,0,0,0,1.0,1,1.0,1,1.0,1,0.1656428188278879,37
1731,0,3470,1351,2119,0,0,0,1.0,1,1.0,1,1.0,1,0.1656428188278879,37
1732,5,3475,1351,2124,0,0,0,1.0,1,1.0,1,1.0,1,0.15325137182745166,37
1733,2,3477,1352,2125,0,0,0,1.0,1,1.0,1,1.0,1,0.16974992307072634,36
1734,1,3478,1352,2126,0,0,0,1.0,1,1.0,1,1.0,1,0.19032386367998264,35
1735,4,3482,1353,2129,0,0,0,1.0,1,1.0,1,1.0,1,0.1780042049580036,34
1736,0,3482,1353,2129,0,0,0,1.0,1,1.0,1,1.0,1,0.16883143619346885,35
1737,4,3486,1355,2131,0,0,0,1.0,1,1.0,1,1.0,1,0.1613108585644827,36
1738,2,3488,1355,2133,0,0,0,1.0,1,1.0,1,1.0,1,0.13931177134011669,37
1739,1,3489,1355,2134,0,0,0,1.0,1,1.0,1,1.0,1,0.1257900546999573,38
1740,0,3489,1355,2134,0,0,0,1.0,1,1.0,1,1.0,1,0.11979663195179116,37
1741,1,3490,1355,2135,0,0,0,1.0,1,1.0,1,1.0,1,0.10486952785474192,38
1742,4,3494,1357,2137,0,0,0,1.0,1,1.0,1,1.0,1,0.18719560529359192,39
1743,4,3498,1359,2139,0,0,0,1.0,1,1.0,1,1.0,1,0.1932724662503107,37
1744,4,3502,1360,2142,0,0,0,1.0,1,1.0,1,1.0,1,0.12254564040068973,38
1745,3,3505,1361,2144,0,0,0,1.0,1,1.0,1,1.0,1,0.18180563069750133,37
1746,0,3505,1361,2144,0,0,0,1.0,1,1.0,1,1.0,1,0.16303499163995594,38
1747,3,3508,1361,2147,0,0,0,1.0,1,1.0,1,1.0,1,0.12590109680690686,38
1748,2,3510,1362,2148,0,0,0,1.0,1,1.0,1,1.0,1,0.08818771771956271,38
1749,0,3510,1362,2148,0,0,0,1.0,1,1.0,1,1.0,1,0.11644652100628367,37
1750,3,3513,1362,2151,0,0,0,1.0,1,1.0,1,1.0,1,0.11937355956330706,39
1751,0,3513,1362,2151,0,0,0,1.0,1,1.0,1,1.0,1,0.1403256950268375,38
1752,0,3513,1362,2151,0,0,0,1.0,1,1.0,1,1.0,1,0.11840680458541467,39
1753,3,3516,1362,2154,0,0,0,1.0,1,1.0,1,1.0,1,0.06101083049568619,40
1754,2,3518,1363,2155,0,0,0,1.0,1,1.0,1,1.0,1,0.11849588938244589,41
1755,2,3520,1363,2157,0,0,0,1.0,1,1.0,1,1.0,1,0.1345830787610999,41
1756,2,3522,1364,2158,0,0,0,1.0,1,1.0,1,1.0,1,0.12720435948034176,42
1757,2,3524,1364,2160,0,0,0,1.0,1,1.0,1,1.0,1,0.09711368325877175,42
1758,4,3528,1367,2161,0,0,0,1.0,1,1.0,1,1.0,1,0.18206133367540678,42
1759,3,3531,1367,2164,0,0,0,1.0,1,1.0,1,1.0,1,0.17721836278981196,39
1760,4,3535,1369,2166,0,0,0,1.0,1,1.0,1,1.0,1,0.21271055459145746,39
1761,4,3539,1370,2169,0,0,0,1.0,1,1.0,1,1.0,1,0.14778721824957183,38
1762,1,3540,1370,2170,0,0,0,1.0,1,1.0,1,1.0,1,0.13180836567094295,37
1763,3,3543,1371,2172,0,0,0,1.0,1,1.0,1,1.0,1,0.0896245907627856,37
1764,1,3544,1372,2172,0,0,0,1.0,1,1.0,1,1.0,1,0.15423963363147639,36
1765,3,3547,1374,2173,0,0,0,1.0,1,1.0,1,1.0,1,0.1569857961668118,37
1766,1,3548,1374,2174,0,0,0,1.0,1,1.0,1,1.0,1,0.10741559551021113,36
1767,0,3548,1374,2174,0,0,0,1.0,1,1.0,1,1.0,1,0.10741559551021113,36
1768,0,3548,1374,2174,0,0,0,1.0,1,1.0,1,1.0,1,0.10741559551021113,36
1769,1,3549,1374,2175,0,0,0,1.0,1,1.0,1,1.0,1,0.09593517974281042,38
1770,0,3549,1374,2175,0,0,0,1.0,1,1.0,1,1.0,1,0.09593517974281042,38
1771,0,3549,1374,2175,0,0,0,1.0,1,1.0,1,1.0,1,0.09593517974281042,38
1772,0,3549,1374,2175,0,0,0,1.0,1,1.0,1,1.0,1,0.1321491435178865,40
1773,1,3550,1375,2175,0,0,0,1.0,1,1.0,1,1.0,1,0.13101394676558675,40
1774,0,3550,1375,2175,0,0,0,1.0,1,1.0,1,1.0,1,0.13101394676558675,40
1775,3,3553,1376,2177,0,0,0,1.0,1,1.0,1,1.0,1,0.14211335510253156,41
1776,0,3553,1376,2177,0,0,0,1.0,1,1.0,1,1.0,1,0.1259115296463568,43
1777,1,3554,1377,2177,0,0,0,1.0,1,1.0,1,1.0,1,0.11024904967353469,44
1778,4,3558,1379,2179,0,0,0,1.0,1,1.0,1,1.0,1,0.11714899629129233,44
1779,1,3559,1380,2179,0,0,0,1.0,1,1.0,1,1.0,1,0.1163375111003026,44
1780,2,3561,1380,2181,0,0,0,1.0,1,1.0,1,1.0,1,0.08966402483452053,46
1781,1,3562,1380,2182,0,0,0,1.0,1,1.0,1,1.0,1,0.08482610794214128,46
1782,3,3565,1382,2183,0,0,0,1.0,1,1.0,1,1.0,1,0.12380151482033344,45
1783,4,3569,1385,2184,0,0,0,1.0,1,1.0,1,1.0,1,0.16922815034729147,44
1784,1,3570,1386,2184,0,0,0,1.0,1,1.0,1,1.0,1,0.18009282144128158,44
1785,2,3572,1388,2184,0,0,0,1.0,1,1.0,1,1.0,1,0.22586525352071515,42
1786,11,3583,1391,2192,0,0,0,1.0,1,1.0,1,1.0,1,0.1491224697360251,42
1787,4,3587,1392,2195,0,0,0,1.0,1,1.0,1,1.0,1,0.14161641888311705,41
1788,3,3590,1393,2197,0,0,0,1.0,1,1.0,1,1.0,1,0.14308112320733693,41
1789,2,3592,1393,2199,0,0,0,1.0,1,1.0,1,1.0,1,0.0929140379625262,41
1790,3,3595,1396,2199,0,0,0,1.0,1,1.0,1,1.0,1,0.19176520991586027,41
1791,1,3596,1396,2200,0,0,0,1.0,1,1.0,1,1.0,1,0.16099802225617724,41
1792,2,3598,1396,2202,0,0,0,1.0,1,1.0,1,1.0,1,0.1164401906765752,43
1793,5,3603,1398,2205,0,0,0,1.0,1,1.0,1,1.0,1,0.0817757488666632,43
1794,0,3603,1398,2205,0,0,0,1.0,1,1.0,1,1.0,1,0.09477374076102837,41
1795,1,3604,1399,2205,0,0,0,1.0,1,1.0,1,1.0,1,0.12589430160580137,41
1796,2,3606,1400,2206,0,0,0,1.0,1,1.0,1,1.0,1,0.1917605245552435,40
1797,1,3607,1401,2206,0,0,0,1.0,1,1.0,1,1.0,1,0.22772499806679286,38
1798,6,3613,1401,2212,0,0,0,1.0,1,1.0,1,1.0,1,0.11708445481548484,38
1799,4,3617,1404,2213,0,0,0,1.0,1,1.0,1,1.0,1,0.1895786327679308,37
1800,2,3619,1405,2214,0,0,0,1.0,1,1.0,1,1.0,1,0.1934184755084476,35
1801,4,3623,1406,2217,0,0,0,1.0,1,1.0,1,1.0,1,0.1896919541671549,34
1802,0,3623,1406,2217,0,0,0,1.0,1,1.0,1,1.0,1,0.20256567185941135,33
1803,0,3623,1406,2217,0,0,0,1.0,1,1.0,1,1.0,1,0.20256567185941135,33
1804,3,3626,1406,2220,0,0,0,1.0,1,1.0,1,1.0,1,0.15253628536570057,33
1805,1,3627,1406,2221,0,0,0,1.0,1,1.0,1,1.0,1,0.1300348933803674,35
1806,2,3629,1407,2222,0,0,0,1.0,1,1.0,1,1.0,1,0.1534293460047571,36
1807,3,3632,1407,2225,0,0,0,1.0,1,1.0,1,1.0,1,0.10763108546792559,35
1808,1,3633,1407,2226,0,0,0,1.0,1,1.0,1,1.0,1,0.10942922009109256,37
1809,2,3635,1407,2228,0,0,0,1.0,1,1.0,1,1.0,1,0.15609684468442606,35
1810,0,3635,1407,2228,0,0,0,1.0,1,1.0,1,1.0,1,0.17032163317192747,36
1811,1,3636,1408,2228,0,0,0,1.0,1,1.0,1,1.0,1,0.21563799236267112,34
1812,1,3637,1408,2229,0,0,0,1.0,1,1.0,1,1.0,1,0.19354618427010284,36
1813,2,3639,1409,2230,0,0,0,1.0,1,1.0,1,1.0,1,0.19102212428468743,35
1814,3,3642,1410,2232,0,0,0,1.0,1,1.0,1,1.0,1,0.23201500816055515,36
1815,1,3643,1411,2232,0,0,0,1.0,1,1.0,1,1.0,1,0.27215069817844006,35
1816,3,3646,1411,2235,0,0,0,1.0,1,1.0,1,1.0,1,0.22606858452861933,35
1817,2,3648,1412,2236,0,0,0,1.0,1,1.0,1,1.0,1,0.23825862689905525,35
1818,2,3650,1413,2237,0,0,0,1.0,1,1.0,1,1.0,1,0.21103635981128116,36
1819,4,3654,1414,2240,0,0,0,1.0,1,1.0,1,1.0,1,0.14347715259341667,37
1820,2,3656,1414,2242,0,0,0,1.0,1,1.0,1,1.0,1,0.14422218894287914,37
1821,0,3656,1414,2242,0,0,0,1.0,1,1.0,1,1.0,1,0.14502796996053693,38
1822,3,3659,1416,2243,0,0,0,1.0,1,1.0,1,1.0,1,0.16723359136180208,37
1823,2,3661,1417,2244,0,0,0,1.0,1,1.0,1,1.0,1,0.1748909381054329,36
1824,2,3663,1419,2244,0,0,0,1.0,1,1.0,1,1.0,1,0.230439024431133,36
1825,6,3669,1421,2248,0,0,0,1.0,1,1.0,1,1.0,1,0.11490520716306225,34
1826,2,3671,1422,2249,0,0,0,1.0,1,1.0,1,1.0,1,0.14995698781169303,35
1827,2,3673,1424,2249,0,0,0,1.0,1,1.0,1,1.0,1,0.1588586157379519,34
1828,4,3677,1427,2250,0,0,0,1.0,1,1.0,1,1.0,1,0.16532944632536303,33
1829,0,3677,1427,2250,0,0,0,1.0,1,1.0,1,1.0,1,0.13438106125932645,31
1830,1,3678,1428,2250,0,0,0,1.0,1,1.0,1,1.0,1,0.11723522060553751,31
1831,2,3680,1429,2251,0,0,0,1.0,1,1.0,1,1.0,1,0.0956960803698314,30
1832,0,3680,1429,2251,0,0,0,1.0,1,1.0,1,1.0,1,0.11024075970106523,29
1833,2,3682,1431,2251,0,0,0,1.0,1,1.0,1,1.0,1,0.14666826735339444,28
1834,2,3684,1432,2252,0,0,0,1.0,1,1.0,1,1.0,1,0.15118589829971685,27
1835,4,3688,1435,2253,0,0,0,1.0,1,1.0,1,1.0,1,0.1546402611476295,26
1836,6,3694,1437,2257,0,0,0,1.0,1,1.0,1,1.0,1,0.1694890419556703,26
1837,2,3696,1438,2258,0,0,0,1.0,1,1.0,1,1.0,1,0.26952441536812505,25
1838,2,3698,1438,2260,0,0,0,1.0,1,1.0,1,1.0,1,0.15626320406784552,25
1839,0,3698,1438,2260,0,0,0,1.0,1,1.0,1,1.0,1,0.20302043470766473,24
1840,1,3699,1439,2260,0,0,0,1.0,1,1.0,1,1.0,1,0.23791537733445745,23
1841,0,3699,1439,2260,0,0,0,1.0,1,1.0,1,1.0,1,0.24978658144922022,22
1842,3,3702,1440,2262,0,0,0,1.0,1,1.0,1,1.0,1,0.20552279763459022,23
1843,0,3702,1440,2262,0,0,0,1.0,1,1.0,1,1.0,1,0.20552279763459022,23
1844,0,3702,1440,2262,0,0,0,1.0,1,1.0,1,1.0,1,0.20552279763459022,23
1845,2,3704,1442,2262,0,0,0,1.0,1,1.0,1,1.0,1,0.2583475594634585,23
1846,3,3707,1442,2265,0,0,0,1.0,1,1.0,1,1.0,1,0.1364764209226825,23
1847,0,3707,1442,2265,0,0,0,1.0,1,1.0,1,1.0,1,0.1256093869835753,24
1848,0,3707,1442,2265,0,0,0,1.0,1,1.0,1,1.0,1,0.1256093869835753,24
1849,0,3707,1442,2265,0,0,0,1.0,1,1.0,1,1.0,1,0.14387508920292877,25
1850,0,3707,1442,2265,0,0,0,1.0,1,1.0,1,1.0,1,0.14387508920292877,25
1851,0,3707,1442,2265,0,0,0,1.0,1,1.0,1,1.0,1,0.14387508920292877,25
1852,0,3707,1442,2265,0,0,0,1.0,1,1.0,1,1.0,1,0.14387508920292877,25
1853,0,3707,1442,2265,0,0,0,1.0,1,1.0,1,1.0,1,0.16270577311157816,25
1854,0,3707,1442,2265,0,0,0,1.0,1,1.0,1,1.0,1,0.16270577311157816,25
1855,0,3707,1442,2265,0,0,0,1.0,1,1.0,1,1.0,1,0.1895078971321846,26
1856,1,3708,1443,2265,0,0,0,1.0,1,1.0,1,1.0,1,0.24171402555562385,27
1857,3,3711,1444,2267,0,0,0,1.0,1,1.0,1,1.0,1,0.3115000762846798,28
1858,2,3713,1444,2269,0,0,0,1.0,1,1.0,1,1.0,1,0.25226941810567394,28
1859,4,3717,1447,2270,0,0,0,1.0,1,1.0,1,1.0,1,0.2823403689600417,28
1860,0,3717,1447,2270,0,0,0,1.0,1,1.0,1,1.0,1,0.2823403689600417,28
1861,1,3718,1447,2271,0,0,0,1.0,1,1.0,1,1.0,1,0.2655105142063283,28
1862,1,3719,1447,2272,0,0,0,1.0,1,1.0,1,1.0,1,0.2550452231635697,28
1863,0,3719,1447,2272,0,0,0,1.0,1,1.0,1,1.0,1,0.26706391042320343,29
1864,3,3722,1448,2274,0,0,0,1.0,1,1.0,1,1.0,1,0.24121154725689595,27
1865,1,3723,1449,2274,0,0,0,1.0,1,1.0,1,1.0,1,0.2628375259292329,26
1866,2,3725,1450,2275,0,0,0,1.0,1,1.0,1,1.0,1,0.2735503831455261,26
1867,1,3726,1450,2276,0,0,0,1.0,1,1.0,1,1.0,1,0.23365278358409824,26
1868,1,3727,1450,2277,0,0,0,1.0,1,1.0,1,1.0,1,0.23027854243854648,26
1869,0,3727,1450,2277,0,0,0,1.0,1,1.0,1,1.0,1,0.23027854243854648,26
1870,1,3728,1450,2278,0,0,0,1.0,1,1.0,1,1.0,1,0.22584331107290231,27
1871,0,3728,1450,2278,0,0,0,1.0,1,1.0,1,1.0,1,0.22584331107290231,27
1872,0,3728,1450,2278,0,0,0,1.0,1,1.0,1,1.0,1,0.24883095090527824,25
1873,0,3728,1450,2278,0,0,0,1.0,1,1.0,1,1.0,1,0.24883095090527824,25
1874,2,3730,1450,2280,0,0,0,1.0,1,1.0,1,1.0,1,0.26229954968083785,25
1875,1,3731,1450,2281,0,0,0,1.0,1,1.0,1,1.0,1,0.24270422118009868,25
1876,0,3731,1450,2281,0,0,0,1.0,1,1.0,1,1.0,1,0.22559667845828443,26
1877,1,3732,1450,2282,0,0,0,1.0,1,1.0,1,1.0,1,0.2259936797722436,27
1878,1,3733,1451,2282,0,0,0,1.0,1,1.0,1,1.0,1,0.24570285080325763,28
1879,2,3735,1451,2284,0,0,0,1.0,1,1.0,1,1.0,1,0.20535857294567794,29
1880,1,3736,1451,2285,0,0,0,1.0,1,1.0,1,1.0,1,0.1891642710036321,29
1881,0,3736,1451,2285,0,0,0,1.0,1,1.0,1,1.0,1,0.1891642710036321,29
1882,0,3736,1451,2285,0,0,0,1.0,1,1.0,1,1.0,1,0.19214598283657816,28
1883,0,3736,1451,2285,0,0,0,1.0,1,1.0,1,1.0,1,0.19214598283657816,28
1884,1,3737,1452,2285,0,0,0,1.0,1,1.0,1,1.0,1,0.2156172930689382,28
1885,0,3737,1452,2285,0,0,0,1.0,1,1.0,1,1.0,1,0.2156172930689382,28
1886,0,3737,1452,2285,0,0,0,1.0,1,1.0,1,1.0,1,0.19968198374166343,29
1887,0,3737,1452,2285,0,0,0,1.0,1,1.0,1,1.0,1,0.19968198374166343,29
1888,2,3739,1452,2287,0,0,0,1.0,1,1.0,1,1.0,1,0.1745517402865719,31
1889,0,3739,1452,2287,0,0,0,1.0,1,1.0,1,1.0,1,0.1745517402865719,31
1890,0,3739,1452,2287,0,0,0,1.0,1,1.0,1,1.0,1,0.1745517402865719,31
1891,0,3739,1452,2287,0,0,0,1.0,1,1.0,1,1.0,1,0.19565281077873592,32
1892,0,3739,1452,2287,0,0,0,1.0,1,1.0,1,1.0,1,0.19565281077873592,32
1893,0,3739,1452,2287,0,0,0,1.0,1,1.0,1,1.0,1,0.19565281077873592,32
1894,0,3739,1452,2287,0,0,0,1.0,1,1.0,1,1.0,1,0.18149712909919807,33
1895,4,3743,1453,2290,0,0,0,1.0,1,1.0,1,1.0,1,0.13929818808004182,35
1896,0,3743,1453,2290,0,0,0,1.0,1,1.0,1,1.0,1,0.16337892888891675,34
1897,0,3743,1453,2290,0,0,0,1.0,1,1.0,1,1.0,1,0.16337892888891675,34
1898,0,3743,1453,2290,0,0,0,1.0,1,1.0,1,1.0,1,0.16337892888891675,34
1899,0,3743,1453,2290,0,0,0,1.0,1,1.0,1,1.0,1,0.16337892888891675,34
1900,1,3744,1453,2291,0,0,0,1.0,1,1.0,1,1.0,1,0.12546053629953544,35
1901,0,3744,1453,2291,0,0,0,1.0,1,1.0,1,1.0,1,0.12546053629953544,35
1902,1,3745,1454,2291,0,0,0,1.0,1,1.0,1,1.0,1,0.1636381049213712,35
1903,0,3745,1454,2291,0,0,0,1.0,1,1.0,1,1.0,1,0.1636381049213712,35
1904,0,3745,1454,2291,0,0,0,1.0,1,1.0,1,1.0,1,0.1636381049213712,35
1905,1,3746,1454,2292,0,0,0,1.0,1,1.0,1,1.0,1,0.14118059037186967,37
1906,0,3746,1454,2292,0,0,0,1.0,1,1.0,1,1.0,1,0.14118059037186967,37
1907,1,3747,1454,2293,0,0,0,1.0,1,1.0,1,1.0,1,0.12485075402430233,39
1908,0,3747,1454,2293,0,0,0,1.0,1,1.0,1,1.0,1,0.12485075402430233,39
1909,2,3749,1455,2294,0,0,0,1.0,1,1.0,1,1.0,1,0.16767917983594527,41
1910,0,3749,1455,2294,0,0,0,1.0,1,1.0,1,1.0,1,0.16767917983594527,41
1911,1,3750,1455,2295,0,0,0,1.0,1,1.0,1,1.0,1,0.20802954706799445,40
1912,3,3753,1456,2297,0,0,0,1.0,1,1.0,1,1.0,1,0.18718097978308634,39
1913,1,3754,1456,2298,0,0,0,1.0,1,1.0,1,1.0,1,0.18851906379236966,40
1914,2,3756,1458,2298,0,0,0,1.0,1,1.0,1,1.0,1,0.23130684757509834,41
1915,6,3762,1459,2303,0,0,0,1.0,1,1.0,1,1.0,1,0.19337013711036607,42
1916,2,3764,1460,2304,0,0,0,1.0,1,1.0,1,1.0,1,0.18500122251977308,42
1917,0,3764,1460,2304,0,0,0,1.0,1,1.0,1,1.0,1,0.1959938653857528,41
1918,6,3770,1462,2308,0,0,0,1.0,1,1.0,1,1.0,1,0.17263326133322626,38
1919,4,3774,1464,2310,0,0,0,1.0,1,1.0,1,1.0,1,0.24961288219729114,38
1920,1,3775,1464,2311,0,0,0,1.0,1,1.0,1,1.0,1,0.26128835274424533,38
1921,4,3779,1464,2315,0,0,0,1.0,1,1.0,1,1.0,1,0.19715366230879142,39
1922,2,3781,1464,2317,0,0,0,1.0,1,1.0,1,1.0,1,0.14987904983000408,40
1923,0,3781,1464,2317,0,0,0,1.0,1,1.0,1,1.0,1,0.1463896978865545,41
1924,2,3783,1466,2317,0,0,0,1.0,1,1.0,1,1.0,1,0.177269324655663,41
1925,0,3783,1466,2317,0,0,0,1.0,1,1.0,1,1.0,1,0.16796209451024904,41
1926,0,3783,1466,2317,0,0,0,1.0,1,1.0,1,1.0,1,0.16796209451024904,41
1927,2,3785,1466,2319,0,0,0,1.0,1,1.0,1,1.0,1,0.1394406940507401,41
1928,2,3787,1468,2319,0,0,0,1.0,1,1.0,1,1.0,1,0.17279170985963366,42
1929,0,3787,1468,2319,0,0,0,1.0,1,1.0,1,1.0,1,0.16352570972154018,41
1930,2,3789,1468,2321,0,0,0,1.0,1,1.0,1,1.0,1,0.13926840047937986,41
1931,0,3789,1468,2321,0,0,0,1.0,1,1.0,1,1.0,1,0.13926840047937986,41
1932,0,3789,1468,2321,0,0,0,1.0,1,1.0,1,1.0,1,0.13926840047937986,41
1933,2,3791,1469,2322,0,0,0,1.0,1,1.0,1,1.0,1,0.16078922517165647,43
1934,2,3793,1469,2324,0,0,0,1.0,1,1.0,1,1.0,1,0.16744326617247451,44
1935,0,3793,1469,2324,0,0,0,1.0,1,1.0,1,1.0,1,0.13624270759530194,45
1936,1,3794,1469,2325,0,0,0,1.0,1,1.0,1,1.0,1,0.12704510246464015,48
1937,2,3796,1471,2325,0,0,0,1.0,1,1.0,1,1.0,1,0.16375645757939866,48
1938,2,3798,1472,2326,0,0,0,1.0,1,1.0,1,1.0,1,0.13184831103563593,48
1939,2,3800,1472,2328,0,0,0,1.0,1,1.0,1,1.0,1,0.10745693679497662,48
1940,0,3800,1472,2328,0,0,0,1.0,1,1.0,1,1.0,1,0.10745693679497662,48
1941,0,3800,1472,2328,0,0,0,1.0,1,1.0,1,1.0,1,0.10745693679497662,48
1942,3,3803,1474,2329,0,0,0,1.0,1,1.0,1,1.0,1,0.1582492891145747,49
1943,0,3803,1474,2329,0,0,0,1.0,1,1.0,1,1.0,1,0.14590201815621454,48
1944,5,3808,1476,2332,0,0,0,1.0,1,1.0,1,1.0,1,0.17040829867636345,47
1945,3,3811,1478,2333,0,0,0,1.0,1,1.0,1,1.0,1,0.15365876034838755,46
1946,0,3811,1478,2333,0,0,0,1.0,1,1.0,1,1.0,1,0.17132870122799013,46
1947,7,3818,1481,2337,0,0,0,1.0,1,1.0,1,1.0,1,0.21417419350986497,45
1948,5,3823,1481,2342,0,0,0,1.0,1,1.0,1,1.0,1,0.1831821704137573,46
1949,3,3826,1483,2343,0,0,0,1.0,1,1.0,1,1.0,1,0.20975317898011667,42
1950,2,3828,1484,2344,0,0,0,1.0,1,1.0,1,1.0,1,0.20905753433822996,40
1951,2,3830,1485,2345,0,0,0,1.0,1,1.0,1,1.0,1,0.1881260144429248,39
1952,1,3831,1486,2345,0,0,0,1.0,1,1.0,1,1.0,1,0.24388150856387908,35
1953,3,3834,1488,2346,0,0,0,1.0,1,1.0,1,1.0,1,0.21212654928808808,36
1954,4,3838,1488,2350,0,0,0,1.0,1,1.0,1,1.0,1,0.13131794641634387,34
1955,1,3839,1489,2350,0,0,0,1.0,1,1.0,1,1.0,1,0.17729064578941617,35
1956,4,3843,1491,2352,0,0,0,1.0,1,1.0,1,1.0,1,0.2025884132525964,37
1957,2,3845,1491,2354,0,0,0,1.0,1,1.0,1,1.0,1,0.15713557858289923,37
1958,1,3846,1491,2355,0,0,0,1.0,1,1.0,1,1.0,1,0.17596434286174148,39
1959,1,3847,1491,2356,0,0,0,1.0,1,1.0,1,1.0,1,0.15512465464976294,41
1960,1,3848,1492,2356,0,0,0,1.0,1,1.0,1,1.0,1,0.1773971651537346,40
1961,2,3850,1493,2357,0,0,0,1.0,1,1.0,1,1.0,1,0.1540249706729185,41
1962,2,3852,1494,2358,0,0,0,1.0,1,1.0,1,1.0,1,0.20356172757151586,40
1963,3,3855,1495,2360,0,0,0,1.0,1,1.0,1,1.0,1,0.16630093208525987,41
1964,0,3855,1495,2360,0,0,0,1.0,1,1.0,1,1.0,1,0.1917956744501779,40
1965,2,3857,1496,2361,0,0,0,1.0,1,1.0,1,1.0,1,0.17913041908364075,41
1966,1,3858,1496,2362,0,0,0,1.0,1,1.0,1,1.0,1,0.16370929101600815,41
1967,2,3860,1497,2363,0,0,0,1.0,1,1.0,1,1.0,1,0.17812740741147043,42
1968,1,3861,1497,2364,0,0,0,1.0,1,1.0,1,1.0,1,0.2001995569154219,42
1969,3,3864,1498,2366,0,0,0,1.0,1,1.0,1,1.0,1,0.18850183210281063,43
1970,1,3865,1498,2367,0,0,0,1.0,1,1.0,1,1.0,1,0.18776602069909154,42
1971,1,3866,1499,2367,0,0,0,1.0,1,1.0,1,1.0,1,0.2367200385553199,42
1972,4,3870,1499,2371,0,0,0,1.0,1,1.0,1,1.0,1,0.16255338897423077,42
1973,2,3872,1499,2373,0,0,0,1.0,1,1.0,1,1.0,1,0.15795107444505066,43
1974,0,3872,1499,2373,0,0,0,1.0,1,1.0,1,1.0,1,0.1726834160347735,43
1975,2,3874,1499,2375,0,0,0,1.0,1,1.0,1,1.0,1,0.13542361253600171,43
1976,0,3874,1499,2375,0,0,0,1.0,1,1.0,1,1.0,1,0.13542361253600171,43
1977,3,3877,1499,2378,0,0,0,1.0,1,1.0,1,1.0,1,0.15016275850089708,48
1978,2,3879,1499,2380,0,0,0,1.0,1,1.0,1,1.0,1,0.13287070380000499,48
1979,1,3880,1500,2380,0,0,0,1.0,1,1.0,1,1.0,1,0.15318836501887506,49
1980,1,3881,1500,2381,0,0,0,1.0,1,1.0,1,1.0,1,0.14687796998513927,50
1981,3,3884,1502,2382,0,0,0,1.0,1,1.0,1,1.0,1,0.14497323066969114,50
1982,1,3885,1503,2382,0,0,0,1.0,1,1.0,1,1.0,1,0.15056390790346266,50
1983,1,3886,1504,2382,0,0,0,1.0,1,1.0,1,1.0,1,0.14281400458445243,49
1984,2,3888,1505,2383,0,0,0,1.0,1,1.0,1,1.0,1,0.13663123393457302,48
1985,2,3890,1507,2383,0,0,0,1.0,1,1.0,1,1.0,1,0.10689240976631817,46
1986,0,3890,1507,2383,0,0,0,1.0,1,1.0,1,1.0,1,0.10689240976631817,46
1987,3,3893,1509,2384,0,0,0,1.0,1,1.0,1,1.0,1,0.14460320161799092,42
1988,0,3893,1509,2384,0,0,0,1.0,1,1.0,1,1.0,1,0.16304339788272343,40
1989,2,3895,1511,2384,0,0,0,1.0,1,1.0,1,1.0,1,0.18230733856971262,38
1990,1,3896,1511,2385,0,0,0,1.0,1,1.0,1,1.0,1,0.14566894716674728,38
1991,4,3900,1514,2386,0,0,0,1.0,1,1.0,1,1.0,1,0.18286527244170625,38
1992,2,3902,1514,2388,0,0,0,1.0,1,1.0,1,1.0,1,0.16725499768815094,39
1993,5,3907,1516,2391,0,0,0,1.0,1,1.0,1,1.0,1,0.25414871175707304,38
1994,3,3910,1517,2393,0,0,0,1.0,1,1.0,1,1.0,1,0.19938014999399503,37
1995,2,3912,1518,2394,0,0,0,1.0,1,1.0,1,1.0,1,0.18589777004329577,37
1996,7,3919,1519,2400,0,0,0,1.0,1,1.0,1,1.0,1,0.19300170274989825,37
1997,1,3920,1519,2401,0,0,0,1.0,1,1.0,1,1.0,1,0.2309179893881947,35
1998,1,3921,1519,2402,0,0,0,1.0,1,1.0,1,1.0,1,0.22575958209184,34
1999,3,3924,1521,2403,0,0,0,1.0,1,1.0,1,1.0,1,0.18643724120788702,35
2000,0,3924,1521,2403,0,0,0,1.0,1,1.0,1,1.0,1,0.20183268078989328,34
2001,2,3926,1521,2405,0,0,0,1.0,1,1.0,1,1.0,1,0.22204494039762476,35
2002,3,3929,1522,2407,0,0,0,1.0,1,1.0,1,1.0,1,0.2264687151110657,36
2003,0,3929,1522,2407,0,0,0,1.0,1,1.0,1,1.0,1,0.24040246236042548,37
2004,3,3932,1523,2409,0,0,0,1.0,1,1.0,1,1.0,1,0.188868533852105,38
2005,3,3935,1523,2412,0,0,0,1.0,1,1.0,1,1.0,1,0.16391680080902807,38
2006,0,3935,1523,2412,0,0,0,1.0,1,1.0,1,1.0,1,0.16391680080902807,38
2007,3,3938,1524,2414,0,0,0,1.0,1,1.0,1,1.0,1,0.12957597716330174,40
2008,0,3938,1524,2414,0,0,0,1.0,1,1.0,1,1.0,1,0.12957597716330174,40
2009,2,3940,1526,2414,0,0,0,1.0,1,1.0,1,1.0,1,0.12100835514834803,41
2010,0,3940,1526,2414,0,0,0,1.0,1,1.0,1,1.0,1,0.12100835514834803,41
2011,1,3941,1526,2415,0,0,0,1.0,1,1.0,1,1.0,1,0.10727472445668747,41
2012,0,3941,1526,2415,0,0,0,1.0,1,1.0,1,1.0,1,0.10727472445668747,41
2013,0,3941,1526,2415,0,0,0,1.0,1,1.0,1,1.0,1,0.12939300112666574,43
2014,1,3942,1526,2416,0,0,0,1.0,1,1.0,1,1.0,1,0.13946331278080545,43
2015,2,3944,1528,2416,0,0,0,1.0,1,1.0,1,1.0,1,0.1470653840518651,43
2016,3,3947,1530,2417,0,0,0,1.0,1,1.0,1,1.0,1,0.18873855316404428,44
2017,3,3950,1530,2420,0,0,0,1.0,1,1.0,1,1.0,1,0.14613076481709536,45
2018,3,3953,1532,2421,0,0,0,1.0,1,1.0,1,1.0,1,0.15574759427694979,46
2019,2,3955,1532,2423,0,0,0,1.0,1,1.0,1,1.0,1,0.1146180470243352,47
2020,1,3956,1532,2424,0,0,0,1.0,1,1.0,1,1.0,1,0.09738255128461475,47
2021,1,3957,1533,2424,0,0,0,1.0,1,1.0,1,1.0,1,0.09506349047090101,47
2022,1,3958,1533,2425,0,0,0,1.0,1,1.0,1,1.0,1,0.0873123511907268,48
2023,1,3959,1534,2425,0,0,0,1.0,1,1.0,1,1.0,1,0.09168243145518509,48
2024,3,3962,1537,2425,0,0,0,1.0,1,1.0,1,1.0,1,0.11577805837276937,45
2025,2,3964,1539,2425,0,0,0,1.0,1,1.0,1,1.0,1,0.17750115535446273,42
2026,8,3972,1542,2430,0,0,0,1.0,1,1.0,1,1.0,1,0.12192192032805113,44
2027,0,3972,1542,2430,0,0,0,1.0,1,1.0,1,1.0,1,0.13259712605149065,40
2028,3,3975,1544,2431,0,0,0,1.0,1,1.0,1,1.0,1,0.15907860757622214,39
2029,0,3975,1544,2431,0,0,0,1.0,1,1.0,1,1.0,1,0.17837356918270086,37
2030,1,3976,1545,2431,0,0,0,1.0,1,1.0,1,1.0,1,0.22284778356534096,34
2031,1,3977,1545,2432,0,0,0,1.0,1,1.0,1,1.0,1,0.2320492094391808,35
2032,2,3979,1545,2434,0,0,0,1.0,1,1.0,1,1.0,1,0.2282539040299082,34
2033,6,3985,1548,2437,0,0,0,1.0,1,1.0,1,1.0,1,0.21067928900481558,36
2034,3,3988,1549,2439,0,0,0,1.0,1,1.0,1,1.0,1,0.2511741452165632,34
2035,5,3993,1550,2443,0,0,0,1.0,1,1.0,1,1.0,1,0.2122755680097784,35
2036,2,3995,1550,2445,0,0,0,1.0,1,1.0,1,1.0,1,0.1778044238595172,34
2037,0,3995,1550,2445,0,0,0,1.0,1,1.0,1,1.0,1,0.1613036184256455,35
2038,0,3995,1550,2445,0,0,0,1.0,1,1.0,1,1.0,1,0.17062239183462605,36
2039,0,3995,1550,2445,0,0,0,1.0,1,1.0,1,1.0,1,0.14610232427371947,38
2040,0,3995,1550,2445,0,0,0,1.0,1,1.0,1,1.0,1,0.14610232427371947,38
2041,0,3995,1550,2445,0,0,0,1.0,1,1.0,1,1.0,1,0.15516950937062826,39
2042,0,3995,1550,2445,0,0,0,1.0,1,1.0,1,1.0,1,0.15516950937062826,39
2043,0,3995,1550,2445,0,0,0,1.0,1,1.0,1,1.0,1,0.15516950937062826,39
2044,0,3995,1550,2445,0,0,0,1.0,1,1.0,1,1.0,1,0.15516950937062826,39
2045,3,3998,1551,2447,0,0,0,1.0,1,1.0,1,1.0,1,0.13484703958493008,41
2046,2,4000,1551,2449,0,0,0,1.0,1,1.0,1,1.0,1,0.12743440608518103,42
2047,2,4002,1551,2451,0,0,0,1.0,1,1.0,1,1.0,1,0.09385863328173802,42
2048,1,4003,1552,2451,0,0,0,1.0,1,1.0,1,1.0,1,0.1265396569109821,43
2049,2,4005,1553,2452,0,0,0,1.0,1,1.0,1,1.0,1,0.13929504561835004,44
2050,4,4009,1553,2456,0,0,0,1.0,1,1.0,1,1.0,1,0.059245896256864,44
2051,3,4012,1554,2458,0,0,0,1.0,1,1.0,1,1.0,1,0.09405875567498284,45
2052,0,4012,1554,2458,0,0,0,1.0,1,1.0,1,1.0,1,0.09405875567498284,45
2053,1,4013,1554,2459,0,0,0,1.0,1,1.0,1,1.0,1,0.07374605576242571,45
2054,1,4014,1555,2459,0,0,0,1.0,1,1.0,1,1.0,1,0.10731265643337773,46
2055,2,4016,1555,2461,0,0,0,1.0,1,1.0,1,1.0,1,0.09598747568966437,46
2056,2,4018,1556,2462,0,0,0,1.0,1,1.0,1,1.0,1,0.10174619391707984,46
2057,6,4024,1559,2465,0,0,0,1.0,1,1.0,1,1.0,1,0.12317667258924857,47
2058,4,4028,1561,2467,0,0,0,1.0,1,1.0,1,1.0,1,0.1067861787880814,47
2059,3,4031,1562,2469,0,0,0,1.0,1,1.0,1,1.0,1,0.07796330581720362,48
2060,2,4033,1563,2470,0,0,0,1.0,1,1.0,1,1.0,1,0.10612837616446233,50
2061,0,4033,1563,2470,0,0,0,1.0,1,1.0,1,1.0,1,0.10463452947375339,51
2062,3,4036,1565,2471,0,0,0,1.0,1,1.0,1,1.0,1,0.15445466748277886,49
2063,1,4037,1566,2471,0,0,0,1.0,1,1.0,1,1.0,1,0.16203093777406027,48
2064,4,4041,1567,2474,0,0,0,1.0,1,1.0,1,1.0,1,0.12725849888049437,45
2065,3,4044,1569,2475,0,0,0,1.0,1,1.0,1,1.0,1,0.13582484748705423,44
2066,1,4045,1570,2475,0,0,0,1.0,1,1.0,1,1.0,1,0.19499560358247023,42
2067,1,4046,1571,2475,0,0,0,1.0,1,1.0,1,1.0,1,0.18511324551251904,41
2068,1,4047,1571,2476,0,0,0,1.0,1,1.0,1,1.0,1,0.18099757160048544,40
2069,0,4047,1571,2476,0,0,0,1.0,1,1.0,1,1.0,1,0.1886358023856303,40
2070,2,4049,1571,2478,0,0,0,1.0,1,1.0,1,1.0,1,0.1370889953998945,40
2071,4,4053,1574,2479,0,0,0,1.0,1,1.0,1,1.0,1,0.14461037964030343,40
2072,3,4056,1574,2482,0,0,0,1.0,1,1.0,1,1.0,1,0.08651498066360704,41
2073,4,4060,1575,2485,0,0,0,1.0,1,1.0,1,1.0,1,0.11310536058974774,41
2074,1,4061,1575,2486,0,0,0,1.0,1,1.0,1,1.0,1,0.09079707063375961,41
2075,0,4061,1575,2486,0,0,0,1.0,1,1.0,1,1.0,1,0.09079707063375961,41
2076,1,4062,1576,2486,0,0,0,1.0,1,1.0,1,1.0,1,0.11501396580402738,41
2077,1,4063,1577,2486,0,0,0,1.0,1,1.0,1,1.0,1,0.1000693608615412,40
2078,1,4064,1578,2486,0,0,0,1.0,1,1.0,1,1.0,1,0.1145305116348099,40
2079,0,4064,1578,2486,0,0,0,1.0,1,1.0,1,1.0,1,0.09742509697944399,39
2080,0,4064,1578,2486,0,0,0,1.0,1,1.0,1,1.0,1,0.08771271061773372,38
2081,0,4064,1578,2486,0,0,0,1.0,1,1.0,1,1.0,1,0.11076696431583404,40
2082,4,4068,1580,2488,0,0,0,1.0,1,1.0,1,1.0,1,0.15900815546295521,41
2083,5,4073,1581,2492,0,0,0,1.0,1,1.0,1,1.0,1,0.110259686566196,40
2084,2,4075,1583,2492,0,0,0,1.0,1,1.0,1,1.0,1,0.07723746243270278,42
2085,1,4076,1584,2492,0,0,0,1.0,1,1.0,1,1.0,1,0.0917019199029089,42
2086,1,4077,1584,2493,0,0,0,1.0,1,1.0,1,1.0,1,0.08382887977692922,43
2087,1,4078,1585,2493,0,0,0,1.0,1,1.0,1,1.0,1,0.10947269596713866,45
2088,2,4080,1587,2493,0,0,0,1.0,1,1.0,1,1.0,1,0.16779995068551723,46
2089,4,4084,1587,2497,0,0,0,1.0,1,1.0,1,1.0,1,0.12010327068876239,47
2090,1,4085,1588,2497,0,0,0,1.0,1,1.0,1,1.0,1,0.16020520113209671,49
2091,0,4085,1588,2497,0,0,0,1.0,1,1.0,1,1.0,1,0.16020520113209671,49
2092,0,4085,1588,2497,0,0,0,1.0,1,1.0,1,1.0,1,0.16020520113209671,49
2093,1,4086,1589,2497,0,0,0,1.0,1,1.0,1,1.0,1,0.16499322729178337,49
2094,0,4086,1589,2497,0,0,0,1.0,1,1.0,1,1.0,1,0.16499322729178337,49
2095,2,4088,1590,2498,0,0,0,1.0,1,1.0,1,1.0,1,0.10281091821596362,49
2096,2,4090,1590,2500,0,0,0,1.0,1,1.0,1,1.0,1,0.10250512344560009,51
2097,1,4091,1590,2501,0,0,0,1.0,1,1.0,1,1.0,1,0.09503742312875657,51
2098,2,4093,1590,2503,0,0,0,1.0,1,1.0,1,1.0,1,0.07104497670066182,52
2099,1,4094,1591,2503,0,0,0,1.0,1,1.0,1,1.0,1,0.0881106358301211,51
2100,3,4097,1593,2504,0,0,0,1.0,1,1.0,1,1.0,1,0.1126217522394895,51
2101,5,4102,1593,2509,0,0,0,1.0,1,1.0,1,1.0,1,0.09478396349913684,48
2102,2,4104,1595,2509,0,0,0,1.0,1,1.0,1,1.0,1,0.14815383588285755,49
2103,8,4112,1598,2514,0,0,0,1.0,1,1.0,1,1.0,1,0.1896970228193588,48
2104,4,4116,1598,2518,0,0,0,1.0,1,1.0,1,1.0,1,0.15114343034355537,43
2105,6,4122,1601,2521,0,0,0,1.0,1,1.0,1,1.0,1,0.1635415449742871,42
2106,2,4124,1603,2521,0,0,0,1.0,1,1.0,1,1.0,1,0.1823031609039878,40
2107,1,4125,1604,2521,0,0,0,1.0,1,1.0,1,1.0,1,0.18004795220367392,39
2108,4,4129,1606,2523,0,0,0,1.0,1,1.0,1,1.0,1,0.14150509923413918,38
2109,0,4129,1606,2523,0,0,0,1.0,1,1.0,1,1.0,1,0.11918193009683119,37
2110,2,4131,1608,2523,0,0,0,1.0,1,1.0,1,1.0,1,0.16197135070321464,38
2111,1,4132,1609,2523,0,0,0,1.0,1,1.0,1,1.0,1,0.19891012005728928,37
2112,4,4136,1611,2525,0,0,0,1.0,1,1.0,1,1.0,1,0.1727328911347077,36
2113,0,4136,1611,2525,0,0,0,1.0,1,1.0,1,1.0,1,0.1748050825786955,36
2114,0,4136,1611,2525,0,0,0,1.0,1,1.0,1,1.0,1,0.15872160702220522,36
2115,0,4136,1611,2525,0,0,0,1.0,1,1.0,1,1.0,1,0.14768244679288706,35
2116,1,4137,1612,2525,0,0,0,1.0,1,1.0,1,1.0,1,0.22340848971982175,37
2117,2,4139,1612,2527,0,0,0,1.0,1,1.0,1,1.0,1,0.14841192159336608,38
2118,4,4143,1613,2530,0,0,0,1.0,1,1.0,1,1.0,1,0.14691869412843775,40
2119,1,4144,1613,2531,0,0,0,1.0,1,1.0,1,1.0,1,0.11672436187806946,40
2120,1,4145,1614,2531,0,0,0,1.0,1,1.0,1,1.0,1,0.15177934129946252,41
2121,1,4146,1614,2532,0,0,0,1.0,1,1.0,1,1.0,1,0.12165039020754952,41
2122,2,4148,1615,2533,0,0,0,1.0,1,1.0,1,1.0,1,0.13120367685940723,42
2123,0,4148,1615,2533,0,0,0,1.0,1,1.0,1,1.0,1,0.1321132959948895,43
2124,1,4149,1615,2534,0,0,0,1.0,1,1.0,1,1.0,1,0.10993754683616773,41
2125,1,4150,1616,2534,0,0,0,1.0,1,1.0,1,1.0,1,0.147684671586821,41
2126,0,4150,1616,2534,0,0,0,1.0,1,1.0,1,1.0,1,0.12858059566309937,40
2127,1,4151,1616,2535,0,0,0,1.0,1,1.0,1,1.0,1,0.10467455621702661,40
2128,0,4151,1616,2535,0,0,0,1.0,1,1.0,1,1.0,1,0.12726628832958806,41
2129,0,4151,1616,2535,0,0,0,1.0,1,1.0,1,1.0,1,0.133376513314802,42
2130,1,4152,1616,2536,0,0,0,1.0,1,1.0,1,1.0,1,0.13314983650025303,45
2131,2,4154,1616,2538,0,0,0,1.0,1,1.0,1,1.0,1,0.10868578232487601,45
2132,1,4155,1616,2539,0,0,0,1.0,1,1.0,1,1.0,1,0.10394903131536239,46
2133,3,4158,1617,2541,0,0,0,1.0,1,1.0,1,1.0,1,0.08786955655014507,46
2134,2,4160,1618,2542,0,0,0,1.0,1,1.0,1,1.0,1,0.06891572129185186,47
2135,1,4161,1619,2542,0,0,0,1.0,1,1.0,1,1.0,1,0.08108051768565247,47
2136,1,4162,1620,2542,0,0,0,1.0,1,1.0,1,1.0,1,0.10676534515161894,47
2137,4,4166,1622,2544,0,0,0,1.0,1,1.0,1,1.0,1,0.08181258266206987,49
2138,0,4166,1622,2544,0,0,0,1.0,1,1.0,1,1.0,1,0.08181258266206987,49
2139,1,4167,1623,2544,0,0,0,1.0,1,1.0,1,1.0,1,0.09705770955998005,47
2140,7,4174,1625,2549,0,0,0,1.0,1,1.0,1,1.0,1,0.09308243634952353,48
2141,2,4176,1626,2550,0,0,0,1.0,1,1.0,1,1.0,1,0.07733582424116751,47
2142,2,4178,1627,2551,0,0,0,1.0,1,1.0,1,1.0,1,0.11042352132149215,47
2143,1,4179,1628,2551,0,0,0,1.0,1,1.0,1,1.0,1,0.11759157066326625,48
2144,4,4183,1631,2552,0,0,0,1.0,1,1.0,1,1.0,1,0.13947082217520732,48
2145,4,4187,1632,2555,0,0,0,1.0,1,1.0,1,1.0,1,0.1512456840618872,46
2146,4,4191,1634,2557,0,0,0,1.0,1,1.0,1,1.0,1,0.11499902377549806,47
2147,5,4196,1637,2559,0,0,0,1.0,1,1.0,1,1.0,1,0.118895152325502,48
2148,1,4197,1637,2560,0,0,0,1.0,1,1.0,1,1.0,1,0.11525208039124504,46
2149,3,4200,1640,2560,0,0,0,1.0,1,1.0,1,1.0,1,0.10699566665815329,46
2150,1,4201,1640,2561,0,0,0,1.0,1,1.0,1,1.0,1,0.09425990627318342,46
2151,3,4204,1643,2561,0,0,0,1.0,1,1.0,1,1.0,1,0.1323770752137415,44
2152,2,4206,1644,2562,0,0,0,1.0,1,1.0,1,1.0,1,0.15011386935712015,45
2153,1,4207,1645,2562,0,0,0,1.0,1,1.0,1,1.0,1,0.17191638854306507,48
2154,4,4211,1646,2565,0,0,0,1.0,1,1.0,1,1.0,1,0.17091531350135436,47
2155,7,4218,1647,2571,0,0,0,1.0,1,1.0,1,1.0,1,0.09147480652144607,48
2156,1,4219,1648,2571,0,0,0,1.0,1,1.0,1,1.0,1,0.11960070209947798,45
2157,0,4219,1648,2571,0,0,0,1.0,1,1.0,1,1.0,1,0.13630316542141022,43
2158,2,4221,1648,2573,0,0,0,1.0,1,1.0,1,1.0,1,0.09829286909422867,43
2159,3,4224,1650,2574,0,0,0,1.0,1,1.0,1,1.0,1,0.1541058545206334,43
2160,0,4224,1650,2574,0,0,0,1.0,1,1.0,1,1.0,1,0.15452603427435918,41
2161,5,4229,1650,2579,0,0,0,1.0,1,1.0,1,1.0,1,0.12459938899839525,41
2162,3,4232,1650,2582,0,0,0,1.0,1,1.0,1,1.0,1,0.10383020287378962,42
2163,2,4234,1650,2584,0,0,0,1.0,1,1.0,1,1.0,1,0.11113272575241004,43
2164,3,4237,1652,2585,0,0,0,1.0,1,1.0,1,1.0,1,0.16791036021360894,44
2165,2,4239,1652,2587,0,0,0,1.0,1,1.0,1,1.0,1,0.12701151322193788,44
2166,2,4241,1652,2589,0,0,0,1.0,1,1.0,1,1.0,1,0.09227625545511005,46
2167,1,4242,1652,2590,0,0,0,1.0,1,1.0,1,1.0,1,0.0750762938070618,46
2168,0,4242,1652,2590,0,0,0,1.0,1,1.0,1,1.0,1,0.05853846119315481,45
2169,2,4244,1653,2591,0,0,0,1.0,1,1.0,1,1.0,1,0.06492627939199029,49
2170,0,4244,1653,2591,0,0,0,1.0,1,1.0,1,1.0,1,0.06492627939199029,49
2171,1,4245,1653,2592,0,0,0,1.0,1,1.0,1,1.0,1,0.07146383430860732,51
2172,2,4247,1654,2593,0,0,0,1.0,1,1.0,1,1.0,1,0.06811195479644222,52
2173,1,4248,1655,2593,0,0,0,1.0,1,1.0,1,1.0,1,0.1034272352750077,52
2174,2,4250,1656,2594,0,0,0,1.0,1,1.0,1,1.0,1,0.08463825975563252,52
2175,2,4252,1657,2595,0,0,0,1.0,1,1.0,1,1.0,1,0.1261189484297364,53
2176,1,4253,1657,2596,0,0,0,1.0,1,1.0,1,1.0,1,0.1165958811505448,54
2177,4,4257,1659,2598,0,0,0,1.0,1,1.0,1,1.0,1,0.13166825702130727,55
2178,4,4261,1661,2600,0,0,0,1.0,1,1.0,1,1.0,1,0.12325257297971619,54
2179,4,4265,1663,2602,0,0,0,1.0,1,1.0,1,1.0,1,0.13429009477300807,52
2180,2,4267,1663,2604,0,0,0,1.0,1,1.0,1,1.0,1,0.1080094702636907,51
2181,0,4267,1663,2604,0,0,0,1.0,1,1.0,1,1.0,1,0.1384672601141278,49
2182,8,4275,1664,2611,0,0,0,1.0,1,1.0,1,1.0,1,0.1286478932401362,49
2183,5,4280,1668,2612,0,0,0,1.0,1,1.0,1,1.0,1,0.16539687980936982,46
2184,4,4284,1670,2614,0,0,0,1.0,1,1.0,1,1.0,1,0.1425948975813055,45
2185,3,4287,1671,2616,0,0,0,1.0,1,1.0,1,1.0,1,0.08334960387108706,44
2186,8,4295,1676,2619,0,0,0,1.0,1,1.0,1,1.0,1,0.15874725094192027,42
2187,6,4301,1680,2621,0,0,0,1.0,1,1.0,1,1.0,1,0.2235838522443713,40
2188,11,4312,1683,2629,0,0,0,1.0,1,1.0,1,1.0,1,0.14929179161978479,38
2189,6,4318,1684,2634,0,0,0,1.0,1,1.0,1,1.0,1,0.13299211962836438,36
2190,4,4322,1686,2636,0,0,0,1.0,1,1.0,1,1.0,1,0.182265879138389,34
2191,4,4326,1687,2639,0,0,0,1.0,1,1.0,1,1.0,1,0.09711148458829849,34
2192,2,4328,1687,2641,0,0,0,1.0,1,1.0,1,1.0,1,0.11384452143713762,33
2193,0,4328,1687,2641,0,0,0,1.0,1,1.0,1,1.0,1,0.13902452343791805,32
2194,1,4329,1687,2642,0,0,0,1.0,1,1.0,1,1.0,1,0.11030600811575275,32
2195,0,4329,1687,2642,0,0,0,1.0,1,1.0,1,1.0,1,0.13235856485263808,31
2196,1,4330,1688,2642,0,0,0,1.0,1,1.0,1,1.0,1,0.14273424808493346,32
2197,2,4332,1688,2644,0,0,0,1.0,1,1.0,1,1.0,1,0.07163347490260125,31
2198,0,4332,1688,2644,0,0,0,1.0,1,1.0,1,1.0,1,0.07163347490260125,31
2199,2,4334,1689,2645,0,0,0,1.0,1,1.0,1,1.0,1,0.09879291529381778,32
2200,1,4335,1689,2646,0,0,0,1.0,1,1.0,1,1.0,1,0.1275423425153273,35
2201,3,4338,1690,2648,0,0,0,1.0,1,1.0,1,1.0,1,0.13114623787750482,36
2202,1,4339,1691,2648,0,0,0,1.0,1,1.0,1,1.0,1,0.13975800159779814,36
2203,2,4341,1691,2650,0,0,0,1.0,1,1.0,1,1.0,1,0.10115181447713475,37
2204,1,4342,1692,2650,0,0,0,1.0,1,1.0,1,1.0,1,0.15418833947980123,36
2205,0,4342,1692,2650,0,0,0,1.0,1,1.0,1,1.0,1,0.16137419463152053,37
2206,4,4346,1693,2653,0,0,0,1.0,1,1.0,1,1.0,1,0.13876902795562818,35
2207,2,4348,1694,2654,0,0,0,1.0,1,1.0,1,1.0,1,0.18393178703820962,37
2208,2,4350,1695,2655,0,0,0,1.0,1,1.0,1,1.0,1,0.1670406685576136,36
2209,0,4350,1695,2655,0,0,0,1.0,1,1.0,1,1.0,1,0.1711018312164906,35
2210,2,4352,1695,2657,0,0,0,1.0,1,1.0,1,1.0,1,0.18871552867674754,38
2211,1,4353,1695,2658,0,0,0,1.0,1,1.0,1,1.0,1,0.1733505866985588,37
2212,1,4354,1695,2659,0,0,0,1.0,1,1.0,1,1.0,1,0.1583663252960434,38
2213,0,4354,1695,2659,0,0,0,1.0,1,1.0,1,1.0,1,0.1583663252960434,38
2214,1,4355,1695,2660,0,0,0,1.0,1,1.0,1,1.0,1,0.14102035677839697,39
2215,1,4356,1696,2660,0,0,0,1.0,1,1.0,1,1.0,1,0.13925364642614987,39
2216,2,4358,1697,2661,0,0,0,1.0,1,1.0,1,1.0,1,0.1455739747853378,39
2217,0,4358,1697,2661,0,0,0,1.0,1,1.0,1,1.0,1,0.10312524460138671,38
2218,3,4361,1699,2662,0,0,0,1.0,1,1.0,1,1.0,1,0.07126637870676862,37
2219,2,4363,1701,2662,0,0,0,1.0,1,1.0,1,1.0,1,0.11448866776772444,36
2220,1,4364,1702,2662,0,0,0,1.0,1,1.0,1,1.0,1,0.15683214412718,34
2221,3,4367,1703,2664,0,0,0,1.0,1,1.0,1,1.0,1,0.10875444261535164,35
2222,0,4367,1703,2664,0,0,0,1.0,1,1.0,1,1.0,1,0.11671007451620816,33
2223,2,4369,1704,2665,0,0,0,1.0,1,1.0,1,1.0,1,0.11156085151666198,34
2224,2,4371,1706,2665,0,0,0,1.0,1,1.0,1,1.0,1,0.1595101459325765,32
2225,2,4373,1708,2665,0,0,0,1.0,1,1.0,1,1.0,1,0.2194140355436622,33
2226,4,4377,1710,2667,0,0,0,1.0,1,1.0,1,1.0,1,0.2611444445017709,32
2227,7,4384,1711,2673,0,0,0,1.0,1,1.0,1,1.0,1,0.19739345487331278,31
2228,4,4388,1711,2677,0,0,0,1.0,1,1.0,1,1.0,1,0.22017768711109945,32
2229,3,4391,1711,2680,0,0,0,1.0,1,1.0,1,1.0,1,0.15845264706836465,32
2230,2,4393,1711,2682,0,0,0,1.0,1,1.0,1,1.0,1,0.15249029172137699,31
2231,0,4393,1711,2682,0,0,0,1.0,1,1.0,1,1.0,1,0.1292372332572349,32
2232,0,4393,1711,2682,0,0,0,1.0,1,1.0,1,1.0,1,0.14447754648721703,32
2233,2,4395,1711,2684,0,0,0,1.0,1,1.0,1,1.0,1,0.10691348412093858,31
2234,2,4397,1713,2684,0,0,0,1.0,1,1.0,1,1.0,1,0.20436143140300644,32
2235,2,4399,1714,2685,0,0,0,1.0,1,1.0,1,1.0,1,0.19078368936781887,31
2236,2,4401,1714,2687,0,0,0,1.0,1,1.0,1,1.0,1,0.14280597113720425,31
2237,3,4404,1716,2688,0,0,0,1.0,1,1.0,1,1.0,1,0.15902988794912618,31
2238,2,4406,1717,2689,0,0,0,1.0,1,1.0,1,1.0,1,0.18925860510739553,31
2239,2,4408,1717,2691,0,0,0,1.0,1,1.0,1,1.0,1,0.1328544952903428,31
2240,0,4408,1717,2691,0,0,0,1.0,1,1.0,1,1.0,1,0.1526084279331068,32
2241,2,4410,1718,2692,0,0,0,1.0,1,1.0,1,1.0,1,0.14911410328474367,32
2242,1,4411,1718,2693,0,0,0,1.0,1,1.0,1,1.0,1,0.10318426186195127,34
2243,3,4414,1720,2694,0,0,0,1.0,1,1.0,1,1.0,1,0.14673790862007605,34
2244,1,4415,1720,2695,0,0,0,1.0,1,1.0,1,1.0,1,0.14411966320602723,36
2245,3,4418,1721,2697,0,0,0,1.0,1,1.0,1,1.0,1,0.13583669693448294,36
2246,0,4418,1721,2697,0,0,0,1.0,1,1.0,1,1.0,1,0.13849383603134222,39
2247,1,4419,1721,2698,0,0,0,1.0,1,1.0,1,1.0,1,0.1452782484705776,40
2248,0,4419,1721,2698,0,0,0,1.0,1,1.0,1,1.0,1,0.1452782484705776,40
2249,0,4419,1721,2698,0,0,0,1.0,1,1.0,1,1.0,1,0.13790688389639022,41
2250,0,4419,1721,2698,0,0,0,1.0,1,1.0,1,1.0,1,0.13790688389639022,41
2251,0,4419,1721,2698,0,0,0,1.0,1,1.0,1,1.0,1,0.1587375793361394,42
2252,5,4424,1722,2702,0,0,0,1.0,1,1.0,1,1.0,1,0.15535910399886343,41
2253,0,4424,1722,2702,0,0,0,1.0,1,1.0,1,1.0,1,0.14062820051805192,40
2254,0,4424,1722,2702,0,0,0,1.0,1,1.0,1,1.0,1,0.16124539721247017,39
2255,2,4426,1722,2704,0,0,0,1.0,1,1.0,1,1.0,1,0.17972130436704162,39
2256,3,4429,1724,2705,0,0,0,1.0,1,1.0,1,1.0,1,0.22568160315859104,40
2257,4,4433,1725,2708,0,0,0,1.0,1,1.0,1,1.0,1,0.19840537797132587,40
2258,1,4434,1726,2708,0,0,0,1.0,1,1.0,1,1.0,1,0.20079659394708604,39
2259,2,4436,1728,2708,0,0,0,1.0,1,1.0,1,1.0,1,0.19561170470398895,41
2260,4,4440,1728,2712,0,0,0,1.0,1,1.0,1,1.0,1,0.09807383993492418,38
2261,1,4441,1729,2712,0,0,0,1.0,1,1.0,1,1.0,1,0.10978121210343045,38
2262,1,4442,1730,2712,0,0,0,1.0,1,1.0,1,1.0,1,0.19412946891078534,36
2263,5,4447,1734,2713,0,0,0,1.0,1,1.0,1,1.0,1,0.1873784930016448,35
2264,4,4451,1737,2714,0,0,0,1.0,1,1.0,1,1.0,1,0.20615708399505595,33
2265,1,4452,1738,2714,0,0,0,1.0,1,1.0,1,1.0,1,0.20589877881795962,33
2266,3,4455,1739,2716,0,0,0,1.0,1,1.0,1,1.0,1,0.14890897331137715,33
2267,5,4460,1743,2717,0,0,0,1.0,1,1.0,1,1.0,1,0.16690055650938304,33
2268,4,4464,1744,2720,0,0,0,1.0,1,1.0,1,1.0,1,0.10664478401744433,35
2269,1,4465,1745,2720,0,0,0,1.0,1,1.0,1,1.0,1,0.12547160271596974,36
2270,1,4466,1746,2720,0,0,0,1.0,1,1.0,1,1.0,1,0.16510015921477858,34
2271,6,4472,1750,2722,0,0,0,1.0,1,1.0,1,1.0,1,0.15082247491675535,34
2272,6,4478,1752,2726,0,0,0,1.0,1,1.0,1,1.0,1,0.08130695045944206,33
2273,0,4478,1752,2726,0,0,0,1.0,1,1.0,1,1.0,1,0.09770821286748309,32
2274,0,4478,1752,2726,0,0,0,1.0,1,1.0,1,1.0,1,0.09770821286748309,32
2275,1,4479,1753,2726,0,0,0,1.0,1,1.0,1,1.0,1,0.1721499976118581,32
2276,2,4481,1754,2727,0,0,0,1.0,1,1.0,1,1.0,1,0.21179070989777318,31
2277,1,4482,1755,2727,0,0,0,1.0,1,1.0,1,1.0,1,0.2232071349294535,30
2278,2,4484,1755,2729,0,0,0,1.0,1,1.0,1,1.0,1,0.15024516241518102,33
2279,1,4485,1755,2730,0,0,0,1.0,1,1.0,1,1.0,1,0.15156776280870374,33
2280,1,4486,1755,2731,0,0,0,1.0,1,1.0,1,1.0,1,0.14258907154992978,35
2281,2,4488,1755,2733,0,0,0,1.0,1,1.0,1,1.0,1,0.12009990160617139,36
2282,0,4488,1755,2733,0,0,0,1.0,1,1.0,1,1.0,1,0.12009990160617139,36
2283,0,4488,1755,2733,0,0,0,1.0,1,1.0,1,1.0,1,0.12009990160617139,36
2284,1,4489,1756,2733,0,0,0,1.0,1,1.0,1,1.0,1,0.13401150094774716,36
2285,0,4489,1756,2733,0,0,0,1.0,1,1.0,1,1.0,1,0.12666952301560755,37
2286,1,4490,1757,2733,0,0,0,1.0,1,1.0,1,1.0,1,0.14933829986169006,38
2287,3,4493,1757,2736,0,0,0,1.0,1,1.0,1,1.0,1,0.09752898209703183,38
2288,2,4495,1759,2736,0,0,0,1.0,1,1.0,1,1.0,1,0.15089789824371086,40
2289,1,4496,1759,2737,0,0,0,1.0,1,1.0,1,1.0,1,0.14789619165822446,40
2290,3,4499,1759,2740,0,0,0,1.0,1,1.0,1,1.0,1,0.095265910516032,39
2291,0,4499,1759,2740,0,0,0,1.0,1,1.0,1,1.0,1,0.0720495447207521,37
2292,2,4501,1761,2740,0,0,0,1.0,1,1.0,1,1.0,1,0.09295945990261617,35
2293,1,4502,1762,2740,0,0,0,1.0,1,1.0,1,1.0,1,0.12763166193702777,35
2294,0,4502,1762,2740,0,0,0,1.0,1,1.0,1,1.0,1,0.1004473351255702,35
2295,0,4502,1762,2740,0,0,0,1.0,1,1.0,1,1.0,1,0.10695807566900678,36
2296,0,4502,1762,2740,0,0,0,1.0,1,1.0,1,1.0,1,0.10992649859608726,34
2297,1,4503,1762,2741,0,0,0,1.0,1,1.0,1,1.0,1,0.11771664424591571,35
2298,0,4503,1762,2741,0,0,0,1.0,1,1.0,1,1.0,1,0.12609476755480198,34
2299,2,4505,1764,2741,0,0,0,1.0,1,1.0,1,1.0,1,0.16818411864696475,35
2300,0,4505,1764,2741,0,0,0,1.0,1,1.0,1,1.0,1,0.16818411864696475,35
2301,0,4505,1764,2741,0,0,0,1.0,1,1.0,1,1.0,1,0.16818411864696475,35
2302,3,4508,1767,2741,0,0,0,1.0,1,1.0,1,1.0,1,0.22960405210472587,37
2303,0,4508,1767,2741,0,0,0,1.0,1,1.0,1,1.0,1,0.18214367423964783,35
2304,5,4513,1770,2743,0,0,0,1.0,1,1.0,1,1.0,1,0.26068540523898165,36
2305,2,4515,1770,2745,0,0,0,1.0,1,1.0,1,1.0,1,0.20393042268071906,34
2306,3,4518,1770,2748,0,0,0,1.0,1,1.0,1,1.0,1,0.15832479908173203,35
2307,1,4519,1770,2749,0,0,0,1.0,1,1.0,1,1.0,1,0.18213342872468546,35
2308,1,4520,1770,2750,0,0,0,1.0,1,1.0,1,1.0,1,0.13333306839343373,35
2309,0,4520,1770,2750,0,0,0,1.0,1,1.0,1,1.0,1,0.133509050240149,34
2310,0,4520,1770,2750,0,0,0,1.0,1,1.0,1,1.0,1,0.13282887528192286,36
2311,1,4521,1770,2751,0,0,0,1.0,1,1.0,1,1.0,1,0.11620751223141945,38
2312,2,4523,1772,2751,0,0,0,1.0,1,1.0,1,1.0,1,0.17804287347621114,39
2313,1,4524,1772,2752,0,0,0,1.0,1,1.0,1,1.0,1,0.1502926025415828,39
2314,4,4528,1773,2755,0,0,0,1.0,1,1.0,1,1.0,1,0.10973007521338685,39
2315,3,4531,1775,2756,0,0,0,1.0,1,1.0,1,1.0,1,0.15239507336584243,40
2316,5,4536,1776,2760,0,0,0,1.0,1,1.0,1,1.0,1,0.15579154210430615,40
2317,2,4538,1776,2762,0,0,0,1.0,1,1.0,1,1.0,1,0.12033508381303869,41
2318,1,4539,1777,2762,0,0,0,1.0,1,1.0,1,1.0,1,0.12318265243240568,41
2319,0,4539,1777,2762,0,0,0,1.0,1,1.0,1,1.0,1,0.12318265243240568,41
2320,2,4541,1778,2763,0,0,0,1.0,1,1.0,1,1.0,1,0.1467145562431321,42
2321,1,4542,1778,2764,0,0,0,1.0,1,1.0,1,1.0,1,0.11597106790166928,43
2322,1,4543,1779,2764,0,0,0,1.0,1,1.0,1,1.0,1,0.14930335649652296,42
2323,2,4545,1779,2766,0,0,0,1.0,1,1.0,1,1.0,1,0.1350654091959978,43
2324,4,4549,1780,2769,0,0,0,1.0,1,1.0,1,1.0,1,0.10712388826614702,44
2325,3,4552,1781,2771,0,0,0,1.0,1,1.0,1,1.0,1,0.11759553660447822,44
2326,0,4552,1781,2771,0,0,0,1.0,1,1.0,1,1.0,1,0.11909415294595226,45
2327,0,4552,1781,2771,0,0,0,1.0,1,1.0,1,1.0,1,0.11909415294595226,45
2328,2,4554,1782,2772,0,0,0,1.0,1,1.0,1,1.0,1,0.14344325125736948,46
2329,0,4554,1782,2772,0,0,0,1.0,1,1.0,1,1.0,1,0.15490542009234376,45
2330,4,4558,1784,2774,0,0,0,1.0,1,1.0,1,1.0,1,0.12926487958333724,47
2331,2,4560,1785,2775,0,0,0,1.0,1,1.0,1,1.0,1,0.14979762281183281,48
2332,2,4562,1785,2777,0,0,0,1.0,1,1.0,1,1.0,1,0.12736101533210156,48
2333,3,4565,1785,2780,0,0,0,1.0,1,1.0,1,1.0,1,0.1321267304679822,49
2334,0,4565,1785,2780,0,0,0,1.0,1,1.0,1,1.0,1,0.13449420561602712,47
2335,3,4568,1786,2782,0,0,0,1.0,1,1.0,1,1.0,1,0.1271349113624061,46
2336,1,4569,1786,2783,0,0,0,1.0,1,1.0,1,1.0,1,0.14270027905414254,46
2337,2,4571,1786,2785,0,0,0,1.0,1,1.0,1,1.0,1,0.10954006732565441,45
2338,2,4573,1786,2787,0,0,0,1.0,1,1.0,1,1.0,1,0.11088821780038918,44
2339,2,4575,1787,2788,0,0,0,1.0,1,1.0,1,1.0,1,0.08870671452959425,45
2340,4,4579,1787,2792,0,0,0,1.0,1,1.0,1,1.0,1,0.08174346949150767,44
2341,1,4580,1787,2793,0,0,0,1.0,1,1.0,1,1.0,1,0.08128478383013372,45
2342,2,4582,1789,2793,0,0,0,1.0,1,1.0,1,1.0,1,0.08761822970544955,47
2343,2,4584,1790,2794,0,0,0,1.0,1,1.0,1,1.0,1,0.08747085284006513,46
2344,1,4585,1790,2795,0,0,0,1.0,1,1.0,1,1.0,1,0.08996014229425453,46
2345,0,4585,1790,2795,0,0,0,1.0,1,1.0,1,1.0,1,0.10486782861584462,45
2346,0,4585,1790,2795,0,0,0,1.0,1,1.0,1,1.0,1,0.09131546959038528,46
2347,0,4585,1790,2795,0,0,0,1.0,1,1.0,1,1.0,1,0.08940938468241368,47
2348,3,4588,1792,2796,0,0,0,1.0,1,1.0,1,1.0,1,0.10298329149330077,49
2349,1,4589,1793,2796,0,0,0,1.0,1,1.0,1,1.0,1,0.1397264859401118,49
2350,4,4593,1793,2800,0,0,0,1.0,1,1.0,1,1.0,1,0.11518472582659309,50
2351,1,4594,1794,2800,0,0,0,1.0,1,1.0,1,1.0,1,0.11463962851249501,50
2352,2,4596,1794,2802,0,0,0,1.0,1,1.0,1,1.0,1,0.10241622226853149,51
2353,1,4597,1794,2803,0,0,0,1.0,1,1.0,1,1.0,1,0.08952089425397353,51
2354,0,4597,1794,2803,0,0,0,1.0,1,1.0,1,1.0,1,0.0854449958450975,51
2355,1,4598,1795,2803,0,0,0,1.0,1,1.0,1,1.0,1,0.09772523704521391,50
2356,2,4600,1795,2805,0,0,0,1.0,1,1.0,1,1.0,1,0.06647416987728773,50
2357,1,4601,1796,2805,0,0,0,1.0,1,1.0,1,1.0,1,0.10190589843006995,49
2358,0,4601,1796,2805,0,0,0,1.0,1,1.0,1,1.0,1,0.11549941011896883,51
2359,1,4602,1796,2806,0,0,0,1.0,1,1.0,1,1.0,1,0.06980007914200016,51
2360,3,4605,1799,2806,0,0,0,1.0,1,1.0,1,1.0,1,0.10437634255908644,51
2361,1,4606,1800,2806,0,0,0,1.0,1,1.0,1,1.0,1,0.13564956711848983,52
2362,4,4610,1801,2809,0,0,0,1.0,1,1.0,1,1.0,1,0.12515649850102248,53
2363,3,4613,1803,2810,0,0,0,1.0,1,1.0,1,1.0,1,0.10080194528000938,54
2364,4,4617,1805,2812,0,0,0,1.0,1,1.0,1,1.0,1,0.1205857223862872,55
2365,4,4621,1807,2814,0,0,0,1.0,1,1.0,1,1.0,1,0.10934926448205931,53
2366,4,4625,1809,2816,0,0,0,1.0,1,1.0,1,1.0,1,0.1203984972921422,53
2367,4,4629,1812,2817,0,0,0,1.0,1,1.0,1,1.0,1,0.19918242333826397,51
2368,4,4633,1813,2820,0,0,0,1.0,1,1.0,1,1.0,1,0.15576123778524173,50
2369,2,4635,1815,2820,0,0,0,1.0,1,1.0,1,1.0,1,0.17859707640299918,47
2370,0,4635,1815,2820,0,0,0,1.0,1,1.0,1,1.0,1,0.1882941721922744,48
2371,3,4638,1816,2822,0,0,0,1.0,1,1.0,1,1.0,1,0.18305612473725005,49
2372,0,4638,1816,2822,0,0,0,1.0,1,1.0,1,1.0,1,0.19091109695158176,48
2373,0,4638,1816,2822,0,0,0,1.0,1,1.0,1,1.0,1,0.19705672086741477,49
2374,0,4638,1816,2822,0,0,0,1.0,1,1.0,1,1.0,1,0.18881924179311918,50
2375,2,4640,1817,2823,0,0,0,1.0,1,1.0,1,1.0,1,0.1924846953583856,50
2376,2,4642,1817,2825,0,0,0,1.0,1,1.0,1,1.0,1,0.1645193866763805,50
2377,0,4642,1817,2825,0,0,0,1.0,1,1.0,1,1.0,1,0.16677132082162832,49
2378,1,4643,1817,2826,0,0,0,1.0,1,1.0,1,1.0,1,0.15454172870275174,49
2379,2,4645,1819,2826,0,0,0,1.0,1,1.0,1,1.0,1,0.17452407970579803,50
2380,1,4646,1820,2826,0,0,0,1.0,1,1.0,1,1.0,1,0.19196279601450553,50
2381,3,4649,1821,2828,0,0,0,1.0,1,1.0,1,1.0,1,0.19126863586736825,51
2382,4,4653,1822,2831,0,0,0,1.0,1,1.0,1,1.0,1,0.1866667241435306,51
2383,5,4658,1823,2835,0,0,0,1.0,1,1.0,1,1.0,1,0.16125400060435494,52
2384,4,4662,1824,2838,0,0,0,1.0,1,1.0,1,1.0,1,0.12473131981709541,52
2385,1,4663,1825,2838,0,0,0,1.0,1,1.0,1,1.0,1,0.16178242149407715,51
2386,3,4666,1826,2840,0,0,0,1.0,1,1.0,1,1.0,1,0.14766171917796322,52
2387,2,4668,1827,2841,0,0,0,1.0,1,1.0,1,1.0,1,0.18233077735211367,49
2388,2,4670,1828,2842,0,0,0,1.0,1,1.0,1,1.0,1,0.1774399869044877,48
2389,5,4675,1831,2844,0,0,0,1.0,1,1.0,1,1.0,1,0.17614859711011444,48
2390,3,4678,1832,2846,0,0,0,1.0,1,1.0,1,1.0,1,0.1658769486147606,49
2391,7,4685,1836,2849,0,0,0,1.0,1,1.0,1,1.0,1,0.1967313338670448,48
2392,7,4692,1838,2854,0,0,0,1.0,1,1.0,1,1.0,1,0.1514693791845626,49
2393,3,4695,1839,2856,0,0,0,1.0,1,1.0,1,1.0,1,0.15527885946378486,50
2394,3,4698,1841,2857,0,0,0,1.0,1,1.0,1,1.0,1,0.14841929706057516,50
2395,1,4699,1841,2858,0,0,0,1.0,1,1.0,1,1.0,1,0.13388274390987967,49
2396,1,4700,1841,2859,0,0,0,1.0,1,1.0,1,1.0,1,0.11894344273534266,50
2397,1,4701,1842,2859,0,0,0,1.0,1,1.0,1,1.0,1,0.15512916535968505,51
2398,2,4703,1844,2859,0,0,0,1.0,1,1.0,1,1.0,1,0.17354053347420334,49
2399,1,4704,1844,2860,0,0,0,1.0,1,1.0,1,1.0,1,0.15786552545842908,50
2400,2,4706,1845,2861,0,0,0,1.0,1,1.0,1,1.0,1,0.17884003235718807,51
2401,2,4708,1845,2863,0,0,0,1.0,1,1.0,1,1.0,1,0.14804827839113816,50
2402,1,4709,1845,2864,0,0,0,1.0,1,1.0,1,1.0,1,0.1364094305135733,51
2403,0,4709,1845,2864,0,0,0,1.0,1,1.0,1,1.0,1,0.14001740796855938,52
2404,3,4712,1845,2867,0,0,0,1.0,1,1.0,1,1.0,1,0.09732686287187493,53
2405,0,4712,1845,2867,0,0,0,1.0,1,1.0,1,1.0,1,0.10986767710633334,52
2406,1,4713,1846,2867,0,0,0,1.0,1,1.0,1,1.0,1,0.11331060945873768,52
2407,2,4715,1846,2869,0,0,0,1.0,1,1.0,1,1.0,1,0.13596275195105945,51
2408,0,4715,1846,2869,0,0,0,1.0,1,1.0,1,1.0,1,0.15495789193288984,50
2409,3,4718,1846,2872,0,0,0,1.0,1,1.0,1,1.0,1,0.16576061498037475,50
2410,1,4719,1847,2872,0,0,0,1.0,1,1.0,1,1.0,1,0.19279669919766707,49
2411,1,4720,1847,2873,0,0,0,1.0,1,1.0,1,1.0,1,0.18446661027676134,48
2412,0,4720,1847,2873,0,0,0,1.0,1,1.0,1,1.0,1,0.20923210863439062,47
2413,2,4722,1847,2875,0,0,0,1.0,1,1.0,1,1.0,1,0.17526522757991367,47
2414,5,4727,1848,2879,0,0,0,1.0,1,1.0,1,1.0,1,0.22944114067553978,47
2415,2,4729,1848,2881,0,0,0,1.0,1,1.0,1,1.0,1,0.2251672996263493,46
2416,4,4733,1848,2885,0,0,0,1.0,1,1.0,1,1.0,1,0.1634274822771251,47
2417,2,4735,1849,2886,0,0,0,1.0,1,1.0,1,1.0,1,0.16962631087129815,46
2418,1,4736,1849,2887,0,0,0,1.0,1,1.0,1,1.0,1,0.1653885646339828,48
2419,0,4736,1849,2887,0,0,0,1.0,1,1.0,1,1.0,1,0.1765718910882651,47
2420,1,4737,1849,2888,0,0,0,1.0,1,1.0,1,1.0,1,0.1570823189128048,49
2421,1,4738,1849,2889,0,0,0,1.0,1,1.0,1,1.0,1,0.13924258640827086,50
2422,3,4741,1851,2890,0,0,0,1.0,1,1.0,1,1.0,1,0.1272846401029184,50
2423,0,4741,1851,2890,0,0,0,1.0,1,1.0,1,1.0,1,0.138214984316583,51
2424,5,4746,1855,2891,0,0,0,1.0,1,1.0,1,1.0,1,0.12731863651543837,50
2425,1,4747,1855,2892,0,0,0,1.0,1,1.0,1,1.0,1,0.1288485618153858,48
2426,6,4753,1859,2894,0,0,0,1.0,1,1.0,1,1.0,1,0.14639642988186208,51
2427,1,4754,1860,2894,0,0,0,1.0,1,1.0,1,1.0,1,0.16573229243225276,50
2428,3,4757,1861,2896,0,0,0,1.0,1,1.0,1,1.0,1,0.13705094143528118,49
2429,4,4761,1863,2898,0,0,0,1.0,1,1.0,1,1.0,1,0.16075072674643928,49
2430,0,4761,1863,2898,0,0,0,1.0,1,1.0,1,1.0,1,0.19422944843747364,46
2431,4,4765,1864,2901,0,0,0,1.0,1,1.0,1,1.0,1,0.1568677808668359,45
2432,4,4769,1865,2904,0,0,0,1.0,1,1.0,1,1.0,1,0.20691791303270765,44
2433,2,4771,1866,2905,0,0,0,1.0,1,1.0,1,1.0,1,0.16543463543796244,45
2434,1,4772,1866,2906,0,0,0,1.0,1,1.0,1,1.0,1,0.15111567237522625,44
2435,0,4772,1866,2906,0,0,0,1.0,1,1.0,1,1.0,1,0.15111567237522625,44
2436,0,4772,1866,2906,0,0,0,1.0,1,1.0,1,1.0,1,0.15111567237522625,44
2437,2,4774,1868,2906,0,0,0,1.0,1,1.0,1,1.0,1,0.14304268833445916,45
2438,1,4775,1869,2906,0,0,0,1.0,1,1.0,1,1.0,1,0.16077434676046065,45
2439,2,4777,1869,2908,0,0,0,1.0,1,1.0,1,1.0,1,0.15818720174614456,46
2440,2,4779,1869,2910,0,0,0,1.0,1,1.0,1,1.0,1,0.10718607417177935,45
2441,0,4779,1869,2910,0,0,0,1.0,1,1.0,1,1.0,1,0.10718607417177935,45
2442,0,4779,1869,2910,0,0,0,1.0,1,1.0,1,1.0,1,0.10209941270998438,46
2443,2,4781,1869,2912,0,0,0,1.0,1,1.0,1,1.0,1,0.08559585475050653,45
2444,6,4787,1872,2915,0,0,0,1.0,1,1.0,1,1.0,1,0.1691318505804297,46
2445,2,4789,1873,2916,0,0,0,1.0,1,1.0,1,1.0,1,0.1736444402844676,44
2446,8,4797,1878,2919,0,0,0,1.0,1,1.0,1,1.0,1,0.135653441227019,44
2447,3,4800,1878,2922,0,0,0,1.0,1,1.0,1,1.0,1,0.13909162352385987,42
2448,3,4803,1881,2922,0,0,0,1.0,1,1.0,1,1.0,1,0.16657299317361002,41
2449,3,4806,1882,2924,0,0,0,1.0,1,1.0,1,1.0,1,0.15190259905533643,40
2450,6,4812,1885,2927,0,0,0,1.0,1,1.0,1,1.0,1,0.20168343251770768,42
2451,2,4814,1885,2929,0,0,0,1.0,1,1.0,1,1.0,1,0.1510279236871196,43
2452,0,4814,1885,2929,0,0,0,1.0,1,1.0,1,1.0,1,0.1510279236871196,43
2453,1,4815,1885,2930,0,0,0,1.0,1,1.0,1,1.0,1,0.16335377079132724,45
2454,2,4817,1887,2930,0,0,0,1.0,1,1.0,1,1.0,1,0.21342571045007594,47
2455,1,4818,1887,2931,0,0,0,1.0,1,1.0,1,1.0,1,0.19674482828164516,48
2456,3,4821,1888,2933,0,0,0,1.0,1,1.0,1,1.0,1,0.21686855801264535,49
2457,1,4822,1889,2933,0,0,0,1.0,1,1.0,1,1.0,1,0.25493671029582565,48
2458,4,4826,1890,2936,0,0,0,1.0,1,1.0,1,1.0,1,0.22597895968670245,49
2459,2,4828,1890,2938,0,0,0,1.0,1,1.0,1,1.0,1,0.19944529397125882,49
2460,2,4830,1891,2939,0,0,0,1.0,1,1.0,1,1.0,1,0.19484622522998502,50
2461,4,4834,1891,2943,0,0,0,1.0,1,1.0,1,1.0,1,0.16399510495424555,50
2462,2,4836,1892,2944,0,0,0,1.0,1,1.0,1,1.0,1,0.175216090222434,51
2463,4,4840,1894,2946,0,0,0,1.0,1,1.0,1,1.0,1,0.21641135160890101,51
2464,10,4850,1899,2951,0,0,0,1.0,1,1.0,1,1.0,1,0.20826806696714922,50
2465,5,4855,1899,2956,0,0,0,1.0,1,1.0,1,1.0,1,0.19982447442735785,49
2466,2,4857,1900,2957,0,0,0,1.0,1,1.0,1,1.0,1,0.1963680373881421,49
2467,2,4859,1900,2959,0,0,0,1.0,1,1.0,1,1.0,1,0.1542156214304886,48
2468,0,4859,1900,2959,0,0,0,1.0,1,1.0,1,1.0,1,0.176104304204469,47
2469,3,4862,1901,2961,0,0,0,1.0,1,1.0,1,1.0,1,0.12319593613644798,46
2470,2,4864,1901,2963,0,0,0,1.0,1,1.0,1,1.0,1,0.12019315010190697,44
2471,2,4866,1902,2964,0,0,0,1.0,1,1.0,1,1.0,1,0.09669324916917359,44
2472,2,4868,1902,2966,0,0,0,1.0,1,1.0,1,1.0,1,0.09710875498667144,44
2473,2,4870,1903,2967,0,0,0,1.0,1,1.0,1,1.0,1,0.08372189184794195,43
2474,1,4871,1904,2967,0,0,0,1.0,1,1.0,1,1.0,1,0.12889775226379074,44
2475,2,4873,1905,2968,0,0,0,1.0,1,1.0,1,1.0,1,0.11346490665517683,46
2476,1,4874,1906,2968,0,0,0,1.0,1,1.0,1,1.0,1,0.1111299749994862,46
2477,2,4876,1906,2970,0,0,0,1.0,1,1.0,1,1.0,1,0.08620155131187537,46
2478,2,4878,1907,2971,0,0,0,1.0,1,1.0,1,1.0,1,0.05898075900390217,46
2479,0,4878,1907,2971,0,0,0,1.0,1,1.0,1,1.0,1,0.05898075900390217,46
2480,3,4881,1909,2972,0,0,0,1.0,1,1.0,1,1.0,1,0.10430405560962132,47
2481,4,4885,1911,2974,0,0,0,1.0,1,1.0,1,1.0,1,0.11955936868651702,47
2482,4,4889,1912,2977,0,0,0,1.0,1,1.0,1,1.0,1,0.11147276973460316,45
2483,1,4890,1912,2978,0,0,0,1.0,1,1.0,1,1.0,1,0.143593018199134,45
2484,3,4893,1913,2980,0,0,0,1.0,1,1.0,1,1.0,1,0.13090817343349173,46
2485,1,4894,1913,2981,0,0,0,1.0,1,1.0,1,1.0,1,0.14384102806973512,44
2486,0,4894,1913,2981,0,0,0,1.0,1,1.0,1,1.0,1,0.17129883711195903,43
2487,1,4895,1914,2981,0,0,0,1.0,1,1.0,1,1.0,1,0.17875663084475873,44
2488,3,4898,1915,2983,0,0,0,1.0,1,1.0,1,1.0,1,0.1304267206723389,45
2489,4,4902,1916,2986,0,0,0,1.0,1,1.0,1,1.0,1,0.1454957702572364,44
2490,2,4904,1917,2987,0,0,0,1.0,1,1.0,1,1.0,1,0.1550969495266183,44
2491,3,4907,1917,2990,0,0,0,1.0,1,1.0,1,1.0,1,0.12713758375423012,44
2492,1,4908,1918,2990,0,0,0,1.0,1,1.0,1,1.0,1,0.15840750224366282,44
2493,0,4908,1918,2990,0,0,0,1.0,1,1.0,1,1.0,1,0.21119963294429356,42
2494,3,4911,1919,2992,0,0,0,1.0,1,1.0,1,1.0,1,0.21318373996987094,42
2495,3,4914,1920,2994,0,0,0,1.0,1,1.0,1,1.0,1,0.2099650961170949,42
2496,2,4916,1921,2995,0,0,0,1.0,1,1.0,1,1.0,1,0.2102515645085373,42
2497,2,4918,1921,2997,0,0,0,1.0,1,1.0,1,1.0,1,0.18649740917419497,44
2498,1,4919,1921,2998,0,0,0,1.0,1,1.0,1,1.0,1,0.17854897771455724,43
2499,1,4920,1921,2999,0,0,0,1.0,1,1.0,1,1.0,1,0.1589289431866137,43
2500,1,4921,1921,3000,0,0,0,1.0,1,1.0,1,1.0,1,0.14676835215747305,44
2501,1,4922,1921,3001,0,0,0,1.0,1,1.0,1,1.0,1,0.1462872277081214,46
2502,2,4924,1921,3003,0,0,0,1.0,1,1.0,1,1.0,1,0.13035132648888106,47
2503,3,4927,1923,3004,0,0,0,1.0,1,1.0,1,1.0,1,0.14961485975784547,47
2504,0,4927,1923,3004,0,0,0,1.0,1,1.0,1,1.0,1,0.14651289763483272,46
2505,5,4932,1928,3004,0,0,0,1.0,1,1.0,1,1.0,1,0.20807318546037937,46
2506,6,4938,1930,3008,0,0,0,1.0,1,1.0,1,1.0,1,0.14829672832225424,45
2507,4,4942,1931,3011,0,0,0,1.0,1,1.0,1,1.0,1,0.15496620179564335,45
2508,4,4946,1931,3015,0,0,0,1.0,1,1.0,1,1.0,1,0.14376548356099783,46
2509,3,4949,1931,3018,0,0,0,1.0,1,1.0,1,1.0,1,0.11340583109853307,45
2510,3,4952,1931,3021,0,0,0,1.0,1,1.0,1,1.0,1,0.12436028060574868,46
2511,1,4953,1932,3021,0,0,0,1.0,1,1.0,1,1.0,1,0.12478165456765265,47
2512,2,4955,1934,3021,0,0,0,1.0,1,1.0,1,1.0,1,0.16573189092754312,47
2513,4,4959,1935,3024,0,0,0,1.0,1,1.0,1,1.0,1,0.14303062942974215,48
2514,1,4960,1936,3024,0,0,0,1.0,1,1.0,1,1.0,1,0.14902770014164032,48
2515,5,4965,1936,3029,0,0,0,1.0,1,1.0,1,1.0,1,0.10800880141622189,49
2516,2,4967,1937,3030,0,0,0,1.0,1,1.0,1,1.0,1,0.11242225143764437,49
2517,3,4970,1939,3031,0,0,0,1.0,1,1.0,1,1.0,1,0.1221654189961498,49
2518,4,4974,1941,3033,0,0,0,1.0,1,1.0,1,1.0,1,0.10816858089884902,48
2519,0,4974,1941,3033,0,0,0,1.0,1,1.0,1,1.0,1,0.10423119971239742,48
2520,2,4976,1942,3034,0,0,0,1.0,1,1.0,1,1.0,1,0.1360250544425365,46
2521,4,4980,1944,3036,0,0,0,1.0,1,1.0,1,1.0,1,0.18548231421426267,47
2522,1,4981,1945,3036,0,0,0,1.0,1,1.0,1,1.0,1,0.2226521310111599,45
2523,2,4983,1947,3036,0,0,0,1.0,1,1.0,1,1.0,1,0.27517207471342,44
2524,1,4984,1947,3037,0,0,0,1.0,1,1.0,1,1.0,1,0.23751931901306475,42
2525,6,4990,1948,3042,0,0,0,1.0,1,1.0,1,1.0,1,0.20400970954734612,42
2526,0,4990,1948,3042,0,0,0,1.0,1,1.0,1,1.0,1,0.20370824548338165,41
2527,1,4991,1949,3042,0,0,0,1.0,1,1.0,1,1.0,1,0.21343668326186446,41
2528,0,4991,1949,3042,0,0,0,1.0,1,1.0,1,1.0,1,0.2368457872840948,41
2529,4,4995,1950,3045,0,0,0,1.0,1,1.0,1,1.0,1,0.19572533635749692,42
2530,1,4996,1950,3046,0,0,0,1.0,1,1.0,1,1.0,1,0.17070604415558305,41
2531,1,4997,1950,3047,0,0,0,1.0,1,1.0,1,1.0,1,0.1667967587696142,41
2532,0,4997,1950,3047,0,0,0,1.0,1,1.0,1,1.0,1,0.19430986408945308,43
2533,0,4997,1950,3047,0,0,0,1.0,1,1.0,1,1.0,1,0.19430986408945308,43
2534,0,4997,1950,3047,0,0,0,1.0,1,1.0,1,1.0,1,0.19430986408945308,43
2535,1,4998,1950,3048,0,0,0,1.0,1,1.0,1,1.0,1,0.19728471688878765,44
2536,0,4998,1950,3048,0,0,0,1.0,1,1.0,1,1.0,1,0.19728471688878765,44
2537,1,4999,1950,3049,0,0,0,1.0,1,1.0,1,1.0,1,0.19844522747465534,45
2538,3,5002,1950,3052,0,0,0,1.0,1,1.0,1,1.0,1,0.19362034525722321,48
2539,2,5004,1952,3052,0,0,0,1.0,1,1.0,1,1.0,1,0.20313113248855044,48
2540,3,5007,1953,3054,0,0,0,1.0,1,1.0,1,1.0,1,0.2084551517861111,50
2541,4,5011,1954,3057,0,0,0,1.0,1,1.0,1,1.0,1,0.2101963265539582,52
2542,7,5018,1957,3061,0,0,0,1.0,1,1.0,1,1.0,1,0.21919005587241816,52
2543,5,5023,1960,3063,0,0,0,1.0,1,1.0,1,1.0,1,0.2109401183806459,51
2544,6,5029,1964,3065,0,0,0,1.0,1,1.0,1,1.0,1,0.24373345984696945,51
2545,5,5034,1964,3070,0,0,0,1.0,1,1.0,1,1.0,1,0.18070728651133192,50
2546,2,5036,1965,3071,0,0,0,1.0,1,1.0,1,1.0,1,0.1784465664271473,50
2547,0,5036,1965,3071,0,0,0,1.0,1,1.0,1,1.0,1,0.19898157869119476,47
2548,1,5037,1965,3072,0,0,0,1.0,1,1.0,1,1.0,1,0.1773491826784013,46
2549,3,5040,1967,3073,0,0,0,1.0,1,1.0,1,1.0,1,0.16833806192368148,46
2550,2,5042,1969,3073,0,0,0,1.0,1,1.0,1,1.0,1,0.16326991861675172,44
2551,1,5043,1969,3074,0,0,0,1.0,1,1.0,1,1.0,1,0.14075643376451802,43
2552,0,5043,1969,3074,0,0,0,1.0,1,1.0,1,1.0,1,0.17226387449664307,43
2553,0,5043,1969,3074,0,0,0,1.0,1,1.0,1,1.0,1,0.1714649799670433,44
2554,2,5045,1970,3075,0,0,0,1.0,1,1.0,1,1.0,1,0.148391177768967,45
2555,3,5048,1971,3077,0,0,0,1.0,1,1.0,1,1.0,1,0.13500121692287181,44
2556,1,5049,1971,3078,0,0,0,1.0,1,1.0,1,1.0,1,0.1251680041320833,44
2557,2,5051,1972,3079,0,0,0,1.0,1,1.0,1,1.0,1,0.15771537930011448,41
2558,0,5051,1972,3079,0,0,0,1.0,1,1.0,1,1.0,1,0.1681404215242447,40
2559,2,5053,1972,3081,0,0,0,1.0,1,1.0,1,1.0,1,0.16131154958209418,41
2560,1,5054,1972,3082,0,0,0,1.0,1,1.0,1,1.0,1,0.1437074579281982,41
2561,2,5056,1972,3084,0,0,0,1.0,1,1.0,1,1.0,1,0.14443449167628788,43
2562,2,5058,1973,3085,0,0,0,1.0,1,1.0,1,1.0,1,0.15524833101713892,44
2563,0,5058,1973,3085,0,0,0,1.0,1,1.0,1,1.0,1,0.15524833101713892,44
2564,2,5060,1975,3085,0,0,0,1.0,1,1.0,1,1.0,1,0.1956890284789274,44
2565,0,5060,1975,3085,0,0,0,1.0,1,1.0,1,1.0,1,0.19528769988492659,45
2566,5,5065,1978,3087,0,0,0,1.0,1,1.0,1,1.0,1,0.2134878430196565,46
2567,4,5069,1979,3090,0,0,0,1.0,1,1.0,1,1.0,1,0.24189197330176196,48
2568,5,5074,1979,3095,0,0,0,1.0,1,1.0,1,1.0,1,0.23005843052284117,48
2569,6,5080,1979,3101,0,0,0,1.0,1,1.0,1,1.0,1,0.18798127840704207,49
2570,1,5081,1979,3102,0,0,0,1.0,1,1.0,1,1.0,1,0.20058578308651911,48
2571,2,5083,1979,3104,0,0,0,1.0,1,1.0,1,1.0,1,0.20058578308651911,48
2572,2,5085,1979,3106,0,0,0,1.0,1,1.0,1,1.0,1,0.16383149971510613,49
2573,3,5088,1979,3109,0,0,0,1.0,1,1.0,1,1.0,1,0.14080456672100936,50
2574,4,5092,1981,3111,0,0,0,1.0,1,1.0,1,1.0,1,0.139490432940647,49
2575,1,5093,1981,3112,0,0,0,1.0,1,1.0,1,1.0,1,0.12614120413338142,48
2576,0,5093,1981,3112,0,0,0,1.0,1,1.0,1,1.0,1,0.12614120413338142,48
2577,0,5093,1981,3112,0,0,0,1.0,1,1.0,1,1.0,1,0.1498356894661846,50
2578,0,5093,1981,3112,0,0,0,1.0,1,1.0,1,1.0,1,0.1498356894661846,50
2579,2,5095,1982,3113,0,0,0,1.0,1,1.0,1,1.0,1,0.13973733028328267,51
2580,2,5097,1983,3114,0,0,0,1.0,1,1.0,1,1.0,1,0.14920223166450042,52
2581,3,5100,1984,3116,0,0,0,1.0,1,1.0,1,1.0,1,0.14961690545468997,51
2582,3,5103,1985,3118,0,0,0,1.0,1,1.0,1,1.0,1,0.13570129836243028,51
2583,3,5106,1987,3119,0,0,0,1.0,1,1.0,1,1.0,1,0.13863318960653462,51
2584,6,5112,1989,3123,0,0,0,1.0,1,1.0,1,1.0,1,0.08843789616223881,51
2585,0,5112,1989,3123,0,0,0,1.0,1,1.0,1,1.0,1,0.07788739451687343,50
2586,3,5115,1992,3123,0,0,0,1.0,1,1.0,1,1.0,1,0.10748790776432258,50
2587,3,5118,1994,3124,0,0,0,1.0,1,1.0,1,1.0,1,0.07864302968600298,48
2588,1,5119,1994,3125,0,0,0,1.0,1,1.0,1,1.0,1,0.06872422037786559,50
2589,1,5120,1995,3125,0,0,0,1.0,1,1.0,1,1.0,1,0.039228684383892175,48
2590,2,5122,1996,3126,0,0,0,1.0,1,1.0,1,1.0,1,0.08643784907727534,47
2591,1,5123,1997,3126,0,0,0,1.0,1,1.0,1,1.0,1,0.08809797512758095,47
2592,1,5124,1998,3126,0,0,0,1.0,1,1.0,1,1.0,1,0.10840853624025504,47
2593,4,5128,1999,3129,0,0,0,1.0,1,1.0,1,1.0,1,0.10788254652973292,47
2594,6,5134,2002,3132,0,0,0,1.0,1,1.0,1,1.0,1,0.12539174101580666,49
2595,1,5135,2002,3133,0,0,0,1.0,1,1.0,1,1.0,1,0.11703344206931855,48
2596,6,5141,2004,3137,0,0,0,1.0,1,1.0,1,1.0,1,0.16188407855387604,47
2597,4,5145,2005,3140,0,0,0,1.0,1,1.0,1,1.0,1,0.17068951307353097,48
2598,4,5149,2007,3142,0,0,0,1.0,1,1.0,1,1.0,1,0.14063775127336017,48
2599,2,5151,2008,3143,0,0,0,1.0,1,1.0,1,1.0,1,0.11441102656412686,49
2600,1,5152,2008,3144,0,0,0,1.0,1,1.0,1,1.0,1,0.10533597541579427,52
2601,1,5153,2008,3145,0,0,0,1.0,1,1.0,1,1.0,1,0.11105452068314679,51
2602,0,5153,2008,3145,0,0,0,1.0,1,1.0,1,1.0,1,0.108593204150151,52
2603,2,5155,2009,3146,0,0,0,1.0,1,1.0,1,1.0,1,0.14115968349088656,53
2604,1,5156,2009,3147,0,0,0,1.0,1,1.0,1,1.0,1,0.13538617408346604,53
2605,1,5157,2009,3148,0,0,0,1.0,1,1.0,1,1.0,1,0.1571957751329993,52
2606,0,5157,2009,3148,0,0,0,1.0,1,1.0,1,1.0,1,0.1571957751329993,52
2607,0,5157,2009,3148,0,0,0,1.0,1,1.0,1,1.0,1,0.16646787563372326,52
2608,2,5159,2009,3150,0,0,0,1.0,1,1.0,1,1.0,1,0.15093790522046646,52
2609,4,5163,2011,3152,0,0,0,1.0,1,1.0,1,1.0,1,0.13076734297386977,53
2610,1,5164,2011,3153,0,0,0,1.0,1,1.0,1,1.0,1,0.12678271092444302,54
2611,3,5167,2013,3154,0,0,0,1.0,1,1.0,1,1.0,1,0.11354860331091321,54
2612,2,5169,2014,3155,0,0,0,1.0,1,1.0,1,1.0,1,0.10112875748231483,56
2613,2,5171,2015,3156,0,0,0,1.0,1,1.0,1,1.0,1,0.10762744452781747,56
2614,4,5175,2016,3159,0,0,0,1.0,1,1.0,1,1.0,1,0.07381648308290188,56
2615,0,5175,2016,3159,0,0,0,1.0,1,1.0,1,1.0,1,0.06565427296668894,57
2616,1,5176,2016,3160,0,0,0,1.0,1,1.0,1,1.0,1,0.05937078285381913,57
2617,3,5179,2017,3162,0,0,0,1.0,1,1.0,1,1.0,1,0.05133940109861411,58
2618,2,5181,2018,3163,0,0,0,1.0,1,1.0,1,1.0,1,0.07921305442736547,58
2619,0,5181,2018,3163,0,0,0,1.0,1,1.0,1,1.0,1,0.07816533359308328,58
2620,2,5183,2018,3165,0,0,0,1.0,1,1.0,1,1.0,1,0.05128178982481493,60
2621,0,5183,2018,3165,0,0,0,1.0,1,1.0,1,1.0,1,0.06232876569687836,59
2622,2,5185,2020,3165,0,0,0,1.0,1,1.0,1,1.0,1,0.07584345214489432,60
2623,4,5189,2022,3167,0,0,0,1.0,1,1.0,1,1.0,1,0.08180686501085714,59
2624,2,5191,2024,3167,0,0,0,1.0,1,1.0,1,1.0,1,0.08964028376064528,58
2625,2,5193,2026,3167,0,0,0,1.0,1,1.0,1,1.0,1,0.09031333836098318,58
2626,6,5199,2028,3171,0,0,0,1.0,1,1.0,1,1.0,1,0.08290505369444057,57
2627,1,5200,2029,3171,0,0,0,1.0,1,1.0,1,1.0,1,0.07951794640168289,55
2628,3,5203,2032,3171,0,0,0,1.0,1,1.0,1,1.0,1,0.11906176923288829,55
2629,2,5205,2032,3173,0,0,0,1.0,1,1.0,1,1.0,1,0.08322790388274756,54
2630,2,5207,2033,3174,0,0,0,1.0,1,1.0,1,1.0,1,0.09404487305216791,55
2631,2,5209,2033,3176,0,0,0,1.0,1,1.0,1,1.0,1,0.09935010941096035,55
2632,2,5211,2035,3176,0,0,0,1.0,1,1.0,1,1.0,1,0.14372561988276064,55
2633,1,5212,2036,3176,0,0,0,1.0,1,1.0,1,1.0,1,0.11362151097469095,53
2634,2,5214,2037,3177,0,0,0,1.0,1,1.0,1,1.0,1,0.09318321240604925,52
2635,1,5215,2037,3178,0,0,0,1.0,1,1.0,1,1.0,1,0.10455116002512699,52
2636,5,5220,2040,3180,0,0,0,1.0,1,1.0,1,1.0,1,0.11883972948690658,51
2637,4,5224,2041,3183,0,0,0,1.0,1,1.0,1,1.0,1,0.08322555758458239,50
2638,3,5227,2042,3185,0,0,0,1.0,1,1.0,1,1.0,1,0.06836995499151712,48
2639,2,5229,2044,3185,0,0,0,1.0,1,1.0,1,1.0,1,0.11933240857716969,48
2640,5,5234,2049,3185,0,0,0,1.0,1,1.0,1,1.0,1,0.17974537958977402,46
2641,11,5245,2052,3193,0,0,0,1.0,1,1.0,1,1.0,1,0.1066687551139494,46
2642,9,5254,2056,3198,0,0,0,1.0,1,1.0,1,1.0,1,0.11534502128347737,47
2643,4,5258,2057,3201,0,0,0,1.0,1,1.0,1,1.0,1,0.10917217620645345,45
2644,3,5261,2057,3204,0,0,0,1.0,1,1.0,1,1.0,1,0.11923334239181523,44
2645,1,5262,2058,3204,0,0,0,1.0,1,1.0,1,1.0,1,0.11851359483405288,42
2646,2,5264,2059,3205,0,0,0,1.0,1,1.0,1,1.0,1,0.1709405150873293,43
2647,5,5269,2059,3210,0,0,0,1.0,1,1.0,1,1.0,1,0.07925638132186194,40
2648,1,5270,2060,3210,0,0,0,1.0,1,1.0,1,1.0,1,0.0764366168014421,41
2649,2,5272,2060,3212,0,0,0,1.0,1,1.0,1,1.0,1,0.07946610739902339,43
2650,0,5272,2060,3212,0,0,0,1.0,1,1.0,1,1.0,1,0.11071861667243824,43
2651,3,5275,2061,3214,0,0,0,1.0,1,1.0,1,1.0,1,0.09166563182743764,44
2652,1,5276,2061,3215,0,0,0,1.0,1,1.0,1,1.0,1,0.08613292489611947,44
2653,0,5276,2061,3215,0,0,0,1.0,1,1.0,1,1.0,1,0.08613292489611947,44
2654,3,5279,2062,3217,0,0,0,1.0,1,1.0,1,1.0,1,0.07208856505057563,45
2655,0,5279,2062,3217,0,0,0,1.0,1,1.0,1,1.0,1,0.07208856505057563,45
2656,1,5280,2063,3217,0,0,0,1.0,1,1.0,1,1.0,1,0.09014759173837526,45
2657,2,5282,2063,3219,0,0,0,1.0,1,1.0,1,1.0,1,0.07800556728628975,45
2658,2,5284,2064,3220,0,0,0,1.0,1,1.0,1,1.0,1,0.10901078296249095,47
2659,2,5286,2064,3222,0,0,0,1.0,1,1.0,1,1.0,1,0.06299601737521238,46
2660,0,5286,2064,3222,0,0,0,1.0,1,1.0,1,1.0,1,0.06299601737521238,46
2661,2,5288,2065,3223,0,0,0,1.0,1,1.0,1,1.0,1,0.11716152860168386,46
2662,5,5293,2067,3226,0,0,0,1.0,1,1.0,1,1.0,1,0.089261208802143,47
2663,2,5295,2069,3226,0,0,0,1.0,1,1.0,1,1.0,1,0.10526013858964245,46
2664,3,5298,2071,3227,0,0,0,1.0,1,1.0,1,1.0,1,0.09766841154217296,45
2665,5,5303,2072,3231,0,0,0,1.0,1,1.0,1,1.0,1,0.10308483747779287,47
2666,8,5311,2076,3235,0,0,0,1.0,1,1.0,1,1.0,1,0.13354617277500702,47
2667,2,5313,2077,3236,0,0,0,1.0,1,1.0,1,1.0,1,0.12606483549265246,45
2668,4,5317,2079,3238,0,0,0,1.0,1,1.0,1,1.0,1,0.10277472138336845,45
2669,3,5320,2080,3240,0,0,0,1.0,1,1.0,1,1.0,1,0.13899857157380277,45
2670,1,5321,2081,3240,0,0,0,1.0,1,1.0,1,1.0,1,0.14421656247857978,45
2671,1,5322,2082,3240,0,0,0,1.0,1,1.0,1,1.0,1,0.14974594345313808,41
2672,1,5323,2083,3240,0,0,0,1.0,1,1.0,1,1.0,1,0.1592879793591142,40
2673,0,5323,2083,3240,0,0,0,1.0,1,1.0,1,1.0,1,0.15716482297087694,39
2674,2,5325,2084,3241,0,0,0,1.0,1,1.0,1,1.0,1,0.17968416844810842,37
2675,1,5326,2085,3241,0,0,0,1.0,1,1.0,1,1.0,1,0.18724413176010157,35
2676,3,5329,2086,3243,0,0,0,1.0,1,1.0,1,1.0,1,0.1653789274577883,34
2677,2,5331,2086,3245,0,0,0,1.0,1,1.0,1,1.0,1,0.14811414258061606,32
2678,2,5333,2086,3247,0,0,0,1.0,1,1.0,1,1.0,1,0.1641813584020435,33
2679,4,5337,2088,3249,0,0,0,1.0,1,1.0,1,1.0,1,0.18483253807211333,33
2680,5,5342,2092,3250,0,0,0,1.0,1,1.0,1,1.0,1,0.26780688479659326,33
2681,2,5344,2092,3252,0,0,0,1.0,1,1.0,1,1.0,1,0.1309546436116186,32
2682,1,5345,2092,3253,0,0,0,1.0,1,1.0,1,1.0,1,0.09819121618794581,32
2683,3,5348,2093,3255,0,0,0,1.0,1,1.0,1,1.0,1,0.15810193815951112,32
2684,0,5348,2093,3255,0,0,0,1.0,1,1.0,1,1.0,1,0.17756971320318005,31
2685,1,5349,2094,3255,0,0,0,1.0,1,1.0,1,1.0,1,0.2221716817405657,30
2686,5,5354,2095,3259,0,0,0,1.0,1,1.0,1,1.0,1,0.13878281923766722,29
2687,1,5355,2095,3260,0,0,0,1.0,1,1.0,1,1.0,1,0.12801911342960673,28
2688,0,5355,2095,3260,0,0,0,1.0,1,1.0,1,1.0,1,0.12801911342960673,28
2689,1,5356,2095,3261,0,0,0,1.0,1,1.0,1,1.0,1,0.17202515933176732,29
2690,1,5357,2095,3262,0,0,0,1.0,1,1.0,1,1.0,1,0.12869083055041217,29
2691,1,5358,2096,3262,0,0,0,1.0,1,1.0,1,1.0,1,0.1561951976901257,29
2692,4,5362,2096,3266,0,0,0,1.0,1,1.0,1,1.0,1,0.05973827422331068,31
2693,2,5364,2097,3267,0,0,0,1.0,1,1.0,1,1.0,1,0.09585749293048709,32
2694,0,5364,2097,3267,0,0,0,1.0,1,1.0,1,1.0,1,0.09585749293048709,32
2695,0,5364,2097,3267,0,0,0,1.0,1,1.0,1,1.0,1,0.07558654649769864,33
2696,0,5364,2097,3267,0,0,0,1.0,1,1.0,1,1.0,1,0.07558654649769864,33
2697,2,5366,2099,3267,0,0,0,1.0,1,1.0,1,1.0,1,0.1338980664170329,34
2698,3,5369,2100,3269,0,0,0,1.0,1,1.0,1,1.0,1,0.10871025367550109,34
2699,0,5369,2100,3269,0,0,0,1.0,1,1.0,1,1.0,1,0.09577759532134228,36
2700,4,5373,2101,3272,0,0,0,1.0,1,1.0,1,1.0,1,0.14890579183778482,36
2701,1,5374,2101,3273,0,0,0,1.0,1,1.0,1,1.0,1,0.1259617536114169,36
2702,2,5376,2102,3274,0,0,0,1.0,1,1.0,1,1.0,1,0.16141104749090282,36
2703,3,5379,2103,3276,0,0,0,1.0,1,1.0,1,1.0,1,0.12329870207536348,38
2704,2,5381,2104,3277,0,0,0,1.0,1,1.0,1,1.0,1,0.15471028456323424,37
2705,2,5383,2105,3278,0,0,0,1.0,1,1.0,1,1.0,1,0.18081645301323618,36
2706,5,5388,2107,3281,0,0,0,1.0,1,1.0,1,1.0,1,0.2233992154538355,34
2707,3,5391,2108,3283,0,0,0,1.0,1,1.0,1,1.0,1,0.2016650822385483,36
2708,4,5395,2110,3285,0,0,0,1.0,1,1.0,1,1.0,1,0.20149669458758399,36
2709,0,5395,2110,3285,0,0,0,1.0,1,1.0,1,1.0,1,0.18720614415428952,33
2710,2,5397,2111,3286,0,0,0,1.0,1,1.0,1,1.0,1,0.14718918897188182,32
2711,1,5398,2112,3286,0,0,0,1.0,1,1.0,1,1.0,1,0.12044541838863725,29
2712,0,5398,2112,3286,0,0,0,1.0,1,1.0,1,1.0,1,0.15642410179923344,28
2713,3,5401,2112,3289,0,0,0,1.0,1,1.0,1,1.0,1,0.1029956784812405,28
2714,1,5402,2113,3289,0,0,0,1.0,1,1.0,1,1.0,1,0.20738823076048182,25
2715,1,5403,2114,3289,0,0,0,1.0,1,1.0,1,1.0,1,0.2090266782173468,24
2716,3,5406,2116,3290,0,0,0,1.0,1,1.0,1,1.0,1,0.33725563369202605,23
2717,3,5409,2117,3292,0,0,0,1.0,1,1.0,1,1.0,1,0.2703324138587426,24
2718,1,5410,2117,3293,0,0,0,1.0,1,1.0,1,1.0,1,0.27088957175669415,24
2719,4,5414,2118,3296,0,0,0,1.0,1,1.0,1,1.0,1,0.11781214293049848,25
2720,1,5415,2118,3297,0,0,0,1.0,1,1.0,1,1.0,1,0.10945284999594765,25
2721,2,5417,2120,3297,0,0,0,1.0,1,1.0,1,1.0,1,0.12960022784792455,26
2722,1,5418,2120,3298,0,0,0,1.0,1,1.0,1,1.0,1,0.08713927543227264,26
2723,0,5418,2120,3298,0,0,0,1.0,1,1.0,1,1.0,1,0.08713927543227264,26
2724,1,5419,2121,3298,0,0,0,1.0,1,1.0,1,1.0,1,0.12942027553504015,27
2725,1,5420,2122,3298,0,0,0,1.0,1,1.0,1,1.0,1,0.1318210102029328,27
2726,1,5421,2122,3299,0,0,0,1.0,1,1.0,1,1.0,1,0.15583121256379281,28
2727,1,5422,2122,3300,0,0,0,1.0,1,1.0,1,1.0,1,0.1262599281600676,29
2728,1,5423,2122,3301,0,0,0,1.0,1,1.0,1,1.0,1,0.07673040539708358,28
2729,0,5423,2122,3301,0,0,0,1.0,1,1.0,1,1.0,1,0.07673040539708358,28
2730,0,5423,2122,3301,0,0,0,1.0,1,1.0,1,1.0,1,0.10653832778111114,29
2731,1,5424,2123,3301,0,0,0,1.0,1,1.0,1,1.0,1,0.17806482700713683,30
2732,3,5427,2124,3303,0,0,0,1.0,1,1.0,1,1.0,1,0.20387652547057117,29
2733,1,5428,2125,3303,0,0,0,1.0,1,1.0,1,1.0,1,0.24172545327057443,29
2734,2,5430,2125,3305,0,0,0,1.0,1,1.0,1,1.0,1,0.1935126870182649,29
2735,1,5431,2126,3305,0,0,0,1.0,1,1.0,1,1.0,1,0.16729873311542678,29
2736,2,5433,2126,3307,0,0,0,1.0,1,1.0,1,1.0,1,0.14229705798766593,30
2737,1,5434,2126,3308,0,0,0,1.0,1,1.0,1,1.0,1,0.11449712984277832,30
2738,1,5435,2127,3308,0,0,0,1.0,1,1.0,1,1.0,1,0.1274252330430235,29
2739,1,5436,2127,3309,0,0,0,1.0,1,1.0,1,1.0,1,0.13151198145766504,30
2740,1,5437,2128,3309,0,0,0,1.0,1,1.0,1,1.0,1,0.17208490955821687,29
2741,1,5438,2128,3310,0,0,0,1.0,1,1.0,1,1.0,1,0.15037451553280326,29
2742,1,5439,2129,3310,0,0,0,1.0,1,1.0,1,1.0,1,0.15993596030131374,29
2743,3,5442,2130,3312,0,0,0,1.0,1,1.0,1,1.0,1,0.21391929426152065,30
2744,4,5446,2132,3314,0,0,0,1.0,1,1.0,1,1.0,1,0.24338900500343993,28
2745,1,5447,2132,3315,0,0,0,1.0,1,1.0,1,1.0,1,0.14111897067621437,27
2746,1,5448,2133,3315,0,0,0,1.0,1,1.0,1,1.0,1,0.17557653837765802,26
2747,1,5449,2134,3315,0,0,0,1.0,1,1.0,1,1.0,1,0.2137511491615931,22
2748,1,5450,2135,3315,0,0,0,1.0,1,1.0,1,1.0,1,0.24089782465040754,22
2749,3,5453,2135,3318,0,0,0,1.0,1,1.0,1,1.0,1,0.21266724956777633,20
2750,0,5453,2135,3318,0,0,0,1.0,1,1.0,1,1.0,1,0.27932877824969404,17
2751,0,5453,2135,3318,0,0,0,1.0,1,1.0,1,1.0,1,0.27932877824969404,17
2752,0,5453,2135,3318,0,0,0,1.0,1,1.0,1,1.0,1,0.25417788585463846,16
2753,0,5453,2135,3318,0,0,0,1.0,1,1.0,1,1.0,1,0.25417788585463846,16
2754,0,5453,2135,3318,0,0,0,1.0,1,1.0,1,1.0,1,0.25417788585463846,16
2755,1,5454,2136,3318,0,0,0,1.0,1,1.0,1,1.0,1,0.2658811907563351,16
2756,0,5454,2136,3318,0,0,0,1.0,1,1.0,1,1.0,1,0.2740974648053188,17
2757,1,5455,2137,3318,0,0,0,1.0,1,1.0,1,1.0,1,0.23608274783290462,18
2758,0,5455,2137,3318,0,0,0,1.0,1,1.0,1,1.0,1,0.23608274783290462,18
2759,0,5455,2137,3318,0,0,0,1.0,1,1.0,1,1.0,1,0.2652338567761984,19
2760,2,5457,2138,3319,0,0,0,1.0,1,1.0,1,1.0,1,0.26658033705812123,18
2761,1,5458,2138,3320,0,0,0,1.0,1,1.0,1,1.0,1,0.20050362542143932,18
2762,0,5458,2138,3320,0,0,0,1.0,1,1.0,1,1.0,1,0.20050362542143932,18
2763,1,5459,2138,3321,0,0,0,1.0,1,1.0,1,1.0,1,0.18037603462790675,18
2764,0,5459,2138,3321,0,0,0,1.0,1,1.0,1,1.0,1,0.18037603462790675,18
2765,0,5459,2138,3321,0,0,0,1.0,1,1.0,1,1.0,1,0.24524703080178797,18
2766,1,5460,2139,3321,0,0,0,1.0,1,1.0,1,1.0,1,0.2490879953573711,18
2767,0,5460,2139,3321,0,0,0,1.0,1,1.0,1,1.0,1,0.2819999680928761,17
2768,0,5460,2139,3321,0,0,0,1.0,1,1.0,1,1.0,1,0.2819999680928761,17
2769,1,5461,2140,3321,0,0,0,1.0,1,1.0,1,1.0,1,0.2693730797158818,17
2770,0,5461,2140,3321,0,0,0,1.0,1,1.0,1,1.0,1,0.2693730797158818,17
2771,0,5461,2140,3321,0,0,0,1.0,1,1.0,1,1.0,1,0.2693730797158818,17
2772,0,5461,2140,3321,0,0,0,1.0,1,1.0,1,1.0,1,0.2693730797158818,17
2773,1,5462,2141,3321,0,0,0,1.0,1,1.0,1,1.0,1,0.27153931669792997,17
2774,0,5462,2141,3321,0,0,0,1.0,1,1.0,1,1.0,1,0.231711873159482,18
2775,1,5463,2142,3321,0,0,0,1.0,1,1.0,1,1.0,1,0.23960473885268313,20
2776,1,5464,2143,3321,0,0,0,1.0,1,1.0,1,1.0,1,0.26486810844425146,21
2777,1,5465,2144,3321,0,0,0,1.0,1,1.0,1,1.0,1,0.30137776630196333,21
2778,0,5465,2144,3321,0,0,0,1.0,1,1.0,1,1.0,1,0.30137776630196333,21
2779,3,5468,2145,3323,0,0,0,1.0,1,1.0,1,1.0,1,0.2650609055532608,22
2780,2,5470,2147,3323,0,0,0,1.0,1,1.0,1,1.0,1,0.31251271095720495,22
2781,3,5473,2148,3325,0,0,0,1.0,1,1.0,1,1.0,1,0.24724711212167183,22
2782,5,5478,2150,3328,0,0,0,1.0,1,1.0,1,1.0,1,0.22260119074961573,23
2783,1,5479,2151,3328,0,0,0,1.0,1,1.0,1,1.0,1,0.21251285161959424,22
2784,1,5480,2151,3329,0,0,0,1.0,1,1.0,1,1.0,1,0.14609632271464706,21
2785,0,5480,2151,3329,0,0,0,1.0,1,1.0,1,1.0,1,0.2197679037517716,19
2786,1,5481,2152,3329,0,0,0,1.0,1,1.0,1,1.0,1,0.2077863289240041,19
2787,1,5482,2152,3330,0,0,0,1.0,1,1.0,1,1.0,1,0.27023050418412914,20
2788,1,5483,2153,3330,0,0,0,1.0,1,1.0,1,1.0,1,0.2689854715403172,20
2789,0,5483,2153,3330,0,0,0,1.0,1,1.0,1,1.0,1,0.31028995688714917,19
2790,0,5483,2153,3330,0,0,0,1.0,1,1.0,1,1.0,1,0.30077521564641346,20
2791,0,5483,2153,3330,0,0,0,1.0,1,1.0,1,1.0,1,0.30077521564641346,20
2792,1,5484,2153,3331,0,0,0,1.0,1,1.0,1,1.0,1,0.2551710416449476,20
2793,0,5484,2153,3331,0,0,0,1.0,1,1.0,1,1.0,1,0.259274821490977,19
2794,1,5485,2153,3332,0,0,0,1.0,1,1.0,1,1.0,1,0.2564289827375408,20
2795,2,5487,2153,3334,0,0,0,1.0,1,1.0,1,1.0,1,0.22643696486531883,21
2796,0,5487,2153,3334,0,0,0,1.0,1,1.0,1,1.0,1,0.21939901532714462,22
2797,0,5487,2153,3334,0,0,0,1.0,1,1.0,1,1.0,1,0.22080859394459806,21
2798,1,5488,2154,3334,0,0,0,1.0,1,1.0,1,1.0,1,0.2523974829716575,21
2799,0,5488,2154,3334,0,0,0,1.0,1,1.0,1,1.0,1,0.25903800602595467,20
2800,2,5490,2154,3336,0,0,0,1.0,1,1.0,1,1.0,1,0.1782083753727985,20
2801,0,5490,2154,3336,0,0,0,1.0,1,1.0,1,1.0,1,0.1782083753727985,20
2802,1,5491,2154,3337,0,0,0,1.0,1,1.0,1,1.0,1,0.13374231873269157,20
2803,0,5491,2154,3337,0,0,0,1.0,1,1.0,1,1.0,1,0.14398454045651393,21
2804,0,5491,2154,3337,0,0,0,1.0,1,1.0,1,1.0,1,0.14869122074125965,22
2805,1,5492,2155,3337,0,0,0,1.0,1,1.0,1,1.0,1,0.14287684892926608,22
2806,1,5493,2156,3337,0,0,0,1.0,1,1.0,1,1.0,1,0.18144444741536156,23
2807,2,5495,2157,3338,0,0,0,1.0,1,1.0,1,1.0,1,0.2512998968399041,24
2808,3,5498,2159,3339,0,0,0,1.0,1,1.0,1,1.0,1,0.26228017677402515,24
2809,3,5501,2159,3342,0,0,0,1.0,1,1.0,1,1.0,1,0.1211786747830258,26
2810,2,5503,2159,3344,0,0,0,1.0,1,1.0,1,1.0,1,0.12893616508847797,26
2811,2,5505,2159,3346,0,0,0,1.0,1,1.0,1,1.0,1,0.1605288135582905,27
2812,1,5506,2159,3347,0,0,0,1.0,1,1.0,1,1.0,1,0.12426943983643476,27
2813,0,5506,2159,3347,0,0,0,1.0,1,1.0,1,1.0,1,0.13966248804672377,28
2814,1,5507,2159,3348,0,0,0,1.0,1,1.0,1,1.0,1,0.13315875113167905,29
2815,1,5508,2159,3349,0,0,0,1.0,1,1.0,1,1.0,1,0.13410577948300792,30
2816,0,5508,2159,3349,0,0,0,1.0,1,1.0,1,1.0,1,0.1255305254153071,31
2817,0,5508,2159,3349,0,0,0,1.0,1,1.0,1,1.0,1,0.1255305254153071,31
2818,1,5509,2159,3350,0,0,0,1.0,1,1.0,1,1.0,1,0.10484885021400728,32
2819,0,5509,2159,3350,0,0,0,1.0,1,1.0,1,1.0,1,0.10484885021400728,32
2820,1,5510,2160,3350,0,0,0,1.0,1,1.0,1,1.0,1,0.11358226937205494,33
2821,0,5510,2160,3350,0,0,0,1.0,1,1.0,1,1.0,1,0.13567389893176435,34
2822,1,5511,2161,3350,0,0,0,1.0,1,1.0,1,1.0,1,0.12031352432700296,35
2823,1,5512,2162,3350,0,0,0,1.0,1,1.0,1,1.0,1,0.19821170298440616,31
2824,5,5517,2164,3353,0,0,0,1.0,1,1.0,1,1.0,1,0.26789445986140553,33
2825,1,5518,2164,3354,0,0,0,1.0,1,1.0,1,1.0,1,0.19692309259015206,31
2826,1,5519,2164,3355,0,0,0,1.0,1,1.0,1,1.0,1,0.1697894910456501,31
2827,2,5521,2165,3356,0,0,0,1.0,1,1.0,1,1.0,1,0.15899094646559314,32
2828,5,5526,2168,3358,0,0,0,1.0,1,1.0,1,1.0,1,0.2188841269519017,33
2829,3,5529,2170,3359,0,0,0,1.0,1,1.0,1,1.0,1,0.2393032043371607,33
2830,6,5535,2171,3364,0,0,0,1.0,1,1.0,1,1.0,1,0.17383024714441478,32
2831,1,5536,2171,3365,0,0,0,1.0,1,1.0,1,1.0,1,0.19166810717934982,31
2832,0,5536,2171,3365,0,0,0,1.0,1,1.0,1,1.0,1,0.17681043852608788,30
2833,0,5536,2171,3365,0,0,0,1.0,1,1.0,1,1.0,1,0.1680941288155718,29
2834,2,5538,2173,3365,0,0,0,1.0,1,1.0,1,1.0,1,0.2857526361446732,29
2835,2,5540,2175,3365,0,0,0,1.0,1,1.0,1,1.0,1,0.38318097724691,27
2836,6,5546,2176,3370,0,0,0,1.0,1,1.0,1,1.0,1,0.2049195802927373,27
2837,0,5546,2176,3370,0,0,0,1.0,1,1.0,1,1.0,1,0.21366474167159397,28
2838,3,5549,2177,3372,0,0,0,1.0,1,1.0,1,1.0,1,0.198744395660569,29
2839,1,5550,2177,3373,0,0,0,1.0,1,1.0,1,1.0,1,0.196220063029478,29
2840,1,5551,2178,3373,0,0,0,1.0,1,1.0,1,1.0,1,0.21007938085227867,29
2841,2,5553,2178,3375,0,0,0,1.0,1,1.0,1,1.0,1,0.19125932515016364,31
2842,2,5555,2178,3377,0,0,0,1.0,1,1.0,1,1.0,1,0.1495582278933217,32
2843,0,5555,2178,3377,0,0,0,1.0,1,1.0,1,1.0,1,0.1495582278933217,32
2844,3,5558,2179,3379,0,0,0,1.0,1,1.0,1,1.0,1,0.13108117057602642,33
2845,2,5560,2180,3380,0,0,0,1.0,1,1.0,1,1.0,1,0.18056207746272288,34
2846,2,5562,2181,3381,0,0,0,1.0,1,1.0,1,1.0,1,0.17771771142157067,34
2847,0,5562,2181,3381,0,0,0,1.0,1,1.0,1,1.0,1,0.16087280121106112,35
2848,4,5566,2182,3384,0,0,0,1.0,1,1.0,1,1.0,1,0.17860391790416488,37
2849,4,5570,2183,3387,0,0,0,1.0,1,1.0,1,1.0,1,0.14431308728643744,37
2850,1,5571,2183,3388,0,0,0,1.0,1,1.0,1,1.0,1,0.1299006151246077,37
2851,3,5574,2184,3390,0,0,0,1.0,1,1.0,1,1.0,1,0.12400875121970913,38
2852,0,5574,2184,3390,0,0,0,1.0,1,1.0,1,1.0,1,0.14316182812920883,36
2853,1,5575,2184,3391,0,0,0,1.0,1,1.0,1,1.0,1,0.16585783075881727,36
2854,0,5575,2184,3391,0,0,0,1.0,1,1.0,1,1.0,1,0.1864023134533513,37
2855,1,5576,2184,3392,0,0,0,1.0,1,1.0,1,1.0,1,0.18767153230873493,37
2856,0,5576,2184,3392,0,0,0,1.0,1,1.0,1,1.0,1,0.18472918396639817,38
2857,4,5580,2186,3394,0,0,0,1.0,1,1.0,1,1.0,1,0.16785759858168714,39
2858,1,5581,2186,3395,0,0,0,1.0,1,1.0,1,1.0,1,0.1569578324219806,39
2859,0,5581,2186,3395,0,0,0,1.0,1,1.0,1,1.0,1,0.1569578324219806,39
2860,3,5584,2187,3397,0,0,0,1.0,1,1.0,1,1.0,1,0.11000251724522253,40
2861,0,5584,2187,3397,0,0,0,1.0,1,1.0,1,1.0,1,0.08738362202055037,38
2862,6,5590,2193,3397,0,0,0,1.0,1,1.0,1,1.0,1,0.18387540349752807,38
2863,4,5594,2195,3399,0,0,0,1.0,1,1.0,1,1.0,1,0.18230921715814527,37
2864,6,5600,2199,3401,0,0,0,1.0,1,1.0,1,1.0,1,0.18154268399540607,35
2865,3,5603,2201,3402,0,0,0,1.0,1,1.0,1,1.0,1,0.21861846248440595,33
2866,3,5606,2203,3403,0,0,0,1.0,1,1.0,1,1.0,1,0.15992803336690692,31
2867,2,5608,2203,3405,0,0,0,1.0,1,1.0,1,1.0,1,0.18575810730754888,30
2868,3,5611,2206,3405,0,0,0,1.0,1,1.0,1,1.0,1,0.23999878876114467,31
2869,2,5613,2207,3406,0,0,0,1.0,1,1.0,1,1.0,1,0.20533245076917245,30
2870,0,5613,2207,3406,0,0,0,1.0,1,1.0,1,1.0,1,0.24805690239298261,26
2871,3,5616,2208,3408,0,0,0,1.0,1,1.0,1,1.0,1,0.1884534522259967,27
2872,1,5617,2208,3409,0,0,0,1.0,1,1.0,1,1.0,1,0.2065586795269696,25
2873,1,5618,2208,3410,0,0,0,1.0,1,1.0,1,1.0,1,0.1920197207231528,24
2874,0,5618,2208,3410,0,0,0,1.0,1,1.0,1,1.0,1,0.17735498202699843,25
2875,0,5618,2208,3410,0,0,0,1.0,1,1.0,1,1.0,1,0.20304824013688907,26
2876,3,5621,2209,3412,0,0,0,1.0,1,1.0,1,1.0,1,0.22933761385568047,28
2877,0,5621,2209,3412,0,0,0,1.0,1,1.0,1,1.0,1,0.2294455954555109,29
2878,3,5624,2209,3415,0,0,0,1.0,1,1.0,1,1.0,1,0.13312576637098997,31
2879,1,5625,2209,3416,0,0,0,1.0,1,1.0,1,1.0,1,0.10799928839801745,31
2880,0,5625,2209,3416,0,0,0,1.0,1,1.0,1,1.0,1,0.11031011325506013,32
2881,0,5625,2209,3416,0,0,0,1.0,1,1.0,1,1.0,1,0.10803919215178343,31
2882,0,5625,2209,3416,0,0,0,1.0,1,1.0,1,1.0,1,0.10803919215178343,31
2883,0,5625,2209,3416,0,0,0,1.0,1,1.0,1,1.0,1,0.14180893668175507,32
2884,1,5626,2210,3416,0,0,0,1.0,1,1.0,1,1.0,1,0.1657222792472238,32
2885,4,5630,2211,3419,0,0,0,1.0,1,1.0,1,1.0,1,0.1093070744456231,33
2886,1,5631,2212,3419,0,0,0,1.0,1,1.0,1,1.0,1,0.10954062233563401,34
2887,2,5633,2212,3421,0,0,0,1.0,1,1.0,1,1.0,1,0.08831243678730438,34
2888,2,5635,2213,3422,0,0,0,1.0,1,1.0,1,1.0,1,0.09460814891539668,34
2889,3,5638,2215,3423,0,0,0,1.0,1,1.0,1,1.0,1,0.16606673803904853,37
2890,1,5639,2215,3424,0,0,0,1.0,1,1.0,1,1.0,1,0.14377689654757345,37
2891,1,5640,2216,3424,0,0,0,1.0,1,1.0,1,1.0,1,0.19335563821635457,37
2892,2,5642,2216,3426,0,0,0,1.0,1,1.0,1,1.0,1,0.16687921658977756,37
2893,2,5644,2217,3427,0,0,0,1.0,1,1.0,1,1.0,1,0.1784579917991412,38
2894,1,5645,2217,3428,0,0,0,1.0,1,1.0,1,1.0,1,0.16742691767813067,39
2895,5,5650,2218,3432,0,0,0,1.0,1,1.0,1,1.0,1,0.11007645374652633,40
2896,2,5652,2219,3433,0,0,0,1.0,1,1.0,1,1.0,1,0.10717776461711837,41
2897,0,5652,2219,3433,0,0,0,1.0,1,1.0,1,1.0,1,0.10717776461711837,41
2898,2,5654,2221,3433,0,0,0,1.0,1,1.0,1,1.0,1,0.14049576874961783,41
2899,0,5654,2221,3433,0,0,0,1.0,1,1.0,1,1.0,1,0.14304754650030452,39
2900,7,5661,2224,3437,0,0,0,1.0,1,1.0,1,1.0,1,0.20127853434566645,40
2901,0,5661,2224,3437,0,0,0,1.0,1,1.0,1,1.0,1,0.16876513194465737,40
2902,3,5664,2225,3439,0,0,0,1.0,1,1.0,1,1.0,1,0.1468384798652979,38
2903,2,5666,2226,3440,0,0,0,1.0,1,1.0,1,1.0,1,0.10637025177246064,36
2904,3,5669,2228,3441,0,0,0,1.0,1,1.0,1,1.0,1,0.12347182038591874,36
2905,0,5669,2228,3441,0,0,0,1.0,1,1.0,1,1.0,1,0.09803184642231799,35
2906,2,5671,2229,3442,0,0,0,1.0,1,1.0,1,1.0,1,0.09748998368450927,36
2907,2,5673,2230,3443,0,0,0,1.0,1,1.0,1,1.0,1,0.12067032722390506,37
2908,1,5674,2231,3443,0,0,0,1.0,1,1.0,1,1.0,1,0.14372094676321487,38
2909,1,5675,2232,3443,0,0,0,1.0,1,1.0,1,1.0,1,0.15870871342792037,37
2910,0,5675,2232,3443,0,0,0,1.0,1,1.0,1,1.0,1,0.1483289603480469,37
2911,0,5675,2232,3443,0,0,0,1.0,1,1.0,1,1.0,1,0.18803635496364618,36
2912,3,5678,2234,3444,0,0,0,1.0,1,1.0,1,1.0,1,0.1849044023513042,36
2913,1,5679,2235,3444,0,0,0,1.0,1,1.0,1,1.0,1,0.17108434015644214,36
2914,2,5681,2236,3445,0,0,0,1.0,1,1.0,1,1.0,1,0.19427331810054138,38
2915,0,5681,2236,3445,0,0,0,1.0,1,1.0,1,1.0,1,0.18569607975404834,37
2916,4,5685,2236,3449,0,0,0,1.0,1,1.0,1,1.0,1,0.14100664697832851,39
2917,5,5690,2237,3453,0,0,0,1.0,1,1.0,1,1.0,1,0.10367177880088271,40
2918,3,5693,2239,3454,0,0,0,1.0,1,1.0,1,1.0,1,0.14733316923156406,40
2919,0,5693,2239,3454,0,0,0,1.0,1,1.0,1,1.0,1,0.1666787331409642,42
2920,1,5694,2239,3455,0,0,0,1.0,1,1.0,1,1.0,1,0.1514193408340149,42
2921,1,5695,2239,3456,0,0,0,1.0,1,1.0,1,1.0,1,0.1204887896848912,42
2922,0,5695,2239,3456,0,0,0,1.0,1,1.0,1,1.0,1,0.1019887820820688,43
2923,0,5695,2239,3456,0,0,0,1.0,1,1.0,1,1.0,1,0.12563284385927848,45
2924,2,5697,2240,3457,0,0,0,1.0,1,1.0,1,1.0,1,0.1133477350173679,46
2925,2,5699,2240,3459,0,0,0,1.0,1,1.0,1,1.0,1,0.06552364759627909,46
2926,0,5699,2240,3459,0,0,0,1.0,1,1.0,1,1.0,1,0.06552364759627909,46
2927,1,5700,2241,3459,0,0,0,1.0,1,1.0,1,1.0,1,0.07417506388507303,48
2928,2,5702,2243,3459,0,0,0,1.0,1,1.0,1,1.0,1,0.11289288576215234,48
2929,1,5703,2243,3460,0,0,0,1.0,1,1.0,1,1.0,1,0.08986597399424126,48
2930,0,5703,2243,3460,0,0,0,1.0,1,1.0,1,1.0,1,0.11236240593513114,50
2931,1,5704,2244,3460,0,0,0,1.0,1,1.0,1,1.0,1,0.14362750188796033,51
2932,3,5707,2244,3463,0,0,0,1.0,1,1.0,1,1.0,1,0.13256973929170374,52
2933,0,5707,2244,3463,0,0,0,1.0,1,1.0,1,1.0,1,0.13922124697971883,53
2934,4,5711,2245,3466,0,0,0,1.0,1,1.0,1,1.0,1,0.16699533157170118,54
2935,2,5713,2245,3468,0,0,0,1.0,1,1.0,1,1.0,1,0.14150501206512,53
2936,1,5714,2246,3468,0,0,0,1.0,1,1.0,1,1.0,1,0.14032495751916524,53
2937,0,5714,2246,3468,0,0,0,1.0,1,1.0,1,1.0,1,0.18216384378544762,51
2938,4,5718,2248,3470,0,0,0,1.0,1,1.0,1,1.0,1,0.20954021192587075,53
2939,0,5718,2248,3470,0,0,0,1.0,1,1.0,1,1.0,1,0.20561900268352465,52
2940,5,5723,2250,3473,0,0,0,1.0,1,1.0,1,1.0,1,0.20767811671960745,52
2941,4,5727,2250,3477,0,0,0,1.0,1,1.0,1,1.0,1,0.14494781378604688,50
2942,0,5727,2250,3477,0,0,0,1.0,1,1.0,1,1.0,1,0.1704977405768485,50
2943,2,5729,2251,3478,0,0,0,1.0,1,1.0,1,1.0,1,0.1511962697460781,49
2944,3,5732,2252,3480,0,0,0,1.0,1,1.0,1,1.0,1,0.1260912462743272,48
2945,1,5733,2253,3480,0,0,0,1.0,1,1.0,1,1.0,1,0.13737225833374891,48
2946,5,5738,2255,3483,0,0,0,1.0,1,1.0,1,1.0,1,0.10344360865958824,47
2947,1,5739,2255,3484,0,0,0,1.0,1,1.0,1,1.0,1,0.0654386788134987,47
2948,1,5740,2255,3485,0,0,0,1.0,1,1.0,1,1.0,1,0.06283110818989456,48
2949,0,5740,2255,3485,0,0,0,1.0,1,1.0,1,1.0,1,0.06283110818989456,48
2950,2,5742,2257,3485,0,0,0,1.0,1,1.0,1,1.0,1,0.05867549163591354,48
2951,2,5744,2258,3486,0,0,0,1.0,1,1.0,1,1.0,1,0.08390231351727546,50
2952,0,5744,2258,3486,0,0,0,1.0,1,1.0,1,1.0,1,0.08390231351727546,50
2953,2,5746,2258,3488,0,0,0,1.0,1,1.0,1,1.0,1,0.10092269378165943,51
2954,0,5746,2258,3488,0,0,0,1.0,1,1.0,1,1.0,1,0.10092269378165943,51
2955,0,5746,2258,3488,0,0,0,1.0,1,1.0,1,1.0,1,0.10092269378165943,51
2956,1,5747,2259,3488,0,0,0,1.0,1,1.0,1,1.0,1,0.1318666523726356,51
2957,2,5749,2259,3490,0,0,0,1.0,1,1.0,1,1.0,1,0.11902149401476143,52
2958,0,5749,2259,3490,0,0,0,1.0,1,1.0,1,1.0,1,0.11902149401476143,52
2959,2,5751,2260,3491,0,0,0,1.0,1,1.0,1,1.0,1,0.11321015015162202,53
2960,1,5752,2261,3491,0,0,0,1.0,1,1.0,1,1.0,1,0.1180339331697669,52
2961,3,5755,2261,3494,0,0,0,1.0,1,1.0,1,1.0,1,0.10245998334379133,53
2962,2,5757,2261,3496,0,0,0,1.0,1,1.0,1,1.0,1,0.08625700890544523,54
2963,3,5760,2263,3497,0,0,0,1.0,1,1.0,1,1.0,1,0.11524050017550043,55
2964,2,5762,2263,3499,0,0,0,1.0,1,1.0,1,1.0,1,0.09856976554177493,55
2965,0,5762,2263,3499,0,0,0,1.0,1,1.0,1,1.0,1,0.11142724449623627,55
2966,0,5762,2263,3499,0,0,0,1.0,1,1.0,1,1.0,1,0.11142724449623627,55
2967,0,5762,2263,3499,0,0,0,1.0,1,1.0,1,1.0,1,0.14511171180391733,56
2968,0,5762,2263,3499,0,0,0,1.0,1,1.0,1,1.0,1,0.14511171180391733,56
2969,2,5764,2264,3500,0,0,0,1.0,1,1.0,1,1.0,1,0.15383947238136453,55
2970,3,5767,2264,3503,0,0,0,1.0,1,1.0,1,1.0,1,0.13595086630279415,57
2971,5,5772,2264,3508,0,0,0,1.0,1,1.0,1,1.0,1,0.10459049649186475,56
2972,0,5772,2264,3508,0,0,0,1.0,1,1.0,1,1.0,1,0.11462070981537795,57
2973,1,5773,2264,3509,0,0,0,1.0,1,1.0,1,1.0,1,0.11955784189178027,59
2974,1,5774,2265,3509,0,0,0,1.0,1,1.0,1,1.0,1,0.12641062967097444,60
2975,2,5776,2267,3509,0,0,0,1.0,1,1.0,1,1.0,1,0.1425409630467598,58
2976,3,5779,2269,3510,0,0,0,1.0,1,1.0,1,1.0,1,0.14968693306988404,59
2977,7,5786,2270,3516,0,0,0,1.0,1,1.0,1,1.0,1,0.09589678698520789,59
2978,1,5787,2270,3517,0,0,0,1.0,1,1.0,1,1.0,1,0.11675228710429354,58
2979,2,5789,2272,3517,0,0,0,1.0,1,1.0,1,1.0,1,0.1364031235458138,57
2980,5,5794,2273,3521,0,0,0,1.0,1,1.0,1,1.0,1,0.10950454754444924,56
2981,1,5795,2273,3522,0,0,0,1.0,1,1.0,1,1.0,1,0.10066253986872331,56
2982,3,5798,2275,3523,0,0,0,1.0,1,1.0,1,1.0,1,0.1469419158271942,57
2983,8,5806,2279,3527,0,0,0,1.0,1,1.0,1,1.0,1,0.15437067020423959,57
2984,3,5809,2280,3529,0,0,0,1.0,1,1.0,1,1.0,1,0.14575106892904077,56
2985,1,5810,2280,3530,0,0,0,1.0,1,1.0,1,1.0,1,0.15852299083943405,55
2986,8,5818,2282,3536,0,0,0,1.0,1,1.0,1,1.0,1,0.08984407511806025,55
2987,2,5820,2283,3537,0,0,0,1.0,1,1.0,1,1.0,1,0.11787920580861394,51
2988,6,5826,2285,3541,0,0,0,1.0,1,1.0,1,1.0,1,0.10444390659171902,52
2989,3,5829,2285,3544,0,0,0,1.0,1,1.0,1,1.0,1,0.07726410171901851,50
2990,1,5830,2286,3544,0,0,0,1.0,1,1.0,1,1.0,1,0.10394043471814009,50
2991,0,5830,2286,3544,0,0,0,1.0,1,1.0,1,1.0,1,0.07252675739680356,50
2992,1,5831,2287,3544,0,0,0,1.0,1,1.0,1,1.0,1,0.08370903251565688,50
2993,0,5831,2287,3544,0,0,0,1.0,1,1.0,1,1.0,1,0.12373016046052256,51
2994,1,5832,2288,3544,0,0,0,1.0,1,1.0,1,1.0,1,0.15747258338866907,51
2995,3,5835,2288,3547,0,0,0,1.0,1,1.0,1,1.0,1,0.1192449996687998,51
2996,2,5837,2289,3548,0,0,0,1.0,1,1.0,1,1.0,1,0.12673351749466824,52
2997,3,5840,2289,3551,0,0,0,1.0,1,1.0,1,1.0,1,0.11500901273758386,52
2998,2,5842,2290,3552,0,0,0,1.0,1,1.0,1,1.0,1,0.12492184846831325,51
2999,1,5843,2290,3553,0,0,0,1.0,1,1.0,1,1.0,1,0.12162866040341032,51
3000,1,5844,2291,3553,0,0,0,1.0,1,1.0,1,1.0,1,0.12490112878734361,52
3001,1,5845,2291,3554,0,0,0,1.0,1,1.0,1,1.0,1,0.11640226456596311,52
3002,1,5846,2292,3554,0,0,0,1.0,1,1.0,1,1.0,1,0.13923296338490052,53
3003,2,5848,2292,3556,0,0,0,1.0,1,1.0,1,1.0,1,0.13180755411036538,54
3004,2,5850,2292,3558,0,0,0,1.0,1,1.0,1,1.0,1,0.13363597113589043,55
3005,1,5851,2292,3559,0,0,0,1.0,1,1.0,1,1.0,1,0.13364901680772365,56
3006,2,5853,2293,3560,0,0,0,1.0,1,1.0,1,1.0,1,0.1448435506059237,57
3007,0,5853,2293,3560,0,0,0,1.0,1,1.0,1,1.0,1,0.15402597137448265,58
3008,4,5857,2296,3561,0,0,0,1.0,1,1.0,1,1.0,1,0.17578370534346022,59
3009,0,5857,2296,3561,0,0,0,1.0,1,1.0,1,1.0,1,0.17578370534346022,59
3010,4,5861,2296,3565,0,0,0,1.0,1,1.0,1,1.0,1,0.098546867202506,59
3011,0,5861,2296,3565,0,0,0,1.0,1,1.0,1,1.0,1,0.098546867202506,59
3012,4,5865,2299,3566,0,0,0,1.0,1,1.0,1,1.0,1,0.15212963387261524,61
3013,5,5870,2300,3570,0,0,0,1.0,1,1.0,1,1.0,1,0.12467572602245379,59
3014,0,5870,2300,3570,0,0,0,1.0,1,1.0,1,1.0,1,0.133901038743344,60
3015,2,5872,2301,3571,0,0,0,1.0,1,1.0,1,1.0,1,0.15743562756464466,58
3016,3,5875,2301,3574,0,0,0,1.0,1,1.0,1,1.0,1,0.13162818827804917,57
3017,1,5876,2302,3574,0,0,0,1.0,1,1.0,1,1.0,1,0.13793351530595094,58
3018,0,5876,2302,3574,0,0,0,1.0,1,1.0,1,1.0,1,0.1669153190051657,55
3019,3,5879,2303,3576,0,0,0,1.0,1,1.0,1,1.0,1,0.15123899932178309,56
3020,3,5882,2304,3578,0,0,0,1.0,1,1.0,1,1.0,1,0.22588131659408034,55
3021,6,5888,2306,3582,0,0,0,1.0,1,1.0,1,1.0,1,0.1945565853858352,55
3022,7,5895,2308,3587,0,0,0,1.0,1,1.0,1,1.0,1,0.19777496529382443,55
3023,2,5897,2309,3588,0,0,0,1.0,1,1.0,1,1.0,1,0.17746750302582393,54
3024,3,5900,2309,3591,0,0,0,1.0,1,1.0,1,1.0,1,0.18423789003197,54
3025,6,5906,2311,3595,0,0,0,1.0,1,1.0,1,1.0,1,0.11950696894739264,54
3026,0,5906,2311,3595,0,0,0,1.0,1,1.0,1,1.0,1,0.10618350555798944,53
3027,6,5912,2313,3599,0,0,0,1.0,1,1.0,1,1.0,1,0.0740980359256526,53
3028,3,5915,2314,3601,0,0,0,1.0,1,1.0,1,1.0,1,0.06635303255205613,51
3029,0,5915,2314,3601,0,0,0,1.0,1,1.0,1,1.0,1,0.062221915641876326,51
3030,4,5919,2317,3602,0,0,0,1.0,1,1.0,1,1.0,1,0.07902463780965488,52
3031,2,5921,2318,3603,0,0,0,1.0,1,1.0,1,1.0,1,0.08127114214667867,51
3032,0,5921,2318,3603,0,0,0,1.0,1,1.0,1,1.0,1,0.06817441926310962,50
3033,1,5922,2319,3603,0,0,0,1.0,1,1.0,1,1.0,1,0.09335442491073445,52
3034,1,5923,2319,3604,0,0,0,1.0,1,1.0,1,1.0,1,0.06874520528289683,51
3035,0,5923,2319,3604,0,0,0,1.0,1,1.0,1,1.0,1,0.0694393586457932,51
3036,1,5924,2319,3605,0,0,0,1.0,1,1.0,1,1.0,1,0.08105517503369174,53
3037,0,5924,2319,3605,0,0,0,1.0,1,1.0,1,1.0,1,0.08227867877768955,52
3038,1,5925,2320,3605,0,0,0,1.0,1,1.0,1,1.0,1,0.08758745774430231,52
3039,3,5928,2322,3606,0,0,0,1.0,1,1.0,1,1.0,1,0.1470800949001827,54
3040,5,5933,2322,3611,0,0,0,1.0,1,1.0,1,1.0,1,0.10158015958876696,55
3041,2,5935,2322,3613,0,0,0,1.0,1,1.0,1,1.0,1,0.0813530222328631,56
3042,1,5936,2322,3614,0,0,0,1.0,1,1.0,1,1.0,1,0.07454738722223164,56
3043,1,5937,2322,3615,0,0,0,1.0,1,1.0,1,1.0,1,0.05367480070074495,57
3044,1,5938,2323,3615,0,0,0,1.0,1,1.0,1,1.0,1,0.07780065842616532,57
3045,0,5938,2323,3615,0,0,0,1.0,1,1.0,1,1.0,1,0.09016600641562734,56
3046,1,5939,2323,3616,0,0,0,1.0,1,1.0,1,1.0,1,0.08346647873754603,57
3047,0,5939,2323,3616,0,0,0,1.0,1,1.0,1,1.0,1,0.09937416277672641,56
3048,3,5942,2324,3618,0,0,0,1.0,1,1.0,1,1.0,1,0.1323887341118428,58
3049,8,5950,2325,3625,0,0,0,1.0,1,1.0,1,1.0,1,0.1106622098337055,59
3050,2,5952,2325,3627,0,0,0,1.0,1,1.0,1,1.0,1,0.07657656964406129,60
3051,1,5953,2326,3627,0,0,0,1.0,1,1.0,1,1.0,1,0.12807650036810792,59
3052,6,5959,2328,3631,0,0,0,1.0,1,1.0,1,1.0,1,0.08870344263460565,58
3053,1,5960,2329,3631,0,0,0,1.0,1,1.0,1,1.0,1,0.08488829579544803,57
3054,2,5962,2331,3631,0,0,0,1.0,1,1.0,1,1.0,1,0.12512863543651587,55
3055,1,5963,2331,3632,0,0,0,1.0,1,1.0,1,1.0,1,0.09656445652399172,54
3056,3,5966,2333,3633,0,0,0,1.0,1,1.0,1,1.0,1,0.12729068989871556,55
3057,2,5968,2334,3634,0,0,0,1.0,1,1.0,1,1.0,1,0.14497678925983906,54
3058,3,5971,2335,3636,0,0,0,1.0,1,1.0,1,1.0,1,0.19800446736642957,55
3059,0,5971,2335,3636,0,0,0,1.0,1,1.0,1,1.0,1,0.19242595804187976,56
3060,0,5971,2335,3636,0,0,0,1.0,1,1.0,1,1.0,1,0.19242595804187976,56
3061,1,5972,2336,3636,0,0,0,1.0,1,1.0,1,1.0,1,0.20033665852498442,56
3062,8,5980,2339,3641,0,0,0,1.0,1,1.0,1,1.0,1,0.16877137131806072,57
3063,2,5982,2339,3643,0,0,0,1.0,1,1.0,1,1.0,1,0.1574652375795919,55
3064,6,5988,2341,3647,0,0,0,1.0,1,1.0,1,1.0,1,0.15285465608042098,56
3065,0,5988,2341,3647,0,0,0,1.0,1,1.0,1,1.0,1,0.12820786658303052,55
3066,2,5990,2343,3647,0,0,0,1.0,1,1.0,1,1.0,1,0.17136745224993294,55
3067,4,5994,2344,3650,0,0,0,1.0,1,1.0,1,1.0,1,0.14908781672373675,54
3068,7,6001,2347,3654,0,0,0,1.0,1,1.0,1,1.0,1,0.12564955284953522,53
3069,4,6005,2351,3654,0,0,0,1.0,1,1.0,1,1.0,1,0.1572824297841445,51
3070,1,6006,2351,3655,0,0,0,1.0,1,1.0,1,1.0,1,0.14080555469525943,50
3071,2,6008,2352,3656,0,0,0,1.0,1,1.0,1,1.0,1,0.12428175162217775,51
3072,2,6010,2352,3658,0,0,0,1.0,1,1.0,1,1.0,1,0.1081171189251484,53
3073,0,6010,2352,3658,0,0,0,1.0,1,1.0,1,1.0,1,0.10958069285529283,51
3074,0,6010,2352,3658,0,0,0,1.0,1,1.0,1,1.0,1,0.11683371823690594,50
3075,1,6011,2352,3659,0,0,0,1.0,1,1.0,1,1.0,1,0.13471110425202568,52
3076,1,6012,2352,3660,0,0,0,1.0,1,1.0,1,1.0,1,0.15859670885675822,53
3077,0,6012,2352,3660,0,0,0,1.0,1,1.0,1,1.0,1,0.14606134953527108,52
3078,1,6013,2352,3661,0,0,0,1.0,1,1.0,1,1.0,1,0.17268921661260636,53
3079,5,6018,2353,3665,0,0,0,1.0,1,1.0,1,1.0,1,0.15584720239106326,53
3080,1,6019,2353,3666,0,0,0,1.0,1,1.0,1,1.0,1,0.1485935390055726,52
3081,3,6022,2354,3668,0,0,0,1.0,1,1.0,1,1.0,1,0.13175034855054357,54
3082,2,6024,2356,3668,0,0,0,1.0,1,1.0,1,1.0,1,0.16175438867914416,54
3083,1,6025,2356,3669,0,0,0,1.0,1,1.0,1,1.0,1,0.1574302959424095,54
3084,2,6027,2357,3670,0,0,0,1.0,1,1.0,1,1.0,1,0.1549250951694633,55
3085,3,6030,2359,3671,0,0,0,1.0,1,1.0,1,1.0,1,0.1912875896307012,55
3086,1,6031,2359,3672,0,0,0,1.0,1,1.0,1,1.0,1,0.16701254352019151,56
3087,0,6031,2359,3672,0,0,0,1.0,1,1.0,1,1.0,1,0.17689928825622875,57
3088,0,6031,2359,3672,0,0,0,1.0,1,1.0,1,1.0,1,0.18962596559814193,56
3089,0,6031,2359,3672,0,0,0,1.0,1,1.0,1,1.0,1,0.19503152345380817,55
3090,1,6032,2359,3673,0,0,0,1.0,1,1.0,1,1.0,1,0.20617066260085518,54
3091,1,6033,2359,3674,0,0,0,1.0,1,1.0,1,1.0,1,0.212585302502357,53
3092,0,6033,2359,3674,0,0,0,1.0,1,1.0,1,1.0,1,0.1847178825793149,56
3093,1,6034,2360,3674,0,0,0,1.0,1,1.0,1,1.0,1,0.18941927669752573,56
3094,5,6039,2360,3679,0,0,0,1.0,1,1.0,1,1.0,1,0.17209696598473084,58
3095,3,6042,2360,3682,0,0,0,1.0,1,1.0,1,1.0,1,0.1319138715330152,59
3096,0,6042,2360,3682,0,0,0,1.0,1,1.0,1,1.0,1,0.1355860920138798,60
3097,1,6043,2360,3683,0,0,0,1.0,1,1.0,1,1.0,1,0.1524106547356168,60
3098,0,6043,2360,3683,0,0,0,1.0,1,1.0,1,1.0,1,0.17378614692997363,58
3099,1,6044,2361,3683,0,0,0,1.0,1,1.0,1,1.0,1,0.1917294245577808,57
3100,1,6045,2361,3684,0,0,0,1.0,1,1.0,1,1.0,1,0.18188783412409268,57
3101,4,6049,2364,3685,0,0,0,1.0,1,1.0,1,1.0,1,0.16794837746902375,58
3102,5,6054,2366,3688,0,0,0,1.0,1,1.0,1,1.0,1,0.18419698921256383,59
3103,2,6056,2367,3689,0,0,0,1.0,1,1.0,1,1.0,1,0.15336610098144152,58
3104,6,6062,2370,3692,0,0,0,1.0,1,1.0,1,1.0,1,0.15347488896352898,58
3105,4,6066,2372,3694,0,0,0,1.0,1,1.0,1,1.0,1,0.1417751760834087,56
3106,5,6071,2374,3697,0,0,0,1.0,1,1.0,1,1.0,1,0.11327211523523587,57
3107,3,6074,2377,3697,0,0,0,1.0,1,1.0,1,1.0,1,0.10782357877835877,55
3108,5,6079,2380,3699,0,0,0,1.0,1,1.0,1,1.0,1,0.1375842373175853,55
3109,6,6085,2382,3703,0,0,0,1.0,1,1.0,1,1.0,1,0.13360433454416965,54
3110,5,6090,2385,3705,0,0,0,1.0,1,1.0,1,1.0,1,0.1467747464518164,54
3111,3,6093,2386,3707,0,0,0,1.0,1,1.0,1,1.0,1,0.14813453831534695,54
3112,6,6099,2389,3710,0,0,0,1.0,1,1.0,1,1.0,1,0.1355387583413132,56
3113,6,6105,2391,3714,0,0,0,1.0,1,1.0,1,1.0,1,0.1294603915883537,55
3114,4,6109,2393,3716,0,0,0,1.0,1,1.0,1,1.0,1,0.1575477515864486,54
3115,3,6112,2393,3719,0,0,0,1.0,1,1.0,1,1.0,1,0.10943456094678441,56
3116,1,6113,2393,3720,0,0,0,1.0,1,1.0,1,1.0,1,0.10628962387791896,56
3117,3,6116,2393,3723,0,0,0,1.0,1,1.0,1,1.0,1,0.11528324875606233,58
3118,4,6120,2394,3726,0,0,0,1.0,1,1.0,1,1.0,1,0.08264370023462855,57
3119,2,6122,2394,3728,0,0,0,1.0,1,1.0,1,1.0,1,0.06338260473238028,57
3120,0,6122,2394,3728,0,0,0,1.0,1,1.0,1,1.0,1,0.06967721659519117,56
3121,0,6122,2394,3728,0,0,0,1.0,1,1.0,1,1.0,1,0.08260428111125262,57
3122,0,6122,2394,3728,0,0,0,1.0,1,1.0,1,1.0,1,0.08260428111125262,57
3123,0,6122,2394,3728,0,0,0,1.0,1,1.0,1,1.0,1,0.08260428111125262,57
3124,1,6123,2394,3729,0,0,0,1.0,1,1.0,1,1.0,1,0.06942172726349582,59
3125,4,6127,2395,3732,0,0,0,1.0,1,1.0,1,1.0,1,0.09500537669910156,61
3126,2,6129,2395,3734,0,0,0,1.0,1,1.0,1,1.0,1,0.0945530169843386,60
3127,4,6133,2395,3738,0,0,0,1.0,1,1.0,1,1.0,1,0.07164399028264856,58
3128,4,6137,2396,3741,0,0,0,1.0,1,1.0,1,1.0,1,0.07828734252336322,58
3129,0,6137,2396,3741,0,0,0,1.0,1,1.0,1,1.0,1,0.07495905092337317,56
3130,2,6139,2396,3743,0,0,0,1.0,1,1.0,1,1.0,1,0.0969891939077925,56
3131,4,6143,2397,3746,0,0,0,1.0,1,1.0,1,1.0,1,0.11263356912479144,55
3132,1,6144,2398,3746,0,0,0,1.0,1,1.0,1,1.0,1,0.1534599332604552,53
3133,3,6147,2398,3749,0,0,0,1.0,1,1.0,1,1.0,1,0.11173344233309127,52
3134,4,6151,2400,3751,0,0,0,1.0,1,1.0,1,1.0,1,0.11099664765588907,52
3135,1,6152,2400,3752,0,0,0,1.0,1,1.0,1,1.0,1,0.11381397114416698,53
3136,5,6157,2400,3757,0,0,0,1.0,1,1.0,1,1.0,1,0.06709525546266185,54
3137,2,6159,2401,3758,0,0,0,1.0,1,1.0,1,1.0,1,0.0834385210496853,55
3138,8,6167,2402,3765,0,0,0,1.0,1,1.0,1,1.0,1,0.08653272690721603,57
3139,3,6170,2404,3766,0,0,0,1.0,1,1.0,1,1.0,1,0.09768554549844816,56
3140,1,6171,2405,3766,0,0,0,1.0,1,1.0,1,1.0,1,0.10289300520872849,56
3141,3,6174,2406,3768,0,0,0,1.0,1,1.0,1,1.0,1,0.11018226526751232,56
3142,0,6174,2406,3768,0,0,0,1.0,1,1.0,1,1.0,1,0.11018226526751232,56
3143,1,6175,2407,3768,0,0,0,1.0,1,1.0,1,1.0,1,0.11052768800777935,56
3144,2,6177,2409,3768,0,0,0,1.0,1,1.0,1,1.0,1,0.09384571513832375,54
3145,3,6180,2410,3770,0,0,0,1.0,1,1.0,1,1.0,1,0.08118508219003415,55
3146,0,6180,2410,3770,0,0,0,1.0,1,1.0,1,1.0,1,0.08555702116114285,53
3147,2,6182,2410,3772,0,0,0,1.0,1,1.0,1,1.0,1,0.08422914350327879,54
3148,2,6184,2411,3773,0,0,0,1.0,1,1.0,1,1.0,1,0.07992049534156236,54
3149,1,6185,2412,3773,0,0,0,1.0,1,1.0,1,1.0,1,0.09713104443327455,53
3150,0,6185,2412,3773,0,0,0,1.0,1,1.0,1,1.0,1,0.09713104443327455,53
3151,2,6187,2412,3775,0,0,0,1.0,1,1.0,1,1.0,1,0.06786774850731778,53
3152,1,6188,2413,3775,0,0,0,1.0,1,1.0,1,1.0,1,0.08945300944227078,54
3153,0,6188,2413,3775,0,0,0,1.0,1,1.0,1,1.0,1,0.11325205508609104,53
3154,6,6194,2414,3780,0,0,0,1.0,1,1.0,1,1.0,1,0.09256859617741543,55
3155,1,6195,2414,3781,0,0,0,1.0,1,1.0,1,1.0,1,0.080084958102597,56
3156,0,6195,2414,3781,0,0,0,1.0,1,1.0,1,1.0,1,0.10319813023278172,56
3157,1,6196,2414,3782,0,0,0,1.0,1,1.0,1,1.0,1,0.07979423820450632,56
3158,1,6197,2414,3783,0,0,0,1.0,1,1.0,1,1.0,1,0.07902934415689804,57
3159,0,6197,2414,3783,0,0,0,1.0,1,1.0,1,1.0,1,0.09594521486830111,56
3160,2,6199,2415,3784,0,0,0,1.0,1,1.0,1,1.0,1,0.11950251234329475,58
3161,2,6201,2416,3785,0,0,0,1.0,1,1.0,1,1.0,1,0.09297429434793199,59
3162,1,6202,2417,3785,0,0,0,1.0,1,1.0,1,1.0,1,0.12433698319553578,59
3163,9,6211,2420,3791,0,0,0,1.0,1,1.0,1,1.0,1,0.11669465095061923,59
3164,0,6211,2420,3791,0,0,0,1.0,1,1.0,1,1.0,1,0.12322691710159238,60
3165,0,6211,2420,3791,0,0,0,1.0,1,1.0,1,1.0,1,0.11296648240720353,58
3166,3,6214,2420,3794,0,0,0,1.0,1,1.0,1,1.0,1,0.07091657651468515,59
3167,4,6218,2423,3795,0,0,0,1.0,1,1.0,1,1.0,1,0.10364780975503414,57
3168,4,6222,2424,3798,0,0,0,1.0,1,1.0,1,1.0,1,0.10965450907427537,58
3169,5,6227,2426,3801,0,0,0,1.0,1,1.0,1,1.0,1,0.09601451659492254,57
3170,0,6227,2426,3801,0,0,0,1.0,1,1.0,1,1.0,1,0.10276277651502616,55
3171,3,6230,2428,3802,0,0,0,1.0,1,1.0,1,1.0,1,0.11703532695147412,56
3172,1,6231,2429,3802,0,0,0,1.0,1,1.0,1,1.0,1,0.14028200974847582,54
3173,3,6234,2430,3804,0,0,0,1.0,1,1.0,1,1.0,1,0.16187512475729568,53
3174,1,6235,2431,3804,0,0,0,1.0,1,1.0,1,1.0,1,0.1321690879426505,53
3175,4,6239,2431,3808,0,0,0,1.0,1,1.0,1,1.0,1,0.09864053946103726,52
3176,3,6242,2434,3808,0,0,0,1.0,1,1.0,1,1.0,1,0.1380190821883933,53
3177,2,6244,2436,3808,0,0,0,1.0,1,1.0,1,1.0,1,0.19680925004921368,52
3178,8,6252,2436,3816,0,0,0,1.0,1,1.0,1,1.0,1,0.08915347075600574,53
3179,1,6253,2436,3817,0,0,0,1.0,1,1.0,1,1.0,1,0.09567035377622504,54
3180,0,6253,2436,3817,0,0,0,1.0,1,1.0,1,1.0,1,0.10915052183543532,54
3181,4,6257,2436,3821,0,0,0,1.0,1,1.0,1,1.0,1,0.07463510337530278,55
3182,0,6257,2436,3821,0,0,0,1.0,1,1.0,1,1.0,1,0.08660362127257705,54
3183,2,6259,2437,3822,0,0,0,1.0,1,1.0,1,1.0,1,0.11391716305872152,56
3184,4,6263,2440,3823,0,0,0,1.0,1,1.0,1,1.0,1,0.13695742036884123,54
3185,0,6263,2440,3823,0,0,0,1.0,1,1.0,1,1.0,1,0.12741955532880905,53
3186,4,6267,2441,3826,0,0,0,1.0,1,1.0,1,1.0,1,0.11963161402179676,52
3187,1,6268,2441,3827,0,0,0,1.0,1,1.0,1,1.0,1,0.0984060328892586,50
3188,1,6269,2442,3827,0,0,0,1.0,1,1.0,1,1.0,1,0.10705205954678279,50
3189,3,6272,2443,3829,0,0,0,1.0,1,1.0,1,1.0,1,0.1421171939609979,49
3190,5,6277,2444,3833,0,0,0,1.0,1,1.0,1,1.0,1,0.14015984375856502,50
3191,2,6279,2446,3833,0,0,0,1.0,1,1.0,1,1.0,1,0.17066401255368152,49
3192,0,6279,2446,3833,0,0,0,1.0,1,1.0,1,1.0,1,0.17066401255368152,49
3193,2,6281,2446,3835,0,0,0,1.0,1,1.0,1,1.0,1,0.1397636010778559,49
3194,5,6286,2449,3837,0,0,0,1.0,1,1.0,1,1.0,1,0.18150416596366248,50
3195,1,6287,2449,3838,0,0,0,1.0,1,1.0,1,1.0,1,0.16887582306557228,49
3196,2,6289,2450,3839,0,0,0,1.0,1,1.0,1,1.0,1,0.1828039690360708,49
3197,2,6291,2450,3841,0,0,0,1.0,1,1.0,1,1.0,1,0.12932921777533352,50
3198,2,6293,2450,3843,0,0,0,1.0,1,1.0,1,1.0,1,0.1304100466029694,50
3199,3,6296,2450,3846,0,0,0,1.0,1,1.0,1,1.0,1,0.07147475138796093,52
3200,0,6296,2450,3846,0,0,0,1.0,1,1.0,1,1.0,1,0.07095358400439525,53
3201,3,6299,2450,3849,0,0,0,1.0,1,1.0,1,1.0,1,0.05850076313168715,55
3202,0,6299,2450,3849,0,0,0,1.0,1,1.0,1,1.0,1,0.05850076313168715,55
3203,0,6299,2450,3849,0,0,0,1.0,1,1.0,1,1.0,1,0.05503943620591241,53
3204,0,6299,2450,3849,0,0,0,1.0,1,1.0,1,1.0,1,0.08070381017880132,53
3205,2,6301,2452,3849,0,0,0,1.0,1,1.0,1,1.0,1,0.10965955413851247,53
3206,1,6302,2452,3850,0,0,0,1.0,1,1.0,1,1.0,1,0.09179090278466435,52
3207,3,6305,2454,3851,0,0,0,1.0,1,1.0,1,1.0,1,0.15325825367876245,53
3208,2,6307,2454,3853,0,0,0,1.0,1,1.0,1,1.0,1,0.16740132457262538,51
3209,2,6309,2454,3855,0,0,0,1.0,1,1.0,1,1.0,1,0.16563051456716477,52
3210,1,6310,2454,3856,0,0,0,1.0,1,1.0,1,1.0,1,0.11472448962584894,49
3211,4,6314,2456,3858,0,0,0,1.0,1,1.0,1,1.0,1,0.16110607289041096,48
3212,2,6316,2458,3858,0,0,0,1.0,1,1.0,1,1.0,1,0.17423738212291792,48
3213,0,6316,2458,3858,0,0,0,1.0,1,1.0,1,1.0,1,0.16985370754104437,49
3214,5,6321,2459,3862,0,0,0,1.0,1,1.0,1,1.0,1,0.11016989683592038,51
3215,0,6321,2459,3862,0,0,0,1.0,1,1.0,1,1.0,1,0.11016989683592038,51
3216,2,6323,2461,3862,0,0,0,1.0,1,1.0,1,1.0,1,0.10806361614899879,51
3217,1,6324,2461,3863,0,0,0,1.0,1,1.0,1,1.0,1,0.09054296488244673,51
3218,0,6324,2461,3863,0,0,0,1.0,1,1.0,1,1.0,1,0.09054296488244673,51
3219,0,6324,2461,3863,0,0,0,1.0,1,1.0,1,1.0,1,0.10036618057149486,52
3220,0,6324,2461,3863,0,0,0,1.0,1,1.0,1,1.0,1,0.10036618057149486,52
3221,2,6326,2461,3865,0,0,0,1.0,1,1.0,1,1.0,1,0.08331011260641524,54
3222,0,6326,2461,3865,0,0,0,1.0,1,1.0,1,1.0,1,0.0758549794074083,54
3223,0,6326,2461,3865,0,0,0,1.0,1,1.0,1,1.0,1,0.09496522029544131,56
3224,1,6327,2462,3865,0,0,0,1.0,1,1.0,1,1.0,1,0.11504257193157141,57
3225,2,6329,2462,3867,0,0,0,1.0,1,1.0,1,1.0,1,0.11883163069375385,58
3226,0,6329,2462,3867,0,0,0,1.0,1,1.0,1,1.0,1,0.11883163069375385,58
3227,0,6329,2462,3867,0,0,0,1.0,1,1.0,1,1.0,1,0.11883163069375385,58
3228,0,6329,2462,3867,0,0,0,1.0,1,1.0,1,1.0,1,0.11883163069375385,58
3229,6,6335,2464,3871,0,0,0,1.0,1,1.0,1,1.0,1,0.14858835220420633,60
3230,0,6335,2464,3871,0,0,0,1.0,1,1.0,1,1.0,1,0.14231531979004006,61
3231,0,6335,2464,3871,0,0,0,1.0,1,1.0,1,1.0,1,0.14231531979004006,61
3232,1,6336,2464,3872,0,0,0,1.0,1,1.0,1,1.0,1,0.13221479549797951,61
3233,0,6336,2464,3872,0,0,0,1.0,1,1.0,1,1.0,1,0.13648210902345898,63
3234,1,6337,2465,3872,0,0,0,1.0,1,1.0,1,1.0,1,0.17883018660841823,64
3235,4,6341,2465,3876,0,0,0,1.0,1,1.0,1,1.0,1,0.1371754977140199,65
3236,1,6342,2465,3877,0,0,0,1.0,1,1.0,1,1.0,1,0.14252819905514863,66
3237,2,6344,2465,3879,0,0,0,1.0,1,1.0,1,1.0,1,0.11767708067941675,67
3238,0,6344,2465,3879,0,0,0,1.0,1,1.0,1,1.0,1,0.11767708067941675,67
3239,0,6344,2465,3879,0,0,0,1.0,1,1.0,1,1.0,1,0.1357181262888312,69
3240,0,6344,2465,3879,0,0,0,1.0,1,1.0,1,1.0,1,0.1357181262888312,69
3241,3,6347,2467,3880,0,0,0,1.0,1,1.0,1,1.0,1,0.13096435525842512,68
3242,1,6348,2468,3880,0,0,0,1.0,1,1.0,1,1.0,1,0.1437548341186062,67
3243,3,6351,2470,3881,0,0,0,1.0,1,1.0,1,1.0,1,0.1311756041094335,68
3244,4,6355,2470,3885,0,0,0,1.0,1,1.0,1,1.0,1,0.08887876259192973,68
3245,1,6356,2470,3886,0,0,0,1.0,1,1.0,1,1.0,1,0.08246158102930339,69
3246,3,6359,2470,3889,0,0,0,1.0,1,1.0,1,1.0,1,0.08558852602959167,68
3247,0,6359,2470,3889,0,0,0,1.0,1,1.0,1,1.0,1,0.08558852602959167,68
3248,1,6360,2471,3889,0,0,0,1.0,1,1.0,1,1.0,1,0.09498259077822199,68
3249,2,6362,2471,3891,0,0,0,1.0,1,1.0,1,1.0,1,0.08884255888629417,69
3250,5,6367,2472,3895,0,0,0,1.0,1,1.0,1,1.0,1,0.06091296542951162,69
3251,2,6369,2473,3896,0,0,0,1.0,1,1.0,1,1.0,1,0.07222095507975725,68
3252,0,6369,2473,3896,0,0,0,1.0,1,1.0,1,1.0,1,0.06277653371690087,68
3253,0,6369,2473,3896,0,0,0,1.0,1,1.0,1,1.0,1,0.07410314083356613,69
3254,0,6369,2473,3896,0,0,0,1.0,1,1.0,1,1.0,1,0.07410314083356613,69
3255,2,6371,2473,3898,0,0,0,1.0,1,1.0,1,1.0,1,0.0783736173794719,70
3256,1,6372,2473,3899,0,0,0,1.0,1,1.0,1,1.0,1,0.06545190195522343,70
3257,0,6372,2473,3899,0,0,0,1.0,1,1.0,1,1.0,1,0.07558581911644605,71
3258,1,6373,2474,3899,0,0,0,1.0,1,1.0,1,1.0,1,0.0850089664942971,72
3259,4,6377,2476,3901,0,0,0,1.0,1,1.0,1,1.0,1,0.09554455719485407,71
3260,1,6378,2477,3901,0,0,0,1.0,1,1.0,1,1.0,1,0.10919927751235217,72
3261,3,6381,2477,3904,0,0,0,1.0,1,1.0,1,1.0,1,0.1121616424969945,74
3262,10,6391,2480,3911,0,0,0,1.0,1,1.0,1,1.0,1,0.08215022157083006,73
3263,3,6394,2482,3912,0,0,0,1.0,1,1.0,1,1.0,1,0.07779723491050633,73
3264,2,6396,2484,3912,0,0,0,1.0,1,1.0,1,1.0,1,0.11790394279281644,71
3265,1,6397,2484,3913,0,0,0,1.0,1,1.0,1,1.0,1,0.10757276263686827,70
3266,1,6398,2485,3913,0,0,0,1.0,1,1.0,1,1.0,1,0.1250839238510654,69
3267,1,6399,2486,3913,0,0,0,1.0,1,1.0,1,1.0,1,0.14664343798277493,69
3268,4,6403,2487,3916,0,0,0,1.0,1,1.0,1,1.0,1,0.15086662701709366,68
3269,3,6406,2488,3918,0,0,0,1.0,1,1.0,1,1.0,1,0.15144841232702694,68
3270,0,6406,2488,3918,0,0,0,1.0,1,1.0,1,1.0,1,0.1624353773093211,67
3271,2,6408,2488,3920,0,0,0,1.0,1,1.0,1,1.0,1,0.1445445016780054,66
3272,1,6409,2488,3921,0,0,0,1.0,1,1.0,1,1.0,1,0.12895526191436055,67
3273,2,6411,2488,3923,0,0,0,1.0,1,1.0,1,1.0,1,0.11945232863213547,66
3274,4,6415,2489,3926,0,0,0,1.0,1,1.0,1,1.0,1,0.10968969666395499,68
3275,0,6415,2489,3926,0,0,0,1.0,1,1.0,1,1.0,1,0.10968969666395499,68
3276,1,6416,2489,3927,0,0,0,1.0,1,1.0,1,1.0,1,0.10254962658376757,69
3277,4,6420,2490,3930,0,0,0,1.0,1,1.0,1,1.0,1,0.08938961877302247,68
3278,1,6421,2490,3931,0,0,0,1.0,1,1.0,1,1.0,1,0.09357763639800258,69
3279,1,6422,2491,3931,0,0,0,1.0,1,1.0,1,1.0,1,0.09692922086030659,67
3280,4,6426,2493,3933,0,0,0,1.0,1,1.0,1,1.0,1,0.10754502599184185,66
3281,2,6428,2495,3933,0,0,0,1.0,1,1.0,1,1.0,1,0.15672131184379273,67
3282,2,6430,2495,3935,0,0,0,1.0,1,1.0,1,1.0,1,0.16344460513961628,66
3283,5,6435,2497,3938,0,0,0,1.0,1,1.0,1,1.0,1,0.1848888623972896,67
3284,2,6437,2497,3940,0,0,0,1.0,1,1.0,1,1.0,1,0.13820066162840122,66
3285,1,6438,2497,3941,0,0,0,1.0,1,1.0,1,1.0,1,0.14094684048596381,66
3286,5,6443,2497,3946,0,0,0,1.0,1,1.0,1,1.0,1,0.1067182834649918,63
3287,3,6446,2499,3947,0,0,0,1.0,1,1.0,1,1.0,1,0.15553707981021792,61
3288,0,6446,2499,3947,0,0,0,1.0,1,1.0,1,1.0,1,0.1604093688625186,63
3289,5,6451,2500,3951,0,0,0,1.0,1,1.0,1,1.0,1,0.1589853345568832,62
3290,0,6451,2500,3951,0,0,0,1.0,1,1.0,1,1.0,1,0.15116519338699305,63
3291,4,6455,2502,3953,0,0,0,1.0,1,1.0,1,1.0,1,0.17024710100751403,62
3292,3,6458,2502,3956,0,0,0,1.0,1,1.0,1,1.0,1,0.15619254621630752,63
3293,0,6458,2502,3956,0,0,0,1.0,1,1.0,1,1.0,1,0.17991008561271682,65
3294,0,6458,2502,3956,0,0,0,1.0,1,1.0,1,1.0,1,0.17991008561271682,65
3295,3,6461,2503,3958,0,0,0,1.0,1,1.0,1,1.0,1,0.15109932938238274,65
3296,0,6461,2503,3958,0,0,0,1.0,1,1.0,1,1.0,1,0.15109932938238274,65
3297,1,6462,2503,3959,0,0,0,1.0,1,1.0,1,1.0,1,0.1369140735602533,66
3298,2,6464,2503,3961,0,0,0,1.0,1,1.0,1,1.0,1,0.12404560471643138,66
3299,0,6464,2503,3961,0,0,0,1.0,1,1.0,1,1.0,1,0.1317488200675598,67
3300,5,6469,2506,3963,0,0,0,1.0,1,1.0,1,1.0,1,0.18434548145822333,67
3301,6,6475,2508,3967,0,0,0,1.0,1,1.0,1,1.0,1,0.19685801747085968,68
3302,3,6478,2508,3970,0,0,0,1.0,1,1.0,1,1.0,1,0.19500862687447784,67
3303,3,6481,2509,3972,0,0,0,1.0,1,1.0,1,1.0,1,0.199763361860136,67
3304,4,6485,2509,3976,0,0,0,1.0,1,1.0,1,1.0,1,0.16524057270011805,67
3305,4,6489,2509,3980,0,0,0,1.0,1,1.0,1,1.0,1,0.14686960131554813,69
3306,1,6490,2509,3981,0,0,0,1.0,1,1.0,1,1.0,1,0.13658581408483553,70
3307,0,6490,2509,3981,0,0,0,1.0,1,1.0,1,1.0,1,0.13658581408483553,70
3308,0,6490,2509,3981,0,0,0,1.0,1,1.0,1,1.0,1,0.13658581408483553,70
3309,4,6494,2509,3985,0,0,0,1.0,1,1.0,1,1.0,1,0.12459605683200281,72
3310,3,6497,2509,3988,0,0,0,1.0,1,1.0,1,1.0,1,0.11553328588053362,74
3311,0,6497,2509,3988,0,0,0,1.0,1,1.0,1,1.0,1,0.11553328588053362,74
3312,0,6497,2509,3988,0,0,0,1.0,1,1.0,1,1.0,1,0.11553328588053362,74
3313,2,6499,2509,3990,0,0,0,1.0,1,1.0,1,1.0,1,0.1105627696693596,75
3314,2,6501,2509,3992,0,0,0,1.0,1,1.0,1,1.0,1,0.11979308033910448,76
3315,2,6503,2510,3993,0,0,0,1.0,1,1.0,1,1.0,1,0.15353186833862648,75
3316,4,6507,2511,3996,0,0,0,1.0,1,1.0,1,1.0,1,0.1305055611597875,76
3317,1,6508,2511,3997,0,0,0,1.0,1,1.0,1,1.0,1,0.12971568927546742,73
3318,4,6512,2514,3998,0,0,0,1.0,1,1.0,1,1.0,1,0.16120759049631628,72
3319,5,6517,2515,4002,0,0,0,1.0,1,1.0,1,1.0,1,0.1613372188431156,71
3320,1,6518,2515,4003,0,0,0,1.0,1,1.0,1,1.0,1,0.15120122633500885,70
3321,2,6520,2516,4004,0,0,0,1.0,1,1.0,1,1.0,1,0.16187746635968306,69
3322,2,6522,2517,4005,0,0,0,1.0,1,1.0,1,1.0,1,0.1525555827890193,68
3323,0,6522,2517,4005,0,0,0,1.0,1,1.0,1,1.0,1,0.15938454217806006,69
3324,1,6523,2518,4005,0,0,0,1.0,1,1.0,1,1.0,1,0.1670274015081817,69
3325,3,6526,2518,4008,0,0,0,1.0,1,1.0,1,1.0,1,0.15742891319377317,70
3326,3,6529,2520,4009,0,0,0,1.0,1,1.0,1,1.0,1,0.1702381919218944,69
3327,2,6531,2521,4010,0,0,0,1.0,1,1.0,1,1.0,1,0.16100211138925494,70
3328,4,6535,2521,4014,0,0,0,1.0,1,1.0,1,1.0,1,0.1358024045480351,73
3329,1,6536,2522,4014,0,0,0,1.0,1,1.0,1,1.0,1,0.1810334611462248,72
3330,2,6538,2523,4015,0,0,0,1.0,1,1.0,1,1.0,1,0.18972197654184142,72
3331,3,6541,2524,4017,0,0,0,1.0,1,1.0,1,1.0,1,0.1673887957597018,72
3332,1,6542,2524,4018,0,0,0,1.0,1,1.0,1,1.0,1,0.16525181154243054,73
3333,0,6542,2524,4018,0,0,0,1.0,1,1.0,1,1.0,1,0.16736683828016294,72
3334,5,6547,2525,4022,0,0,0,1.0,1,1.0,1,1.0,1,0.15505585437917518,73
3335,4,6551,2526,4025,0,0,0,1.0,1,1.0,1,1.0,1,0.15550057039555754,74
3336,3,6554,2526,4028,0,0,0,1.0,1,1.0,1,1.0,1,0.14929836467739607,74
3337,2,6556,2526,4030,0,0,0,1.0,1,1.0,1,1.0,1,0.13446142316722648,74
3338,1,6557,2526,4031,0,0,0,1.0,1,1.0,1,1.0,1,0.13065972132248688,74
3339,1,6558,2527,4031,0,0,0,1.0,1,1.0,1,1.0,1,0.1515548203809925,75
3340,5,6563,2527,4036,0,0,0,1.0,1,1.0,1,1.0,1,0.1334280052869259,75
3341,0,6563,2527,4036,0,0,0,1.0,1,1.0,1,1.0,1,0.1430689500164413,76
3342,0,6563,2527,4036,0,0,0,1.0,1,1.0,1,1.0,1,0.1626452201676219,76
3343,3,6566,2528,4038,0,0,0,1.0,1,1.0,1,1.0,1,0.1445108865094669,75
3344,5,6571,2530,4041,0,0,0,1.0,1,1.0,1,1.0,1,0.14467328977197552,75
3345,1,6572,2531,4041,0,0,0,1.0,1,1.0,1,1.0,1,0.168966660636806,72
3346,2,6574,2532,4042,0,0,0,1.0,1,1.0,1,1.0,1,0.1652393526849977,73
3347,1,6575,2533,4042,0,0,0,1.0,1,1.0,1,1.0,1,0.15191297548902855,73
3348,2,6577,2533,4044,0,0,0,1.0,1,1.0,1,1.0,1,0.1470987095932965,73
3349,3,6580,2533,4047,0,0,0,1.0,1,1.0,1,1.0,1,0.14056485250837553,74
3350,6,6586,2536,4050,0,0,0,1.0,1,1.0,1,1.0,1,0.17065611969549613,73
3351,1,6587,2537,4050,0,0,0,1.0,1,1.0,1,1.0,1,0.1781077226155348,72
3352,4,6591,2537,4054,0,0,0,1.0,1,1.0,1,1.0,1,0.15788583211842427,72
3353,2,6593,2539,4054,0,0,0,1.0,1,1.0,1,1.0,1,0.18496839386763633,72
3354,3,6596,2540,4056,0,0,0,1.0,1,1.0,1,1.0,1,0.19345959730419154,70
3355,5,6601,2540,4061,0,0,0,1.0,1,1.0,1,1.0,1,0.15035688147358667,69
3356,4,6605,2542,4063,0,0,0,1.0,1,1.0,1,1.0,1,0.17397336437117422,69
3357,1,6606,2542,4064,0,0,0,1.0,1,1.0,1,1.0,1,0.17694479708457492,68
3358,4,6610,2544,4066,0,0,0,1.0,1,1.0,1,1.0,1,0.19534263828078746,68
3359,2,6612,2544,4068,0,0,0,1.0,1,1.0,1,1.0,1,0.18905280702320998,66
3360,2,6614,2545,4069,0,0,0,1.0,1,1.0,1,1.0,1,0.20234891664153196,65
3361,3,6617,2545,4072,0,0,0,1.0,1,1.0,1,1.0,1,0.19814743184444927,64
3362,2,6619,2545,4074,0,0,0,1.0,1,1.0,1,1.0,1,0.18105288915859102,64
3363,0,6619,2545,4074,0,0,0,1.0,1,1.0,1,1.0,1,0.17203249148861274,65
3364,1,6620,2545,4075,0,0,0,1.0,1,1.0,1,1.0,1,0.16773726929781355,66
3365,1,6621,2545,4076,0,0,0,1.0,1,1.0,1,1.0,1,0.1659244101131524,68
3366,1,6622,2545,4077,0,0,0,1.0,1,1.0,1,1.0,1,0.164076346395827,66
3367,3,6625,2545,4080,0,0,0,1.0,1,1.0,1,1.0,1,0.14109623955252898,68
3368,5,6630,2546,4084,0,0,0,1.0,1,1.0,1,1.0,1,0.11713668182363005,68
3369,3,6633,2546,4087,0,0,0,1.0,1,1.0,1,1.0,1,0.12672591178496803,69
3370,3,6636,2546,4090,0,0,0,1.0,1,1.0,1,1.0,1,0.09563274367229613,71
3371,1,6637,2546,4091,0,0,0,1.0,1,1.0,1,1.0,1,0.08850883047194265,71
3372,1,6638,2547,4091,0,0,0,1.0,1,1.0,1,1.0,1,0.09897300065333799,71
3373,1,6639,2547,4092,0,0,0,1.0,1,1.0,1,1.0,1,0.09268324490562879,72
3374,0,6639,2547,4092,0,0,0,1.0,1,1.0,1,1.0,1,0.08883141611490356,72
3375,2,6641,2548,4093,0,0,0,1.0,1,1.0,1,1.0,1,0.08712946678932282,73
3376,1,6642,2548,4094,0,0,0,1.0,1,1.0,1,1.0,1,0.0721314240434243,75
3377,1,6643,2549,4094,0,0,0,1.0,1,1.0,1,1.0,1,0.09801160127528263,77
3378,0,6643,2549,4094,0,0,0,1.0,1,1.0,1,1.0,1,0.09801160127528263,77
3379,3,6646,2551,4095,0,0,0,1.0,1,1.0,1,1.0,1,0.11686822934786947,77
3380,1,6647,2552,4095,0,0,0,1.0,1,1.0,1,1.0,1,0.12540106835251752,76
3381,1,6648,2553,4095,0,0,0,1.0,1,1.0,1,1.0,1,0.13315708111220478,76
3382,6,6654,2555,4099,0,0,0,1.0,1,1.0,1,1.0,1,0.10731312791940992,78
3383,1,6655,2555,4100,0,0,0,1.0,1,1.0,1,1.0,1,0.0814217208586469,77
3384,3,6658,2558,4100,0,0,0,1.0,1,1.0,1,1.0,1,0.11740711669458727,77
3385,3,6661,2560,4101,0,0,0,1.0,1,1.0,1,1.0,1,0.10319557034466703,75
3386,3,6664,2562,4102,0,0,0,1.0,1,1.0,1,1.0,1,0.12603255847651978,76
3387,2,6666,2562,4104,0,0,0,1.0,1,1.0,1,1.0,1,0.12334349882822229,75
3388,6,6672,2564,4108,0,0,0,1.0,1,1.0,1,1.0,1,0.12173248115298646,76
3389,0,6672,2564,4108,0,0,0,1.0,1,1.0,1,1.0,1,0.11882180379990058,77
3390,0,6672,2564,4108,0,0,0,1.0,1,1.0,1,1.0,1,0.10856443273724262,76
3391,2,6674,2565,4109,0,0,0,1.0,1,1.0,1,1.0,1,0.10706563625619278,77
3392,2,6676,2566,4110,0,0,0,1.0,1,1.0,1,1.0,1,0.11518800171252053,78
3393,0,6676,2566,4110,0,0,0,1.0,1,1.0,1,1.0,1,0.10716201997838609,76
3394,2,6678,2566,4112,0,0,0,1.0,1,1.0,1,1.0,1,0.10739000850216757,75
3395,2,6680,2566,4114,0,0,0,1.0,1,1.0,1,1.0,1,0.06386823395706842,73
3396,0,6680,2566,4114,0,0,0,1.0,1,1.0,1,1.0,1,0.06386823395706842,73
3397,0,6680,2566,4114,0,0,0,1.0,1,1.0,1,1.0,1,0.06489371556868823,74
3398,0,6680,2566,4114,0,0,0,1.0,1,1.0,1,1.0,1,0.06489371556868823,74
3399,2,6682,2568,4114,0,0,0,1.0,1,1.0,1,1.0,1,0.09439043192461895,75
3400,5,6687,2569,4118,0,0,0,1.0,1,1.0,1,1.0,1,0.06517306516422675,75
3401,2,6689,2569,4120,0,0,0,1.0,1,1.0,1,1.0,1,0.03657353390254362,77
3402,1,6690,2570,4120,0,0,0,1.0,1,1.0,1,1.0,1,0.05364081144793527,77
3403,3,6693,2571,4122,0,0,0,1.0,1,1.0,1,1.0,1,0.06174626711495187,78
3404,1,6694,2572,4122,0,0,0,1.0,1,1.0,1,1.0,1,0.09004550387341509,78
3405,1,6695,2572,4123,0,0,0,1.0,1,1.0,1,1.0,1,0.087262475347163,78
3406,2,6697,2573,4124,0,0,0,1.0,1,1.0,1,1.0,1,0.08083169009554118,78
3407,2,6699,2574,4125,0,0,0,1.0,1,1.0,1,1.0,1,0.10219245070079412,78
3408,0,6699,2574,4125,0,0,0,1.0,1,1.0,1,1.0,1,0.10680861916025652,79
3409,3,6702,2574,4128,0,0,0,1.0,1,1.0,1,1.0,1,0.08222720201536773,81
3410,2,6704,2574,4130,0,0,0,1.0,1,1.0,1,1.0,1,0.07838983043930389,82
3411,3,6707,2576,4131,0,0,0,1.0,1,1.0,1,1.0,1,0.09661011483854823,84
3412,3,6710,2576,4134,0,0,0,1.0,1,1.0,1,1.0,1,0.08245157971973942,84
3413,0,6710,2576,4134,0,0,0,1.0,1,1.0,1,1.0,1,0.08245157971973942,84
3414,1,6711,2577,4134,0,0,0,1.0,1,1.0,1,1.0,1,0.08516920000439583,84
3415,3,6714,2578,4136,0,0,0,1.0,1,1.0,1,1.0,1,0.07903161244113692,85
3416,3,6717,2579,4138,0,0,0,1.0,1,1.0,1,1.0,1,0.06608664615665581,85
3417,1,6718,2580,4138,0,0,0,1.0,1,1.0,1,1.0,1,0.07512488703924841,86
3418,3,6721,2583,4138,0,0,0,1.0,1,1.0,1,1.0,1,0.12427723218699285,86
3419,6,6727,2585,4142,0,0,0,1.0,1,1.0,1,1.0,1,0.14788623930361056,87
3420,2,6729,2585,4144,0,0,0,1.0,1,1.0,1,1.0,1,0.14098192236815743,88
3421,3,6732,2585,4147,0,0,0,1.0,1,1.0,1,1.0,1,0.12627349529399068,89
3422,2,6734,2585,4149,0,0,0,1.0,1,1.0,1,1.0,1,0.12561083459374692,90
3423,0,6734,2585,4149,0,0,0,1.0,1,1.0,1,1.0,1,0.12565129939697467,90
3424,4,6738,2585,4153,0,0,0,1.0,1,1.0,1,1.0,1,0.10415118996882397,91
3425,2,6740,2586,4154,0,0,0,1.0,1,1.0,1,1.0,1,0.0937561976322231,90
3426,3,6743,2587,4156,0,0,0,1.0,1,1.0,1,1.0,1,0.07984655589212974,92
3427,2,6745,2587,4158,0,0,0,1.0,1,1.0,1,1.0,1,0.08564440558131912,92
3428,0,6745,2587,4158,0,0,0,1.0,1,1.0,1,1.0,1,0.09262571217432386,91
3429,0,6745,2587,4158,0,0,0,1.0,1,1.0,1,1.0,1,0.09262571217432386,91
3430,3,6748,2589,4159,0,0,0,1.0,1,1.0,1,1.0,1,0.11786898154913132,91
3431,0,6748,2589,4159,0,0,0,1.0,1,1.0,1,1.0,1,0.10749949239931832,90
3432,4,6752,2591,4161,0,0,0,1.0,1,1.0,1,1.0,1,0.12712308495474595,91
3433,7,6759,2591,4168,0,0,0,1.0,1,1.0,1,1.0,1,0.12471421686584391,90
3434,1,6760,2591,4169,0,0,0,1.0,1,1.0,1,1.0,1,0.1204943827064859,89
3435,0,6760,2591,4169,0,0,0,1.0,1,1.0,1,1.0,1,0.11626358001493828,88
3436,4,6764,2592,4172,0,0,0,1.0,1,1.0,1,1.0,1,0.11151365411106226,86
3437,3,6767,2594,4173,0,0,0,1.0,1,1.0,1,1.0,1,0.12548875532043502,86
3438,1,6768,2594,4174,0,0,0,1.0,1,1.0,1,1.0,1,0.11005676332490982,87
3439,5,6773,2595,4178,0,0,0,1.0,1,1.0,1,1.0,1,0.1108594767161315,86
3440,0,6773,2595,4178,0,0,0,1.0,1,1.0,1,1.0,1,0.1281719323942065,86
3441,0,6773,2595,4178,0,0,0,1.0,1,1.0,1,1.0,1,0.11922684565909471,85
3442,3,6776,2595,4181,0,0,0,1.0,1,1.0,1,1.0,1,0.09515411865986532,85
3443,1,6777,2595,4182,0,0,0,1.0,1,1.0,1,1.0,1,0.09806670982105843,85
3444,2,6779,2597,4182,0,0,0,1.0,1,1.0,1,1.0,1,0.10518911256775232,85
3445,4,6783,2598,4185,0,0,0,1.0,1,1.0,1,1.0,1,0.1217461111604617,84
3446,6,6789,2601,4188,0,0,0,1.0,1,1.0,1,1.0,1,0.1643262913344285,85
3447,3,6792,2602,4190,0,0,0,1.0,1,1.0,1,1.0,1,0.1505317353345884,85
3448,3,6795,2602,4193,0,0,0,1.0,1,1.0,1,1.0,1,0.14257291447736092,85
3449,2,6797,2603,4194,0,0,0,1.0,1,1.0,1,1.0,1,0.16398081117064212,84
3450,0,6797,2603,4194,0,0,0,1.0,1,1.0,1,1.0,1,0.16398081117064212,84
3451,4,6801,2603,4198,0,0,0,1.0,1,1.0,1,1.0,1,0.14598971537718922,85
3452,1,6802,2603,4199,0,0,0,1.0,1,1.0,1,1.0,1,0.13847103905802313,86
3453,2,6804,2604,4200,0,0,0,1.0,1,1.0,1,1.0,1,0.12568380736528983,85
3454,4,6808,2604,4204,0,0,0,1.0,1,1.0,1,1.0,1,0.10146676466820534,88
3455,0,6808,2604,4204,0,0,0,1.0,1,1.0,1,1.0,1,0.10146676466820534,88
3456,1,6809,2605,4204,0,0,0,1.0,1,1.0,1,1.0,1,0.10254313790907114,88
3457,1,6810,2605,4205,0,0,0,1.0,1,1.0,1,1.0,1,0.09806813350596406,89
3458,1,6811,2605,4206,0,0,0,1.0,1,1.0,1,1.0,1,0.10447073342660619,88
3459,0,6811,2605,4206,0,0,0,1.0,1,1.0,1,1.0,1,0.10447073342660619,88
3460,0,6811,2605,4206,0,0,0,1.0,1,1.0,1,1.0,1,0.09823274952568403,89
3461,0,6811,2605,4206,0,0,0,1.0,1,1.0,1,1.0,1,0.09823274952568403,89
3462,2,6813,2605,4208,0,0,0,1.0,1,1.0,1,1.0,1,0.09447541369505877,90
3463,1,6814,2605,4209,0,0,0,1.0,1,1.0,1,1.0,1,0.09380601273283218,89
3464,0,6814,2605,4209,0,0,0,1.0,1,1.0,1,1.0,1,0.09885691269952379,88
3465,1,6815,2605,4210,0,0,0,1.0,1,1.0,1,1.0,1,0.1148627254198743,87
3466,4,6819,2605,4214,0,0,0,1.0,1,1.0,1,1.0,1,0.08900216773355761,87
3467,1,6820,2606,4214,0,0,0,1.0,1,1.0,1,1.0,1,0.10194056758692234,87
3468,4,6824,2608,4216,0,0,0,1.0,1,1.0,1,1.0,1,0.12269116077481067,88
3469,5,6829,2609,4220,0,0,0,1.0,1,1.0,1,1.0,1,0.12110702286761917,85
3470,5,6834,2610,4224,0,0,0,1.0,1,1.0,1,1.0,1,0.11311361028251019,86
3471,4,6838,2612,4226,0,0,0,1.0,1,1.0,1,1.0,1,0.138449483036832,84
3472,5,6843,2613,4230,0,0,0,1.0,1,1.0,1,1.0,1,0.12150197239289674,83
3473,1,6844,2614,4230,0,0,0,1.0,1,1.0,1,1.0,1,0.14229168232854036,81
3474,2,6846,2614,4232,0,0,0,1.0,1,1.0,1,1.0,1,0.11653669373538739,80
3475,4,6850,2615,4235,0,0,0,1.0,1,1.0,1,1.0,1,0.13355471212129547,82
3476,2,6852,2616,4236,0,0,0,1.0,1,1.0,1,1.0,1,0.10880569023388215,81
3477,6,6858,2617,4241,0,0,0,1.0,1,1.0,1,1.0,1,0.12637538152911065,83
3478,3,6861,2618,4243,0,0,0,1.0,1,1.0,1,1.0,1,0.12750593778657435,83
3479,1,6862,2618,4244,0,0,0,1.0,1,1.0,1,1.0,1,0.12128723909101859,83
3480,1,6863,2619,4244,0,0,0,1.0,1,1.0,1,1.0,1,0.11793671984768406,83
3481,5,6868,2621,4247,0,0,0,1.0,1,1.0,1,1.0,1,0.10335951813188604,83
3482,4,6872,2624,4248,0,0,0,1.0,1,1.0,1,1.0,1,0.1285347019168911,83
3483,3,6875,2626,4249,0,0,0,1.0,1,1.0,1,1.0,1,0.13590812839704092,82
3484,4,6879,2627,4252,0,0,0,1.0,1,1.0,1,1.0,1,0.12797269803356484,82
3485,1,6880,2628,4252,0,0,0,1.0,1,1.0,1,1.0,1,0.1486689294086671,83
3486,0,6880,2628,4252,0,0,0,1.0,1,1.0,1,1.0,1,0.1486689294086671,83
3487,3,6883,2628,4255,0,0,0,1.0,1,1.0,1,1.0,1,0.1320785568987938,84
3488,0,6883,2628,4255,0,0,0,1.0,1,1.0,1,1.0,1,0.14386951322466293,84
3489,2,6885,2628,4257,0,0,0,1.0,1,1.0,1,1.0,1,0.12080129249066178,84
3490,1,6886,2628,4258,0,0,0,1.0,1,1.0,1,1.0,1,0.11263359439919012,84
3491,2,6888,2628,4260,0,0,0,1.0,1,1.0,1,1.0,1,0.11837250073735421,86
3492,1,6889,2629,4260,0,0,0,1.0,1,1.0,1,1.0,1,0.11001196795226281,86
3493,2,6891,2629,4262,0,0,0,1.0,1,1.0,1,1.0,1,0.10050170869152661,86
3494,2,6893,2629,4264,0,0,0,1.0,1,1.0,1,1.0,1,0.0907111503535955,86
3495,0,6893,2629,4264,0,0,0,1.0,1,1.0,1,1.0,1,0.08932663940733064,87
3496,1,6894,2629,4265,0,0,0,1.0,1,1.0,1,1.0,1,0.08882480225159255,88
3497,2,6896,2630,4266,0,0,0,1.0,1,1.0,1,1.0,1,0.10956883852743779,89
3498,1,6897,2630,4267,0,0,0,1.0,1,1.0,1,1.0,1,0.12292685758947929,89
3499,6,6903,2630,4273,0,0,0,1.0,1,1.0,1,1.0,1,0.108357253898511,91
3500,2,6905,2630,4275,0,0,0,1.0,1,1.0,1,1.0,1,0.10452692999374592,90
3501,0,6905,2630,4275,0,0,0,1.0,1,1.0,1,1.0,1,0.10452692999374592,90
3502,3,6908,2630,4278,0,0,0,1.0,1,1.0,1,1.0,1,0.08974591758387941,91
3503,2,6910,2630,4280,0,0,0,1.0,1,1.0,1,1.0,1,0.10369550439522128,91
3504,4,6914,2632,4282,0,0,0,1.0,1,1.0,1,1.0,1,0.13339320378916195,89
3505,5,6919,2633,4286,0,0,0,1.0,1,1.0,1,1.0,1,0.11371755812635095,87
3506,3,6922,2635,4287,0,0,0,1.0,1,1.0,1,1.0,1,0.12847005954138765,87
3507,4,6926,2637,4289,0,0,0,1.0,1,1.0,1,1.0,1,0.11511502706408779,84
3508,7,6933,2641,4292,0,0,0,1.0,1,1.0,1,1.0,1,0.1514576948596769,83
3509,4,6937,2642,4295,0,0,0,1.0,1,1.0,1,1.0,1,0.13431059151946217,80
3510,0,6937,2642,4295,0,0,0,1.0,1,1.0,1,1.0,1,0.1403422841728051,78
3511,3,6940,2643,4297,0,0,0,1.0,1,1.0,1,1.0,1,0.1387112994907503,77
3512,0,6940,2643,4297,0,0,0,1.0,1,1.0,1,1.0,1,0.15059454503611316,74
3513,3,6943,2643,4300,0,0,0,1.0,1,1.0,1,1.0,1,0.13205143020477142,76
3514,2,6945,2643,4302,0,0,0,1.0,1,1.0,1,1.0,1,0.12020175582198918,76
3515,4,6949,2645,4304,0,0,0,1.0,1,1.0,1,1.0,1,0.13180460057511947,75
3516,1,6950,2645,4305,0,0,0,1.0,1,1.0,1,1.0,1,0.11895916494471119,73
3517,2,6952,2647,4305,0,0,0,1.0,1,1.0,1,1.0,1,0.15526380169173992,74
3518,0,6952,2647,4305,0,0,0,1.0,1,1.0,1,1.0,1,0.17330634394102978,74
3519,0,6952,2647,4305,0,0,0,1.0,1,1.0,1,1.0,1,0.18590114369272034,73
3520,5,6957,2647,4310,0,0,0,1.0,1,1.0,1,1.0,1,0.12797415420588878,74
3521,4,6961,2647,4314,0,0,0,1.0,1,1.0,1,1.0,1,0.1164730069231852,75
3522,1,6962,2647,4315,0,0,0,1.0,1,1.0,1,1.0,1,0.11038880571542,75
3523,3,6965,2647,4318,0,0,0,1.0,1,1.0,1,1.0,1,0.10075772527640114,75
3524,1,6966,2647,4319,0,0,0,1.0,1,1.0,1,1.0,1,0.07812616412052192,75
3525,0,6966,2647,4319,0,0,0,1.0,1,1.0,1,1.0,1,0.08690632853016104,75
3526,1,6967,2647,4320,0,0,0,1.0,1,1.0,1,1.0,1,0.07787510031350739,76
3527,2,6969,2649,4320,0,0,0,1.0,1,1.0,1,1.0,1,0.13115434290047118,77
3528,2,6971,2649,4322,0,0,0,1.0,1,1.0,1,1.0,1,0.13153025600954063,77
3529,4,6975,2650,4325,0,0,0,1.0,1,1.0,1,1.0,1,0.12946766306298035,78
3530,0,6975,2650,4325,0,0,0,1.0,1,1.0,1,1.0,1,0.15544829724115902,78
3531,2,6977,2651,4326,0,0,0,1.0,1,1.0,1,1.0,1,0.15369979430002056,79
3532,6,6983,2652,4331,0,0,0,1.0,1,1.0,1,1.0,1,0.14056751708383713,79
3533,2,6985,2654,4331,0,0,0,1.0,1,1.0,1,1.0,1,0.17722890829351756,79
3534,12,6997,2657,4340,0,0,0,1.0,1,1.0,1,1.0,1,0.18849032571267152,80
3535,6,7003,2657,4346,0,0,0,1.0,1,1.0,1,1.0,1,0.15725277758417827,81
3536,1,7004,2657,4347,0,0,0,1.0,1,1.0,1,1.0,1,0.15216928987050246,82
3537,0,7004,2657,4347,0,0,0,1.0,1,1.0,1,1.0,1,0.15216928987050246,82
3538,4,7008,2657,4351,0,0,0,1.0,1,1.0,1,1.0,1,0.12903904094821708,83
3539,0,7008,2657,4351,0,0,0,1.0,1,1.0,1,1.0,1,0.12903904094821708,83
3540,4,7012,2658,4354,0,0,0,1.0,1,1.0,1,1.0,1,0.12383196920097894,85
3541,1,7013,2658,4355,0,0,0,1.0,1,1.0,1,1.0,1,0.10783573021650326,85
3542,3,7016,2658,4358,0,0,0,1.0,1,1.0,1,1.0,1,0.09729223925623978,88
3543,0,7016,2658,4358,0,0,0,1.0,1,1.0,1,1.0,1,0.09334978757889985,87
3544,3,7019,2658,4361,0,0,0,1.0,1,1.0,1,1.0,1,0.07845057266173064,87
3545,1,7020,2659,4361,0,0,0,1.0,1,1.0,1,1.0,1,0.08487983537103726,85
3546,1,7021,2660,4361,0,0,0,1.0,1,1.0,1,1.0,1,0.07713941162921434,83
3547,3,7024,2660,4364,0,0,0,1.0,1,1.0,1,1.0,1,0.05690311558189802,82
3548,1,7025,2661,4364,0,0,0,1.0,1,1.0,1,1.0,1,0.05968812336707073,82
3549,0,7025,2661,4364,0,0,0,1.0,1,1.0,1,1.0,1,0.05398403221154787,81
3550,0,7025,2661,4364,0,0,0,1.0,1,1.0,1,1.0,1,0.06885370859775285,79
3551,0,7025,2661,4364,0,0,0,1.0,1,1.0,1,1.0,1,0.07314857854042663,80
3552,1,7026,2662,4364,0,0,0,1.0,1,1.0,1,1.0,1,0.08751520020363517,78
3553,3,7029,2662,4367,0,0,0,1.0,1,1.0,1,1.0,1,0.07444157406041936,79
3554,1,7030,2663,4367,0,0,0,1.0,1,1.0,1,1.0,1,0.08955558785685684,77
3555,1,7031,2664,4367,0,0,0,1.0,1,1.0,1,1.0,1,0.10662482669744042,77
3556,3,7034,2664,4370,0,0,0,1.0,1,1.0,1,1.0,1,0.09787786833828045,76
3557,1,7035,2664,4371,0,0,0,1.0,1,1.0,1,1.0,1,0.08621077160035674,76
3558,1,7036,2665,4371,0,0,0,1.0,1,1.0,1,1.0,1,0.11173681678646809,76
3559,5,7041,2665,4376,0,0,0,1.0,1,1.0,1,1.0,1,0.07409751135258462,76
3560,3,7044,2666,4378,0,0,0,1.0,1,1.0,1,1.0,1,0.08044807792560761,78
3561,3,7047,2667,4380,0,0,0,1.0,1,1.0,1,1.0,1,0.09690384425948505,79
3562,3,7050,2668,4382,0,0,0,1.0,1,1.0,1,1.0,1,0.11081271591106756,79
3563,1,7051,2669,4382,0,0,0,1.0,1,1.0,1,1.0,1,0.11437366899755091,79
3564,7,7058,2671,4387,0,0,0,1.0,1,1.0,1,1.0,1,0.1302557689118239,80
3565,11,7069,2672,4397,0,0,0,1.0,1,1.0,1,1.0,1,0.12328545754612841,83
3566,4,7073,2673,4400,0,0,0,1.0,1,1.0,1,1.0,1,0.12262988363005826,84
3567,3,7076,2673,4403,0,0,0,1.0,1,1.0,1,1.0,1,0.12853981180772592,84
3568,4,7080,2674,4406,0,0,0,1.0,1,1.0,1,1.0,1,0.11036937327267732,84
3569,1,7081,2675,4406,0,0,0,1.0,1,1.0,1,1.0,1,0.1140366290104658,84
3570,5,7086,2677,4409,0,0,0,1.0,1,1.0,1,1.0,1,0.1120277362379304,87
3571,4,7090,2678,4412,0,0,0,1.0,1,1.0,1,1.0,1,0.09151024993365525,86
3572,5,7095,2680,4415,0,0,0,1.0,1,1.0,1,1.0,1,0.12172819289647817,87
3573,3,7098,2682,4416,0,0,0,1.0,1,1.0,1,1.0,1,0.14664745632734885,87
3574,5,7103,2684,4419,0,0,0,1.0,1,1.0,1,1.0,1,0.1562539880877258,88
3575,3,7106,2684,4422,0,0,0,1.0,1,1.0,1,1.0,1,0.13658947933480803,88
3576,2,7108,2685,4423,0,0,0,1.0,1,1.0,1,1.0,1,0.12280485836479213,90
3577,4,7112,2685,4427,0,0,0,1.0,1,1.0,1,1.0,1,0.10598564717793085,90
3578,2,7114,2685,4429,0,0,0,1.0,1,1.0,1,1.0,1,0.10379707017055995,91
3579,0,7114,2685,4429,0,0,0,1.0,1,1.0,1,1.0,1,0.10379707017055995,91
3580,4,7118,2685,4433,0,0,0,1.0,1,1.0,1,1.0,1,0.10507285679988386,91
3581,3,7121,2685,4436,0,0,0,1.0,1,1.0,1,1.0,1,0.09179032390354055,91
3582,5,7126,2686,4440,0,0,0,1.0,1,1.0,1,1.0,1,0.09797123631489141,92
3583,3,7129,2686,4443,0,0,0,1.0,1,1.0,1,1.0,1,0.08034663132342619,88
3584,3,7132,2689,4443,0,0,0,1.0,1,1.0,1,1.0,1,0.11086853313306576,87
3585,2,7134,2689,4445,0,0,0,1.0,1,1.0,1,1.0,1,0.08815817081642073,84
3586,3,7137,2690,4447,0,0,0,1.0,1,1.0,1,1.0,1,0.08096344810371849,83
3587,2,7139,2690,4449,0,0,0,1.0,1,1.0,1,1.0,1,0.08638390445911498,82
3588,5,7144,2692,4452,0,0,0,1.0,1,1.0,1,1.0,1,0.09612143266003731,81
3589,3,7147,2694,4453,0,0,0,1.0,1,1.0,1,1.0,1,0.11757511135802787,80
3590,4,7151,2695,4456,0,0,0,1.0,1,1.0,1,1.0,1,0.11799404973894694,78
3591,4,7155,2697,4458,0,0,0,1.0,1,1.0,1,1.0,1,0.09471312840248947,77
3592,6,7161,2698,4463,0,0,0,1.0,1,1.0,1,1.0,1,0.08413116879072757,75
3593,4,7165,2699,4466,0,0,0,1.0,1,1.0,1,1.0,1,0.08447289894671142,76
3594,1,7166,2700,4466,0,0,0,1.0,1,1.0,1,1.0,1,0.09778272066144107,74
3595,4,7170,2700,4470,0,0,0,1.0,1,1.0,1,1.0,1,0.07255776871367386,74
3596,0,7170,2700,4470,0,0,0,1.0,1,1.0,1,1.0,1,0.07745189968762278,73
3597,1,7171,2701,4470,0,0,0,1.0,1,1.0,1,1.0,1,0.08429556706509983,73
3598,2,7173,2703,4470,0,0,0,1.0,1,1.0,1,1.0,1,0.11726443608592112,73
3599,1,7174,2703,4471,0,0,0,1.0,1,1.0,1,1.0,1,0.11010882768853444,73
3600,0,7174,2703,4471,0,0,0,1.0,1,1.0,1,1.0,1,0.10215306525910708,74
3601,5,7179,2705,4474,0,0,0,1.0,1,1.0,1,1.0,1,0.09046044730246362,75
3602,1,7180,2705,4475,0,0,0,1.0,1,1.0,1,1.0,1,0.05966369473216174,76
3603,3,7183,2707,4476,0,0,0,1.0,1,1.0,1,1.0,1,0.07925498450276744,77
3604,4,7187,2710,4477,0,0,0,1.0,1,1.0,1,1.0,1,0.12233921907464528,78
3605,7,7194,2713,4481,0,0,0,1.0,1,1.0,1,1.0,1,0.12363488816746142,77
3606,3,7197,2714,4483,0,0,0,1.0,1,1.0,1,1.0,1,0.11353287885387789,79
3607,6,7203,2715,4488,0,0,0,1.0,1,1.0,1,1.0,1,0.061320071043030625,79
3608,0,7203,2715,4488,0,0,0,1.0,1,1.0,1,1.0,1,0.061320071043030625,79
3609,1,7204,2715,4489,0,0,0,1.0,1,1.0,1,1.0,1,0.055513371985326784,79
3610,3,7207,2718,4489,0,0,0,1.0,1,1.0,1,1.0,1,0.1007303628564952,80
3611,3,7210,2719,4491,0,0,0,1.0,1,1.0,1,1.0,1,0.08998439944444311,80
3612,2,7212,2720,4492,0,0,0,1.0,1,1.0,1,1.0,1,0.11943773360277636,79
3613,10,7222,2721,4501,0,0,0,1.0,1,1.0,1,1.0,1,0.09587331997139145,79
3614,2,7224,2723,4501,0,0,0,1.0,1,1.0,1,1.0,1,0.13661295866676731,78
3615,2,7226,2723,4503,0,0,0,1.0,1,1.0,1,1.0,1,0.09920488362688606,79
3616,3,7229,2724,4505,0,0,0,1.0,1,1.0,1,1.0,1,0.08461450734763105,79
3617,1,7230,2725,4505,0,0,0,1.0,1,1.0,1,1.0,1,0.07928926077105403,80
3618,3,7233,2725,4508,0,0,0,1.0,1,1.0,1,1.0,1,0.08912149461442564,82
3619,4,7237,2726,4511,0,0,0,1.0,1,1.0,1,1.0,1,0.07992308277752529,82
3620,3,7240,2728,4512,0,0,0,1.0,1,1.0,1,1.0,1,0.09229530917815322,81
3621,0,7240,2728,4512,0,0,0,1.0,1,1.0,1,1.0,1,0.0943030214521309,83
3622,1,7241,2728,4513,0,0,0,1.0,1,1.0,1,1.0,1,0.07659867497517756,81
3623,1,7242,2729,4513,0,0,0,1.0,1,1.0,1,1.0,1,0.08707389672623642,81
3624,1,7243,2730,4513,0,0,0,1.0,1,1.0,1,1.0,1,0.09790132065932075,79
3625,6,7249,2732,4517,0,0,0,1.0,1,1.0,1,1.0,1,0.08421781259638554,80
3626,1,7250,2732,4518,0,0,0,1.0,1,1.0,1,1.0,1,0.07820391325190396,78
3627,3,7253,2733,4520,0,0,0,1.0,1,1.0,1,1.0,1,0.10069618766782393,78
3628,4,7257,2733,4524,0,0,0,1.0,1,1.0,1,1.0,1,0.07871536625662677,77
3629,0,7257,2733,4524,0,0,0,1.0,1,1.0,1,1.0,1,0.08562105531559774,76
3630,0,7257,2733,4524,0,0,0,1.0,1,1.0,1,1.0,1,0.08002792520526943,77
3631,2,7259,2734,4525,0,0,0,1.0,1,1.0,1,1.0,1,0.0676522336588387,75
3632,3,7262,2737,4525,0,0,0,1.0,1,1.0,1,1.0,1,0.13899411291987,74
3633,4,7266,2738,4528,0,0,0,1.0,1,1.0,1,1.0,1,0.1242170381596849,75
3634,4,7270,2738,4532,0,0,0,1.0,1,1.0,1,1.0,1,0.09166171829784661,74
3635,1,7271,2739,4532,0,0,0,1.0,1,1.0,1,1.0,1,0.10235380747530178,74
3636,3,7274,2740,4534,0,0,0,1.0,1,1.0,1,1.0,1,0.1023753710475657,74
3637,4,7278,2740,4538,0,0,0,1.0,1,1.0,1,1.0,1,0.09680506725303085,74
3638,3,7281,2740,4541,0,0,0,1.0,1,1.0,1,1.0,1,0.08567840166989212,75
3639,2,7283,2742,4541,0,0,0,1.0,1,1.0,1,1.0,1,0.08950005554796377,76
3640,4,7287,2742,4545,0,0,0,1.0,1,1.0,1,1.0,1,0.05632065275617211,76
3641,3,7290,2744,4546,0,0,0,1.0,1,1.0,1,1.0,1,0.08449778058425704,75
3642,3,7293,2746,4547,0,0,0,1.0,1,1.0,1,1.0,1,0.10808266142510124,75
3643,2,7295,2746,4549,0,0,0,1.0,1,1.0,1,1.0,1,0.09126645879685218,74
3644,0,7295,2746,4549,0,0,0,1.0,1,1.0,1,1.0,1,0.09126645879685218,74
3645,1,7296,2746,4550,0,0,0,1.0,1,1.0,1,1.0,1,0.08851883219451964,74
3646,2,7298,2746,4552,0,0,0,1.0,1,1.0,1,1.0,1,0.06830965888865652,75
3647,1,7299,2746,4553,0,0,0,1.0,1,1.0,1,1.0,1,0.06931867470754756,77
3648,2,7301,2746,4555,0,0,0,1.0,1,1.0,1,1.0,1,0.08694790192257186,78
3649,3,7304,2746,4558,0,0,0,1.0,1,1.0,1,1.0,1,0.08230713372193978,80
3650,5,7309,2747,4562,0,0,0,1.0,1,1.0,1,1.0,1,0.08086126558952571,81
3651,2,7311,2747,4564,0,0,0,1.0,1,1.0,1,1.0,1,0.09157888968925557,81
3652,3,7314,2747,4567,0,0,0,1.0,1,1.0,1,1.0,1,0.08424744240583715,83
3653,0,7314,2747,4567,0,0,0,1.0,1,1.0,1,1.0,1,0.08424744240583715,83
3654,0,7314,2747,4567,0,0,0,1.0,1,1.0,1,1.0,1,0.08424744240583715,83
3655,1,7315,2747,4568,0,0,0,1.0,1,1.0,1,1.0,1,0.07192876436624271,84
3656,1,7316,2748,4568,0,0,0,1.0,1,1.0,1,1.0,1,0.08560337311058616,85
3657,4,7320,2749,4571,0,0,0,1.0,1,1.0,1,1.0,1,0.0869785426236765,86
3658,2,7322,2750,4572,0,0,0,1.0,1,1.0,1,1.0,1,0.09513640202912664,87
3659,0,7322,2750,4572,0,0,0,1.0,1,1.0,1,1.0,1,0.08893795823722607,87
3660,0,7322,2750,4572,0,0,0,1.0,1,1.0,1,1.0,1,0.09494692789872276,86
3661,3,7325,2751,4574,0,0,0,1.0,1,1.0,1,1.0,1,0.0974907618667085,86
3662,1,7326,2752,4574,0,0,0,1.0,1,1.0,1,1.0,1,0.11515106794145555,83
3663,5,7331,2757,4574,0,0,0,1.0,1,1.0,1,1.0,1,0.1594351512614613,85
3664,6,7337,2759,4578,0,0,0,1.0,1,1.0,1,1.0,1,0.12765846140112072,82
3665,4,7341,2759,4582,0,0,0,1.0,1,1.0,1,1.0,1,0.09695832577167184,81
3666,3,7344,2760,4584,0,0,0,1.0,1,1.0,1,1.0,1,0.11128915533425128,79
3667,3,7347,2760,4587,0,0,0,1.0,1,1.0,1,1.0,1,0.08998542399373463,79
3668,1,7348,2761,4587,0,0,0,1.0,1,1.0,1,1.0,1,0.10967204281522525,77
3669,1,7349,2762,4587,0,0,0,1.0,1,1.0,1,1.0,1,0.10621249998866861,75
3670,5,7354,2764,4590,0,0,0,1.0,1,1.0,1,1.0,1,0.10712909490653741,76
3671,1,7355,2764,4591,0,0,0,1.0,1,1.0,1,1.0,1,0.09408333653184234,74
3672,1,7356,2765,4591,0,0,0,1.0,1,1.0,1,1.0,1,0.09288265884883254,75
3673,5,7361,2767,4594,0,0,0,1.0,1,1.0,1,1.0,1,0.11116154473160214,75
3674,3,7364,2769,4595,0,0,0,1.0,1,1.0,1,1.0,1,0.11790997795223536,75
3675,0,7364,2769,4595,0,0,0,1.0,1,1.0,1,1.0,1,0.11872145524237031,75
3676,3,7367,2770,4597,0,0,0,1.0,1,1.0,1,1.0,1,0.1124255252192049,75
3677,0,7367,2770,4597,0,0,0,1.0,1,1.0,1,1.0,1,0.12163874313983343,75
3678,3,7370,2771,4599,0,0,0,1.0,1,1.0,1,1.0,1,0.11635651482232585,77
3679,2,7372,2772,4600,0,0,0,1.0,1,1.0,1,1.0,1,0.13704950226095913,78
3680,1,7373,2772,4601,0,0,0,1.0,1,1.0,1,1.0,1,0.13624992245020104,80
3681,0,7373,2772,4601,0,0,0,1.0,1,1.0,1,1.0,1,0.137955620373049,81
3682,0,7373,2772,4601,0,0,0,1.0,1,1.0,1,1.0,1,0.137955620373049,81
3683,2,7375,2773,4602,0,0,0,1.0,1,1.0,1,1.0,1,0.14486683917540927,81
3684,0,7375,2773,4602,0,0,0,1.0,1,1.0,1,1.0,1,0.14486683917540927,81
3685,0,7375,2773,4602,0,0,0,1.0,1,1.0,1,1.0,1,0.14486683917540927,81
3686,0,7375,2773,4602,0,0,0,1.0,1,1.0,1,1.0,1,0.14486683917540927,81
3687,1,7376,2773,4603,0,0,0,1.0,1,1.0,1,1.0,1,0.1306011764561711,82
3688,2,7378,2773,4605,0,0,0,1.0,1,1.0,1,1.0,1,0.1276345436333666,84
3689,0,7378,2773,4605,0,0,0,1.0,1,1.0,1,1.0,1,0.1276345436333666,84
3690,2,7380,2775,4605,0,0,0,1.0,1,1.0,1,1.0,1,0.14736714499189874,85
3691,2,7382,2775,4607,0,0,0,1.0,1,1.0,1,1.0,1,0.13047410744546117,86
3692,0,7382,2775,4607,0,0,0,1.0,1,1.0,1,1.0,1,0.12274128947130367,86
3693,1,7383,2775,4608,0,0,0,1.0,1,1.0,1,1.0,1,0.11924268233374463,86
3694,0,7383,2775,4608,0,0,0,1.0,1,1.0,1,1.0,1,0.11924268233374463,86
3695,1,7384,2776,4608,0,0,0,1.0,1,1.0,1,1.0,1,0.13592130356219637,86
3696,0,7384,2776,4608,0,0,0,1.0,1,1.0,1,1.0,1,0.12212882846709817,87
3697,0,7384,2776,4608,0,0,0,1.0,1,1.0,1,1.0,1,0.11999838789560188,85
3698,0,7384,2776,4608,0,0,0,1.0,1,1.0,1,1.0,1,0.11919667884762862,85
3699,1,7385,2777,4608,0,0,0,1.0,1,1.0,1,1.0,1,0.1163400773561237,85
3700,7,7392,2781,4611,0,0,0,1.0,1,1.0,1,1.0,1,0.1365602785624014,84
3701,4,7396,2782,4614,0,0,0,1.0,1,1.0,1,1.0,1,0.15664950189780769,85
3702,7,7403,2784,4619,0,0,0,1.0,1,1.0,1,1.0,1,0.14863539764941225,85
3703,1,7404,2784,4620,0,0,0,1.0,1,1.0,1,1.0,1,0.13931211804779628,85
3704,2,7406,2784,4622,0,0,0,1.0,1,1.0,1,1.0,1,0.12939738438901965,85
3705,0,7406,2784,4622,0,0,0,1.0,1,1.0,1,1.0,1,0.1231063105421566,86
3706,1,7407,2785,4622,0,0,0,1.0,1,1.0,1,1.0,1,0.12403126713440212,86
3707,2,7409,2787,4622,0,0,0,1.0,1,1.0,1,1.0,1,0.14279954077762996,85
3708,1,7410,2787,4623,0,0,0,1.0,1,1.0,1,1.0,1,0.13667087020846086,84
3709,1,7411,2787,4624,0,0,0,1.0,1,1.0,1,1.0,1,0.1374162725110848,85
3710,0,7411,2787,4624,0,0,0,1.0,1,1.0,1,1.0,1,0.13357189608325648,84
3711,1,7412,2787,4625,0,0,0,1.0,1,1.0,1,1.0,1,0.1275330501151059,85
3712,3,7415,2787,4628,0,0,0,1.0,1,1.0,1,1.0,1,0.10915559278298045,85
3713,0,7415,2787,4628,0,0,0,1.0,1,1.0,1,1.0,1,0.10915559278298045,85
3714,3,7418,2788,4630,0,0,0,1.0,1,1.0,1,1.0,1,0.12197166570381344,85
3715,2,7420,2789,4631,0,0,0,1.0,1,1.0,1,1.0,1,0.11748911271118667,85
3716,2,7422,2790,4632,0,0,0,1.0,1,1.0,1,1.0,1,0.11830072260464365,84
3717,0,7422,2790,4632,0,0,0,1.0,1,1.0,1,1.0,1,0.12232899304590102,86
3718,3,7425,2791,4634,0,0,0,1.0,1,1.0,1,1.0,1,0.13793440797762835,85
3719,4,7429,2793,4636,0,0,0,1.0,1,1.0,1,1.0,1,0.13239404038797012,84
3720,2,7431,2793,4638,0,0,0,1.0,1,1.0,1,1.0,1,0.1374507043929827,84
3721,7,7438,2796,4642,0,0,0,1.0,1,1.0,1,1.0,1,0.12857228508949078,85
3722,1,7439,2796,4643,0,0,0,1.0,1,1.0,1,1.0,1,0.124239931435999,85
3723,1,7440,2796,4644,0,0,0,1.0,1,1.0,1,1.0,1,0.13120898489834282,85
3724,3,7443,2796,4647,0,0,0,1.0,1,1.0,1,1.0,1,0.11173955958540209,86
3725,1,7444,2797,4647,0,0,0,1.0,1,1.0,1,1.0,1,0.11863868273522028,86
3726,0,7444,2797,4647,0,0,0,1.0,1,1.0,1,1.0,1,0.11863868273522028,86
3727,1,7445,2797,4648,0,0,0,1.0,1,1.0,1,1.0,1,0.1066201444172888,86
3728,2,7447,2799,4648,0,0,0,1.0,1,1.0,1,1.0,1,0.1353084715883227,86
3729,2,7449,2800,4649,0,0,0,1.0,1,1.0,1,1.0,1,0.14778423625215326,86
3730,2,7451,2800,4651,0,0,0,1.0,1,1.0,1,1.0,1,0.14745991610188314,85
3731,1,7452,2800,4652,0,0,0,1.0,1,1.0,1,1.0,1,0.14780544140564775,86
3732,0,7452,2800,4652,0,0,0,1.0,1,1.0,1,1.0,1,0.14349454093679942,87
3733,1,7453,2801,4652,0,0,0,1.0,1,1.0,1,1.0,1,0.16847096506950282,87
3734,1,7454,2801,4653,0,0,0,1.0,1,1.0,1,1.0,1,0.16523591883360103,87
3735,4,7458,2802,4656,0,0,0,1.0,1,1.0,1,1.0,1,0.15354479602104754,86
3736,1,7459,2802,4657,0,0,0,1.0,1,1.0,1,1.0,1,0.13783409451752385,87
3737,1,7460,2803,4657,0,0,0,1.0,1,1.0,1,1.0,1,0.13977690809582477,87
3738,4,7464,2804,4660,0,0,0,1.0,1,1.0,1,1.0,1,0.1355751452497957,87
3739,3,7467,2804,4663,0,0,0,1.0,1,1.0,1,1.0,1,0.11231912953346786,88
3740,3,7470,2805,4665,0,0,0,1.0,1,1.0,1,1.0,1,0.12752903937685345,87
3741,4,7474,2805,4669,0,0,0,1.0,1,1.0,1,1.0,1,0.12159732677580237,87
3742,4,7478,2806,4672,0,0,0,1.0,1,1.0,1,1.0,1,0.092334121618357,86
3743,0,7478,2806,4672,0,0,0,1.0,1,1.0,1,1.0,1,0.10780208684044212,84
3744,2,7480,2807,4673,0,0,0,1.0,1,1.0,1,1.0,1,0.12567511094098152,83
3745,3,7483,2807,4676,0,0,0,1.0,1,1.0,1,1.0,1,0.10910489242795113,83
3746,2,7485,2808,4677,0,0,0,1.0,1,1.0,1,1.0,1,0.1356706579013334,83
3747,3,7488,2810,4678,0,0,0,1.0,1,1.0,1,1.0,1,0.1355122146648553,81
3748,5,7493,2810,4683,0,0,0,1.0,1,1.0,1,1.0,1,0.10354880333195343,81
3749,1,7494,2810,4684,0,0,0,1.0,1,1.0,1,1.0,1,0.11102496086769502,80
3750,0,7494,2810,4684,0,0,0,1.0,1,1.0,1,1.0,1,0.12147558850572872,79
3751,5,7499,2813,4686,0,0,0,1.0,1,1.0,1,1.0,1,0.1415764364953274,80
3752,2,7501,2814,4687,0,0,0,1.0,1,1.0,1,1.0,1,0.14996183412198016,80
3753,5,7506,2817,4689,0,0,0,1.0,1,1.0,1,1.0,1,0.15624507325943943,81
3754,4,7510,2818,4692,0,0,0,1.0,1,1.0,1,1.0,1,0.15198727149274482,81
3755,5,7515,2819,4696,0,0,0,1.0,1,1.0,1,1.0,1,0.15215536243125968,80
3756,1,7516,2819,4697,0,0,0,1.0,1,1.0,1,1.0,1,0.1586865299871169,79
3757,2,7518,2819,4699,0,0,0,1.0,1,1.0,1,1.0,1,0.15882257305645436,80
3758,2,7520,2820,4700,0,0,0,1.0,1,1.0,1,1.0,1,0.1624376536408499,79
3759,2,7522,2822,4700,0,0,0,1.0,1,1.0,1,1.0,1,0.20214050267449388,79
3760,2,7524,2822,4702,0,0,0,1.0,1,1.0,1,1.0,1,0.18207922118275932,79
3761,0,7524,2822,4702,0,0,0,1.0,1,1.0,1,1.0,1,0.1994472981632943,78
3762,1,7525,2822,4703,0,0,0,1.0,1,1.0,1,1.0,1,0.19465741663700692,80
3763,1,7526,2822,4704,0,0,0,1.0,1,1.0,1,1.0,1,0.19160484466764152,80
3764,1,7527,2823,4704,0,0,0,1.0,1,1.0,1,1.0,1,0.20687606614833318,80
3765,3,7530,2823,4707,0,0,0,1.0,1,1.0,1,1.0,1,0.19963030806710563,81
3766,8,7538,2824,4714,0,0,0,1.0,1,1.0,1,1.0,1,0.18377342555445617,83
3767,1,7539,2825,4714,0,0,0,1.0,1,1.0,1,1.0,1,0.17760427069972948,83
3768,3,7542,2825,4717,0,0,0,1.0,1,1.0,1,1.0,1,0.17719081581808604,84
3769,5,7547,2825,4722,0,0,0,1.0,1,1.0,1,1.0,1,0.12521205606730035,86
3770,1,7548,2825,4723,0,0,0,1.0,1,1.0,1,1.0,1,0.11344084381059617,87
3771,1,7549,2826,4723,0,0,0,1.0,1,1.0,1,1.0,1,0.11666148481277301,87
3772,2,7551,2826,4725,0,0,0,1.0,1,1.0,1,1.0,1,0.12058208078896439,88
3773,0,7551,2826,4725,0,0,0,1.0,1,1.0,1,1.0,1,0.12956149616844334,85
3774,2,7553,2827,4726,0,0,0,1.0,1,1.0,1,1.0,1,0.12318086553120632,85
3775,2,7555,2828,4727,0,0,0,1.0,1,1.0,1,1.0,1,0.1437789903889128,83
3776,5,7560,2830,4730,0,0,0,1.0,1,1.0,1,1.0,1,0.15509926005869512,82
3777,1,7561,2830,4731,0,0,0,1.0,1,1.0,1,1.0,1,0.1377918322178419,81
3778,3,7564,2830,4734,0,0,0,1.0,1,1.0,1,1.0,1,0.12859495385037195,81
3779,2,7566,2832,4734,0,0,0,1.0,1,1.0,1,1.0,1,0.15127873704369665,80
3780,1,7567,2832,4735,0,0,0,1.0,1,1.0,1,1.0,1,0.1416921929771972,80
3781,1,7568,2832,4736,0,0,0,1.0,1,1.0,1,1.0,1,0.13957389476074716,80
3782,0,7568,2832,4736,0,0,0,1.0,1,1.0,1,1.0,1,0.13957389476074716,80
3783,0,7568,2832,4736,0,0,0,1.0,1,1.0,1,1.0,1,0.14072992958399708,80
3784,2,7570,2833,4737,0,0,0,1.0,1,1.0,1,1.0,1,0.14341017505923812,79
3785,3,7573,2834,4739,0,0,0,1.0,1,1.0,1,1.0,1,0.1696049013342935,77
3786,0,7573,2834,4739,0,0,0,1.0,1,1.0,1,1.0,1,0.15985479635820016,78
3787,3,7576,2835,4741,0,0,0,1.0,1,1.0,1,1.0,1,0.1747075373083647,77
3788,5,7581,2837,4744,0,0,0,1.0,1,1.0,1,1.0,1,0.1778966028209009,78
3789,3,7584,2839,4745,0,0,0,1.0,1,1.0,1,1.0,1,0.20454696353634017,77
3790,6,7590,2840,4750,0,0,0,1.0,1,1.0,1,1.0,1,0.17237917381825327,77
3791,1,7591,2841,4750,0,0,0,1.0,1,1.0,1,1.0,1,0.1799293431155415,77
3792,1,7592,2841,4751,0,0,0,1.0,1,1.0,1,1.0,1,0.1560436008568379,78
3793,1,7593,2841,4752,0,0,0,1.0,1,1.0,1,1.0,1,0.1414781122710482,80
3794,3,7596,2841,4755,0,0,0,1.0,1,1.0,1,1.0,1,0.13378983436811373,82
3795,2,7598,2841,4757,0,0,0,1.0,1,1.0,1,1.0,1,0.1340499589692817,83
3796,4,7602,2842,4760,0,0,0,1.0,1,1.0,1,1.0,1,0.10766202716562875,83
3797,4,7606,2842,4764,0,0,0,1.0,1,1.0,1,1.0,1,0.10836123200274773,82
3798,1,7607,2842,4765,0,0,0,1.0,1,1.0,1,1.0,1,0.11965928541869504,82
3799,2,7609,2842,4767,0,0,0,1.0,1,1.0,1,1.0,1,0.11863795389968901,83
3800,3,7612,2843,4769,0,0,0,1.0,1,1.0,1,1.0,1,0.12376859885209561,83
3801,0,7612,2843,4769,0,0,0,1.0,1,1.0,1,1.0,1,0.12376859885209561,83
3802,4,7616,2843,4773,0,0,0,1.0,1,1.0,1,1.0,1,0.106277634914819,82
3803,0,7616,2843,4773,0,0,0,1.0,1,1.0,1,1.0,1,0.11315086143914788,84
3804,1,7617,2843,4774,0,0,0,1.0,1,1.0,1,1.0,1,0.09962153496768884,84
3805,3,7620,2844,4776,0,0,0,1.0,1,1.0,1,1.0,1,0.13257738798988966,86
3806,2,7622,2844,4778,0,0,0,1.0,1,1.0,1,1.0,1,0.12230624513852142,86
3807,1,7623,2845,4778,0,0,0,1.0,1,1.0,1,1.0,1,0.14168614563924636,86
3808,3,7626,2845,4781,0,0,0,1.0,1,1.0,1,1.0,1,0.12886962314429487,85
3809,3,7629,2846,4783,0,0,0,1.0,1,1.0,1,1.0,1,0.13231579147189895,85
3810,0,7629,2846,4783,0,0,0,1.0,1,1.0,1,1.0,1,0.13231579147189895,85
3811,4,7633,2847,4786,0,0,0,1.0,1,1.0,1,1.0,1,0.12857476135670115,84
3812,2,7635,2849,4786,0,0,0,1.0,1,1.0,1,1.0,1,0.14637859141097606,83
3813,3,7638,2849,4789,0,0,0,1.0,1,1.0,1,1.0,1,0.11280388816957246,82
3814,6,7644,2850,4794,0,0,0,1.0,1,1.0,1,1.0,1,0.1295303887196066,81
3815,3,7647,2850,4797,0,0,0,1.0,1,1.0,1,1.0,1,0.14555780667380977,82
3816,3,7650,2850,4800,0,0,0,1.0,1,1.0,1,1.0,1,0.11097065563437082,81
3817,2,7652,2851,4801,0,0,0,1.0,1,1.0,1,1.0,1,0.10330290345295808,81
3818,2,7654,2853,4801,0,0,0,1.0,1,1.0,1,1.0,1,0.1508301857436844,81
3819,6,7660,2855,4805,0,0,0,1.0,1,1.0,1,1.0,1,0.16634604434597244,82
3820,4,7664,2855,4809,0,0,0,1.0,1,1.0,1,1.0,1,0.1520092919443026,84
3821,1,7665,2855,4810,0,0,0,1.0,1,1.0,1,1.0,1,0.1488790225709165,84
3822,1,7666,2855,4811,0,0,0,1.0,1,1.0,1,1.0,1,0.13776960406615757,82
3823,8,7674,2858,4816,0,0,0,1.0,1,1.0,1,1.0,1,0.15478005251015145,81
3824,2,7676,2858,4818,0,0,0,1.0,1,1.0,1,1.0,1,0.16809263988954296,78
3825,1,7677,2858,4819,0,0,0,1.0,1,1.0,1,1.0,1,0.17791789205426795,76
3826,4,7681,2859,4822,0,0,0,1.0,1,1.0,1,1.0,1,0.17232764414152105,76
3827,1,7682,2859,4823,0,0,0,1.0,1,1.0,1,1.0,1,0.17282553996621694,75
3828,1,7683,2860,4823,0,0,0,1.0,1,1.0,1,1.0,1,0.17583442501099433,74
3829,6,7689,2861,4828,0,0,0,1.0,1,1.0,1,1.0,1,0.17097862558699145,74
3830,2,7691,2862,4829,0,0,0,1.0,1,1.0,1,1.0,1,0.14713690113302905,74
3831,3,7694,2864,4830,0,0,0,1.0,1,1.0,1,1.0,1,0.18510882754045152,74
3832,6,7700,2865,4835,0,0,0,1.0,1,1.0,1,1.0,1,0.1585841779520832,73
3833,3,7703,2868,4835,0,0,0,1.0,1,1.0,1,1.0,1,0.17746833233196554,73
3834,5,7708,2869,4839,0,0,0,1.0,1,1.0,1,1.0,1,0.17601385142398776,74
3835,6,7714,2870,4844,0,0,0,1.0,1,1.0,1,1.0,1,0.1554852816985252,75
3836,2,7716,2870,4846,0,0,0,1.0,1,1.0,1,1.0,1,0.13929475526385102,75
3837,2,7718,2871,4847,0,0,0,1.0,1,1.0,1,1.0,1,0.16400132656710853,78
3838,6,7724,2872,4852,0,0,0,1.0,1,1.0,1,1.0,1,0.1350289949215183,78
3839,3,7727,2872,4855,0,0,0,1.0,1,1.0,1,1.0,1,0.11224097282085192,79
3840,2,7729,2873,4856,0,0,0,1.0,1,1.0,1,1.0,1,0.12217242339158561,82
3841,2,7731,2873,4858,0,0,0,1.0,1,1.0,1,1.0,1,0.10124613398219802,82
3842,0,7731,2873,4858,0,0,0,1.0,1,1.0,1,1.0,1,0.09966666595599914,82
3843,1,7732,2873,4859,0,0,0,1.0,1,1.0,1,1.0,1,0.08649635764923397,82
3844,0,7732,2873,4859,0,0,0,1.0,1,1.0,1,1.0,1,0.08531352525181281,83
3845,2,7734,2873,4861,0,0,0,1.0,1,1.0,1,1.0,1,0.0917083350193852,84
3846,2,7736,2873,4863,0,0,0,1.0,1,1.0,1,1.0,1,0.08828222002346459,85
3847,3,7739,2873,4866,0,0,0,1.0,1,1.0,1,1.0,1,0.08352733030942616,84
3848,1,7740,2874,4866,0,0,0,1.0,1,1.0,1,1.0,1,0.09953772184713204,84
3849,1,7741,2874,4867,0,0,0,1.0,1,1.0,1,1.0,1,0.09475268250532871,83
3850,1,7742,2874,4868,0,0,0,1.0,1,1.0,1,1.0,1,0.09644778735462695,80
3851,1,7743,2874,4869,0,0,0,1.0,1,1.0,1,1.0,1,0.08456882346255479,80
3852,1,7744,2874,4870,0,0,0,1.0,1,1.0,1,1.0,1,0.09873571249077948,79
3853,0,7744,2874,4870,0,0,0,1.0,1,1.0,1,1.0,1,0.09873571249077948,79
3854,2,7746,2876,4870,0,0,0,1.0,1,1.0,1,1.0,1,0.12960418395754264,78
3855,1,7747,2877,4870,0,0,0,1.0,1,1.0,1,1.0,1,0.14694546537830663,78
3856,5,7752,2878,4874,0,0,0,1.0,1,1.0,1,1.0,1,0.12541971964973736,80
3857,1,7753,2878,4875,0,0,0,1.0,1,1.0,1,1.0,1,0.12004303136195563,81
3858,1,7754,2879,4875,0,0,0,1.0,1,1.0,1,1.0,1,0.12229532210497837,81
3859,5,7759,2879,4880,0,0,0,1.0,1,1.0,1,1.0,1,0.11843947158794105,83
3860,6,7765,2880,4885,0,0,0,1.0,1,1.0,1,1.0,1,0.13323176832510075,82
3861,6,7771,2880,4891,0,0,0,1.0,1,1.0,1,1.0,1,0.13779412933486992,84
3862,3,7774,2881,4893,0,0,0,1.0,1,1.0,1,1.0,1,0.13408335951541672,85
3863,1,7775,2881,4894,0,0,0,1.0,1,1.0,1,1.0,1,0.11967656007941298,84
3864,1,7776,2882,4894,0,0,0,1.0,1,1.0,1,1.0,1,0.11557750430904176,83
3865,0,7776,2882,4894,0,0,0,1.0,1,1.0,1,1.0,1,0.1135020371359424,82
3866,0,7776,2882,4894,0,0,0,1.0,1,1.0,1,1.0,1,0.11382322167660777,81
3867,2,7778,2884,4894,0,0,0,1.0,1,1.0,1,1.0,1,0.11594091258383288,81
3868,6,7784,2885,4899,0,0,0,1.0,1,1.0,1,1.0,1,0.09883959198757258,81
3869,3,7787,2886,4901,0,0,0,1.0,1,1.0,1,1.0,1,0.10118272144309304,81
3870,2,7789,2886,4903,0,0,0,1.0,1,1.0,1,1.0,1,0.09043584244554746,80
3871,2,7791,2887,4904,0,0,0,1.0,1,1.0,1,1.0,1,0.08650787745889091,82
3872,2,7793,2888,4905,0,0,0,1.0,1,1.0,1,1.0,1,0.09757569619117028,81
3873,1,7794,2888,4906,0,0,0,1.0,1,1.0,1,1.0,1,0.09346280315314395,81
3874,2,7796,2889,4907,0,0,0,1.0,1,1.0,1,1.0,1,0.08775861759532817,78
3875,0,7796,2889,4907,0,0,0,1.0,1,1.0,1,1.0,1,0.0901524261321117,77
3876,3,7799,2889,4910,0,0,0,1.0,1,1.0,1,1.0,1,0.06986273767248716,78
3877,2,7801,2889,4912,0,0,0,1.0,1,1.0,1,1.0,1,0.09327900706599423,75
3878,2,7803,2891,4912,0,0,0,1.0,1,1.0,1,1.0,1,0.08995561587569685,75
3879,1,7804,2891,4913,0,0,0,1.0,1,1.0,1,1.0,1,0.1037937198987839,73
3880,1,7805,2891,4914,0,0,0,1.0,1,1.0,1,1.0,1,0.08192716582831766,74
3881,2,7807,2891,4916,0,0,0,1.0,1,1.0,1,1.0,1,0.0777248930692641,75
3882,4,7811,2891,4920,0,0,0,1.0,1,1.0,1,1.0,1,0.07413741368267666,76
3883,1,7812,2891,4921,0,0,0,1.0,1,1.0,1,1.0,1,0.06787290099065849,77
3884,5,7817,2893,4924,0,0,0,1.0,1,1.0,1,1.0,1,0.08339525175030804,78
3885,1,7818,2893,4925,0,0,0,1.0,1,1.0,1,1.0,1,0.07123443668975439,78
3886,4,7822,2895,4927,0,0,0,1.0,1,1.0,1,1.0,1,0.07894590908704748,79
3887,2,7824,2896,4928,0,0,0,1.0,1,1.0,1,1.0,1,0.098189147512794,78
3888,6,7830,2898,4932,0,0,0,1.0,1,1.0,1,1.0,1,0.11057148931429123,80
3889,9,7839,2899,4940,0,0,0,1.0,1,1.0,1,1.0,1,0.07280045394883788,82
3890,4,7843,2900,4943,0,0,0,1.0,1,1.0,1,1.0,1,0.07772046281469619,82
3891,3,7846,2901,4945,0,0,0,1.0,1,1.0,1,1.0,1,0.08088815365087877,85
3892,10,7856,2904,4952,0,0,0,1.0,1,1.0,1,1.0,1,0.08219465630688509,87
3893,1,7857,2904,4953,0,0,0,1.0,1,1.0,1,1.0,1,0.07185294294363538,86
3894,0,7857,2904,4953,0,0,0,1.0,1,1.0,1,1.0,1,0.07815930886768446,87
3895,6,7863,2906,4957,0,0,0,1.0,1,1.0,1,1.0,1,0.058682810684286664,87
3896,0,7863,2906,4957,0,0,0,1.0,1,1.0,1,1.0,1,0.0633015197808529,85
3897,1,7864,2907,4957,0,0,0,1.0,1,1.0,1,1.0,1,0.06644078925988016,85
3898,3,7867,2908,4959,0,0,0,1.0,1,1.0,1,1.0,1,0.09161668005997055,86
3899,1,7868,2909,4959,0,0,0,1.0,1,1.0,1,1.0,1,0.09958613955937451,86
3900,1,7869,2909,4960,0,0,0,1.0,1,1.0,1,1.0,1,0.09429419299010121,86
3901,4,7873,2911,4962,0,0,0,1.0,1,1.0,1,1.0,1,0.0957577499901587,86
3902,3,7876,2912,4964,0,0,0,1.0,1,1.0,1,1.0,1,0.09347429159681063,87
3903,2,7878,2914,4964,0,0,0,1.0,1,1.0,1,1.0,1,0.11952070561490252,87
3904,6,7884,2916,4968,0,0,0,1.0,1,1.0,1,1.0,1,0.0978258506610097,85
3905,2,7886,2917,4969,0,0,0,1.0,1,1.0,1,1.0,1,0.07961476694860438,84
3906,1,7887,2917,4970,0,0,0,1.0,1,1.0,1,1.0,1,0.07083347345446268,86
3907,1,7888,2917,4971,0,0,0,1.0,1,1.0,1,1.0,1,0.06578035570266447,84
3908,1,7889,2918,4971,0,0,0,1.0,1,1.0,1,1.0,1,0.0724395895691246,83
3909,3,7892,2920,4972,0,0,0,1.0,1,1.0,1,1.0,1,0.08247441343493826,81
3910,6,7898,2923,4975,0,0,0,1.0,1,1.0,1,1.0,1,0.05538254790110024,82
3911,2,7900,2925,4975,0,0,0,1.0,1,1.0,1,1.0,1,0.06110370408554677,81
3912,2,7902,2926,4976,0,0,0,1.0,1,1.0,1,1.0,1,0.0681488337155029,80
3913,4,7906,2929,4977,0,0,0,1.0,1,1.0,1,1.0,1,0.1137489198654842,80
3914,5,7911,2930,4981,0,0,0,1.0,1,1.0,1,1.0,1,0.09394902402635669,81
3915,4,7915,2933,4982,0,0,0,1.0,1,1.0,1,1.0,1,0.11113075701541657,81
3916,5,7920,2934,4986,0,0,0,1.0,1,1.0,1,1.0,1,0.10551229968978182,81
3917,4,7924,2935,4989,0,0,0,1.0,1,1.0,1,1.0,1,0.09820698117644772,82
3918,4,7928,2936,4992,0,0,0,1.0,1,1.0,1,1.0,1,0.09047604471024695,85
3919,4,7932,2938,4994,0,0,0,1.0,1,1.0,1,1.0,1,0.05881580653330142,85
3920,1,7933,2939,4994,0,0,0,1.0,1,1.0,1,1.0,1,0.061932008311022635,85
3921,2,7935,2940,4995,0,0,0,1.0,1,1.0,1,1.0,1,0.06784747264384257,88
3922,1,7936,2941,4995,0,0,0,1.0,1,1.0,1,1.0,1,0.07534598862945333,88
3923,1,7937,2941,4996,0,0,0,1.0,1,1.0,1,1.0,1,0.06506083993292097,89
3924,1,7938,2941,4997,0,0,0,1.0,1,1.0,1,1.0,1,0.06415856615350783,90
3925,1,7939,2942,4997,0,0,0,1.0,1,1.0,1,1.0,1,0.06997063044971397,88
3926,2,7941,2943,4998,0,0,0,1.0,1,1.0,1,1.0,1,0.07434763848041867,89
3927,0,7941,2943,4998,0,0,0,1.0,1,1.0,1,1.0,1,0.08285742577348663,89
3928,2,7943,2943,5000,0,0,0,1.0,1,1.0,1,1.0,1,0.08044248539539256,88
3929,1,7944,2944,5000,0,0,0,1.0,1,1.0,1,1.0,1,0.0999610206757677,88
3930,0,7944,2944,5000,0,0,0,1.0,1,1.0,1,1.0,1,0.10577928400029649,87
3931,8,7952,2946,5006,0,0,0,1.0,1,1.0,1,1.0,1,0.08126877928612697,86
3932,2,7954,2947,5007,0,0,0,1.0,1,1.0,1,1.0,1,0.08156727566875843,85
3933,0,7954,2947,5007,0,0,0,1.0,1,1.0,1,1.0,1,0.08802578752515308,84
3934,3,7957,2947,5010,0,0,0,1.0,1,1.0,1,1.0,1,0.08783934953015723,85
3935,3,7960,2949,5011,0,0,0,1.0,1,1.0,1,1.0,1,0.10768563006513067,84
3936,6,7966,2950,5016,0,0,0,1.0,1,1.0,1,1.0,1,0.10475386994111525,84
3937,5,7971,2951,5020,0,0,0,1.0,1,1.0,1,1.0,1,0.1043638187452506,82
3938,2,7973,2952,5021,0,0,0,1.0,1,1.0,1,1.0,1,0.09724764968815436,82
3939,0,7973,2952,5021,0,0,0,1.0,1,1.0,1,1.0,1,0.1000468907251954,84
3940,5,7978,2954,5024,0,0,0,1.0,1,1.0,1,1.0,1,0.08329068765741027,84
3941,2,7980,2954,5026,0,0,0,1.0,1,1.0,1,1.0,1,0.06324533641619517,85
3942,1,7981,2955,5026,0,0,0,1.0,1,1.0,1,1.0,1,0.07855299424561037,85
3943,3,7984,2955,5029,0,0,0,1.0,1,1.0,1,1.0,1,0.053672441922116475,84
3944,2,7986,2956,5030,0,0,0,1.0,1,1.0,1,1.0,1,0.07698115224431237,83
3945,1,7987,2957,5030,0,0,0,1.0,1,1.0,1,1.0,1,0.08385498841701866,83
3946,7,7994,2959,5035,0,0,0,1.0,1,1.0,1,1.0,1,0.08912630879793834,83
3947,0,7994,2959,5035,0,0,0,1.0,1,1.0,1,1.0,1,0.08912630879793834,83
3948,4,7998,2960,5038,0,0,0,1.0,1,1.0,1,1.0,1,0.10045524976840965,84
3949,5,8003,2960,5043,0,0,0,1.0,1,1.0,1,1.0,1,0.08938249730158139,84
3950,1,8004,2961,5043,0,0,0,1.0,1,1.0,1,1.0,1,0.10140105405651204,86
3951,2,8006,2961,5045,0,0,0,1.0,1,1.0,1,1.0,1,0.09652481619331732,87
3952,3,8009,2961,5048,0,0,0,1.0,1,1.0,1,1.0,1,0.07460760668790377,86
3953,2,8011,2962,5049,0,0,0,1.0,1,1.0,1,1.0,1,0.08554319914098561,86
3954,0,8011,2962,5049,0,0,0,1.0,1,1.0,1,1.0,1,0.07769227826626855,85
3955,4,8015,2962,5053,0,0,0,1.0,1,1.0,1,1.0,1,0.07323939905177536,85
3956,0,8015,2962,5053,0,0,0,1.0,1,1.0,1,1.0,1,0.07980719501792838,84
3957,0,8015,2962,5053,0,0,0,1.0,1,1.0,1,1.0,1,0.08783453494237517,85
3958,4,8019,2962,5057,0,0,0,1.0,1,1.0,1,1.0,1,0.06127111116572092,84
3959,1,8020,2963,5057,0,0,0,1.0,1,1.0,1,1.0,1,0.0725261496662925,83
3960,3,8023,2965,5058,0,0,0,1.0,1,1.0,1,1.0,1,0.10447434287858373,84
3961,3,8026,2966,5060,0,0,0,1.0,1,1.0,1,1.0,1,0.10570750738875488,83
3962,1,8027,2967,5060,0,0,0,1.0,1,1.0,1,1.0,1,0.10794929258938317,84
3963,0,8027,2967,5060,0,0,0,1.0,1,1.0,1,1.0,1,0.09934082539653691,81
3964,6,8033,2970,5063,0,0,0,1.0,1,1.0,1,1.0,1,0.11503881381511259,81
3965,3,8036,2970,5066,0,0,0,1.0,1,1.0,1,1.0,1,0.09775241176810286,81
3966,2,8038,2972,5066,0,0,0,1.0,1,1.0,1,1.0,1,0.10165033998047185,79
3967,5,8043,2973,5070,0,0,0,1.0,1,1.0,1,1.0,1,0.0790700093050221,81
3968,0,8043,2973,5070,0,0,0,1.0,1,1.0,1,1.0,1,0.09128309270669022,79
3969,3,8046,2976,5070,0,0,0,1.0,1,1.0,1,1.0,1,0.10528779516342889,79
3970,3,8049,2978,5071,0,0,0,1.0,1,1.0,1,1.0,1,0.1143845772927264,78
3971,0,8049,2978,5071,0,0,0,1.0,1,1.0,1,1.0,1,0.11535872316505813,77
3972,1,8050,2979,5071,0,0,0,1.0,1,1.0,1,1.0,1,0.12106715333474943,78
3973,2,8052,2979,5073,0,0,0,1.0,1,1.0,1,1.0,1,0.11374579668258279,77
3974,1,8053,2979,5074,0,0,0,1.0,1,1.0,1,1.0,1,0.10492454631107798,77
3975,3,8056,2981,5075,0,0,0,1.0,1,1.0,1,1.0,1,0.12426385579188817,76
3976,2,8058,2981,5077,0,0,0,1.0,1,1.0,1,1.0,1,0.11268560418979376,77
3977,0,8058,2981,5077,0,0,0,1.0,1,1.0,1,1.0,1,0.12072036527365189,78
3978,3,8061,2982,5079,0,0,0,1.0,1,1.0,1,1.0,1,0.14032779861192277,79
3979,3,8064,2982,5082,0,0,0,1.0,1,1.0,1,1.0,1,0.12603504167521307,79
3980,2,8066,2983,5083,0,0,0,1.0,1,1.0,1,1.0,1,0.11956773676828286,79
3981,3,8069,2984,5085,0,0,0,1.0,1,1.0,1,1.0,1,0.13541730543571923,83
3982,4,8073,2984,5089,0,0,0,1.0,1,1.0,1,1.0,1,0.10498320097959045,83
3983,2,8075,2984,5091,0,0,0,1.0,1,1.0,1,1.0,1,0.11470777541319488,82
3984,3,8078,2984,5094,0,0,0,1.0,1,1.0,1,1.0,1,0.10729125115964239,83
3985,6,8084,2986,5098,0,0,0,1.0,1,1.0,1,1.0,1,0.10335013179482679,84
3986,5,8089,2988,5101,0,0,0,1.0,1,1.0,1,1.0,1,0.11714821222101056,83
3987,1,8090,2988,5102,0,0,0,1.0,1,1.0,1,1.0,1,0.11601943523236356,82
3988,5,8095,2989,5106,0,0,0,1.0,1,1.0,1,1.0,1,0.10604911429342789,83
3989,0,8095,2989,5106,0,0,0,1.0,1,1.0,1,1.0,1,0.11774301772544402,81
3990,1,8096,2989,5107,0,0,0,1.0,1,1.0,1,1.0,1,0.10618053173742378,81
3991,3,8099,2990,5109,0,0,0,1.0,1,1.0,1,1.0,1,0.11451721905451703,79
3992,0,8099,2990,5109,0,0,0,1.0,1,1.0,1,1.0,1,0.1071731935698338,81
3993,2,8101,2991,5110,0,0,0,1.0,1,1.0,1,1.0,1,0.10298136522206396,80
3994,1,8102,2992,5110,0,0,0,1.0,1,1.0,1,1.0,1,0.10985161544979709,80
3995,1,8103,2993,5110,0,0,0,1.0,1,1.0,1,1.0,1,0.11384653551576866,81
3996,2,8105,2993,5112,0,0,0,1.0,1,1.0,1,1.0,1,0.12853544810710937,80
3997,2,8107,2994,5113,0,0,0,1.0,1,1.0,1,1.0,1,0.10699775286457999,81
3998,2,8109,2995,5114,0,0,0,1.0,1,1.0,1,1.0,1,0.09566787450520371,82
3999,3,8112,2995,5117,0,0,0,1.0,1,1.0,1,1.0,1,0.07902584875477692,82
4000,3,8115,2997,5118,0,0,0,1.0,1,1.0,1,1.0,1,0.08606702402892252,82
4001,1,8116,2998,5118,0,0,0,1.0,1,1.0,1,1.0,1,0.094044715522506,81
4002,2,8118,3000,5118,0,0,0,1.0,1,1.0,1,1.0,1,0.09039678280921336,81
4003,4,8122,3003,5119,0,0,0,1.0,1,1.0,1,1.0,1,0.11812611756548524,81
4004,4,8126,3005,5121,0,0,0,1.0,1,1.0,1,1.0,1,0.13401636922135912,80
4005,2,8128,3007,5121,0,0,0,1.0,1,1.0,1,1.0,1,0.1610994570562648,78
4006,3,8131,3008,5123,0,0,0,1.0,1,1.0,1,1.0,1,0.13025097482509704,76
4007,3,8134,3010,5124,0,0,0,1.0,1,1.0,1,1.0,1,0.14024116155736865,75
4008,1,8135,3010,5125,0,0,0,1.0,1,1.0,1,1.0,1,0.12091297174866003,74
4009,6,8141,3011,5130,0,0,0,1.0,1,1.0,1,1.0,1,0.09259044917142874,75
4010,3,8144,3012,5132,0,0,0,1.0,1,1.0,1,1.0,1,0.09307021055008767,75
4011,0,8144,3012,5132,0,0,0,1.0,1,1.0,1,1.0,1,0.10174792908114957,74
4012,6,8150,3013,5137,0,0,0,1.0,1,1.0,1,1.0,1,0.09155482655103751,74
4013,1,8151,3014,5137,0,0,0,1.0,1,1.0,1,1.0,1,0.11934726902854938,74
4014,1,8152,3015,5137,0,0,0,1.0,1,1.0,1,1.0,1,0.13599356829311154,73
4015,2,8154,3015,5139,0,0,0,1.0,1,1.0,1,1.0,1,0.12437147389181587,74
4016,1,8155,3015,5140,0,0,0,1.0,1,1.0,1,1.0,1,0.14378256275593404,74
4017,5,8160,3017,5143,0,0,0,1.0,1,1.0,1,1.0,1,0.1590645440525838,78
4018,9,8169,3018,5151,0,0,0,1.0,1,1.0,1,1.0,1,0.10887575410693276,78
4019,1,8170,3019,5151,0,0,0,1.0,1,1.0,1,1.0,1,0.10728227139103501,78
4020,0,8170,3019,5151,0,0,0,1.0,1,1.0,1,1.0,1,0.10728227139103501,78
4021,1,8171,3019,5152,0,0,0,1.0,1,1.0,1,1.0,1,0.10186927697708936,78
4022,4,8175,3021,5154,0,0,0,1.0,1,1.0,1,1.0,1,0.09605487589384092,79
4023,0,8175,3021,5154,0,0,0,1.0,1,1.0,1,1.0,1,0.09104886633749819,78
4024,0,8175,3021,5154,0,0,0,1.0,1,1.0,1,1.0,1,0.09194449755774012,77
4025,3,8178,3023,5155,0,0,0,1.0,1,1.0,1,1.0,1,0.1082394507390238,76
4026,1,8179,3023,5156,0,0,0,1.0,1,1.0,1,1.0,1,0.09497467590932918,76
4027,5,8184,3026,5158,0,0,0,1.0,1,1.0,1,1.0,1,0.1284085701042665,75
4028,3,8187,3027,5160,0,0,0,1.0,1,1.0,1,1.0,1,0.12220817390861557,76
4029,2,8189,3027,5162,0,0,0,1.0,1,1.0,1,1.0,1,0.11422233282976137,75
4030,4,8193,3028,5165,0,0,0,1.0,1,1.0,1,1.0,1,0.09246884494143909,74
4031,1,8194,3028,5166,0,0,0,1.0,1,1.0,1,1.0,1,0.08478666879144568,73
4032,0,8194,3028,5166,0,0,0,1.0,1,1.0,1,1.0,1,0.10224144918741128,71
4033,1,8195,3028,5167,0,0,0,1.0,1,1.0,1,1.0,1,0.09410770469594842,73
4034,6,8201,3031,5170,0,0,0,1.0,1,1.0,1,1.0,1,0.05729267084308958,72
4035,1,8202,3032,5170,0,0,0,1.0,1,1.0,1,1.0,1,0.06818720919388052,71
4036,3,8205,3033,5172,0,0,0,1.0,1,1.0,1,1.0,1,0.05526653027777004,71
4037,2,8207,3035,5172,0,0,0,1.0,1,1.0,1,1.0,1,0.08765445860540692,70
4038,2,8209,3036,5173,0,0,0,1.0,1,1.0,1,1.0,1,0.10974477972145544,69
4039,4,8213,3037,5176,0,0,0,1.0,1,1.0,1,1.0,1,0.11799780224635142,68
4040,2,8215,3037,5178,0,0,0,1.0,1,1.0,1,1.0,1,0.12261317789548559,69
4041,2,8217,3038,5179,0,0,0,1.0,1,1.0,1,1.0,1,0.15630255018174374,67
4042,3,8220,3038,5182,0,0,0,1.0,1,1.0,1,1.0,1,0.16046576135167512,67
4043,4,8224,3039,5185,0,0,0,1.0,1,1.0,1,1.0,1,0.17192394749593756,66
4044,4,8228,3041,5187,0,0,0,1.0,1,1.0,1,1.0,1,0.18985311523697815,65
4045,3,8231,3041,5190,0,0,0,1.0,1,1.0,1,1.0,1,0.16380098207141747,66
4046,2,8233,3042,5191,0,0,0,1.0,1,1.0,1,1.0,1,0.18820825271237934,68
4047,0,8233,3042,5191,0,0,0,1.0,1,1.0,1,1.0,1,0.18820825271237934,68
4048,2,8235,3042,5193,0,0,0,1.0,1,1.0,1,1.0,1,0.17300424169879547,69
4049,0,8235,3042,5193,0,0,0,1.0,1,1.0,1,1.0,1,0.17300424169879547,69
4050,0,8235,3042,5193,0,0,0,1.0,1,1.0,1,1.0,1,0.1715392121571681,69
4051,1,8236,3042,5194,0,0,0,1.0,1,1.0,1,1.0,1,0.1638703503312563,69
4052,2,8238,3042,5196,0,0,0,1.0,1,1.0,1,1.0,1,0.14960344586686905,69
4053,0,8238,3042,5196,0,0,0,1.0,1,1.0,1,1.0,1,0.14960344586686905,69
4054,1,8239,3043,5196,0,0,0,1.0,1,1.0,1,1.0,1,0.15667748368284531,70
4055,2,8241,3043,5198,0,0,0,1.0,1,1.0,1,1.0,1,0.1380280932464395,70
4056,1,8242,3043,5199,0,0,0,1.0,1,1.0,1,1.0,1,0.12840958757243442,70
4057,2,8244,3043,5201,0,0,0,1.0,1,1.0,1,1.0,1,0.12339507029065527,71
4058,0,8244,3043,5201,0,0,0,1.0,1,1.0,1,1.0,1,0.12339507029065527,71
4059,2,8246,3044,5202,0,0,0,1.0,1,1.0,1,1.0,1,0.13606552287413276,72
4060,1,8247,3044,5203,0,0,0,1.0,1,1.0,1,1.0,1,0.13542537097124552,71
4061,4,8251,3045,5206,0,0,0,1.0,1,1.0,1,1.0,1,0.11785489641192125,72
4062,0,8251,3045,5206,0,0,0,1.0,1,1.0,1,1.0,1,0.11785489641192125,72
4063,2,8253,3045,5208,0,0,0,1.0,1,1.0,1,1.0,1,0.11663092186133588,72
4064,6,8259,3050,5209,0,0,0,1.0,1,1.0,1,1.0,1,0.11418833228544528,71
4065,2,8261,3051,5210,0,0,0,1.0,1,1.0,1,1.0,1,0.1143403139022887,70
4066,7,8268,3053,5215,0,0,0,1.0,1,1.0,1,1.0,1,0.10617215712630611,70
4067,5,8273,3054,5219,0,0,0,1.0,1,1.0,1,1.0,1,0.08112150975082724,68
4068,5,8278,3056,5222,0,0,0,1.0,1,1.0,1,1.0,1,0.1380108459705642,70
4069,6,8284,3056,5228,0,0,0,1.0,1,1.0,1,1.0,1,0.06268719253726188,68
4070,1,8285,3057,5228,0,0,0,1.0,1,1.0,1,1.0,1,0.08468734026405483,67
4071,5,8290,3058,5232,0,0,0,1.0,1,1.0,1,1.0,1,0.11107394040154463,68
4072,4,8294,3060,5234,0,0,0,1.0,1,1.0,1,1.0,1,0.10425875452500746,70
4073,5,8299,3064,5235,0,0,0,1.0,1,1.0,1,1.0,1,0.1267563066458172,70
4074,6,8305,3067,5238,0,0,0,1.0,1,1.0,1,1.0,1,0.12103996242736634,71
4075,6,8311,3069,5242,0,0,0,1.0,1,1.0,1,1.0,1,0.11613575433492558,72
4076,3,8314,3070,5244,0,0,0,1.0,1,1.0,1,1.0,1,0.10159491430147423,73
4077,5,8319,3072,5247,0,0,0,1.0,1,1.0,1,1.0,1,0.1310734467058767,72
4078,3,8322,3073,5249,0,0,0,1.0,1,1.0,1,1.0,1,0.13289155980823555,71
4079,0,8322,3073,5249,0,0,0,1.0,1,1.0,1,1.0,1,0.13993714086811854,69
4080,2,8324,3074,5250,0,0,0,1.0,1,1.0,1,1.0,1,0.14173038310603533,67
4081,4,8328,3074,5254,0,0,0,1.0,1,1.0,1,1.0,1,0.11063455002540427,66
4082,0,8328,3074,5254,0,0,0,1.0,1,1.0,1,1.0,1,0.12692284796674333,65
4083,3,8331,3075,5256,0,0,0,1.0,1,1.0,1,1.0,1,0.141624158969781,64
4084,3,8334,3076,5258,0,0,0,1.0,1,1.0,1,1.0,1,0.13465918405698632,64
4085,3,8337,3077,5260,0,0,0,1.0,1,1.0,1,1.0,1,0.128226074140805,65
4086,2,8339,3078,5261,0,0,0,1.0,1,1.0,1,1.0,1,0.13053700749238176,66
4087,1,8340,3078,5262,0,0,0,1.0,1,1.0,1,1.0,1,0.1269094944979487,66
4088,0,8340,3078,5262,0,0,0,1.0,1,1.0,1,1.0,1,0.15602539413530986,65
4089,0,8340,3078,5262,0,0,0,1.0,1,1.0,1,1.0,1,0.15602539413530986,65
4090,2,8342,3078,5264,0,0,0,1.0,1,1.0,1,1.0,1,0.1401759797976821,65
4091,0,8342,3078,5264,0,0,0,1.0,1,1.0,1,1.0,1,0.1401759797976821,65
4092,1,8343,3078,5265,0,0,0,1.0,1,1.0,1,1.0,1,0.14730949812150831,64
4093,3,8346,3078,5268,0,0,0,1.0,1,1.0,1,1.0,1,0.12020121139169367,66
4094,1,8347,3079,5268,0,0,0,1.0,1,1.0,1,1.0,1,0.15125547580893187,65
4095,3,8350,3081,5269,0,0,0,1.0,1,1.0,1,1.0,1,0.14928760063455399,65
4096,3,8353,3081,5272,0,0,0,1.0,1,1.0,1,1.0,1,0.12358223705353695,67
4097,2,8355,3082,5273,0,0,0,1.0,1,1.0,1,1.0,1,0.10945328618846796,67
4098,3,8358,3085,5273,0,0,0,1.0,1,1.0,1,1.0,1,0.12346856467992579,68
4099,5,8363,3087,5276,0,0,0,1.0,1,1.0,1,1.0,1,0.10870389002243704,69
4100,4,8367,3088,5279,0,0,0,1.0,1,1.0,1,1.0,1,0.11988568617858548,70
4101,3,8370,3088,5282,0,0,0,1.0,1,1.0,1,1.0,1,0.12210889891428942,71
4102,1,8371,3088,5283,0,0,0,1.0,1,1.0,1,1.0,1,0.11314103336776635,71
4103,1,8372,3089,5283,0,0,0,1.0,1,1.0,1,1.0,1,0.12373510236252912,71
4104,2,8374,3091,5283,0,0,0,1.0,1,1.0,1,1.0,1,0.13504613038850688,69
4105,4,8378,3093,5285,0,0,0,1.0,1,1.0,1,1.0,1,0.15721166226564653,67
4106,3,8381,3094,5287,0,0,0,1.0,1,1.0,1,1.0,1,0.16861249677728438,68
4107,5,8386,3094,5292,0,0,0,1.0,1,1.0,1,1.0,1,0.12133960537375969,70
4108,0,8386,3094,5292,0,0,0,1.0,1,1.0,1,1.0,1,0.11937002055495885,70
4109,0,8386,3094,5292,0,0,0,1.0,1,1.0,1,1.0,1,0.1267408907325818,69
4110,0,8386,3094,5292,0,0,0,1.0,1,1.0,1,1.0,1,0.1041827912365845,71
4111,1,8387,3094,5293,0,0,0,1.0,1,1.0,1,1.0,1,0.10277461090723343,70
4112,1,8388,3094,5294,0,0,0,1.0,1,1.0,1,1.0,1,0.10290554359258933,72
4113,1,8389,3094,5295,0,0,0,1.0,1,1.0,1,1.0,1,0.09386581443001493,72
4114,6,8395,3096,5299,0,0,0,1.0,1,1.0,1,1.0,1,0.08879397066243731,72
4115,2,8397,3098,5299,0,0,0,1.0,1,1.0,1,1.0,1,0.09985793874961708,70
4116,0,8397,3098,5299,0,0,0,1.0,1,1.0,1,1.0,1,0.10013833410642722,67
4117,5,8402,3101,5301,0,0,0,1.0,1,1.0,1,1.0,1,0.11085264924366092,67
4118,2,8404,3101,5303,0,0,0,1.0,1,1.0,1,1.0,1,0.1345174578561737,66
4119,3,8407,3102,5305,0,0,0,1.0,1,1.0,1,1.0,1,0.16806654949224992,67
4120,7,8414,3104,5310,0,0,0,1.0,1,1.0,1,1.0,1,0.18542315700069076,64
4121,2,8416,3104,5312,0,0,0,1.0,1,1.0,1,1.0,1,0.1843376608233442,63
4122,5,8421,3105,5316,0,0,0,1.0,1,1.0,1,1.0,1,0.1632868022393176,63
4123,8,8429,3105,5324,0,0,0,1.0,1,1.0,1,1.0,1,0.14239522010684885,61
4124,1,8430,3106,5324,0,0,0,1.0,1,1.0,1,1.0,1,0.14684599950751304,62
4125,2,8432,3106,5326,0,0,0,1.0,1,1.0,1,1.0,1,0.13632482282807135,60
4126,2,8434,3106,5328,0,0,0,1.0,1,1.0,1,1.0,1,0.13421887701416504,59
4127,1,8435,3107,5328,0,0,0,1.0,1,1.0,1,1.0,1,0.1598201697839824,60
4128,1,8436,3107,5329,0,0,0,1.0,1,1.0,1,1.0,1,0.1462042821568142,60
4129,3,8439,3107,5332,0,0,0,1.0,1,1.0,1,1.0,1,0.14262836950487148,60
4130,3,8442,3110,5332,0,0,0,1.0,1,1.0,1,1.0,1,0.15529394547957545,61
4131,1,8443,3110,5333,0,0,0,1.0,1,1.0,1,1.0,1,0.1430371070069138,60
4132,3,8446,3111,5335,0,0,0,1.0,1,1.0,1,1.0,1,0.15336848842038492,60
4133,1,8447,3112,5335,0,0,0,1.0,1,1.0,1,1.0,1,0.1716711005553029,62
4134,2,8449,3113,5336,0,0,0,1.0,1,1.0,1,1.0,1,0.17523048877168315,63
4135,4,8453,3114,5339,0,0,0,1.0,1,1.0,1,1.0,1,0.13601135502239592,65
4136,1,8454,3114,5340,0,0,0,1.0,1,1.0,1,1.0,1,0.1303584367791866,65
4137,1,8455,3115,5340,0,0,0,1.0,1,1.0,1,1.0,1,0.14858353931065418,66
4138,3,8458,3116,5342,0,0,0,1.0,1,1.0,1,1.0,1,0.1336808872212365,67
4139,3,8461,3118,5343,0,0,0,1.0,1,1.0,1,1.0,1,0.16394485562811084,67
4140,3,8464,3118,5346,0,0,0,1.0,1,1.0,1,1.0,1,0.11597909005708465,66
4141,1,8465,3118,5347,0,0,0,1.0,1,1.0,1,1.0,1,0.11056893679858629,67
4142,0,8465,3118,5347,0,0,0,1.0,1,1.0,1,1.0,1,0.11056893679858629,67
4143,2,8467,3118,5349,0,0,0,1.0,1,1.0,1,1.0,1,0.0919940263969134,66
4144,0,8467,3118,5349,0,0,0,1.0,1,1.0,1,1.0,1,0.10492379666612607,64
4145,2,8469,3120,5349,0,0,0,1.0,1,1.0,1,1.0,1,0.11876966379518117,63
4146,3,8472,3122,5350,0,0,0,1.0,1,1.0,1,1.0,1,0.13325135548805384,62
4147,6,8478,3123,5355,0,0,0,1.0,1,1.0,1,1.0,1,0.11014778004751026,60
4148,6,8484,3127,5357,0,0,0,1.0,1,1.0,1,1.0,1,0.11118352385468569,62
4149,2,8486,3127,5359,0,0,0,1.0,1,1.0,1,1.0,1,0.10423910465754535,61
4150,5,8491,3128,5363,0,0,0,1.0,1,1.0,1,1.0,1,0.08938179211521198,60
4151,1,8492,3129,5363,0,0,0,1.0,1,1.0,1,1.0,1,0.1043391481660706,60
4152,1,8493,3130,5363,0,0,0,1.0,1,1.0,1,1.0,1,0.13027773929706937,60
4153,2,8495,3131,5364,0,0,0,1.0,1,1.0,1,1.0,1,0.14424273883973754,58
4154,4,8499,3131,5368,0,0,0,1.0,1,1.0,1,1.0,1,0.12874384956179666,57
4155,1,8500,3132,5368,0,0,0,1.0,1,1.0,1,1.0,1,0.13635655275753542,57
4156,4,8504,3132,5372,0,0,0,1.0,1,1.0,1,1.0,1,0.10843493125635638,58
4157,0,8504,3132,5372,0,0,0,1.0,1,1.0,1,1.0,1,0.11865681551113098,57
4158,1,8505,3133,5372,0,0,0,1.0,1,1.0,1,1.0,1,0.1578721319625724,55
4159,5,8510,3134,5376,0,0,0,1.0,1,1.0,1,1.0,1,0.13707982087192525,57
4160,1,8511,3134,5377,0,0,0,1.0,1,1.0,1,1.0,1,0.13628804175592255,58
4161,0,8511,3134,5377,0,0,0,1.0,1,1.0,1,1.0,1,0.13628804175592255,58
4162,2,8513,3135,5378,0,0,0,1.0,1,1.0,1,1.0,1,0.15806664374859747,57
4163,0,8513,3135,5378,0,0,0,1.0,1,1.0,1,1.0,1,0.15282647572989239,58
4164,5,8518,3138,5380,0,0,0,1.0,1,1.0,1,1.0,1,0.2043410946079849,56
4165,6,8524,3139,5385,0,0,0,1.0,1,1.0,1,1.0,1,0.18205201020802372,58
4166,0,8524,3139,5385,0,0,0,1.0,1,1.0,1,1.0,1,0.1718305433036842,57
4167,2,8526,3140,5386,0,0,0,1.0,1,1.0,1,1.0,1,0.17032267905253917,57
4168,1,8527,3140,5387,0,0,0,1.0,1,1.0,1,1.0,1,0.16322337239678883,58
4169,1,8528,3140,5388,0,0,0,1.0,1,1.0,1,1.0,1,0.1503201705539462,58
4170,1,8529,3141,5388,0,0,0,1.0,1,1.0,1,1.0,1,0.17360293461252144,58
4171,0,8529,3141,5388,0,0,0,1.0,1,1.0,1,1.0,1,0.19073318107884635,57
4172,3,8532,3141,5391,0,0,0,1.0,1,1.0,1,1.0,1,0.15093809345704762,57
4173,2,8534,3143,5391,0,0,0,1.0,1,1.0,1,1.0,1,0.20321576110308429,56
4174,3,8537,3144,5393,0,0,0,1.0,1,1.0,1,1.0,1,0.21127501999912218,56
4175,2,8539,3144,5395,0,0,0,1.0,1,1.0,1,1.0,1,0.18404509465945673,55
4176,1,8540,3144,5396,0,0,0,1.0,1,1.0,1,1.0,1,0.1752110189283328,57
4177,6,8546,3144,5402,0,0,0,1.0,1,1.0,1,1.0,1,0.1341505524242198,58
4178,5,8551,3146,5405,0,0,0,1.0,1,1.0,1,1.0,1,0.11398103798378467,60
4179,4,8555,3146,5409,0,0,0,1.0,1,1.0,1,1.0,1,0.11642209049638588,61
4180,0,8555,3146,5409,0,0,0,1.0,1,1.0,1,1.0,1,0.12474232636857532,62
4181,0,8555,3146,5409,0,0,0,1.0,1,1.0,1,1.0,1,0.12273609441499048,63
4182,1,8556,3147,5409,0,0,0,1.0,1,1.0,1,1.0,1,0.1209992445256586,63
4183,5,8561,3148,5413,0,0,0,1.0,1,1.0,1,1.0,1,0.09359497107709296,63
4184,4,8565,3149,5416,0,0,0,1.0,1,1.0,1,1.0,1,0.08652788820139709,63
4185,1,8566,3149,5417,0,0,0,1.0,1,1.0,1,1.0,1,0.07695438028619142,61
4186,4,8570,3151,5419,0,0,0,1.0,1,1.0,1,1.0,1,0.09051287646346991,62
4187,1,8571,3151,5420,0,0,0,1.0,1,1.0,1,1.0,1,0.09954815093838848,60
4188,0,8571,3151,5420,0,0,0,1.0,1,1.0,1,1.0,1,0.11776169477875513,60
4189,4,8575,3152,5423,0,0,0,1.0,1,1.0,1,1.0,1,0.07756944332667069,60
4190,1,8576,3153,5423,0,0,0,1.0,1,1.0,1,1.0,1,0.09711514391907067,61
4191,0,8576,3153,5423,0,0,0,1.0,1,1.0,1,1.0,1,0.06966266182325703,59
4192,2,8578,3154,5424,0,0,0,1.0,1,1.0,1,1.0,1,0.05199352401774592,58
4193,2,8580,3156,5424,0,0,0,1.0,1,1.0,1,1.0,1,0.08769974128806905,57
4194,1,8581,3157,5424,0,0,0,1.0,1,1.0,1,1.0,1,0.08672049417725515,54
4195,1,8582,3158,5424,0,0,0,1.0,1,1.0,1,1.0,1,0.10054397276736741,55
4196,3,8585,3160,5425,0,0,0,1.0,1,1.0,1,1.0,1,0.15360383988120954,56
4197,0,8585,3160,5425,0,0,0,1.0,1,1.0,1,1.0,1,0.14527512093798625,55
4198,2,8587,3161,5426,0,0,0,1.0,1,1.0,1,1.0,1,0.1900437525797252,56
4199,2,8589,3162,5427,0,0,0,1.0,1,1.0,1,1.0,1,0.20416416371893595,55
4200,0,8589,3162,5427,0,0,0,1.0,1,1.0,1,1.0,1,0.20404970550536897,55
4201,1,8590,3162,5428,0,0,0,1.0,1,1.0,1,1.0,1,0.1729548887955206,56
4202,0,8590,3162,5428,0,0,0,1.0,1,1.0,1,1.0,1,0.1729548887955206,56
4203,3,8593,3162,5431,0,0,0,1.0,1,1.0,1,1.0,1,0.15440896331921622,57
4204,2,8595,3163,5432,0,0,0,1.0,1,1.0,1,1.0,1,0.12455673669602566,57
4205,0,8595,3163,5432,0,0,0,1.0,1,1.0,1,1.0,1,0.12343289201689006,58
4206,2,8597,3164,5433,0,0,0,1.0,1,1.0,1,1.0,1,0.12228305275738158,58
4207,3,8600,3166,5434,0,0,0,1.0,1,1.0,1,1.0,1,0.10897077664082504,58
4208,1,8601,3167,5434,0,0,0,1.0,1,1.0,1,1.0,1,0.13304640454834749,60
4209,3,8604,3170,5434,0,0,0,1.0,1,1.0,1,1.0,1,0.1453225075455201,61
4210,4,8608,3170,5438,0,0,0,1.0,1,1.0,1,1.0,1,0.10926977105274178,62
4211,3,8611,3171,5440,0,0,0,1.0,1,1.0,1,1.0,1,0.12064893462553887,63
4212,1,8612,3171,5441,0,0,0,1.0,1,1.0,1,1.0,1,0.120485454533073,64
4213,4,8616,3171,5445,0,0,0,1.0,1,1.0,1,1.0,1,0.11488421970275937,65
4214,1,8617,3171,5446,0,0,0,1.0,1,1.0,1,1.0,1,0.10669748698858535,65
4215,0,8617,3171,5446,0,0,0,1.0,1,1.0,1,1.0,1,0.10669748698858535,65
4216,1,8618,3171,5447,0,0,0,1.0,1,1.0,1,1.0,1,0.1099962431623757,64
4217,3,8621,3172,5449,0,0,0,1.0,1,1.0,1,1.0,1,0.1163510691401462,65
4218,0,8621,3172,5449,0,0,0,1.0,1,1.0,1,1.0,1,0.1163510691401462,65
4219,2,8623,3173,5450,0,0,0,1.0,1,1.0,1,1.0,1,0.10718280663700908,65
4220,1,8624,3174,5450,0,0,0,1.0,1,1.0,1,1.0,1,0.12786121137647366,65
4221,2,8626,3175,5451,0,0,0,1.0,1,1.0,1,1.0,1,0.15679577796158042,67
4222,3,8629,3176,5453,0,0,0,1.0,1,1.0,1,1.0,1,0.14733591566159232,68
4223,3,8632,3177,5455,0,0,0,1.0,1,1.0,1,1.0,1,0.14472156471820993,68
4224,3,8635,3178,5457,0,0,0,1.0,1,1.0,1,1.0,1,0.1388539383626915,68
4225,0,8635,3178,5457,0,0,0,1.0,1,1.0,1,1.0,1,0.1332496002841081,66
4226,1,8636,3179,5457,0,0,0,1.0,1,1.0,1,1.0,1,0.15144690000516123,66
4227,1,8637,3180,5457,0,0,0,1.0,1,1.0,1,1.0,1,0.18121082422154886,66
4228,2,8639,3180,5459,0,0,0,1.0,1,1.0,1,1.0,1,0.16135909849141739,65
4229,2,8641,3181,5460,0,0,0,1.0,1,1.0,1,1.0,1,0.1570719237138761,65
4230,3,8644,3182,5462,0,0,0,1.0,1,1.0,1,1.0,1,0.1517567801043697,64
4231,0,8644,3182,5462,0,0,0,1.0,1,1.0,1,1.0,1,0.15489512624592897,64
4232,3,8647,3183,5464,0,0,0,1.0,1,1.0,1,1.0,1,0.12261445127763486,65
4233,0,8647,3183,5464,0,0,0,1.0,1,1.0,1,1.0,1,0.11208156016482514,64
4234,2,8649,3184,5465,0,0,0,1.0,1,1.0,1,1.0,1,0.10205350604235652,63
4235,1,8650,3185,5465,0,0,0,1.0,1,1.0,1,1.0,1,0.11578853073304952,63
4236,0,8650,3185,5465,0,0,0,1.0,1,1.0,1,1.0,1,0.11578853073304952,63
4237,4,8654,3186,5468,0,0,0,1.0,1,1.0,1,1.0,1,0.1026742161850128,65
4238,0,8654,3186,5468,0,0,0,1.0,1,1.0,1,1.0,1,0.1026742161850128,65
4239,0,8654,3186,5468,0,0,0,1.0,1,1.0,1,1.0,1,0.1026742161850128,65
4240,2,8656,3187,5469,0,0,0,1.0,1,1.0,1,1.0,1,0.0699531301161199,66
4241,0,8656,3187,5469,0,0,0,1.0,1,1.0,1,1.0,1,0.0699531301161199,66
4242,1,8657,3187,5470,0,0,0,1.0,1,1.0,1,1.0,1,0.06175823510323708,69
4243,1,8658,3187,5471,0,0,0,1.0,1,1.0,1,1.0,1,0.07106296519890153,71
4244,0,8658,3187,5471,0,0,0,1.0,1,1.0,1,1.0,1,0.07106296519890153,71
4245,1,8659,3187,5472,0,0,0,1.0,1,1.0,1,1.0,1,0.0648294700271701,73
4246,1,8660,3187,5473,0,0,0,1.0,1,1.0,1,1.0,1,0.05218209578679847,74
4247,0,8660,3187,5473,0,0,0,1.0,1,1.0,1,1.0,1,0.05218209578679847,74
4248,0,8660,3187,5473,0,0,0,1.0,1,1.0,1,1.0,1,0.05218209578679847,74
4249,0,8660,3187,5473,0,0,0,1.0,1,1.0,1,1.0,1,0.05218209578679847,74
4250,1,8661,3188,5473,0,0,0,1.0,1,1.0,1,1.0,1,0.068349216193044,74
4251,1,8662,3188,5474,0,0,0,1.0,1,1.0,1,1.0,1,0.06598919473367629,75
4252,5,8667,3193,5474,0,0,0,1.0,1,1.0,1,1.0,1,0.15454117871448297,75
4253,4,8671,3193,5478,0,0,0,1.0,1,1.0,1,1.0,1,0.13210382458890663,76
4254,2,8673,3195,5478,0,0,0,1.0,1,1.0,1,1.0,1,0.13449905263719203,75
4255,5,8678,3196,5482,0,0,0,1.0,1,1.0,1,1.0,1,0.11597304377260506,76
4256,0,8678,3196,5482,0,0,0,1.0,1,1.0,1,1.0,1,0.1163264240993901,78
4257,3,8681,3198,5483,0,0,0,1.0,1,1.0,1,1.0,1,0.13856171203214812,78
4258,3,8684,3198,5486,0,0,0,1.0,1,1.0,1,1.0,1,0.11835850781757523,77
4259,3,8687,3199,5488,0,0,0,1.0,1,1.0,1,1.0,1,0.10605429520164814,78
4260,1,8688,3199,5489,0,0,0,1.0,1,1.0,1,1.0,1,0.11297677952138148,77
4261,1,8689,3200,5489,0,0,0,1.0,1,1.0,1,1.0,1,0.12296793905308602,76
4262,4,8693,3200,5493,0,0,0,1.0,1,1.0,1,1.0,1,0.11515672974590738,75
4263,2,8695,3200,5495,0,0,0,1.0,1,1.0,1,1.0,1,0.10462924001990846,74
4264,3,8698,3200,5498,0,0,0,1.0,1,1.0,1,1.0,1,0.1252226107925023,74
4265,3,8701,3202,5499,0,0,0,1.0,1,1.0,1,1.0,1,0.10008181545256517,73
4266,1,8702,3203,5499,0,0,0,1.0,1,1.0,1,1.0,1,0.11278755232597878,71
4267,5,8707,3206,5501,0,0,0,1.0,1,1.0,1,1.0,1,0.1152679015951711,69
4268,1,8708,3206,5502,0,0,0,1.0,1,1.0,1,1.0,1,0.1291830010508753,67
4269,3,8711,3209,5502,0,0,0,1.0,1,1.0,1,1.0,1,0.16292187127818017,64
4270,5,8716,3211,5505,0,0,0,1.0,1,1.0,1,1.0,1,0.12479628567085298,63
4271,2,8718,3211,5507,0,0,0,1.0,1,1.0,1,1.0,1,0.12640388853269158,63
4272,3,8721,3213,5508,0,0,0,1.0,1,1.0,1,1.0,1,0.17957801759536765,62
4273,4,8725,3214,5511,0,0,0,1.0,1,1.0,1,1.0,1,0.15748810563809804,62
4274,1,8726,3214,5512,0,0,0,1.0,1,1.0,1,1.0,1,0.14789454420572423,62
4275,2,8728,3214,5514,0,0,0,1.0,1,1.0,1,1.0,1,0.13982515505949647,61
4276,3,8731,3214,5517,0,0,0,1.0,1,1.0,1,1.0,1,0.11626903129782591,62
4277,2,8733,3214,5519,0,0,0,1.0,1,1.0,1,1.0,1,0.11720919572256351,63
4278,0,8733,3214,5519,0,0,0,1.0,1,1.0,1,1.0,1,0.1075820202746602,64
4279,1,8734,3214,5520,0,0,0,1.0,1,1.0,1,1.0,1,0.1159438525361107,65
4280,0,8734,3214,5520,0,0,0,1.0,1,1.0,1,1.0,1,0.1159438525361107,65
4281,1,8735,3215,5520,0,0,0,1.0,1,1.0,1,1.0,1,0.11977482651420855,65
4282,5,8740,3218,5522,0,0,0,1.0,1,1.0,1,1.0,1,0.15553162961262812,66
4283,4,8744,3220,5524,0,0,0,1.0,1,1.0,1,1.0,1,0.18982902916160743,66
4284,1,8745,3221,5524,0,0,0,1.0,1,1.0,1,1.0,1,0.21429532481667318,66
4285,4,8749,3221,5528,0,0,0,1.0,1,1.0,1,1.0,1,0.17889628264090335,67
4286,2,8751,3221,5530,0,0,0,1.0,1,1.0,1,1.0,1,0.1837905385131946,67
4287,2,8753,3221,5532,0,0,0,1.0,1,1.0,1,1.0,1,0.17775108124535138,67
4288,5,8758,3221,5537,0,0,0,1.0,1,1.0,1,1.0,1,0.12578784143623778,68
4289,0,8758,3221,5537,0,0,0,1.0,1,1.0,1,1.0,1,0.12651045707752445,68
4290,0,8758,3221,5537,0,0,0,1.0,1,1.0,1,1.0,1,0.14115451158778297,70
4291,3,8761,3222,5539,0,0,0,1.0,1,1.0,1,1.0,1,0.140440554496413,71
4292,0,8761,3222,5539,0,0,0,1.0,1,1.0,1,1.0,1,0.140440554496413,71
4293,1,8762,3222,5540,0,0,0,1.0,1,1.0,1,1.0,1,0.12976649316546243,71
4294,1,8763,3223,5540,0,0,0,1.0,1,1.0,1,1.0,1,0.13500333919293792,71
4295,2,8765,3224,5541,0,0,0,1.0,1,1.0,1,1.0,1,0.15193052574875024,72
4296,1,8766,3225,5541,0,0,0,1.0,1,1.0,1,1.0,1,0.16051823112684072,73
4297,3,8769,3225,5544,0,0,0,1.0,1,1.0,1,1.0,1,0.1389247210809897,73
4298,3,8772,3226,5546,0,0,0,1.0,1,1.0,1,1.0,1,0.14250729316578328,74
4299,0,8772,3226,5546,0,0,0,1.0,1,1.0,1,1.0,1,0.12704717168802804,75
4300,3,8775,3226,5549,0,0,0,1.0,1,1.0,1,1.0,1,0.10159351104238151,75
4301,0,8775,3226,5549,0,0,0,1.0,1,1.0,1,1.0,1,0.09637379303756073,76
4302,0,8775,3226,5549,0,0,0,1.0,1,1.0,1,1.0,1,0.09637379303756073,76
4303,2,8777,3226,5551,0,0,0,1.0,1,1.0,1,1.0,1,0.08988866848097048,75
4304,3,8780,3228,5552,0,0,0,1.0,1,1.0,1,1.0,1,0.10047175173537118,75
4305,1,8781,3229,5552,0,0,0,1.0,1,1.0,1,1.0,1,0.118040387629398,73
4306,4,8785,3231,5554,0,0,0,1.0,1,1.0,1,1.0,1,0.13935103057167106,74
4307,5,8790,3232,5558,0,0,0,1.0,1,1.0,1,1.0,1,0.1090515201242697,73
4308,2,8792,3232,5560,0,0,0,1.0,1,1.0,1,1.0,1,0.12951543145305122,71
4309,3,8795,3233,5562,0,0,0,1.0,1,1.0,1,1.0,1,0.13107680018481532,70
4310,1,8796,3234,5562,0,0,0,1.0,1,1.0,1,1.0,1,0.1257762842212077,69
4311,3,8799,3235,5564,0,0,0,1.0,1,1.0,1,1.0,1,0.12122671847147908,69
4312,3,8802,3236,5566,0,0,0,1.0,1,1.0,1,1.0,1,0.14135437102417184,66
4313,2,8804,3238,5566,0,0,0,1.0,1,1.0,1,1.0,1,0.15821059306687948,64
4314,1,8805,3238,5567,0,0,0,1.0,1,1.0,1,1.0,1,0.19415886897279352,61
4315,6,8811,3241,5570,0,0,0,1.0,1,1.0,1,1.0,1,0.15359100690700014,61
4316,2,8813,3242,5571,0,0,0,1.0,1,1.0,1,1.0,1,0.09392727969685273,60
4317,0,8813,3242,5571,0,0,0,1.0,1,1.0,1,1.0,1,0.10387779235503469,62
4318,2,8815,3244,5571,0,0,0,1.0,1,1.0,1,1.0,1,0.14672685858353177,59
4319,0,8815,3244,5571,0,0,0,1.0,1,1.0,1,1.0,1,0.13719083965423656,60
4320,1,8816,3244,5572,0,0,0,1.0,1,1.0,1,1.0,1,0.1269136210069242,60
4321,2,8818,3245,5573,0,0,0,1.0,1,1.0,1,1.0,1,0.13277316511797027,61
4322,1,8819,3246,5573,0,0,0,1.0,1,1.0,1,1.0,1,0.14071431857290026,61
4323,1,8820,3247,5573,0,0,0,1.0,1,1.0,1,1.0,1,0.1523962550954935,61
4324,2,8822,3248,5574,0,0,0,1.0,1,1.0,1,1.0,1,0.16583857525098694,60
4325,2,8824,3249,5575,0,0,0,1.0,1,1.0,1,1.0,1,0.1762233082046893,60
4326,2,8826,3250,5576,0,0,0,1.0,1,1.0,1,1.0,1,0.17516880221375566,61
4327,2,8828,3250,5578,0,0,0,1.0,1,1.0,1,1.0,1,0.15125863830887845,62
4328,2,8830,3250,5580,0,0,0,1.0,1,1.0,1,1.0,1,0.1381026289114204,62
4329,6,8836,3251,5585,0,0,0,1.0,1,1.0,1,1.0,1,0.12655914369856483,65
4330,1,8837,3251,5586,0,0,0,1.0,1,1.0,1,1.0,1,0.1226742692768706,65
4331,0,8837,3251,5586,0,0,0,1.0,1,1.0,1,1.0,1,0.1226742692768706,65
4332,4,8841,3252,5589,0,0,0,1.0,1,1.0,1,1.0,1,0.13681958502236524,66
4333,2,8843,3252,5591,0,0,0,1.0,1,1.0,1,1.0,1,0.11540192865089864,66
4334,2,8845,3253,5592,0,0,0,1.0,1,1.0,1,1.0,1,0.1234814370760836,66
4335,0,8845,3253,5592,0,0,0,1.0,1,1.0,1,1.0,1,0.13493967695565295,65
4336,3,8848,3255,5593,0,0,0,1.0,1,1.0,1,1.0,1,0.13943263198752193,67
4337,6,8854,3255,5599,0,0,0,1.0,1,1.0,1,1.0,1,0.1670993496902643,69
4338,4,8858,3256,5602,0,0,0,1.0,1,1.0,1,1.0,1,0.1667489425365355,70
4339,5,8863,3256,5607,0,0,0,1.0,1,1.0,1,1.0,1,0.13384925785609628,70
4340,1,8864,3256,5608,0,0,0,1.0,1,1.0,1,1.0,1,0.14222591204170068,71
4341,4,8868,3258,5610,0,0,0,1.0,1,1.0,1,1.0,1,0.1700925677589584,70
4342,3,8871,3258,5613,0,0,0,1.0,1,1.0,1,1.0,1,0.15808948001966344,71
4343,4,8875,3261,5614,0,0,0,1.0,1,1.0,1,1.0,1,0.1707103312240743,67
4344,5,8880,3264,5616,0,0,0,1.0,1,1.0,1,1.0,1,0.19134598023118526,67
4345,10,8890,3268,5622,0,0,0,1.0,1,1.0,1,1.0,1,0.15181736082043953,64
4346,4,8894,3272,5622,0,0,0,1.0,1,1.0,1,1.0,1,0.1752613839333759,64
4347,6,8900,3276,5624,0,0,0,1.0,1,1.0,1,1.0,1,0.2152802532383902,62
4348,6,8906,3277,5629,0,0,0,1.0,1,1.0,1,1.0,1,0.18851808087454042,62
4349,4,8910,3278,5632,0,0,0,1.0,1,1.0,1,1.0,1,0.19985272854101377,61
4350,2,8912,3279,5633,0,0,0,1.0,1,1.0,1,1.0,1,0.21207670013323512,60
4351,2,8914,3280,5634,0,0,0,1.0,1,1.0,1,1.0,1,0.18962924349152854,60
4352,1,8915,3280,5635,0,0,0,1.0,1,1.0,1,1.0,1,0.2139354778066416,57
4353,1,8916,3280,5636,0,0,0,1.0,1,1.0,1,1.0,1,0.22026543560295153,55
4354,3,8919,3280,5639,0,0,0,1.0,1,1.0,1,1.0,1,0.1661796677881758,55
4355,3,8922,3281,5641,0,0,0,1.0,1,1.0,1,1.0,1,0.15312019599760276,53
4356,0,8922,3281,5641,0,0,0,1.0,1,1.0,1,1.0,1,0.12383442701450136,55
4357,3,8925,3283,5642,0,0,0,1.0,1,1.0,1,1.0,1,0.13434637869404809,55
4358,1,8926,3284,5642,0,0,0,1.0,1,1.0,1,1.0,1,0.1473148377688556,55
4359,1,8927,3284,5643,0,0,0,1.0,1,1.0,1,1.0,1,0.12773601539505275,54
4360,2,8929,3284,5645,0,0,0,1.0,1,1.0,1,1.0,1,0.10113094728535384,55
4361,1,8930,3285,5645,0,0,0,1.0,1,1.0,1,1.0,1,0.11830024332938349,54
4362,0,8930,3285,5645,0,0,0,1.0,1,1.0,1,1.0,1,0.11909744400047995,55
4363,3,8933,3287,5646,0,0,0,1.0,1,1.0,1,1.0,1,0.1438375640303131,55
4364,2,8935,3288,5647,0,0,0,1.0,1,1.0,1,1.0,1,0.14244630074345063,55
4365,2,8937,3288,5649,0,0,0,1.0,1,1.0,1,1.0,1,0.14597288020175891,54
4366,4,8941,3289,5652,0,0,0,1.0,1,1.0,1,1.0,1,0.132494711012273,54
4367,1,8942,3290,5652,0,0,0,1.0,1,1.0,1,1.0,1,0.13557884711730744,57
4368,1,8943,3290,5653,0,0,0,1.0,1,1.0,1,1.0,1,0.1674555340847766,57
4369,2,8945,3290,5655,0,0,0,1.0,1,1.0,1,1.0,1,0.13631506025812887,58
4370,1,8946,3290,5656,0,0,0,1.0,1,1.0,1,1.0,1,0.13643038029174367,59
4371,2,8948,3290,5658,0,0,0,1.0,1,1.0,1,1.0,1,0.11480658200956806,60
4372,3,8951,3291,5660,0,0,0,1.0,1,1.0,1,1.0,1,0.11709398969082037,60
4373,2,8953,3291,5662,0,0,0,1.0,1,1.0,1,1.0,1,0.09529676981176316,60
4374,0,8953,3291,5662,0,0,0,1.0,1,1.0,1,1.0,1,0.11059058413622436,59
4375,1,8954,3291,5663,0,0,0,1.0,1,1.0,1,1.0,1,0.11344729570570065,60
4376,0,8954,3291,5663,0,0,0,1.0,1,1.0,1,1.0,1,0.12844975670569247,60
4377,3,8957,3293,5664,0,0,0,1.0,1,1.0,1,1.0,1,0.16985103310618946,61
4378,2,8959,3294,5665,0,0,0,1.0,1,1.0,1,1.0,1,0.17731967244606775,64
4379,1,8960,3295,5665,0,0,0,1.0,1,1.0,1,1.0,1,0.19518037828658177,64
4380,3,8963,3296,5667,0,0,0,1.0,1,1.0,1,1.0,1,0.18910522521176779,65
4381,2,8965,3296,5669,0,0,0,1.0,1,1.0,1,1.0,1,0.18738063104783825,64
4382,3,8968,3297,5671,0,0,0,1.0,1,1.0,1,1.0,1,0.18929629827425204,64
4383,4,8972,3299,5673,0,0,0,1.0,1,1.0,1,1.0,1,0.2090353394817857,64
4384,9,8981,3302,5679,0,0,0,1.0,1,1.0,1,1.0,1,0.22766503935507768,60
4385,3,8984,3303,5681,0,0,0,1.0,1,1.0,1,1.0,1,0.21005151805404113,58
4386,2,8986,3305,5681,0,0,0,1.0,1,1.0,1,1.0,1,0.21565012578288725,58
4387,3,8989,3305,5684,0,0,0,1.0,1,1.0,1,1.0,1,0.1667589070903285,55
4388,2,8991,3307,5684,0,0,0,1.0,1,1.0,1,1.0,1,0.1559696045641488,56
4389,1,8992,3307,5685,0,0,0,1.0,1,1.0,1,1.0,1,0.13588264921882495,55
4390,3,8995,3308,5687,0,0,0,1.0,1,1.0,1,1.0,1,0.13808241447130212,55
4391,3,8998,3310,5688,0,0,0,1.0,1,1.0,1,1.0,1,0.12877591441491792,56
4392,2,9000,3310,5690,0,0,0,1.0,1,1.0,1,1.0,1,0.12170554815557558,56
4393,2,9002,3311,5691,0,0,0,1.0,1,1.0,1,1.0,1,0.14973430948952848,55
4394,1,9003,3312,5691,0,0,0,1.0,1,1.0,1,1.0,1,0.1541657169224131,53
4395,1,9004,3313,5691,0,0,0,1.0,1,1.0,1,1.0,1,0.17049272572767124,53
4396,3,9007,3315,5692,0,0,0,1.0,1,1.0,1,1.0,1,0.16265677589702826,53
4397,1,9008,3316,5692,0,0,0,1.0,1,1.0,1,1.0,1,0.19971196972131913,50
4398,1,9009,3317,5692,0,0,0,1.0,1,1.0,1,1.0,1,0.23158525018414267,50
4399,0,9009,3317,5692,0,0,0,1.0,1,1.0,1,1.0,1,0.2255676525445943,52
4400,3,9012,3317,5695,0,0,0,1.0,1,1.0,1,1.0,1,0.1991912497808012,55
4401,1,9013,3317,5696,0,0,0,1.0,1,1.0,1,1.0,1,0.18682232435117274,56
4402,2,9015,3318,5697,0,0,0,1.0,1,1.0,1,1.0,1,0.19257024888850768,56
4403,2,9017,3320,5697,0,0,0,1.0,1,1.0,1,1.0,1,0.1929067022821094,57
4404,0,9017,3320,5697,0,0,0,1.0,1,1.0,1,1.0,1,0.1929067022821094,57
4405,3,9020,3320,5700,0,0,0,1.0,1,1.0,1,1.0,1,0.1423282284410979,58
4406,0,9020,3320,5700,0,0,0,1.0,1,1.0,1,1.0,1,0.1423282284410979,58
4407,0,9020,3320,5700,0,0,0,1.0,1,1.0,1,1.0,1,0.1423282284410979,58
4408,0,9020,3320,5700,0,0,0,1.0,1,1.0,1,1.0,1,0.14901199083319566,59
4409,0,9020,3320,5700,0,0,0,1.0,1,1.0,1,1.0,1,0.14901199083319566,59
4410,0,9020,3320,5700,0,0,0,1.0,1,1.0,1,1.0,1,0.14901199083319566,59
4411,2,9022,3320,5702,0,0,0,1.0,1,1.0,1,1.0,1,0.12691098309090956,62
4412,0,9022,3320,5702,0,0,0,1.0,1,1.0,1,1.0,1,0.1274736332869792,63
4413,1,9023,3321,5702,0,0,0,1.0,1,1.0,1,1.0,1,0.13308853917358512,63
4414,2,9025,3321,5704,0,0,0,1.0,1,1.0,1,1.0,1,0.11904327621932088,64
4415,3,9028,3322,5706,0,0,0,1.0,1,1.0,1,1.0,1,0.1233536506118459,64
4416,2,9030,3322,5708,0,0,0,1.0,1,1.0,1,1.0,1,0.10273252498925411,64
4417,0,9030,3322,5708,0,0,0,1.0,1,1.0,1,1.0,1,0.11193444345373063,65
4418,1,9031,3323,5708,0,0,0,1.0,1,1.0,1,1.0,1,0.12307967600126168,65
4419,3,9034,3323,5711,0,0,0,1.0,1,1.0,1,1.0,1,0.12693024463349994,62
4420,2,9036,3323,5713,0,0,0,1.0,1,1.0,1,1.0,1,0.10692282390821774,62
4421,2,9038,3323,5715,0,0,0,1.0,1,1.0,1,1.0,1,0.10488696007334165,65
4422,5,9043,3325,5718,0,0,0,1.0,1,1.0,1,1.0,1,0.1171126504763761,64
4423,2,9045,3326,5719,0,0,0,1.0,1,1.0,1,1.0,1,0.09677815644828835,63
4424,3,9048,3327,5721,0,0,0,1.0,1,1.0,1,1.0,1,0.0830844900035133,63
4425,3,9051,3328,5723,0,0,0,1.0,1,1.0,1,1.0,1,0.08713058110814226,63
4426,2,9053,3330,5723,0,0,0,1.0,1,1.0,1,1.0,1,0.08421904663988043,63
4427,0,9053,3330,5723,0,0,0,1.0,1,1.0,1,1.0,1,0.0787764504429192,62
4428,0,9053,3330,5723,0,0,0,1.0,1,1.0,1,1.0,1,0.0762074634888724,61
4429,4,9057,3334,5723,0,0,0,1.0,1,1.0,1,1.0,1,0.13607528194448498,62
4430,2,9059,3335,5724,0,0,0,1.0,1,1.0,1,1.0,1,0.12429985681737765,60
4431,2,9061,3336,5725,0,0,0,1.0,1,1.0,1,1.0,1,0.11682684016682172,59
4432,7,9068,3337,5731,0,0,0,1.0,1,1.0,1,1.0,1,0.08711917915870217,60
4433,6,9074,3340,5734,0,0,0,1.0,1,1.0,1,1.0,1,0.0899629334368804,61
4434,3,9077,3341,5736,0,0,0,1.0,1,1.0,1,1.0,1,0.09271299868700658,61
4435,3,9080,3342,5738,0,0,0,1.0,1,1.0,1,1.0,1,0.08152785123285237,61
4436,0,9080,3342,5738,0,0,0,1.0,1,1.0,1,1.0,1,0.08152785123285237,61
4437,4,9084,3344,5740,0,0,0,1.0,1,1.0,1,1.0,1,0.10285212828993294,61
4438,3,9087,3344,5743,0,0,0,1.0,1,1.0,1,1.0,1,0.05019682432009045,62
4439,0,9087,3344,5743,0,0,0,1.0,1,1.0,1,1.0,1,0.06552544017925807,63
4440,2,9089,3345,5744,0,0,0,1.0,1,1.0,1,1.0,1,0.06616086034362374,64
4441,2,9091,3346,5745,0,0,0,1.0,1,1.0,1,1.0,1,0.06322929660881096,64
4442,5,9096,3349,5747,0,0,0,1.0,1,1.0,1,1.0,1,0.12357587020668946,67
4443,2,9098,3351,5747,0,0,0,1.0,1,1.0,1,1.0,1,0.13416682508984432,68
4444,2,9100,3351,5749,0,0,0,1.0,1,1.0,1,1.0,1,0.12357090030253129,69
4445,4,9104,3352,5752,0,0,0,1.0,1,1.0,1,1.0,1,0.12514144397745453,71
4446,0,9104,3352,5752,0,0,0,1.0,1,1.0,1,1.0,1,0.12514144397745453,71
4447,5,9109,3352,5757,0,0,0,1.0,1,1.0,1,1.0,1,0.10203870635968032,72
4448,2,9111,3352,5759,0,0,0,1.0,1,1.0,1,1.0,1,0.11083112133745791,71
4449,3,9114,3353,5761,0,0,0,1.0,1,1.0,1,1.0,1,0.10884948719862605,70
4450,3,9117,3353,5764,0,0,0,1.0,1,1.0,1,1.0,1,0.10585122838718601,69
4451,1,9118,3353,5765,0,0,0,1.0,1,1.0,1,1.0,1,0.09038361720610696,69
4452,3,9121,3353,5768,0,0,0,1.0,1,1.0,1,1.0,1,0.08708129050380543,70
4453,1,9122,3353,5769,0,0,0,1.0,1,1.0,1,1.0,1,0.09625620734005277,70
4454,5,9127,3355,5772,0,0,0,1.0,1,1.0,1,1.0,1,0.10678983519271179,71
4455,2,9129,3355,5774,0,0,0,1.0,1,1.0,1,1.0,1,0.09597740952300483,71
4456,4,9133,3358,5775,0,0,0,1.0,1,1.0,1,1.0,1,0.11221324506702487,71
4457,1,9134,3358,5776,0,0,0,1.0,1,1.0,1,1.0,1,0.09614828336075198,69
4458,3,9137,3360,5777,0,0,0,1.0,1,1.0,1,1.0,1,0.10561248518511222,70
4459,2,9139,3361,5778,0,0,0,1.0,1,1.0,1,1.0,1,0.09819421032202388,68
4460,2,9141,3363,5778,0,0,0,1.0,1,1.0,1,1.0,1,0.10882703067169923,68
4461,2,9143,3364,5779,0,0,0,1.0,1,1.0,1,1.0,1,0.0867776517476105,67
4462,3,9146,3366,5780,0,0,0,1.0,1,1.0,1,1.0,1,0.10636854325188952,66
4463,3,9149,3369,5780,0,0,0,1.0,1,1.0,1,1.0,1,0.14763310125589738,65
4464,4,9153,3372,5781,0,0,0,1.0,1,1.0,1,1.0,1,0.1740550245648865,62
4465,11,9164,3376,5788,0,0,0,1.0,1,1.0,1,1.0,1,0.1455327312091565,61
4466,2,9166,3377,5789,0,0,0,1.0,1,1.0,1,1.0,1,0.1566798445795028,60
4467,3,9169,3379,5790,0,0,0,1.0,1,1.0,1,1.0,1,0.14988636643374723,58
4468,4,9173,3380,5793,0,0,0,1.0,1,1.0,1,1.0,1,0.11923018125554442,57
4469,0,9173,3380,5793,0,0,0,1.0,1,1.0,1,1.0,1,0.12798415879296493,56
4470,3,9176,3382,5794,0,0,0,1.0,1,1.0,1,1.0,1,0.13633431772694948,55
4471,3,9179,3383,5796,0,0,0,1.0,1,1.0,1,1.0,1,0.1207737969359632,55
4472,2,9181,3385,5796,0,0,0,1.0,1,1.0,1,1.0,1,0.12873872489043992,55
4473,3,9184,3387,5797,0,0,0,1.0,1,1.0,1,1.0,1,0.15201249569527328,55
4474,4,9188,3388,5800,0,0,0,1.0,1,1.0,1,1.0,1,0.12766491622493006,55
4475,2,9190,3388,5802,0,0,0,1.0,1,1.0,1,1.0,1,0.06555023161228879,56
4476,1,9191,3389,5802,0,0,0,1.0,1,1.0,1,1.0,1,0.06391518681564558,56
4477,1,9192,3389,5803,0,0,0,1.0,1,1.0,1,1.0,1,0.06264592617410181,57
4478,0,9192,3389,5803,0,0,0,1.0,1,1.0,1,1.0,1,0.06550368007208697,55
4479,1,9193,3390,5803,0,0,0,1.0,1,1.0,1,1.0,1,0.07750788783970854,55
4480,1,9194,3391,5803,0,0,0,1.0,1,1.0,1,1.0,1,0.09843851581841713,54
4481,2,9196,3391,5805,0,0,0,1.0,1,1.0,1,1.0,1,0.12308553011906487,53
4482,1,9197,3392,5805,0,0,0,1.0,1,1.0,1,1.0,1,0.14276728813983086,54
4483,4,9201,3392,5809,0,0,0,1.0,1,1.0,1,1.0,1,0.08807429716580838,55
4484,2,9203,3393,5810,0,0,0,1.0,1,1.0,1,1.0,1,0.11269952839811014,57
4485,4,9207,3395,5812,0,0,0,1.0,1,1.0,1,1.0,1,0.0862891338162428,60
4486,2,9209,3397,5812,0,0,0,1.0,1,1.0,1,1.0,1,0.08405670941569128,60
4487,1,9210,3397,5813,0,0,0,1.0,1,1.0,1,1.0,1,0.07379893268848624,60
4488,0,9210,3397,5813,0,0,0,1.0,1,1.0,1,1.0,1,0.07379893268848624,60
4489,1,9211,3398,5813,0,0,0,1.0,1,1.0,1,1.0,1,0.091062405293855,60
4490,0,9211,3398,5813,0,0,0,1.0,1,1.0,1,1.0,1,0.091062405293855,60
4491,1,9212,3399,5813,0,0,0,1.0,1,1.0,1,1.0,1,0.10506925048552133,61
4492,2,9214,3400,5814,0,0,0,1.0,1,1.0,1,1.0,1,0.0874150152047067,61
4493,2,9216,3402,5814,0,0,0,1.0,1,1.0,1,1.0,1,0.14112313900278384,60
4494,1,9217,3402,5815,0,0,0,1.0,1,1.0,1,1.0,1,0.13697522436384976,61
4495,5,9222,3402,5820,0,0,0,1.0,1,1.0,1,1.0,1,0.11076166447477734,59
4496,1,9223,3403,5820,0,0,0,1.0,1,1.0,1,1.0,1,0.14280471935593375,60
4497,0,9223,3403,5820,0,0,0,1.0,1,1.0,1,1.0,1,0.1506860741498016,59
4498,5,9228,3403,5825,0,0,0,1.0,1,1.0,1,1.0,1,0.10915928028847358,57
4499,2,9230,3405,5825,0,0,0,1.0,1,1.0,1,1.0,1,0.13368068902179697,58
4500,1,9231,3406,5825,0,0,0,1.0,1,1.0,1,1.0,1,0.15126894931268214,56
4501,5,9236,3408,5828,0,0,0,1.0,1,1.0,1,1.0,1,0.13402269533408173,57
4502,5,9241,3410,5831,0,0,0,1.0,1,1.0,1,1.0,1,0.10265248774418206,56
4503,1,9242,3411,5831,0,0,0,1.0,1,1.0,1,1.0,1,0.11564867548138559,54
4504,0,9242,3411,5831,0,0,0,1.0,1,1.0,1,1.0,1,0.09168971205427834,54
4505,2,9244,3413,5831,0,0,0,1.0,1,1.0,1,1.0,1,0.12444758010594183,51
4506,1,9245,3414,5831,0,0,0,1.0,1,1.0,1,1.0,1,0.1388576097417294,49
4507,2,9247,3415,5832,0,0,0,1.0,1,1.0,1,1.0,1,0.1708977023114857,48
4508,2,9249,3415,5834,0,0,0,1.0,1,1.0,1,1.0,1,0.1794441946635672,48
4509,3,9252,3417,5835,0,0,0,1.0,1,1.0,1,1.0,1,0.18388855340295196,46
4510,6,9258,3417,5841,0,0,0,1.0,1,1.0,1,1.0,1,0.09774299735007842,44
4511,1,9259,3417,5842,0,0,0,1.0,1,1.0,1,1.0,1,0.12018119546385579,45
4512,1,9260,3418,5842,0,0,0,1.0,1,1.0,1,1.0,1,0.12321640108843197,46
4513,1,9261,3418,5843,0,0,0,1.0,1,1.0,1,1.0,1,0.1127728161995489,45
4514,1,9262,3419,5843,0,0,0,1.0,1,1.0,1,1.0,1,0.12273145100507207,46
4515,1,9263,3419,5844,0,0,0,1.0,1,1.0,1,1.0,1,0.12495296608078105,48
4516,1,9264,3419,5845,0,0,0,1.0,1,1.0,1,1.0,1,0.13329583574076845,49
4517,0,9264,3419,5845,0,0,0,1.0,1,1.0,1,1.0,1,0.13645773296907168,50
4518,1,9265,3420,5845,0,0,0,1.0,1,1.0,1,1.0,1,0.14020376542817584,50
4519,3,9268,3422,5846,0,0,0,1.0,1,1.0,1,1.0,1,0.15182697202725687,49
4520,0,9268,3422,5846,0,0,0,1.0,1,1.0,1,1.0,1,0.16437721566255498,50
4521,1,9269,3422,5847,0,0,0,1.0,1,1.0,1,1.0,1,0.15807903325920297,50
4522,4,9273,3422,5851,0,0,0,1.0,1,1.0,1,1.0,1,0.13765605372580048,50
4523,2,9275,3423,5852,0,0,0,1.0,1,1.0,1,1.0,1,0.14436525331083386,51
4524,2,9277,3424,5853,0,0,0,1.0,1,1.0,1,1.0,1,0.15562645981451761,52
4525,4,9281,3425,5856,0,0,0,1.0,1,1.0,1,1.0,1,0.1297872690307704,53
4526,2,9283,3425,5858,0,0,0,1.0,1,1.0,1,1.0,1,0.07884298586091094,54
4527,1,9284,3425,5859,0,0,0,1.0,1,1.0,1,1.0,1,0.08920228531770033,55
4528,1,9285,3425,5860,0,0,0,1.0,1,1.0,1,1.0,1,0.0680963273855504,55
4529,0,9285,3425,5860,0,0,0,1.0,1,1.0,1,1.0,1,0.09468502333944805,55
4530,1,9286,3425,5861,0,0,0,1.0,1,1.0,1,1.0,1,0.07346369360703947,56
4531,5,9291,3429,5862,0,0,0,1.0,1,1.0,1,1.0,1,0.11821268134724373,56
4532,0,9291,3429,5862,0,0,0,1.0,1,1.0,1,1.0,1,0.14068384744736043,55
4533,1,9292,3430,5862,0,0,0,1.0,1,1.0,1,1.0,1,0.16075631531696732,54
4534,1,9293,3430,5863,0,0,0,1.0,1,1.0,1,1.0,1,0.14928475404340483,55
4535,3,9296,3431,5865,0,0,0,1.0,1,1.0,1,1.0,1,0.14015957979823124,52
4536,4,9300,3433,5867,0,0,0,1.0,1,1.0,1,1.0,1,0.13853014167116862,53
4537,2,9302,3434,5868,0,0,0,1.0,1,1.0,1,1.0,1,0.1468879221011262,52
4538,1,9303,3435,5868,0,0,0,1.0,1,1.0,1,1.0,1,0.14494603592143146,52
4539,3,9306,3437,5869,0,0,0,1.0,1,1.0,1,1.0,1,0.15145661334659116,53
4540,6,9312,3438,5874,0,0,0,1.0,1,1.0,1,1.0,1,0.11731569812334856,54
4541,1,9313,3438,5875,0,0,0,1.0,1,1.0,1,1.0,1,0.13127088153233357,53
4542,4,9317,3441,5876,0,0,0,1.0,1,1.0,1,1.0,1,0.11405743064554134,53
4543,1,9318,3441,5877,0,0,0,1.0,1,1.0,1,1.0,1,0.10826017576817981,53
4544,1,9319,3442,5877,0,0,0,1.0,1,1.0,1,1.0,1,0.09459771554220932,52
4545,0,9319,3442,5877,0,0,0,1.0,1,1.0,1,1.0,1,0.11274216932487388,50
4546,2,9321,3442,5879,0,0,0,1.0,1,1.0,1,1.0,1,0.08237044572848502,49
4547,2,9323,3443,5880,0,0,0,1.0,1,1.0,1,1.0,1,0.08325027735462047,49
4548,0,9323,3443,5880,0,0,0,1.0,1,1.0,1,1.0,1,0.08325027735462047,49
4549,2,9325,3444,5881,0,0,0,1.0,1,1.0,1,1.0,1,0.06340859784492674,50
4550,1,9326,3445,5881,0,0,0,1.0,1,1.0,1,1.0,1,0.09052857632554087,49
4551,0,9326,3445,5881,0,0,0,1.0,1,1.0,1,1.0,1,0.09052857632554087,49
4552,1,9327,3446,5881,0,0,0,1.0,1,1.0,1,1.0,1,0.08490317305284192,49
4553,2,9329,3448,5881,0,0,0,1.0,1,1.0,1,1.0,1,0.16377072979503152,49
4554,2,9331,3450,5881,0,0,0,1.0,1,1.0,1,1.0,1,0.19119269933215774,49
4555,5,9336,3451,5885,0,0,0,1.0,1,1.0,1,1.0,1,0.13580039993744242,48
4556,1,9337,3452,5885,0,0,0,1.0,1,1.0,1,1.0,1,0.15372298977665766,48
4557,3,9340,3453,5887,0,0,0,1.0,1,1.0,1,1.0,1,0.1603565246457549,49
4558,2,9342,3455,5887,0,0,0,1.0,1,1.0,1,1.0,1,0.15194118100965803,49
4559,1,9343,3456,5887,0,0,0,1.0,1,1.0,1,1.0,1,0.19533411097205391,50
4560,3,9346,3456,5890,0,0,0,1.0,1,1.0,1,1.0,1,0.18415955098809944,51
4561,2,9348,3456,5892,0,0,0,1.0,1,1.0,1,1.0,1,0.13898457883090062,52
4562,0,9348,3456,5892,0,0,0,1.0,1,1.0,1,1.0,1,0.13556425906204755,53
4563,1,9349,3457,5892,0,0,0,1.0,1,1.0,1,1.0,1,0.1428124681409873,52
4564,0,9349,3457,5892,0,0,0,1.0,1,1.0,1,1.0,1,0.13824174633392358,54
4565,2,9351,3458,5893,0,0,0,1.0,1,1.0,1,1.0,1,0.14003288347264112,55
4566,1,9352,3458,5894,0,0,0,1.0,1,1.0,1,1.0,1,0.12831115652940323,55
4567,3,9355,3460,5895,0,0,0,1.0,1,1.0,1,1.0,1,0.09992573323218261,56
4568,4,9359,3461,5898,0,0,0,1.0,1,1.0,1,1.0,1,0.11140734146361675,58
4569,1,9360,3461,5899,0,0,0,1.0,1,1.0,1,1.0,1,0.09686164162613377,59
4570,4,9364,3463,5901,0,0,0,1.0,1,1.0,1,1.0,1,0.09264613930379136,59
4571,0,9364,3463,5901,0,0,0,1.0,1,1.0,1,1.0,1,0.08493459166681483,57
4572,1,9365,3464,5901,0,0,0,1.0,1,1.0,1,1.0,1,0.09804227224438514,56
4573,2,9367,3465,5902,0,0,0,1.0,1,1.0,1,1.0,1,0.1103678508220724,56
4574,0,9367,3465,5902,0,0,0,1.0,1,1.0,1,1.0,1,0.1310679870986123,55
4575,0,9367,3465,5902,0,0,0,1.0,1,1.0,1,1.0,1,0.1310679870986123,55
4576,2,9369,3465,5904,0,0,0,1.0,1,1.0,1,1.0,1,0.1266984883755386,55
4577,0,9369,3465,5904,0,0,0,1.0,1,1.0,1,1.0,1,0.1400595285444472,54
4578,0,9369,3465,5904,0,0,0,1.0,1,1.0,1,1.0,1,0.14107007458068732,54
4579,3,9372,3466,5906,0,0,0,1.0,1,1.0,1,1.0,1,0.1351584891392481,54
4580,0,9372,3466,5906,0,0,0,1.0,1,1.0,1,1.0,1,0.1278363354897218,55
4581,2,9374,3468,5906,0,0,0,1.0,1,1.0,1,1.0,1,0.17165798155622758,56
4582,0,9374,3468,5906,0,0,0,1.0,1,1.0,1,1.0,1,0.17165798155622758,56
4583,1,9375,3469,5906,0,0,0,1.0,1,1.0,1,1.0,1,0.17313294313779648,57
4584,1,9376,3470,5906,0,0,0,1.0,1,1.0,1,1.0,1,0.1981159167182656,57
4585,3,9379,3470,5909,0,0,0,1.0,1,1.0,1,1.0,1,0.17112832512278736,57
4586,0,9379,3470,5909,0,0,0,1.0,1,1.0,1,1.0,1,0.17112832512278736,57
4587,0,9379,3470,5909,0,0,0,1.0,1,1.0,1,1.0,1,0.17112832512278736,57
4588,0,9379,3470,5909,0,0,0,1.0,1,1.0,1,1.0,1,0.16969135914336086,58
4589,0,9379,3470,5909,0,0,0,1.0,1,1.0,1,1.0,1,0.17864831839853448,59
4590,0,9379,3470,5909,0,0,0,1.0,1,1.0,1,1.0,1,0.18834554251179816,60
4591,0,9379,3470,5909,0,0,0,1.0,1,1.0,1,1.0,1,0.19183662249022498,61
4592,1,9380,3470,5910,0,0,0,1.0,1,1.0,1,1.0,1,0.16915387544955973,62
4593,3,9383,3470,5913,0,0,0,1.0,1,1.0,1,1.0,1,0.14111179407641103,64
4594,3,9386,3470,5916,0,0,0,1.0,1,1.0,1,1.0,1,0.11474189545474896,64
4595,0,9386,3470,5916,0,0,0,1.0,1,1.0,1,1.0,1,0.11538126349749055,63
4596,0,9386,3470,5916,0,0,0,1.0,1,1.0,1,1.0,1,0.11538126349749055,63
4597,3,9389,3471,5918,0,0,0,1.0,1,1.0,1,1.0,1,0.07729065354375984,63
4598,1,9390,3472,5918,0,0,0,1.0,1,1.0,1,1.0,1,0.0767336702820851,65
4599,2,9392,3473,5919,0,0,0,1.0,1,1.0,1,1.0,1,0.09530892643337203,66
4600,3,9395,3474,5921,0,0,0,1.0,1,1.0,1,1.0,1,0.09712988952201074,67
4601,0,9395,3474,5921,0,0,0,1.0,1,1.0,1,1.0,1,0.09712988952201074,67
4602,1,9396,3474,5922,0,0,0,1.0,1,1.0,1,1.0,1,0.09056407532563261,69
4603,2,9398,3475,5923,0,0,0,1.0,1,1.0,1,1.0,1,0.09720863680430399,69
4604,1,9399,3476,5923,0,0,0,1.0,1,1.0,1,1.0,1,0.09831883160717904,69
4605,0,9399,3476,5923,0,0,0,1.0,1,1.0,1,1.0,1,0.09575285122669164,70
4606,0,9399,3476,5923,0,0,0,1.0,1,1.0,1,1.0,1,0.09575285122669164,70
4607,3,9402,3476,5926,0,0,0,1.0,1,1.0,1,1.0,1,0.07332632877528633,72
4608,0,9402,3476,5926,0,0,0,1.0,1,1.0,1,1.0,1,0.07976432444821951,73
4609,1,9403,3477,5926,0,0,0,1.0,1,1.0,1,1.0,1,0.09196011665307022,72
4610,2,9405,3478,5927,0,0,0,1.0,1,1.0,1,1.0,1,0.09185407534217965,72
4611,4,9409,3480,5929,0,0,0,1.0,1,1.0,1,1.0,1,0.1167098842337234,71
4612,4,9413,3482,5931,0,0,0,1.0,1,1.0,1,1.0,1,0.1035860923179396,70
4613,0,9413,3482,5931,0,0,0,1.0,1,1.0,1,1.0,1,0.1033446402308502,69
4614,0,9413,3482,5931,0,0,0,1.0,1,1.0,1,1.0,1,0.12175930168442387,68
4615,3,9416,3484,5932,0,0,0,1.0,1,1.0,1,1.0,1,0.1156685322481038,68
4616,0,9416,3484,5932,0,0,0,1.0,1,1.0,1,1.0,1,0.16158126956879276,65
4617,1,9417,3485,5932,0,0,0,1.0,1,1.0,1,1.0,1,0.14265998843521688,66
4618,4,9421,3486,5935,0,0,0,1.0,1,1.0,1,1.0,1,0.13626716178613718,66
4619,1,9422,3486,5936,0,0,0,1.0,1,1.0,1,1.0,1,0.13042939946759666,65
4620,1,9423,3486,5937,0,0,0,1.0,1,1.0,1,1.0,1,0.11569413740279107,65
4621,8,9431,3492,5939,0,0,0,1.0,1,1.0,1,1.0,1,0.168683454114691,67
4622,2,9433,3493,5940,0,0,0,1.0,1,1.0,1,1.0,1,0.16130554307141778,65
4623,1,9434,3493,5941,0,0,0,1.0,1,1.0,1,1.0,1,0.16683003566907117,66
4624,4,9438,3493,5945,0,0,0,1.0,1,1.0,1,1.0,1,0.1374149396571694,65
4625,1,9439,3493,5946,0,0,0,1.0,1,1.0,1,1.0,1,0.13499081267979512,64
4626,1,9440,3494,5946,0,0,0,1.0,1,1.0,1,1.0,1,0.12127724439806203,63
4627,5,9445,3494,5951,0,0,0,1.0,1,1.0,1,1.0,1,0.07605250441380325,65
4628,0,9445,3494,5951,0,0,0,1.0,1,1.0,1,1.0,1,0.07623420028171472,64
4629,1,9446,3495,5951,0,0,0,1.0,1,1.0,1,1.0,1,0.08637445377562078,64
4630,1,9447,3495,5952,0,0,0,1.0,1,1.0,1,1.0,1,0.07425328550238672,64
4631,6,9453,3498,5955,0,0,0,1.0,1,1.0,1,1.0,1,0.12602834773370278,66
4632,4,9457,3498,5959,0,0,0,1.0,1,1.0,1,1.0,1,0.13414725688321083,65
4633,3,9460,3498,5962,0,0,0,1.0,1,1.0,1,1.0,1,0.0829396753440855,66
4634,1,9461,3498,5963,0,0,0,1.0,1,1.0,1,1.0,1,0.07943075261694191,66
4635,0,9461,3498,5963,0,0,0,1.0,1,1.0,1,1.0,1,0.07760713040914968,66
4636,0,9461,3498,5963,0,0,0,1.0,1,1.0,1,1.0,1,0.07760713040914968,66
4637,1,9462,3498,5964,0,0,0,1.0,1,1.0,1,1.0,1,0.06682711130425267,68
4638,0,9462,3498,5964,0,0,0,1.0,1,1.0,1,1.0,1,0.06682711130425267,68
4639,1,9463,3499,5964,0,0,0,1.0,1,1.0,1,1.0,1,0.07945109725025187,69
4640,0,9463,3499,5964,0,0,0,1.0,1,1.0,1,1.0,1,0.07945109725025187,69
4641,2,9465,3499,5966,0,0,0,1.0,1,1.0,1,1.0,1,0.06349802140527527,70
4642,2,9467,3499,5968,0,0,0,1.0,1,1.0,1,1.0,1,0.04936146471653438,69
4643,1,9468,3500,5968,0,0,0,1.0,1,1.0,1,1.0,1,0.053304586764892456,70
4644,1,9469,3501,5968,0,0,0,1.0,1,1.0,1,1.0,1,0.07904385254875594,69
4645,1,9470,3501,5969,0,0,0,1.0,1,1.0,1,1.0,1,0.07719882865842907,70
4646,1,9471,3502,5969,0,0,0,1.0,1,1.0,1,1.0,1,0.11762644818431507,68
4647,3,9474,3505,5969,0,0,0,1.0,1,1.0,1,1.0,1,0.15279549334578965,68
4648,5,9479,3505,5974,0,0,0,1.0,1,1.0,1,1.0,1,0.14288985039781413,67
4649,7,9486,3508,5978,0,0,0,1.0,1,1.0,1,1.0,1,0.1631235050810367,67
4650,0,9486,3508,5978,0,0,0,1.0,1,1.0,1,1.0,1,0.14689881565636953,67
4651,11,9497,3511,5986,0,0,0,1.0,1,1.0,1,1.0,1,0.1286521585887218,68
4652,2,9499,3511,5988,0,0,0,1.0,1,1.0,1,1.0,1,0.14907884811324892,66
4653,2,9501,3512,5989,0,0,0,1.0,1,1.0,1,1.0,1,0.14552505105661087,64
4654,4,9505,3513,5992,0,0,0,1.0,1,1.0,1,1.0,1,0.14386871240085694,65
4655,0,9505,3513,5992,0,0,0,1.0,1,1.0,1,1.0,1,0.14250991487242035,64
4656,1,9506,3514,5992,0,0,0,1.0,1,1.0,1,1.0,1,0.16044726383348945,65
4657,4,9510,3514,5996,0,0,0,1.0,1,1.0,1,1.0,1,0.13302742819881222,66
4658,5,9515,3517,5998,0,0,0,1.0,1,1.0,1,1.0,1,0.19998360653937083,65
4659,1,9516,3517,5999,0,0,0,1.0,1,1.0,1,1.0,1,0.19870966860531178,65
4660,6,9522,3520,6002,0,0,0,1.0,1,1.0,1,1.0,1,0.1887011589899445,66
4661,3,9525,3520,6005,0,0,0,1.0,1,1.0,1,1.0,1,0.18259351505554716,66
4662,1,9526,3520,6006,0,0,0,1.0,1,1.0,1,1.0,1,0.1705548922322446,68
4663,2,9528,3520,6008,0,0,0,1.0,1,1.0,1,1.0,1,0.15773045127568938,67
4664,5,9533,3521,6012,0,0,0,1.0,1,1.0,1,1.0,1,0.1260292721359341,67
4665,1,9534,3522,6012,0,0,0,1.0,1,1.0,1,1.0,1,0.12156607151818925,67
4666,2,9536,3523,6013,0,0,0,1.0,1,1.0,1,1.0,1,0.12817492974913025,67
4667,1,9537,3524,6013,0,0,0,1.0,1,1.0,1,1.0,1,0.13240125371713526,66
4668,1,9538,3525,6013,0,0,0,1.0,1,1.0,1,1.0,1,0.1474101706808471,66
4669,5,9543,3527,6016,0,0,0,1.0,1,1.0,1,1.0,1,0.14874922749419503,66
4670,0,9543,3527,6016,0,0,0,1.0,1,1.0,1,1.0,1,0.16203447425877412,64
4671,0,9543,3527,6016,0,0,0,1.0,1,1.0,1,1.0,1,0.16203447425877412,64
4672,4,9547,3528,6019,0,0,0,1.0,1,1.0,1,1.0,1,0.1728806532620965,64
4673,2,9549,3528,6021,0,0,0,1.0,1,1.0,1,1.0,1,0.15164590295431016,65
4674,2,9551,3530,6021,0,0,0,1.0,1,1.0,1,1.0,1,0.16432058718540837,66
4675,6,9557,3530,6027,0,0,0,1.0,1,1.0,1,1.0,1,0.12644278408287649,65
4676,0,9557,3530,6027,0,0,0,1.0,1,1.0,1,1.0,1,0.15156832923709967,65
4677,0,9557,3530,6027,0,0,0,1.0,1,1.0,1,1.0,1,0.16571635059043394,65
4678,2,9559,3530,6029,0,0,0,1.0,1,1.0,1,1.0,1,0.171978525988215,64
4679,2,9561,3530,6031,0,0,0,1.0,1,1.0,1,1.0,1,0.15476784982091932,66
4680,2,9563,3530,6033,0,0,0,1.0,1,1.0,1,1.0,1,0.1612020082153628,67
4681,3,9566,3530,6036,0,0,0,1.0,1,1.0,1,1.0,1,0.1258787260080565,67
4682,4,9570,3533,6037,0,0,0,1.0,1,1.0,1,1.0,1,0.1433797315112198,67
4683,3,9573,3534,6039,0,0,0,1.0,1,1.0,1,1.0,1,0.1361646413763406,67
4684,4,9577,3536,6041,0,0,0,1.0,1,1.0,1,1.0,1,0.13713389280623253,66
4685,0,9577,3536,6041,0,0,0,1.0,1,1.0,1,1.0,1,0.13037452081945108,65
4686,1,9578,3537,6041,0,0,0,1.0,1,1.0,1,1.0,1,0.17682256809720748,65
4687,1,9579,3537,6042,0,0,0,1.0,1,1.0,1,1.0,1,0.15942717060264452,65
4688,3,9582,3539,6043,0,0,0,1.0,1,1.0,1,1.0,1,0.18544641792177272,64
4689,4,9586,3540,6046,0,0,0,1.0,1,1.0,1,1.0,1,0.16817112907962195,65
4690,0,9586,3540,6046,0,0,0,1.0,1,1.0,1,1.0,1,0.1820724372311502,63
4691,6,9592,3543,6049,0,0,0,1.0,1,1.0,1,1.0,1,0.1841922230809256,64
4692,0,9592,3543,6049,0,0,0,1.0,1,1.0,1,1.0,1,0.15372068638831063,63
4693,6,9598,3545,6053,0,0,0,1.0,1,1.0,1,1.0,1,0.17886651876946932,64
4694,1,9599,3545,6054,0,0,0,1.0,1,1.0,1,1.0,1,0.15162706643704849,63
4695,0,9599,3545,6054,0,0,0,1.0,1,1.0,1,1.0,1,0.15356036883144716,62
4696,2,9601,3545,6056,0,0,0,1.0,1,1.0,1,1.0,1,0.14287430207574325,61
4697,3,9604,3545,6059,0,0,0,1.0,1,1.0,1,1.0,1,0.12171767352360682,63
4698,1,9605,3545,6060,0,0,0,1.0,1,1.0,1,1.0,1,0.13017297134343672,63
4699,2,9607,3545,6062,0,0,0,1.0,1,1.0,1,1.0,1,0.10685790232903546,65
4700,0,9607,3545,6062,0,0,0,1.0,1,1.0,1,1.0,1,0.11405138049590041,64
4701,4,9611,3547,6064,0,0,0,1.0,1,1.0,1,1.0,1,0.13231165519376392,64
4702,3,9614,3547,6067,0,0,0,1.0,1,1.0,1,1.0,1,0.1195979614184634,66
4703,1,9615,3548,6067,0,0,0,1.0,1,1.0,1,1.0,1,0.11994139243072441,65
4704,0,9615,3548,6067,0,0,0,1.0,1,1.0,1,1.0,1,0.11024503568432324,64
4705,3,9618,3550,6068,0,0,0,1.0,1,1.0,1,1.0,1,0.1574591459734039,65
4706,6,9624,3555,6069,0,0,0,1.0,1,1.0,1,1.0,1,0.20015803996654108,65
4707,4,9628,3556,6072,0,0,0,1.0,1,1.0,1,1.0,1,0.20241686675311635,63
4708,5,9633,3557,6076,0,0,0,1.0,1,1.0,1,1.0,1,0.16360375757953743,62
4709,4,9637,3560,6077,0,0,0,1.0,1,1.0,1,1.0,1,0.1868462209091877,61
4710,0,9637,3560,6077,0,0,0,1.0,1,1.0,1,1.0,1,0.1813195437761178,60
4711,5,9642,3562,6080,0,0,0,1.0,1,1.0,1,1.0,1,0.17944159465842313,59
4712,3,9645,3563,6082,0,0,0,1.0,1,1.0,1,1.0,1,0.16036186082294698,58
4713,4,9649,3565,6084,0,0,0,1.0,1,1.0,1,1.0,1,0.16359440799542044,58
4714,5,9654,3565,6089,0,0,0,1.0,1,1.0,1,1.0,1,0.13901851566919088,57
4715,0,9654,3565,6089,0,0,0,1.0,1,1.0,1,1.0,1,0.15336042773640782,57
4716,4,9658,3566,6092,0,0,0,1.0,1,1.0,1,1.0,1,0.1548893419715164,55
4717,7,9665,3568,6097,0,0,0,1.0,1,1.0,1,1.0,1,0.11045730851137861,57
4718,1,9666,3568,6098,0,0,0,1.0,1,1.0,1,1.0,1,0.1008940754485138,56
4719,1,9667,3569,6098,0,0,0,1.0,1,1.0,1,1.0,1,0.14811190599302565,56
4720,5,9672,3569,6103,0,0,0,1.0,1,1.0,1,1.0,1,0.10847659740080176,57
4721,1,9673,3569,6104,0,0,0,1.0,1,1.0,1,1.0,1,0.08716585547697815,57
4722,1,9674,3570,6104,0,0,0,1.0,1,1.0,1,1.0,1,0.1010194904662906,57
4723,4,9678,3570,6108,0,0,0,1.0,1,1.0,1,1.0,1,0.09562531239622603,57
4724,0,9678,3570,6108,0,0,0,1.0,1,1.0,1,1.0,1,0.09800874846579984,57
4725,1,9679,3570,6109,0,0,0,1.0,1,1.0,1,1.0,1,0.11689796471353282,57
4726,3,9682,3571,6111,0,0,0,1.0,1,1.0,1,1.0,1,0.1258510306257236,57
4727,1,9683,3571,6112,0,0,0,1.0,1,1.0,1,1.0,1,0.1208214341786031,56
4728,0,9683,3571,6112,0,0,0,1.0,1,1.0,1,1.0,1,0.12968087606288484,57
4729,1,9684,3571,6113,0,0,0,1.0,1,1.0,1,1.0,1,0.14211976978064098,56
4730,2,9686,3573,6113,0,0,0,1.0,1,1.0,1,1.0,1,0.16418310357441762,54
4731,1,9687,3574,6113,0,0,0,1.0,1,1.0,1,1.0,1,0.1688176300490021,54
4732,6,9693,3576,6117,0,0,0,1.0,1,1.0,1,1.0,1,0.17436397400769296,54
4733,1,9694,3577,6117,0,0,0,1.0,1,1.0,1,1.0,1,0.18249126492601295,55
4734,3,9697,3579,6118,0,0,0,1.0,1,1.0,1,1.0,1,0.23862312826471369,56
4735,2,9699,3580,6119,0,0,0,1.0,1,1.0,1,1.0,1,0.23304883463965204,56
4736,4,9703,3581,6122,0,0,0,1.0,1,1.0,1,1.0,1,0.20325025506365502,58
4737,0,9703,3581,6122,0,0,0,1.0,1,1.0,1,1.0,1,0.19293850598971388,59
4738,3,9706,3584,6122,0,0,0,1.0,1,1.0,1,1.0,1,0.2446380789377633,60
4739,3,9709,3584,6125,0,0,0,1.0,1,1.0,1,1.0,1,0.2342048359817838,60
4740,1,9710,3584,6126,0,0,0,1.0,1,1.0,1,1.0,1,0.23336424636295847,60
4741,2,9712,3584,6128,0,0,0,1.0,1,1.0,1,1.0,1,0.2231850096411981,61
4742,2,9714,3585,6129,0,0,0,1.0,1,1.0,1,1.0,1,0.2219911024990102,61
4743,0,9714,3585,6129,0,0,0,1.0,1,1.0,1,1.0,1,0.21374443889564593,60
4744,4,9718,3586,6132,0,0,0,1.0,1,1.0,1,1.0,1,0.17795124987494468,60
4745,1,9719,3586,6133,0,0,0,1.0,1,1.0,1,1.0,1,0.16179240256793034,59
4746,4,9723,3588,6135,0,0,0,1.0,1,1.0,1,1.0,1,0.16136020942641868,59
4747,4,9727,3590,6137,0,0,0,1.0,1,1.0,1,1.0,1,0.13528328818112648,58
4748,5,9732,3592,6140,0,0,0,1.0,1,1.0,1,1.0,1,0.09261969584464272,58
4749,2,9734,3593,6141,0,0,0,1.0,1,1.0,1,1.0,1,0.09332213807007783,58
4750,2,9736,3594,6142,0,0,0,1.0,1,1.0,1,1.0,1,0.08717352581123565,56
4751,3,9739,3595,6144,0,0,0,1.0,1,1.0,1,1.0,1,0.0866886123411476,58
4752,1,9740,3596,6144,0,0,0,1.0,1,1.0,1,1.0,1,0.08926440130513127,55
4753,0,9740,3596,6144,0,0,0,1.0,1,1.0,1,1.0,1,0.08926440130513127,55
4754,0,9740,3596,6144,0,0,0,1.0,1,1.0,1,1.0,1,0.10382690552968232,54
4755,3,9743,3597,6146,0,0,0,1.0,1,1.0,1,1.0,1,0.09554025574723785,54
4756,4,9747,3598,6149,0,0,0,1.0,1,1.0,1,1.0,1,0.06378970740667078,54
4757,0,9747,3598,6149,0,0,0,1.0,1,1.0,1,1.0,1,0.07561188107335062,53
4758,0,9747,3598,6149,0,0,0,1.0,1,1.0,1,1.0,1,0.07561188107335062,53
4759,2,9749,3599,6150,0,0,0,1.0,1,1.0,1,1.0,1,0.09821834298689049,53
4760,2,9751,3600,6151,0,0,0,1.0,1,1.0,1,1.0,1,0.13136610827655695,53
4761,3,9754,3601,6153,0,0,0,1.0,1,1.0,1,1.0,1,0.1297745626573402,52
4762,8,9762,3603,6159,0,0,0,1.0,1,1.0,1,1.0,1,0.15484485561197608,54
4763,1,9763,3603,6160,0,0,0,1.0,1,1.0,1,1.0,1,0.14372682890242036,54
4764,2,9765,3604,6161,0,0,0,1.0,1,1.0,1,1.0,1,0.14937525422387382,55
4765,3,9768,3606,6162,0,0,0,1.0,1,1.0,1,1.0,1,0.19952558219332478,56
4766,3,9771,3607,6164,0,0,0,1.0,1,1.0,1,1.0,1,0.16263704428221532,58
4767,7,9778,3608,6170,0,0,0,1.0,1,1.0,1,1.0,1,0.1195011912343582,59
4768,2,9780,3609,6171,0,0,0,1.0,1,1.0,1,1.0,1,0.11529001240345142,60
4769,0,9780,3609,6171,0,0,0,1.0,1,1.0,1,1.0,1,0.12313927791941665,59
4770,0,9780,3609,6171,0,0,0,1.0,1,1.0,1,1.0,1,0.12790719308225743,60
4771,1,9781,3609,6172,0,0,0,1.0,1,1.0,1,1.0,1,0.14176370547549763,59
4772,1,9782,3609,6173,0,0,0,1.0,1,1.0,1,1.0,1,0.1342545047957902,59
4773,0,9782,3609,6173,0,0,0,1.0,1,1.0,1,1.0,1,0.12006448224310273,60
4774,1,9783,3610,6173,0,0,0,1.0,1,1.0,1,1.0,1,0.14269684718814066,60
4775,0,9783,3610,6173,0,0,0,1.0,1,1.0,1,1.0,1,0.1439362630092396,62
4776,0,9783,3610,6173,0,0,0,1.0,1,1.0,1,1.0,1,0.13533463495557038,63
4777,2,9785,3611,6174,0,0,0,1.0,1,1.0,1,1.0,1,0.1276547283262586,63
4778,0,9785,3611,6174,0,0,0,1.0,1,1.0,1,1.0,1,0.1276547283262586,63
4779,0,9785,3611,6174,0,0,0,1.0,1,1.0,1,1.0,1,0.1276547283262586,63
4780,3,9788,3612,6176,0,0,0,1.0,1,1.0,1,1.0,1,0.11948081365488908,65
4781,0,9788,3612,6176,0,0,0,1.0,1,1.0,1,1.0,1,0.13963974265315252,64
4782,3,9791,3612,6179,0,0,0,1.0,1,1.0,1,1.0,1,0.1103848812751316,65
4783,7,9798,3614,6184,0,0,0,1.0,1,1.0,1,1.0,1,0.10026439749231564,66
4784,5,9803,3616,6187,0,0,0,1.0,1,1.0,1,1.0,1,0.04826985205723279,64
4785,3,9806,3617,6189,0,0,0,1.0,1,1.0,1,1.0,1,0.06800224622787152,65
4786,2,9808,3619,6189,0,0,0,1.0,1,1.0,1,1.0,1,0.07818380791613054,66
4787,2,9810,3621,6189,0,0,0,1.0,1,1.0,1,1.0,1,0.08368655599449336,63
4788,5,9815,3624,6191,0,0,0,1.0,1,1.0,1,1.0,1,0.1020031753652971,63
4789,8,9823,3627,6196,0,0,0,1.0,1,1.0,1,1.0,1,0.048057312273721925,60
4790,3,9826,3627,6199,0,0,0,1.0,1,1.0,1,1.0,1,0.04201844608351755,61
4791,3,9829,3629,6200,0,0,0,1.0,1,1.0,1,1.0,1,0.08906610525284721,59
4792,3,9832,3631,6201,0,0,0,1.0,1,1.0,1,1.0,1,0.06967558684359282,59
4793,1,9833,3632,6201,0,0,0,1.0,1,1.0,1,1.0,1,0.09480526351438348,61
4794,3,9836,3634,6202,0,0,0,1.0,1,1.0,1,1.0,1,0.07548468426832988,60
4795,3,9839,3635,6204,0,0,0,1.0,1,1.0,1,1.0,1,0.04939741928281347,61
4796,2,9841,3637,6204,0,0,0,1.0,1,1.0,1,1.0,1,0.09338018383178393,60
4797,3,9844,3638,6206,0,0,0,1.0,1,1.0,1,1.0,1,0.09836612154337619,61
4798,8,9852,3639,6213,0,0,0,1.0,1,1.0,1,1.0,1,0.10447196307543154,61
4799,1,9853,3639,6214,0,0,0,1.0,1,1.0,1,1.0,1,0.13539026997646156,59
4800,1,9854,3639,6215,0,0,0,1.0,1,1.0,1,1.0,1,0.14432022856737123,57
4801,8,9862,3640,6222,0,0,0,1.0,1,1.0,1,1.0,1,0.1008721818641707,58
4802,5,9867,3640,6227,0,0,0,1.0,1,1.0,1,1.0,1,0.1251311329141451,56
4803,6,9873,3641,6232,0,0,0,1.0,1,1.0,1,1.0,1,0.10869475389442788,57
4804,1,9874,3641,6233,0,0,0,1.0,1,1.0,1,1.0,1,0.0676819273060626,55
4805,4,9878,3644,6234,0,0,0,1.0,1,1.0,1,1.0,1,0.14158263084893152,56
4806,1,9879,3644,6235,0,0,0,1.0,1,1.0,1,1.0,1,0.09732960947700389,55
4807,0,9879,3644,6235,0,0,0,1.0,1,1.0,1,1.0,1,0.10734468931633376,53
4808,5,9884,3646,6238,0,0,0,1.0,1,1.0,1,1.0,1,0.1046426523700388,54
4809,2,9886,3646,6240,0,0,0,1.0,1,1.0,1,1.0,1,0.12233970667776381,53
4810,2,9888,3647,6241,0,0,0,1.0,1,1.0,1,1.0,1,0.09117478302924273,53
4811,3,9891,3648,6243,0,0,0,1.0,1,1.0,1,1.0,1,0.08262701387300458,54
4812,1,9892,3649,6243,0,0,0,1.0,1,1.0,1,1.0,1,0.07963863395679556,54
4813,3,9895,3650,6245,0,0,0,1.0,1,1.0,1,1.0,1,0.05879231620983781,55
4814,2,9897,3652,6245,0,0,0,1.0,1,1.0,1,1.0,1,0.09837056062035282,55
4815,2,9899,3652,6247,0,0,0,1.0,1,1.0,1,1.0,1,0.10874177953173916,56
4816,2,9901,3653,6248,0,0,0,1.0,1,1.0,1,1.0,1,0.11186996896496591,56
4817,6,9907,3655,6252,0,0,0,1.0,1,1.0,1,1.0,1,0.09320890018081315,58
4818,4,9911,3658,6253,0,0,0,1.0,1,1.0,1,1.0,1,0.11959558010250777,58
4819,4,9915,3659,6256,0,0,0,1.0,1,1.0,1,1.0,1,0.12049547508863907,58
4820,1,9916,3659,6257,0,0,0,1.0,1,1.0,1,1.0,1,0.10956647009697647,58
4821,2,9918,3659,6259,0,0,0,1.0,1,1.0,1,1.0,1,0.1021869247560105,58
4822,1,9919,3659,6260,0,0,0,1.0,1,1.0,1,1.0,1,0.0910010619807942,58
4823,2,9921,3660,6261,0,0,0,1.0,1,1.0,1,1.0,1,0.09233509656050749,57
4824,3,9924,3660,6264,0,0,0,1.0,1,1.0,1,1.0,1,0.07887293058570699,56
4825,1,9925,3660,6265,0,0,0,1.0,1,1.0,1,1.0,1,0.12369120645315497,57
4826,2,9927,3662,6265,0,0,0,1.0,1,1.0,1,1.0,1,0.12081566169495976,57
4827,3,9930,3662,6268,0,0,0,1.0,1,1.0,1,1.0,1,0.1414690190699192,56
4828,3,9933,3663,6270,0,0,0,1.0,1,1.0,1,1.0,1,0.10049857659425346,57
4829,0,9933,3663,6270,0,0,0,1.0,1,1.0,1,1.0,1,0.10881231465052393,56
4830,1,9934,3664,6270,0,0,0,1.0,1,1.0,1,1.0,1,0.10020029085995498,57
4831,4,9938,3666,6272,0,0,0,1.0,1,1.0,1,1.0,1,0.13068641169586334,57
4832,0,9938,3666,6272,0,0,0,1.0,1,1.0,1,1.0,1,0.13446639051327958,55
4833,3,9941,3667,6274,0,0,0,1.0,1,1.0,1,1.0,1,0.13756267506525224,55
4834,4,9945,3667,6278,0,0,0,1.0,1,1.0,1,1.0,1,0.11056010344381142,55
4835,3,9948,3667,6281,0,0,0,1.0,1,1.0,1,1.0,1,0.09905314376770914,55
4836,2,9950,3667,6283,0,0,0,1.0,1,1.0,1,1.0,1,0.0899050145062619,55
4837,1,9951,3667,6284,0,0,0,1.0,1,1.0,1,1.0,1,0.08802284978303668,53
4838,2,9953,3667,6286,0,0,0,1.0,1,1.0,1,1.0,1,0.06710023552473507,54
4839,3,9956,3669,6287,0,0,0,1.0,1,1.0,1,1.0,1,0.10422172207563145,53
4840,5,9961,3670,6291,0,0,0,1.0,1,1.0,1,1.0,1,0.06389894576907248,52
4841,4,9965,3673,6292,0,0,0,1.0,1,1.0,1,1.0,1,0.11571075769317243,51
4842,5,9970,3675,6295,0,0,0,1.0,1,1.0,1,1.0,1,0.16966219821778653,50
4843,5,9975,3676,6299,0,0,0,1.0,1,1.0,1,1.0,1,0.12628388796756349,51
4844,1,9976,3676,6300,0,0,0,1.0,1,1.0,1,1.0,1,0.09764078980587444,50
4845,3,9979,3678,6301,0,0,0,1.0,1,1.0,1,1.0,1,0.14076483676098825,49
4846,3,9982,3678,6304,0,0,0,1.0,1,1.0,1,1.0,1,0.10898655922209616,49
4847,0,9982,3678,6304,0,0,0,1.0,1,1.0,1,1.0,1,0.12734831933429383,48
4848,2,9984,3680,6304,0,0,0,1.0,1,1.0,1,1.0,1,0.13807138193015966,48
4849,1,9985,3681,6304,0,0,0,1.0,1,1.0,1,1.0,1,0.1357585087692939,48
4850,1,9986,3681,6305,0,0,0,1.0,1,1.0,1,1.0,1,0.12786842527405812,49
4851,3,9989,3681,6308,0,0,0,1.0,1,1.0,1,1.0,1,0.12673235070615818,49
4852,1,9990,3681,6309,0,0,0,1.0,1,1.0,1,1.0,1,0.1481739719183966,49
4853,0,9990,3681,6309,0,0,0,1.0,1,1.0,1,1.0,1,0.14424454167861192,50
4854,3,9993,3682,6311,0,0,0,1.0,1,1.0,1,1.0,1,0.13371746326336065,51
4855,1,9994,3682,6312,0,0,0,1.0,1,1.0,1,1.0,1,0.12706000293584344,51
4856,0,9994,3682,6312,0,0,0,1.0,1,1.0,1,1.0,1,0.13246427257210708,50
4857,1,9995,3682,6313,0,0,0,1.0,1,1.0,1,1.0,1,0.11408148398926087,51
4858,1,9996,3682,6314,0,0,0,1.0,1,1.0,1,1.0,1,0.10256439008692682,51
4859,0,9996,3682,6314,0,0,0,1.0,1,1.0,1,1.0,1,0.11275556273694524,52
4860,0,9996,3682,6314,0,0,0,1.0,1,1.0,1,1.0,1,0.11275556273694524,52
4861,1,9997,3682,6315,0,0,0,1.0,1,1.0,1,1.0,1,0.11480852086557984,53
4862,2,9999,3684,6315,0,0,0,1.0,1,1.0,1,1.0,1,0.14197246909601058,53
4863,0,9999,3684,6315,0,0,0,1.0,1,1.0,1,1.0,1,0.1294817187131276,51
4864,4,10003,3684,6319,0,0,0,1.0,1,1.0,1,1.0,1,0.07443547159133969,53
4865,1,10004,3684,6320,0,0,0,1.0,1,1.0,1,1.0,1,0.07722821859706988,52
4866,1,10005,3685,6320,0,0,0,1.0,1,1.0,1,1.0,1,0.08691084870735818,53
4867,3,10008,3686,6322,0,0,0,1.0,1,1.0,1,1.0,1,0.06333491831630352,51
4868,2,10010,3687,6323,0,0,0,1.0,1,1.0,1,1.0,1,0.09510744337858798,53
4869,2,10012,3687,6325,0,0,0,1.0,1,1.0,1,1.0,1,0.0944029330568707,53
4870,5,10017,3689,6328,0,0,0,1.0,1,1.0,1,1.0,1,0.09198151274194859,55
4871,2,10019,3690,6329,0,0,0,1.0,1,1.0,1,1.0,1,0.10612273758561326,55
4872,3,10022,3692,6330,0,0,0,1.0,1,1.0,1,1.0,1,0.13178369079532393,56
4873,5,10027,3693,6334,0,0,0,1.0,1,1.0,1,1.0,1,0.09309203605122758,56
4874,2,10029,3694,6335,0,0,0,1.0,1,1.0,1,1.0,1,0.10791505511554471,58
4875,1,10030,3694,6336,0,0,0,1.0,1,1.0,1,1.0,1,0.10477344192476927,56
4876,5,10035,3696,6339,0,0,0,1.0,1,1.0,1,1.0,1,0.10348877549497948,56
4877,2,10037,3697,6340,0,0,0,1.0,1,1.0,1,1.0,1,0.11563092432412052,54
4878,0,10037,3697,6340,0,0,0,1.0,1,1.0,1,1.0,1,0.11563092432412052,54
4879,5,10042,3700,6342,0,0,0,1.0,1,1.0,1,1.0,1,0.12537470453766536,54
4880,0,10042,3700,6342,0,0,0,1.0,1,1.0,1,1.0,1,0.15547223210716618,53
4881,1,10043,3700,6343,0,0,0,1.0,1,1.0,1,1.0,1,0.15838876904445737,54
4882,5,10048,3701,6347,0,0,0,1.0,1,1.0,1,1.0,1,0.11937715630177605,52
4883,1,10049,3701,6348,0,0,0,1.0,1,1.0,1,1.0,1,0.11284000439206966,54
4884,0,10049,3701,6348,0,0,0,1.0,1,1.0,1,1.0,1,0.13519518314101844,52
4885,2,10051,3702,6349,0,0,0,1.0,1,1.0,1,1.0,1,0.11101081934854791,51
4886,0,10051,3702,6349,0,0,0,1.0,1,1.0,1,1.0,1,0.11542898950940146,50
4887,0,10051,3702,6349,0,0,0,1.0,1,1.0,1,1.0,1,0.13025200622929764,49
4888,1,10052,3702,6350,0,0,0,1.0,1,1.0,1,1.0,1,0.12508644465928098,48
4889,1,10053,3702,6351,0,0,0,1.0,1,1.0,1,1.0,1,0.11577215787170839,48
4890,0,10053,3702,6351,0,0,0,1.0,1,1.0,1,1.0,1,0.11577215787170839,48
4891,1,10054,3703,6351,0,0,0,1.0,1,1.0,1,1.0,1,0.17095971883990935,49
4892,3,10057,3703,6354,0,0,0,1.0,1,1.0,1,1.0,1,0.15409305556672148,51
4893,0,10057,3703,6354,0,0,0,1.0,1,1.0,1,1.0,1,0.15559212350189983,51
4894,4,10061,3704,6357,0,0,0,1.0,1,1.0,1,1.0,1,0.12444255461285715,52
4895,0,10061,3704,6357,0,0,0,1.0,1,1.0,1,1.0,1,0.12444255461285715,52
4896,0,10061,3704,6357,0,0,0,1.0,1,1.0,1,1.0,1,0.11658944784367205,51
4897,1,10062,3704,6358,0,0,0,1.0,1,1.0,1,1.0,1,0.1051843691693801,52
4898,1,10063,3705,6358,0,0,0,1.0,1,1.0,1,1.0,1,0.0932017435035632,52
4899,1,10064,3705,6359,0,0,0,1.0,1,1.0,1,1.0,1,0.0844031786296549,53
4900,3,10067,3707,6360,0,0,0,1.0,1,1.0,1,1.0,1,0.06209950156842642,54
4901,2,10069,3709,6360,0,0,0,1.0,1,1.0,1,1.0,1,0.08337668126974905,54
4902,1,10070,3710,6360,0,0,0,1.0,1,1.0,1,1.0,1,0.09600171888516737,55
4903,5,10075,3712,6363,0,0,0,1.0,1,1.0,1,1.0,1,0.1207083234969613,56
4904,5,10080,3714,6366,0,0,0,1.0,1,1.0,1,1.0,1,0.14806276320903394,55
4905,1,10081,3714,6367,0,0,0,1.0,1,1.0,1,1.0,1,0.14299670679534138,54
4906,6,10087,3715,6372,0,0,0,1.0,1,1.0,1,1.0,1,0.1013241244226489,54
4907,2,10089,3715,6374,0,0,0,1.0,1,1.0,1,1.0,1,0.0977429290807618,54
4908,0,10089,3715,6374,0,0,0,1.0,1,1.0,1,1.0,1,0.09914958361911795,53
4909,2,10091,3717,6374,0,0,0,1.0,1,1.0,1,1.0,1,0.11532432547932041,54
4910,2,10093,3717,6376,0,0,0,1.0,1,1.0,1,1.0,1,0.09630784854235198,55
4911,2,10095,3718,6377,0,0,0,1.0,1,1.0,1,1.0,1,0.11235830488819758,57
4912,4,10099,3721,6378,0,0,0,1.0,1,1.0,1,1.0,1,0.12985947981302995,57
4913,0,10099,3721,6378,0,0,0,1.0,1,1.0,1,1.0,1,0.11366649814412687,56
4914,3,10102,3723,6379,0,0,0,1.0,1,1.0,1,1.0,1,0.1237800094581363,56
4915,2,10104,3724,6380,0,0,0,1.0,1,1.0,1,1.0,1,0.10507551066748219,56
4916,1,10105,3725,6380,0,0,0,1.0,1,1.0,1,1.0,1,0.13990280908992073,54
4917,1,10106,3725,6381,0,0,0,1.0,1,1.0,1,1.0,1,0.1705909121358158,53
4918,6,10112,3727,6385,0,0,0,1.0,1,1.0,1,1.0,1,0.13401364704686602,52
4919,1,10113,3728,6385,0,0,0,1.0,1,1.0,1,1.0,1,0.18171800183545037,49
4920,0,10113,3728,6385,0,0,0,1.0,1,1.0,1,1.0,1,0.18171800183545037,49
4921,5,10118,3729,6389,0,0,0,1.0,1,1.0,1,1.0,1,0.1561651748574381,50
4922,3,10121,3729,6392,0,0,0,1.0,1,1.0,1,1.0,1,0.12573586749233723,50
4923,2,10123,3729,6394,0,0,0,1.0,1,1.0,1,1.0,1,0.13463816296748177,52
4924,3,10126,3729,6397,0,0,0,1.0,1,1.0,1,1.0,1,0.11778727426849313,53
4925,1,10127,3729,6398,0,0,0,1.0,1,1.0,1,1.0,1,0.08049643725418767,54
4926,2,10129,3729,6400,0,0,0,1.0,1,1.0,1,1.0,1,0.08049643725418767,54
4927,1,10130,3730,6400,0,0,0,1.0,1,1.0,1,1.0,1,0.08854989064657119,54
4928,0,10130,3730,6400,0,0,0,1.0,1,1.0,1,1.0,1,0.08854989064657119,54
4929,0,10130,3730,6400,0,0,0,1.0,1,1.0,1,1.0,1,0.10229333108664071,55
4930,3,10133,3731,6402,0,0,0,1.0,1,1.0,1,1.0,1,0.11119057640699885,58
4931,0,10133,3731,6402,0,0,0,1.0,1,1.0,1,1.0,1,0.11119057640699885,58
4932,3,10136,3731,6405,0,0,0,1.0,1,1.0,1,1.0,1,0.11711302143911517,59
4933,2,10138,3731,6407,0,0,0,1.0,1,1.0,1,1.0,1,0.0917505786834927,59
4934,2,10140,3733,6407,0,0,0,1.0,1,1.0,1,1.0,1,0.11670018817269887,59
4935,3,10143,3734,6409,0,0,0,1.0,1,1.0,1,1.0,1,0.10880990769278845,59
4936,2,10145,3735,6410,0,0,0,1.0,1,1.0,1,1.0,1,0.12956297167354963,59
4937,1,10146,3735,6411,0,0,0,1.0,1,1.0,1,1.0,1,0.1335690160247578,61
4938,1,10147,3735,6412,0,0,0,1.0,1,1.0,1,1.0,1,0.12782814338307125,62
4939,1,10148,3735,6413,0,0,0,1.0,1,1.0,1,1.0,1,0.13209514802583447,63
4940,1,10149,3735,6414,0,0,0,1.0,1,1.0,1,1.0,1,0.1334941015989841,65
4941,0,10149,3735,6414,0,0,0,1.0,1,1.0,1,1.0,1,0.1334941015989841,65
4942,6,10155,3738,6417,0,0,0,1.0,1,1.0,1,1.0,1,0.1483985314623982,67
4943,2,10157,3738,6419,0,0,0,1.0,1,1.0,1,1.0,1,0.13893558455976046,66
4944,4,10161,3740,6421,0,0,0,1.0,1,1.0,1,1.0,1,0.15055224752798768,63
4945,4,10165,3741,6424,0,0,0,1.0,1,1.0,1,1.0,1,0.10637251308628014,61
4946,2,10167,3742,6425,0,0,0,1.0,1,1.0,1,1.0,1,0.11281343523122844,60
4947,1,10168,3742,6426,0,0,0,1.0,1,1.0,1,1.0,1,0.10072962995570338,58
4948,1,10169,3743,6426,0,0,0,1.0,1,1.0,1,1.0,1,0.10074970575281174,57
4949,1,10170,3743,6427,0,0,0,1.0,1,1.0,1,1.0,1,0.09417805304431752,56
4950,1,10171,3743,6428,0,0,0,1.0,1,1.0,1,1.0,1,0.1022466856986855,57
4951,5,10176,3745,6431,0,0,0,1.0,1,1.0,1,1.0,1,0.09538265458174297,55
4952,5,10181,3748,6433,0,0,0,1.0,1,1.0,1,1.0,1,0.12935435425924624,55
4953,5,10186,3749,6437,0,0,0,1.0,1,1.0,1,1.0,1,0.12938838961555277,54
4954,3,10189,3750,6439,0,0,0,1.0,1,1.0,1,1.0,1,0.10194587678706993,54
4955,1,10190,3750,6440,0,0,0,1.0,1,1.0,1,1.0,1,0.0987546813194217,52
4956,0,10190,3750,6440,0,0,0,1.0,1,1.0,1,1.0,1,0.0987546813194217,52
4957,4,10194,3751,6443,0,0,0,1.0,1,1.0,1,1.0,1,0.05963944137320496,53
4958,1,10195,3752,6443,0,0,0,1.0,1,1.0,1,1.0,1,0.0643331663406663,52
4959,1,10196,3753,6443,0,0,0,1.0,1,1.0,1,1.0,1,0.08967188831162022,51
4960,1,10197,3753,6444,0,0,0,1.0,1,1.0,1,1.0,1,0.08247149374511488,53
4961,1,10198,3754,6444,0,0,0,1.0,1,1.0,1,1.0,1,0.08384985701776462,53
4962,1,10199,3754,6445,0,0,0,1.0,1,1.0,1,1.0,1,0.07491654817480173,55
4963,2,10201,3755,6446,0,0,0,1.0,1,1.0,1,1.0,1,0.059704109124158876,54
4964,3,10204,3757,6447,0,0,0,1.0,1,1.0,1,1.0,1,0.04387354766673096,54
4965,1,10205,3758,6447,0,0,0,1.0,1,1.0,1,1.0,1,0.07166038152206304,54
4966,2,10207,3759,6448,0,0,0,1.0,1,1.0,1,1.0,1,0.08522728070986961,54
4967,5,10212,3761,6451,0,0,0,1.0,1,1.0,1,1.0,1,0.10215183770582091,55
4968,1,10213,3762,6451,0,0,0,1.0,1,1.0,1,1.0,1,0.0988044211116753,55
4969,4,10217,3763,6454,0,0,0,1.0,1,1.0,1,1.0,1,0.08846334496393934,57
4970,1,10218,3764,6454,0,0,0,1.0,1,1.0,1,1.0,1,0.10857582437269866,56
4971,4,10222,3766,6456,0,0,0,1.0,1,1.0,1,1.0,1,0.13265840734549908,57
4972,6,10228,3767,6461,0,0,0,1.0,1,1.0,1,1.0,1,0.11960766484595634,57
4973,2,10230,3768,6462,0,0,0,1.0,1,1.0,1,1.0,1,0.10598065208149086,60
4974,0,10230,3768,6462,0,0,0,1.0,1,1.0,1,1.0,1,0.12041586201910795,58
4975,1,10231,3768,6463,0,0,0,1.0,1,1.0,1,1.0,1,0.11667341141765682,59
4976,3,10234,3770,6464,0,0,0,1.0,1,1.0,1,1.0,1,0.10308931737948923,59
4977,2,10236,3772,6464,0,0,0,1.0,1,1.0,1,1.0,1,0.11571505269287309,59
4978,3,10239,3773,6466,0,0,0,1.0,1,1.0,1,1.0,1,0.0946530529612726,59
4979,3,10242,3774,6468,0,0,0,1.0,1,1.0,1,1.0,1,0.10355557360748563,61
4980,2,10244,3774,6470,0,0,0,1.0,1,1.0,1,1.0,1,0.09164532319008556,62
4981,2,10246,3774,6472,0,0,0,1.0,1,1.0,1,1.0,1,0.055864868635835174,62
4982,2,10248,3775,6473,0,0,0,1.0,1,1.0,1,1.0,1,0.07141093503016584,63
4983,0,10248,3775,6473,0,0,0,1.0,1,1.0,1,1.0,1,0.07016476401263316,63
4984,4,10252,3777,6475,0,0,0,1.0,1,1.0,1,1.0,1,0.05562417126744236,61
4985,0,10252,3777,6475,0,0,0,1.0,1,1.0,1,1.0,1,0.06505759791369692,59
4986,3,10255,3778,6477,0,0,0,1.0,1,1.0,1,1.0,1,0.08575370673282194,62
4987,4,10259,3780,6479,0,0,0,1.0,1,1.0,1,1.0,1,0.06856129541349457,60
4988,1,10260,3781,6479,0,0,0,1.0,1,1.0,1,1.0,1,0.06909358527028818,59
4989,5,10265,3784,6481,0,0,0,1.0,1,1.0,1,1.0,1,0.09274300701888812,57
4990,3,10268,3784,6484,0,0,0,1.0,1,1.0,1,1.0,1,0.09199103489882776,55
4991,3,10271,3786,6485,0,0,0,1.0,1,1.0,1,1.0,1,0.09796222754551971,54
4992,1,10272,3786,6486,0,0,0,1.0,1,1.0,1,1.0,1,0.09534963724377743,52
4993,2,10274,3787,6487,0,0,0,1.0,1,1.0,1,1.0,1,0.08602151151330871,51
4994,2,10276,3789,6487,0,0,0,1.0,1,1.0,1,1.0,1,0.08105445601994696,49
4995,3,10279,3791,6488,0,0,0,1.0,1,1.0,1,1.0,1,0.10799109588988273,48
4996,6,10285,3797,6488,0,0,0,1.0,1,1.0,1,1.0,1,0.13546346141977286,48
4997,1,10286,3798,6488,0,0,0,1.0,1,1.0,1,1.0,1,0.13655355851085096,46
4998,4,10290,3799,6491,0,0,0,1.0,1,1.0,1,1.0,1,0.1449824490804483,48
4999,7,10297,3800,6497,0,0,0,1.0,1,1.0,1,1.0,1,0.1307300308412214,48
5000,1,10298,3800,6498,0,0,0,1.0,1,1.0,1,1.0,1,0.11501560819747118,47
5001,0,10298,3800,6498,0,0,0,1.0,1,1.0,1,1.0,1,0.14315610707996607,45
5002,6,10304,3801,6503,0,0,0,1.0,1,1.0,1,1.0,1,0.14961432510971087,46
5003,4,10308,3801,6507,0,0,0,1.0,1,1.0,1,1.0,1,0.17732238397243769,46
5004,4,10312,3802,6510,0,0,0,1.0,1,1.0,1,1.0,1,0.16818719350339875,46
5005,1,10313,3802,6511,0,0,0,1.0,1,1.0,1,1.0,1,0.18697551255443612,45
5006,0,10313,3802,6511,0,0,0,1.0,1,1.0,1,1.0,1,0.19685083284373064,45
5007,2,10315,3803,6512,0,0,0,1.0,1,1.0,1,1.0,1,0.177532397133323,46
5008,2,10317,3803,6514,0,0,0,1.0,1,1.0,1,1.0,1,0.16163282800228002,49
5009,0,10317,3803,6514,0,0,0,1.0,1,1.0,1,1.0,1,0.15157418068690473,49
5010,1,10318,3803,6515,0,0,0,1.0,1,1.0,1,1.0,1,0.14704825720743728,50
5011,1,10319,3803,6516,0,0,0,1.0,1,1.0,1,1.0,1,0.14326897454575047,51
5012,0,10319,3803,6516,0,0,0,1.0,1,1.0,1,1.0,1,0.1535361075020402,52
5013,0,10319,3803,6516,0,0,0,1.0,1,1.0,1,1.0,1,0.1535361075020402,52
5014,0,10319,3803,6516,0,0,0,1.0,1,1.0,1,1.0,1,0.16317399928546644,53
5015,5,10324,3804,6520,0,0,0,1.0,1,1.0,1,1.0,1,0.14302646274240532,54
5016,4,10328,3805,6523,0,0,0,1.0,1,1.0,1,1.0,1,0.14339110130917676,55
5017,2,10330,3805,6525,0,0,0,1.0,1,1.0,1,1.0,1,0.1186860322199103,55
5018,1,10331,3805,6526,0,0,0,1.0,1,1.0,1,1.0,1,0.12519560102701172,56
5019,1,10332,3805,6527,0,0,0,1.0,1,1.0,1,1.0,1,0.1176056442793613,56
5020,3,10335,3805,6530,0,0,0,1.0,1,1.0,1,1.0,1,0.08412656031809321,55
5021,0,10335,3805,6530,0,0,0,1.0,1,1.0,1,1.0,1,0.09703809601099424,56
5022,2,10337,3807,6530,0,0,0,1.0,1,1.0,1,1.0,1,0.1061653091705043,56
5023,1,10338,3808,6530,0,0,0,1.0,1,1.0,1,1.0,1,0.08827292734687897,55
5024,3,10341,3811,6530,0,0,0,1.0,1,1.0,1,1.0,1,0.13686531390160178,55
5025,3,10344,3813,6531,0,0,0,1.0,1,1.0,1,1.0,1,0.1181821235790915,53
5026,4,10348,3816,6532,0,0,0,1.0,1,1.0,1,1.0,1,0.11596483178199161,52
5027,2,10350,3817,6533,0,0,0,1.0,1,1.0,1,1.0,1,0.13711691858979436,51
5028,5,10355,3820,6535,0,0,0,1.0,1,1.0,1,1.0,1,0.16833988271619907,51
5029,2,10357,3821,6536,0,0,0,1.0,1,1.0,1,1.0,1,0.16184239261775551,50
5030,1,10358,3822,6536,0,0,0,1.0,1,1.0,1,1.0,1,0.1196097582163209,49
5031,1,10359,3823,6536,0,0,0,1.0,1,1.0,1,1.0,1,0.12449192139009511,49
5032,2,10361,3825,6536,0,0,0,1.0,1,1.0,1,1.0,1,0.1495179771644886,48
5033,4,10365,3827,6538,0,0,0,1.0,1,1.0,1,1.0,1,0.16386419809685626,50
5034,0,10365,3827,6538,0,0,0,1.0,1,1.0,1,1.0,1,0.14636370022023998,49
5035,5,10370,3829,6541,0,0,0,1.0,1,1.0,1,1.0,1,0.1457881303238939,49
5036,1,10371,3830,6541,0,0,0,1.0,1,1.0,1,1.0,1,0.12907101548485456,47
5037,2,10373,3830,6543,0,0,0,1.0,1,1.0,1,1.0,1,0.11196903976953973,47
5038,0,10373,3830,6543,0,0,0,1.0,1,1.0,1,1.0,1,0.1313557402042936,47
5039,0,10373,3830,6543,0,0,0,1.0,1,1.0,1,1.0,1,0.12547483420327354,48
5040,0,10373,3830,6543,0,0,0,1.0,1,1.0,1,1.0,1,0.12547483420327354,48
5041,1,10374,3831,6543,0,0,0,1.0,1,1.0,1,1.0,1,0.11510192505306628,48
5042,0,10374,3831,6543,0,0,0,1.0,1,1.0,1,1.0,1,0.1126287326164777,50
5043,0,10374,3831,6543,0,0,0,1.0,1,1.0,1,1.0,1,0.1165130977955707,51
5044,1,10375,3831,6544,0,0,0,1.0,1,1.0,1,1.0,1,0.10318339175623863,51
5045,1,10376,3831,6545,0,0,0,1.0,1,1.0,1,1.0,1,0.09844897533569098,52
5046,4,10380,3832,6548,0,0,0,1.0,1,1.0,1,1.0,1,0.08516941895643093,51
5047,0,10380,3832,6548,0,0,0,1.0,1,1.0,1,1.0,1,0.08516941895643093,51
5048,1,10381,3833,6548,0,0,0,1.0,1,1.0,1,1.0,1,0.08943204188624057,52
5049,1,10382,3833,6549,0,0,0,1.0,1,1.0,1,1.0,1,0.10447132803880915,54
5050,1,10383,3833,6550,0,0,0,1.0,1,1.0,1,1.0,1,0.09656612989572617,56
5051,0,10383,3833,6550,0,0,0,1.0,1,1.0,1,1.0,1,0.1134031225622104,55
5052,0,10383,3833,6550,0,0,0,1.0,1,1.0,1,1.0,1,0.1134031225622104,55
5053,0,10383,3833,6550,0,0,0,1.0,1,1.0,1,1.0,1,0.1134031225622104,55
5054,1,10384,3834,6550,0,0,0,1.0,1,1.0,1,1.0,1,0.12812086924885538,55
5055,1,10385,3834,6551,0,0,0,1.0,1,1.0,1,1.0,1,0.14672151778834003,55
5056,5,10390,3835,6555,0,0,0,1.0,1,1.0,1,1.0,1,0.1379485428783102,56
5057,1,10391,3836,6555,0,0,0,1.0,1,1.0,1,1.0,1,0.13622985565548676,58
5058,3,10394,3837,6557,0,0,0,1.0,1,1.0,1,1.0,1,0.13162149796007552,59
5059,3,10397,3837,6560,0,0,0,1.0,1,1.0,1,1.0,1,0.09159508535309228,59
5060,1,10398,3837,6561,0,0,0,1.0,1,1.0,1,1.0,1,0.08231716095222189,59
5061,2,10400,3837,6563,0,0,0,1.0,1,1.0,1,1.0,1,0.09103110233411238,59
5062,2,10402,3839,6563,0,0,0,1.0,1,1.0,1,1.0,1,0.15062305589372776,59
5063,2,10404,3839,6565,0,0,0,1.0,1,1.0,1,1.0,1,0.12745937026419957,59
5064,5,10409,3844,6565,0,0,0,1.0,1,1.0,1,1.0,1,0.20256645313804836,57
5065,5,10414,3845,6569,0,0,0,1.0,1,1.0,1,1.0,1,0.14669960590087655,55
5066,5,10419,3847,6572,0,0,0,1.0,1,1.0,1,1.0,1,0.16925811341449828,55
5067,3,10422,3847,6575,0,0,0,1.0,1,1.0,1,1.0,1,0.14114451266695935,54
5068,1,10423,3847,6576,0,0,0,1.0,1,1.0,1,1.0,1,0.12104052431003522,54
5069,3,10426,3849,6577,0,0,0,1.0,1,1.0,1,1.0,1,0.13101346773897596,54
5070,1,10427,3850,6577,0,0,0,1.0,1,1.0,1,1.0,1,0.12795316347407115,52
5071,4,10431,3851,6580,0,0,0,1.0,1,1.0,1,1.0,1,0.0994116271110707,54
5072,0,10431,3851,6580,0,0,0,1.0,1,1.0,1,1.0,1,0.08921159749519672,52
5073,1,10432,3851,6581,0,0,0,1.0,1,1.0,1,1.0,1,0.09500846474785474,51
5074,1,10433,3852,6581,0,0,0,1.0,1,1.0,1,1.0,1,0.11232014523678956,52
5075,0,10433,3852,6581,0,0,0,1.0,1,1.0,1,1.0,1,0.11979652091575946,53
5076,0,10433,3852,6581,0,0,0,1.0,1,1.0,1,1.0,1,0.11979652091575946,53
5077,2,10435,3854,6581,0,0,0,1.0,1,1.0,1,1.0,1,0.11390155119790761,56
5078,2,10437,3854,6583,0,0,0,1.0,1,1.0,1,1.0,1,0.07589450485365797,55
5079,2,10439,3854,6585,0,0,0,1.0,1,1.0,1,1.0,1,0.08627704070848399,56
5080,2,10441,3854,6587,0,0,0,1.0,1,1.0,1,1.0,1,0.07263923227735211,57
5081,1,10442,3854,6588,0,0,0,1.0,1,1.0,1,1.0,1,0.06639347759940833,58
5082,0,10442,3854,6588,0,0,0,1.0,1,1.0,1,1.0,1,0.06639347759940833,58
5083,0,10442,3854,6588,0,0,0,1.0,1,1.0,1,1.0,1,0.07367242005568296,59
5084,1,10443,3855,6588,0,0,0,1.0,1,1.0,1,1.0,1,0.07642681979381727,59
5085,1,10444,3856,6588,0,0,0,1.0,1,1.0,1,1.0,1,0.0929807504821757,60
5086,2,10446,3856,6590,0,0,0,1.0,1,1.0,1,1.0,1,0.0716844454880939,61
5087,4,10450,3858,6592,0,0,0,1.0,1,1.0,1,1.0,1,0.09161150616670871,62
5088,2,10452,3859,6593,0,0,0,1.0,1,1.0,1,1.0,1,0.09875562232766427,64
5089,4,10456,3862,6594,0,0,0,1.0,1,1.0,1,1.0,1,0.11207993051936312,64
5090,3,10459,3863,6596,0,0,0,1.0,1,1.0,1,1.0,1,0.08588369844323791,64
5091,3,10462,3866,6596,0,0,0,1.0,1,1.0,1,1.0,1,0.10698627751167726,64
5092,2,10464,3868,6596,0,0,0,1.0,1,1.0,1,1.0,1,0.13437760087408143,64
5093,0,10464,3868,6596,0,0,0,1.0,1,1.0,1,1.0,1,0.13437760087408143,64
5094,2,10466,3869,6597,0,0,0,1.0,1,1.0,1,1.0,1,0.13259733102728552,65
5095,3,10469,3870,6599,0,0,0,1.0,1,1.0,1,1.0,1,0.09514169914892745,66
5096,0,10469,3870,6599,0,0,0,1.0,1,1.0,1,1.0,1,0.10435385746951414,66
5097,2,10471,3872,6599,0,0,0,1.0,1,1.0,1,1.0,1,0.10516330040098694,67
5098,1,10472,3872,6600,0,0,0,1.0,1,1.0,1,1.0,1,0.0909891990190206,67
5099,3,10475,3873,6602,0,0,0,1.0,1,1.0,1,1.0,1,0.08426102570802577,70
5100,1,10476,3873,6603,0,0,0,1.0,1,1.0,1,1.0,1,0.08205179947157627,71
5101,4,10480,3875,6605,0,0,0,1.0,1,1.0,1,1.0,1,0.08604238556739177,72
5102,6,10486,3879,6607,0,0,0,1.0,1,1.0,1,1.0,1,0.10509124275997571,72
5103,3,10489,3880,6609,0,0,0,1.0,1,1.0,1,1.0,1,0.08545612679024579,70
5104,4,10493,3882,6611,0,0,0,1.0,1,1.0,1,1.0,1,0.10854344214429922,67
5105,2,10495,3882,6613,0,0,0,1.0,1,1.0,1,1.0,1,0.09732461787041786,66
5106,2,10497,3884,6613,0,0,0,1.0,1,1.0,1,1.0,1,0.11537184735498483,64
5107,5,10502,3887,6615,0,0,0,1.0,1,1.0,1,1.0,1,0.10791735134751754,61
5108,2,10504,3888,6616,0,0,0,1.0,1,1.0,1,1.0,1,0.10002512208613565,57
5109,5,10509,3893,6616,0,0,0,1.0,1,1.0,1,1.0,1,0.15724565179977754,55
5110,9,10518,3895,6623,0,0,0,1.0,1,1.0,1,1.0,1,0.09511782550533965,53
5111,2,10520,3897,6623,0,0,0,1.0,1,1.0,1,1.0,1,0.12571635964567351,52
5112,3,10523,3900,6623,0,0,0,1.0,1,1.0,1,1.0,1,0.14932450276982626,52
5113,5,10528,3900,6628,0,0,0,1.0,1,1.0,1,1.0,1,0.07680591260636026,49
5114,4,10532,3904,6628,0,0,0,1.0,1,1.0,1,1.0,1,0.1265492207557515,49
5115,2,10534,3904,6630,0,0,0,1.0,1,1.0,1,1.0,1,0.11520344007584335,48
5116,1,10535,3904,6631,0,0,0,1.0,1,1.0,1,1.0,1,0.09863746412653206,47
5117,0,10535,3904,6631,0,0,0,1.0,1,1.0,1,1.0,1,0.10893854265468945,48
5118,0,10535,3904,6631,0,0,0,1.0,1,1.0,1,1.0,1,0.09847595210505607,49
5119,0,10535,3904,6631,0,0,0,1.0,1,1.0,1,1.0,1,0.09847595210505607,49
5120,1,10536,3905,6631,0,0,0,1.0,1,1.0,1,1.0,1,0.09762270932133396,48
5121,1,10537,3906,6631,0,0,0,1.0,1,1.0,1,1.0,1,0.13396149987436945,48
5122,3,10540,3907,6633,0,0,0,1.0,1,1.0,1,1.0,1,0.1370323666182489,46
5123,1,10541,3908,6633,0,0,0,1.0,1,1.0,1,1.0,1,0.14859881728503888,46
5124,2,10543,3908,6635,0,0,0,1.0,1,1.0,1,1.0,1,0.1339803292058957,47
5125,8,10551,3909,6642,0,0,0,1.0,1,1.0,1,1.0,1,0.11829651128783397,49
5126,1,10552,3909,6643,0,0,0,1.0,1,1.0,1,1.0,1,0.10904755274024991,49
5127,5,10557,3910,6647,0,0,0,1.0,1,1.0,1,1.0,1,0.13265535474724374,51
5128,5,10562,3911,6651,0,0,0,1.0,1,1.0,1,1.0,1,0.11186032968370159,53
5129,2,10564,3912,6652,0,0,0,1.0,1,1.0,1,1.0,1,0.13462560240628854,55
5130,0,10564,3912,6652,0,0,0,1.0,1,1.0,1,1.0,1,0.13462560240628854,55
5131,2,10566,3912,6654,0,0,0,1.0,1,1.0,1,1.0,1,0.10981769228556033,55
5132,0,10566,3912,6654,0,0,0,1.0,1,1.0,1,1.0,1,0.10981769228556033,55
5133,0,10566,3912,6654,0,0,0,1.0,1,1.0,1,1.0,1,0.10740966655921375,56
5134,2,10568,3912,6656,0,0,0,1.0,1,1.0,1,1.0,1,0.11733208665110252,56
5135,2,10570,3913,6657,0,0,0,1.0,1,1.0,1,1.0,1,0.11495711380078655,56
5136,0,10570,3913,6657,0,0,0,1.0,1,1.0,1,1.0,1,0.12824559202482885,55
5137,2,10572,3914,6658,0,0,0,1.0,1,1.0,1,1.0,1,0.14179771736063032,55
5138,2,10574,3914,6660,0,0,0,1.0,1,1.0,1,1.0,1,0.13729191587090137,54
5139,1,10575,3915,6660,0,0,0,1.0,1,1.0,1,1.0,1,0.13045779586869868,54
5140,4,10579,3916,6663,0,0,0,1.0,1,1.0,1,1.0,1,0.09194893389728606,54
5141,2,10581,3918,6663,0,0,0,1.0,1,1.0,1,1.0,1,0.13624412335091382,53
5142,6,10587,3921,6666,0,0,0,1.0,1,1.0,1,1.0,1,0.1392568167681754,55
5143,6,10593,3925,6668,0,0,0,1.0,1,1.0,1,1.0,1,0.10137972948528087,54
5144,4,10597,3926,6671,0,0,0,1.0,1,1.0,1,1.0,1,0.07247729504089609,50
5145,1,10598,3927,6671,0,0,0,1.0,1,1.0,1,1.0,1,0.11436853279378047,51
5146,1,10599,3928,6671,0,0,0,1.0,1,1.0,1,1.0,1,0.11371519286974784,48
5147,4,10603,3930,6673,0,0,0,1.0,1,1.0,1,1.0,1,0.09715055346073774,49
5148,0,10603,3930,6673,0,0,0,1.0,1,1.0,1,1.0,1,0.06912301832914167,47
5149,2,10605,3932,6673,0,0,0,1.0,1,1.0,1,1.0,1,0.1508527901520239,46
5150,8,10613,3936,6677,0,0,0,1.0,1,1.0,1,1.0,1,0.14867345846788163,46
5151,0,10613,3936,6677,0,0,0,1.0,1,1.0,1,1.0,1,0.12911681665150962,45
5152,3,10616,3939,6677,0,0,0,1.0,1,1.0,1,1.0,1,0.17519459179654145,45
5153,2,10618,3939,6679,0,0,0,1.0,1,1.0,1,1.0,1,0.17312716805839817,45
5154,1,10619,3940,6679,0,0,0,1.0,1,1.0,1,1.0,1,0.17552094453607409,45
5155,4,10623,3941,6682,0,0,0,1.0,1,1.0,1,1.0,1,0.15799027562028406,44
5156,4,10627,3943,6684,0,0,0,1.0,1,1.0,1,1.0,1,0.15941610371633574,44
5157,0,10627,3943,6684,0,0,0,1.0,1,1.0,1,1.0,1,0.17664553693760182,42
5158,2,10629,3943,6686,0,0,0,1.0,1,1.0,1,1.0,1,0.14373680350602375,43
5159,0,10629,3943,6686,0,0,0,1.0,1,1.0,1,1.0,1,0.17876234964615587,43
5160,0,10629,3943,6686,0,0,0,1.0,1,1.0,1,1.0,1,0.17876234964615587,43
5161,1,10630,3943,6687,0,0,0,1.0,1,1.0,1,1.0,1,0.1680972516483231,43
5162,1,10631,3943,6688,0,0,0,1.0,1,1.0,1,1.0,1,0.14697046942432276,44
5163,1,10632,3943,6689,0,0,0,1.0,1,1.0,1,1.0,1,0.14851377431872329,46
5164,4,10636,3944,6692,0,0,0,1.0,1,1.0,1,1.0,1,0.11429409513874039,46
5165,1,10637,3945,6692,0,0,0,1.0,1,1.0,1,1.0,1,0.13718573680410234,46
5166,3,10640,3946,6694,0,0,0,1.0,1,1.0,1,1.0,1,0.14977200006422742,47
5167,0,10640,3946,6694,0,0,0,1.0,1,1.0,1,1.0,1,0.14977200006422742,47
5168,6,10646,3948,6698,0,0,0,1.0,1,1.0,1,1.0,1,0.13756984513446444,47
5169,0,10646,3948,6698,0,0,0,1.0,1,1.0,1,1.0,1,0.13756984513446444,47
5170,4,10650,3949,6701,0,0,0,1.0,1,1.0,1,1.0,1,0.11502966303266121,48
5171,1,10651,3950,6701,0,0,0,1.0,1,1.0,1,1.0,1,0.13455369402351564,48
5172,0,10651,3950,6701,0,0,0,1.0,1,1.0,1,1.0,1,0.10691875529127476,49
5173,0,10651,3950,6701,0,0,0,1.0,1,1.0,1,1.0,1,0.11431647574724078,49
5174,1,10652,3950,6702,0,0,0,1.0,1,1.0,1,1.0,1,0.10546094819573797,52
5175,0,10652,3950,6702,0,0,0,1.0,1,1.0,1,1.0,1,0.10343336779943184,53
5176,1,10653,3950,6703,0,0,0,1.0,1,1.0,1,1.0,1,0.10393732711337884,54
5177,2,10655,3952,6703,0,0,0,1.0,1,1.0,1,1.0,1,0.12038655329449097,54
5178,4,10659,3954,6705,0,0,0,1.0,1,1.0,1,1.0,1,0.16108190547404738,55
5179,2,10661,3956,6705,0,0,0,1.0,1,1.0,1,1.0,1,0.1749271748509242,53
5180,4,10665,3958,6707,0,0,0,1.0,1,1.0,1,1.0,1,0.15075840863548767,52
5181,4,10669,3960,6709,0,0,0,1.0,1,1.0,1,1.0,1,0.13636643523602635,52
5182,2,10671,3960,6711,0,0,0,1.0,1,1.0,1,1.0,1,0.0923220030179173,52
5183,3,10674,3962,6712,0,0,0,1.0,1,1.0,1,1.0,1,0.10720655627952581,52
5184,0,10674,3962,6712,0,0,0,1.0,1,1.0,1,1.0,1,0.10716766631745317,52
5185,3,10677,3963,6714,0,0,0,1.0,1,1.0,1,1.0,1,0.11786636462517956,50
5186,1,10678,3964,6714,0,0,0,1.0,1,1.0,1,1.0,1,0.17669315376502212,48
5187,1,10679,3965,6714,0,0,0,1.0,1,1.0,1,1.0,1,0.17633253929457454,46
5188,3,10682,3965,6717,0,0,0,1.0,1,1.0,1,1.0,1,0.12193312925473819,44
5189,1,10683,3965,6718,0,0,0,1.0,1,1.0,1,1.0,1,0.10621786988948376,44
5190,0,10683,3965,6718,0,0,0,1.0,1,1.0,1,1.0,1,0.10266942058380944,45
5191,0,10683,3965,6718,0,0,0,1.0,1,1.0,1,1.0,1,0.1030720023519205,45
5192,2,10685,3966,6719,0,0,0,1.0,1,1.0,1,1.0,1,0.10748024539806525,45
5193,0,10685,3966,6719,0,0,0,1.0,1,1.0,1,1.0,1,0.10748024539806525,45
5194,0,10685,3966,6719,0,0,0,1.0,1,1.0,1,1.0,1,0.11045385209840186,45
5195,3,10688,3967,6721,0,0,0,1.0,1,1.0,1,1.0,1,0.1220257900088861,46
5196,2,10690,3967,6723,0,0,0,1.0,1,1.0,1,1.0,1,0.1220257900088861,46
5197,3,10693,3968,6725,0,0,0,1.0,1,1.0,1,1.0,1,0.12573872164107308,46
5198,1,10694,3968,6726,0,0,0,1.0,1,1.0,1,1.0,1,0.09614207151468747,47
5199,1,10695,3969,6726,0,0,0,1.0,1,1.0,1,1.0,1,0.126532219372149,49
5200,5,10700,3970,6730,0,0,0,1.0,1,1.0,1,1.0,1,0.09226975311771965,49
5201,2,10702,3972,6730,0,0,0,1.0,1,1.0,1,1.0,1,0.09037194261652987,50
5202,1,10703,3972,6731,0,0,0,1.0,1,1.0,1,1.0,1,0.09834968912626511,52
5203,0,10703,3972,6731,0,0,0,1.0,1,1.0,1,1.0,1,0.09834968912626511,52
5204,2,10705,3972,6733,0,0,0,1.0,1,1.0,1,1.0,1,0.10203355691497379,54
5205,1,10706,3972,6734,0,0,0,1.0,1,1.0,1,1.0,1,0.08280556874331041,54
5206,3,10709,3972,6737,0,0,0,1.0,1,1.0,1,1.0,1,0.053118923390549,55
5207,0,10709,3972,6737,0,0,0,1.0,1,1.0,1,1.0,1,0.06985445305751922,54
5208,0,10709,3972,6737,0,0,0,1.0,1,1.0,1,1.0,1,0.06985445305751922,54
5209,2,10711,3973,6738,0,0,0,1.0,1,1.0,1,1.0,1,0.09164085723153693,54
5210,0,10711,3973,6738,0,0,0,1.0,1,1.0,1,1.0,1,0.09164085723153693,54
5211,0,10711,3973,6738,0,0,0,1.0,1,1.0,1,1.0,1,0.10583660718224237,56
5212,2,10713,3973,6740,0,0,0,1.0,1,1.0,1,1.0,1,0.08307436934882664,57
5213,3,10716,3976,6740,0,0,0,1.0,1,1.0,1,1.0,1,0.12800830762281595,57
5214,4,10720,3978,6742,0,0,0,1.0,1,1.0,1,1.0,1,0.17164364894918474,58
5215,4,10724,3978,6746,0,0,0,1.0,1,1.0,1,1.0,1,0.15583492073530864,57
5216,2,10726,3979,6747,0,0,0,1.0,1,1.0,1,1.0,1,0.13610802412682974,57
5217,0,10726,3979,6747,0,0,0,1.0,1,1.0,1,1.0,1,0.10262080630814127,56
5218,4,10730,3982,6748,0,0,0,1.0,1,1.0,1,1.0,1,0.11204430029443725,56
5219,1,10731,3982,6749,0,0,0,1.0,1,1.0,1,1.0,1,0.14143571224805485,54
5220,2,10733,3983,6750,0,0,0,1.0,1,1.0,1,1.0,1,0.14527199521815895,53
5221,3,10736,3983,6753,0,0,0,1.0,1,1.0,1,1.0,1,0.12072182114169686,52
5222,2,10738,3983,6755,0,0,0,1.0,1,1.0,1,1.0,1,0.13731921289194254,52
5223,2,10740,3984,6756,0,0,0,1.0,1,1.0,1,1.0,1,0.15492668341130011,52
5224,4,10744,3986,6758,0,0,0,1.0,1,1.0,1,1.0,1,0.13739118138560136,52
5225,1,10745,3986,6759,0,0,0,1.0,1,1.0,1,1.0,1,0.15302054123983067,50
5226,3,10748,3987,6761,0,0,0,1.0,1,1.0,1,1.0,1,0.1376900806643465,51
5227,7,10755,3988,6767,0,0,0,1.0,1,1.0,1,1.0,1,0.09923615398361596,49
5228,0,10755,3988,6767,0,0,0,1.0,1,1.0,1,1.0,1,0.11818915829922477,48
5229,1,10756,3988,6768,0,0,0,1.0,1,1.0,1,1.0,1,0.14068476250258247,49
5230,3,10759,3988,6771,0,0,0,1.0,1,1.0,1,1.0,1,0.08555466307278564,49
5231,1,10760,3989,6771,0,0,0,1.0,1,1.0,1,1.0,1,0.0935312512937016,49
5232,5,10765,3990,6775,0,0,0,1.0,1,1.0,1,1.0,1,0.07995823169488178,51
5233,2,10767,3991,6776,0,0,0,1.0,1,1.0,1,1.0,1,0.09796929613739144,51
5234,6,10773,3996,6777,0,0,0,1.0,1,1.0,1,1.0,1,0.13638118177664105,52
5235,2,10775,3996,6779,0,0,0,1.0,1,1.0,1,1.0,1,0.11316190857434082,52
5236,1,10776,3996,6780,0,0,0,1.0,1,1.0,1,1.0,1,0.08903056705961969,52
5237,1,10777,3996,6781,0,0,0,1.0,1,1.0,1,1.0,1,0.08884230963412941,53
5238,1,10778,3996,6782,0,0,0,1.0,1,1.0,1,1.0,1,0.08147391521361638,53
5239,0,10778,3996,6782,0,0,0,1.0,1,1.0,1,1.0,1,0.08147391521361638,53
5240,2,10780,3998,6782,0,0,0,1.0,1,1.0,1,1.0,1,0.13129376046317132,55
5241,2,10782,3998,6784,0,0,0,1.0,1,1.0,1,1.0,1,0.10822066651804864,56
5242,3,10785,3999,6786,0,0,0,1.0,1,1.0,1,1.0,1,0.08914764051480138,54
5243,1,10786,4000,6786,0,0,0,1.0,1,1.0,1,1.0,1,0.10947215173519,55
5244,2,10788,4002,6786,0,0,0,1.0,1,1.0,1,1.0,1,0.14496886608220735,55
5245,4,10792,4003,6789,0,0,0,1.0,1,1.0,1,1.0,1,0.10544768533615909,55
5246,2,10794,4004,6790,0,0,0,1.0,1,1.0,1,1.0,1,0.144769322873128,55
5247,1,10795,4005,6790,0,0,0,1.0,1,1.0,1,1.0,1,0.15821052451845707,54
5248,3,10798,4005,6793,0,0,0,1.0,1,1.0,1,1.0,1,0.1176634176583743,53
5249,3,10801,4007,6794,0,0,0,1.0,1,1.0,1,1.0,1,0.1496731862644004,55
5250,0,10801,4007,6794,0,0,0,1.0,1,1.0,1,1.0,1,0.1496731862644004,55
5251,6,10807,4008,6799,0,0,0,1.0,1,1.0,1,1.0,1,0.114707451044716,57
5252,2,10809,4009,6800,0,0,0,1.0,1,1.0,1,1.0,1,0.13484880723031717,58
5253,2,10811,4010,6801,0,0,0,1.0,1,1.0,1,1.0,1,0.13595854695790385,59
5254,3,10814,4010,6804,0,0,0,1.0,1,1.0,1,1.0,1,0.10234666310436584,59
5255,1,10815,4011,6804,0,0,0,1.0,1,1.0,1,1.0,1,0.1170567848928611,58
5256,1,10816,4012,6804,0,0,0,1.0,1,1.0,1,1.0,1,0.1412433578964432,59
5257,2,10818,4013,6805,0,0,0,1.0,1,1.0,1,1.0,1,0.12526533491680272,58
5258,1,10819,4014,6805,0,0,0,1.0,1,1.0,1,1.0,1,0.15897768944647242,56
5259,0,10819,4014,6805,0,0,0,1.0,1,1.0,1,1.0,1,0.17178668464140817,56
5260,4,10823,4016,6807,0,0,0,1.0,1,1.0,1,1.0,1,0.18478451045977268,55
5261,3,10826,4017,6809,0,0,0,1.0,1,1.0,1,1.0,1,0.1500690221008319,54
5262,1,10827,4018,6809,0,0,0,1.0,1,1.0,1,1.0,1,0.17402363184278738,54
5263,4,10831,4019,6812,0,0,0,1.0,1,1.0,1,1.0,1,0.16879251213360538,53
5264,3,10834,4020,6814,0,0,0,1.0,1,1.0,1,1.0,1,0.11426622666060622,51
5265,0,10834,4020,6814,0,0,0,1.0,1,1.0,1,1.0,1,0.10403704086924993,50
5266,5,10839,4022,6817,0,0,0,1.0,1,1.0,1,1.0,1,0.0966839076121137,49
5267,2,10841,4024,6817,0,0,0,1.0,1,1.0,1,1.0,1,0.14303285511075892,48
5268,2,10843,4025,6818,0,0,0,1.0,1,1.0,1,1.0,1,0.10531710221454901,47
5269,4,10847,4026,6821,0,0,0,1.0,1,1.0,1,1.0,1,0.11575315863009054,45
5270,1,10848,4026,6822,0,0,0,1.0,1,1.0,1,1.0,1,0.11449822819321989,47
5271,2,10850,4026,6824,0,0,0,1.0,1,1.0,1,1.0,1,0.11303636957127784,45
5272,3,10853,4029,6824,0,0,0,1.0,1,1.0,1,1.0,1,0.19719788646067163,46
5273,1,10854,4029,6825,0,0,0,1.0,1,1.0,1,1.0,1,0.1727581052098405,44
5274,3,10857,4030,6827,0,0,0,1.0,1,1.0,1,1.0,1,0.2154338480218052,44
5275,7,10864,4031,6833,0,0,0,1.0,1,1.0,1,1.0,1,0.09802983058666423,46
5276,0,10864,4031,6833,0,0,0,1.0,1,1.0,1,1.0,1,0.09802983058666423,46
5277,5,10869,4033,6836,0,0,0,1.0,1,1.0,1,1.0,1,0.11314387247427954,46
5278,3,10872,4034,6838,0,0,0,1.0,1,1.0,1,1.0,1,0.11761960072136385,46
5279,2,10874,4035,6839,0,0,0,1.0,1,1.0,1,1.0,1,0.13172582735993385,47
5280,2,10876,4036,6840,0,0,0,1.0,1,1.0,1,1.0,1,0.1369554252062629,47
5281,3,10879,4037,6842,0,0,0,1.0,1,1.0,1,1.0,1,0.1716689580055276,48
5282,0,10879,4037,6842,0,0,0,1.0,1,1.0,1,1.0,1,0.1716689580055276,48
5283,0,10879,4037,6842,0,0,0,1.0,1,1.0,1,1.0,1,0.1800734402556517,49
5284,1,10880,4037,6843,0,0,0,1.0,1,1.0,1,1.0,1,0.16419555105362327,49
5285,0,10880,4037,6843,0,0,0,1.0,1,1.0,1,1.0,1,0.14091114875176664,50
5286,0,10880,4037,6843,0,0,0,1.0,1,1.0,1,1.0,1,0.15566086735168166,51
5287,0,10880,4037,6843,0,0,0,1.0,1,1.0,1,1.0,1,0.15566086735168166,51
5288,1,10881,4037,6844,0,0,0,1.0,1,1.0,1,1.0,1,0.14028474819667938,51
5289,3,10884,4037,6847,0,0,0,1.0,1,1.0,1,1.0,1,0.11611420687078428,53
5290,2,10886,4037,6849,0,0,0,1.0,1,1.0,1,1.0,1,0.06755745017145723,53
5291,1,10887,4038,6849,0,0,0,1.0,1,1.0,1,1.0,1,0.09358338955876859,53
5292,2,10889,4040,6849,0,0,0,1.0,1,1.0,1,1.0,1,0.11277187927043333,53
5293,1,10890,4040,6850,0,0,0,1.0,1,1.0,1,1.0,1,0.11324820102027391,53
5294,2,10892,4041,6851,0,0,0,1.0,1,1.0,1,1.0,1,0.10553891579645404,54
5295,2,10894,4043,6851,0,0,0,1.0,1,1.0,1,1.0,1,0.11589849161658093,52
5296,3,10897,4044,6853,0,0,0,1.0,1,1.0,1,1.0,1,0.09962233638788115,49
5297,1,10898,4045,6853,0,0,0,1.0,1,1.0,1,1.0,1,0.14607026098208192,49
5298,1,10899,4045,6854,0,0,0,1.0,1,1.0,1,1.0,1,0.1501120956134205,49
5299,2,10901,4046,6855,0,0,0,1.0,1,1.0,1,1.0,1,0.12313928304201598,50
5300,0,10901,4046,6855,0,0,0,1.0,1,1.0,1,1.0,1,0.13276403639828424,48
5301,1,10902,4047,6855,0,0,0,1.0,1,1.0,1,1.0,1,0.16774056530800863,46
5302,2,10904,4048,6856,0,0,0,1.0,1,1.0,1,1.0,1,0.16430800925209627,47
5303,3,10907,4050,6857,0,0,0,1.0,1,1.0,1,1.0,1,0.16485657174004748,46
5304,1,10908,4051,6857,0,0,0,1.0,1,1.0,1,1.0,1,0.20108154609995516,45
5305,2,10910,4051,6859,0,0,0,1.0,1,1.0,1,1.0,1,0.17224462052625159,44
5306,4,10914,4055,6859,0,0,0,1.0,1,1.0,1,1.0,1,0.23821477946964495,42
5307,2,10916,4055,6861,0,0,0,1.0,1,1.0,1,1.0,1,0.20216948627167308,42
5308,3,10919,4056,6863,0,0,0,1.0,1,1.0,1,1.0,1,0.17216081679187212,43
5309,1,10920,4057,6863,0,0,0,1.0,1,1.0,1,1.0,1,0.184863623297814,41
5310,2,10922,4058,6864,0,0,0,1.0,1,1.0,1,1.0,1,0.21336999092771947,41
5311,2,10924,4059,6865,0,0,0,1.0,1,1.0,1,1.0,1,0.18135576353845423,42
5312,1,10925,4059,6866,0,0,0,1.0,1,1.0,1,1.0,1,0.17948229184234996,43
5313,2,10927,4059,6868,0,0,0,1.0,1,1.0,1,1.0,1,0.14584211398778715,44
5314,1,10928,4059,6869,0,0,0,1.0,1,1.0,1,1.0,1,0.13437431011262194,44
5315,4,10932,4061,6871,0,0,0,1.0,1,1.0,1,1.0,1,0.15132365338462095,45
5316,1,10933,4061,6872,0,0,0,1.0,1,1.0,1,1.0,1,0.14782111955285218,46
5317,3,10936,4063,6873,0,0,0,1.0,1,1.0,1,1.0,1,0.1464992946966824,46
5318,1,10937,4064,6873,0,0,0,1.0,1,1.0,1,1.0,1,0.1439598406849642,46
5319,0,10937,4064,6873,0,0,0,1.0,1,1.0,1,1.0,1,0.15854210426488807,47
5320,6,10943,4065,6878,0,0,0,1.0,1,1.0,1,1.0,1,0.06371044615861343,48
5321,0,10943,4065,6878,0,0,0,1.0,1,1.0,1,1.0,1,0.07616384137415576,49
5322,0,10943,4065,6878,0,0,0,1.0,1,1.0,1,1.0,1,0.07616384137415576,49
5323,1,10944,4065,6879,0,0,0,1.0,1,1.0,1,1.0,1,0.09907529803519136,51
5324,0,10944,4065,6879,0,0,0,1.0,1,1.0,1,1.0,1,0.0981960689936714,53
5325,1,10945,4066,6879,0,0,0,1.0,1,1.0,1,1.0,1,0.11067414180256799,53
5326,1,10946,4067,6879,0,0,0,1.0,1,1.0,1,1.0,1,0.12890135570466565,53
5327,4,10950,4068,6882,0,0,0,1.0,1,1.0,1,1.0,1,0.11716985114297457,53
5328,1,10951,4068,6883,0,0,0,1.0,1,1.0,1,1.0,1,0.12168615471334443,54
5329,5,10956,4070,6886,0,0,0,1.0,1,1.0,1,1.0,1,0.12369437598493709,53
5330,2,10958,4072,6886,0,0,0,1.0,1,1.0,1,1.0,1,0.18325717725123894,52
5331,0,10958,4072,6886,0,0,0,1.0,1,1.0,1,1.0,1,0.1935263571224191,51
5332,3,10961,4072,6889,0,0,0,1.0,1,1.0,1,1.0,1,0.14724642451969738,52
5333,2,10963,4073,6890,0,0,0,1.0,1,1.0,1,1.0,1,0.1740044107618815,53
5334,4,10967,4074,6893,0,0,0,1.0,1,1.0,1,1.0,1,0.16134947132052102,54
5335,4,10971,4074,6897,0,0,0,1.0,1,1.0,1,1.0,1,0.09501032526772608,55
5336,1,10972,4074,6898,0,0,0,1.0,1,1.0,1,1.0,1,0.09197176942840887,54
5337,0,10972,4074,6898,0,0,0,1.0,1,1.0,1,1.0,1,0.10440019193569516,55
5338,1,10973,4075,6898,0,0,0,1.0,1,1.0,1,1.0,1,0.11808788087150035,55
5339,0,10973,4075,6898,0,0,0,1.0,1,1.0,1,1.0,1,0.11808788087150035,55
5340,0,10973,4075,6898,0,0,0,1.0,1,1.0,1,1.0,1,0.11808788087150035,55
5341,2,10975,4076,6899,0,0,0,1.0,1,1.0,1,1.0,1,0.15555813995015655,54
5342,0,10975,4076,6899,0,0,0,1.0,1,1.0,1,1.0,1,0.14807143235334375,55
5343,4,10979,4078,6901,0,0,0,1.0,1,1.0,1,1.0,1,0.14185587047751916,54
5344,4,10983,4081,6902,0,0,0,1.0,1,1.0,1,1.0,1,0.15958958155523284,55
5345,2,10985,4082,6903,0,0,0,1.0,1,1.0,1,1.0,1,0.12049574910620005,53
5346,4,10989,4084,6905,0,0,0,1.0,1,1.0,1,1.0,1,0.12409540374492468,53
5347,2,10991,4085,6906,0,0,0,1.0,1,1.0,1,1.0,1,0.13590234244500338,51
5348,6,10997,4087,6910,0,0,0,1.0,1,1.0,1,1.0,1,0.09415612447669677,53
5349,3,11000,4089,6911,0,0,0,1.0,1,1.0,1,1.0,1,0.09721852171208477,52
5350,3,11003,4090,6913,0,0,0,1.0,1,1.0,1,1.0,1,0.08434950389938958,50
5351,3,11006,4091,6915,0,0,0,1.0,1,1.0,1,1.0,1,0.0910231837637308,52
5352,1,11007,4092,6915,0,0,0,1.0,1,1.0,1,1.0,1,0.10300136297772232,49
5353,0,11007,4092,6915,0,0,0,1.0,1,1.0,1,1.0,1,0.10300136297772232,49
5354,1,11008,4092,6916,0,0,0,1.0,1,1.0,1,1.0,1,0.07897739880228483,49
5355,0,11008,4092,6916,0,0,0,1.0,1,1.0,1,1.0,1,0.10051518150463612,48
5356,5,11013,4094,6919,0,0,0,1.0,1,1.0,1,1.0,1,0.09986502356575985,49
5357,0,11013,4094,6919,0,0,0,1.0,1,1.0,1,1.0,1,0.12093984119835727,47
5358,1,11014,4095,6919,0,0,0,1.0,1,1.0,1,1.0,1,0.1304912093067198,48
5359,2,11016,4096,6920,0,0,0,1.0,1,1.0,1,1.0,1,0.10769569219163024,48
5360,0,11016,4096,6920,0,0,0,1.0,1,1.0,1,1.0,1,0.10769569219163024,48
5361,0,11016,4096,6920,0,0,0,1.0,1,1.0,1,1.0,1,0.10965170361168228,50
5362,1,11017,4096,6921,0,0,0,1.0,1,1.0,1,1.0,1,0.10171731445451922,50
5363,1,11018,4096,6922,0,0,0,1.0,1,1.0,1,1.0,1,0.08454221133178681,50
5364,1,11019,4097,6922,0,0,0,1.0,1,1.0,1,1.0,1,0.09629455738843584,51
5365,1,11020,4097,6923,0,0,0,1.0,1,1.0,1,1.0,1,0.11411261555585239,52
5366,0,11020,4097,6923,0,0,0,1.0,1,1.0,1,1.0,1,0.11411261555585239,52
5367,4,11024,4099,6925,0,0,0,1.0,1,1.0,1,1.0,1,0.13877339718819112,54
5368,4,11028,4100,6928,0,0,0,1.0,1,1.0,1,1.0,1,0.11115975321788509,55
5369,2,11030,4101,6929,0,0,0,1.0,1,1.0,1,1.0,1,0.09709971364878728,53
5370,2,11032,4102,6930,0,0,0,1.0,1,1.0,1,1.0,1,0.11888105568555958,54
5371,3,11035,4105,6930,0,0,0,1.0,1,1.0,1,1.0,1,0.16702749366616274,53
5372,4,11039,4108,6931,0,0,0,1.0,1,1.0,1,1.0,1,0.21502885533418692,53
5373,3,11042,4108,6934,0,0,0,1.0,1,1.0,1,1.0,1,0.1999655360456754,52
5374,7,11049,4110,6939,0,0,0,1.0,1,1.0,1,1.0,1,0.15210563414918654,51
5375,2,11051,4110,6941,0,0,0,1.0,1,1.0,1,1.0,1,0.11886823558166637,52
5376,5,11056,4113,6943,0,0,0,1.0,1,1.0,1,1.0,1,0.10793316783414925,51
5377,2,11058,4113,6945,0,0,0,1.0,1,1.0,1,1.0,1,0.08138186830475028,52
5378,1,11059,4114,6945,0,0,0,1.0,1,1.0,1,1.0,1,0.0980234634622458,50
5379,0,11059,4114,6945,0,0,0,1.0,1,1.0,1,1.0,1,0.0980234634622458,50
5380,2,11061,4114,6947,0,0,0,1.0,1,1.0,1,1.0,1,0.10769938305122854,52
5381,0,11061,4114,6947,0,0,0,1.0,1,1.0,1,1.0,1,0.10769938305122854,52
5382,1,11062,4114,6948,0,0,0,1.0,1,1.0,1,1.0,1,0.09668142339531326,52
5383,1,11063,4114,6949,0,0,0,1.0,1,1.0,1,1.0,1,0.0684736825029353,51
5384,0,11063,4114,6949,0,0,0,1.0,1,1.0,1,1.0,1,0.079749638764359,52
5385,1,11064,4115,6949,0,0,0,1.0,1,1.0,1,1.0,1,0.12128058230269377,51
5386,5,11069,4116,6953,0,0,0,1.0,1,1.0,1,1.0,1,0.0715956081562007,52
5387,1,11070,4116,6954,0,0,0,1.0,1,1.0,1,1.0,1,0.08364363998711283,53
5388,1,11071,4116,6955,0,0,0,1.0,1,1.0,1,1.0,1,0.08547552986812217,54
5389,1,11072,4117,6955,0,0,0,1.0,1,1.0,1,1.0,1,0.062473692253406474,55
5390,2,11074,4118,6956,0,0,0,1.0,1,1.0,1,1.0,1,0.06110329765356801,56
5391,1,11075,4119,6956,0,0,0,1.0,1,1.0,1,1.0,1,0.07120771411344103,56
5392,3,11078,4122,6956,0,0,0,1.0,1,1.0,1,1.0,1,0.11036457441965099,56
5393,1,11079,4123,6956,0,0,0,1.0,1,1.0,1,1.0,1,0.1391016302928452,54
5394,1,11080,4124,6956,0,0,0,1.0,1,1.0,1,1.0,1,0.15295062962685885,53
5395,4,11084,4125,6959,0,0,0,1.0,1,1.0,1,1.0,1,0.13166076897689125,53
5396,4,11088,4125,6963,0,0,0,1.0,1,1.0,1,1.0,1,0.09649679956579293,54
5397,4,11092,4127,6965,0,0,0,1.0,1,1.0,1,1.0,1,0.12240648657528298,53
5398,4,11096,4127,6969,0,0,0,1.0,1,1.0,1,1.0,1,0.05742734256371874,53
5399,11,11107,4130,6977,0,0,0,1.0,1,1.0,1,1.0,1,0.09292106293761329,55
5400,2,11109,4130,6979,0,0,0,1.0,1,1.0,1,1.0,1,0.09430349663718983,55
5401,4,11113,4132,6981,0,0,0,1.0,1,1.0,1,1.0,1,0.10391812357637525,56
5402,0,11113,4132,6981,0,0,0,1.0,1,1.0,1,1.0,1,0.0,0
