,SuccessfulHandoverCount,TotalSuccessfulHandoverCount,TotalSuccessfulHandoverCountRange,TotalSuccessfulHandoverCountLoadBalancing,TotalSuccessfulHandoverCountOverload,FailedHandoverCount,TotalFailedHandoverCount,AvgQoS,MinQoS,AvgQoS_LoadBased,MinQoS_LoadBased,AvgQoS_RangeBased,MinQoS_RangeBased,GiniLoad,VehicleCount
0,0,0,0,0,0,0,0,1.0,1,1.0,1,1.0,1,0.0,0
1,27,27,27,0,0,0,0,1.0,1,1.0,1,1.0,1,0.39050516080563324,26
2,21,48,48,0,0,0,0,1.0,1,1.0,1,1.0,1,0.379384355868756,27
3,18,66,66,0,0,0,0,1.0,1,1.0,1,1.0,1,0.2989236684515959,28
4,19,85,85,0,0,0,0,1.0,1,1.0,1,1.0,1,0.3156900018763717,29
5,20,105,105,0,0,0,0,1.0,1,1.0,1,1.0,1,0.38186625874311664,29
6,10,115,115,0,0,0,0,1.0,1,1.0,1,1.0,1,0.257896971269174,32
7,12,127,127,0,0,0,0,1.0,1,1.0,1,1.0,1,0.1954271024923558,33
8,18,145,145,0,0,0,0,1.0,1,1.0,1,1.0,1,0.2591266787554084,35
9,21,166,166,0,0,0,0,1.0,1,1.0,1,1.0,1,0.3054148213642207,35
10,18,184,184,0,0,0,0,1.0,1,1.0,1,1.0,1,0.2707805166598556,35
11,14,198,198,0,0,0,0,1.0,1,1.0,1,1.0,1,0.3879607336282463,35
12,12,210,210,0,0,0,0,1.0,1,1.0,1,1.0,1,0.34393569186639383,34
13,13,223,223,0,0,0,0,1.0,1,1.0,1,1.0,1,0.4125951920703137,32
14,9,232,232,0,0,0,0,1.0,1,1.0,1,1.0,1,0.43407091970603334,31
15,12,244,244,0,0,0,0,1.0,1,1.0,1,1.0,1,0.4597913953105632,30
16,9,253,253,0,0,0,0,1.0,1,1.0,1,1.0,1,0.41526456677102075,30
17,6,259,259,0,0,0,0,1.0,1,1.0,1,1.0,1,0.3104406987780828,29
18,8,267,267,0,0,0,0,1.0,1,1.0,1,1.0,1,0.3100444933910029,29
19,8,275,275,0,0,0,0,1.0,1,1.0,1,1.0,1,0.37733048746990183,28
20,7,282,282,0,0,0,0,1.0,1,1.0,1,1.0,1,0.3749381959104199,28
21,7,289,289,0,0,0,0,1.0,1,1.0,1,1.0,1,0.30382688111329464,28
22,10,299,299,0,0,0,0,1.0,1,1.0,1,1.0,1,0.4071187647217063,28
23,9,308,308,0,0,0,0,1.0,1,1.0,1,1.0,1,0.34718007853044586,27
24,12,320,320,0,0,0,0,1.0,1,1.0,1,1.0,1,0.41153425369698243,28
25,9,329,329,0,0,0,0,1.0,1,1.0,1,1.0,1,0.34965994582774645,28
26,14,343,343,0,0,0,0,1.0,1,1.0,1,1.0,1,0.1979013938870143,30
27,15,358,358,0,0,0,0,1.0,1,1.0,1,1.0,1,0.26268711459265526,30
28,7,365,365,0,0,0,0,1.0,1,1.0,1,1.0,1,0.21963060548910815,31
29,8,373,373,0,0,0,0,1.0,1,1.0,1,1.0,1,0.2622407484697077,30
30,6,379,379,0,0,0,0,1.0,1,1.0,1,1.0,1,0.22608315884213062,30
31,6,385,385,0,0,0,0,1.0,1,1.0,1,1.0,1,0.27508044358198414,31
32,5,390,390,0,0,0,0,1.0,1,1.0,1,1.0,1,0.3145590033863314,31
33,16,406,406,0,0,0,0,1.0,1,1.0,1,1.0,1,0.16752734798580188,31
34,10,416,416,0,0,0,0,1.0,1,1.0,1,1.0,1,0.3287763604897121,29
35,13,429,429,0,0,0,0,1.0,1,1.0,1,1.0,1,0.27552843495954915,30
36,14,443,443,0,0,0,0,1.0,1,1.0,1,1.0,1,0.30679955237828554,30
37,11,454,454,0,0,0,0,1.0,1,1.0,1,1.0,1,0.30161564412819997,31
38,16,470,470,0,0,0,0,1.0,1,1.0,1,1.0,1,0.2868443621610973,32
39,11,481,481,0,0,0,0,1.0,1,1.0,1,1.0,1,0.2726141794237174,36
40,10,491,491,0,0,0,0,1.0,1,1.0,1,1.0,1,0.3047076051734719,37
41,12,503,503,0,0,0,0,1.0,1,1.0,1,1.0,1,0.34612573903958455,37
42,10,513,513,0,0,0,0,1.0,1,1.0,1,1.0,1,0.28656950086489097,38
43,15,528,528,0,0,0,0,1.0,1,1.0,1,1.0,1,0.3551701699918694,40
44,10,538,538,0,0,0,0,1.0,1,1.0,1,1.0,1,0.3784128766312034,39
45,11,549,549,0,0,0,0,1.0,1,1.0,1,1.0,1,0.3361226429384917,40
46,11,560,560,0,0,0,0,1.0,1,1.0,1,1.0,1,0.34872405710613597,39
47,12,572,572,0,0,0,0,1.0,1,1.0,1,1.0,1,0.355611012101899,39
48,4,576,576,0,0,0,0,1.0,1,1.0,1,1.0,1,0.35471369072981984,39
49,5,581,581,0,0,0,0,1.0,1,1.0,1,1.0,1,0.3724766338691548,37
50,9,590,590,0,0,0,0,1.0,1,1.0,1,1.0,1,0.4451089560321052,35
51,14,604,604,0,0,0,0,1.0,1,1.0,1,1.0,1,0.46830256091317135,34
52,9,613,613,0,0,0,0,1.0,1,1.0,1,1.0,1,0.4307902576924,34
53,9,622,622,0,0,0,0,1.0,1,1.0,1,1.0,1,0.3624415619938757,35
54,10,632,632,0,0,0,0,1.0,1,1.0,1,1.0,1,0.3116471879317436,36
55,15,647,647,0,0,0,0,1.0,1,1.0,1,1.0,1,0.29871994443077393,36
56,10,657,657,0,0,0,0,1.0,1,1.0,1,1.0,1,0.41698671278798133,36
57,8,665,665,0,0,0,0,1.0,1,1.0,1,1.0,1,0.3459519123495702,37
58,6,671,671,0,0,0,0,1.0,1,1.0,1,1.0,1,0.4040497815401649,38
59,4,675,675,0,0,0,0,1.0,1,1.0,1,1.0,1,0.4931209873293389,37
60,7,682,682,0,0,0,0,1.0,1,1.0,1,1.0,1,0.4457277896241631,38
61,6,688,688,0,0,0,0,1.0,1,1.0,1,1.0,1,0.4637013612859314,37
62,7,695,695,0,0,0,0,1.0,1,1.0,1,1.0,1,0.39447832983346687,39
63,20,715,715,0,0,0,0,1.0,1,1.0,1,1.0,1,0.3383198634359664,39
64,11,726,726,0,0,0,0,1.0,1,1.0,1,1.0,1,0.3812299842803793,38
65,17,743,743,0,0,0,0,1.0,1,1.0,1,1.0,1,0.39394034038269476,39
66,9,752,752,0,0,0,0,1.0,1,1.0,1,1.0,1,0.37527947580981136,39
67,10,762,762,0,0,0,0,1.0,1,1.0,1,1.0,1,0.27059438709208056,36
68,8,770,770,0,0,0,0,1.0,1,1.0,1,1.0,1,0.3329813154174897,36
69,11,781,781,0,0,0,0,1.0,1,1.0,1,1.0,1,0.38500140693041945,37
70,7,788,788,0,0,0,0,1.0,1,1.0,1,1.0,1,0.45387670423850374,36
71,9,797,797,0,0,0,0,1.0,1,1.0,1,1.0,1,0.4544366196285242,38
72,10,807,807,0,0,0,0,1.0,1,1.0,1,1.0,1,0.5035294064810688,38
73,7,814,814,0,0,0,0,1.0,1,1.0,1,1.0,1,0.496494137320873,37
74,15,829,829,0,0,0,0,1.0,1,1.0,1,1.0,1,0.4457634733779122,38
75,11,840,840,0,0,0,0,1.0,1,1.0,1,1.0,1,0.49990131245727826,38
76,20,860,860,0,0,0,0,1.0,1,1.0,1,1.0,1,0.46150465579373623,39
77,6,866,866,0,0,0,0,1.0,1,1.0,1,1.0,1,0.4178632944981774,40
78,17,883,883,0,0,0,0,1.0,1,1.0,1,1.0,1,0.45224115189912123,41
79,15,898,898,0,0,0,0,1.0,1,1.0,1,1.0,1,0.3532019705919762,41
80,11,909,909,0,0,0,0,1.0,1,1.0,1,1.0,1,0.4317925397664162,41
81,11,920,920,0,0,0,0,1.0,1,1.0,1,1.0,1,0.5017265229084619,41
82,14,934,934,0,0,0,0,1.0,1,1.0,1,1.0,1,0.41471742477980383,44
83,13,947,947,0,0,0,0,1.0,1,1.0,1,1.0,1,0.4126944845557114,44
84,13,960,960,0,0,0,0,1.0,1,1.0,1,1.0,1,0.3862741469594141,45
85,10,970,970,0,0,0,0,1.0,1,1.0,1,1.0,1,0.4055491182954027,45
86,14,984,984,0,0,0,0,1.0,1,1.0,1,1.0,1,0.4088614894360324,45
87,9,993,993,0,0,0,0,1.0,1,1.0,1,1.0,1,0.4637876213156135,44
88,13,1006,1006,0,0,0,0,1.0,1,1.0,1,1.0,1,0.4530444844752826,44
89,9,1015,1015,0,0,0,0,1.0,1,1.0,1,1.0,1,0.5024668386954964,43
90,10,1025,1025,0,0,0,0,1.0,1,1.0,1,1.0,1,0.47307331888874354,44
91,7,1032,1032,0,0,0,0,1.0,1,1.0,1,1.0,1,0.4813033757415324,44
92,12,1044,1044,0,0,0,0,1.0,1,1.0,1,1.0,1,0.46359537281628693,43
93,12,1056,1056,0,0,0,0,1.0,1,1.0,1,1.0,1,0.512728931472494,44
94,10,1066,1066,0,0,0,0,1.0,1,1.0,1,1.0,1,0.37618710104986586,44
95,21,1087,1087,0,0,0,0,1.0,1,1.0,1,1.0,1,0.5138414306546715,43
96,10,1097,1097,0,0,0,0,1.0,1,1.0,1,1.0,1,0.48516816316852734,44
97,17,1114,1114,0,0,0,0,1.0,1,1.0,1,1.0,1,0.5070553327878214,44
98,11,1125,1125,0,0,0,0,1.0,1,1.0,1,1.0,1,0.4240176457280729,43
99,14,1139,1139,0,0,0,0,1.0,1,1.0,1,1.0,1,0.5027299343234635,43
100,10,1149,1149,0,0,0,0,1.0,1,1.0,1,1.0,1,0.44969342805112295,47
101,10,1159,1159,0,0,0,0,1.0,1,1.0,1,1.0,1,0.4551408353667354,47
102,9,1168,1168,0,0,0,0,1.0,1,1.0,1,1.0,1,0.32006289435697416,47
103,18,1186,1186,0,0,0,0,1.0,1,1.0,1,1.0,1,0.2653450735001771,46
104,16,1202,1202,0,0,0,0,1.0,1,1.0,1,1.0,1,0.2868494481719451,45
105,14,1216,1216,0,0,0,0,1.0,1,1.0,1,1.0,1,0.4425469843326125,44
106,23,1239,1239,0,0,0,0,1.0,1,1.0,1,1.0,1,0.23584532209096637,45
107,20,1259,1259,0,0,0,0,1.0,1,1.0,1,1.0,1,0.30473171462182913,44
108,16,1275,1275,0,0,0,0,1.0,1,1.0,1,1.0,1,0.22175773340486163,46
109,27,1302,1302,0,0,0,0,1.0,1,1.0,1,1.0,1,0.33835795394329077,46
110,19,1321,1321,0,0,0,0,1.0,1,1.0,1,1.0,1,0.40506615299199383,46
111,11,1332,1332,0,0,0,0,1.0,1,1.0,1,1.0,1,0.34747801463465133,46
112,18,1350,1350,0,0,0,0,1.0,1,1.0,1,1.0,1,0.3903193917593019,46
113,9,1359,1359,0,0,0,0,1.0,1,1.0,1,1.0,1,0.30158075222901454,46
114,10,1369,1369,0,0,0,0,1.0,1,1.0,1,1.0,1,0.3261557592677095,46
115,9,1378,1378,0,0,0,0,1.0,1,1.0,1,1.0,1,0.1998366109759492,47
116,16,1394,1394,0,0,0,0,1.0,1,1.0,1,1.0,1,0.3679888257385839,47
117,4,1398,1398,0,0,0,0,1.0,1,1.0,1,1.0,1,0.37693303329157946,45
118,14,1412,1412,0,0,0,0,1.0,1,1.0,1,1.0,1,0.386343862908516,46
119,18,1430,1430,0,0,0,0,1.0,1,1.0,1,1.0,1,0.3766351714526206,46
120,7,1437,1437,0,0,0,0,1.0,1,1.0,1,1.0,1,0.39970792456612325,47
121,9,1446,1446,0,0,0,0,1.0,1,1.0,1,1.0,1,0.4136903270047735,46
122,4,1450,1450,0,0,0,0,1.0,1,1.0,1,1.0,1,0.4334381103603457,46
123,9,1459,1459,0,0,0,0,1.0,1,1.0,1,1.0,1,0.39280444276577864,45
124,10,1469,1469,0,0,0,0,1.0,1,1.0,1,1.0,1,0.34787502777858503,46
125,11,1480,1480,0,0,0,0,1.0,1,1.0,1,1.0,1,0.37566601881952916,44
126,13,1493,1493,0,0,0,0,1.0,1,1.0,1,1.0,1,0.3272506317085401,45
127,8,1501,1501,0,0,0,0,1.0,1,1.0,1,1.0,1,0.32162348757623144,45
128,9,1510,1510,0,0,0,0,1.0,1,1.0,1,1.0,1,0.31156232920488786,46
129,15,1525,1525,0,0,0,0,1.0,1,1.0,1,1.0,1,0.3042331110276045,48
130,18,1543,1543,0,0,0,0,1.0,1,1.0,1,1.0,1,0.28872745186224186,48
131,20,1563,1563,0,0,0,0,1.0,1,1.0,1,1.0,1,0.3398468116399708,49
132,18,1581,1581,0,0,0,0,1.0,1,1.0,1,1.0,1,0.26767775576605923,51
133,16,1597,1597,0,0,0,0,1.0,1,1.0,1,1.0,1,0.2162756625873009,49
134,12,1609,1609,0,0,0,0,1.0,1,1.0,1,1.0,1,0.17299085038171605,49
135,18,1627,1627,0,0,0,0,1.0,1,1.0,1,1.0,1,0.19938931411096086,49
136,16,1643,1643,0,0,0,0,1.0,1,1.0,1,1.0,1,0.2978720696534079,48
137,16,1659,1659,0,0,0,0,1.0,1,1.0,1,1.0,1,0.24179278404497995,47
138,12,1671,1671,0,0,0,0,1.0,1,1.0,1,1.0,1,0.20492494911217812,48
139,17,1688,1688,0,0,0,0,1.0,1,1.0,1,1.0,1,0.38685100337832756,48
140,19,1707,1707,0,0,0,0,1.0,1,1.0,1,1.0,1,0.28112114857970955,49
141,14,1721,1721,0,0,0,0,1.0,1,1.0,1,1.0,1,0.33708206251943873,49
142,12,1733,1733,0,0,0,0,1.0,1,1.0,1,1.0,1,0.37080734424191925,49
143,6,1739,1739,0,0,0,0,1.0,1,1.0,1,1.0,1,0.379715133836806,47
144,14,1753,1753,0,0,0,0,1.0,1,1.0,1,1.0,1,0.41603204798114063,46
145,6,1759,1759,0,0,0,0,1.0,1,1.0,1,1.0,1,0.4076706241037376,44
146,9,1768,1768,0,0,0,0,1.0,1,1.0,1,1.0,1,0.40711144687667133,44
147,13,1781,1781,0,0,0,0,1.0,1,1.0,1,1.0,1,0.3470522865303246,43
148,15,1796,1796,0,0,0,0,1.0,1,1.0,1,1.0,1,0.37407335262871094,43
149,13,1809,1809,0,0,0,0,1.0,1,1.0,1,1.0,1,0.3384594522511529,43
150,10,1819,1819,0,0,0,0,1.0,1,1.0,1,1.0,1,0.4800796338162774,42
151,4,1823,1823,0,0,0,0,1.0,1,1.0,1,1.0,1,0.45530318847622064,42
152,13,1836,1836,0,0,0,0,1.0,1,1.0,1,1.0,1,0.4290124447111327,42
153,5,1841,1841,0,0,0,0,1.0,1,1.0,1,1.0,1,0.4132808983330163,42
154,9,1850,1850,0,0,0,0,1.0,1,1.0,1,1.0,1,0.3642390881166004,43
155,8,1858,1858,0,0,0,0,1.0,1,1.0,1,1.0,1,0.3597160328020284,43
156,16,1874,1874,0,0,0,0,1.0,1,1.0,1,1.0,1,0.36794541565782557,42
157,15,1889,1889,0,0,0,0,1.0,1,1.0,1,1.0,1,0.390091323037704,41
158,13,1902,1902,0,0,0,0,1.0,1,1.0,1,1.0,1,0.3468329080736976,42
159,19,1921,1921,0,0,0,0,1.0,1,1.0,1,1.0,1,0.3341241110322332,43
160,17,1938,1938,0,0,0,0,1.0,1,1.0,1,1.0,1,0.381697622548941,44
161,11,1949,1949,0,0,0,0,1.0,1,1.0,1,1.0,1,0.37156286322028076,44
162,11,1960,1960,0,0,0,0,1.0,1,1.0,1,1.0,1,0.3796984754603826,45
163,9,1969,1969,0,0,0,0,1.0,1,1.0,1,1.0,1,0.35856462807953937,43
164,18,1987,1987,0,0,0,0,1.0,1,1.0,1,1.0,1,0.29513563378454827,42
165,6,1993,1993,0,0,0,0,1.0,1,1.0,1,1.0,1,0.2330524222445247,42
166,11,2004,2004,0,0,0,0,1.0,1,1.0,1,1.0,1,0.28222130402712337,42
167,12,2016,2016,0,0,0,0,1.0,1,1.0,1,1.0,1,0.22996775213040885,41
168,13,2029,2029,0,0,0,0,1.0,1,1.0,1,1.0,1,0.2023156497078734,40
169,11,2040,2040,0,0,0,0,1.0,1,1.0,1,1.0,1,0.19218599192111976,40
170,10,2050,2050,0,0,0,0,1.0,1,1.0,1,1.0,1,0.23692186278362581,38
171,12,2062,2062,0,0,0,0,1.0,1,1.0,1,1.0,1,0.20774154727516894,37
172,14,2076,2076,0,0,0,0,1.0,1,1.0,1,1.0,1,0.3541322991644681,35
173,11,2087,2087,0,0,0,0,1.0,1,1.0,1,1.0,1,0.3059022125009884,36
174,9,2096,2096,0,0,0,0,1.0,1,1.0,1,1.0,1,0.2998690535943976,34
175,12,2108,2108,0,0,0,0,1.0,1,1.0,1,1.0,1,0.3725827554978046,33
176,17,2125,2125,0,0,0,0,1.0,1,1.0,1,1.0,1,0.387916643746521,34
177,18,2143,2143,0,0,0,0,1.0,1,1.0,1,1.0,1,0.4110542614981712,36
178,11,2154,2154,0,0,0,0,1.0,1,1.0,1,1.0,1,0.23474137849131407,37
179,10,2164,2164,0,0,0,0,1.0,1,1.0,1,1.0,1,0.2792773062194835,37
180,10,2174,2174,0,0,0,0,1.0,1,1.0,1,1.0,1,0.3393682808346679,36
181,8,2182,2182,0,0,0,0,1.0,1,1.0,1,1.0,1,0.36631381658073436,36
182,8,2190,2190,0,0,0,0,1.0,1,1.0,1,1.0,1,0.3823254643625496,38
183,19,2209,2209,0,0,0,0,1.0,1,1.0,1,1.0,1,0.37385695320219126,37
184,7,2216,2216,0,0,0,0,1.0,1,1.0,1,1.0,1,0.3178893304957461,36
185,14,2230,2230,0,0,0,0,1.0,1,1.0,1,1.0,1,0.1993524981841182,35
186,10,2240,2240,0,0,0,0,1.0,1,1.0,1,1.0,1,0.33813941514811346,34
187,17,2257,2257,0,0,0,0,1.0,1,1.0,1,1.0,1,0.29678512450659045,33
188,12,2269,2269,0,0,0,0,1.0,1,1.0,1,1.0,1,0.22738399669615622,33
189,18,2287,2287,0,0,0,0,1.0,1,1.0,1,1.0,1,0.31776035177997414,33
190,20,2307,2307,0,0,0,0,1.0,1,1.0,1,1.0,1,0.38938359498858494,32
191,11,2318,2318,0,0,0,0,1.0,1,1.0,1,1.0,1,0.3298346183631606,34
192,12,2330,2330,0,0,0,0,1.0,1,1.0,1,1.0,1,0.46113276997845337,34
193,12,2342,2342,0,0,0,0,1.0,1,1.0,1,1.0,1,0.37173770500181846,35
194,17,2359,2359,0,0,0,0,1.0,1,1.0,1,1.0,1,0.3968175539148309,37
195,13,2372,2372,0,0,0,0,1.0,1,1.0,1,1.0,1,0.37898299547681397,36
196,9,2381,2381,0,0,0,0,1.0,1,1.0,1,1.0,1,0.3801404052053445,36
197,6,2387,2387,0,0,0,0,1.0,1,1.0,1,1.0,1,0.416413258977305,37
198,8,2395,2395,0,0,0,0,1.0,1,1.0,1,1.0,1,0.3590476681781607,37
199,15,2410,2410,0,0,0,0,1.0,1,1.0,1,1.0,1,0.3698142154500347,37
200,7,2417,2417,0,0,0,0,1.0,1,1.0,1,1.0,1,0.44645076995992905,37
201,9,2426,2426,0,0,0,0,1.0,1,1.0,1,1.0,1,0.4198385419085839,36
202,9,2435,2435,0,0,0,0,1.0,1,1.0,1,1.0,1,0.33632342958855616,36
203,7,2442,2442,0,0,0,0,1.0,1,1.0,1,1.0,1,0.35432320357650754,35
204,11,2453,2453,0,0,0,0,1.0,1,1.0,1,1.0,1,0.3499413888024176,35
205,8,2461,2461,0,0,0,0,1.0,1,1.0,1,1.0,1,0.2826333703408394,35
206,12,2473,2473,0,0,0,0,1.0,1,1.0,1,1.0,1,0.30391045092291025,34
207,12,2485,2485,0,0,0,0,1.0,1,1.0,1,1.0,1,0.30154596336786843,34
208,13,2498,2498,0,0,0,0,1.0,1,1.0,1,1.0,1,0.22259672922240192,33
209,14,2512,2512,0,0,0,0,1.0,1,1.0,1,1.0,1,0.1756263136672745,33
210,16,2528,2528,0,0,0,0,1.0,1,1.0,1,1.0,1,0.2958064791259453,34
211,14,2542,2542,0,0,0,0,1.0,1,1.0,1,1.0,1,0.2904613191979546,33
212,10,2552,2552,0,0,0,0,1.0,1,1.0,1,1.0,1,0.34809422433096127,33
213,16,2568,2568,0,0,0,0,1.0,1,1.0,1,1.0,1,0.22022495033173772,35
214,17,2585,2585,0,0,0,0,1.0,1,1.0,1,1.0,1,0.34061580597570595,34
215,11,2596,2596,0,0,0,0,1.0,1,1.0,1,1.0,1,0.405265757239504,35
216,18,2614,2614,0,0,0,0,1.0,1,1.0,1,1.0,1,0.4282285982687212,36
217,7,2621,2621,0,0,0,0,1.0,1,1.0,1,1.0,1,0.39983934416593936,36
218,9,2630,2630,0,0,0,0,1.0,1,1.0,1,1.0,1,0.458456606640546,36
219,10,2640,2640,0,0,0,0,1.0,1,1.0,1,1.0,1,0.32514253171775215,37
220,18,2658,2658,0,0,0,0,1.0,1,1.0,1,1.0,1,0.3593963808062625,38
221,15,2673,2673,0,0,0,0,1.0,1,1.0,1,1.0,1,0.2397319268546303,37
222,13,2686,2686,0,0,0,0,1.0,1,1.0,1,1.0,1,0.263695912928181,38
223,10,2696,2696,0,0,0,0,1.0,1,1.0,1,1.0,1,0.3302574358578431,38
224,17,2713,2713,0,0,0,0,1.0,1,1.0,1,1.0,1,0.3824048373931036,38
225,12,2725,2725,0,0,0,0,1.0,1,1.0,1,1.0,1,0.3444693426976247,36
226,10,2735,2735,0,0,0,0,1.0,1,1.0,1,1.0,1,0.33202964004976565,37
227,10,2745,2745,0,0,0,0,1.0,1,1.0,1,1.0,1,0.2592777526270856,35
228,9,2754,2754,0,0,0,0,1.0,1,1.0,1,1.0,1,0.23485054690761498,35
229,13,2767,2767,0,0,0,0,1.0,1,1.0,1,1.0,1,0.2835657394084844,35
230,6,2773,2773,0,0,0,0,1.0,1,1.0,1,1.0,1,0.3815837138870178,35
231,7,2780,2780,0,0,0,0,1.0,1,1.0,1,1.0,1,0.3497379079823143,35
232,6,2786,2786,0,0,0,0,1.0,1,1.0,1,1.0,1,0.4156131089719752,36
233,8,2794,2794,0,0,0,0,1.0,1,1.0,1,1.0,1,0.3603051193082814,36
234,4,2798,2798,0,0,0,0,1.0,1,1.0,1,1.0,1,0.4169069104728779,34
235,7,2805,2805,0,0,0,0,1.0,1,1.0,1,1.0,1,0.33058999246014764,33
236,5,2810,2810,0,0,0,0,1.0,1,1.0,1,1.0,1,0.40974405068467135,31
237,5,2815,2815,0,0,0,0,1.0,1,1.0,1,1.0,1,0.45927084415678104,32
238,12,2827,2827,0,0,0,0,1.0,1,1.0,1,1.0,1,0.3855820523223542,31
239,10,2837,2837,0,0,0,0,1.0,1,1.0,1,1.0,1,0.25913302608744787,30
240,9,2846,2846,0,0,0,0,1.0,1,1.0,1,1.0,1,0.2903473426987614,27
241,12,2858,2858,0,0,0,0,1.0,1,1.0,1,1.0,1,0.23002721308506577,27
242,12,2870,2870,0,0,0,0,1.0,1,1.0,1,1.0,1,0.3074648352696387,28
243,14,2884,2884,0,0,0,0,1.0,1,1.0,1,1.0,1,0.3484288726115412,28
244,13,2897,2897,0,0,0,0,1.0,1,1.0,1,1.0,1,0.2980530514269688,27
245,16,2913,2913,0,0,0,0,1.0,1,1.0,1,1.0,1,0.3856111054529914,27
246,9,2922,2922,0,0,0,0,1.0,1,1.0,1,1.0,1,0.4326993705588591,25
247,7,2929,2929,0,0,0,0,1.0,1,1.0,1,1.0,1,0.4464058085748999,24
248,11,2940,2940,0,0,0,0,1.0,1,1.0,1,1.0,1,0.4758576615249491,24
249,11,2951,2951,0,0,0,0,1.0,1,1.0,1,1.0,1,0.4776855496129251,25
250,15,2966,2966,0,0,0,0,1.0,1,1.0,1,1.0,1,0.413346306795326,27
251,9,2975,2975,0,0,0,0,1.0,1,1.0,1,1.0,1,0.4379800286233617,27
252,12,2987,2987,0,0,0,0,1.0,1,1.0,1,1.0,1,0.3622212683679757,27
253,15,3002,3002,0,0,0,0,1.0,1,1.0,1,1.0,1,0.4188741436849301,29
254,11,3013,3013,0,0,0,0,1.0,1,1.0,1,1.0,1,0.3384733251800484,30
255,20,3033,3033,0,0,0,0,1.0,1,1.0,1,1.0,1,0.2958925123669519,31
256,14,3047,3047,0,0,0,0,1.0,1,1.0,1,1.0,1,0.3533240024633486,31
257,10,3057,3057,0,0,0,0,1.0,1,1.0,1,1.0,1,0.3601149762511128,33
258,11,3068,3068,0,0,0,0,1.0,1,1.0,1,1.0,1,0.2580010469619977,33
259,14,3082,3082,0,0,0,0,1.0,1,1.0,1,1.0,1,0.3317036804672116,33
260,4,3086,3086,0,0,0,0,1.0,1,1.0,1,1.0,1,0.38786263631598533,35
261,9,3095,3095,0,0,0,0,1.0,1,1.0,1,1.0,1,0.4206675311794307,35
262,8,3103,3103,0,0,0,0,1.0,1,1.0,1,1.0,1,0.4136169392574448,35
263,2,3105,3105,0,0,0,0,1.0,1,1.0,1,1.0,1,0.46709975827585587,34
264,3,3108,3108,0,0,0,0,1.0,1,1.0,1,1.0,1,0.49683141517048385,32
265,5,3113,3113,0,0,0,0,1.0,1,1.0,1,1.0,1,0.5199793828871095,30
266,10,3123,3123,0,0,0,0,1.0,1,1.0,1,1.0,1,0.49845365376419243,31
267,12,3135,3135,0,0,0,0,1.0,1,1.0,1,1.0,1,0.47439172811768326,30
268,11,3146,3146,0,0,0,0,1.0,1,1.0,1,1.0,1,0.4279162705457587,31
269,13,3159,3159,0,0,0,0,1.0,1,1.0,1,1.0,1,0.4622043927925497,31
270,12,3171,3171,0,0,0,0,1.0,1,1.0,1,1.0,1,0.4602669854294889,32
271,9,3180,3180,0,0,0,0,1.0,1,1.0,1,1.0,1,0.4546761635373896,31
272,15,3195,3195,0,0,0,0,1.0,1,1.0,1,1.0,1,0.5043090263706217,32
273,10,3205,3205,0,0,0,0,1.0,1,1.0,1,1.0,1,0.481349224932613,32
274,4,3209,3209,0,0,0,0,1.0,1,1.0,1,1.0,1,0.4482901039334377,32
275,7,3216,3216,0,0,0,0,1.0,1,1.0,1,1.0,1,0.44109067121173934,33
276,10,3226,3226,0,0,0,0,1.0,1,1.0,1,1.0,1,0.46855126482207193,34
277,9,3235,3235,0,0,0,0,1.0,1,1.0,1,1.0,1,0.45799125248393463,32
278,7,3242,3242,0,0,0,0,1.0,1,1.0,1,1.0,1,0.35995816198051916,31
279,11,3253,3253,0,0,0,0,1.0,1,1.0,1,1.0,1,0.43420436372032317,31
280,17,3270,3270,0,0,0,0,1.0,1,1.0,1,1.0,1,0.3268793056189885,30
281,19,3289,3289,0,0,0,0,1.0,1,1.0,1,1.0,1,0.3691240947248796,31
282,14,3303,3303,0,0,0,0,1.0,1,1.0,1,1.0,1,0.39987214157993795,30
283,16,3319,3319,0,0,0,0,1.0,1,1.0,1,1.0,1,0.3280374013335313,31
284,15,3334,3334,0,0,0,0,1.0,1,1.0,1,1.0,1,0.3402489778361011,31
285,12,3346,3346,0,0,0,0,1.0,1,1.0,1,1.0,1,0.33190162154353936,31
286,6,3352,3352,0,0,0,0,1.0,1,1.0,1,1.0,1,0.37174175274288046,31
287,4,3356,3356,0,0,0,0,1.0,1,1.0,1,1.0,1,0.29069073711818844,33
288,10,3366,3366,0,0,0,0,1.0,1,1.0,1,1.0,1,0.37245944766874783,32
289,10,3376,3376,0,0,0,0,1.0,1,1.0,1,1.0,1,0.2796143181818166,32
290,7,3383,3383,0,0,0,0,1.0,1,1.0,1,1.0,1,0.2875975716353244,31
291,11,3394,3394,0,0,0,0,1.0,1,1.0,1,1.0,1,0.34688176791675457,30
292,11,3405,3405,0,0,0,0,1.0,1,1.0,1,1.0,1,0.2952321549803879,32
293,9,3414,3414,0,0,0,0,1.0,1,1.0,1,1.0,1,0.23034549270040583,32
294,11,3425,3425,0,0,0,0,1.0,1,1.0,1,1.0,1,0.23761145580663962,32
295,8,3433,3433,0,0,0,0,1.0,1,1.0,1,1.0,1,0.35488459903980546,34
296,9,3442,3442,0,0,0,0,1.0,1,1.0,1,1.0,1,0.29688986040233684,34
297,5,3447,3447,0,0,0,0,1.0,1,1.0,1,1.0,1,0.35562468440046857,34
298,6,3453,3453,0,0,0,0,1.0,1,1.0,1,1.0,1,0.29984867103363877,35
299,15,3468,3468,0,0,0,0,1.0,1,1.0,1,1.0,1,0.3101949548178488,35
300,15,3483,3483,0,0,0,0,1.0,1,1.0,1,1.0,1,0.3298618762612009,35
301,14,3497,3497,0,0,0,0,1.0,1,1.0,1,1.0,1,0.30222164467010243,38
302,18,3515,3515,0,0,0,0,1.0,1,1.0,1,1.0,1,0.3669772672875517,38
303,16,3531,3531,0,0,0,0,1.0,1,1.0,1,1.0,1,0.43867199556564823,37
304,16,3547,3547,0,0,0,0,1.0,1,1.0,1,1.0,1,0.4117369553016153,37
305,6,3553,3553,0,0,0,0,1.0,1,1.0,1,1.0,1,0.2587998111401495,36
306,12,3565,3565,0,0,0,0,1.0,1,1.0,1,1.0,1,0.2258657347756234,36
307,8,3573,3573,0,0,0,0,1.0,1,1.0,1,1.0,1,0.2036191323570972,35
308,10,3583,3583,0,0,0,0,1.0,1,1.0,1,1.0,1,0.20246678859156636,37
309,10,3593,3593,0,0,0,0,1.0,1,1.0,1,1.0,1,0.24991954875322675,37
310,5,3598,3598,0,0,0,0,1.0,1,1.0,1,1.0,1,0.2446741658184558,37
311,8,3606,3606,0,0,0,0,1.0,1,1.0,1,1.0,1,0.22366290182892593,39
312,13,3619,3619,0,0,0,0,1.0,1,1.0,1,1.0,1,0.25497688935945784,40
313,12,3631,3631,0,0,0,0,1.0,1,1.0,1,1.0,1,0.18225264835892638,39
314,17,3648,3648,0,0,0,0,1.0,1,1.0,1,1.0,1,0.2512424815460907,40
315,11,3659,3659,0,0,0,0,1.0,1,1.0,1,1.0,1,0.28461475260140023,39
316,6,3665,3665,0,0,0,0,1.0,1,1.0,1,1.0,1,0.3513809498673772,39
317,14,3679,3679,0,0,0,0,1.0,1,1.0,1,1.0,1,0.3251217161180033,40
318,15,3694,3694,0,0,0,0,1.0,1,1.0,1,1.0,1,0.3163516312746149,41
319,12,3706,3706,0,0,0,0,1.0,1,1.0,1,1.0,1,0.37481630165053825,41
320,12,3718,3718,0,0,0,0,1.0,1,1.0,1,1.0,1,0.3468614910291271,41
321,10,3728,3728,0,0,0,0,1.0,1,1.0,1,1.0,1,0.3523725033184996,41
322,19,3747,3747,0,0,0,0,1.0,1,1.0,1,1.0,1,0.32257196196995613,41
323,20,3767,3767,0,0,0,0,1.0,1,1.0,1,1.0,1,0.4525231685308953,41
324,20,3787,3787,0,0,0,0,1.0,1,1.0,1,1.0,1,0.361099961403146,42
325,12,3799,3799,0,0,0,0,1.0,1,1.0,1,1.0,1,0.3212427040093156,42
326,4,3803,3803,0,0,0,0,1.0,1,1.0,1,1.0,1,0.3313669632307328,42
327,6,3809,3809,0,0,0,0,1.0,1,1.0,1,1.0,1,0.2987510412174771,42
328,5,3814,3814,0,0,0,0,1.0,1,1.0,1,1.0,1,0.30237905481092786,43
329,14,3828,3828,0,0,0,0,1.0,1,1.0,1,1.0,1,0.31495933313222857,43
330,6,3834,3834,0,0,0,0,1.0,1,1.0,1,1.0,1,0.3478496201431603,45
331,17,3851,3851,0,0,0,0,1.0,1,1.0,1,1.0,1,0.3015584900219046,45
332,11,3862,3862,0,0,0,0,1.0,1,1.0,1,1.0,1,0.2580080941508813,45
333,11,3873,3873,0,0,0,0,1.0,1,1.0,1,1.0,1,0.3624979870696793,46
334,5,3878,3878,0,0,0,0,1.0,1,1.0,1,1.0,1,0.39421107047556875,48
335,8,3886,3886,0,0,0,0,1.0,1,1.0,1,1.0,1,0.36519262911410444,48
336,7,3893,3893,0,0,0,0,1.0,1,1.0,1,1.0,1,0.3139142875613108,48
337,12,3905,3905,0,0,0,0,1.0,1,1.0,1,1.0,1,0.37086355456897857,49
338,8,3913,3913,0,0,0,0,1.0,1,1.0,1,1.0,1,0.3048106022614724,50
339,3,3916,3916,0,0,0,0,1.0,1,1.0,1,1.0,1,0.2947089807599426,50
340,8,3924,3924,0,0,0,0,1.0,1,1.0,1,1.0,1,0.28147392825184603,50
341,5,3929,3929,0,0,0,0,1.0,1,1.0,1,1.0,1,0.287006949917501,51
342,8,3937,3937,0,0,0,0,1.0,1,1.0,1,1.0,1,0.30916894083832575,51
343,9,3946,3946,0,0,0,0,1.0,1,1.0,1,1.0,1,0.2583120853565357,51
344,17,3963,3963,0,0,0,0,1.0,1,1.0,1,1.0,1,0.17380427981757784,50
345,17,3980,3980,0,0,0,0,1.0,1,1.0,1,1.0,1,0.3288972942731034,51
346,12,3992,3992,0,0,0,0,1.0,1,1.0,1,1.0,1,0.24578443259376648,51
347,14,4006,4006,0,0,0,0,1.0,1,1.0,1,1.0,1,0.2820497088118488,51
348,17,4023,4023,0,0,0,0,1.0,1,1.0,1,1.0,1,0.3590580315932434,53
349,12,4035,4035,0,0,0,0,1.0,1,1.0,1,1.0,1,0.3037475575818147,55
350,14,4049,4049,0,0,0,0,1.0,1,1.0,1,1.0,1,0.31100506079410245,54
351,15,4064,4064,0,0,0,0,1.0,1,1.0,1,1.0,1,0.38713079639429865,54
352,13,4077,4077,0,0,0,0,1.0,1,1.0,1,1.0,1,0.3248804507764231,53
353,9,4086,4086,0,0,0,0,1.0,1,1.0,1,1.0,1,0.38652250072700894,53
354,14,4100,4100,0,0,0,0,1.0,1,1.0,1,1.0,1,0.3629872168875875,50
355,11,4111,4111,0,0,0,0,1.0,1,1.0,1,1.0,1,0.330755216547651,51
356,16,4127,4127,0,0,0,0,1.0,1,1.0,1,1.0,1,0.3113574963872657,51
357,16,4143,4143,0,0,0,0,1.0,1,1.0,1,1.0,1,0.3643202526626649,50
358,17,4160,4160,0,0,0,0,1.0,1,1.0,1,1.0,1,0.3041439061768983,48
359,9,4169,4169,0,0,0,0,1.0,1,1.0,1,1.0,1,0.35379980731614025,47
360,12,4181,4181,0,0,0,0,1.0,1,1.0,1,1.0,1,0.39806132168167285,45
361,9,4190,4190,0,0,0,0,1.0,1,1.0,1,1.0,1,0.2952313573509973,44
362,9,4199,4199,0,0,0,0,1.0,1,1.0,1,1.0,1,0.33335087904630034,44
363,12,4211,4211,0,0,0,0,1.0,1,1.0,1,1.0,1,0.278108195169831,44
364,7,4218,4218,0,0,0,0,1.0,1,1.0,1,1.0,1,0.2483886912593217,43
365,10,4228,4228,0,0,0,0,1.0,1,1.0,1,1.0,1,0.31737374869679386,43
366,12,4240,4240,0,0,0,0,1.0,1,1.0,1,1.0,1,0.29766067171971633,45
367,5,4245,4245,0,0,0,0,1.0,1,1.0,1,1.0,1,0.35329506627273577,44
368,7,4252,4252,0,0,0,0,1.0,1,1.0,1,1.0,1,0.3416255134684402,46
369,9,4261,4261,0,0,0,0,1.0,1,1.0,1,1.0,1,0.3853064504419097,45
370,10,4271,4271,0,0,0,0,1.0,1,1.0,1,1.0,1,0.33143293606596885,46
371,12,4283,4283,0,0,0,0,1.0,1,1.0,1,1.0,1,0.3341134731566934,47
372,10,4293,4293,0,0,0,0,1.0,1,1.0,1,1.0,1,0.31917624855843973,48
373,10,4303,4303,0,0,0,0,1.0,1,1.0,1,1.0,1,0.26873424448176714,48
374,20,4323,4323,0,0,0,0,1.0,1,1.0,1,1.0,1,0.34337410935338963,49
375,14,4337,4337,0,0,0,0,1.0,1,1.0,1,1.0,1,0.238696322623188,49
376,17,4354,4354,0,0,0,0,1.0,1,1.0,1,1.0,1,0.348007044980257,49
377,6,4360,4360,0,0,0,0,1.0,1,1.0,1,1.0,1,0.23620554396833154,49
378,14,4374,4374,0,0,0,0,1.0,1,1.0,1,1.0,1,0.26604338498131586,49
379,12,4386,4386,0,0,0,0,1.0,1,1.0,1,1.0,1,0.27979372661457197,50
380,12,4398,4398,0,0,0,0,1.0,1,1.0,1,1.0,1,0.2703597880072925,50
381,15,4413,4413,0,0,0,0,1.0,1,1.0,1,1.0,1,0.28623622112509106,51
382,9,4422,4422,0,0,0,0,1.0,1,1.0,1,1.0,1,0.3221893260864925,50
383,13,4435,4435,0,0,0,0,1.0,1,1.0,1,1.0,1,0.3086275030867945,51
384,9,4444,4444,0,0,0,0,1.0,1,1.0,1,1.0,1,0.2957001871203226,50
385,14,4458,4458,0,0,0,0,1.0,1,1.0,1,1.0,1,0.40192426819997606,50
386,15,4473,4473,0,0,0,0,1.0,1,1.0,1,1.0,1,0.3848615288489701,48
387,14,4487,4487,0,0,0,0,1.0,1,1.0,1,1.0,1,0.3186939883038285,47
388,15,4502,4502,0,0,0,0,1.0,1,1.0,1,1.0,1,0.35158722725835717,48
389,12,4514,4514,0,0,0,0,1.0,1,1.0,1,1.0,1,0.3910173381527127,47
390,18,4532,4532,0,0,0,0,1.0,1,1.0,1,1.0,1,0.34853902982269425,49
391,19,4551,4551,0,0,0,0,1.0,1,1.0,1,1.0,1,0.43025765539926136,46
392,13,4564,4564,0,0,0,0,1.0,1,1.0,1,1.0,1,0.4356087633972002,46
393,18,4582,4582,0,0,0,0,1.0,1,1.0,1,1.0,1,0.3568800094561646,44
394,19,4601,4601,0,0,0,0,1.0,1,1.0,1,1.0,1,0.3932450363100649,43
395,20,4621,4621,0,0,0,0,1.0,1,1.0,1,1.0,1,0.41148839617143446,42
396,23,4644,4644,0,0,0,0,1.0,1,1.0,1,1.0,1,0.3307736548791925,39
397,16,4660,4660,0,0,0,0,1.0,1,1.0,1,1.0,1,0.36252266147323975,39
398,19,4679,4679,0,0,0,0,1.0,1,1.0,1,1.0,1,0.3585420955434431,36
399,9,4688,4688,0,0,0,0,1.0,1,1.0,1,1.0,1,0.3760532086038147,36
400,11,4699,4699,0,0,0,0,1.0,1,1.0,1,1.0,1,0.33951500734209666,34
401,11,4710,4710,0,0,0,0,1.0,1,1.0,1,1.0,1,0.32055179121869454,33
402,17,4727,4727,0,0,0,0,1.0,1,1.0,1,1.0,1,0.27177571321728383,34
403,13,4740,4740,0,0,0,0,1.0,1,1.0,1,1.0,1,0.3823599364937184,36
404,21,4761,4761,0,0,0,0,1.0,1,1.0,1,1.0,1,0.36105594010614867,36
405,13,4774,4774,0,0,0,0,1.0,1,1.0,1,1.0,1,0.23997471040201115,37
406,10,4784,4784,0,0,0,0,1.0,1,1.0,1,1.0,1,0.4732092304521549,37
407,12,4796,4796,0,0,0,0,1.0,1,1.0,1,1.0,1,0.2829764336970347,39
408,19,4815,4815,0,0,0,0,1.0,1,1.0,1,1.0,1,0.3032120533951729,40
409,10,4825,4825,0,0,0,0,1.0,1,1.0,1,1.0,1,0.41169867302417806,41
410,16,4841,4841,0,0,0,0,1.0,1,1.0,1,1.0,1,0.3942304075099952,42
411,11,4852,4852,0,0,0,0,1.0,1,1.0,1,1.0,1,0.3765795067937009,43
412,9,4861,4861,0,0,0,0,1.0,1,1.0,1,1.0,1,0.3667671162067607,44
413,12,4873,4873,0,0,0,0,1.0,1,1.0,1,1.0,1,0.45407032009928766,44
414,11,4884,4884,0,0,0,0,1.0,1,1.0,1,1.0,1,0.4412820342304302,45
415,10,4894,4894,0,0,0,0,1.0,1,1.0,1,1.0,1,0.48816405703415855,45
416,7,4901,4901,0,0,0,0,1.0,1,1.0,1,1.0,1,0.3916881498721365,46
417,15,4916,4916,0,0,0,0,1.0,1,1.0,1,1.0,1,0.46037539748565126,46
418,10,4926,4926,0,0,0,0,1.0,1,1.0,1,1.0,1,0.44440643677865677,47
419,6,4932,4932,0,0,0,0,1.0,1,1.0,1,1.0,1,0.43889619791579154,47
420,8,4940,4940,0,0,0,0,1.0,1,1.0,1,1.0,1,0.35323365953532765,47
421,6,4946,4946,0,0,0,0,1.0,1,1.0,1,1.0,1,0.4140512326334617,47
422,9,4955,4955,0,0,0,0,1.0,1,1.0,1,1.0,1,0.35675578433593375,49
423,6,4961,4961,0,0,0,0,1.0,1,1.0,1,1.0,1,0.3564855696225811,47
424,17,4978,4978,0,0,0,0,1.0,1,1.0,1,1.0,1,0.35099556039784274,45
425,17,4995,4995,0,0,0,0,1.0,1,1.0,1,1.0,1,0.3481243099316155,46
426,20,5015,5015,0,0,0,0,1.0,1,1.0,1,1.0,1,0.3832648670098369,46
427,21,5036,5036,0,0,0,0,1.0,1,1.0,1,1.0,1,0.2813597158856876,45
428,19,5055,5055,0,0,0,0,1.0,1,1.0,1,1.0,1,0.28783056628532805,45
429,17,5072,5072,0,0,0,0,1.0,1,1.0,1,1.0,1,0.23760315627759054,42
430,10,5082,5082,0,0,0,0,1.0,1,1.0,1,1.0,1,0.19851362937226916,40
431,14,5096,5096,0,0,0,0,1.0,1,1.0,1,1.0,1,0.31364679752411373,39
432,8,5104,5104,0,0,0,0,1.0,1,1.0,1,1.0,1,0.2891795579022001,37
433,7,5111,5111,0,0,0,0,1.0,1,1.0,1,1.0,1,0.346433934740628,35
434,5,5116,5116,0,0,0,0,1.0,1,1.0,1,1.0,1,0.3737992381878452,33
435,9,5125,5125,0,0,0,0,1.0,1,1.0,1,1.0,1,0.3682978882763173,33
436,6,5131,5131,0,0,0,0,1.0,1,1.0,1,1.0,1,0.2990008537537266,33
437,9,5140,5140,0,0,0,0,1.0,1,1.0,1,1.0,1,0.251226820630606,33
438,7,5147,5147,0,0,0,0,1.0,1,1.0,1,1.0,1,0.39245399733595726,32
439,9,5156,5156,0,0,0,0,1.0,1,1.0,1,1.0,1,0.36440673840900906,34
440,12,5168,5168,0,0,0,0,1.0,1,1.0,1,1.0,1,0.1592514196861963,34
441,9,5177,5177,0,0,0,0,1.0,1,1.0,1,1.0,1,0.187483934152505,35
442,12,5189,5189,0,0,0,0,1.0,1,1.0,1,1.0,1,0.20033855182369467,37
443,14,5203,5203,0,0,0,0,1.0,1,1.0,1,1.0,1,0.29052828150006194,37
444,9,5212,5212,0,0,0,0,1.0,1,1.0,1,1.0,1,0.3629172901789586,38
445,11,5223,5223,0,0,0,0,1.0,1,1.0,1,1.0,1,0.37233323060302637,39
446,12,5235,5235,0,0,0,0,1.0,1,1.0,1,1.0,1,0.40561090914228615,39
447,10,5245,5245,0,0,0,0,1.0,1,1.0,1,1.0,1,0.35659492258007497,41
448,13,5258,5258,0,0,0,0,1.0,1,1.0,1,1.0,1,0.3703055625377035,41
449,9,5267,5267,0,0,0,0,1.0,1,1.0,1,1.0,1,0.31505435798295134,40
450,6,5273,5273,0,0,0,0,1.0,1,1.0,1,1.0,1,0.4537346210956248,40
451,18,5291,5291,0,0,0,0,1.0,1,1.0,1,1.0,1,0.28273233422244376,41
452,13,5304,5304,0,0,0,0,1.0,1,1.0,1,1.0,1,0.28792543527204495,41
453,23,5327,5327,0,0,0,0,1.0,1,1.0,1,1.0,1,0.2690909326749085,40
454,8,5335,5335,0,0,0,0,1.0,1,1.0,1,1.0,1,0.24249878601001446,41
455,25,5360,5360,0,0,0,0,1.0,1,1.0,1,1.0,1,0.32502351627788073,41
456,15,5375,5375,0,0,0,0,1.0,1,1.0,1,1.0,1,0.3242937568299702,43
457,21,5396,5396,0,0,0,0,1.0,1,1.0,1,1.0,1,0.34095442740097004,43
458,10,5406,5406,0,0,0,0,1.0,1,1.0,1,1.0,1,0.32786054278612164,43
459,11,5417,5417,0,0,0,0,1.0,1,1.0,1,1.0,1,0.28828992893129146,44
460,14,5431,5431,0,0,0,0,1.0,1,1.0,1,1.0,1,0.23030956662092303,47
461,12,5443,5443,0,0,0,0,1.0,1,1.0,1,1.0,1,0.20954700492618322,48
462,11,5454,5454,0,0,0,0,1.0,1,1.0,1,1.0,1,0.2563094642883985,49
463,3,5457,5457,0,0,0,0,1.0,1,1.0,1,1.0,1,0.22951798294888667,47
464,5,5462,5462,0,0,0,0,1.0,1,1.0,1,1.0,1,0.23152049749169318,48
465,11,5473,5473,0,0,0,0,1.0,1,1.0,1,1.0,1,0.2572165993865901,47
466,6,5479,5479,0,0,0,0,1.0,1,1.0,1,1.0,1,0.2509921735657738,46
467,8,5487,5487,0,0,0,0,1.0,1,1.0,1,1.0,1,0.25915739876151433,44
468,11,5498,5498,0,0,0,0,1.0,1,1.0,1,1.0,1,0.2646172244258317,41
469,7,5505,5505,0,0,0,0,1.0,1,1.0,1,1.0,1,0.2811190157272417,40
470,11,5516,5516,0,0,0,0,1.0,1,1.0,1,1.0,1,0.2967375802492426,39
471,13,5529,5529,0,0,0,0,1.0,1,1.0,1,1.0,1,0.36389775493988685,38
472,7,5536,5536,0,0,0,0,1.0,1,1.0,1,1.0,1,0.3644848245006491,36
473,8,5544,5544,0,0,0,0,1.0,1,1.0,1,1.0,1,0.3926280841518982,36
474,7,5551,5551,0,0,0,0,1.0,1,1.0,1,1.0,1,0.34281943943887905,34
475,6,5557,5557,0,0,0,0,1.0,1,1.0,1,1.0,1,0.36129697960198554,34
476,5,5562,5562,0,0,0,0,1.0,1,1.0,1,1.0,1,0.36355219699832736,32
477,8,5570,5570,0,0,0,0,1.0,1,1.0,1,1.0,1,0.35126301835497187,32
478,5,5575,5575,0,0,0,0,1.0,1,1.0,1,1.0,1,0.37727665279447375,30
479,10,5585,5585,0,0,0,0,1.0,1,1.0,1,1.0,1,0.28898995038998476,31
480,10,5595,5595,0,0,0,0,1.0,1,1.0,1,1.0,1,0.24423547936217727,27
481,8,5603,5603,0,0,0,0,1.0,1,1.0,1,1.0,1,0.14544210952318903,28
482,11,5614,5614,0,0,0,0,1.0,1,1.0,1,1.0,1,0.32012969676191355,28
483,13,5627,5627,0,0,0,0,1.0,1,1.0,1,1.0,1,0.2189332793216641,29
484,19,5646,5646,0,0,0,0,1.0,1,1.0,1,1.0,1,0.3503758367691215,29
485,12,5658,5658,0,0,0,0,1.0,1,1.0,1,1.0,1,0.4206532501402569,29
486,19,5677,5677,0,0,0,0,1.0,1,1.0,1,1.0,1,0.4052252653645422,31
487,21,5698,5698,0,0,0,0,1.0,1,1.0,1,1.0,1,0.34076132397830416,33
488,11,5709,5709,0,0,0,0,1.0,1,1.0,1,1.0,1,0.25783176896158694,34
489,11,5720,5720,0,0,0,0,1.0,1,1.0,1,1.0,1,0.4064558890025266,34
490,18,5738,5738,0,0,0,0,1.0,1,1.0,1,1.0,1,0.3667843385288705,34
491,2,5740,5740,0,0,0,0,1.0,1,1.0,1,1.0,1,0.3725195758805924,34
492,5,5745,5745,0,0,0,0,1.0,1,1.0,1,1.0,1,0.33379576089706203,34
493,10,5755,5755,0,0,0,0,1.0,1,1.0,1,1.0,1,0.41334313514010507,34
494,12,5767,5767,0,0,0,0,1.0,1,1.0,1,1.0,1,0.3351897041753028,36
495,11,5778,5778,0,0,0,0,1.0,1,1.0,1,1.0,1,0.39389623929947615,36
496,7,5785,5785,0,0,0,0,1.0,1,1.0,1,1.0,1,0.353950503610178,37
497,10,5795,5795,0,0,0,0,1.0,1,1.0,1,1.0,1,0.36928760016266926,39
498,13,5808,5808,0,0,0,0,1.0,1,1.0,1,1.0,1,0.27019965121345724,40
499,14,5822,5822,0,0,0,0,1.0,1,1.0,1,1.0,1,0.3313620405200611,40
500,11,5833,5833,0,0,0,0,1.0,1,1.0,1,1.0,1,0.3238860336930061,42
501,17,5850,5850,0,0,0,0,1.0,1,1.0,1,1.0,1,0.2941606395390586,42
502,17,5867,5867,0,0,0,0,1.0,1,1.0,1,1.0,1,0.3780496494290905,42
503,14,5881,5881,0,0,0,0,1.0,1,1.0,1,1.0,1,0.31595863223265164,41
504,13,5894,5894,0,0,0,0,1.0,1,1.0,1,1.0,1,0.3703275726470489,42
505,10,5904,5904,0,0,0,0,1.0,1,1.0,1,1.0,1,0.24566312637077933,38
506,12,5916,5916,0,0,0,0,1.0,1,1.0,1,1.0,1,0.2666904700443105,37
507,10,5926,5926,0,0,0,0,1.0,1,1.0,1,1.0,1,0.2026859537342285,35
508,10,5936,5936,0,0,0,0,1.0,1,1.0,1,1.0,1,0.24377907518989436,35
509,5,5941,5941,0,0,0,0,1.0,1,1.0,1,1.0,1,0.28266434083636877,34
510,7,5948,5948,0,0,0,0,1.0,1,1.0,1,1.0,1,0.379742525607666,34
511,6,5954,5954,0,0,0,0,1.0,1,1.0,1,1.0,1,0.36718296999901173,32
512,4,5958,5958,0,0,0,0,1.0,1,1.0,1,1.0,1,0.48746365091177013,30
513,15,5973,5973,0,0,0,0,1.0,1,1.0,1,1.0,1,0.37852144201052496,31
514,6,5979,5979,0,0,0,0,1.0,1,1.0,1,1.0,1,0.4669983177731272,31
515,11,5990,5990,0,0,0,0,1.0,1,1.0,1,1.0,1,0.3886690712688952,32
516,16,6006,6006,0,0,0,0,1.0,1,1.0,1,1.0,1,0.3798704358808474,31
517,15,6021,6021,0,0,0,0,1.0,1,1.0,1,1.0,1,0.3372612685257714,32
518,13,6034,6034,0,0,0,0,1.0,1,1.0,1,1.0,1,0.3585998400212681,31
519,16,6050,6050,0,0,0,0,1.0,1,1.0,1,1.0,1,0.3806509845898931,31
520,9,6059,6059,0,0,0,0,1.0,1,1.0,1,1.0,1,0.47377362154240543,33
521,16,6075,6075,0,0,0,0,1.0,1,1.0,1,1.0,1,0.33061819072726656,34
522,7,6082,6082,0,0,0,0,1.0,1,1.0,1,1.0,1,0.41688870183489446,34
523,7,6089,6089,0,0,0,0,1.0,1,1.0,1,1.0,1,0.42624054971544784,33
524,10,6099,6099,0,0,0,0,1.0,1,1.0,1,1.0,1,0.3070871629528738,34
525,4,6103,6103,0,0,0,0,1.0,1,1.0,1,1.0,1,0.36012007780631805,32
526,13,6116,6116,0,0,0,0,1.0,1,1.0,1,1.0,1,0.3405621461927604,32
527,13,6129,6129,0,0,0,0,1.0,1,1.0,1,1.0,1,0.4236856233985163,31
528,15,6144,6144,0,0,0,0,1.0,1,1.0,1,1.0,1,0.3309768629839971,31
529,8,6152,6152,0,0,0,0,1.0,1,1.0,1,1.0,1,0.4448926648047023,30
530,9,6161,6161,0,0,0,0,1.0,1,1.0,1,1.0,1,0.41385334308427074,30
531,6,6167,6167,0,0,0,0,1.0,1,1.0,1,1.0,1,0.463617002008003,32
532,8,6175,6175,0,0,0,0,1.0,1,1.0,1,1.0,1,0.43545584020953015,32
533,10,6185,6185,0,0,0,0,1.0,1,1.0,1,1.0,1,0.4276418863906281,34
534,10,6195,6195,0,0,0,0,1.0,1,1.0,1,1.0,1,0.42715268708508775,34
535,7,6202,6202,0,0,0,0,1.0,1,1.0,1,1.0,1,0.4424166732155759,37
536,8,6210,6210,0,0,0,0,1.0,1,1.0,1,1.0,1,0.3342424488487894,37
537,9,6219,6219,0,0,0,0,1.0,1,1.0,1,1.0,1,0.4131144027762451,37
538,5,6224,6224,0,0,0,0,1.0,1,1.0,1,1.0,1,0.3705229713727238,38
539,8,6232,6232,0,0,0,0,1.0,1,1.0,1,1.0,1,0.37447174654890963,38
540,4,6236,6236,0,0,0,0,1.0,1,1.0,1,1.0,1,0.4331519333348475,38
541,7,6243,6243,0,0,0,0,1.0,1,1.0,1,1.0,1,0.3506421763375147,39
542,10,6253,6253,0,0,0,0,1.0,1,1.0,1,1.0,1,0.4014647662244679,40
543,9,6262,6262,0,0,0,0,1.0,1,1.0,1,1.0,1,0.5056562114658013,37
544,9,6271,6271,0,0,0,0,1.0,1,1.0,1,1.0,1,0.5162348751718994,35
545,8,6279,6279,0,0,0,0,1.0,1,1.0,1,1.0,1,0.4309832404182533,35
546,12,6291,6291,0,0,0,0,1.0,1,1.0,1,1.0,1,0.45792093452095683,35
547,15,6306,6306,0,0,0,0,1.0,1,1.0,1,1.0,1,0.4501146803709595,34
548,12,6318,6318,0,0,0,0,1.0,1,1.0,1,1.0,1,0.38851555047175546,34
549,12,6330,6330,0,0,0,0,1.0,1,1.0,1,1.0,1,0.5131554713364465,31
550,9,6339,6339,0,0,0,0,1.0,1,1.0,1,1.0,1,0.3051224383842598,30
551,11,6350,6350,0,0,0,0,1.0,1,1.0,1,1.0,1,0.39301084448467366,31
552,9,6359,6359,0,0,0,0,1.0,1,1.0,1,1.0,1,0.4408342088370953,29
553,16,6375,6375,0,0,0,0,1.0,1,1.0,1,1.0,1,0.4739127291686017,30
554,9,6384,6384,0,0,0,0,1.0,1,1.0,1,1.0,1,0.48327337030910517,30
555,15,6399,6399,0,0,0,0,1.0,1,1.0,1,1.0,1,0.40500269766218533,30
556,13,6412,6412,0,0,0,0,1.0,1,1.0,1,1.0,1,0.4989020956464969,31
557,16,6428,6428,0,0,0,0,1.0,1,1.0,1,1.0,1,0.5190700857714231,31
558,14,6442,6442,0,0,0,0,1.0,1,1.0,1,1.0,1,0.3585628355458578,31
559,15,6457,6457,0,0,0,0,1.0,1,1.0,1,1.0,1,0.49040945844989414,31
560,21,6478,6478,0,0,0,0,1.0,1,1.0,1,1.0,1,0.47222541170254334,32
561,19,6497,6497,0,0,0,0,1.0,1,1.0,1,1.0,1,0.31525497550601683,33
562,17,6514,6514,0,0,0,0,1.0,1,1.0,1,1.0,1,0.3904432993013555,33
563,13,6527,6527,0,0,0,0,1.0,1,1.0,1,1.0,1,0.43434931945807786,33
564,12,6539,6539,0,0,0,0,1.0,1,1.0,1,1.0,1,0.38140859069711136,34
565,15,6554,6554,0,0,0,0,1.0,1,1.0,1,1.0,1,0.3294712317197521,35
566,11,6565,6565,0,0,0,0,1.0,1,1.0,1,1.0,1,0.3023672461324083,36
567,14,6579,6579,0,0,0,0,1.0,1,1.0,1,1.0,1,0.38285274239941036,37
568,16,6595,6595,0,0,0,0,1.0,1,1.0,1,1.0,1,0.3682288701989155,36
569,8,6603,6603,0,0,0,0,1.0,1,1.0,1,1.0,1,0.3260569624352194,37
570,6,6609,6609,0,0,0,0,1.0,1,1.0,1,1.0,1,0.27290906197148734,38
571,10,6619,6619,0,0,0,0,1.0,1,1.0,1,1.0,1,0.35167091147634577,38
572,3,6622,6622,0,0,0,0,1.0,1,1.0,1,1.0,1,0.3142408115845493,39
573,8,6630,6630,0,0,0,0,1.0,1,1.0,1,1.0,1,0.37984198554640214,39
574,8,6638,6638,0,0,0,0,1.0,1,1.0,1,1.0,1,0.2810030905641839,41
575,10,6648,6648,0,0,0,0,1.0,1,1.0,1,1.0,1,0.31054835355685456,41
576,10,6658,6658,0,0,0,0,1.0,1,1.0,1,1.0,1,0.32726292949129643,42
577,6,6664,6664,0,0,0,0,1.0,1,1.0,1,1.0,1,0.31580864465419006,42
578,7,6671,6671,0,0,0,0,1.0,1,1.0,1,1.0,1,0.2877314557793558,41
579,5,6676,6676,0,0,0,0,1.0,1,1.0,1,1.0,1,0.2718429767338987,42
580,11,6687,6687,0,0,0,0,1.0,1,1.0,1,1.0,1,0.3136601776030374,43
581,8,6695,6695,0,0,0,0,1.0,1,1.0,1,1.0,1,0.252418044789293,42
582,14,6709,6709,0,0,0,0,1.0,1,1.0,1,1.0,1,0.24380618296527587,41
583,11,6720,6720,0,0,0,0,1.0,1,1.0,1,1.0,1,0.2890869509336814,40
584,19,6739,6739,0,0,0,0,1.0,1,1.0,1,1.0,1,0.3351594137962867,38
585,18,6757,6757,0,0,0,0,1.0,1,1.0,1,1.0,1,0.2643951791738938,38
586,11,6768,6768,0,0,0,0,1.0,1,1.0,1,1.0,1,0.2752086552542249,37
587,13,6781,6781,0,0,0,0,1.0,1,1.0,1,1.0,1,0.264078713069177,35
588,16,6797,6797,0,0,0,0,1.0,1,1.0,1,1.0,1,0.39190314331434684,35
589,9,6806,6806,0,0,0,0,1.0,1,1.0,1,1.0,1,0.2433408736372853,34
590,17,6823,6823,0,0,0,0,1.0,1,1.0,1,1.0,1,0.44525659972444565,36
591,10,6833,6833,0,0,0,0,1.0,1,1.0,1,1.0,1,0.30383750685127275,35
592,14,6847,6847,0,0,0,0,1.0,1,1.0,1,1.0,1,0.29443301037774966,37
593,11,6858,6858,0,0,0,0,1.0,1,1.0,1,1.0,1,0.3904001657012758,36
594,18,6876,6876,0,0,0,0,1.0,1,1.0,1,1.0,1,0.2488803864128495,35
595,14,6890,6890,0,0,0,0,1.0,1,1.0,1,1.0,1,0.43114596737672617,34
596,10,6900,6900,0,0,0,0,1.0,1,1.0,1,1.0,1,0.30121770620099514,34
597,17,6917,6917,0,0,0,0,1.0,1,1.0,1,1.0,1,0.480411338192913,33
598,19,6936,6936,0,0,0,0,1.0,1,1.0,1,1.0,1,0.46110004532299664,33
599,15,6951,6951,0,0,0,0,1.0,1,1.0,1,1.0,1,0.49818314061967234,33
600,8,6959,6959,0,0,0,0,1.0,1,1.0,1,1.0,1,0.5209237517950628,33
601,9,6968,6968,0,0,0,0,1.0,1,1.0,1,1.0,1,0.5942409998089672,34
602,15,6983,6983,0,0,0,0,1.0,1,1.0,1,1.0,1,0.6096646793511975,35
603,12,6995,6995,0,0,0,0,1.0,1,1.0,1,1.0,1,0.5391235900712816,35
604,7,7002,7002,0,0,0,0,1.0,1,1.0,1,1.0,1,0.5514683942644609,35
605,11,7013,7013,0,0,0,0,1.0,1,1.0,1,1.0,1,0.4791147625915713,35
606,9,7022,7022,0,0,0,0,1.0,1,1.0,1,1.0,1,0.5582019482655721,35
607,13,7035,7035,0,0,0,0,1.0,1,1.0,1,1.0,1,0.5341356776150389,35
608,14,7049,7049,0,0,0,0,1.0,1,1.0,1,1.0,1,0.6294858276730338,36
609,13,7062,7062,0,0,0,0,1.0,1,1.0,1,1.0,1,0.4105275763139782,37
610,16,7078,7078,0,0,0,0,1.0,1,1.0,1,1.0,1,0.2914766481151102,37
611,17,7095,7095,0,0,0,0,1.0,1,1.0,1,1.0,1,0.4312576688926202,39
612,16,7111,7111,0,0,0,0,1.0,1,1.0,1,1.0,1,0.34321032314277067,39
613,18,7129,7129,0,0,0,0,1.0,1,1.0,1,1.0,1,0.290780032634115,39
614,13,7142,7142,0,0,0,0,1.0,1,1.0,1,1.0,1,0.2433209906301582,39
615,13,7155,7155,0,0,0,0,1.0,1,1.0,1,1.0,1,0.38756759342082053,39
616,4,7159,7159,0,0,0,0,1.0,1,1.0,1,1.0,1,0.3618628986656747,38
617,8,7167,7167,0,0,0,0,1.0,1,1.0,1,1.0,1,0.39631920154841793,39
618,9,7176,7176,0,0,0,0,1.0,1,1.0,1,1.0,1,0.44568483850882845,40
619,7,7183,7183,0,0,0,0,1.0,1,1.0,1,1.0,1,0.407149177773482,39
620,8,7191,7191,0,0,0,0,1.0,1,1.0,1,1.0,1,0.323299670554787,38
621,13,7204,7204,0,0,0,0,1.0,1,1.0,1,1.0,1,0.31436135394737197,38
622,12,7216,7216,0,0,0,0,1.0,1,1.0,1,1.0,1,0.3180700611487211,38
623,16,7232,7232,0,0,0,0,1.0,1,1.0,1,1.0,1,0.36817380082269757,37
624,13,7245,7245,0,0,0,0,1.0,1,1.0,1,1.0,1,0.32629404345637625,33
625,15,7260,7260,0,0,0,0,1.0,1,1.0,1,1.0,1,0.3420365905302398,32
626,17,7277,7277,0,0,0,0,1.0,1,1.0,1,1.0,1,0.41283273307512974,31
627,9,7286,7286,0,0,0,0,1.0,1,1.0,1,1.0,1,0.46257176909421094,30
628,18,7304,7304,0,0,0,0,1.0,1,1.0,1,1.0,1,0.39901652406791427,32
629,6,7310,7310,0,0,0,0,1.0,1,1.0,1,1.0,1,0.37440180950998414,29
630,10,7320,7320,0,0,0,0,1.0,1,1.0,1,1.0,1,0.3984057322157596,29
631,8,7328,7328,0,0,0,0,1.0,1,1.0,1,1.0,1,0.5189500772551894,25
632,5,7333,7333,0,0,0,0,1.0,1,1.0,1,1.0,1,0.55623792385271,24
633,15,7348,7348,0,0,0,0,1.0,1,1.0,1,1.0,1,0.5281289333255382,23
634,6,7354,7354,0,0,0,0,1.0,1,1.0,1,1.0,1,0.5114928611312668,23
635,13,7367,7367,0,0,0,0,1.0,1,1.0,1,1.0,1,0.35811339269111203,22
636,7,7374,7374,0,0,0,0,1.0,1,1.0,1,1.0,1,0.42243618605518773,22
637,6,7380,7380,0,0,0,0,1.0,1,1.0,1,1.0,1,0.3829633135889948,23
638,5,7385,7385,0,0,0,0,1.0,1,1.0,1,1.0,1,0.35184719880204685,23
639,5,7390,7390,0,0,0,0,1.0,1,1.0,1,1.0,1,0.2562350231204902,24
640,5,7395,7395,0,0,0,0,1.0,1,1.0,1,1.0,1,0.24874987196249274,24
641,10,7405,7405,0,0,0,0,1.0,1,1.0,1,1.0,1,0.3083279318074178,25
642,10,7415,7415,0,0,0,0,1.0,1,1.0,1,1.0,1,0.20359876477560324,26
643,9,7424,7424,0,0,0,0,1.0,1,1.0,1,1.0,1,0.3460937529242477,28
644,13,7437,7437,0,0,0,0,1.0,1,1.0,1,1.0,1,0.3769520099117633,28
645,11,7448,7448,0,0,0,0,1.0,1,1.0,1,1.0,1,0.30067671843313637,28
646,9,7457,7457,0,0,0,0,1.0,1,1.0,1,1.0,1,0.3974135521036304,29
647,9,7466,7466,0,0,0,0,1.0,1,1.0,1,1.0,1,0.4021567973415977,30
648,7,7473,7473,0,0,0,0,1.0,1,1.0,1,1.0,1,0.3411642229185777,30
649,10,7483,7483,0,0,0,0,1.0,1,1.0,1,1.0,1,0.36898328854723483,31
650,7,7490,7490,0,0,0,0,1.0,1,1.0,1,1.0,1,0.2267177954889664,31
651,11,7501,7501,0,0,0,0,1.0,1,1.0,1,1.0,1,0.4228641138130153,32
652,9,7510,7510,0,0,0,0,1.0,1,1.0,1,1.0,1,0.37794768523600125,32
653,10,7520,7520,0,0,0,0,1.0,1,1.0,1,1.0,1,0.2897320458862053,33
654,17,7537,7537,0,0,0,0,1.0,1,1.0,1,1.0,1,0.4391843163432861,33
655,16,7553,7553,0,0,0,0,1.0,1,1.0,1,1.0,1,0.3863438124216249,36
656,11,7564,7564,0,0,0,0,1.0,1,1.0,1,1.0,1,0.3498225975501199,36
657,13,7577,7577,0,0,0,0,1.0,1,1.0,1,1.0,1,0.22301619438955397,35
658,18,7595,7595,0,0,0,0,1.0,1,1.0,1,1.0,1,0.2947788850184846,33
659,12,7607,7607,0,0,0,0,1.0,1,1.0,1,1.0,1,0.37819551438109894,35
660,10,7617,7617,0,0,0,0,1.0,1,1.0,1,1.0,1,0.3492692693975182,34
661,7,7624,7624,0,0,0,0,1.0,1,1.0,1,1.0,1,0.4334490035005029,33
662,11,7635,7635,0,0,0,0,1.0,1,1.0,1,1.0,1,0.44733515115754546,31
663,17,7652,7652,0,0,0,0,1.0,1,1.0,1,1.0,1,0.3284372722900209,29
664,8,7660,7660,0,0,0,0,1.0,1,1.0,1,1.0,1,0.361338228076217,27
665,17,7677,7677,0,0,0,0,1.0,1,1.0,1,1.0,1,0.3653874492232717,27
666,15,7692,7692,0,0,0,0,1.0,1,1.0,1,1.0,1,0.2755240479995704,28
667,10,7702,7702,0,0,0,0,1.0,1,1.0,1,1.0,1,0.367585346141936,26
668,14,7716,7716,0,0,0,0,1.0,1,1.0,1,1.0,1,0.434300646308395,26
669,11,7727,7727,0,0,0,0,1.0,1,1.0,1,1.0,1,0.43466970706998126,25
670,3,7730,7730,0,0,0,0,1.0,1,1.0,1,1.0,1,0.49640479377824764,24
671,3,7733,7733,0,0,0,0,1.0,1,1.0,1,1.0,1,0.46155198842971923,24
672,7,7740,7740,0,0,0,0,1.0,1,1.0,1,1.0,1,0.39685115467750004,25
673,7,7747,7747,0,0,0,0,1.0,1,1.0,1,1.0,1,0.388418165279285,25
674,7,7754,7754,0,0,0,0,1.0,1,1.0,1,1.0,1,0.2489331903157449,25
675,8,7762,7762,0,0,0,0,1.0,1,1.0,1,1.0,1,0.3173947989659435,26
676,10,7772,7772,0,0,0,0,1.0,1,1.0,1,1.0,1,0.2894125158240702,27
677,8,7780,7780,0,0,0,0,1.0,1,1.0,1,1.0,1,0.3349155701191547,28
678,8,7788,7788,0,0,0,0,1.0,1,1.0,1,1.0,1,0.4085691550291151,28
679,9,7797,7797,0,0,0,0,1.0,1,1.0,1,1.0,1,0.37224313776727136,30
680,14,7811,7811,0,0,0,0,1.0,1,1.0,1,1.0,1,0.4251842969103637,29
681,9,7820,7820,0,0,0,0,1.0,1,1.0,1,1.0,1,0.3874364654762449,29
682,6,7826,7826,0,0,0,0,1.0,1,1.0,1,1.0,1,0.4516432931109948,30
683,7,7833,7833,0,0,0,0,1.0,1,1.0,1,1.0,1,0.33137092243784955,30
684,17,7850,7850,0,0,0,0,1.0,1,1.0,1,1.0,1,0.2569646621270803,31
685,17,7867,7867,0,0,0,0,1.0,1,1.0,1,1.0,1,0.4161979166484857,30
686,9,7876,7876,0,0,0,0,1.0,1,1.0,1,1.0,1,0.36134625204783805,30
687,6,7882,7882,0,0,0,0,1.0,1,1.0,1,1.0,1,0.3619464043430008,30
688,10,7892,7892,0,0,0,0,1.0,1,1.0,1,1.0,1,0.298089132391758,31
689,11,7903,7903,0,0,0,0,1.0,1,1.0,1,1.0,1,0.33182489786356284,32
690,17,7920,7920,0,0,0,0,1.0,1,1.0,1,1.0,1,0.44408290704160075,32
691,9,7929,7929,0,0,0,0,1.0,1,1.0,1,1.0,1,0.36605625424705224,32
692,11,7940,7940,0,0,0,0,1.0,1,1.0,1,1.0,1,0.49364764496623,32
693,12,7952,7952,0,0,0,0,1.0,1,1.0,1,1.0,1,0.4323443408213156,34
694,19,7971,7971,0,0,0,0,1.0,1,1.0,1,1.0,1,0.44555034878876415,36
695,12,7983,7983,0,0,0,0,1.0,1,1.0,1,1.0,1,0.41692818848425117,34
696,17,8000,8000,0,0,0,0,1.0,1,1.0,1,1.0,1,0.3100902989049773,33
697,17,8017,8017,0,0,0,0,1.0,1,1.0,1,1.0,1,0.5041556022100747,33
698,11,8028,8028,0,0,0,0,1.0,1,1.0,1,1.0,1,0.4236032315863597,34
699,12,8040,8040,0,0,0,0,1.0,1,1.0,1,1.0,1,0.31229952265500777,33
700,9,8049,8049,0,0,0,0,1.0,1,1.0,1,1.0,1,0.4091582038530828,32
701,4,8053,8053,0,0,0,0,1.0,1,1.0,1,1.0,1,0.4649286702522428,33
702,12,8065,8065,0,0,0,0,1.0,1,1.0,1,1.0,1,0.3560757765747543,34
703,11,8076,8076,0,0,0,0,1.0,1,1.0,1,1.0,1,0.43768218287901445,32
704,10,8086,8086,0,0,0,0,1.0,1,1.0,1,1.0,1,0.34969047520444224,31
705,12,8098,8098,0,0,0,0,1.0,1,1.0,1,1.0,1,0.4022939139539998,33
706,16,8114,8114,0,0,0,0,1.0,1,1.0,1,1.0,1,0.4224991534377466,33
707,14,8128,8128,0,0,0,0,1.0,1,1.0,1,1.0,1,0.5014315765506099,31
708,8,8136,8136,0,0,0,0,1.0,1,1.0,1,1.0,1,0.4681868039492879,31
709,16,8152,8152,0,0,0,0,1.0,1,1.0,1,1.0,1,0.47153604498330887,30
710,9,8161,8161,0,0,0,0,1.0,1,1.0,1,1.0,1,0.5588652493546847,30
711,5,8166,8166,0,0,0,0,1.0,1,1.0,1,1.0,1,0.5576896537869032,30
712,10,8176,8176,0,0,0,0,1.0,1,1.0,1,1.0,1,0.5814830882070062,30
713,15,8191,8191,0,0,0,0,1.0,1,1.0,1,1.0,1,0.6195529928504837,31
714,14,8205,8205,0,0,0,0,1.0,1,1.0,1,1.0,1,0.5059847323338867,31
715,11,8216,8216,0,0,0,0,1.0,1,1.0,1,1.0,1,0.6101893999790167,30
716,13,8229,8229,0,0,0,0,1.0,1,1.0,1,1.0,1,0.42719748740259206,31
717,20,8249,8249,0,0,0,0,1.0,1,1.0,1,1.0,1,0.5203852656869948,32
718,11,8260,8260,0,0,0,0,1.0,1,1.0,1,1.0,1,0.5021795045525367,32
719,15,8275,8275,0,0,0,0,1.0,1,1.0,1,1.0,1,0.4699592209348139,32
720,18,8293,8293,0,0,0,0,1.0,1,1.0,1,1.0,1,0.5043083612151366,34
721,17,8310,8310,0,0,0,0,1.0,1,1.0,1,1.0,1,0.5053582192034746,34
722,8,8318,8318,0,0,0,0,1.0,1,1.0,1,1.0,1,0.633488597675068,34
723,15,8333,8333,0,0,0,0,1.0,1,1.0,1,1.0,1,0.46325490686722126,35
724,18,8351,8351,0,0,0,0,1.0,1,1.0,1,1.0,1,0.41622001185348306,36
725,15,8366,8366,0,0,0,0,1.0,1,1.0,1,1.0,1,0.5846200325514269,37
726,14,8380,8380,0,0,0,0,1.0,1,1.0,1,1.0,1,0.47375173253146935,37
727,8,8388,8388,0,0,0,0,1.0,1,1.0,1,1.0,1,0.4846502707316365,38
728,10,8398,8398,0,0,0,0,1.0,1,1.0,1,1.0,1,0.3997212898210326,39
729,11,8409,8409,0,0,0,0,1.0,1,1.0,1,1.0,1,0.5284021705752922,39
730,8,8417,8417,0,0,0,0,1.0,1,1.0,1,1.0,1,0.4899092784176092,40
731,12,8429,8429,0,0,0,0,1.0,1,1.0,1,1.0,1,0.5282214272888083,40
732,17,8446,8446,0,0,0,0,1.0,1,1.0,1,1.0,1,0.49519789252093194,41
733,9,8455,8455,0,0,0,0,1.0,1,1.0,1,1.0,1,0.5572104553803914,41
734,25,8480,8480,0,0,0,0,1.0,1,1.0,1,1.0,1,0.4207142507714187,42
735,28,8508,8508,0,0,0,0,1.0,1,1.0,1,1.0,1,0.5749320779765997,42
736,25,8533,8533,0,0,0,0,1.0,1,1.0,1,1.0,1,0.539691657347934,41
737,13,8546,8546,0,0,0,0,1.0,1,1.0,1,1.0,1,0.41180754428138855,41
738,21,8567,8567,0,0,0,0,1.0,1,1.0,1,1.0,1,0.45863624551492305,39
739,17,8584,8584,0,0,0,0,1.0,1,1.0,1,1.0,1,0.38980214987263,39
740,16,8600,8600,0,0,0,0,1.0,1,1.0,1,1.0,1,0.4199076190341441,39
741,20,8620,8620,0,0,0,0,1.0,1,1.0,1,1.0,1,0.3958853332012652,38
742,19,8639,8639,0,0,0,0,1.0,1,1.0,1,1.0,1,0.38223350874221057,39
743,20,8659,8659,0,0,0,0,1.0,1,1.0,1,1.0,1,0.31863678729365186,39
744,11,8670,8670,0,0,0,0,1.0,1,1.0,1,1.0,1,0.2899904623099505,39
745,16,8686,8686,0,0,0,0,1.0,1,1.0,1,1.0,1,0.2717360191752063,39
746,11,8697,8697,0,0,0,0,1.0,1,1.0,1,1.0,1,0.22666153850415846,40
747,12,8709,8709,0,0,0,0,1.0,1,1.0,1,1.0,1,0.39532878028802193,41
748,7,8716,8716,0,0,0,0,1.0,1,1.0,1,1.0,1,0.34169119997923236,41
749,11,8727,8727,0,0,0,0,1.0,1,1.0,1,1.0,1,0.2804324533760783,41
750,15,8742,8742,0,0,0,0,1.0,1,1.0,1,1.0,1,0.2522906821472188,39
751,7,8749,8749,0,0,0,0,1.0,1,1.0,1,1.0,1,0.29177725063785726,41
752,9,8758,8758,0,0,0,0,1.0,1,1.0,1,1.0,1,0.39237465322377474,41
753,19,8777,8777,0,0,0,0,1.0,1,1.0,1,1.0,1,0.35916834032833567,41
754,14,8791,8791,0,0,0,0,1.0,1,1.0,1,1.0,1,0.3127399122163854,41
755,7,8798,8798,0,0,0,0,1.0,1,1.0,1,1.0,1,0.2365711336078098,41
756,5,8803,8803,0,0,0,0,1.0,1,1.0,1,1.0,1,0.3670227185330646,41
757,15,8818,8818,0,0,0,0,1.0,1,1.0,1,1.0,1,0.2266919771559239,39
758,15,8833,8833,0,0,0,0,1.0,1,1.0,1,1.0,1,0.23638072463330287,39
759,10,8843,8843,0,0,0,0,1.0,1,1.0,1,1.0,1,0.4024410642220406,39
760,8,8851,8851,0,0,0,0,1.0,1,1.0,1,1.0,1,0.3443003684867617,40
761,15,8866,8866,0,0,0,0,1.0,1,1.0,1,1.0,1,0.4031657999415807,41
762,5,8871,8871,0,0,0,0,1.0,1,1.0,1,1.0,1,0.29963172889235834,42
763,6,8877,8877,0,0,0,0,1.0,1,1.0,1,1.0,1,0.37146486012934254,43
764,9,8886,8886,0,0,0,0,1.0,1,1.0,1,1.0,1,0.4261705479403544,43
765,6,8892,8892,0,0,0,0,1.0,1,1.0,1,1.0,1,0.3910032558069781,45
766,15,8907,8907,0,0,0,0,1.0,1,1.0,1,1.0,1,0.28511494631828926,45
767,17,8924,8924,0,0,0,0,1.0,1,1.0,1,1.0,1,0.20481160696080628,46
768,10,8934,8934,0,0,0,0,1.0,1,1.0,1,1.0,1,0.3115515819534394,45
769,14,8948,8948,0,0,0,0,1.0,1,1.0,1,1.0,1,0.33839308406383656,46
770,10,8958,8958,0,0,0,0,1.0,1,1.0,1,1.0,1,0.28998351903001596,47
771,12,8970,8970,0,0,0,0,1.0,1,1.0,1,1.0,1,0.3588371443915921,47
772,13,8983,8983,0,0,0,0,1.0,1,1.0,1,1.0,1,0.2006488561943609,46
773,16,8999,8999,0,0,0,0,1.0,1,1.0,1,1.0,1,0.29447744323095526,45
774,10,9009,9009,0,0,0,0,1.0,1,1.0,1,1.0,1,0.2357172545341333,45
775,15,9024,9024,0,0,0,0,1.0,1,1.0,1,1.0,1,0.32148377546369916,45
776,14,9038,9038,0,0,0,0,1.0,1,1.0,1,1.0,1,0.30189271300819864,43
777,11,9049,9049,0,0,0,0,1.0,1,1.0,1,1.0,1,0.3619363380448935,44
778,17,9066,9066,0,0,0,0,1.0,1,1.0,1,1.0,1,0.3534377070866507,45
779,19,9085,9085,0,0,0,0,1.0,1,1.0,1,1.0,1,0.3512936878417561,45
780,23,9108,9108,0,0,0,0,1.0,1,1.0,1,1.0,1,0.3396809990013239,45
781,19,9127,9127,0,0,0,0,1.0,1,1.0,1,1.0,1,0.3398793644110693,46
782,17,9144,9144,0,0,0,0,1.0,1,1.0,1,1.0,1,0.41168436294391814,47
783,25,9169,9169,0,0,0,0,1.0,1,1.0,1,1.0,1,0.40204652025220944,46
784,33,9202,9202,0,0,0,0,1.0,1,1.0,1,1.0,1,0.40326898505897624,45
785,26,9228,9228,0,0,0,0,1.0,1,1.0,1,1.0,1,0.39797243106142144,43
786,32,9260,9260,0,0,0,0,1.0,1,1.0,1,1.0,1,0.41589291237937365,43
787,17,9277,9277,0,0,0,0,1.0,1,1.0,1,1.0,1,0.36996301027562545,43
788,24,9301,9301,0,0,0,0,1.0,1,1.0,1,1.0,1,0.35426690441656367,44
789,10,9311,9311,0,0,0,0,1.0,1,1.0,1,1.0,1,0.3448438585453441,46
790,18,9329,9329,0,0,0,0,1.0,1,1.0,1,1.0,1,0.3417773025911686,46
791,15,9344,9344,0,0,0,0,1.0,1,1.0,1,1.0,1,0.33122845221758246,46
792,9,9353,9353,0,0,0,0,1.0,1,1.0,1,1.0,1,0.33532796587206765,47
793,7,9360,9360,0,0,0,0,1.0,1,1.0,1,1.0,1,0.25943865376788905,48
794,19,9379,9379,0,0,0,0,1.0,1,1.0,1,1.0,1,0.3585577983296558,48
795,16,9395,9395,0,0,0,0,1.0,1,1.0,1,1.0,1,0.26534248082641526,47
796,18,9413,9413,0,0,0,0,1.0,1,1.0,1,1.0,1,0.329609024429574,45
797,14,9427,9427,0,0,0,0,1.0,1,1.0,1,1.0,1,0.3217769935590129,47
798,20,9447,9447,0,0,0,0,1.0,1,1.0,1,1.0,1,0.3203663039165837,48
799,19,9466,9466,0,0,0,0,1.0,1,1.0,1,1.0,1,0.4493767609934691,48
800,18,9484,9484,0,0,0,0,1.0,1,1.0,1,1.0,1,0.37664951503558247,48
801,24,9508,9508,0,0,0,0,1.0,1,1.0,1,1.0,1,0.3569122451871883,49
802,12,9520,9520,0,0,0,0,1.0,1,1.0,1,1.0,1,0.3694973516630137,50
803,13,9533,9533,0,0,0,0,1.0,1,1.0,1,1.0,1,0.3606969189027552,50
804,16,9549,9549,0,0,0,0,1.0,1,1.0,1,1.0,1,0.3521904124046657,50
805,11,9560,9560,0,0,0,0,1.0,1,1.0,1,1.0,1,0.3501053807897698,50
806,22,9582,9582,0,0,0,0,1.0,1,1.0,1,1.0,1,0.41162773404902786,51
807,15,9597,9597,0,0,0,0,1.0,1,1.0,1,1.0,1,0.37695841824187004,51
808,11,9608,9608,0,0,0,0,1.0,1,1.0,1,1.0,1,0.45472614173795395,53
809,23,9631,9631,0,0,0,0,1.0,1,1.0,1,1.0,1,0.4629560558354694,51
810,26,9657,9657,0,0,0,0,1.0,1,1.0,1,1.0,1,0.3946313156289666,52
811,18,9675,9675,0,0,0,0,1.0,1,1.0,1,1.0,1,0.37216840472458634,50
812,26,9701,9701,0,0,0,0,1.0,1,1.0,1,1.0,1,0.33784266333144874,51
813,20,9721,9721,0,0,0,0,1.0,1,1.0,1,1.0,1,0.3853017646870954,51
814,23,9744,9744,0,0,0,0,1.0,1,1.0,1,1.0,1,0.4045918110652287,52
815,16,9760,9760,0,0,0,0,1.0,1,1.0,1,1.0,1,0.3142497988692207,50
816,20,9780,9780,0,0,0,0,1.0,1,1.0,1,1.0,1,0.3565979347921474,50
817,13,9793,9793,0,0,0,0,1.0,1,1.0,1,1.0,1,0.342052816486239,49
818,10,9803,9803,0,0,0,0,1.0,1,1.0,1,1.0,1,0.346862007611248,49
819,14,9817,9817,0,0,0,0,1.0,1,1.0,1,1.0,1,0.3642803041063874,50
820,12,9829,9829,0,0,0,0,1.0,1,1.0,1,1.0,1,0.36559171355373055,49
821,7,9836,9836,0,0,0,0,1.0,1,1.0,1,1.0,1,0.34246306739663257,49
822,8,9844,9844,0,0,0,0,1.0,1,1.0,1,1.0,1,0.3441056230388034,49
823,12,9856,9856,0,0,0,0,1.0,1,1.0,1,1.0,1,0.3638570823547163,47
824,12,9868,9868,0,0,0,0,1.0,1,1.0,1,1.0,1,0.3409081700354759,45
825,13,9881,9881,0,0,0,0,1.0,1,1.0,1,1.0,1,0.3555252871070859,43
826,15,9896,9896,0,0,0,0,1.0,1,1.0,1,1.0,1,0.37428115387679717,44
827,8,9904,9904,0,0,0,0,1.0,1,1.0,1,1.0,1,0.35627030922000436,43
828,16,9920,9920,0,0,0,0,1.0,1,1.0,1,1.0,1,0.340865309929724,43
829,13,9933,9933,0,0,0,0,1.0,1,1.0,1,1.0,1,0.32999762764796753,45
830,14,9947,9947,0,0,0,0,1.0,1,1.0,1,1.0,1,0.37694234288550943,46
831,13,9960,9960,0,0,0,0,1.0,1,1.0,1,1.0,1,0.2964993460732508,48
832,18,9978,9978,0,0,0,0,1.0,1,1.0,1,1.0,1,0.2816978053344903,47
833,19,9997,9997,0,0,0,0,1.0,1,1.0,1,1.0,1,0.29020996335383825,47
834,16,10013,10013,0,0,0,0,1.0,1,1.0,1,1.0,1,0.35913022277572787,46
835,13,10026,10026,0,0,0,0,1.0,1,1.0,1,1.0,1,0.39099347315805233,45
836,14,10040,10040,0,0,0,0,1.0,1,1.0,1,1.0,1,0.3986507715939896,46
837,18,10058,10058,0,0,0,0,1.0,1,1.0,1,1.0,1,0.37842283969734475,46
838,22,10080,10080,0,0,0,0,1.0,1,1.0,1,1.0,1,0.3821274385414833,45
839,14,10094,10094,0,0,0,0,1.0,1,1.0,1,1.0,1,0.3622082284420537,46
840,17,10111,10111,0,0,0,0,1.0,1,1.0,1,1.0,1,0.3176693454561186,46
841,11,10122,10122,0,0,0,0,1.0,1,1.0,1,1.0,1,0.36538631897436485,46
842,13,10135,10135,0,0,0,0,1.0,1,1.0,1,1.0,1,0.340353855756306,46
843,9,10144,10144,0,0,0,0,1.0,1,1.0,1,1.0,1,0.3556372375174457,46
844,9,10153,10153,0,0,0,0,1.0,1,1.0,1,1.0,1,0.3945700322922886,47
845,9,10162,10162,0,0,0,0,1.0,1,1.0,1,1.0,1,0.34458032799020033,48
846,15,10177,10177,0,0,0,0,1.0,1,1.0,1,1.0,1,0.3257472818931066,47
847,10,10187,10187,0,0,0,0,1.0,1,1.0,1,1.0,1,0.2598803486894927,48
848,15,10202,10202,0,0,0,0,1.0,1,1.0,1,1.0,1,0.2840543820392553,48
849,16,10218,10218,0,0,0,0,1.0,1,1.0,1,1.0,1,0.1968742181771047,48
850,16,10234,10234,0,0,0,0,1.0,1,1.0,1,1.0,1,0.2520998655131262,46
851,15,10249,10249,0,0,0,0,1.0,1,1.0,1,1.0,1,0.20784166094032533,45
852,11,10260,10260,0,0,0,0,1.0,1,1.0,1,1.0,1,0.3541992670008934,44
853,10,10270,10270,0,0,0,0,1.0,1,1.0,1,1.0,1,0.24856353026640784,44
854,14,10284,10284,0,0,0,0,1.0,1,1.0,1,1.0,1,0.2753637935861375,45
855,10,10294,10294,0,0,0,0,1.0,1,1.0,1,1.0,1,0.33493252083221003,46
856,12,10306,10306,0,0,0,0,1.0,1,1.0,1,1.0,1,0.3034415254078939,46
857,11,10317,10317,0,0,0,0,1.0,1,1.0,1,1.0,1,0.4200384072334462,47
858,12,10329,10329,0,0,0,0,1.0,1,1.0,1,1.0,1,0.41238012731149626,48
859,7,10336,10336,0,0,0,0,1.0,1,1.0,1,1.0,1,0.2759764206934864,48
860,15,10351,10351,0,0,0,0,1.0,1,1.0,1,1.0,1,0.3746886644632707,49
861,6,10357,10357,0,0,0,0,1.0,1,1.0,1,1.0,1,0.37469121047463033,49
862,16,10373,10373,0,0,0,0,1.0,1,1.0,1,1.0,1,0.3774771152835527,49
863,7,10380,10380,0,0,0,0,1.0,1,1.0,1,1.0,1,0.335560189777845,48
864,11,10391,10391,0,0,0,0,1.0,1,1.0,1,1.0,1,0.3512097845993458,49
865,11,10402,10402,0,0,0,0,1.0,1,1.0,1,1.0,1,0.389177385779933,48
866,13,10415,10415,0,0,0,0,1.0,1,1.0,1,1.0,1,0.30672272468198286,50
867,9,10424,10424,0,0,0,0,1.0,1,1.0,1,1.0,1,0.35414160057879635,50
868,15,10439,10439,0,0,0,0,1.0,1,1.0,1,1.0,1,0.32041063209518567,51
869,18,10457,10457,0,0,0,0,1.0,1,1.0,1,1.0,1,0.29007930972522594,49
870,16,10473,10473,0,0,0,0,1.0,1,1.0,1,1.0,1,0.3362196954989446,49
871,11,10484,10484,0,0,0,0,1.0,1,1.0,1,1.0,1,0.3068478725395281,49
872,11,10495,10495,0,0,0,0,1.0,1,1.0,1,1.0,1,0.30359261845328583,48
873,13,10508,10508,0,0,0,0,1.0,1,1.0,1,1.0,1,0.23957626068925944,49
874,13,10521,10521,0,0,0,0,1.0,1,1.0,1,1.0,1,0.2739541480045207,49
875,11,10532,10532,0,0,0,0,1.0,1,1.0,1,1.0,1,0.22819605593919387,50
876,9,10541,10541,0,0,0,0,1.0,1,1.0,1,1.0,1,0.21382479701628757,50
877,19,10560,10560,0,0,0,0,1.0,1,1.0,1,1.0,1,0.23881094500103395,50
878,8,10568,10568,0,0,0,0,1.0,1,1.0,1,1.0,1,0.2705884114248972,49
879,15,10583,10583,0,0,0,0,1.0,1,1.0,1,1.0,1,0.3187892245704276,49
880,11,10594,10594,0,0,0,0,1.0,1,1.0,1,1.0,1,0.36210087790001544,48
881,7,10601,10601,0,0,0,0,1.0,1,1.0,1,1.0,1,0.3540421875604557,49
882,6,10607,10607,0,0,0,0,1.0,1,1.0,1,1.0,1,0.39641591551798494,48
883,12,10619,10619,0,0,0,0,1.0,1,1.0,1,1.0,1,0.3734032878790823,50
884,9,10628,10628,0,0,0,0,1.0,1,1.0,1,1.0,1,0.3166331205887717,50
885,9,10637,10637,0,0,0,0,1.0,1,1.0,1,1.0,1,0.38769770302424345,49
886,13,10650,10650,0,0,0,0,1.0,1,1.0,1,1.0,1,0.38518775757979085,49
887,10,10660,10660,0,0,0,0,1.0,1,1.0,1,1.0,1,0.38161589345999436,49
888,6,10666,10666,0,0,0,0,1.0,1,1.0,1,1.0,1,0.29473275001818894,47
889,9,10675,10675,0,0,0,0,1.0,1,1.0,1,1.0,1,0.37129901643618896,46
890,11,10686,10686,0,0,0,0,1.0,1,1.0,1,1.0,1,0.38602629392999577,44
891,11,10697,10697,0,0,0,0,1.0,1,1.0,1,1.0,1,0.3767322232535386,45
892,9,10706,10706,0,0,0,0,1.0,1,1.0,1,1.0,1,0.27152280050300753,45
893,16,10722,10722,0,0,0,0,1.0,1,1.0,1,1.0,1,0.35624947099510107,45
894,12,10734,10734,0,0,0,0,1.0,1,1.0,1,1.0,1,0.306004949339926,44
895,20,10754,10754,0,0,0,0,1.0,1,1.0,1,1.0,1,0.28119829990755607,45
896,8,10762,10762,0,0,0,0,1.0,1,1.0,1,1.0,1,0.38098073741023625,44
897,5,10767,10767,0,0,0,0,1.0,1,1.0,1,1.0,1,0.35992376533823744,44
898,9,10776,10776,0,0,0,0,1.0,1,1.0,1,1.0,1,0.27398372780475816,45
899,6,10782,10782,0,0,0,0,1.0,1,1.0,1,1.0,1,0.36341121787833414,44
900,8,10790,10790,0,0,0,0,1.0,1,1.0,1,1.0,1,0.3085602704538681,46
901,16,10806,10806,0,0,0,0,1.0,1,1.0,1,1.0,1,0.29096390493771246,45
902,22,10828,10828,0,0,0,0,1.0,1,1.0,1,1.0,1,0.30045803089258777,45
903,25,10853,10853,0,0,0,0,1.0,1,1.0,1,1.0,1,0.2643180455096399,44
904,13,10866,10866,0,0,0,0,1.0,1,1.0,1,1.0,1,0.3836252907126168,45
905,18,10884,10884,0,0,0,0,1.0,1,1.0,1,1.0,1,0.3898360767926658,45
906,14,10898,10898,0,0,0,0,1.0,1,1.0,1,1.0,1,0.3048242737080682,45
907,16,10914,10914,0,0,0,0,1.0,1,1.0,1,1.0,1,0.319375260093466,46
908,19,10933,10933,0,0,0,0,1.0,1,1.0,1,1.0,1,0.2712569932082603,46
909,11,10944,10944,0,0,0,0,1.0,1,1.0,1,1.0,1,0.3284919394710273,46
910,20,10964,10964,0,0,0,0,1.0,1,1.0,1,1.0,1,0.39766195391615095,44
911,15,10979,10979,0,0,0,0,1.0,1,1.0,1,1.0,1,0.2866525523362736,45
912,30,11009,11009,0,0,0,0,1.0,1,1.0,1,1.0,1,0.33562331164332077,44
913,8,11017,11017,0,0,0,0,1.0,1,1.0,1,1.0,1,0.36215871965764945,45
914,21,11038,11038,0,0,0,0,1.0,1,1.0,1,1.0,1,0.3529848132080287,45
915,13,11051,11051,0,0,0,0,1.0,1,1.0,1,1.0,1,0.37798507000330583,45
916,17,11068,11068,0,0,0,0,1.0,1,1.0,1,1.0,1,0.42949385724686423,45
917,14,11082,11082,0,0,0,0,1.0,1,1.0,1,1.0,1,0.5027833074071572,46
918,10,11092,11092,0,0,0,0,1.0,1,1.0,1,1.0,1,0.33129110845441906,47
919,19,11111,11111,0,0,0,0,1.0,1,1.0,1,1.0,1,0.40092556368020005,47
920,21,11132,11132,0,0,0,0,1.0,1,1.0,1,1.0,1,0.3801790964141193,47
921,20,11152,11152,0,0,0,0,1.0,1,1.0,1,1.0,1,0.3935327872429865,49
922,16,11168,11168,0,0,0,0,1.0,1,1.0,1,1.0,1,0.38559522903993065,49
923,11,11179,11179,0,0,0,0,1.0,1,1.0,1,1.0,1,0.32716705529809265,47
924,9,11188,11188,0,0,0,0,1.0,1,1.0,1,1.0,1,0.23330963045969874,47
925,21,11209,11209,0,0,0,0,1.0,1,1.0,1,1.0,1,0.27789641381824354,47
926,8,11217,11217,0,0,0,0,1.0,1,1.0,1,1.0,1,0.3021049275883111,46
927,15,11232,11232,0,0,0,0,1.0,1,1.0,1,1.0,1,0.27949094126889445,45
928,9,11241,11241,0,0,0,0,1.0,1,1.0,1,1.0,1,0.27802198369471526,43
929,10,11251,11251,0,0,0,0,1.0,1,1.0,1,1.0,1,0.21983986678221784,42
930,10,11261,11261,0,0,0,0,1.0,1,1.0,1,1.0,1,0.1465270693197718,41
931,14,11275,11275,0,0,0,0,1.0,1,1.0,1,1.0,1,0.19584408747077453,40
932,12,11287,11287,0,0,0,0,1.0,1,1.0,1,1.0,1,0.22704064495845405,40
933,11,11298,11298,0,0,0,0,1.0,1,1.0,1,1.0,1,0.2767828694289114,39
934,13,11311,11311,0,0,0,0,1.0,1,1.0,1,1.0,1,0.20353296430626414,39
935,16,11327,11327,0,0,0,0,1.0,1,1.0,1,1.0,1,0.34778631880117894,41
936,15,11342,11342,0,0,0,0,1.0,1,1.0,1,1.0,1,0.37413488776312187,42
937,16,11358,11358,0,0,0,0,1.0,1,1.0,1,1.0,1,0.4252642271533391,43
938,14,11372,11372,0,0,0,0,1.0,1,1.0,1,1.0,1,0.3291835091829342,44
939,19,11391,11391,0,0,0,0,1.0,1,1.0,1,1.0,1,0.3170472836213016,46
940,12,11403,11403,0,0,0,0,1.0,1,1.0,1,1.0,1,0.4463587792014421,46
941,15,11418,11418,0,0,0,0,1.0,1,1.0,1,1.0,1,0.40254158319612054,46
942,17,11435,11435,0,0,0,0,1.0,1,1.0,1,1.0,1,0.41853670382067276,46
943,14,11449,11449,0,0,0,0,1.0,1,1.0,1,1.0,1,0.385198169069352,45
944,18,11467,11467,0,0,0,0,1.0,1,1.0,1,1.0,1,0.35703257151567697,45
945,16,11483,11483,0,0,0,0,1.0,1,1.0,1,1.0,1,0.4595530984439321,44
946,22,11505,11505,0,0,0,0,1.0,1,1.0,1,1.0,1,0.3877436866140637,46
947,33,11538,11538,0,0,0,0,1.0,1,1.0,1,1.0,1,0.3588663569189356,44
948,14,11552,11552,0,0,0,0,1.0,1,1.0,1,1.0,1,0.45697109389675145,44
949,20,11572,11572,0,0,0,0,1.0,1,1.0,1,1.0,1,0.4270877266010457,44
950,14,11586,11586,0,0,0,0,1.0,1,1.0,1,1.0,1,0.448139296474204,43
951,16,11602,11602,0,0,0,0,1.0,1,1.0,1,1.0,1,0.5326976053078779,42
952,18,11620,11620,0,0,0,0,1.0,1,1.0,1,1.0,1,0.3635351135114906,42
953,32,11652,11652,0,0,0,0,1.0,1,1.0,1,1.0,1,0.42962582016466344,41
954,11,11663,11663,0,0,0,0,1.0,1,1.0,1,1.0,1,0.4944205678912193,40
955,19,11682,11682,0,0,0,0,1.0,1,1.0,1,1.0,1,0.5225091853082483,42
956,20,11702,11702,0,0,0,0,1.0,1,1.0,1,1.0,1,0.3543005665582624,43
957,28,11730,11730,0,0,0,0,1.0,1,1.0,1,1.0,1,0.47984837426015353,42
958,16,11746,11746,0,0,0,0,1.0,1,1.0,1,1.0,1,0.48534333903459953,43
959,21,11767,11767,0,0,0,0,1.0,1,1.0,1,1.0,1,0.5479967008492818,45
960,14,11781,11781,0,0,0,0,1.0,1,1.0,1,1.0,1,0.460081045145724,47
961,13,11794,11794,0,0,0,0,1.0,1,1.0,1,1.0,1,0.4492704553816259,45
962,21,11815,11815,0,0,0,0,1.0,1,1.0,1,1.0,1,0.3673256227487859,45
963,25,11840,11840,0,0,0,0,1.0,1,1.0,1,1.0,1,0.4064111240475565,44
964,21,11861,11861,0,0,0,0,1.0,1,1.0,1,1.0,1,0.42711406184390815,44
965,23,11884,11884,0,0,0,0,1.0,1,1.0,1,1.0,1,0.41045029476755435,45
966,17,11901,11901,0,0,0,0,1.0,1,1.0,1,1.0,1,0.49546122233365303,43
967,16,11917,11917,0,0,0,0,1.0,1,1.0,1,1.0,1,0.5273751208505834,43
968,25,11942,11942,0,0,0,0,1.0,1,1.0,1,1.0,1,0.5259490920616727,43
969,14,11956,11956,0,0,0,0,1.0,1,1.0,1,1.0,1,0.5078704504207555,42
970,13,11969,11969,0,0,0,0,1.0,1,1.0,1,1.0,1,0.5299090399916593,42
971,15,11984,11984,0,0,0,0,1.0,1,1.0,1,1.0,1,0.477507412943016,42
972,17,12001,12001,0,0,0,0,1.0,1,1.0,1,1.0,1,0.4702194694289261,42
973,9,12010,12010,0,0,0,0,1.0,1,1.0,1,1.0,1,0.46003553322656754,43
974,15,12025,12025,0,0,0,0,1.0,1,1.0,1,1.0,1,0.5448612160955492,43
975,17,12042,12042,0,0,0,0,1.0,1,1.0,1,1.0,1,0.48052733583606844,43
976,26,12068,12068,0,0,0,0,1.0,1,1.0,1,1.0,1,0.4293777797673686,45
977,8,12076,12076,0,0,0,0,1.0,1,1.0,1,1.0,1,0.3666932641926256,44
978,11,12087,12087,0,0,0,0,1.0,1,1.0,1,1.0,1,0.4708220208200875,44
979,15,12102,12102,0,0,0,0,1.0,1,1.0,1,1.0,1,0.3517872878138713,45
980,14,12116,12116,0,0,0,0,1.0,1,1.0,1,1.0,1,0.49799344778037863,45
981,13,12129,12129,0,0,0,0,1.0,1,1.0,1,1.0,1,0.4103093656961172,45
982,14,12143,12143,0,0,0,0,1.0,1,1.0,1,1.0,1,0.5266474816944636,46
983,40,12183,12183,0,0,0,0,1.0,1,1.0,1,1.0,1,0.4963758285500875,45
984,15,12198,12198,0,0,0,0,1.0,1,1.0,1,1.0,1,0.3449572757380082,45
985,22,12220,12220,0,0,0,0,1.0,1,1.0,1,1.0,1,0.36571130354478254,45
986,18,12238,12238,0,0,0,0,1.0,1,1.0,1,1.0,1,0.3410278493573996,44
987,14,12252,12252,0,0,0,0,1.0,1,1.0,1,1.0,1,0.49393290333223544,45
988,11,12263,12263,0,0,0,0,1.0,1,1.0,1,1.0,1,0.4485801497039917,44
989,16,12279,12279,0,0,0,0,1.0,1,1.0,1,1.0,1,0.508617153912236,43
990,13,12292,12292,0,0,0,0,1.0,1,1.0,1,1.0,1,0.3931498547982437,42
991,16,12308,12308,0,0,0,0,1.0,1,1.0,1,1.0,1,0.5186193439785884,42
992,19,12327,12327,0,0,0,0,1.0,1,1.0,1,1.0,1,0.5405219327203046,43
993,23,12350,12350,0,0,0,0,1.0,1,1.0,1,1.0,1,0.52474033261856,43
994,26,12376,12376,0,0,0,0,1.0,1,1.0,1,1.0,1,0.5565874070152708,43
995,11,12387,12387,0,0,0,0,1.0,1,1.0,1,1.0,1,0.42364705863457497,43
996,26,12413,12413,0,0,0,0,1.0,1,1.0,1,1.0,1,0.6008602375352066,44
997,23,12436,12436,0,0,0,0,1.0,1,1.0,1,1.0,1,0.5534058698634288,44
998,16,12452,12452,0,0,0,0,1.0,1,1.0,1,1.0,1,0.5177988040102716,45
999,16,12468,12468,0,0,0,0,1.0,1,1.0,1,1.0,1,0.5349909304037951,42
1000,17,12485,12485,0,0,0,0,1.0,1,1.0,1,1.0,1,0.5728731394112014,43
1001,24,12509,12509,0,0,0,0,1.0,1,1.0,1,1.0,1,0.5921378987856126,42
1002,10,12519,12519,0,0,0,0,1.0,1,1.0,1,1.0,1,0.5726829264284641,43
1003,20,12539,12539,0,0,0,0,1.0,1,1.0,1,1.0,1,0.4911944163026104,43
1004,19,12558,12558,0,0,0,0,1.0,1,1.0,1,1.0,1,0.6391641572447093,43
1005,23,12581,12581,0,0,0,0,1.0,1,1.0,1,1.0,1,0.5802989195596319,44
1006,29,12610,12610,0,0,0,0,1.0,1,1.0,1,1.0,1,0.54871997216931,46
1007,26,12636,12636,0,0,0,0,1.0,1,1.0,1,1.0,1,0.5953593421983426,46
1008,26,12662,12662,0,0,0,0,1.0,1,1.0,1,1.0,1,0.4422105452151876,47
1009,26,12688,12688,0,0,0,0,1.0,1,1.0,1,1.0,1,0.5728009260850276,48
1010,18,12706,12706,0,0,0,0,1.0,1,1.0,1,1.0,1,0.5845181623595006,48
1011,22,12728,12728,0,0,0,0,1.0,1,1.0,1,1.0,1,0.3775707440143625,48
1012,13,12741,12741,0,0,0,0,1.0,1,1.0,1,1.0,1,0.49834669042574115,49
1013,19,12760,12760,0,0,0,0,1.0,1,1.0,1,1.0,1,0.5476489310788443,50
1014,16,12776,12776,0,0,0,0,1.0,1,1.0,1,1.0,1,0.5495411240605369,50
1015,18,12794,12794,0,0,0,0,1.0,1,1.0,1,1.0,1,0.43768810343498277,51
1016,14,12808,12808,0,0,0,0,1.0,1,1.0,1,1.0,1,0.4674663150261608,51
1017,13,12821,12821,0,0,0,0,1.0,1,1.0,1,1.0,1,0.42739179482203554,52
1018,23,12844,12844,0,0,0,0,1.0,1,1.0,1,1.0,1,0.40073064039190526,52
1019,16,12860,12860,0,0,0,0,1.0,1,1.0,1,1.0,1,0.31203049280325035,52
1020,14,12874,12874,0,0,0,0,1.0,1,1.0,1,1.0,1,0.36157109775174634,53
1021,14,12888,12888,0,0,0,0,1.0,1,1.0,1,1.0,1,0.33025601496159573,53
1022,11,12899,12899,0,0,0,0,1.0,1,1.0,1,1.0,1,0.35444466392972124,54
1023,12,12911,12911,0,0,0,0,1.0,1,1.0,1,1.0,1,0.3378349687461519,55
1024,13,12924,12924,0,0,0,0,1.0,1,1.0,1,1.0,1,0.35297057802751347,55
1025,20,12944,12944,0,0,0,0,1.0,1,1.0,1,1.0,1,0.337856907872608,56
1026,19,12963,12963,0,0,0,0,1.0,1,1.0,1,1.0,1,0.3770487209272709,57
1027,15,12978,12978,0,0,0,0,1.0,1,1.0,1,1.0,1,0.3346265070627393,58
1028,13,12991,12991,0,0,0,0,1.0,1,1.0,1,1.0,1,0.3997851492106786,58
1029,15,13006,13006,0,0,0,0,1.0,1,1.0,1,1.0,1,0.3310540664433313,59
1030,17,13023,13023,0,0,0,0,1.0,1,1.0,1,1.0,1,0.3688773020093845,60
1031,12,13035,13035,0,0,0,0,1.0,1,1.0,1,1.0,1,0.382135387304358,60
1032,14,13049,13049,0,0,0,0,1.0,1,1.0,1,1.0,1,0.3285131339220467,61
1033,23,13072,13072,0,0,0,0,1.0,1,1.0,1,1.0,1,0.33168658968427267,60
1034,12,13084,13084,0,0,0,0,1.0,1,1.0,1,1.0,1,0.34714990123572903,60
1035,11,13095,13095,0,0,0,0,1.0,1,1.0,1,1.0,1,0.3651715374532757,59
1036,14,13109,13109,0,0,0,0,1.0,1,1.0,1,1.0,1,0.3311066079843128,60
1037,20,13129,13129,0,0,0,0,1.0,1,1.0,1,1.0,1,0.3176946817893535,59
1038,20,13149,13149,0,0,0,0,1.0,1,1.0,1,1.0,1,0.3893905799697088,60
1039,20,13169,13169,0,0,0,0,1.0,1,1.0,1,1.0,1,0.39467318150551134,60
1040,18,13187,13187,0,0,0,0,1.0,1,1.0,1,1.0,1,0.4485151815898209,58
1041,12,13199,13199,0,0,0,0,1.0,1,1.0,1,1.0,1,0.44076800147232525,56
1042,9,13208,13208,0,0,0,0,1.0,1,1.0,1,1.0,1,0.40140834543356274,55
1043,12,13220,13220,0,0,0,0,1.0,1,1.0,1,1.0,1,0.30626394570603915,55
1044,15,13235,13235,0,0,0,0,1.0,1,1.0,1,1.0,1,0.3533968017278705,52
1045,21,13256,13256,0,0,0,0,1.0,1,1.0,1,1.0,1,0.3778971594463758,52
1046,23,13279,13279,0,0,0,0,1.0,1,1.0,1,1.0,1,0.2794801905037536,53
1047,18,13297,13297,0,0,0,0,1.0,1,1.0,1,1.0,1,0.31742219597072285,54
1048,19,13316,13316,0,0,0,0,1.0,1,1.0,1,1.0,1,0.2985141931575455,56
1049,16,13332,13332,0,0,0,0,1.0,1,1.0,1,1.0,1,0.3497203794426409,55
1050,11,13343,13343,0,0,0,0,1.0,1,1.0,1,1.0,1,0.3831875207709036,56
1051,8,13351,13351,0,0,0,0,1.0,1,1.0,1,1.0,1,0.3970679878527999,55
1052,10,13361,13361,0,0,0,0,1.0,1,1.0,1,1.0,1,0.31915215359308413,56
1053,10,13371,13371,0,0,0,0,1.0,1,1.0,1,1.0,1,0.42186207045460716,56
1054,13,13384,13384,0,0,0,0,1.0,1,1.0,1,1.0,1,0.3952250673640265,57
1055,10,13394,13394,0,0,0,0,1.0,1,1.0,1,1.0,1,0.4354002101313331,58
1056,10,13404,13404,0,0,0,0,1.0,1,1.0,1,1.0,1,0.37125572317013156,59
1057,19,13423,13423,0,0,0,0,1.0,1,1.0,1,1.0,1,0.38269680178358756,60
1058,15,13438,13438,0,0,0,0,1.0,1,1.0,1,1.0,1,0.24030442375546932,60
1059,18,13456,13456,0,0,0,0,1.0,1,1.0,1,1.0,1,0.25190486795596256,60
1060,9,13465,13465,0,0,0,0,1.0,1,1.0,1,1.0,1,0.2785614425573677,60
1061,17,13482,13482,0,0,0,0,1.0,1,1.0,1,1.0,1,0.3200481597048193,59
1062,10,13492,13492,0,0,0,0,1.0,1,1.0,1,1.0,1,0.33323816702851594,59
1063,16,13508,13508,0,0,0,0,1.0,1,1.0,1,1.0,1,0.3265984407892233,58
1064,12,13520,13520,0,0,0,0,1.0,1,1.0,1,1.0,1,0.33273520558966513,58
1065,13,13533,13533,0,0,0,0,1.0,1,1.0,1,1.0,1,0.4727042596766903,60
1066,22,13555,13555,0,0,0,0,1.0,1,1.0,1,1.0,1,0.375761926791385,58
1067,18,13573,13573,0,0,0,0,1.0,1,1.0,1,1.0,1,0.28329050268041334,59
1068,14,13587,13587,0,0,0,0,1.0,1,1.0,1,1.0,1,0.36701418096891963,59
1069,15,13602,13602,0,0,0,0,1.0,1,1.0,1,1.0,1,0.37402164169279223,58
1070,17,13619,13619,0,0,0,0,1.0,1,1.0,1,1.0,1,0.28988310870310224,58
1071,12,13631,13631,0,0,0,0,1.0,1,1.0,1,1.0,1,0.34577321041430664,57
1072,8,13639,13639,0,0,0,0,1.0,1,1.0,1,1.0,1,0.3986905835352143,56
1073,15,13654,13654,0,0,0,0,1.0,1,1.0,1,1.0,1,0.33402882414675306,54
1074,13,13667,13667,0,0,0,0,1.0,1,1.0,1,1.0,1,0.37173078187768244,54
1075,18,13685,13685,0,0,0,0,1.0,1,1.0,1,1.0,1,0.3524886092330451,51
1076,21,13706,13706,0,0,0,0,1.0,1,1.0,1,1.0,1,0.37662645785918825,51
1077,16,13722,13722,0,0,0,0,1.0,1,1.0,1,1.0,1,0.35896074818835116,51
1078,19,13741,13741,0,0,0,0,1.0,1,1.0,1,1.0,1,0.36908536545680054,52
1079,14,13755,13755,0,0,0,0,1.0,1,1.0,1,1.0,1,0.37724447536570965,51
1080,11,13766,13766,0,0,0,0,1.0,1,1.0,1,1.0,1,0.35849444027859123,51
1081,15,13781,13781,0,0,0,0,1.0,1,1.0,1,1.0,1,0.34969685196897343,48
1082,9,13790,13790,0,0,0,0,1.0,1,1.0,1,1.0,1,0.37831744840328435,47
1083,13,13803,13803,0,0,0,0,1.0,1,1.0,1,1.0,1,0.3697322109778808,46
1084,22,13825,13825,0,0,0,0,1.0,1,1.0,1,1.0,1,0.3056632113330166,45
1085,15,13840,13840,0,0,0,0,1.0,1,1.0,1,1.0,1,0.34875694158916,46
1086,23,13863,13863,0,0,0,0,1.0,1,1.0,1,1.0,1,0.29641445693699814,45
1087,12,13875,13875,0,0,0,0,1.0,1,1.0,1,1.0,1,0.306711980679383,44
1088,11,13886,13886,0,0,0,0,1.0,1,1.0,1,1.0,1,0.36688632073222194,45
1089,11,13897,13897,0,0,0,0,1.0,1,1.0,1,1.0,1,0.40664847589567904,46
1090,28,13925,13925,0,0,0,0,1.0,1,1.0,1,1.0,1,0.33724354904367,47
1091,16,13941,13941,0,0,0,0,1.0,1,1.0,1,1.0,1,0.26850129512349535,47
1092,23,13964,13964,0,0,0,0,1.0,1,1.0,1,1.0,1,0.3374961567150806,48
1093,29,13993,13993,0,0,0,0,1.0,1,1.0,1,1.0,1,0.29544359069632387,48
1094,20,14013,14013,0,0,0,0,1.0,1,1.0,1,1.0,1,0.250492214106729,48
1095,16,14029,14029,0,0,0,0,1.0,1,1.0,1,1.0,1,0.296065384402098,49
1096,17,14046,14046,0,0,0,0,1.0,1,1.0,1,1.0,1,0.26980775828553244,49
1097,16,14062,14062,0,0,0,0,1.0,1,1.0,1,1.0,1,0.3246966894114067,50
1098,22,14084,14084,0,0,0,0,1.0,1,1.0,1,1.0,1,0.3664281622949401,51
1099,11,14095,14095,0,0,0,0,1.0,1,1.0,1,1.0,1,0.3511645275411824,54
1100,14,14109,14109,0,0,0,0,1.0,1,1.0,1,1.0,1,0.4070610553667127,54
1101,20,14129,14129,0,0,0,0,1.0,1,1.0,1,1.0,1,0.3076311160293112,54
1102,17,14146,14146,0,0,0,0,1.0,1,1.0,1,1.0,1,0.4146917498917483,54
1103,15,14161,14161,0,0,0,0,1.0,1,1.0,1,1.0,1,0.34574784892695326,53
1104,14,14175,14175,0,0,0,0,1.0,1,1.0,1,1.0,1,0.2742375551072572,53
1105,27,14202,14202,0,0,0,0,1.0,1,1.0,1,1.0,1,0.3451062833676251,52
1106,12,14214,14214,0,0,0,0,1.0,1,1.0,1,1.0,1,0.302025524650687,52
1107,32,14246,14246,0,0,0,0,1.0,1,1.0,1,1.0,1,0.32490363195387284,52
1108,17,14263,14263,0,0,0,0,1.0,1,1.0,1,1.0,1,0.3708794090435995,51
1109,24,14287,14287,0,0,0,0,1.0,1,1.0,1,1.0,1,0.43480492520924185,49
1110,41,14328,14328,0,0,0,0,1.0,1,1.0,1,1.0,1,0.40873264073184623,48
1111,23,14351,14351,0,0,0,0,1.0,1,1.0,1,1.0,1,0.40637882913388174,47
1112,19,14370,14370,0,0,0,0,1.0,1,1.0,1,1.0,1,0.41632915209542326,46
1113,20,14390,14390,0,0,0,0,1.0,1,1.0,1,1.0,1,0.47351660677979424,43
1114,12,14402,14402,0,0,0,0,1.0,1,1.0,1,1.0,1,0.44602576491580104,41
1115,26,14428,14428,0,0,0,0,1.0,1,1.0,1,1.0,1,0.5261314811205003,40
1116,14,14442,14442,0,0,0,0,1.0,1,1.0,1,1.0,1,0.4607865276179836,39
1117,19,14461,14461,0,0,0,0,1.0,1,1.0,1,1.0,1,0.3867045834723033,40
1118,27,14488,14488,0,0,0,0,1.0,1,1.0,1,1.0,1,0.4922366408402695,40
1119,25,14513,14513,0,0,0,0,1.0,1,1.0,1,1.0,1,0.35256495637987506,40
1120,20,14533,14533,0,0,0,0,1.0,1,1.0,1,1.0,1,0.4951814652138193,40
1121,9,14542,14542,0,0,0,0,1.0,1,1.0,1,1.0,1,0.37818737888257714,40
1122,15,14557,14557,0,0,0,0,1.0,1,1.0,1,1.0,1,0.4752338767795092,41
1123,12,14569,14569,0,0,0,0,1.0,1,1.0,1,1.0,1,0.3949181143459576,41
1124,9,14578,14578,0,0,0,0,1.0,1,1.0,1,1.0,1,0.3743117277070781,41
1125,9,14587,14587,0,0,0,0,1.0,1,1.0,1,1.0,1,0.386626200131739,41
1126,11,14598,14598,0,0,0,0,1.0,1,1.0,1,1.0,1,0.3465573594947103,41
1127,6,14604,14604,0,0,0,0,1.0,1,1.0,1,1.0,1,0.361347076417831,41
1128,10,14614,14614,0,0,0,0,1.0,1,1.0,1,1.0,1,0.43605579117689325,42
1129,11,14625,14625,0,0,0,0,1.0,1,1.0,1,1.0,1,0.3689611754905872,42
1130,6,14631,14631,0,0,0,0,1.0,1,1.0,1,1.0,1,0.41151906520177955,42
1131,8,14639,14639,0,0,0,0,1.0,1,1.0,1,1.0,1,0.42937175411546397,42
1132,15,14654,14654,0,0,0,0,1.0,1,1.0,1,1.0,1,0.30693025690267584,43
1133,15,14669,14669,0,0,0,0,1.0,1,1.0,1,1.0,1,0.3838722403314265,45
1134,8,14677,14677,0,0,0,0,1.0,1,1.0,1,1.0,1,0.35606308905591744,46
1135,7,14684,14684,0,0,0,0,1.0,1,1.0,1,1.0,1,0.41918297298553026,45
1136,7,14691,14691,0,0,0,0,1.0,1,1.0,1,1.0,1,0.4398882724347103,48
1137,9,14700,14700,0,0,0,0,1.0,1,1.0,1,1.0,1,0.4046311530393497,49
1138,22,14722,14722,0,0,0,0,1.0,1,1.0,1,1.0,1,0.32739082004836334,49
1139,12,14734,14734,0,0,0,0,1.0,1,1.0,1,1.0,1,0.37017419090597214,49
1140,20,14754,14754,0,0,0,0,1.0,1,1.0,1,1.0,1,0.3251409890597467,49
1141,19,14773,14773,0,0,0,0,1.0,1,1.0,1,1.0,1,0.3103944919227134,48
1142,19,14792,14792,0,0,0,0,1.0,1,1.0,1,1.0,1,0.3476233733515492,48
1143,15,14807,14807,0,0,0,0,1.0,1,1.0,1,1.0,1,0.30752726651523704,48
1144,26,14833,14833,0,0,0,0,1.0,1,1.0,1,1.0,1,0.39220571669333587,48
1145,16,14849,14849,0,0,0,0,1.0,1,1.0,1,1.0,1,0.36643211803176196,48
1146,22,14871,14871,0,0,0,0,1.0,1,1.0,1,1.0,1,0.289588337130529,48
1147,25,14896,14896,0,0,0,0,1.0,1,1.0,1,1.0,1,0.5079654191453237,46
1148,13,14909,14909,0,0,0,0,1.0,1,1.0,1,1.0,1,0.4237075134388542,46
1149,9,14918,14918,0,0,0,0,1.0,1,1.0,1,1.0,1,0.3952130942049631,45
1150,20,14938,14938,0,0,0,0,1.0,1,1.0,1,1.0,1,0.4567584685635491,46
1151,13,14951,14951,0,0,0,0,1.0,1,1.0,1,1.0,1,0.3485912596832781,44
1152,14,14965,14965,0,0,0,0,1.0,1,1.0,1,1.0,1,0.38229352640468384,44
1153,11,14976,14976,0,0,0,0,1.0,1,1.0,1,1.0,1,0.41353631133409596,43
1154,16,14992,14992,0,0,0,0,1.0,1,1.0,1,1.0,1,0.3502516611971206,43
1155,16,15008,15008,0,0,0,0,1.0,1,1.0,1,1.0,1,0.4120582906588707,43
1156,12,15020,15020,0,0,0,0,1.0,1,1.0,1,1.0,1,0.4058345091463519,42
1157,21,15041,15041,0,0,0,0,1.0,1,1.0,1,1.0,1,0.3847889873568718,42
1158,10,15051,15051,0,0,0,0,1.0,1,1.0,1,1.0,1,0.3359006773094276,41
1159,22,15073,15073,0,0,0,0,1.0,1,1.0,1,1.0,1,0.36838241243628644,41
1160,14,15087,15087,0,0,0,0,1.0,1,1.0,1,1.0,1,0.4397347579470098,41
1161,7,15094,15094,0,0,0,0,1.0,1,1.0,1,1.0,1,0.45000681459109254,42
1162,10,15104,15104,0,0,0,0,1.0,1,1.0,1,1.0,1,0.30035567217430625,43
1163,9,15113,15113,0,0,0,0,1.0,1,1.0,1,1.0,1,0.38900237781933555,43
1164,6,15119,15119,0,0,0,0,1.0,1,1.0,1,1.0,1,0.40490050829423846,44
1165,14,15133,15133,0,0,0,0,1.0,1,1.0,1,1.0,1,0.3013168656228624,44
1166,12,15145,15145,0,0,0,0,1.0,1,1.0,1,1.0,1,0.34105801440595257,46
1167,15,15160,15160,0,0,0,0,1.0,1,1.0,1,1.0,1,0.373440236292328,46
1168,15,15175,15175,0,0,0,0,1.0,1,1.0,1,1.0,1,0.21930417208352943,47
1169,13,15188,15188,0,0,0,0,1.0,1,1.0,1,1.0,1,0.4095303050627708,46
1170,17,15205,15205,0,0,0,0,1.0,1,1.0,1,1.0,1,0.3420341660679231,48
1171,10,15215,15215,0,0,0,0,1.0,1,1.0,1,1.0,1,0.363950838210039,49
1172,14,15229,15229,0,0,0,0,1.0,1,1.0,1,1.0,1,0.3167620280711407,49
1173,11,15240,15240,0,0,0,0,1.0,1,1.0,1,1.0,1,0.28482774905668146,49
1174,20,15260,15260,0,0,0,0,1.0,1,1.0,1,1.0,1,0.36337495067960845,49
1175,21,15281,15281,0,0,0,0,1.0,1,1.0,1,1.0,1,0.26425285433001083,50
1176,21,15302,15302,0,0,0,0,1.0,1,1.0,1,1.0,1,0.3818754082498211,52
1177,12,15314,15314,0,0,0,0,1.0,1,1.0,1,1.0,1,0.3520414338340712,52
1178,23,15337,15337,0,0,0,0,1.0,1,1.0,1,1.0,1,0.36336393654520954,52
1179,21,15358,15358,0,0,0,0,1.0,1,1.0,1,1.0,1,0.3215400079161354,53
1180,33,15391,15391,0,0,0,0,1.0,1,1.0,1,1.0,1,0.34451818073022744,54
1181,17,15408,15408,0,0,0,0,1.0,1,1.0,1,1.0,1,0.33106018747906263,55
1182,21,15429,15429,0,0,0,0,1.0,1,1.0,1,1.0,1,0.26308156683238504,55
1183,40,15469,15469,0,0,0,0,1.0,1,1.0,1,1.0,1,0.2998273523697246,53
1184,18,15487,15487,0,0,0,0,1.0,1,1.0,1,1.0,1,0.3271593245696407,54
1185,19,15506,15506,0,0,0,0,1.0,1,1.0,1,1.0,1,0.2731930255790607,53
1186,12,15518,15518,0,0,0,0,1.0,1,1.0,1,1.0,1,0.4116922222811445,54
1187,14,15532,15532,0,0,0,0,1.0,1,1.0,1,1.0,1,0.3767054295400694,55
1188,25,15557,15557,0,0,0,0,1.0,1,1.0,1,1.0,1,0.29583656282060883,55
1189,17,15574,15574,0,0,0,0,1.0,1,1.0,1,1.0,1,0.3058207235885063,54
1190,13,15587,15587,0,0,0,0,1.0,1,1.0,1,1.0,1,0.39628230322583874,55
1191,19,15606,15606,0,0,0,0,1.0,1,1.0,1,1.0,1,0.29646795696181744,54
1192,20,15626,15626,0,0,0,0,1.0,1,1.0,1,1.0,1,0.16756441244581066,52
1193,16,15642,15642,0,0,0,0,1.0,1,1.0,1,1.0,1,0.2842910003665692,53
1194,10,15652,15652,0,0,0,0,1.0,1,1.0,1,1.0,1,0.2817420189606473,53
1195,8,15660,15660,0,0,0,0,1.0,1,1.0,1,1.0,1,0.31495668320457404,54
1196,21,15681,15681,0,0,0,0,1.0,1,1.0,1,1.0,1,0.26399504031804627,56
1197,17,15698,15698,0,0,0,0,1.0,1,1.0,1,1.0,1,0.23933409815270584,56
1198,20,15718,15718,0,0,0,0,1.0,1,1.0,1,1.0,1,0.3961409411888913,58
1199,17,15735,15735,0,0,0,0,1.0,1,1.0,1,1.0,1,0.3962339043678228,58
1200,13,15748,15748,0,0,0,0,1.0,1,1.0,1,1.0,1,0.34600329583362843,58
1201,16,15764,15764,0,0,0,0,1.0,1,1.0,1,1.0,1,0.26551871225630835,58
1202,13,15777,15777,0,0,0,0,1.0,1,1.0,1,1.0,1,0.22816859785028387,60
1203,10,15787,15787,0,0,0,0,1.0,1,1.0,1,1.0,1,0.2612072552650605,58
1204,10,15797,15797,0,0,0,0,1.0,1,1.0,1,1.0,1,0.2482104714893178,59
1205,12,15809,15809,0,0,0,0,1.0,1,1.0,1,1.0,1,0.24029568752851194,59
1206,8,15817,15817,0,0,0,0,1.0,1,1.0,1,1.0,1,0.23637134878020843,58
1207,16,15833,15833,0,0,0,0,1.0,1,1.0,1,1.0,1,0.32373673474543735,60
1208,16,15849,15849,0,0,0,0,1.0,1,1.0,1,1.0,1,0.24073393009353353,60
1209,22,15871,15871,0,0,0,0,1.0,1,1.0,1,1.0,1,0.2949202138945885,61
1210,10,15881,15881,0,0,0,0,1.0,1,1.0,1,1.0,1,0.3203340946809536,61
1211,18,15899,15899,0,0,0,0,1.0,1,1.0,1,1.0,1,0.28539013927509355,63
1212,20,15919,15919,0,0,0,0,1.0,1,1.0,1,1.0,1,0.23327019847746058,63
1213,24,15943,15943,0,0,0,0,1.0,1,1.0,1,1.0,1,0.3316955615766022,63
1214,15,15958,15958,0,0,0,0,1.0,1,1.0,1,1.0,1,0.30282739212692794,62
1215,26,15984,15984,0,0,0,0,1.0,1,1.0,1,1.0,1,0.2717374088276166,63
1216,17,16001,16001,0,0,0,0,1.0,1,1.0,1,1.0,1,0.38105629033815486,64
1217,16,16017,16017,0,0,0,0,1.0,1,1.0,1,1.0,1,0.30453461360646683,65
1218,18,16035,16035,0,0,0,0,1.0,1,1.0,1,1.0,1,0.28546665519403197,64
1219,23,16058,16058,0,0,0,0,1.0,1,1.0,1,1.0,1,0.31210770390478454,65
1220,16,16074,16074,0,0,0,0,1.0,1,1.0,1,1.0,1,0.35376290555547396,64
1221,20,16094,16094,0,0,0,0,1.0,1,1.0,1,1.0,1,0.3626111692243623,65
1222,14,16108,16108,0,0,0,0,1.0,1,1.0,1,1.0,1,0.3404245357904073,66
1223,19,16127,16127,0,0,0,0,1.0,1,1.0,1,1.0,1,0.20885303880212533,64
1224,17,16144,16144,0,0,0,0,1.0,1,1.0,1,1.0,1,0.3546298754399896,66
1225,19,16163,16163,0,0,0,0,1.0,1,1.0,1,1.0,1,0.3219413866704984,66
1226,16,16179,16179,0,0,0,0,1.0,1,1.0,1,1.0,1,0.3941804535707471,68
1227,37,16216,16216,0,0,0,0,1.0,1,1.0,1,1.0,1,0.3558308761049827,64
1228,17,16233,16233,0,0,0,0,1.0,1,1.0,1,1.0,1,0.29388869544396845,62
1229,19,16252,16252,0,0,0,0,1.0,1,1.0,1,1.0,1,0.44355732082846844,61
1230,11,16263,16263,0,0,0,0,1.0,1,1.0,1,1.0,1,0.3200169037141279,58
1231,12,16275,16275,0,0,0,0,1.0,1,1.0,1,1.0,1,0.4366337263876571,57
1232,16,16291,16291,0,0,0,0,1.0,1,1.0,1,1.0,1,0.46219289334432156,53
1233,14,16305,16305,0,0,0,0,1.0,1,1.0,1,1.0,1,0.4048033115534457,53
1234,18,16323,16323,0,0,0,0,1.0,1,1.0,1,1.0,1,0.3916732635540221,54
1235,20,16343,16343,0,0,0,0,1.0,1,1.0,1,1.0,1,0.38911645374833614,55
1236,25,16368,16368,0,0,0,0,1.0,1,1.0,1,1.0,1,0.40497656845061786,55
1237,21,16389,16389,0,0,0,0,1.0,1,1.0,1,1.0,1,0.3830811359011453,55
1238,18,16407,16407,0,0,0,0,1.0,1,1.0,1,1.0,1,0.4668380521652748,54
1239,5,16412,16412,0,0,0,0,1.0,1,1.0,1,1.0,1,0.4171175242458818,55
1240,11,16423,16423,0,0,0,0,1.0,1,1.0,1,1.0,1,0.39515406655941504,55
1241,13,16436,16436,0,0,0,0,1.0,1,1.0,1,1.0,1,0.32410926987446864,54
1242,10,16446,16446,0,0,0,0,1.0,1,1.0,1,1.0,1,0.33245470216787454,54
1243,17,16463,16463,0,0,0,0,1.0,1,1.0,1,1.0,1,0.36192024329683253,55
1244,19,16482,16482,0,0,0,0,1.0,1,1.0,1,1.0,1,0.3505337328801348,55
1245,33,16515,16515,0,0,0,0,1.0,1,1.0,1,1.0,1,0.3369546586584176,55
1246,20,16535,16535,0,0,0,0,1.0,1,1.0,1,1.0,1,0.3563838593290023,55
1247,37,16572,16572,0,0,0,0,1.0,1,1.0,1,1.0,1,0.37334301249930263,57
1248,25,16597,16597,0,0,0,0,1.0,1,1.0,1,1.0,1,0.34857889973307093,56
1249,22,16619,16619,0,0,0,0,1.0,1,1.0,1,1.0,1,0.3526079955995508,56
1250,21,16640,16640,0,0,0,0,1.0,1,1.0,1,1.0,1,0.30351956205581787,56
1251,18,16658,16658,0,0,0,0,1.0,1,1.0,1,1.0,1,0.36345540065451304,58
1252,25,16683,16683,0,0,0,0,1.0,1,1.0,1,1.0,1,0.2639579482481628,58
1253,24,16707,16707,0,0,0,0,1.0,1,1.0,1,1.0,1,0.3972716847718088,58
1254,14,16721,16721,0,0,0,0,1.0,1,1.0,1,1.0,1,0.37582953756776344,60
1255,31,16752,16752,0,0,0,0,1.0,1,1.0,1,1.0,1,0.49204618462158556,61
1256,25,16777,16777,0,0,0,0,1.0,1,1.0,1,1.0,1,0.43471632762336465,61
1257,14,16791,16791,0,0,0,0,1.0,1,1.0,1,1.0,1,0.27885933683501696,62
1258,14,16805,16805,0,0,0,0,1.0,1,1.0,1,1.0,1,0.45511647014694273,63
1259,31,16836,16836,0,0,0,0,1.0,1,1.0,1,1.0,1,0.3028831785569809,63
1260,18,16854,16854,0,0,0,0,1.0,1,1.0,1,1.0,1,0.41782354051987963,63
1261,39,16893,16893,0,0,0,0,1.0,1,1.0,1,1.0,1,0.43038549829258277,63
1262,37,16930,16930,0,0,0,0,1.0,1,1.0,1,1.0,1,0.3856431535456206,64
1263,16,16946,16946,0,0,0,0,1.0,1,1.0,1,1.0,1,0.430580959267304,63
1264,23,16969,16969,0,0,0,0,1.0,1,1.0,1,1.0,1,0.3288660692749027,63
1265,24,16993,16993,0,0,0,0,1.0,1,1.0,1,1.0,1,0.5156404439211655,60
1266,25,17018,17018,0,0,0,0,1.0,1,1.0,1,1.0,1,0.2717300767777683,61
1267,22,17040,17040,0,0,0,0,1.0,1,1.0,1,1.0,1,0.4286960266640322,58
1268,17,17057,17057,0,0,0,0,1.0,1,1.0,1,1.0,1,0.33319849009007363,54
1269,16,17073,17073,0,0,0,0,1.0,1,1.0,1,1.0,1,0.3791667824002773,54
1270,16,17089,17089,0,0,0,0,1.0,1,1.0,1,1.0,1,0.2745478276335937,51
1271,13,17102,17102,0,0,0,0,1.0,1,1.0,1,1.0,1,0.3355327547804116,50
1272,6,17108,17108,0,0,0,0,1.0,1,1.0,1,1.0,1,0.4178387197632592,47
1273,7,17115,17115,0,0,0,0,1.0,1,1.0,1,1.0,1,0.346313199201295,47
1274,30,17145,17145,0,0,0,0,1.0,1,1.0,1,1.0,1,0.2865430030189093,49
1275,16,17161,17161,0,0,0,0,1.0,1,1.0,1,1.0,1,0.2463891949595421,48
1276,20,17181,17181,0,0,0,0,1.0,1,1.0,1,1.0,1,0.30171739314962465,49
1277,15,17196,17196,0,0,0,0,1.0,1,1.0,1,1.0,1,0.32117969139335606,50
1278,18,17214,17214,0,0,0,0,1.0,1,1.0,1,1.0,1,0.341574624154175,51
1279,22,17236,17236,0,0,0,0,1.0,1,1.0,1,1.0,1,0.28048240934342417,51
1280,15,17251,17251,0,0,0,0,1.0,1,1.0,1,1.0,1,0.2675715460006325,52
1281,12,17263,17263,0,0,0,0,1.0,1,1.0,1,1.0,1,0.2781189158985223,52
1282,13,17276,17276,0,0,0,0,1.0,1,1.0,1,1.0,1,0.22366567482379257,52
1283,17,17293,17293,0,0,0,0,1.0,1,1.0,1,1.0,1,0.36880355875849613,52
1284,20,17313,17313,0,0,0,0,1.0,1,1.0,1,1.0,1,0.3459214888246627,52
1285,24,17337,17337,0,0,0,0,1.0,1,1.0,1,1.0,1,0.41461504305080593,51
1286,23,17360,17360,0,0,0,0,1.0,1,1.0,1,1.0,1,0.45494032015429803,52
1287,23,17383,17383,0,0,0,0,1.0,1,1.0,1,1.0,1,0.43425483031228523,54
1288,15,17398,17398,0,0,0,0,1.0,1,1.0,1,1.0,1,0.2233299769366698,55
1289,14,17412,17412,0,0,0,0,1.0,1,1.0,1,1.0,1,0.3682660776115829,56
1290,14,17426,17426,0,0,0,0,1.0,1,1.0,1,1.0,1,0.3733236039370779,57
1291,26,17452,17452,0,0,0,0,1.0,1,1.0,1,1.0,1,0.30657429671409053,58
1292,18,17470,17470,0,0,0,0,1.0,1,1.0,1,1.0,1,0.33547633046873826,59
1293,19,17489,17489,0,0,0,0,1.0,1,1.0,1,1.0,1,0.3106074203612892,59
1294,20,17509,17509,0,0,0,0,1.0,1,1.0,1,1.0,1,0.29213718718597487,59
1295,14,17523,17523,0,0,0,0,1.0,1,1.0,1,1.0,1,0.2110296058810885,59
1296,14,17537,17537,0,0,0,0,1.0,1,1.0,1,1.0,1,0.2796919159184075,59
1297,10,17547,17547,0,0,0,0,1.0,1,1.0,1,1.0,1,0.23764551476284063,61
1298,9,17556,17556,0,0,0,0,1.0,1,1.0,1,1.0,1,0.2731974671585305,61
1299,14,17570,17570,0,0,0,0,1.0,1,1.0,1,1.0,1,0.21059821368789253,60
1300,11,17581,17581,0,0,0,0,1.0,1,1.0,1,1.0,1,0.23493886453486215,59
1301,8,17589,17589,0,0,0,0,1.0,1,1.0,1,1.0,1,0.21267259969705396,59
1302,10,17599,17599,0,0,0,0,1.0,1,1.0,1,1.0,1,0.2819928992127669,59
1303,19,17618,17618,0,0,0,0,1.0,1,1.0,1,1.0,1,0.30128188922341115,55
1304,21,17639,17639,0,0,0,0,1.0,1,1.0,1,1.0,1,0.2324922130612023,56
1305,12,17651,17651,0,0,0,0,1.0,1,1.0,1,1.0,1,0.26091508350154735,54
1306,12,17663,17663,0,0,0,0,1.0,1,1.0,1,1.0,1,0.3213503164614494,53
1307,13,17676,17676,0,0,0,0,1.0,1,1.0,1,1.0,1,0.362980053698431,52
1308,20,17696,17696,0,0,0,0,1.0,1,1.0,1,1.0,1,0.268204476660643,52
1309,19,17715,17715,0,0,0,0,1.0,1,1.0,1,1.0,1,0.2574909405448025,54
1310,15,17730,17730,0,0,0,0,1.0,1,1.0,1,1.0,1,0.2710680076906721,52
1311,16,17746,17746,0,0,0,0,1.0,1,1.0,1,1.0,1,0.21663209311064283,51
1312,12,17758,17758,0,0,0,0,1.0,1,1.0,1,1.0,1,0.3118770248879387,49
1313,12,17770,17770,0,0,0,0,1.0,1,1.0,1,1.0,1,0.40072228841771024,47
1314,20,17790,17790,0,0,0,0,1.0,1,1.0,1,1.0,1,0.4556291992094905,46
1315,20,17810,17810,0,0,0,0,1.0,1,1.0,1,1.0,1,0.39919081077846896,45
1316,23,17833,17833,0,0,0,0,1.0,1,1.0,1,1.0,1,0.36415722229833386,46
1317,21,17854,17854,0,0,0,0,1.0,1,1.0,1,1.0,1,0.40986824145454187,45
1318,22,17876,17876,0,0,0,0,1.0,1,1.0,1,1.0,1,0.38910013693429757,46
1319,20,17896,17896,0,0,0,0,1.0,1,1.0,1,1.0,1,0.38502217816487827,46
1320,11,17907,17907,0,0,0,0,1.0,1,1.0,1,1.0,1,0.27913838483392917,46
1321,17,17924,17924,0,0,0,0,1.0,1,1.0,1,1.0,1,0.2737307919310175,48
1322,15,17939,17939,0,0,0,0,1.0,1,1.0,1,1.0,1,0.3064415374283488,49
1323,14,17953,17953,0,0,0,0,1.0,1,1.0,1,1.0,1,0.18008670483532502,49
1324,20,17973,17973,0,0,0,0,1.0,1,1.0,1,1.0,1,0.3437630589459589,50
1325,14,17987,17987,0,0,0,0,1.0,1,1.0,1,1.0,1,0.2882105257563611,49
1326,13,18000,18000,0,0,0,0,1.0,1,1.0,1,1.0,1,0.22809994010395823,50
1327,22,18022,18022,0,0,0,0,1.0,1,1.0,1,1.0,1,0.2703785273222807,50
1328,21,18043,18043,0,0,0,0,1.0,1,1.0,1,1.0,1,0.3051081502035585,49
1329,20,18063,18063,0,0,0,0,1.0,1,1.0,1,1.0,1,0.296558005072207,50
1330,16,18079,18079,0,0,0,0,1.0,1,1.0,1,1.0,1,0.18708436884655255,50
1331,17,18096,18096,0,0,0,0,1.0,1,1.0,1,1.0,1,0.3351092539788861,50
1332,16,18112,18112,0,0,0,0,1.0,1,1.0,1,1.0,1,0.25131044847704326,51
1333,17,18129,18129,0,0,0,0,1.0,1,1.0,1,1.0,1,0.24135450707509956,52
1334,17,18146,18146,0,0,0,0,1.0,1,1.0,1,1.0,1,0.2898099544267406,54
1335,24,18170,18170,0,0,0,0,1.0,1,1.0,1,1.0,1,0.28111062299276507,54
1336,28,18198,18198,0,0,0,0,1.0,1,1.0,1,1.0,1,0.3294350014787705,56
1337,18,18216,18216,0,0,0,0,1.0,1,1.0,1,1.0,1,0.28377594010169077,57
1338,9,18225,18225,0,0,0,0,1.0,1,1.0,1,1.0,1,0.32697831229043284,57
1339,16,18241,18241,0,0,0,0,1.0,1,1.0,1,1.0,1,0.2967792316380608,58
1340,17,18258,18258,0,0,0,0,1.0,1,1.0,1,1.0,1,0.35194552404621665,59
1341,12,18270,18270,0,0,0,0,1.0,1,1.0,1,1.0,1,0.36192445820427327,57
1342,11,18281,18281,0,0,0,0,1.0,1,1.0,1,1.0,1,0.29323004019635374,57
1343,11,18292,18292,0,0,0,0,1.0,1,1.0,1,1.0,1,0.36988335846147347,55
1344,8,18300,18300,0,0,0,0,1.0,1,1.0,1,1.0,1,0.3505390236145764,54
1345,19,18319,18319,0,0,0,0,1.0,1,1.0,1,1.0,1,0.3351900866607333,53
1346,17,18336,18336,0,0,0,0,1.0,1,1.0,1,1.0,1,0.4156815920636059,53
1347,20,18356,18356,0,0,0,0,1.0,1,1.0,1,1.0,1,0.27044007619563426,51
1348,19,18375,18375,0,0,0,0,1.0,1,1.0,1,1.0,1,0.2840775849221477,52
1349,15,18390,18390,0,0,0,0,1.0,1,1.0,1,1.0,1,0.4007759546885319,50
1350,10,18400,18400,0,0,0,0,1.0,1,1.0,1,1.0,1,0.34718501528836904,51
1351,13,18413,18413,0,0,0,0,1.0,1,1.0,1,1.0,1,0.3407107607956669,50
1352,25,18438,18438,0,0,0,0,1.0,1,1.0,1,1.0,1,0.4371822650005755,50
1353,30,18468,18468,0,0,0,0,1.0,1,1.0,1,1.0,1,0.35776893658834497,50
1354,29,18497,18497,0,0,0,0,1.0,1,1.0,1,1.0,1,0.41737530260541056,51
1355,29,18526,18526,0,0,0,0,1.0,1,1.0,1,1.0,1,0.36820115597920944,53
1356,32,18558,18558,0,0,0,0,1.0,1,1.0,1,1.0,1,0.36547576463747,52
1357,19,18577,18577,0,0,0,0,1.0,1,1.0,1,1.0,1,0.15944312942949715,52
1358,19,18596,18596,0,0,0,0,1.0,1,1.0,1,1.0,1,0.33652732909796274,53
1359,29,18625,18625,0,0,0,0,1.0,1,1.0,1,1.0,1,0.4239384775578643,54
1360,17,18642,18642,0,0,0,0,1.0,1,1.0,1,1.0,1,0.24062764446885415,55
1361,21,18663,18663,0,0,0,0,1.0,1,1.0,1,1.0,1,0.35002706010143847,55
1362,23,18686,18686,0,0,0,0,1.0,1,1.0,1,1.0,1,0.35697776689362604,56
1363,14,18700,18700,0,0,0,0,1.0,1,1.0,1,1.0,1,0.2277233980289153,56
1364,14,18714,18714,0,0,0,0,1.0,1,1.0,1,1.0,1,0.3793423543148361,55
1365,20,18734,18734,0,0,0,0,1.0,1,1.0,1,1.0,1,0.3825728203097461,56
1366,17,18751,18751,0,0,0,0,1.0,1,1.0,1,1.0,1,0.23998491615310552,57
1367,20,18771,18771,0,0,0,0,1.0,1,1.0,1,1.0,1,0.43026155579205233,57
1368,20,18791,18791,0,0,0,0,1.0,1,1.0,1,1.0,1,0.36947095204550934,58
1369,28,18819,18819,0,0,0,0,1.0,1,1.0,1,1.0,1,0.4501215415390381,59
1370,24,18843,18843,0,0,0,0,1.0,1,1.0,1,1.0,1,0.3206161345812116,60
1371,32,18875,18875,0,0,0,0,1.0,1,1.0,1,1.0,1,0.3582161966927754,59
1372,19,18894,18894,0,0,0,0,1.0,1,1.0,1,1.0,1,0.3828172851530069,59
1373,19,18913,18913,0,0,0,0,1.0,1,1.0,1,1.0,1,0.3581496002346426,59
1374,27,18940,18940,0,0,0,0,1.0,1,1.0,1,1.0,1,0.4320871691543697,59
1375,13,18953,18953,0,0,0,0,1.0,1,1.0,1,1.0,1,0.3999823436642598,62
1376,10,18963,18963,0,0,0,0,1.0,1,1.0,1,1.0,1,0.43719640235963114,61
1377,11,18974,18974,0,0,0,0,1.0,1,1.0,1,1.0,1,0.3688335236983108,63
1378,13,18987,18987,0,0,0,0,1.0,1,1.0,1,1.0,1,0.32291016369136877,62
1379,14,19001,19001,0,0,0,0,1.0,1,1.0,1,1.0,1,0.4076715120293089,61
1380,21,19022,19022,0,0,0,0,1.0,1,1.0,1,1.0,1,0.4114664430010092,60
1381,16,19038,19038,0,0,0,0,1.0,1,1.0,1,1.0,1,0.30696928975140036,58
1382,18,19056,19056,0,0,0,0,1.0,1,1.0,1,1.0,1,0.3552968958980717,56
1383,29,19085,19085,0,0,0,0,1.0,1,1.0,1,1.0,1,0.41551640415619817,57
1384,21,19106,19106,0,0,0,0,1.0,1,1.0,1,1.0,1,0.28530309179141167,55
1385,20,19126,19126,0,0,0,0,1.0,1,1.0,1,1.0,1,0.41769991893809766,55
1386,19,19145,19145,0,0,0,0,1.0,1,1.0,1,1.0,1,0.4231254969278699,54
1387,16,19161,19161,0,0,0,0,1.0,1,1.0,1,1.0,1,0.39360961084780005,53
1388,27,19188,19188,0,0,0,0,1.0,1,1.0,1,1.0,1,0.32541882600182226,52
1389,19,19207,19207,0,0,0,0,1.0,1,1.0,1,1.0,1,0.45737825608435917,52
1390,20,19227,19227,0,0,0,0,1.0,1,1.0,1,1.0,1,0.3370277676852059,51
1391,21,19248,19248,0,0,0,0,1.0,1,1.0,1,1.0,1,0.4061841879830595,52
1392,13,19261,19261,0,0,0,0,1.0,1,1.0,1,1.0,1,0.4319588744803566,51
1393,11,19272,19272,0,0,0,0,1.0,1,1.0,1,1.0,1,0.4919211227350432,51
1394,25,19297,19297,0,0,0,0,1.0,1,1.0,1,1.0,1,0.4620282766591621,52
1395,16,19313,19313,0,0,0,0,1.0,1,1.0,1,1.0,1,0.2797654180053805,52
1396,22,19335,19335,0,0,0,0,1.0,1,1.0,1,1.0,1,0.4004083433311401,53
1397,30,19365,19365,0,0,0,0,1.0,1,1.0,1,1.0,1,0.3914543878023883,56
1398,21,19386,19386,0,0,0,0,1.0,1,1.0,1,1.0,1,0.4149745567846838,56
1399,23,19409,19409,0,0,0,0,1.0,1,1.0,1,1.0,1,0.3686894265124225,57
1400,41,19450,19450,0,0,0,0,1.0,1,1.0,1,1.0,1,0.4238216501038162,57
1401,18,19468,19468,0,0,0,0,1.0,1,1.0,1,1.0,1,0.31731792413480686,57
1402,21,19489,19489,0,0,0,0,1.0,1,1.0,1,1.0,1,0.43650496858002297,57
1403,31,19520,19520,0,0,0,0,1.0,1,1.0,1,1.0,1,0.42534677782333924,56
1404,20,19540,19540,0,0,0,0,1.0,1,1.0,1,1.0,1,0.48493871341618555,58
1405,16,19556,19556,0,0,0,0,1.0,1,1.0,1,1.0,1,0.49505858756374244,58
1406,23,19579,19579,0,0,0,0,1.0,1,1.0,1,1.0,1,0.46698111480741594,58
1407,11,19590,19590,0,0,0,0,1.0,1,1.0,1,1.0,1,0.44236695342058374,57
1408,20,19610,19610,0,0,0,0,1.0,1,1.0,1,1.0,1,0.30008443284253017,58
1409,15,19625,19625,0,0,0,0,1.0,1,1.0,1,1.0,1,0.4612972726480443,57
1410,17,19642,19642,0,0,0,0,1.0,1,1.0,1,1.0,1,0.4741835670850515,57
1411,19,19661,19661,0,0,0,0,1.0,1,1.0,1,1.0,1,0.3111601216235625,56
1412,10,19671,19671,0,0,0,0,1.0,1,1.0,1,1.0,1,0.5118514509586058,55
1413,12,19683,19683,0,0,0,0,1.0,1,1.0,1,1.0,1,0.4840801689941165,57
1414,10,19693,19693,0,0,0,0,1.0,1,1.0,1,1.0,1,0.48841747078234804,57
1415,20,19713,19713,0,0,0,0,1.0,1,1.0,1,1.0,1,0.3677377470744805,60
1416,20,19733,19733,0,0,0,0,1.0,1,1.0,1,1.0,1,0.407633390297351,61
1417,18,19751,19751,0,0,0,0,1.0,1,1.0,1,1.0,1,0.3629301407393997,59
1418,23,19774,19774,0,0,0,0,1.0,1,1.0,1,1.0,1,0.26530345841893915,60
1419,18,19792,19792,0,0,0,0,1.0,1,1.0,1,1.0,1,0.36996946360546845,59
1420,17,19809,19809,0,0,0,0,1.0,1,1.0,1,1.0,1,0.3529209179880574,58
1421,14,19823,19823,0,0,0,0,1.0,1,1.0,1,1.0,1,0.35973704393520006,57
1422,9,19832,19832,0,0,0,0,1.0,1,1.0,1,1.0,1,0.3084954792338169,57
1423,7,19839,19839,0,0,0,0,1.0,1,1.0,1,1.0,1,0.3745282897271448,56
1424,9,19848,19848,0,0,0,0,1.0,1,1.0,1,1.0,1,0.34251419842989655,57
1425,13,19861,19861,0,0,0,0,1.0,1,1.0,1,1.0,1,0.29256426944026476,54
1426,7,19868,19868,0,0,0,0,1.0,1,1.0,1,1.0,1,0.31588024158023204,54
1427,11,19879,19879,0,0,0,0,1.0,1,1.0,1,1.0,1,0.44278303938311037,53
1428,7,19886,19886,0,0,0,0,1.0,1,1.0,1,1.0,1,0.39959342551204374,52
1429,12,19898,19898,0,0,0,0,1.0,1,1.0,1,1.0,1,0.43419949554189413,52
1430,18,19916,19916,0,0,0,0,1.0,1,1.0,1,1.0,1,0.30360536173575015,51
1431,18,19934,19934,0,0,0,0,1.0,1,1.0,1,1.0,1,0.3743495817240886,51
1432,11,19945,19945,0,0,0,0,1.0,1,1.0,1,1.0,1,0.36587614882001773,52
1433,15,19960,19960,0,0,0,0,1.0,1,1.0,1,1.0,1,0.4376729321876658,52
1434,17,19977,19977,0,0,0,0,1.0,1,1.0,1,1.0,1,0.4113710564991804,52
1435,13,19990,19990,0,0,0,0,1.0,1,1.0,1,1.0,1,0.4064190159748209,50
1436,10,20000,20000,0,0,0,0,1.0,1,1.0,1,1.0,1,0.37248417093289443,50
1437,16,20016,20016,0,0,0,0,1.0,1,1.0,1,1.0,1,0.37706537285541963,49
1438,19,20035,20035,0,0,0,0,1.0,1,1.0,1,1.0,1,0.41667446379352413,49
1439,17,20052,20052,0,0,0,0,1.0,1,1.0,1,1.0,1,0.37039814421380585,50
1440,12,20064,20064,0,0,0,0,1.0,1,1.0,1,1.0,1,0.4452433046299468,50
1441,16,20080,20080,0,0,0,0,1.0,1,1.0,1,1.0,1,0.45919569474776745,51
1442,7,20087,20087,0,0,0,0,1.0,1,1.0,1,1.0,1,0.4496721088902773,50
1443,9,20096,20096,0,0,0,0,1.0,1,1.0,1,1.0,1,0.437274311675771,51
1444,12,20108,20108,0,0,0,0,1.0,1,1.0,1,1.0,1,0.5151868711720603,51
1445,12,20120,20120,0,0,0,0,1.0,1,1.0,1,1.0,1,0.40263159466627774,51
1446,11,20131,20131,0,0,0,0,1.0,1,1.0,1,1.0,1,0.44858074827794664,51
1447,13,20144,20144,0,0,0,0,1.0,1,1.0,1,1.0,1,0.4295457488690557,51
1448,16,20160,20160,0,0,0,0,1.0,1,1.0,1,1.0,1,0.4479456083936048,51
1449,14,20174,20174,0,0,0,0,1.0,1,1.0,1,1.0,1,0.47080286673140925,51
1450,12,20186,20186,0,0,0,0,1.0,1,1.0,1,1.0,1,0.3706694331579498,52
1451,12,20198,20198,0,0,0,0,1.0,1,1.0,1,1.0,1,0.4660215784194117,54
1452,12,20210,20210,0,0,0,0,1.0,1,1.0,1,1.0,1,0.45611041277865316,56
1453,19,20229,20229,0,0,0,0,1.0,1,1.0,1,1.0,1,0.44614277331741775,56
1454,30,20259,20259,0,0,0,0,1.0,1,1.0,1,1.0,1,0.3916635395662565,58
1455,26,20285,20285,0,0,0,0,1.0,1,1.0,1,1.0,1,0.5133883882267327,55
1456,36,20321,20321,0,0,0,0,1.0,1,1.0,1,1.0,1,0.3372302919665289,56
1457,31,20352,20352,0,0,0,0,1.0,1,1.0,1,1.0,1,0.44413771246986194,54
1458,16,20368,20368,0,0,0,0,1.0,1,1.0,1,1.0,1,0.29676226110752396,52
1459,24,20392,20392,0,0,0,0,1.0,1,1.0,1,1.0,1,0.5656651391390225,52
1460,41,20433,20433,0,0,0,0,1.0,1,1.0,1,1.0,1,0.5768076472817967,50
1461,36,20469,20469,0,0,0,0,1.0,1,1.0,1,1.0,1,0.5947381517545328,53
1462,14,20483,20483,0,0,0,0,1.0,1,1.0,1,1.0,1,0.4832492138433882,51
1463,17,20500,20500,0,0,0,0,1.0,1,1.0,1,1.0,1,0.31117304810854823,51
1464,22,20522,20522,0,0,0,0,1.0,1,1.0,1,1.0,1,0.5660396403555322,51
1465,18,20540,20540,0,0,0,0,1.0,1,1.0,1,1.0,1,0.4429676366502258,49
1466,18,20558,20558,0,0,0,0,1.0,1,1.0,1,1.0,1,0.46787598428198146,49
1467,14,20572,20572,0,0,0,0,1.0,1,1.0,1,1.0,1,0.35500407098501197,47
1468,17,20589,20589,0,0,0,0,1.0,1,1.0,1,1.0,1,0.4717664835448158,48
1469,10,20599,20599,0,0,0,0,1.0,1,1.0,1,1.0,1,0.38411982526233374,47
1470,9,20608,20608,0,0,0,0,1.0,1,1.0,1,1.0,1,0.38555939391338384,49
1471,9,20617,20617,0,0,0,0,1.0,1,1.0,1,1.0,1,0.4645060523106705,48
1472,6,20623,20623,0,0,0,0,1.0,1,1.0,1,1.0,1,0.4429518054907118,48
1473,7,20630,20630,0,0,0,0,1.0,1,1.0,1,1.0,1,0.43814858456612593,49
1474,8,20638,20638,0,0,0,0,1.0,1,1.0,1,1.0,1,0.4363620350391641,49
1475,9,20647,20647,0,0,0,0,1.0,1,1.0,1,1.0,1,0.4674597111317626,49
1476,7,20654,20654,0,0,0,0,1.0,1,1.0,1,1.0,1,0.41255513741857336,51
1477,7,20661,20661,0,0,0,0,1.0,1,1.0,1,1.0,1,0.4577281751588755,51
1478,15,20676,20676,0,0,0,0,1.0,1,1.0,1,1.0,1,0.3941259159363545,52
1479,14,20690,20690,0,0,0,0,1.0,1,1.0,1,1.0,1,0.30526932771293874,53
1480,13,20703,20703,0,0,0,0,1.0,1,1.0,1,1.0,1,0.3660808549249505,53
1481,10,20713,20713,0,0,0,0,1.0,1,1.0,1,1.0,1,0.3230619493076818,53
1482,13,20726,20726,0,0,0,0,1.0,1,1.0,1,1.0,1,0.3777159513904891,52
1483,11,20737,20737,0,0,0,0,1.0,1,1.0,1,1.0,1,0.3349548959446679,52
1484,15,20752,20752,0,0,0,0,1.0,1,1.0,1,1.0,1,0.291502193339929,53
1485,19,20771,20771,0,0,0,0,1.0,1,1.0,1,1.0,1,0.2877477677898558,53
1486,26,20797,20797,0,0,0,0,1.0,1,1.0,1,1.0,1,0.3768122465131185,54
1487,24,20821,20821,0,0,0,0,1.0,1,1.0,1,1.0,1,0.34821112858043923,55
1488,29,20850,20850,0,0,0,0,1.0,1,1.0,1,1.0,1,0.328415856288794,57
1489,28,20878,20878,0,0,0,0,1.0,1,1.0,1,1.0,1,0.3990571917621149,58
1490,26,20904,20904,0,0,0,0,1.0,1,1.0,1,1.0,1,0.39068411238707473,58
1491,12,20916,20916,0,0,0,0,1.0,1,1.0,1,1.0,1,0.42300620342550554,59
1492,21,20937,20937,0,0,0,0,1.0,1,1.0,1,1.0,1,0.3207050654020058,59
1493,17,20954,20954,0,0,0,0,1.0,1,1.0,1,1.0,1,0.3790104144568784,58
1494,15,20969,20969,0,0,0,0,1.0,1,1.0,1,1.0,1,0.37809203244134443,58
1495,7,20976,20976,0,0,0,0,1.0,1,1.0,1,1.0,1,0.32572508833478875,57
1496,13,20989,20989,0,0,0,0,1.0,1,1.0,1,1.0,1,0.4138493753588422,59
1497,8,20997,20997,0,0,0,0,1.0,1,1.0,1,1.0,1,0.3707914890400151,58
1498,9,21006,21006,0,0,0,0,1.0,1,1.0,1,1.0,1,0.2785966779061233,58
1499,16,21022,21022,0,0,0,0,1.0,1,1.0,1,1.0,1,0.29052405070380966,56
1500,8,21030,21030,0,0,0,0,1.0,1,1.0,1,1.0,1,0.33026459201406316,57
1501,10,21040,21040,0,0,0,0,1.0,1,1.0,1,1.0,1,0.4110343330616786,55
1502,8,21048,21048,0,0,0,0,1.0,1,1.0,1,1.0,1,0.35347159740313944,55
1503,12,21060,21060,0,0,0,0,1.0,1,1.0,1,1.0,1,0.4490654281527435,54
1504,12,21072,21072,0,0,0,0,1.0,1,1.0,1,1.0,1,0.34097198813971824,55
1505,13,21085,21085,0,0,0,0,1.0,1,1.0,1,1.0,1,0.39289428863548287,53
1506,15,21100,21100,0,0,0,0,1.0,1,1.0,1,1.0,1,0.2964868680175553,55
1507,14,21114,21114,0,0,0,0,1.0,1,1.0,1,1.0,1,0.43069039334155707,53
1508,7,21121,21121,0,0,0,0,1.0,1,1.0,1,1.0,1,0.4186637951012858,53
1509,20,21141,21141,0,0,0,0,1.0,1,1.0,1,1.0,1,0.4031174238653829,52
1510,12,21153,21153,0,0,0,0,1.0,1,1.0,1,1.0,1,0.34063179707640484,50
1511,10,21163,21163,0,0,0,0,1.0,1,1.0,1,1.0,1,0.43102160852482785,49
1512,12,21175,21175,0,0,0,0,1.0,1,1.0,1,1.0,1,0.47761069646207194,48
1513,8,21183,21183,0,0,0,0,1.0,1,1.0,1,1.0,1,0.4781139734264653,47
1514,10,21193,21193,0,0,0,0,1.0,1,1.0,1,1.0,1,0.3830425792717725,48
1515,19,21212,21212,0,0,0,0,1.0,1,1.0,1,1.0,1,0.3308308390274836,48
1516,14,21226,21226,0,0,0,0,1.0,1,1.0,1,1.0,1,0.4374937263954269,47
1517,23,21249,21249,0,0,0,0,1.0,1,1.0,1,1.0,1,0.3927502604531283,48
1518,19,21268,21268,0,0,0,0,1.0,1,1.0,1,1.0,1,0.4090794266684458,48
1519,9,21277,21277,0,0,0,0,1.0,1,1.0,1,1.0,1,0.42581826666993117,47
1520,19,21296,21296,0,0,0,0,1.0,1,1.0,1,1.0,1,0.3750146536846398,48
1521,15,21311,21311,0,0,0,0,1.0,1,1.0,1,1.0,1,0.2895757389429985,49
1522,16,21327,21327,0,0,0,0,1.0,1,1.0,1,1.0,1,0.35567875523453,48
1523,11,21338,21338,0,0,0,0,1.0,1,1.0,1,1.0,1,0.23577564519821856,49
1524,15,21353,21353,0,0,0,0,1.0,1,1.0,1,1.0,1,0.2891496741865001,49
1525,8,21361,21361,0,0,0,0,1.0,1,1.0,1,1.0,1,0.337308968059289,51
1526,8,21369,21369,0,0,0,0,1.0,1,1.0,1,1.0,1,0.2787261946458733,52
1527,15,21384,21384,0,0,0,0,1.0,1,1.0,1,1.0,1,0.32161894712431893,54
1528,15,21399,21399,0,0,0,0,1.0,1,1.0,1,1.0,1,0.33791378989203275,54
1529,8,21407,21407,0,0,0,0,1.0,1,1.0,1,1.0,1,0.30626889776949545,54
1530,9,21416,21416,0,0,0,0,1.0,1,1.0,1,1.0,1,0.4329408568981865,54
1531,9,21425,21425,0,0,0,0,1.0,1,1.0,1,1.0,1,0.42672446710295325,54
1532,7,21432,21432,0,0,0,0,1.0,1,1.0,1,1.0,1,0.3585733725942671,54
1533,13,21445,21445,0,0,0,0,1.0,1,1.0,1,1.0,1,0.3560023418655611,54
1534,8,21453,21453,0,0,0,0,1.0,1,1.0,1,1.0,1,0.43680411484237147,54
1535,5,21458,21458,0,0,0,0,1.0,1,1.0,1,1.0,1,0.4029699623649605,54
1536,10,21468,21468,0,0,0,0,1.0,1,1.0,1,1.0,1,0.3729232118412769,55
1537,3,21471,21471,0,0,0,0,1.0,1,1.0,1,1.0,1,0.42512946368233845,53
1538,7,21478,21478,0,0,0,0,1.0,1,1.0,1,1.0,1,0.4108379247259511,54
1539,9,21487,21487,0,0,0,0,1.0,1,1.0,1,1.0,1,0.4172450338960915,54
1540,12,21499,21499,0,0,0,0,1.0,1,1.0,1,1.0,1,0.38520404454445645,54
1541,6,21505,21505,0,0,0,0,1.0,1,1.0,1,1.0,1,0.351962085449506,54
1542,15,21520,21520,0,0,0,0,1.0,1,1.0,1,1.0,1,0.22429082917984525,57
1543,11,21531,21531,0,0,0,0,1.0,1,1.0,1,1.0,1,0.24933563253122587,55
1544,14,21545,21545,0,0,0,0,1.0,1,1.0,1,1.0,1,0.28265848806084226,54
1545,16,21561,21561,0,0,0,0,1.0,1,1.0,1,1.0,1,0.24146702448648366,54
1546,14,21575,21575,0,0,0,0,1.0,1,1.0,1,1.0,1,0.28113089935308366,53
1547,21,21596,21596,0,0,0,0,1.0,1,1.0,1,1.0,1,0.3001185423777284,53
1548,18,21614,21614,0,0,0,0,1.0,1,1.0,1,1.0,1,0.24792445155912857,54
1549,16,21630,21630,0,0,0,0,1.0,1,1.0,1,1.0,1,0.19852748048242272,52
1550,24,21654,21654,0,0,0,0,1.0,1,1.0,1,1.0,1,0.22550931772054347,52
1551,18,21672,21672,0,0,0,0,1.0,1,1.0,1,1.0,1,0.18443642871607155,52
1552,22,21694,21694,0,0,0,0,1.0,1,1.0,1,1.0,1,0.33805976217871553,51
1553,14,21708,21708,0,0,0,0,1.0,1,1.0,1,1.0,1,0.15877693606210977,51
1554,18,21726,21726,0,0,0,0,1.0,1,1.0,1,1.0,1,0.2933136912538281,51
1555,16,21742,21742,0,0,0,0,1.0,1,1.0,1,1.0,1,0.22201788448051843,50
1556,29,21771,21771,0,0,0,0,1.0,1,1.0,1,1.0,1,0.2628388926126621,51
1557,17,21788,21788,0,0,0,0,1.0,1,1.0,1,1.0,1,0.28420973356470486,51
1558,24,21812,21812,0,0,0,0,1.0,1,1.0,1,1.0,1,0.23080809129132895,52
1559,12,21824,21824,0,0,0,0,1.0,1,1.0,1,1.0,1,0.2411319212502512,53
1560,18,21842,21842,0,0,0,0,1.0,1,1.0,1,1.0,1,0.23421246108870397,51
1561,16,21858,21858,0,0,0,0,1.0,1,1.0,1,1.0,1,0.24372430843851242,51
1562,11,21869,21869,0,0,0,0,1.0,1,1.0,1,1.0,1,0.19269802834774657,52
1563,11,21880,21880,0,0,0,0,1.0,1,1.0,1,1.0,1,0.21228160125645965,52
1564,9,21889,21889,0,0,0,0,1.0,1,1.0,1,1.0,1,0.26375278508824734,51
1565,9,21898,21898,0,0,0,0,1.0,1,1.0,1,1.0,1,0.2815975530052109,53
1566,7,21905,21905,0,0,0,0,1.0,1,1.0,1,1.0,1,0.3346102567903823,53
1567,6,21911,21911,0,0,0,0,1.0,1,1.0,1,1.0,1,0.34112659059202494,52
1568,10,21921,21921,0,0,0,0,1.0,1,1.0,1,1.0,1,0.25009193663220247,52
1569,13,21934,21934,0,0,0,0,1.0,1,1.0,1,1.0,1,0.3589602087921605,49
1570,15,21949,21949,0,0,0,0,1.0,1,1.0,1,1.0,1,0.3009101968056872,48
1571,15,21964,21964,0,0,0,0,1.0,1,1.0,1,1.0,1,0.30857872490715216,46
1572,20,21984,21984,0,0,0,0,1.0,1,1.0,1,1.0,1,0.29552035020959827,47
1573,19,22003,22003,0,0,0,0,1.0,1,1.0,1,1.0,1,0.32586071365312363,48
1574,11,22014,22014,0,0,0,0,1.0,1,1.0,1,1.0,1,0.291842035889249,46
1575,17,22031,22031,0,0,0,0,1.0,1,1.0,1,1.0,1,0.34541251331772177,47
1576,9,22040,22040,0,0,0,0,1.0,1,1.0,1,1.0,1,0.46321178467700475,46
1577,10,22050,22050,0,0,0,0,1.0,1,1.0,1,1.0,1,0.48852642553611453,45
1578,7,22057,22057,0,0,0,0,1.0,1,1.0,1,1.0,1,0.48941287602984285,44
1579,3,22060,22060,0,0,0,0,1.0,1,1.0,1,1.0,1,0.4591951045208607,43
1580,15,22075,22075,0,0,0,0,1.0,1,1.0,1,1.0,1,0.45640844765683536,43
1581,9,22084,22084,0,0,0,0,1.0,1,1.0,1,1.0,1,0.4365627958005233,42
1582,7,22091,22091,0,0,0,0,1.0,1,1.0,1,1.0,1,0.4135819734924052,42
1583,22,22113,22113,0,0,0,0,1.0,1,1.0,1,1.0,1,0.40575448970399536,43
1584,13,22126,22126,0,0,0,0,1.0,1,1.0,1,1.0,1,0.2869225203743217,41
1585,17,22143,22143,0,0,0,0,1.0,1,1.0,1,1.0,1,0.29717560205957255,43
1586,13,22156,22156,0,0,0,0,1.0,1,1.0,1,1.0,1,0.31040178533523155,42
1587,24,22180,22180,0,0,0,0,1.0,1,1.0,1,1.0,1,0.4141827967204311,42
1588,22,22202,22202,0,0,0,0,1.0,1,1.0,1,1.0,1,0.3707573039526259,42
1589,19,22221,22221,0,0,0,0,1.0,1,1.0,1,1.0,1,0.336520604841641,42
1590,13,22234,22234,0,0,0,0,1.0,1,1.0,1,1.0,1,0.21469829305287408,41
1591,12,22246,22246,0,0,0,0,1.0,1,1.0,1,1.0,1,0.3714050937897823,40
1592,27,22273,22273,0,0,0,0,1.0,1,1.0,1,1.0,1,0.4544571097602757,39
1593,14,22287,22287,0,0,0,0,1.0,1,1.0,1,1.0,1,0.3554644929317643,39
1594,12,22299,22299,0,0,0,0,1.0,1,1.0,1,1.0,1,0.3964370690973815,39
1595,19,22318,22318,0,0,0,0,1.0,1,1.0,1,1.0,1,0.25961359351094365,42
1596,21,22339,22339,0,0,0,0,1.0,1,1.0,1,1.0,1,0.31168672699246674,41
1597,18,22357,22357,0,0,0,0,1.0,1,1.0,1,1.0,1,0.2756339160683045,41
1598,9,22366,22366,0,0,0,0,1.0,1,1.0,1,1.0,1,0.2817319679237991,39
1599,27,22393,22393,0,0,0,0,1.0,1,1.0,1,1.0,1,0.31274905528682445,39
1600,17,22410,22410,0,0,0,0,1.0,1,1.0,1,1.0,1,0.22790408638084517,40
1601,15,22425,22425,0,0,0,0,1.0,1,1.0,1,1.0,1,0.2584505092223629,41
1602,17,22442,22442,0,0,0,0,1.0,1,1.0,1,1.0,1,0.22821359890741869,41
1603,17,22459,22459,0,0,0,0,1.0,1,1.0,1,1.0,1,0.22567902254896338,43
1604,14,22473,22473,0,0,0,0,1.0,1,1.0,1,1.0,1,0.1891793244996264,43
1605,16,22489,22489,0,0,0,0,1.0,1,1.0,1,1.0,1,0.2008123918419146,44
1606,11,22500,22500,0,0,0,0,1.0,1,1.0,1,1.0,1,0.25563001526521933,44
1607,5,22505,22505,0,0,0,0,1.0,1,1.0,1,1.0,1,0.2938219694749194,42
1608,12,22517,22517,0,0,0,0,1.0,1,1.0,1,1.0,1,0.32996782048035955,41
1609,7,22524,22524,0,0,0,0,1.0,1,1.0,1,1.0,1,0.32043916221766305,39
1610,11,22535,22535,0,0,0,0,1.0,1,1.0,1,1.0,1,0.345103917672301,39
1611,14,22549,22549,0,0,0,0,1.0,1,1.0,1,1.0,1,0.3718177782230459,40
1612,8,22557,22557,0,0,0,0,1.0,1,1.0,1,1.0,1,0.3582408722288415,39
1613,15,22572,22572,0,0,0,0,1.0,1,1.0,1,1.0,1,0.40961664191425157,41
1614,11,22583,22583,0,0,0,0,1.0,1,1.0,1,1.0,1,0.3658673469945498,41
1615,19,22602,22602,0,0,0,0,1.0,1,1.0,1,1.0,1,0.3553289090968231,41
1616,20,22622,22622,0,0,0,0,1.0,1,1.0,1,1.0,1,0.36043836033778565,43
1617,13,22635,22635,0,0,0,0,1.0,1,1.0,1,1.0,1,0.3817686660958447,44
1618,10,22645,22645,0,0,0,0,1.0,1,1.0,1,1.0,1,0.34222129422747605,44
1619,18,22663,22663,0,0,0,0,1.0,1,1.0,1,1.0,1,0.3873315369144115,44
1620,8,22671,22671,0,0,0,0,1.0,1,1.0,1,1.0,1,0.4947195156232775,45
1621,6,22677,22677,0,0,0,0,1.0,1,1.0,1,1.0,1,0.40814595860694775,44
1622,13,22690,22690,0,0,0,0,1.0,1,1.0,1,1.0,1,0.5370174884772079,44
1623,13,22703,22703,0,0,0,0,1.0,1,1.0,1,1.0,1,0.4172267730690903,43
1624,16,22719,22719,0,0,0,0,1.0,1,1.0,1,1.0,1,0.3930054177190592,43
1625,14,22733,22733,0,0,0,0,1.0,1,1.0,1,1.0,1,0.5197878856643553,43
1626,21,22754,22754,0,0,0,0,1.0,1,1.0,1,1.0,1,0.5148203621835121,42
1627,19,22773,22773,0,0,0,0,1.0,1,1.0,1,1.0,1,0.5010717083947072,42
1628,11,22784,22784,0,0,0,0,1.0,1,1.0,1,1.0,1,0.41013010882344375,42
1629,10,22794,22794,0,0,0,0,1.0,1,1.0,1,1.0,1,0.4153990135632813,41
1630,15,22809,22809,0,0,0,0,1.0,1,1.0,1,1.0,1,0.3675298188869134,41
1631,7,22816,22816,0,0,0,0,1.0,1,1.0,1,1.0,1,0.3857591266467157,40
1632,7,22823,22823,0,0,0,0,1.0,1,1.0,1,1.0,1,0.43624340478866586,39
1633,9,22832,22832,0,0,0,0,1.0,1,1.0,1,1.0,1,0.39214570615976024,39
1634,14,22846,22846,0,0,0,0,1.0,1,1.0,1,1.0,1,0.2881283817650094,39
1635,16,22862,22862,0,0,0,0,1.0,1,1.0,1,1.0,1,0.1979819794405621,40
1636,12,22874,22874,0,0,0,0,1.0,1,1.0,1,1.0,1,0.2852544954468812,41
1637,8,22882,22882,0,0,0,0,1.0,1,1.0,1,1.0,1,0.30635808672499887,41
1638,15,22897,22897,0,0,0,0,1.0,1,1.0,1,1.0,1,0.3283633954808082,42
1639,13,22910,22910,0,0,0,0,1.0,1,1.0,1,1.0,1,0.38033258739708015,43
1640,14,22924,22924,0,0,0,0,1.0,1,1.0,1,1.0,1,0.20338378835887813,43
1641,9,22933,22933,0,0,0,0,1.0,1,1.0,1,1.0,1,0.22625569581960472,44
1642,9,22942,22942,0,0,0,0,1.0,1,1.0,1,1.0,1,0.32532026192222857,45
1643,9,22951,22951,0,0,0,0,1.0,1,1.0,1,1.0,1,0.3598664232692854,44
1644,11,22962,22962,0,0,0,0,1.0,1,1.0,1,1.0,1,0.36554106935575703,45
1645,14,22976,22976,0,0,0,0,1.0,1,1.0,1,1.0,1,0.32754502403374464,44
1646,16,22992,22992,0,0,0,0,1.0,1,1.0,1,1.0,1,0.40773890351842923,43
1647,5,22997,22997,0,0,0,0,1.0,1,1.0,1,1.0,1,0.3852201849724773,43
1648,12,23009,23009,0,0,0,0,1.0,1,1.0,1,1.0,1,0.37130710260954886,42
1649,12,23021,23021,0,0,0,0,1.0,1,1.0,1,1.0,1,0.43407461451917767,41
1650,6,23027,23027,0,0,0,0,1.0,1,1.0,1,1.0,1,0.35269256298917484,41
1651,12,23039,23039,0,0,0,0,1.0,1,1.0,1,1.0,1,0.39285174245991067,40
1652,7,23046,23046,0,0,0,0,1.0,1,1.0,1,1.0,1,0.39821811792783735,39
1653,17,23063,23063,0,0,0,0,1.0,1,1.0,1,1.0,1,0.41075894620347403,39
1654,18,23081,23081,0,0,0,0,1.0,1,1.0,1,1.0,1,0.3005261031196473,39
1655,14,23095,23095,0,0,0,0,1.0,1,1.0,1,1.0,1,0.3268490816113611,40
1656,13,23108,23108,0,0,0,0,1.0,1,1.0,1,1.0,1,0.29267343210513624,40
1657,10,23118,23118,0,0,0,0,1.0,1,1.0,1,1.0,1,0.3027091906023874,40
1658,14,23132,23132,0,0,0,0,1.0,1,1.0,1,1.0,1,0.2781666856286596,40
1659,15,23147,23147,0,0,0,0,1.0,1,1.0,1,1.0,1,0.2442685970374063,40
1660,7,23154,23154,0,0,0,0,1.0,1,1.0,1,1.0,1,0.27614647856747027,41
1661,9,23163,23163,0,0,0,0,1.0,1,1.0,1,1.0,1,0.28768273508406506,42
1662,6,23169,23169,0,0,0,0,1.0,1,1.0,1,1.0,1,0.26422340843101855,44
1663,10,23179,23179,0,0,0,0,1.0,1,1.0,1,1.0,1,0.30303569068712166,43
1664,10,23189,23189,0,0,0,0,1.0,1,1.0,1,1.0,1,0.3716064045016874,42
1665,15,23204,23204,0,0,0,0,1.0,1,1.0,1,1.0,1,0.27523305991412184,42
1666,11,23215,23215,0,0,0,0,1.0,1,1.0,1,1.0,1,0.34638404082955565,43
1667,8,23223,23223,0,0,0,0,1.0,1,1.0,1,1.0,1,0.4452834040722776,40
1668,8,23231,23231,0,0,0,0,1.0,1,1.0,1,1.0,1,0.4061967155451941,40
1669,13,23244,23244,0,0,0,0,1.0,1,1.0,1,1.0,1,0.2470038863784217,40
1670,12,23256,23256,0,0,0,0,1.0,1,1.0,1,1.0,1,0.43631901045236826,39
1671,11,23267,23267,0,0,0,0,1.0,1,1.0,1,1.0,1,0.3196158233559956,39
1672,18,23285,23285,0,0,0,0,1.0,1,1.0,1,1.0,1,0.31998884361142527,38
1673,8,23293,23293,0,0,0,0,1.0,1,1.0,1,1.0,1,0.39603503202539486,38
1674,9,23302,23302,0,0,0,0,1.0,1,1.0,1,1.0,1,0.4185732039847897,38
1675,18,23320,23320,0,0,0,0,1.0,1,1.0,1,1.0,1,0.47290739950038335,39
1676,8,23328,23328,0,0,0,0,1.0,1,1.0,1,1.0,1,0.3094924705998244,39
1677,14,23342,23342,0,0,0,0,1.0,1,1.0,1,1.0,1,0.4584120657238786,40
1678,13,23355,23355,0,0,0,0,1.0,1,1.0,1,1.0,1,0.42741929467407574,39
1679,10,23365,23365,0,0,0,0,1.0,1,1.0,1,1.0,1,0.37052734765643836,39
1680,13,23378,23378,0,0,0,0,1.0,1,1.0,1,1.0,1,0.35439329907110473,40
1681,5,23383,23383,0,0,0,0,1.0,1,1.0,1,1.0,1,0.3195357994633109,41
1682,26,23409,23409,0,0,0,0,1.0,1,1.0,1,1.0,1,0.23567136314481177,40
1683,21,23430,23430,0,0,0,0,1.0,1,1.0,1,1.0,1,0.25116437126851576,43
1684,20,23450,23450,0,0,0,0,1.0,1,1.0,1,1.0,1,0.3031125921279088,42
1685,14,23464,23464,0,0,0,0,1.0,1,1.0,1,1.0,1,0.37781501308440474,41
1686,8,23472,23472,0,0,0,0,1.0,1,1.0,1,1.0,1,0.38933454597271994,39
1687,15,23487,23487,0,0,0,0,1.0,1,1.0,1,1.0,1,0.3014467667314822,41
1688,12,23499,23499,0,0,0,0,1.0,1,1.0,1,1.0,1,0.33740606294714054,39
1689,9,23508,23508,0,0,0,0,1.0,1,1.0,1,1.0,1,0.30854800473773963,37
1690,8,23516,23516,0,0,0,0,1.0,1,1.0,1,1.0,1,0.2804624332423697,36
1691,10,23526,23526,0,0,0,0,1.0,1,1.0,1,1.0,1,0.3159675864478129,36
1692,5,23531,23531,0,0,0,0,1.0,1,1.0,1,1.0,1,0.36116349790713076,34
1693,8,23539,23539,0,0,0,0,1.0,1,1.0,1,1.0,1,0.4218497551274479,33
1694,15,23554,23554,0,0,0,0,1.0,1,1.0,1,1.0,1,0.45528308452075766,32
1695,12,23566,23566,0,0,0,0,1.0,1,1.0,1,1.0,1,0.4417375976332281,32
1696,16,23582,23582,0,0,0,0,1.0,1,1.0,1,1.0,1,0.3582385405418527,34
1697,17,23599,23599,0,0,0,0,1.0,1,1.0,1,1.0,1,0.36651607252825785,34
1698,13,23612,23612,0,0,0,0,1.0,1,1.0,1,1.0,1,0.44391671620280243,36
1699,11,23623,23623,0,0,0,0,1.0,1,1.0,1,1.0,1,0.4467101506937744,36
1700,14,23637,23637,0,0,0,0,1.0,1,1.0,1,1.0,1,0.4163562500800003,37
1701,17,23654,23654,0,0,0,0,1.0,1,1.0,1,1.0,1,0.4769251811607528,39
1702,17,23671,23671,0,0,0,0,1.0,1,1.0,1,1.0,1,0.4740980517021904,39
1703,16,23687,23687,0,0,0,0,1.0,1,1.0,1,1.0,1,0.4012497432061529,38
1704,14,23701,23701,0,0,0,0,1.0,1,1.0,1,1.0,1,0.322452289145901,38
1705,14,23715,23715,0,0,0,0,1.0,1,1.0,1,1.0,1,0.38897532687156877,37
1706,15,23730,23730,0,0,0,0,1.0,1,1.0,1,1.0,1,0.26194490782246427,37
1707,16,23746,23746,0,0,0,0,1.0,1,1.0,1,1.0,1,0.36718225067658705,36
1708,18,23764,23764,0,0,0,0,1.0,1,1.0,1,1.0,1,0.3924030617718414,34
1709,22,23786,23786,0,0,0,0,1.0,1,1.0,1,1.0,1,0.411390812003102,34
1710,11,23797,23797,0,0,0,0,1.0,1,1.0,1,1.0,1,0.4608241380517115,33
1711,7,23804,23804,0,0,0,0,1.0,1,1.0,1,1.0,1,0.3536556588114933,32
1712,13,23817,23817,0,0,0,0,1.0,1,1.0,1,1.0,1,0.41293215745351736,31
1713,18,23835,23835,0,0,0,0,1.0,1,1.0,1,1.0,1,0.3513359510161322,32
1714,21,23856,23856,0,0,0,0,1.0,1,1.0,1,1.0,1,0.39836135001854256,32
1715,5,23861,23861,0,0,0,0,1.0,1,1.0,1,1.0,1,0.3942862681249594,32
1716,12,23873,23873,0,0,0,0,1.0,1,1.0,1,1.0,1,0.3827347280789142,34
1717,15,23888,23888,0,0,0,0,1.0,1,1.0,1,1.0,1,0.43450910667772086,34
1718,10,23898,23898,0,0,0,0,1.0,1,1.0,1,1.0,1,0.5109496762420731,34
1719,14,23912,23912,0,0,0,0,1.0,1,1.0,1,1.0,1,0.420192718012258,34
1720,14,23926,23926,0,0,0,0,1.0,1,1.0,1,1.0,1,0.499107910728276,34
1721,12,23938,23938,0,0,0,0,1.0,1,1.0,1,1.0,1,0.4938451270900797,35
1722,18,23956,23956,0,0,0,0,1.0,1,1.0,1,1.0,1,0.2945543660917185,35
1723,12,23968,23968,0,0,0,0,1.0,1,1.0,1,1.0,1,0.4764875885119045,34
1724,13,23981,23981,0,0,0,0,1.0,1,1.0,1,1.0,1,0.43126432734149045,33
1725,15,23996,23996,0,0,0,0,1.0,1,1.0,1,1.0,1,0.39947109246399365,35
1726,19,24015,24015,0,0,0,0,1.0,1,1.0,1,1.0,1,0.3878945927589015,34
1727,16,24031,24031,0,0,0,0,1.0,1,1.0,1,1.0,1,0.4909875375679166,34
1728,13,24044,24044,0,0,0,0,1.0,1,1.0,1,1.0,1,0.5560894961763578,35
1729,18,24062,24062,0,0,0,0,1.0,1,1.0,1,1.0,1,0.5482770067206371,35
1730,13,24075,24075,0,0,0,0,1.0,1,1.0,1,1.0,1,0.4643255808992862,35
1731,17,24092,24092,0,0,0,0,1.0,1,1.0,1,1.0,1,0.5038903605240925,35
1732,15,24107,24107,0,0,0,0,1.0,1,1.0,1,1.0,1,0.5755691860551079,35
1733,10,24117,24117,0,0,0,0,1.0,1,1.0,1,1.0,1,0.3861323371214374,33
1734,22,24139,24139,0,0,0,0,1.0,1,1.0,1,1.0,1,0.4103591455065756,34
1735,16,24155,24155,0,0,0,0,1.0,1,1.0,1,1.0,1,0.3785659238583623,33
1736,17,24172,24172,0,0,0,0,1.0,1,1.0,1,1.0,1,0.2837628702792747,33
1737,10,24182,24182,0,0,0,0,1.0,1,1.0,1,1.0,1,0.2611147559479109,35
1738,17,24199,24199,0,0,0,0,1.0,1,1.0,1,1.0,1,0.30929242490260145,36
1739,16,24215,24215,0,0,0,0,1.0,1,1.0,1,1.0,1,0.2568127555265887,36
1740,11,24226,24226,0,0,0,0,1.0,1,1.0,1,1.0,1,0.282649109181304,37
1741,10,24236,24236,0,0,0,0,1.0,1,1.0,1,1.0,1,0.285162652080238,36
1742,12,24248,24248,0,0,0,0,1.0,1,1.0,1,1.0,1,0.25683539834866354,36
1743,9,24257,24257,0,0,0,0,1.0,1,1.0,1,1.0,1,0.2302463534548875,37
1744,4,24261,24261,0,0,0,0,1.0,1,1.0,1,1.0,1,0.2856290609876067,37
1745,7,24268,24268,0,0,0,0,1.0,1,1.0,1,1.0,1,0.33360332007768456,38
1746,9,24277,24277,0,0,0,0,1.0,1,1.0,1,1.0,1,0.3039027854975273,38
1747,8,24285,24285,0,0,0,0,1.0,1,1.0,1,1.0,1,0.3118732174135949,37
1748,14,24299,24299,0,0,0,0,1.0,1,1.0,1,1.0,1,0.4566179796079211,38
1749,8,24307,24307,0,0,0,0,1.0,1,1.0,1,1.0,1,0.42412891274978026,38
1750,23,24330,24330,0,0,0,0,1.0,1,1.0,1,1.0,1,0.42953311869772953,39
1751,20,24350,24350,0,0,0,0,1.0,1,1.0,1,1.0,1,0.42981129342056973,41
1752,13,24363,24363,0,0,0,0,1.0,1,1.0,1,1.0,1,0.4440499362030876,41
1753,13,24376,24376,0,0,0,0,1.0,1,1.0,1,1.0,1,0.37314072200158255,41
1754,14,24390,24390,0,0,0,0,1.0,1,1.0,1,1.0,1,0.37680418861765036,40
1755,19,24409,24409,0,0,0,0,1.0,1,1.0,1,1.0,1,0.3904314296525467,41
1756,12,24421,24421,0,0,0,0,1.0,1,1.0,1,1.0,1,0.29606101459211087,41
1757,19,24440,24440,0,0,0,0,1.0,1,1.0,1,1.0,1,0.3555399749761662,40
1758,14,24454,24454,0,0,0,0,1.0,1,1.0,1,1.0,1,0.29412445453303476,41
1759,13,24467,24467,0,0,0,0,1.0,1,1.0,1,1.0,1,0.38283414934123117,38
1760,17,24484,24484,0,0,0,0,1.0,1,1.0,1,1.0,1,0.24452901274618874,38
1761,17,24501,24501,0,0,0,0,1.0,1,1.0,1,1.0,1,0.3997928581975589,37
1762,8,24509,24509,0,0,0,0,1.0,1,1.0,1,1.0,1,0.3958646449637516,37
1763,13,24522,24522,0,0,0,0,1.0,1,1.0,1,1.0,1,0.3591879363381289,37
1764,7,24529,24529,0,0,0,0,1.0,1,1.0,1,1.0,1,0.3680701847504353,36
1765,12,24541,24541,0,0,0,0,1.0,1,1.0,1,1.0,1,0.47210291243340785,36
1766,6,24547,24547,0,0,0,0,1.0,1,1.0,1,1.0,1,0.4294135111812716,37
1767,13,24560,24560,0,0,0,0,1.0,1,1.0,1,1.0,1,0.48540293775663573,37
1768,9,24569,24569,0,0,0,0,1.0,1,1.0,1,1.0,1,0.4494921576473226,37
1769,11,24580,24580,0,0,0,0,1.0,1,1.0,1,1.0,1,0.4629135554451278,38
1770,10,24590,24590,0,0,0,0,1.0,1,1.0,1,1.0,1,0.4640687251330519,39
1771,7,24597,24597,0,0,0,0,1.0,1,1.0,1,1.0,1,0.4930962287443026,39
1772,11,24608,24608,0,0,0,0,1.0,1,1.0,1,1.0,1,0.4598236208672061,39
1773,7,24615,24615,0,0,0,0,1.0,1,1.0,1,1.0,1,0.44609657732951086,41
1774,10,24625,24625,0,0,0,0,1.0,1,1.0,1,1.0,1,0.4235726807441515,41
1775,13,24638,24638,0,0,0,0,1.0,1,1.0,1,1.0,1,0.4488644469272292,42
1776,10,24648,24648,0,0,0,0,1.0,1,1.0,1,1.0,1,0.4263147724921876,43
1777,16,24664,24664,0,0,0,0,1.0,1,1.0,1,1.0,1,0.4593379614442395,43
1778,7,24671,24671,0,0,0,0,1.0,1,1.0,1,1.0,1,0.3434696480321608,44
1779,17,24688,24688,0,0,0,0,1.0,1,1.0,1,1.0,1,0.38810820970348253,46
1780,8,24696,24696,0,0,0,0,1.0,1,1.0,1,1.0,1,0.48905788154925367,46
1781,5,24701,24701,0,0,0,0,1.0,1,1.0,1,1.0,1,0.45126226183800283,46
1782,5,24706,24706,0,0,0,0,1.0,1,1.0,1,1.0,1,0.4766754192842003,46
1783,7,24713,24713,0,0,0,0,1.0,1,1.0,1,1.0,1,0.43724328311352867,44
1784,22,24735,24735,0,0,0,0,1.0,1,1.0,1,1.0,1,0.3778176113046383,45
1785,14,24749,24749,0,0,0,0,1.0,1,1.0,1,1.0,1,0.4409141018484204,42
1786,13,24762,24762,0,0,0,0,1.0,1,1.0,1,1.0,1,0.33575678872094517,43
1787,15,24777,24777,0,0,0,0,1.0,1,1.0,1,1.0,1,0.36832300123734407,41
1788,14,24791,24791,0,0,0,0,1.0,1,1.0,1,1.0,1,0.3693658449959079,41
1789,18,24809,24809,0,0,0,0,1.0,1,1.0,1,1.0,1,0.2537505728213579,41
1790,17,24826,24826,0,0,0,0,1.0,1,1.0,1,1.0,1,0.21127091360932732,41
1791,14,24840,24840,0,0,0,0,1.0,1,1.0,1,1.0,1,0.219353106108495,40
1792,10,24850,24850,0,0,0,0,1.0,1,1.0,1,1.0,1,0.2976935381153525,40
1793,10,24860,24860,0,0,0,0,1.0,1,1.0,1,1.0,1,0.32511909129372346,41
1794,11,24871,24871,0,0,0,0,1.0,1,1.0,1,1.0,1,0.2981967634750836,41
1795,11,24882,24882,0,0,0,0,1.0,1,1.0,1,1.0,1,0.32758622072630655,40
1796,11,24893,24893,0,0,0,0,1.0,1,1.0,1,1.0,1,0.38019617863978156,40
1797,6,24899,24899,0,0,0,0,1.0,1,1.0,1,1.0,1,0.42566261530444144,37
1798,11,24910,24910,0,0,0,0,1.0,1,1.0,1,1.0,1,0.339584296211405,37
1799,6,24916,24916,0,0,0,0,1.0,1,1.0,1,1.0,1,0.3455241979622492,36
1800,10,24926,24926,0,0,0,0,1.0,1,1.0,1,1.0,1,0.3258688862563721,36
1801,9,24935,24935,0,0,0,0,1.0,1,1.0,1,1.0,1,0.4136222179133763,34
1802,9,24944,24944,0,0,0,0,1.0,1,1.0,1,1.0,1,0.5446668207558333,33
1803,11,24955,24955,0,0,0,0,1.0,1,1.0,1,1.0,1,0.3899896563583183,33
1804,10,24965,24965,0,0,0,0,1.0,1,1.0,1,1.0,1,0.2783915992160149,33
1805,10,24975,24975,0,0,0,0,1.0,1,1.0,1,1.0,1,0.3782851159600431,35
1806,16,24991,24991,0,0,0,0,1.0,1,1.0,1,1.0,1,0.39002232826902317,35
1807,11,25002,25002,0,0,0,0,1.0,1,1.0,1,1.0,1,0.35148127335227686,35
1808,13,25015,25015,0,0,0,0,1.0,1,1.0,1,1.0,1,0.39559310606096815,36
1809,11,25026,25026,0,0,0,0,1.0,1,1.0,1,1.0,1,0.32012156843087963,36
1810,12,25038,25038,0,0,0,0,1.0,1,1.0,1,1.0,1,0.2774436162008007,35
1811,9,25047,25047,0,0,0,0,1.0,1,1.0,1,1.0,1,0.3890717290230456,36
1812,16,25063,25063,0,0,0,0,1.0,1,1.0,1,1.0,1,0.335813015783259,36
1813,9,25072,25072,0,0,0,0,1.0,1,1.0,1,1.0,1,0.3882831264470686,36
1814,9,25081,25081,0,0,0,0,1.0,1,1.0,1,1.0,1,0.36078475799695886,34
1815,11,25092,25092,0,0,0,0,1.0,1,1.0,1,1.0,1,0.4416878233964505,35
1816,11,25103,25103,0,0,0,0,1.0,1,1.0,1,1.0,1,0.4050498031706214,34
1817,18,25121,25121,0,0,0,0,1.0,1,1.0,1,1.0,1,0.45193138708282443,34
1818,11,25132,25132,0,0,0,0,1.0,1,1.0,1,1.0,1,0.5311822792452767,34
1819,12,25144,25144,0,0,0,0,1.0,1,1.0,1,1.0,1,0.42103323138956306,35
1820,16,25160,25160,0,0,0,0,1.0,1,1.0,1,1.0,1,0.32643386035873007,36
1821,5,25165,25165,0,0,0,0,1.0,1,1.0,1,1.0,1,0.3482330538830038,36
1822,10,25175,25175,0,0,0,0,1.0,1,1.0,1,1.0,1,0.378155564659047,37
1823,7,25182,25182,0,0,0,0,1.0,1,1.0,1,1.0,1,0.36401633460422417,38
1824,6,25188,25188,0,0,0,0,1.0,1,1.0,1,1.0,1,0.3067110581194175,37
1825,10,25198,25198,0,0,0,0,1.0,1,1.0,1,1.0,1,0.3130454096146973,36
1826,12,25210,25210,0,0,0,0,1.0,1,1.0,1,1.0,1,0.24906845872612735,35
1827,10,25220,25220,0,0,0,0,1.0,1,1.0,1,1.0,1,0.3401297025331023,35
1828,11,25231,25231,0,0,0,0,1.0,1,1.0,1,1.0,1,0.2975802450571766,33
1829,11,25242,25242,0,0,0,0,1.0,1,1.0,1,1.0,1,0.37884814497059843,32
1830,10,25252,25252,0,0,0,0,1.0,1,1.0,1,1.0,1,0.36323324065607027,32
1831,8,25260,25260,0,0,0,0,1.0,1,1.0,1,1.0,1,0.5090072386030882,30
1832,8,25268,25268,0,0,0,0,1.0,1,1.0,1,1.0,1,0.4460002256551843,30
1833,10,25278,25278,0,0,0,0,1.0,1,1.0,1,1.0,1,0.511300755322197,29
1834,8,25286,25286,0,0,0,0,1.0,1,1.0,1,1.0,1,0.3026343986520861,28
1835,11,25297,25297,0,0,0,0,1.0,1,1.0,1,1.0,1,0.3721088165806017,28
1836,8,25305,25305,0,0,0,0,1.0,1,1.0,1,1.0,1,0.42712979299650317,29
1837,8,25313,25313,0,0,0,0,1.0,1,1.0,1,1.0,1,0.3754694750514359,28
1838,5,25318,25318,0,0,0,0,1.0,1,1.0,1,1.0,1,0.43009857982845745,28
1839,10,25328,25328,0,0,0,0,1.0,1,1.0,1,1.0,1,0.35487645204930685,27
1840,11,25339,25339,0,0,0,0,1.0,1,1.0,1,1.0,1,0.4206632886945448,26
1841,10,25349,25349,0,0,0,0,1.0,1,1.0,1,1.0,1,0.3961517398198001,25
1842,8,25357,25357,0,0,0,0,1.0,1,1.0,1,1.0,1,0.3044825329120634,26
1843,4,25361,25361,0,0,0,0,1.0,1,1.0,1,1.0,1,0.2535969795154993,26
1844,12,25373,25373,0,0,0,0,1.0,1,1.0,1,1.0,1,0.3079774958260441,26
1845,6,25379,25379,0,0,0,0,1.0,1,1.0,1,1.0,1,0.33782290482919136,26
1846,6,25385,25385,0,0,0,0,1.0,1,1.0,1,1.0,1,0.4196937144374402,26
1847,14,25399,25399,0,0,0,0,1.0,1,1.0,1,1.0,1,0.3479853152973872,26
1848,3,25402,25402,0,0,0,0,1.0,1,1.0,1,1.0,1,0.3874900194083404,27
1849,5,25407,25407,0,0,0,0,1.0,1,1.0,1,1.0,1,0.3231106056114471,27
1850,5,25412,25412,0,0,0,0,1.0,1,1.0,1,1.0,1,0.3903002764137376,28
1851,4,25416,25416,0,0,0,0,1.0,1,1.0,1,1.0,1,0.3446647791059937,28
1852,9,25425,25425,0,0,0,0,1.0,1,1.0,1,1.0,1,0.3581002132562082,28
1853,4,25429,25429,0,0,0,0,1.0,1,1.0,1,1.0,1,0.42093798581299585,27
1854,7,25436,25436,0,0,0,0,1.0,1,1.0,1,1.0,1,0.4245528690419779,28
1855,5,25441,25441,0,0,0,0,1.0,1,1.0,1,1.0,1,0.3669251432473262,28
1856,8,25449,25449,0,0,0,0,1.0,1,1.0,1,1.0,1,0.35889924300446857,30
1857,7,25456,25456,0,0,0,0,1.0,1,1.0,1,1.0,1,0.37580581683424485,31
1858,5,25461,25461,0,0,0,0,1.0,1,1.0,1,1.0,1,0.4180018290901429,31
1859,4,25465,25465,0,0,0,0,1.0,1,1.0,1,1.0,1,0.45406777406425336,31
1860,0,25465,25465,0,0,0,0,1.0,1,1.0,1,1.0,1,0.45406777406425336,31
1861,2,25467,25467,0,0,0,0,1.0,1,1.0,1,1.0,1,0.45615347140170504,31
1862,3,25470,25470,0,0,0,0,1.0,1,1.0,1,1.0,1,0.43279296135603434,31
1863,9,25479,25479,0,0,0,0,1.0,1,1.0,1,1.0,1,0.45979590450534596,31
1864,3,25482,25482,0,0,0,0,1.0,1,1.0,1,1.0,1,0.40434727102569634,30
1865,6,25488,25488,0,0,0,0,1.0,1,1.0,1,1.0,1,0.38703381714624574,27
1866,3,25491,25491,0,0,0,0,1.0,1,1.0,1,1.0,1,0.35701900555905314,28
1867,2,25493,25493,0,0,0,0,1.0,1,1.0,1,1.0,1,0.37280090341012745,26
1868,4,25497,25497,0,0,0,0,1.0,1,1.0,1,1.0,1,0.37939721321804115,26
1869,4,25501,25501,0,0,0,0,1.0,1,1.0,1,1.0,1,0.36060819549137985,25
1870,1,25502,25502,0,0,0,0,1.0,1,1.0,1,1.0,1,0.34855757679573546,25
1871,4,25506,25506,0,0,0,0,1.0,1,1.0,1,1.0,1,0.3817522260101868,26
1872,3,25509,25509,0,0,0,0,1.0,1,1.0,1,1.0,1,0.37844422301061553,25
1873,4,25513,25513,0,0,0,0,1.0,1,1.0,1,1.0,1,0.438417153487854,23
1874,6,25519,25519,0,0,0,0,1.0,1,1.0,1,1.0,1,0.4660938951857133,23
1875,7,25526,25526,0,0,0,0,1.0,1,1.0,1,1.0,1,0.4209309554244504,21
1876,6,25532,25532,0,0,0,0,1.0,1,1.0,1,1.0,1,0.39706573083965313,24
1877,6,25538,25538,0,0,0,0,1.0,1,1.0,1,1.0,1,0.3344950957591012,24
1878,4,25542,25542,0,0,0,0,1.0,1,1.0,1,1.0,1,0.36568508458748883,26
1879,11,25553,25553,0,0,0,0,1.0,1,1.0,1,1.0,1,0.39515378076901153,26
1880,12,25565,25565,0,0,0,0,1.0,1,1.0,1,1.0,1,0.3501040501122938,26
1881,7,25572,25572,0,0,0,0,1.0,1,1.0,1,1.0,1,0.3371563277135749,26
1882,8,25580,25580,0,0,0,0,1.0,1,1.0,1,1.0,1,0.37418506699475973,25
1883,9,25589,25589,0,0,0,0,1.0,1,1.0,1,1.0,1,0.37271549160602513,25
1884,6,25595,25595,0,0,0,0,1.0,1,1.0,1,1.0,1,0.4213104515940037,25
1885,5,25600,25600,0,0,0,0,1.0,1,1.0,1,1.0,1,0.40062220710618807,25
1886,10,25610,25610,0,0,0,0,1.0,1,1.0,1,1.0,1,0.2935819623296722,26
1887,8,25618,25618,0,0,0,0,1.0,1,1.0,1,1.0,1,0.3343592979637532,26
1888,4,25622,25622,0,0,0,0,1.0,1,1.0,1,1.0,1,0.3088003483449523,27
1889,4,25626,25626,0,0,0,0,1.0,1,1.0,1,1.0,1,0.33960954171485747,28
1890,2,25628,25628,0,0,0,0,1.0,1,1.0,1,1.0,1,0.22585380461125698,28
1891,3,25631,25631,0,0,0,0,1.0,1,1.0,1,1.0,1,0.32503055825745225,29
1892,2,25633,25633,0,0,0,0,1.0,1,1.0,1,1.0,1,0.2702141549199229,29
1893,4,25637,25637,0,0,0,0,1.0,1,1.0,1,1.0,1,0.29632886949815,29
1894,4,25641,25641,0,0,0,0,1.0,1,1.0,1,1.0,1,0.3485288059722096,29
1895,4,25645,25645,0,0,0,0,1.0,1,1.0,1,1.0,1,0.3445633167706019,31
1896,1,25646,25646,0,0,0,0,1.0,1,1.0,1,1.0,1,0.33087310669368314,31
1897,7,25653,25653,0,0,0,0,1.0,1,1.0,1,1.0,1,0.32437552475548187,31
1898,1,25654,25654,0,0,0,0,1.0,1,1.0,1,1.0,1,0.2916768240372652,31
1899,3,25657,25657,0,0,0,0,1.0,1,1.0,1,1.0,1,0.31640091720388247,32
1900,2,25659,25659,0,0,0,0,1.0,1,1.0,1,1.0,1,0.31097338928014673,32
1901,1,25660,25660,0,0,0,0,1.0,1,1.0,1,1.0,1,0.3385174369091253,32
1902,2,25662,25662,0,0,0,0,1.0,1,1.0,1,1.0,1,0.36267242636941144,32
1903,1,25663,25663,0,0,0,0,1.0,1,1.0,1,1.0,1,0.3324537472739419,32
1904,1,25664,25664,0,0,0,0,1.0,1,1.0,1,1.0,1,0.34580250980870725,34
1905,4,25668,25668,0,0,0,0,1.0,1,1.0,1,1.0,1,0.3070343810186041,34
1906,9,25677,25677,0,0,0,0,1.0,1,1.0,1,1.0,1,0.339576010247547,35
1907,7,25684,25684,0,0,0,0,1.0,1,1.0,1,1.0,1,0.4430841578072278,36
1908,7,25691,25691,0,0,0,0,1.0,1,1.0,1,1.0,1,0.3775139578558059,36
1909,12,25703,25703,0,0,0,0,1.0,1,1.0,1,1.0,1,0.3121481060624622,37
1910,11,25714,25714,0,0,0,0,1.0,1,1.0,1,1.0,1,0.3291100702419605,38
1911,5,25719,25719,0,0,0,0,1.0,1,1.0,1,1.0,1,0.30852882332158915,37
1912,15,25734,25734,0,0,0,0,1.0,1,1.0,1,1.0,1,0.33366755324115505,37
1913,7,25741,25741,0,0,0,0,1.0,1,1.0,1,1.0,1,0.29507604098231827,36
1914,10,25751,25751,0,0,0,0,1.0,1,1.0,1,1.0,1,0.301505657664466,37
1915,10,25761,25761,0,0,0,0,1.0,1,1.0,1,1.0,1,0.32751899829621073,37
1916,13,25774,25774,0,0,0,0,1.0,1,1.0,1,1.0,1,0.2159538278577166,39
1917,6,25780,25780,0,0,0,0,1.0,1,1.0,1,1.0,1,0.2408758422051885,38
1918,12,25792,25792,0,0,0,0,1.0,1,1.0,1,1.0,1,0.2696675644918878,38
1919,12,25804,25804,0,0,0,0,1.0,1,1.0,1,1.0,1,0.40138998552561367,38
1920,16,25820,25820,0,0,0,0,1.0,1,1.0,1,1.0,1,0.2449036940497576,39
1921,12,25832,25832,0,0,0,0,1.0,1,1.0,1,1.0,1,0.15585723983471952,38
1922,17,25849,25849,0,0,0,0,1.0,1,1.0,1,1.0,1,0.2789505219178173,39
1923,22,25871,25871,0,0,0,0,1.0,1,1.0,1,1.0,1,0.25896011696143395,40
1924,16,25887,25887,0,0,0,0,1.0,1,1.0,1,1.0,1,0.31558467395920436,40
1925,12,25899,25899,0,0,0,0,1.0,1,1.0,1,1.0,1,0.30516626249971845,40
1926,10,25909,25909,0,0,0,0,1.0,1,1.0,1,1.0,1,0.35298044278017815,40
1927,4,25913,25913,0,0,0,0,1.0,1,1.0,1,1.0,1,0.369699630432499,41
1928,7,25920,25920,0,0,0,0,1.0,1,1.0,1,1.0,1,0.41498008445557805,41
1929,8,25928,25928,0,0,0,0,1.0,1,1.0,1,1.0,1,0.3521183833714038,40
1930,5,25933,25933,0,0,0,0,1.0,1,1.0,1,1.0,1,0.4153888814364971,40
1931,6,25939,25939,0,0,0,0,1.0,1,1.0,1,1.0,1,0.44176590890286294,40
1932,2,25941,25941,0,0,0,0,1.0,1,1.0,1,1.0,1,0.4255237450760662,40
1933,5,25946,25946,0,0,0,0,1.0,1,1.0,1,1.0,1,0.4227093354097954,42
1934,6,25952,25952,0,0,0,0,1.0,1,1.0,1,1.0,1,0.40488848176998954,44
1935,11,25963,25963,0,0,0,0,1.0,1,1.0,1,1.0,1,0.3309654480826628,44
1936,6,25969,25969,0,0,0,0,1.0,1,1.0,1,1.0,1,0.36265243874806435,46
1937,16,25985,25985,0,0,0,0,1.0,1,1.0,1,1.0,1,0.28388547905962247,47
1938,6,25991,25991,0,0,0,0,1.0,1,1.0,1,1.0,1,0.21000706918184017,47
1939,8,25999,25999,0,0,0,0,1.0,1,1.0,1,1.0,1,0.2846879750067385,47
1940,13,26012,26012,0,0,0,0,1.0,1,1.0,1,1.0,1,0.2819719605029506,47
1941,16,26028,26028,0,0,0,0,1.0,1,1.0,1,1.0,1,0.21226501712939683,47
1942,10,26038,26038,0,0,0,0,1.0,1,1.0,1,1.0,1,0.25998768550289914,49
1943,13,26051,26051,0,0,0,0,1.0,1,1.0,1,1.0,1,0.30695546139695473,47
1944,17,26068,26068,0,0,0,0,1.0,1,1.0,1,1.0,1,0.29490123852091304,47
1945,15,26083,26083,0,0,0,0,1.0,1,1.0,1,1.0,1,0.36348755188582066,45
1946,10,26093,26093,0,0,0,0,1.0,1,1.0,1,1.0,1,0.3848668344285467,45
1947,22,26115,26115,0,0,0,0,1.0,1,1.0,1,1.0,1,0.2819025882407083,45
1948,11,26126,26126,0,0,0,0,1.0,1,1.0,1,1.0,1,0.32031808003545714,45
1949,10,26136,26136,0,0,0,0,1.0,1,1.0,1,1.0,1,0.311603358033723,42
1950,15,26151,26151,0,0,0,0,1.0,1,1.0,1,1.0,1,0.2492503328728082,42
1951,12,26163,26163,0,0,0,0,1.0,1,1.0,1,1.0,1,0.30194770913598384,38
1952,9,26172,26172,0,0,0,0,1.0,1,1.0,1,1.0,1,0.3221167749595418,36
1953,13,26185,26185,0,0,0,0,1.0,1,1.0,1,1.0,1,0.3066087901926833,35
1954,14,26199,26199,0,0,0,0,1.0,1,1.0,1,1.0,1,0.3714892011341393,32
1955,13,26212,26212,0,0,0,0,1.0,1,1.0,1,1.0,1,0.30362873196372286,33
1956,16,26228,26228,0,0,0,0,1.0,1,1.0,1,1.0,1,0.2859781258652044,31
1957,11,26239,26239,0,0,0,0,1.0,1,1.0,1,1.0,1,0.32486084279692123,33
1958,18,26257,26257,0,0,0,0,1.0,1,1.0,1,1.0,1,0.32215543076094316,34
1959,13,26270,26270,0,0,0,0,1.0,1,1.0,1,1.0,1,0.39544222495841874,35
1960,14,26284,26284,0,0,0,0,1.0,1,1.0,1,1.0,1,0.37638138718838104,36
1961,10,26294,26294,0,0,0,0,1.0,1,1.0,1,1.0,1,0.22628963590270648,36
1962,10,26304,26304,0,0,0,0,1.0,1,1.0,1,1.0,1,0.29849621758873657,35
1963,9,26313,26313,0,0,0,0,1.0,1,1.0,1,1.0,1,0.31494138984067344,36
1964,13,26326,26326,0,0,0,0,1.0,1,1.0,1,1.0,1,0.3571554820406324,35
1965,5,26331,26331,0,0,0,0,1.0,1,1.0,1,1.0,1,0.3035886922697294,36
1966,6,26337,26337,0,0,0,0,1.0,1,1.0,1,1.0,1,0.2701728451032635,36
1967,7,26344,26344,0,0,0,0,1.0,1,1.0,1,1.0,1,0.2984821982298388,36
1968,7,26351,26351,0,0,0,0,1.0,1,1.0,1,1.0,1,0.3080766725102024,37
1969,6,26357,26357,0,0,0,0,1.0,1,1.0,1,1.0,1,0.2582202578075512,37
1970,3,26360,26360,0,0,0,0,1.0,1,1.0,1,1.0,1,0.31651499178558745,38
1971,5,26365,26365,0,0,0,0,1.0,1,1.0,1,1.0,1,0.3312607988282217,37
1972,6,26371,26371,0,0,0,0,1.0,1,1.0,1,1.0,1,0.23057083425678124,37
1973,9,26380,26380,0,0,0,0,1.0,1,1.0,1,1.0,1,0.2824919334570642,37
1974,11,26391,26391,0,0,0,0,1.0,1,1.0,1,1.0,1,0.3643907930728478,38
1975,12,26403,26403,0,0,0,0,1.0,1,1.0,1,1.0,1,0.27742398427335124,37
1976,13,26416,26416,0,0,0,0,1.0,1,1.0,1,1.0,1,0.2714533742202126,39
1977,8,26424,26424,0,0,0,0,1.0,1,1.0,1,1.0,1,0.31763907390385615,42
1978,12,26436,26436,0,0,0,0,1.0,1,1.0,1,1.0,1,0.31211088070306187,42
1979,16,26452,26452,0,0,0,0,1.0,1,1.0,1,1.0,1,0.2862835802127912,42
1980,9,26461,26461,0,0,0,0,1.0,1,1.0,1,1.0,1,0.2975198915836174,43
1981,9,26470,26470,0,0,0,0,1.0,1,1.0,1,1.0,1,0.30848197643537956,44
1982,4,26474,26474,0,0,0,0,1.0,1,1.0,1,1.0,1,0.30921127217442373,44
1983,8,26482,26482,0,0,0,0,1.0,1,1.0,1,1.0,1,0.3946969068067951,44
1984,4,26486,26486,0,0,0,0,1.0,1,1.0,1,1.0,1,0.3883048358020259,42
1985,7,26493,26493,0,0,0,0,1.0,1,1.0,1,1.0,1,0.41334897520748964,41
1986,15,26508,26508,0,0,0,0,1.0,1,1.0,1,1.0,1,0.4547954279448813,40
1987,10,26518,26518,0,0,0,0,1.0,1,1.0,1,1.0,1,0.41808557878685665,37
1988,19,26537,26537,0,0,0,0,1.0,1,1.0,1,1.0,1,0.3944705844441729,35
1989,9,26546,26546,0,0,0,0,1.0,1,1.0,1,1.0,1,0.4118774555034803,32
1990,17,26563,26563,0,0,0,0,1.0,1,1.0,1,1.0,1,0.4310908034052566,31
1991,5,26568,26568,0,0,0,0,1.0,1,1.0,1,1.0,1,0.45997348881478295,32
1992,10,26578,26578,0,0,0,0,1.0,1,1.0,1,1.0,1,0.33729862343305334,32
1993,8,26586,26586,0,0,0,0,1.0,1,1.0,1,1.0,1,0.4820343643885287,32
1994,12,26598,26598,0,0,0,0,1.0,1,1.0,1,1.0,1,0.3468245802946934,31
1995,12,26610,26610,0,0,0,0,1.0,1,1.0,1,1.0,1,0.425324265089876,32
1996,13,26623,26623,0,0,0,0,1.0,1,1.0,1,1.0,1,0.42058137341164614,32
1997,13,26636,26636,0,0,0,0,1.0,1,1.0,1,1.0,1,0.4796835161293846,31
1998,10,26646,26646,0,0,0,0,1.0,1,1.0,1,1.0,1,0.34909827170171165,32
1999,12,26658,26658,0,0,0,0,1.0,1,1.0,1,1.0,1,0.4740524404360685,31
2000,8,26666,26666,0,0,0,0,1.0,1,1.0,1,1.0,1,0.5474184675654988,30
2001,18,26684,26684,0,0,0,0,1.0,1,1.0,1,1.0,1,0.5245318067701948,29
2002,14,26698,26698,0,0,0,0,1.0,1,1.0,1,1.0,1,0.35994374575029414,31
2003,12,26710,26710,0,0,0,0,1.0,1,1.0,1,1.0,1,0.363956573277271,33
2004,14,26724,26724,0,0,0,0,1.0,1,1.0,1,1.0,1,0.4402960377612694,34
2005,16,26740,26740,0,0,0,0,1.0,1,1.0,1,1.0,1,0.49270800227444445,35
2006,20,26760,26760,0,0,0,0,1.0,1,1.0,1,1.0,1,0.38709431143756284,36
2007,8,26768,26768,0,0,0,0,1.0,1,1.0,1,1.0,1,0.4065813521170185,36
2008,11,26779,26779,0,0,0,0,1.0,1,1.0,1,1.0,1,0.27509998378064277,36
2009,13,26792,26792,0,0,0,0,1.0,1,1.0,1,1.0,1,0.31369595724383803,37
2010,9,26801,26801,0,0,0,0,1.0,1,1.0,1,1.0,1,0.4034358534965416,37
2011,9,26810,26810,0,0,0,0,1.0,1,1.0,1,1.0,1,0.3280379865873839,37
2012,11,26821,26821,0,0,0,0,1.0,1,1.0,1,1.0,1,0.3903286693901504,37
2013,8,26829,26829,0,0,0,0,1.0,1,1.0,1,1.0,1,0.2740091284759535,39
2014,12,26841,26841,0,0,0,0,1.0,1,1.0,1,1.0,1,0.3751915817881319,39
2015,8,26849,26849,0,0,0,0,1.0,1,1.0,1,1.0,1,0.43862929196109235,39
2016,23,26872,26872,0,0,0,0,1.0,1,1.0,1,1.0,1,0.3265466304041589,41
2017,18,26890,26890,0,0,0,0,1.0,1,1.0,1,1.0,1,0.2454208157387386,41
2018,18,26908,26908,0,0,0,0,1.0,1,1.0,1,1.0,1,0.21909954810724755,42
2019,13,26921,26921,0,0,0,0,1.0,1,1.0,1,1.0,1,0.21013008451768897,43
2020,11,26932,26932,0,0,0,0,1.0,1,1.0,1,1.0,1,0.24706351124921494,43
2021,7,26939,26939,0,0,0,0,1.0,1,1.0,1,1.0,1,0.35751344954003234,43
2022,14,26953,26953,0,0,0,0,1.0,1,1.0,1,1.0,1,0.39203025243774753,44
2023,5,26958,26958,0,0,0,0,1.0,1,1.0,1,1.0,1,0.3626943839668668,42
2024,17,26975,26975,0,0,0,0,1.0,1,1.0,1,1.0,1,0.3234747796644049,41
2025,10,26985,26985,0,0,0,0,1.0,1,1.0,1,1.0,1,0.4309707600888199,39
2026,20,27005,27005,0,0,0,0,1.0,1,1.0,1,1.0,1,0.31878061631320825,39
2027,9,27014,27014,0,0,0,0,1.0,1,1.0,1,1.0,1,0.41379681962963977,38
2028,13,27027,27027,0,0,0,0,1.0,1,1.0,1,1.0,1,0.32172294807748636,37
2029,7,27034,27034,0,0,0,0,1.0,1,1.0,1,1.0,1,0.35757958708898674,35
2030,10,27044,27044,0,0,0,0,1.0,1,1.0,1,1.0,1,0.3278686073533662,32
2031,16,27060,27060,0,0,0,0,1.0,1,1.0,1,1.0,1,0.3007916927087051,34
2032,11,27071,27071,0,0,0,0,1.0,1,1.0,1,1.0,1,0.29377234849084294,35
2033,14,27085,27085,0,0,0,0,1.0,1,1.0,1,1.0,1,0.3314572345597865,35
2034,18,27103,27103,0,0,0,0,1.0,1,1.0,1,1.0,1,0.3565942246058966,35
2035,12,27115,27115,0,0,0,0,1.0,1,1.0,1,1.0,1,0.43869703621629147,36
2036,19,27134,27134,0,0,0,0,1.0,1,1.0,1,1.0,1,0.41756264394487397,35
2037,13,27147,27147,0,0,0,0,1.0,1,1.0,1,1.0,1,0.2982897011944424,36
2038,9,27156,27156,0,0,0,0,1.0,1,1.0,1,1.0,1,0.3864451427347018,38
2039,4,27160,27160,0,0,0,0,1.0,1,1.0,1,1.0,1,0.37496262746420667,38
2040,12,27172,27172,0,0,0,0,1.0,1,1.0,1,1.0,1,0.3854213478243863,37
2041,5,27177,27177,0,0,0,0,1.0,1,1.0,1,1.0,1,0.45875987981895905,38
2042,14,27191,27191,0,0,0,0,1.0,1,1.0,1,1.0,1,0.37379987458548986,38
2043,7,27198,27198,0,0,0,0,1.0,1,1.0,1,1.0,1,0.45093240409082685,38
2044,8,27206,27206,0,0,0,0,1.0,1,1.0,1,1.0,1,0.4950901155309085,39
2045,9,27215,27215,0,0,0,0,1.0,1,1.0,1,1.0,1,0.4308782520454777,40
2046,18,27233,27233,0,0,0,0,1.0,1,1.0,1,1.0,1,0.46196290639894644,41
2047,13,27246,27246,0,0,0,0,1.0,1,1.0,1,1.0,1,0.33800627148451656,41
2048,14,27260,27260,0,0,0,0,1.0,1,1.0,1,1.0,1,0.31842217666926975,43
2049,17,27277,27277,0,0,0,0,1.0,1,1.0,1,1.0,1,0.35338692022629903,43
2050,11,27288,27288,0,0,0,0,1.0,1,1.0,1,1.0,1,0.21496872662121502,43
2051,10,27298,27298,0,0,0,0,1.0,1,1.0,1,1.0,1,0.2507571642229015,43
2052,11,27309,27309,0,0,0,0,1.0,1,1.0,1,1.0,1,0.2805397319857638,44
2053,14,27323,27323,0,0,0,0,1.0,1,1.0,1,1.0,1,0.27264568836692493,43
2054,17,27340,27340,0,0,0,0,1.0,1,1.0,1,1.0,1,0.3527121475159926,44
2055,4,27344,27344,0,0,0,0,1.0,1,1.0,1,1.0,1,0.3201347397307738,43
2056,12,27356,27356,0,0,0,0,1.0,1,1.0,1,1.0,1,0.2976649803795707,44
2057,16,27372,27372,0,0,0,0,1.0,1,1.0,1,1.0,1,0.39092645437510715,44
2058,11,27383,27383,0,0,0,0,1.0,1,1.0,1,1.0,1,0.32278694930491575,44
2059,15,27398,27398,0,0,0,0,1.0,1,1.0,1,1.0,1,0.28761541113212213,45
2060,9,27407,27407,0,0,0,0,1.0,1,1.0,1,1.0,1,0.2535574527113906,46
2061,15,27422,27422,0,0,0,0,1.0,1,1.0,1,1.0,1,0.35126152337947336,48
2062,14,27436,27436,0,0,0,0,1.0,1,1.0,1,1.0,1,0.2679771482767528,48
2063,9,27445,27445,0,0,0,0,1.0,1,1.0,1,1.0,1,0.24331036229923128,45
2064,8,27453,27453,0,0,0,0,1.0,1,1.0,1,1.0,1,0.28353662809439917,44
2065,10,27463,27463,0,0,0,0,1.0,1,1.0,1,1.0,1,0.22375358518315852,42
2066,14,27477,27477,0,0,0,0,1.0,1,1.0,1,1.0,1,0.22956586704905063,42
2067,12,27489,27489,0,0,0,0,1.0,1,1.0,1,1.0,1,0.35983305286027434,38
2068,20,27509,27509,0,0,0,0,1.0,1,1.0,1,1.0,1,0.3537318175814301,37
2069,13,27522,27522,0,0,0,0,1.0,1,1.0,1,1.0,1,0.35727925786810844,35
2070,14,27536,27536,0,0,0,0,1.0,1,1.0,1,1.0,1,0.4018353586018719,35
2071,8,27544,27544,0,0,0,0,1.0,1,1.0,1,1.0,1,0.35045350703855654,34
2072,12,27556,27556,0,0,0,0,1.0,1,1.0,1,1.0,1,0.39009751444278346,35
2073,17,27573,27573,0,0,0,0,1.0,1,1.0,1,1.0,1,0.40095366144042777,37
2074,19,27592,27592,0,0,0,0,1.0,1,1.0,1,1.0,1,0.3321501877548148,36
2075,15,27607,27607,0,0,0,0,1.0,1,1.0,1,1.0,1,0.29478845317171015,38
2076,24,27631,27631,0,0,0,0,1.0,1,1.0,1,1.0,1,0.4188839900169724,37
2077,10,27641,27641,0,0,0,0,1.0,1,1.0,1,1.0,1,0.38019298016351283,37
2078,28,27669,27669,0,0,0,0,1.0,1,1.0,1,1.0,1,0.36860091816836377,37
2079,12,27681,27681,0,0,0,0,1.0,1,1.0,1,1.0,1,0.3165232707796495,37
2080,19,27700,27700,0,0,0,0,1.0,1,1.0,1,1.0,1,0.20247376316239052,36
2081,12,27712,27712,0,0,0,0,1.0,1,1.0,1,1.0,1,0.19654166320326097,37
2082,15,27727,27727,0,0,0,0,1.0,1,1.0,1,1.0,1,0.17469812485704952,38
2083,11,27738,27738,0,0,0,0,1.0,1,1.0,1,1.0,1,0.3404187624513745,39
2084,10,27748,27748,0,0,0,0,1.0,1,1.0,1,1.0,1,0.2997384373082583,41
2085,12,27760,27760,0,0,0,0,1.0,1,1.0,1,1.0,1,0.2700156078009517,41
2086,9,27769,27769,0,0,0,0,1.0,1,1.0,1,1.0,1,0.23293090768376534,44
2087,16,27785,27785,0,0,0,0,1.0,1,1.0,1,1.0,1,0.27530365048827493,44
2088,8,27793,27793,0,0,0,0,1.0,1,1.0,1,1.0,1,0.2734832997032684,45
2089,9,27802,27802,0,0,0,0,1.0,1,1.0,1,1.0,1,0.3777098479260793,46
2090,10,27812,27812,0,0,0,0,1.0,1,1.0,1,1.0,1,0.39722115059634727,47
2091,16,27828,27828,0,0,0,0,1.0,1,1.0,1,1.0,1,0.37820874862214876,48
2092,13,27841,27841,0,0,0,0,1.0,1,1.0,1,1.0,1,0.2838366657487256,48
2093,13,27854,27854,0,0,0,0,1.0,1,1.0,1,1.0,1,0.31836203758703513,48
2094,10,27864,27864,0,0,0,0,1.0,1,1.0,1,1.0,1,0.42693173200041545,47
2095,13,27877,27877,0,0,0,0,1.0,1,1.0,1,1.0,1,0.3280334851551884,49
2096,11,27888,27888,0,0,0,0,1.0,1,1.0,1,1.0,1,0.36464040239333334,50
2097,12,27900,27900,0,0,0,0,1.0,1,1.0,1,1.0,1,0.36238664024704176,50
2098,13,27913,27913,0,0,0,0,1.0,1,1.0,1,1.0,1,0.41003296256607663,51
2099,10,27923,27923,0,0,0,0,1.0,1,1.0,1,1.0,1,0.36370150274649365,50
2100,9,27932,27932,0,0,0,0,1.0,1,1.0,1,1.0,1,0.32174102758749257,49
2101,12,27944,27944,0,0,0,0,1.0,1,1.0,1,1.0,1,0.36191826361047336,48
2102,14,27958,27958,0,0,0,0,1.0,1,1.0,1,1.0,1,0.37511946501202803,49
2103,16,27974,27974,0,0,0,0,1.0,1,1.0,1,1.0,1,0.39737513345803727,44
2104,12,27986,27986,0,0,0,0,1.0,1,1.0,1,1.0,1,0.34419991131088773,42
2105,12,27998,27998,0,0,0,0,1.0,1,1.0,1,1.0,1,0.37239007864443446,40
2106,12,28010,28010,0,0,0,0,1.0,1,1.0,1,1.0,1,0.4373671557257459,39
2107,13,28023,28023,0,0,0,0,1.0,1,1.0,1,1.0,1,0.44481228065780637,37
2108,9,28032,28032,0,0,0,0,1.0,1,1.0,1,1.0,1,0.3891020935107708,37
2109,14,28046,28046,0,0,0,0,1.0,1,1.0,1,1.0,1,0.45100718639433324,36
2110,8,28054,28054,0,0,0,0,1.0,1,1.0,1,1.0,1,0.470304328885805,35
2111,12,28066,28066,0,0,0,0,1.0,1,1.0,1,1.0,1,0.47796147996982435,35
2112,5,28071,28071,0,0,0,0,1.0,1,1.0,1,1.0,1,0.45951475685553056,35
2113,11,28082,28082,0,0,0,0,1.0,1,1.0,1,1.0,1,0.49940933839496765,35
2114,11,28093,28093,0,0,0,0,1.0,1,1.0,1,1.0,1,0.48632475975176714,36
2115,17,28110,28110,0,0,0,0,1.0,1,1.0,1,1.0,1,0.4263808694111353,37
2116,11,28121,28121,0,0,0,0,1.0,1,1.0,1,1.0,1,0.4752158645221884,39
2117,13,28134,28134,0,0,0,0,1.0,1,1.0,1,1.0,1,0.4290027129622195,39
2118,8,28142,28142,0,0,0,0,1.0,1,1.0,1,1.0,1,0.39889588140992693,41
2119,14,28156,28156,0,0,0,0,1.0,1,1.0,1,1.0,1,0.5158165780783435,42
2120,9,28165,28165,0,0,0,0,1.0,1,1.0,1,1.0,1,0.5202728969020889,42
2121,17,28182,28182,0,0,0,0,1.0,1,1.0,1,1.0,1,0.5582647729911808,42
2122,8,28190,28190,0,0,0,0,1.0,1,1.0,1,1.0,1,0.5090722008683064,43
2123,12,28202,28202,0,0,0,0,1.0,1,1.0,1,1.0,1,0.5469355045144862,42
2124,9,28211,28211,0,0,0,0,1.0,1,1.0,1,1.0,1,0.5434460881256854,42
2125,7,28218,28218,0,0,0,0,1.0,1,1.0,1,1.0,1,0.5451291067732993,41
2126,10,28228,28228,0,0,0,0,1.0,1,1.0,1,1.0,1,0.5153392254341579,41
2127,4,28232,28232,0,0,0,0,1.0,1,1.0,1,1.0,1,0.6291701190387124,41
2128,13,28245,28245,0,0,0,0,1.0,1,1.0,1,1.0,1,0.4893009607004956,42
2129,11,28256,28256,0,0,0,0,1.0,1,1.0,1,1.0,1,0.4072531402906873,43
2130,13,28269,28269,0,0,0,0,1.0,1,1.0,1,1.0,1,0.36653074132091346,45
2131,15,28284,28284,0,0,0,0,1.0,1,1.0,1,1.0,1,0.4124638227938711,44
2132,14,28298,28298,0,0,0,0,1.0,1,1.0,1,1.0,1,0.3779415811260685,44
2133,15,28313,28313,0,0,0,0,1.0,1,1.0,1,1.0,1,0.2812787885616283,45
2134,13,28326,28326,0,0,0,0,1.0,1,1.0,1,1.0,1,0.1963049380803115,45
2135,23,28349,28349,0,0,0,0,1.0,1,1.0,1,1.0,1,0.2331974949264877,46
2136,16,28365,28365,0,0,0,0,1.0,1,1.0,1,1.0,1,0.2816814682577255,47
2137,15,28380,28380,0,0,0,0,1.0,1,1.0,1,1.0,1,0.21994635789286018,47
2138,12,28392,28392,0,0,0,0,1.0,1,1.0,1,1.0,1,0.26223761940876283,45
2139,6,28398,28398,0,0,0,0,1.0,1,1.0,1,1.0,1,0.19511520355389075,45
2140,16,28414,28414,0,0,0,0,1.0,1,1.0,1,1.0,1,0.23198500992933824,44
2141,11,28425,28425,0,0,0,0,1.0,1,1.0,1,1.0,1,0.23493178395108294,45
2142,13,28438,28438,0,0,0,0,1.0,1,1.0,1,1.0,1,0.22227536472826637,46
2143,19,28457,28457,0,0,0,0,1.0,1,1.0,1,1.0,1,0.22850593236466274,46
2144,17,28474,28474,0,0,0,0,1.0,1,1.0,1,1.0,1,0.28103224903957114,48
2145,14,28488,28488,0,0,0,0,1.0,1,1.0,1,1.0,1,0.21269507864394796,46
2146,18,28506,28506,0,0,0,0,1.0,1,1.0,1,1.0,1,0.2929342898142997,45
2147,17,28523,28523,0,0,0,0,1.0,1,1.0,1,1.0,1,0.20319054584062132,44
2148,16,28539,28539,0,0,0,0,1.0,1,1.0,1,1.0,1,0.30523051532742196,44
2149,18,28557,28557,0,0,0,0,1.0,1,1.0,1,1.0,1,0.2838005724335687,42
2150,13,28570,28570,0,0,0,0,1.0,1,1.0,1,1.0,1,0.3107250064903159,40
2151,12,28582,28582,0,0,0,0,1.0,1,1.0,1,1.0,1,0.3781496561508275,39
2152,14,28596,28596,0,0,0,0,1.0,1,1.0,1,1.0,1,0.3554702782611117,40
2153,22,28618,28618,0,0,0,0,1.0,1,1.0,1,1.0,1,0.32041287081888686,42
2154,13,28631,28631,0,0,0,0,1.0,1,1.0,1,1.0,1,0.2913337034388693,42
2155,9,28640,28640,0,0,0,0,1.0,1,1.0,1,1.0,1,0.35452830648903044,41
2156,12,28652,28652,0,0,0,0,1.0,1,1.0,1,1.0,1,0.3308140208986177,40
2157,5,28657,28657,0,0,0,0,1.0,1,1.0,1,1.0,1,0.4096740807116445,40
2158,14,28671,28671,0,0,0,0,1.0,1,1.0,1,1.0,1,0.35191876617832973,38
2159,14,28685,28685,0,0,0,0,1.0,1,1.0,1,1.0,1,0.34437345713392514,38
2160,13,28698,28698,0,0,0,0,1.0,1,1.0,1,1.0,1,0.37240658101876134,38
2161,20,28718,28718,0,0,0,0,1.0,1,1.0,1,1.0,1,0.3506913110452819,38
2162,7,28725,28725,0,0,0,0,1.0,1,1.0,1,1.0,1,0.32076278450106854,38
2163,14,28739,28739,0,0,0,0,1.0,1,1.0,1,1.0,1,0.2932444383676256,40
2164,8,28747,28747,0,0,0,0,1.0,1,1.0,1,1.0,1,0.2105048042125798,41
2165,12,28759,28759,0,0,0,0,1.0,1,1.0,1,1.0,1,0.2531870199228218,42
2166,7,28766,28766,0,0,0,0,1.0,1,1.0,1,1.0,1,0.23590397673313918,42
2167,5,28771,28771,0,0,0,0,1.0,1,1.0,1,1.0,1,0.24282757267626942,43
2168,8,28779,28779,0,0,0,0,1.0,1,1.0,1,1.0,1,0.22833089832756498,43
2169,9,28788,28788,0,0,0,0,1.0,1,1.0,1,1.0,1,0.2441576388011245,45
2170,10,28798,28798,0,0,0,0,1.0,1,1.0,1,1.0,1,0.24372514646003857,46
2171,9,28807,28807,0,0,0,0,1.0,1,1.0,1,1.0,1,0.22134136972135918,48
2172,17,28824,28824,0,0,0,0,1.0,1,1.0,1,1.0,1,0.23633006209691845,49
2173,11,28835,28835,0,0,0,0,1.0,1,1.0,1,1.0,1,0.27129744660551397,49
2174,24,28859,28859,0,0,0,0,1.0,1,1.0,1,1.0,1,0.23158257889558617,49
2175,13,28872,28872,0,0,0,0,1.0,1,1.0,1,1.0,1,0.24995463339117246,49
2176,16,28888,28888,0,0,0,0,1.0,1,1.0,1,1.0,1,0.32810299294967127,51
2177,19,28907,28907,0,0,0,0,1.0,1,1.0,1,1.0,1,0.29004418253527425,51
2178,11,28918,28918,0,0,0,0,1.0,1,1.0,1,1.0,1,0.24838425737469377,50
2179,13,28931,28931,0,0,0,0,1.0,1,1.0,1,1.0,1,0.289284246157325,49
2180,13,28944,28944,0,0,0,0,1.0,1,1.0,1,1.0,1,0.38936552497229515,47
2181,11,28955,28955,0,0,0,0,1.0,1,1.0,1,1.0,1,0.4054046827377488,47
2182,13,28968,28968,0,0,0,0,1.0,1,1.0,1,1.0,1,0.4054067784054562,45
2183,17,28985,28985,0,0,0,0,1.0,1,1.0,1,1.0,1,0.36624471697621125,44
2184,15,29000,29000,0,0,0,0,1.0,1,1.0,1,1.0,1,0.33434673249050606,43
2185,13,29013,29013,0,0,0,0,1.0,1,1.0,1,1.0,1,0.2993117029137494,40
2186,12,29025,29025,0,0,0,0,1.0,1,1.0,1,1.0,1,0.42631796140104944,38
2187,17,29042,29042,0,0,0,0,1.0,1,1.0,1,1.0,1,0.39554936383400974,35
2188,8,29050,29050,0,0,0,0,1.0,1,1.0,1,1.0,1,0.5121982925259011,34
2189,17,29067,29067,0,0,0,0,1.0,1,1.0,1,1.0,1,0.48313746257638895,31
2190,16,29083,29083,0,0,0,0,1.0,1,1.0,1,1.0,1,0.4377487565336882,29
2191,9,29092,29092,0,0,0,0,1.0,1,1.0,1,1.0,1,0.4815030588114987,28
2192,14,29106,29106,0,0,0,0,1.0,1,1.0,1,1.0,1,0.49355017037916427,29
2193,17,29123,29123,0,0,0,0,1.0,1,1.0,1,1.0,1,0.3051265977006198,28
2194,16,29139,29139,0,0,0,0,1.0,1,1.0,1,1.0,1,0.4680098920359445,27
2195,17,29156,29156,0,0,0,0,1.0,1,1.0,1,1.0,1,0.4320880183365139,27
2196,12,29168,29168,0,0,0,0,1.0,1,1.0,1,1.0,1,0.45586166807604706,27
2197,10,29178,29178,0,0,0,0,1.0,1,1.0,1,1.0,1,0.5108398613390299,27
2198,5,29183,29183,0,0,0,0,1.0,1,1.0,1,1.0,1,0.5486591326093238,28
2199,11,29194,29194,0,0,0,0,1.0,1,1.0,1,1.0,1,0.49108630879020193,29
2200,12,29206,29206,0,0,0,0,1.0,1,1.0,1,1.0,1,0.4697474116295558,31
2201,14,29220,29220,0,0,0,0,1.0,1,1.0,1,1.0,1,0.5548716564259624,32
2202,20,29240,29240,0,0,0,0,1.0,1,1.0,1,1.0,1,0.4703589134803945,31
2203,18,29258,29258,0,0,0,0,1.0,1,1.0,1,1.0,1,0.4352840477404523,32
2204,16,29274,29274,0,0,0,0,1.0,1,1.0,1,1.0,1,0.4597410037377159,32
2205,11,29285,29285,0,0,0,0,1.0,1,1.0,1,1.0,1,0.4339254318523748,33
2206,12,29297,29297,0,0,0,0,1.0,1,1.0,1,1.0,1,0.5045784307672657,32
2207,11,29308,29308,0,0,0,0,1.0,1,1.0,1,1.0,1,0.4398097796349662,33
2208,13,29321,29321,0,0,0,0,1.0,1,1.0,1,1.0,1,0.4432505457886286,35
2209,17,29338,29338,0,0,0,0,1.0,1,1.0,1,1.0,1,0.5090726797818906,36
2210,15,29353,29353,0,0,0,0,1.0,1,1.0,1,1.0,1,0.3525488768284365,35
2211,15,29368,29368,0,0,0,0,1.0,1,1.0,1,1.0,1,0.30466330224983124,36
2212,12,29380,29380,0,0,0,0,1.0,1,1.0,1,1.0,1,0.3531453241032403,37
2213,14,29394,29394,0,0,0,0,1.0,1,1.0,1,1.0,1,0.30458465505187954,37
2214,17,29411,29411,0,0,0,0,1.0,1,1.0,1,1.0,1,0.30208273102135913,39
2215,12,29423,29423,0,0,0,0,1.0,1,1.0,1,1.0,1,0.2945115188626062,36
2216,14,29437,29437,0,0,0,0,1.0,1,1.0,1,1.0,1,0.3678719320654771,37
2217,12,29449,29449,0,0,0,0,1.0,1,1.0,1,1.0,1,0.37130378397598357,35
2218,7,29456,29456,0,0,0,0,1.0,1,1.0,1,1.0,1,0.41310765433254076,35
2219,6,29462,29462,0,0,0,0,1.0,1,1.0,1,1.0,1,0.41172156325212217,33
2220,6,29468,29468,0,0,0,0,1.0,1,1.0,1,1.0,1,0.4925679135951507,31
2221,5,29473,29473,0,0,0,0,1.0,1,1.0,1,1.0,1,0.5095921339344324,31
2222,8,29481,29481,0,0,0,0,1.0,1,1.0,1,1.0,1,0.3921315025700595,30
2223,14,29495,29495,0,0,0,0,1.0,1,1.0,1,1.0,1,0.5878330291339385,28
2224,11,29506,29506,0,0,0,0,1.0,1,1.0,1,1.0,1,0.36295051072081785,29
2225,13,29519,29519,0,0,0,0,1.0,1,1.0,1,1.0,1,0.39874514899835495,28
2226,12,29531,29531,0,0,0,0,1.0,1,1.0,1,1.0,1,0.3571611249903945,30
2227,19,29550,29550,0,0,0,0,1.0,1,1.0,1,1.0,1,0.4454182845595484,28
2228,14,29564,29564,0,0,0,0,1.0,1,1.0,1,1.0,1,0.3692533324148627,29
2229,14,29578,29578,0,0,0,0,1.0,1,1.0,1,1.0,1,0.45136584066865815,28
2230,12,29590,29590,0,0,0,0,1.0,1,1.0,1,1.0,1,0.3495254273705733,28
2231,7,29597,29597,0,0,0,0,1.0,1,1.0,1,1.0,1,0.46733105190863644,27
2232,8,29605,29605,0,0,0,0,1.0,1,1.0,1,1.0,1,0.47378980468768556,27
2233,11,29616,29616,0,0,0,0,1.0,1,1.0,1,1.0,1,0.38155512489637133,28
2234,6,29622,29622,0,0,0,0,1.0,1,1.0,1,1.0,1,0.44652119666301177,26
2235,8,29630,29630,0,0,0,0,1.0,1,1.0,1,1.0,1,0.39540868859327954,26
2236,13,29643,29643,0,0,0,0,1.0,1,1.0,1,1.0,1,0.23997601871735544,26
2237,10,29653,29653,0,0,0,0,1.0,1,1.0,1,1.0,1,0.40251923290168057,26
2238,11,29664,29664,0,0,0,0,1.0,1,1.0,1,1.0,1,0.4225612111349272,27
2239,8,29672,29672,0,0,0,0,1.0,1,1.0,1,1.0,1,0.37985117210554686,28
2240,18,29690,29690,0,0,0,0,1.0,1,1.0,1,1.0,1,0.4029946216725565,30
2241,10,29700,29700,0,0,0,0,1.0,1,1.0,1,1.0,1,0.35053432959715014,29
2242,14,29714,29714,0,0,0,0,1.0,1,1.0,1,1.0,1,0.38295379917749856,29
2243,4,29718,29718,0,0,0,0,1.0,1,1.0,1,1.0,1,0.43238717421961176,29
2244,7,29725,29725,0,0,0,0,1.0,1,1.0,1,1.0,1,0.44770965354601433,29
2245,5,29730,29730,0,0,0,0,1.0,1,1.0,1,1.0,1,0.4413771356932659,30
2246,11,29741,29741,0,0,0,0,1.0,1,1.0,1,1.0,1,0.4155098713853745,33
2247,12,29753,29753,0,0,0,0,1.0,1,1.0,1,1.0,1,0.369406781457989,34
2248,11,29764,29764,0,0,0,0,1.0,1,1.0,1,1.0,1,0.36435765784576124,34
2249,4,29768,29768,0,0,0,0,1.0,1,1.0,1,1.0,1,0.47103826636278173,35
2250,8,29776,29776,0,0,0,0,1.0,1,1.0,1,1.0,1,0.5100255917382951,35
2251,8,29784,29784,0,0,0,0,1.0,1,1.0,1,1.0,1,0.4904532730077876,36
2252,12,29796,29796,0,0,0,0,1.0,1,1.0,1,1.0,1,0.39084338123162077,37
2253,21,29817,29817,0,0,0,0,1.0,1,1.0,1,1.0,1,0.352315088513846,35
2254,7,29824,29824,0,0,0,0,1.0,1,1.0,1,1.0,1,0.39142170565898504,33
2255,13,29837,29837,0,0,0,0,1.0,1,1.0,1,1.0,1,0.41406645437284284,35
2256,13,29850,29850,0,0,0,0,1.0,1,1.0,1,1.0,1,0.48529979848889265,34
2257,20,29870,29870,0,0,0,0,1.0,1,1.0,1,1.0,1,0.36250101566519444,36
2258,14,29884,29884,0,0,0,0,1.0,1,1.0,1,1.0,1,0.4607238409917412,35
2259,8,29892,29892,0,0,0,0,1.0,1,1.0,1,1.0,1,0.3735509815152027,35
2260,12,29904,29904,0,0,0,0,1.0,1,1.0,1,1.0,1,0.47199459464546356,33
2261,13,29917,29917,0,0,0,0,1.0,1,1.0,1,1.0,1,0.4655287127588612,33
2262,7,29924,29924,0,0,0,0,1.0,1,1.0,1,1.0,1,0.44720866768555634,32
2263,9,29933,29933,0,0,0,0,1.0,1,1.0,1,1.0,1,0.4232011159912078,31
2264,10,29943,29943,0,0,0,0,1.0,1,1.0,1,1.0,1,0.41728095630489614,30
2265,11,29954,29954,0,0,0,0,1.0,1,1.0,1,1.0,1,0.4141266974671814,29
2266,9,29963,29963,0,0,0,0,1.0,1,1.0,1,1.0,1,0.2817181993584413,30
2267,12,29975,29975,0,0,0,0,1.0,1,1.0,1,1.0,1,0.28969686665552974,29
2268,20,29995,29995,0,0,0,0,1.0,1,1.0,1,1.0,1,0.3057044227386639,30
2269,8,30003,30003,0,0,0,0,1.0,1,1.0,1,1.0,1,0.28614803364198615,31
2270,13,30016,30016,0,0,0,0,1.0,1,1.0,1,1.0,1,0.26704449832707783,31
2271,13,30029,30029,0,0,0,0,1.0,1,1.0,1,1.0,1,0.26055598403738295,31
2272,14,30043,30043,0,0,0,0,1.0,1,1.0,1,1.0,1,0.2726365524578826,31
2273,7,30050,30050,0,0,0,0,1.0,1,1.0,1,1.0,1,0.30109896337540937,30
2274,13,30063,30063,0,0,0,0,1.0,1,1.0,1,1.0,1,0.35483021924989877,31
2275,15,30078,30078,0,0,0,0,1.0,1,1.0,1,1.0,1,0.24726888526803278,32
2276,8,30086,30086,0,0,0,0,1.0,1,1.0,1,1.0,1,0.35837656757164366,31
2277,8,30094,30094,0,0,0,0,1.0,1,1.0,1,1.0,1,0.3738793206861554,31
2278,9,30103,30103,0,0,0,0,1.0,1,1.0,1,1.0,1,0.4193091403760946,32
2279,7,30110,30110,0,0,0,0,1.0,1,1.0,1,1.0,1,0.4268670673788559,32
2280,7,30117,30117,0,0,0,0,1.0,1,1.0,1,1.0,1,0.42027764155142766,33
2281,7,30124,30124,0,0,0,0,1.0,1,1.0,1,1.0,1,0.41648334888461414,34
2282,12,30136,30136,0,0,0,0,1.0,1,1.0,1,1.0,1,0.36611903318006306,34
2283,12,30148,30148,0,0,0,0,1.0,1,1.0,1,1.0,1,0.3025083707365393,34
2284,8,30156,30156,0,0,0,0,1.0,1,1.0,1,1.0,1,0.29978411372510727,34
2285,19,30175,30175,0,0,0,0,1.0,1,1.0,1,1.0,1,0.3069803036557769,35
2286,9,30184,30184,0,0,0,0,1.0,1,1.0,1,1.0,1,0.3285051187434321,34
2287,12,30196,30196,0,0,0,0,1.0,1,1.0,1,1.0,1,0.33172333753215305,35
2288,8,30204,30204,0,0,0,0,1.0,1,1.0,1,1.0,1,0.4227501111660648,35
2289,9,30213,30213,0,0,0,0,1.0,1,1.0,1,1.0,1,0.3007310520026914,37
2290,10,30223,30223,0,0,0,0,1.0,1,1.0,1,1.0,1,0.30450098714134155,37
2291,12,30235,30235,0,0,0,0,1.0,1,1.0,1,1.0,1,0.27169815173574474,35
2292,8,30243,30243,0,0,0,0,1.0,1,1.0,1,1.0,1,0.285020440602991,35
2293,1,30244,30244,0,0,0,0,1.0,1,1.0,1,1.0,1,0.35848335466801373,34
2294,7,30251,30251,0,0,0,0,1.0,1,1.0,1,1.0,1,0.3456565608434799,33
2295,9,30260,30260,0,0,0,0,1.0,1,1.0,1,1.0,1,0.39769857694304644,34
2296,4,30264,30264,0,0,0,0,1.0,1,1.0,1,1.0,1,0.4099695628938718,33
2297,11,30275,30275,0,0,0,0,1.0,1,1.0,1,1.0,1,0.45532808216008214,32
2298,7,30282,30282,0,0,0,0,1.0,1,1.0,1,1.0,1,0.3988470345117783,32
2299,6,30288,30288,0,0,0,0,1.0,1,1.0,1,1.0,1,0.40863851444307076,33
2300,10,30298,30298,0,0,0,0,1.0,1,1.0,1,1.0,1,0.34725014395113213,33
2301,5,30303,30303,0,0,0,0,1.0,1,1.0,1,1.0,1,0.4176491510627164,33
2302,9,30312,30312,0,0,0,0,1.0,1,1.0,1,1.0,1,0.4890600747808281,34
2303,5,30317,30317,0,0,0,0,1.0,1,1.0,1,1.0,1,0.4770488299007447,34
2304,6,30323,30323,0,0,0,0,1.0,1,1.0,1,1.0,1,0.5023552202778172,33
2305,6,30329,30329,0,0,0,0,1.0,1,1.0,1,1.0,1,0.49728192958428485,33
2306,9,30338,30338,0,0,0,0,1.0,1,1.0,1,1.0,1,0.5171728064672212,33
2307,10,30348,30348,0,0,0,0,1.0,1,1.0,1,1.0,1,0.37888556631307085,35
2308,9,30357,30357,0,0,0,0,1.0,1,1.0,1,1.0,1,0.4159722651570762,34
2309,8,30365,30365,0,0,0,0,1.0,1,1.0,1,1.0,1,0.409051324440408,34
2310,8,30373,30373,0,0,0,0,1.0,1,1.0,1,1.0,1,0.49906089879124954,34
2311,8,30381,30381,0,0,0,0,1.0,1,1.0,1,1.0,1,0.3553725690359393,35
2312,10,30391,30391,0,0,0,0,1.0,1,1.0,1,1.0,1,0.3754698004911075,34
2313,17,30408,30408,0,0,0,0,1.0,1,1.0,1,1.0,1,0.49069595880028044,35
2314,5,30413,30413,0,0,0,0,1.0,1,1.0,1,1.0,1,0.5092583002767458,35
2315,23,30436,30436,0,0,0,0,1.0,1,1.0,1,1.0,1,0.5488605779611319,34
2316,10,30446,30446,0,0,0,0,1.0,1,1.0,1,1.0,1,0.48241455572615266,35
2317,13,30459,30459,0,0,0,0,1.0,1,1.0,1,1.0,1,0.4368945828818466,32
2318,12,30471,30471,0,0,0,0,1.0,1,1.0,1,1.0,1,0.44705412688088714,32
2319,5,30476,30476,0,0,0,0,1.0,1,1.0,1,1.0,1,0.39276378422115815,32
2320,10,30486,30486,0,0,0,0,1.0,1,1.0,1,1.0,1,0.41895142067379243,32
2321,12,30498,30498,0,0,0,0,1.0,1,1.0,1,1.0,1,0.37980173347758994,33
2322,6,30504,30504,0,0,0,0,1.0,1,1.0,1,1.0,1,0.4900157953788723,33
2323,4,30508,30508,0,0,0,0,1.0,1,1.0,1,1.0,1,0.3984912173264924,33
2324,9,30517,30517,0,0,0,0,1.0,1,1.0,1,1.0,1,0.39606414039290777,34
2325,9,30526,30526,0,0,0,0,1.0,1,1.0,1,1.0,1,0.40204410469322294,35
2326,10,30536,30536,0,0,0,0,1.0,1,1.0,1,1.0,1,0.37958425162201537,35
2327,10,30546,30546,0,0,0,0,1.0,1,1.0,1,1.0,1,0.40152549333815996,36
2328,16,30562,30562,0,0,0,0,1.0,1,1.0,1,1.0,1,0.3363410958603699,37
2329,10,30572,30572,0,0,0,0,1.0,1,1.0,1,1.0,1,0.3200987920822677,37
2330,9,30581,30581,0,0,0,0,1.0,1,1.0,1,1.0,1,0.34516938226514815,38
2331,17,30598,30598,0,0,0,0,1.0,1,1.0,1,1.0,1,0.3610187667033141,40
2332,11,30609,30609,0,0,0,0,1.0,1,1.0,1,1.0,1,0.296909686242035,40
2333,6,30615,30615,0,0,0,0,1.0,1,1.0,1,1.0,1,0.4088358234578837,41
2334,6,30621,30621,0,0,0,0,1.0,1,1.0,1,1.0,1,0.398861915444802,41
2335,7,30628,30628,0,0,0,0,1.0,1,1.0,1,1.0,1,0.3728204514117282,41
2336,12,30640,30640,0,0,0,0,1.0,1,1.0,1,1.0,1,0.46478675012809784,41
2337,16,30656,30656,0,0,0,0,1.0,1,1.0,1,1.0,1,0.37485468348024165,42
2338,16,30672,30672,0,0,0,0,1.0,1,1.0,1,1.0,1,0.39255615656993703,43
2339,11,30683,30683,0,0,0,0,1.0,1,1.0,1,1.0,1,0.32631743009418146,43
2340,22,30705,30705,0,0,0,0,1.0,1,1.0,1,1.0,1,0.29957835952499545,45
2341,17,30722,30722,0,0,0,0,1.0,1,1.0,1,1.0,1,0.30538940411355553,45
2342,21,30743,30743,0,0,0,0,1.0,1,1.0,1,1.0,1,0.32655565634384376,46
2343,25,30768,30768,0,0,0,0,1.0,1,1.0,1,1.0,1,0.30800113285722125,45
2344,20,30788,30788,0,0,0,0,1.0,1,1.0,1,1.0,1,0.33411532711865705,44
2345,16,30804,30804,0,0,0,0,1.0,1,1.0,1,1.0,1,0.3839899510826187,44
2346,19,30823,30823,0,0,0,0,1.0,1,1.0,1,1.0,1,0.41220384619844075,44
2347,11,30834,30834,0,0,0,0,1.0,1,1.0,1,1.0,1,0.35212312552407726,44
2348,19,30853,30853,0,0,0,0,1.0,1,1.0,1,1.0,1,0.2480633766754847,45
2349,13,30866,30866,0,0,0,0,1.0,1,1.0,1,1.0,1,0.3955375418152128,46
2350,10,30876,30876,0,0,0,0,1.0,1,1.0,1,1.0,1,0.4056063902660582,47
2351,14,30890,30890,0,0,0,0,1.0,1,1.0,1,1.0,1,0.37224753495385066,47
2352,14,30904,30904,0,0,0,0,1.0,1,1.0,1,1.0,1,0.3485336050955098,47
2353,8,30912,30912,0,0,0,0,1.0,1,1.0,1,1.0,1,0.37083355598423706,46
2354,16,30928,30928,0,0,0,0,1.0,1,1.0,1,1.0,1,0.4436500415226297,47
2355,11,30939,30939,0,0,0,0,1.0,1,1.0,1,1.0,1,0.3744659645876848,47
2356,8,30947,30947,0,0,0,0,1.0,1,1.0,1,1.0,1,0.34225051819093616,47
2357,13,30960,30960,0,0,0,0,1.0,1,1.0,1,1.0,1,0.4082074265302242,47
2358,14,30974,30974,0,0,0,0,1.0,1,1.0,1,1.0,1,0.3308882689010365,48
2359,16,30990,30990,0,0,0,0,1.0,1,1.0,1,1.0,1,0.40706394867313456,49
2360,19,31009,31009,0,0,0,0,1.0,1,1.0,1,1.0,1,0.37363491244284724,49
2361,9,31018,31018,0,0,0,0,1.0,1,1.0,1,1.0,1,0.3820650174250943,50
2362,25,31043,31043,0,0,0,0,1.0,1,1.0,1,1.0,1,0.3898535378287371,51
2363,19,31062,31062,0,0,0,0,1.0,1,1.0,1,1.0,1,0.3284010441008698,51
2364,16,31078,31078,0,0,0,0,1.0,1,1.0,1,1.0,1,0.3801183449494265,52
2365,24,31102,31102,0,0,0,0,1.0,1,1.0,1,1.0,1,0.343764488069597,53
2366,28,31130,31130,0,0,0,0,1.0,1,1.0,1,1.0,1,0.3967817520126207,54
2367,18,31148,31148,0,0,0,0,1.0,1,1.0,1,1.0,1,0.4736041933378141,52
2368,16,31164,31164,0,0,0,0,1.0,1,1.0,1,1.0,1,0.42748500733365563,51
2369,14,31178,31178,0,0,0,0,1.0,1,1.0,1,1.0,1,0.44168232985128697,51
2370,19,31197,31197,0,0,0,0,1.0,1,1.0,1,1.0,1,0.38849301034190103,52
2371,8,31205,31205,0,0,0,0,1.0,1,1.0,1,1.0,1,0.33378313211869237,52
2372,11,31216,31216,0,0,0,0,1.0,1,1.0,1,1.0,1,0.3298688380516937,49
2373,13,31229,31229,0,0,0,0,1.0,1,1.0,1,1.0,1,0.2837480878521221,47
2374,11,31240,31240,0,0,0,0,1.0,1,1.0,1,1.0,1,0.3638427241475147,45
2375,9,31249,31249,0,0,0,0,1.0,1,1.0,1,1.0,1,0.35091284985869253,45
2376,12,31261,31261,0,0,0,0,1.0,1,1.0,1,1.0,1,0.3756807260469676,43
2377,10,31271,31271,0,0,0,0,1.0,1,1.0,1,1.0,1,0.3787948156933123,44
2378,19,31290,31290,0,0,0,0,1.0,1,1.0,1,1.0,1,0.3267546558818009,43
2379,8,31298,31298,0,0,0,0,1.0,1,1.0,1,1.0,1,0.29631524678886323,43
2380,7,31305,31305,0,0,0,0,1.0,1,1.0,1,1.0,1,0.40303407399788127,43
2381,8,31313,31313,0,0,0,0,1.0,1,1.0,1,1.0,1,0.3827487011815596,44
2382,5,31318,31318,0,0,0,0,1.0,1,1.0,1,1.0,1,0.42172079294734877,44
2383,11,31329,31329,0,0,0,0,1.0,1,1.0,1,1.0,1,0.32419756225792146,45
2384,9,31338,31338,0,0,0,0,1.0,1,1.0,1,1.0,1,0.3230060444803834,45
2385,11,31349,31349,0,0,0,0,1.0,1,1.0,1,1.0,1,0.37011797922782674,45
2386,8,31357,31357,0,0,0,0,1.0,1,1.0,1,1.0,1,0.2452605733138025,46
2387,15,31372,31372,0,0,0,0,1.0,1,1.0,1,1.0,1,0.38149241583977866,44
2388,7,31379,31379,0,0,0,0,1.0,1,1.0,1,1.0,1,0.340368797934448,44
2389,19,31398,31398,0,0,0,0,1.0,1,1.0,1,1.0,1,0.29173470834664283,43
2390,21,31419,31419,0,0,0,0,1.0,1,1.0,1,1.0,1,0.4089312749743834,44
2391,13,31432,31432,0,0,0,0,1.0,1,1.0,1,1.0,1,0.4158772976802999,43
2392,19,31451,31451,0,0,0,0,1.0,1,1.0,1,1.0,1,0.4062237645776974,44
2393,21,31472,31472,0,0,0,0,1.0,1,1.0,1,1.0,1,0.3324178150966179,45
2394,21,31493,31493,0,0,0,0,1.0,1,1.0,1,1.0,1,0.33702604877331044,44
2395,15,31508,31508,0,0,0,0,1.0,1,1.0,1,1.0,1,0.35195131780885347,44
2396,18,31526,31526,0,0,0,0,1.0,1,1.0,1,1.0,1,0.36790248588431634,45
2397,27,31553,31553,0,0,0,0,1.0,1,1.0,1,1.0,1,0.32094720928167125,44
2398,15,31568,31568,0,0,0,0,1.0,1,1.0,1,1.0,1,0.352443571557233,44
2399,15,31583,31583,0,0,0,0,1.0,1,1.0,1,1.0,1,0.3959427419103723,45
2400,6,31589,31589,0,0,0,0,1.0,1,1.0,1,1.0,1,0.34291126455927684,45
2401,15,31604,31604,0,0,0,0,1.0,1,1.0,1,1.0,1,0.24593334783638535,46
2402,10,31614,31614,0,0,0,0,1.0,1,1.0,1,1.0,1,0.3072481554783504,47
2403,12,31626,31626,0,0,0,0,1.0,1,1.0,1,1.0,1,0.23242078776023012,48
2404,10,31636,31636,0,0,0,0,1.0,1,1.0,1,1.0,1,0.25351397407248627,47
2405,10,31646,31646,0,0,0,0,1.0,1,1.0,1,1.0,1,0.28591949332626515,45
2406,11,31657,31657,0,0,0,0,1.0,1,1.0,1,1.0,1,0.2450128272329065,45
2407,8,31665,31665,0,0,0,0,1.0,1,1.0,1,1.0,1,0.2672648700381817,42
2408,12,31677,31677,0,0,0,0,1.0,1,1.0,1,1.0,1,0.34918731388704843,41
2409,16,31693,31693,0,0,0,0,1.0,1,1.0,1,1.0,1,0.3755430414909344,41
2410,14,31707,31707,0,0,0,0,1.0,1,1.0,1,1.0,1,0.22381605915119773,40
2411,9,31716,31716,0,0,0,0,1.0,1,1.0,1,1.0,1,0.28358434921440007,40
2412,5,31721,31721,0,0,0,0,1.0,1,1.0,1,1.0,1,0.3175428000123542,38
2413,5,31726,31726,0,0,0,0,1.0,1,1.0,1,1.0,1,0.27742635473052424,38
2414,9,31735,31735,0,0,0,0,1.0,1,1.0,1,1.0,1,0.3098305331212775,36
2415,7,31742,31742,0,0,0,0,1.0,1,1.0,1,1.0,1,0.38741256725096285,36
2416,12,31754,31754,0,0,0,0,1.0,1,1.0,1,1.0,1,0.3134354222366204,35
2417,10,31764,31764,0,0,0,0,1.0,1,1.0,1,1.0,1,0.37586958779945884,33
2418,12,31776,31776,0,0,0,0,1.0,1,1.0,1,1.0,1,0.4465031037073962,33
2419,7,31783,31783,0,0,0,0,1.0,1,1.0,1,1.0,1,0.3848755799654199,33
2420,14,31797,31797,0,0,0,0,1.0,1,1.0,1,1.0,1,0.4542563699237132,34
2421,18,31815,31815,0,0,0,0,1.0,1,1.0,1,1.0,1,0.5045444472605924,34
2422,11,31826,31826,0,0,0,0,1.0,1,1.0,1,1.0,1,0.45604982894818236,35
2423,12,31838,31838,0,0,0,0,1.0,1,1.0,1,1.0,1,0.5089649780124219,36
2424,14,31852,31852,0,0,0,0,1.0,1,1.0,1,1.0,1,0.4563084507426247,35
2425,9,31861,31861,0,0,0,0,1.0,1,1.0,1,1.0,1,0.4482312892547551,33
2426,15,31876,31876,0,0,0,0,1.0,1,1.0,1,1.0,1,0.38919144422208624,34
2427,19,31895,31895,0,0,0,0,1.0,1,1.0,1,1.0,1,0.4097973680877188,34
2428,11,31906,31906,0,0,0,0,1.0,1,1.0,1,1.0,1,0.41658067922084985,34
2429,15,31921,31921,0,0,0,0,1.0,1,1.0,1,1.0,1,0.43988859940627484,34
2430,10,31931,31931,0,0,0,0,1.0,1,1.0,1,1.0,1,0.42911866687545586,33
2431,6,31937,31937,0,0,0,0,1.0,1,1.0,1,1.0,1,0.4693919027355895,33
2432,9,31946,31946,0,0,0,0,1.0,1,1.0,1,1.0,1,0.5013935172255304,33
2433,8,31954,31954,0,0,0,0,1.0,1,1.0,1,1.0,1,0.4307709979490583,34
2434,11,31965,31965,0,0,0,0,1.0,1,1.0,1,1.0,1,0.2882791286421127,34
2435,7,31972,31972,0,0,0,0,1.0,1,1.0,1,1.0,1,0.3780199926485013,34
2436,10,31982,31982,0,0,0,0,1.0,1,1.0,1,1.0,1,0.3516902686303799,33
2437,7,31989,31989,0,0,0,0,1.0,1,1.0,1,1.0,1,0.38464594985525286,33
2438,6,31995,31995,0,0,0,0,1.0,1,1.0,1,1.0,1,0.39458122512251625,34
2439,7,32002,32002,0,0,0,0,1.0,1,1.0,1,1.0,1,0.45920934565089266,35
2440,7,32009,32009,0,0,0,0,1.0,1,1.0,1,1.0,1,0.49888314820482194,35
2441,7,32016,32016,0,0,0,0,1.0,1,1.0,1,1.0,1,0.4156441676389127,35
2442,8,32024,32024,0,0,0,0,1.0,1,1.0,1,1.0,1,0.4811915584083101,35
2443,7,32031,32031,0,0,0,0,1.0,1,1.0,1,1.0,1,0.5078310870639856,35
2444,10,32041,32041,0,0,0,0,1.0,1,1.0,1,1.0,1,0.3979781290820215,34
2445,9,32050,32050,0,0,0,0,1.0,1,1.0,1,1.0,1,0.40429322914018856,33
2446,10,32060,32060,0,0,0,0,1.0,1,1.0,1,1.0,1,0.390550833854327,30
2447,6,32066,32066,0,0,0,0,1.0,1,1.0,1,1.0,1,0.4100441067486162,29
2448,12,32078,32078,0,0,0,0,1.0,1,1.0,1,1.0,1,0.36101706810181927,27
2449,10,32088,32088,0,0,0,0,1.0,1,1.0,1,1.0,1,0.34391389514370635,26
2450,13,32101,32101,0,0,0,0,1.0,1,1.0,1,1.0,1,0.32801318728882706,28
2451,11,32112,32112,0,0,0,0,1.0,1,1.0,1,1.0,1,0.3739192192743377,28
2452,16,32128,32128,0,0,0,0,1.0,1,1.0,1,1.0,1,0.3477080471319371,29
2453,10,32138,32138,0,0,0,0,1.0,1,1.0,1,1.0,1,0.30602952849707105,30
2454,15,32153,32153,0,0,0,0,1.0,1,1.0,1,1.0,1,0.2567567540305215,32
2455,18,32171,32171,0,0,0,0,1.0,1,1.0,1,1.0,1,0.3784057488796779,33
2456,16,32187,32187,0,0,0,0,1.0,1,1.0,1,1.0,1,0.42116620002631194,34
2457,12,32199,32199,0,0,0,0,1.0,1,1.0,1,1.0,1,0.3698032498073004,34
2458,8,32207,32207,0,0,0,0,1.0,1,1.0,1,1.0,1,0.4212532943067479,36
2459,12,32219,32219,0,0,0,0,1.0,1,1.0,1,1.0,1,0.3256079513768764,36
2460,8,32227,32227,0,0,0,0,1.0,1,1.0,1,1.0,1,0.40029753735607126,37
2461,7,32234,32234,0,0,0,0,1.0,1,1.0,1,1.0,1,0.39690684054181824,37
2462,8,32242,32242,0,0,0,0,1.0,1,1.0,1,1.0,1,0.44467593884651535,38
2463,9,32251,32251,0,0,0,0,1.0,1,1.0,1,1.0,1,0.46029226393139455,38
2464,18,32269,32269,0,0,0,0,1.0,1,1.0,1,1.0,1,0.4192541462745533,37
2465,18,32287,32287,0,0,0,0,1.0,1,1.0,1,1.0,1,0.37309290915050447,36
2466,6,32293,32293,0,0,0,0,1.0,1,1.0,1,1.0,1,0.3276067157729197,36
2467,12,32305,32305,0,0,0,0,1.0,1,1.0,1,1.0,1,0.3267300992950941,34
2468,7,32312,32312,0,0,0,0,1.0,1,1.0,1,1.0,1,0.3949946362977379,33
2469,4,32316,32316,0,0,0,0,1.0,1,1.0,1,1.0,1,0.4268075535350946,32
2470,13,32329,32329,0,0,0,0,1.0,1,1.0,1,1.0,1,0.36625517440360583,33
2471,14,32343,32343,0,0,0,0,1.0,1,1.0,1,1.0,1,0.4532597324409445,31
2472,14,32357,32357,0,0,0,0,1.0,1,1.0,1,1.0,1,0.448691870831626,32
2473,10,32367,32367,0,0,0,0,1.0,1,1.0,1,1.0,1,0.4851243272428921,31
2474,18,32385,32385,0,0,0,0,1.0,1,1.0,1,1.0,1,0.5224601842098638,33
2475,8,32393,32393,0,0,0,0,1.0,1,1.0,1,1.0,1,0.5414538017118209,33
2476,11,32404,32404,0,0,0,0,1.0,1,1.0,1,1.0,1,0.445304430511303,33
2477,14,32418,32418,0,0,0,0,1.0,1,1.0,1,1.0,1,0.3368957916743101,33
2478,16,32434,32434,0,0,0,0,1.0,1,1.0,1,1.0,1,0.3327428067628011,33
2479,9,32443,32443,0,0,0,0,1.0,1,1.0,1,1.0,1,0.3776731717683863,33
2480,11,32454,32454,0,0,0,0,1.0,1,1.0,1,1.0,1,0.32586214796207763,34
2481,13,32467,32467,0,0,0,0,1.0,1,1.0,1,1.0,1,0.2920966978239792,33
2482,15,32482,32482,0,0,0,0,1.0,1,1.0,1,1.0,1,0.27145220159613126,34
2483,10,32492,32492,0,0,0,0,1.0,1,1.0,1,1.0,1,0.26915866126004023,33
2484,20,32512,32512,0,0,0,0,1.0,1,1.0,1,1.0,1,0.2624204563108192,32
2485,12,32524,32524,0,0,0,0,1.0,1,1.0,1,1.0,1,0.30120066167964815,31
2486,9,32533,32533,0,0,0,0,1.0,1,1.0,1,1.0,1,0.2751106239069536,29
2487,5,32538,32538,0,0,0,0,1.0,1,1.0,1,1.0,1,0.3398879511275862,29
2488,14,32552,32552,0,0,0,0,1.0,1,1.0,1,1.0,1,0.38347226679116103,30
2489,9,32561,32561,0,0,0,0,1.0,1,1.0,1,1.0,1,0.258106637458789,29
2490,11,32572,32572,0,0,0,0,1.0,1,1.0,1,1.0,1,0.3750081426809997,30
2491,16,32588,32588,0,0,0,0,1.0,1,1.0,1,1.0,1,0.3605787828522245,30
2492,6,32594,32594,0,0,0,0,1.0,1,1.0,1,1.0,1,0.43894492145697817,29
2493,11,32605,32605,0,0,0,0,1.0,1,1.0,1,1.0,1,0.4972108175620003,29
2494,4,32609,32609,0,0,0,0,1.0,1,1.0,1,1.0,1,0.4310957100563853,28
2495,10,32619,32619,0,0,0,0,1.0,1,1.0,1,1.0,1,0.5311421077169167,29
2496,6,32625,32625,0,0,0,0,1.0,1,1.0,1,1.0,1,0.5339266574540472,28
2497,3,32628,32628,0,0,0,0,1.0,1,1.0,1,1.0,1,0.42753445462802536,28
2498,14,32642,32642,0,0,0,0,1.0,1,1.0,1,1.0,1,0.2921897471310882,29
2499,15,32657,32657,0,0,0,0,1.0,1,1.0,1,1.0,1,0.3626064102349186,30
2500,10,32667,32667,0,0,0,0,1.0,1,1.0,1,1.0,1,0.37945910134564936,29
2501,17,32684,32684,0,0,0,0,1.0,1,1.0,1,1.0,1,0.37731991599316156,33
2502,17,32701,32701,0,0,0,0,1.0,1,1.0,1,1.0,1,0.24786372659052955,33
2503,15,32716,32716,0,0,0,0,1.0,1,1.0,1,1.0,1,0.3152230495591695,31
2504,15,32731,32731,0,0,0,0,1.0,1,1.0,1,1.0,1,0.22105690648387002,31
2505,6,32737,32737,0,0,0,0,1.0,1,1.0,1,1.0,1,0.2737300243665873,32
2506,7,32744,32744,0,0,0,0,1.0,1,1.0,1,1.0,1,0.21326681172941306,31
2507,5,32749,32749,0,0,0,0,1.0,1,1.0,1,1.0,1,0.2413302434118085,29
2508,9,32758,32758,0,0,0,0,1.0,1,1.0,1,1.0,1,0.23754509018587883,31
2509,5,32763,32763,0,0,0,0,1.0,1,1.0,1,1.0,1,0.25105036864991553,30
2510,3,32766,32766,0,0,0,0,1.0,1,1.0,1,1.0,1,0.23776113653958145,31
2511,6,32772,32772,0,0,0,0,1.0,1,1.0,1,1.0,1,0.2933957443736687,32
2512,11,32783,32783,0,0,0,0,1.0,1,1.0,1,1.0,1,0.3591745006152571,32
2513,13,32796,32796,0,0,0,0,1.0,1,1.0,1,1.0,1,0.3636323453497571,34
2514,13,32809,32809,0,0,0,0,1.0,1,1.0,1,1.0,1,0.37568098643299047,35
2515,14,32823,32823,0,0,0,0,1.0,1,1.0,1,1.0,1,0.395929919670384,35
2516,10,32833,32833,0,0,0,0,1.0,1,1.0,1,1.0,1,0.4438841524192884,34
2517,12,32845,32845,0,0,0,0,1.0,1,1.0,1,1.0,1,0.3914002971784533,34
2518,19,32864,32864,0,0,0,0,1.0,1,1.0,1,1.0,1,0.3916699720437448,33
2519,12,32876,32876,0,0,0,0,1.0,1,1.0,1,1.0,1,0.40028912543390965,32
2520,12,32888,32888,0,0,0,0,1.0,1,1.0,1,1.0,1,0.3611275142171295,31
2521,9,32897,32897,0,0,0,0,1.0,1,1.0,1,1.0,1,0.3797671783966314,31
2522,9,32906,32906,0,0,0,0,1.0,1,1.0,1,1.0,1,0.3919012887951905,30
2523,10,32916,32916,0,0,0,0,1.0,1,1.0,1,1.0,1,0.35620934300048085,30
2524,8,32924,32924,0,0,0,0,1.0,1,1.0,1,1.0,1,0.43073053183896337,29
2525,10,32934,32934,0,0,0,0,1.0,1,1.0,1,1.0,1,0.45283449826218136,29
2526,13,32947,32947,0,0,0,0,1.0,1,1.0,1,1.0,1,0.5211647972585817,27
2527,5,32952,32952,0,0,0,0,1.0,1,1.0,1,1.0,1,0.49794836872112685,28
2528,5,32957,32957,0,0,0,0,1.0,1,1.0,1,1.0,1,0.4861791295733574,28
2529,4,32961,32961,0,0,0,0,1.0,1,1.0,1,1.0,1,0.40095513463813587,28
2530,7,32968,32968,0,0,0,0,1.0,1,1.0,1,1.0,1,0.3913020075721482,29
2531,5,32973,32973,0,0,0,0,1.0,1,1.0,1,1.0,1,0.40210434201821416,30
2532,11,32984,32984,0,0,0,0,1.0,1,1.0,1,1.0,1,0.28047550165021456,31
2533,11,32995,32995,0,0,0,0,1.0,1,1.0,1,1.0,1,0.2801071000456496,31
2534,13,33008,33008,0,0,0,0,1.0,1,1.0,1,1.0,1,0.37341115103448025,31
2535,8,33016,33016,0,0,0,0,1.0,1,1.0,1,1.0,1,0.3663645800646956,31
2536,8,33024,33024,0,0,0,0,1.0,1,1.0,1,1.0,1,0.3776886286313544,32
2537,5,33029,33029,0,0,0,0,1.0,1,1.0,1,1.0,1,0.2663590594072017,33
2538,11,33040,33040,0,0,0,0,1.0,1,1.0,1,1.0,1,0.3537008276812262,35
2539,6,33046,33046,0,0,0,0,1.0,1,1.0,1,1.0,1,0.3996529444437231,37
2540,11,33057,33057,0,0,0,0,1.0,1,1.0,1,1.0,1,0.42012855516378933,38
2541,8,33065,33065,0,0,0,0,1.0,1,1.0,1,1.0,1,0.3100209791371485,39
2542,10,33075,33075,0,0,0,0,1.0,1,1.0,1,1.0,1,0.4280374579955707,38
2543,6,33081,33081,0,0,0,0,1.0,1,1.0,1,1.0,1,0.36806108687376465,41
2544,16,33097,33097,0,0,0,0,1.0,1,1.0,1,1.0,1,0.428072947897263,39
2545,14,33111,33111,0,0,0,0,1.0,1,1.0,1,1.0,1,0.39172513359386657,40
2546,7,33118,33118,0,0,0,0,1.0,1,1.0,1,1.0,1,0.3572482128980396,38
2547,14,33132,33132,0,0,0,0,1.0,1,1.0,1,1.0,1,0.49324429626928257,38
2548,4,33136,33136,0,0,0,0,1.0,1,1.0,1,1.0,1,0.494288878804887,35
2549,6,33142,33142,0,0,0,0,1.0,1,1.0,1,1.0,1,0.5487731447253374,35
2550,4,33146,33146,0,0,0,0,1.0,1,1.0,1,1.0,1,0.4476274297677902,33
2551,2,33148,33148,0,0,0,0,1.0,1,1.0,1,1.0,1,0.5604031842935197,31
2552,2,33150,33150,0,0,0,0,1.0,1,1.0,1,1.0,1,0.5907221742785332,30
2553,4,33154,33154,0,0,0,0,1.0,1,1.0,1,1.0,1,0.5753813291982194,30
2554,10,33164,33164,0,0,0,0,1.0,1,1.0,1,1.0,1,0.416549719939262,32
2555,12,33176,33176,0,0,0,0,1.0,1,1.0,1,1.0,1,0.4476127096307453,32
2556,6,33182,33182,0,0,0,0,1.0,1,1.0,1,1.0,1,0.4430220248911554,32
2557,16,33198,33198,0,0,0,0,1.0,1,1.0,1,1.0,1,0.5604808882891671,30
2558,8,33206,33206,0,0,0,0,1.0,1,1.0,1,1.0,1,0.5990840601256002,31
2559,12,33218,33218,0,0,0,0,1.0,1,1.0,1,1.0,1,0.548306291049429,30
2560,9,33227,33227,0,0,0,0,1.0,1,1.0,1,1.0,1,0.6271544723888591,30
2561,13,33240,33240,0,0,0,0,1.0,1,1.0,1,1.0,1,0.5691585845056975,30
2562,9,33249,33249,0,0,0,0,1.0,1,1.0,1,1.0,1,0.49195064055856064,33
2563,12,33261,33261,0,0,0,0,1.0,1,1.0,1,1.0,1,0.5706849968873998,33
2564,16,33277,33277,0,0,0,0,1.0,1,1.0,1,1.0,1,0.5586023228960805,33
2565,10,33287,33287,0,0,0,0,1.0,1,1.0,1,1.0,1,0.5136192713186147,33
2566,12,33299,33299,0,0,0,0,1.0,1,1.0,1,1.0,1,0.4887340247504843,35
2567,10,33309,33309,0,0,0,0,1.0,1,1.0,1,1.0,1,0.5438059588623386,36
2568,12,33321,33321,0,0,0,0,1.0,1,1.0,1,1.0,1,0.48003412537991336,37
2569,7,33328,33328,0,0,0,0,1.0,1,1.0,1,1.0,1,0.5658181774478492,37
2570,7,33335,33335,0,0,0,0,1.0,1,1.0,1,1.0,1,0.508138422656757,37
2571,5,33340,33340,0,0,0,0,1.0,1,1.0,1,1.0,1,0.49022559877712446,37
2572,6,33346,33346,0,0,0,0,1.0,1,1.0,1,1.0,1,0.4780876494883862,39
2573,6,33352,33352,0,0,0,0,1.0,1,1.0,1,1.0,1,0.5057695342642092,39
2574,3,33355,33355,0,0,0,0,1.0,1,1.0,1,1.0,1,0.4582811729234754,38
2575,7,33362,33362,0,0,0,0,1.0,1,1.0,1,1.0,1,0.6065210225029175,38
2576,11,33373,33373,0,0,0,0,1.0,1,1.0,1,1.0,1,0.5525070547690395,37
2577,6,33379,33379,0,0,0,0,1.0,1,1.0,1,1.0,1,0.616897580261532,39
2578,7,33386,33386,0,0,0,0,1.0,1,1.0,1,1.0,1,0.5104954258861925,40
2579,8,33394,33394,0,0,0,0,1.0,1,1.0,1,1.0,1,0.48078229303056325,41
2580,13,33407,33407,0,0,0,0,1.0,1,1.0,1,1.0,1,0.5543972137985843,42
2581,14,33421,33421,0,0,0,0,1.0,1,1.0,1,1.0,1,0.4436810742658018,43
2582,17,33438,33438,0,0,0,0,1.0,1,1.0,1,1.0,1,0.41181299240643354,43
2583,18,33456,33456,0,0,0,0,1.0,1,1.0,1,1.0,1,0.3112633697488933,43
2584,22,33478,33478,0,0,0,0,1.0,1,1.0,1,1.0,1,0.3263118163066551,43
2585,16,33494,33494,0,0,0,0,1.0,1,1.0,1,1.0,1,0.19403569257638337,44
2586,21,33515,33515,0,0,0,0,1.0,1,1.0,1,1.0,1,0.29547781920100136,43
2587,21,33536,33536,0,0,0,0,1.0,1,1.0,1,1.0,1,0.2794516995438374,44
2588,8,33544,33544,0,0,0,0,1.0,1,1.0,1,1.0,1,0.21702949046705095,44
2589,18,33562,33562,0,0,0,0,1.0,1,1.0,1,1.0,1,0.3799083499785091,44
2590,17,33579,33579,0,0,0,0,1.0,1,1.0,1,1.0,1,0.36905749304145347,44
2591,8,33587,33587,0,0,0,0,1.0,1,1.0,1,1.0,1,0.3336339154972678,44
2592,12,33599,33599,0,0,0,0,1.0,1,1.0,1,1.0,1,0.34852362319070257,44
2593,6,33605,33605,0,0,0,0,1.0,1,1.0,1,1.0,1,0.4193964810624049,43
2594,16,33621,33621,0,0,0,0,1.0,1,1.0,1,1.0,1,0.32925841349587626,48
2595,15,33636,33636,0,0,0,0,1.0,1,1.0,1,1.0,1,0.37097135242502766,45
2596,13,33649,33649,0,0,0,0,1.0,1,1.0,1,1.0,1,0.29850517159549517,46
2597,10,33659,33659,0,0,0,0,1.0,1,1.0,1,1.0,1,0.42801612830541963,45
2598,15,33674,33674,0,0,0,0,1.0,1,1.0,1,1.0,1,0.46169554762866216,45
2599,8,33682,33682,0,0,0,0,1.0,1,1.0,1,1.0,1,0.4160303040194369,45
2600,13,33695,33695,0,0,0,0,1.0,1,1.0,1,1.0,1,0.4765668378825175,48
2601,14,33709,33709,0,0,0,0,1.0,1,1.0,1,1.0,1,0.48901473286108593,47
2602,17,33726,33726,0,0,0,0,1.0,1,1.0,1,1.0,1,0.45943919154435525,48
2603,12,33738,33738,0,0,0,0,1.0,1,1.0,1,1.0,1,0.4339849393500041,48
2604,9,33747,33747,0,0,0,0,1.0,1,1.0,1,1.0,1,0.33142612409563615,47
2605,14,33761,33761,0,0,0,0,1.0,1,1.0,1,1.0,1,0.3789356013821319,47
2606,11,33772,33772,0,0,0,0,1.0,1,1.0,1,1.0,1,0.30664424927861506,46
2607,17,33789,33789,0,0,0,0,1.0,1,1.0,1,1.0,1,0.2609227321647772,45
2608,18,33807,33807,0,0,0,0,1.0,1,1.0,1,1.0,1,0.31081709831889864,45
2609,18,33825,33825,0,0,0,0,1.0,1,1.0,1,1.0,1,0.25330779401637754,44
2610,17,33842,33842,0,0,0,0,1.0,1,1.0,1,1.0,1,0.20783263563375431,45
2611,14,33856,33856,0,0,0,0,1.0,1,1.0,1,1.0,1,0.28224502117106315,46
2612,20,33876,33876,0,0,0,0,1.0,1,1.0,1,1.0,1,0.2883031299630061,47
2613,25,33901,33901,0,0,0,0,1.0,1,1.0,1,1.0,1,0.30779866389897725,48
2614,14,33915,33915,0,0,0,0,1.0,1,1.0,1,1.0,1,0.3632590219352834,48
2615,17,33932,33932,0,0,0,0,1.0,1,1.0,1,1.0,1,0.37196718999330514,49
2616,10,33942,33942,0,0,0,0,1.0,1,1.0,1,1.0,1,0.30130874381211026,49
2617,13,33955,33955,0,0,0,0,1.0,1,1.0,1,1.0,1,0.3122878863359617,48
2618,17,33972,33972,0,0,0,0,1.0,1,1.0,1,1.0,1,0.2709129010344428,47
2619,10,33982,33982,0,0,0,0,1.0,1,1.0,1,1.0,1,0.285581549586815,50
2620,10,33992,33992,0,0,0,0,1.0,1,1.0,1,1.0,1,0.30785677019959257,51
2621,14,34006,34006,0,0,0,0,1.0,1,1.0,1,1.0,1,0.24167184801242872,52
2622,9,34015,34015,0,0,0,0,1.0,1,1.0,1,1.0,1,0.302993727883328,52
2623,8,34023,34023,0,0,0,0,1.0,1,1.0,1,1.0,1,0.3290532058332749,53
2624,17,34040,34040,0,0,0,0,1.0,1,1.0,1,1.0,1,0.3589768385214371,51
2625,8,34048,34048,0,0,0,0,1.0,1,1.0,1,1.0,1,0.3405564464225873,50
2626,13,34061,34061,0,0,0,0,1.0,1,1.0,1,1.0,1,0.27979523617360363,49
2627,10,34071,34071,0,0,0,0,1.0,1,1.0,1,1.0,1,0.3028720767860195,48
2628,9,34080,34080,0,0,0,0,1.0,1,1.0,1,1.0,1,0.39165416711690754,48
2629,12,34092,34092,0,0,0,0,1.0,1,1.0,1,1.0,1,0.35667615072840403,47
2630,11,34103,34103,0,0,0,0,1.0,1,1.0,1,1.0,1,0.45750914254742325,47
2631,12,34115,34115,0,0,0,0,1.0,1,1.0,1,1.0,1,0.40351557378994085,47
2632,11,34126,34126,0,0,0,0,1.0,1,1.0,1,1.0,1,0.34747278354484,47
2633,16,34142,34142,0,0,0,0,1.0,1,1.0,1,1.0,1,0.34920407063905023,44
2634,19,34161,34161,0,0,0,0,1.0,1,1.0,1,1.0,1,0.3032775798003644,44
2635,20,34181,34181,0,0,0,0,1.0,1,1.0,1,1.0,1,0.40100646301761456,45
2636,20,34201,34201,0,0,0,0,1.0,1,1.0,1,1.0,1,0.2814646656748929,40
2637,16,34217,34217,0,0,0,0,1.0,1,1.0,1,1.0,1,0.37682745218619074,41
2638,13,34230,34230,0,0,0,0,1.0,1,1.0,1,1.0,1,0.3162942907322493,38
2639,13,34243,34243,0,0,0,0,1.0,1,1.0,1,1.0,1,0.346870348473954,39
2640,17,34260,34260,0,0,0,0,1.0,1,1.0,1,1.0,1,0.3608169472696754,38
2641,14,34274,34274,0,0,0,0,1.0,1,1.0,1,1.0,1,0.3333828283956762,37
2642,11,34285,34285,0,0,0,0,1.0,1,1.0,1,1.0,1,0.3829533917614436,38
2643,8,34293,34293,0,0,0,0,1.0,1,1.0,1,1.0,1,0.3489384790025781,37
2644,6,34299,34299,0,0,0,0,1.0,1,1.0,1,1.0,1,0.3293389738920729,36
2645,14,34313,34313,0,0,0,0,1.0,1,1.0,1,1.0,1,0.3648820315914311,35
2646,9,34322,34322,0,0,0,0,1.0,1,1.0,1,1.0,1,0.36307951039721653,35
2647,7,34329,34329,0,0,0,0,1.0,1,1.0,1,1.0,1,0.36492799540011794,35
2648,11,34340,34340,0,0,0,0,1.0,1,1.0,1,1.0,1,0.40551397716530846,36
2649,11,34351,34351,0,0,0,0,1.0,1,1.0,1,1.0,1,0.4764436573540735,37
2650,14,34365,34365,0,0,0,0,1.0,1,1.0,1,1.0,1,0.43280838620451884,39
2651,8,34373,34373,0,0,0,0,1.0,1,1.0,1,1.0,1,0.42574364669629694,39
2652,7,34380,34380,0,0,0,0,1.0,1,1.0,1,1.0,1,0.40664976249402407,39
2653,7,34387,34387,0,0,0,0,1.0,1,1.0,1,1.0,1,0.29739728846991276,39
2654,10,34397,34397,0,0,0,0,1.0,1,1.0,1,1.0,1,0.30550856242620983,40
2655,6,34403,34403,0,0,0,0,1.0,1,1.0,1,1.0,1,0.2866479021129135,40
2656,10,34413,34413,0,0,0,0,1.0,1,1.0,1,1.0,1,0.24376742626562198,39
2657,11,34424,34424,0,0,0,0,1.0,1,1.0,1,1.0,1,0.25566927140693113,40
2658,13,34437,34437,0,0,0,0,1.0,1,1.0,1,1.0,1,0.28142162099525514,41
2659,15,34452,34452,0,0,0,0,1.0,1,1.0,1,1.0,1,0.2941411005429715,41
2660,13,34465,34465,0,0,0,0,1.0,1,1.0,1,1.0,1,0.26706614248550126,40
2661,8,34473,34473,0,0,0,0,1.0,1,1.0,1,1.0,1,0.24402410717660153,40
2662,10,34483,34483,0,0,0,0,1.0,1,1.0,1,1.0,1,0.2910309440969041,42
2663,17,34500,34500,0,0,0,0,1.0,1,1.0,1,1.0,1,0.32493242570829134,41
2664,5,34505,34505,0,0,0,0,1.0,1,1.0,1,1.0,1,0.3225738574115866,42
2665,19,34524,34524,0,0,0,0,1.0,1,1.0,1,1.0,1,0.3508763562884702,43
2666,17,34541,34541,0,0,0,0,1.0,1,1.0,1,1.0,1,0.3194967850385561,44
2667,8,34549,34549,0,0,0,0,1.0,1,1.0,1,1.0,1,0.36802862850985035,42
2668,11,34560,34560,0,0,0,0,1.0,1,1.0,1,1.0,1,0.3468864669561206,41
2669,12,34572,34572,0,0,0,0,1.0,1,1.0,1,1.0,1,0.41717861293409575,42
2670,16,34588,34588,0,0,0,0,1.0,1,1.0,1,1.0,1,0.4079087383357698,40
2671,13,34601,34601,0,0,0,0,1.0,1,1.0,1,1.0,1,0.33454280906477857,39
2672,9,34610,34610,0,0,0,0,1.0,1,1.0,1,1.0,1,0.4009457394335092,36
2673,16,34626,34626,0,0,0,0,1.0,1,1.0,1,1.0,1,0.4356708390427797,35
2674,15,34641,34641,0,0,0,0,1.0,1,1.0,1,1.0,1,0.37725509415869607,33
2675,15,34656,34656,0,0,0,0,1.0,1,1.0,1,1.0,1,0.33708333704230475,34
2676,14,34670,34670,0,0,0,0,1.0,1,1.0,1,1.0,1,0.5285149758582387,32
2677,14,34684,34684,0,0,0,0,1.0,1,1.0,1,1.0,1,0.4062565284868023,33
2678,7,34691,34691,0,0,0,0,1.0,1,1.0,1,1.0,1,0.48471020592970193,33
2679,14,34705,34705,0,0,0,0,1.0,1,1.0,1,1.0,1,0.5379803014175909,32
2680,9,34714,34714,0,0,0,0,1.0,1,1.0,1,1.0,1,0.3895202556495741,32
2681,12,34726,34726,0,0,0,0,1.0,1,1.0,1,1.0,1,0.2949743028910484,32
2682,10,34736,34736,0,0,0,0,1.0,1,1.0,1,1.0,1,0.25829638792898335,33
2683,9,34745,34745,0,0,0,0,1.0,1,1.0,1,1.0,1,0.20042106930329465,32
2684,20,34765,34765,0,0,0,0,1.0,1,1.0,1,1.0,1,0.30640187529956736,31
2685,17,34782,34782,0,0,0,0,1.0,1,1.0,1,1.0,1,0.31864876622082505,31
2686,15,34797,34797,0,0,0,0,1.0,1,1.0,1,1.0,1,0.43535919987111127,30
2687,14,34811,34811,0,0,0,0,1.0,1,1.0,1,1.0,1,0.35348931336335976,30
2688,14,34825,34825,0,0,0,0,1.0,1,1.0,1,1.0,1,0.40472880097113273,30
2689,17,34842,34842,0,0,0,0,1.0,1,1.0,1,1.0,1,0.3377990525070074,31
2690,18,34860,34860,0,0,0,0,1.0,1,1.0,1,1.0,1,0.5594630770756553,31
2691,15,34875,34875,0,0,0,0,1.0,1,1.0,1,1.0,1,0.288171496758894,32
2692,17,34892,34892,0,0,0,0,1.0,1,1.0,1,1.0,1,0.3426887597710453,32
2693,19,34911,34911,0,0,0,0,1.0,1,1.0,1,1.0,1,0.3362166940577649,33
2694,6,34917,34917,0,0,0,0,1.0,1,1.0,1,1.0,1,0.2687193100313764,34
2695,13,34930,34930,0,0,0,0,1.0,1,1.0,1,1.0,1,0.39598854893728935,35
2696,5,34935,34935,0,0,0,0,1.0,1,1.0,1,1.0,1,0.3498904838335124,35
2697,7,34942,34942,0,0,0,0,1.0,1,1.0,1,1.0,1,0.27544859388708803,35
2698,6,34948,34948,0,0,0,0,1.0,1,1.0,1,1.0,1,0.362430468487158,36
2699,13,34961,34961,0,0,0,0,1.0,1,1.0,1,1.0,1,0.31847791853069046,36
2700,16,34977,34977,0,0,0,0,1.0,1,1.0,1,1.0,1,0.36783370600320603,37
2701,12,34989,34989,0,0,0,0,1.0,1,1.0,1,1.0,1,0.39918214501171195,37
2702,14,35003,35003,0,0,0,0,1.0,1,1.0,1,1.0,1,0.4186656828693666,37
2703,13,35016,35016,0,0,0,0,1.0,1,1.0,1,1.0,1,0.32943257224517375,38
2704,8,35024,35024,0,0,0,0,1.0,1,1.0,1,1.0,1,0.2699845122917142,37
2705,14,35038,35038,0,0,0,0,1.0,1,1.0,1,1.0,1,0.32315333968577653,36
2706,13,35051,35051,0,0,0,0,1.0,1,1.0,1,1.0,1,0.4199739419759235,36
2707,7,35058,35058,0,0,0,0,1.0,1,1.0,1,1.0,1,0.32593073147527746,35
2708,15,35073,35073,0,0,0,0,1.0,1,1.0,1,1.0,1,0.3291338402970876,36
2709,9,35082,35082,0,0,0,0,1.0,1,1.0,1,1.0,1,0.29999349749598864,32
2710,6,35088,35088,0,0,0,0,1.0,1,1.0,1,1.0,1,0.38708549194193637,29
2711,3,35091,35091,0,0,0,0,1.0,1,1.0,1,1.0,1,0.35182583702556325,29
2712,5,35096,35096,0,0,0,0,1.0,1,1.0,1,1.0,1,0.4519028329442977,28
2713,8,35104,35104,0,0,0,0,1.0,1,1.0,1,1.0,1,0.40354208674296316,28
2714,12,35116,35116,0,0,0,0,1.0,1,1.0,1,1.0,1,0.4043427625071054,26
2715,8,35124,35124,0,0,0,0,1.0,1,1.0,1,1.0,1,0.3711911089423174,24
2716,7,35131,35131,0,0,0,0,1.0,1,1.0,1,1.0,1,0.3448874747676022,24
2717,20,35151,35151,0,0,0,0,1.0,1,1.0,1,1.0,1,0.32578079324793197,25
2718,9,35160,35160,0,0,0,0,1.0,1,1.0,1,1.0,1,0.22524455465703552,25
2719,13,35173,35173,0,0,0,0,1.0,1,1.0,1,1.0,1,0.41769454054510036,25
2720,14,35187,35187,0,0,0,0,1.0,1,1.0,1,1.0,1,0.39697740244246205,25
2721,8,35195,35195,0,0,0,0,1.0,1,1.0,1,1.0,1,0.41972520338755087,25
2722,8,35203,35203,0,0,0,0,1.0,1,1.0,1,1.0,1,0.42074306731803846,26
2723,8,35211,35211,0,0,0,0,1.0,1,1.0,1,1.0,1,0.26381939087026557,26
2724,7,35218,35218,0,0,0,0,1.0,1,1.0,1,1.0,1,0.26780059988598315,27
2725,13,35231,35231,0,0,0,0,1.0,1,1.0,1,1.0,1,0.28133423169440014,28
2726,7,35238,35238,0,0,0,0,1.0,1,1.0,1,1.0,1,0.32839510923473364,28
2727,3,35241,35241,0,0,0,0,1.0,1,1.0,1,1.0,1,0.3878841609947613,29
2728,8,35249,35249,0,0,0,0,1.0,1,1.0,1,1.0,1,0.3992468622372859,29
2729,11,35260,35260,0,0,0,0,1.0,1,1.0,1,1.0,1,0.3129244217420945,29
2730,13,35273,35273,0,0,0,0,1.0,1,1.0,1,1.0,1,0.42091516039711774,29
2731,12,35285,35285,0,0,0,0,1.0,1,1.0,1,1.0,1,0.43784324494267596,30
2732,9,35294,35294,0,0,0,0,1.0,1,1.0,1,1.0,1,0.340612463833814,29
2733,11,35305,35305,0,0,0,0,1.0,1,1.0,1,1.0,1,0.38738793057869264,29
2734,11,35316,35316,0,0,0,0,1.0,1,1.0,1,1.0,1,0.3791929685854871,29
2735,7,35323,35323,0,0,0,0,1.0,1,1.0,1,1.0,1,0.361277602103769,29
2736,9,35332,35332,0,0,0,0,1.0,1,1.0,1,1.0,1,0.3312638117502009,30
2737,6,35338,35338,0,0,0,0,1.0,1,1.0,1,1.0,1,0.34895090643986554,30
2738,6,35344,35344,0,0,0,0,1.0,1,1.0,1,1.0,1,0.2630311086919131,30
2739,4,35348,35348,0,0,0,0,1.0,1,1.0,1,1.0,1,0.21190842727619844,29
2740,6,35354,35354,0,0,0,0,1.0,1,1.0,1,1.0,1,0.337482327926755,29
2741,2,35356,35356,0,0,0,0,1.0,1,1.0,1,1.0,1,0.33688670751413635,28
2742,2,35358,35358,0,0,0,0,1.0,1,1.0,1,1.0,1,0.3482637834089627,28
2743,2,35360,35360,0,0,0,0,1.0,1,1.0,1,1.0,1,0.4281116218692593,29
2744,3,35363,35363,0,0,0,0,1.0,1,1.0,1,1.0,1,0.3073161430707565,27
2745,1,35364,35364,0,0,0,0,1.0,1,1.0,1,1.0,1,0.23384983535979126,25
2746,3,35367,35367,0,0,0,0,1.0,1,1.0,1,1.0,1,0.28574636384836755,25
2747,4,35371,35371,0,0,0,0,1.0,1,1.0,1,1.0,1,0.28220085535036865,23
2748,4,35375,35375,0,0,0,0,1.0,1,1.0,1,1.0,1,0.3105207159244466,22
2749,3,35378,35378,0,0,0,0,1.0,1,1.0,1,1.0,1,0.30545450667306673,19
2750,6,35384,35384,0,0,0,0,1.0,1,1.0,1,1.0,1,0.35736484616857456,18
2751,2,35386,35386,0,0,0,0,1.0,1,1.0,1,1.0,1,0.5411307617119592,16
2752,2,35388,35388,0,0,0,0,1.0,1,1.0,1,1.0,1,0.40288325858287416,15
2753,2,35390,35390,0,0,0,0,1.0,1,1.0,1,1.0,1,0.55052620302011,15
2754,4,35394,35394,0,0,0,0,1.0,1,1.0,1,1.0,1,0.5247925702141409,15
2755,4,35398,35398,0,0,0,0,1.0,1,1.0,1,1.0,1,0.55052620302011,15
2756,3,35401,35401,0,0,0,0,1.0,1,1.0,1,1.0,1,0.3577327812641488,16
2757,6,35407,35407,0,0,0,0,1.0,1,1.0,1,1.0,1,0.3774922180339906,17
2758,5,35412,35412,0,0,0,0,1.0,1,1.0,1,1.0,1,0.3913098777098496,17
2759,2,35414,35414,0,0,0,0,1.0,1,1.0,1,1.0,1,0.46791847752013066,18
2760,3,35417,35417,0,0,0,0,1.0,1,1.0,1,1.0,1,0.341301356143461,18
2761,4,35421,35421,0,0,0,0,1.0,1,1.0,1,1.0,1,0.5088755663636498,18
2762,11,35432,35432,0,0,0,0,1.0,1,1.0,1,1.0,1,0.3168612020283557,18
2763,6,35438,35438,0,0,0,0,1.0,1,1.0,1,1.0,1,0.5017776092709,17
2764,7,35445,35445,0,0,0,0,1.0,1,1.0,1,1.0,1,0.5259927280128627,17
2765,6,35451,35451,0,0,0,0,1.0,1,1.0,1,1.0,1,0.572951807051364,18
2766,8,35459,35459,0,0,0,0,1.0,1,1.0,1,1.0,1,0.49986102430895163,18
2767,9,35468,35468,0,0,0,0,1.0,1,1.0,1,1.0,1,0.5430861963646202,18
2768,6,35474,35474,0,0,0,0,1.0,1,1.0,1,1.0,1,0.555990279279354,18
2769,5,35479,35479,0,0,0,0,1.0,1,1.0,1,1.0,1,0.5324405111889912,18
2770,9,35488,35488,0,0,0,0,1.0,1,1.0,1,1.0,1,0.5816632868333546,18
2771,6,35494,35494,0,0,0,0,1.0,1,1.0,1,1.0,1,0.4793953030279559,18
2772,6,35500,35500,0,0,0,0,1.0,1,1.0,1,1.0,1,0.46644789373215534,18
2773,7,35507,35507,0,0,0,0,1.0,1,1.0,1,1.0,1,0.5105381287532255,18
2774,7,35514,35514,0,0,0,0,1.0,1,1.0,1,1.0,1,0.38546896643698375,20
2775,6,35520,35520,0,0,0,0,1.0,1,1.0,1,1.0,1,0.287125734475245,21
2776,4,35524,35524,0,0,0,0,1.0,1,1.0,1,1.0,1,0.24821882474660076,21
2777,7,35531,35531,0,0,0,0,1.0,1,1.0,1,1.0,1,0.30648506544560167,22
2778,5,35536,35536,0,0,0,0,1.0,1,1.0,1,1.0,1,0.3116126554173818,24
2779,7,35543,35543,0,0,0,0,1.0,1,1.0,1,1.0,1,0.34446533528212187,24
2780,4,35547,35547,0,0,0,0,1.0,1,1.0,1,1.0,1,0.2934602254705565,24
2781,3,35550,35550,0,0,0,0,1.0,1,1.0,1,1.0,1,0.35225005021913064,24
2782,7,35557,35557,0,0,0,0,1.0,1,1.0,1,1.0,1,0.3274095654292387,24
2783,3,35560,35560,0,0,0,0,1.0,1,1.0,1,1.0,1,0.3498870018892108,24
2784,6,35566,35566,0,0,0,0,1.0,1,1.0,1,1.0,1,0.3177929268928729,24
2785,3,35569,35569,0,0,0,0,1.0,1,1.0,1,1.0,1,0.2579715828190743,22
2786,6,35575,35575,0,0,0,0,1.0,1,1.0,1,1.0,1,0.3058028459074183,22
2787,5,35580,35580,0,0,0,0,1.0,1,1.0,1,1.0,1,0.25073749661870587,21
2788,3,35583,35583,0,0,0,0,1.0,1,1.0,1,1.0,1,0.2990058966203328,20
2789,2,35585,35585,0,0,0,0,1.0,1,1.0,1,1.0,1,0.22927143002224531,20
2790,4,35589,35589,0,0,0,0,1.0,1,1.0,1,1.0,1,0.22683204168004759,21
2791,5,35594,35594,0,0,0,0,1.0,1,1.0,1,1.0,1,0.21994079136559214,21
2792,4,35598,35598,0,0,0,0,1.0,1,1.0,1,1.0,1,0.2504722860340742,21
2793,6,35604,35604,0,0,0,0,1.0,1,1.0,1,1.0,1,0.2828468970077897,18
2794,2,35606,35606,0,0,0,0,1.0,1,1.0,1,1.0,1,0.24024282173055544,18
2795,4,35610,35610,0,0,0,0,1.0,1,1.0,1,1.0,1,0.21670845653557524,20
2796,8,35618,35618,0,0,0,0,1.0,1,1.0,1,1.0,1,0.17414715584388363,21
2797,3,35621,35621,0,0,0,0,1.0,1,1.0,1,1.0,1,0.1741114281194991,21
2798,6,35627,35627,0,0,0,0,1.0,1,1.0,1,1.0,1,0.1715182907087232,21
2799,6,35633,35633,0,0,0,0,1.0,1,1.0,1,1.0,1,0.26642238294585646,22
2800,13,35646,35646,0,0,0,0,1.0,1,1.0,1,1.0,1,0.23935218276416748,22
2801,5,35651,35651,0,0,0,0,1.0,1,1.0,1,1.0,1,0.24105799849096687,22
2802,8,35659,35659,0,0,0,0,1.0,1,1.0,1,1.0,1,0.19032490425474824,22
2803,1,35660,35660,0,0,0,0,1.0,1,1.0,1,1.0,1,0.2226920521961136,22
2804,5,35665,35665,0,0,0,0,1.0,1,1.0,1,1.0,1,0.23698761209832608,23
2805,4,35669,35669,0,0,0,0,1.0,1,1.0,1,1.0,1,0.27954133555636357,23
2806,3,35672,35672,0,0,0,0,1.0,1,1.0,1,1.0,1,0.31691930569138094,23
2807,4,35676,35676,0,0,0,0,1.0,1,1.0,1,1.0,1,0.3812552540130805,24
2808,3,35679,35679,0,0,0,0,1.0,1,1.0,1,1.0,1,0.36094081335280337,24
2809,7,35686,35686,0,0,0,0,1.0,1,1.0,1,1.0,1,0.29088589542242427,25
2810,5,35691,35691,0,0,0,0,1.0,1,1.0,1,1.0,1,0.3283212623020472,24
2811,10,35701,35701,0,0,0,0,1.0,1,1.0,1,1.0,1,0.36139326161227203,26
2812,10,35711,35711,0,0,0,0,1.0,1,1.0,1,1.0,1,0.3284454104089252,26
2813,5,35716,35716,0,0,0,0,1.0,1,1.0,1,1.0,1,0.3382698584652558,27
2814,19,35735,35735,0,0,0,0,1.0,1,1.0,1,1.0,1,0.37844608056703427,29
2815,11,35746,35746,0,0,0,0,1.0,1,1.0,1,1.0,1,0.3329525491190932,29
2816,7,35753,35753,0,0,0,0,1.0,1,1.0,1,1.0,1,0.30358077594405747,29
2817,10,35763,35763,0,0,0,0,1.0,1,1.0,1,1.0,1,0.33936802593805804,29
2818,10,35773,35773,0,0,0,0,1.0,1,1.0,1,1.0,1,0.36209251991738317,29
2819,10,35783,35783,0,0,0,0,1.0,1,1.0,1,1.0,1,0.4018104118467875,30
2820,12,35795,35795,0,0,0,0,1.0,1,1.0,1,1.0,1,0.30586493294407474,30
2821,15,35810,35810,0,0,0,0,1.0,1,1.0,1,1.0,1,0.30158658385434745,31
2822,10,35820,35820,0,0,0,0,1.0,1,1.0,1,1.0,1,0.3407381718128271,30
2823,12,35832,35832,0,0,0,0,1.0,1,1.0,1,1.0,1,0.31947224031041527,27
2824,12,35844,35844,0,0,0,0,1.0,1,1.0,1,1.0,1,0.43629902568108725,28
2825,15,35859,35859,0,0,0,0,1.0,1,1.0,1,1.0,1,0.29819940711755605,28
2826,14,35873,35873,0,0,0,0,1.0,1,1.0,1,1.0,1,0.298237852825561,27
2827,12,35885,35885,0,0,0,0,1.0,1,1.0,1,1.0,1,0.2763495493059748,28
2828,15,35900,35900,0,0,0,0,1.0,1,1.0,1,1.0,1,0.2972401160817487,28
2829,10,35910,35910,0,0,0,0,1.0,1,1.0,1,1.0,1,0.34516105403919317,27
2830,6,35916,35916,0,0,0,0,1.0,1,1.0,1,1.0,1,0.20871216022744918,27
2831,5,35921,35921,0,0,0,0,1.0,1,1.0,1,1.0,1,0.37588879422737737,27
2832,9,35930,35930,0,0,0,0,1.0,1,1.0,1,1.0,1,0.32538688849117314,27
2833,8,35938,35938,0,0,0,0,1.0,1,1.0,1,1.0,1,0.3495820120357494,26
2834,13,35951,35951,0,0,0,0,1.0,1,1.0,1,1.0,1,0.4853989031889195,26
2835,5,35956,35956,0,0,0,0,1.0,1,1.0,1,1.0,1,0.3211032079232604,25
2836,10,35966,35966,0,0,0,0,1.0,1,1.0,1,1.0,1,0.40920171737892364,27
2837,12,35978,35978,0,0,0,0,1.0,1,1.0,1,1.0,1,0.5364609366280213,27
2838,13,35991,35991,0,0,0,0,1.0,1,1.0,1,1.0,1,0.47704806813006967,27
2839,16,36007,36007,0,0,0,0,1.0,1,1.0,1,1.0,1,0.36818094364892945,29
2840,13,36020,36020,0,0,0,0,1.0,1,1.0,1,1.0,1,0.4071370143435435,29
2841,14,36034,36034,0,0,0,0,1.0,1,1.0,1,1.0,1,0.3448815217499502,31
2842,18,36052,36052,0,0,0,0,1.0,1,1.0,1,1.0,1,0.3680412125834548,31
2843,14,36066,36066,0,0,0,0,1.0,1,1.0,1,1.0,1,0.281265249619556,32
2844,14,36080,36080,0,0,0,0,1.0,1,1.0,1,1.0,1,0.29702897395122585,33
2845,14,36094,36094,0,0,0,0,1.0,1,1.0,1,1.0,1,0.25574825973881044,32
2846,8,36102,36102,0,0,0,0,1.0,1,1.0,1,1.0,1,0.32073445060139355,33
2847,6,36108,36108,0,0,0,0,1.0,1,1.0,1,1.0,1,0.3594132933189277,32
2848,8,36116,36116,0,0,0,0,1.0,1,1.0,1,1.0,1,0.3036312938609361,33
2849,8,36124,36124,0,0,0,0,1.0,1,1.0,1,1.0,1,0.394825504777239,34
2850,7,36131,36131,0,0,0,0,1.0,1,1.0,1,1.0,1,0.30809437980185833,34
2851,7,36138,36138,0,0,0,0,1.0,1,1.0,1,1.0,1,0.25703125455621373,34
2852,8,36146,36146,0,0,0,0,1.0,1,1.0,1,1.0,1,0.2769743035776016,35
2853,10,36156,36156,0,0,0,0,1.0,1,1.0,1,1.0,1,0.3292549254811517,36
2854,13,36169,36169,0,0,0,0,1.0,1,1.0,1,1.0,1,0.3806050492685232,37
2855,13,36182,36182,0,0,0,0,1.0,1,1.0,1,1.0,1,0.44667722616088834,38
2856,11,36193,36193,0,0,0,0,1.0,1,1.0,1,1.0,1,0.35959893680196336,38
2857,10,36203,36203,0,0,0,0,1.0,1,1.0,1,1.0,1,0.3448365441486802,39
2858,13,36216,36216,0,0,0,0,1.0,1,1.0,1,1.0,1,0.3998624512872269,40
2859,16,36232,36232,0,0,0,0,1.0,1,1.0,1,1.0,1,0.3448407406139052,40
2860,11,36243,36243,0,0,0,0,1.0,1,1.0,1,1.0,1,0.32731462623466523,40
2861,13,36256,36256,0,0,0,0,1.0,1,1.0,1,1.0,1,0.40057491982351284,38
2862,14,36270,36270,0,0,0,0,1.0,1,1.0,1,1.0,1,0.3493693897861981,38
2863,13,36283,36283,0,0,0,0,1.0,1,1.0,1,1.0,1,0.436614677939543,38
2864,15,36298,36298,0,0,0,0,1.0,1,1.0,1,1.0,1,0.37607022745931423,36
2865,12,36310,36310,0,0,0,0,1.0,1,1.0,1,1.0,1,0.3511214528392104,34
2866,10,36320,36320,0,0,0,0,1.0,1,1.0,1,1.0,1,0.5519448186109943,31
2867,6,36326,36326,0,0,0,0,1.0,1,1.0,1,1.0,1,0.4537483037485021,30
2868,7,36333,36333,0,0,0,0,1.0,1,1.0,1,1.0,1,0.5426759295215897,27
2869,9,36342,36342,0,0,0,0,1.0,1,1.0,1,1.0,1,0.4899740007895962,27
2870,12,36354,36354,0,0,0,0,1.0,1,1.0,1,1.0,1,0.646292670034262,25
2871,6,36360,36360,0,0,0,0,1.0,1,1.0,1,1.0,1,0.5240248894566691,25
2872,9,36369,36369,0,0,0,0,1.0,1,1.0,1,1.0,1,0.3971689488996881,23
2873,16,36385,36385,0,0,0,0,1.0,1,1.0,1,1.0,1,0.48032015766004565,24
2874,16,36401,36401,0,0,0,0,1.0,1,1.0,1,1.0,1,0.43147053358058024,24
2875,12,36413,36413,0,0,0,0,1.0,1,1.0,1,1.0,1,0.4379475410824477,23
2876,8,36421,36421,0,0,0,0,1.0,1,1.0,1,1.0,1,0.4246557879827376,24
2877,15,36436,36436,0,0,0,0,1.0,1,1.0,1,1.0,1,0.48307757079040103,24
2878,15,36451,36451,0,0,0,0,1.0,1,1.0,1,1.0,1,0.45785138578449586,24
2879,15,36466,36466,0,0,0,0,1.0,1,1.0,1,1.0,1,0.5367663600809364,25
2880,14,36480,36480,0,0,0,0,1.0,1,1.0,1,1.0,1,0.38329965706260966,26
2881,20,36500,36500,0,0,0,0,1.0,1,1.0,1,1.0,1,0.587467177577713,26
2882,11,36511,36511,0,0,0,0,1.0,1,1.0,1,1.0,1,0.49278265853217457,27
2883,13,36524,36524,0,0,0,0,1.0,1,1.0,1,1.0,1,0.5383990806546601,28
2884,15,36539,36539,0,0,0,0,1.0,1,1.0,1,1.0,1,0.49381962753125813,29
2885,19,36558,36558,0,0,0,0,1.0,1,1.0,1,1.0,1,0.4163070625392621,31
2886,9,36567,36567,0,0,0,0,1.0,1,1.0,1,1.0,1,0.4406674598842217,31
2887,20,36587,36587,0,0,0,0,1.0,1,1.0,1,1.0,1,0.43782469062009,33
2888,21,36608,36608,0,0,0,0,1.0,1,1.0,1,1.0,1,0.3939127626300092,34
2889,27,36635,36635,0,0,0,0,1.0,1,1.0,1,1.0,1,0.38710287059785575,35
2890,22,36657,36657,0,0,0,0,1.0,1,1.0,1,1.0,1,0.5090001226649067,35
2891,26,36683,36683,0,0,0,0,1.0,1,1.0,1,1.0,1,0.6104922570360489,35
2892,19,36702,36702,0,0,0,0,1.0,1,1.0,1,1.0,1,0.5811671931435073,35
2893,15,36717,36717,0,0,0,0,1.0,1,1.0,1,1.0,1,0.5151573576974908,37
2894,10,36727,36727,0,0,0,0,1.0,1,1.0,1,1.0,1,0.5183397161990385,37
2895,14,36741,36741,0,0,0,0,1.0,1,1.0,1,1.0,1,0.5196633170243702,37
2896,18,36759,36759,0,0,0,0,1.0,1,1.0,1,1.0,1,0.5088416969804711,38
2897,14,36773,36773,0,0,0,0,1.0,1,1.0,1,1.0,1,0.5383903815122907,37
2898,11,36784,36784,0,0,0,0,1.0,1,1.0,1,1.0,1,0.557503756362914,38
2899,15,36799,36799,0,0,0,0,1.0,1,1.0,1,1.0,1,0.49317080845538935,37
2900,13,36812,36812,0,0,0,0,1.0,1,1.0,1,1.0,1,0.496190128441345,36
2901,18,36830,36830,0,0,0,0,1.0,1,1.0,1,1.0,1,0.3576229009946756,37
2902,13,36843,36843,0,0,0,0,1.0,1,1.0,1,1.0,1,0.5606738401458348,35
2903,12,36855,36855,0,0,0,0,1.0,1,1.0,1,1.0,1,0.5563342872536109,35
2904,28,36883,36883,0,0,0,0,1.0,1,1.0,1,1.0,1,0.5136289307299489,33
2905,15,36898,36898,0,0,0,0,1.0,1,1.0,1,1.0,1,0.5817739532033768,34
2906,13,36911,36911,0,0,0,0,1.0,1,1.0,1,1.0,1,0.6310263214964427,34
2907,15,36926,36926,0,0,0,0,1.0,1,1.0,1,1.0,1,0.5723180926848048,35
2908,17,36943,36943,0,0,0,0,1.0,1,1.0,1,1.0,1,0.5225082126287633,36
2909,14,36957,36957,0,0,0,0,1.0,1,1.0,1,1.0,1,0.6143297667148729,38
2910,23,36980,36980,0,0,0,0,1.0,1,1.0,1,1.0,1,0.5334231709984035,38
2911,10,36990,36990,0,0,0,0,1.0,1,1.0,1,1.0,1,0.5212372236905144,37
2912,10,37000,37000,0,0,0,0,1.0,1,1.0,1,1.0,1,0.6085866017234816,37
2913,26,37026,37026,0,0,0,0,1.0,1,1.0,1,1.0,1,0.4676892886515842,38
2914,20,37046,37046,0,0,0,0,1.0,1,1.0,1,1.0,1,0.5142150562071971,38
2915,14,37060,37060,0,0,0,0,1.0,1,1.0,1,1.0,1,0.4854071738263909,39
2916,18,37078,37078,0,0,0,0,1.0,1,1.0,1,1.0,1,0.3392776935325487,40
2917,13,37091,37091,0,0,0,0,1.0,1,1.0,1,1.0,1,0.38088423943257316,41
2918,9,37100,37100,0,0,0,0,1.0,1,1.0,1,1.0,1,0.45809496983751247,41
2919,10,37110,37110,0,0,0,0,1.0,1,1.0,1,1.0,1,0.46609439781605644,41
2920,10,37120,37120,0,0,0,0,1.0,1,1.0,1,1.0,1,0.46675404885558186,43
2921,12,37132,37132,0,0,0,0,1.0,1,1.0,1,1.0,1,0.5182611763038665,42
2922,16,37148,37148,0,0,0,0,1.0,1,1.0,1,1.0,1,0.44300569017815344,43
2923,15,37163,37163,0,0,0,0,1.0,1,1.0,1,1.0,1,0.39862149363295946,44
2924,16,37179,37179,0,0,0,0,1.0,1,1.0,1,1.0,1,0.33971684383059625,45
2925,8,37187,37187,0,0,0,0,1.0,1,1.0,1,1.0,1,0.3897922470073564,45
2926,13,37200,37200,0,0,0,0,1.0,1,1.0,1,1.0,1,0.3197343524722507,47
2927,17,37217,37217,0,0,0,0,1.0,1,1.0,1,1.0,1,0.3655051415220739,47
2928,7,37224,37224,0,0,0,0,1.0,1,1.0,1,1.0,1,0.3250449622761431,48
2929,9,37233,37233,0,0,0,0,1.0,1,1.0,1,1.0,1,0.38664550587555835,48
2930,13,37246,37246,0,0,0,0,1.0,1,1.0,1,1.0,1,0.44728266019105584,50
2931,9,37255,37255,0,0,0,0,1.0,1,1.0,1,1.0,1,0.34598547023458887,51
2932,9,37264,37264,0,0,0,0,1.0,1,1.0,1,1.0,1,0.3612227650640476,51
2933,11,37275,37275,0,0,0,0,1.0,1,1.0,1,1.0,1,0.3413714836641755,52
2934,16,37291,37291,0,0,0,0,1.0,1,1.0,1,1.0,1,0.4390023126824554,52
2935,7,37298,37298,0,0,0,0,1.0,1,1.0,1,1.0,1,0.46600916328118513,51
2936,11,37309,37309,0,0,0,0,1.0,1,1.0,1,1.0,1,0.387590191137728,49
2937,15,37324,37324,0,0,0,0,1.0,1,1.0,1,1.0,1,0.35297342679542587,50
2938,10,37334,37334,0,0,0,0,1.0,1,1.0,1,1.0,1,0.401306967497964,50
2939,6,37340,37340,0,0,0,0,1.0,1,1.0,1,1.0,1,0.3995414635506889,51
2940,13,37353,37353,0,0,0,0,1.0,1,1.0,1,1.0,1,0.34311904842477065,52
2941,15,37368,37368,0,0,0,0,1.0,1,1.0,1,1.0,1,0.41289719469663777,53
2942,8,37376,37376,0,0,0,0,1.0,1,1.0,1,1.0,1,0.4198880901837851,52
2943,14,37390,37390,0,0,0,0,1.0,1,1.0,1,1.0,1,0.3998571183820917,51
2944,13,37403,37403,0,0,0,0,1.0,1,1.0,1,1.0,1,0.41030498462634396,52
2945,22,37425,37425,0,0,0,0,1.0,1,1.0,1,1.0,1,0.40345011871729003,50
2946,27,37452,37452,0,0,0,0,1.0,1,1.0,1,1.0,1,0.4652013925915248,51
2947,20,37472,37472,0,0,0,0,1.0,1,1.0,1,1.0,1,0.4636608148606151,50
2948,16,37488,37488,0,0,0,0,1.0,1,1.0,1,1.0,1,0.5196857535310826,50
2949,21,37509,37509,0,0,0,0,1.0,1,1.0,1,1.0,1,0.4781139556622919,49
2950,11,37520,37520,0,0,0,0,1.0,1,1.0,1,1.0,1,0.556880269094499,48
2951,11,37531,37531,0,0,0,0,1.0,1,1.0,1,1.0,1,0.5710207401128523,48
2952,20,37551,37551,0,0,0,0,1.0,1,1.0,1,1.0,1,0.5692132848397427,46
2953,21,37572,37572,0,0,0,0,1.0,1,1.0,1,1.0,1,0.573706858453305,46
2954,15,37587,37587,0,0,0,0,1.0,1,1.0,1,1.0,1,0.5401272927924452,48
2955,20,37607,37607,0,0,0,0,1.0,1,1.0,1,1.0,1,0.4472922000580431,48
2956,17,37624,37624,0,0,0,0,1.0,1,1.0,1,1.0,1,0.442646030134573,47
2957,17,37641,37641,0,0,0,0,1.0,1,1.0,1,1.0,1,0.3674266187981423,48
2958,20,37661,37661,0,0,0,0,1.0,1,1.0,1,1.0,1,0.41348409896618865,49
2959,13,37674,37674,0,0,0,0,1.0,1,1.0,1,1.0,1,0.2855443408290132,49
2960,17,37691,37691,0,0,0,0,1.0,1,1.0,1,1.0,1,0.3868227463796729,49
2961,26,37717,37717,0,0,0,0,1.0,1,1.0,1,1.0,1,0.3609147938203478,51
2962,11,37728,37728,0,0,0,0,1.0,1,1.0,1,1.0,1,0.3885197455517778,51
2963,12,37740,37740,0,0,0,0,1.0,1,1.0,1,1.0,1,0.4624427846928403,51
2964,8,37748,37748,0,0,0,0,1.0,1,1.0,1,1.0,1,0.3788166311761233,52
2965,6,37754,37754,0,0,0,0,1.0,1,1.0,1,1.0,1,0.4229826201086263,53
2966,14,37768,37768,0,0,0,0,1.0,1,1.0,1,1.0,1,0.4358969560025892,53
2967,10,37778,37778,0,0,0,0,1.0,1,1.0,1,1.0,1,0.42544925921289184,53
2968,8,37786,37786,0,0,0,0,1.0,1,1.0,1,1.0,1,0.4624606964634793,54
2969,5,37791,37791,0,0,0,0,1.0,1,1.0,1,1.0,1,0.497353348161763,55
2970,9,37800,37800,0,0,0,0,1.0,1,1.0,1,1.0,1,0.43158132383285525,55
2971,9,37809,37809,0,0,0,0,1.0,1,1.0,1,1.0,1,0.5020644096426892,55
2972,8,37817,37817,0,0,0,0,1.0,1,1.0,1,1.0,1,0.5628330774274062,55
2973,3,37820,37820,0,0,0,0,1.0,1,1.0,1,1.0,1,0.5567733430255485,55
2974,14,37834,37834,0,0,0,0,1.0,1,1.0,1,1.0,1,0.4770148269699913,56
2975,12,37846,37846,0,0,0,0,1.0,1,1.0,1,1.0,1,0.5393385809365379,55
2976,9,37855,37855,0,0,0,0,1.0,1,1.0,1,1.0,1,0.4849060695248592,57
2977,13,37868,37868,0,0,0,0,1.0,1,1.0,1,1.0,1,0.5111515406318112,59
2978,12,37880,37880,0,0,0,0,1.0,1,1.0,1,1.0,1,0.4035543559321142,59
2979,9,37889,37889,0,0,0,0,1.0,1,1.0,1,1.0,1,0.4063480968233746,59
2980,24,37913,37913,0,0,0,0,1.0,1,1.0,1,1.0,1,0.43246153996871095,59
2981,12,37925,37925,0,0,0,0,1.0,1,1.0,1,1.0,1,0.3644068822672191,59
2982,15,37940,37940,0,0,0,0,1.0,1,1.0,1,1.0,1,0.37838673918320903,61
2983,25,37965,37965,0,0,0,0,1.0,1,1.0,1,1.0,1,0.24784729625241064,61
2984,31,37996,37996,0,0,0,0,1.0,1,1.0,1,1.0,1,0.25831433975409357,61
2985,24,38020,38020,0,0,0,0,1.0,1,1.0,1,1.0,1,0.352746336624004,57
2986,19,38039,38039,0,0,0,0,1.0,1,1.0,1,1.0,1,0.3016913113274628,58
2987,21,38060,38060,0,0,0,0,1.0,1,1.0,1,1.0,1,0.2733659749694763,56
2988,16,38076,38076,0,0,0,0,1.0,1,1.0,1,1.0,1,0.3469613918000313,55
2989,15,38091,38091,0,0,0,0,1.0,1,1.0,1,1.0,1,0.3129972787101947,53
2990,18,38109,38109,0,0,0,0,1.0,1,1.0,1,1.0,1,0.2665454500498245,52
2991,16,38125,38125,0,0,0,0,1.0,1,1.0,1,1.0,1,0.3297595009967052,54
2992,17,38142,38142,0,0,0,0,1.0,1,1.0,1,1.0,1,0.32253924570405096,55
2993,7,38149,38149,0,0,0,0,1.0,1,1.0,1,1.0,1,0.36402163515073216,53
2994,4,38153,38153,0,0,0,0,1.0,1,1.0,1,1.0,1,0.3077788222271635,53
2995,11,38164,38164,0,0,0,0,1.0,1,1.0,1,1.0,1,0.3741712530425854,51
2996,9,38173,38173,0,0,0,0,1.0,1,1.0,1,1.0,1,0.4040029066219774,52
2997,8,38181,38181,0,0,0,0,1.0,1,1.0,1,1.0,1,0.3421780335315309,50
2998,8,38189,38189,0,0,0,0,1.0,1,1.0,1,1.0,1,0.4049593789797906,51
2999,14,38203,38203,0,0,0,0,1.0,1,1.0,1,1.0,1,0.4029300709109006,48
3000,8,38211,38211,0,0,0,0,1.0,1,1.0,1,1.0,1,0.413835952928804,48
3001,11,38222,38222,0,0,0,0,1.0,1,1.0,1,1.0,1,0.44016444003901334,49
3002,11,38233,38233,0,0,0,0,1.0,1,1.0,1,1.0,1,0.48091839728283087,50
3003,7,38240,38240,0,0,0,0,1.0,1,1.0,1,1.0,1,0.4725860809971348,50
3004,9,38249,38249,0,0,0,0,1.0,1,1.0,1,1.0,1,0.44463136044040696,51
3005,10,38259,38259,0,0,0,0,1.0,1,1.0,1,1.0,1,0.37081608460009935,50
3006,10,38269,38269,0,0,0,0,1.0,1,1.0,1,1.0,1,0.35698379062980373,51
3007,8,38277,38277,0,0,0,0,1.0,1,1.0,1,1.0,1,0.39851957259763854,51
3008,25,38302,38302,0,0,0,0,1.0,1,1.0,1,1.0,1,0.3732508342031444,53
3009,15,38317,38317,0,0,0,0,1.0,1,1.0,1,1.0,1,0.26766452289524173,52
3010,12,38329,38329,0,0,0,0,1.0,1,1.0,1,1.0,1,0.21542295515528034,52
3011,14,38343,38343,0,0,0,0,1.0,1,1.0,1,1.0,1,0.3330928421348065,51
3012,18,38361,38361,0,0,0,0,1.0,1,1.0,1,1.0,1,0.24989009194628145,54
3013,25,38386,38386,0,0,0,0,1.0,1,1.0,1,1.0,1,0.33431897684507,52
3014,15,38401,38401,0,0,0,0,1.0,1,1.0,1,1.0,1,0.2539789126175959,51
3015,17,38418,38418,0,0,0,0,1.0,1,1.0,1,1.0,1,0.31736171661068946,50
3016,18,38436,38436,0,0,0,0,1.0,1,1.0,1,1.0,1,0.33023443135941843,50
3017,15,38451,38451,0,0,0,0,1.0,1,1.0,1,1.0,1,0.3057297047657469,48
3018,9,38460,38460,0,0,0,0,1.0,1,1.0,1,1.0,1,0.3818903911943439,48
3019,21,38481,38481,0,0,0,0,1.0,1,1.0,1,1.0,1,0.3768352627002734,47
3020,16,38497,38497,0,0,0,0,1.0,1,1.0,1,1.0,1,0.335982896432578,47
3021,19,38516,38516,0,0,0,0,1.0,1,1.0,1,1.0,1,0.3609800333953587,46
3022,20,38536,38536,0,0,0,0,1.0,1,1.0,1,1.0,1,0.41974204737694354,45
3023,19,38555,38555,0,0,0,0,1.0,1,1.0,1,1.0,1,0.4833409590319023,41
3024,19,38574,38574,0,0,0,0,1.0,1,1.0,1,1.0,1,0.29521224925092987,43
3025,19,38593,38593,0,0,0,0,1.0,1,1.0,1,1.0,1,0.44008236546408136,39
3026,15,38608,38608,0,0,0,0,1.0,1,1.0,1,1.0,1,0.34935541124550107,38
3027,21,38629,38629,0,0,0,0,1.0,1,1.0,1,1.0,1,0.45105210619784314,38
3028,18,38647,38647,0,0,0,0,1.0,1,1.0,1,1.0,1,0.4476068820850539,38
3029,9,38656,38656,0,0,0,0,1.0,1,1.0,1,1.0,1,0.3731709336472341,37
3030,13,38669,38669,0,0,0,0,1.0,1,1.0,1,1.0,1,0.4921366970363033,38
3031,14,38683,38683,0,0,0,0,1.0,1,1.0,1,1.0,1,0.3967471480022639,39
3032,9,38692,38692,0,0,0,0,1.0,1,1.0,1,1.0,1,0.42087198568336237,39
3033,11,38703,38703,0,0,0,0,1.0,1,1.0,1,1.0,1,0.5209774858821238,39
3034,4,38707,38707,0,0,0,0,1.0,1,1.0,1,1.0,1,0.49611866943061367,38
3035,7,38714,38714,0,0,0,0,1.0,1,1.0,1,1.0,1,0.4234227996356457,39
3036,17,38731,38731,0,0,0,0,1.0,1,1.0,1,1.0,1,0.5216652153122641,39
3037,14,38745,38745,0,0,0,0,1.0,1,1.0,1,1.0,1,0.37203760400982544,39
3038,13,38758,38758,0,0,0,0,1.0,1,1.0,1,1.0,1,0.41645418391882605,40
3039,12,38770,38770,0,0,0,0,1.0,1,1.0,1,1.0,1,0.40417512764346986,41
3040,16,38786,38786,0,0,0,0,1.0,1,1.0,1,1.0,1,0.33702524008690377,42
3041,19,38805,38805,0,0,0,0,1.0,1,1.0,1,1.0,1,0.40947438168936395,43
3042,19,38824,38824,0,0,0,0,1.0,1,1.0,1,1.0,1,0.43010326325028136,45
3043,17,38841,38841,0,0,0,0,1.0,1,1.0,1,1.0,1,0.3884409450054145,45
3044,15,38856,38856,0,0,0,0,1.0,1,1.0,1,1.0,1,0.29506622219364886,45
3045,17,38873,38873,0,0,0,0,1.0,1,1.0,1,1.0,1,0.32450082807000047,45
3046,15,38888,38888,0,0,0,0,1.0,1,1.0,1,1.0,1,0.3914636128882757,46
3047,11,38899,38899,0,0,0,0,1.0,1,1.0,1,1.0,1,0.4404721326463173,46
3048,18,38917,38917,0,0,0,0,1.0,1,1.0,1,1.0,1,0.39493479364808093,49
3049,10,38927,38927,0,0,0,0,1.0,1,1.0,1,1.0,1,0.4221593464502848,50
3050,28,38955,38955,0,0,0,0,1.0,1,1.0,1,1.0,1,0.38727255539238886,50
3051,9,38964,38964,0,0,0,0,1.0,1,1.0,1,1.0,1,0.3842480081827565,50
3052,14,38978,38978,0,0,0,0,1.0,1,1.0,1,1.0,1,0.3724105955817809,50
3053,10,38988,38988,0,0,0,0,1.0,1,1.0,1,1.0,1,0.4264302875622461,49
3054,21,39009,39009,0,0,0,0,1.0,1,1.0,1,1.0,1,0.5083868586252133,47
3055,14,39023,39023,0,0,0,0,1.0,1,1.0,1,1.0,1,0.34893955587259917,48
3056,18,39041,39041,0,0,0,0,1.0,1,1.0,1,1.0,1,0.35059179669352863,47
3057,6,39047,39047,0,0,0,0,1.0,1,1.0,1,1.0,1,0.3756375477861596,48
3058,12,39059,39059,0,0,0,0,1.0,1,1.0,1,1.0,1,0.36656649249353923,46
3059,12,39071,39071,0,0,0,0,1.0,1,1.0,1,1.0,1,0.28463544793501944,44
3060,14,39085,39085,0,0,0,0,1.0,1,1.0,1,1.0,1,0.3239393578324217,44
3061,12,39097,39097,0,0,0,0,1.0,1,1.0,1,1.0,1,0.3339051811668326,42
3062,9,39106,39106,0,0,0,0,1.0,1,1.0,1,1.0,1,0.28100012345900094,42
3063,12,39118,39118,0,0,0,0,1.0,1,1.0,1,1.0,1,0.2063714153739418,41
3064,13,39131,39131,0,0,0,0,1.0,1,1.0,1,1.0,1,0.2414798329748926,42
3065,7,39138,39138,0,0,0,0,1.0,1,1.0,1,1.0,1,0.2400889571144626,40
3066,14,39152,39152,0,0,0,0,1.0,1,1.0,1,1.0,1,0.2788649904056732,42
3067,17,39169,39169,0,0,0,0,1.0,1,1.0,1,1.0,1,0.1722704950791826,40
3068,9,39178,39178,0,0,0,0,1.0,1,1.0,1,1.0,1,0.36161091253628636,39
3069,9,39187,39187,0,0,0,0,1.0,1,1.0,1,1.0,1,0.30248855298587235,38
3070,18,39205,39205,0,0,0,0,1.0,1,1.0,1,1.0,1,0.26842876078049116,39
3071,9,39214,39214,0,0,0,0,1.0,1,1.0,1,1.0,1,0.20946164401726203,39
3072,9,39223,39223,0,0,0,0,1.0,1,1.0,1,1.0,1,0.2514697094990194,40
3073,12,39235,39235,0,0,0,0,1.0,1,1.0,1,1.0,1,0.21198977613468645,38
3074,15,39250,39250,0,0,0,0,1.0,1,1.0,1,1.0,1,0.23875025684965248,38
3075,11,39261,39261,0,0,0,0,1.0,1,1.0,1,1.0,1,0.20914225909646889,41
3076,14,39275,39275,0,0,0,0,1.0,1,1.0,1,1.0,1,0.1838476474644461,42
3077,16,39291,39291,0,0,0,0,1.0,1,1.0,1,1.0,1,0.2641777504288764,42
3078,12,39303,39303,0,0,0,0,1.0,1,1.0,1,1.0,1,0.2581189752530913,42
3079,12,39315,39315,0,0,0,0,1.0,1,1.0,1,1.0,1,0.26140727962097027,42
3080,6,39321,39321,0,0,0,0,1.0,1,1.0,1,1.0,1,0.32090295771410493,43
3081,16,39337,39337,0,0,0,0,1.0,1,1.0,1,1.0,1,0.20931043846692537,44
3082,10,39347,39347,0,0,0,0,1.0,1,1.0,1,1.0,1,0.32170326327272014,45
3083,7,39354,39354,0,0,0,0,1.0,1,1.0,1,1.0,1,0.20437747229734632,45
3084,6,39360,39360,0,0,0,0,1.0,1,1.0,1,1.0,1,0.2785993009103796,45
3085,13,39373,39373,0,0,0,0,1.0,1,1.0,1,1.0,1,0.26416843799229595,46
3086,9,39382,39382,0,0,0,0,1.0,1,1.0,1,1.0,1,0.27831628860326824,46
3087,5,39387,39387,0,0,0,0,1.0,1,1.0,1,1.0,1,0.2694481354620494,47
3088,4,39391,39391,0,0,0,0,1.0,1,1.0,1,1.0,1,0.32112686225434617,48
3089,6,39397,39397,0,0,0,0,1.0,1,1.0,1,1.0,1,0.3147390772085665,46
3090,11,39408,39408,0,0,0,0,1.0,1,1.0,1,1.0,1,0.2907538984062126,46
3091,18,39426,39426,0,0,0,0,1.0,1,1.0,1,1.0,1,0.3458131700718144,46
3092,15,39441,39441,0,0,0,0,1.0,1,1.0,1,1.0,1,0.29719573601559957,47
3093,10,39451,39451,0,0,0,0,1.0,1,1.0,1,1.0,1,0.36126118409733776,47
3094,18,39469,39469,0,0,0,0,1.0,1,1.0,1,1.0,1,0.3345533582225346,45
3095,16,39485,39485,0,0,0,0,1.0,1,1.0,1,1.0,1,0.3502468167154438,46
3096,15,39500,39500,0,0,0,0,1.0,1,1.0,1,1.0,1,0.382304006322959,46
3097,12,39512,39512,0,0,0,0,1.0,1,1.0,1,1.0,1,0.31623912278139366,47
3098,11,39523,39523,0,0,0,0,1.0,1,1.0,1,1.0,1,0.34170216043960244,47
3099,16,39539,39539,0,0,0,0,1.0,1,1.0,1,1.0,1,0.36249561254196655,47
3100,10,39549,39549,0,0,0,0,1.0,1,1.0,1,1.0,1,0.3239065475494278,47
3101,11,39560,39560,0,0,0,0,1.0,1,1.0,1,1.0,1,0.3193069348302633,48
3102,8,39568,39568,0,0,0,0,1.0,1,1.0,1,1.0,1,0.3033880604060755,48
3103,8,39576,39576,0,0,0,0,1.0,1,1.0,1,1.0,1,0.30791485680508,49
3104,15,39591,39591,0,0,0,0,1.0,1,1.0,1,1.0,1,0.2764025827523723,48
3105,17,39608,39608,0,0,0,0,1.0,1,1.0,1,1.0,1,0.19896845457005582,45
3106,11,39619,39619,0,0,0,0,1.0,1,1.0,1,1.0,1,0.19805993584258447,46
3107,15,39634,39634,0,0,0,0,1.0,1,1.0,1,1.0,1,0.22009602992946395,44
3108,8,39642,39642,0,0,0,0,1.0,1,1.0,1,1.0,1,0.22430321908103087,45
3109,11,39653,39653,0,0,0,0,1.0,1,1.0,1,1.0,1,0.21059841128798565,44
3110,11,39664,39664,0,0,0,0,1.0,1,1.0,1,1.0,1,0.2500161312190275,46
3111,18,39682,39682,0,0,0,0,1.0,1,1.0,1,1.0,1,0.30277645875827414,46
3112,15,39697,39697,0,0,0,0,1.0,1,1.0,1,1.0,1,0.29461612745476545,47
3113,16,39713,39713,0,0,0,0,1.0,1,1.0,1,1.0,1,0.2785452901789937,48
3114,11,39724,39724,0,0,0,0,1.0,1,1.0,1,1.0,1,0.27986071635018533,48
3115,11,39735,39735,0,0,0,0,1.0,1,1.0,1,1.0,1,0.3359094271720225,49
3116,4,39739,39739,0,0,0,0,1.0,1,1.0,1,1.0,1,0.3141033607346075,48
3117,16,39755,39755,0,0,0,0,1.0,1,1.0,1,1.0,1,0.3097752935857229,49
3118,18,39773,39773,0,0,0,0,1.0,1,1.0,1,1.0,1,0.35838248730699057,50
3119,9,39782,39782,0,0,0,0,1.0,1,1.0,1,1.0,1,0.36120481910415064,50
3120,19,39801,39801,0,0,0,0,1.0,1,1.0,1,1.0,1,0.3518644756536806,50
3121,19,39820,39820,0,0,0,0,1.0,1,1.0,1,1.0,1,0.3111887968998079,50
3122,21,39841,39841,0,0,0,0,1.0,1,1.0,1,1.0,1,0.296963161098408,50
3123,15,39856,39856,0,0,0,0,1.0,1,1.0,1,1.0,1,0.3466468382066159,51
3124,15,39871,39871,0,0,0,0,1.0,1,1.0,1,1.0,1,0.3759393177413916,51
3125,21,39892,39892,0,0,0,0,1.0,1,1.0,1,1.0,1,0.32225615217359715,51
3126,26,39918,39918,0,0,0,0,1.0,1,1.0,1,1.0,1,0.23963905226792476,54
3127,21,39939,39939,0,0,0,0,1.0,1,1.0,1,1.0,1,0.3682465256987669,53
3128,16,39955,39955,0,0,0,0,1.0,1,1.0,1,1.0,1,0.3327013452616804,52
3129,13,39968,39968,0,0,0,0,1.0,1,1.0,1,1.0,1,0.40494915124877634,51
3130,17,39985,39985,0,0,0,0,1.0,1,1.0,1,1.0,1,0.31578691241900764,50
3131,11,39996,39996,0,0,0,0,1.0,1,1.0,1,1.0,1,0.40436525397629997,50
3132,6,40002,40002,0,0,0,0,1.0,1,1.0,1,1.0,1,0.36994592515691666,49
3133,12,40014,40014,0,0,0,0,1.0,1,1.0,1,1.0,1,0.32428210801556356,49
3134,13,40027,40027,0,0,0,0,1.0,1,1.0,1,1.0,1,0.306787233062779,46
3135,15,40042,40042,0,0,0,0,1.0,1,1.0,1,1.0,1,0.3241860603260738,47
3136,19,40061,40061,0,0,0,0,1.0,1,1.0,1,1.0,1,0.3174557421354077,46
3137,13,40074,40074,0,0,0,0,1.0,1,1.0,1,1.0,1,0.4171225739469581,49
3138,7,40081,40081,0,0,0,0,1.0,1,1.0,1,1.0,1,0.39794520267742006,49
3139,15,40096,40096,0,0,0,0,1.0,1,1.0,1,1.0,1,0.33152209996979615,50
3140,12,40108,40108,0,0,0,0,1.0,1,1.0,1,1.0,1,0.2798120628749465,51
3141,12,40120,40120,0,0,0,0,1.0,1,1.0,1,1.0,1,0.40344513674204296,50
3142,11,40131,40131,0,0,0,0,1.0,1,1.0,1,1.0,1,0.354969415826586,50
3143,2,40133,40133,0,0,0,0,1.0,1,1.0,1,1.0,1,0.3681352349971052,49
3144,15,40148,40148,0,0,0,0,1.0,1,1.0,1,1.0,1,0.34178249795031296,49
3145,17,40165,40165,0,0,0,0,1.0,1,1.0,1,1.0,1,0.345247521651046,48
3146,19,40184,40184,0,0,0,0,1.0,1,1.0,1,1.0,1,0.37152100466697396,49
3147,17,40201,40201,0,0,0,0,1.0,1,1.0,1,1.0,1,0.40825209813266233,48
3148,12,40213,40213,0,0,0,0,1.0,1,1.0,1,1.0,1,0.3676663051420478,48
3149,14,40227,40227,0,0,0,0,1.0,1,1.0,1,1.0,1,0.42173712009546394,47
3150,16,40243,40243,0,0,0,0,1.0,1,1.0,1,1.0,1,0.5203101843003699,47
3151,17,40260,40260,0,0,0,0,1.0,1,1.0,1,1.0,1,0.4413435156123122,48
3152,22,40282,40282,0,0,0,0,1.0,1,1.0,1,1.0,1,0.2973966403026603,47
3153,18,40300,40300,0,0,0,0,1.0,1,1.0,1,1.0,1,0.4176816340761081,47
3154,13,40313,40313,0,0,0,0,1.0,1,1.0,1,1.0,1,0.40558299100661127,48
3155,10,40323,40323,0,0,0,0,1.0,1,1.0,1,1.0,1,0.31284062566910464,48
3156,11,40334,40334,0,0,0,0,1.0,1,1.0,1,1.0,1,0.278586811121335,48
3157,15,40349,40349,0,0,0,0,1.0,1,1.0,1,1.0,1,0.3772208548674315,48
3158,10,40359,40359,0,0,0,0,1.0,1,1.0,1,1.0,1,0.33701439015896195,48
3159,15,40374,40374,0,0,0,0,1.0,1,1.0,1,1.0,1,0.2944883533782108,49
3160,13,40387,40387,0,0,0,0,1.0,1,1.0,1,1.0,1,0.3097606489572886,51
3161,10,40397,40397,0,0,0,0,1.0,1,1.0,1,1.0,1,0.3660383973152468,52
3162,12,40409,40409,0,0,0,0,1.0,1,1.0,1,1.0,1,0.3365725400926298,51
3163,11,40420,40420,0,0,0,0,1.0,1,1.0,1,1.0,1,0.3850373346149569,51
3164,9,40429,40429,0,0,0,0,1.0,1,1.0,1,1.0,1,0.3635794583306559,52
3165,16,40445,40445,0,0,0,0,1.0,1,1.0,1,1.0,1,0.36733711439995853,50
3166,15,40460,40460,0,0,0,0,1.0,1,1.0,1,1.0,1,0.36319604887186896,50
3167,8,40468,40468,0,0,0,0,1.0,1,1.0,1,1.0,1,0.3395447325672237,49
3168,11,40479,40479,0,0,0,0,1.0,1,1.0,1,1.0,1,0.35722945926518845,47
3169,9,40488,40488,0,0,0,0,1.0,1,1.0,1,1.0,1,0.3638958732767521,48
3170,9,40497,40497,0,0,0,0,1.0,1,1.0,1,1.0,1,0.3091183066595355,47
3171,7,40504,40504,0,0,0,0,1.0,1,1.0,1,1.0,1,0.37140942389680914,47
3172,14,40518,40518,0,0,0,0,1.0,1,1.0,1,1.0,1,0.34455391620613346,46
3173,9,40527,40527,0,0,0,0,1.0,1,1.0,1,1.0,1,0.3496795201376578,45
3174,18,40545,40545,0,0,0,0,1.0,1,1.0,1,1.0,1,0.3400314746670623,43
3175,10,40555,40555,0,0,0,0,1.0,1,1.0,1,1.0,1,0.26304211559967094,43
3176,6,40561,40561,0,0,0,0,1.0,1,1.0,1,1.0,1,0.3673846459540508,44
3177,13,40574,40574,0,0,0,0,1.0,1,1.0,1,1.0,1,0.39796396294896674,44
3178,20,40594,40594,0,0,0,0,1.0,1,1.0,1,1.0,1,0.2314377770085172,47
3179,21,40615,40615,0,0,0,0,1.0,1,1.0,1,1.0,1,0.3927325114233061,48
3180,19,40634,40634,0,0,0,0,1.0,1,1.0,1,1.0,1,0.21633889495556774,48
3181,12,40646,40646,0,0,0,0,1.0,1,1.0,1,1.0,1,0.3749011686221212,48
3182,13,40659,40659,0,0,0,0,1.0,1,1.0,1,1.0,1,0.4115214405513183,51
3183,7,40666,40666,0,0,0,0,1.0,1,1.0,1,1.0,1,0.376499366654852,50
3184,22,40688,40688,0,0,0,0,1.0,1,1.0,1,1.0,1,0.3454578755631065,50
3185,12,40700,40700,0,0,0,0,1.0,1,1.0,1,1.0,1,0.33867468550111746,48
3186,15,40715,40715,0,0,0,0,1.0,1,1.0,1,1.0,1,0.34235565345528646,48
3187,10,40725,40725,0,0,0,0,1.0,1,1.0,1,1.0,1,0.33591378201848787,48
3188,13,40738,40738,0,0,0,0,1.0,1,1.0,1,1.0,1,0.34451838985735234,48
3189,9,40747,40747,0,0,0,0,1.0,1,1.0,1,1.0,1,0.3233712444012116,49
3190,8,40755,40755,0,0,0,0,1.0,1,1.0,1,1.0,1,0.3543390466962623,51
3191,10,40765,40765,0,0,0,0,1.0,1,1.0,1,1.0,1,0.37568025897654816,52
3192,6,40771,40771,0,0,0,0,1.0,1,1.0,1,1.0,1,0.4463682856529574,52
3193,10,40781,40781,0,0,0,0,1.0,1,1.0,1,1.0,1,0.3560157524522709,52
3194,13,40794,40794,0,0,0,0,1.0,1,1.0,1,1.0,1,0.33765327249167476,54
3195,10,40804,40804,0,0,0,0,1.0,1,1.0,1,1.0,1,0.36422410093370094,54
3196,20,40824,40824,0,0,0,0,1.0,1,1.0,1,1.0,1,0.31980544195596905,54
3197,11,40835,40835,0,0,0,0,1.0,1,1.0,1,1.0,1,0.29318241535743855,54
3198,18,40853,40853,0,0,0,0,1.0,1,1.0,1,1.0,1,0.31128147144526197,54
3199,14,40867,40867,0,0,0,0,1.0,1,1.0,1,1.0,1,0.2905291253683385,56
3200,9,40876,40876,0,0,0,0,1.0,1,1.0,1,1.0,1,0.194337218323522,56
3201,12,40888,40888,0,0,0,0,1.0,1,1.0,1,1.0,1,0.2697743924999213,56
3202,11,40899,40899,0,0,0,0,1.0,1,1.0,1,1.0,1,0.26773291547236444,57
3203,11,40910,40910,0,0,0,0,1.0,1,1.0,1,1.0,1,0.330686904865462,56
3204,17,40927,40927,0,0,0,0,1.0,1,1.0,1,1.0,1,0.2966318189500134,55
3205,9,40936,40936,0,0,0,0,1.0,1,1.0,1,1.0,1,0.3031374307638439,54
3206,14,40950,40950,0,0,0,0,1.0,1,1.0,1,1.0,1,0.31707735257507647,56
3207,11,40961,40961,0,0,0,0,1.0,1,1.0,1,1.0,1,0.3045850716777063,54
3208,15,40976,40976,0,0,0,0,1.0,1,1.0,1,1.0,1,0.33945600605825077,53
3209,11,40987,40987,0,0,0,0,1.0,1,1.0,1,1.0,1,0.34419672340228313,54
3210,4,40991,40991,0,0,0,0,1.0,1,1.0,1,1.0,1,0.3810760310120034,53
3211,4,40995,40995,0,0,0,0,1.0,1,1.0,1,1.0,1,0.43135866683932766,53
3212,5,41000,41000,0,0,0,0,1.0,1,1.0,1,1.0,1,0.393624598408963,54
3213,8,41008,41008,0,0,0,0,1.0,1,1.0,1,1.0,1,0.3924666959941322,54
3214,14,41022,41022,0,0,0,0,1.0,1,1.0,1,1.0,1,0.4289892991859346,55
3215,12,41034,41034,0,0,0,0,1.0,1,1.0,1,1.0,1,0.4118258171334654,55
3216,7,41041,41041,0,0,0,0,1.0,1,1.0,1,1.0,1,0.4070071566060422,55
3217,5,41046,41046,0,0,0,0,1.0,1,1.0,1,1.0,1,0.41892952262833216,54
3218,4,41050,41050,0,0,0,0,1.0,1,1.0,1,1.0,1,0.4239865526287705,54
3219,11,41061,41061,0,0,0,0,1.0,1,1.0,1,1.0,1,0.4192550605949268,55
3220,7,41068,41068,0,0,0,0,1.0,1,1.0,1,1.0,1,0.4540785116052782,56
3221,6,41074,41074,0,0,0,0,1.0,1,1.0,1,1.0,1,0.42807750401917327,57
3222,9,41083,41083,0,0,0,0,1.0,1,1.0,1,1.0,1,0.4433480969155137,57
3223,14,41097,41097,0,0,0,0,1.0,1,1.0,1,1.0,1,0.47324174159280435,56
3224,16,41113,41113,0,0,0,0,1.0,1,1.0,1,1.0,1,0.44308933102343845,58
3225,13,41126,41126,0,0,0,0,1.0,1,1.0,1,1.0,1,0.4240065464359315,55
3226,19,41145,41145,0,0,0,0,1.0,1,1.0,1,1.0,1,0.44491900798068007,54
3227,16,41161,41161,0,0,0,0,1.0,1,1.0,1,1.0,1,0.37772532201748227,53
3228,13,41174,41174,0,0,0,0,1.0,1,1.0,1,1.0,1,0.47036629389151535,52
3229,18,41192,41192,0,0,0,0,1.0,1,1.0,1,1.0,1,0.35222448746196183,52
3230,15,41207,41207,0,0,0,0,1.0,1,1.0,1,1.0,1,0.44962166162133965,50
3231,13,41220,41220,0,0,0,0,1.0,1,1.0,1,1.0,1,0.38586042752403676,50
3232,9,41229,41229,0,0,0,0,1.0,1,1.0,1,1.0,1,0.41192614553924745,50
3233,9,41238,41238,0,0,0,0,1.0,1,1.0,1,1.0,1,0.4948239043448435,50
3234,13,41251,41251,0,0,0,0,1.0,1,1.0,1,1.0,1,0.4597673500525498,49
3235,10,41261,41261,0,0,0,0,1.0,1,1.0,1,1.0,1,0.5034744615803566,49
3236,12,41273,41273,0,0,0,0,1.0,1,1.0,1,1.0,1,0.48133485007887444,51
3237,12,41285,41285,0,0,0,0,1.0,1,1.0,1,1.0,1,0.46114715695367525,53
3238,8,41293,41293,0,0,0,0,1.0,1,1.0,1,1.0,1,0.48372494510451647,53
3239,13,41306,41306,0,0,0,0,1.0,1,1.0,1,1.0,1,0.5094062263889731,53
3240,13,41319,41319,0,0,0,0,1.0,1,1.0,1,1.0,1,0.5067119687009711,53
3241,18,41337,41337,0,0,0,0,1.0,1,1.0,1,1.0,1,0.5371783032481215,53
3242,15,41352,41352,0,0,0,0,1.0,1,1.0,1,1.0,1,0.48625339422501657,53
3243,19,41371,41371,0,0,0,0,1.0,1,1.0,1,1.0,1,0.4448159584449246,56
3244,13,41384,41384,0,0,0,0,1.0,1,1.0,1,1.0,1,0.47401041966282254,57
3245,20,41404,41404,0,0,0,0,1.0,1,1.0,1,1.0,1,0.41078439540064854,59
3246,12,41416,41416,0,0,0,0,1.0,1,1.0,1,1.0,1,0.39605326483750536,59
3247,13,41429,41429,0,0,0,0,1.0,1,1.0,1,1.0,1,0.3674767724287616,59
3248,10,41439,41439,0,0,0,0,1.0,1,1.0,1,1.0,1,0.31955523886951015,59
3249,17,41456,41456,0,0,0,0,1.0,1,1.0,1,1.0,1,0.413629086922566,58
3250,13,41469,41469,0,0,0,0,1.0,1,1.0,1,1.0,1,0.42188224860216067,58
3251,13,41482,41482,0,0,0,0,1.0,1,1.0,1,1.0,1,0.39619510287228027,57
3252,10,41492,41492,0,0,0,0,1.0,1,1.0,1,1.0,1,0.49045734668584795,57
3253,15,41507,41507,0,0,0,0,1.0,1,1.0,1,1.0,1,0.37150572032969714,56
3254,12,41519,41519,0,0,0,0,1.0,1,1.0,1,1.0,1,0.482964957211161,57
3255,15,41534,41534,0,0,0,0,1.0,1,1.0,1,1.0,1,0.43230465794197764,57
3256,11,41545,41545,0,0,0,0,1.0,1,1.0,1,1.0,1,0.3052897843542199,57
3257,18,41563,41563,0,0,0,0,1.0,1,1.0,1,1.0,1,0.3331837173385547,57
3258,24,41587,41587,0,0,0,0,1.0,1,1.0,1,1.0,1,0.27791147971716973,58
3259,16,41603,41603,0,0,0,0,1.0,1,1.0,1,1.0,1,0.30255504007106276,59
3260,19,41622,41622,0,0,0,0,1.0,1,1.0,1,1.0,1,0.23701729652333633,60
3261,23,41645,41645,0,0,0,0,1.0,1,1.0,1,1.0,1,0.2887772642393315,60
3262,18,41663,41663,0,0,0,0,1.0,1,1.0,1,1.0,1,0.27047695542530076,61
3263,23,41686,41686,0,0,0,0,1.0,1,1.0,1,1.0,1,0.2992028985142389,62
3264,18,41704,41704,0,0,0,0,1.0,1,1.0,1,1.0,1,0.31682035815991183,60
3265,14,41718,41718,0,0,0,0,1.0,1,1.0,1,1.0,1,0.32138258109661677,58
3266,18,41736,41736,0,0,0,0,1.0,1,1.0,1,1.0,1,0.3813481571090915,59
3267,15,41751,41751,0,0,0,0,1.0,1,1.0,1,1.0,1,0.33258620710500425,60
3268,13,41764,41764,0,0,0,0,1.0,1,1.0,1,1.0,1,0.38494518161268415,58
3269,16,41780,41780,0,0,0,0,1.0,1,1.0,1,1.0,1,0.40277507027007925,57
3270,15,41795,41795,0,0,0,0,1.0,1,1.0,1,1.0,1,0.3917943246118413,56
3271,18,41813,41813,0,0,0,0,1.0,1,1.0,1,1.0,1,0.457327750726053,55
3272,9,41822,41822,0,0,0,0,1.0,1,1.0,1,1.0,1,0.47133493706306895,55
3273,15,41837,41837,0,0,0,0,1.0,1,1.0,1,1.0,1,0.4187833508170633,55
3274,14,41851,41851,0,0,0,0,1.0,1,1.0,1,1.0,1,0.4334526086644283,55
3275,14,41865,41865,0,0,0,0,1.0,1,1.0,1,1.0,1,0.4503688879033337,55
3276,9,41874,41874,0,0,0,0,1.0,1,1.0,1,1.0,1,0.43790493637075373,55
3277,18,41892,41892,0,0,0,0,1.0,1,1.0,1,1.0,1,0.46636493268247103,57
3278,8,41900,41900,0,0,0,0,1.0,1,1.0,1,1.0,1,0.4152704970945686,56
3279,10,41910,41910,0,0,0,0,1.0,1,1.0,1,1.0,1,0.4549835950844988,54
3280,22,41932,41932,0,0,0,0,1.0,1,1.0,1,1.0,1,0.48622878107452405,53
3281,10,41942,41942,0,0,0,0,1.0,1,1.0,1,1.0,1,0.3809336277890296,52
3282,13,41955,41955,0,0,0,0,1.0,1,1.0,1,1.0,1,0.34627245095812403,50
3283,9,41964,41964,0,0,0,0,1.0,1,1.0,1,1.0,1,0.4097665759873076,50
3284,13,41977,41977,0,0,0,0,1.0,1,1.0,1,1.0,1,0.21774981323795115,47
3285,13,41990,41990,0,0,0,0,1.0,1,1.0,1,1.0,1,0.2164639700364747,48
3286,23,42013,42013,0,0,0,0,1.0,1,1.0,1,1.0,1,0.2739863203160738,46
3287,20,42033,42033,0,0,0,0,1.0,1,1.0,1,1.0,1,0.22776150853838364,46
3288,15,42048,42048,0,0,0,0,1.0,1,1.0,1,1.0,1,0.2672303103657491,46
3289,15,42063,42063,0,0,0,0,1.0,1,1.0,1,1.0,1,0.20121886192155342,48
3290,18,42081,42081,0,0,0,0,1.0,1,1.0,1,1.0,1,0.20601870047728832,48
3291,13,42094,42094,0,0,0,0,1.0,1,1.0,1,1.0,1,0.2380401468975464,50
3292,16,42110,42110,0,0,0,0,1.0,1,1.0,1,1.0,1,0.17142496612237298,50
3293,18,42128,42128,0,0,0,0,1.0,1,1.0,1,1.0,1,0.247041857956419,51
3294,16,42144,42144,0,0,0,0,1.0,1,1.0,1,1.0,1,0.23334186085944594,50
3295,12,42156,42156,0,0,0,0,1.0,1,1.0,1,1.0,1,0.29574198008726527,50
3296,9,42165,42165,0,0,0,0,1.0,1,1.0,1,1.0,1,0.30463865872461326,50
3297,15,42180,42180,0,0,0,0,1.0,1,1.0,1,1.0,1,0.2702834075032465,51
3298,16,42196,42196,0,0,0,0,1.0,1,1.0,1,1.0,1,0.3258396150254086,52
3299,16,42212,42212,0,0,0,0,1.0,1,1.0,1,1.0,1,0.2591050629077122,53
3300,16,42228,42228,0,0,0,0,1.0,1,1.0,1,1.0,1,0.2790918119488899,53
3301,20,42248,42248,0,0,0,0,1.0,1,1.0,1,1.0,1,0.32001417998633785,53
3302,6,42254,42254,0,0,0,0,1.0,1,1.0,1,1.0,1,0.3257983988767591,53
3303,9,42263,42263,0,0,0,0,1.0,1,1.0,1,1.0,1,0.345466361650752,52
3304,12,42275,42275,0,0,0,0,1.0,1,1.0,1,1.0,1,0.2689099510172354,52
3305,13,42288,42288,0,0,0,0,1.0,1,1.0,1,1.0,1,0.28015170304885656,51
3306,7,42295,42295,0,0,0,0,1.0,1,1.0,1,1.0,1,0.2476923955405016,51
3307,15,42310,42310,0,0,0,0,1.0,1,1.0,1,1.0,1,0.24395971395299673,48
3308,17,42327,42327,0,0,0,0,1.0,1,1.0,1,1.0,1,0.266079382878863,48
3309,17,42344,42344,0,0,0,0,1.0,1,1.0,1,1.0,1,0.2957626513800373,48
3310,14,42358,42358,0,0,0,0,1.0,1,1.0,1,1.0,1,0.30813898629812975,47
3311,14,42372,42372,0,0,0,0,1.0,1,1.0,1,1.0,1,0.3818285414306807,49
3312,18,42390,42390,0,0,0,0,1.0,1,1.0,1,1.0,1,0.2698440394545074,48
3313,14,42404,42404,0,0,0,0,1.0,1,1.0,1,1.0,1,0.3307255852251544,49
3314,8,42412,42412,0,0,0,0,1.0,1,1.0,1,1.0,1,0.2941236354772759,47
3315,11,42423,42423,0,0,0,0,1.0,1,1.0,1,1.0,1,0.4064681427639385,47
3316,10,42433,42433,0,0,0,0,1.0,1,1.0,1,1.0,1,0.39256726311432305,47
3317,6,42439,42439,0,0,0,0,1.0,1,1.0,1,1.0,1,0.3522674673818104,46
3318,23,42462,42462,0,0,0,0,1.0,1,1.0,1,1.0,1,0.31948606850070926,45
3319,12,42474,42474,0,0,0,0,1.0,1,1.0,1,1.0,1,0.241594348275911,44
3320,15,42489,42489,0,0,0,0,1.0,1,1.0,1,1.0,1,0.30515804225991827,43
3321,13,42502,42502,0,0,0,0,1.0,1,1.0,1,1.0,1,0.39477656942362793,43
3322,16,42518,42518,0,0,0,0,1.0,1,1.0,1,1.0,1,0.4106007772577672,40
3323,18,42536,42536,0,0,0,0,1.0,1,1.0,1,1.0,1,0.3899709558751626,40
3324,18,42554,42554,0,0,0,0,1.0,1,1.0,1,1.0,1,0.36334060487269026,40
3325,17,42571,42571,0,0,0,0,1.0,1,1.0,1,1.0,1,0.42682443902935147,40
3326,14,42585,42585,0,0,0,0,1.0,1,1.0,1,1.0,1,0.32592958084618345,41
3327,21,42606,42606,0,0,0,0,1.0,1,1.0,1,1.0,1,0.442498459876484,39
3328,22,42628,42628,0,0,0,0,1.0,1,1.0,1,1.0,1,0.3746002910086899,41
3329,20,42648,42648,0,0,0,0,1.0,1,1.0,1,1.0,1,0.5007729620755237,39
3330,12,42660,42660,0,0,0,0,1.0,1,1.0,1,1.0,1,0.28701612479626987,40
3331,15,42675,42675,0,0,0,0,1.0,1,1.0,1,1.0,1,0.4431580197214376,38
3332,11,42686,42686,0,0,0,0,1.0,1,1.0,1,1.0,1,0.3795717828777109,38
3333,21,42707,42707,0,0,0,0,1.0,1,1.0,1,1.0,1,0.3478430782222556,38
3334,8,42715,42715,0,0,0,0,1.0,1,1.0,1,1.0,1,0.4636929326757316,40
3335,25,42740,42740,0,0,0,0,1.0,1,1.0,1,1.0,1,0.2631437724829446,40
3336,13,42753,42753,0,0,0,0,1.0,1,1.0,1,1.0,1,0.40692546036870153,39
3337,12,42765,42765,0,0,0,0,1.0,1,1.0,1,1.0,1,0.37058667605478196,40
3338,22,42787,42787,0,0,0,0,1.0,1,1.0,1,1.0,1,0.3910251812164604,41
3339,18,42805,42805,0,0,0,0,1.0,1,1.0,1,1.0,1,0.43035908577846754,42
3340,15,42820,42820,0,0,0,0,1.0,1,1.0,1,1.0,1,0.43528410391175726,43
3341,12,42832,42832,0,0,0,0,1.0,1,1.0,1,1.0,1,0.3601353945281099,43
3342,24,42856,42856,0,0,0,0,1.0,1,1.0,1,1.0,1,0.41136220889264563,44
3343,9,42865,42865,0,0,0,0,1.0,1,1.0,1,1.0,1,0.38760325099955667,44
3344,11,42876,42876,0,0,0,0,1.0,1,1.0,1,1.0,1,0.440939962201033,44
3345,14,42890,42890,0,0,0,0,1.0,1,1.0,1,1.0,1,0.4846675287265907,43
3346,7,42897,42897,0,0,0,0,1.0,1,1.0,1,1.0,1,0.5218446602469596,42
3347,8,42905,42905,0,0,0,0,1.0,1,1.0,1,1.0,1,0.45641187341116163,44
3348,14,42919,42919,0,0,0,0,1.0,1,1.0,1,1.0,1,0.40543906967919835,45
3349,13,42932,42932,0,0,0,0,1.0,1,1.0,1,1.0,1,0.5034384713485051,45
3350,22,42954,42954,0,0,0,0,1.0,1,1.0,1,1.0,1,0.4125655562970674,46
3351,17,42971,42971,0,0,0,0,1.0,1,1.0,1,1.0,1,0.4269699229316029,47
3352,29,43000,43000,0,0,0,0,1.0,1,1.0,1,1.0,1,0.446041754360003,47
3353,21,43021,43021,0,0,0,0,1.0,1,1.0,1,1.0,1,0.5730018378861935,48
3354,20,43041,43041,0,0,0,0,1.0,1,1.0,1,1.0,1,0.5237266536647861,48
3355,19,43060,43060,0,0,0,0,1.0,1,1.0,1,1.0,1,0.5016101245678298,48
3356,27,43087,43087,0,0,0,0,1.0,1,1.0,1,1.0,1,0.3528165967422751,48
3357,20,43107,43107,0,0,0,0,1.0,1,1.0,1,1.0,1,0.404487313420029,47
3358,25,43132,43132,0,0,0,0,1.0,1,1.0,1,1.0,1,0.4045154309216666,46
3359,18,43150,43150,0,0,0,0,1.0,1,1.0,1,1.0,1,0.4882327548107666,45
3360,11,43161,43161,0,0,0,0,1.0,1,1.0,1,1.0,1,0.5042792574562616,44
3361,21,43182,43182,0,0,0,0,1.0,1,1.0,1,1.0,1,0.4939779072001714,43
3362,15,43197,43197,0,0,0,0,1.0,1,1.0,1,1.0,1,0.40258230971045134,42
3363,17,43214,43214,0,0,0,0,1.0,1,1.0,1,1.0,1,0.43386977940423793,41
3364,18,43232,43232,0,0,0,0,1.0,1,1.0,1,1.0,1,0.2099046578974649,41
3365,19,43251,43251,0,0,0,0,1.0,1,1.0,1,1.0,1,0.25376923898457343,41
3366,19,43270,43270,0,0,0,0,1.0,1,1.0,1,1.0,1,0.2901843422789933,40
3367,12,43282,43282,0,0,0,0,1.0,1,1.0,1,1.0,1,0.2585770093202736,39
3368,12,43294,43294,0,0,0,0,1.0,1,1.0,1,1.0,1,0.33196618814841117,39
3369,8,43302,43302,0,0,0,0,1.0,1,1.0,1,1.0,1,0.3884445884254816,40
3370,15,43317,43317,0,0,0,0,1.0,1,1.0,1,1.0,1,0.27648259053084123,41
3371,10,43327,43327,0,0,0,0,1.0,1,1.0,1,1.0,1,0.3242085136498177,41
3372,16,43343,43343,0,0,0,0,1.0,1,1.0,1,1.0,1,0.2965875086232376,40
3373,10,43353,43353,0,0,0,0,1.0,1,1.0,1,1.0,1,0.4090022289126929,41
3374,15,43368,43368,0,0,0,0,1.0,1,1.0,1,1.0,1,0.27832089450717484,42
3375,13,43381,43381,0,0,0,0,1.0,1,1.0,1,1.0,1,0.26221113537257174,44
3376,14,43395,43395,0,0,0,0,1.0,1,1.0,1,1.0,1,0.2130394764387483,46
3377,10,43405,43405,0,0,0,0,1.0,1,1.0,1,1.0,1,0.34849970689453424,47
3378,11,43416,43416,0,0,0,0,1.0,1,1.0,1,1.0,1,0.2744651707673662,48
3379,7,43423,43423,0,0,0,0,1.0,1,1.0,1,1.0,1,0.21939126060325842,48
3380,12,43435,43435,0,0,0,0,1.0,1,1.0,1,1.0,1,0.21829721027980487,48
3381,10,43445,43445,0,0,0,0,1.0,1,1.0,1,1.0,1,0.2696325663548647,48
3382,18,43463,43463,0,0,0,0,1.0,1,1.0,1,1.0,1,0.3074821263247377,49
3383,13,43476,43476,0,0,0,0,1.0,1,1.0,1,1.0,1,0.26349093046170763,47
3384,10,43486,43486,0,0,0,0,1.0,1,1.0,1,1.0,1,0.26529751553054653,48
3385,15,43501,43501,0,0,0,0,1.0,1,1.0,1,1.0,1,0.21363731087998014,47
3386,14,43515,43515,0,0,0,0,1.0,1,1.0,1,1.0,1,0.17453139276584365,49
3387,18,43533,43533,0,0,0,0,1.0,1,1.0,1,1.0,1,0.29487092063511167,48
3388,13,43546,43546,0,0,0,0,1.0,1,1.0,1,1.0,1,0.3378789180483223,48
3389,13,43559,43559,0,0,0,0,1.0,1,1.0,1,1.0,1,0.25021978980520626,50
3390,17,43576,43576,0,0,0,0,1.0,1,1.0,1,1.0,1,0.25682994968465606,51
3391,20,43596,43596,0,0,0,0,1.0,1,1.0,1,1.0,1,0.3051807451122003,51
3392,19,43615,43615,0,0,0,0,1.0,1,1.0,1,1.0,1,0.18599788437790618,52
3393,31,43646,43646,0,0,0,0,1.0,1,1.0,1,1.0,1,0.28114010658802674,52
3394,20,43666,43666,0,0,0,0,1.0,1,1.0,1,1.0,1,0.32343566591359885,52
3395,15,43681,43681,0,0,0,0,1.0,1,1.0,1,1.0,1,0.26839871149039146,50
3396,22,43703,43703,0,0,0,0,1.0,1,1.0,1,1.0,1,0.24834010308224905,49
3397,31,43734,43734,0,0,0,0,1.0,1,1.0,1,1.0,1,0.22465977841929835,49
3398,21,43755,43755,0,0,0,0,1.0,1,1.0,1,1.0,1,0.23556603386729386,48
3399,13,43768,43768,0,0,0,0,1.0,1,1.0,1,1.0,1,0.26517382126026173,49
3400,14,43782,43782,0,0,0,0,1.0,1,1.0,1,1.0,1,0.2646092681479226,50
3401,19,43801,43801,0,0,0,0,1.0,1,1.0,1,1.0,1,0.33503456919904834,51
3402,22,43823,43823,0,0,0,0,1.0,1,1.0,1,1.0,1,0.35040886550869654,51
3403,14,43837,43837,0,0,0,0,1.0,1,1.0,1,1.0,1,0.3389744458094818,51
3404,25,43862,43862,0,0,0,0,1.0,1,1.0,1,1.0,1,0.34881405449642755,51
3405,14,43876,43876,0,0,0,0,1.0,1,1.0,1,1.0,1,0.35737958912883744,51
3406,11,43887,43887,0,0,0,0,1.0,1,1.0,1,1.0,1,0.36610069014408025,51
3407,17,43904,43904,0,0,0,0,1.0,1,1.0,1,1.0,1,0.3251136472195373,52
3408,18,43922,43922,0,0,0,0,1.0,1,1.0,1,1.0,1,0.44993911267731296,53
3409,25,43947,43947,0,0,0,0,1.0,1,1.0,1,1.0,1,0.35884663432756453,54
3410,20,43967,43967,0,0,0,0,1.0,1,1.0,1,1.0,1,0.4833525159549128,54
3411,12,43979,43979,0,0,0,0,1.0,1,1.0,1,1.0,1,0.44122959703979503,54
3412,26,44005,44005,0,0,0,0,1.0,1,1.0,1,1.0,1,0.48183555374394166,55
3413,26,44031,44031,0,0,0,0,1.0,1,1.0,1,1.0,1,0.323188559752168,55
3414,16,44047,44047,0,0,0,0,1.0,1,1.0,1,1.0,1,0.2725166122316472,55
3415,26,44073,44073,0,0,0,0,1.0,1,1.0,1,1.0,1,0.3302200450905793,56
3416,26,44099,44099,0,0,0,0,1.0,1,1.0,1,1.0,1,0.2785609550158694,55
3417,24,44123,44123,0,0,0,0,1.0,1,1.0,1,1.0,1,0.2505302555327885,56
3418,19,44142,44142,0,0,0,0,1.0,1,1.0,1,1.0,1,0.2335955831356232,55
3419,21,44163,44163,0,0,0,0,1.0,1,1.0,1,1.0,1,0.2654607474438923,56
3420,19,44182,44182,0,0,0,0,1.0,1,1.0,1,1.0,1,0.23896034369004154,55
3421,19,44201,44201,0,0,0,0,1.0,1,1.0,1,1.0,1,0.23830333743237386,57
3422,18,44219,44219,0,0,0,0,1.0,1,1.0,1,1.0,1,0.2530247123796194,56
3423,21,44240,44240,0,0,0,0,1.0,1,1.0,1,1.0,1,0.2600482201132864,56
3424,18,44258,44258,0,0,0,0,1.0,1,1.0,1,1.0,1,0.23586937553426982,56
3425,17,44275,44275,0,0,0,0,1.0,1,1.0,1,1.0,1,0.4000559193457842,56
3426,27,44302,44302,0,0,0,0,1.0,1,1.0,1,1.0,1,0.23368757229814893,55
3427,34,44336,44336,0,0,0,0,1.0,1,1.0,1,1.0,1,0.4146905702605615,55
3428,14,44350,44350,0,0,0,0,1.0,1,1.0,1,1.0,1,0.24083591349089709,55
3429,15,44365,44365,0,0,0,0,1.0,1,1.0,1,1.0,1,0.3910357364280732,54
3430,21,44386,44386,0,0,0,0,1.0,1,1.0,1,1.0,1,0.33731268807642123,56
3431,16,44402,44402,0,0,0,0,1.0,1,1.0,1,1.0,1,0.32231020743170125,54
3432,26,44428,44428,0,0,0,0,1.0,1,1.0,1,1.0,1,0.33352250759092783,56
3433,20,44448,44448,0,0,0,0,1.0,1,1.0,1,1.0,1,0.34266488748885154,53
3434,26,44474,44474,0,0,0,0,1.0,1,1.0,1,1.0,1,0.40707204337234504,51
3435,23,44497,44497,0,0,0,0,1.0,1,1.0,1,1.0,1,0.42669320667028965,51
3436,24,44521,44521,0,0,0,0,1.0,1,1.0,1,1.0,1,0.29577078396045053,51
3437,24,44545,44545,0,0,0,0,1.0,1,1.0,1,1.0,1,0.49118356980957123,53
3438,17,44562,44562,0,0,0,0,1.0,1,1.0,1,1.0,1,0.4331479765083675,52
3439,18,44580,44580,0,0,0,0,1.0,1,1.0,1,1.0,1,0.39164047909078276,54
3440,23,44603,44603,0,0,0,0,1.0,1,1.0,1,1.0,1,0.3710934852439032,52
3441,10,44613,44613,0,0,0,0,1.0,1,1.0,1,1.0,1,0.36596751867279975,53
3442,17,44630,44630,0,0,0,0,1.0,1,1.0,1,1.0,1,0.3606666011540052,53
3443,12,44642,44642,0,0,0,0,1.0,1,1.0,1,1.0,1,0.3852877314864052,53
3444,13,44655,44655,0,0,0,0,1.0,1,1.0,1,1.0,1,0.3728111931100664,52
3445,14,44669,44669,0,0,0,0,1.0,1,1.0,1,1.0,1,0.2487642224338307,53
3446,13,44682,44682,0,0,0,0,1.0,1,1.0,1,1.0,1,0.2887215675238463,53
3447,19,44701,44701,0,0,0,0,1.0,1,1.0,1,1.0,1,0.2932718151948521,53
3448,13,44714,44714,0,0,0,0,1.0,1,1.0,1,1.0,1,0.26630858554513737,52
3449,17,44731,44731,0,0,0,0,1.0,1,1.0,1,1.0,1,0.2985642917473173,52
3450,8,44739,44739,0,0,0,0,1.0,1,1.0,1,1.0,1,0.24357073684638203,52
3451,15,44754,44754,0,0,0,0,1.0,1,1.0,1,1.0,1,0.2862800551092041,54
3452,10,44764,44764,0,0,0,0,1.0,1,1.0,1,1.0,1,0.2630242309453457,54
3453,21,44785,44785,0,0,0,0,1.0,1,1.0,1,1.0,1,0.2555854644613107,54
3454,17,44802,44802,0,0,0,0,1.0,1,1.0,1,1.0,1,0.3639568776885522,57
3455,18,44820,44820,0,0,0,0,1.0,1,1.0,1,1.0,1,0.3228963565422312,57
3456,15,44835,44835,0,0,0,0,1.0,1,1.0,1,1.0,1,0.3565532015521713,58
3457,26,44861,44861,0,0,0,0,1.0,1,1.0,1,1.0,1,0.39145912687896045,57
3458,26,44887,44887,0,0,0,0,1.0,1,1.0,1,1.0,1,0.4375762838114817,57
3459,21,44908,44908,0,0,0,0,1.0,1,1.0,1,1.0,1,0.4399959727594158,57
3460,14,44922,44922,0,0,0,0,1.0,1,1.0,1,1.0,1,0.3911719196493734,58
3461,28,44950,44950,0,0,0,0,1.0,1,1.0,1,1.0,1,0.3918433906268422,59
3462,22,44972,44972,0,0,0,0,1.0,1,1.0,1,1.0,1,0.4444898853082,59
3463,13,44985,44985,0,0,0,0,1.0,1,1.0,1,1.0,1,0.3296520839133328,59
3464,16,45001,45001,0,0,0,0,1.0,1,1.0,1,1.0,1,0.3921224640292988,59
3465,18,45019,45019,0,0,0,0,1.0,1,1.0,1,1.0,1,0.3179079474658584,57
3466,12,45031,45031,0,0,0,0,1.0,1,1.0,1,1.0,1,0.30489354300334004,57
3467,17,45048,45048,0,0,0,0,1.0,1,1.0,1,1.0,1,0.2884469505915397,57
3468,18,45066,45066,0,0,0,0,1.0,1,1.0,1,1.0,1,0.3044681456248649,57
3469,14,45080,45080,0,0,0,0,1.0,1,1.0,1,1.0,1,0.3144080989754795,53
3470,10,45090,45090,0,0,0,0,1.0,1,1.0,1,1.0,1,0.27740069872833273,50
3471,10,45100,45100,0,0,0,0,1.0,1,1.0,1,1.0,1,0.3212183529217427,49
3472,18,45118,45118,0,0,0,0,1.0,1,1.0,1,1.0,1,0.22284934282821717,47
3473,5,45123,45123,0,0,0,0,1.0,1,1.0,1,1.0,1,0.3534582950328536,45
3474,21,45144,45144,0,0,0,0,1.0,1,1.0,1,1.0,1,0.3178191441864656,42
3475,13,45157,45157,0,0,0,0,1.0,1,1.0,1,1.0,1,0.35713740520227044,43
3476,13,45170,45170,0,0,0,0,1.0,1,1.0,1,1.0,1,0.28788350930271517,41
3477,19,45189,45189,0,0,0,0,1.0,1,1.0,1,1.0,1,0.3758682983314512,42
3478,19,45208,45208,0,0,0,0,1.0,1,1.0,1,1.0,1,0.3009435317716913,40
3479,18,45226,45226,0,0,0,0,1.0,1,1.0,1,1.0,1,0.3264034756111577,40
3480,19,45245,45245,0,0,0,0,1.0,1,1.0,1,1.0,1,0.2477611951119691,40
3481,17,45262,45262,0,0,0,0,1.0,1,1.0,1,1.0,1,0.22180193736402937,40
3482,10,45272,45272,0,0,0,0,1.0,1,1.0,1,1.0,1,0.23888841057501956,40
3483,14,45286,45286,0,0,0,0,1.0,1,1.0,1,1.0,1,0.4222581859956589,39
3484,12,45298,45298,0,0,0,0,1.0,1,1.0,1,1.0,1,0.3896121948246949,39
3485,6,45304,45304,0,0,0,0,1.0,1,1.0,1,1.0,1,0.230607884334856,40
3486,17,45321,45321,0,0,0,0,1.0,1,1.0,1,1.0,1,0.29314636309521,41
3487,18,45339,45339,0,0,0,0,1.0,1,1.0,1,1.0,1,0.4544418543580937,41
3488,15,45354,45354,0,0,0,0,1.0,1,1.0,1,1.0,1,0.4354333341105299,42
3489,15,45369,45369,0,0,0,0,1.0,1,1.0,1,1.0,1,0.39414255325932546,44
3490,17,45386,45386,0,0,0,0,1.0,1,1.0,1,1.0,1,0.26110805948818183,44
3491,28,45414,45414,0,0,0,0,1.0,1,1.0,1,1.0,1,0.37036392637879584,45
3492,27,45441,45441,0,0,0,0,1.0,1,1.0,1,1.0,1,0.3910099771113456,45
3493,21,45462,45462,0,0,0,0,1.0,1,1.0,1,1.0,1,0.41763040978329935,45
3494,16,45478,45478,0,0,0,0,1.0,1,1.0,1,1.0,1,0.42324334164521105,45
3495,12,45490,45490,0,0,0,0,1.0,1,1.0,1,1.0,1,0.3651320819623654,45
3496,18,45508,45508,0,0,0,0,1.0,1,1.0,1,1.0,1,0.45172398041382494,46
3497,31,45539,45539,0,0,0,0,1.0,1,1.0,1,1.0,1,0.4416275625590073,47
3498,38,45577,45577,0,0,0,0,1.0,1,1.0,1,1.0,1,0.38407805925157995,48
3499,11,45588,45588,0,0,0,0,1.0,1,1.0,1,1.0,1,0.41305248982037135,47
3500,12,45600,45600,0,0,0,0,1.0,1,1.0,1,1.0,1,0.41207701131831403,50
3501,13,45613,45613,0,0,0,0,1.0,1,1.0,1,1.0,1,0.3578894528829204,50
3502,25,45638,45638,0,0,0,0,1.0,1,1.0,1,1.0,1,0.4534270101028073,50
3503,16,45654,45654,0,0,0,0,1.0,1,1.0,1,1.0,1,0.40468292220920454,50
3504,23,45677,45677,0,0,0,0,1.0,1,1.0,1,1.0,1,0.5010573608511841,47
3505,23,45700,45700,0,0,0,0,1.0,1,1.0,1,1.0,1,0.526703205313813,48
3506,16,45716,45716,0,0,0,0,1.0,1,1.0,1,1.0,1,0.49876873127484933,49
3507,12,45728,45728,0,0,0,0,1.0,1,1.0,1,1.0,1,0.5571554883826295,46
3508,28,45756,45756,0,0,0,0,1.0,1,1.0,1,1.0,1,0.5138845430018592,47
3509,10,45766,45766,0,0,0,0,1.0,1,1.0,1,1.0,1,0.5832370720595546,44
3510,11,45777,45777,0,0,0,0,1.0,1,1.0,1,1.0,1,0.4190244549433301,45
3511,18,45795,45795,0,0,0,0,1.0,1,1.0,1,1.0,1,0.5353444449175809,44
3512,19,45814,45814,0,0,0,0,1.0,1,1.0,1,1.0,1,0.4797605912693978,42
3513,16,45830,45830,0,0,0,0,1.0,1,1.0,1,1.0,1,0.47335700958846677,42
3514,6,45836,45836,0,0,0,0,1.0,1,1.0,1,1.0,1,0.4611311574884444,42
3515,13,45849,45849,0,0,0,0,1.0,1,1.0,1,1.0,1,0.4687604444754632,42
3516,14,45863,45863,0,0,0,0,1.0,1,1.0,1,1.0,1,0.374857108530681,41
3517,11,45874,45874,0,0,0,0,1.0,1,1.0,1,1.0,1,0.41501539722729486,44
3518,17,45891,45891,0,0,0,0,1.0,1,1.0,1,1.0,1,0.5536902672255175,43
3519,12,45903,45903,0,0,0,0,1.0,1,1.0,1,1.0,1,0.4841056685831326,44
3520,19,45922,45922,0,0,0,0,1.0,1,1.0,1,1.0,1,0.4786330835696049,45
3521,11,45933,45933,0,0,0,0,1.0,1,1.0,1,1.0,1,0.4429518646730216,45
3522,13,45946,45946,0,0,0,0,1.0,1,1.0,1,1.0,1,0.4548347702533443,46
3523,24,45970,45970,0,0,0,0,1.0,1,1.0,1,1.0,1,0.5215597480542872,46
3524,15,45985,45985,0,0,0,0,1.0,1,1.0,1,1.0,1,0.4729182727290965,47
3525,27,46012,46012,0,0,0,0,1.0,1,1.0,1,1.0,1,0.4461463945605452,48
3526,16,46028,46028,0,0,0,0,1.0,1,1.0,1,1.0,1,0.5102700142653257,49
3527,15,46043,46043,0,0,0,0,1.0,1,1.0,1,1.0,1,0.45171504517065736,49
3528,21,46064,46064,0,0,0,0,1.0,1,1.0,1,1.0,1,0.3798240429078499,51
3529,17,46081,46081,0,0,0,0,1.0,1,1.0,1,1.0,1,0.4768637960544986,51
3530,21,46102,46102,0,0,0,0,1.0,1,1.0,1,1.0,1,0.4510474355793423,52
3531,15,46117,46117,0,0,0,0,1.0,1,1.0,1,1.0,1,0.37920766471043094,52
3532,27,46144,46144,0,0,0,0,1.0,1,1.0,1,1.0,1,0.4662800175880476,52
3533,20,46164,46164,0,0,0,0,1.0,1,1.0,1,1.0,1,0.5001496485220296,52
3534,20,46184,46184,0,0,0,0,1.0,1,1.0,1,1.0,1,0.4934042713212484,52
3535,32,46216,46216,0,0,0,0,1.0,1,1.0,1,1.0,1,0.3605834681188804,52
3536,22,46238,46238,0,0,0,0,1.0,1,1.0,1,1.0,1,0.4471622975551101,54
3537,32,46270,46270,0,0,0,0,1.0,1,1.0,1,1.0,1,0.4099815008838853,55
3538,18,46288,46288,0,0,0,0,1.0,1,1.0,1,1.0,1,0.47509870569493134,55
3539,15,46303,46303,0,0,0,0,1.0,1,1.0,1,1.0,1,0.504217780171801,58
3540,16,46319,46319,0,0,0,0,1.0,1,1.0,1,1.0,1,0.35723951574652757,59
3541,18,46337,46337,0,0,0,0,1.0,1,1.0,1,1.0,1,0.4460538588103504,59
3542,23,46360,46360,0,0,0,0,1.0,1,1.0,1,1.0,1,0.46089303969627987,61
3543,16,46376,46376,0,0,0,0,1.0,1,1.0,1,1.0,1,0.34206701886678825,62
3544,26,46402,46402,0,0,0,0,1.0,1,1.0,1,1.0,1,0.4629219158827191,59
3545,23,46425,46425,0,0,0,0,1.0,1,1.0,1,1.0,1,0.4932133736767422,59
3546,23,46448,46448,0,0,0,0,1.0,1,1.0,1,1.0,1,0.4720266668826948,57
3547,16,46464,46464,0,0,0,0,1.0,1,1.0,1,1.0,1,0.5422254065283787,53
3548,20,46484,46484,0,0,0,0,1.0,1,1.0,1,1.0,1,0.40641990803103395,53
3549,29,46513,46513,0,0,0,0,1.0,1,1.0,1,1.0,1,0.45689134197295583,52
3550,18,46531,46531,0,0,0,0,1.0,1,1.0,1,1.0,1,0.5389293291671896,51
3551,13,46544,46544,0,0,0,0,1.0,1,1.0,1,1.0,1,0.611242798678071,51
3552,26,46570,46570,0,0,0,0,1.0,1,1.0,1,1.0,1,0.5682530836058239,51
3553,16,46586,46586,0,0,0,0,1.0,1,1.0,1,1.0,1,0.61785724708329,49
3554,21,46607,46607,0,0,0,0,1.0,1,1.0,1,1.0,1,0.573387729684963,49
3555,19,46626,46626,0,0,0,0,1.0,1,1.0,1,1.0,1,0.5296852396637052,51
3556,31,46657,46657,0,0,0,0,1.0,1,1.0,1,1.0,1,0.5019561894761403,51
3557,26,46683,46683,0,0,0,0,1.0,1,1.0,1,1.0,1,0.47439208074661066,52
3558,27,46710,46710,0,0,0,0,1.0,1,1.0,1,1.0,1,0.4459162176092088,52
3559,25,46735,46735,0,0,0,0,1.0,1,1.0,1,1.0,1,0.5283449271777781,52
3560,21,46756,46756,0,0,0,0,1.0,1,1.0,1,1.0,1,0.5935465544989341,53
3561,27,46783,46783,0,0,0,0,1.0,1,1.0,1,1.0,1,0.4992057464904638,54
3562,23,46806,46806,0,0,0,0,1.0,1,1.0,1,1.0,1,0.519811057208328,54
3563,28,46834,46834,0,0,0,0,1.0,1,1.0,1,1.0,1,0.5415524148882552,55
3564,14,46848,46848,0,0,0,0,1.0,1,1.0,1,1.0,1,0.5236884873451724,57
3565,17,46865,46865,0,0,0,0,1.0,1,1.0,1,1.0,1,0.5273787964860059,56
3566,16,46881,46881,0,0,0,0,1.0,1,1.0,1,1.0,1,0.5642346004136363,57
3567,17,46898,46898,0,0,0,0,1.0,1,1.0,1,1.0,1,0.5939420034411775,57
3568,18,46916,46916,0,0,0,0,1.0,1,1.0,1,1.0,1,0.4698713798130988,57
3569,24,46940,46940,0,0,0,0,1.0,1,1.0,1,1.0,1,0.5103781176598626,57
3570,16,46956,46956,0,0,0,0,1.0,1,1.0,1,1.0,1,0.4845666458822639,59
3571,25,46981,46981,0,0,0,0,1.0,1,1.0,1,1.0,1,0.4295815568478995,60
3572,15,46996,46996,0,0,0,0,1.0,1,1.0,1,1.0,1,0.4218503758320186,61
3573,24,47020,47020,0,0,0,0,1.0,1,1.0,1,1.0,1,0.40953798566577665,62
3574,17,47037,47037,0,0,0,0,1.0,1,1.0,1,1.0,1,0.4174783827722818,63
3575,18,47055,47055,0,0,0,0,1.0,1,1.0,1,1.0,1,0.46274352492460086,63
3576,11,47066,47066,0,0,0,0,1.0,1,1.0,1,1.0,1,0.38711138876288737,63
3577,15,47081,47081,0,0,0,0,1.0,1,1.0,1,1.0,1,0.3722449593735207,64
3578,10,47091,47091,0,0,0,0,1.0,1,1.0,1,1.0,1,0.36929511530442416,64
3579,8,47099,47099,0,0,0,0,1.0,1,1.0,1,1.0,1,0.376468786821248,64
3580,16,47115,47115,0,0,0,0,1.0,1,1.0,1,1.0,1,0.3642392887823313,65
3581,13,47128,47128,0,0,0,0,1.0,1,1.0,1,1.0,1,0.40800823146626025,68
3582,13,47141,47141,0,0,0,0,1.0,1,1.0,1,1.0,1,0.3703733458741476,68
3583,14,47155,47155,0,0,0,0,1.0,1,1.0,1,1.0,1,0.43484141133740023,65
3584,26,47181,47181,0,0,0,0,1.0,1,1.0,1,1.0,1,0.45187457449163404,64
3585,15,47196,47196,0,0,0,0,1.0,1,1.0,1,1.0,1,0.4132674517024597,64
3586,21,47217,47217,0,0,0,0,1.0,1,1.0,1,1.0,1,0.30947924139722016,65
3587,30,47247,47247,0,0,0,0,1.0,1,1.0,1,1.0,1,0.40397151394664327,64
3588,20,47267,47267,0,0,0,0,1.0,1,1.0,1,1.0,1,0.38493005156781007,62
3589,22,47289,47289,0,0,0,0,1.0,1,1.0,1,1.0,1,0.22765113724603445,63
3590,18,47307,47307,0,0,0,0,1.0,1,1.0,1,1.0,1,0.35516053730611064,63
3591,22,47329,47329,0,0,0,0,1.0,1,1.0,1,1.0,1,0.3932187776940381,62
3592,8,47337,47337,0,0,0,0,1.0,1,1.0,1,1.0,1,0.2989631169904515,59
3593,15,47352,47352,0,0,0,0,1.0,1,1.0,1,1.0,1,0.37180930059812256,58
3594,20,47372,47372,0,0,0,0,1.0,1,1.0,1,1.0,1,0.42145289949131626,57
3595,18,47390,47390,0,0,0,0,1.0,1,1.0,1,1.0,1,0.34163176441771226,59
3596,24,47414,47414,0,0,0,0,1.0,1,1.0,1,1.0,1,0.4309480848746652,57
3597,24,47438,47438,0,0,0,0,1.0,1,1.0,1,1.0,1,0.4002755193717722,57
3598,16,47454,47454,0,0,0,0,1.0,1,1.0,1,1.0,1,0.34497496809788103,57
3599,22,47476,47476,0,0,0,0,1.0,1,1.0,1,1.0,1,0.3754195295672427,58
3600,15,47491,47491,0,0,0,0,1.0,1,1.0,1,1.0,1,0.30839108621517747,58
3601,19,47510,47510,0,0,0,0,1.0,1,1.0,1,1.0,1,0.3362540483088418,58
3602,16,47526,47526,0,0,0,0,1.0,1,1.0,1,1.0,1,0.3550852319978597,60
3603,18,47544,47544,0,0,0,0,1.0,1,1.0,1,1.0,1,0.3506937404174862,60
3604,14,47558,47558,0,0,0,0,1.0,1,1.0,1,1.0,1,0.28982631146206744,60
3605,19,47577,47577,0,0,0,0,1.0,1,1.0,1,1.0,1,0.3353673268302065,61
3606,9,47586,47586,0,0,0,0,1.0,1,1.0,1,1.0,1,0.2825415619364099,63
3607,16,47602,47602,0,0,0,0,1.0,1,1.0,1,1.0,1,0.2643242664905024,63
3608,21,47623,47623,0,0,0,0,1.0,1,1.0,1,1.0,1,0.2552832309736967,64
3609,20,47643,47643,0,0,0,0,1.0,1,1.0,1,1.0,1,0.2672440504211206,66
3610,16,47659,47659,0,0,0,0,1.0,1,1.0,1,1.0,1,0.2807682716760092,67
3611,18,47677,47677,0,0,0,0,1.0,1,1.0,1,1.0,1,0.22114682417552792,67
3612,14,47691,47691,0,0,0,0,1.0,1,1.0,1,1.0,1,0.2736494510237239,66
3613,12,47703,47703,0,0,0,0,1.0,1,1.0,1,1.0,1,0.30294329221275806,66
3614,11,47714,47714,0,0,0,0,1.0,1,1.0,1,1.0,1,0.31066951680604776,65
3615,5,47719,47719,0,0,0,0,1.0,1,1.0,1,1.0,1,0.3448662368770344,65
3616,7,47726,47726,0,0,0,0,1.0,1,1.0,1,1.0,1,0.3657886718748891,65
3617,13,47739,47739,0,0,0,0,1.0,1,1.0,1,1.0,1,0.43942308611531095,66
3618,9,47748,47748,0,0,0,0,1.0,1,1.0,1,1.0,1,0.37097434203762697,66
3619,5,47753,47753,0,0,0,0,1.0,1,1.0,1,1.0,1,0.33883777321791,65
3620,14,47767,47767,0,0,0,0,1.0,1,1.0,1,1.0,1,0.35264402139719425,66
3621,14,47781,47781,0,0,0,0,1.0,1,1.0,1,1.0,1,0.4111240731451896,65
3622,12,47793,47793,0,0,0,0,1.0,1,1.0,1,1.0,1,0.3609629352713418,65
3623,14,47807,47807,0,0,0,0,1.0,1,1.0,1,1.0,1,0.32726598842346055,62
3624,19,47826,47826,0,0,0,0,1.0,1,1.0,1,1.0,1,0.34190526964540224,62
3625,17,47843,47843,0,0,0,0,1.0,1,1.0,1,1.0,1,0.2984897533233613,61
3626,18,47861,47861,0,0,0,0,1.0,1,1.0,1,1.0,1,0.2864556064456152,58
3627,18,47879,47879,0,0,0,0,1.0,1,1.0,1,1.0,1,0.16279054144269278,58
3628,19,47898,47898,0,0,0,0,1.0,1,1.0,1,1.0,1,0.2974821978537699,57
3629,20,47918,47918,0,0,0,0,1.0,1,1.0,1,1.0,1,0.21667740638151675,57
3630,21,47939,47939,0,0,0,0,1.0,1,1.0,1,1.0,1,0.31042417313213044,56
3631,14,47953,47953,0,0,0,0,1.0,1,1.0,1,1.0,1,0.23635479340644208,54
3632,15,47968,47968,0,0,0,0,1.0,1,1.0,1,1.0,1,0.22504642753924972,52
3633,16,47984,47984,0,0,0,0,1.0,1,1.0,1,1.0,1,0.19790762700033773,52
3634,10,47994,47994,0,0,0,0,1.0,1,1.0,1,1.0,1,0.22536532187476985,49
3635,19,48013,48013,0,0,0,0,1.0,1,1.0,1,1.0,1,0.18260687185127206,47
3636,14,48027,48027,0,0,0,0,1.0,1,1.0,1,1.0,1,0.14445306142669312,48
3637,16,48043,48043,0,0,0,0,1.0,1,1.0,1,1.0,1,0.29766783418287174,49
3638,18,48061,48061,0,0,0,0,1.0,1,1.0,1,1.0,1,0.27671011810759266,50
3639,15,48076,48076,0,0,0,0,1.0,1,1.0,1,1.0,1,0.29822391818700156,52
3640,12,48088,48088,0,0,0,0,1.0,1,1.0,1,1.0,1,0.33624316595185827,52
3641,8,48096,48096,0,0,0,0,1.0,1,1.0,1,1.0,1,0.2680128973417058,52
3642,8,48104,48104,0,0,0,0,1.0,1,1.0,1,1.0,1,0.3128985009193178,52
3643,9,48113,48113,0,0,0,0,1.0,1,1.0,1,1.0,1,0.31500413312148756,52
3644,9,48122,48122,0,0,0,0,1.0,1,1.0,1,1.0,1,0.2896102581225392,52
3645,12,48134,48134,0,0,0,0,1.0,1,1.0,1,1.0,1,0.3016945517073261,53
3646,12,48146,48146,0,0,0,0,1.0,1,1.0,1,1.0,1,0.2827719025548908,53
3647,15,48161,48161,0,0,0,0,1.0,1,1.0,1,1.0,1,0.29540049686845765,55
3648,15,48176,48176,0,0,0,0,1.0,1,1.0,1,1.0,1,0.30657562890668005,57
3649,18,48194,48194,0,0,0,0,1.0,1,1.0,1,1.0,1,0.25050188423090025,57
3650,7,48201,48201,0,0,0,0,1.0,1,1.0,1,1.0,1,0.2539801355194347,59
3651,19,48220,48220,0,0,0,0,1.0,1,1.0,1,1.0,1,0.3255757465848982,59
3652,6,48226,48226,0,0,0,0,1.0,1,1.0,1,1.0,1,0.280843157721586,59
3653,6,48232,48232,0,0,0,0,1.0,1,1.0,1,1.0,1,0.29445017870708684,59
3654,8,48240,48240,0,0,0,0,1.0,1,1.0,1,1.0,1,0.26667052855904394,59
3655,8,48248,48248,0,0,0,0,1.0,1,1.0,1,1.0,1,0.21099136593638576,62
3656,10,48258,48258,0,0,0,0,1.0,1,1.0,1,1.0,1,0.24476996013700963,62
3657,11,48269,48269,0,0,0,0,1.0,1,1.0,1,1.0,1,0.22355831053620867,63
3658,9,48278,48278,0,0,0,0,1.0,1,1.0,1,1.0,1,0.2167945426493759,63
3659,21,48299,48299,0,0,0,0,1.0,1,1.0,1,1.0,1,0.23087026421908893,62
3660,20,48319,48319,0,0,0,0,1.0,1,1.0,1,1.0,1,0.2094344712093508,62
3661,17,48336,48336,0,0,0,0,1.0,1,1.0,1,1.0,1,0.24677243378964683,61
3662,23,48359,48359,0,0,0,0,1.0,1,1.0,1,1.0,1,0.3045116567143898,60
3663,21,48380,48380,0,0,0,0,1.0,1,1.0,1,1.0,1,0.2438473182789111,61
3664,28,48408,48408,0,0,0,0,1.0,1,1.0,1,1.0,1,0.22737755890793274,58
3665,18,48426,48426,0,0,0,0,1.0,1,1.0,1,1.0,1,0.2291685470465591,58
3666,17,48443,48443,0,0,0,0,1.0,1,1.0,1,1.0,1,0.21340039496625346,58
3667,24,48467,48467,0,0,0,0,1.0,1,1.0,1,1.0,1,0.2929093889045803,58
3668,34,48501,48501,0,0,0,0,1.0,1,1.0,1,1.0,1,0.28626924408893245,58
3669,15,48516,48516,0,0,0,0,1.0,1,1.0,1,1.0,1,0.3135876093028271,57
3670,19,48535,48535,0,0,0,0,1.0,1,1.0,1,1.0,1,0.28622107445320766,56
3671,11,48546,48546,0,0,0,0,1.0,1,1.0,1,1.0,1,0.27879379127198484,57
3672,18,48564,48564,0,0,0,0,1.0,1,1.0,1,1.0,1,0.2465751924308277,57
3673,13,48577,48577,0,0,0,0,1.0,1,1.0,1,1.0,1,0.3084141930302575,58
3674,14,48591,48591,0,0,0,0,1.0,1,1.0,1,1.0,1,0.26476204445475066,57
3675,11,48602,48602,0,0,0,0,1.0,1,1.0,1,1.0,1,0.2823476704123617,58
3676,7,48609,48609,0,0,0,0,1.0,1,1.0,1,1.0,1,0.25598998651216964,59
3677,12,48621,48621,0,0,0,0,1.0,1,1.0,1,1.0,1,0.24160210086854012,60
3678,16,48637,48637,0,0,0,0,1.0,1,1.0,1,1.0,1,0.2586517692146857,62
3679,20,48657,48657,0,0,0,0,1.0,1,1.0,1,1.0,1,0.3180958877824797,62
3680,13,48670,48670,0,0,0,0,1.0,1,1.0,1,1.0,1,0.30378953965627997,63
3681,10,48680,48680,0,0,0,0,1.0,1,1.0,1,1.0,1,0.27439858411985446,64
3682,7,48687,48687,0,0,0,0,1.0,1,1.0,1,1.0,1,0.22505904091149595,64
3683,12,48699,48699,0,0,0,0,1.0,1,1.0,1,1.0,1,0.29067353952424657,64
3684,6,48705,48705,0,0,0,0,1.0,1,1.0,1,1.0,1,0.2953026369654507,64
3685,7,48712,48712,0,0,0,0,1.0,1,1.0,1,1.0,1,0.26204308337585347,64
3686,10,48722,48722,0,0,0,0,1.0,1,1.0,1,1.0,1,0.287465014354647,65
3687,3,48725,48725,0,0,0,0,1.0,1,1.0,1,1.0,1,0.2966260281377001,65
3688,11,48736,48736,0,0,0,0,1.0,1,1.0,1,1.0,1,0.25261574249722246,66
3689,7,48743,48743,0,0,0,0,1.0,1,1.0,1,1.0,1,0.3490687403954006,66
3690,18,48761,48761,0,0,0,0,1.0,1,1.0,1,1.0,1,0.29036281460128566,67
3691,12,48773,48773,0,0,0,0,1.0,1,1.0,1,1.0,1,0.3047914329120676,68
3692,14,48787,48787,0,0,0,0,1.0,1,1.0,1,1.0,1,0.2799160324526647,69
3693,23,48810,48810,0,0,0,0,1.0,1,1.0,1,1.0,1,0.2924445411772692,69
3694,22,48832,48832,0,0,0,0,1.0,1,1.0,1,1.0,1,0.32021948142548584,70
3695,18,48850,48850,0,0,0,0,1.0,1,1.0,1,1.0,1,0.24134006228401114,70
3696,17,48867,48867,0,0,0,0,1.0,1,1.0,1,1.0,1,0.3278293828615182,71
3697,25,48892,48892,0,0,0,0,1.0,1,1.0,1,1.0,1,0.30869077739574924,70
3698,26,48918,48918,0,0,0,0,1.0,1,1.0,1,1.0,1,0.2639905016018493,70
3699,32,48950,48950,0,0,0,0,1.0,1,1.0,1,1.0,1,0.330707151146963,70
3700,24,48974,48974,0,0,0,0,1.0,1,1.0,1,1.0,1,0.32057802395277024,68
3701,34,49008,49008,0,0,0,0,1.0,1,1.0,1,1.0,1,0.3959395822878434,69
3702,14,49022,49022,0,0,0,0,1.0,1,1.0,1,1.0,1,0.3972912907374573,69
3703,27,49049,49049,0,0,0,0,1.0,1,1.0,1,1.0,1,0.3358073523217603,70
3704,25,49074,49074,0,0,0,0,1.0,1,1.0,1,1.0,1,0.4822037313198739,69
3705,15,49089,49089,0,0,0,0,1.0,1,1.0,1,1.0,1,0.361224964886741,69
3706,19,49108,49108,0,0,0,0,1.0,1,1.0,1,1.0,1,0.368852840065654,69
3707,16,49124,49124,0,0,0,0,1.0,1,1.0,1,1.0,1,0.3470620208702004,67
3708,24,49148,49148,0,0,0,0,1.0,1,1.0,1,1.0,1,0.4264675394753823,67
3709,16,49164,49164,0,0,0,0,1.0,1,1.0,1,1.0,1,0.33596972529421754,67
3710,34,49198,49198,0,0,0,0,1.0,1,1.0,1,1.0,1,0.40758026364343686,67
3711,32,49230,49230,0,0,0,0,1.0,1,1.0,1,1.0,1,0.43114267859716454,68
3712,16,49246,49246,0,0,0,0,1.0,1,1.0,1,1.0,1,0.4525451187015313,68
3713,33,49279,49279,0,0,0,0,1.0,1,1.0,1,1.0,1,0.3286779799193689,68
3714,21,49300,49300,0,0,0,0,1.0,1,1.0,1,1.0,1,0.4236393024147164,67
3715,15,49315,49315,0,0,0,0,1.0,1,1.0,1,1.0,1,0.32542607363594545,68
3716,15,49330,49330,0,0,0,0,1.0,1,1.0,1,1.0,1,0.33941090479714126,67
3717,16,49346,49346,0,0,0,0,1.0,1,1.0,1,1.0,1,0.358513574198186,68
3718,24,49370,49370,0,0,0,0,1.0,1,1.0,1,1.0,1,0.3528894430526653,68
3719,38,49408,49408,0,0,0,0,1.0,1,1.0,1,1.0,1,0.316910370399142,68
3720,18,49426,49426,0,0,0,0,1.0,1,1.0,1,1.0,1,0.3171905631458031,68
3721,31,49457,49457,0,0,0,0,1.0,1,1.0,1,1.0,1,0.32972582817071167,70
3722,30,49487,49487,0,0,0,0,1.0,1,1.0,1,1.0,1,0.30306938432120073,71
3723,31,49518,49518,0,0,0,0,1.0,1,1.0,1,1.0,1,0.3194630158113771,71
3724,31,49549,49549,0,0,0,0,1.0,1,1.0,1,1.0,1,0.3434614280644146,72
3725,24,49573,49573,0,0,0,0,1.0,1,1.0,1,1.0,1,0.32582850220743054,72
3726,29,49602,49602,0,0,0,0,1.0,1,1.0,1,1.0,1,0.2565623369801423,71
3727,15,49617,49617,0,0,0,0,1.0,1,1.0,1,1.0,1,0.4411588447568559,71
3728,29,49646,49646,0,0,0,0,1.0,1,1.0,1,1.0,1,0.3465534678100533,70
3729,24,49670,49670,0,0,0,0,1.0,1,1.0,1,1.0,1,0.36485944651527585,70
3730,27,49697,49697,0,0,0,0,1.0,1,1.0,1,1.0,1,0.35438757015930483,71
3731,10,49707,49707,0,0,0,0,1.0,1,1.0,1,1.0,1,0.32739896046747446,71
3732,11,49718,49718,0,0,0,0,1.0,1,1.0,1,1.0,1,0.3209325151612528,72
3733,12,49730,49730,0,0,0,0,1.0,1,1.0,1,1.0,1,0.35727591913718015,73
3734,18,49748,49748,0,0,0,0,1.0,1,1.0,1,1.0,1,0.33136618682466623,74
3735,19,49767,49767,0,0,0,0,1.0,1,1.0,1,1.0,1,0.3766301458536321,72
3736,15,49782,49782,0,0,0,0,1.0,1,1.0,1,1.0,1,0.3513022177417049,72
3737,16,49798,49798,0,0,0,0,1.0,1,1.0,1,1.0,1,0.3285038631310605,73
3738,9,49807,49807,0,0,0,0,1.0,1,1.0,1,1.0,1,0.3377537925800952,72
3739,17,49824,49824,0,0,0,0,1.0,1,1.0,1,1.0,1,0.37867954192317343,73
3740,13,49837,49837,0,0,0,0,1.0,1,1.0,1,1.0,1,0.34405281856751574,70
3741,19,49856,49856,0,0,0,0,1.0,1,1.0,1,1.0,1,0.34401774287614517,70
3742,14,49870,49870,0,0,0,0,1.0,1,1.0,1,1.0,1,0.302733272291473,70
3743,17,49887,49887,0,0,0,0,1.0,1,1.0,1,1.0,1,0.3413348273062698,69
3744,22,49909,49909,0,0,0,0,1.0,1,1.0,1,1.0,1,0.34723321619347686,69
3745,20,49929,49929,0,0,0,0,1.0,1,1.0,1,1.0,1,0.24243071910304723,68
3746,18,49947,49947,0,0,0,0,1.0,1,1.0,1,1.0,1,0.3091512538219103,66
3747,18,49965,49965,0,0,0,0,1.0,1,1.0,1,1.0,1,0.3196627240082206,66
3748,21,49986,49986,0,0,0,0,1.0,1,1.0,1,1.0,1,0.3334901706683173,65
3749,11,49997,49997,0,0,0,0,1.0,1,1.0,1,1.0,1,0.3039928905939347,64
3750,15,50012,50012,0,0,0,0,1.0,1,1.0,1,1.0,1,0.37043232964660266,63
3751,15,50027,50027,0,0,0,0,1.0,1,1.0,1,1.0,1,0.36920221758904176,64
3752,17,50044,50044,0,0,0,0,1.0,1,1.0,1,1.0,1,0.34877033554144043,64
3753,27,50071,50071,0,0,0,0,1.0,1,1.0,1,1.0,1,0.3211395082316703,65
3754,17,50088,50088,0,0,0,0,1.0,1,1.0,1,1.0,1,0.3084452460992099,65
3755,12,50100,50100,0,0,0,0,1.0,1,1.0,1,1.0,1,0.3688145302232995,65
3756,28,50128,50128,0,0,0,0,1.0,1,1.0,1,1.0,1,0.3635582906931374,65
3757,15,50143,50143,0,0,0,0,1.0,1,1.0,1,1.0,1,0.33459646744787735,65
3758,10,50153,50153,0,0,0,0,1.0,1,1.0,1,1.0,1,0.3403419799437139,64
3759,19,50172,50172,0,0,0,0,1.0,1,1.0,1,1.0,1,0.30394026330920487,64
3760,14,50186,50186,0,0,0,0,1.0,1,1.0,1,1.0,1,0.3983319583792704,63
3761,13,50199,50199,0,0,0,0,1.0,1,1.0,1,1.0,1,0.35317520828974247,63
3762,20,50219,50219,0,0,0,0,1.0,1,1.0,1,1.0,1,0.3906006433539716,65
3763,16,50235,50235,0,0,0,0,1.0,1,1.0,1,1.0,1,0.3636988268281192,65
3764,29,50264,50264,0,0,0,0,1.0,1,1.0,1,1.0,1,0.3390946852849036,66
3765,26,50290,50290,0,0,0,0,1.0,1,1.0,1,1.0,1,0.30672094690407437,67
3766,21,50311,50311,0,0,0,0,1.0,1,1.0,1,1.0,1,0.3889199736837125,67
3767,14,50325,50325,0,0,0,0,1.0,1,1.0,1,1.0,1,0.38831378652585546,68
3768,25,50350,50350,0,0,0,0,1.0,1,1.0,1,1.0,1,0.3968998890491514,67
3769,24,50374,50374,0,0,0,0,1.0,1,1.0,1,1.0,1,0.30869461376855095,69
3770,21,50395,50395,0,0,0,0,1.0,1,1.0,1,1.0,1,0.3848752278059937,69
3771,34,50429,50429,0,0,0,0,1.0,1,1.0,1,1.0,1,0.29259543358046936,69
3772,33,50462,50462,0,0,0,0,1.0,1,1.0,1,1.0,1,0.37072976878293795,70
3773,20,50482,50482,0,0,0,0,1.0,1,1.0,1,1.0,1,0.3492679173755067,68
3774,26,50508,50508,0,0,0,0,1.0,1,1.0,1,1.0,1,0.32740117014229925,68
3775,21,50529,50529,0,0,0,0,1.0,1,1.0,1,1.0,1,0.34323234584292805,68
3776,29,50558,50558,0,0,0,0,1.0,1,1.0,1,1.0,1,0.3777584131579905,66
3777,32,50590,50590,0,0,0,0,1.0,1,1.0,1,1.0,1,0.4277993801124978,65
3778,32,50622,50622,0,0,0,0,1.0,1,1.0,1,1.0,1,0.35106089976298843,65
3779,16,50638,50638,0,0,0,0,1.0,1,1.0,1,1.0,1,0.34445215278185765,65
3780,21,50659,50659,0,0,0,0,1.0,1,1.0,1,1.0,1,0.4061675478638007,64
3781,19,50678,50678,0,0,0,0,1.0,1,1.0,1,1.0,1,0.3366394377385673,64
3782,18,50696,50696,0,0,0,0,1.0,1,1.0,1,1.0,1,0.3402548180980458,67
3783,16,50712,50712,0,0,0,0,1.0,1,1.0,1,1.0,1,0.3979755100416871,65
3784,15,50727,50727,0,0,0,0,1.0,1,1.0,1,1.0,1,0.3491510075398636,65
3785,17,50744,50744,0,0,0,0,1.0,1,1.0,1,1.0,1,0.4108915173471727,63
3786,17,50761,50761,0,0,0,0,1.0,1,1.0,1,1.0,1,0.35490199874629863,66
3787,16,50777,50777,0,0,0,0,1.0,1,1.0,1,1.0,1,0.33735961189925995,65
3788,14,50791,50791,0,0,0,0,1.0,1,1.0,1,1.0,1,0.3583407076810748,65
3789,16,50807,50807,0,0,0,0,1.0,1,1.0,1,1.0,1,0.38125485455783487,65
3790,18,50825,50825,0,0,0,0,1.0,1,1.0,1,1.0,1,0.3073546090939879,64
3791,15,50840,50840,0,0,0,0,1.0,1,1.0,1,1.0,1,0.36183279272558166,64
3792,13,50853,50853,0,0,0,0,1.0,1,1.0,1,1.0,1,0.3768323612886626,65
3793,19,50872,50872,0,0,0,0,1.0,1,1.0,1,1.0,1,0.35563305623244773,68
3794,16,50888,50888,0,0,0,0,1.0,1,1.0,1,1.0,1,0.3345963748666409,68
3795,15,50903,50903,0,0,0,0,1.0,1,1.0,1,1.0,1,0.34509538555519276,69
3796,32,50935,50935,0,0,0,0,1.0,1,1.0,1,1.0,1,0.4280217995043042,69
3797,24,50959,50959,0,0,0,0,1.0,1,1.0,1,1.0,1,0.4046524227327279,70
3798,21,50980,50980,0,0,0,0,1.0,1,1.0,1,1.0,1,0.39316198496145077,70
3799,25,51005,51005,0,0,0,0,1.0,1,1.0,1,1.0,1,0.34569219473326773,69
3800,31,51036,51036,0,0,0,0,1.0,1,1.0,1,1.0,1,0.36797670862610715,69
3801,18,51054,51054,0,0,0,0,1.0,1,1.0,1,1.0,1,0.4248199614676337,67
3802,31,51085,51085,0,0,0,0,1.0,1,1.0,1,1.0,1,0.3766627575788,67
3803,19,51104,51104,0,0,0,0,1.0,1,1.0,1,1.0,1,0.3901475829388832,69
3804,29,51133,51133,0,0,0,0,1.0,1,1.0,1,1.0,1,0.3680012706347324,70
3805,31,51164,51164,0,0,0,0,1.0,1,1.0,1,1.0,1,0.3154724003027243,71
3806,28,51192,51192,0,0,0,0,1.0,1,1.0,1,1.0,1,0.32128827799216697,71
3807,29,51221,51221,0,0,0,0,1.0,1,1.0,1,1.0,1,0.29108575070469933,72
3808,15,51236,51236,0,0,0,0,1.0,1,1.0,1,1.0,1,0.22704593548058025,72
3809,13,51249,51249,0,0,0,0,1.0,1,1.0,1,1.0,1,0.2961827466163433,72
3810,14,51263,51263,0,0,0,0,1.0,1,1.0,1,1.0,1,0.2824828807601995,72
3811,15,51278,51278,0,0,0,0,1.0,1,1.0,1,1.0,1,0.2882108705704734,71
3812,12,51290,51290,0,0,0,0,1.0,1,1.0,1,1.0,1,0.2787589451513423,72
3813,13,51303,51303,0,0,0,0,1.0,1,1.0,1,1.0,1,0.2591273361737102,71
3814,16,51319,51319,0,0,0,0,1.0,1,1.0,1,1.0,1,0.30792013689963743,72
3815,17,51336,51336,0,0,0,0,1.0,1,1.0,1,1.0,1,0.2738483794656309,71
3816,13,51349,51349,0,0,0,0,1.0,1,1.0,1,1.0,1,0.30305984333404723,69
3817,16,51365,51365,0,0,0,0,1.0,1,1.0,1,1.0,1,0.34346896047249653,72
3818,27,51392,51392,0,0,0,0,1.0,1,1.0,1,1.0,1,0.3558478264223058,72
3819,12,51404,51404,0,0,0,0,1.0,1,1.0,1,1.0,1,0.3834809801251684,72
3820,16,51420,51420,0,0,0,0,1.0,1,1.0,1,1.0,1,0.3392643316769154,72
3821,16,51436,51436,0,0,0,0,1.0,1,1.0,1,1.0,1,0.32701088947197665,72
3822,13,51449,51449,0,0,0,0,1.0,1,1.0,1,1.0,1,0.3068405562414475,69
3823,21,51470,51470,0,0,0,0,1.0,1,1.0,1,1.0,1,0.34649992767010446,69
3824,15,51485,51485,0,0,0,0,1.0,1,1.0,1,1.0,1,0.3475016890838944,65
3825,12,51497,51497,0,0,0,0,1.0,1,1.0,1,1.0,1,0.36735088371933744,64
3826,24,51521,51521,0,0,0,0,1.0,1,1.0,1,1.0,1,0.3709244405934257,65
3827,26,51547,51547,0,0,0,0,1.0,1,1.0,1,1.0,1,0.29681256056091093,64
3828,16,51563,51563,0,0,0,0,1.0,1,1.0,1,1.0,1,0.3462104870601151,65
3829,30,51593,51593,0,0,0,0,1.0,1,1.0,1,1.0,1,0.2769128537123432,65
3830,34,51627,51627,0,0,0,0,1.0,1,1.0,1,1.0,1,0.31202466930617745,64
3831,47,51674,51674,0,0,0,0,1.0,1,1.0,1,1.0,1,0.3535489563268702,63
3832,28,51702,51702,0,0,0,0,1.0,1,1.0,1,1.0,1,0.4176341924808297,64
3833,25,51727,51727,0,0,0,0,1.0,1,1.0,1,1.0,1,0.4446262105855873,64
3834,21,51748,51748,0,0,0,0,1.0,1,1.0,1,1.0,1,0.38579369389948887,63
3835,20,51768,51768,0,0,0,0,1.0,1,1.0,1,1.0,1,0.35608749175494553,63
3836,34,51802,51802,0,0,0,0,1.0,1,1.0,1,1.0,1,0.3403543521886001,63
3837,22,51824,51824,0,0,0,0,1.0,1,1.0,1,1.0,1,0.2726279878332539,62
3838,28,51852,51852,0,0,0,0,1.0,1,1.0,1,1.0,1,0.31551693436097417,62
3839,24,51876,51876,0,0,0,0,1.0,1,1.0,1,1.0,1,0.36938511344527886,60
3840,14,51890,51890,0,0,0,0,1.0,1,1.0,1,1.0,1,0.3017445930874764,62
3841,13,51903,51903,0,0,0,0,1.0,1,1.0,1,1.0,1,0.3481776923804101,62
3842,27,51930,51930,0,0,0,0,1.0,1,1.0,1,1.0,1,0.27401592868272995,63
3843,19,51949,51949,0,0,0,0,1.0,1,1.0,1,1.0,1,0.32447129283098247,64
3844,17,51966,51966,0,0,0,0,1.0,1,1.0,1,1.0,1,0.28164193895145617,65
3845,28,51994,51994,0,0,0,0,1.0,1,1.0,1,1.0,1,0.3310555592363158,66
3846,20,52014,52014,0,0,0,0,1.0,1,1.0,1,1.0,1,0.3422918533665034,67
3847,23,52037,52037,0,0,0,0,1.0,1,1.0,1,1.0,1,0.27026822062339273,67
3848,28,52065,52065,0,0,0,0,1.0,1,1.0,1,1.0,1,0.27133882124216024,67
3849,16,52081,52081,0,0,0,0,1.0,1,1.0,1,1.0,1,0.2588831746943608,67
3850,15,52096,52096,0,0,0,0,1.0,1,1.0,1,1.0,1,0.27841464066453503,68
3851,14,52110,52110,0,0,0,0,1.0,1,1.0,1,1.0,1,0.2940784619448198,68
3852,24,52134,52134,0,0,0,0,1.0,1,1.0,1,1.0,1,0.3156967015268916,70
3853,13,52147,52147,0,0,0,0,1.0,1,1.0,1,1.0,1,0.33157095268982184,70
3854,16,52163,52163,0,0,0,0,1.0,1,1.0,1,1.0,1,0.34985974605348497,70
3855,16,52179,52179,0,0,0,0,1.0,1,1.0,1,1.0,1,0.33531724896941445,69
3856,25,52204,52204,0,0,0,0,1.0,1,1.0,1,1.0,1,0.3219456475869384,70
3857,9,52213,52213,0,0,0,0,1.0,1,1.0,1,1.0,1,0.33489133032329693,68
3858,21,52234,52234,0,0,0,0,1.0,1,1.0,1,1.0,1,0.33693929735538364,67
3859,18,52252,52252,0,0,0,0,1.0,1,1.0,1,1.0,1,0.3323705487532365,66
3860,15,52267,52267,0,0,0,0,1.0,1,1.0,1,1.0,1,0.38342606585943806,66
3861,22,52289,52289,0,0,0,0,1.0,1,1.0,1,1.0,1,0.36992724774969127,66
3862,22,52311,52311,0,0,0,0,1.0,1,1.0,1,1.0,1,0.35812649988900835,66
3863,35,52346,52346,0,0,0,0,1.0,1,1.0,1,1.0,1,0.38863315743930277,63
3864,15,52361,52361,0,0,0,0,1.0,1,1.0,1,1.0,1,0.39793680174852974,63
3865,38,52399,52399,0,0,0,0,1.0,1,1.0,1,1.0,1,0.4342351614663763,61
3866,19,52418,52418,0,0,0,0,1.0,1,1.0,1,1.0,1,0.4041775861983405,61
3867,21,52439,52439,0,0,0,0,1.0,1,1.0,1,1.0,1,0.31824384936747685,60
3868,20,52459,52459,0,0,0,0,1.0,1,1.0,1,1.0,1,0.3703533458479749,59
3869,18,52477,52477,0,0,0,0,1.0,1,1.0,1,1.0,1,0.403635732897555,61
3870,32,52509,52509,0,0,0,0,1.0,1,1.0,1,1.0,1,0.37349982424712563,61
3871,21,52530,52530,0,0,0,0,1.0,1,1.0,1,1.0,1,0.22477900842390006,64
3872,22,52552,52552,0,0,0,0,1.0,1,1.0,1,1.0,1,0.3192981270968312,63
3873,26,52578,52578,0,0,0,0,1.0,1,1.0,1,1.0,1,0.31166028984491656,62
3874,30,52608,52608,0,0,0,0,1.0,1,1.0,1,1.0,1,0.21487080507842232,63
3875,19,52627,52627,0,0,0,0,1.0,1,1.0,1,1.0,1,0.3573342766788142,61
3876,13,52640,52640,0,0,0,0,1.0,1,1.0,1,1.0,1,0.30690680501286693,62
3877,21,52661,52661,0,0,0,0,1.0,1,1.0,1,1.0,1,0.4192462021215845,63
3878,15,52676,52676,0,0,0,0,1.0,1,1.0,1,1.0,1,0.21986949424025748,63
3879,20,52696,52696,0,0,0,0,1.0,1,1.0,1,1.0,1,0.34120841015280734,63
3880,23,52719,52719,0,0,0,0,1.0,1,1.0,1,1.0,1,0.3136587014289529,65
3881,30,52749,52749,0,0,0,0,1.0,1,1.0,1,1.0,1,0.40535165760387093,65
3882,26,52775,52775,0,0,0,0,1.0,1,1.0,1,1.0,1,0.3203969343455259,66
3883,23,52798,52798,0,0,0,0,1.0,1,1.0,1,1.0,1,0.4314772246877669,66
3884,28,52826,52826,0,0,0,0,1.0,1,1.0,1,1.0,1,0.3631592822563985,66
3885,13,52839,52839,0,0,0,0,1.0,1,1.0,1,1.0,1,0.3740803180164907,66
3886,19,52858,52858,0,0,0,0,1.0,1,1.0,1,1.0,1,0.45608896384062475,65
3887,31,52889,52889,0,0,0,0,1.0,1,1.0,1,1.0,1,0.36687301800056527,65
3888,33,52922,52922,0,0,0,0,1.0,1,1.0,1,1.0,1,0.39233311630104606,66
3889,25,52947,52947,0,0,0,0,1.0,1,1.0,1,1.0,1,0.3765015269408672,64
3890,18,52965,52965,0,0,0,0,1.0,1,1.0,1,1.0,1,0.37565107355252547,63
3891,24,52989,52989,0,0,0,0,1.0,1,1.0,1,1.0,1,0.3561424157769128,66
3892,40,53029,53029,0,0,0,0,1.0,1,1.0,1,1.0,1,0.3248668542748731,67
3893,21,53050,53050,0,0,0,0,1.0,1,1.0,1,1.0,1,0.30229138797144534,66
3894,30,53080,53080,0,0,0,0,1.0,1,1.0,1,1.0,1,0.29248071878901233,67
3895,23,53103,53103,0,0,0,0,1.0,1,1.0,1,1.0,1,0.33928365945365435,66
3896,38,53141,53141,0,0,0,0,1.0,1,1.0,1,1.0,1,0.4146539629754753,66
3897,36,53177,53177,0,0,0,0,1.0,1,1.0,1,1.0,1,0.3132500539930111,65
3898,28,53205,53205,0,0,0,0,1.0,1,1.0,1,1.0,1,0.42082554140314377,65
3899,22,53227,53227,0,0,0,0,1.0,1,1.0,1,1.0,1,0.3930022200104127,64
3900,25,53252,53252,0,0,0,0,1.0,1,1.0,1,1.0,1,0.23201700301026823,63
3901,32,53284,53284,0,0,0,0,1.0,1,1.0,1,1.0,1,0.4127268468249388,63
3902,26,53310,53310,0,0,0,0,1.0,1,1.0,1,1.0,1,0.3065485176261036,64
3903,30,53340,53340,0,0,0,0,1.0,1,1.0,1,1.0,1,0.3220345515327624,64
3904,35,53375,53375,0,0,0,0,1.0,1,1.0,1,1.0,1,0.32680149061687425,63
3905,41,53416,53416,0,0,0,0,1.0,1,1.0,1,1.0,1,0.28615136071464653,63
3906,34,53450,53450,0,0,0,0,1.0,1,1.0,1,1.0,1,0.27964716750245344,64
3907,24,53474,53474,0,0,0,0,1.0,1,1.0,1,1.0,1,0.31315760085780114,64
3908,25,53499,53499,0,0,0,0,1.0,1,1.0,1,1.0,1,0.30824671838308526,63
3909,34,53533,53533,0,0,0,0,1.0,1,1.0,1,1.0,1,0.3545678238524266,62
3910,27,53560,53560,0,0,0,0,1.0,1,1.0,1,1.0,1,0.3405420754950293,62
3911,27,53587,53587,0,0,0,0,1.0,1,1.0,1,1.0,1,0.3724290420635889,64
3912,35,53622,53622,0,0,0,0,1.0,1,1.0,1,1.0,1,0.36620058016263635,64
3913,17,53639,53639,0,0,0,0,1.0,1,1.0,1,1.0,1,0.3828248680738964,65
3914,43,53682,53682,0,0,0,0,1.0,1,1.0,1,1.0,1,0.47375378313336297,65
3915,15,53697,53697,0,0,0,0,1.0,1,1.0,1,1.0,1,0.38524105014375376,66
3916,24,53721,53721,0,0,0,0,1.0,1,1.0,1,1.0,1,0.4333738538571073,66
3917,35,53756,53756,0,0,0,0,1.0,1,1.0,1,1.0,1,0.4270321473605362,66
3918,22,53778,53778,0,0,0,0,1.0,1,1.0,1,1.0,1,0.4207499652260921,67
3919,21,53799,53799,0,0,0,0,1.0,1,1.0,1,1.0,1,0.3389092735925053,68
3920,33,53832,53832,0,0,0,0,1.0,1,1.0,1,1.0,1,0.41574016718998774,69
3921,26,53858,53858,0,0,0,0,1.0,1,1.0,1,1.0,1,0.3270977628208091,68
3922,30,53888,53888,0,0,0,0,1.0,1,1.0,1,1.0,1,0.3521000727769719,68
3923,25,53913,53913,0,0,0,0,1.0,1,1.0,1,1.0,1,0.41974066357426887,69
3924,36,53949,53949,0,0,0,0,1.0,1,1.0,1,1.0,1,0.38479140503064824,69
3925,23,53972,53972,0,0,0,0,1.0,1,1.0,1,1.0,1,0.44338711563495,67
3926,37,54009,54009,0,0,0,0,1.0,1,1.0,1,1.0,1,0.3645341690556223,67
3927,29,54038,54038,0,0,0,0,1.0,1,1.0,1,1.0,1,0.45502124748528405,65
3928,27,54065,54065,0,0,0,0,1.0,1,1.0,1,1.0,1,0.3184846038113729,65
3929,35,54100,54100,0,0,0,0,1.0,1,1.0,1,1.0,1,0.39617312259350623,64
3930,38,54138,54138,0,0,0,0,1.0,1,1.0,1,1.0,1,0.4001647533011228,64
3931,55,54193,54193,0,0,0,0,1.0,1,1.0,1,1.0,1,0.39932084662450773,62
3932,30,54223,54223,0,0,0,0,1.0,1,1.0,1,1.0,1,0.34858928056521676,62
3933,35,54258,54258,0,0,0,0,1.0,1,1.0,1,1.0,1,0.4150958815265354,62
3934,16,54274,54274,0,0,0,0,1.0,1,1.0,1,1.0,1,0.403398358419009,61
3935,28,54302,54302,0,0,0,0,1.0,1,1.0,1,1.0,1,0.3627326138674366,64
3936,29,54331,54331,0,0,0,0,1.0,1,1.0,1,1.0,1,0.3900307219518103,65
3937,24,54355,54355,0,0,0,0,1.0,1,1.0,1,1.0,1,0.3396623996912881,66
3938,23,54378,54378,0,0,0,0,1.0,1,1.0,1,1.0,1,0.4105494040241151,66
3939,27,54405,54405,0,0,0,0,1.0,1,1.0,1,1.0,1,0.3735927562252641,67
3940,23,54428,54428,0,0,0,0,1.0,1,1.0,1,1.0,1,0.40066269281340877,69
3941,19,54447,54447,0,0,0,0,1.0,1,1.0,1,1.0,1,0.32715386419802867,69
3942,26,54473,54473,0,0,0,0,1.0,1,1.0,1,1.0,1,0.2842408266205878,69
3943,38,54511,54511,0,0,0,0,1.0,1,1.0,1,1.0,1,0.3689273970324064,68
3944,30,54541,54541,0,0,0,0,1.0,1,1.0,1,1.0,1,0.3528876754870771,68
3945,25,54566,54566,0,0,0,0,1.0,1,1.0,1,1.0,1,0.2766581912050971,67
3946,39,54605,54605,0,0,0,0,1.0,1,1.0,1,1.0,1,0.3902018792304534,67
3947,16,54621,54621,0,0,0,0,1.0,1,1.0,1,1.0,1,0.41732696767375316,66
3948,29,54650,54650,0,0,0,0,1.0,1,1.0,1,1.0,1,0.3635810194248483,67
3949,19,54669,54669,0,0,0,0,1.0,1,1.0,1,1.0,1,0.3788075731409671,66
3950,33,54702,54702,0,0,0,0,1.0,1,1.0,1,1.0,1,0.3727911104233296,65
3951,26,54728,54728,0,0,0,0,1.0,1,1.0,1,1.0,1,0.3814006456506092,65
3952,28,54756,54756,0,0,0,0,1.0,1,1.0,1,1.0,1,0.3782887385408291,65
3953,17,54773,54773,0,0,0,0,1.0,1,1.0,1,1.0,1,0.3846511043970145,65
3954,27,54800,54800,0,0,0,0,1.0,1,1.0,1,1.0,1,0.3789889282241502,64
3955,19,54819,54819,0,0,0,0,1.0,1,1.0,1,1.0,1,0.33133646804396644,64
3956,21,54840,54840,0,0,0,0,1.0,1,1.0,1,1.0,1,0.4395293612714107,63
3957,15,54855,54855,0,0,0,0,1.0,1,1.0,1,1.0,1,0.42323980012162654,63
3958,20,54875,54875,0,0,0,0,1.0,1,1.0,1,1.0,1,0.4006442887325616,63
3959,33,54908,54908,0,0,0,0,1.0,1,1.0,1,1.0,1,0.46748338252407584,62
3960,24,54932,54932,0,0,0,0,1.0,1,1.0,1,1.0,1,0.4010092714534985,62
3961,32,54964,54964,0,0,0,0,1.0,1,1.0,1,1.0,1,0.4503571422621529,64
3962,15,54979,54979,0,0,0,0,1.0,1,1.0,1,1.0,1,0.42818426035802754,64
3963,26,55005,55005,0,0,0,0,1.0,1,1.0,1,1.0,1,0.3946622595369738,62
3964,13,55018,55018,0,0,0,0,1.0,1,1.0,1,1.0,1,0.38437237363863797,63
3965,33,55051,55051,0,0,0,0,1.0,1,1.0,1,1.0,1,0.4305221126745645,63
3966,16,55067,55067,0,0,0,0,1.0,1,1.0,1,1.0,1,0.3394546243592302,62
3967,22,55089,55089,0,0,0,0,1.0,1,1.0,1,1.0,1,0.34944553735864275,64
3968,21,55110,55110,0,0,0,0,1.0,1,1.0,1,1.0,1,0.40299153115987274,63
3969,16,55126,55126,0,0,0,0,1.0,1,1.0,1,1.0,1,0.4226701249093922,63
3970,29,55155,55155,0,0,0,0,1.0,1,1.0,1,1.0,1,0.4264804302624447,65
3971,22,55177,55177,0,0,0,0,1.0,1,1.0,1,1.0,1,0.38681736838704195,65
3972,22,55199,55199,0,0,0,0,1.0,1,1.0,1,1.0,1,0.3881621194384619,66
3973,24,55223,55223,0,0,0,0,1.0,1,1.0,1,1.0,1,0.38251836221250485,66
3974,27,55250,55250,0,0,0,0,1.0,1,1.0,1,1.0,1,0.31926841561929165,66
3975,27,55277,55277,0,0,0,0,1.0,1,1.0,1,1.0,1,0.39439909320124533,66
3976,15,55292,55292,0,0,0,0,1.0,1,1.0,1,1.0,1,0.37498595788066297,66
3977,30,55322,55322,0,0,0,0,1.0,1,1.0,1,1.0,1,0.35865613444418326,64
3978,37,55359,55359,0,0,0,0,1.0,1,1.0,1,1.0,1,0.4344971275245056,63
3979,15,55374,55374,0,0,0,0,1.0,1,1.0,1,1.0,1,0.2954237350525092,63
3980,32,55406,55406,0,0,0,0,1.0,1,1.0,1,1.0,1,0.3541839587928474,63
3981,21,55427,55427,0,0,0,0,1.0,1,1.0,1,1.0,1,0.39682898521239074,64
3982,37,55464,55464,0,0,0,0,1.0,1,1.0,1,1.0,1,0.3747582243214395,65
3983,32,55496,55496,0,0,0,0,1.0,1,1.0,1,1.0,1,0.34764127082715274,64
3984,19,55515,55515,0,0,0,0,1.0,1,1.0,1,1.0,1,0.37129369597157524,65
3985,21,55536,55536,0,0,0,0,1.0,1,1.0,1,1.0,1,0.36266017529701666,64
3986,18,55554,55554,0,0,0,0,1.0,1,1.0,1,1.0,1,0.32856329736970324,63
3987,17,55571,55571,0,0,0,0,1.0,1,1.0,1,1.0,1,0.40055624564616776,63
3988,27,55598,55598,0,0,0,0,1.0,1,1.0,1,1.0,1,0.3112675296861651,63
3989,16,55614,55614,0,0,0,0,1.0,1,1.0,1,1.0,1,0.3388051714047653,63
3990,14,55628,55628,0,0,0,0,1.0,1,1.0,1,1.0,1,0.35596320193275166,62
3991,18,55646,55646,0,0,0,0,1.0,1,1.0,1,1.0,1,0.27828163635624686,62
3992,29,55675,55675,0,0,0,0,1.0,1,1.0,1,1.0,1,0.31762474357235576,65
3993,13,55688,55688,0,0,0,0,1.0,1,1.0,1,1.0,1,0.3687437284003065,65
3994,22,55710,55710,0,0,0,0,1.0,1,1.0,1,1.0,1,0.3737389288368606,64
3995,44,55754,55754,0,0,0,0,1.0,1,1.0,1,1.0,1,0.2623504412088911,64
3996,19,55773,55773,0,0,0,0,1.0,1,1.0,1,1.0,1,0.37290073571456234,67
3997,29,55802,55802,0,0,0,0,1.0,1,1.0,1,1.0,1,0.36074188933690854,69
3998,20,55822,55822,0,0,0,0,1.0,1,1.0,1,1.0,1,0.3350180019857839,69
3999,29,55851,55851,0,0,0,0,1.0,1,1.0,1,1.0,1,0.37732034679253984,69
4000,18,55869,55869,0,0,0,0,1.0,1,1.0,1,1.0,1,0.30336015439369607,69
4001,28,55897,55897,0,0,0,0,1.0,1,1.0,1,1.0,1,0.3260866238376755,68
4002,32,55929,55929,0,0,0,0,1.0,1,1.0,1,1.0,1,0.34183052746685205,68
4003,23,55952,55952,0,0,0,0,1.0,1,1.0,1,1.0,1,0.3099617161730964,68
4004,24,55976,55976,0,0,0,0,1.0,1,1.0,1,1.0,1,0.3432601256745106,67
4005,16,55992,55992,0,0,0,0,1.0,1,1.0,1,1.0,1,0.40069785575370487,67
4006,25,56017,56017,0,0,0,0,1.0,1,1.0,1,1.0,1,0.4221688515100431,67
4007,39,56056,56056,0,0,0,0,1.0,1,1.0,1,1.0,1,0.37966346527122197,67
4008,26,56082,56082,0,0,0,0,1.0,1,1.0,1,1.0,1,0.45556842746042603,67
4009,21,56103,56103,0,0,0,0,1.0,1,1.0,1,1.0,1,0.37310616315656947,67
4010,44,56147,56147,0,0,0,0,1.0,1,1.0,1,1.0,1,0.4658324983067116,66
4011,22,56169,56169,0,0,0,0,1.0,1,1.0,1,1.0,1,0.3073887673455847,66
4012,25,56194,56194,0,0,0,0,1.0,1,1.0,1,1.0,1,0.38899595907063234,66
4013,25,56219,56219,0,0,0,0,1.0,1,1.0,1,1.0,1,0.3976239637004845,66
4014,26,56245,56245,0,0,0,0,1.0,1,1.0,1,1.0,1,0.3194030799321474,66
4015,28,56273,56273,0,0,0,0,1.0,1,1.0,1,1.0,1,0.3181586817902851,64
4016,16,56289,56289,0,0,0,0,1.0,1,1.0,1,1.0,1,0.4232101321251885,64
4017,18,56307,56307,0,0,0,0,1.0,1,1.0,1,1.0,1,0.41588604458997336,66
4018,17,56324,56324,0,0,0,0,1.0,1,1.0,1,1.0,1,0.38566162852666314,67
4019,23,56347,56347,0,0,0,0,1.0,1,1.0,1,1.0,1,0.3873191458884388,67
4020,23,56370,56370,0,0,0,0,1.0,1,1.0,1,1.0,1,0.35936780499845117,66
4021,25,56395,56395,0,0,0,0,1.0,1,1.0,1,1.0,1,0.35781714579585816,66
4022,23,56418,56418,0,0,0,0,1.0,1,1.0,1,1.0,1,0.40440998449809484,66
4023,12,56430,56430,0,0,0,0,1.0,1,1.0,1,1.0,1,0.37916158587662474,66
4024,25,56455,56455,0,0,0,0,1.0,1,1.0,1,1.0,1,0.39957879083523545,66
4025,36,56491,56491,0,0,0,0,1.0,1,1.0,1,1.0,1,0.37301998444155904,66
4026,24,56515,56515,0,0,0,0,1.0,1,1.0,1,1.0,1,0.3912870126899697,66
4027,15,56530,56530,0,0,0,0,1.0,1,1.0,1,1.0,1,0.4261413023420892,64
4028,27,56557,56557,0,0,0,0,1.0,1,1.0,1,1.0,1,0.3498368283859155,63
4029,19,56576,56576,0,0,0,0,1.0,1,1.0,1,1.0,1,0.4047115001184219,62
4030,24,56600,56600,0,0,0,0,1.0,1,1.0,1,1.0,1,0.4586456689011891,63
4031,20,56620,56620,0,0,0,0,1.0,1,1.0,1,1.0,1,0.4360846540232195,62
4032,17,56637,56637,0,0,0,0,1.0,1,1.0,1,1.0,1,0.4485521341903182,62
4033,12,56649,56649,0,0,0,0,1.0,1,1.0,1,1.0,1,0.44542627197089874,61
4034,19,56668,56668,0,0,0,0,1.0,1,1.0,1,1.0,1,0.45357190559907135,60
4035,19,56687,56687,0,0,0,0,1.0,1,1.0,1,1.0,1,0.45080205811514157,59
4036,19,56706,56706,0,0,0,0,1.0,1,1.0,1,1.0,1,0.45419254130349496,58
4037,14,56720,56720,0,0,0,0,1.0,1,1.0,1,1.0,1,0.4572963880100284,59
4038,15,56735,56735,0,0,0,0,1.0,1,1.0,1,1.0,1,0.479876125747564,58
4039,14,56749,56749,0,0,0,0,1.0,1,1.0,1,1.0,1,0.5490613878485984,56
4040,22,56771,56771,0,0,0,0,1.0,1,1.0,1,1.0,1,0.4377022268939957,55
4041,20,56791,56791,0,0,0,0,1.0,1,1.0,1,1.0,1,0.5071004345888734,54
4042,14,56805,56805,0,0,0,0,1.0,1,1.0,1,1.0,1,0.4534583704110723,56
4043,21,56826,56826,0,0,0,0,1.0,1,1.0,1,1.0,1,0.5298484654653959,56
4044,14,56840,56840,0,0,0,0,1.0,1,1.0,1,1.0,1,0.4377388653276081,56
4045,20,56860,56860,0,0,0,0,1.0,1,1.0,1,1.0,1,0.4668055415207093,57
4046,20,56880,56880,0,0,0,0,1.0,1,1.0,1,1.0,1,0.508220713822901,59
4047,22,56902,56902,0,0,0,0,1.0,1,1.0,1,1.0,1,0.4698699319358778,59
4048,20,56922,56922,0,0,0,0,1.0,1,1.0,1,1.0,1,0.43252949134158886,59
4049,17,56939,56939,0,0,0,0,1.0,1,1.0,1,1.0,1,0.4366370707097987,60
4050,21,56960,56960,0,0,0,0,1.0,1,1.0,1,1.0,1,0.5706981599383664,60
4051,14,56974,56974,0,0,0,0,1.0,1,1.0,1,1.0,1,0.518575912404224,60
4052,13,56987,56987,0,0,0,0,1.0,1,1.0,1,1.0,1,0.4285351757254896,60
4053,19,57006,57006,0,0,0,0,1.0,1,1.0,1,1.0,1,0.472668453895455,60
4054,14,57020,57020,0,0,0,0,1.0,1,1.0,1,1.0,1,0.5137183369279756,61
4055,16,57036,57036,0,0,0,0,1.0,1,1.0,1,1.0,1,0.3874393741584892,61
4056,21,57057,57057,0,0,0,0,1.0,1,1.0,1,1.0,1,0.5089673914600389,62
4057,32,57089,57089,0,0,0,0,1.0,1,1.0,1,1.0,1,0.4670034792706649,63
4058,27,57116,57116,0,0,0,0,1.0,1,1.0,1,1.0,1,0.4382386356728868,64
4059,18,57134,57134,0,0,0,0,1.0,1,1.0,1,1.0,1,0.491726252418005,63
4060,17,57151,57151,0,0,0,0,1.0,1,1.0,1,1.0,1,0.38695111454993375,63
4061,12,57163,57163,0,0,0,0,1.0,1,1.0,1,1.0,1,0.4667392249074717,63
4062,16,57179,57179,0,0,0,0,1.0,1,1.0,1,1.0,1,0.4772249560328876,65
4063,18,57197,57197,0,0,0,0,1.0,1,1.0,1,1.0,1,0.4434766328119087,64
4064,27,57224,57224,0,0,0,0,1.0,1,1.0,1,1.0,1,0.4184636842116174,65
4065,29,57253,57253,0,0,0,0,1.0,1,1.0,1,1.0,1,0.5398170374667265,64
4066,19,57272,57272,0,0,0,0,1.0,1,1.0,1,1.0,1,0.39171023624148543,64
4067,28,57300,57300,0,0,0,0,1.0,1,1.0,1,1.0,1,0.3791574796454688,63
4068,20,57320,57320,0,0,0,0,1.0,1,1.0,1,1.0,1,0.3877930774135454,64
4069,37,57357,57357,0,0,0,0,1.0,1,1.0,1,1.0,1,0.32432629063113444,62
4070,19,57376,57376,0,0,0,0,1.0,1,1.0,1,1.0,1,0.29675119551746726,61
4071,32,57408,57408,0,0,0,0,1.0,1,1.0,1,1.0,1,0.3481935367323941,61
4072,29,57437,57437,0,0,0,0,1.0,1,1.0,1,1.0,1,0.23465812355442411,60
4073,18,57455,57455,0,0,0,0,1.0,1,1.0,1,1.0,1,0.36697844673995755,60
4074,13,57468,57468,0,0,0,0,1.0,1,1.0,1,1.0,1,0.373689947940855,60
4075,17,57485,57485,0,0,0,0,1.0,1,1.0,1,1.0,1,0.36170363371317366,59
4076,29,57514,57514,0,0,0,0,1.0,1,1.0,1,1.0,1,0.401792174123538,60
4077,31,57545,57545,0,0,0,0,1.0,1,1.0,1,1.0,1,0.3974669792998198,61
4078,14,57559,57559,0,0,0,0,1.0,1,1.0,1,1.0,1,0.3710228317958562,60
4079,12,57571,57571,0,0,0,0,1.0,1,1.0,1,1.0,1,0.3330000803894888,58
4080,15,57586,57586,0,0,0,0,1.0,1,1.0,1,1.0,1,0.37862410013400805,56
4081,30,57616,57616,0,0,0,0,1.0,1,1.0,1,1.0,1,0.4590174157970915,56
4082,20,57636,57636,0,0,0,0,1.0,1,1.0,1,1.0,1,0.4768403982593652,55
4083,28,57664,57664,0,0,0,0,1.0,1,1.0,1,1.0,1,0.40336981692179374,55
4084,15,57679,57679,0,0,0,0,1.0,1,1.0,1,1.0,1,0.48340735182288036,55
4085,21,57700,57700,0,0,0,0,1.0,1,1.0,1,1.0,1,0.38645029296255207,56
4086,21,57721,57721,0,0,0,0,1.0,1,1.0,1,1.0,1,0.329779758404824,57
4087,15,57736,57736,0,0,0,0,1.0,1,1.0,1,1.0,1,0.394626137565328,57
4088,25,57761,57761,0,0,0,0,1.0,1,1.0,1,1.0,1,0.32367034386757204,57
4089,10,57771,57771,0,0,0,0,1.0,1,1.0,1,1.0,1,0.40156185798946714,56
4090,13,57784,57784,0,0,0,0,1.0,1,1.0,1,1.0,1,0.2973111498785405,56
4091,19,57803,57803,0,0,0,0,1.0,1,1.0,1,1.0,1,0.4074017581494883,56
4092,16,57819,57819,0,0,0,0,1.0,1,1.0,1,1.0,1,0.34190726210179473,57
4093,25,57844,57844,0,0,0,0,1.0,1,1.0,1,1.0,1,0.4252644285015449,58
4094,32,57876,57876,0,0,0,0,1.0,1,1.0,1,1.0,1,0.2811280714718031,57
4095,26,57902,57902,0,0,0,0,1.0,1,1.0,1,1.0,1,0.2831155353703232,57
4096,32,57934,57934,0,0,0,0,1.0,1,1.0,1,1.0,1,0.3550590443669319,59
4097,20,57954,57954,0,0,0,0,1.0,1,1.0,1,1.0,1,0.29093809628174955,59
4098,25,57979,57979,0,0,0,0,1.0,1,1.0,1,1.0,1,0.2875216502321216,59
4099,17,57996,57996,0,0,0,0,1.0,1,1.0,1,1.0,1,0.3234526910033216,60
4100,18,58014,58014,0,0,0,0,1.0,1,1.0,1,1.0,1,0.36745589247995675,60
4101,17,58031,58031,0,0,0,0,1.0,1,1.0,1,1.0,1,0.27744567195351666,60
4102,11,58042,58042,0,0,0,0,1.0,1,1.0,1,1.0,1,0.35049980566868777,60
4103,27,58069,58069,0,0,0,0,1.0,1,1.0,1,1.0,1,0.282725673695844,58
4104,17,58086,58086,0,0,0,0,1.0,1,1.0,1,1.0,1,0.35935712960495203,60
4105,18,58104,58104,0,0,0,0,1.0,1,1.0,1,1.0,1,0.31504155388464605,59
4106,22,58126,58126,0,0,0,0,1.0,1,1.0,1,1.0,1,0.3922444162531339,61
4107,23,58149,58149,0,0,0,0,1.0,1,1.0,1,1.0,1,0.38486265847720136,59
4108,19,58168,58168,0,0,0,0,1.0,1,1.0,1,1.0,1,0.3738333594019603,60
4109,26,58194,58194,0,0,0,0,1.0,1,1.0,1,1.0,1,0.32635135703202084,59
4110,26,58220,58220,0,0,0,0,1.0,1,1.0,1,1.0,1,0.3706752368227443,60
4111,17,58237,58237,0,0,0,0,1.0,1,1.0,1,1.0,1,0.3647675495818176,61
4112,12,58249,58249,0,0,0,0,1.0,1,1.0,1,1.0,1,0.2912095906180163,60
4113,24,58273,58273,0,0,0,0,1.0,1,1.0,1,1.0,1,0.34537530494880675,61
4114,19,58292,58292,0,0,0,0,1.0,1,1.0,1,1.0,1,0.3436253636236776,62
4115,23,58315,58315,0,0,0,0,1.0,1,1.0,1,1.0,1,0.4106482723628145,60
4116,13,58328,58328,0,0,0,0,1.0,1,1.0,1,1.0,1,0.34837595514665415,59
4117,21,58349,58349,0,0,0,0,1.0,1,1.0,1,1.0,1,0.32508233873913256,56
4118,20,58369,58369,0,0,0,0,1.0,1,1.0,1,1.0,1,0.41684894216914353,55
4119,28,58397,58397,0,0,0,0,1.0,1,1.0,1,1.0,1,0.32935840236619546,53
4120,20,58417,58417,0,0,0,0,1.0,1,1.0,1,1.0,1,0.3958083277186413,52
4121,21,58438,58438,0,0,0,0,1.0,1,1.0,1,1.0,1,0.22045980779939064,53
4122,14,58452,58452,0,0,0,0,1.0,1,1.0,1,1.0,1,0.32656672121972485,52
4123,16,58468,58468,0,0,0,0,1.0,1,1.0,1,1.0,1,0.1758799869461152,51
4124,25,58493,58493,0,0,0,0,1.0,1,1.0,1,1.0,1,0.29301426468307146,51
4125,23,58516,58516,0,0,0,0,1.0,1,1.0,1,1.0,1,0.3051150386847151,50
4126,26,58542,58542,0,0,0,0,1.0,1,1.0,1,1.0,1,0.268722248830534,50
4127,20,58562,58562,0,0,0,0,1.0,1,1.0,1,1.0,1,0.2681007191751186,49
4128,22,58584,58584,0,0,0,0,1.0,1,1.0,1,1.0,1,0.3123456093551805,49
4129,17,58601,58601,0,0,0,0,1.0,1,1.0,1,1.0,1,0.25242541878000413,49
4130,16,58617,58617,0,0,0,0,1.0,1,1.0,1,1.0,1,0.37940100036576685,50
4131,20,58637,58637,0,0,0,0,1.0,1,1.0,1,1.0,1,0.349625496266795,50
4132,26,58663,58663,0,0,0,0,1.0,1,1.0,1,1.0,1,0.3643383031539162,50
4133,21,58684,58684,0,0,0,0,1.0,1,1.0,1,1.0,1,0.3459371006094483,51
4134,21,58705,58705,0,0,0,0,1.0,1,1.0,1,1.0,1,0.2943635320824539,53
4135,19,58724,58724,0,0,0,0,1.0,1,1.0,1,1.0,1,0.39212472085479866,54
4136,18,58742,58742,0,0,0,0,1.0,1,1.0,1,1.0,1,0.3924702952607482,54
4137,16,58758,58758,0,0,0,0,1.0,1,1.0,1,1.0,1,0.3772658361254098,55
4138,30,58788,58788,0,0,0,0,1.0,1,1.0,1,1.0,1,0.44629931440641935,54
4139,22,58810,58810,0,0,0,0,1.0,1,1.0,1,1.0,1,0.42547256846395987,54
4140,20,58830,58830,0,0,0,0,1.0,1,1.0,1,1.0,1,0.4592806765867575,55
4141,22,58852,58852,0,0,0,0,1.0,1,1.0,1,1.0,1,0.4512524007917376,55
4142,21,58873,58873,0,0,0,0,1.0,1,1.0,1,1.0,1,0.46957669043854716,55
4143,22,58895,58895,0,0,0,0,1.0,1,1.0,1,1.0,1,0.501114871075198,53
4144,21,58916,58916,0,0,0,0,1.0,1,1.0,1,1.0,1,0.40746687793531333,52
4145,27,58943,58943,0,0,0,0,1.0,1,1.0,1,1.0,1,0.4141348723362567,51
4146,18,58961,58961,0,0,0,0,1.0,1,1.0,1,1.0,1,0.3700001836225485,51
4147,16,58977,58977,0,0,0,0,1.0,1,1.0,1,1.0,1,0.41082051020482874,50
4148,18,58995,58995,0,0,0,0,1.0,1,1.0,1,1.0,1,0.3984356665748168,52
4149,16,59011,59011,0,0,0,0,1.0,1,1.0,1,1.0,1,0.30512860439580786,53
4150,11,59022,59022,0,0,0,0,1.0,1,1.0,1,1.0,1,0.38993435025131234,53
4151,14,59036,59036,0,0,0,0,1.0,1,1.0,1,1.0,1,0.3150851493322042,53
4152,11,59047,59047,0,0,0,0,1.0,1,1.0,1,1.0,1,0.310730609761824,54
4153,15,59062,59062,0,0,0,0,1.0,1,1.0,1,1.0,1,0.3779176833883346,51
4154,14,59076,59076,0,0,0,0,1.0,1,1.0,1,1.0,1,0.26640882714384373,51
4155,13,59089,59089,0,0,0,0,1.0,1,1.0,1,1.0,1,0.3293135196670794,51
4156,21,59110,59110,0,0,0,0,1.0,1,1.0,1,1.0,1,0.27770621914615484,52
4157,20,59130,59130,0,0,0,0,1.0,1,1.0,1,1.0,1,0.23650325393512608,52
4158,25,59155,59155,0,0,0,0,1.0,1,1.0,1,1.0,1,0.29744336062540677,52
4159,23,59178,59178,0,0,0,0,1.0,1,1.0,1,1.0,1,0.28438284308301653,52
4160,24,59202,59202,0,0,0,0,1.0,1,1.0,1,1.0,1,0.23486724019133542,50
4161,25,59227,59227,0,0,0,0,1.0,1,1.0,1,1.0,1,0.3582872075204843,50
4162,31,59258,59258,0,0,0,0,1.0,1,1.0,1,1.0,1,0.34651362800905144,51
4163,24,59282,59282,0,0,0,0,1.0,1,1.0,1,1.0,1,0.3807476076665556,48
4164,18,59300,59300,0,0,0,0,1.0,1,1.0,1,1.0,1,0.22877196884830764,50
4165,24,59324,59324,0,0,0,0,1.0,1,1.0,1,1.0,1,0.4585923218100105,49
4166,27,59351,59351,0,0,0,0,1.0,1,1.0,1,1.0,1,0.35998294023250815,50
4167,12,59363,59363,0,0,0,0,1.0,1,1.0,1,1.0,1,0.4669762227658588,50
4168,28,59391,59391,0,0,0,0,1.0,1,1.0,1,1.0,1,0.3619784764470801,50
4169,16,59407,59407,0,0,0,0,1.0,1,1.0,1,1.0,1,0.4067130361000775,51
4170,11,59418,59418,0,0,0,0,1.0,1,1.0,1,1.0,1,0.39886712672905644,50
4171,10,59428,59428,0,0,0,0,1.0,1,1.0,1,1.0,1,0.3797132024865305,50
4172,11,59439,59439,0,0,0,0,1.0,1,1.0,1,1.0,1,0.42188795192792145,49
4173,15,59454,59454,0,0,0,0,1.0,1,1.0,1,1.0,1,0.41936319723005505,48
4174,13,59467,59467,0,0,0,0,1.0,1,1.0,1,1.0,1,0.4021595518681981,48
4175,14,59481,59481,0,0,0,0,1.0,1,1.0,1,1.0,1,0.4340556300392724,48
4176,20,59501,59501,0,0,0,0,1.0,1,1.0,1,1.0,1,0.355669504284893,50
4177,17,59518,59518,0,0,0,0,1.0,1,1.0,1,1.0,1,0.35024898748015987,52
4178,9,59527,59527,0,0,0,0,1.0,1,1.0,1,1.0,1,0.3670993528534771,53
4179,15,59542,59542,0,0,0,0,1.0,1,1.0,1,1.0,1,0.34701080063870604,54
4180,13,59555,59555,0,0,0,0,1.0,1,1.0,1,1.0,1,0.38408491207569606,55
4181,12,59567,59567,0,0,0,0,1.0,1,1.0,1,1.0,1,0.3336461388962165,56
4182,12,59579,59579,0,0,0,0,1.0,1,1.0,1,1.0,1,0.28252785451894835,56
4183,12,59591,59591,0,0,0,0,1.0,1,1.0,1,1.0,1,0.33087462571461385,57
4184,20,59611,59611,0,0,0,0,1.0,1,1.0,1,1.0,1,0.36682646589025575,57
4185,21,59632,59632,0,0,0,0,1.0,1,1.0,1,1.0,1,0.26196575066705763,54
4186,21,59653,59653,0,0,0,0,1.0,1,1.0,1,1.0,1,0.2676558012331549,55
4187,15,59668,59668,0,0,0,0,1.0,1,1.0,1,1.0,1,0.3229527034282441,53
4188,20,59688,59688,0,0,0,0,1.0,1,1.0,1,1.0,1,0.3095601903195985,53
4189,29,59717,59717,0,0,0,0,1.0,1,1.0,1,1.0,1,0.2948998633478322,53
4190,23,59740,59740,0,0,0,0,1.0,1,1.0,1,1.0,1,0.3125265053949333,53
4191,16,59756,59756,0,0,0,0,1.0,1,1.0,1,1.0,1,0.39993977219406474,51
4192,25,59781,59781,0,0,0,0,1.0,1,1.0,1,1.0,1,0.20491635888433438,51
4193,24,59805,59805,0,0,0,0,1.0,1,1.0,1,1.0,1,0.3674085295116084,50
4194,12,59817,59817,0,0,0,0,1.0,1,1.0,1,1.0,1,0.327009778885997,50
4195,16,59833,59833,0,0,0,0,1.0,1,1.0,1,1.0,1,0.20749355806783273,50
4196,30,59863,59863,0,0,0,0,1.0,1,1.0,1,1.0,1,0.2732231088404189,51
4197,20,59883,59883,0,0,0,0,1.0,1,1.0,1,1.0,1,0.27014854674277317,50
4198,14,59897,59897,0,0,0,0,1.0,1,1.0,1,1.0,1,0.35120511850347963,48
4199,18,59915,59915,0,0,0,0,1.0,1,1.0,1,1.0,1,0.3596117052551093,48
4200,15,59930,59930,0,0,0,0,1.0,1,1.0,1,1.0,1,0.33745835735306834,48
4201,17,59947,59947,0,0,0,0,1.0,1,1.0,1,1.0,1,0.4300784443218079,47
4202,13,59960,59960,0,0,0,0,1.0,1,1.0,1,1.0,1,0.4403467109811244,47
4203,29,59989,59989,0,0,0,0,1.0,1,1.0,1,1.0,1,0.39488844343843155,47
4204,35,60024,60024,0,0,0,0,1.0,1,1.0,1,1.0,1,0.43251781387933563,48
4205,19,60043,60043,0,0,0,0,1.0,1,1.0,1,1.0,1,0.3952422722975106,49
4206,12,60055,60055,0,0,0,0,1.0,1,1.0,1,1.0,1,0.37318820830243526,49
4207,15,60070,60070,0,0,0,0,1.0,1,1.0,1,1.0,1,0.38730655557254484,48
4208,13,60083,60083,0,0,0,0,1.0,1,1.0,1,1.0,1,0.38838511980700385,49
4209,15,60098,60098,0,0,0,0,1.0,1,1.0,1,1.0,1,0.4241330000998349,51
4210,10,60108,60108,0,0,0,0,1.0,1,1.0,1,1.0,1,0.42367593926466,52
4211,16,60124,60124,0,0,0,0,1.0,1,1.0,1,1.0,1,0.3981521368925952,53
4212,17,60141,60141,0,0,0,0,1.0,1,1.0,1,1.0,1,0.4243853232093934,53
4213,13,60154,60154,0,0,0,0,1.0,1,1.0,1,1.0,1,0.34519840293177234,54
4214,17,60171,60171,0,0,0,0,1.0,1,1.0,1,1.0,1,0.41049253141426184,54
4215,21,60192,60192,0,0,0,0,1.0,1,1.0,1,1.0,1,0.37866182999035064,54
4216,12,60204,60204,0,0,0,0,1.0,1,1.0,1,1.0,1,0.4499603713773954,53
4217,21,60225,60225,0,0,0,0,1.0,1,1.0,1,1.0,1,0.35967809748153157,54
4218,15,60240,60240,0,0,0,0,1.0,1,1.0,1,1.0,1,0.4640697355310619,53
4219,17,60257,60257,0,0,0,0,1.0,1,1.0,1,1.0,1,0.40724550614822713,53
4220,13,60270,60270,0,0,0,0,1.0,1,1.0,1,1.0,1,0.3935754916224672,53
4221,21,60291,60291,0,0,0,0,1.0,1,1.0,1,1.0,1,0.44648699705217415,54
4222,11,60302,60302,0,0,0,0,1.0,1,1.0,1,1.0,1,0.41246786968437643,55
4223,14,60316,60316,0,0,0,0,1.0,1,1.0,1,1.0,1,0.4033953467515566,56
4224,20,60336,60336,0,0,0,0,1.0,1,1.0,1,1.0,1,0.3635830786043596,55
4225,27,60363,60363,0,0,0,0,1.0,1,1.0,1,1.0,1,0.37461523784770323,53
4226,15,60378,60378,0,0,0,0,1.0,1,1.0,1,1.0,1,0.41318131741844777,54
4227,19,60397,60397,0,0,0,0,1.0,1,1.0,1,1.0,1,0.5090113717268959,52
4228,22,60419,60419,0,0,0,0,1.0,1,1.0,1,1.0,1,0.40760889356290997,51
4229,20,60439,60439,0,0,0,0,1.0,1,1.0,1,1.0,1,0.48382967685221046,48
4230,15,60454,60454,0,0,0,0,1.0,1,1.0,1,1.0,1,0.4969717783085014,48
4231,18,60472,60472,0,0,0,0,1.0,1,1.0,1,1.0,1,0.4034333238924914,48
4232,25,60497,60497,0,0,0,0,1.0,1,1.0,1,1.0,1,0.4880682065874188,48
4233,23,60520,60520,0,0,0,0,1.0,1,1.0,1,1.0,1,0.4731497305979136,48
4234,17,60537,60537,0,0,0,0,1.0,1,1.0,1,1.0,1,0.3913634054724977,49
4235,24,60561,60561,0,0,0,0,1.0,1,1.0,1,1.0,1,0.561565605196109,47
4236,26,60587,60587,0,0,0,0,1.0,1,1.0,1,1.0,1,0.51006325538364,47
4237,26,60613,60613,0,0,0,0,1.0,1,1.0,1,1.0,1,0.46397163388361723,48
4238,25,60638,60638,0,0,0,0,1.0,1,1.0,1,1.0,1,0.48076564860324333,47
4239,20,60658,60658,0,0,0,0,1.0,1,1.0,1,1.0,1,0.4496962114843317,48
4240,16,60674,60674,0,0,0,0,1.0,1,1.0,1,1.0,1,0.5797005574428616,47
4241,18,60692,60692,0,0,0,0,1.0,1,1.0,1,1.0,1,0.49459382865734564,49
4242,9,60701,60701,0,0,0,0,1.0,1,1.0,1,1.0,1,0.49520462127493514,49
4243,11,60712,60712,0,0,0,0,1.0,1,1.0,1,1.0,1,0.36978020408800943,50
4244,18,60730,60730,0,0,0,0,1.0,1,1.0,1,1.0,1,0.41622535340780537,51
4245,19,60749,60749,0,0,0,0,1.0,1,1.0,1,1.0,1,0.47318426720760276,51
4246,18,60767,60767,0,0,0,0,1.0,1,1.0,1,1.0,1,0.3652131453684704,51
4247,15,60782,60782,0,0,0,0,1.0,1,1.0,1,1.0,1,0.40445601077652893,52
4248,23,60805,60805,0,0,0,0,1.0,1,1.0,1,1.0,1,0.41064046815362065,52
4249,18,60823,60823,0,0,0,0,1.0,1,1.0,1,1.0,1,0.32751231067393943,52
4250,26,60849,60849,0,0,0,0,1.0,1,1.0,1,1.0,1,0.2943258663380115,52
4251,32,60881,60881,0,0,0,0,1.0,1,1.0,1,1.0,1,0.28013103802492423,53
4252,34,60915,60915,0,0,0,0,1.0,1,1.0,1,1.0,1,0.2518296932866857,53
4253,25,60940,60940,0,0,0,0,1.0,1,1.0,1,1.0,1,0.30209164081652484,54
4254,18,60958,60958,0,0,0,0,1.0,1,1.0,1,1.0,1,0.2187890721335071,54
4255,21,60979,60979,0,0,0,0,1.0,1,1.0,1,1.0,1,0.36365410979077795,55
4256,17,60996,60996,0,0,0,0,1.0,1,1.0,1,1.0,1,0.3173195270198139,57
4257,16,61012,61012,0,0,0,0,1.0,1,1.0,1,1.0,1,0.2134632596836205,57
4258,17,61029,61029,0,0,0,0,1.0,1,1.0,1,1.0,1,0.2837312558326274,57
4259,21,61050,61050,0,0,0,0,1.0,1,1.0,1,1.0,1,0.34546829248404654,57
4260,16,61066,61066,0,0,0,0,1.0,1,1.0,1,1.0,1,0.37220648659315236,58
4261,15,61081,61081,0,0,0,0,1.0,1,1.0,1,1.0,1,0.29425671409169335,59
4262,15,61096,61096,0,0,0,0,1.0,1,1.0,1,1.0,1,0.4178928002239205,60
4263,26,61122,61122,0,0,0,0,1.0,1,1.0,1,1.0,1,0.3336682757626102,59
4264,22,61144,61144,0,0,0,0,1.0,1,1.0,1,1.0,1,0.3217835799533186,58
4265,28,61172,61172,0,0,0,0,1.0,1,1.0,1,1.0,1,0.45311895039769945,58
4266,24,61196,61196,0,0,0,0,1.0,1,1.0,1,1.0,1,0.45607669190462546,58
4267,23,61219,61219,0,0,0,0,1.0,1,1.0,1,1.0,1,0.4521038662437287,55
4268,11,61230,61230,0,0,0,0,1.0,1,1.0,1,1.0,1,0.4293917744342319,55
4269,17,61247,61247,0,0,0,0,1.0,1,1.0,1,1.0,1,0.4601883547885835,50
4270,23,61270,61270,0,0,0,0,1.0,1,1.0,1,1.0,1,0.38530236703370896,47
4271,14,61284,61284,0,0,0,0,1.0,1,1.0,1,1.0,1,0.5075959047577706,47
4272,15,61299,61299,0,0,0,0,1.0,1,1.0,1,1.0,1,0.41815989057622477,46
4273,12,61311,61311,0,0,0,0,1.0,1,1.0,1,1.0,1,0.37990641225549554,47
4274,19,61330,61330,0,0,0,0,1.0,1,1.0,1,1.0,1,0.3066237836161853,45
4275,14,61344,61344,0,0,0,0,1.0,1,1.0,1,1.0,1,0.20985600526924147,44
4276,16,61360,61360,0,0,0,0,1.0,1,1.0,1,1.0,1,0.28161866224941007,43
4277,10,61370,61370,0,0,0,0,1.0,1,1.0,1,1.0,1,0.23288370619678794,42
4278,16,61386,61386,0,0,0,0,1.0,1,1.0,1,1.0,1,0.1779044762545843,43
4279,14,61400,61400,0,0,0,0,1.0,1,1.0,1,1.0,1,0.22820211421403536,42
4280,12,61412,61412,0,0,0,0,1.0,1,1.0,1,1.0,1,0.1591329936476541,44
4281,23,61435,61435,0,0,0,0,1.0,1,1.0,1,1.0,1,0.23608113982849105,44
4282,17,61452,61452,0,0,0,0,1.0,1,1.0,1,1.0,1,0.2219320383324521,44
4283,24,61476,61476,0,0,0,0,1.0,1,1.0,1,1.0,1,0.24146261594463306,45
4284,18,61494,61494,0,0,0,0,1.0,1,1.0,1,1.0,1,0.22898997785873096,45
4285,10,61504,61504,0,0,0,0,1.0,1,1.0,1,1.0,1,0.25792111757735686,47
4286,12,61516,61516,0,0,0,0,1.0,1,1.0,1,1.0,1,0.2617207195040635,47
4287,19,61535,61535,0,0,0,0,1.0,1,1.0,1,1.0,1,0.3054979651461185,49
4288,22,61557,61557,0,0,0,0,1.0,1,1.0,1,1.0,1,0.2645029742814055,49
4289,16,61573,61573,0,0,0,0,1.0,1,1.0,1,1.0,1,0.2809312800385553,50
4290,20,61593,61593,0,0,0,0,1.0,1,1.0,1,1.0,1,0.27546486296312017,51
4291,18,61611,61611,0,0,0,0,1.0,1,1.0,1,1.0,1,0.2492662258350138,50
4292,13,61624,61624,0,0,0,0,1.0,1,1.0,1,1.0,1,0.30937477997967455,51
4293,22,61646,61646,0,0,0,0,1.0,1,1.0,1,1.0,1,0.2832118342602745,51
4294,14,61660,61660,0,0,0,0,1.0,1,1.0,1,1.0,1,0.24959765852662527,50
4295,18,61678,61678,0,0,0,0,1.0,1,1.0,1,1.0,1,0.37883924123125506,50
4296,19,61697,61697,0,0,0,0,1.0,1,1.0,1,1.0,1,0.3355275332514766,49
4297,15,61712,61712,0,0,0,0,1.0,1,1.0,1,1.0,1,0.336299306592579,49
4298,11,61723,61723,0,0,0,0,1.0,1,1.0,1,1.0,1,0.3405056781119177,49
4299,12,61735,61735,0,0,0,0,1.0,1,1.0,1,1.0,1,0.28479956681920976,48
4300,12,61747,61747,0,0,0,0,1.0,1,1.0,1,1.0,1,0.25107983726191635,49
4301,12,61759,61759,0,0,0,0,1.0,1,1.0,1,1.0,1,0.2880711575165081,50
4302,16,61775,61775,0,0,0,0,1.0,1,1.0,1,1.0,1,0.25459433538950627,51
4303,13,61788,61788,0,0,0,0,1.0,1,1.0,1,1.0,1,0.3018744918612596,51
4304,11,61799,61799,0,0,0,0,1.0,1,1.0,1,1.0,1,0.3152325557357527,51
4305,12,61811,61811,0,0,0,0,1.0,1,1.0,1,1.0,1,0.2522348917655886,49
4306,12,61823,61823,0,0,0,0,1.0,1,1.0,1,1.0,1,0.25963863057913167,49
4307,8,61831,61831,0,0,0,0,1.0,1,1.0,1,1.0,1,0.1679927557933338,46
4308,6,61837,61837,0,0,0,0,1.0,1,1.0,1,1.0,1,0.2645339975006806,44
4309,9,61846,61846,0,0,0,0,1.0,1,1.0,1,1.0,1,0.24007458281136002,44
4310,10,61856,61856,0,0,0,0,1.0,1,1.0,1,1.0,1,0.32452368207484666,42
4311,10,61866,61866,0,0,0,0,1.0,1,1.0,1,1.0,1,0.2519369025371319,42
4312,7,61873,61873,0,0,0,0,1.0,1,1.0,1,1.0,1,0.26074557851007113,40
4313,18,61891,61891,0,0,0,0,1.0,1,1.0,1,1.0,1,0.36594214247476586,40
4314,13,61904,61904,0,0,0,0,1.0,1,1.0,1,1.0,1,0.4082872878123447,36
4315,14,61918,61918,0,0,0,0,1.0,1,1.0,1,1.0,1,0.3770911303266059,37
4316,8,61926,61926,0,0,0,0,1.0,1,1.0,1,1.0,1,0.35961703704504866,37
4317,10,61936,61936,0,0,0,0,1.0,1,1.0,1,1.0,1,0.34475128415490924,36
4318,8,61944,61944,0,0,0,0,1.0,1,1.0,1,1.0,1,0.3582970814985183,34
4319,12,61956,61956,0,0,0,0,1.0,1,1.0,1,1.0,1,0.31350062483797003,34
4320,13,61969,61969,0,0,0,0,1.0,1,1.0,1,1.0,1,0.47920653084815423,34
4321,12,61981,61981,0,0,0,0,1.0,1,1.0,1,1.0,1,0.33659322820117565,35
4322,11,61992,61992,0,0,0,0,1.0,1,1.0,1,1.0,1,0.3960333016820406,35
4323,13,62005,62005,0,0,0,0,1.0,1,1.0,1,1.0,1,0.31198875977252377,35
4324,17,62022,62022,0,0,0,0,1.0,1,1.0,1,1.0,1,0.3422553949515197,34
4325,15,62037,62037,0,0,0,0,1.0,1,1.0,1,1.0,1,0.23495821075887424,34
4326,15,62052,62052,0,0,0,0,1.0,1,1.0,1,1.0,1,0.3741109628289641,36
4327,14,62066,62066,0,0,0,0,1.0,1,1.0,1,1.0,1,0.3120545693827351,35
4328,15,62081,62081,0,0,0,0,1.0,1,1.0,1,1.0,1,0.30002558909702315,35
4329,19,62100,62100,0,0,0,0,1.0,1,1.0,1,1.0,1,0.3913782854254366,38
4330,17,62117,62117,0,0,0,0,1.0,1,1.0,1,1.0,1,0.2588711532298121,38
4331,14,62131,62131,0,0,0,0,1.0,1,1.0,1,1.0,1,0.38833862480704884,39
4332,18,62149,62149,0,0,0,0,1.0,1,1.0,1,1.0,1,0.37534215908789786,40
4333,6,62155,62155,0,0,0,0,1.0,1,1.0,1,1.0,1,0.41948119816150864,41
4334,9,62164,62164,0,0,0,0,1.0,1,1.0,1,1.0,1,0.28627491795175325,41
4335,4,62168,62168,0,0,0,0,1.0,1,1.0,1,1.0,1,0.3208713100747692,42
4336,8,62176,62176,0,0,0,0,1.0,1,1.0,1,1.0,1,0.27840688416111853,43
4337,10,62186,62186,0,0,0,0,1.0,1,1.0,1,1.0,1,0.31920004110733896,44
4338,7,62193,62193,0,0,0,0,1.0,1,1.0,1,1.0,1,0.2683965944973149,44
4339,10,62203,62203,0,0,0,0,1.0,1,1.0,1,1.0,1,0.37656786605315046,46
4340,12,62215,62215,0,0,0,0,1.0,1,1.0,1,1.0,1,0.3174582982848175,47
4341,11,62226,62226,0,0,0,0,1.0,1,1.0,1,1.0,1,0.3606361315320537,47
4342,14,62240,62240,0,0,0,0,1.0,1,1.0,1,1.0,1,0.38360168461210514,47
4343,15,62255,62255,0,0,0,0,1.0,1,1.0,1,1.0,1,0.5022907947625873,42
4344,12,62267,62267,0,0,0,0,1.0,1,1.0,1,1.0,1,0.4574353244399969,42
4345,13,62280,62280,0,0,0,0,1.0,1,1.0,1,1.0,1,0.5304854500711862,39
4346,10,62290,62290,0,0,0,0,1.0,1,1.0,1,1.0,1,0.5669192859875156,37
4347,9,62299,62299,0,0,0,0,1.0,1,1.0,1,1.0,1,0.5631094471051323,37
4348,15,62314,62314,0,0,0,0,1.0,1,1.0,1,1.0,1,0.4644241324716528,38
4349,6,62320,62320,0,0,0,0,1.0,1,1.0,1,1.0,1,0.4468896771104909,36
4350,10,62330,62330,0,0,0,0,1.0,1,1.0,1,1.0,1,0.4448328050211102,37
4351,7,62337,62337,0,0,0,0,1.0,1,1.0,1,1.0,1,0.4542972880214181,35
4352,12,62349,62349,0,0,0,0,1.0,1,1.0,1,1.0,1,0.464237665405465,34
4353,13,62362,62362,0,0,0,0,1.0,1,1.0,1,1.0,1,0.510396222066585,34
4354,9,62371,62371,0,0,0,0,1.0,1,1.0,1,1.0,1,0.5954357424893516,32
4355,18,62389,62389,0,0,0,0,1.0,1,1.0,1,1.0,1,0.33095752857338273,32
4356,14,62403,62403,0,0,0,0,1.0,1,1.0,1,1.0,1,0.4121410609506483,34
4357,16,62419,62419,0,0,0,0,1.0,1,1.0,1,1.0,1,0.2952840124827992,35
4358,16,62435,62435,0,0,0,0,1.0,1,1.0,1,1.0,1,0.33561584801448424,35
4359,14,62449,62449,0,0,0,0,1.0,1,1.0,1,1.0,1,0.37616215553031607,37
4360,10,62459,62459,0,0,0,0,1.0,1,1.0,1,1.0,1,0.37899693661373957,38
4361,16,62475,62475,0,0,0,0,1.0,1,1.0,1,1.0,1,0.30186607705336166,39
4362,14,62489,62489,0,0,0,0,1.0,1,1.0,1,1.0,1,0.35292430565425603,38
4363,9,62498,62498,0,0,0,0,1.0,1,1.0,1,1.0,1,0.30116172129051877,38
4364,12,62510,62510,0,0,0,0,1.0,1,1.0,1,1.0,1,0.32977813941826367,39
4365,15,62525,62525,0,0,0,0,1.0,1,1.0,1,1.0,1,0.3209352311074232,39
4366,9,62534,62534,0,0,0,0,1.0,1,1.0,1,1.0,1,0.3955483863777664,39
4367,5,62539,62539,0,0,0,0,1.0,1,1.0,1,1.0,1,0.43138230570378305,41
4368,10,62549,62549,0,0,0,0,1.0,1,1.0,1,1.0,1,0.45122456890330687,41
4369,13,62562,62562,0,0,0,0,1.0,1,1.0,1,1.0,1,0.36773919658013227,42
4370,5,62567,62567,0,0,0,0,1.0,1,1.0,1,1.0,1,0.3680560917488532,42
4371,8,62575,62575,0,0,0,0,1.0,1,1.0,1,1.0,1,0.3697600748709358,43
4372,8,62583,62583,0,0,0,0,1.0,1,1.0,1,1.0,1,0.3588288192909861,43
4373,12,62595,62595,0,0,0,0,1.0,1,1.0,1,1.0,1,0.3398181795518086,43
4374,10,62605,62605,0,0,0,0,1.0,1,1.0,1,1.0,1,0.378585774203142,44
4375,11,62616,62616,0,0,0,0,1.0,1,1.0,1,1.0,1,0.3364192923670862,45
4376,10,62626,62626,0,0,0,0,1.0,1,1.0,1,1.0,1,0.31058088271883905,46
4377,10,62636,62636,0,0,0,0,1.0,1,1.0,1,1.0,1,0.3699320910273684,47
4378,5,62641,62641,0,0,0,0,1.0,1,1.0,1,1.0,1,0.3678017671150931,49
4379,9,62650,62650,0,0,0,0,1.0,1,1.0,1,1.0,1,0.3391200882639243,51
4380,4,62654,62654,0,0,0,0,1.0,1,1.0,1,1.0,1,0.3389168078405325,50
4381,5,62659,62659,0,0,0,0,1.0,1,1.0,1,1.0,1,0.32030452000718745,49
4382,10,62669,62669,0,0,0,0,1.0,1,1.0,1,1.0,1,0.3765230682626402,47
4383,8,62677,62677,0,0,0,0,1.0,1,1.0,1,1.0,1,0.39572334329245323,47
4384,11,62688,62688,0,0,0,0,1.0,1,1.0,1,1.0,1,0.4438060521934767,44
4385,14,62702,62702,0,0,0,0,1.0,1,1.0,1,1.0,1,0.33647460295352466,42
4386,5,62707,62707,0,0,0,0,1.0,1,1.0,1,1.0,1,0.3891388554393252,41
4387,8,62715,62715,0,0,0,0,1.0,1,1.0,1,1.0,1,0.3119926005008137,39
4388,19,62734,62734,0,0,0,0,1.0,1,1.0,1,1.0,1,0.36980153587454456,39
4389,12,62746,62746,0,0,0,0,1.0,1,1.0,1,1.0,1,0.47599859282632906,38
4390,7,62753,62753,0,0,0,0,1.0,1,1.0,1,1.0,1,0.3666324689543536,38
4391,7,62760,62760,0,0,0,0,1.0,1,1.0,1,1.0,1,0.3822749792581417,39
4392,9,62769,62769,0,0,0,0,1.0,1,1.0,1,1.0,1,0.3267732361033272,39
4393,4,62773,62773,0,0,0,0,1.0,1,1.0,1,1.0,1,0.362043411484719,40
4394,8,62781,62781,0,0,0,0,1.0,1,1.0,1,1.0,1,0.2905262553038767,39
4395,5,62786,62786,0,0,0,0,1.0,1,1.0,1,1.0,1,0.3191412473533287,39
4396,6,62792,62792,0,0,0,0,1.0,1,1.0,1,1.0,1,0.3987194093102682,39
4397,8,62800,62800,0,0,0,0,1.0,1,1.0,1,1.0,1,0.36104655035323807,38
4398,9,62809,62809,0,0,0,0,1.0,1,1.0,1,1.0,1,0.39904313268687114,39
4399,11,62820,62820,0,0,0,0,1.0,1,1.0,1,1.0,1,0.4378177678673474,42
4400,17,62837,62837,0,0,0,0,1.0,1,1.0,1,1.0,1,0.3238140201438321,43
4401,7,62844,62844,0,0,0,0,1.0,1,1.0,1,1.0,1,0.4069752512452311,44
4402,11,62855,62855,0,0,0,0,1.0,1,1.0,1,1.0,1,0.3523779773944243,44
4403,14,62869,62869,0,0,0,0,1.0,1,1.0,1,1.0,1,0.3090886015040508,45
4404,19,62888,62888,0,0,0,0,1.0,1,1.0,1,1.0,1,0.30246410501669635,45
4405,10,62898,62898,0,0,0,0,1.0,1,1.0,1,1.0,1,0.30038403483586906,46
4406,12,62910,62910,0,0,0,0,1.0,1,1.0,1,1.0,1,0.35826050500477785,46
4407,7,62917,62917,0,0,0,0,1.0,1,1.0,1,1.0,1,0.33122966401654963,46
4408,7,62924,62924,0,0,0,0,1.0,1,1.0,1,1.0,1,0.3824747649843137,47
4409,6,62930,62930,0,0,0,0,1.0,1,1.0,1,1.0,1,0.3025452172558011,48
4410,8,62938,62938,0,0,0,0,1.0,1,1.0,1,1.0,1,0.3114593788745337,48
4411,12,62950,62950,0,0,0,0,1.0,1,1.0,1,1.0,1,0.31350780459613165,50
4412,9,62959,62959,0,0,0,0,1.0,1,1.0,1,1.0,1,0.26900894364428685,50
4413,6,62965,62965,0,0,0,0,1.0,1,1.0,1,1.0,1,0.3303210687697169,50
4414,13,62978,62978,0,0,0,0,1.0,1,1.0,1,1.0,1,0.3062552950067642,51
4415,12,62990,62990,0,0,0,0,1.0,1,1.0,1,1.0,1,0.2333214530545827,51
4416,8,62998,62998,0,0,0,0,1.0,1,1.0,1,1.0,1,0.26954912214384275,51
4417,9,63007,63007,0,0,0,0,1.0,1,1.0,1,1.0,1,0.25325024831390625,51
4418,11,63018,63018,0,0,0,0,1.0,1,1.0,1,1.0,1,0.27054871392261653,51
4419,13,63031,63031,0,0,0,0,1.0,1,1.0,1,1.0,1,0.3002540535851131,50
4420,15,63046,63046,0,0,0,0,1.0,1,1.0,1,1.0,1,0.29895374695752164,50
4421,12,63058,63058,0,0,0,0,1.0,1,1.0,1,1.0,1,0.24651040733741622,52
4422,13,63071,63071,0,0,0,0,1.0,1,1.0,1,1.0,1,0.19866318112585968,51
4423,19,63090,63090,0,0,0,0,1.0,1,1.0,1,1.0,1,0.21680292332129772,51
4424,18,63108,63108,0,0,0,0,1.0,1,1.0,1,1.0,1,0.2643281820226622,53
4425,22,63130,63130,0,0,0,0,1.0,1,1.0,1,1.0,1,0.303128077533508,54
4426,16,63146,63146,0,0,0,0,1.0,1,1.0,1,1.0,1,0.24788490335425356,55
4427,22,63168,63168,0,0,0,0,1.0,1,1.0,1,1.0,1,0.23122921999583954,55
4428,8,63176,63176,0,0,0,0,1.0,1,1.0,1,1.0,1,0.24170051523132607,55
4429,23,63199,63199,0,0,0,0,1.0,1,1.0,1,1.0,1,0.22791207113053755,56
4430,15,63214,63214,0,0,0,0,1.0,1,1.0,1,1.0,1,0.34010407290826805,55
4431,21,63235,63235,0,0,0,0,1.0,1,1.0,1,1.0,1,0.2693018128794106,56
4432,20,63255,63255,0,0,0,0,1.0,1,1.0,1,1.0,1,0.27792854172450054,56
4433,21,63276,63276,0,0,0,0,1.0,1,1.0,1,1.0,1,0.19336764906244333,57
4434,14,63290,63290,0,0,0,0,1.0,1,1.0,1,1.0,1,0.21816296680296537,56
4435,19,63309,63309,0,0,0,0,1.0,1,1.0,1,1.0,1,0.29818713439390976,56
4436,28,63337,63337,0,0,0,0,1.0,1,1.0,1,1.0,1,0.156656979426517,55
4437,19,63356,63356,0,0,0,0,1.0,1,1.0,1,1.0,1,0.24910286856621816,54
4438,22,63378,63378,0,0,0,0,1.0,1,1.0,1,1.0,1,0.29110878766379794,54
4439,21,63399,63399,0,0,0,0,1.0,1,1.0,1,1.0,1,0.36305542369005656,55
4440,17,63416,63416,0,0,0,0,1.0,1,1.0,1,1.0,1,0.35039681174389137,55
4441,22,63438,63438,0,0,0,0,1.0,1,1.0,1,1.0,1,0.3329245099929231,59
4442,12,63450,63450,0,0,0,0,1.0,1,1.0,1,1.0,1,0.3524238685108132,61
4443,31,63481,63481,0,0,0,0,1.0,1,1.0,1,1.0,1,0.3400390398264213,60
4444,19,63500,63500,0,0,0,0,1.0,1,1.0,1,1.0,1,0.34436781057106813,61
4445,21,63521,63521,0,0,0,0,1.0,1,1.0,1,1.0,1,0.3232479821167673,61
4446,17,63538,63538,0,0,0,0,1.0,1,1.0,1,1.0,1,0.2938641606268732,62
4447,30,63568,63568,0,0,0,0,1.0,1,1.0,1,1.0,1,0.35533773334749047,63
4448,16,63584,63584,0,0,0,0,1.0,1,1.0,1,1.0,1,0.34048896473602686,63
4449,17,63601,63601,0,0,0,0,1.0,1,1.0,1,1.0,1,0.3794983031958917,63
4450,11,63612,63612,0,0,0,0,1.0,1,1.0,1,1.0,1,0.3470112218404853,62
4451,16,63628,63628,0,0,0,0,1.0,1,1.0,1,1.0,1,0.34242580338276485,63
4452,10,63638,63638,0,0,0,0,1.0,1,1.0,1,1.0,1,0.41340335023913444,64
4453,15,63653,63653,0,0,0,0,1.0,1,1.0,1,1.0,1,0.3412389351836881,65
4454,13,63666,63666,0,0,0,0,1.0,1,1.0,1,1.0,1,0.33418375538718303,66
4455,22,63688,63688,0,0,0,0,1.0,1,1.0,1,1.0,1,0.33099265818787976,67
4456,17,63705,63705,0,0,0,0,1.0,1,1.0,1,1.0,1,0.3326200613299691,67
4457,11,63716,63716,0,0,0,0,1.0,1,1.0,1,1.0,1,0.3447541421231659,65
4458,14,63730,63730,0,0,0,0,1.0,1,1.0,1,1.0,1,0.27013846699143845,65
4459,19,63749,63749,0,0,0,0,1.0,1,1.0,1,1.0,1,0.35195296854208635,64
4460,16,63765,63765,0,0,0,0,1.0,1,1.0,1,1.0,1,0.2583756232403666,63
4461,16,63781,63781,0,0,0,0,1.0,1,1.0,1,1.0,1,0.318624748667501,62
4462,16,63797,63797,0,0,0,0,1.0,1,1.0,1,1.0,1,0.4218677722810712,61
4463,24,63821,63821,0,0,0,0,1.0,1,1.0,1,1.0,1,0.34641942858499564,61
4464,12,63833,63833,0,0,0,0,1.0,1,1.0,1,1.0,1,0.40752280549443387,58
4465,15,63848,63848,0,0,0,0,1.0,1,1.0,1,1.0,1,0.35921724375516484,57
4466,29,63877,63877,0,0,0,0,1.0,1,1.0,1,1.0,1,0.3106004915238684,54
4467,17,63894,63894,0,0,0,0,1.0,1,1.0,1,1.0,1,0.3056524356665512,52
4468,18,63912,63912,0,0,0,0,1.0,1,1.0,1,1.0,1,0.3297735170810727,52
4469,18,63930,63930,0,0,0,0,1.0,1,1.0,1,1.0,1,0.278869567890545,51
4470,15,63945,63945,0,0,0,0,1.0,1,1.0,1,1.0,1,0.33008845143340204,51
4471,17,63962,63962,0,0,0,0,1.0,1,1.0,1,1.0,1,0.29503768223696564,50
4472,21,63983,63983,0,0,0,0,1.0,1,1.0,1,1.0,1,0.3811279609476139,48
4473,34,64017,64017,0,0,0,0,1.0,1,1.0,1,1.0,1,0.3839079489705946,47
4474,29,64046,64046,0,0,0,0,1.0,1,1.0,1,1.0,1,0.4319049247771717,49
4475,22,64068,64068,0,0,0,0,1.0,1,1.0,1,1.0,1,0.3988684146679773,47
4476,23,64091,64091,0,0,0,0,1.0,1,1.0,1,1.0,1,0.355959947105754,49
4477,19,64110,64110,0,0,0,0,1.0,1,1.0,1,1.0,1,0.292596409787994,48
4478,18,64128,64128,0,0,0,0,1.0,1,1.0,1,1.0,1,0.4624835943750029,48
4479,10,64138,64138,0,0,0,0,1.0,1,1.0,1,1.0,1,0.40696458835555827,48
4480,9,64147,64147,0,0,0,0,1.0,1,1.0,1,1.0,1,0.47067641036834545,49
4481,13,64160,64160,0,0,0,0,1.0,1,1.0,1,1.0,1,0.48619340246396886,49
4482,16,64176,64176,0,0,0,0,1.0,1,1.0,1,1.0,1,0.47604256437004877,49
4483,12,64188,64188,0,0,0,0,1.0,1,1.0,1,1.0,1,0.39256503925287445,50
4484,16,64204,64204,0,0,0,0,1.0,1,1.0,1,1.0,1,0.4316197212917655,52
4485,11,64215,64215,0,0,0,0,1.0,1,1.0,1,1.0,1,0.40125117601956706,53
4486,16,64231,64231,0,0,0,0,1.0,1,1.0,1,1.0,1,0.35378270618257557,55
4487,18,64249,64249,0,0,0,0,1.0,1,1.0,1,1.0,1,0.40241460569934706,55
4488,17,64266,64266,0,0,0,0,1.0,1,1.0,1,1.0,1,0.41195355789720944,54
4489,19,64285,64285,0,0,0,0,1.0,1,1.0,1,1.0,1,0.4917494139157408,53
4490,18,64303,64303,0,0,0,0,1.0,1,1.0,1,1.0,1,0.41339148605017456,53
4491,9,64312,64312,0,0,0,0,1.0,1,1.0,1,1.0,1,0.43152376614588017,52
4492,16,64328,64328,0,0,0,0,1.0,1,1.0,1,1.0,1,0.440824387097991,52
4493,15,64343,64343,0,0,0,0,1.0,1,1.0,1,1.0,1,0.3430104176262463,52
4494,13,64356,64356,0,0,0,0,1.0,1,1.0,1,1.0,1,0.3537475907358045,53
4495,23,64379,64379,0,0,0,0,1.0,1,1.0,1,1.0,1,0.37258628826158036,50
4496,13,64392,64392,0,0,0,0,1.0,1,1.0,1,1.0,1,0.28890331158011195,51
4497,15,64407,64407,0,0,0,0,1.0,1,1.0,1,1.0,1,0.27573345032102686,50
4498,20,64427,64427,0,0,0,0,1.0,1,1.0,1,1.0,1,0.3429987122400162,49
4499,13,64440,64440,0,0,0,0,1.0,1,1.0,1,1.0,1,0.3044509804049758,48
4500,17,64457,64457,0,0,0,0,1.0,1,1.0,1,1.0,1,0.29189744150602565,48
4501,19,64476,64476,0,0,0,0,1.0,1,1.0,1,1.0,1,0.27652821471895817,48
4502,11,64487,64487,0,0,0,0,1.0,1,1.0,1,1.0,1,0.3208503325724826,49
4503,15,64502,64502,0,0,0,0,1.0,1,1.0,1,1.0,1,0.36330804304476033,49
4504,14,64516,64516,0,0,0,0,1.0,1,1.0,1,1.0,1,0.29474483778418303,45
4505,27,64543,64543,0,0,0,0,1.0,1,1.0,1,1.0,1,0.3867480643096254,46
4506,11,64554,64554,0,0,0,0,1.0,1,1.0,1,1.0,1,0.2913774890511264,45
4507,18,64572,64572,0,0,0,0,1.0,1,1.0,1,1.0,1,0.3525838057796058,45
4508,14,64586,64586,0,0,0,0,1.0,1,1.0,1,1.0,1,0.2608395754089863,43
4509,11,64597,64597,0,0,0,0,1.0,1,1.0,1,1.0,1,0.2533586489253769,41
4510,12,64609,64609,0,0,0,0,1.0,1,1.0,1,1.0,1,0.32564778880753076,42
4511,9,64618,64618,0,0,0,0,1.0,1,1.0,1,1.0,1,0.2757223442637993,41
4512,9,64627,64627,0,0,0,0,1.0,1,1.0,1,1.0,1,0.32017514386313184,41
4513,9,64636,64636,0,0,0,0,1.0,1,1.0,1,1.0,1,0.2603262311895658,41
4514,16,64652,64652,0,0,0,0,1.0,1,1.0,1,1.0,1,0.29795134043936305,42
4515,10,64662,64662,0,0,0,0,1.0,1,1.0,1,1.0,1,0.34795114820368067,41
4516,12,64674,64674,0,0,0,0,1.0,1,1.0,1,1.0,1,0.4280885986015173,42
4517,10,64684,64684,0,0,0,0,1.0,1,1.0,1,1.0,1,0.3160778409553207,43
4518,10,64694,64694,0,0,0,0,1.0,1,1.0,1,1.0,1,0.36398834454861023,42
4519,8,64702,64702,0,0,0,0,1.0,1,1.0,1,1.0,1,0.3379573736683923,42
4520,15,64717,64717,0,0,0,0,1.0,1,1.0,1,1.0,1,0.31343490523410134,42
4521,10,64727,64727,0,0,0,0,1.0,1,1.0,1,1.0,1,0.2982208454163467,42
4522,18,64745,64745,0,0,0,0,1.0,1,1.0,1,1.0,1,0.33894802879229957,42
4523,13,64758,64758,0,0,0,0,1.0,1,1.0,1,1.0,1,0.3294923149505024,42
4524,12,64770,64770,0,0,0,0,1.0,1,1.0,1,1.0,1,0.2576348659479646,43
4525,15,64785,64785,0,0,0,0,1.0,1,1.0,1,1.0,1,0.26959155694414616,46
4526,16,64801,64801,0,0,0,0,1.0,1,1.0,1,1.0,1,0.26540219959364997,46
4527,16,64817,64817,0,0,0,0,1.0,1,1.0,1,1.0,1,0.26982745538649583,47
4528,18,64835,64835,0,0,0,0,1.0,1,1.0,1,1.0,1,0.31239616017254657,49
4529,15,64850,64850,0,0,0,0,1.0,1,1.0,1,1.0,1,0.3746139981811696,50
4530,15,64865,64865,0,0,0,0,1.0,1,1.0,1,1.0,1,0.32474593348663305,51
4531,7,64872,64872,0,0,0,0,1.0,1,1.0,1,1.0,1,0.33848337997756395,51
4532,16,64888,64888,0,0,0,0,1.0,1,1.0,1,1.0,1,0.29496637466211334,51
4533,9,64897,64897,0,0,0,0,1.0,1,1.0,1,1.0,1,0.4185656564350395,50
4534,17,64914,64914,0,0,0,0,1.0,1,1.0,1,1.0,1,0.2252221953951216,51
4535,15,64929,64929,0,0,0,0,1.0,1,1.0,1,1.0,1,0.3364316925932072,50
4536,20,64949,64949,0,0,0,0,1.0,1,1.0,1,1.0,1,0.4004500792073392,48
4537,14,64963,64963,0,0,0,0,1.0,1,1.0,1,1.0,1,0.40038694312992557,49
4538,14,64977,64977,0,0,0,0,1.0,1,1.0,1,1.0,1,0.3962744951387117,48
4539,12,64989,64989,0,0,0,0,1.0,1,1.0,1,1.0,1,0.3324446825452791,50
4540,17,65006,65006,0,0,0,0,1.0,1,1.0,1,1.0,1,0.4051716208895829,49
4541,13,65019,65019,0,0,0,0,1.0,1,1.0,1,1.0,1,0.4423307149004315,49
4542,14,65033,65033,0,0,0,0,1.0,1,1.0,1,1.0,1,0.3925254934295692,47
4543,8,65041,65041,0,0,0,0,1.0,1,1.0,1,1.0,1,0.46736217949242315,45
4544,7,65048,65048,0,0,0,0,1.0,1,1.0,1,1.0,1,0.4255873061503418,45
4545,10,65058,65058,0,0,0,0,1.0,1,1.0,1,1.0,1,0.42484537323006183,43
4546,7,65065,65065,0,0,0,0,1.0,1,1.0,1,1.0,1,0.4643920641736037,43
4547,9,65074,65074,0,0,0,0,1.0,1,1.0,1,1.0,1,0.48488967963237,41
4548,14,65088,65088,0,0,0,0,1.0,1,1.0,1,1.0,1,0.4743145677161705,42
4549,16,65104,65104,0,0,0,0,1.0,1,1.0,1,1.0,1,0.36459134088874046,41
4550,11,65115,65115,0,0,0,0,1.0,1,1.0,1,1.0,1,0.3677944604471543,41
4551,12,65127,65127,0,0,0,0,1.0,1,1.0,1,1.0,1,0.42733055687170934,39
4552,8,65135,65135,0,0,0,0,1.0,1,1.0,1,1.0,1,0.3300312563298978,38
4553,13,65148,65148,0,0,0,0,1.0,1,1.0,1,1.0,1,0.41494372890460823,39
4554,10,65158,65158,0,0,0,0,1.0,1,1.0,1,1.0,1,0.44511099183142183,38
4555,7,65165,65165,0,0,0,0,1.0,1,1.0,1,1.0,1,0.38682022482862644,37
4556,12,65177,65177,0,0,0,0,1.0,1,1.0,1,1.0,1,0.43875939558453403,36
4557,7,65184,65184,0,0,0,0,1.0,1,1.0,1,1.0,1,0.36222140469207253,38
4558,11,65195,65195,0,0,0,0,1.0,1,1.0,1,1.0,1,0.32733634638517367,39
4559,13,65208,65208,0,0,0,0,1.0,1,1.0,1,1.0,1,0.4398039225109062,38
4560,7,65215,65215,0,0,0,0,1.0,1,1.0,1,1.0,1,0.3790934292318265,41
4561,7,65222,65222,0,0,0,0,1.0,1,1.0,1,1.0,1,0.4274469805027415,41
4562,12,65234,65234,0,0,0,0,1.0,1,1.0,1,1.0,1,0.3597573522182978,43
4563,12,65246,65246,0,0,0,0,1.0,1,1.0,1,1.0,1,0.334387446749146,42
4564,12,65258,65258,0,0,0,0,1.0,1,1.0,1,1.0,1,0.36067433226498624,43
4565,17,65275,65275,0,0,0,0,1.0,1,1.0,1,1.0,1,0.31698948698642065,44
4566,13,65288,65288,0,0,0,0,1.0,1,1.0,1,1.0,1,0.2413070542577341,45
4567,24,65312,65312,0,0,0,0,1.0,1,1.0,1,1.0,1,0.32735700713601457,47
4568,23,65335,65335,0,0,0,0,1.0,1,1.0,1,1.0,1,0.28853321732021303,47
4569,16,65351,65351,0,0,0,0,1.0,1,1.0,1,1.0,1,0.26686290186081774,49
4570,20,65371,65371,0,0,0,0,1.0,1,1.0,1,1.0,1,0.3150889744730765,49
4571,12,65383,65383,0,0,0,0,1.0,1,1.0,1,1.0,1,0.30429959096510295,48
4572,26,65409,65409,0,0,0,0,1.0,1,1.0,1,1.0,1,0.36668897636804865,48
4573,21,65430,65430,0,0,0,0,1.0,1,1.0,1,1.0,1,0.34544981926418605,48
4574,15,65445,65445,0,0,0,0,1.0,1,1.0,1,1.0,1,0.3412766451276411,50
4575,22,65467,65467,0,0,0,0,1.0,1,1.0,1,1.0,1,0.3704425365932626,51
4576,13,65480,65480,0,0,0,0,1.0,1,1.0,1,1.0,1,0.3955257755180312,48
4577,19,65499,65499,0,0,0,0,1.0,1,1.0,1,1.0,1,0.4140860160441988,47
4578,15,65514,65514,0,0,0,0,1.0,1,1.0,1,1.0,1,0.4078495136587794,46
4579,21,65535,65535,0,0,0,0,1.0,1,1.0,1,1.0,1,0.37868208881548837,46
4580,18,65553,65553,0,0,0,0,1.0,1,1.0,1,1.0,1,0.3416941078062152,47
4581,9,65562,65562,0,0,0,0,1.0,1,1.0,1,1.0,1,0.3557639561659083,47
4582,12,65574,65574,0,0,0,0,1.0,1,1.0,1,1.0,1,0.39855264047634914,48
4583,9,65583,65583,0,0,0,0,1.0,1,1.0,1,1.0,1,0.3496930027404164,48
4584,15,65598,65598,0,0,0,0,1.0,1,1.0,1,1.0,1,0.36690257145422367,50
4585,12,65610,65610,0,0,0,0,1.0,1,1.0,1,1.0,1,0.4013241206225699,50
4586,8,65618,65618,0,0,0,0,1.0,1,1.0,1,1.0,1,0.30889399904158565,50
4587,14,65632,65632,0,0,0,0,1.0,1,1.0,1,1.0,1,0.3404894914267608,50
4588,14,65646,65646,0,0,0,0,1.0,1,1.0,1,1.0,1,0.33441913565153125,50
4589,16,65662,65662,0,0,0,0,1.0,1,1.0,1,1.0,1,0.3725680856242749,52
4590,15,65677,65677,0,0,0,0,1.0,1,1.0,1,1.0,1,0.3950095308210852,52
4591,14,65691,65691,0,0,0,0,1.0,1,1.0,1,1.0,1,0.3680200358827672,53
4592,14,65705,65705,0,0,0,0,1.0,1,1.0,1,1.0,1,0.341820362998872,54
4593,10,65715,65715,0,0,0,0,1.0,1,1.0,1,1.0,1,0.30585019389317875,56
4594,23,65738,65738,0,0,0,0,1.0,1,1.0,1,1.0,1,0.3163809022202761,57
4595,25,65763,65763,0,0,0,0,1.0,1,1.0,1,1.0,1,0.29656483805233336,56
4596,22,65785,65785,0,0,0,0,1.0,1,1.0,1,1.0,1,0.2784102075134287,56
4597,15,65800,65800,0,0,0,0,1.0,1,1.0,1,1.0,1,0.3335976111577315,56
4598,12,65812,65812,0,0,0,0,1.0,1,1.0,1,1.0,1,0.24734435920769055,57
4599,14,65826,65826,0,0,0,0,1.0,1,1.0,1,1.0,1,0.3226960213562722,59
4600,19,65845,65845,0,0,0,0,1.0,1,1.0,1,1.0,1,0.3120545608018198,60
4601,22,65867,65867,0,0,0,0,1.0,1,1.0,1,1.0,1,0.3105161786937472,60
4602,17,65884,65884,0,0,0,0,1.0,1,1.0,1,1.0,1,0.3269460682932072,62
4603,13,65897,65897,0,0,0,0,1.0,1,1.0,1,1.0,1,0.400374996172623,62
4604,19,65916,65916,0,0,0,0,1.0,1,1.0,1,1.0,1,0.3129274126220635,63
4605,14,65930,65930,0,0,0,0,1.0,1,1.0,1,1.0,1,0.3347225393459607,63
4606,12,65942,65942,0,0,0,0,1.0,1,1.0,1,1.0,1,0.3142577868996324,64
4607,25,65967,65967,0,0,0,0,1.0,1,1.0,1,1.0,1,0.3404248739421294,65
4608,17,65984,65984,0,0,0,0,1.0,1,1.0,1,1.0,1,0.3815118044540041,66
4609,21,66005,66005,0,0,0,0,1.0,1,1.0,1,1.0,1,0.34502447867074076,65
4610,14,66019,66019,0,0,0,0,1.0,1,1.0,1,1.0,1,0.3880638693013678,63
4611,28,66047,66047,0,0,0,0,1.0,1,1.0,1,1.0,1,0.33282000056216776,64
4612,29,66076,66076,0,0,0,0,1.0,1,1.0,1,1.0,1,0.33501365377279924,62
4613,24,66100,66100,0,0,0,0,1.0,1,1.0,1,1.0,1,0.3637480572567028,63
4614,20,66120,66120,0,0,0,0,1.0,1,1.0,1,1.0,1,0.3505400382434523,61
4615,27,66147,66147,0,0,0,0,1.0,1,1.0,1,1.0,1,0.4604056556364002,59
4616,16,66163,66163,0,0,0,0,1.0,1,1.0,1,1.0,1,0.3711169905003042,58
4617,17,66180,66180,0,0,0,0,1.0,1,1.0,1,1.0,1,0.4620901515726175,58
4618,30,66210,66210,0,0,0,0,1.0,1,1.0,1,1.0,1,0.3820574688360835,57
4619,21,66231,66231,0,0,0,0,1.0,1,1.0,1,1.0,1,0.39612591778871137,57
4620,22,66253,66253,0,0,0,0,1.0,1,1.0,1,1.0,1,0.46466225469033556,57
4621,32,66285,66285,0,0,0,0,1.0,1,1.0,1,1.0,1,0.33724006617296504,59
4622,34,66319,66319,0,0,0,0,1.0,1,1.0,1,1.0,1,0.42846838452410047,60
4623,24,66343,66343,0,0,0,0,1.0,1,1.0,1,1.0,1,0.3906282933272955,59
4624,36,66379,66379,0,0,0,0,1.0,1,1.0,1,1.0,1,0.4125188790295476,59
4625,23,66402,66402,0,0,0,0,1.0,1,1.0,1,1.0,1,0.29133501841205195,57
4626,30,66432,66432,0,0,0,0,1.0,1,1.0,1,1.0,1,0.48883666948640064,56
4627,18,66450,66450,0,0,0,0,1.0,1,1.0,1,1.0,1,0.4219253843959214,56
4628,28,66478,66478,0,0,0,0,1.0,1,1.0,1,1.0,1,0.4100773594735537,56
4629,21,66499,66499,0,0,0,0,1.0,1,1.0,1,1.0,1,0.4862059708140538,56
4630,19,66518,66518,0,0,0,0,1.0,1,1.0,1,1.0,1,0.42210627014253466,57
4631,25,66543,66543,0,0,0,0,1.0,1,1.0,1,1.0,1,0.44018607874232374,56
4632,25,66568,66568,0,0,0,0,1.0,1,1.0,1,1.0,1,0.4937916866846837,57
4633,15,66583,66583,0,0,0,0,1.0,1,1.0,1,1.0,1,0.4184768281682409,58
4634,28,66611,66611,0,0,0,0,1.0,1,1.0,1,1.0,1,0.4474467964091748,58
4635,20,66631,66631,0,0,0,0,1.0,1,1.0,1,1.0,1,0.45412692792543374,59
4636,27,66658,66658,0,0,0,0,1.0,1,1.0,1,1.0,1,0.40186307783328307,60
4637,23,66681,66681,0,0,0,0,1.0,1,1.0,1,1.0,1,0.44633417456691005,60
4638,46,66727,66727,0,0,0,0,1.0,1,1.0,1,1.0,1,0.48883611332543064,61
4639,33,66760,66760,0,0,0,0,1.0,1,1.0,1,1.0,1,0.3993139650712906,62
4640,25,66785,66785,0,0,0,0,1.0,1,1.0,1,1.0,1,0.5165065039074834,63
4641,32,66817,66817,0,0,0,0,1.0,1,1.0,1,1.0,1,0.46014857281431887,63
4642,39,66856,66856,0,0,0,0,1.0,1,1.0,1,1.0,1,0.420415013343026,62
4643,21,66877,66877,0,0,0,0,1.0,1,1.0,1,1.0,1,0.39911827573398395,63
4644,20,66897,66897,0,0,0,0,1.0,1,1.0,1,1.0,1,0.5140841666155722,62
4645,19,66916,66916,0,0,0,0,1.0,1,1.0,1,1.0,1,0.41251061834307134,63
4646,26,66942,66942,0,0,0,0,1.0,1,1.0,1,1.0,1,0.4666092273769382,63
4647,29,66971,66971,0,0,0,0,1.0,1,1.0,1,1.0,1,0.4386256415566768,62
4648,42,67013,67013,0,0,0,0,1.0,1,1.0,1,1.0,1,0.4148918340692315,63
4649,31,67044,67044,0,0,0,0,1.0,1,1.0,1,1.0,1,0.4789858218017929,61
4650,40,67084,67084,0,0,0,0,1.0,1,1.0,1,1.0,1,0.31024112940966814,63
4651,41,67125,67125,0,0,0,0,1.0,1,1.0,1,1.0,1,0.3824822288489288,62
4652,38,67163,67163,0,0,0,0,1.0,1,1.0,1,1.0,1,0.42303222150749153,59
4653,38,67201,67201,0,0,0,0,1.0,1,1.0,1,1.0,1,0.3376892477040423,60
4654,37,67238,67238,0,0,0,0,1.0,1,1.0,1,1.0,1,0.4092094619556552,60
4655,25,67263,67263,0,0,0,0,1.0,1,1.0,1,1.0,1,0.4173363523629638,60
4656,22,67285,67285,0,0,0,0,1.0,1,1.0,1,1.0,1,0.46771622749763503,61
4657,23,67308,67308,0,0,0,0,1.0,1,1.0,1,1.0,1,0.38943266688120626,62
4658,20,67328,67328,0,0,0,0,1.0,1,1.0,1,1.0,1,0.43973613757849533,62
4659,12,67340,67340,0,0,0,0,1.0,1,1.0,1,1.0,1,0.3773257661473735,61
4660,15,67355,67355,0,0,0,0,1.0,1,1.0,1,1.0,1,0.37457836737589256,61
4661,17,67372,67372,0,0,0,0,1.0,1,1.0,1,1.0,1,0.3985637351182706,61
4662,20,67392,67392,0,0,0,0,1.0,1,1.0,1,1.0,1,0.4825248278680976,62
4663,16,67408,67408,0,0,0,0,1.0,1,1.0,1,1.0,1,0.4159492757632859,61
4664,24,67432,67432,0,0,0,0,1.0,1,1.0,1,1.0,1,0.32881237237824346,62
4665,23,67455,67455,0,0,0,0,1.0,1,1.0,1,1.0,1,0.41385116742176736,61
4666,24,67479,67479,0,0,0,0,1.0,1,1.0,1,1.0,1,0.3479582889825023,61
4667,26,67505,67505,0,0,0,0,1.0,1,1.0,1,1.0,1,0.31075942663010153,59
4668,24,67529,67529,0,0,0,0,1.0,1,1.0,1,1.0,1,0.3987310927268372,59
4669,42,67571,67571,0,0,0,0,1.0,1,1.0,1,1.0,1,0.3587614388435456,58
4670,20,67591,67591,0,0,0,0,1.0,1,1.0,1,1.0,1,0.33948732514015073,57
4671,18,67609,67609,0,0,0,0,1.0,1,1.0,1,1.0,1,0.43507132276989985,55
4672,17,67626,67626,0,0,0,0,1.0,1,1.0,1,1.0,1,0.37966183840798307,56
4673,23,67649,67649,0,0,0,0,1.0,1,1.0,1,1.0,1,0.3510440373832398,58
4674,18,67667,67667,0,0,0,0,1.0,1,1.0,1,1.0,1,0.33625813216588213,58
4675,23,67690,67690,0,0,0,0,1.0,1,1.0,1,1.0,1,0.329291096023995,57
4676,28,67718,67718,0,0,0,0,1.0,1,1.0,1,1.0,1,0.3631262952021034,58
4677,22,67740,67740,0,0,0,0,1.0,1,1.0,1,1.0,1,0.34238631984473716,57
4678,39,67779,67779,0,0,0,0,1.0,1,1.0,1,1.0,1,0.3608503187704493,57
4679,19,67798,67798,0,0,0,0,1.0,1,1.0,1,1.0,1,0.40834600877416916,57
4680,19,67817,67817,0,0,0,0,1.0,1,1.0,1,1.0,1,0.2998676890316642,59
4681,24,67841,67841,0,0,0,0,1.0,1,1.0,1,1.0,1,0.34383370274749564,60
4682,23,67864,67864,0,0,0,0,1.0,1,1.0,1,1.0,1,0.3652560947798753,60
4683,42,67906,67906,0,0,0,0,1.0,1,1.0,1,1.0,1,0.2735770553553829,60
4684,26,67932,67932,0,0,0,0,1.0,1,1.0,1,1.0,1,0.3401262315577896,60
4685,27,67959,67959,0,0,0,0,1.0,1,1.0,1,1.0,1,0.3244048597813777,59
4686,21,67980,67980,0,0,0,0,1.0,1,1.0,1,1.0,1,0.27633788780890567,60
4687,18,67998,67998,0,0,0,0,1.0,1,1.0,1,1.0,1,0.3383178563455748,59
4688,18,68016,68016,0,0,0,0,1.0,1,1.0,1,1.0,1,0.2969840201546204,59
4689,20,68036,68036,0,0,0,0,1.0,1,1.0,1,1.0,1,0.35781979788402446,59
4690,15,68051,68051,0,0,0,0,1.0,1,1.0,1,1.0,1,0.295048938310679,58
4691,18,68069,68069,0,0,0,0,1.0,1,1.0,1,1.0,1,0.2832751922601469,57
4692,20,68089,68089,0,0,0,0,1.0,1,1.0,1,1.0,1,0.30461451350711743,58
4693,15,68104,68104,0,0,0,0,1.0,1,1.0,1,1.0,1,0.3231356358679855,57
4694,20,68124,68124,0,0,0,0,1.0,1,1.0,1,1.0,1,0.2337800579574018,57
4695,16,68140,68140,0,0,0,0,1.0,1,1.0,1,1.0,1,0.3402011016061683,56
4696,20,68160,68160,0,0,0,0,1.0,1,1.0,1,1.0,1,0.3433340292835704,57
4697,22,68182,68182,0,0,0,0,1.0,1,1.0,1,1.0,1,0.26909639756740233,58
4698,19,68201,68201,0,0,0,0,1.0,1,1.0,1,1.0,1,0.3360195788265609,59
4699,16,68217,68217,0,0,0,0,1.0,1,1.0,1,1.0,1,0.35230963902140017,58
4700,25,68242,68242,0,0,0,0,1.0,1,1.0,1,1.0,1,0.33666905956882337,59
4701,28,68270,68270,0,0,0,0,1.0,1,1.0,1,1.0,1,0.3805688962011855,60
4702,19,68289,68289,0,0,0,0,1.0,1,1.0,1,1.0,1,0.31575716443671714,61
4703,21,68310,68310,0,0,0,0,1.0,1,1.0,1,1.0,1,0.3797787651587899,59
4704,15,68325,68325,0,0,0,0,1.0,1,1.0,1,1.0,1,0.41205126309156853,58
4705,24,68349,68349,0,0,0,0,1.0,1,1.0,1,1.0,1,0.39983051855021184,58
4706,27,68376,68376,0,0,0,0,1.0,1,1.0,1,1.0,1,0.3524270865407856,60
4707,19,68395,68395,0,0,0,0,1.0,1,1.0,1,1.0,1,0.4086927123734008,57
4708,23,68418,68418,0,0,0,0,1.0,1,1.0,1,1.0,1,0.2931251302993426,57
4709,15,68433,68433,0,0,0,0,1.0,1,1.0,1,1.0,1,0.4403286157408692,55
4710,22,68455,68455,0,0,0,0,1.0,1,1.0,1,1.0,1,0.32708256088414356,53
4711,23,68478,68478,0,0,0,0,1.0,1,1.0,1,1.0,1,0.4525371082390462,52
4712,11,68489,68489,0,0,0,0,1.0,1,1.0,1,1.0,1,0.4934491936181653,52
4713,29,68518,68518,0,0,0,0,1.0,1,1.0,1,1.0,1,0.43592767707600644,51
4714,10,68528,68528,0,0,0,0,1.0,1,1.0,1,1.0,1,0.43972841347821534,50
4715,27,68555,68555,0,0,0,0,1.0,1,1.0,1,1.0,1,0.4376492066672253,50
4716,14,68569,68569,0,0,0,0,1.0,1,1.0,1,1.0,1,0.4763529560564787,49
4717,10,68579,68579,0,0,0,0,1.0,1,1.0,1,1.0,1,0.37179898615708934,49
4718,11,68590,68590,0,0,0,0,1.0,1,1.0,1,1.0,1,0.39859031650914983,50
4719,14,68604,68604,0,0,0,0,1.0,1,1.0,1,1.0,1,0.4183948272636642,49
4720,11,68615,68615,0,0,0,0,1.0,1,1.0,1,1.0,1,0.3639598532585031,49
4721,14,68629,68629,0,0,0,0,1.0,1,1.0,1,1.0,1,0.37904123381050525,50
4722,30,68659,68659,0,0,0,0,1.0,1,1.0,1,1.0,1,0.392554416735814,51
4723,9,68668,68668,0,0,0,0,1.0,1,1.0,1,1.0,1,0.3960321614384847,50
4724,20,68688,68688,0,0,0,0,1.0,1,1.0,1,1.0,1,0.43623697640606296,50
4725,16,68704,68704,0,0,0,0,1.0,1,1.0,1,1.0,1,0.46927883676794735,52
4726,21,68725,68725,0,0,0,0,1.0,1,1.0,1,1.0,1,0.4689192869196261,51
4727,19,68744,68744,0,0,0,0,1.0,1,1.0,1,1.0,1,0.41706869344172764,52
4728,10,68754,68754,0,0,0,0,1.0,1,1.0,1,1.0,1,0.3425069323250764,52
4729,17,68771,68771,0,0,0,0,1.0,1,1.0,1,1.0,1,0.38165715320475574,52
4730,21,68792,68792,0,0,0,0,1.0,1,1.0,1,1.0,1,0.3232170122293364,50
4731,17,68809,68809,0,0,0,0,1.0,1,1.0,1,1.0,1,0.3957349604592125,51
4732,15,68824,68824,0,0,0,0,1.0,1,1.0,1,1.0,1,0.38255225319169045,52
4733,18,68842,68842,0,0,0,0,1.0,1,1.0,1,1.0,1,0.4442749797717708,53
4734,24,68866,68866,0,0,0,0,1.0,1,1.0,1,1.0,1,0.4085877187265057,53
4735,14,68880,68880,0,0,0,0,1.0,1,1.0,1,1.0,1,0.4212208978232371,53
4736,19,68899,68899,0,0,0,0,1.0,1,1.0,1,1.0,1,0.40208491723186335,55
4737,27,68926,68926,0,0,0,0,1.0,1,1.0,1,1.0,1,0.4574858159152445,57
4738,29,68955,68955,0,0,0,0,1.0,1,1.0,1,1.0,1,0.330620094464884,57
4739,16,68971,68971,0,0,0,0,1.0,1,1.0,1,1.0,1,0.47813586341037073,57
4740,12,68983,68983,0,0,0,0,1.0,1,1.0,1,1.0,1,0.43485352305543795,57
4741,22,69005,69005,0,0,0,0,1.0,1,1.0,1,1.0,1,0.3951896078585613,58
4742,20,69025,69025,0,0,0,0,1.0,1,1.0,1,1.0,1,0.3687544500836983,58
4743,25,69050,69050,0,0,0,0,1.0,1,1.0,1,1.0,1,0.5359879120705527,56
4744,16,69066,69066,0,0,0,0,1.0,1,1.0,1,1.0,1,0.49026382628763454,57
4745,20,69086,69086,0,0,0,0,1.0,1,1.0,1,1.0,1,0.4336471102254877,56
4746,26,69112,69112,0,0,0,0,1.0,1,1.0,1,1.0,1,0.45281283041151854,56
4747,22,69134,69134,0,0,0,0,1.0,1,1.0,1,1.0,1,0.3995285414920877,55
4748,15,69149,69149,0,0,0,0,1.0,1,1.0,1,1.0,1,0.41754910878477264,55
4749,9,69158,69158,0,0,0,0,1.0,1,1.0,1,1.0,1,0.3107680969639496,54
4750,12,69170,69170,0,0,0,0,1.0,1,1.0,1,1.0,1,0.36957557718093653,53
4751,14,69184,69184,0,0,0,0,1.0,1,1.0,1,1.0,1,0.47998747779268724,53
4752,11,69195,69195,0,0,0,0,1.0,1,1.0,1,1.0,1,0.43803259062236155,53
4753,12,69207,69207,0,0,0,0,1.0,1,1.0,1,1.0,1,0.5439451987959207,52
4754,21,69228,69228,0,0,0,0,1.0,1,1.0,1,1.0,1,0.3913013291361451,52
4755,21,69249,69249,0,0,0,0,1.0,1,1.0,1,1.0,1,0.4364866075955371,51
4756,19,69268,69268,0,0,0,0,1.0,1,1.0,1,1.0,1,0.4429418538801841,52
4757,18,69286,69286,0,0,0,0,1.0,1,1.0,1,1.0,1,0.478253771953489,51
4758,18,69304,69304,0,0,0,0,1.0,1,1.0,1,1.0,1,0.4545689103975153,51
4759,17,69321,69321,0,0,0,0,1.0,1,1.0,1,1.0,1,0.31521712188358014,51
4760,21,69342,69342,0,0,0,0,1.0,1,1.0,1,1.0,1,0.28870959464049806,52
4761,23,69365,69365,0,0,0,0,1.0,1,1.0,1,1.0,1,0.33509288688647115,50
4762,14,69379,69379,0,0,0,0,1.0,1,1.0,1,1.0,1,0.26814500848499484,51
4763,15,69394,69394,0,0,0,0,1.0,1,1.0,1,1.0,1,0.27670473969589465,51
4764,15,69409,69409,0,0,0,0,1.0,1,1.0,1,1.0,1,0.2933021412107435,53
4765,14,69423,69423,0,0,0,0,1.0,1,1.0,1,1.0,1,0.345966622646768,53
4766,14,69437,69437,0,0,0,0,1.0,1,1.0,1,1.0,1,0.3475633207457905,55
4767,17,69454,69454,0,0,0,0,1.0,1,1.0,1,1.0,1,0.24388437873948812,56
4768,20,69474,69474,0,0,0,0,1.0,1,1.0,1,1.0,1,0.3274448237837022,56
4769,19,69493,69493,0,0,0,0,1.0,1,1.0,1,1.0,1,0.2869863921754153,56
4770,13,69506,69506,0,0,0,0,1.0,1,1.0,1,1.0,1,0.3924035918411635,56
4771,10,69516,69516,0,0,0,0,1.0,1,1.0,1,1.0,1,0.44018341680271156,55
4772,17,69533,69533,0,0,0,0,1.0,1,1.0,1,1.0,1,0.37677344602039947,56
4773,14,69547,69547,0,0,0,0,1.0,1,1.0,1,1.0,1,0.4478238170069688,56
4774,13,69560,69560,0,0,0,0,1.0,1,1.0,1,1.0,1,0.3312165557844786,58
4775,18,69578,69578,0,0,0,0,1.0,1,1.0,1,1.0,1,0.36670502801089405,59
4776,25,69603,69603,0,0,0,0,1.0,1,1.0,1,1.0,1,0.4022248859128809,59
4777,20,69623,69623,0,0,0,0,1.0,1,1.0,1,1.0,1,0.38875823432987006,60
4778,16,69639,69639,0,0,0,0,1.0,1,1.0,1,1.0,1,0.35280717676751605,60
4779,15,69654,69654,0,0,0,0,1.0,1,1.0,1,1.0,1,0.4095765829154072,61
4780,14,69668,69668,0,0,0,0,1.0,1,1.0,1,1.0,1,0.3188239453397794,63
4781,14,69682,69682,0,0,0,0,1.0,1,1.0,1,1.0,1,0.26386729315121243,62
4782,13,69695,69695,0,0,0,0,1.0,1,1.0,1,1.0,1,0.31212934738062603,63
4783,13,69708,69708,0,0,0,0,1.0,1,1.0,1,1.0,1,0.23778730274060503,62
4784,17,69725,69725,0,0,0,0,1.0,1,1.0,1,1.0,1,0.18628828635152278,62
4785,19,69744,69744,0,0,0,0,1.0,1,1.0,1,1.0,1,0.1782265028097461,62
4786,25,69769,69769,0,0,0,0,1.0,1,1.0,1,1.0,1,0.20455323458910338,63
4787,20,69789,69789,0,0,0,0,1.0,1,1.0,1,1.0,1,0.15607495398975496,62
4788,14,69803,69803,0,0,0,0,1.0,1,1.0,1,1.0,1,0.17857622853353128,62
4789,24,69827,69827,0,0,0,0,1.0,1,1.0,1,1.0,1,0.11557756464290511,60
4790,19,69846,69846,0,0,0,0,1.0,1,1.0,1,1.0,1,0.1363309768882307,61
4791,13,69859,69859,0,0,0,0,1.0,1,1.0,1,1.0,1,0.1631929812968458,60
4792,10,69869,69869,0,0,0,0,1.0,1,1.0,1,1.0,1,0.13896759116547003,60
4793,9,69878,69878,0,0,0,0,1.0,1,1.0,1,1.0,1,0.19096967050329425,61
4794,9,69887,69887,0,0,0,0,1.0,1,1.0,1,1.0,1,0.26530201961881444,59
4795,13,69900,69900,0,0,0,0,1.0,1,1.0,1,1.0,1,0.2666415624729852,61
4796,11,69911,69911,0,0,0,0,1.0,1,1.0,1,1.0,1,0.25079461746791154,59
4797,13,69924,69924,0,0,0,0,1.0,1,1.0,1,1.0,1,0.26023652991898644,58
4798,8,69932,69932,0,0,0,0,1.0,1,1.0,1,1.0,1,0.27937171328115734,59
4799,9,69941,69941,0,0,0,0,1.0,1,1.0,1,1.0,1,0.3240714178153104,57
4800,11,69952,69952,0,0,0,0,1.0,1,1.0,1,1.0,1,0.3381994980875387,58
4801,17,69969,69969,0,0,0,0,1.0,1,1.0,1,1.0,1,0.3097052408282732,57
4802,10,69979,69979,0,0,0,0,1.0,1,1.0,1,1.0,1,0.3586165422511625,57
4803,12,69991,69991,0,0,0,0,1.0,1,1.0,1,1.0,1,0.28397701252294416,56
4804,20,70011,70011,0,0,0,0,1.0,1,1.0,1,1.0,1,0.28389827684929786,54
4805,14,70025,70025,0,0,0,0,1.0,1,1.0,1,1.0,1,0.32298617913877775,56
4806,12,70037,70037,0,0,0,0,1.0,1,1.0,1,1.0,1,0.34409016344368276,55
4807,23,70060,70060,0,0,0,0,1.0,1,1.0,1,1.0,1,0.3224059781572338,54
4808,16,70076,70076,0,0,0,0,1.0,1,1.0,1,1.0,1,0.3238691338364001,53
4809,19,70095,70095,0,0,0,0,1.0,1,1.0,1,1.0,1,0.32230400129998465,53
4810,18,70113,70113,0,0,0,0,1.0,1,1.0,1,1.0,1,0.3257573249601443,51
4811,20,70133,70133,0,0,0,0,1.0,1,1.0,1,1.0,1,0.34024311375430377,52
4812,19,70152,70152,0,0,0,0,1.0,1,1.0,1,1.0,1,0.3077538512200303,52
4813,15,70167,70167,0,0,0,0,1.0,1,1.0,1,1.0,1,0.2523036598190977,52
4814,15,70182,70182,0,0,0,0,1.0,1,1.0,1,1.0,1,0.2461063719597083,53
4815,12,70194,70194,0,0,0,0,1.0,1,1.0,1,1.0,1,0.27271707055474814,54
4816,17,70211,70211,0,0,0,0,1.0,1,1.0,1,1.0,1,0.23730423401395634,54
4817,12,70223,70223,0,0,0,0,1.0,1,1.0,1,1.0,1,0.22591867051552622,55
4818,10,70233,70233,0,0,0,0,1.0,1,1.0,1,1.0,1,0.2911181903150736,55
4819,10,70243,70243,0,0,0,0,1.0,1,1.0,1,1.0,1,0.261595520969804,55
4820,11,70254,70254,0,0,0,0,1.0,1,1.0,1,1.0,1,0.30174460078613374,55
4821,12,70266,70266,0,0,0,0,1.0,1,1.0,1,1.0,1,0.4009249537931021,55
4822,10,70276,70276,0,0,0,0,1.0,1,1.0,1,1.0,1,0.39857160382418694,54
4823,8,70284,70284,0,0,0,0,1.0,1,1.0,1,1.0,1,0.3585708396914694,54
4824,8,70292,70292,0,0,0,0,1.0,1,1.0,1,1.0,1,0.39015961489941703,55
4825,7,70299,70299,0,0,0,0,1.0,1,1.0,1,1.0,1,0.39474452442835234,53
4826,9,70308,70308,0,0,0,0,1.0,1,1.0,1,1.0,1,0.31497106089260246,54
4827,14,70322,70322,0,0,0,0,1.0,1,1.0,1,1.0,1,0.46136425501348227,53
4828,12,70334,70334,0,0,0,0,1.0,1,1.0,1,1.0,1,0.3843636481811466,54
4829,8,70342,70342,0,0,0,0,1.0,1,1.0,1,1.0,1,0.37295401171062986,54
4830,11,70353,70353,0,0,0,0,1.0,1,1.0,1,1.0,1,0.3479983820349356,53
4831,8,70361,70361,0,0,0,0,1.0,1,1.0,1,1.0,1,0.36608898044669436,52
4832,6,70367,70367,0,0,0,0,1.0,1,1.0,1,1.0,1,0.3520217220155533,50
4833,9,70376,70376,0,0,0,0,1.0,1,1.0,1,1.0,1,0.4375327576983579,51
4834,10,70386,70386,0,0,0,0,1.0,1,1.0,1,1.0,1,0.3790603954360196,51
4835,16,70402,70402,0,0,0,0,1.0,1,1.0,1,1.0,1,0.3280138315881804,50
4836,13,70415,70415,0,0,0,0,1.0,1,1.0,1,1.0,1,0.3217396658977534,50
4837,20,70435,70435,0,0,0,0,1.0,1,1.0,1,1.0,1,0.2847647646924993,46
4838,23,70458,70458,0,0,0,0,1.0,1,1.0,1,1.0,1,0.25859466654250207,47
4839,13,70471,70471,0,0,0,0,1.0,1,1.0,1,1.0,1,0.33921648170736945,45
4840,18,70489,70489,0,0,0,0,1.0,1,1.0,1,1.0,1,0.3751358454223612,45
4841,9,70498,70498,0,0,0,0,1.0,1,1.0,1,1.0,1,0.3827931444591562,43
4842,11,70509,70509,0,0,0,0,1.0,1,1.0,1,1.0,1,0.41543305540128533,43
4843,13,70522,70522,0,0,0,0,1.0,1,1.0,1,1.0,1,0.34785320265113123,44
4844,16,70538,70538,0,0,0,0,1.0,1,1.0,1,1.0,1,0.3326017664487267,43
4845,20,70558,70558,0,0,0,0,1.0,1,1.0,1,1.0,1,0.41293208767140976,44
4846,10,70568,70568,0,0,0,0,1.0,1,1.0,1,1.0,1,0.39356602845874084,43
4847,14,70582,70582,0,0,0,0,1.0,1,1.0,1,1.0,1,0.34142908367746294,42
4848,14,70596,70596,0,0,0,0,1.0,1,1.0,1,1.0,1,0.35671164371980624,41
4849,12,70608,70608,0,0,0,0,1.0,1,1.0,1,1.0,1,0.3538709754164737,41
4850,11,70619,70619,0,0,0,0,1.0,1,1.0,1,1.0,1,0.34560397542565985,41
4851,21,70640,70640,0,0,0,0,1.0,1,1.0,1,1.0,1,0.42897378289212784,41
4852,10,70650,70650,0,0,0,0,1.0,1,1.0,1,1.0,1,0.46619742405592923,43
4853,13,70663,70663,0,0,0,0,1.0,1,1.0,1,1.0,1,0.3995386290998049,44
4854,11,70674,70674,0,0,0,0,1.0,1,1.0,1,1.0,1,0.31970011442820717,45
4855,8,70682,70682,0,0,0,0,1.0,1,1.0,1,1.0,1,0.46478404789795996,44
4856,13,70695,70695,0,0,0,0,1.0,1,1.0,1,1.0,1,0.39670512090870946,44
4857,15,70710,70710,0,0,0,0,1.0,1,1.0,1,1.0,1,0.5244719717516807,44
4858,7,70717,70717,0,0,0,0,1.0,1,1.0,1,1.0,1,0.3869614899832535,45
4859,21,70738,70738,0,0,0,0,1.0,1,1.0,1,1.0,1,0.4983485081099904,46
4860,6,70744,70744,0,0,0,0,1.0,1,1.0,1,1.0,1,0.3805148105273043,46
4861,6,70750,70750,0,0,0,0,1.0,1,1.0,1,1.0,1,0.42888177450433906,46
4862,15,70765,70765,0,0,0,0,1.0,1,1.0,1,1.0,1,0.4236347237183458,47
4863,14,70779,70779,0,0,0,0,1.0,1,1.0,1,1.0,1,0.40506655038642414,47
4864,9,70788,70788,0,0,0,0,1.0,1,1.0,1,1.0,1,0.3586336314018598,47
4865,16,70804,70804,0,0,0,0,1.0,1,1.0,1,1.0,1,0.31737989345122053,48
4866,14,70818,70818,0,0,0,0,1.0,1,1.0,1,1.0,1,0.3448131426914228,49
4867,13,70831,70831,0,0,0,0,1.0,1,1.0,1,1.0,1,0.3309703056059007,50
4868,20,70851,70851,0,0,0,0,1.0,1,1.0,1,1.0,1,0.32461978363990374,50
4869,10,70861,70861,0,0,0,0,1.0,1,1.0,1,1.0,1,0.27804785000037696,50
4870,15,70876,70876,0,0,0,0,1.0,1,1.0,1,1.0,1,0.2800484855298404,52
4871,12,70888,70888,0,0,0,0,1.0,1,1.0,1,1.0,1,0.31333580657411486,52
4872,9,70897,70897,0,0,0,0,1.0,1,1.0,1,1.0,1,0.31293169025947287,53
4873,15,70912,70912,0,0,0,0,1.0,1,1.0,1,1.0,1,0.39735341046882044,55
4874,19,70931,70931,0,0,0,0,1.0,1,1.0,1,1.0,1,0.30805982222817047,56
4875,10,70941,70941,0,0,0,0,1.0,1,1.0,1,1.0,1,0.3226435341101888,55
4876,14,70955,70955,0,0,0,0,1.0,1,1.0,1,1.0,1,0.327416958859773,55
4877,14,70969,70969,0,0,0,0,1.0,1,1.0,1,1.0,1,0.35968424141377725,54
4878,10,70979,70979,0,0,0,0,1.0,1,1.0,1,1.0,1,0.3470527127100421,53
4879,22,71001,71001,0,0,0,0,1.0,1,1.0,1,1.0,1,0.3321766871288713,54
4880,10,71011,71011,0,0,0,0,1.0,1,1.0,1,1.0,1,0.3443914735201519,54
4881,21,71032,71032,0,0,0,0,1.0,1,1.0,1,1.0,1,0.2901568291478374,53
4882,14,71046,71046,0,0,0,0,1.0,1,1.0,1,1.0,1,0.34562026498148685,53
4883,15,71061,71061,0,0,0,0,1.0,1,1.0,1,1.0,1,0.3468233496020256,53
4884,11,71072,71072,0,0,0,0,1.0,1,1.0,1,1.0,1,0.39278506628043525,51
4885,9,71081,71081,0,0,0,0,1.0,1,1.0,1,1.0,1,0.35771445703117766,50
4886,15,71096,71096,0,0,0,0,1.0,1,1.0,1,1.0,1,0.42560234784121376,48
4887,5,71101,71101,0,0,0,0,1.0,1,1.0,1,1.0,1,0.4197741778423923,48
4888,11,71112,71112,0,0,0,0,1.0,1,1.0,1,1.0,1,0.40238365612909255,48
4889,8,71120,71120,0,0,0,0,1.0,1,1.0,1,1.0,1,0.3016630454663605,48
4890,10,71130,71130,0,0,0,0,1.0,1,1.0,1,1.0,1,0.4147528656734483,49
4891,13,71143,71143,0,0,0,0,1.0,1,1.0,1,1.0,1,0.34081638023698935,50
4892,8,71151,71151,0,0,0,0,1.0,1,1.0,1,1.0,1,0.2333840591315612,49
4893,22,71173,71173,0,0,0,0,1.0,1,1.0,1,1.0,1,0.3867001859896139,50
4894,13,71186,71186,0,0,0,0,1.0,1,1.0,1,1.0,1,0.24184305607123732,51
4895,19,71205,71205,0,0,0,0,1.0,1,1.0,1,1.0,1,0.2883972843924383,52
4896,26,71231,71231,0,0,0,0,1.0,1,1.0,1,1.0,1,0.25177705060596217,53
4897,10,71241,71241,0,0,0,0,1.0,1,1.0,1,1.0,1,0.2679494684287276,53
4898,29,71270,71270,0,0,0,0,1.0,1,1.0,1,1.0,1,0.2929310357660286,53
4899,18,71288,71288,0,0,0,0,1.0,1,1.0,1,1.0,1,0.18616088491292326,55
4900,15,71303,71303,0,0,0,0,1.0,1,1.0,1,1.0,1,0.297770321666295,55
4901,17,71320,71320,0,0,0,0,1.0,1,1.0,1,1.0,1,0.328780454843951,56
4902,26,71346,71346,0,0,0,0,1.0,1,1.0,1,1.0,1,0.24193210228448397,58
4903,33,71379,71379,0,0,0,0,1.0,1,1.0,1,1.0,1,0.33633978591337443,58
4904,22,71401,71401,0,0,0,0,1.0,1,1.0,1,1.0,1,0.3074521112157977,57
4905,18,71419,71419,0,0,0,0,1.0,1,1.0,1,1.0,1,0.3014290342923171,54
4906,13,71432,71432,0,0,0,0,1.0,1,1.0,1,1.0,1,0.3852414868719521,55
4907,21,71453,71453,0,0,0,0,1.0,1,1.0,1,1.0,1,0.40580468212306214,52
4908,22,71475,71475,0,0,0,0,1.0,1,1.0,1,1.0,1,0.39223098831065134,53
4909,12,71487,71487,0,0,0,0,1.0,1,1.0,1,1.0,1,0.39314593424336036,52
4910,21,71508,71508,0,0,0,0,1.0,1,1.0,1,1.0,1,0.4404565014357299,53
4911,19,71527,71527,0,0,0,0,1.0,1,1.0,1,1.0,1,0.46521853079469605,55
4912,15,71542,71542,0,0,0,0,1.0,1,1.0,1,1.0,1,0.4558641181277605,54
4913,23,71565,71565,0,0,0,0,1.0,1,1.0,1,1.0,1,0.3989806986874669,53
4914,23,71588,71588,0,0,0,0,1.0,1,1.0,1,1.0,1,0.407394855511819,53
4915,24,71612,71612,0,0,0,0,1.0,1,1.0,1,1.0,1,0.33865124252845147,54
4916,20,71632,71632,0,0,0,0,1.0,1,1.0,1,1.0,1,0.34819720944944055,52
4917,18,71650,71650,0,0,0,0,1.0,1,1.0,1,1.0,1,0.32548061877295614,52
4918,14,71664,71664,0,0,0,0,1.0,1,1.0,1,1.0,1,0.3715977946217936,51
4919,16,71680,71680,0,0,0,0,1.0,1,1.0,1,1.0,1,0.3991720360452181,50
4920,17,71697,71697,0,0,0,0,1.0,1,1.0,1,1.0,1,0.32128997602331016,51
4921,11,71708,71708,0,0,0,0,1.0,1,1.0,1,1.0,1,0.2718159090770766,51
4922,19,71727,71727,0,0,0,0,1.0,1,1.0,1,1.0,1,0.23169519654370582,53
4923,21,71748,71748,0,0,0,0,1.0,1,1.0,1,1.0,1,0.3464920239789466,53
4924,14,71762,71762,0,0,0,0,1.0,1,1.0,1,1.0,1,0.29525040716737044,55
4925,23,71785,71785,0,0,0,0,1.0,1,1.0,1,1.0,1,0.25933333045117307,56
4926,16,71801,71801,0,0,0,0,1.0,1,1.0,1,1.0,1,0.23742531424680444,55
4927,11,71812,71812,0,0,0,0,1.0,1,1.0,1,1.0,1,0.3192161641912803,55
4928,13,71825,71825,0,0,0,0,1.0,1,1.0,1,1.0,1,0.26492618317135785,55
4929,15,71840,71840,0,0,0,0,1.0,1,1.0,1,1.0,1,0.19163257596376254,56
4930,13,71853,71853,0,0,0,0,1.0,1,1.0,1,1.0,1,0.26936273317936116,58
4931,15,71868,71868,0,0,0,0,1.0,1,1.0,1,1.0,1,0.2711994919331176,59
4932,17,71885,71885,0,0,0,0,1.0,1,1.0,1,1.0,1,0.30344706381845427,60
4933,11,71896,71896,0,0,0,0,1.0,1,1.0,1,1.0,1,0.24984115152335468,60
4934,10,71906,71906,0,0,0,0,1.0,1,1.0,1,1.0,1,0.2937006480856639,60
4935,11,71917,71917,0,0,0,0,1.0,1,1.0,1,1.0,1,0.2881335589800151,60
4936,17,71934,71934,0,0,0,0,1.0,1,1.0,1,1.0,1,0.316131044938379,61
4937,15,71949,71949,0,0,0,0,1.0,1,1.0,1,1.0,1,0.40275083907941506,62
4938,14,71963,71963,0,0,0,0,1.0,1,1.0,1,1.0,1,0.33558595454125284,62
4939,13,71976,71976,0,0,0,0,1.0,1,1.0,1,1.0,1,0.37394543363676036,64
4940,13,71989,71989,0,0,0,0,1.0,1,1.0,1,1.0,1,0.40109978797852025,67
4941,16,72005,72005,0,0,0,0,1.0,1,1.0,1,1.0,1,0.3986076962303766,66
4942,13,72018,72018,0,0,0,0,1.0,1,1.0,1,1.0,1,0.349104889453007,67
4943,20,72038,72038,0,0,0,0,1.0,1,1.0,1,1.0,1,0.355766547265348,65
4944,17,72055,72055,0,0,0,0,1.0,1,1.0,1,1.0,1,0.33966637589799314,65
4945,8,72063,72063,0,0,0,0,1.0,1,1.0,1,1.0,1,0.33383588099728384,62
4946,13,72076,72076,0,0,0,0,1.0,1,1.0,1,1.0,1,0.3044327351327047,61
4947,20,72096,72096,0,0,0,0,1.0,1,1.0,1,1.0,1,0.37280385350628376,59
4948,21,72117,72117,0,0,0,0,1.0,1,1.0,1,1.0,1,0.3175249704000016,59
4949,15,72132,72132,0,0,0,0,1.0,1,1.0,1,1.0,1,0.3762841389487776,57
4950,29,72161,72161,0,0,0,0,1.0,1,1.0,1,1.0,1,0.3348773060936358,58
4951,13,72174,72174,0,0,0,0,1.0,1,1.0,1,1.0,1,0.30562852261031137,55
4952,23,72197,72197,0,0,0,0,1.0,1,1.0,1,1.0,1,0.33182817548424665,53
4953,37,72234,72234,0,0,0,0,1.0,1,1.0,1,1.0,1,0.243322095023688,54
4954,19,72253,72253,0,0,0,0,1.0,1,1.0,1,1.0,1,0.32014344040920095,52
4955,25,72278,72278,0,0,0,0,1.0,1,1.0,1,1.0,1,0.2219412428631126,51
4956,17,72295,72295,0,0,0,0,1.0,1,1.0,1,1.0,1,0.2867370900717065,47
4957,19,72314,72314,0,0,0,0,1.0,1,1.0,1,1.0,1,0.3126666742549433,48
4958,13,72327,72327,0,0,0,0,1.0,1,1.0,1,1.0,1,0.2728970633846972,47
4959,17,72344,72344,0,0,0,0,1.0,1,1.0,1,1.0,1,0.2637728595770978,47
4960,15,72359,72359,0,0,0,0,1.0,1,1.0,1,1.0,1,0.3514763800486434,48
4961,15,72374,72374,0,0,0,0,1.0,1,1.0,1,1.0,1,0.3126559619683962,49
4962,16,72390,72390,0,0,0,0,1.0,1,1.0,1,1.0,1,0.4560697780830194,49
4963,13,72403,72403,0,0,0,0,1.0,1,1.0,1,1.0,1,0.4028964472740605,51
4964,23,72426,72426,0,0,0,0,1.0,1,1.0,1,1.0,1,0.46599873554680526,51
4965,19,72445,72445,0,0,0,0,1.0,1,1.0,1,1.0,1,0.4617574562615284,51
4966,24,72469,72469,0,0,0,0,1.0,1,1.0,1,1.0,1,0.2716193737831383,51
4967,8,72477,72477,0,0,0,0,1.0,1,1.0,1,1.0,1,0.3223911968285362,51
4968,12,72489,72489,0,0,0,0,1.0,1,1.0,1,1.0,1,0.246197236945215,52
4969,14,72503,72503,0,0,0,0,1.0,1,1.0,1,1.0,1,0.23722047843065178,53
4970,16,72519,72519,0,0,0,0,1.0,1,1.0,1,1.0,1,0.2578665033942899,54
4971,14,72533,72533,0,0,0,0,1.0,1,1.0,1,1.0,1,0.2406447699204686,55
4972,18,72551,72551,0,0,0,0,1.0,1,1.0,1,1.0,1,0.31947313003498723,56
4973,11,72562,72562,0,0,0,0,1.0,1,1.0,1,1.0,1,0.29449795577996346,57
4974,17,72579,72579,0,0,0,0,1.0,1,1.0,1,1.0,1,0.353197924401847,56
4975,13,72592,72592,0,0,0,0,1.0,1,1.0,1,1.0,1,0.2866857244581542,57
4976,10,72602,72602,0,0,0,0,1.0,1,1.0,1,1.0,1,0.2785168984469187,57
4977,13,72615,72615,0,0,0,0,1.0,1,1.0,1,1.0,1,0.2825648602385917,57
4978,13,72628,72628,0,0,0,0,1.0,1,1.0,1,1.0,1,0.27401337327302294,58
4979,15,72643,72643,0,0,0,0,1.0,1,1.0,1,1.0,1,0.3299596466577639,58
4980,10,72653,72653,0,0,0,0,1.0,1,1.0,1,1.0,1,0.31870388913584785,59
4981,18,72671,72671,0,0,0,0,1.0,1,1.0,1,1.0,1,0.33429682662758925,60
4982,20,72691,72691,0,0,0,0,1.0,1,1.0,1,1.0,1,0.35808725296913696,61
4983,15,72706,72706,0,0,0,0,1.0,1,1.0,1,1.0,1,0.33074433479041737,61
4984,15,72721,72721,0,0,0,0,1.0,1,1.0,1,1.0,1,0.2692155708437655,59
4985,24,72745,72745,0,0,0,0,1.0,1,1.0,1,1.0,1,0.37937054615635707,58
4986,16,72761,72761,0,0,0,0,1.0,1,1.0,1,1.0,1,0.38588402372517205,59
4987,24,72785,72785,0,0,0,0,1.0,1,1.0,1,1.0,1,0.4121878290130005,58
4988,13,72798,72798,0,0,0,0,1.0,1,1.0,1,1.0,1,0.410576308756615,57
4989,13,72811,72811,0,0,0,0,1.0,1,1.0,1,1.0,1,0.2982574840414174,54
4990,16,72827,72827,0,0,0,0,1.0,1,1.0,1,1.0,1,0.4093283000576636,53
4991,11,72838,72838,0,0,0,0,1.0,1,1.0,1,1.0,1,0.41430462626632863,52
4992,26,72864,72864,0,0,0,0,1.0,1,1.0,1,1.0,1,0.32425988701155284,48
4993,18,72882,72882,0,0,0,0,1.0,1,1.0,1,1.0,1,0.44009319664732427,48
4994,26,72908,72908,0,0,0,0,1.0,1,1.0,1,1.0,1,0.44323679621448686,45
4995,25,72933,72933,0,0,0,0,1.0,1,1.0,1,1.0,1,0.4966808903145159,45
4996,21,72954,72954,0,0,0,0,1.0,1,1.0,1,1.0,1,0.4906434723631928,45
4997,31,72985,72985,0,0,0,0,1.0,1,1.0,1,1.0,1,0.41016065836374277,42
4998,23,73008,73008,0,0,0,0,1.0,1,1.0,1,1.0,1,0.31531505188890335,44
4999,19,73027,73027,0,0,0,0,1.0,1,1.0,1,1.0,1,0.43396554388252334,44
5000,21,73048,73048,0,0,0,0,1.0,1,1.0,1,1.0,1,0.4919465911636546,42
5001,12,73060,73060,0,0,0,0,1.0,1,1.0,1,1.0,1,0.38866505360657844,42
5002,21,73081,73081,0,0,0,0,1.0,1,1.0,1,1.0,1,0.4127955208158088,41
5003,18,73099,73099,0,0,0,0,1.0,1,1.0,1,1.0,1,0.47277744406228867,41
5004,16,73115,73115,0,0,0,0,1.0,1,1.0,1,1.0,1,0.5310621878719405,41
5005,32,73147,73147,0,0,0,0,1.0,1,1.0,1,1.0,1,0.5451479910191711,41
5006,31,73178,73178,0,0,0,0,1.0,1,1.0,1,1.0,1,0.36178282617778884,42
5007,11,73189,73189,0,0,0,0,1.0,1,1.0,1,1.0,1,0.4991544383943429,43
5008,12,73201,73201,0,0,0,0,1.0,1,1.0,1,1.0,1,0.3974389534516282,46
5009,14,73215,73215,0,0,0,0,1.0,1,1.0,1,1.0,1,0.5148913748389289,46
5010,14,73229,73229,0,0,0,0,1.0,1,1.0,1,1.0,1,0.3735620253557102,46
5011,22,73251,73251,0,0,0,0,1.0,1,1.0,1,1.0,1,0.5144620806575846,47
5012,14,73265,73265,0,0,0,0,1.0,1,1.0,1,1.0,1,0.5430726598554845,48
5013,12,73277,73277,0,0,0,0,1.0,1,1.0,1,1.0,1,0.4405766582810771,48
5014,26,73303,73303,0,0,0,0,1.0,1,1.0,1,1.0,1,0.5073820324054059,49
5015,18,73321,73321,0,0,0,0,1.0,1,1.0,1,1.0,1,0.38843133018502696,50
5016,22,73343,73343,0,0,0,0,1.0,1,1.0,1,1.0,1,0.38396775997336935,51
5017,18,73361,73361,0,0,0,0,1.0,1,1.0,1,1.0,1,0.41292453278100816,51
5018,15,73376,73376,0,0,0,0,1.0,1,1.0,1,1.0,1,0.3162682798829182,51
5019,13,73389,73389,0,0,0,0,1.0,1,1.0,1,1.0,1,0.37546015388188675,51
5020,22,73411,73411,0,0,0,0,1.0,1,1.0,1,1.0,1,0.4067866706649322,51
5021,9,73420,73420,0,0,0,0,1.0,1,1.0,1,1.0,1,0.345755397248701,52
5022,9,73429,73429,0,0,0,0,1.0,1,1.0,1,1.0,1,0.4296799469194738,52
5023,13,73442,73442,0,0,0,0,1.0,1,1.0,1,1.0,1,0.32997585266060675,52
5024,12,73454,73454,0,0,0,0,1.0,1,1.0,1,1.0,1,0.40851499591060847,51
5025,16,73470,73470,0,0,0,0,1.0,1,1.0,1,1.0,1,0.3587785222251589,50
5026,21,73491,73491,0,0,0,0,1.0,1,1.0,1,1.0,1,0.40022400414836046,49
5027,18,73509,73509,0,0,0,0,1.0,1,1.0,1,1.0,1,0.3645215916608105,47
5028,12,73521,73521,0,0,0,0,1.0,1,1.0,1,1.0,1,0.38880053335722864,47
5029,26,73547,73547,0,0,0,0,1.0,1,1.0,1,1.0,1,0.3351773955875018,46
5030,18,73565,73565,0,0,0,0,1.0,1,1.0,1,1.0,1,0.4414047021937376,48
5031,17,73582,73582,0,0,0,0,1.0,1,1.0,1,1.0,1,0.3232903691872885,46
5032,18,73600,73600,0,0,0,0,1.0,1,1.0,1,1.0,1,0.4328554372811352,46
5033,23,73623,73623,0,0,0,0,1.0,1,1.0,1,1.0,1,0.4024693877866165,47
5034,15,73638,73638,0,0,0,0,1.0,1,1.0,1,1.0,1,0.41100394812798113,48
5035,21,73659,73659,0,0,0,0,1.0,1,1.0,1,1.0,1,0.47692303191131113,47
5036,12,73671,73671,0,0,0,0,1.0,1,1.0,1,1.0,1,0.5543646349232608,47
5037,18,73689,73689,0,0,0,0,1.0,1,1.0,1,1.0,1,0.4973468186404359,47
5038,25,73714,73714,0,0,0,0,1.0,1,1.0,1,1.0,1,0.39591218934922395,48
5039,9,73723,73723,0,0,0,0,1.0,1,1.0,1,1.0,1,0.4823759534724671,47
5040,10,73733,73733,0,0,0,0,1.0,1,1.0,1,1.0,1,0.5583163040009621,48
5041,20,73753,73753,0,0,0,0,1.0,1,1.0,1,1.0,1,0.40306980940705817,49
5042,19,73772,73772,0,0,0,0,1.0,1,1.0,1,1.0,1,0.49164303169160506,50
5043,27,73799,73799,0,0,0,0,1.0,1,1.0,1,1.0,1,0.35306949719266756,51
5044,21,73820,73820,0,0,0,0,1.0,1,1.0,1,1.0,1,0.44385895659132996,51
5045,19,73839,73839,0,0,0,0,1.0,1,1.0,1,1.0,1,0.30245065931802584,51
5046,29,73868,73868,0,0,0,0,1.0,1,1.0,1,1.0,1,0.3951093092438793,52
5047,8,73876,73876,0,0,0,0,1.0,1,1.0,1,1.0,1,0.37960137800757304,52
5048,24,73900,73900,0,0,0,0,1.0,1,1.0,1,1.0,1,0.4559440830477873,52
5049,12,73912,73912,0,0,0,0,1.0,1,1.0,1,1.0,1,0.45745315186235896,52
5050,12,73924,73924,0,0,0,0,1.0,1,1.0,1,1.0,1,0.43247419213857197,55
5051,26,73950,73950,0,0,0,0,1.0,1,1.0,1,1.0,1,0.4708104389063319,55
5052,17,73967,73967,0,0,0,0,1.0,1,1.0,1,1.0,1,0.4576224359813576,55
5053,31,73998,73998,0,0,0,0,1.0,1,1.0,1,1.0,1,0.39310318687271106,54
5054,12,74010,74010,0,0,0,0,1.0,1,1.0,1,1.0,1,0.42127755835552577,54
5055,14,74024,74024,0,0,0,0,1.0,1,1.0,1,1.0,1,0.4493562728365413,54
5056,16,74040,74040,0,0,0,0,1.0,1,1.0,1,1.0,1,0.43090487440282005,55
5057,20,74060,74060,0,0,0,0,1.0,1,1.0,1,1.0,1,0.2651906644008451,56
5058,39,74099,74099,0,0,0,0,1.0,1,1.0,1,1.0,1,0.42011886926497255,58
5059,28,74127,74127,0,0,0,0,1.0,1,1.0,1,1.0,1,0.29978151411643017,58
5060,17,74144,74144,0,0,0,0,1.0,1,1.0,1,1.0,1,0.34594605512918003,59
5061,22,74166,74166,0,0,0,0,1.0,1,1.0,1,1.0,1,0.3796774819190761,58
5062,27,74193,74193,0,0,0,0,1.0,1,1.0,1,1.0,1,0.31416262492147795,58
5063,20,74213,74213,0,0,0,0,1.0,1,1.0,1,1.0,1,0.36543434309992456,57
5064,26,74239,74239,0,0,0,0,1.0,1,1.0,1,1.0,1,0.3588737830005201,57
5065,15,74254,74254,0,0,0,0,1.0,1,1.0,1,1.0,1,0.452595292391747,56
5066,16,74270,74270,0,0,0,0,1.0,1,1.0,1,1.0,1,0.5103905962328472,55
5067,20,74290,74290,0,0,0,0,1.0,1,1.0,1,1.0,1,0.5223044778128693,54
5068,15,74305,74305,0,0,0,0,1.0,1,1.0,1,1.0,1,0.5383516640029273,54
5069,12,74317,74317,0,0,0,0,1.0,1,1.0,1,1.0,1,0.5193266219642928,53
5070,23,74340,74340,0,0,0,0,1.0,1,1.0,1,1.0,1,0.43072187924288,53
5071,10,74350,74350,0,0,0,0,1.0,1,1.0,1,1.0,1,0.34185078493922233,53
5072,15,74365,74365,0,0,0,0,1.0,1,1.0,1,1.0,1,0.48244227124065836,53
5073,11,74376,74376,0,0,0,0,1.0,1,1.0,1,1.0,1,0.5262864969435369,53
5074,7,74383,74383,0,0,0,0,1.0,1,1.0,1,1.0,1,0.4108629013267748,52
5075,17,74400,74400,0,0,0,0,1.0,1,1.0,1,1.0,1,0.4950889272057228,52
5076,10,74410,74410,0,0,0,0,1.0,1,1.0,1,1.0,1,0.3742966939219465,55
5077,14,74424,74424,0,0,0,0,1.0,1,1.0,1,1.0,1,0.4438979832080376,55
5078,11,74435,74435,0,0,0,0,1.0,1,1.0,1,1.0,1,0.415288717130415,55
5079,14,74449,74449,0,0,0,0,1.0,1,1.0,1,1.0,1,0.41921206454141735,54
5080,6,74455,74455,0,0,0,0,1.0,1,1.0,1,1.0,1,0.4317597853647462,55
5081,9,74464,74464,0,0,0,0,1.0,1,1.0,1,1.0,1,0.4637086497381971,57
5082,17,74481,74481,0,0,0,0,1.0,1,1.0,1,1.0,1,0.36719332683341144,57
5083,15,74496,74496,0,0,0,0,1.0,1,1.0,1,1.0,1,0.3318129724680947,58
5084,22,74518,74518,0,0,0,0,1.0,1,1.0,1,1.0,1,0.4130922093823331,58
5085,23,74541,74541,0,0,0,0,1.0,1,1.0,1,1.0,1,0.21821074258716427,59
5086,18,74559,74559,0,0,0,0,1.0,1,1.0,1,1.0,1,0.23530770635158374,60
5087,34,74593,74593,0,0,0,0,1.0,1,1.0,1,1.0,1,0.30852761788990946,61
5088,35,74628,74628,0,0,0,0,1.0,1,1.0,1,1.0,1,0.34251075685100896,62
5089,18,74646,74646,0,0,0,0,1.0,1,1.0,1,1.0,1,0.4272941894976209,63
5090,34,74680,74680,0,0,0,0,1.0,1,1.0,1,1.0,1,0.31339956486871257,63
5091,23,74703,74703,0,0,0,0,1.0,1,1.0,1,1.0,1,0.3628109715681737,63
5092,18,74721,74721,0,0,0,0,1.0,1,1.0,1,1.0,1,0.39711936421963795,63
5093,16,74737,74737,0,0,0,0,1.0,1,1.0,1,1.0,1,0.2822228402289209,63
5094,19,74756,74756,0,0,0,0,1.0,1,1.0,1,1.0,1,0.3443691369868049,64
5095,18,74774,74774,0,0,0,0,1.0,1,1.0,1,1.0,1,0.2972978045002753,64
5096,24,74798,74798,0,0,0,0,1.0,1,1.0,1,1.0,1,0.3668732189482737,67
5097,17,74815,74815,0,0,0,0,1.0,1,1.0,1,1.0,1,0.41223936148720963,67
5098,24,74839,74839,0,0,0,0,1.0,1,1.0,1,1.0,1,0.39675097360643236,68
5099,19,74858,74858,0,0,0,0,1.0,1,1.0,1,1.0,1,0.3445413053140189,70
5100,13,74871,74871,0,0,0,0,1.0,1,1.0,1,1.0,1,0.40936418491546067,71
5101,11,74882,74882,0,0,0,0,1.0,1,1.0,1,1.0,1,0.35325368122879514,71
5102,10,74892,74892,0,0,0,0,1.0,1,1.0,1,1.0,1,0.3639796350811426,70
5103,6,74898,74898,0,0,0,0,1.0,1,1.0,1,1.0,1,0.3901393110941955,67
5104,19,74917,74917,0,0,0,0,1.0,1,1.0,1,1.0,1,0.36978903954949777,67
5105,8,74925,74925,0,0,0,0,1.0,1,1.0,1,1.0,1,0.349864136891922,63
5106,15,74940,74940,0,0,0,0,1.0,1,1.0,1,1.0,1,0.36322862515579485,63
5107,12,74952,74952,0,0,0,0,1.0,1,1.0,1,1.0,1,0.33463186772428805,60
5108,15,74967,74967,0,0,0,0,1.0,1,1.0,1,1.0,1,0.3723358593434861,56
5109,14,74981,74981,0,0,0,0,1.0,1,1.0,1,1.0,1,0.402986583249936,56
5110,11,74992,74992,0,0,0,0,1.0,1,1.0,1,1.0,1,0.298033237458922,52
5111,15,75007,75007,0,0,0,0,1.0,1,1.0,1,1.0,1,0.48146153801358527,51
5112,7,75014,75014,0,0,0,0,1.0,1,1.0,1,1.0,1,0.37220834712066647,50
5113,17,75031,75031,0,0,0,0,1.0,1,1.0,1,1.0,1,0.41194883061204673,48
5114,13,75044,75044,0,0,0,0,1.0,1,1.0,1,1.0,1,0.30444101443938026,46
5115,11,75055,75055,0,0,0,0,1.0,1,1.0,1,1.0,1,0.4411859754833672,44
5116,24,75079,75079,0,0,0,0,1.0,1,1.0,1,1.0,1,0.33845463529211334,44
5117,15,75094,75094,0,0,0,0,1.0,1,1.0,1,1.0,1,0.4463513233762678,46
5118,18,75112,75112,0,0,0,0,1.0,1,1.0,1,1.0,1,0.4397455675884727,46
5119,19,75131,75131,0,0,0,0,1.0,1,1.0,1,1.0,1,0.2918657837777137,46
5120,18,75149,75149,0,0,0,0,1.0,1,1.0,1,1.0,1,0.35391234202020944,46
5121,15,75164,75164,0,0,0,0,1.0,1,1.0,1,1.0,1,0.23828861348355646,46
5122,15,75179,75179,0,0,0,0,1.0,1,1.0,1,1.0,1,0.293551070314785,46
5123,18,75197,75197,0,0,0,0,1.0,1,1.0,1,1.0,1,0.2804669601168623,45
5124,15,75212,75212,0,0,0,0,1.0,1,1.0,1,1.0,1,0.2191593365511801,47
5125,23,75235,75235,0,0,0,0,1.0,1,1.0,1,1.0,1,0.26936936218068025,50
5126,14,75249,75249,0,0,0,0,1.0,1,1.0,1,1.0,1,0.29791003787671155,50
5127,24,75273,75273,0,0,0,0,1.0,1,1.0,1,1.0,1,0.28800169547021104,52
5128,18,75291,75291,0,0,0,0,1.0,1,1.0,1,1.0,1,0.28223631569896834,53
5129,21,75312,75312,0,0,0,0,1.0,1,1.0,1,1.0,1,0.35008557891506337,55
5130,16,75328,75328,0,0,0,0,1.0,1,1.0,1,1.0,1,0.21917142499490413,55
5131,10,75338,75338,0,0,0,0,1.0,1,1.0,1,1.0,1,0.3192288220773321,54
5132,11,75349,75349,0,0,0,0,1.0,1,1.0,1,1.0,1,0.30152441280745657,54
5133,12,75361,75361,0,0,0,0,1.0,1,1.0,1,1.0,1,0.3274586968551848,54
5134,11,75372,75372,0,0,0,0,1.0,1,1.0,1,1.0,1,0.28646811100590547,53
5135,16,75388,75388,0,0,0,0,1.0,1,1.0,1,1.0,1,0.28591288209845167,54
5136,18,75406,75406,0,0,0,0,1.0,1,1.0,1,1.0,1,0.33993250098443845,54
5137,11,75417,75417,0,0,0,0,1.0,1,1.0,1,1.0,1,0.29668044077582206,54
5138,11,75428,75428,0,0,0,0,1.0,1,1.0,1,1.0,1,0.39631810035146303,54
5139,7,75435,75435,0,0,0,0,1.0,1,1.0,1,1.0,1,0.4178849835735566,55
5140,18,75453,75453,0,0,0,0,1.0,1,1.0,1,1.0,1,0.35826779537759357,55
5141,16,75469,75469,0,0,0,0,1.0,1,1.0,1,1.0,1,0.3633622738174986,53
5142,13,75482,75482,0,0,0,0,1.0,1,1.0,1,1.0,1,0.35899051000775034,54
5143,14,75496,75496,0,0,0,0,1.0,1,1.0,1,1.0,1,0.30158295755075754,52
5144,8,75504,75504,0,0,0,0,1.0,1,1.0,1,1.0,1,0.363281617485527,50
5145,14,75518,75518,0,0,0,0,1.0,1,1.0,1,1.0,1,0.3780558729013296,49
5146,14,75532,75532,0,0,0,0,1.0,1,1.0,1,1.0,1,0.31077118716095115,49
5147,19,75551,75551,0,0,0,0,1.0,1,1.0,1,1.0,1,0.4335296964938546,46
5148,14,75565,75565,0,0,0,0,1.0,1,1.0,1,1.0,1,0.3591262226352949,46
5149,8,75573,75573,0,0,0,0,1.0,1,1.0,1,1.0,1,0.34657108406528125,45
5150,15,75588,75588,0,0,0,0,1.0,1,1.0,1,1.0,1,0.3298428948876963,47
5151,21,75609,75609,0,0,0,0,1.0,1,1.0,1,1.0,1,0.2088683057269929,46
5152,15,75624,75624,0,0,0,0,1.0,1,1.0,1,1.0,1,0.32892139842594587,46
5153,15,75639,75639,0,0,0,0,1.0,1,1.0,1,1.0,1,0.36380261830504496,45
5154,23,75662,75662,0,0,0,0,1.0,1,1.0,1,1.0,1,0.28996834148794853,47
5155,17,75679,75679,0,0,0,0,1.0,1,1.0,1,1.0,1,0.4161581296480914,47
5156,16,75695,75695,0,0,0,0,1.0,1,1.0,1,1.0,1,0.3716955254350446,47
5157,30,75725,75725,0,0,0,0,1.0,1,1.0,1,1.0,1,0.34278954763590763,46
5158,29,75754,75754,0,0,0,0,1.0,1,1.0,1,1.0,1,0.2281297438932754,47
5159,20,75774,75774,0,0,0,0,1.0,1,1.0,1,1.0,1,0.295938475516227,49
5160,15,75789,75789,0,0,0,0,1.0,1,1.0,1,1.0,1,0.3854334203705244,48
5161,20,75809,75809,0,0,0,0,1.0,1,1.0,1,1.0,1,0.2355812848778935,48
5162,16,75825,75825,0,0,0,0,1.0,1,1.0,1,1.0,1,0.4161577736052651,49
5163,21,75846,75846,0,0,0,0,1.0,1,1.0,1,1.0,1,0.3398521849939099,51
5164,22,75868,75868,0,0,0,0,1.0,1,1.0,1,1.0,1,0.4382039546287635,51
5165,24,75892,75892,0,0,0,0,1.0,1,1.0,1,1.0,1,0.37146684326013624,52
5166,24,75916,75916,0,0,0,0,1.0,1,1.0,1,1.0,1,0.3857246637609254,52
5167,21,75937,75937,0,0,0,0,1.0,1,1.0,1,1.0,1,0.3234069374444712,52
5168,21,75958,75958,0,0,0,0,1.0,1,1.0,1,1.0,1,0.16981635340635443,52
5169,17,75975,75975,0,0,0,0,1.0,1,1.0,1,1.0,1,0.3925966710633408,53
5170,14,75989,75989,0,0,0,0,1.0,1,1.0,1,1.0,1,0.31175971588302864,53
5171,7,75996,75996,0,0,0,0,1.0,1,1.0,1,1.0,1,0.25139801975350196,52
5172,9,76005,76005,0,0,0,0,1.0,1,1.0,1,1.0,1,0.2807960634105598,53
5173,9,76014,76014,0,0,0,0,1.0,1,1.0,1,1.0,1,0.26864280648908384,54
5174,11,76025,76025,0,0,0,0,1.0,1,1.0,1,1.0,1,0.34880177973744747,56
5175,18,76043,76043,0,0,0,0,1.0,1,1.0,1,1.0,1,0.255623088415941,58
5176,14,76057,76057,0,0,0,0,1.0,1,1.0,1,1.0,1,0.2894586331348443,58
5177,18,76075,76075,0,0,0,0,1.0,1,1.0,1,1.0,1,0.2722875842584829,59
5178,18,76093,76093,0,0,0,0,1.0,1,1.0,1,1.0,1,0.2585248122510936,57
5179,10,76103,76103,0,0,0,0,1.0,1,1.0,1,1.0,1,0.26653081571273896,58
5180,14,76117,76117,0,0,0,0,1.0,1,1.0,1,1.0,1,0.2920951133652186,56
5181,17,76134,76134,0,0,0,0,1.0,1,1.0,1,1.0,1,0.1864490689571245,57
5182,10,76144,76144,0,0,0,0,1.0,1,1.0,1,1.0,1,0.29279744214071957,56
5183,11,76155,76155,0,0,0,0,1.0,1,1.0,1,1.0,1,0.24833184806659134,57
5184,12,76167,76167,0,0,0,0,1.0,1,1.0,1,1.0,1,0.30903939132505476,56
5185,9,76176,76176,0,0,0,0,1.0,1,1.0,1,1.0,1,0.2921362685619934,56
5186,11,76187,76187,0,0,0,0,1.0,1,1.0,1,1.0,1,0.3273430209012065,54
5187,21,76208,76208,0,0,0,0,1.0,1,1.0,1,1.0,1,0.23087666378294835,51
5188,18,76226,76226,0,0,0,0,1.0,1,1.0,1,1.0,1,0.27462618832701,50
5189,20,76246,76246,0,0,0,0,1.0,1,1.0,1,1.0,1,0.22048933988832917,49
5190,22,76268,76268,0,0,0,0,1.0,1,1.0,1,1.0,1,0.3478832294718544,50
5191,13,76281,76281,0,0,0,0,1.0,1,1.0,1,1.0,1,0.29565941068105867,50
5192,13,76294,76294,0,0,0,0,1.0,1,1.0,1,1.0,1,0.3676645202476552,49
5193,24,76318,76318,0,0,0,0,1.0,1,1.0,1,1.0,1,0.3937782001061191,50
5194,18,76336,76336,0,0,0,0,1.0,1,1.0,1,1.0,1,0.3539933957806053,51
5195,14,76350,76350,0,0,0,0,1.0,1,1.0,1,1.0,1,0.4241103244431506,51
5196,28,76378,76378,0,0,0,0,1.0,1,1.0,1,1.0,1,0.420978605038272,51
5197,11,76389,76389,0,0,0,0,1.0,1,1.0,1,1.0,1,0.46076638865228364,51
5198,16,76405,76405,0,0,0,0,1.0,1,1.0,1,1.0,1,0.3859100654505526,51
5199,14,76419,76419,0,0,0,0,1.0,1,1.0,1,1.0,1,0.36202356130651825,54
5200,16,76435,76435,0,0,0,0,1.0,1,1.0,1,1.0,1,0.30641585413063677,54
5201,31,76466,76466,0,0,0,0,1.0,1,1.0,1,1.0,1,0.3549327044167066,55
5202,22,76488,76488,0,0,0,0,1.0,1,1.0,1,1.0,1,0.43721346896013097,56
5203,25,76513,76513,0,0,0,0,1.0,1,1.0,1,1.0,1,0.3488024182598284,56
5204,23,76536,76536,0,0,0,0,1.0,1,1.0,1,1.0,1,0.450858281785302,58
5205,20,76556,76556,0,0,0,0,1.0,1,1.0,1,1.0,1,0.4191263513803217,58
5206,18,76574,76574,0,0,0,0,1.0,1,1.0,1,1.0,1,0.42258746588030055,58
5207,19,76593,76593,0,0,0,0,1.0,1,1.0,1,1.0,1,0.4862393959523972,59
5208,19,76612,76612,0,0,0,0,1.0,1,1.0,1,1.0,1,0.375191393722208,58
5209,24,76636,76636,0,0,0,0,1.0,1,1.0,1,1.0,1,0.4847220169187288,58
5210,15,76651,76651,0,0,0,0,1.0,1,1.0,1,1.0,1,0.4791014716345066,57
5211,26,76677,76677,0,0,0,0,1.0,1,1.0,1,1.0,1,0.42722131050080847,57
5212,14,76691,76691,0,0,0,0,1.0,1,1.0,1,1.0,1,0.4050649496007452,59
5213,17,76708,76708,0,0,0,0,1.0,1,1.0,1,1.0,1,0.4536809669862102,59
5214,27,76735,76735,0,0,0,0,1.0,1,1.0,1,1.0,1,0.26726706393191585,59
5215,24,76759,76759,0,0,0,0,1.0,1,1.0,1,1.0,1,0.35272768856765585,58
5216,13,76772,76772,0,0,0,0,1.0,1,1.0,1,1.0,1,0.34096520645816203,59
5217,15,76787,76787,0,0,0,0,1.0,1,1.0,1,1.0,1,0.40629391531208187,58
5218,24,76811,76811,0,0,0,0,1.0,1,1.0,1,1.0,1,0.23850820364082145,58
5219,19,76830,76830,0,0,0,0,1.0,1,1.0,1,1.0,1,0.34900690889103003,57
5220,9,76839,76839,0,0,0,0,1.0,1,1.0,1,1.0,1,0.31493788048030846,56
5221,23,76862,76862,0,0,0,0,1.0,1,1.0,1,1.0,1,0.37045123207398395,58
5222,15,76877,76877,0,0,0,0,1.0,1,1.0,1,1.0,1,0.4707274808470696,56
5223,18,76895,76895,0,0,0,0,1.0,1,1.0,1,1.0,1,0.4379841690060784,55
5224,13,76908,76908,0,0,0,0,1.0,1,1.0,1,1.0,1,0.43566479857326235,56
5225,10,76918,76918,0,0,0,0,1.0,1,1.0,1,1.0,1,0.3709093476145215,55
5226,8,76926,76926,0,0,0,0,1.0,1,1.0,1,1.0,1,0.46570194327736686,55
5227,18,76944,76944,0,0,0,0,1.0,1,1.0,1,1.0,1,0.42723197794310314,53
5228,21,76965,76965,0,0,0,0,1.0,1,1.0,1,1.0,1,0.47269866676379635,51
5229,12,76977,76977,0,0,0,0,1.0,1,1.0,1,1.0,1,0.45051647206136186,51
5230,22,76999,76999,0,0,0,0,1.0,1,1.0,1,1.0,1,0.44950379849819705,51
5231,15,77014,77014,0,0,0,0,1.0,1,1.0,1,1.0,1,0.42890079394264785,52
5232,27,77041,77041,0,0,0,0,1.0,1,1.0,1,1.0,1,0.45161531813714634,52
5233,21,77062,77062,0,0,0,0,1.0,1,1.0,1,1.0,1,0.40957537829259094,53
5234,21,77083,77083,0,0,0,0,1.0,1,1.0,1,1.0,1,0.39179886255629837,53
5235,15,77098,77098,0,0,0,0,1.0,1,1.0,1,1.0,1,0.39005050907360694,53
5236,24,77122,77122,0,0,0,0,1.0,1,1.0,1,1.0,1,0.38293752129166025,52
5237,35,77157,77157,0,0,0,0,1.0,1,1.0,1,1.0,1,0.3462791721048652,52
5238,27,77184,77184,0,0,0,0,1.0,1,1.0,1,1.0,1,0.39502969118028897,52
5239,14,77198,77198,0,0,0,0,1.0,1,1.0,1,1.0,1,0.3645532935120354,51
5240,24,77222,77222,0,0,0,0,1.0,1,1.0,1,1.0,1,0.39305912302724705,53
5241,19,77241,77241,0,0,0,0,1.0,1,1.0,1,1.0,1,0.32812836129180417,53
5242,21,77262,77262,0,0,0,0,1.0,1,1.0,1,1.0,1,0.33029670267144895,51
5243,23,77285,77285,0,0,0,0,1.0,1,1.0,1,1.0,1,0.30403538450642614,51
5244,24,77309,77309,0,0,0,0,1.0,1,1.0,1,1.0,1,0.25835853090620275,52
5245,25,77334,77334,0,0,0,0,1.0,1,1.0,1,1.0,1,0.28907799685562885,53
5246,9,77343,77343,0,0,0,0,1.0,1,1.0,1,1.0,1,0.3324023057529827,53
5247,15,77358,77358,0,0,0,0,1.0,1,1.0,1,1.0,1,0.3116601731374595,54
5248,13,77371,77371,0,0,0,0,1.0,1,1.0,1,1.0,1,0.3288601286129425,54
5249,19,77390,77390,0,0,0,0,1.0,1,1.0,1,1.0,1,0.3278137002510471,55
5250,14,77404,77404,0,0,0,0,1.0,1,1.0,1,1.0,1,0.32244099072937393,57
5251,15,77419,77419,0,0,0,0,1.0,1,1.0,1,1.0,1,0.2700491078576788,58
5252,10,77429,77429,0,0,0,0,1.0,1,1.0,1,1.0,1,0.34771152289646234,58
5253,13,77442,77442,0,0,0,0,1.0,1,1.0,1,1.0,1,0.33853310409642495,58
5254,15,77457,77457,0,0,0,0,1.0,1,1.0,1,1.0,1,0.38983764089511386,59
5255,15,77472,77472,0,0,0,0,1.0,1,1.0,1,1.0,1,0.33892324453679623,58
5256,14,77486,77486,0,0,0,0,1.0,1,1.0,1,1.0,1,0.4113542948892736,58
5257,14,77500,77500,0,0,0,0,1.0,1,1.0,1,1.0,1,0.3280974164603345,57
5258,10,77510,77510,0,0,0,0,1.0,1,1.0,1,1.0,1,0.4595733342465898,55
5259,14,77524,77524,0,0,0,0,1.0,1,1.0,1,1.0,1,0.41309021543897984,56
5260,14,77538,77538,0,0,0,0,1.0,1,1.0,1,1.0,1,0.3838726754921296,55
5261,11,77549,77549,0,0,0,0,1.0,1,1.0,1,1.0,1,0.4168394559817965,54
5262,13,77562,77562,0,0,0,0,1.0,1,1.0,1,1.0,1,0.38096297107452537,54
5263,12,77574,77574,0,0,0,0,1.0,1,1.0,1,1.0,1,0.3489334301601666,55
5264,17,77591,77591,0,0,0,0,1.0,1,1.0,1,1.0,1,0.3641689579537441,53
5265,10,77601,77601,0,0,0,0,1.0,1,1.0,1,1.0,1,0.3175383248022703,52
5266,10,77611,77611,0,0,0,0,1.0,1,1.0,1,1.0,1,0.4364028660760487,49
5267,15,77626,77626,0,0,0,0,1.0,1,1.0,1,1.0,1,0.3540519979180173,49
5268,12,77638,77638,0,0,0,0,1.0,1,1.0,1,1.0,1,0.34712614495350164,46
5269,15,77653,77653,0,0,0,0,1.0,1,1.0,1,1.0,1,0.31593024170774936,45
5270,14,77667,77667,0,0,0,0,1.0,1,1.0,1,1.0,1,0.2859311948980566,46
5271,14,77681,77681,0,0,0,0,1.0,1,1.0,1,1.0,1,0.3163716520505027,46
5272,18,77699,77699,0,0,0,0,1.0,1,1.0,1,1.0,1,0.30306949065087213,45
5273,15,77714,77714,0,0,0,0,1.0,1,1.0,1,1.0,1,0.2933211074129402,45
5274,14,77728,77728,0,0,0,0,1.0,1,1.0,1,1.0,1,0.3188146667606277,45
5275,18,77746,77746,0,0,0,0,1.0,1,1.0,1,1.0,1,0.3478324573492703,46
5276,15,77761,77761,0,0,0,0,1.0,1,1.0,1,1.0,1,0.3144792453885493,45
5277,16,77777,77777,0,0,0,0,1.0,1,1.0,1,1.0,1,0.3260368661439453,45
5278,25,77802,77802,0,0,0,0,1.0,1,1.0,1,1.0,1,0.3829685944881627,44
5279,19,77821,77821,0,0,0,0,1.0,1,1.0,1,1.0,1,0.41952861798199753,45
5280,19,77840,77840,0,0,0,0,1.0,1,1.0,1,1.0,1,0.29188255402091207,46
5281,9,77849,77849,0,0,0,0,1.0,1,1.0,1,1.0,1,0.4242658355637981,46
5282,16,77865,77865,0,0,0,0,1.0,1,1.0,1,1.0,1,0.39423364113317,47
5283,13,77878,77878,0,0,0,0,1.0,1,1.0,1,1.0,1,0.356089613667975,48
5284,10,77888,77888,0,0,0,0,1.0,1,1.0,1,1.0,1,0.4014064405688213,48
5285,13,77901,77901,0,0,0,0,1.0,1,1.0,1,1.0,1,0.46588885266671026,48
5286,21,77922,77922,0,0,0,0,1.0,1,1.0,1,1.0,1,0.32035231606215353,50
5287,15,77937,77937,0,0,0,0,1.0,1,1.0,1,1.0,1,0.377645829869644,50
5288,18,77955,77955,0,0,0,0,1.0,1,1.0,1,1.0,1,0.3770605660220001,51
5289,12,77967,77967,0,0,0,0,1.0,1,1.0,1,1.0,1,0.4196706234983342,51
5290,14,77981,77981,0,0,0,0,1.0,1,1.0,1,1.0,1,0.41374974994873387,52
5291,9,77990,77990,0,0,0,0,1.0,1,1.0,1,1.0,1,0.3970314978695967,52
5292,11,78001,78001,0,0,0,0,1.0,1,1.0,1,1.0,1,0.45058808954667734,53
5293,14,78015,78015,0,0,0,0,1.0,1,1.0,1,1.0,1,0.4850856607971311,51
5294,12,78027,78027,0,0,0,0,1.0,1,1.0,1,1.0,1,0.45769893239536186,50
5295,17,78044,78044,0,0,0,0,1.0,1,1.0,1,1.0,1,0.39568179450071944,49
5296,19,78063,78063,0,0,0,0,1.0,1,1.0,1,1.0,1,0.5095250574942221,48
5297,19,78082,78082,0,0,0,0,1.0,1,1.0,1,1.0,1,0.4676174644372848,46
5298,28,78110,78110,0,0,0,0,1.0,1,1.0,1,1.0,1,0.44282181475234217,46
5299,17,78127,78127,0,0,0,0,1.0,1,1.0,1,1.0,1,0.5197905419423566,47
5300,22,78149,78149,0,0,0,0,1.0,1,1.0,1,1.0,1,0.4427148878186612,48
5301,32,78181,78181,0,0,0,0,1.0,1,1.0,1,1.0,1,0.33726628874552966,48
5302,26,78207,78207,0,0,0,0,1.0,1,1.0,1,1.0,1,0.48851665704066227,49
5303,11,78218,78218,0,0,0,0,1.0,1,1.0,1,1.0,1,0.4644291605005454,48
5304,18,78236,78236,0,0,0,0,1.0,1,1.0,1,1.0,1,0.44167408225831056,48
5305,12,78248,78248,0,0,0,0,1.0,1,1.0,1,1.0,1,0.44984993192688183,47
5306,23,78271,78271,0,0,0,0,1.0,1,1.0,1,1.0,1,0.30137284060614444,48
5307,16,78287,78287,0,0,0,0,1.0,1,1.0,1,1.0,1,0.48706659148746856,48
5308,13,78300,78300,0,0,0,0,1.0,1,1.0,1,1.0,1,0.35892174948182776,47
5309,19,78319,78319,0,0,0,0,1.0,1,1.0,1,1.0,1,0.4386322799843171,46
5310,28,78347,78347,0,0,0,0,1.0,1,1.0,1,1.0,1,0.4367458073168595,46
5311,22,78369,78369,0,0,0,0,1.0,1,1.0,1,1.0,1,0.40980084335856937,46
5312,32,78401,78401,0,0,0,0,1.0,1,1.0,1,1.0,1,0.45949749003638996,46
5313,30,78431,78431,0,0,0,0,1.0,1,1.0,1,1.0,1,0.36839184104472755,46
5314,27,78458,78458,0,0,0,0,1.0,1,1.0,1,1.0,1,0.40253098928880215,46
5315,26,78484,78484,0,0,0,0,1.0,1,1.0,1,1.0,1,0.3814465260451249,47
5316,30,78514,78514,0,0,0,0,1.0,1,1.0,1,1.0,1,0.3405062293711748,48
5317,24,78538,78538,0,0,0,0,1.0,1,1.0,1,1.0,1,0.24521813289508496,49
5318,25,78563,78563,0,0,0,0,1.0,1,1.0,1,1.0,1,0.3314219541777393,49
5319,8,78571,78571,0,0,0,0,1.0,1,1.0,1,1.0,1,0.34858866255029736,50
5320,16,78587,78587,0,0,0,0,1.0,1,1.0,1,1.0,1,0.3095402438324259,51
5321,15,78602,78602,0,0,0,0,1.0,1,1.0,1,1.0,1,0.34088971366552445,52
5322,15,78617,78617,0,0,0,0,1.0,1,1.0,1,1.0,1,0.23040118804335546,53
5323,12,78629,78629,0,0,0,0,1.0,1,1.0,1,1.0,1,0.3335677395777679,53
5324,12,78641,78641,0,0,0,0,1.0,1,1.0,1,1.0,1,0.29476482207181254,55
5325,18,78659,78659,0,0,0,0,1.0,1,1.0,1,1.0,1,0.335863144322698,55
5326,17,78676,78676,0,0,0,0,1.0,1,1.0,1,1.0,1,0.25534226597069176,55
5327,9,78685,78685,0,0,0,0,1.0,1,1.0,1,1.0,1,0.25865734418736647,56
5328,11,78696,78696,0,0,0,0,1.0,1,1.0,1,1.0,1,0.27497074901769525,57
5329,10,78706,78706,0,0,0,0,1.0,1,1.0,1,1.0,1,0.26169580151819555,57
5330,13,78719,78719,0,0,0,0,1.0,1,1.0,1,1.0,1,0.32259480925189477,56
5331,14,78733,78733,0,0,0,0,1.0,1,1.0,1,1.0,1,0.30725420567228595,57
5332,14,78747,78747,0,0,0,0,1.0,1,1.0,1,1.0,1,0.3107335683460575,58
5333,9,78756,78756,0,0,0,0,1.0,1,1.0,1,1.0,1,0.2705384641585912,59
5334,18,78774,78774,0,0,0,0,1.0,1,1.0,1,1.0,1,0.2516711975288234,59
5335,22,78796,78796,0,0,0,0,1.0,1,1.0,1,1.0,1,0.2967113080551429,58
5336,18,78814,78814,0,0,0,0,1.0,1,1.0,1,1.0,1,0.2674277023705909,59
5337,13,78827,78827,0,0,0,0,1.0,1,1.0,1,1.0,1,0.28072555135935134,60
5338,15,78842,78842,0,0,0,0,1.0,1,1.0,1,1.0,1,0.22889844468589038,60
5339,13,78855,78855,0,0,0,0,1.0,1,1.0,1,1.0,1,0.3094200938807852,60
5340,24,78879,78879,0,0,0,0,1.0,1,1.0,1,1.0,1,0.319494689144918,60
5341,14,78893,78893,0,0,0,0,1.0,1,1.0,1,1.0,1,0.32403767582389426,61
5342,13,78906,78906,0,0,0,0,1.0,1,1.0,1,1.0,1,0.2436897002701089,59
5343,22,78928,78928,0,0,0,0,1.0,1,1.0,1,1.0,1,0.2361154794450072,58
5344,17,78945,78945,0,0,0,0,1.0,1,1.0,1,1.0,1,0.2563638742194745,58
5345,21,78966,78966,0,0,0,0,1.0,1,1.0,1,1.0,1,0.27463633516463937,54
5346,13,78979,78979,0,0,0,0,1.0,1,1.0,1,1.0,1,0.25329061883602516,54
5347,29,79008,79008,0,0,0,0,1.0,1,1.0,1,1.0,1,0.2799313205574663,54
5348,17,79025,79025,0,0,0,0,1.0,1,1.0,1,1.0,1,0.28518217185321615,55
5349,27,79052,79052,0,0,0,0,1.0,1,1.0,1,1.0,1,0.35240562413176385,56
5350,19,79071,79071,0,0,0,0,1.0,1,1.0,1,1.0,1,0.26776534586358985,56
5351,13,79084,79084,0,0,0,0,1.0,1,1.0,1,1.0,1,0.34056898456103907,57
5352,12,79096,79096,0,0,0,0,1.0,1,1.0,1,1.0,1,0.33030326277164657,57
5353,7,79103,79103,0,0,0,0,1.0,1,1.0,1,1.0,1,0.3377363165983672,57
5354,25,79128,79128,0,0,0,0,1.0,1,1.0,1,1.0,1,0.40260342579258557,56
5355,26,79154,79154,0,0,0,0,1.0,1,1.0,1,1.0,1,0.33963317511829777,57
5356,19,79173,79173,0,0,0,0,1.0,1,1.0,1,1.0,1,0.3847205340498053,56
5357,23,79196,79196,0,0,0,0,1.0,1,1.0,1,1.0,1,0.3749691540471465,56
5358,28,79224,79224,0,0,0,0,1.0,1,1.0,1,1.0,1,0.34717688260435386,57
5359,26,79250,79250,0,0,0,0,1.0,1,1.0,1,1.0,1,0.45024154151644785,57
5360,21,79271,79271,0,0,0,0,1.0,1,1.0,1,1.0,1,0.4742400084175433,55
5361,32,79303,79303,0,0,0,0,1.0,1,1.0,1,1.0,1,0.5190948502197122,56
5362,24,79327,79327,0,0,0,0,1.0,1,1.0,1,1.0,1,0.4106064996378384,57
5363,31,79358,79358,0,0,0,0,1.0,1,1.0,1,1.0,1,0.46668293109744996,57
5364,21,79379,79379,0,0,0,0,1.0,1,1.0,1,1.0,1,0.45055860572807,58
5365,34,79413,79413,0,0,0,0,1.0,1,1.0,1,1.0,1,0.43665549288029576,59
5366,24,79437,79437,0,0,0,0,1.0,1,1.0,1,1.0,1,0.36017051285870494,60
5367,34,79471,79471,0,0,0,0,1.0,1,1.0,1,1.0,1,0.3496106746370853,60
5368,25,79496,79496,0,0,0,0,1.0,1,1.0,1,1.0,1,0.3120963570499231,58
5369,34,79530,79530,0,0,0,0,1.0,1,1.0,1,1.0,1,0.3165816821042114,58
5370,24,79554,79554,0,0,0,0,1.0,1,1.0,1,1.0,1,0.3441019005137127,57
5371,26,79580,79580,0,0,0,0,1.0,1,1.0,1,1.0,1,0.2769071728497972,56
5372,18,79598,79598,0,0,0,0,1.0,1,1.0,1,1.0,1,0.2710571810367879,55
5373,21,79619,79619,0,0,0,0,1.0,1,1.0,1,1.0,1,0.34747168256342853,54
5374,22,79641,79641,0,0,0,0,1.0,1,1.0,1,1.0,1,0.30942673011713506,53
5375,36,79677,79677,0,0,0,0,1.0,1,1.0,1,1.0,1,0.3585412111243858,52
5376,21,79698,79698,0,0,0,0,1.0,1,1.0,1,1.0,1,0.2516127853481553,52
5377,16,79714,79714,0,0,0,0,1.0,1,1.0,1,1.0,1,0.3560584493896534,51
5378,19,79733,79733,0,0,0,0,1.0,1,1.0,1,1.0,1,0.28905261701528434,52
5379,15,79748,79748,0,0,0,0,1.0,1,1.0,1,1.0,1,0.2286547631840537,50
5380,8,79756,79756,0,0,0,0,1.0,1,1.0,1,1.0,1,0.27997483932094164,51
5381,6,79762,79762,0,0,0,0,1.0,1,1.0,1,1.0,1,0.2617000528298852,50
5382,8,79770,79770,0,0,0,0,1.0,1,1.0,1,1.0,1,0.3823295038208881,48
5383,21,79791,79791,0,0,0,0,1.0,1,1.0,1,1.0,1,0.3367767027527601,48
5384,15,79806,79806,0,0,0,0,1.0,1,1.0,1,1.0,1,0.342032152456931,48
5385,16,79822,79822,0,0,0,0,1.0,1,1.0,1,1.0,1,0.40165780561716274,47
5386,15,79837,79837,0,0,0,0,1.0,1,1.0,1,1.0,1,0.308172076772875,48
5387,10,79847,79847,0,0,0,0,1.0,1,1.0,1,1.0,1,0.3763073153614235,48
5388,25,79872,79872,0,0,0,0,1.0,1,1.0,1,1.0,1,0.2693500391182,48
5389,11,79883,79883,0,0,0,0,1.0,1,1.0,1,1.0,1,0.26069959359000733,50
5390,13,79896,79896,0,0,0,0,1.0,1,1.0,1,1.0,1,0.3613093116312419,52
5391,12,79908,79908,0,0,0,0,1.0,1,1.0,1,1.0,1,0.40034461155611867,52
5392,15,79923,79923,0,0,0,0,1.0,1,1.0,1,1.0,1,0.38771277805839294,51
5393,11,79934,79934,0,0,0,0,1.0,1,1.0,1,1.0,1,0.4526602392221648,50
5394,16,79950,79950,0,0,0,0,1.0,1,1.0,1,1.0,1,0.3433537077959749,50
5395,10,79960,79960,0,0,0,0,1.0,1,1.0,1,1.0,1,0.3497591338129414,49
5396,17,79977,79977,0,0,0,0,1.0,1,1.0,1,1.0,1,0.35099927951776694,48
5397,12,79989,79989,0,0,0,0,1.0,1,1.0,1,1.0,1,0.21381254462229593,48
5398,14,80003,80003,0,0,0,0,1.0,1,1.0,1,1.0,1,0.32831640857615774,46
5399,13,80016,80016,0,0,0,0,1.0,1,1.0,1,1.0,1,0.24185624205314382,46
5400,11,80027,80027,0,0,0,0,1.0,1,1.0,1,1.0,1,0.23450236651234133,48
5401,10,80037,80037,0,0,0,0,1.0,1,1.0,1,1.0,1,0.1826196295822468,49
5402,0,80037,80037,0,0,0,0,1.0,1,1.0,1,1.0,1,0.0,0
