,SuccessfulHandoverCount,TotalSuccessfulHandoverCount,TotalSuccessfulHandoverCountRange,TotalSuccessfulHandoverCountLoadBalancing,TotalSuccessfulHandoverCountOverload,FailedHandoverCount,TotalFailedHandoverCount,AvgQoS,MinQoS,AvgQoS_LoadBased,MinQoS_LoadBased,AvgQoS_RangeBased,MinQoS_RangeBased,GiniLoad,VehicleCount
0,0,0,0,0,0,0,0,1.0,1,1.0,1,1.0,1,0.0,0
1,21,21,0,21,0,0,0,1.0,1,1.0,1,1.0,1,0.22146569632253624,30
2,17,38,0,38,0,0,0,1.0,1,1.0,1,1.0,1,0.23998874993324257,32
3,7,45,0,45,0,0,0,1.0,1,1.0,1,1.0,1,0.1312578109298706,33
4,1,46,0,46,0,0,0,1.0,1,1.0,1,1.0,1,0.1693011671321828,34
5,0,46,0,46,0,0,0,1.0,1,1.0,1,1.0,1,0.1539008923327226,36
6,1,47,0,47,0,0,0,1.0,1,1.0,1,1.0,1,0.1420139180606984,38
7,1,48,0,48,0,0,0,1.0,1,1.0,1,1.0,1,0.1433996335533686,40
8,0,48,0,48,0,0,0,1.0,1,1.0,1,1.0,1,0.1433996335533686,40
9,0,48,0,48,0,0,0,1.0,1,1.0,1,1.0,1,0.1433996335533686,40
10,3,51,1,50,0,0,0,1.0,1,1.0,1,1.0,1,0.15022320545666398,41
11,0,51,1,50,0,0,0,1.0,1,1.0,1,1.0,1,0.15024431294786747,40
12,3,54,2,52,0,0,0,1.0,1,1.0,1,1.0,1,0.07953097643446129,39
13,3,57,5,52,0,0,0,1.0,1,1.0,1,1.0,1,0.16861438608257254,37
14,1,58,5,53,0,0,0,1.0,1,1.0,1,1.0,1,0.20764674176711903,35
15,4,62,5,57,0,0,0,1.0,1,1.0,1,1.0,1,0.1541844738702888,36
16,3,65,7,58,0,0,0,1.0,1,1.0,1,1.0,1,0.20767013993546024,34
17,3,68,7,61,0,0,0,1.0,1,1.0,1,1.0,1,0.21115867973947797,33
18,0,68,7,61,0,0,0,1.0,1,1.0,1,1.0,1,0.2234813722406316,34
19,1,69,8,61,0,0,0,1.0,1,1.0,1,1.0,1,0.24629718663606057,34
20,1,70,8,62,0,0,0,1.0,1,1.0,1,1.0,1,0.21848918642760676,34
21,5,75,9,66,0,0,0,1.0,1,1.0,1,1.0,1,0.19429636280225573,36
22,0,75,9,66,0,0,0,1.0,1,1.0,1,1.0,1,0.21715341659064263,35
23,6,81,11,70,0,0,0,1.0,1,1.0,1,1.0,1,0.1673257592778142,35
24,2,83,12,71,0,0,0,1.0,1,1.0,1,1.0,1,0.12288117905895948,35
25,2,85,13,72,0,0,0,1.0,1,1.0,1,1.0,1,0.11209305304176088,35
26,3,88,15,73,0,0,0,1.0,1,1.0,1,1.0,1,0.14183162904594934,36
27,2,90,16,74,0,0,0,1.0,1,1.0,1,1.0,1,0.10469867131699326,34
28,2,92,17,75,0,0,0,1.0,1,1.0,1,1.0,1,0.1418213231372449,35
29,3,95,17,78,0,0,0,1.0,1,1.0,1,1.0,1,0.09650122952395458,33
30,3,98,19,79,0,0,0,1.0,1,1.0,1,1.0,1,0.11715939829043935,33
31,1,99,19,80,0,0,0,1.0,1,1.0,1,1.0,1,0.18869491846424294,33
32,1,100,20,80,0,0,0,1.0,1,1.0,1,1.0,1,0.23509190476072675,32
33,1,101,20,81,0,0,0,1.0,1,1.0,1,1.0,1,0.22587214119963558,33
34,2,103,21,82,0,0,0,1.0,1,1.0,1,1.0,1,0.22140989407896275,33
35,3,106,21,85,0,0,0,1.0,1,1.0,1,1.0,1,0.16936014240579747,35
36,1,107,21,86,0,0,0,1.0,1,1.0,1,1.0,1,0.17075093971746477,36
37,4,111,22,89,0,0,0,1.0,1,1.0,1,1.0,1,0.11725938083604041,37
38,2,113,23,90,0,0,0,1.0,1,1.0,1,1.0,1,0.12512274230235162,36
39,1,114,23,91,0,0,0,1.0,1,1.0,1,1.0,1,0.14545803754375328,38
40,1,115,23,92,0,0,0,1.0,1,1.0,1,1.0,1,0.15406277631835505,40
41,0,115,23,92,0,0,0,1.0,1,1.0,1,1.0,1,0.15406277631835505,40
42,1,116,24,92,0,0,0,1.0,1,1.0,1,1.0,1,0.17039715295944044,40
43,3,119,26,93,0,0,0,1.0,1,1.0,1,1.0,1,0.23472101918258345,43
44,0,119,26,93,0,0,0,1.0,1,1.0,1,1.0,1,0.23472101918258345,43
45,4,123,27,96,0,0,0,1.0,1,1.0,1,1.0,1,0.18999836769876274,44
46,0,123,27,96,0,0,0,1.0,1,1.0,1,1.0,1,0.18999836769876274,44
47,0,123,27,96,0,0,0,1.0,1,1.0,1,1.0,1,0.18999836769876274,44
48,1,124,28,96,0,0,0,1.0,1,1.0,1,1.0,1,0.2242436211805704,44
49,1,125,28,97,0,0,0,1.0,1,1.0,1,1.0,1,0.21055639413738503,41
50,0,125,28,97,0,0,0,1.0,1,1.0,1,1.0,1,0.2071290513905392,40
51,0,125,28,97,0,0,0,1.0,1,1.0,1,1.0,1,0.21319579707149836,38
52,1,126,29,97,0,0,0,1.0,1,1.0,1,1.0,1,0.26371070537631636,37
53,4,130,29,101,0,0,0,1.0,1,1.0,1,1.0,1,0.23037699612812151,38
54,2,132,29,103,0,0,0,1.0,1,1.0,1,1.0,1,0.2342970623613001,38
55,5,137,30,107,0,0,0,1.0,1,1.0,1,1.0,1,0.1927523362441851,38
56,1,138,31,107,0,0,0,1.0,1,1.0,1,1.0,1,0.18165343707134868,38
57,2,140,32,108,0,0,0,1.0,1,1.0,1,1.0,1,0.17819852431883218,38
58,3,143,35,108,0,0,0,1.0,1,1.0,1,1.0,1,0.24265104013380856,38
59,4,147,35,112,0,0,0,1.0,1,1.0,1,1.0,1,0.14012696741341232,40
60,1,148,36,112,0,0,0,1.0,1,1.0,1,1.0,1,0.16021592544961644,40
61,0,148,36,112,0,0,0,1.0,1,1.0,1,1.0,1,0.15325534820828826,40
62,2,150,37,113,0,0,0,1.0,1,1.0,1,1.0,1,0.15077379872699478,42
63,1,151,38,113,0,0,0,1.0,1,1.0,1,1.0,1,0.15665241435229552,40
64,0,151,38,113,0,0,0,1.0,1,1.0,1,1.0,1,0.1534702008701811,41
65,1,152,39,113,0,0,0,1.0,1,1.0,1,1.0,1,0.17368444885613363,41
66,0,152,39,113,0,0,0,1.0,1,1.0,1,1.0,1,0.17387658320028693,41
67,0,152,39,113,0,0,0,1.0,1,1.0,1,1.0,1,0.17387658320028693,41
68,1,153,40,113,0,0,0,1.0,1,1.0,1,1.0,1,0.18343415104147925,41
69,6,159,42,117,0,0,0,1.0,1,1.0,1,1.0,1,0.16529071557353167,41
70,0,159,42,117,0,0,0,1.0,1,1.0,1,1.0,1,0.18265780328153783,42
71,4,163,42,121,0,0,0,1.0,1,1.0,1,1.0,1,0.11314859772670892,44
72,0,163,42,121,0,0,0,1.0,1,1.0,1,1.0,1,0.11314859772670892,44
73,1,164,42,122,0,0,0,1.0,1,1.0,1,1.0,1,0.09941192981286398,46
74,1,165,43,122,0,0,0,1.0,1,1.0,1,1.0,1,0.14407339178771617,44
75,2,167,44,123,0,0,0,1.0,1,1.0,1,1.0,1,0.10517132873556642,44
76,4,171,47,124,0,0,0,1.0,1,1.0,1,1.0,1,0.2113845231518829,45
77,5,176,48,128,0,0,0,1.0,1,1.0,1,1.0,1,0.1579265770649004,44
78,2,178,48,130,0,0,0,1.0,1,1.0,1,1.0,1,0.14984828533666134,44
79,0,178,48,130,0,0,0,1.0,1,1.0,1,1.0,1,0.16378514300872857,43
80,2,180,50,130,0,0,0,1.0,1,1.0,1,1.0,1,0.17500680957470888,43
81,5,185,52,133,0,0,0,1.0,1,1.0,1,1.0,1,0.20667811159271335,44
82,3,188,54,134,0,0,0,1.0,1,1.0,1,1.0,1,0.22875498234663585,45
83,8,196,56,140,0,0,0,1.0,1,1.0,1,1.0,1,0.2118095955008716,45
84,1,197,56,141,0,0,0,1.0,1,1.0,1,1.0,1,0.2048791314423466,45
85,1,198,56,142,0,0,0,1.0,1,1.0,1,1.0,1,0.19257812283183073,45
86,0,198,56,142,0,0,0,1.0,1,1.0,1,1.0,1,0.19257812283183073,45
87,0,198,56,142,0,0,0,1.0,1,1.0,1,1.0,1,0.20824454088249697,44
88,0,198,56,142,0,0,0,1.0,1,1.0,1,1.0,1,0.19217452627367934,45
89,6,204,58,146,0,0,0,1.0,1,1.0,1,1.0,1,0.18567868555362588,46
90,1,205,58,147,0,0,0,1.0,1,1.0,1,1.0,1,0.20044929354073104,44
91,1,206,59,147,0,0,0,1.0,1,1.0,1,1.0,1,0.18329319976113814,45
92,0,206,59,147,0,0,0,1.0,1,1.0,1,1.0,1,0.1964653553825513,46
93,0,206,59,147,0,0,0,1.0,1,1.0,1,1.0,1,0.1964653553825513,46
94,0,206,59,147,0,0,0,1.0,1,1.0,1,1.0,1,0.1964653553825513,46
95,1,207,59,148,0,0,0,1.0,1,1.0,1,1.0,1,0.20231967540965604,46
96,1,208,59,149,0,0,0,1.0,1,1.0,1,1.0,1,0.19772461121006993,46
97,0,208,59,149,0,0,0,1.0,1,1.0,1,1.0,1,0.1902451347697995,47
98,0,208,59,149,0,0,0,1.0,1,1.0,1,1.0,1,0.1902451347697995,47
99,7,215,61,154,0,0,0,1.0,1,1.0,1,1.0,1,0.2040723522503732,46
100,2,217,62,155,0,0,0,1.0,1,1.0,1,1.0,1,0.20955977510541238,48
101,1,218,62,156,0,0,0,1.0,1,1.0,1,1.0,1,0.20599498487534193,49
102,2,220,63,157,0,0,0,1.0,1,1.0,1,1.0,1,0.18154772095879168,49
103,1,221,63,158,0,0,0,1.0,1,1.0,1,1.0,1,0.1624997548932757,48
104,2,223,64,159,0,0,0,1.0,1,1.0,1,1.0,1,0.16969347345680785,49
105,4,227,67,160,0,0,0,1.0,1,1.0,1,1.0,1,0.15602289811273012,48
106,3,230,68,162,0,0,0,1.0,1,1.0,1,1.0,1,0.12470322225792314,48
107,2,232,69,163,0,0,0,1.0,1,1.0,1,1.0,1,0.13099386400856447,47
108,3,235,70,165,0,0,0,1.0,1,1.0,1,1.0,1,0.09197220911527715,47
109,3,238,73,165,0,0,0,1.0,1,1.0,1,1.0,1,0.1464454926295326,47
110,0,238,73,165,0,0,0,1.0,1,1.0,1,1.0,1,0.14571169778983067,47
111,3,241,74,167,0,0,0,1.0,1,1.0,1,1.0,1,0.0742898233502761,46
112,1,242,75,167,0,0,0,1.0,1,1.0,1,1.0,1,0.09973526079151918,46
113,5,247,78,169,0,0,0,1.0,1,1.0,1,1.0,1,0.1283515303967253,45
114,1,248,78,170,0,0,0,1.0,1,1.0,1,1.0,1,0.11017127486521848,46
115,1,249,78,171,0,0,0,1.0,1,1.0,1,1.0,1,0.11426504747468456,47
116,1,250,79,171,0,0,0,1.0,1,1.0,1,1.0,1,0.12594990213432275,48
117,4,254,82,172,0,0,0,1.0,1,1.0,1,1.0,1,0.12406951954028558,48
118,1,255,82,173,0,0,0,1.0,1,1.0,1,1.0,1,0.12823349587302818,49
119,1,256,83,173,0,0,0,1.0,1,1.0,1,1.0,1,0.13894907328032957,50
120,0,256,83,173,0,0,0,1.0,1,1.0,1,1.0,1,0.13397508129813984,51
121,2,258,83,175,0,0,0,1.0,1,1.0,1,1.0,1,0.1145668777158035,51
122,1,259,84,175,0,0,0,1.0,1,1.0,1,1.0,1,0.10855684257662698,51
123,0,259,84,175,0,0,0,1.0,1,1.0,1,1.0,1,0.10855684257662698,51
124,0,259,84,175,0,0,0,1.0,1,1.0,1,1.0,1,0.10855684257662698,51
125,1,260,84,176,0,0,0,1.0,1,1.0,1,1.0,1,0.13867311010752484,50
126,3,263,85,178,0,0,0,1.0,1,1.0,1,1.0,1,0.09882784619266617,52
127,3,266,85,181,0,0,0,1.0,1,1.0,1,1.0,1,0.08845962365401294,50
128,0,266,85,181,0,0,0,1.0,1,1.0,1,1.0,1,0.08845962365401294,50
129,3,269,86,183,0,0,0,1.0,1,1.0,1,1.0,1,0.09835942906436976,52
130,1,270,87,183,0,0,0,1.0,1,1.0,1,1.0,1,0.12725924634408597,52
131,3,273,87,186,0,0,0,1.0,1,1.0,1,1.0,1,0.09021004522034451,54
132,0,273,87,186,0,0,0,1.0,1,1.0,1,1.0,1,0.09021004522034451,54
133,2,275,87,188,0,0,0,1.0,1,1.0,1,1.0,1,0.08689462030802482,52
134,2,277,88,189,0,0,0,1.0,1,1.0,1,1.0,1,0.06003408406305091,52
135,4,281,92,189,0,0,0,1.0,1,1.0,1,1.0,1,0.14928621740438028,51
136,4,285,92,193,0,0,0,1.0,1,1.0,1,1.0,1,0.11282653990726083,51
137,1,286,92,194,0,0,0,1.0,1,1.0,1,1.0,1,0.07288711336199352,50
138,3,289,93,196,0,0,0,1.0,1,1.0,1,1.0,1,0.07452349888647436,52
139,4,293,95,198,0,0,0,1.0,1,1.0,1,1.0,1,0.10633622315543015,51
140,1,294,96,198,0,0,0,1.0,1,1.0,1,1.0,1,0.09641626932997643,51
141,2,296,98,198,0,0,0,1.0,1,1.0,1,1.0,1,0.13387608964966147,50
142,2,298,100,198,0,0,0,1.0,1,1.0,1,1.0,1,0.13570218697132272,51
143,4,302,101,201,0,0,0,1.0,1,1.0,1,1.0,1,0.08495986080340835,48
144,5,307,103,204,0,0,0,1.0,1,1.0,1,1.0,1,0.10235074513307099,49
145,1,308,104,204,0,0,0,1.0,1,1.0,1,1.0,1,0.09754719732061562,47
146,4,312,105,207,0,0,0,1.0,1,1.0,1,1.0,1,0.07433997415156501,49
147,3,315,106,209,0,0,0,1.0,1,1.0,1,1.0,1,0.0944564893396401,46
148,1,316,107,209,0,0,0,1.0,1,1.0,1,1.0,1,0.07957759648981794,47
149,1,317,108,209,0,0,0,1.0,1,1.0,1,1.0,1,0.09465383028822803,46
150,0,317,108,209,0,0,0,1.0,1,1.0,1,1.0,1,0.07922561341782686,47
151,2,319,110,209,0,0,0,1.0,1,1.0,1,1.0,1,0.11897404335415418,46
152,0,319,110,209,0,0,0,1.0,1,1.0,1,1.0,1,0.1361289107874364,45
153,1,320,110,210,0,0,0,1.0,1,1.0,1,1.0,1,0.1374808431088288,46
154,0,320,110,210,0,0,0,1.0,1,1.0,1,1.0,1,0.15616343266312013,44
155,2,322,111,211,0,0,0,1.0,1,1.0,1,1.0,1,0.14538368818665529,45
156,3,325,112,213,0,0,0,1.0,1,1.0,1,1.0,1,0.13525465591909688,43
157,2,327,112,215,0,0,0,1.0,1,1.0,1,1.0,1,0.1274341404253298,42
158,3,330,112,218,0,0,0,1.0,1,1.0,1,1.0,1,0.1096165754857528,43
159,1,331,113,218,0,0,0,1.0,1,1.0,1,1.0,1,0.15938762815947644,44
160,0,331,113,218,0,0,0,1.0,1,1.0,1,1.0,1,0.1565133876700126,44
161,4,335,114,221,0,0,0,1.0,1,1.0,1,1.0,1,0.14071246796264728,44
162,2,337,115,222,0,0,0,1.0,1,1.0,1,1.0,1,0.15003952752950817,44
163,7,344,121,223,0,0,0,1.0,1,1.0,1,1.0,1,0.2062213389101974,44
164,2,346,122,224,0,0,0,1.0,1,1.0,1,1.0,1,0.21798116134712908,44
165,7,353,124,229,0,0,0,1.0,1,1.0,1,1.0,1,0.1515874084292884,43
166,3,356,125,231,0,0,0,1.0,1,1.0,1,1.0,1,0.19236562780750713,43
167,4,360,126,234,0,0,0,1.0,1,1.0,1,1.0,1,0.15794278591763028,42
168,0,360,126,234,0,0,0,1.0,1,1.0,1,1.0,1,0.11647897864897926,40
169,2,362,126,236,0,0,0,1.0,1,1.0,1,1.0,1,0.09077333473399164,41
170,0,362,126,236,0,0,0,1.0,1,1.0,1,1.0,1,0.06861954172414264,39
171,2,364,127,237,0,0,0,1.0,1,1.0,1,1.0,1,0.07145374627573008,39
172,0,364,127,237,0,0,0,1.0,1,1.0,1,1.0,1,0.08533042672560565,38
173,1,365,128,237,0,0,0,1.0,1,1.0,1,1.0,1,0.11229283662302929,38
174,0,365,128,237,0,0,0,1.0,1,1.0,1,1.0,1,0.13341127242110512,37
175,2,367,130,237,0,0,0,1.0,1,1.0,1,1.0,1,0.20475737317369472,36
176,3,370,131,239,0,0,0,1.0,1,1.0,1,1.0,1,0.18588146562718177,36
177,4,374,134,240,0,0,0,1.0,1,1.0,1,1.0,1,0.17677165332511477,38
178,1,375,134,241,0,0,0,1.0,1,1.0,1,1.0,1,0.18827327665777283,39
179,2,377,134,243,0,0,0,1.0,1,1.0,1,1.0,1,0.161723718805801,40
180,1,378,134,244,0,0,0,1.0,1,1.0,1,1.0,1,0.15095558792954222,40
181,0,378,134,244,0,0,0,1.0,1,1.0,1,1.0,1,0.18183696673323027,39
182,2,380,136,244,0,0,0,1.0,1,1.0,1,1.0,1,0.20266111878024415,40
183,3,383,138,245,0,0,0,1.0,1,1.0,1,1.0,1,0.2345009196611705,40
184,1,384,138,246,0,0,0,1.0,1,1.0,1,1.0,1,0.213164830031021,38
185,4,388,139,249,0,0,0,1.0,1,1.0,1,1.0,1,0.16508661808798772,38
186,3,391,141,250,0,0,0,1.0,1,1.0,1,1.0,1,0.19714794815751846,37
187,7,398,142,256,0,0,0,1.0,1,1.0,1,1.0,1,0.15777282724323322,36
188,4,402,143,259,0,0,0,1.0,1,1.0,1,1.0,1,0.15574202776481924,36
189,3,405,144,261,0,0,0,1.0,1,1.0,1,1.0,1,0.0861831173217559,36
190,0,405,144,261,0,0,0,1.0,1,1.0,1,1.0,1,0.12523400012906044,36
191,1,406,145,261,0,0,0,1.0,1,1.0,1,1.0,1,0.1389909189772863,37
192,0,406,145,261,0,0,0,1.0,1,1.0,1,1.0,1,0.1389909189772863,37
193,1,407,146,261,0,0,0,1.0,1,1.0,1,1.0,1,0.14791873300289682,38
194,1,408,147,261,0,0,0,1.0,1,1.0,1,1.0,1,0.16419232539631384,39
195,7,415,148,267,0,0,0,1.0,1,1.0,1,1.0,1,0.12448373827798666,40
196,1,416,149,267,0,0,0,1.0,1,1.0,1,1.0,1,0.11670339577963826,40
197,2,418,149,269,0,0,0,1.0,1,1.0,1,1.0,1,0.1137389214891263,40
198,2,420,150,270,0,0,0,1.0,1,1.0,1,1.0,1,0.11392705891813351,40
199,1,421,151,270,0,0,0,1.0,1,1.0,1,1.0,1,0.12618045011166262,40
200,0,421,151,270,0,0,0,1.0,1,1.0,1,1.0,1,0.12618045011166262,40
201,0,421,151,270,0,0,0,1.0,1,1.0,1,1.0,1,0.14317908104582378,39
202,0,421,151,270,0,0,0,1.0,1,1.0,1,1.0,1,0.12567055435261654,40
203,2,423,153,270,0,0,0,1.0,1,1.0,1,1.0,1,0.1387927391277436,39
204,1,424,154,270,0,0,0,1.0,1,1.0,1,1.0,1,0.15224367899330188,38
205,2,426,154,272,0,0,0,1.0,1,1.0,1,1.0,1,0.0802999424705383,37
206,2,428,155,273,0,0,0,1.0,1,1.0,1,1.0,1,0.07451949020777306,36
207,1,429,156,273,0,0,0,1.0,1,1.0,1,1.0,1,0.10875158318712796,37
208,2,431,156,275,0,0,0,1.0,1,1.0,1,1.0,1,0.11651512050938961,36
209,2,433,158,275,0,0,0,1.0,1,1.0,1,1.0,1,0.15297523826045592,36
210,1,434,159,275,0,0,0,1.0,1,1.0,1,1.0,1,0.21105401150467154,36
211,1,435,159,276,0,0,0,1.0,1,1.0,1,1.0,1,0.19039405016980374,34
212,1,436,160,276,0,0,0,1.0,1,1.0,1,1.0,1,0.243493524654228,34
213,5,441,160,281,0,0,0,1.0,1,1.0,1,1.0,1,0.20753820854700164,36
214,3,444,162,282,0,0,0,1.0,1,1.0,1,1.0,1,0.25641740356966763,35
215,5,449,162,287,0,0,0,1.0,1,1.0,1,1.0,1,0.17658842835699282,35
216,2,451,162,289,0,0,0,1.0,1,1.0,1,1.0,1,0.12436058147519617,37
217,0,451,162,289,0,0,0,1.0,1,1.0,1,1.0,1,0.12436058147519617,37
218,2,453,164,289,0,0,0,1.0,1,1.0,1,1.0,1,0.11694322054517844,37
219,2,455,165,290,0,0,0,1.0,1,1.0,1,1.0,1,0.10758577871920051,37
220,0,455,165,290,0,0,0,1.0,1,1.0,1,1.0,1,0.11683723641149897,38
221,0,455,165,290,0,0,0,1.0,1,1.0,1,1.0,1,0.1026300630444111,39
222,1,456,166,290,0,0,0,1.0,1,1.0,1,1.0,1,0.10789097906598116,39
223,4,460,168,292,0,0,0,1.0,1,1.0,1,1.0,1,0.11344579546126686,40
224,1,461,169,292,0,0,0,1.0,1,1.0,1,1.0,1,0.11250332586879538,40
225,3,464,169,295,0,0,0,1.0,1,1.0,1,1.0,1,0.07832651691244231,39
226,5,469,173,296,0,0,0,1.0,1,1.0,1,1.0,1,0.17716170622055313,39
227,5,474,174,300,0,0,0,1.0,1,1.0,1,1.0,1,0.15775726254134603,39
228,2,476,176,300,0,0,0,1.0,1,1.0,1,1.0,1,0.18719506328484706,38
229,3,479,177,302,0,0,0,1.0,1,1.0,1,1.0,1,0.1540985139111376,39
230,1,480,178,302,0,0,0,1.0,1,1.0,1,1.0,1,0.14540821187472183,38
231,3,483,179,304,0,0,0,1.0,1,1.0,1,1.0,1,0.12935027181024247,38
232,2,485,180,305,0,0,0,1.0,1,1.0,1,1.0,1,0.14892965153324975,37
233,2,487,181,306,0,0,0,1.0,1,1.0,1,1.0,1,0.14041263141782337,36
234,0,487,181,306,0,0,0,1.0,1,1.0,1,1.0,1,0.1730603867459094,34
235,2,489,183,306,0,0,0,1.0,1,1.0,1,1.0,1,0.232827039734032,34
236,0,489,183,306,0,0,0,1.0,1,1.0,1,1.0,1,0.25124586600690674,33
237,1,490,183,307,0,0,0,1.0,1,1.0,1,1.0,1,0.2618824685455121,32
238,0,490,183,307,0,0,0,1.0,1,1.0,1,1.0,1,0.26299771898142105,32
239,2,492,185,307,0,0,0,1.0,1,1.0,1,1.0,1,0.2272335367926179,31
240,0,492,185,307,0,0,0,1.0,1,1.0,1,1.0,1,0.22277014265888231,28
241,4,496,186,310,0,0,0,1.0,1,1.0,1,1.0,1,0.20318707479114836,27
242,1,497,186,311,0,0,0,1.0,1,1.0,1,1.0,1,0.19550242018574635,29
243,2,499,187,312,0,0,0,1.0,1,1.0,1,1.0,1,0.17242980332995242,28
244,1,500,188,312,0,0,0,1.0,1,1.0,1,1.0,1,0.20035126911412385,28
245,1,501,189,312,0,0,0,1.0,1,1.0,1,1.0,1,0.18284384467716505,27
246,2,503,191,312,0,0,0,1.0,1,1.0,1,1.0,1,0.1809579274355199,25
247,3,506,192,314,0,0,0,1.0,1,1.0,1,1.0,1,0.15078762476451166,26
248,0,506,192,314,0,0,0,1.0,1,1.0,1,1.0,1,0.18295371316140402,27
249,1,507,193,314,0,0,0,1.0,1,1.0,1,1.0,1,0.14893730604026723,26
250,1,508,193,315,0,0,0,1.0,1,1.0,1,1.0,1,0.16941969519150404,27
251,2,510,194,316,0,0,0,1.0,1,1.0,1,1.0,1,0.1784778055866757,28
252,0,510,194,316,0,0,0,1.0,1,1.0,1,1.0,1,0.1784778055866757,28
253,1,511,195,316,0,0,0,1.0,1,1.0,1,1.0,1,0.17649079723669056,28
254,2,513,195,318,0,0,0,1.0,1,1.0,1,1.0,1,0.15802455679398716,29
255,2,515,196,319,0,0,0,1.0,1,1.0,1,1.0,1,0.19329649557254946,30
256,0,515,196,319,0,0,0,1.0,1,1.0,1,1.0,1,0.19329649557254946,30
257,3,518,197,321,0,0,0,1.0,1,1.0,1,1.0,1,0.20167524269438286,32
258,4,522,198,324,0,0,0,1.0,1,1.0,1,1.0,1,0.20806707596772187,32
259,1,523,198,325,0,0,0,1.0,1,1.0,1,1.0,1,0.18683237261621255,32
260,0,523,198,325,0,0,0,1.0,1,1.0,1,1.0,1,0.13804814838289334,34
261,0,523,198,325,0,0,0,1.0,1,1.0,1,1.0,1,0.15621436176444994,35
262,4,527,200,327,0,0,0,1.0,1,1.0,1,1.0,1,0.20025161041869555,36
263,0,527,200,327,0,0,0,1.0,1,1.0,1,1.0,1,0.20035186210442488,34
264,1,528,200,328,0,0,0,1.0,1,1.0,1,1.0,1,0.15664675835696226,34
265,0,528,200,328,0,0,0,1.0,1,1.0,1,1.0,1,0.1856082031627458,33
266,1,529,201,328,0,0,0,1.0,1,1.0,1,1.0,1,0.21151103774099433,34
267,0,529,201,328,0,0,0,1.0,1,1.0,1,1.0,1,0.22299805429147146,33
268,2,531,201,330,0,0,0,1.0,1,1.0,1,1.0,1,0.2169698954724752,34
269,0,531,201,330,0,0,0,1.0,1,1.0,1,1.0,1,0.2169698954724752,34
270,1,532,201,331,0,0,0,1.0,1,1.0,1,1.0,1,0.20866016917109373,36
271,0,532,201,331,0,0,0,1.0,1,1.0,1,1.0,1,0.20866016917109373,36
272,2,534,201,333,0,0,0,1.0,1,1.0,1,1.0,1,0.20117139870697695,38
273,1,535,201,334,0,0,0,1.0,1,1.0,1,1.0,1,0.1836633192898693,38
274,2,537,202,335,0,0,0,1.0,1,1.0,1,1.0,1,0.18191967584261554,38
275,2,539,202,337,0,0,0,1.0,1,1.0,1,1.0,1,0.15860589410995926,38
276,2,541,202,339,0,0,0,1.0,1,1.0,1,1.0,1,0.13665442546059478,39
277,1,542,203,339,0,0,0,1.0,1,1.0,1,1.0,1,0.1770944657324216,38
278,4,546,203,343,0,0,0,1.0,1,1.0,1,1.0,1,0.1267662309243494,38
279,2,548,203,345,0,0,0,1.0,1,1.0,1,1.0,1,0.0914228074453942,38
280,1,549,204,345,0,0,0,1.0,1,1.0,1,1.0,1,0.12196672447447417,38
281,0,549,204,345,0,0,0,1.0,1,1.0,1,1.0,1,0.1126309444276312,38
282,0,549,204,345,0,0,0,1.0,1,1.0,1,1.0,1,0.11961459840659595,38
283,1,550,205,345,0,0,0,1.0,1,1.0,1,1.0,1,0.13570857501120262,38
284,0,550,205,345,0,0,0,1.0,1,1.0,1,1.0,1,0.13609783764527564,39
285,1,551,206,345,0,0,0,1.0,1,1.0,1,1.0,1,0.1741489987886012,39
286,0,551,206,345,0,0,0,1.0,1,1.0,1,1.0,1,0.1741489987886012,39
287,3,554,206,348,0,0,0,1.0,1,1.0,1,1.0,1,0.18049544370286685,39
288,2,556,206,350,0,0,0,1.0,1,1.0,1,1.0,1,0.1309509577545196,39
289,0,556,206,350,0,0,0,1.0,1,1.0,1,1.0,1,0.1309509577545196,39
290,1,557,207,350,0,0,0,1.0,1,1.0,1,1.0,1,0.14810446630900492,39
291,2,559,208,351,0,0,0,1.0,1,1.0,1,1.0,1,0.13870314116008134,39
292,1,560,208,352,0,0,0,1.0,1,1.0,1,1.0,1,0.1227333872620618,40
293,2,562,208,354,0,0,0,1.0,1,1.0,1,1.0,1,0.08791883648887694,41
294,1,563,209,354,0,0,0,1.0,1,1.0,1,1.0,1,0.07451347050853814,40
295,5,568,212,356,0,0,0,1.0,1,1.0,1,1.0,1,0.12465855871041824,42
296,2,570,214,356,0,0,0,1.0,1,1.0,1,1.0,1,0.1198482380211792,42
297,2,572,215,357,0,0,0,1.0,1,1.0,1,1.0,1,0.11475013393334885,43
298,2,574,216,358,0,0,0,1.0,1,1.0,1,1.0,1,0.1593850531064274,44
299,3,577,217,360,0,0,0,1.0,1,1.0,1,1.0,1,0.11496112144073728,44
300,4,581,217,364,0,0,0,1.0,1,1.0,1,1.0,1,0.07975928252673115,45
301,2,583,219,364,0,0,0,1.0,1,1.0,1,1.0,1,0.1157625261808519,47
302,3,586,220,366,0,0,0,1.0,1,1.0,1,1.0,1,0.10629658753880869,46
303,3,589,222,367,0,0,0,1.0,1,1.0,1,1.0,1,0.10005306622805034,45
304,2,591,224,367,0,0,0,1.0,1,1.0,1,1.0,1,0.12647266959889114,45
305,1,592,224,368,0,0,0,1.0,1,1.0,1,1.0,1,0.0988859064918484,43
306,1,593,224,369,0,0,0,1.0,1,1.0,1,1.0,1,0.13218174204232808,44
307,5,598,226,372,0,0,0,1.0,1,1.0,1,1.0,1,0.1312817780080066,42
308,1,599,227,372,0,0,0,1.0,1,1.0,1,1.0,1,0.1453588985977587,41
309,2,601,227,374,0,0,0,1.0,1,1.0,1,1.0,1,0.11642937327271882,42
310,0,601,227,374,0,0,0,1.0,1,1.0,1,1.0,1,0.09942782393450582,41
311,1,602,227,375,0,0,0,1.0,1,1.0,1,1.0,1,0.08041921837836478,41
312,0,602,227,375,0,0,0,1.0,1,1.0,1,1.0,1,0.0756006184158273,44
313,0,602,227,375,0,0,0,1.0,1,1.0,1,1.0,1,0.06679799989866395,43
314,2,604,228,376,0,0,0,1.0,1,1.0,1,1.0,1,0.06567714495455385,43
315,1,605,229,376,0,0,0,1.0,1,1.0,1,1.0,1,0.11780849117546241,43
316,0,605,229,376,0,0,0,1.0,1,1.0,1,1.0,1,0.11780849117546241,43
317,1,606,229,377,0,0,0,1.0,1,1.0,1,1.0,1,0.11217473783511836,44
318,3,609,232,377,0,0,0,1.0,1,1.0,1,1.0,1,0.21859332092047534,45
319,3,612,232,380,0,0,0,1.0,1,1.0,1,1.0,1,0.1508258122237812,46
320,2,614,233,381,0,0,0,1.0,1,1.0,1,1.0,1,0.19297918500540429,45
321,2,616,233,383,0,0,0,1.0,1,1.0,1,1.0,1,0.13860115698139291,44
322,0,616,233,383,0,0,0,1.0,1,1.0,1,1.0,1,0.13197112039590647,42
323,3,619,235,384,0,0,0,1.0,1,1.0,1,1.0,1,0.07691671014493484,42
324,0,619,235,384,0,0,0,1.0,1,1.0,1,1.0,1,0.07330959950277102,43
325,2,621,237,384,0,0,0,1.0,1,1.0,1,1.0,1,0.14293117606397704,43
326,0,621,237,384,0,0,0,1.0,1,1.0,1,1.0,1,0.14293117606397704,43
327,3,624,239,385,0,0,0,1.0,1,1.0,1,1.0,1,0.13117130504133112,44
328,0,624,239,385,0,0,0,1.0,1,1.0,1,1.0,1,0.13117130504133112,44
329,0,624,239,385,0,0,0,1.0,1,1.0,1,1.0,1,0.1151118971344683,45
330,0,624,239,385,0,0,0,1.0,1,1.0,1,1.0,1,0.1282539863813086,46
331,0,624,239,385,0,0,0,1.0,1,1.0,1,1.0,1,0.1282539863813086,46
332,0,624,239,385,0,0,0,1.0,1,1.0,1,1.0,1,0.10602385004671543,47
333,1,625,239,386,0,0,0,1.0,1,1.0,1,1.0,1,0.10558737083314391,48
334,0,625,239,386,0,0,0,1.0,1,1.0,1,1.0,1,0.10558737083314391,48
335,1,626,240,386,0,0,0,1.0,1,1.0,1,1.0,1,0.10747245958367128,49
336,3,629,240,389,0,0,0,1.0,1,1.0,1,1.0,1,0.09700232570503498,50
337,2,631,241,390,0,0,0,1.0,1,1.0,1,1.0,1,0.10496689325206332,51
338,0,631,241,390,0,0,0,1.0,1,1.0,1,1.0,1,0.10496689325206332,51
339,2,633,242,391,0,0,0,1.0,1,1.0,1,1.0,1,0.1064359168075744,51
340,1,634,243,391,0,0,0,1.0,1,1.0,1,1.0,1,0.13374078784003043,51
341,2,636,243,393,0,0,0,1.0,1,1.0,1,1.0,1,0.08834841843378415,51
342,1,637,244,393,0,0,0,1.0,1,1.0,1,1.0,1,0.11475524011613622,51
343,1,638,244,394,0,0,0,1.0,1,1.0,1,1.0,1,0.11023991497573704,51
344,1,639,245,394,0,0,0,1.0,1,1.0,1,1.0,1,0.10356276605080142,50
345,0,639,245,394,0,0,0,1.0,1,1.0,1,1.0,1,0.10356276605080142,50
346,4,643,247,396,0,0,0,1.0,1,1.0,1,1.0,1,0.1535698210328174,50
347,3,646,247,399,0,0,0,1.0,1,1.0,1,1.0,1,0.11254503735882253,51
348,0,646,247,399,0,0,0,1.0,1,1.0,1,1.0,1,0.10857899353937062,52
349,3,649,249,400,0,0,0,1.0,1,1.0,1,1.0,1,0.114483756348371,54
350,3,652,249,403,0,0,0,1.0,1,1.0,1,1.0,1,0.12223348429164159,54
351,6,658,253,405,0,0,0,1.0,1,1.0,1,1.0,1,0.18928859842630347,54
352,5,663,254,409,0,0,0,1.0,1,1.0,1,1.0,1,0.18283224986851365,56
353,6,669,256,413,0,0,0,1.0,1,1.0,1,1.0,1,0.13307497930405612,54
354,1,670,256,414,0,0,0,1.0,1,1.0,1,1.0,1,0.15096121960789302,53
355,2,672,257,415,0,0,0,1.0,1,1.0,1,1.0,1,0.1266522552475223,54
356,0,672,257,415,0,0,0,1.0,1,1.0,1,1.0,1,0.12734310724558967,54
357,4,676,258,418,0,0,0,1.0,1,1.0,1,1.0,1,0.13370042490940348,53
358,0,676,258,418,0,0,0,1.0,1,1.0,1,1.0,1,0.17004156286127506,49
359,2,678,258,420,0,0,0,1.0,1,1.0,1,1.0,1,0.14801436237813298,48
360,1,679,258,421,0,0,0,1.0,1,1.0,1,1.0,1,0.1550182445646555,47
361,3,682,258,424,0,0,0,1.0,1,1.0,1,1.0,1,0.12333573983748036,46
362,0,682,258,424,0,0,0,1.0,1,1.0,1,1.0,1,0.12289185389782645,46
363,1,683,258,425,0,0,0,1.0,1,1.0,1,1.0,1,0.12584949461514125,47
364,0,683,258,425,0,0,0,1.0,1,1.0,1,1.0,1,0.12584949461514125,47
365,1,684,258,426,0,0,0,1.0,1,1.0,1,1.0,1,0.10656538530228135,47
366,7,691,260,431,0,0,0,1.0,1,1.0,1,1.0,1,0.11604627764416983,50
367,2,693,261,432,0,0,0,1.0,1,1.0,1,1.0,1,0.11993552643893692,50
368,1,694,261,433,0,0,0,1.0,1,1.0,1,1.0,1,0.08611642164154722,51
369,0,694,261,433,0,0,0,1.0,1,1.0,1,1.0,1,0.10505583169948851,51
370,0,694,261,433,0,0,0,1.0,1,1.0,1,1.0,1,0.10505583169948851,51
371,0,694,261,433,0,0,0,1.0,1,1.0,1,1.0,1,0.12929989813092282,52
372,2,696,261,435,0,0,0,1.0,1,1.0,1,1.0,1,0.11811670081850777,53
373,1,697,262,435,0,0,0,1.0,1,1.0,1,1.0,1,0.11880340462910728,53
374,6,703,264,439,0,0,0,1.0,1,1.0,1,1.0,1,0.08291748159211902,53
375,2,705,266,439,0,0,0,1.0,1,1.0,1,1.0,1,0.09446000013243268,53
376,1,706,267,439,0,0,0,1.0,1,1.0,1,1.0,1,0.0999122107097274,53
377,4,710,270,440,0,0,0,1.0,1,1.0,1,1.0,1,0.11363100813123644,53
378,2,712,272,440,0,0,0,1.0,1,1.0,1,1.0,1,0.09646304069044125,53
379,3,715,273,442,0,0,0,1.0,1,1.0,1,1.0,1,0.0872645501415179,54
380,2,717,274,443,0,0,0,1.0,1,1.0,1,1.0,1,0.0860148921732777,54
381,1,718,275,443,0,0,0,1.0,1,1.0,1,1.0,1,0.09009717371393103,54
382,3,721,276,445,0,0,0,1.0,1,1.0,1,1.0,1,0.08698154775346145,55
383,2,723,277,446,0,0,0,1.0,1,1.0,1,1.0,1,0.07838728738753599,55
384,0,723,277,446,0,0,0,1.0,1,1.0,1,1.0,1,0.08084521435793922,54
385,1,724,277,447,0,0,0,1.0,1,1.0,1,1.0,1,0.08105129603636695,52
386,2,726,278,448,0,0,0,1.0,1,1.0,1,1.0,1,0.07918633998344646,52
387,2,728,279,449,0,0,0,1.0,1,1.0,1,1.0,1,0.09448392198101557,50
388,3,731,280,451,0,0,0,1.0,1,1.0,1,1.0,1,0.09984664006474533,52
389,1,732,281,451,0,0,0,1.0,1,1.0,1,1.0,1,0.12481636520358101,51
390,2,734,282,452,0,0,0,1.0,1,1.0,1,1.0,1,0.13302341116454428,50
391,7,741,286,455,0,0,0,1.0,1,1.0,1,1.0,1,0.10804009404393088,49
392,6,747,288,459,0,0,0,1.0,1,1.0,1,1.0,1,0.12374390968184987,47
393,6,753,290,463,0,0,0,1.0,1,1.0,1,1.0,1,0.15521712523451192,47
394,7,760,292,468,0,0,0,1.0,1,1.0,1,1.0,1,0.13000787274325293,48
395,3,763,293,470,0,0,0,1.0,1,1.0,1,1.0,1,0.11379125646581643,46
396,4,767,295,472,0,0,0,1.0,1,1.0,1,1.0,1,0.08232362989427851,43
397,0,767,295,472,0,0,0,1.0,1,1.0,1,1.0,1,0.08318172369438095,42
398,1,768,296,472,0,0,0,1.0,1,1.0,1,1.0,1,0.12737291323579863,40
399,2,770,297,473,0,0,0,1.0,1,1.0,1,1.0,1,0.15218182914458056,39
400,1,771,298,473,0,0,0,1.0,1,1.0,1,1.0,1,0.1324924897216287,38
401,1,772,298,474,0,0,0,1.0,1,1.0,1,1.0,1,0.1152712782848383,37
402,0,772,298,474,0,0,0,1.0,1,1.0,1,1.0,1,0.12161434925721959,36
403,1,773,299,474,0,0,0,1.0,1,1.0,1,1.0,1,0.09699433824851572,38
404,2,775,300,475,0,0,0,1.0,1,1.0,1,1.0,1,0.07984903221765371,39
405,0,775,300,475,0,0,0,1.0,1,1.0,1,1.0,1,0.06229459044800442,40
406,1,776,301,475,0,0,0,1.0,1,1.0,1,1.0,1,0.08220474425476518,41
407,0,776,301,475,0,0,0,1.0,1,1.0,1,1.0,1,0.08983751748747812,42
408,0,776,301,475,0,0,0,1.0,1,1.0,1,1.0,1,0.10520423753290084,43
409,1,777,302,475,0,0,0,1.0,1,1.0,1,1.0,1,0.12147600880241305,44
410,2,779,302,477,0,0,0,1.0,1,1.0,1,1.0,1,0.11918675716733193,46
411,1,780,303,477,0,0,0,1.0,1,1.0,1,1.0,1,0.13693048821106546,46
412,1,781,303,478,0,0,0,1.0,1,1.0,1,1.0,1,0.13325460216826715,47
413,1,782,304,478,0,0,0,1.0,1,1.0,1,1.0,1,0.1622417230775237,47
414,1,783,304,479,0,0,0,1.0,1,1.0,1,1.0,1,0.14944313754877195,47
415,3,786,304,482,0,0,0,1.0,1,1.0,1,1.0,1,0.12801371021646882,48
416,2,788,305,483,0,0,0,1.0,1,1.0,1,1.0,1,0.14848307028144409,49
417,2,790,305,485,0,0,0,1.0,1,1.0,1,1.0,1,0.09511607373037927,49
418,3,793,307,486,0,0,0,1.0,1,1.0,1,1.0,1,0.14252204904873317,50
419,2,795,307,488,0,0,0,1.0,1,1.0,1,1.0,1,0.10062479157060025,50
420,0,795,307,488,0,0,0,1.0,1,1.0,1,1.0,1,0.10062479157060025,50
421,1,796,308,488,0,0,0,1.0,1,1.0,1,1.0,1,0.12703485465200398,50
422,0,796,308,488,0,0,0,1.0,1,1.0,1,1.0,1,0.14563313665422817,50
423,5,801,309,492,0,0,0,1.0,1,1.0,1,1.0,1,0.1438689086116796,51
424,1,802,309,493,0,0,0,1.0,1,1.0,1,1.0,1,0.1446656087012581,49
425,2,804,310,494,0,0,0,1.0,1,1.0,1,1.0,1,0.1526887855433141,48
426,6,810,312,498,0,0,0,1.0,1,1.0,1,1.0,1,0.09188756001047164,50
427,3,813,313,500,0,0,0,1.0,1,1.0,1,1.0,1,0.055788130922222984,48
428,3,816,315,501,0,0,0,1.0,1,1.0,1,1.0,1,0.12407042859600353,49
429,2,818,316,502,0,0,0,1.0,1,1.0,1,1.0,1,0.09924694974099937,45
430,2,820,318,502,0,0,0,1.0,1,1.0,1,1.0,1,0.13374427540235903,44
431,1,821,318,503,0,0,0,1.0,1,1.0,1,1.0,1,0.08769041998119935,42
432,0,821,318,503,0,0,0,1.0,1,1.0,1,1.0,1,0.12873950245371438,40
433,1,822,319,503,0,0,0,1.0,1,1.0,1,1.0,1,0.16397049763039648,39
434,2,824,319,505,0,0,0,1.0,1,1.0,1,1.0,1,0.1360977731180703,39
435,4,828,320,508,0,0,0,1.0,1,1.0,1,1.0,1,0.125343311799652,38
436,3,831,321,510,0,0,0,1.0,1,1.0,1,1.0,1,0.09577171816115539,38
437,0,831,321,510,0,0,0,1.0,1,1.0,1,1.0,1,0.1004606875530124,39
438,2,833,322,511,0,0,0,1.0,1,1.0,1,1.0,1,0.12522612251332432,38
439,1,834,322,512,0,0,0,1.0,1,1.0,1,1.0,1,0.1382183826461538,39
440,0,834,322,512,0,0,0,1.0,1,1.0,1,1.0,1,0.1382183826461538,39
441,1,835,323,512,0,0,0,1.0,1,1.0,1,1.0,1,0.1475526715151759,41
442,5,840,323,517,0,0,0,1.0,1,1.0,1,1.0,1,0.08018212822234716,42
443,2,842,324,518,0,0,0,1.0,1,1.0,1,1.0,1,0.09302466564184403,42
444,0,842,324,518,0,0,0,1.0,1,1.0,1,1.0,1,0.0986593581810639,43
445,3,845,325,520,0,0,0,1.0,1,1.0,1,1.0,1,0.08291177913583302,44
446,1,846,326,520,0,0,0,1.0,1,1.0,1,1.0,1,0.06923952808253465,44
447,2,848,328,520,0,0,0,1.0,1,1.0,1,1.0,1,0.11114947604189299,47
448,0,848,328,520,0,0,0,1.0,1,1.0,1,1.0,1,0.11354581438153614,46
449,1,849,328,521,0,0,0,1.0,1,1.0,1,1.0,1,0.10264206801856492,46
450,0,849,328,521,0,0,0,1.0,1,1.0,1,1.0,1,0.14106319249734106,46
451,2,851,328,523,0,0,0,1.0,1,1.0,1,1.0,1,0.12056448547797015,47
452,0,851,328,523,0,0,0,1.0,1,1.0,1,1.0,1,0.1495797355294095,47
453,0,851,328,523,0,0,0,1.0,1,1.0,1,1.0,1,0.1495797355294095,47
454,1,852,328,524,0,0,0,1.0,1,1.0,1,1.0,1,0.1261459162822133,46
455,2,854,329,525,0,0,0,1.0,1,1.0,1,1.0,1,0.11653643277096248,47
456,4,858,330,528,0,0,0,1.0,1,1.0,1,1.0,1,0.08678269520936464,49
457,3,861,331,530,0,0,0,1.0,1,1.0,1,1.0,1,0.08714584452745378,50
458,0,861,331,530,0,0,0,1.0,1,1.0,1,1.0,1,0.08714584452745378,50
459,3,864,331,533,0,0,0,1.0,1,1.0,1,1.0,1,0.05040058429881603,52
460,0,864,331,533,0,0,0,1.0,1,1.0,1,1.0,1,0.06735623990245611,53
461,1,865,331,534,0,0,0,1.0,1,1.0,1,1.0,1,0.06807256872472385,54
462,0,865,331,534,0,0,0,1.0,1,1.0,1,1.0,1,0.06807256872472385,54
463,7,872,334,538,0,0,0,1.0,1,1.0,1,1.0,1,0.07806889031743465,55
464,2,874,334,540,0,0,0,1.0,1,1.0,1,1.0,1,0.07694373586582473,56
465,3,877,335,542,0,0,0,1.0,1,1.0,1,1.0,1,0.06127562770837346,54
466,4,881,338,543,0,0,0,1.0,1,1.0,1,1.0,1,0.1298008966728938,54
467,5,886,339,547,0,0,0,1.0,1,1.0,1,1.0,1,0.12743081218154323,51
468,6,892,344,548,0,0,0,1.0,1,1.0,1,1.0,1,0.18113940141031348,51
469,4,896,345,551,0,0,0,1.0,1,1.0,1,1.0,1,0.1256511845549298,48
470,3,899,347,552,0,0,0,1.0,1,1.0,1,1.0,1,0.13662466755896668,47
471,2,901,349,552,0,0,0,1.0,1,1.0,1,1.0,1,0.1290366452400902,44
472,4,905,351,554,0,0,0,1.0,1,1.0,1,1.0,1,0.16294080571758823,43
473,1,906,351,555,0,0,0,1.0,1,1.0,1,1.0,1,0.1623413961542686,41
474,2,908,352,556,0,0,0,1.0,1,1.0,1,1.0,1,0.17348753562665392,39
475,4,912,353,559,0,0,0,1.0,1,1.0,1,1.0,1,0.12232865299234923,40
476,3,915,354,561,0,0,0,1.0,1,1.0,1,1.0,1,0.10333252046468447,38
477,2,917,356,561,0,0,0,1.0,1,1.0,1,1.0,1,0.17906606200075803,35
478,2,919,357,562,0,0,0,1.0,1,1.0,1,1.0,1,0.2007117869647173,35
479,0,919,357,562,0,0,0,1.0,1,1.0,1,1.0,1,0.24471647858960865,32
480,1,920,357,563,0,0,0,1.0,1,1.0,1,1.0,1,0.23346788855275843,32
481,1,921,357,564,0,0,0,1.0,1,1.0,1,1.0,1,0.21179467064662869,33
482,5,926,360,566,0,0,0,1.0,1,1.0,1,1.0,1,0.2567041970943666,34
483,1,927,360,567,0,0,0,1.0,1,1.0,1,1.0,1,0.23155918090553262,32
484,4,931,361,570,0,0,0,1.0,1,1.0,1,1.0,1,0.18688854175394323,33
485,5,936,362,574,0,0,0,1.0,1,1.0,1,1.0,1,0.12745740890394844,34
486,3,939,362,577,0,0,0,1.0,1,1.0,1,1.0,1,0.10529632778864795,36
487,1,940,362,578,0,0,0,1.0,1,1.0,1,1.0,1,0.07197178765444259,36
488,0,940,362,578,0,0,0,1.0,1,1.0,1,1.0,1,0.0895666089966104,37
489,2,942,364,578,0,0,0,1.0,1,1.0,1,1.0,1,0.14170314569141565,38
490,1,943,365,578,0,0,0,1.0,1,1.0,1,1.0,1,0.13629570847177916,38
491,1,944,365,579,0,0,0,1.0,1,1.0,1,1.0,1,0.11497897518377909,37
492,2,946,366,580,0,0,0,1.0,1,1.0,1,1.0,1,0.13077853123500588,37
493,1,947,366,581,0,0,0,1.0,1,1.0,1,1.0,1,0.09778198734971304,37
494,0,947,366,581,0,0,0,1.0,1,1.0,1,1.0,1,0.1258546468904834,39
495,0,947,366,581,0,0,0,1.0,1,1.0,1,1.0,1,0.12761838754683436,40
496,0,947,366,581,0,0,0,1.0,1,1.0,1,1.0,1,0.12761838754683436,40
497,2,949,366,583,0,0,0,1.0,1,1.0,1,1.0,1,0.09685018948607482,43
498,1,950,367,583,0,0,0,1.0,1,1.0,1,1.0,1,0.10479653007880566,43
499,3,953,369,584,0,0,0,1.0,1,1.0,1,1.0,1,0.1640203032100278,44
500,4,957,370,587,0,0,0,1.0,1,1.0,1,1.0,1,0.09382252733763263,45
501,4,961,371,590,0,0,0,1.0,1,1.0,1,1.0,1,0.07609645186921574,45
502,2,963,373,590,0,0,0,1.0,1,1.0,1,1.0,1,0.10971196637046579,45
503,4,967,376,591,0,0,0,1.0,1,1.0,1,1.0,1,0.13806172766046085,46
504,4,971,377,594,0,0,0,1.0,1,1.0,1,1.0,1,0.16101665089380895,47
505,3,974,377,597,0,0,0,1.0,1,1.0,1,1.0,1,0.11563032810426097,42
506,3,977,380,597,0,0,0,1.0,1,1.0,1,1.0,1,0.18109013260522652,41
507,1,978,380,598,0,0,0,1.0,1,1.0,1,1.0,1,0.18564112851508796,38
508,1,979,381,598,0,0,0,1.0,1,1.0,1,1.0,1,0.19696831221758465,38
509,1,980,381,599,0,0,0,1.0,1,1.0,1,1.0,1,0.19110499733434994,37
510,1,981,382,599,0,0,0,1.0,1,1.0,1,1.0,1,0.20683550251367083,36
511,2,983,383,600,0,0,0,1.0,1,1.0,1,1.0,1,0.21247321195236443,34
512,0,983,383,600,0,0,0,1.0,1,1.0,1,1.0,1,0.21611044471431562,32
513,2,985,383,602,0,0,0,1.0,1,1.0,1,1.0,1,0.1139311628644938,32
514,1,986,383,603,0,0,0,1.0,1,1.0,1,1.0,1,0.10647704283938618,35
515,0,986,383,603,0,0,0,1.0,1,1.0,1,1.0,1,0.10647704283938618,35
516,1,987,383,604,0,0,0,1.0,1,1.0,1,1.0,1,0.12384287873126915,36
517,0,987,383,604,0,0,0,1.0,1,1.0,1,1.0,1,0.12384287873126915,36
518,0,987,383,604,0,0,0,1.0,1,1.0,1,1.0,1,0.159135171045936,39
519,1,988,384,604,0,0,0,1.0,1,1.0,1,1.0,1,0.1767698831434771,39
520,3,991,386,605,0,0,0,1.0,1,1.0,1,1.0,1,0.20649678843217834,39
521,3,994,387,607,0,0,0,1.0,1,1.0,1,1.0,1,0.16961306051852632,40
522,0,994,387,607,0,0,0,1.0,1,1.0,1,1.0,1,0.16961306051852632,40
523,2,996,387,609,0,0,0,1.0,1,1.0,1,1.0,1,0.14032991828082345,41
524,1,997,388,609,0,0,0,1.0,1,1.0,1,1.0,1,0.14950446044420965,41
525,3,1000,390,610,0,0,0,1.0,1,1.0,1,1.0,1,0.1458685082144043,40
526,1,1001,390,611,0,0,0,1.0,1,1.0,1,1.0,1,0.15440026139227128,40
527,0,1001,390,611,0,0,0,1.0,1,1.0,1,1.0,1,0.15440026139227128,40
528,0,1001,390,611,0,0,0,1.0,1,1.0,1,1.0,1,0.15440026139227128,40
529,1,1002,390,612,0,0,0,1.0,1,1.0,1,1.0,1,0.15508059877885194,39
530,1,1003,391,612,0,0,0,1.0,1,1.0,1,1.0,1,0.17001592144769784,39
531,2,1005,392,613,0,0,0,1.0,1,1.0,1,1.0,1,0.16905436558338846,39
532,3,1008,392,616,0,0,0,1.0,1,1.0,1,1.0,1,0.10291031869509815,40
533,1,1009,393,616,0,0,0,1.0,1,1.0,1,1.0,1,0.15911806242407328,40
534,3,1012,393,619,0,0,0,1.0,1,1.0,1,1.0,1,0.14498732966381156,42
535,0,1012,393,619,0,0,0,1.0,1,1.0,1,1.0,1,0.14983976704774638,42
536,0,1012,393,619,0,0,0,1.0,1,1.0,1,1.0,1,0.16108740330585963,43
537,0,1012,393,619,0,0,0,1.0,1,1.0,1,1.0,1,0.16108740330585963,43
538,2,1014,394,620,0,0,0,1.0,1,1.0,1,1.0,1,0.17297980019141018,44
539,2,1016,394,622,0,0,0,1.0,1,1.0,1,1.0,1,0.14922000395667573,44
540,1,1017,395,622,0,0,0,1.0,1,1.0,1,1.0,1,0.17172407920757987,44
541,3,1020,396,624,0,0,0,1.0,1,1.0,1,1.0,1,0.137195093395274,45
542,4,1024,397,627,0,0,0,1.0,1,1.0,1,1.0,1,0.1228617566056485,46
543,4,1028,399,629,0,0,0,1.0,1,1.0,1,1.0,1,0.1520874575986032,43
544,1,1029,400,629,0,0,0,1.0,1,1.0,1,1.0,1,0.18516254051398154,42
545,4,1033,402,631,0,0,0,1.0,1,1.0,1,1.0,1,0.11482235121644148,43
546,3,1036,405,631,0,0,0,1.0,1,1.0,1,1.0,1,0.1981683124390252,41
547,3,1039,405,634,0,0,0,1.0,1,1.0,1,1.0,1,0.09531910119417931,40
548,1,1040,406,634,0,0,0,1.0,1,1.0,1,1.0,1,0.09166218404466805,40
549,3,1043,408,635,0,0,0,1.0,1,1.0,1,1.0,1,0.1347540603762878,39
550,1,1044,409,635,0,0,0,1.0,1,1.0,1,1.0,1,0.1623805568271892,38
551,3,1047,410,637,0,0,0,1.0,1,1.0,1,1.0,1,0.13504397378795552,38
552,2,1049,412,637,0,0,0,1.0,1,1.0,1,1.0,1,0.1947570779353943,39
553,1,1050,412,638,0,0,0,1.0,1,1.0,1,1.0,1,0.13343932406112233,38
554,3,1053,413,640,0,0,0,1.0,1,1.0,1,1.0,1,0.12689491610574316,39
555,2,1055,413,642,0,0,0,1.0,1,1.0,1,1.0,1,0.10085965087201756,39
556,2,1057,414,643,0,0,0,1.0,1,1.0,1,1.0,1,0.09881408008915366,40
557,0,1057,414,643,0,0,0,1.0,1,1.0,1,1.0,1,0.10967417042565933,40
558,0,1057,414,643,0,0,0,1.0,1,1.0,1,1.0,1,0.10967417042565933,40
559,1,1058,415,643,0,0,0,1.0,1,1.0,1,1.0,1,0.10779619354337788,40
560,1,1059,415,644,0,0,0,1.0,1,1.0,1,1.0,1,0.1052396635741192,41
561,2,1061,416,645,0,0,0,1.0,1,1.0,1,1.0,1,0.14146915634203688,42
562,2,1063,418,645,0,0,0,1.0,1,1.0,1,1.0,1,0.1716435792249389,42
563,3,1066,419,647,0,0,0,1.0,1,1.0,1,1.0,1,0.1910256118961452,42
564,1,1067,419,648,0,0,0,1.0,1,1.0,1,1.0,1,0.19989960043321772,43
565,4,1071,420,651,0,0,0,1.0,1,1.0,1,1.0,1,0.20504397417236553,44
566,2,1073,420,653,0,0,0,1.0,1,1.0,1,1.0,1,0.19932817430497354,45
567,3,1076,421,655,0,0,0,1.0,1,1.0,1,1.0,1,0.20423664042190456,45
568,3,1079,421,658,0,0,0,1.0,1,1.0,1,1.0,1,0.16764330727943963,46
569,2,1081,423,658,0,0,0,1.0,1,1.0,1,1.0,1,0.16181623956961802,47
570,2,1083,424,659,0,0,0,1.0,1,1.0,1,1.0,1,0.18083114987648202,48
571,2,1085,425,660,0,0,0,1.0,1,1.0,1,1.0,1,0.18386912890127433,48
572,1,1086,425,661,0,0,0,1.0,1,1.0,1,1.0,1,0.1909447738776643,47
573,1,1087,425,662,0,0,0,1.0,1,1.0,1,1.0,1,0.18764501029686093,49
574,3,1090,425,665,0,0,0,1.0,1,1.0,1,1.0,1,0.17230102846316495,49
575,6,1096,425,671,0,0,0,1.0,1,1.0,1,1.0,1,0.11013566143878349,50
576,2,1098,425,673,0,0,0,1.0,1,1.0,1,1.0,1,0.1298720642870058,51
577,5,1103,425,678,0,0,0,1.0,1,1.0,1,1.0,1,0.07841898144049511,51
578,0,1103,425,678,0,0,0,1.0,1,1.0,1,1.0,1,0.07841898144049511,51
579,1,1104,426,678,0,0,0,1.0,1,1.0,1,1.0,1,0.10824235203306382,52
580,3,1107,427,680,0,0,0,1.0,1,1.0,1,1.0,1,0.12400221363645147,52
581,2,1109,427,682,0,0,0,1.0,1,1.0,1,1.0,1,0.10694517876065317,52
582,0,1109,427,682,0,0,0,1.0,1,1.0,1,1.0,1,0.11119338177893229,53
583,0,1109,427,682,0,0,0,1.0,1,1.0,1,1.0,1,0.11237009273249378,51
584,3,1112,430,682,0,0,0,1.0,1,1.0,1,1.0,1,0.13472640141704625,51
585,8,1120,433,687,0,0,0,1.0,1,1.0,1,1.0,1,0.10401208065974216,49
586,0,1120,433,687,0,0,0,1.0,1,1.0,1,1.0,1,0.09560375942696551,49
587,2,1122,434,688,0,0,0,1.0,1,1.0,1,1.0,1,0.09539031946463587,48
588,1,1123,435,688,0,0,0,1.0,1,1.0,1,1.0,1,0.10740950009163629,46
589,3,1126,436,690,0,0,0,1.0,1,1.0,1,1.0,1,0.14463282878334507,48
590,3,1129,438,691,0,0,0,1.0,1,1.0,1,1.0,1,0.15922290150257076,47
591,1,1130,439,691,0,0,0,1.0,1,1.0,1,1.0,1,0.18733789186497346,48
592,1,1131,440,691,0,0,0,1.0,1,1.0,1,1.0,1,0.18574566244138666,47
593,4,1135,443,692,0,0,0,1.0,1,1.0,1,1.0,1,0.21134617321812815,45
594,2,1137,443,694,0,0,0,1.0,1,1.0,1,1.0,1,0.15220344294445787,44
595,0,1137,443,694,0,0,0,1.0,1,1.0,1,1.0,1,0.15748693205666667,43
596,3,1140,445,695,0,0,0,1.0,1,1.0,1,1.0,1,0.1546537284234768,44
597,2,1142,445,697,0,0,0,1.0,1,1.0,1,1.0,1,0.13384603937716197,43
598,6,1148,447,701,0,0,0,1.0,1,1.0,1,1.0,1,0.12246353627391526,45
599,1,1149,448,701,0,0,0,1.0,1,1.0,1,1.0,1,0.15977496702310018,44
600,1,1150,448,702,0,0,0,1.0,1,1.0,1,1.0,1,0.13006619850037562,44
601,1,1151,448,703,0,0,0,1.0,1,1.0,1,1.0,1,0.13402171289173362,45
602,0,1151,448,703,0,0,0,1.0,1,1.0,1,1.0,1,0.14517776890393452,46
603,0,1151,448,703,0,0,0,1.0,1,1.0,1,1.0,1,0.14585583176284667,46
604,3,1154,449,705,0,0,0,1.0,1,1.0,1,1.0,1,0.1243430721493408,47
605,0,1154,449,705,0,0,0,1.0,1,1.0,1,1.0,1,0.1243430721493408,47
606,0,1154,449,705,0,0,0,1.0,1,1.0,1,1.0,1,0.13226341000731598,47
607,1,1155,449,706,0,0,0,1.0,1,1.0,1,1.0,1,0.12219503806461371,48
608,0,1155,449,706,0,0,0,1.0,1,1.0,1,1.0,1,0.14473408418251105,47
609,2,1157,449,708,0,0,0,1.0,1,1.0,1,1.0,1,0.11829608406567693,48
610,1,1158,449,709,0,0,0,1.0,1,1.0,1,1.0,1,0.10836491554455444,48
611,1,1159,450,709,0,0,0,1.0,1,1.0,1,1.0,1,0.10253277081975166,49
612,3,1162,450,712,0,0,0,1.0,1,1.0,1,1.0,1,0.0874959101954842,50
613,1,1163,451,712,0,0,0,1.0,1,1.0,1,1.0,1,0.08454521948237545,50
614,0,1163,451,712,0,0,0,1.0,1,1.0,1,1.0,1,0.08454521948237545,50
615,1,1164,452,712,0,0,0,1.0,1,1.0,1,1.0,1,0.10735485375243285,50
616,0,1164,452,712,0,0,0,1.0,1,1.0,1,1.0,1,0.10735485375243285,50
617,4,1168,452,716,0,0,0,1.0,1,1.0,1,1.0,1,0.06755783559058826,52
618,0,1168,452,716,0,0,0,1.0,1,1.0,1,1.0,1,0.06755783559058826,52
619,0,1168,452,716,0,0,0,1.0,1,1.0,1,1.0,1,0.0638684134682712,50
620,1,1169,453,716,0,0,0,1.0,1,1.0,1,1.0,1,0.12184617575752514,50
621,4,1173,455,718,0,0,0,1.0,1,1.0,1,1.0,1,0.11919388680891256,49
622,0,1173,455,718,0,0,0,1.0,1,1.0,1,1.0,1,0.13315385308993352,49
623,5,1178,457,721,0,0,0,1.0,1,1.0,1,1.0,1,0.11878026199744293,48
624,5,1183,458,725,0,0,0,1.0,1,1.0,1,1.0,1,0.09756228685226268,46
625,1,1184,458,726,0,0,0,1.0,1,1.0,1,1.0,1,0.10025791432513685,45
626,6,1190,461,729,0,0,0,1.0,1,1.0,1,1.0,1,0.09233937282363125,44
627,4,1194,464,730,0,0,0,1.0,1,1.0,1,1.0,1,0.11543151764028187,44
628,3,1197,467,730,0,0,0,1.0,1,1.0,1,1.0,1,0.19010378916661824,44
629,2,1199,468,731,0,0,0,1.0,1,1.0,1,1.0,1,0.14285180870059436,41
630,1,1200,469,731,0,0,0,1.0,1,1.0,1,1.0,1,0.14416663284763764,40
631,2,1202,470,732,0,0,0,1.0,1,1.0,1,1.0,1,0.20057684429294834,38
632,2,1204,471,733,0,0,0,1.0,1,1.0,1,1.0,1,0.20018130082004737,38
633,0,1204,471,733,0,0,0,1.0,1,1.0,1,1.0,1,0.1998212645725459,36
634,1,1205,472,733,0,0,0,1.0,1,1.0,1,1.0,1,0.21422048334958985,35
635,2,1207,472,735,0,0,0,1.0,1,1.0,1,1.0,1,0.1492447115479198,35
636,2,1209,473,736,0,0,0,1.0,1,1.0,1,1.0,1,0.15509034667225927,36
637,0,1209,473,736,0,0,0,1.0,1,1.0,1,1.0,1,0.1645433200819618,35
638,1,1210,474,736,0,0,0,1.0,1,1.0,1,1.0,1,0.2098895855376185,34
639,7,1217,476,741,0,0,0,1.0,1,1.0,1,1.0,1,0.1165110927175839,36
640,0,1217,476,741,0,0,0,1.0,1,1.0,1,1.0,1,0.14269011097797415,37
641,1,1218,476,742,0,0,0,1.0,1,1.0,1,1.0,1,0.11113079790232624,37
642,1,1219,476,743,0,0,0,1.0,1,1.0,1,1.0,1,0.10012005263791399,38
643,1,1220,477,743,0,0,0,1.0,1,1.0,1,1.0,1,0.11595257486614233,39
644,1,1221,478,743,0,0,0,1.0,1,1.0,1,1.0,1,0.1477086474590431,39
645,4,1225,478,747,0,0,0,1.0,1,1.0,1,1.0,1,0.09476365560989773,39
646,3,1228,479,749,0,0,0,1.0,1,1.0,1,1.0,1,0.1297004358408397,40
647,1,1229,479,750,0,0,0,1.0,1,1.0,1,1.0,1,0.12010593461986721,40
648,0,1229,479,750,0,0,0,1.0,1,1.0,1,1.0,1,0.12010593461986721,40
649,0,1229,479,750,0,0,0,1.0,1,1.0,1,1.0,1,0.12010593461986721,40
650,2,1231,480,751,0,0,0,1.0,1,1.0,1,1.0,1,0.13140367481785378,41
651,2,1233,480,753,0,0,0,1.0,1,1.0,1,1.0,1,0.10853914774125734,42
652,1,1234,481,753,0,0,0,1.0,1,1.0,1,1.0,1,0.14721609010145312,41
653,0,1234,481,753,0,0,0,1.0,1,1.0,1,1.0,1,0.14721609010145312,41
654,1,1235,481,754,0,0,0,1.0,1,1.0,1,1.0,1,0.1504629585480958,42
655,2,1237,481,756,0,0,0,1.0,1,1.0,1,1.0,1,0.11116337756527724,45
656,3,1240,484,756,0,0,0,1.0,1,1.0,1,1.0,1,0.16914654750777894,45
657,2,1242,484,758,0,0,0,1.0,1,1.0,1,1.0,1,0.17208194645517125,43
658,4,1246,486,760,0,0,0,1.0,1,1.0,1,1.0,1,0.2051150621031215,43
659,2,1248,487,761,0,0,0,1.0,1,1.0,1,1.0,1,0.18116251383379478,43
660,7,1255,490,765,0,0,0,1.0,1,1.0,1,1.0,1,0.2227186185892201,43
661,3,1258,490,768,0,0,0,1.0,1,1.0,1,1.0,1,0.17366534706361725,41
662,3,1261,492,769,0,0,0,1.0,1,1.0,1,1.0,1,0.20707017353848073,40
663,3,1264,493,771,0,0,0,1.0,1,1.0,1,1.0,1,0.18291335935126002,39
664,3,1267,494,773,0,0,0,1.0,1,1.0,1,1.0,1,0.19088199567310313,36
665,3,1270,495,775,0,0,0,1.0,1,1.0,1,1.0,1,0.16207392250000544,36
666,4,1274,497,777,0,0,0,1.0,1,1.0,1,1.0,1,0.18617278775709142,36
667,1,1275,497,778,0,0,0,1.0,1,1.0,1,1.0,1,0.17492226668677333,35
668,3,1278,498,780,0,0,0,1.0,1,1.0,1,1.0,1,0.16062728102040846,34
669,5,1283,500,783,0,0,0,1.0,1,1.0,1,1.0,1,0.18189989403822185,34
670,3,1286,501,785,0,0,0,1.0,1,1.0,1,1.0,1,0.14472198557091887,32
671,2,1288,502,786,0,0,0,1.0,1,1.0,1,1.0,1,0.09401923189587352,33
672,0,1288,502,786,0,0,0,1.0,1,1.0,1,1.0,1,0.1237276895150322,32
673,0,1288,502,786,0,0,0,1.0,1,1.0,1,1.0,1,0.1237276895150322,32
674,1,1289,503,786,0,0,0,1.0,1,1.0,1,1.0,1,0.15398148243718185,32
675,5,1294,505,789,0,0,0,1.0,1,1.0,1,1.0,1,0.1302195078299251,34
676,1,1295,505,790,0,0,0,1.0,1,1.0,1,1.0,1,0.101041982061137,35
677,0,1295,505,790,0,0,0,1.0,1,1.0,1,1.0,1,0.101041982061137,35
678,0,1295,505,790,0,0,0,1.0,1,1.0,1,1.0,1,0.101041982061137,35
679,2,1297,507,790,0,0,0,1.0,1,1.0,1,1.0,1,0.16675407449380886,36
680,2,1299,507,792,0,0,0,1.0,1,1.0,1,1.0,1,0.1278945610989,37
681,1,1300,507,793,0,0,0,1.0,1,1.0,1,1.0,1,0.0926285912177063,37
682,1,1301,508,793,0,0,0,1.0,1,1.0,1,1.0,1,0.09260153542460134,37
683,2,1303,509,794,0,0,0,1.0,1,1.0,1,1.0,1,0.07934642158805312,38
684,1,1304,510,794,0,0,0,1.0,1,1.0,1,1.0,1,0.11251564488273309,39
685,0,1304,510,794,0,0,0,1.0,1,1.0,1,1.0,1,0.10332329664047622,38
686,0,1304,510,794,0,0,0,1.0,1,1.0,1,1.0,1,0.13510141168171588,37
687,3,1307,512,795,0,0,0,1.0,1,1.0,1,1.0,1,0.2110859905438997,38
688,0,1307,512,795,0,0,0,1.0,1,1.0,1,1.0,1,0.21068126528452488,37
689,2,1309,513,796,0,0,0,1.0,1,1.0,1,1.0,1,0.23662405767849118,39
690,1,1310,513,797,0,0,0,1.0,1,1.0,1,1.0,1,0.23135806318922209,38
691,2,1312,514,798,0,0,0,1.0,1,1.0,1,1.0,1,0.1953712219802924,38
692,1,1313,514,799,0,0,0,1.0,1,1.0,1,1.0,1,0.18620301851786422,38
693,1,1314,515,799,0,0,0,1.0,1,1.0,1,1.0,1,0.20384795311884996,40
694,7,1321,517,804,0,0,0,1.0,1,1.0,1,1.0,1,0.17559654195689797,42
695,3,1324,519,805,0,0,0,1.0,1,1.0,1,1.0,1,0.17992416155096883,40
696,4,1328,520,808,0,0,0,1.0,1,1.0,1,1.0,1,0.19030686254665552,39
697,1,1329,520,809,0,0,0,1.0,1,1.0,1,1.0,1,0.16890426334038128,39
698,3,1332,521,811,0,0,0,1.0,1,1.0,1,1.0,1,0.13959294591136276,37
699,0,1332,521,811,0,0,0,1.0,1,1.0,1,1.0,1,0.1344062053148868,37
700,1,1333,521,812,0,0,0,1.0,1,1.0,1,1.0,1,0.14801417474666673,37
701,3,1336,522,814,0,0,0,1.0,1,1.0,1,1.0,1,0.11682389188527408,37
702,1,1337,523,814,0,0,0,1.0,1,1.0,1,1.0,1,0.14238320850893438,38
703,6,1343,526,817,0,0,0,1.0,1,1.0,1,1.0,1,0.1725774122950785,36
704,4,1347,529,818,0,0,0,1.0,1,1.0,1,1.0,1,0.17420995978506548,36
705,3,1350,531,819,0,0,0,1.0,1,1.0,1,1.0,1,0.17304685562908695,36
706,5,1355,534,821,0,0,0,1.0,1,1.0,1,1.0,1,0.23153988537225786,35
707,5,1360,536,824,0,0,0,1.0,1,1.0,1,1.0,1,0.16379459843540264,36
708,2,1362,537,825,0,0,0,1.0,1,1.0,1,1.0,1,0.14698637606822054,36
709,0,1362,537,825,0,0,0,1.0,1,1.0,1,1.0,1,0.11443025161103297,34
710,1,1363,538,825,0,0,0,1.0,1,1.0,1,1.0,1,0.12499697705744867,34
711,0,1363,538,825,0,0,0,1.0,1,1.0,1,1.0,1,0.11622616165510488,34
712,5,1368,540,828,0,0,0,1.0,1,1.0,1,1.0,1,0.1320187290123256,35
713,1,1369,541,828,0,0,0,1.0,1,1.0,1,1.0,1,0.15697211462273125,34
714,0,1369,541,828,0,0,0,1.0,1,1.0,1,1.0,1,0.16373397791669536,34
715,1,1370,541,829,0,0,0,1.0,1,1.0,1,1.0,1,0.12364158093727212,35
716,1,1371,542,829,0,0,0,1.0,1,1.0,1,1.0,1,0.17250099262155424,33
717,5,1376,545,831,0,0,0,1.0,1,1.0,1,1.0,1,0.2442150985138891,33
718,2,1378,546,832,0,0,0,1.0,1,1.0,1,1.0,1,0.2606363526362597,32
719,1,1379,546,833,0,0,0,1.0,1,1.0,1,1.0,1,0.23470306932574936,32
720,3,1382,547,835,0,0,0,1.0,1,1.0,1,1.0,1,0.2186818894820178,33
721,0,1382,547,835,0,0,0,1.0,1,1.0,1,1.0,1,0.2186818894820178,33
722,7,1389,548,841,0,0,0,1.0,1,1.0,1,1.0,1,0.15391505028421884,34
723,3,1392,548,844,0,0,0,1.0,1,1.0,1,1.0,1,0.12219999287644091,34
724,0,1392,548,844,0,0,0,1.0,1,1.0,1,1.0,1,0.12473997203083466,36
725,0,1392,548,844,0,0,0,1.0,1,1.0,1,1.0,1,0.12473997203083466,36
726,0,1392,548,844,0,0,0,1.0,1,1.0,1,1.0,1,0.12473997203083466,36
727,1,1393,548,845,0,0,0,1.0,1,1.0,1,1.0,1,0.10641289792049988,36
728,1,1394,548,846,0,0,0,1.0,1,1.0,1,1.0,1,0.09354841857864518,37
729,1,1395,548,847,0,0,0,1.0,1,1.0,1,1.0,1,0.06986502692688114,37
730,0,1395,548,847,0,0,0,1.0,1,1.0,1,1.0,1,0.07488112924401938,38
731,2,1397,549,848,0,0,0,1.0,1,1.0,1,1.0,1,0.13849539449857992,39
732,0,1397,549,848,0,0,0,1.0,1,1.0,1,1.0,1,0.12645518400306097,41
733,1,1398,550,848,0,0,0,1.0,1,1.0,1,1.0,1,0.11889678054542335,39
734,3,1401,551,850,0,0,0,1.0,1,1.0,1,1.0,1,0.07708505509461204,39
735,2,1403,553,850,0,0,0,1.0,1,1.0,1,1.0,1,0.15949487344409186,39
736,1,1404,553,851,0,0,0,1.0,1,1.0,1,1.0,1,0.1376991271319173,38
737,2,1406,554,852,0,0,0,1.0,1,1.0,1,1.0,1,0.1489655868355486,39
738,0,1406,554,852,0,0,0,1.0,1,1.0,1,1.0,1,0.15209320162887272,37
739,1,1407,554,853,0,0,0,1.0,1,1.0,1,1.0,1,0.14284125398393144,37
740,1,1408,555,853,0,0,0,1.0,1,1.0,1,1.0,1,0.22199912917393733,35
741,1,1409,555,854,0,0,0,1.0,1,1.0,1,1.0,1,0.24169718371124188,33
742,4,1413,556,857,0,0,0,1.0,1,1.0,1,1.0,1,0.18769457087592278,35
743,4,1417,559,858,0,0,0,1.0,1,1.0,1,1.0,1,0.22253742190407694,35
744,2,1419,560,859,0,0,0,1.0,1,1.0,1,1.0,1,0.19396370738728275,34
745,7,1426,563,863,0,0,0,1.0,1,1.0,1,1.0,1,0.18334158639542508,34
746,3,1429,565,864,0,0,0,1.0,1,1.0,1,1.0,1,0.14084020149270607,33
747,2,1431,565,866,0,0,0,1.0,1,1.0,1,1.0,1,0.11710384537239499,32
748,0,1431,565,866,0,0,0,1.0,1,1.0,1,1.0,1,0.11164695336788191,33
749,0,1431,565,866,0,0,0,1.0,1,1.0,1,1.0,1,0.11164695336788191,33
750,1,1432,566,866,0,0,0,1.0,1,1.0,1,1.0,1,0.11437869866744828,34
751,3,1435,567,868,0,0,0,1.0,1,1.0,1,1.0,1,0.10705996923940264,36
752,1,1436,568,868,0,0,0,1.0,1,1.0,1,1.0,1,0.11550137092961021,35
753,3,1439,570,869,0,0,0,1.0,1,1.0,1,1.0,1,0.1815631534568559,37
754,1,1440,570,870,0,0,0,1.0,1,1.0,1,1.0,1,0.16810304856904412,37
755,2,1442,571,871,0,0,0,1.0,1,1.0,1,1.0,1,0.16320977993071847,35
756,3,1445,571,874,0,0,0,1.0,1,1.0,1,1.0,1,0.12599672786583413,36
757,1,1446,571,875,0,0,0,1.0,1,1.0,1,1.0,1,0.0656818703758247,35
758,0,1446,571,875,0,0,0,1.0,1,1.0,1,1.0,1,0.09328421047043892,36
759,1,1447,572,875,0,0,0,1.0,1,1.0,1,1.0,1,0.14471207069359218,37
760,0,1447,572,875,0,0,0,1.0,1,1.0,1,1.0,1,0.1473248836326084,36
761,0,1447,572,875,0,0,0,1.0,1,1.0,1,1.0,1,0.1473248836326084,36
762,0,1447,572,875,0,0,0,1.0,1,1.0,1,1.0,1,0.16010006308281324,37
763,0,1447,572,875,0,0,0,1.0,1,1.0,1,1.0,1,0.16675210442285734,38
764,0,1447,572,875,0,0,0,1.0,1,1.0,1,1.0,1,0.16675210442285734,38
765,0,1447,572,875,0,0,0,1.0,1,1.0,1,1.0,1,0.16675210442285734,38
766,2,1449,572,877,0,0,0,1.0,1,1.0,1,1.0,1,0.14352341555180403,40
767,3,1452,572,880,0,0,0,1.0,1,1.0,1,1.0,1,0.10779734270543272,41
768,2,1454,573,881,0,0,0,1.0,1,1.0,1,1.0,1,0.1355904951056556,41
769,3,1457,573,884,0,0,0,1.0,1,1.0,1,1.0,1,0.0948619387169296,42
770,2,1459,573,886,0,0,0,1.0,1,1.0,1,1.0,1,0.05710063898642441,41
771,0,1459,573,886,0,0,0,1.0,1,1.0,1,1.0,1,0.0871713511194317,41
772,2,1461,575,886,0,0,0,1.0,1,1.0,1,1.0,1,0.0905664695808782,41
773,1,1462,575,887,0,0,0,1.0,1,1.0,1,1.0,1,0.056804044380228125,41
774,2,1464,577,887,0,0,0,1.0,1,1.0,1,1.0,1,0.13644965592805772,42
775,3,1467,577,890,0,0,0,1.0,1,1.0,1,1.0,1,0.11476840580094222,42
776,0,1467,577,890,0,0,0,1.0,1,1.0,1,1.0,1,0.11476840580094222,42
777,1,1468,577,891,0,0,0,1.0,1,1.0,1,1.0,1,0.09630800197679837,42
778,3,1471,578,893,0,0,0,1.0,1,1.0,1,1.0,1,0.0897587187230115,44
779,1,1472,579,893,0,0,0,1.0,1,1.0,1,1.0,1,0.13733874103224888,44
780,2,1474,579,895,0,0,0,1.0,1,1.0,1,1.0,1,0.10404829315201186,44
781,1,1475,579,896,0,0,0,1.0,1,1.0,1,1.0,1,0.08299857674883815,46
782,1,1476,580,896,0,0,0,1.0,1,1.0,1,1.0,1,0.12309491211217946,45
783,4,1480,581,899,0,0,0,1.0,1,1.0,1,1.0,1,0.13908710957470624,44
784,1,1481,581,900,0,0,0,1.0,1,1.0,1,1.0,1,0.13012526946089467,44
785,3,1484,582,902,0,0,0,1.0,1,1.0,1,1.0,1,0.08253527485575796,43
786,1,1485,583,902,0,0,0,1.0,1,1.0,1,1.0,1,0.07910576425903165,43
787,0,1485,583,902,0,0,0,1.0,1,1.0,1,1.0,1,0.07910576425903165,43
788,5,1490,585,905,0,0,0,1.0,1,1.0,1,1.0,1,0.1370516689274517,45
789,2,1492,586,906,0,0,0,1.0,1,1.0,1,1.0,1,0.1429134287491001,46
790,4,1496,586,910,0,0,0,1.0,1,1.0,1,1.0,1,0.16008425321454162,45
791,3,1499,587,912,0,0,0,1.0,1,1.0,1,1.0,1,0.12836937419966177,46
792,2,1501,588,913,0,0,0,1.0,1,1.0,1,1.0,1,0.11499733683222148,46
793,1,1502,588,914,0,0,0,1.0,1,1.0,1,1.0,1,0.11066833692371557,46
794,2,1504,588,916,0,0,0,1.0,1,1.0,1,1.0,1,0.13369957514044026,47
795,1,1505,588,917,0,0,0,1.0,1,1.0,1,1.0,1,0.11646274193249402,47
796,0,1505,588,917,0,0,0,1.0,1,1.0,1,1.0,1,0.12308218731603807,46
797,4,1509,589,920,0,0,0,1.0,1,1.0,1,1.0,1,0.14632411643131715,47
798,5,1514,590,924,0,0,0,1.0,1,1.0,1,1.0,1,0.12378217768472297,48
799,4,1518,590,928,0,0,0,1.0,1,1.0,1,1.0,1,0.10521505035920632,48
800,2,1520,591,929,0,0,0,1.0,1,1.0,1,1.0,1,0.11980803143917666,48
801,4,1524,592,932,0,0,0,1.0,1,1.0,1,1.0,1,0.11224031838139105,49
802,0,1524,592,932,0,0,0,1.0,1,1.0,1,1.0,1,0.1101206578559933,50
803,3,1527,592,935,0,0,0,1.0,1,1.0,1,1.0,1,0.10378702205625509,49
804,1,1528,592,936,0,0,0,1.0,1,1.0,1,1.0,1,0.09834901188627866,50
805,0,1528,592,936,0,0,0,1.0,1,1.0,1,1.0,1,0.09834901188627866,50
806,0,1528,592,936,0,0,0,1.0,1,1.0,1,1.0,1,0.09834901188627866,50
807,0,1528,592,936,0,0,0,1.0,1,1.0,1,1.0,1,0.09813694339999461,51
808,2,1530,593,937,0,0,0,1.0,1,1.0,1,1.0,1,0.08522579662811214,51
809,3,1533,594,939,0,0,0,1.0,1,1.0,1,1.0,1,0.07536285664800703,51
810,2,1535,595,940,0,0,0,1.0,1,1.0,1,1.0,1,0.07837215071575067,52
811,2,1537,596,941,0,0,0,1.0,1,1.0,1,1.0,1,0.07940318518157363,50
812,1,1538,597,941,0,0,0,1.0,1,1.0,1,1.0,1,0.15148265793572718,48
813,7,1545,599,946,0,0,0,1.0,1,1.0,1,1.0,1,0.1235354200680777,49
814,0,1545,599,946,0,0,0,1.0,1,1.0,1,1.0,1,0.14164916736152727,48
815,6,1551,601,950,0,0,0,1.0,1,1.0,1,1.0,1,0.11141578407926526,48
816,1,1552,602,950,0,0,0,1.0,1,1.0,1,1.0,1,0.14275859646519556,46
817,3,1555,602,953,0,0,0,1.0,1,1.0,1,1.0,1,0.18802327095413526,44
818,3,1558,602,956,0,0,0,1.0,1,1.0,1,1.0,1,0.16249508876453703,46
819,3,1561,603,958,0,0,0,1.0,1,1.0,1,1.0,1,0.1537748331006992,44
820,2,1563,603,960,0,0,0,1.0,1,1.0,1,1.0,1,0.11455316169860183,44
821,0,1563,603,960,0,0,0,1.0,1,1.0,1,1.0,1,0.11455316169860183,44
822,3,1566,605,961,0,0,0,1.0,1,1.0,1,1.0,1,0.13491945864552762,44
823,1,1567,605,962,0,0,0,1.0,1,1.0,1,1.0,1,0.1045254257741396,42
824,6,1573,609,964,0,0,0,1.0,1,1.0,1,1.0,1,0.09222989229813301,42
825,4,1577,612,965,0,0,0,1.0,1,1.0,1,1.0,1,0.10805201490125503,40
826,4,1581,613,968,0,0,0,1.0,1,1.0,1,1.0,1,0.10727771441280998,41
827,0,1581,613,968,0,0,0,1.0,1,1.0,1,1.0,1,0.09883737005379814,40
828,2,1583,615,968,0,0,0,1.0,1,1.0,1,1.0,1,0.08783258406216367,40
829,4,1587,617,970,0,0,0,1.0,1,1.0,1,1.0,1,0.07851023942621273,42
830,3,1590,618,972,0,0,0,1.0,1,1.0,1,1.0,1,0.12842112529773464,42
831,6,1596,620,976,0,0,0,1.0,1,1.0,1,1.0,1,0.10871922579593021,43
832,2,1598,621,977,0,0,0,1.0,1,1.0,1,1.0,1,0.0866535992672405,42
833,1,1599,621,978,0,0,0,1.0,1,1.0,1,1.0,1,0.09942994682315343,41
834,3,1602,624,978,0,0,0,1.0,1,1.0,1,1.0,1,0.14753208720054165,41
835,2,1604,625,979,0,0,0,1.0,1,1.0,1,1.0,1,0.14715213522405785,41
836,1,1605,625,980,0,0,0,1.0,1,1.0,1,1.0,1,0.115107703438495,40
837,1,1606,625,981,0,0,0,1.0,1,1.0,1,1.0,1,0.09096330240528085,41
838,1,1607,626,981,0,0,0,1.0,1,1.0,1,1.0,1,0.12519847556140828,41
839,3,1610,626,984,0,0,0,1.0,1,1.0,1,1.0,1,0.04658890414380118,41
840,1,1611,627,984,0,0,0,1.0,1,1.0,1,1.0,1,0.1121751005778031,42
841,1,1612,628,984,0,0,0,1.0,1,1.0,1,1.0,1,0.13557923755092774,42
842,1,1613,629,984,0,0,0,1.0,1,1.0,1,1.0,1,0.16092732715093858,42
843,3,1616,631,985,0,0,0,1.0,1,1.0,1,1.0,1,0.17822829673447502,42
844,3,1619,632,987,0,0,0,1.0,1,1.0,1,1.0,1,0.19398802493481784,42
845,8,1627,633,994,0,0,0,1.0,1,1.0,1,1.0,1,0.12955640420803327,44
846,2,1629,634,995,0,0,0,1.0,1,1.0,1,1.0,1,0.12611157793138886,44
847,1,1630,634,996,0,0,0,1.0,1,1.0,1,1.0,1,0.12258181949676403,42
848,0,1630,634,996,0,0,0,1.0,1,1.0,1,1.0,1,0.13849045631114307,43
849,2,1632,634,998,0,0,0,1.0,1,1.0,1,1.0,1,0.11009487770729706,43
850,2,1634,634,1000,0,0,0,1.0,1,1.0,1,1.0,1,0.12432214694984589,41
851,2,1636,634,1002,0,0,0,1.0,1,1.0,1,1.0,1,0.12755122111898573,40
852,1,1637,635,1002,0,0,0,1.0,1,1.0,1,1.0,1,0.13859366137254012,40
853,1,1638,636,1002,0,0,0,1.0,1,1.0,1,1.0,1,0.13276404019458787,40
854,2,1640,637,1003,0,0,0,1.0,1,1.0,1,1.0,1,0.12865938045540293,40
855,2,1642,638,1004,0,0,0,1.0,1,1.0,1,1.0,1,0.11701553238508898,41
856,1,1643,639,1004,0,0,0,1.0,1,1.0,1,1.0,1,0.134965547454339,41
857,2,1645,640,1005,0,0,0,1.0,1,1.0,1,1.0,1,0.12749056435131675,42
858,2,1647,640,1007,0,0,0,1.0,1,1.0,1,1.0,1,0.072504499327552,43
859,0,1647,640,1007,0,0,0,1.0,1,1.0,1,1.0,1,0.072504499327552,43
860,0,1647,640,1007,0,0,0,1.0,1,1.0,1,1.0,1,0.0835249678080913,44
861,1,1648,641,1007,0,0,0,1.0,1,1.0,1,1.0,1,0.08739631254741406,44
862,0,1648,641,1007,0,0,0,1.0,1,1.0,1,1.0,1,0.08739631254741406,44
863,5,1653,644,1009,0,0,0,1.0,1,1.0,1,1.0,1,0.12922319944850663,44
864,3,1656,645,1011,0,0,0,1.0,1,1.0,1,1.0,1,0.11996208005283372,44
865,2,1658,647,1011,0,0,0,1.0,1,1.0,1,1.0,1,0.09217205837370461,43
866,7,1665,651,1014,0,0,0,1.0,1,1.0,1,1.0,1,0.14344016948610958,45
867,3,1668,651,1017,0,0,0,1.0,1,1.0,1,1.0,1,0.10628293650880001,44
868,4,1672,654,1018,0,0,0,1.0,1,1.0,1,1.0,1,0.10683842880837975,45
869,5,1677,658,1019,0,0,0,1.0,1,1.0,1,1.0,1,0.14410253074375695,44
870,1,1678,659,1019,0,0,0,1.0,1,1.0,1,1.0,1,0.15363649123773343,44
871,4,1682,659,1023,0,0,0,1.0,1,1.0,1,1.0,1,0.10929585262337432,43
872,3,1685,659,1026,0,0,0,1.0,1,1.0,1,1.0,1,0.09128608230316056,43
873,3,1688,660,1028,0,0,0,1.0,1,1.0,1,1.0,1,0.11388284853010329,43
874,4,1692,661,1031,0,0,0,1.0,1,1.0,1,1.0,1,0.10736571829579672,46
875,3,1695,662,1033,0,0,0,1.0,1,1.0,1,1.0,1,0.12279836714677021,43
876,3,1698,663,1035,0,0,0,1.0,1,1.0,1,1.0,1,0.09578735246426502,44
877,1,1699,663,1036,0,0,0,1.0,1,1.0,1,1.0,1,0.1027420210795174,44
878,0,1699,663,1036,0,0,0,1.0,1,1.0,1,1.0,1,0.1027420210795174,44
879,2,1701,664,1037,0,0,0,1.0,1,1.0,1,1.0,1,0.10117713557108589,44
880,2,1703,666,1037,0,0,0,1.0,1,1.0,1,1.0,1,0.13020343029216164,44
881,1,1704,666,1038,0,0,0,1.0,1,1.0,1,1.0,1,0.10406913824405886,43
882,1,1705,667,1038,0,0,0,1.0,1,1.0,1,1.0,1,0.1166064344062334,45
883,2,1707,667,1040,0,0,0,1.0,1,1.0,1,1.0,1,0.09983126081807989,45
884,4,1711,669,1042,0,0,0,1.0,1,1.0,1,1.0,1,0.09306746865869993,45
885,2,1713,670,1043,0,0,0,1.0,1,1.0,1,1.0,1,0.03892558438215488,43
886,1,1714,671,1043,0,0,0,1.0,1,1.0,1,1.0,1,0.1389200004331511,43
887,2,1716,671,1045,0,0,0,1.0,1,1.0,1,1.0,1,0.09160370432449104,41
888,1,1717,671,1046,0,0,0,1.0,1,1.0,1,1.0,1,0.1557019368378,40
889,3,1720,672,1048,0,0,0,1.0,1,1.0,1,1.0,1,0.11797158119581454,40
890,1,1721,673,1048,0,0,0,1.0,1,1.0,1,1.0,1,0.09928688150947185,38
891,5,1726,675,1051,0,0,0,1.0,1,1.0,1,1.0,1,0.1599924426706943,39
892,1,1727,675,1052,0,0,0,1.0,1,1.0,1,1.0,1,0.1354056336382168,39
893,0,1727,675,1052,0,0,0,1.0,1,1.0,1,1.0,1,0.1455175886749536,37
894,3,1730,678,1052,0,0,0,1.0,1,1.0,1,1.0,1,0.2220145428369788,36
895,3,1733,678,1055,0,0,0,1.0,1,1.0,1,1.0,1,0.18251363242729726,37
896,1,1734,679,1055,0,0,0,1.0,1,1.0,1,1.0,1,0.24167941968912857,36
897,3,1737,680,1057,0,0,0,1.0,1,1.0,1,1.0,1,0.21846655285004207,36
898,0,1737,680,1057,0,0,0,1.0,1,1.0,1,1.0,1,0.23328763932995536,35
899,2,1739,681,1058,0,0,0,1.0,1,1.0,1,1.0,1,0.23286419905322078,35
900,1,1740,682,1058,0,0,0,1.0,1,1.0,1,1.0,1,0.2640334944096497,36
901,0,1740,682,1058,0,0,0,1.0,1,1.0,1,1.0,1,0.2640334944096497,36
902,4,1744,684,1060,0,0,0,1.0,1,1.0,1,1.0,1,0.256574735043026,36
903,2,1746,684,1062,0,0,0,1.0,1,1.0,1,1.0,1,0.19469305779566673,35
904,5,1751,687,1064,0,0,0,1.0,1,1.0,1,1.0,1,0.16688826731095605,37
905,3,1754,689,1065,0,0,0,1.0,1,1.0,1,1.0,1,0.1487622921036597,36
906,1,1755,690,1065,0,0,0,1.0,1,1.0,1,1.0,1,0.18470785315197277,37
907,6,1761,693,1068,0,0,0,1.0,1,1.0,1,1.0,1,0.11820291389433268,37
908,5,1766,696,1070,0,0,0,1.0,1,1.0,1,1.0,1,0.16727852981499253,36
909,5,1771,696,1075,0,0,0,1.0,1,1.0,1,1.0,1,0.15438293605702952,36
910,2,1773,697,1076,0,0,0,1.0,1,1.0,1,1.0,1,0.1635399862615661,37
911,5,1778,698,1080,0,0,0,1.0,1,1.0,1,1.0,1,0.14765094238224427,36
912,1,1779,699,1080,0,0,0,1.0,1,1.0,1,1.0,1,0.14537959960118324,34
913,3,1782,701,1081,0,0,0,1.0,1,1.0,1,1.0,1,0.1709105374097153,34
914,1,1783,702,1081,0,0,0,1.0,1,1.0,1,1.0,1,0.1826622809681569,33
915,3,1786,702,1084,0,0,0,1.0,1,1.0,1,1.0,1,0.0939928286355686,33
916,0,1786,702,1084,0,0,0,1.0,1,1.0,1,1.0,1,0.11827368403186064,34
917,1,1787,703,1084,0,0,0,1.0,1,1.0,1,1.0,1,0.1342824874693228,34
918,1,1788,703,1085,0,0,0,1.0,1,1.0,1,1.0,1,0.11100666743339345,36
919,2,1790,703,1087,0,0,0,1.0,1,1.0,1,1.0,1,0.04286862293332951,36
920,1,1791,703,1088,0,0,0,1.0,1,1.0,1,1.0,1,0.06606232295143447,37
921,0,1791,703,1088,0,0,0,1.0,1,1.0,1,1.0,1,0.06606232295143447,37
922,2,1793,704,1089,0,0,0,1.0,1,1.0,1,1.0,1,0.10950605589586575,38
923,1,1794,705,1089,0,0,0,1.0,1,1.0,1,1.0,1,0.059630705389541544,36
924,0,1794,705,1089,0,0,0,1.0,1,1.0,1,1.0,1,0.08161357627441473,35
925,0,1794,705,1089,0,0,0,1.0,1,1.0,1,1.0,1,0.16441628271856606,35
926,1,1795,706,1089,0,0,0,1.0,1,1.0,1,1.0,1,0.1665622222118651,34
927,4,1799,707,1092,0,0,0,1.0,1,1.0,1,1.0,1,0.12610216636370514,32
928,0,1799,707,1092,0,0,0,1.0,1,1.0,1,1.0,1,0.179206272802705,32
929,5,1804,709,1095,0,0,0,1.0,1,1.0,1,1.0,1,0.16555252639432444,31
930,1,1805,710,1095,0,0,0,1.0,1,1.0,1,1.0,1,0.2180726396399972,30
931,4,1809,712,1097,0,0,0,1.0,1,1.0,1,1.0,1,0.21811345977810093,29
932,0,1809,712,1097,0,0,0,1.0,1,1.0,1,1.0,1,0.21811345977810093,29
933,2,1811,712,1099,0,0,0,1.0,1,1.0,1,1.0,1,0.16381206274393195,29
934,0,1811,712,1099,0,0,0,1.0,1,1.0,1,1.0,1,0.16381206274393195,29
935,2,1813,712,1101,0,0,0,1.0,1,1.0,1,1.0,1,0.1271767963289408,31
936,1,1814,713,1101,0,0,0,1.0,1,1.0,1,1.0,1,0.14670497087483378,31
937,3,1817,714,1103,0,0,0,1.0,1,1.0,1,1.0,1,0.1288373421879495,34
938,0,1817,714,1103,0,0,0,1.0,1,1.0,1,1.0,1,0.114941877859209,33
939,4,1821,715,1106,0,0,0,1.0,1,1.0,1,1.0,1,0.15698254475435394,36
940,0,1821,715,1106,0,0,0,1.0,1,1.0,1,1.0,1,0.167789357945425,36
941,0,1821,715,1106,0,0,0,1.0,1,1.0,1,1.0,1,0.167789357945425,36
942,3,1824,716,1108,0,0,0,1.0,1,1.0,1,1.0,1,0.14193244065155383,36
943,1,1825,717,1108,0,0,0,1.0,1,1.0,1,1.0,1,0.14503219682019583,35
944,2,1827,719,1108,0,0,0,1.0,1,1.0,1,1.0,1,0.17766229915936846,35
945,3,1830,719,1111,0,0,0,1.0,1,1.0,1,1.0,1,0.1105161050865189,33
946,7,1837,721,1116,0,0,0,1.0,1,1.0,1,1.0,1,0.1835921464968794,36
947,3,1840,722,1118,0,0,0,1.0,1,1.0,1,1.0,1,0.17889028917606659,34
948,1,1841,723,1118,0,0,0,1.0,1,1.0,1,1.0,1,0.22926450991848357,33
949,3,1844,724,1120,0,0,0,1.0,1,1.0,1,1.0,1,0.27438369238077776,34
950,1,1845,724,1121,0,0,0,1.0,1,1.0,1,1.0,1,0.3044387775455392,33
951,2,1847,724,1123,0,0,0,1.0,1,1.0,1,1.0,1,0.26622168324028195,33
952,1,1848,724,1124,0,0,0,1.0,1,1.0,1,1.0,1,0.27641614076734344,32
953,0,1848,724,1124,0,0,0,1.0,1,1.0,1,1.0,1,0.27641614076734344,32
954,0,1848,724,1124,0,0,0,1.0,1,1.0,1,1.0,1,0.303894309122976,31
955,4,1852,724,1128,0,0,0,1.0,1,1.0,1,1.0,1,0.23863656117973758,32
956,3,1855,725,1130,0,0,0,1.0,1,1.0,1,1.0,1,0.2006211961619827,32
957,1,1856,725,1131,0,0,0,1.0,1,1.0,1,1.0,1,0.1561877595301126,33
958,1,1857,725,1132,0,0,0,1.0,1,1.0,1,1.0,1,0.1316501596686313,35
959,1,1858,726,1132,0,0,0,1.0,1,1.0,1,1.0,1,0.15206167373584653,36
960,0,1858,726,1132,0,0,0,1.0,1,1.0,1,1.0,1,0.1587672865448721,38
961,3,1861,727,1134,0,0,0,1.0,1,1.0,1,1.0,1,0.22122527341153744,37
962,1,1862,728,1134,0,0,0,1.0,1,1.0,1,1.0,1,0.2696424636542554,35
963,2,1864,728,1136,0,0,0,1.0,1,1.0,1,1.0,1,0.2125221957778816,35
964,2,1866,728,1138,0,0,0,1.0,1,1.0,1,1.0,1,0.17964854082359966,34
965,1,1867,728,1139,0,0,0,1.0,1,1.0,1,1.0,1,0.15407522590255562,35
966,1,1868,728,1140,0,0,0,1.0,1,1.0,1,1.0,1,0.17301947280900548,34
967,2,1870,728,1142,0,0,0,1.0,1,1.0,1,1.0,1,0.1569654549419987,35
968,1,1871,729,1142,0,0,0,1.0,1,1.0,1,1.0,1,0.15480653053972507,36
969,2,1873,730,1143,0,0,0,1.0,1,1.0,1,1.0,1,0.1947814446928962,35
970,1,1874,730,1144,0,0,0,1.0,1,1.0,1,1.0,1,0.20756876674180674,34
971,2,1876,730,1146,0,0,0,1.0,1,1.0,1,1.0,1,0.19017823163003125,35
972,0,1876,730,1146,0,0,0,1.0,1,1.0,1,1.0,1,0.19017823163003125,35
973,1,1877,730,1147,0,0,0,1.0,1,1.0,1,1.0,1,0.19363196327815327,36
974,0,1877,730,1147,0,0,0,1.0,1,1.0,1,1.0,1,0.23120101223631082,35
975,0,1877,730,1147,0,0,0,1.0,1,1.0,1,1.0,1,0.20379854888725382,36
976,1,1878,730,1148,0,0,0,1.0,1,1.0,1,1.0,1,0.21070901504436484,38
977,1,1879,731,1148,0,0,0,1.0,1,1.0,1,1.0,1,0.2313995028060894,38
978,0,1879,731,1148,0,0,0,1.0,1,1.0,1,1.0,1,0.2313995028060894,38
979,2,1881,731,1150,0,0,0,1.0,1,1.0,1,1.0,1,0.20123839343508512,39
980,3,1884,733,1151,0,0,0,1.0,1,1.0,1,1.0,1,0.2132889129082812,39
981,4,1888,735,1153,0,0,0,1.0,1,1.0,1,1.0,1,0.23225197269650036,40
982,6,1894,738,1156,0,0,0,1.0,1,1.0,1,1.0,1,0.23589326948840084,40
983,1,1895,738,1157,0,0,0,1.0,1,1.0,1,1.0,1,0.17975952308869234,38
984,4,1899,740,1159,0,0,0,1.0,1,1.0,1,1.0,1,0.14333470531464307,39
985,5,1904,743,1161,0,0,0,1.0,1,1.0,1,1.0,1,0.1996408079626626,38
986,4,1908,744,1164,0,0,0,1.0,1,1.0,1,1.0,1,0.1483388826432105,38
987,2,1910,745,1165,0,0,0,1.0,1,1.0,1,1.0,1,0.14825917000358807,38
988,0,1910,745,1165,0,0,0,1.0,1,1.0,1,1.0,1,0.14825917000358807,38
989,2,1912,745,1167,0,0,0,1.0,1,1.0,1,1.0,1,0.10511579431793872,38
990,1,1913,745,1168,0,0,0,1.0,1,1.0,1,1.0,1,0.08379802476882196,38
991,0,1913,745,1168,0,0,0,1.0,1,1.0,1,1.0,1,0.08308719871761275,40
992,1,1914,746,1168,0,0,0,1.0,1,1.0,1,1.0,1,0.10379455980972886,39
993,2,1916,747,1169,0,0,0,1.0,1,1.0,1,1.0,1,0.12363892158259478,38
994,1,1917,747,1170,0,0,0,1.0,1,1.0,1,1.0,1,0.13638192608033495,39
995,1,1918,747,1171,0,0,0,1.0,1,1.0,1,1.0,1,0.12330350030483336,41
996,0,1918,747,1171,0,0,0,1.0,1,1.0,1,1.0,1,0.12913546067387477,40
997,0,1918,747,1171,0,0,0,1.0,1,1.0,1,1.0,1,0.15218489302090357,41
998,0,1918,747,1171,0,0,0,1.0,1,1.0,1,1.0,1,0.143150521782744,40
999,0,1918,747,1171,0,0,0,1.0,1,1.0,1,1.0,1,0.16095703242251733,40
1000,0,1918,747,1171,0,0,0,1.0,1,1.0,1,1.0,1,0.16095703242251733,40
1001,1,1919,747,1172,0,0,0,1.0,1,1.0,1,1.0,1,0.14266660658880884,39
1002,0,1919,747,1172,0,0,0,1.0,1,1.0,1,1.0,1,0.14266660658880884,39
1003,0,1919,747,1172,0,0,0,1.0,1,1.0,1,1.0,1,0.14266660658880884,39
1004,0,1919,747,1172,0,0,0,1.0,1,1.0,1,1.0,1,0.14266660658880884,39
1005,0,1919,747,1172,0,0,0,1.0,1,1.0,1,1.0,1,0.15868329001179643,40
1006,0,1919,747,1172,0,0,0,1.0,1,1.0,1,1.0,1,0.14706672493584547,41
1007,3,1922,747,1175,0,0,0,1.0,1,1.0,1,1.0,1,0.11109778918333213,42
1008,2,1924,748,1176,0,0,0,1.0,1,1.0,1,1.0,1,0.10326521511605553,43
1009,0,1924,748,1176,0,0,0,1.0,1,1.0,1,1.0,1,0.1161459607030094,44
1010,0,1924,748,1176,0,0,0,1.0,1,1.0,1,1.0,1,0.1161459607030094,44
1011,1,1925,749,1176,0,0,0,1.0,1,1.0,1,1.0,1,0.15422394340918721,44
1012,4,1929,751,1178,0,0,0,1.0,1,1.0,1,1.0,1,0.16706907603564158,46
1013,2,1931,751,1180,0,0,0,1.0,1,1.0,1,1.0,1,0.11788163781168333,46
1014,2,1933,752,1181,0,0,0,1.0,1,1.0,1,1.0,1,0.14821213107344622,46
1015,0,1933,752,1181,0,0,0,1.0,1,1.0,1,1.0,1,0.14821213107344622,46
1016,1,1934,753,1181,0,0,0,1.0,1,1.0,1,1.0,1,0.1621609342146264,47
1017,1,1935,753,1182,0,0,0,1.0,1,1.0,1,1.0,1,0.1568408402535535,47
1018,7,1942,754,1188,0,0,0,1.0,1,1.0,1,1.0,1,0.1277060871886147,48
1019,2,1944,755,1189,0,0,0,1.0,1,1.0,1,1.0,1,0.1262260659594297,49
1020,1,1945,755,1190,0,0,0,1.0,1,1.0,1,1.0,1,0.11095900885251708,51
1021,3,1948,757,1191,0,0,0,1.0,1,1.0,1,1.0,1,0.15697086534742125,51
1022,2,1950,758,1192,0,0,0,1.0,1,1.0,1,1.0,1,0.13108727313898133,52
1023,2,1952,758,1194,0,0,0,1.0,1,1.0,1,1.0,1,0.11782155609367019,52
1024,0,1952,758,1194,0,0,0,1.0,1,1.0,1,1.0,1,0.11782155609367019,52
1025,1,1953,758,1195,0,0,0,1.0,1,1.0,1,1.0,1,0.11006426984890462,54
1026,0,1953,758,1195,0,0,0,1.0,1,1.0,1,1.0,1,0.11006426984890462,54
1027,2,1955,758,1197,0,0,0,1.0,1,1.0,1,1.0,1,0.08309219061357269,55
1028,1,1956,758,1198,0,0,0,1.0,1,1.0,1,1.0,1,0.08711867023211145,56
1029,0,1956,758,1198,0,0,0,1.0,1,1.0,1,1.0,1,0.08711867023211145,56
1030,2,1958,759,1199,0,0,0,1.0,1,1.0,1,1.0,1,0.10540594448094426,57
1031,2,1960,759,1201,0,0,0,1.0,1,1.0,1,1.0,1,0.07590172296370226,58
1032,3,1963,762,1201,0,0,0,1.0,1,1.0,1,1.0,1,0.11196738860121547,58
1033,4,1967,762,1205,0,0,0,1.0,1,1.0,1,1.0,1,0.07739498438091205,57
1034,3,1970,765,1205,0,0,0,1.0,1,1.0,1,1.0,1,0.13146314979531917,57
1035,3,1973,767,1206,0,0,0,1.0,1,1.0,1,1.0,1,0.11228756499965041,57
1036,4,1977,769,1208,0,0,0,1.0,1,1.0,1,1.0,1,0.10633834843818167,59
1037,4,1981,771,1210,0,0,0,1.0,1,1.0,1,1.0,1,0.1069395678864184,57
1038,3,1984,772,1212,0,0,0,1.0,1,1.0,1,1.0,1,0.15091085364458032,59
1039,6,1990,774,1216,0,0,0,1.0,1,1.0,1,1.0,1,0.08542496220506965,57
1040,0,1990,774,1216,0,0,0,1.0,1,1.0,1,1.0,1,0.12904249508409152,56
1041,3,1993,775,1218,0,0,0,1.0,1,1.0,1,1.0,1,0.11006601459083201,54
1042,0,1993,775,1218,0,0,0,1.0,1,1.0,1,1.0,1,0.07827629005853283,52
1043,1,1994,776,1218,0,0,0,1.0,1,1.0,1,1.0,1,0.09970552482531307,52
1044,2,1996,778,1218,0,0,0,1.0,1,1.0,1,1.0,1,0.12782862723367341,50
1045,2,1998,779,1219,0,0,0,1.0,1,1.0,1,1.0,1,0.13743251277376814,51
1046,1,1999,780,1219,0,0,0,1.0,1,1.0,1,1.0,1,0.15085439873214912,50
1047,2,2001,781,1220,0,0,0,1.0,1,1.0,1,1.0,1,0.12644780214807536,50
1048,1,2002,781,1221,0,0,0,1.0,1,1.0,1,1.0,1,0.10535929682484857,50
1049,3,2005,782,1223,0,0,0,1.0,1,1.0,1,1.0,1,0.12808873365821044,50
1050,1,2006,783,1223,0,0,0,1.0,1,1.0,1,1.0,1,0.12875393705236815,50
1051,2,2008,783,1225,0,0,0,1.0,1,1.0,1,1.0,1,0.09987525229930536,50
1052,2,2010,783,1227,0,0,0,1.0,1,1.0,1,1.0,1,0.0923055906540968,51
1053,0,2010,783,1227,0,0,0,1.0,1,1.0,1,1.0,1,0.0923055906540968,51
1054,0,2010,783,1227,0,0,0,1.0,1,1.0,1,1.0,1,0.07985789666227455,53
1055,1,2011,783,1228,0,0,0,1.0,1,1.0,1,1.0,1,0.08256617277068089,54
1056,0,2011,783,1228,0,0,0,1.0,1,1.0,1,1.0,1,0.08082986340065132,54
1057,1,2012,784,1228,0,0,0,1.0,1,1.0,1,1.0,1,0.11792637924175436,55
1058,1,2013,784,1229,0,0,0,1.0,1,1.0,1,1.0,1,0.128381848873465,54
1059,5,2018,786,1232,0,0,0,1.0,1,1.0,1,1.0,1,0.16551080502927565,53
1060,2,2020,787,1233,0,0,0,1.0,1,1.0,1,1.0,1,0.160316715920333,53
1061,6,2026,790,1236,0,0,0,1.0,1,1.0,1,1.0,1,0.14700963913328316,53
1062,4,2030,794,1236,0,0,0,1.0,1,1.0,1,1.0,1,0.12637392847377074,54
1063,1,2031,794,1237,0,0,0,1.0,1,1.0,1,1.0,1,0.15804982358450856,53
1064,3,2034,797,1237,0,0,0,1.0,1,1.0,1,1.0,1,0.14053739594429437,55
1065,3,2037,797,1240,0,0,0,1.0,1,1.0,1,1.0,1,0.1500344551215087,54
1066,6,2043,799,1244,0,0,0,1.0,1,1.0,1,1.0,1,0.13968388502333162,55
1067,3,2046,800,1246,0,0,0,1.0,1,1.0,1,1.0,1,0.13014187943817293,55
1068,1,2047,800,1247,0,0,0,1.0,1,1.0,1,1.0,1,0.13619366297108404,55
1069,3,2050,800,1250,0,0,0,1.0,1,1.0,1,1.0,1,0.1378196164255819,55
1070,1,2051,801,1250,0,0,0,1.0,1,1.0,1,1.0,1,0.15053867331046877,54
1071,3,2054,802,1252,0,0,0,1.0,1,1.0,1,1.0,1,0.15802154219133643,55
1072,1,2055,803,1252,0,0,0,1.0,1,1.0,1,1.0,1,0.13347529960176385,54
1073,2,2057,804,1253,0,0,0,1.0,1,1.0,1,1.0,1,0.13974302649836848,54
1074,2,2059,805,1254,0,0,0,1.0,1,1.0,1,1.0,1,0.13626082918389665,52
1075,0,2059,805,1254,0,0,0,1.0,1,1.0,1,1.0,1,0.15726711166584986,51
1076,4,2063,806,1257,0,0,0,1.0,1,1.0,1,1.0,1,0.17539785594272148,52
1077,7,2070,807,1263,0,0,0,1.0,1,1.0,1,1.0,1,0.08507883386678404,49
1078,5,2075,810,1265,0,0,0,1.0,1,1.0,1,1.0,1,0.11090119711344527,48
1079,1,2076,811,1265,0,0,0,1.0,1,1.0,1,1.0,1,0.13359788178990362,47
1080,2,2078,813,1265,0,0,0,1.0,1,1.0,1,1.0,1,0.1433235531891421,47
1081,1,2079,814,1265,0,0,0,1.0,1,1.0,1,1.0,1,0.18347293586781474,45
1082,1,2080,815,1265,0,0,0,1.0,1,1.0,1,1.0,1,0.21472227289106094,42
1083,2,2082,816,1266,0,0,0,1.0,1,1.0,1,1.0,1,0.23525106555645553,42
1084,1,2083,816,1267,0,0,0,1.0,1,1.0,1,1.0,1,0.24799928402279947,40
1085,1,2084,816,1268,0,0,0,1.0,1,1.0,1,1.0,1,0.20994869124717006,43
1086,3,2087,817,1270,0,0,0,1.0,1,1.0,1,1.0,1,0.2172763480111511,41
1087,3,2090,817,1273,0,0,0,1.0,1,1.0,1,1.0,1,0.2288943254658281,41
1088,3,2093,817,1276,0,0,0,1.0,1,1.0,1,1.0,1,0.1624136524217554,41
1089,2,2095,818,1277,0,0,0,1.0,1,1.0,1,1.0,1,0.14748138714959885,42
1090,1,2096,818,1278,0,0,0,1.0,1,1.0,1,1.0,1,0.13219638386180807,43
1091,2,2098,819,1279,0,0,0,1.0,1,1.0,1,1.0,1,0.1544246906167627,43
1092,0,2098,819,1279,0,0,0,1.0,1,1.0,1,1.0,1,0.1544246906167627,43
1093,1,2099,820,1279,0,0,0,1.0,1,1.0,1,1.0,1,0.15825480621119004,43
1094,1,2100,820,1280,0,0,0,1.0,1,1.0,1,1.0,1,0.13884192248591834,43
1095,2,2102,821,1281,0,0,0,1.0,1,1.0,1,1.0,1,0.16071055287566227,44
1096,1,2103,822,1281,0,0,0,1.0,1,1.0,1,1.0,1,0.1766448491649611,44
1097,5,2108,824,1284,0,0,0,1.0,1,1.0,1,1.0,1,0.20550008765638783,45
1098,0,2108,824,1284,0,0,0,1.0,1,1.0,1,1.0,1,0.20548318828498177,46
1099,3,2111,825,1286,0,0,0,1.0,1,1.0,1,1.0,1,0.19914124859900062,48
1100,1,2112,825,1287,0,0,0,1.0,1,1.0,1,1.0,1,0.1766812009359694,49
1101,1,2113,825,1288,0,0,0,1.0,1,1.0,1,1.0,1,0.15617934195177754,49
1102,4,2117,827,1290,0,0,0,1.0,1,1.0,1,1.0,1,0.15202006854473976,50
1103,5,2122,828,1294,0,0,0,1.0,1,1.0,1,1.0,1,0.10505485269455458,48
1104,3,2125,829,1296,0,0,0,1.0,1,1.0,1,1.0,1,0.05758903279440128,50
1105,2,2127,831,1296,0,0,0,1.0,1,1.0,1,1.0,1,0.07395907366253086,48
1106,1,2128,832,1296,0,0,0,1.0,1,1.0,1,1.0,1,0.08364695734568531,48
1107,1,2129,833,1296,0,0,0,1.0,1,1.0,1,1.0,1,0.07182534353986338,47
1108,1,2130,834,1296,0,0,0,1.0,1,1.0,1,1.0,1,0.09615799821471566,47
1109,6,2136,836,1300,0,0,0,1.0,1,1.0,1,1.0,1,0.08492805346964302,46
1110,2,2138,837,1301,0,0,0,1.0,1,1.0,1,1.0,1,0.14617721671870115,43
1111,4,2142,838,1304,0,0,0,1.0,1,1.0,1,1.0,1,0.1136729348642205,44
1112,1,2143,839,1304,0,0,0,1.0,1,1.0,1,1.0,1,0.13964494763123564,43
1113,1,2144,839,1305,0,0,0,1.0,1,1.0,1,1.0,1,0.13627192435514376,39
1114,0,2144,839,1305,0,0,0,1.0,1,1.0,1,1.0,1,0.13627192435514376,39
1115,6,2150,841,1309,0,0,0,1.0,1,1.0,1,1.0,1,0.13510347970900333,37
1116,1,2151,842,1309,0,0,0,1.0,1,1.0,1,1.0,1,0.12996374034648658,37
1117,5,2156,844,1312,0,0,0,1.0,1,1.0,1,1.0,1,0.1280781896372301,36
1118,2,2158,844,1314,0,0,0,1.0,1,1.0,1,1.0,1,0.13951732398192868,36
1119,1,2159,844,1315,0,0,0,1.0,1,1.0,1,1.0,1,0.11080297093908888,36
1120,0,2159,844,1315,0,0,0,1.0,1,1.0,1,1.0,1,0.11080297093908888,36
1121,1,2160,845,1315,0,0,0,1.0,1,1.0,1,1.0,1,0.15303892940433655,36
1122,1,2161,845,1316,0,0,0,1.0,1,1.0,1,1.0,1,0.16953452378907075,37
1123,1,2162,845,1317,0,0,0,1.0,1,1.0,1,1.0,1,0.1434526753192332,37
1124,0,2162,845,1317,0,0,0,1.0,1,1.0,1,1.0,1,0.1434526753192332,37
1125,0,2162,845,1317,0,0,0,1.0,1,1.0,1,1.0,1,0.17167737703069838,38
1126,1,2163,846,1317,0,0,0,1.0,1,1.0,1,1.0,1,0.19740101972358673,38
1127,2,2165,847,1318,0,0,0,1.0,1,1.0,1,1.0,1,0.22187312051151484,39
1128,1,2166,847,1319,0,0,0,1.0,1,1.0,1,1.0,1,0.20127102219959192,39
1129,1,2167,847,1320,0,0,0,1.0,1,1.0,1,1.0,1,0.19432511901627622,39
1130,1,2168,848,1320,0,0,0,1.0,1,1.0,1,1.0,1,0.22713773535176107,39
1131,2,2170,848,1322,0,0,0,1.0,1,1.0,1,1.0,1,0.1751267215429566,39
1132,1,2171,848,1323,0,0,0,1.0,1,1.0,1,1.0,1,0.1687471293846546,39
1133,1,2172,848,1324,0,0,0,1.0,1,1.0,1,1.0,1,0.15243197024202254,42
1134,0,2172,848,1324,0,0,0,1.0,1,1.0,1,1.0,1,0.15243197024202254,42
1135,1,2173,848,1325,0,0,0,1.0,1,1.0,1,1.0,1,0.17516061387729728,44
1136,2,2175,848,1327,0,0,0,1.0,1,1.0,1,1.0,1,0.1662815672405433,46
1137,0,2175,848,1327,0,0,0,1.0,1,1.0,1,1.0,1,0.18242964753934027,45
1138,4,2179,848,1331,0,0,0,1.0,1,1.0,1,1.0,1,0.12073530093565639,46
1139,1,2180,849,1331,0,0,0,1.0,1,1.0,1,1.0,1,0.1408555127322176,47
1140,0,2180,849,1331,0,0,0,1.0,1,1.0,1,1.0,1,0.15446788674849843,46
1141,2,2182,849,1333,0,0,0,1.0,1,1.0,1,1.0,1,0.14707515312018415,45
1142,3,2185,852,1333,0,0,0,1.0,1,1.0,1,1.0,1,0.16727326940283427,45
1143,5,2190,855,1335,0,0,0,1.0,1,1.0,1,1.0,1,0.14275333416572777,43
1144,5,2195,858,1337,0,0,0,1.0,1,1.0,1,1.0,1,0.09915726270837447,45
1145,3,2198,859,1339,0,0,0,1.0,1,1.0,1,1.0,1,0.09434732017792238,44
1146,4,2202,860,1342,0,0,0,1.0,1,1.0,1,1.0,1,0.10983810051031909,45
1147,2,2204,861,1343,0,0,0,1.0,1,1.0,1,1.0,1,0.06542650116527547,44
1148,2,2206,863,1343,0,0,0,1.0,1,1.0,1,1.0,1,0.11559790061425775,43
1149,2,2208,864,1344,0,0,0,1.0,1,1.0,1,1.0,1,0.16201891424889933,42
1150,7,2215,867,1348,0,0,0,1.0,1,1.0,1,1.0,1,0.18614539145727252,45
1151,3,2218,867,1351,0,0,0,1.0,1,1.0,1,1.0,1,0.16116500663315136,40
1152,6,2224,870,1354,0,0,0,1.0,1,1.0,1,1.0,1,0.1691425933077261,41
1153,4,2228,874,1354,0,0,0,1.0,1,1.0,1,1.0,1,0.22949348241156733,38
1154,2,2230,875,1355,0,0,0,1.0,1,1.0,1,1.0,1,0.20353862438280845,37
1155,0,2230,875,1355,0,0,0,1.0,1,1.0,1,1.0,1,0.191133860240615,38
1156,2,2232,876,1356,0,0,0,1.0,1,1.0,1,1.0,1,0.2166915617756879,38
1157,1,2233,876,1357,0,0,0,1.0,1,1.0,1,1.0,1,0.17094916078571756,37
1158,1,2234,877,1357,0,0,0,1.0,1,1.0,1,1.0,1,0.1965861297289994,36
1159,1,2235,877,1358,0,0,0,1.0,1,1.0,1,1.0,1,0.16158065547264192,35
1160,2,2237,878,1359,0,0,0,1.0,1,1.0,1,1.0,1,0.16999465220294852,35
1161,1,2238,878,1360,0,0,0,1.0,1,1.0,1,1.0,1,0.1762700031679491,36
1162,0,2238,878,1360,0,0,0,1.0,1,1.0,1,1.0,1,0.1824784982100363,37
1163,1,2239,878,1361,0,0,0,1.0,1,1.0,1,1.0,1,0.17206434798872072,37
1164,0,2239,878,1361,0,0,0,1.0,1,1.0,1,1.0,1,0.16016860209381492,38
1165,0,2239,878,1361,0,0,0,1.0,1,1.0,1,1.0,1,0.16016860209381492,38
1166,0,2239,878,1361,0,0,0,1.0,1,1.0,1,1.0,1,0.18062405707021673,40
1167,3,2242,879,1363,0,0,0,1.0,1,1.0,1,1.0,1,0.15199184154156944,40
1168,0,2242,879,1363,0,0,0,1.0,1,1.0,1,1.0,1,0.15199184154156944,40
1169,1,2243,879,1364,0,0,0,1.0,1,1.0,1,1.0,1,0.14342798649450536,41
1170,3,2246,881,1365,0,0,0,1.0,1,1.0,1,1.0,1,0.11751917770761483,41
1171,2,2248,882,1366,0,0,0,1.0,1,1.0,1,1.0,1,0.11159712154460398,43
1172,1,2249,883,1366,0,0,0,1.0,1,1.0,1,1.0,1,0.11557127748095075,43
1173,0,2249,883,1366,0,0,0,1.0,1,1.0,1,1.0,1,0.11557127748095075,43
1174,1,2250,884,1366,0,0,0,1.0,1,1.0,1,1.0,1,0.1271545446140303,43
1175,1,2251,884,1367,0,0,0,1.0,1,1.0,1,1.0,1,0.10894340331069437,44
1176,3,2254,885,1369,0,0,0,1.0,1,1.0,1,1.0,1,0.1291018447677952,45
1177,2,2256,886,1370,0,0,0,1.0,1,1.0,1,1.0,1,0.15408574550279597,45
1178,1,2257,887,1370,0,0,0,1.0,1,1.0,1,1.0,1,0.15037518414832077,45
1179,5,2262,889,1373,0,0,0,1.0,1,1.0,1,1.0,1,0.1824341354456775,46
1180,0,2262,889,1373,0,0,0,1.0,1,1.0,1,1.0,1,0.1657421336990932,47
1181,1,2263,889,1374,0,0,0,1.0,1,1.0,1,1.0,1,0.16979691377729997,48
1182,1,2264,890,1374,0,0,0,1.0,1,1.0,1,1.0,1,0.1671229809091089,48
1183,1,2265,890,1375,0,0,0,1.0,1,1.0,1,1.0,1,0.1712707669040996,46
1184,3,2268,893,1375,0,0,0,1.0,1,1.0,1,1.0,1,0.16639246316585332,47
1185,4,2272,894,1378,0,0,0,1.0,1,1.0,1,1.0,1,0.14973222477108902,44
1186,1,2273,894,1379,0,0,0,1.0,1,1.0,1,1.0,1,0.1656183536156428,47
1187,1,2274,894,1380,0,0,0,1.0,1,1.0,1,1.0,1,0.1541710707165727,49
1188,2,2276,895,1381,0,0,0,1.0,1,1.0,1,1.0,1,0.15702125094975947,50
1189,0,2276,895,1381,0,0,0,1.0,1,1.0,1,1.0,1,0.13526260456901867,48
1190,0,2276,895,1381,0,0,0,1.0,1,1.0,1,1.0,1,0.13310589523095875,48
1191,0,2276,895,1381,0,0,0,1.0,1,1.0,1,1.0,1,0.1462757783092739,46
1192,2,2278,897,1381,0,0,0,1.0,1,1.0,1,1.0,1,0.17747307931627465,46
1193,3,2281,897,1384,0,0,0,1.0,1,1.0,1,1.0,1,0.16296845679740452,45
1194,1,2282,897,1385,0,0,0,1.0,1,1.0,1,1.0,1,0.15247108529103146,45
1195,3,2285,898,1387,0,0,0,1.0,1,1.0,1,1.0,1,0.140240903840828,47
1196,1,2286,898,1388,0,0,0,1.0,1,1.0,1,1.0,1,0.13623491359868856,48
1197,4,2290,898,1392,0,0,0,1.0,1,1.0,1,1.0,1,0.1282838395301951,49
1198,1,2291,899,1392,0,0,0,1.0,1,1.0,1,1.0,1,0.11430530697439859,49
1199,1,2292,899,1393,0,0,0,1.0,1,1.0,1,1.0,1,0.12480675801147431,50
1200,1,2293,900,1393,0,0,0,1.0,1,1.0,1,1.0,1,0.1271294492628163,50
1201,1,2294,900,1394,0,0,0,1.0,1,1.0,1,1.0,1,0.1134669608665582,50
1202,1,2295,901,1394,0,0,0,1.0,1,1.0,1,1.0,1,0.09931960433841468,51
1203,1,2296,901,1395,0,0,0,1.0,1,1.0,1,1.0,1,0.08494130920437461,52
1204,0,2296,901,1395,0,0,0,1.0,1,1.0,1,1.0,1,0.08494130920437461,52
1205,2,2298,902,1396,0,0,0,1.0,1,1.0,1,1.0,1,0.10018789999602218,53
1206,0,2298,902,1396,0,0,0,1.0,1,1.0,1,1.0,1,0.10018789999602218,53
1207,0,2298,902,1396,0,0,0,1.0,1,1.0,1,1.0,1,0.10741363159394296,55
1208,2,2300,902,1398,0,0,0,1.0,1,1.0,1,1.0,1,0.10099993396714207,56
1209,1,2301,902,1399,0,0,0,1.0,1,1.0,1,1.0,1,0.1039372779845048,55
1210,0,2301,902,1399,0,0,0,1.0,1,1.0,1,1.0,1,0.1039372779845048,55
1211,0,2301,902,1399,0,0,0,1.0,1,1.0,1,1.0,1,0.08319115181801329,57
1212,1,2302,903,1399,0,0,0,1.0,1,1.0,1,1.0,1,0.09864117255322113,57
1213,0,2302,903,1399,0,0,0,1.0,1,1.0,1,1.0,1,0.09864117255322113,57
1214,5,2307,907,1400,0,0,0,1.0,1,1.0,1,1.0,1,0.1775021803380648,57
1215,5,2312,907,1405,0,0,0,1.0,1,1.0,1,1.0,1,0.1377349866727212,59
1216,2,2314,907,1407,0,0,0,1.0,1,1.0,1,1.0,1,0.11996871601174372,61
1217,0,2314,907,1407,0,0,0,1.0,1,1.0,1,1.0,1,0.11996871601174372,61
1218,2,2316,907,1409,0,0,0,1.0,1,1.0,1,1.0,1,0.12480547735619645,61
1219,2,2318,908,1410,0,0,0,1.0,1,1.0,1,1.0,1,0.12473000644427669,61
1220,4,2322,909,1413,0,0,0,1.0,1,1.0,1,1.0,1,0.11636202159317563,60
1221,3,2325,909,1416,0,0,0,1.0,1,1.0,1,1.0,1,0.12324502364941735,61
1222,2,2327,909,1418,0,0,0,1.0,1,1.0,1,1.0,1,0.12144243629064957,61
1223,3,2330,910,1420,0,0,0,1.0,1,1.0,1,1.0,1,0.12068417162955561,59
1224,4,2334,913,1421,0,0,0,1.0,1,1.0,1,1.0,1,0.12228905226927374,60
1225,5,2339,913,1426,0,0,0,1.0,1,1.0,1,1.0,1,0.09645591558965459,60
1226,2,2341,914,1427,0,0,0,1.0,1,1.0,1,1.0,1,0.11460266721421698,61
1227,2,2343,916,1427,0,0,0,1.0,1,1.0,1,1.0,1,0.102887378466386,59
1228,2,2345,917,1428,0,0,0,1.0,1,1.0,1,1.0,1,0.06225628408218148,58
1229,1,2346,917,1429,0,0,0,1.0,1,1.0,1,1.0,1,0.05186749055531171,57
1230,2,2348,919,1429,0,0,0,1.0,1,1.0,1,1.0,1,0.07953067381806073,55
1231,4,2352,920,1432,0,0,0,1.0,1,1.0,1,1.0,1,0.07149310114052165,54
1232,2,2354,922,1432,0,0,0,1.0,1,1.0,1,1.0,1,0.0871841466425598,51
1233,3,2357,924,1433,0,0,0,1.0,1,1.0,1,1.0,1,0.09948539203932123,49
1234,3,2360,926,1434,0,0,0,1.0,1,1.0,1,1.0,1,0.16408444176695344,49
1235,2,2362,926,1436,0,0,0,1.0,1,1.0,1,1.0,1,0.14768442317185482,48
1236,2,2364,926,1438,0,0,0,1.0,1,1.0,1,1.0,1,0.14068390737266795,49
1237,2,2366,927,1439,0,0,0,1.0,1,1.0,1,1.0,1,0.1727105840612926,48
1238,1,2367,927,1440,0,0,0,1.0,1,1.0,1,1.0,1,0.15336944330197153,47
1239,3,2370,927,1443,0,0,0,1.0,1,1.0,1,1.0,1,0.11001947741197841,48
1240,0,2370,927,1443,0,0,0,1.0,1,1.0,1,1.0,1,0.12233362822693024,49
1241,3,2373,928,1445,0,0,0,1.0,1,1.0,1,1.0,1,0.13475569616413902,49
1242,1,2374,928,1446,0,0,0,1.0,1,1.0,1,1.0,1,0.11668661429700695,49
1243,1,2375,928,1447,0,0,0,1.0,1,1.0,1,1.0,1,0.09650346010060047,50
1244,1,2376,928,1448,0,0,0,1.0,1,1.0,1,1.0,1,0.09854816410918059,50
1245,2,2378,929,1449,0,0,0,1.0,1,1.0,1,1.0,1,0.10061222291073008,51
1246,1,2379,930,1449,0,0,0,1.0,1,1.0,1,1.0,1,0.16337671772767834,52
1247,1,2380,930,1450,0,0,0,1.0,1,1.0,1,1.0,1,0.1470763930471518,52
1248,4,2384,933,1451,0,0,0,1.0,1,1.0,1,1.0,1,0.2041768983468187,51
1249,5,2389,935,1454,0,0,0,1.0,1,1.0,1,1.0,1,0.13500867308776085,51
1250,0,2389,935,1454,0,0,0,1.0,1,1.0,1,1.0,1,0.13500867308776085,51
1251,3,2392,935,1457,0,0,0,1.0,1,1.0,1,1.0,1,0.1072231890856942,53
1252,0,2392,935,1457,0,0,0,1.0,1,1.0,1,1.0,1,0.11105342390984299,52
1253,2,2394,935,1459,0,0,0,1.0,1,1.0,1,1.0,1,0.08067412874605731,52
1254,0,2394,935,1459,0,0,0,1.0,1,1.0,1,1.0,1,0.08447091302092272,53
1255,1,2395,936,1459,0,0,0,1.0,1,1.0,1,1.0,1,0.08531531890687444,55
1256,0,2395,936,1459,0,0,0,1.0,1,1.0,1,1.0,1,0.08531531890687444,55
1257,1,2396,936,1460,0,0,0,1.0,1,1.0,1,1.0,1,0.10596686296866933,57
1258,0,2396,936,1460,0,0,0,1.0,1,1.0,1,1.0,1,0.10608277354049522,57
1259,0,2396,936,1460,0,0,0,1.0,1,1.0,1,1.0,1,0.10608277354049522,57
1260,0,2396,936,1460,0,0,0,1.0,1,1.0,1,1.0,1,0.11221316205928096,56
1261,1,2397,936,1461,0,0,0,1.0,1,1.0,1,1.0,1,0.11241345382106868,57
1262,3,2400,937,1463,0,0,0,1.0,1,1.0,1,1.0,1,0.10904219000507304,58
1263,6,2406,938,1468,0,0,0,1.0,1,1.0,1,1.0,1,0.061710080513934056,58
1264,1,2407,939,1468,0,0,0,1.0,1,1.0,1,1.0,1,0.08880083917734789,57
1265,9,2416,944,1472,0,0,0,1.0,1,1.0,1,1.0,1,0.0899446557576192,56
1266,2,2418,945,1473,0,0,0,1.0,1,1.0,1,1.0,1,0.1214076800573973,55
1267,4,2422,947,1475,0,0,0,1.0,1,1.0,1,1.0,1,0.1342494561823282,53
1268,3,2425,950,1475,0,0,0,1.0,1,1.0,1,1.0,1,0.2228956711576178,52
1269,10,2435,951,1484,0,0,0,1.0,1,1.0,1,1.0,1,0.10852303827147917,51
1270,2,2437,951,1486,0,0,0,1.0,1,1.0,1,1.0,1,0.1250458683526872,47
1271,5,2442,952,1490,0,0,0,1.0,1,1.0,1,1.0,1,0.08996023603556852,46
1272,1,2443,953,1490,0,0,0,1.0,1,1.0,1,1.0,1,0.07133176305568965,43
1273,0,2443,953,1490,0,0,0,1.0,1,1.0,1,1.0,1,0.05474315298145625,44
1274,2,2445,954,1491,0,0,0,1.0,1,1.0,1,1.0,1,0.11254426187512097,44
1275,4,2449,956,1493,0,0,0,1.0,1,1.0,1,1.0,1,0.08404756228221018,45
1276,1,2450,957,1493,0,0,0,1.0,1,1.0,1,1.0,1,0.07575463390564205,43
1277,2,2452,958,1494,0,0,0,1.0,1,1.0,1,1.0,1,0.08541125934726197,44
1278,3,2455,961,1494,0,0,0,1.0,1,1.0,1,1.0,1,0.12561066479489827,45
1279,2,2457,961,1496,0,0,0,1.0,1,1.0,1,1.0,1,0.08253495239485087,47
1280,0,2457,961,1496,0,0,0,1.0,1,1.0,1,1.0,1,0.08253495239485087,47
1281,1,2458,961,1497,0,0,0,1.0,1,1.0,1,1.0,1,0.07199887152222162,47
1282,1,2459,962,1497,0,0,0,1.0,1,1.0,1,1.0,1,0.09714213507110744,46
1283,2,2461,964,1497,0,0,0,1.0,1,1.0,1,1.0,1,0.1255719821532066,46
1284,1,2462,964,1498,0,0,0,1.0,1,1.0,1,1.0,1,0.11432114793320533,46
1285,2,2464,964,1500,0,0,0,1.0,1,1.0,1,1.0,1,0.10613501063251347,46
1286,0,2464,964,1500,0,0,0,1.0,1,1.0,1,1.0,1,0.090685449783394,45
1287,1,2465,964,1501,0,0,0,1.0,1,1.0,1,1.0,1,0.11649053675087054,49
1288,0,2465,964,1501,0,0,0,1.0,1,1.0,1,1.0,1,0.11649053675087054,49
1289,1,2466,964,1502,0,0,0,1.0,1,1.0,1,1.0,1,0.11586280951978113,52
1290,0,2466,964,1502,0,0,0,1.0,1,1.0,1,1.0,1,0.11586280951978113,52
1291,3,2469,964,1505,0,0,0,1.0,1,1.0,1,1.0,1,0.06406111682622864,52
1292,3,2472,965,1507,0,0,0,1.0,1,1.0,1,1.0,1,0.06320276255560155,53
1293,0,2472,965,1507,0,0,0,1.0,1,1.0,1,1.0,1,0.06320276255560155,53
1294,0,2472,965,1507,0,0,0,1.0,1,1.0,1,1.0,1,0.06320276255560155,53
1295,1,2473,965,1508,0,0,0,1.0,1,1.0,1,1.0,1,0.04758033856239376,54
1296,1,2474,965,1509,0,0,0,1.0,1,1.0,1,1.0,1,0.028682758447184067,55
1297,0,2474,965,1509,0,0,0,1.0,1,1.0,1,1.0,1,0.04508810485176623,54
1298,0,2474,965,1509,0,0,0,1.0,1,1.0,1,1.0,1,0.0560584460379092,55
1299,0,2474,965,1509,0,0,0,1.0,1,1.0,1,1.0,1,0.07374497064856386,54
1300,1,2475,965,1510,0,0,0,1.0,1,1.0,1,1.0,1,0.085997970228466,55
1301,5,2480,968,1512,0,0,0,1.0,1,1.0,1,1.0,1,0.10402704554141051,54
1302,1,2481,969,1512,0,0,0,1.0,1,1.0,1,1.0,1,0.10965881969226708,54
1303,4,2485,972,1513,0,0,0,1.0,1,1.0,1,1.0,1,0.1891936661379538,50
1304,7,2492,977,1515,0,0,0,1.0,1,1.0,1,1.0,1,0.13749283770155665,51
1305,3,2495,979,1516,0,0,0,1.0,1,1.0,1,1.0,1,0.1686809929835983,48
1306,8,2503,984,1519,0,0,0,1.0,1,1.0,1,1.0,1,0.24012277916910557,48
1307,6,2509,985,1524,0,0,0,1.0,1,1.0,1,1.0,1,0.15109971814311535,48
1308,1,2510,985,1525,0,0,0,1.0,1,1.0,1,1.0,1,0.14498467571599796,46
1309,3,2513,985,1528,0,0,0,1.0,1,1.0,1,1.0,1,0.09520175443650239,47
1310,0,2513,985,1528,0,0,0,1.0,1,1.0,1,1.0,1,0.09213545540410745,46
1311,3,2516,988,1528,0,0,0,1.0,1,1.0,1,1.0,1,0.1569510790061716,46
1312,1,2517,989,1528,0,0,0,1.0,1,1.0,1,1.0,1,0.17239142686340778,45
1313,6,2523,990,1533,0,0,0,1.0,1,1.0,1,1.0,1,0.183010072761137,44
1314,2,2525,990,1535,0,0,0,1.0,1,1.0,1,1.0,1,0.1760228511069652,42
1315,2,2527,991,1536,0,0,0,1.0,1,1.0,1,1.0,1,0.19103564006052953,40
1316,2,2529,991,1538,0,0,0,1.0,1,1.0,1,1.0,1,0.1553861328225078,42
1317,3,2532,991,1541,0,0,0,1.0,1,1.0,1,1.0,1,0.1512665022597969,42
1318,0,2532,991,1541,0,0,0,1.0,1,1.0,1,1.0,1,0.1512665022597969,42
1319,1,2533,992,1541,0,0,0,1.0,1,1.0,1,1.0,1,0.19617152740337182,42
1320,2,2535,992,1543,0,0,0,1.0,1,1.0,1,1.0,1,0.16224068644897702,42
1321,3,2538,992,1546,0,0,0,1.0,1,1.0,1,1.0,1,0.0916024757909213,45
1322,4,2542,992,1550,0,0,0,1.0,1,1.0,1,1.0,1,0.08533005478633655,45
1323,2,2544,993,1551,0,0,0,1.0,1,1.0,1,1.0,1,0.08132671525954066,46
1324,0,2544,993,1551,0,0,0,1.0,1,1.0,1,1.0,1,0.09501492530649962,45
1325,1,2545,994,1551,0,0,0,1.0,1,1.0,1,1.0,1,0.12252526243282713,46
1326,0,2545,994,1551,0,0,0,1.0,1,1.0,1,1.0,1,0.13867539798691364,45
1327,1,2546,994,1552,0,0,0,1.0,1,1.0,1,1.0,1,0.1525217030668542,46
1328,0,2546,994,1552,0,0,0,1.0,1,1.0,1,1.0,1,0.1625410732583817,47
1329,1,2547,995,1552,0,0,0,1.0,1,1.0,1,1.0,1,0.16870370815534644,47
1330,1,2548,995,1553,0,0,0,1.0,1,1.0,1,1.0,1,0.1703917730110916,46
1331,2,2550,996,1554,0,0,0,1.0,1,1.0,1,1.0,1,0.1569787720181546,46
1332,3,2553,997,1556,0,0,0,1.0,1,1.0,1,1.0,1,0.19077940573564375,49
1333,3,2556,997,1559,0,0,0,1.0,1,1.0,1,1.0,1,0.13681486621938846,50
1334,0,2556,997,1559,0,0,0,1.0,1,1.0,1,1.0,1,0.13681486621938846,50
1335,1,2557,998,1559,0,0,0,1.0,1,1.0,1,1.0,1,0.17105096629884162,52
1336,1,2558,998,1560,0,0,0,1.0,1,1.0,1,1.0,1,0.15317390762073513,53
1337,6,2564,999,1565,0,0,0,1.0,1,1.0,1,1.0,1,0.14432751900290186,54
1338,5,2569,1001,1568,0,0,0,1.0,1,1.0,1,1.0,1,0.1553853537584727,54
1339,1,2570,1001,1569,0,0,0,1.0,1,1.0,1,1.0,1,0.15110586030993137,54
1340,0,2570,1001,1569,0,0,0,1.0,1,1.0,1,1.0,1,0.15021186006483614,53
1341,0,2570,1001,1569,0,0,0,1.0,1,1.0,1,1.0,1,0.16735384012426013,53
1342,1,2571,1002,1569,0,0,0,1.0,1,1.0,1,1.0,1,0.19506667190233282,52
1343,4,2575,1002,1573,0,0,0,1.0,1,1.0,1,1.0,1,0.1465568033068964,50
1344,3,2578,1004,1574,0,0,0,1.0,1,1.0,1,1.0,1,0.1730564976300694,51
1345,0,2578,1004,1574,0,0,0,1.0,1,1.0,1,1.0,1,0.16721118789781345,50
1346,8,2586,1008,1578,0,0,0,1.0,1,1.0,1,1.0,1,0.15860015631074487,50
1347,5,2591,1008,1583,0,0,0,1.0,1,1.0,1,1.0,1,0.10019056754841012,48
1348,1,2592,1008,1584,0,0,0,1.0,1,1.0,1,1.0,1,0.07492874246521353,49
1349,0,2592,1008,1584,0,0,0,1.0,1,1.0,1,1.0,1,0.07848564910868902,48
1350,1,2593,1009,1584,0,0,0,1.0,1,1.0,1,1.0,1,0.10656001335150954,49
1351,0,2593,1009,1584,0,0,0,1.0,1,1.0,1,1.0,1,0.08466258547743435,48
1352,1,2594,1010,1584,0,0,0,1.0,1,1.0,1,1.0,1,0.0938275636377052,49
1353,1,2595,1010,1585,0,0,0,1.0,1,1.0,1,1.0,1,0.060368312419330425,49
1354,0,2595,1010,1585,0,0,0,1.0,1,1.0,1,1.0,1,0.0803667865495812,49
1355,0,2595,1010,1585,0,0,0,1.0,1,1.0,1,1.0,1,0.07004115507119199,50
1356,2,2597,1011,1586,0,0,0,1.0,1,1.0,1,1.0,1,0.09109317316948379,50
1357,3,2600,1012,1588,0,0,0,1.0,1,1.0,1,1.0,1,0.09115529932261086,50
1358,4,2604,1013,1591,0,0,0,1.0,1,1.0,1,1.0,1,0.08569931798464966,51
1359,3,2607,1014,1593,0,0,0,1.0,1,1.0,1,1.0,1,0.11172371422190368,53
1360,3,2610,1014,1596,0,0,0,1.0,1,1.0,1,1.0,1,0.08097064838120781,54
1361,0,2610,1014,1596,0,0,0,1.0,1,1.0,1,1.0,1,0.08097064838120781,54
1362,1,2611,1015,1596,0,0,0,1.0,1,1.0,1,1.0,1,0.07035328745739258,55
1363,1,2612,1015,1597,0,0,0,1.0,1,1.0,1,1.0,1,0.054777938583844714,55
1364,1,2613,1015,1598,0,0,0,1.0,1,1.0,1,1.0,1,0.06856384020439651,55
1365,4,2617,1016,1601,0,0,0,1.0,1,1.0,1,1.0,1,0.08400605050826844,56
1366,1,2618,1017,1601,0,0,0,1.0,1,1.0,1,1.0,1,0.10232985933541025,56
1367,2,2620,1017,1603,0,0,0,1.0,1,1.0,1,1.0,1,0.0821819757014985,56
1368,2,2622,1018,1604,0,0,0,1.0,1,1.0,1,1.0,1,0.11120266080041052,58
1369,2,2624,1018,1606,0,0,0,1.0,1,1.0,1,1.0,1,0.092406485764752,59
1370,2,2626,1019,1607,0,0,0,1.0,1,1.0,1,1.0,1,0.07082919974428174,59
1371,1,2627,1019,1608,0,0,0,1.0,1,1.0,1,1.0,1,0.06314932227215733,59
1372,2,2629,1020,1609,0,0,0,1.0,1,1.0,1,1.0,1,0.078061462669857,59
1373,1,2630,1020,1610,0,0,0,1.0,1,1.0,1,1.0,1,0.06755782662421007,59
1374,7,2637,1024,1613,0,0,0,1.0,1,1.0,1,1.0,1,0.09543664803397191,60
1375,2,2639,1024,1615,0,0,0,1.0,1,1.0,1,1.0,1,0.08379855907181541,61
1376,2,2641,1024,1617,0,0,0,1.0,1,1.0,1,1.0,1,0.09586848349442498,61
1377,2,2643,1025,1618,0,0,0,1.0,1,1.0,1,1.0,1,0.10761346331664827,61
1378,3,2646,1028,1618,0,0,0,1.0,1,1.0,1,1.0,1,0.1838088982790124,61
1379,4,2650,1028,1622,0,0,0,1.0,1,1.0,1,1.0,1,0.13840031479711534,60
1380,2,2652,1029,1623,0,0,0,1.0,1,1.0,1,1.0,1,0.15174766890765615,60
1381,1,2653,1029,1624,0,0,0,1.0,1,1.0,1,1.0,1,0.1291064677177584,58
1382,2,2655,1030,1625,0,0,0,1.0,1,1.0,1,1.0,1,0.1536063572572763,58
1383,4,2659,1032,1627,0,0,0,1.0,1,1.0,1,1.0,1,0.11073414212207572,57
1384,2,2661,1034,1627,0,0,0,1.0,1,1.0,1,1.0,1,0.11045831054608837,54
1385,1,2662,1035,1627,0,0,0,1.0,1,1.0,1,1.0,1,0.09514295483349196,52
1386,3,2665,1037,1628,0,0,0,1.0,1,1.0,1,1.0,1,0.09531498455666647,51
1387,1,2666,1037,1629,0,0,0,1.0,1,1.0,1,1.0,1,0.09552852497072954,51
1388,1,2667,1038,1629,0,0,0,1.0,1,1.0,1,1.0,1,0.10678012854539881,52
1389,3,2670,1038,1632,0,0,0,1.0,1,1.0,1,1.0,1,0.11253627379201013,50
1390,2,2672,1039,1633,0,0,0,1.0,1,1.0,1,1.0,1,0.12138323983172099,51
1391,3,2675,1039,1636,0,0,0,1.0,1,1.0,1,1.0,1,0.09734596407236566,50
1392,1,2676,1040,1636,0,0,0,1.0,1,1.0,1,1.0,1,0.10597043207759765,50
1393,0,2676,1040,1636,0,0,0,1.0,1,1.0,1,1.0,1,0.11907516891599866,49
1394,2,2678,1041,1637,0,0,0,1.0,1,1.0,1,1.0,1,0.13473802486647793,50
1395,3,2681,1041,1640,0,0,0,1.0,1,1.0,1,1.0,1,0.0983294956459329,51
1396,1,2682,1042,1640,0,0,0,1.0,1,1.0,1,1.0,1,0.14844388963521868,52
1397,2,2684,1042,1642,0,0,0,1.0,1,1.0,1,1.0,1,0.1349812954930494,52
1398,0,2684,1042,1642,0,0,0,1.0,1,1.0,1,1.0,1,0.12416188149483119,53
1399,1,2685,1043,1642,0,0,0,1.0,1,1.0,1,1.0,1,0.14513154672550446,54
1400,2,2687,1044,1643,0,0,0,1.0,1,1.0,1,1.0,1,0.15452974352876495,54
1401,2,2689,1045,1644,0,0,0,1.0,1,1.0,1,1.0,1,0.1580608573114285,54
1402,4,2693,1047,1646,0,0,0,1.0,1,1.0,1,1.0,1,0.16413595510777942,53
1403,0,2693,1047,1646,0,0,0,1.0,1,1.0,1,1.0,1,0.18175666365887702,52
1404,1,2694,1047,1647,0,0,0,1.0,1,1.0,1,1.0,1,0.18497890296469804,53
1405,2,2696,1047,1649,0,0,0,1.0,1,1.0,1,1.0,1,0.18894747391018202,52
1406,0,2696,1047,1649,0,0,0,1.0,1,1.0,1,1.0,1,0.17494850344051052,53
1407,1,2697,1047,1650,0,0,0,1.0,1,1.0,1,1.0,1,0.17726955572637726,54
1408,0,2697,1047,1650,0,0,0,1.0,1,1.0,1,1.0,1,0.1894453036923238,53
1409,0,2697,1047,1650,0,0,0,1.0,1,1.0,1,1.0,1,0.19293084824535417,55
1410,0,2697,1047,1650,0,0,0,1.0,1,1.0,1,1.0,1,0.19718493602619944,54
1411,2,2699,1047,1652,0,0,0,1.0,1,1.0,1,1.0,1,0.17316874232330406,54
1412,0,2699,1047,1652,0,0,0,1.0,1,1.0,1,1.0,1,0.176945606421538,53
1413,2,2701,1047,1654,0,0,0,1.0,1,1.0,1,1.0,1,0.15667664646915327,54
1414,3,2704,1047,1657,0,0,0,1.0,1,1.0,1,1.0,1,0.14825532174077805,55
1415,1,2705,1047,1658,0,0,0,1.0,1,1.0,1,1.0,1,0.11593460785609545,57
1416,4,2709,1048,1661,0,0,0,1.0,1,1.0,1,1.0,1,0.13936196475851123,59
1417,4,2713,1052,1661,0,0,0,1.0,1,1.0,1,1.0,1,0.188861910897916,58
1418,4,2717,1053,1664,0,0,0,1.0,1,1.0,1,1.0,1,0.17533517071703875,57
1419,3,2720,1054,1666,0,0,0,1.0,1,1.0,1,1.0,1,0.1716617329106441,56
1420,2,2722,1055,1667,0,0,0,1.0,1,1.0,1,1.0,1,0.22654121585083511,54
1421,7,2729,1055,1674,0,0,0,1.0,1,1.0,1,1.0,1,0.15455753770391548,55
1422,0,2729,1055,1674,0,0,0,1.0,1,1.0,1,1.0,1,0.17451127994170576,52
1423,10,2739,1057,1682,0,0,0,1.0,1,1.0,1,1.0,1,0.15969320757520336,52
1424,4,2743,1059,1684,0,0,0,1.0,1,1.0,1,1.0,1,0.13932435144345087,51
1425,5,2748,1059,1689,0,0,0,1.0,1,1.0,1,1.0,1,0.10615218172492541,50
1426,4,2752,1060,1692,0,0,0,1.0,1,1.0,1,1.0,1,0.10599034761506008,50
1427,2,2754,1060,1694,0,0,0,1.0,1,1.0,1,1.0,1,0.1084602151680544,48
1428,3,2757,1062,1695,0,0,0,1.0,1,1.0,1,1.0,1,0.11439188816889738,48
1429,1,2758,1062,1696,0,0,0,1.0,1,1.0,1,1.0,1,0.11311723809332445,48
1430,1,2759,1062,1697,0,0,0,1.0,1,1.0,1,1.0,1,0.09980879406114951,48
1431,0,2759,1062,1697,0,0,0,1.0,1,1.0,1,1.0,1,0.09980879406114951,48
1432,0,2759,1062,1697,0,0,0,1.0,1,1.0,1,1.0,1,0.07411314326711999,50
1433,1,2760,1062,1698,0,0,0,1.0,1,1.0,1,1.0,1,0.06797709917341235,51
1434,3,2763,1065,1698,0,0,0,1.0,1,1.0,1,1.0,1,0.10355108302418971,51
1435,2,2765,1067,1698,0,0,0,1.0,1,1.0,1,1.0,1,0.116939657502185,50
1436,4,2769,1069,1700,0,0,0,1.0,1,1.0,1,1.0,1,0.112232052532908,51
1437,1,2770,1069,1701,0,0,0,1.0,1,1.0,1,1.0,1,0.09485322413175085,51
1438,2,2772,1071,1701,0,0,0,1.0,1,1.0,1,1.0,1,0.11617539909297454,51
1439,3,2775,1073,1702,0,0,0,1.0,1,1.0,1,1.0,1,0.13920964699674954,50
1440,4,2779,1074,1705,0,0,0,1.0,1,1.0,1,1.0,1,0.15078428383581785,51
1441,2,2781,1074,1707,0,0,0,1.0,1,1.0,1,1.0,1,0.13325345212047396,51
1442,5,2786,1075,1711,0,0,0,1.0,1,1.0,1,1.0,1,0.11222973841607788,52
1443,1,2787,1075,1712,0,0,0,1.0,1,1.0,1,1.0,1,0.126203956137986,53
1444,1,2788,1075,1713,0,0,0,1.0,1,1.0,1,1.0,1,0.11252511150286444,54
1445,3,2791,1076,1715,0,0,0,1.0,1,1.0,1,1.0,1,0.09418050337381272,54
1446,1,2792,1076,1716,0,0,0,1.0,1,1.0,1,1.0,1,0.11200847868880669,54
1447,0,2792,1076,1716,0,0,0,1.0,1,1.0,1,1.0,1,0.10046615621877747,55
1448,1,2793,1076,1717,0,0,0,1.0,1,1.0,1,1.0,1,0.08851795985377824,55
1449,0,2793,1076,1717,0,0,0,1.0,1,1.0,1,1.0,1,0.08851795985377824,55
1450,2,2795,1076,1719,0,0,0,1.0,1,1.0,1,1.0,1,0.0845044198022642,57
1451,0,2795,1076,1719,0,0,0,1.0,1,1.0,1,1.0,1,0.0845044198022642,57
1452,0,2795,1076,1719,0,0,0,1.0,1,1.0,1,1.0,1,0.0845044198022642,57
1453,3,2798,1077,1721,0,0,0,1.0,1,1.0,1,1.0,1,0.10280207127122584,57
1454,2,2800,1078,1722,0,0,0,1.0,1,1.0,1,1.0,1,0.1314621217454539,58
1455,0,2800,1078,1722,0,0,0,1.0,1,1.0,1,1.0,1,0.13233018215566977,56
1456,2,2802,1079,1723,0,0,0,1.0,1,1.0,1,1.0,1,0.1390416742322107,55
1457,3,2805,1079,1726,0,0,0,1.0,1,1.0,1,1.0,1,0.10986975614236141,54
1458,1,2806,1080,1726,0,0,0,1.0,1,1.0,1,1.0,1,0.12236231641372546,53
1459,2,2808,1080,1728,0,0,0,1.0,1,1.0,1,1.0,1,0.11321254204031952,52
1460,0,2808,1080,1728,0,0,0,1.0,1,1.0,1,1.0,1,0.10552509574548732,51
1461,2,2810,1082,1728,0,0,0,1.0,1,1.0,1,1.0,1,0.12857456935073555,51
1462,4,2814,1085,1729,0,0,0,1.0,1,1.0,1,1.0,1,0.10040626384512462,51
1463,6,2820,1089,1731,0,0,0,1.0,1,1.0,1,1.0,1,0.16162869632492624,52
1464,5,2825,1092,1733,0,0,0,1.0,1,1.0,1,1.0,1,0.16278751383932502,52
1465,3,2828,1094,1734,0,0,0,1.0,1,1.0,1,1.0,1,0.18254510005946528,51
1466,5,2833,1098,1735,0,0,0,1.0,1,1.0,1,1.0,1,0.2103974559283494,50
1467,6,2839,1100,1739,0,0,0,1.0,1,1.0,1,1.0,1,0.1827548017022824,48
1468,3,2842,1101,1741,0,0,0,1.0,1,1.0,1,1.0,1,0.13097864906911694,48
1469,11,2853,1104,1749,0,0,0,1.0,1,1.0,1,1.0,1,0.1139653640830611,48
1470,1,2854,1104,1750,0,0,0,1.0,1,1.0,1,1.0,1,0.12559312082326887,48
1471,2,2856,1106,1750,0,0,0,1.0,1,1.0,1,1.0,1,0.15454465532363576,45
1472,2,2858,1106,1752,0,0,0,1.0,1,1.0,1,1.0,1,0.14022190829905212,45
1473,2,2860,1106,1754,0,0,0,1.0,1,1.0,1,1.0,1,0.1148222349634408,46
1474,3,2863,1106,1757,0,0,0,1.0,1,1.0,1,1.0,1,0.10877959694135579,46
1475,2,2865,1107,1758,0,0,0,1.0,1,1.0,1,1.0,1,0.07419516713124445,46
1476,0,2865,1107,1758,0,0,0,1.0,1,1.0,1,1.0,1,0.0838096085465541,47
1477,2,2867,1108,1759,0,0,0,1.0,1,1.0,1,1.0,1,0.08275025238444536,47
1478,3,2870,1109,1761,0,0,0,1.0,1,1.0,1,1.0,1,0.09328924735432405,47
1479,0,2870,1109,1761,0,0,0,1.0,1,1.0,1,1.0,1,0.10170592261117264,48
1480,2,2872,1110,1762,0,0,0,1.0,1,1.0,1,1.0,1,0.09316657500592117,47
1481,2,2874,1111,1763,0,0,0,1.0,1,1.0,1,1.0,1,0.10138056550083385,47
1482,1,2875,1112,1763,0,0,0,1.0,1,1.0,1,1.0,1,0.11196928483555602,46
1483,1,2876,1113,1763,0,0,0,1.0,1,1.0,1,1.0,1,0.12468038642351642,47
1484,3,2879,1113,1766,0,0,0,1.0,1,1.0,1,1.0,1,0.11131319287112525,47
1485,1,2880,1113,1767,0,0,0,1.0,1,1.0,1,1.0,1,0.13823216804564867,47
1486,3,2883,1113,1770,0,0,0,1.0,1,1.0,1,1.0,1,0.1203112102453004,49
1487,1,2884,1113,1771,0,0,0,1.0,1,1.0,1,1.0,1,0.10910492839089941,49
1488,1,2885,1114,1771,0,0,0,1.0,1,1.0,1,1.0,1,0.11534007026795531,51
1489,3,2888,1115,1773,0,0,0,1.0,1,1.0,1,1.0,1,0.13029648445730602,52
1490,1,2889,1116,1773,0,0,0,1.0,1,1.0,1,1.0,1,0.11305954379634564,52
1491,3,2892,1119,1773,0,0,0,1.0,1,1.0,1,1.0,1,0.15170647826255237,53
1492,7,2899,1123,1776,0,0,0,1.0,1,1.0,1,1.0,1,0.17151131706855585,53
1493,3,2902,1124,1778,0,0,0,1.0,1,1.0,1,1.0,1,0.1333282752093335,52
1494,2,2904,1125,1779,0,0,0,1.0,1,1.0,1,1.0,1,0.10873106223831513,50
1495,4,2908,1127,1781,0,0,0,1.0,1,1.0,1,1.0,1,0.10241241713770646,50
1496,1,2909,1127,1782,0,0,0,1.0,1,1.0,1,1.0,1,0.10551355644482965,52
1497,4,2913,1129,1784,0,0,0,1.0,1,1.0,1,1.0,1,0.1330563673843031,51
1498,1,2914,1130,1784,0,0,0,1.0,1,1.0,1,1.0,1,0.13971693434063537,50
1499,2,2916,1131,1785,0,0,0,1.0,1,1.0,1,1.0,1,0.12017714502546338,50
1500,1,2917,1132,1785,0,0,0,1.0,1,1.0,1,1.0,1,0.127802425369925,49
1501,3,2920,1133,1787,0,0,0,1.0,1,1.0,1,1.0,1,0.1002456422539295,47
1502,3,2923,1136,1787,0,0,0,1.0,1,1.0,1,1.0,1,0.13739458503486465,47
1503,3,2926,1136,1790,0,0,0,1.0,1,1.0,1,1.0,1,0.09954323907523034,47
1504,1,2927,1137,1790,0,0,0,1.0,1,1.0,1,1.0,1,0.1156185637926279,48
1505,4,2931,1139,1792,0,0,0,1.0,1,1.0,1,1.0,1,0.08178956792863305,47
1506,2,2933,1141,1792,0,0,0,1.0,1,1.0,1,1.0,1,0.11260838945849191,47
1507,3,2936,1143,1793,0,0,0,1.0,1,1.0,1,1.0,1,0.1390439594529119,45
1508,2,2938,1143,1795,0,0,0,1.0,1,1.0,1,1.0,1,0.11754032631974824,45
1509,3,2941,1145,1796,0,0,0,1.0,1,1.0,1,1.0,1,0.15021599453388038,44
1510,4,2945,1147,1798,0,0,0,1.0,1,1.0,1,1.0,1,0.18164106798420565,42
1511,0,2945,1147,1798,0,0,0,1.0,1,1.0,1,1.0,1,0.16508393003945254,40
1512,3,2948,1150,1798,0,0,0,1.0,1,1.0,1,1.0,1,0.2600700142124529,39
1513,5,2953,1150,1803,0,0,0,1.0,1,1.0,1,1.0,1,0.16739933847908747,39
1514,0,2953,1150,1803,0,0,0,1.0,1,1.0,1,1.0,1,0.18398262601585702,38
1515,3,2956,1151,1805,0,0,0,1.0,1,1.0,1,1.0,1,0.18344407771864643,39
1516,1,2957,1151,1806,0,0,0,1.0,1,1.0,1,1.0,1,0.16389396229029035,39
1517,6,2963,1153,1810,0,0,0,1.0,1,1.0,1,1.0,1,0.13094392101738128,39
1518,2,2965,1154,1811,0,0,0,1.0,1,1.0,1,1.0,1,0.14674961014597748,39
1519,2,2967,1154,1813,0,0,0,1.0,1,1.0,1,1.0,1,0.09634368064246285,39
1520,3,2970,1157,1813,0,0,0,1.0,1,1.0,1,1.0,1,0.17827989034229652,39
1521,3,2973,1158,1815,0,0,0,1.0,1,1.0,1,1.0,1,0.1807577784199143,40
1522,1,2974,1159,1815,0,0,0,1.0,1,1.0,1,1.0,1,0.20713895163193505,40
1523,4,2978,1159,1819,0,0,0,1.0,1,1.0,1,1.0,1,0.11660746694528852,41
1524,0,2978,1159,1819,0,0,0,1.0,1,1.0,1,1.0,1,0.12525306873824554,42
1525,0,2978,1159,1819,0,0,0,1.0,1,1.0,1,1.0,1,0.13547769074672403,45
1526,0,2978,1159,1819,0,0,0,1.0,1,1.0,1,1.0,1,0.13914247163214494,46
1527,1,2979,1159,1820,0,0,0,1.0,1,1.0,1,1.0,1,0.10972401025018659,46
1528,1,2980,1159,1821,0,0,0,1.0,1,1.0,1,1.0,1,0.10547092923885035,47
1529,0,2980,1159,1821,0,0,0,1.0,1,1.0,1,1.0,1,0.10547092923885035,47
1530,0,2980,1159,1821,0,0,0,1.0,1,1.0,1,1.0,1,0.12074997026884506,48
1531,1,2981,1159,1822,0,0,0,1.0,1,1.0,1,1.0,1,0.11200910195448946,46
1532,3,2984,1161,1823,0,0,0,1.0,1,1.0,1,1.0,1,0.1036254366174652,47
1533,0,2984,1161,1823,0,0,0,1.0,1,1.0,1,1.0,1,0.09808470498512993,46
1534,1,2985,1162,1823,0,0,0,1.0,1,1.0,1,1.0,1,0.10774737771816308,47
1535,1,2986,1163,1823,0,0,0,1.0,1,1.0,1,1.0,1,0.10772244973700582,47
1536,0,2986,1163,1823,0,0,0,1.0,1,1.0,1,1.0,1,0.12206703257490598,48
1537,1,2987,1163,1824,0,0,0,1.0,1,1.0,1,1.0,1,0.10075735933583949,46
1538,3,2990,1163,1827,0,0,0,1.0,1,1.0,1,1.0,1,0.10866021093596621,47
1539,2,2992,1163,1829,0,0,0,1.0,1,1.0,1,1.0,1,0.09455322437481724,47
1540,2,2994,1164,1830,0,0,0,1.0,1,1.0,1,1.0,1,0.09554295359580263,47
1541,1,2995,1164,1831,0,0,0,1.0,1,1.0,1,1.0,1,0.08387878965361899,47
1542,3,2998,1166,1832,0,0,0,1.0,1,1.0,1,1.0,1,0.14274691438107268,50
1543,3,3001,1167,1834,0,0,0,1.0,1,1.0,1,1.0,1,0.1070376746891211,47
1544,4,3005,1171,1834,0,0,0,1.0,1,1.0,1,1.0,1,0.1940959115268137,48
1545,6,3011,1173,1838,0,0,0,1.0,1,1.0,1,1.0,1,0.09144158512076722,47
1546,3,3014,1175,1839,0,0,0,1.0,1,1.0,1,1.0,1,0.10048462875547712,47
1547,2,3016,1176,1840,0,0,0,1.0,1,1.0,1,1.0,1,0.10535374519056831,47
1548,4,3020,1180,1840,0,0,0,1.0,1,1.0,1,1.0,1,0.13912468129463065,47
1549,4,3024,1183,1841,0,0,0,1.0,1,1.0,1,1.0,1,0.11272284715764076,46
1550,4,3028,1185,1843,0,0,0,1.0,1,1.0,1,1.0,1,0.12548685366128381,44
1551,6,3034,1187,1847,0,0,0,1.0,1,1.0,1,1.0,1,0.07099363795618345,45
1552,5,3039,1189,1850,0,0,0,1.0,1,1.0,1,1.0,1,0.07100390025047723,43
1553,3,3042,1192,1850,0,0,0,1.0,1,1.0,1,1.0,1,0.11803310255395265,43
1554,0,3042,1192,1850,0,0,0,1.0,1,1.0,1,1.0,1,0.11264850855359894,41
1555,3,3045,1192,1853,0,0,0,1.0,1,1.0,1,1.0,1,0.08227186694696016,44
1556,2,3047,1193,1854,0,0,0,1.0,1,1.0,1,1.0,1,0.09691013359133309,45
1557,1,3048,1194,1854,0,0,0,1.0,1,1.0,1,1.0,1,0.13371700949302234,45
1558,1,3049,1194,1855,0,0,0,1.0,1,1.0,1,1.0,1,0.10941787671960898,46
1559,6,3055,1196,1859,0,0,0,1.0,1,1.0,1,1.0,1,0.09436424607309755,47
1560,1,3056,1196,1860,0,0,0,1.0,1,1.0,1,1.0,1,0.0835552513280477,46
1561,0,3056,1196,1860,0,0,0,1.0,1,1.0,1,1.0,1,0.08142606610652203,47
1562,0,3056,1196,1860,0,0,0,1.0,1,1.0,1,1.0,1,0.10211352015139087,47
1563,0,3056,1196,1860,0,0,0,1.0,1,1.0,1,1.0,1,0.10211352015139087,47
1564,0,3056,1196,1860,0,0,0,1.0,1,1.0,1,1.0,1,0.10211352015139087,47
1565,1,3057,1196,1861,0,0,0,1.0,1,1.0,1,1.0,1,0.11356762903572241,48
1566,2,3059,1197,1862,0,0,0,1.0,1,1.0,1,1.0,1,0.10737596650354608,48
1567,4,3063,1197,1866,0,0,0,1.0,1,1.0,1,1.0,1,0.04853422784165087,48
1568,2,3065,1198,1867,0,0,0,1.0,1,1.0,1,1.0,1,0.08590896669534222,48
1569,0,3065,1198,1867,0,0,0,1.0,1,1.0,1,1.0,1,0.08236948476939884,45
1570,0,3065,1198,1867,0,0,0,1.0,1,1.0,1,1.0,1,0.09462106096136273,44
1571,5,3070,1202,1868,0,0,0,1.0,1,1.0,1,1.0,1,0.15877019563039665,42
1572,3,3073,1203,1870,0,0,0,1.0,1,1.0,1,1.0,1,0.20799726497353638,43
1573,5,3078,1203,1875,0,0,0,1.0,1,1.0,1,1.0,1,0.11063441710877286,43
1574,3,3081,1205,1876,0,0,0,1.0,1,1.0,1,1.0,1,0.11446610621998088,42
1575,2,3083,1207,1876,0,0,0,1.0,1,1.0,1,1.0,1,0.17782005466222572,43
1576,2,3085,1209,1876,0,0,0,1.0,1,1.0,1,1.0,1,0.15128502538109026,41
1577,4,3089,1210,1879,0,0,0,1.0,1,1.0,1,1.0,1,0.10950928597530676,40
1578,0,3089,1210,1879,0,0,0,1.0,1,1.0,1,1.0,1,0.11385977256465192,40
1579,0,3089,1210,1879,0,0,0,1.0,1,1.0,1,1.0,1,0.11463977707639217,40
1580,0,3089,1210,1879,0,0,0,1.0,1,1.0,1,1.0,1,0.11463977707639217,40
1581,1,3090,1211,1879,0,0,0,1.0,1,1.0,1,1.0,1,0.12754482400344574,40
1582,5,3095,1214,1881,0,0,0,1.0,1,1.0,1,1.0,1,0.18569080554362005,40
1583,5,3100,1214,1886,0,0,0,1.0,1,1.0,1,1.0,1,0.1433738044797871,38
1584,4,3104,1217,1887,0,0,0,1.0,1,1.0,1,1.0,1,0.21812623526070277,39
1585,6,3110,1218,1892,0,0,0,1.0,1,1.0,1,1.0,1,0.10518113487302601,38
1586,1,3111,1219,1892,0,0,0,1.0,1,1.0,1,1.0,1,0.11637053684421601,38
1587,3,3114,1220,1894,0,0,0,1.0,1,1.0,1,1.0,1,0.0953485275141206,37
1588,6,3120,1223,1897,0,0,0,1.0,1,1.0,1,1.0,1,0.11063071188172179,39
1589,2,3122,1225,1897,0,0,0,1.0,1,1.0,1,1.0,1,0.10134346606158814,37
1590,1,3123,1226,1897,0,0,0,1.0,1,1.0,1,1.0,1,0.15107402779716475,37
1591,5,3128,1228,1900,0,0,0,1.0,1,1.0,1,1.0,1,0.1673437877467214,36
1592,2,3130,1228,1902,0,0,0,1.0,1,1.0,1,1.0,1,0.2085716706884837,34
1593,1,3131,1229,1902,0,0,0,1.0,1,1.0,1,1.0,1,0.22390928293574797,33
1594,0,3131,1229,1902,0,0,0,1.0,1,1.0,1,1.0,1,0.2840209016811142,31
1595,6,3137,1230,1907,0,0,0,1.0,1,1.0,1,1.0,1,0.1710910774489151,34
1596,2,3139,1230,1909,0,0,0,1.0,1,1.0,1,1.0,1,0.14962067602299797,33
1597,1,3140,1231,1909,0,0,0,1.0,1,1.0,1,1.0,1,0.18263988341206364,33
1598,0,3140,1231,1909,0,0,0,1.0,1,1.0,1,1.0,1,0.1712347311423785,33
1599,0,3140,1231,1909,0,0,0,1.0,1,1.0,1,1.0,1,0.1712347311423785,33
1600,2,3142,1232,1910,0,0,0,1.0,1,1.0,1,1.0,1,0.16532772666277443,34
1601,2,3144,1233,1911,0,0,0,1.0,1,1.0,1,1.0,1,0.17968254246643986,35
1602,3,3147,1234,1913,0,0,0,1.0,1,1.0,1,1.0,1,0.12677838321898818,36
1603,2,3149,1234,1915,0,0,0,1.0,1,1.0,1,1.0,1,0.11136385942894589,38
1604,0,3149,1234,1915,0,0,0,1.0,1,1.0,1,1.0,1,0.11136385942894589,38
1605,1,3150,1235,1915,0,0,0,1.0,1,1.0,1,1.0,1,0.13038438067792288,38
1606,6,3156,1238,1918,0,0,0,1.0,1,1.0,1,1.0,1,0.138596197936218,39
1607,0,3156,1238,1918,0,0,0,1.0,1,1.0,1,1.0,1,0.1276121877147453,37
1608,0,3156,1238,1918,0,0,0,1.0,1,1.0,1,1.0,1,0.14859049331721386,36
1609,0,3156,1238,1918,0,0,0,1.0,1,1.0,1,1.0,1,0.1254909797345242,34
1610,0,3156,1238,1918,0,0,0,1.0,1,1.0,1,1.0,1,0.1292614911199129,34
1611,3,3159,1239,1920,0,0,0,1.0,1,1.0,1,1.0,1,0.15998310562078905,35
1612,1,3160,1239,1921,0,0,0,1.0,1,1.0,1,1.0,1,0.1441042638904766,33
1613,2,3162,1240,1922,0,0,0,1.0,1,1.0,1,1.0,1,0.18222859967071361,34
1614,0,3162,1240,1922,0,0,0,1.0,1,1.0,1,1.0,1,0.17454635171492786,35
1615,2,3164,1240,1924,0,0,0,1.0,1,1.0,1,1.0,1,0.13248346010702894,35
1616,2,3166,1241,1925,0,0,0,1.0,1,1.0,1,1.0,1,0.1391361201738759,37
1617,3,3169,1243,1926,0,0,0,1.0,1,1.0,1,1.0,1,0.1382305665728219,38
1618,1,3170,1243,1927,0,0,0,1.0,1,1.0,1,1.0,1,0.12576644616777952,38
1619,2,3172,1244,1928,0,0,0,1.0,1,1.0,1,1.0,1,0.12731697925191446,38
1620,2,3174,1245,1929,0,0,0,1.0,1,1.0,1,1.0,1,0.14808478112207768,39
1621,1,3175,1245,1930,0,0,0,1.0,1,1.0,1,1.0,1,0.14299547060864892,37
1622,3,3178,1246,1932,0,0,0,1.0,1,1.0,1,1.0,1,0.15819870730929994,37
1623,2,3180,1248,1932,0,0,0,1.0,1,1.0,1,1.0,1,0.19810785879921244,37
1624,2,3182,1249,1933,0,0,0,1.0,1,1.0,1,1.0,1,0.18837969865629997,37
1625,2,3184,1249,1935,0,0,0,1.0,1,1.0,1,1.0,1,0.15260061436998426,35
1626,2,3186,1250,1936,0,0,0,1.0,1,1.0,1,1.0,1,0.17919822147337364,35
1627,2,3188,1251,1937,0,0,0,1.0,1,1.0,1,1.0,1,0.1635120933020827,34
1628,3,3191,1252,1939,0,0,0,1.0,1,1.0,1,1.0,1,0.16885770954782375,35
1629,2,3193,1254,1939,0,0,0,1.0,1,1.0,1,1.0,1,0.17318880852979943,34
1630,1,3194,1254,1940,0,0,0,1.0,1,1.0,1,1.0,1,0.09313979844057621,32
1631,0,3194,1254,1940,0,0,0,1.0,1,1.0,1,1.0,1,0.11174641111636054,33
1632,1,3195,1255,1940,0,0,0,1.0,1,1.0,1,1.0,1,0.17676587382325953,32
1633,0,3195,1255,1940,0,0,0,1.0,1,1.0,1,1.0,1,0.16005272076325214,31
1634,1,3196,1256,1940,0,0,0,1.0,1,1.0,1,1.0,1,0.2210052525094685,31
1635,0,3196,1256,1940,0,0,0,1.0,1,1.0,1,1.0,1,0.21885062455738663,31
1636,2,3198,1256,1942,0,0,0,1.0,1,1.0,1,1.0,1,0.20035278501122886,33
1637,0,3198,1256,1942,0,0,0,1.0,1,1.0,1,1.0,1,0.20035278501122886,33
1638,1,3199,1256,1943,0,0,0,1.0,1,1.0,1,1.0,1,0.19779514041552243,36
1639,2,3201,1256,1945,0,0,0,1.0,1,1.0,1,1.0,1,0.16080223114201203,36
1640,1,3202,1257,1945,0,0,0,1.0,1,1.0,1,1.0,1,0.18427684478259865,36
1641,0,3202,1257,1945,0,0,0,1.0,1,1.0,1,1.0,1,0.1909050126787167,38
1642,1,3203,1258,1945,0,0,0,1.0,1,1.0,1,1.0,1,0.23752944208921395,37
1643,2,3205,1259,1946,0,0,0,1.0,1,1.0,1,1.0,1,0.20144156454155415,37
1644,2,3207,1261,1946,0,0,0,1.0,1,1.0,1,1.0,1,0.28429724065676076,38
1645,4,3211,1261,1950,0,0,0,1.0,1,1.0,1,1.0,1,0.21032395788090413,36
1646,2,3213,1262,1951,0,0,0,1.0,1,1.0,1,1.0,1,0.21914138158007798,37
1647,6,3219,1264,1955,0,0,0,1.0,1,1.0,1,1.0,1,0.15343859630456042,35
1648,1,3220,1264,1956,0,0,0,1.0,1,1.0,1,1.0,1,0.16835230595759507,38
1649,2,3222,1265,1957,0,0,0,1.0,1,1.0,1,1.0,1,0.14968603129250052,35
1650,0,3222,1265,1957,0,0,0,1.0,1,1.0,1,1.0,1,0.16231552750692835,34
1651,0,3222,1265,1957,0,0,0,1.0,1,1.0,1,1.0,1,0.1793805627296497,32
1652,1,3223,1265,1958,0,0,0,1.0,1,1.0,1,1.0,1,0.18311801769952926,33
1653,0,3223,1265,1958,0,0,0,1.0,1,1.0,1,1.0,1,0.18311801769952926,33
1654,1,3224,1265,1959,0,0,0,1.0,1,1.0,1,1.0,1,0.17385493342111946,34
1655,2,3226,1265,1961,0,0,0,1.0,1,1.0,1,1.0,1,0.15614609960973833,35
1656,1,3227,1265,1962,0,0,0,1.0,1,1.0,1,1.0,1,0.12909487624188917,35
1657,0,3227,1265,1962,0,0,0,1.0,1,1.0,1,1.0,1,0.1408119891144737,36
1658,1,3228,1266,1962,0,0,0,1.0,1,1.0,1,1.0,1,0.11468646697266056,36
1659,0,3228,1266,1962,0,0,0,1.0,1,1.0,1,1.0,1,0.11468646697266056,36
1660,5,3233,1269,1964,0,0,0,1.0,1,1.0,1,1.0,1,0.1142920764554682,38
1661,1,3234,1269,1965,0,0,0,1.0,1,1.0,1,1.0,1,0.09473708662523099,38
1662,4,3238,1272,1966,0,0,0,1.0,1,1.0,1,1.0,1,0.09638187087636285,39
1663,2,3240,1273,1967,0,0,0,1.0,1,1.0,1,1.0,1,0.13340692022960648,40
1664,1,3241,1274,1967,0,0,0,1.0,1,1.0,1,1.0,1,0.17001121550367915,39
1665,5,3246,1275,1971,0,0,0,1.0,1,1.0,1,1.0,1,0.13114091368756672,40
1666,2,3248,1277,1971,0,0,0,1.0,1,1.0,1,1.0,1,0.18327342894026394,40
1667,5,3253,1281,1972,0,0,0,1.0,1,1.0,1,1.0,1,0.15968034144772766,40
1668,2,3255,1282,1973,0,0,0,1.0,1,1.0,1,1.0,1,0.11479877173249411,41
1669,1,3256,1282,1974,0,0,0,1.0,1,1.0,1,1.0,1,0.0677299159033376,40
1670,0,3256,1282,1974,0,0,0,1.0,1,1.0,1,1.0,1,0.0677299159033376,40
1671,1,3257,1283,1974,0,0,0,1.0,1,1.0,1,1.0,1,0.11456661323740493,41
1672,1,3258,1284,1974,0,0,0,1.0,1,1.0,1,1.0,1,0.15232734352152957,40
1673,3,3261,1286,1975,0,0,0,1.0,1,1.0,1,1.0,1,0.1722400452749549,39
1674,2,3263,1286,1977,0,0,0,1.0,1,1.0,1,1.0,1,0.13721751938562962,40
1675,2,3265,1286,1979,0,0,0,1.0,1,1.0,1,1.0,1,0.12017471233660547,38
1676,1,3266,1287,1979,0,0,0,1.0,1,1.0,1,1.0,1,0.1206314263284233,39
1677,1,3267,1287,1980,0,0,0,1.0,1,1.0,1,1.0,1,0.08095704673093475,39
1678,0,3267,1287,1980,0,0,0,1.0,1,1.0,1,1.0,1,0.08095704673093475,39
1679,1,3268,1288,1980,0,0,0,1.0,1,1.0,1,1.0,1,0.0788877644137975,39
1680,3,3271,1290,1981,0,0,0,1.0,1,1.0,1,1.0,1,0.1115220607353325,41
1681,2,3273,1291,1982,0,0,0,1.0,1,1.0,1,1.0,1,0.10937615620660046,41
1682,2,3275,1291,1984,0,0,0,1.0,1,1.0,1,1.0,1,0.08544308730001801,43
1683,3,3278,1294,1984,0,0,0,1.0,1,1.0,1,1.0,1,0.1300855427569534,43
1684,2,3280,1295,1985,0,0,0,1.0,1,1.0,1,1.0,1,0.13940850939771526,42
1685,2,3282,1296,1986,0,0,0,1.0,1,1.0,1,1.0,1,0.15768867622874166,41
1686,5,3287,1297,1990,0,0,0,1.0,1,1.0,1,1.0,1,0.14771286850650506,41
1687,2,3289,1297,1992,0,0,0,1.0,1,1.0,1,1.0,1,0.09967795028482254,40
1688,3,3292,1300,1992,0,0,0,1.0,1,1.0,1,1.0,1,0.14931028815469677,39
1689,4,3296,1301,1995,0,0,0,1.0,1,1.0,1,1.0,1,0.1503222821315377,38
1690,0,3296,1301,1995,0,0,0,1.0,1,1.0,1,1.0,1,0.14240153002786268,38
1691,0,3296,1301,1995,0,0,0,1.0,1,1.0,1,1.0,1,0.14044008703390432,36
1692,1,3297,1302,1995,0,0,0,1.0,1,1.0,1,1.0,1,0.177559016543329,36
1693,1,3298,1303,1995,0,0,0,1.0,1,1.0,1,1.0,1,0.18752069361517032,35
1694,0,3298,1303,1995,0,0,0,1.0,1,1.0,1,1.0,1,0.17069215709525284,33
1695,0,3298,1303,1995,0,0,0,1.0,1,1.0,1,1.0,1,0.18142669897543565,34
1696,2,3300,1304,1996,0,0,0,1.0,1,1.0,1,1.0,1,0.17365262709975285,35
1697,3,3303,1305,1998,0,0,0,1.0,1,1.0,1,1.0,1,0.16359477439269093,36
1698,2,3305,1307,1998,0,0,0,1.0,1,1.0,1,1.0,1,0.19487945148819807,38
1699,2,3307,1308,1999,0,0,0,1.0,1,1.0,1,1.0,1,0.21124116012074914,38
1700,2,3309,1308,2001,0,0,0,1.0,1,1.0,1,1.0,1,0.18177615727103605,39
1701,3,3312,1309,2003,0,0,0,1.0,1,1.0,1,1.0,1,0.1749715600384218,40
1702,5,3317,1312,2005,0,0,0,1.0,1,1.0,1,1.0,1,0.18529667744183673,41
1703,3,3320,1313,2007,0,0,0,1.0,1,1.0,1,1.0,1,0.17681888426246614,41
1704,4,3324,1316,2008,0,0,0,1.0,1,1.0,1,1.0,1,0.18956392475798067,41
1705,2,3326,1317,2009,0,0,0,1.0,1,1.0,1,1.0,1,0.14531684792377905,40
1706,1,3327,1317,2010,0,0,0,1.0,1,1.0,1,1.0,1,0.13443416889661858,40
1707,4,3331,1317,2014,0,0,0,1.0,1,1.0,1,1.0,1,0.07064794404405228,39
1708,1,3332,1318,2014,0,0,0,1.0,1,1.0,1,1.0,1,0.0976825120795454,39
1709,0,3332,1318,2014,0,0,0,1.0,1,1.0,1,1.0,1,0.08706102073105526,38
1710,4,3336,1320,2016,0,0,0,1.0,1,1.0,1,1.0,1,0.15112914679196685,39
1711,4,3340,1321,2019,0,0,0,1.0,1,1.0,1,1.0,1,0.14077127022510968,38
1712,3,3343,1323,2020,0,0,0,1.0,1,1.0,1,1.0,1,0.15720864996741657,38
1713,1,3344,1323,2021,0,0,0,1.0,1,1.0,1,1.0,1,0.1461538836883494,37
1714,2,3346,1324,2022,0,0,0,1.0,1,1.0,1,1.0,1,0.15388563589887747,38
1715,2,3348,1325,2023,0,0,0,1.0,1,1.0,1,1.0,1,0.14362768328904585,40
1716,0,3348,1325,2023,0,0,0,1.0,1,1.0,1,1.0,1,0.14945369097552502,39
1717,0,3348,1325,2023,0,0,0,1.0,1,1.0,1,1.0,1,0.1462516602726426,38
1718,0,3348,1325,2023,0,0,0,1.0,1,1.0,1,1.0,1,0.1765621404431753,38
1719,0,3348,1325,2023,0,0,0,1.0,1,1.0,1,1.0,1,0.1765621404431753,38
1720,0,3348,1325,2023,0,0,0,1.0,1,1.0,1,1.0,1,0.18201652347934455,41
1721,1,3349,1326,2023,0,0,0,1.0,1,1.0,1,1.0,1,0.1605450674075911,39
1722,4,3353,1328,2025,0,0,0,1.0,1,1.0,1,1.0,1,0.1535048657134708,40
1723,1,3354,1329,2025,0,0,0,1.0,1,1.0,1,1.0,1,0.15083737846962728,38
1724,0,3354,1329,2025,0,0,0,1.0,1,1.0,1,1.0,1,0.14779633769603237,37
1725,1,3355,1329,2026,0,0,0,1.0,1,1.0,1,1.0,1,0.1435132241453269,38
1726,2,3357,1330,2027,0,0,0,1.0,1,1.0,1,1.0,1,0.10619558750184117,37
1727,0,3357,1330,2027,0,0,0,1.0,1,1.0,1,1.0,1,0.10619558750184117,37
1728,0,3357,1330,2027,0,0,0,1.0,1,1.0,1,1.0,1,0.10459646448501846,35
1729,0,3357,1330,2027,0,0,0,1.0,1,1.0,1,1.0,1,0.13465395126306823,37
1730,1,3358,1331,2027,0,0,0,1.0,1,1.0,1,1.0,1,0.19179878262591546,37
1731,1,3359,1331,2028,0,0,0,1.0,1,1.0,1,1.0,1,0.16855824251110596,37
1732,2,3361,1331,2030,0,0,0,1.0,1,1.0,1,1.0,1,0.19834877907067136,37
1733,6,3367,1333,2034,0,0,0,1.0,1,1.0,1,1.0,1,0.15286124921043365,36
1734,0,3367,1333,2034,0,0,0,1.0,1,1.0,1,1.0,1,0.1531969036460036,35
1735,6,3373,1336,2037,0,0,0,1.0,1,1.0,1,1.0,1,0.14722737895164537,34
1736,2,3375,1337,2038,0,0,0,1.0,1,1.0,1,1.0,1,0.10827111027780645,35
1737,2,3377,1339,2038,0,0,0,1.0,1,1.0,1,1.0,1,0.15619254054730042,36
1738,2,3379,1339,2040,0,0,0,1.0,1,1.0,1,1.0,1,0.11560723708833565,37
1739,1,3380,1340,2040,0,0,0,1.0,1,1.0,1,1.0,1,0.11321540617746724,38
1740,0,3380,1340,2040,0,0,0,1.0,1,1.0,1,1.0,1,0.12121906616655975,37
1741,3,3383,1341,2042,0,0,0,1.0,1,1.0,1,1.0,1,0.11119089110283976,38
1742,6,3389,1344,2045,0,0,0,1.0,1,1.0,1,1.0,1,0.19925859133825538,39
1743,4,3393,1344,2049,0,0,0,1.0,1,1.0,1,1.0,1,0.12606540320780954,37
1744,5,3398,1346,2052,0,0,0,1.0,1,1.0,1,1.0,1,0.15023040964984424,38
1745,4,3402,1347,2055,0,0,0,1.0,1,1.0,1,1.0,1,0.16226204104017408,37
1746,3,3405,1348,2057,0,0,0,1.0,1,1.0,1,1.0,1,0.11516070814082348,38
1747,2,3407,1349,2058,0,0,0,1.0,1,1.0,1,1.0,1,0.10651903890751484,38
1748,1,3408,1350,2058,0,0,0,1.0,1,1.0,1,1.0,1,0.13557638380511744,38
1749,1,3409,1350,2059,0,0,0,1.0,1,1.0,1,1.0,1,0.12118979549022345,37
1750,0,3409,1350,2059,0,0,0,1.0,1,1.0,1,1.0,1,0.13161545906578107,39
1751,0,3409,1350,2059,0,0,0,1.0,1,1.0,1,1.0,1,0.13407061032641868,38
1752,1,3410,1350,2060,0,0,0,1.0,1,1.0,1,1.0,1,0.13604693524298264,39
1753,1,3411,1351,2060,0,0,0,1.0,1,1.0,1,1.0,1,0.14071197181767103,40
1754,2,3413,1351,2062,0,0,0,1.0,1,1.0,1,1.0,1,0.1292135248185104,41
1755,3,3416,1351,2065,0,0,0,1.0,1,1.0,1,1.0,1,0.08449607426050477,41
1756,2,3418,1352,2066,0,0,0,1.0,1,1.0,1,1.0,1,0.1003796746421873,42
1757,1,3419,1353,2066,0,0,0,1.0,1,1.0,1,1.0,1,0.11536469502557686,42
1758,3,3422,1356,2066,0,0,0,1.0,1,1.0,1,1.0,1,0.2054385184678928,42
1759,3,3425,1356,2069,0,0,0,1.0,1,1.0,1,1.0,1,0.17717397437288404,39
1760,1,3426,1356,2070,0,0,0,1.0,1,1.0,1,1.0,1,0.18825239189829865,39
1761,3,3429,1357,2072,0,0,0,1.0,1,1.0,1,1.0,1,0.12858217807031777,38
1762,1,3430,1357,2073,0,0,0,1.0,1,1.0,1,1.0,1,0.12313178192509532,37
1763,1,3431,1358,2073,0,0,0,1.0,1,1.0,1,1.0,1,0.1499496837299055,37
1764,2,3433,1360,2073,0,0,0,1.0,1,1.0,1,1.0,1,0.18359176623265325,36
1765,4,3437,1362,2075,0,0,0,1.0,1,1.0,1,1.0,1,0.1249698576591761,37
1766,1,3438,1362,2076,0,0,0,1.0,1,1.0,1,1.0,1,0.10510243784420333,36
1767,0,3438,1362,2076,0,0,0,1.0,1,1.0,1,1.0,1,0.10510243784420333,36
1768,0,3438,1362,2076,0,0,0,1.0,1,1.0,1,1.0,1,0.10510243784420333,36
1769,3,3441,1363,2078,0,0,0,1.0,1,1.0,1,1.0,1,0.10168212902035093,38
1770,2,3443,1364,2079,0,0,0,1.0,1,1.0,1,1.0,1,0.1328527633529816,38
1771,0,3443,1364,2079,0,0,0,1.0,1,1.0,1,1.0,1,0.1328527633529816,38
1772,3,3446,1365,2081,0,0,0,1.0,1,1.0,1,1.0,1,0.1034965032576637,40
1773,0,3446,1365,2081,0,0,0,1.0,1,1.0,1,1.0,1,0.09146522108359682,40
1774,0,3446,1365,2081,0,0,0,1.0,1,1.0,1,1.0,1,0.09146522108359682,40
1775,0,3446,1365,2081,0,0,0,1.0,1,1.0,1,1.0,1,0.10425019938016569,41
1776,0,3446,1365,2081,0,0,0,1.0,1,1.0,1,1.0,1,0.09899372340546439,43
1777,2,3448,1366,2082,0,0,0,1.0,1,1.0,1,1.0,1,0.0755369901850441,44
1778,2,3450,1368,2082,0,0,0,1.0,1,1.0,1,1.0,1,0.08917587946245113,44
1779,1,3451,1369,2082,0,0,0,1.0,1,1.0,1,1.0,1,0.11343090377168676,44
1780,3,3454,1369,2085,0,0,0,1.0,1,1.0,1,1.0,1,0.09503547271091004,46
1781,3,3457,1371,2086,0,0,0,1.0,1,1.0,1,1.0,1,0.09430100789558472,46
1782,4,3461,1373,2088,0,0,0,1.0,1,1.0,1,1.0,1,0.11375161018776835,45
1783,2,3463,1374,2089,0,0,0,1.0,1,1.0,1,1.0,1,0.13512654903919621,44
1784,0,3463,1374,2089,0,0,0,1.0,1,1.0,1,1.0,1,0.13143852451153878,44
1785,2,3465,1375,2090,0,0,0,1.0,1,1.0,1,1.0,1,0.13540845430364237,42
1786,7,3472,1378,2094,0,0,0,1.0,1,1.0,1,1.0,1,0.13328664350904115,42
1787,4,3476,1379,2097,0,0,0,1.0,1,1.0,1,1.0,1,0.11037907050742543,41
1788,4,3480,1382,2098,0,0,0,1.0,1,1.0,1,1.0,1,0.18086522876825942,41
1789,2,3482,1382,2100,0,0,0,1.0,1,1.0,1,1.0,1,0.13011251599801787,41
1790,4,3486,1384,2102,0,0,0,1.0,1,1.0,1,1.0,1,0.14556811125844335,41
1791,4,3490,1384,2106,0,0,0,1.0,1,1.0,1,1.0,1,0.08431582412431328,41
1792,0,3490,1384,2106,0,0,0,1.0,1,1.0,1,1.0,1,0.09566872745801067,43
1793,2,3492,1386,2106,0,0,0,1.0,1,1.0,1,1.0,1,0.0953953511724077,43
1794,1,3493,1387,2106,0,0,0,1.0,1,1.0,1,1.0,1,0.09000696372311337,41
1795,4,3497,1390,2107,0,0,0,1.0,1,1.0,1,1.0,1,0.11364229484808198,41
1796,1,3498,1391,2107,0,0,0,1.0,1,1.0,1,1.0,1,0.1130753315260883,40
1797,0,3498,1391,2107,0,0,0,1.0,1,1.0,1,1.0,1,0.11170461349879339,38
1798,3,3501,1392,2109,0,0,0,1.0,1,1.0,1,1.0,1,0.12008957014266719,38
1799,3,3504,1394,2110,0,0,0,1.0,1,1.0,1,1.0,1,0.14553337814055742,37
1800,2,3506,1395,2111,0,0,0,1.0,1,1.0,1,1.0,1,0.16627271293192805,35
1801,4,3510,1397,2113,0,0,0,1.0,1,1.0,1,1.0,1,0.15373881975751777,34
1802,0,3510,1397,2113,0,0,0,1.0,1,1.0,1,1.0,1,0.1361288923161273,33
1803,2,3512,1399,2113,0,0,0,1.0,1,1.0,1,1.0,1,0.2249925893330104,33
1804,2,3514,1400,2114,0,0,0,1.0,1,1.0,1,1.0,1,0.18548058381342847,33
1805,2,3516,1400,2116,0,0,0,1.0,1,1.0,1,1.0,1,0.113368236348614,35
1806,1,3517,1400,2117,0,0,0,1.0,1,1.0,1,1.0,1,0.08990705904620871,36
1807,0,3517,1400,2117,0,0,0,1.0,1,1.0,1,1.0,1,0.08677651985913917,35
1808,1,3518,1401,2117,0,0,0,1.0,1,1.0,1,1.0,1,0.07765176799980396,37
1809,1,3519,1401,2118,0,0,0,1.0,1,1.0,1,1.0,1,0.08460648572723536,35
1810,0,3519,1401,2118,0,0,0,1.0,1,1.0,1,1.0,1,0.10577684841762253,36
1811,1,3520,1402,2118,0,0,0,1.0,1,1.0,1,1.0,1,0.2015847163968106,34
1812,0,3520,1402,2118,0,0,0,1.0,1,1.0,1,1.0,1,0.22847784564162957,36
1813,1,3521,1402,2119,0,0,0,1.0,1,1.0,1,1.0,1,0.24163483525439047,35
1814,3,3524,1402,2122,0,0,0,1.0,1,1.0,1,1.0,1,0.20310058180104654,36
1815,1,3525,1402,2123,0,0,0,1.0,1,1.0,1,1.0,1,0.20518742925674363,35
1816,2,3527,1402,2125,0,0,0,1.0,1,1.0,1,1.0,1,0.18099237540716648,35
1817,1,3528,1403,2125,0,0,0,1.0,1,1.0,1,1.0,1,0.18750222011639892,35
1818,4,3532,1406,2126,0,0,0,1.0,1,1.0,1,1.0,1,0.13341265661250126,36
1819,3,3535,1409,2126,0,0,0,1.0,1,1.0,1,1.0,1,0.1569297278493736,37
1820,1,3536,1409,2127,0,0,0,1.0,1,1.0,1,1.0,1,0.13814066180365345,37
1821,1,3537,1409,2128,0,0,0,1.0,1,1.0,1,1.0,1,0.13119350498623575,38
1822,4,3541,1412,2129,0,0,0,1.0,1,1.0,1,1.0,1,0.17283006251335345,37
1823,2,3543,1414,2129,0,0,0,1.0,1,1.0,1,1.0,1,0.2040246487224944,36
1824,2,3545,1416,2129,0,0,0,1.0,1,1.0,1,1.0,1,0.20901037317853105,36
1825,3,3548,1417,2131,0,0,0,1.0,1,1.0,1,1.0,1,0.12802940333129964,34
1826,5,3553,1420,2133,0,0,0,1.0,1,1.0,1,1.0,1,0.15405217784567296,35
1827,2,3555,1421,2134,0,0,0,1.0,1,1.0,1,1.0,1,0.15631476262125596,34
1828,1,3556,1422,2134,0,0,0,1.0,1,1.0,1,1.0,1,0.1644455937423501,33
1829,1,3557,1423,2134,0,0,0,1.0,1,1.0,1,1.0,1,0.16472648851569155,31
1830,0,3557,1423,2134,0,0,0,1.0,1,1.0,1,1.0,1,0.15247353265831345,31
1831,1,3558,1424,2134,0,0,0,1.0,1,1.0,1,1.0,1,0.16297358880169435,30
1832,0,3558,1424,2134,0,0,0,1.0,1,1.0,1,1.0,1,0.15755612478175873,29
1833,3,3561,1427,2134,0,0,0,1.0,1,1.0,1,1.0,1,0.2864702332153369,28
1834,1,3562,1428,2134,0,0,0,1.0,1,1.0,1,1.0,1,0.33164668884696735,27
1835,8,3570,1431,2139,0,0,0,1.0,1,1.0,1,1.0,1,0.2324997453001945,26
1836,2,3572,1431,2141,0,0,0,1.0,1,1.0,1,1.0,1,0.24281320349066815,26
1837,2,3574,1431,2143,0,0,0,1.0,1,1.0,1,1.0,1,0.1557865792601022,25
1838,1,3575,1431,2144,0,0,0,1.0,1,1.0,1,1.0,1,0.12046369482911694,25
1839,1,3576,1431,2145,0,0,0,1.0,1,1.0,1,1.0,1,0.13793325372481194,24
1840,1,3577,1432,2145,0,0,0,1.0,1,1.0,1,1.0,1,0.20912677205021957,23
1841,0,3577,1432,2145,0,0,0,1.0,1,1.0,1,1.0,1,0.19543891532561702,22
1842,0,3577,1432,2145,0,0,0,1.0,1,1.0,1,1.0,1,0.19128240775890676,23
1843,1,3578,1433,2145,0,0,0,1.0,1,1.0,1,1.0,1,0.1727794567384161,23
1844,0,3578,1433,2145,0,0,0,1.0,1,1.0,1,1.0,1,0.1727794567384161,23
1845,2,3580,1435,2145,0,0,0,1.0,1,1.0,1,1.0,1,0.23689071679670212,23
1846,2,3582,1436,2146,0,0,0,1.0,1,1.0,1,1.0,1,0.11561256175900105,23
1847,0,3582,1436,2146,0,0,0,1.0,1,1.0,1,1.0,1,0.12989724745997397,24
1848,0,3582,1436,2146,0,0,0,1.0,1,1.0,1,1.0,1,0.12989724745997397,24
1849,1,3583,1436,2147,0,0,0,1.0,1,1.0,1,1.0,1,0.13363057949745188,25
1850,0,3583,1436,2147,0,0,0,1.0,1,1.0,1,1.0,1,0.13363057949745188,25
1851,0,3583,1436,2147,0,0,0,1.0,1,1.0,1,1.0,1,0.13363057949745188,25
1852,0,3583,1436,2147,0,0,0,1.0,1,1.0,1,1.0,1,0.13363057949745188,25
1853,0,3583,1436,2147,0,0,0,1.0,1,1.0,1,1.0,1,0.15331260343224373,25
1854,1,3584,1437,2147,0,0,0,1.0,1,1.0,1,1.0,1,0.21333138330982293,25
1855,1,3585,1437,2148,0,0,0,1.0,1,1.0,1,1.0,1,0.226410061350796,26
1856,1,3586,1438,2148,0,0,0,1.0,1,1.0,1,1.0,1,0.22747763459434714,27
1857,1,3587,1438,2149,0,0,0,1.0,1,1.0,1,1.0,1,0.20403717692622372,28
1858,1,3588,1439,2149,0,0,0,1.0,1,1.0,1,1.0,1,0.2094787840704773,28
1859,3,3591,1440,2151,0,0,0,1.0,1,1.0,1,1.0,1,0.2011096537875365,28
1860,0,3591,1440,2151,0,0,0,1.0,1,1.0,1,1.0,1,0.2011096537875365,28
1861,0,3591,1440,2151,0,0,0,1.0,1,1.0,1,1.0,1,0.2011096537875365,28
1862,0,3591,1440,2151,0,0,0,1.0,1,1.0,1,1.0,1,0.2011096537875365,28
1863,1,3592,1441,2151,0,0,0,1.0,1,1.0,1,1.0,1,0.23248138331581888,29
1864,2,3594,1443,2151,0,0,0,1.0,1,1.0,1,1.0,1,0.24299738489884715,27
1865,2,3596,1444,2152,0,0,0,1.0,1,1.0,1,1.0,1,0.27474630747246137,26
1866,2,3598,1445,2153,0,0,0,1.0,1,1.0,1,1.0,1,0.2968716685417691,26
1867,1,3599,1445,2154,0,0,0,1.0,1,1.0,1,1.0,1,0.24882999172013254,26
1868,1,3600,1445,2155,0,0,0,1.0,1,1.0,1,1.0,1,0.24696430944001974,26
1869,3,3603,1445,2158,0,0,0,1.0,1,1.0,1,1.0,1,0.17543498411169547,26
1870,0,3603,1445,2158,0,0,0,1.0,1,1.0,1,1.0,1,0.19221988001077703,27
1871,1,3604,1445,2159,0,0,0,1.0,1,1.0,1,1.0,1,0.16268908703171794,27
1872,0,3604,1445,2159,0,0,0,1.0,1,1.0,1,1.0,1,0.1882658495072851,25
1873,0,3604,1445,2159,0,0,0,1.0,1,1.0,1,1.0,1,0.1882658495072851,25
1874,1,3605,1445,2160,0,0,0,1.0,1,1.0,1,1.0,1,0.22056878231172372,25
1875,1,3606,1445,2161,0,0,0,1.0,1,1.0,1,1.0,1,0.1961942357641489,25
1876,0,3606,1445,2161,0,0,0,1.0,1,1.0,1,1.0,1,0.17245743795136598,26
1877,0,3606,1445,2161,0,0,0,1.0,1,1.0,1,1.0,1,0.17380893644758813,27
1878,2,3608,1447,2161,0,0,0,1.0,1,1.0,1,1.0,1,0.22303081052754986,28
1879,0,3608,1447,2161,0,0,0,1.0,1,1.0,1,1.0,1,0.2145218254288093,29
1880,1,3609,1447,2162,0,0,0,1.0,1,1.0,1,1.0,1,0.19602066550606195,29
1881,0,3609,1447,2162,0,0,0,1.0,1,1.0,1,1.0,1,0.19602066550606195,29
1882,0,3609,1447,2162,0,0,0,1.0,1,1.0,1,1.0,1,0.1961398405306516,28
1883,0,3609,1447,2162,0,0,0,1.0,1,1.0,1,1.0,1,0.1961398405306516,28
1884,0,3609,1447,2162,0,0,0,1.0,1,1.0,1,1.0,1,0.1961398405306516,28
1885,0,3609,1447,2162,0,0,0,1.0,1,1.0,1,1.0,1,0.1961398405306516,28
1886,1,3610,1448,2162,0,0,0,1.0,1,1.0,1,1.0,1,0.25386414691696135,29
1887,1,3611,1448,2163,0,0,0,1.0,1,1.0,1,1.0,1,0.2115528762876981,29
1888,3,3614,1448,2166,0,0,0,1.0,1,1.0,1,1.0,1,0.1742923617254443,31
1889,1,3615,1448,2167,0,0,0,1.0,1,1.0,1,1.0,1,0.15864441572041219,31
1890,0,3615,1448,2167,0,0,0,1.0,1,1.0,1,1.0,1,0.15864441572041219,31
1891,0,3615,1448,2167,0,0,0,1.0,1,1.0,1,1.0,1,0.18021537858436315,32
1892,0,3615,1448,2167,0,0,0,1.0,1,1.0,1,1.0,1,0.18021537858436315,32
1893,0,3615,1448,2167,0,0,0,1.0,1,1.0,1,1.0,1,0.18021537858436315,32
1894,0,3615,1448,2167,0,0,0,1.0,1,1.0,1,1.0,1,0.1627717285873097,33
1895,2,3617,1449,2168,0,0,0,1.0,1,1.0,1,1.0,1,0.12593533935265072,35
1896,0,3617,1449,2168,0,0,0,1.0,1,1.0,1,1.0,1,0.14888867165681302,34
1897,0,3617,1449,2168,0,0,0,1.0,1,1.0,1,1.0,1,0.14888867165681302,34
1898,0,3617,1449,2168,0,0,0,1.0,1,1.0,1,1.0,1,0.14888867165681302,34
1899,0,3617,1449,2168,0,0,0,1.0,1,1.0,1,1.0,1,0.14888867165681302,34
1900,0,3617,1449,2168,0,0,0,1.0,1,1.0,1,1.0,1,0.1508563423610823,35
1901,0,3617,1449,2168,0,0,0,1.0,1,1.0,1,1.0,1,0.1508563423610823,35
1902,0,3617,1449,2168,0,0,0,1.0,1,1.0,1,1.0,1,0.1508563423610823,35
1903,0,3617,1449,2168,0,0,0,1.0,1,1.0,1,1.0,1,0.1508563423610823,35
1904,0,3617,1449,2168,0,0,0,1.0,1,1.0,1,1.0,1,0.1508563423610823,35
1905,1,3618,1449,2169,0,0,0,1.0,1,1.0,1,1.0,1,0.12471611147780692,37
1906,0,3618,1449,2169,0,0,0,1.0,1,1.0,1,1.0,1,0.12471611147780692,37
1907,0,3618,1449,2169,0,0,0,1.0,1,1.0,1,1.0,1,0.1520181565178675,39
1908,0,3618,1449,2169,0,0,0,1.0,1,1.0,1,1.0,1,0.1520181565178675,39
1909,3,3621,1449,2172,0,0,0,1.0,1,1.0,1,1.0,1,0.12232877283282807,41
1910,0,3621,1449,2172,0,0,0,1.0,1,1.0,1,1.0,1,0.12232877283282807,41
1911,4,3625,1450,2175,0,0,0,1.0,1,1.0,1,1.0,1,0.170489067043864,40
1912,2,3627,1452,2175,0,0,0,1.0,1,1.0,1,1.0,1,0.20032273291461322,39
1913,2,3629,1452,2177,0,0,0,1.0,1,1.0,1,1.0,1,0.1833467072846901,40
1914,1,3630,1453,2177,0,0,0,1.0,1,1.0,1,1.0,1,0.20634521349682305,41
1915,2,3632,1454,2178,0,0,0,1.0,1,1.0,1,1.0,1,0.18894158446509526,42
1916,3,3635,1456,2179,0,0,0,1.0,1,1.0,1,1.0,1,0.2159390496224073,42
1917,3,3638,1458,2180,0,0,0,1.0,1,1.0,1,1.0,1,0.2125007074672752,41
1918,2,3640,1459,2181,0,0,0,1.0,1,1.0,1,1.0,1,0.2097455604273927,38
1919,2,3642,1459,2183,0,0,0,1.0,1,1.0,1,1.0,1,0.22753836595798943,38
1920,2,3644,1459,2185,0,0,0,1.0,1,1.0,1,1.0,1,0.23085196419363155,38
1921,1,3645,1459,2186,0,0,0,1.0,1,1.0,1,1.0,1,0.18174770639151344,39
1922,1,3646,1460,2186,0,0,0,1.0,1,1.0,1,1.0,1,0.18927617174434566,40
1923,2,3648,1460,2188,0,0,0,1.0,1,1.0,1,1.0,1,0.1581706443655799,41
1924,5,3653,1463,2190,0,0,0,1.0,1,1.0,1,1.0,1,0.16843477591676703,41
1925,2,3655,1463,2192,0,0,0,1.0,1,1.0,1,1.0,1,0.13465320624858568,41
1926,0,3655,1463,2192,0,0,0,1.0,1,1.0,1,1.0,1,0.13465320624858568,41
1927,0,3655,1463,2192,0,0,0,1.0,1,1.0,1,1.0,1,0.13465320624858568,41
1928,1,3656,1464,2192,0,0,0,1.0,1,1.0,1,1.0,1,0.1362422631667616,42
1929,0,3656,1464,2192,0,0,0,1.0,1,1.0,1,1.0,1,0.13531460384408717,41
1930,0,3656,1464,2192,0,0,0,1.0,1,1.0,1,1.0,1,0.13531460384408717,41
1931,0,3656,1464,2192,0,0,0,1.0,1,1.0,1,1.0,1,0.13531460384408717,41
1932,0,3656,1464,2192,0,0,0,1.0,1,1.0,1,1.0,1,0.13531460384408717,41
1933,3,3659,1465,2194,0,0,0,1.0,1,1.0,1,1.0,1,0.14709842067655562,43
1934,1,3660,1465,2195,0,0,0,1.0,1,1.0,1,1.0,1,0.13699183192269465,44
1935,0,3660,1465,2195,0,0,0,1.0,1,1.0,1,1.0,1,0.110601762163293,45
1936,1,3661,1465,2196,0,0,0,1.0,1,1.0,1,1.0,1,0.11607019079327803,48
1937,1,3662,1466,2196,0,0,0,1.0,1,1.0,1,1.0,1,0.14319323152019814,48
1938,0,3662,1466,2196,0,0,0,1.0,1,1.0,1,1.0,1,0.14319323152019814,48
1939,4,3666,1467,2199,0,0,0,1.0,1,1.0,1,1.0,1,0.10300624795165182,48
1940,0,3666,1467,2199,0,0,0,1.0,1,1.0,1,1.0,1,0.10300624795165182,48
1941,0,3666,1467,2199,0,0,0,1.0,1,1.0,1,1.0,1,0.10300624795165182,48
1942,3,3669,1469,2200,0,0,0,1.0,1,1.0,1,1.0,1,0.17736002408358856,49
1943,2,3671,1470,2201,0,0,0,1.0,1,1.0,1,1.0,1,0.13343980359368016,48
1944,2,3673,1471,2202,0,0,0,1.0,1,1.0,1,1.0,1,0.15888620145404778,47
1945,3,3676,1474,2202,0,0,0,1.0,1,1.0,1,1.0,1,0.16382837432628083,46
1946,3,3679,1475,2204,0,0,0,1.0,1,1.0,1,1.0,1,0.17664091844365576,46
1947,8,3687,1477,2210,0,0,0,1.0,1,1.0,1,1.0,1,0.1299123069747943,45
1948,2,3689,1478,2211,0,0,0,1.0,1,1.0,1,1.0,1,0.14129618343034542,46
1949,3,3692,1480,2212,0,0,0,1.0,1,1.0,1,1.0,1,0.19114117251634788,42
1950,1,3693,1480,2213,0,0,0,1.0,1,1.0,1,1.0,1,0.18242692174449285,40
1951,4,3697,1483,2214,0,0,0,1.0,1,1.0,1,1.0,1,0.1734928046189707,39
1952,1,3698,1484,2214,0,0,0,1.0,1,1.0,1,1.0,1,0.23428029104265477,35
1953,5,3703,1486,2217,0,0,0,1.0,1,1.0,1,1.0,1,0.1453715685553977,36
1954,1,3704,1487,2217,0,0,0,1.0,1,1.0,1,1.0,1,0.1764700269115754,34
1955,2,3706,1488,2218,0,0,0,1.0,1,1.0,1,1.0,1,0.14488809093179408,35
1956,2,3708,1490,2218,0,0,0,1.0,1,1.0,1,1.0,1,0.19142097134696442,37
1957,3,3711,1490,2221,0,0,0,1.0,1,1.0,1,1.0,1,0.1435066828571944,37
1958,3,3714,1490,2224,0,0,0,1.0,1,1.0,1,1.0,1,0.13763751797163767,39
1959,1,3715,1490,2225,0,0,0,1.0,1,1.0,1,1.0,1,0.14116467217014803,41
1960,1,3716,1491,2225,0,0,0,1.0,1,1.0,1,1.0,1,0.14762366050158585,40
1961,3,3719,1492,2227,0,0,0,1.0,1,1.0,1,1.0,1,0.13299800851248053,41
1962,1,3720,1493,2227,0,0,0,1.0,1,1.0,1,1.0,1,0.16836716529761273,40
1963,1,3721,1493,2228,0,0,0,1.0,1,1.0,1,1.0,1,0.14328502955143102,41
1964,0,3721,1493,2228,0,0,0,1.0,1,1.0,1,1.0,1,0.1695424700553098,40
1965,5,3726,1494,2232,0,0,0,1.0,1,1.0,1,1.0,1,0.12186314791303642,41
1966,0,3726,1494,2232,0,0,0,1.0,1,1.0,1,1.0,1,0.12186314791303642,41
1967,2,3728,1495,2233,0,0,0,1.0,1,1.0,1,1.0,1,0.10206203348757666,42
1968,0,3728,1495,2233,0,0,0,1.0,1,1.0,1,1.0,1,0.12276696116115247,42
1969,1,3729,1496,2233,0,0,0,1.0,1,1.0,1,1.0,1,0.13497404163446508,43
1970,0,3729,1496,2233,0,0,0,1.0,1,1.0,1,1.0,1,0.1460407749999485,42
1971,2,3731,1496,2235,0,0,0,1.0,1,1.0,1,1.0,1,0.11919665170273636,42
1972,0,3731,1496,2235,0,0,0,1.0,1,1.0,1,1.0,1,0.11919665170273636,42
1973,0,3731,1496,2235,0,0,0,1.0,1,1.0,1,1.0,1,0.13269231731871098,43
1974,2,3733,1497,2236,0,0,0,1.0,1,1.0,1,1.0,1,0.16592345216028992,43
1975,2,3735,1497,2238,0,0,0,1.0,1,1.0,1,1.0,1,0.13738648707265919,43
1976,0,3735,1497,2238,0,0,0,1.0,1,1.0,1,1.0,1,0.13738648707265919,43
1977,4,3739,1497,2242,0,0,0,1.0,1,1.0,1,1.0,1,0.14588225302773408,48
1978,4,3743,1499,2244,0,0,0,1.0,1,1.0,1,1.0,1,0.1360054364842571,48
1979,4,3747,1500,2247,0,0,0,1.0,1,1.0,1,1.0,1,0.14780469472550314,49
1980,1,3748,1501,2247,0,0,0,1.0,1,1.0,1,1.0,1,0.17763865992049113,50
1981,6,3754,1502,2252,0,0,0,1.0,1,1.0,1,1.0,1,0.14152109575359706,50
1982,1,3755,1503,2252,0,0,0,1.0,1,1.0,1,1.0,1,0.14082369342743747,50
1983,1,3756,1504,2252,0,0,0,1.0,1,1.0,1,1.0,1,0.14986376420629335,49
1984,0,3756,1504,2252,0,0,0,1.0,1,1.0,1,1.0,1,0.1384284253071909,48
1985,1,3757,1505,2252,0,0,0,1.0,1,1.0,1,1.0,1,0.12873776327095757,46
1986,3,3760,1508,2252,0,0,0,1.0,1,1.0,1,1.0,1,0.1342261572592699,46
1987,2,3762,1510,2252,0,0,0,1.0,1,1.0,1,1.0,1,0.18373272422846224,42
1988,0,3762,1510,2252,0,0,0,1.0,1,1.0,1,1.0,1,0.20217088398272112,40
1989,5,3767,1512,2255,0,0,0,1.0,1,1.0,1,1.0,1,0.18063634655009778,38
1990,1,3768,1512,2256,0,0,0,1.0,1,1.0,1,1.0,1,0.15838022183233075,38
1991,3,3771,1514,2257,0,0,0,1.0,1,1.0,1,1.0,1,0.16146984735360925,38
1992,0,3771,1514,2257,0,0,0,1.0,1,1.0,1,1.0,1,0.16581125369390384,39
1993,3,3774,1516,2258,0,0,0,1.0,1,1.0,1,1.0,1,0.26354289213298643,38
1994,1,3775,1516,2259,0,0,0,1.0,1,1.0,1,1.0,1,0.2366199632685498,37
1995,4,3779,1517,2262,0,0,0,1.0,1,1.0,1,1.0,1,0.21230553629753704,37
1996,1,3780,1518,2262,0,0,0,1.0,1,1.0,1,1.0,1,0.24099960509963503,37
1997,4,3784,1518,2266,0,0,0,1.0,1,1.0,1,1.0,1,0.1883081382870133,35
1998,1,3785,1519,2266,0,0,0,1.0,1,1.0,1,1.0,1,0.2067658094917844,34
1999,2,3787,1521,2266,0,0,0,1.0,1,1.0,1,1.0,1,0.2303388870179165,35
2000,0,3787,1521,2266,0,0,0,1.0,1,1.0,1,1.0,1,0.24700011216941753,34
2001,2,3789,1521,2268,0,0,0,1.0,1,1.0,1,1.0,1,0.22831473718487066,35
2002,2,3791,1522,2269,0,0,0,1.0,1,1.0,1,1.0,1,0.26359551379906215,36
2003,5,3796,1522,2274,0,0,0,1.0,1,1.0,1,1.0,1,0.21829850894323216,37
2004,2,3798,1522,2276,0,0,0,1.0,1,1.0,1,1.0,1,0.17384733927512605,38
2005,1,3799,1522,2277,0,0,0,1.0,1,1.0,1,1.0,1,0.15749920222990016,38
2006,0,3799,1522,2277,0,0,0,1.0,1,1.0,1,1.0,1,0.15749920222990016,38
2007,1,3800,1523,2277,0,0,0,1.0,1,1.0,1,1.0,1,0.1417981467637369,40
2008,0,3800,1523,2277,0,0,0,1.0,1,1.0,1,1.0,1,0.1417981467637369,40
2009,2,3802,1525,2277,0,0,0,1.0,1,1.0,1,1.0,1,0.1497498436764672,41
2010,1,3803,1525,2278,0,0,0,1.0,1,1.0,1,1.0,1,0.12314930838884872,41
2011,1,3804,1525,2279,0,0,0,1.0,1,1.0,1,1.0,1,0.10536212783964748,41
2012,0,3804,1525,2279,0,0,0,1.0,1,1.0,1,1.0,1,0.10536212783964748,41
2013,0,3804,1525,2279,0,0,0,1.0,1,1.0,1,1.0,1,0.12471859958113037,43
2014,0,3804,1525,2279,0,0,0,1.0,1,1.0,1,1.0,1,0.14669720171890782,43
2015,0,3804,1525,2279,0,0,0,1.0,1,1.0,1,1.0,1,0.14669720171890782,43
2016,1,3805,1525,2280,0,0,0,1.0,1,1.0,1,1.0,1,0.14836238588964973,44
2017,2,3807,1525,2282,0,0,0,1.0,1,1.0,1,1.0,1,0.1266533755321069,45
2018,2,3809,1526,2283,0,0,0,1.0,1,1.0,1,1.0,1,0.13128023283015197,46
2019,2,3811,1526,2285,0,0,0,1.0,1,1.0,1,1.0,1,0.08600661018521961,47
2020,2,3813,1528,2285,0,0,0,1.0,1,1.0,1,1.0,1,0.12033323317800182,47
2021,3,3816,1529,2287,0,0,0,1.0,1,1.0,1,1.0,1,0.11258342353742794,47
2022,2,3818,1529,2289,0,0,0,1.0,1,1.0,1,1.0,1,0.11451607695751455,48
2023,2,3820,1531,2289,0,0,0,1.0,1,1.0,1,1.0,1,0.14593492267197417,48
2024,6,3826,1535,2291,0,0,0,1.0,1,1.0,1,1.0,1,0.15198071452673187,45
2025,4,3830,1537,2293,0,0,0,1.0,1,1.0,1,1.0,1,0.19250822691153488,42
2026,9,3839,1541,2298,0,0,0,1.0,1,1.0,1,1.0,1,0.18588481531638693,44
2027,4,3843,1543,2300,0,0,0,1.0,1,1.0,1,1.0,1,0.16070809698197308,40
2028,1,3844,1543,2301,0,0,0,1.0,1,1.0,1,1.0,1,0.1771714175893739,39
2029,3,3847,1543,2304,0,0,0,1.0,1,1.0,1,1.0,1,0.13536883895044488,37
2030,2,3849,1544,2305,0,0,0,1.0,1,1.0,1,1.0,1,0.14666490202035662,34
2031,0,3849,1544,2305,0,0,0,1.0,1,1.0,1,1.0,1,0.15956924802088535,35
2032,3,3852,1545,2307,0,0,0,1.0,1,1.0,1,1.0,1,0.25666495270157885,34
2033,4,3856,1547,2309,0,0,0,1.0,1,1.0,1,1.0,1,0.2258567248033453,36
2034,0,3856,1547,2309,0,0,0,1.0,1,1.0,1,1.0,1,0.2122381285577802,34
2035,4,3860,1547,2313,0,0,0,1.0,1,1.0,1,1.0,1,0.1953623575996664,35
2036,2,3862,1548,2314,0,0,0,1.0,1,1.0,1,1.0,1,0.1782691161554803,34
2037,0,3862,1548,2314,0,0,0,1.0,1,1.0,1,1.0,1,0.17268270170512393,35
2038,0,3862,1548,2314,0,0,0,1.0,1,1.0,1,1.0,1,0.16834898274636156,36
2039,3,3865,1549,2316,0,0,0,1.0,1,1.0,1,1.0,1,0.12677558819464535,38
2040,0,3865,1549,2316,0,0,0,1.0,1,1.0,1,1.0,1,0.12677558819464535,38
2041,0,3865,1549,2316,0,0,0,1.0,1,1.0,1,1.0,1,0.12853794400626412,39
2042,1,3866,1549,2317,0,0,0,1.0,1,1.0,1,1.0,1,0.10576469590832725,39
2043,0,3866,1549,2317,0,0,0,1.0,1,1.0,1,1.0,1,0.10576469590832725,39
2044,0,3866,1549,2317,0,0,0,1.0,1,1.0,1,1.0,1,0.10576469590832725,39
2045,1,3867,1550,2317,0,0,0,1.0,1,1.0,1,1.0,1,0.1147974001056907,41
2046,0,3867,1550,2317,0,0,0,1.0,1,1.0,1,1.0,1,0.1381196538579778,42
2047,1,3868,1550,2318,0,0,0,1.0,1,1.0,1,1.0,1,0.11772251546147589,42
2048,1,3869,1551,2318,0,0,0,1.0,1,1.0,1,1.0,1,0.1442175327145882,43
2049,6,3875,1553,2322,0,0,0,1.0,1,1.0,1,1.0,1,0.11596153365091681,44
2050,2,3877,1553,2324,0,0,0,1.0,1,1.0,1,1.0,1,0.1234626902506932,44
2051,5,3882,1554,2328,0,0,0,1.0,1,1.0,1,1.0,1,0.11718688288943514,45
2052,0,3882,1554,2328,0,0,0,1.0,1,1.0,1,1.0,1,0.11718688288943514,45
2053,3,3885,1554,2331,0,0,0,1.0,1,1.0,1,1.0,1,0.06163508424033992,45
2054,1,3886,1554,2332,0,0,0,1.0,1,1.0,1,1.0,1,0.07466822451295647,46
2055,0,3886,1554,2332,0,0,0,1.0,1,1.0,1,1.0,1,0.07466822451295647,46
2056,2,3888,1556,2332,0,0,0,1.0,1,1.0,1,1.0,1,0.1127050551087046,46
2057,3,3891,1558,2333,0,0,0,1.0,1,1.0,1,1.0,1,0.07905781862932619,47
2058,4,3895,1562,2333,0,0,0,1.0,1,1.0,1,1.0,1,0.1559257914964735,47
2059,4,3899,1563,2336,0,0,0,1.0,1,1.0,1,1.0,1,0.10618449051759472,48
2060,6,3905,1565,2340,0,0,0,1.0,1,1.0,1,1.0,1,0.1131868357541264,50
2061,1,3906,1565,2341,0,0,0,1.0,1,1.0,1,1.0,1,0.07863776835059785,51
2062,0,3906,1565,2341,0,0,0,1.0,1,1.0,1,1.0,1,0.07984355498449543,49
2063,1,3907,1566,2341,0,0,0,1.0,1,1.0,1,1.0,1,0.0767553108665843,48
2064,0,3907,1566,2341,0,0,0,1.0,1,1.0,1,1.0,1,0.0914030949505023,45
2065,2,3909,1566,2343,0,0,0,1.0,1,1.0,1,1.0,1,0.0825971900281872,44
2066,1,3910,1567,2343,0,0,0,1.0,1,1.0,1,1.0,1,0.14092890245437303,42
2067,3,3913,1568,2345,0,0,0,1.0,1,1.0,1,1.0,1,0.10887589942415696,41
2068,1,3914,1569,2345,0,0,0,1.0,1,1.0,1,1.0,1,0.16108466900397136,40
2069,1,3915,1569,2346,0,0,0,1.0,1,1.0,1,1.0,1,0.15096839134138584,40
2070,1,3916,1569,2347,0,0,0,1.0,1,1.0,1,1.0,1,0.11417113952550093,40
2071,1,3917,1570,2347,0,0,0,1.0,1,1.0,1,1.0,1,0.1235356515166968,40
2072,2,3919,1570,2349,0,0,0,1.0,1,1.0,1,1.0,1,0.12889244238453196,41
2073,3,3922,1571,2351,0,0,0,1.0,1,1.0,1,1.0,1,0.10342353070166262,41
2074,0,3922,1571,2351,0,0,0,1.0,1,1.0,1,1.0,1,0.10293245128800142,41
2075,0,3922,1571,2351,0,0,0,1.0,1,1.0,1,1.0,1,0.10293245128800142,41
2076,4,3926,1573,2353,0,0,0,1.0,1,1.0,1,1.0,1,0.1086930625430648,41
2077,0,3926,1573,2353,0,0,0,1.0,1,1.0,1,1.0,1,0.1217901944510556,40
2078,1,3927,1574,2353,0,0,0,1.0,1,1.0,1,1.0,1,0.12442391625745157,40
2079,2,3929,1574,2355,0,0,0,1.0,1,1.0,1,1.0,1,0.06797398208940801,39
2080,2,3931,1575,2356,0,0,0,1.0,1,1.0,1,1.0,1,0.05752221054963967,38
2081,1,3932,1575,2357,0,0,0,1.0,1,1.0,1,1.0,1,0.03521449900463304,40
2082,1,3933,1576,2357,0,0,0,1.0,1,1.0,1,1.0,1,0.09772220337796422,41
2083,2,3935,1577,2358,0,0,0,1.0,1,1.0,1,1.0,1,0.08245152087704988,40
2084,2,3937,1579,2358,0,0,0,1.0,1,1.0,1,1.0,1,0.14344517401750945,42
2085,2,3939,1580,2359,0,0,0,1.0,1,1.0,1,1.0,1,0.12528602666490216,42
2086,0,3939,1580,2359,0,0,0,1.0,1,1.0,1,1.0,1,0.10954266816779998,43
2087,2,3941,1581,2360,0,0,0,1.0,1,1.0,1,1.0,1,0.12116106475467085,45
2088,7,3948,1584,2364,0,0,0,1.0,1,1.0,1,1.0,1,0.1685915042212544,46
2089,2,3950,1584,2366,0,0,0,1.0,1,1.0,1,1.0,1,0.1365498373213783,47
2090,4,3954,1585,2369,0,0,0,1.0,1,1.0,1,1.0,1,0.1583363634872002,49
2091,1,3955,1585,2370,0,0,0,1.0,1,1.0,1,1.0,1,0.149441258641576,49
2092,0,3955,1585,2370,0,0,0,1.0,1,1.0,1,1.0,1,0.149441258641576,49
2093,2,3957,1586,2371,0,0,0,1.0,1,1.0,1,1.0,1,0.12269985592011838,49
2094,1,3958,1586,2372,0,0,0,1.0,1,1.0,1,1.0,1,0.1165554715227051,49
2095,0,3958,1586,2372,0,0,0,1.0,1,1.0,1,1.0,1,0.10107726363631522,49
2096,0,3958,1586,2372,0,0,0,1.0,1,1.0,1,1.0,1,0.09400924485982085,51
2097,1,3959,1587,2372,0,0,0,1.0,1,1.0,1,1.0,1,0.07663973870244473,51
2098,2,3961,1588,2373,0,0,0,1.0,1,1.0,1,1.0,1,0.06715739183676296,52
2099,2,3963,1589,2374,0,0,0,1.0,1,1.0,1,1.0,1,0.09200257596098142,51
2100,2,3965,1590,2375,0,0,0,1.0,1,1.0,1,1.0,1,0.06616771947000831,51
2101,2,3967,1590,2377,0,0,0,1.0,1,1.0,1,1.0,1,0.08230873817069875,48
2102,3,3970,1593,2377,0,0,0,1.0,1,1.0,1,1.0,1,0.17438397133098837,49
2103,9,3979,1596,2383,0,0,0,1.0,1,1.0,1,1.0,1,0.1302955996387434,48
2104,2,3981,1597,2384,0,0,0,1.0,1,1.0,1,1.0,1,0.1258255333909685,43
2105,2,3983,1598,2385,0,0,0,1.0,1,1.0,1,1.0,1,0.13475038488249613,42
2106,2,3985,1599,2386,0,0,0,1.0,1,1.0,1,1.0,1,0.17002248054161267,40
2107,3,3988,1601,2387,0,0,0,1.0,1,1.0,1,1.0,1,0.15785776898585152,39
2108,3,3991,1603,2388,0,0,0,1.0,1,1.0,1,1.0,1,0.1406505825674683,38
2109,0,3991,1603,2388,0,0,0,1.0,1,1.0,1,1.0,1,0.13224870072939351,37
2110,2,3993,1604,2389,0,0,0,1.0,1,1.0,1,1.0,1,0.11057324641081184,38
2111,1,3994,1605,2389,0,0,0,1.0,1,1.0,1,1.0,1,0.12803620861239257,37
2112,2,3996,1607,2389,0,0,0,1.0,1,1.0,1,1.0,1,0.18616693983715218,36
2113,2,3998,1608,2390,0,0,0,1.0,1,1.0,1,1.0,1,0.24673999537904268,36
2114,2,4000,1609,2391,0,0,0,1.0,1,1.0,1,1.0,1,0.2193207196885101,36
2115,1,4001,1609,2392,0,0,0,1.0,1,1.0,1,1.0,1,0.18947252511913562,35
2116,1,4002,1609,2393,0,0,0,1.0,1,1.0,1,1.0,1,0.1644393758631069,37
2117,1,4003,1609,2394,0,0,0,1.0,1,1.0,1,1.0,1,0.1290574021746065,38
2118,0,4003,1609,2394,0,0,0,1.0,1,1.0,1,1.0,1,0.13811076819853302,40
2119,1,4004,1609,2395,0,0,0,1.0,1,1.0,1,1.0,1,0.13053408693789353,40
2120,1,4005,1610,2395,0,0,0,1.0,1,1.0,1,1.0,1,0.13192738662734652,41
2121,1,4006,1610,2396,0,0,0,1.0,1,1.0,1,1.0,1,0.10670894614150145,41
2122,0,4006,1610,2396,0,0,0,1.0,1,1.0,1,1.0,1,0.10898476410583312,42
2123,0,4006,1610,2396,0,0,0,1.0,1,1.0,1,1.0,1,0.11350858021018559,43
2124,0,4006,1610,2396,0,0,0,1.0,1,1.0,1,1.0,1,0.126447646817938,41
2125,0,4006,1610,2396,0,0,0,1.0,1,1.0,1,1.0,1,0.126447646817938,41
2126,0,4006,1610,2396,0,0,0,1.0,1,1.0,1,1.0,1,0.11657146491979654,40
2127,0,4006,1610,2396,0,0,0,1.0,1,1.0,1,1.0,1,0.11657146491979654,40
2128,0,4006,1610,2396,0,0,0,1.0,1,1.0,1,1.0,1,0.12911931583741396,41
2129,0,4006,1610,2396,0,0,0,1.0,1,1.0,1,1.0,1,0.13119828174485296,42
2130,0,4006,1610,2396,0,0,0,1.0,1,1.0,1,1.0,1,0.15357914587235513,45
2131,1,4007,1610,2397,0,0,0,1.0,1,1.0,1,1.0,1,0.1308238783518376,45
2132,2,4009,1610,2399,0,0,0,1.0,1,1.0,1,1.0,1,0.12070992643119811,46
2133,3,4012,1611,2401,0,0,0,1.0,1,1.0,1,1.0,1,0.11694601702690148,46
2134,2,4014,1612,2402,0,0,0,1.0,1,1.0,1,1.0,1,0.09228497931199402,47
2135,0,4014,1612,2402,0,0,0,1.0,1,1.0,1,1.0,1,0.09228497931199402,47
2136,2,4016,1613,2403,0,0,0,1.0,1,1.0,1,1.0,1,0.10042301161707139,47
2137,4,4020,1615,2405,0,0,0,1.0,1,1.0,1,1.0,1,0.10003873741437438,49
2138,0,4020,1615,2405,0,0,0,1.0,1,1.0,1,1.0,1,0.10003873741437438,49
2139,4,4024,1616,2408,0,0,0,1.0,1,1.0,1,1.0,1,0.10112387278771141,47
2140,6,4030,1617,2413,0,0,0,1.0,1,1.0,1,1.0,1,0.13731719354274508,48
2141,4,4034,1618,2416,0,0,0,1.0,1,1.0,1,1.0,1,0.10815395150741569,47
2142,1,4035,1618,2417,0,0,0,1.0,1,1.0,1,1.0,1,0.08198914009185639,47
2143,3,4038,1619,2419,0,0,0,1.0,1,1.0,1,1.0,1,0.09603540950724998,48
2144,4,4042,1623,2419,0,0,0,1.0,1,1.0,1,1.0,1,0.17146147088230906,48
2145,8,4050,1625,2425,0,0,0,1.0,1,1.0,1,1.0,1,0.09883025745808412,46
2146,3,4053,1626,2427,0,0,0,1.0,1,1.0,1,1.0,1,0.10115676588225199,47
2147,4,4057,1628,2429,0,0,0,1.0,1,1.0,1,1.0,1,0.06922121019183294,48
2148,0,4057,1628,2429,0,0,0,1.0,1,1.0,1,1.0,1,0.07500099079839606,46
2149,6,4063,1631,2432,0,0,0,1.0,1,1.0,1,1.0,1,0.14400146152456725,46
2150,3,4066,1633,2433,0,0,0,1.0,1,1.0,1,1.0,1,0.14066215062956428,46
2151,6,4072,1636,2436,0,0,0,1.0,1,1.0,1,1.0,1,0.09521034561222956,44
2152,1,4073,1637,2436,0,0,0,1.0,1,1.0,1,1.0,1,0.14549083794204348,45
2153,2,4075,1638,2437,0,0,0,1.0,1,1.0,1,1.0,1,0.14153867497690717,48
2154,0,4075,1638,2437,0,0,0,1.0,1,1.0,1,1.0,1,0.15997377601775317,47
2155,5,4080,1640,2440,0,0,0,1.0,1,1.0,1,1.0,1,0.15702715703831355,48
2156,1,4081,1641,2440,0,0,0,1.0,1,1.0,1,1.0,1,0.19088249216872477,45
2157,1,4082,1641,2441,0,0,0,1.0,1,1.0,1,1.0,1,0.18991614808718368,43
2158,2,4084,1642,2442,0,0,0,1.0,1,1.0,1,1.0,1,0.17790866116446144,43
2159,4,4088,1644,2444,0,0,0,1.0,1,1.0,1,1.0,1,0.2221451696801616,43
2160,2,4090,1644,2446,0,0,0,1.0,1,1.0,1,1.0,1,0.17173085934016238,41
2161,3,4093,1644,2449,0,0,0,1.0,1,1.0,1,1.0,1,0.11526044366610093,41
2162,2,4095,1645,2450,0,0,0,1.0,1,1.0,1,1.0,1,0.10078696448017647,42
2163,4,4099,1646,2453,0,0,0,1.0,1,1.0,1,1.0,1,0.07780805074929298,43
2164,3,4102,1648,2454,0,0,0,1.0,1,1.0,1,1.0,1,0.16495783495398691,44
2165,4,4106,1648,2458,0,0,0,1.0,1,1.0,1,1.0,1,0.10204247582782236,44
2166,0,4106,1648,2458,0,0,0,1.0,1,1.0,1,1.0,1,0.11682039532804467,46
2167,3,4109,1649,2460,0,0,0,1.0,1,1.0,1,1.0,1,0.08323860374262107,46
2168,0,4109,1649,2460,0,0,0,1.0,1,1.0,1,1.0,1,0.07234418169442318,45
2169,3,4112,1650,2462,0,0,0,1.0,1,1.0,1,1.0,1,0.08251710806276473,49
2170,0,4112,1650,2462,0,0,0,1.0,1,1.0,1,1.0,1,0.08251710806276473,49
2171,2,4114,1651,2463,0,0,0,1.0,1,1.0,1,1.0,1,0.09479947149059262,51
2172,1,4115,1651,2464,0,0,0,1.0,1,1.0,1,1.0,1,0.08054138021343343,52
2173,1,4116,1652,2464,0,0,0,1.0,1,1.0,1,1.0,1,0.11642807376362986,52
2174,3,4119,1654,2465,0,0,0,1.0,1,1.0,1,1.0,1,0.1208267836035234,52
2175,0,4119,1654,2465,0,0,0,1.0,1,1.0,1,1.0,1,0.13157674467120414,53
2176,2,4121,1654,2467,0,0,0,1.0,1,1.0,1,1.0,1,0.09469137634322318,54
2177,3,4124,1657,2467,0,0,0,1.0,1,1.0,1,1.0,1,0.15046552300148067,55
2178,5,4129,1658,2471,0,0,0,1.0,1,1.0,1,1.0,1,0.10961995036042245,54
2179,2,4131,1659,2472,0,0,0,1.0,1,1.0,1,1.0,1,0.10388987536109018,52
2180,2,4133,1660,2473,0,0,0,1.0,1,1.0,1,1.0,1,0.1278870983293219,51
2181,2,4135,1660,2475,0,0,0,1.0,1,1.0,1,1.0,1,0.11582119283591215,49
2182,2,4137,1662,2475,0,0,0,1.0,1,1.0,1,1.0,1,0.138795719683718,49
2183,6,4143,1666,2477,0,0,0,1.0,1,1.0,1,1.0,1,0.14723768439009077,46
2184,6,4149,1668,2481,0,0,0,1.0,1,1.0,1,1.0,1,0.1584218909926236,45
2185,3,4152,1670,2482,0,0,0,1.0,1,1.0,1,1.0,1,0.12937929429494743,44
2186,6,4158,1674,2484,0,0,0,1.0,1,1.0,1,1.0,1,0.09184790964564836,42
2187,4,4162,1677,2485,0,0,0,1.0,1,1.0,1,1.0,1,0.1671460397488783,40
2188,5,4167,1680,2487,0,0,0,1.0,1,1.0,1,1.0,1,0.14324183071619687,38
2189,3,4170,1682,2488,0,0,0,1.0,1,1.0,1,1.0,1,0.15948904775592684,36
2190,3,4173,1683,2490,0,0,0,1.0,1,1.0,1,1.0,1,0.17282963910364604,34
2191,2,4175,1684,2491,0,0,0,1.0,1,1.0,1,1.0,1,0.08798452833205364,34
2192,2,4177,1686,2491,0,0,0,1.0,1,1.0,1,1.0,1,0.1273515462304806,33
2193,0,4177,1686,2491,0,0,0,1.0,1,1.0,1,1.0,1,0.11835241482160323,32
2194,1,4178,1686,2492,0,0,0,1.0,1,1.0,1,1.0,1,0.08063203414288682,32
2195,0,4178,1686,2492,0,0,0,1.0,1,1.0,1,1.0,1,0.09480550660992075,31
2196,2,4180,1688,2492,0,0,0,1.0,1,1.0,1,1.0,1,0.1414437604215821,32
2197,2,4182,1688,2494,0,0,0,1.0,1,1.0,1,1.0,1,0.08123911087883151,31
2198,0,4182,1688,2494,0,0,0,1.0,1,1.0,1,1.0,1,0.08123911087883151,31
2199,1,4183,1689,2494,0,0,0,1.0,1,1.0,1,1.0,1,0.08599973677813717,32
2200,1,4184,1689,2495,0,0,0,1.0,1,1.0,1,1.0,1,0.10292489675666691,35
2201,1,4185,1689,2496,0,0,0,1.0,1,1.0,1,1.0,1,0.08319207507194662,36
2202,1,4186,1690,2496,0,0,0,1.0,1,1.0,1,1.0,1,0.08936714973979751,36
2203,3,4189,1691,2498,0,0,0,1.0,1,1.0,1,1.0,1,0.05176973722010458,37
2204,2,4191,1693,2498,0,0,0,1.0,1,1.0,1,1.0,1,0.11218452341205863,36
2205,0,4191,1693,2498,0,0,0,1.0,1,1.0,1,1.0,1,0.11708369734356164,37
2206,5,4196,1696,2500,0,0,0,1.0,1,1.0,1,1.0,1,0.18633138652190637,35
2207,5,4201,1698,2503,0,0,0,1.0,1,1.0,1,1.0,1,0.15919166305849153,37
2208,0,4201,1698,2503,0,0,0,1.0,1,1.0,1,1.0,1,0.14517224840428047,36
2209,0,4201,1698,2503,0,0,0,1.0,1,1.0,1,1.0,1,0.15193839611467252,35
2210,1,4202,1698,2504,0,0,0,1.0,1,1.0,1,1.0,1,0.15991446564981288,38
2211,2,4204,1698,2506,0,0,0,1.0,1,1.0,1,1.0,1,0.10903053576540074,37
2212,3,4207,1698,2509,0,0,0,1.0,1,1.0,1,1.0,1,0.11099344823737008,38
2213,1,4208,1698,2510,0,0,0,1.0,1,1.0,1,1.0,1,0.08266473430590142,38
2214,0,4208,1698,2510,0,0,0,1.0,1,1.0,1,1.0,1,0.0636340819563253,39
2215,1,4209,1699,2510,0,0,0,1.0,1,1.0,1,1.0,1,0.11349241818476923,39
2216,1,4210,1700,2510,0,0,0,1.0,1,1.0,1,1.0,1,0.15742763212868585,39
2217,3,4213,1701,2512,0,0,0,1.0,1,1.0,1,1.0,1,0.08062448740623278,38
2218,1,4214,1702,2512,0,0,0,1.0,1,1.0,1,1.0,1,0.08057691349152252,37
2219,0,4214,1702,2512,0,0,0,1.0,1,1.0,1,1.0,1,0.07953340222669025,36
2220,0,4214,1702,2512,0,0,0,1.0,1,1.0,1,1.0,1,0.12173305401767823,34
2221,4,4218,1704,2514,0,0,0,1.0,1,1.0,1,1.0,1,0.10380733115281952,35
2222,1,4219,1705,2514,0,0,0,1.0,1,1.0,1,1.0,1,0.12434966062705448,33
2223,3,4222,1706,2516,0,0,0,1.0,1,1.0,1,1.0,1,0.11188871233719273,34
2224,1,4223,1707,2516,0,0,0,1.0,1,1.0,1,1.0,1,0.1571754959225425,32
2225,7,4230,1709,2521,0,0,0,1.0,1,1.0,1,1.0,1,0.14086149695790584,33
2226,2,4232,1710,2522,0,0,0,1.0,1,1.0,1,1.0,1,0.1887711216292121,32
2227,5,4237,1711,2526,0,0,0,1.0,1,1.0,1,1.0,1,0.13888491174245718,31
2228,0,4237,1711,2526,0,0,0,1.0,1,1.0,1,1.0,1,0.15398239719998685,32
2229,2,4239,1712,2527,0,0,0,1.0,1,1.0,1,1.0,1,0.13348703627531133,32
2230,1,4240,1713,2527,0,0,0,1.0,1,1.0,1,1.0,1,0.1549655163065295,31
2231,0,4240,1713,2527,0,0,0,1.0,1,1.0,1,1.0,1,0.13662581721814973,32
2232,0,4240,1713,2527,0,0,0,1.0,1,1.0,1,1.0,1,0.14897572944837714,32
2233,1,4241,1714,2527,0,0,0,1.0,1,1.0,1,1.0,1,0.18552629123298256,31
2234,2,4243,1715,2528,0,0,0,1.0,1,1.0,1,1.0,1,0.18213763437455535,32
2235,1,4244,1715,2529,0,0,0,1.0,1,1.0,1,1.0,1,0.21449576950946722,31
2236,0,4244,1715,2529,0,0,0,1.0,1,1.0,1,1.0,1,0.21449576950946722,31
2237,3,4247,1716,2531,0,0,0,1.0,1,1.0,1,1.0,1,0.1518265488970522,31
2238,1,4248,1717,2531,0,0,0,1.0,1,1.0,1,1.0,1,0.180895435006884,31
2239,3,4251,1717,2534,0,0,0,1.0,1,1.0,1,1.0,1,0.10590743790040846,31
2240,0,4251,1717,2534,0,0,0,1.0,1,1.0,1,1.0,1,0.12067666556620602,32
2241,2,4253,1719,2534,0,0,0,1.0,1,1.0,1,1.0,1,0.1588513625635331,32
2242,3,4256,1720,2536,0,0,0,1.0,1,1.0,1,1.0,1,0.09926564003779446,34
2243,5,4261,1723,2538,0,0,0,1.0,1,1.0,1,1.0,1,0.15719988605681626,34
2244,0,4261,1723,2538,0,0,0,1.0,1,1.0,1,1.0,1,0.16842302289169614,36
2245,1,4262,1723,2539,0,0,0,1.0,1,1.0,1,1.0,1,0.150578863213046,36
2246,1,4263,1723,2540,0,0,0,1.0,1,1.0,1,1.0,1,0.1532849176090229,39
2247,0,4263,1723,2540,0,0,0,1.0,1,1.0,1,1.0,1,0.1500323139065878,40
2248,0,4263,1723,2540,0,0,0,1.0,1,1.0,1,1.0,1,0.1500323139065878,40
2249,1,4264,1723,2541,0,0,0,1.0,1,1.0,1,1.0,1,0.13094696377434653,41
2250,0,4264,1723,2541,0,0,0,1.0,1,1.0,1,1.0,1,0.13094696377434653,41
2251,1,4265,1723,2542,0,0,0,1.0,1,1.0,1,1.0,1,0.14041059833710323,42
2252,1,4266,1723,2543,0,0,0,1.0,1,1.0,1,1.0,1,0.14414667407513918,41
2253,1,4267,1723,2544,0,0,0,1.0,1,1.0,1,1.0,1,0.11456217717765173,40
2254,1,4268,1724,2544,0,0,0,1.0,1,1.0,1,1.0,1,0.14421960148968474,39
2255,3,4271,1724,2547,0,0,0,1.0,1,1.0,1,1.0,1,0.15077601742332017,39
2256,2,4273,1726,2547,0,0,0,1.0,1,1.0,1,1.0,1,0.19723823445237573,40
2257,4,4277,1727,2550,0,0,0,1.0,1,1.0,1,1.0,1,0.15499869879300154,40
2258,2,4279,1729,2550,0,0,0,1.0,1,1.0,1,1.0,1,0.14611487730187836,39
2259,1,4280,1730,2550,0,0,0,1.0,1,1.0,1,1.0,1,0.14526561476120042,41
2260,0,4280,1730,2550,0,0,0,1.0,1,1.0,1,1.0,1,0.1617661789079994,38
2261,1,4281,1731,2550,0,0,0,1.0,1,1.0,1,1.0,1,0.16068958155371968,38
2262,2,4283,1731,2552,0,0,0,1.0,1,1.0,1,1.0,1,0.18045600173371817,36
2263,5,4288,1734,2554,0,0,0,1.0,1,1.0,1,1.0,1,0.18159588595996018,35
2264,4,4292,1737,2555,0,0,0,1.0,1,1.0,1,1.0,1,0.23424455863700785,33
2265,5,4297,1739,2558,0,0,0,1.0,1,1.0,1,1.0,1,0.17885257347366573,33
2266,5,4302,1741,2561,0,0,0,1.0,1,1.0,1,1.0,1,0.24757979040308561,33
2267,5,4307,1743,2564,0,0,0,1.0,1,1.0,1,1.0,1,0.14071934159609073,33
2268,3,4310,1744,2566,0,0,0,1.0,1,1.0,1,1.0,1,0.15923184810399046,35
2269,5,4315,1745,2570,0,0,0,1.0,1,1.0,1,1.0,1,0.052081024444853415,36
2270,0,4315,1745,2570,0,0,0,1.0,1,1.0,1,1.0,1,0.07027988872459316,34
2271,3,4318,1748,2570,0,0,0,1.0,1,1.0,1,1.0,1,0.16265214792867577,34
2272,4,4322,1750,2572,0,0,0,1.0,1,1.0,1,1.0,1,0.17228960606679491,33
2273,3,4325,1752,2573,0,0,0,1.0,1,1.0,1,1.0,1,0.14722514979259066,32
2274,4,4329,1754,2575,0,0,0,1.0,1,1.0,1,1.0,1,0.1883308992132768,32
2275,1,4330,1754,2576,0,0,0,1.0,1,1.0,1,1.0,1,0.19893923248990128,32
2276,0,4330,1754,2576,0,0,0,1.0,1,1.0,1,1.0,1,0.18253630555117836,31
2277,2,4332,1755,2577,0,0,0,1.0,1,1.0,1,1.0,1,0.16950041561674697,30
2278,1,4333,1755,2578,0,0,0,1.0,1,1.0,1,1.0,1,0.14181798098697698,33
2279,2,4335,1755,2580,0,0,0,1.0,1,1.0,1,1.0,1,0.10195232611749024,33
2280,0,4335,1755,2580,0,0,0,1.0,1,1.0,1,1.0,1,0.10648810572515555,35
2281,1,4336,1755,2581,0,0,0,1.0,1,1.0,1,1.0,1,0.11765934641278303,36
2282,0,4336,1755,2581,0,0,0,1.0,1,1.0,1,1.0,1,0.11765934641278303,36
2283,1,4337,1756,2581,0,0,0,1.0,1,1.0,1,1.0,1,0.13969264469150458,36
2284,1,4338,1757,2581,0,0,0,1.0,1,1.0,1,1.0,1,0.14334303588572977,36
2285,1,4339,1757,2582,0,0,0,1.0,1,1.0,1,1.0,1,0.10265814512754748,37
2286,1,4340,1758,2582,0,0,0,1.0,1,1.0,1,1.0,1,0.12981962776715955,38
2287,1,4341,1758,2583,0,0,0,1.0,1,1.0,1,1.0,1,0.09288155636020579,38
2288,8,4349,1760,2589,0,0,0,1.0,1,1.0,1,1.0,1,0.13243331047094148,40
2289,4,4353,1760,2593,0,0,0,1.0,1,1.0,1,1.0,1,0.07448605746768923,40
2290,0,4353,1760,2593,0,0,0,1.0,1,1.0,1,1.0,1,0.09375379047498136,39
2291,0,4353,1760,2593,0,0,0,1.0,1,1.0,1,1.0,1,0.09470281351043161,37
2292,1,4354,1761,2593,0,0,0,1.0,1,1.0,1,1.0,1,0.17870618650134967,35
2293,3,4357,1763,2594,0,0,0,1.0,1,1.0,1,1.0,1,0.20953325402989564,35
2294,1,4358,1763,2595,0,0,0,1.0,1,1.0,1,1.0,1,0.15238815547618942,35
2295,1,4359,1763,2596,0,0,0,1.0,1,1.0,1,1.0,1,0.15202772465737732,36
2296,0,4359,1763,2596,0,0,0,1.0,1,1.0,1,1.0,1,0.1833585437764954,34
2297,2,4361,1763,2598,0,0,0,1.0,1,1.0,1,1.0,1,0.1727984246893911,35
2298,0,4361,1763,2598,0,0,0,1.0,1,1.0,1,1.0,1,0.18798538582128269,34
2299,2,4363,1764,2599,0,0,0,1.0,1,1.0,1,1.0,1,0.1879199009345412,35
2300,3,4366,1764,2602,0,0,0,1.0,1,1.0,1,1.0,1,0.16879157574441261,35
2301,0,4366,1764,2602,0,0,0,1.0,1,1.0,1,1.0,1,0.16879157574441261,35
2302,2,4368,1766,2602,0,0,0,1.0,1,1.0,1,1.0,1,0.2084932977906951,37
2303,0,4368,1766,2602,0,0,0,1.0,1,1.0,1,1.0,1,0.16595421910161162,35
2304,1,4369,1767,2602,0,0,0,1.0,1,1.0,1,1.0,1,0.2105389124440095,36
2305,2,4371,1767,2604,0,0,0,1.0,1,1.0,1,1.0,1,0.1741658093130777,34
2306,3,4374,1768,2606,0,0,0,1.0,1,1.0,1,1.0,1,0.1817271818869064,35
2307,1,4375,1768,2607,0,0,0,1.0,1,1.0,1,1.0,1,0.18514519990663933,35
2308,0,4375,1768,2607,0,0,0,1.0,1,1.0,1,1.0,1,0.18514519990663933,35
2309,1,4376,1768,2608,0,0,0,1.0,1,1.0,1,1.0,1,0.16455406718410728,34
2310,1,4377,1769,2608,0,0,0,1.0,1,1.0,1,1.0,1,0.1991299776368902,36
2311,3,4380,1769,2611,0,0,0,1.0,1,1.0,1,1.0,1,0.1386046706604665,38
2312,3,4383,1771,2612,0,0,0,1.0,1,1.0,1,1.0,1,0.1844047871023975,39
2313,4,4387,1772,2615,0,0,0,1.0,1,1.0,1,1.0,1,0.09459012541363293,39
2314,0,4387,1772,2615,0,0,0,1.0,1,1.0,1,1.0,1,0.09459012541363293,39
2315,4,4391,1774,2617,0,0,0,1.0,1,1.0,1,1.0,1,0.12006372558508531,40
2316,2,4393,1774,2619,0,0,0,1.0,1,1.0,1,1.0,1,0.11989899423589338,40
2317,2,4395,1775,2620,0,0,0,1.0,1,1.0,1,1.0,1,0.15223189656193917,41
2318,1,4396,1776,2620,0,0,0,1.0,1,1.0,1,1.0,1,0.15530757138541348,41
2319,3,4399,1776,2623,0,0,0,1.0,1,1.0,1,1.0,1,0.11970788055511354,41
2320,2,4401,1776,2625,0,0,0,1.0,1,1.0,1,1.0,1,0.09107619875913085,42
2321,0,4401,1776,2625,0,0,0,1.0,1,1.0,1,1.0,1,0.08484207238010055,43
2322,0,4401,1776,2625,0,0,0,1.0,1,1.0,1,1.0,1,0.09080959465698181,42
2323,1,4402,1777,2625,0,0,0,1.0,1,1.0,1,1.0,1,0.14154751408244728,43
2324,1,4403,1777,2626,0,0,0,1.0,1,1.0,1,1.0,1,0.15580475634793503,44
2325,3,4406,1778,2628,0,0,0,1.0,1,1.0,1,1.0,1,0.15417007610577788,44
2326,3,4409,1779,2630,0,0,0,1.0,1,1.0,1,1.0,1,0.15791424808069127,45
2327,2,4411,1779,2632,0,0,0,1.0,1,1.0,1,1.0,1,0.12589788053464743,45
2328,1,4412,1780,2632,0,0,0,1.0,1,1.0,1,1.0,1,0.1545851268466538,46
2329,1,4413,1780,2633,0,0,0,1.0,1,1.0,1,1.0,1,0.1246116384647296,45
2330,0,4413,1780,2633,0,0,0,1.0,1,1.0,1,1.0,1,0.10916899410465154,47
2331,0,4413,1780,2633,0,0,0,1.0,1,1.0,1,1.0,1,0.12861566322069254,48
2332,0,4413,1780,2633,0,0,0,1.0,1,1.0,1,1.0,1,0.12861566322069254,48
2333,2,4415,1782,2633,0,0,0,1.0,1,1.0,1,1.0,1,0.16997824520526308,49
2334,3,4418,1783,2635,0,0,0,1.0,1,1.0,1,1.0,1,0.18280155994935107,47
2335,4,4422,1783,2639,0,0,0,1.0,1,1.0,1,1.0,1,0.09334840385568934,46
2336,0,4422,1783,2639,0,0,0,1.0,1,1.0,1,1.0,1,0.10765610473025855,46
2337,0,4422,1783,2639,0,0,0,1.0,1,1.0,1,1.0,1,0.11004602058932265,45
2338,1,4423,1784,2639,0,0,0,1.0,1,1.0,1,1.0,1,0.11598345477868921,44
2339,2,4425,1785,2640,0,0,0,1.0,1,1.0,1,1.0,1,0.11256062060113857,45
2340,1,4426,1786,2640,0,0,0,1.0,1,1.0,1,1.0,1,0.09653023310382021,44
2341,1,4427,1786,2641,0,0,0,1.0,1,1.0,1,1.0,1,0.10057561781282012,45
2342,2,4429,1788,2641,0,0,0,1.0,1,1.0,1,1.0,1,0.09770259742486533,47
2343,2,4431,1788,2643,0,0,0,1.0,1,1.0,1,1.0,1,0.06260161952842284,46
2344,1,4432,1789,2643,0,0,0,1.0,1,1.0,1,1.0,1,0.09590498692294072,46
2345,0,4432,1789,2643,0,0,0,1.0,1,1.0,1,1.0,1,0.10975287783855303,45
2346,0,4432,1789,2643,0,0,0,1.0,1,1.0,1,1.0,1,0.09733194004648298,46
2347,0,4432,1789,2643,0,0,0,1.0,1,1.0,1,1.0,1,0.10181256353909249,47
2348,3,4435,1790,2645,0,0,0,1.0,1,1.0,1,1.0,1,0.1087630685601679,49
2349,2,4437,1791,2646,0,0,0,1.0,1,1.0,1,1.0,1,0.13412822886801012,49
2350,0,4437,1791,2646,0,0,0,1.0,1,1.0,1,1.0,1,0.11580626878768825,50
2351,1,4438,1792,2646,0,0,0,1.0,1,1.0,1,1.0,1,0.13586224263845703,50
2352,1,4439,1792,2647,0,0,0,1.0,1,1.0,1,1.0,1,0.14143338309875453,51
2353,1,4440,1792,2648,0,0,0,1.0,1,1.0,1,1.0,1,0.12100722416847892,51
2354,0,4440,1792,2648,0,0,0,1.0,1,1.0,1,1.0,1,0.1339864114062999,51
2355,6,4446,1794,2652,0,0,0,1.0,1,1.0,1,1.0,1,0.10367011071952476,50
2356,0,4446,1794,2652,0,0,0,1.0,1,1.0,1,1.0,1,0.10367011071952476,50
2357,0,4446,1794,2652,0,0,0,1.0,1,1.0,1,1.0,1,0.09237765422049432,49
2358,2,4448,1794,2654,0,0,0,1.0,1,1.0,1,1.0,1,0.09225842792836815,51
2359,1,4449,1794,2655,0,0,0,1.0,1,1.0,1,1.0,1,0.08501525293711461,51
2360,2,4451,1795,2656,0,0,0,1.0,1,1.0,1,1.0,1,0.09012972499763555,51
2361,1,4452,1796,2656,0,0,0,1.0,1,1.0,1,1.0,1,0.14014553600404198,52
2362,4,4456,1798,2658,0,0,0,1.0,1,1.0,1,1.0,1,0.1360976134598526,53
2363,3,4459,1799,2660,0,0,0,1.0,1,1.0,1,1.0,1,0.10478114252040019,54
2364,1,4460,1799,2661,0,0,0,1.0,1,1.0,1,1.0,1,0.10159234225521215,55
2365,6,4466,1803,2663,0,0,0,1.0,1,1.0,1,1.0,1,0.1340669467390864,53
2366,3,4469,1805,2664,0,0,0,1.0,1,1.0,1,1.0,1,0.13366741431466156,53
2367,1,4470,1806,2664,0,0,0,1.0,1,1.0,1,1.0,1,0.19308614324083598,51
2368,4,4474,1808,2666,0,0,0,1.0,1,1.0,1,1.0,1,0.19291100006660986,50
2369,6,4480,1809,2671,0,0,0,1.0,1,1.0,1,1.0,1,0.2060235308124921,47
2370,2,4482,1809,2673,0,0,0,1.0,1,1.0,1,1.0,1,0.19806323280602084,48
2371,1,4483,1809,2674,0,0,0,1.0,1,1.0,1,1.0,1,0.20944440997794192,49
2372,0,4483,1809,2674,0,0,0,1.0,1,1.0,1,1.0,1,0.2262576291952785,48
2373,0,4483,1809,2674,0,0,0,1.0,1,1.0,1,1.0,1,0.23481724000422893,49
2374,2,4485,1809,2676,0,0,0,1.0,1,1.0,1,1.0,1,0.20526254311451067,50
2375,2,4487,1810,2677,0,0,0,1.0,1,1.0,1,1.0,1,0.20510385431046993,50
2376,1,4488,1810,2678,0,0,0,1.0,1,1.0,1,1.0,1,0.20714768416978835,50
2377,1,4489,1810,2679,0,0,0,1.0,1,1.0,1,1.0,1,0.2105608081603624,49
2378,2,4491,1810,2681,0,0,0,1.0,1,1.0,1,1.0,1,0.19022051162102738,49
2379,3,4494,1811,2683,0,0,0,1.0,1,1.0,1,1.0,1,0.19431828296736214,50
2380,3,4497,1812,2685,0,0,0,1.0,1,1.0,1,1.0,1,0.20484457175667242,50
2381,2,4499,1813,2686,0,0,0,1.0,1,1.0,1,1.0,1,0.2055921065408512,51
2382,3,4502,1814,2688,0,0,0,1.0,1,1.0,1,1.0,1,0.1966587408591069,51
2383,6,4508,1815,2693,0,0,0,1.0,1,1.0,1,1.0,1,0.14236139103726295,52
2384,0,4508,1815,2693,0,0,0,1.0,1,1.0,1,1.0,1,0.11474544375217763,52
2385,3,4511,1816,2695,0,0,0,1.0,1,1.0,1,1.0,1,0.13534216145143718,51
2386,3,4514,1818,2696,0,0,0,1.0,1,1.0,1,1.0,1,0.16767164318015723,52
2387,3,4517,1819,2698,0,0,0,1.0,1,1.0,1,1.0,1,0.18179732222719172,49
2388,4,4521,1820,2701,0,0,0,1.0,1,1.0,1,1.0,1,0.1523770383013499,48
2389,3,4524,1821,2703,0,0,0,1.0,1,1.0,1,1.0,1,0.11191621335239833,48
2390,2,4526,1822,2704,0,0,0,1.0,1,1.0,1,1.0,1,0.10336598318773939,49
2391,3,4529,1825,2704,0,0,0,1.0,1,1.0,1,1.0,1,0.1697737673606016,48
2392,3,4532,1827,2705,0,0,0,1.0,1,1.0,1,1.0,1,0.17145830897201655,49
2393,5,4537,1828,2709,0,0,0,1.0,1,1.0,1,1.0,1,0.15342842600217652,50
2394,3,4540,1830,2710,0,0,0,1.0,1,1.0,1,1.0,1,0.18419656750513935,50
2395,1,4541,1830,2711,0,0,0,1.0,1,1.0,1,1.0,1,0.1582466935444869,49
2396,3,4544,1831,2713,0,0,0,1.0,1,1.0,1,1.0,1,0.1484436897663684,50
2397,2,4546,1833,2713,0,0,0,1.0,1,1.0,1,1.0,1,0.19339948728193943,51
2398,1,4547,1833,2714,0,0,0,1.0,1,1.0,1,1.0,1,0.14095242618774026,49
2399,1,4548,1833,2715,0,0,0,1.0,1,1.0,1,1.0,1,0.12602442456268234,50
2400,1,4549,1834,2715,0,0,0,1.0,1,1.0,1,1.0,1,0.16497825667158633,51
2401,2,4551,1834,2717,0,0,0,1.0,1,1.0,1,1.0,1,0.15749059252689204,50
2402,1,4552,1834,2718,0,0,0,1.0,1,1.0,1,1.0,1,0.1408752674503884,51
2403,0,4552,1834,2718,0,0,0,1.0,1,1.0,1,1.0,1,0.14203132001130053,52
2404,2,4554,1834,2720,0,0,0,1.0,1,1.0,1,1.0,1,0.10648749607130946,53
2405,2,4556,1834,2722,0,0,0,1.0,1,1.0,1,1.0,1,0.10558747352408122,52
2406,1,4557,1835,2722,0,0,0,1.0,1,1.0,1,1.0,1,0.11523301574447997,52
2407,0,4557,1835,2722,0,0,0,1.0,1,1.0,1,1.0,1,0.13141625594752188,51
2408,1,4558,1836,2722,0,0,0,1.0,1,1.0,1,1.0,1,0.15400838533191472,50
2409,0,4558,1836,2722,0,0,0,1.0,1,1.0,1,1.0,1,0.16664042101157278,50
2410,2,4560,1837,2723,0,0,0,1.0,1,1.0,1,1.0,1,0.1882328968429118,49
2411,0,4560,1837,2723,0,0,0,1.0,1,1.0,1,1.0,1,0.19473514609997958,48
2412,1,4561,1837,2724,0,0,0,1.0,1,1.0,1,1.0,1,0.20793656075613595,47
2413,2,4563,1837,2726,0,0,0,1.0,1,1.0,1,1.0,1,0.1712966704138753,47
2414,2,4565,1838,2727,0,0,0,1.0,1,1.0,1,1.0,1,0.23833629318763772,47
2415,4,4569,1838,2731,0,0,0,1.0,1,1.0,1,1.0,1,0.20237553252667045,46
2416,1,4570,1838,2732,0,0,0,1.0,1,1.0,1,1.0,1,0.1819802364519715,47
2417,2,4572,1839,2733,0,0,0,1.0,1,1.0,1,1.0,1,0.19242730710235806,46
2418,3,4575,1840,2735,0,0,0,1.0,1,1.0,1,1.0,1,0.19058235940846152,48
2419,3,4578,1841,2737,0,0,0,1.0,1,1.0,1,1.0,1,0.17649995213634628,47
2420,2,4580,1841,2739,0,0,0,1.0,1,1.0,1,1.0,1,0.13426602497107584,49
2421,0,4580,1841,2739,0,0,0,1.0,1,1.0,1,1.0,1,0.12927458631719888,50
2422,5,4585,1844,2741,0,0,0,1.0,1,1.0,1,1.0,1,0.11142413757964743,50
2423,0,4585,1844,2741,0,0,0,1.0,1,1.0,1,1.0,1,0.12668851449238952,51
2424,2,4587,1846,2741,0,0,0,1.0,1,1.0,1,1.0,1,0.1413732997396812,50
2425,1,4588,1846,2742,0,0,0,1.0,1,1.0,1,1.0,1,0.1450200811187222,48
2426,4,4592,1849,2743,0,0,0,1.0,1,1.0,1,1.0,1,0.13509725110431983,51
2427,2,4594,1850,2744,0,0,0,1.0,1,1.0,1,1.0,1,0.11491805539583835,50
2428,5,4599,1854,2745,0,0,0,1.0,1,1.0,1,1.0,1,0.13641836556509043,49
2429,2,4601,1855,2746,0,0,0,1.0,1,1.0,1,1.0,1,0.15790994374138997,49
2430,0,4601,1855,2746,0,0,0,1.0,1,1.0,1,1.0,1,0.17052103572490737,46
2431,1,4602,1855,2747,0,0,0,1.0,1,1.0,1,1.0,1,0.15162454640507125,45
2432,4,4606,1856,2750,0,0,0,1.0,1,1.0,1,1.0,1,0.19609107544103127,44
2433,1,4607,1856,2751,0,0,0,1.0,1,1.0,1,1.0,1,0.12403874836883111,45
2434,1,4608,1857,2751,0,0,0,1.0,1,1.0,1,1.0,1,0.151989619974742,44
2435,0,4608,1857,2751,0,0,0,1.0,1,1.0,1,1.0,1,0.151989619974742,44
2436,1,4609,1858,2751,0,0,0,1.0,1,1.0,1,1.0,1,0.16442093882437064,44
2437,3,4612,1859,2753,0,0,0,1.0,1,1.0,1,1.0,1,0.13391088467511048,45
2438,2,4614,1860,2754,0,0,0,1.0,1,1.0,1,1.0,1,0.13578874337039432,45
2439,2,4616,1860,2756,0,0,0,1.0,1,1.0,1,1.0,1,0.1269150668027391,46
2440,0,4616,1860,2756,0,0,0,1.0,1,1.0,1,1.0,1,0.14146610451376457,45
2441,3,4619,1861,2758,0,0,0,1.0,1,1.0,1,1.0,1,0.12623954331231813,45
2442,0,4619,1861,2758,0,0,0,1.0,1,1.0,1,1.0,1,0.11969594835970421,46
2443,1,4620,1861,2759,0,0,0,1.0,1,1.0,1,1.0,1,0.1259998295041859,45
2444,3,4623,1863,2760,0,0,0,1.0,1,1.0,1,1.0,1,0.15397688906574314,46
2445,3,4626,1863,2763,0,0,0,1.0,1,1.0,1,1.0,1,0.13314073864628345,44
2446,3,4629,1864,2765,0,0,0,1.0,1,1.0,1,1.0,1,0.14108417454493663,44
2447,5,4634,1865,2769,0,0,0,1.0,1,1.0,1,1.0,1,0.14054575373057632,42
2448,3,4637,1868,2769,0,0,0,1.0,1,1.0,1,1.0,1,0.16189617285832142,41
2449,2,4639,1869,2770,0,0,0,1.0,1,1.0,1,1.0,1,0.145638507970748,40
2450,3,4642,1871,2771,0,0,0,1.0,1,1.0,1,1.0,1,0.1281409429933415,42
2451,0,4642,1871,2771,0,0,0,1.0,1,1.0,1,1.0,1,0.12429932316122465,43
2452,0,4642,1871,2771,0,0,0,1.0,1,1.0,1,1.0,1,0.12429932316122465,43
2453,1,4643,1871,2772,0,0,0,1.0,1,1.0,1,1.0,1,0.14729534061092736,45
2454,2,4645,1873,2772,0,0,0,1.0,1,1.0,1,1.0,1,0.19477055534236318,47
2455,1,4646,1873,2773,0,0,0,1.0,1,1.0,1,1.0,1,0.17710175657771315,48
2456,4,4650,1875,2775,0,0,0,1.0,1,1.0,1,1.0,1,0.20402283285147305,49
2457,2,4652,1876,2776,0,0,0,1.0,1,1.0,1,1.0,1,0.23659239208485308,48
2458,1,4653,1877,2776,0,0,0,1.0,1,1.0,1,1.0,1,0.23408992481873456,49
2459,4,4657,1877,2780,0,0,0,1.0,1,1.0,1,1.0,1,0.15494650790649164,49
2460,4,4661,1879,2782,0,0,0,1.0,1,1.0,1,1.0,1,0.18923415787699072,50
2461,1,4662,1879,2783,0,0,0,1.0,1,1.0,1,1.0,1,0.17829722243874854,50
2462,3,4665,1881,2784,0,0,0,1.0,1,1.0,1,1.0,1,0.2134976893793067,51
2463,4,4669,1883,2786,0,0,0,1.0,1,1.0,1,1.0,1,0.21025690435637132,51
2464,3,4672,1886,2786,0,0,0,1.0,1,1.0,1,1.0,1,0.18650417699760305,50
2465,3,4675,1888,2787,0,0,0,1.0,1,1.0,1,1.0,1,0.19094647363786849,49
2466,3,4678,1889,2789,0,0,0,1.0,1,1.0,1,1.0,1,0.16656284155414697,49
2467,2,4680,1889,2791,0,0,0,1.0,1,1.0,1,1.0,1,0.11620790365740742,48
2468,1,4681,1890,2791,0,0,0,1.0,1,1.0,1,1.0,1,0.1490120491121468,47
2469,3,4684,1891,2793,0,0,0,1.0,1,1.0,1,1.0,1,0.10578502003813936,46
2470,1,4685,1891,2794,0,0,0,1.0,1,1.0,1,1.0,1,0.12997204087274622,44
2471,1,4686,1891,2795,0,0,0,1.0,1,1.0,1,1.0,1,0.13957969385676264,44
2472,3,4689,1891,2798,0,0,0,1.0,1,1.0,1,1.0,1,0.11412457909987235,44
2473,1,4690,1891,2799,0,0,0,1.0,1,1.0,1,1.0,1,0.1205724057382277,43
2474,3,4693,1893,2800,0,0,0,1.0,1,1.0,1,1.0,1,0.15230461772731116,44
2475,3,4696,1894,2802,0,0,0,1.0,1,1.0,1,1.0,1,0.12173002398697096,46
2476,2,4698,1894,2804,0,0,0,1.0,1,1.0,1,1.0,1,0.08765736387516788,46
2477,0,4698,1894,2804,0,0,0,1.0,1,1.0,1,1.0,1,0.08765736387516788,46
2478,0,4698,1894,2804,0,0,0,1.0,1,1.0,1,1.0,1,0.08765736387516788,46
2479,0,4698,1894,2804,0,0,0,1.0,1,1.0,1,1.0,1,0.08765736387516788,46
2480,2,4700,1895,2805,0,0,0,1.0,1,1.0,1,1.0,1,0.10597376871355876,47
2481,3,4703,1897,2806,0,0,0,1.0,1,1.0,1,1.0,1,0.09598698635132406,47
2482,1,4704,1898,2806,0,0,0,1.0,1,1.0,1,1.0,1,0.12899735655991806,45
2483,1,4705,1898,2807,0,0,0,1.0,1,1.0,1,1.0,1,0.12632915568471625,45
2484,1,4706,1899,2807,0,0,0,1.0,1,1.0,1,1.0,1,0.14395454088330112,46
2485,1,4707,1900,2807,0,0,0,1.0,1,1.0,1,1.0,1,0.15506766898571875,44
2486,0,4707,1900,2807,0,0,0,1.0,1,1.0,1,1.0,1,0.16216198155913214,43
2487,0,4707,1900,2807,0,0,0,1.0,1,1.0,1,1.0,1,0.15569075757605352,44
2488,4,4711,1903,2808,0,0,0,1.0,1,1.0,1,1.0,1,0.16440147641877106,45
2489,2,4713,1903,2810,0,0,0,1.0,1,1.0,1,1.0,1,0.17016948321329314,44
2490,3,4716,1904,2812,0,0,0,1.0,1,1.0,1,1.0,1,0.13588505890111496,44
2491,2,4718,1904,2814,0,0,0,1.0,1,1.0,1,1.0,1,0.17780235834525865,44
2492,0,4718,1904,2814,0,0,0,1.0,1,1.0,1,1.0,1,0.17780235834525865,44
2493,0,4718,1904,2814,0,0,0,1.0,1,1.0,1,1.0,1,0.21685237984194045,42
2494,2,4720,1906,2814,0,0,0,1.0,1,1.0,1,1.0,1,0.24481830868163473,42
2495,3,4723,1906,2817,0,0,0,1.0,1,1.0,1,1.0,1,0.16671723289884366,42
2496,1,4724,1907,2817,0,0,0,1.0,1,1.0,1,1.0,1,0.15181399143933486,42
2497,0,4724,1907,2817,0,0,0,1.0,1,1.0,1,1.0,1,0.15943069531696794,44
2498,1,4725,1907,2818,0,0,0,1.0,1,1.0,1,1.0,1,0.1463179977873896,43
2499,0,4725,1907,2818,0,0,0,1.0,1,1.0,1,1.0,1,0.1463179977873896,43
2500,4,4729,1909,2820,0,0,0,1.0,1,1.0,1,1.0,1,0.12074236295483298,44
2501,2,4731,1910,2821,0,0,0,1.0,1,1.0,1,1.0,1,0.10599343888095485,46
2502,3,4734,1911,2823,0,0,0,1.0,1,1.0,1,1.0,1,0.10860661525624252,47
2503,2,4736,1913,2823,0,0,0,1.0,1,1.0,1,1.0,1,0.1477722221299323,47
2504,1,4737,1914,2823,0,0,0,1.0,1,1.0,1,1.0,1,0.17641288278111186,46
2505,7,4744,1918,2826,0,0,0,1.0,1,1.0,1,1.0,1,0.16412241992078336,46
2506,1,4745,1918,2827,0,0,0,1.0,1,1.0,1,1.0,1,0.14428353327552712,45
2507,3,4748,1919,2829,0,0,0,1.0,1,1.0,1,1.0,1,0.16894400147841077,45
2508,2,4750,1920,2830,0,0,0,1.0,1,1.0,1,1.0,1,0.16660848757551774,46
2509,4,4754,1921,2833,0,0,0,1.0,1,1.0,1,1.0,1,0.09686464404039612,45
2510,3,4757,1923,2834,0,0,0,1.0,1,1.0,1,1.0,1,0.1382984311764917,46
2511,4,4761,1923,2838,0,0,0,1.0,1,1.0,1,1.0,1,0.09331822706662182,47
2512,3,4764,1924,2840,0,0,0,1.0,1,1.0,1,1.0,1,0.1275690612942831,47
2513,2,4766,1924,2842,0,0,0,1.0,1,1.0,1,1.0,1,0.09369870146941038,48
2514,2,4768,1926,2842,0,0,0,1.0,1,1.0,1,1.0,1,0.16518947894542627,48
2515,4,4772,1926,2846,0,0,0,1.0,1,1.0,1,1.0,1,0.10755832953240092,49
2516,1,4773,1927,2846,0,0,0,1.0,1,1.0,1,1.0,1,0.12349837268536137,49
2517,4,4777,1929,2848,0,0,0,1.0,1,1.0,1,1.0,1,0.10376932935256968,49
2518,1,4778,1930,2848,0,0,0,1.0,1,1.0,1,1.0,1,0.12838339643992341,48
2519,2,4780,1930,2850,0,0,0,1.0,1,1.0,1,1.0,1,0.0843743867758149,48
2520,1,4781,1931,2850,0,0,0,1.0,1,1.0,1,1.0,1,0.12635618700141904,46
2521,3,4784,1933,2851,0,0,0,1.0,1,1.0,1,1.0,1,0.16808278486484177,47
2522,1,4785,1933,2852,0,0,0,1.0,1,1.0,1,1.0,1,0.1865195995781407,45
2523,4,4789,1935,2854,0,0,0,1.0,1,1.0,1,1.0,1,0.2055932395089501,44
2524,0,4789,1935,2854,0,0,0,1.0,1,1.0,1,1.0,1,0.1983018870039919,42
2525,4,4793,1936,2857,0,0,0,1.0,1,1.0,1,1.0,1,0.18970373367998145,42
2526,0,4793,1936,2857,0,0,0,1.0,1,1.0,1,1.0,1,0.19439496455755007,41
2527,2,4795,1936,2859,0,0,0,1.0,1,1.0,1,1.0,1,0.15949501299337196,41
2528,1,4796,1936,2860,0,0,0,1.0,1,1.0,1,1.0,1,0.13765898312201535,41
2529,1,4797,1937,2860,0,0,0,1.0,1,1.0,1,1.0,1,0.1509662503613525,42
2530,0,4797,1937,2860,0,0,0,1.0,1,1.0,1,1.0,1,0.159482770627411,41
2531,0,4797,1937,2860,0,0,0,1.0,1,1.0,1,1.0,1,0.159482770627411,41
2532,1,4798,1937,2861,0,0,0,1.0,1,1.0,1,1.0,1,0.16553240323617022,43
2533,1,4799,1937,2862,0,0,0,1.0,1,1.0,1,1.0,1,0.1560696993258811,43
2534,0,4799,1937,2862,0,0,0,1.0,1,1.0,1,1.0,1,0.1560696993258811,43
2535,2,4801,1938,2863,0,0,0,1.0,1,1.0,1,1.0,1,0.18117208755431743,44
2536,1,4802,1938,2864,0,0,0,1.0,1,1.0,1,1.0,1,0.17675414504742987,44
2537,1,4803,1939,2864,0,0,0,1.0,1,1.0,1,1.0,1,0.20675258060412094,45
2538,1,4804,1939,2865,0,0,0,1.0,1,1.0,1,1.0,1,0.20832732972922963,48
2539,5,4809,1941,2868,0,0,0,1.0,1,1.0,1,1.0,1,0.2213812735488796,48
2540,3,4812,1942,2870,0,0,0,1.0,1,1.0,1,1.0,1,0.21918915526964863,50
2541,2,4814,1942,2872,0,0,0,1.0,1,1.0,1,1.0,1,0.20033237821978472,52
2542,6,4820,1946,2874,0,0,0,1.0,1,1.0,1,1.0,1,0.2560771086990798,52
2543,6,4826,1947,2879,0,0,0,1.0,1,1.0,1,1.0,1,0.20552752790555495,51
2544,4,4830,1950,2880,0,0,0,1.0,1,1.0,1,1.0,1,0.19682370467393923,51
2545,2,4832,1951,2881,0,0,0,1.0,1,1.0,1,1.0,1,0.1867277360908867,50
2546,2,4834,1952,2882,0,0,0,1.0,1,1.0,1,1.0,1,0.18185281319703048,50
2547,3,4837,1953,2884,0,0,0,1.0,1,1.0,1,1.0,1,0.17242019064462624,47
2548,0,4837,1953,2884,0,0,0,1.0,1,1.0,1,1.0,1,0.15666137324320809,46
2549,4,4841,1956,2885,0,0,0,1.0,1,1.0,1,1.0,1,0.1565392388094049,46
2550,3,4844,1958,2886,0,0,0,1.0,1,1.0,1,1.0,1,0.16291848428948746,44
2551,3,4847,1958,2889,0,0,0,1.0,1,1.0,1,1.0,1,0.08477272682861589,43
2552,0,4847,1958,2889,0,0,0,1.0,1,1.0,1,1.0,1,0.12186092383202392,43
2553,0,4847,1958,2889,0,0,0,1.0,1,1.0,1,1.0,1,0.1315123893679258,44
2554,1,4848,1959,2889,0,0,0,1.0,1,1.0,1,1.0,1,0.14526401444108367,45
2555,5,4853,1960,2893,0,0,0,1.0,1,1.0,1,1.0,1,0.10698933656933071,44
2556,0,4853,1960,2893,0,0,0,1.0,1,1.0,1,1.0,1,0.11584289674934577,44
2557,1,4854,1961,2893,0,0,0,1.0,1,1.0,1,1.0,1,0.14972707383516487,41
2558,0,4854,1961,2893,0,0,0,1.0,1,1.0,1,1.0,1,0.15430134313104202,40
2559,1,4855,1961,2894,0,0,0,1.0,1,1.0,1,1.0,1,0.14793177948282055,41
2560,0,4855,1961,2894,0,0,0,1.0,1,1.0,1,1.0,1,0.14793177948282055,41
2561,4,4859,1961,2898,0,0,0,1.0,1,1.0,1,1.0,1,0.13033255185649043,43
2562,3,4862,1962,2900,0,0,0,1.0,1,1.0,1,1.0,1,0.14221710958087044,44
2563,0,4862,1962,2900,0,0,0,1.0,1,1.0,1,1.0,1,0.14221710958087044,44
2564,2,4864,1964,2900,0,0,0,1.0,1,1.0,1,1.0,1,0.16124710828990169,44
2565,0,4864,1964,2900,0,0,0,1.0,1,1.0,1,1.0,1,0.15359364911334855,45
2566,2,4866,1965,2901,0,0,0,1.0,1,1.0,1,1.0,1,0.18728398449825262,46
2567,2,4868,1966,2902,0,0,0,1.0,1,1.0,1,1.0,1,0.18757028053557012,48
2568,2,4870,1967,2903,0,0,0,1.0,1,1.0,1,1.0,1,0.20773697458016488,48
2569,4,4874,1967,2907,0,0,0,1.0,1,1.0,1,1.0,1,0.18720817596809924,49
2570,2,4876,1967,2909,0,0,0,1.0,1,1.0,1,1.0,1,0.19332948658687216,48
2571,3,4879,1967,2912,0,0,0,1.0,1,1.0,1,1.0,1,0.1543193421665964,48
2572,1,4880,1967,2913,0,0,0,1.0,1,1.0,1,1.0,1,0.1300634933052571,49
2573,1,4881,1967,2914,0,0,0,1.0,1,1.0,1,1.0,1,0.11277761456168467,50
2574,2,4883,1968,2915,0,0,0,1.0,1,1.0,1,1.0,1,0.13081728545169863,49
2575,1,4884,1968,2916,0,0,0,1.0,1,1.0,1,1.0,1,0.12784120331937474,48
2576,0,4884,1968,2916,0,0,0,1.0,1,1.0,1,1.0,1,0.12784120331937474,48
2577,0,4884,1968,2916,0,0,0,1.0,1,1.0,1,1.0,1,0.156046460490092,50
2578,2,4886,1969,2917,0,0,0,1.0,1,1.0,1,1.0,1,0.1554778286148367,50
2579,3,4889,1970,2919,0,0,0,1.0,1,1.0,1,1.0,1,0.12593320941692507,51
2580,3,4892,1972,2920,0,0,0,1.0,1,1.0,1,1.0,1,0.1422772481298956,52
2581,2,4894,1972,2922,0,0,0,1.0,1,1.0,1,1.0,1,0.12920321307098634,51
2582,3,4897,1974,2923,0,0,0,1.0,1,1.0,1,1.0,1,0.14202283745581964,51
2583,3,4900,1975,2925,0,0,0,1.0,1,1.0,1,1.0,1,0.14588414678991,51
2584,6,4906,1978,2928,0,0,0,1.0,1,1.0,1,1.0,1,0.12950867663087132,51
2585,2,4908,1979,2929,0,0,0,1.0,1,1.0,1,1.0,1,0.11200584043863071,50
2586,2,4910,1981,2929,0,0,0,1.0,1,1.0,1,1.0,1,0.11750718574298698,50
2587,2,4912,1983,2929,0,0,0,1.0,1,1.0,1,1.0,1,0.10540116137187693,48
2588,5,4917,1984,2933,0,0,0,1.0,1,1.0,1,1.0,1,0.09845145388095203,50
2589,2,4919,1985,2934,0,0,0,1.0,1,1.0,1,1.0,1,0.05060881884120747,48
2590,0,4919,1985,2934,0,0,0,1.0,1,1.0,1,1.0,1,0.06300056746307335,47
2591,0,4919,1985,2934,0,0,0,1.0,1,1.0,1,1.0,1,0.06300056746307335,47
2592,1,4920,1986,2934,0,0,0,1.0,1,1.0,1,1.0,1,0.052740974650947875,47
2593,2,4922,1987,2935,0,0,0,1.0,1,1.0,1,1.0,1,0.056625707966098206,47
2594,5,4927,1988,2939,0,0,0,1.0,1,1.0,1,1.0,1,0.06755061936471027,49
2595,3,4930,1990,2940,0,0,0,1.0,1,1.0,1,1.0,1,0.09423379997505647,48
2596,1,4931,1991,2940,0,0,0,1.0,1,1.0,1,1.0,1,0.1088346089604786,47
2597,2,4933,1993,2940,0,0,0,1.0,1,1.0,1,1.0,1,0.10020822368581558,48
2598,2,4935,1994,2941,0,0,0,1.0,1,1.0,1,1.0,1,0.10526275094503174,48
2599,3,4938,1995,2943,0,0,0,1.0,1,1.0,1,1.0,1,0.0787891357896416,49
2600,0,4938,1995,2943,0,0,0,1.0,1,1.0,1,1.0,1,0.08521663204206394,52
2601,5,4943,1997,2946,0,0,0,1.0,1,1.0,1,1.0,1,0.1257906867518842,51
2602,2,4945,1998,2947,0,0,0,1.0,1,1.0,1,1.0,1,0.13835952689559397,52
2603,3,4948,1999,2949,0,0,0,1.0,1,1.0,1,1.0,1,0.1566524310651425,53
2604,0,4948,1999,2949,0,0,0,1.0,1,1.0,1,1.0,1,0.1566524310651425,53
2605,4,4952,2000,2952,0,0,0,1.0,1,1.0,1,1.0,1,0.15858519750857256,52
2606,3,4955,2000,2955,0,0,0,1.0,1,1.0,1,1.0,1,0.14264333076452712,52
2607,2,4957,2000,2957,0,0,0,1.0,1,1.0,1,1.0,1,0.11845402417044831,52
2608,1,4958,2000,2958,0,0,0,1.0,1,1.0,1,1.0,1,0.11562788697433257,52
2609,1,4959,2001,2958,0,0,0,1.0,1,1.0,1,1.0,1,0.10827660733618952,53
2610,2,4961,2001,2960,0,0,0,1.0,1,1.0,1,1.0,1,0.10488327074392123,54
2611,5,4966,2003,2963,0,0,0,1.0,1,1.0,1,1.0,1,0.09420163866458378,54
2612,1,4967,2004,2963,0,0,0,1.0,1,1.0,1,1.0,1,0.1017646427964396,56
2613,4,4971,2006,2965,0,0,0,1.0,1,1.0,1,1.0,1,0.08569724660386614,56
2614,2,4973,2007,2966,0,0,0,1.0,1,1.0,1,1.0,1,0.08390553872022513,56
2615,0,4973,2007,2966,0,0,0,1.0,1,1.0,1,1.0,1,0.071444496070397,57
2616,0,4973,2007,2966,0,0,0,1.0,1,1.0,1,1.0,1,0.071444496070397,57
2617,2,4975,2008,2967,0,0,0,1.0,1,1.0,1,1.0,1,0.08237278330140108,58
2618,2,4977,2009,2968,0,0,0,1.0,1,1.0,1,1.0,1,0.06023053322170777,58
2619,1,4978,2009,2969,0,0,0,1.0,1,1.0,1,1.0,1,0.08500365459325764,58
2620,1,4979,2009,2970,0,0,0,1.0,1,1.0,1,1.0,1,0.08557919418211739,60
2621,1,4980,2009,2971,0,0,0,1.0,1,1.0,1,1.0,1,0.06154569401179433,59
2622,1,4981,2010,2971,0,0,0,1.0,1,1.0,1,1.0,1,0.08459645621507188,60
2623,5,4986,2012,2974,0,0,0,1.0,1,1.0,1,1.0,1,0.054430715196983025,59
2624,3,4989,2015,2974,0,0,0,1.0,1,1.0,1,1.0,1,0.09895162337404863,58
2625,4,4993,2018,2975,0,0,0,1.0,1,1.0,1,1.0,1,0.11779855292728524,58
2626,5,4998,2020,2978,0,0,0,1.0,1,1.0,1,1.0,1,0.061087335148408285,57
2627,0,4998,2020,2978,0,0,0,1.0,1,1.0,1,1.0,1,0.06985784041908759,55
2628,3,5001,2023,2978,0,0,0,1.0,1,1.0,1,1.0,1,0.10775887988172746,55
2629,0,5001,2023,2978,0,0,0,1.0,1,1.0,1,1.0,1,0.10740527932335857,54
2630,2,5003,2024,2979,0,0,0,1.0,1,1.0,1,1.0,1,0.13436200573581386,55
2631,4,5007,2025,2982,0,0,0,1.0,1,1.0,1,1.0,1,0.11385535048788037,55
2632,2,5009,2026,2983,0,0,0,1.0,1,1.0,1,1.0,1,0.128918601273749,55
2633,1,5010,2027,2983,0,0,0,1.0,1,1.0,1,1.0,1,0.09870733759903481,53
2634,2,5012,2028,2984,0,0,0,1.0,1,1.0,1,1.0,1,0.12290299021200883,52
2635,2,5014,2028,2986,0,0,0,1.0,1,1.0,1,1.0,1,0.08566983137512059,52
2636,2,5016,2030,2986,0,0,0,1.0,1,1.0,1,1.0,1,0.11546833512164709,51
2637,3,5019,2032,2987,0,0,0,1.0,1,1.0,1,1.0,1,0.11790196696595426,50
2638,1,5020,2033,2987,0,0,0,1.0,1,1.0,1,1.0,1,0.12519928651562218,48
2639,1,5021,2034,2987,0,0,0,1.0,1,1.0,1,1.0,1,0.12470027889770789,48
2640,4,5025,2038,2987,0,0,0,1.0,1,1.0,1,1.0,1,0.12790007086212432,46
2641,6,5031,2042,2989,0,0,0,1.0,1,1.0,1,1.0,1,0.1736873821918714,46
2642,9,5040,2048,2992,0,0,0,1.0,1,1.0,1,1.0,1,0.14203412832107468,47
2643,4,5044,2050,2994,0,0,0,1.0,1,1.0,1,1.0,1,0.17774988004104908,45
2644,2,5046,2052,2994,0,0,0,1.0,1,1.0,1,1.0,1,0.2137578531968574,44
2645,3,5049,2053,2996,0,0,0,1.0,1,1.0,1,1.0,1,0.15092259833718796,42
2646,2,5051,2053,2998,0,0,0,1.0,1,1.0,1,1.0,1,0.1418586896400333,43
2647,1,5052,2053,2999,0,0,0,1.0,1,1.0,1,1.0,1,0.09247022008530473,40
2648,1,5053,2054,2999,0,0,0,1.0,1,1.0,1,1.0,1,0.1339440969434395,41
2649,4,5057,2055,3002,0,0,0,1.0,1,1.0,1,1.0,1,0.08053539787794611,43
2650,1,5058,2055,3003,0,0,0,1.0,1,1.0,1,1.0,1,0.11354442083546769,43
2651,3,5061,2055,3006,0,0,0,1.0,1,1.0,1,1.0,1,0.06838128359318482,44
2652,0,5061,2055,3006,0,0,0,1.0,1,1.0,1,1.0,1,0.06838128359318482,44
2653,0,5061,2055,3006,0,0,0,1.0,1,1.0,1,1.0,1,0.06838128359318482,44
2654,1,5062,2056,3006,0,0,0,1.0,1,1.0,1,1.0,1,0.11565663562450132,45
2655,1,5063,2057,3006,0,0,0,1.0,1,1.0,1,1.0,1,0.1108597735979881,45
2656,2,5065,2059,3006,0,0,0,1.0,1,1.0,1,1.0,1,0.15766845454625386,45
2657,4,5069,2059,3010,0,0,0,1.0,1,1.0,1,1.0,1,0.10293430343498618,45
2658,3,5072,2059,3013,0,0,0,1.0,1,1.0,1,1.0,1,0.09531785104707176,47
2659,1,5073,2059,3014,0,0,0,1.0,1,1.0,1,1.0,1,0.08726551048019622,46
2660,0,5073,2059,3014,0,0,0,1.0,1,1.0,1,1.0,1,0.08726551048019622,46
2661,1,5074,2059,3015,0,0,0,1.0,1,1.0,1,1.0,1,0.08372039365022152,46
2662,2,5076,2060,3016,0,0,0,1.0,1,1.0,1,1.0,1,0.08708654730689885,47
2663,4,5080,2062,3018,0,0,0,1.0,1,1.0,1,1.0,1,0.07476854503385477,46
2664,2,5082,2064,3018,0,0,0,1.0,1,1.0,1,1.0,1,0.12035802601632954,45
2665,6,5088,2066,3022,0,0,0,1.0,1,1.0,1,1.0,1,0.060242231954254356,47
2666,5,5093,2068,3025,0,0,0,1.0,1,1.0,1,1.0,1,0.137621027191387,47
2667,9,5102,2071,3031,0,0,0,1.0,1,1.0,1,1.0,1,0.09848488899904617,45
2668,2,5104,2071,3033,0,0,0,1.0,1,1.0,1,1.0,1,0.07981913060932519,45
2669,2,5106,2072,3034,0,0,0,1.0,1,1.0,1,1.0,1,0.1093338348305493,45
2670,3,5109,2074,3035,0,0,0,1.0,1,1.0,1,1.0,1,0.11077926287106596,45
2671,0,5109,2074,3035,0,0,0,1.0,1,1.0,1,1.0,1,0.09392343583375132,41
2672,2,5111,2075,3036,0,0,0,1.0,1,1.0,1,1.0,1,0.08783844355706358,40
2673,1,5112,2076,3036,0,0,0,1.0,1,1.0,1,1.0,1,0.12427614779035127,39
2674,2,5114,2078,3036,0,0,0,1.0,1,1.0,1,1.0,1,0.16519133213190948,37
2675,1,5115,2078,3037,0,0,0,1.0,1,1.0,1,1.0,1,0.13901800525306923,35
2676,2,5117,2079,3038,0,0,0,1.0,1,1.0,1,1.0,1,0.21539800814728288,34
2677,3,5120,2080,3040,0,0,0,1.0,1,1.0,1,1.0,1,0.14386215131777585,32
2678,4,5124,2081,3043,0,0,0,1.0,1,1.0,1,1.0,1,0.12928216202858475,33
2679,3,5127,2083,3044,0,0,0,1.0,1,1.0,1,1.0,1,0.17666748966563658,33
2680,6,5133,2086,3047,0,0,0,1.0,1,1.0,1,1.0,1,0.12954263580080372,33
2681,1,5134,2086,3048,0,0,0,1.0,1,1.0,1,1.0,1,0.054344408792208795,32
2682,0,5134,2086,3048,0,0,0,1.0,1,1.0,1,1.0,1,0.054344408792208795,32
2683,1,5135,2087,3048,0,0,0,1.0,1,1.0,1,1.0,1,0.19110884837376632,32
2684,0,5135,2087,3048,0,0,0,1.0,1,1.0,1,1.0,1,0.19853423919272048,31
2685,4,5139,2087,3052,0,0,0,1.0,1,1.0,1,1.0,1,0.16465026925953297,30
2686,2,5141,2088,3053,0,0,0,1.0,1,1.0,1,1.0,1,0.18615284454738282,29
2687,1,5142,2088,3054,0,0,0,1.0,1,1.0,1,1.0,1,0.18316154030796158,28
2688,0,5142,2088,3054,0,0,0,1.0,1,1.0,1,1.0,1,0.18316154030796158,28
2689,2,5144,2088,3056,0,0,0,1.0,1,1.0,1,1.0,1,0.18644599963144104,29
2690,1,5145,2088,3057,0,0,0,1.0,1,1.0,1,1.0,1,0.13237613110325694,29
2691,1,5146,2089,3057,0,0,0,1.0,1,1.0,1,1.0,1,0.15267771847192993,29
2692,3,5149,2089,3060,0,0,0,1.0,1,1.0,1,1.0,1,0.09353019247006958,31
2693,2,5151,2091,3060,0,0,0,1.0,1,1.0,1,1.0,1,0.16452245506923338,32
2694,1,5152,2092,3060,0,0,0,1.0,1,1.0,1,1.0,1,0.15606697721485027,32
2695,2,5154,2092,3062,0,0,0,1.0,1,1.0,1,1.0,1,0.10127714182484292,33
2696,0,5154,2092,3062,0,0,0,1.0,1,1.0,1,1.0,1,0.10127714182484292,33
2697,3,5157,2093,3064,0,0,0,1.0,1,1.0,1,1.0,1,0.11051346540375315,34
2698,1,5158,2094,3064,0,0,0,1.0,1,1.0,1,1.0,1,0.10775117712130472,34
2699,0,5158,2094,3064,0,0,0,1.0,1,1.0,1,1.0,1,0.12464460695473403,36
2700,1,5159,2095,3064,0,0,0,1.0,1,1.0,1,1.0,1,0.19668405435325212,36
2701,0,5159,2095,3064,0,0,0,1.0,1,1.0,1,1.0,1,0.19668405435325212,36
2702,4,5163,2096,3067,0,0,0,1.0,1,1.0,1,1.0,1,0.1773076028022243,36
2703,3,5166,2098,3068,0,0,0,1.0,1,1.0,1,1.0,1,0.16421466898541265,38
2704,2,5168,2099,3069,0,0,0,1.0,1,1.0,1,1.0,1,0.195174022159687,37
2705,5,5173,2101,3072,0,0,0,1.0,1,1.0,1,1.0,1,0.1592232196141596,36
2706,1,5174,2102,3072,0,0,0,1.0,1,1.0,1,1.0,1,0.18452185797162451,34
2707,1,5175,2102,3073,0,0,0,1.0,1,1.0,1,1.0,1,0.14740895559819409,36
2708,3,5178,2105,3073,0,0,0,1.0,1,1.0,1,1.0,1,0.20673711789983548,36
2709,3,5181,2107,3074,0,0,0,1.0,1,1.0,1,1.0,1,0.16913630290255466,33
2710,1,5182,2108,3074,0,0,0,1.0,1,1.0,1,1.0,1,0.19302958043301502,32
2711,0,5182,2108,3074,0,0,0,1.0,1,1.0,1,1.0,1,0.16736959521172964,29
2712,1,5183,2109,3074,0,0,0,1.0,1,1.0,1,1.0,1,0.22926077579528123,28
2713,1,5184,2110,3074,0,0,0,1.0,1,1.0,1,1.0,1,0.2924574168329345,28
2714,0,5184,2110,3074,0,0,0,1.0,1,1.0,1,1.0,1,0.27950846860272394,25
2715,3,5187,2112,3075,0,0,0,1.0,1,1.0,1,1.0,1,0.307640905799145,24
2716,1,5188,2113,3075,0,0,0,1.0,1,1.0,1,1.0,1,0.36853619827008977,23
2717,5,5193,2114,3079,0,0,0,1.0,1,1.0,1,1.0,1,0.20525683295816016,24
2718,2,5195,2114,3081,0,0,0,1.0,1,1.0,1,1.0,1,0.12877507664430518,24
2719,1,5196,2114,3082,0,0,0,1.0,1,1.0,1,1.0,1,0.13554546956344968,25
2720,2,5198,2116,3082,0,0,0,1.0,1,1.0,1,1.0,1,0.1445006062655122,25
2721,2,5200,2118,3082,0,0,0,1.0,1,1.0,1,1.0,1,0.13420858417077733,26
2722,1,5201,2119,3082,0,0,0,1.0,1,1.0,1,1.0,1,0.17596282777680697,26
2723,2,5203,2120,3083,0,0,0,1.0,1,1.0,1,1.0,1,0.0982013249239982,26
2724,1,5204,2121,3083,0,0,0,1.0,1,1.0,1,1.0,1,0.14906696133996894,27
2725,1,5205,2122,3083,0,0,0,1.0,1,1.0,1,1.0,1,0.16134288056943402,27
2726,1,5206,2122,3084,0,0,0,1.0,1,1.0,1,1.0,1,0.1154148216644433,28
2727,0,5206,2122,3084,0,0,0,1.0,1,1.0,1,1.0,1,0.11411757866216937,29
2728,0,5206,2122,3084,0,0,0,1.0,1,1.0,1,1.0,1,0.1283262418987236,28
2729,1,5207,2123,3084,0,0,0,1.0,1,1.0,1,1.0,1,0.13578012069909967,28
2730,0,5207,2123,3084,0,0,0,1.0,1,1.0,1,1.0,1,0.15712653140917213,29
2731,4,5211,2124,3087,0,0,0,1.0,1,1.0,1,1.0,1,0.13194083004823576,30
2732,1,5212,2124,3088,0,0,0,1.0,1,1.0,1,1.0,1,0.11663853393788948,29
2733,0,5212,2124,3088,0,0,0,1.0,1,1.0,1,1.0,1,0.11663853393788948,29
2734,0,5212,2124,3088,0,0,0,1.0,1,1.0,1,1.0,1,0.11663853393788948,29
2735,2,5214,2126,3088,0,0,0,1.0,1,1.0,1,1.0,1,0.20420940060839599,29
2736,1,5215,2126,3089,0,0,0,1.0,1,1.0,1,1.0,1,0.1893443286579715,30
2737,0,5215,2126,3089,0,0,0,1.0,1,1.0,1,1.0,1,0.1893443286579715,30
2738,2,5217,2128,3089,0,0,0,1.0,1,1.0,1,1.0,1,0.2391758757057927,29
2739,1,5218,2128,3090,0,0,0,1.0,1,1.0,1,1.0,1,0.23658588410000608,30
2740,1,5219,2129,3090,0,0,0,1.0,1,1.0,1,1.0,1,0.28221624953968605,29
2741,3,5222,2129,3093,0,0,0,1.0,1,1.0,1,1.0,1,0.20993217063787145,29
2742,3,5225,2130,3095,0,0,0,1.0,1,1.0,1,1.0,1,0.151220021623601,29
2743,5,5230,2131,3099,0,0,0,1.0,1,1.0,1,1.0,1,0.1490263485115774,30
2744,3,5233,2133,3100,0,0,0,1.0,1,1.0,1,1.0,1,0.16373203059387254,28
2745,1,5234,2133,3101,0,0,0,1.0,1,1.0,1,1.0,1,0.13635651363471152,27
2746,3,5237,2135,3102,0,0,0,1.0,1,1.0,1,1.0,1,0.17690953406824014,26
2747,1,5238,2136,3102,0,0,0,1.0,1,1.0,1,1.0,1,0.27456578828825384,22
2748,2,5240,2137,3103,0,0,0,1.0,1,1.0,1,1.0,1,0.2641242383978779,22
2749,1,5241,2137,3104,0,0,0,1.0,1,1.0,1,1.0,1,0.33169464778494434,20
2750,1,5242,2137,3105,0,0,0,1.0,1,1.0,1,1.0,1,0.2871142716911764,17
2751,0,5242,2137,3105,0,0,0,1.0,1,1.0,1,1.0,1,0.2871142716911764,17
2752,0,5242,2137,3105,0,0,0,1.0,1,1.0,1,1.0,1,0.28674727518993365,16
2753,1,5243,2137,3106,0,0,0,1.0,1,1.0,1,1.0,1,0.20943363225450204,16
2754,0,5243,2137,3106,0,0,0,1.0,1,1.0,1,1.0,1,0.20943363225450204,16
2755,1,5244,2138,3106,0,0,0,1.0,1,1.0,1,1.0,1,0.24004038074294923,16
2756,0,5244,2138,3106,0,0,0,1.0,1,1.0,1,1.0,1,0.27769198490367114,17
2757,1,5245,2139,3106,0,0,0,1.0,1,1.0,1,1.0,1,0.28363381462140697,18
2758,0,5245,2139,3106,0,0,0,1.0,1,1.0,1,1.0,1,0.28363381462140697,18
2759,2,5247,2139,3108,0,0,0,1.0,1,1.0,1,1.0,1,0.24753658935058606,19
2760,2,5249,2140,3109,0,0,0,1.0,1,1.0,1,1.0,1,0.2476974675525966,18
2761,2,5251,2140,3111,0,0,0,1.0,1,1.0,1,1.0,1,0.13675232201873633,18
2762,0,5251,2140,3111,0,0,0,1.0,1,1.0,1,1.0,1,0.13675232201873633,18
2763,0,5251,2140,3111,0,0,0,1.0,1,1.0,1,1.0,1,0.13675232201873633,18
2764,0,5251,2140,3111,0,0,0,1.0,1,1.0,1,1.0,1,0.13675232201873633,18
2765,1,5252,2141,3111,0,0,0,1.0,1,1.0,1,1.0,1,0.15097194295188715,18
2766,1,5253,2142,3111,0,0,0,1.0,1,1.0,1,1.0,1,0.21652501468416102,18
2767,0,5253,2142,3111,0,0,0,1.0,1,1.0,1,1.0,1,0.20025618532092745,17
2768,0,5253,2142,3111,0,0,0,1.0,1,1.0,1,1.0,1,0.20025618532092745,17
2769,0,5253,2142,3111,0,0,0,1.0,1,1.0,1,1.0,1,0.20025618532092745,17
2770,0,5253,2142,3111,0,0,0,1.0,1,1.0,1,1.0,1,0.20025618532092745,17
2771,0,5253,2142,3111,0,0,0,1.0,1,1.0,1,1.0,1,0.20025618532092745,17
2772,0,5253,2142,3111,0,0,0,1.0,1,1.0,1,1.0,1,0.20025618532092745,17
2773,2,5255,2144,3111,0,0,0,1.0,1,1.0,1,1.0,1,0.3155334990217042,17
2774,1,5256,2144,3112,0,0,0,1.0,1,1.0,1,1.0,1,0.2193344821772982,18
2775,1,5257,2145,3112,0,0,0,1.0,1,1.0,1,1.0,1,0.2556904214370667,20
2776,1,5258,2146,3112,0,0,0,1.0,1,1.0,1,1.0,1,0.343912105451564,21
2777,3,5261,2146,3115,0,0,0,1.0,1,1.0,1,1.0,1,0.23636226084894293,21
2778,0,5261,2146,3115,0,0,0,1.0,1,1.0,1,1.0,1,0.23636226084894293,21
2779,1,5262,2146,3116,0,0,0,1.0,1,1.0,1,1.0,1,0.19015716719221074,22
2780,3,5265,2148,3117,0,0,0,1.0,1,1.0,1,1.0,1,0.26240324265460196,22
2781,1,5266,2148,3118,0,0,0,1.0,1,1.0,1,1.0,1,0.20233429817270063,22
2782,2,5268,2150,3118,0,0,0,1.0,1,1.0,1,1.0,1,0.19521137930522686,23
2783,1,5269,2151,3118,0,0,0,1.0,1,1.0,1,1.0,1,0.19013226285097085,22
2784,0,5269,2151,3118,0,0,0,1.0,1,1.0,1,1.0,1,0.16196617900218424,21
2785,0,5269,2151,3118,0,0,0,1.0,1,1.0,1,1.0,1,0.17317269584301878,19
2786,1,5270,2152,3118,0,0,0,1.0,1,1.0,1,1.0,1,0.14317466371182141,19
2787,0,5270,2152,3118,0,0,0,1.0,1,1.0,1,1.0,1,0.14494667987614687,20
2788,1,5271,2153,3118,0,0,0,1.0,1,1.0,1,1.0,1,0.1470915333914397,20
2789,0,5271,2153,3118,0,0,0,1.0,1,1.0,1,1.0,1,0.17527469692660438,19
2790,0,5271,2153,3118,0,0,0,1.0,1,1.0,1,1.0,1,0.17890826824321757,20
2791,0,5271,2153,3118,0,0,0,1.0,1,1.0,1,1.0,1,0.17890826824321757,20
2792,0,5271,2153,3118,0,0,0,1.0,1,1.0,1,1.0,1,0.17890826824321757,20
2793,0,5271,2153,3118,0,0,0,1.0,1,1.0,1,1.0,1,0.21778417674834943,19
2794,0,5271,2153,3118,0,0,0,1.0,1,1.0,1,1.0,1,0.2402803010365879,20
2795,1,5272,2153,3119,0,0,0,1.0,1,1.0,1,1.0,1,0.1978037455470148,21
2796,1,5273,2154,3119,0,0,0,1.0,1,1.0,1,1.0,1,0.15259552127169929,22
2797,0,5273,2154,3119,0,0,0,1.0,1,1.0,1,1.0,1,0.19330915396990525,21
2798,0,5273,2154,3119,0,0,0,1.0,1,1.0,1,1.0,1,0.19330915396990525,21
2799,0,5273,2154,3119,0,0,0,1.0,1,1.0,1,1.0,1,0.1926819123312445,20
2800,0,5273,2154,3119,0,0,0,1.0,1,1.0,1,1.0,1,0.1926819123312445,20
2801,0,5273,2154,3119,0,0,0,1.0,1,1.0,1,1.0,1,0.1926819123312445,20
2802,1,5274,2154,3120,0,0,0,1.0,1,1.0,1,1.0,1,0.13266458381450166,20
2803,0,5274,2154,3120,0,0,0,1.0,1,1.0,1,1.0,1,0.16224194048073637,21
2804,0,5274,2154,3120,0,0,0,1.0,1,1.0,1,1.0,1,0.18066879835891295,22
2805,1,5275,2155,3120,0,0,0,1.0,1,1.0,1,1.0,1,0.1573579089277358,22
2806,5,5280,2158,3122,0,0,0,1.0,1,1.0,1,1.0,1,0.17251711520421487,23
2807,2,5282,2160,3122,0,0,0,1.0,1,1.0,1,1.0,1,0.2386443208126772,24
2808,2,5284,2161,3123,0,0,0,1.0,1,1.0,1,1.0,1,0.2509802100394466,24
2809,3,5287,2161,3126,0,0,0,1.0,1,1.0,1,1.0,1,0.1669515815883009,26
2810,1,5288,2161,3127,0,0,0,1.0,1,1.0,1,1.0,1,0.12731226080085414,26
2811,1,5289,2161,3128,0,0,0,1.0,1,1.0,1,1.0,1,0.08148311821501751,27
2812,0,5289,2161,3128,0,0,0,1.0,1,1.0,1,1.0,1,0.08148311821501751,27
2813,0,5289,2161,3128,0,0,0,1.0,1,1.0,1,1.0,1,0.10728949077018933,28
2814,1,5290,2161,3129,0,0,0,1.0,1,1.0,1,1.0,1,0.10769835160128402,29
2815,1,5291,2161,3130,0,0,0,1.0,1,1.0,1,1.0,1,0.10513423684045338,30
2816,0,5291,2161,3130,0,0,0,1.0,1,1.0,1,1.0,1,0.10727050225244097,31
2817,0,5291,2161,3130,0,0,0,1.0,1,1.0,1,1.0,1,0.10727050225244097,31
2818,2,5293,2163,3130,0,0,0,1.0,1,1.0,1,1.0,1,0.12876075226119432,32
2819,1,5294,2163,3131,0,0,0,1.0,1,1.0,1,1.0,1,0.08467067404369592,32
2820,1,5295,2163,3132,0,0,0,1.0,1,1.0,1,1.0,1,0.09302242814322602,33
2821,1,5296,2163,3133,0,0,0,1.0,1,1.0,1,1.0,1,0.07141124192273841,34
2822,1,5297,2164,3133,0,0,0,1.0,1,1.0,1,1.0,1,0.12076988188474286,35
2823,2,5299,2165,3134,0,0,0,1.0,1,1.0,1,1.0,1,0.12950187558754944,31
2824,3,5302,2167,3135,0,0,0,1.0,1,1.0,1,1.0,1,0.24375337671196326,33
2825,2,5304,2167,3137,0,0,0,1.0,1,1.0,1,1.0,1,0.16012888448294815,31
2826,1,5305,2168,3137,0,0,0,1.0,1,1.0,1,1.0,1,0.19895669613746986,31
2827,3,5308,2170,3138,0,0,0,1.0,1,1.0,1,1.0,1,0.17346360088637267,32
2828,6,5314,2172,3142,0,0,0,1.0,1,1.0,1,1.0,1,0.21239739614055603,33
2829,5,5319,2173,3146,0,0,0,1.0,1,1.0,1,1.0,1,0.15934461863513483,33
2830,2,5321,2174,3147,0,0,0,1.0,1,1.0,1,1.0,1,0.1527721181691157,32
2831,1,5322,2175,3147,0,0,0,1.0,1,1.0,1,1.0,1,0.1509214255195325,31
2832,2,5324,2176,3148,0,0,0,1.0,1,1.0,1,1.0,1,0.1333375029393134,30
2833,2,5326,2176,3150,0,0,0,1.0,1,1.0,1,1.0,1,0.09787887240118785,29
2834,3,5329,2179,3150,0,0,0,1.0,1,1.0,1,1.0,1,0.12703538345920784,29
2835,1,5330,2180,3150,0,0,0,1.0,1,1.0,1,1.0,1,0.20810397498505837,27
2836,0,5330,2180,3150,0,0,0,1.0,1,1.0,1,1.0,1,0.21815541514102707,27
2837,1,5331,2181,3150,0,0,0,1.0,1,1.0,1,1.0,1,0.24748565811877907,28
2838,1,5332,2181,3151,0,0,0,1.0,1,1.0,1,1.0,1,0.22620010828664736,29
2839,1,5333,2181,3152,0,0,0,1.0,1,1.0,1,1.0,1,0.19609813293623052,29
2840,0,5333,2181,3152,0,0,0,1.0,1,1.0,1,1.0,1,0.19609813293623052,29
2841,3,5336,2182,3154,0,0,0,1.0,1,1.0,1,1.0,1,0.16345361859907911,31
2842,1,5337,2182,3155,0,0,0,1.0,1,1.0,1,1.0,1,0.1928975610112275,32
2843,1,5338,2182,3156,0,0,0,1.0,1,1.0,1,1.0,1,0.17645623106639138,32
2844,2,5340,2183,3157,0,0,0,1.0,1,1.0,1,1.0,1,0.17145747080441046,33
2845,3,5343,2184,3159,0,0,0,1.0,1,1.0,1,1.0,1,0.18648710187785664,34
2846,2,5345,2185,3160,0,0,0,1.0,1,1.0,1,1.0,1,0.18733019010825194,34
2847,4,5349,2185,3164,0,0,0,1.0,1,1.0,1,1.0,1,0.12961179915217358,35
2848,1,5350,2185,3165,0,0,0,1.0,1,1.0,1,1.0,1,0.10594610952023018,37
2849,0,5350,2185,3165,0,0,0,1.0,1,1.0,1,1.0,1,0.10594610952023018,37
2850,0,5350,2185,3165,0,0,0,1.0,1,1.0,1,1.0,1,0.10594610952023018,37
2851,1,5351,2185,3166,0,0,0,1.0,1,1.0,1,1.0,1,0.09577829142376162,38
2852,0,5351,2185,3166,0,0,0,1.0,1,1.0,1,1.0,1,0.10486888248729594,36
2853,1,5352,2185,3167,0,0,0,1.0,1,1.0,1,1.0,1,0.1338158902799091,36
2854,0,5352,2185,3167,0,0,0,1.0,1,1.0,1,1.0,1,0.15977448081257858,37
2855,2,5354,2185,3169,0,0,0,1.0,1,1.0,1,1.0,1,0.13321612615342848,37
2856,0,5354,2185,3169,0,0,0,1.0,1,1.0,1,1.0,1,0.13488345334978516,38
2857,4,5358,2187,3171,0,0,0,1.0,1,1.0,1,1.0,1,0.16433700000942636,39
2858,3,5361,2187,3174,0,0,0,1.0,1,1.0,1,1.0,1,0.20561309004588563,39
2859,4,5365,2187,3178,0,0,0,1.0,1,1.0,1,1.0,1,0.13173871409772775,39
2860,3,5368,2188,3180,0,0,0,1.0,1,1.0,1,1.0,1,0.10251701804402599,40
2861,0,5368,2188,3180,0,0,0,1.0,1,1.0,1,1.0,1,0.10381947725130197,38
2862,5,5373,2193,3180,0,0,0,1.0,1,1.0,1,1.0,1,0.14525050053253782,38
2863,3,5376,2196,3180,0,0,0,1.0,1,1.0,1,1.0,1,0.16252316533138586,37
2864,5,5381,2200,3181,0,0,0,1.0,1,1.0,1,1.0,1,0.18266157776961628,35
2865,4,5385,2201,3184,0,0,0,1.0,1,1.0,1,1.0,1,0.16137452837966704,33
2866,3,5388,2203,3185,0,0,0,1.0,1,1.0,1,1.0,1,0.21004057963019998,31
2867,4,5392,2204,3188,0,0,0,1.0,1,1.0,1,1.0,1,0.1542746329188407,30
2868,2,5394,2206,3188,0,0,0,1.0,1,1.0,1,1.0,1,0.21646371091218386,31
2869,3,5397,2208,3189,0,0,0,1.0,1,1.0,1,1.0,1,0.2113651103429486,30
2870,1,5398,2208,3190,0,0,0,1.0,1,1.0,1,1.0,1,0.19185343538915905,26
2871,1,5399,2208,3191,0,0,0,1.0,1,1.0,1,1.0,1,0.1703405695226296,27
2872,0,5399,2208,3191,0,0,0,1.0,1,1.0,1,1.0,1,0.18089057291514418,25
2873,0,5399,2208,3191,0,0,0,1.0,1,1.0,1,1.0,1,0.22391329959745596,24
2874,1,5400,2208,3192,0,0,0,1.0,1,1.0,1,1.0,1,0.16832193710933216,25
2875,1,5401,2209,3192,0,0,0,1.0,1,1.0,1,1.0,1,0.19768685520018844,26
2876,2,5403,2210,3193,0,0,0,1.0,1,1.0,1,1.0,1,0.22585209061357867,28
2877,0,5403,2210,3193,0,0,0,1.0,1,1.0,1,1.0,1,0.2234627017873539,29
2878,0,5403,2210,3193,0,0,0,1.0,1,1.0,1,1.0,1,0.214791102051698,31
2879,1,5404,2210,3194,0,0,0,1.0,1,1.0,1,1.0,1,0.19076196994889572,31
2880,1,5405,2210,3195,0,0,0,1.0,1,1.0,1,1.0,1,0.18055935544746077,32
2881,2,5407,2210,3197,0,0,0,1.0,1,1.0,1,1.0,1,0.1639892610434444,31
2882,0,5407,2210,3197,0,0,0,1.0,1,1.0,1,1.0,1,0.1639892610434444,31
2883,1,5408,2210,3198,0,0,0,1.0,1,1.0,1,1.0,1,0.17605355778726914,32
2884,1,5409,2211,3198,0,0,0,1.0,1,1.0,1,1.0,1,0.1991920252535651,32
2885,4,5413,2212,3201,0,0,0,1.0,1,1.0,1,1.0,1,0.13857039488386788,33
2886,3,5416,2213,3203,0,0,0,1.0,1,1.0,1,1.0,1,0.11328504462954847,34
2887,2,5418,2213,3205,0,0,0,1.0,1,1.0,1,1.0,1,0.10488712462487086,34
2888,1,5419,2214,3205,0,0,0,1.0,1,1.0,1,1.0,1,0.10428644042768974,34
2889,4,5423,2216,3207,0,0,0,1.0,1,1.0,1,1.0,1,0.13385652924675212,37
2890,1,5424,2216,3208,0,0,0,1.0,1,1.0,1,1.0,1,0.1127573597534143,37
2891,2,5426,2217,3209,0,0,0,1.0,1,1.0,1,1.0,1,0.147273834207876,37
2892,0,5426,2217,3209,0,0,0,1.0,1,1.0,1,1.0,1,0.147273834207876,37
2893,2,5428,2218,3210,0,0,0,1.0,1,1.0,1,1.0,1,0.12537455129245506,38
2894,0,5428,2218,3210,0,0,0,1.0,1,1.0,1,1.0,1,0.12116230469445068,39
2895,2,5430,2219,3211,0,0,0,1.0,1,1.0,1,1.0,1,0.09768714744494088,40
2896,1,5431,2220,3211,0,0,0,1.0,1,1.0,1,1.0,1,0.14168211575024112,41
2897,1,5432,2220,3212,0,0,0,1.0,1,1.0,1,1.0,1,0.09966438499739111,41
2898,2,5434,2222,3212,0,0,0,1.0,1,1.0,1,1.0,1,0.14918440579968367,41
2899,2,5436,2223,3213,0,0,0,1.0,1,1.0,1,1.0,1,0.15191061713564427,39
2900,8,5444,2225,3219,0,0,0,1.0,1,1.0,1,1.0,1,0.16574063033870157,40
2901,1,5445,2225,3220,0,0,0,1.0,1,1.0,1,1.0,1,0.13261898104611605,40
2902,2,5447,2226,3221,0,0,0,1.0,1,1.0,1,1.0,1,0.13895788811637877,38
2903,1,5448,2226,3222,0,0,0,1.0,1,1.0,1,1.0,1,0.10374142546431932,36
2904,1,5449,2227,3222,0,0,0,1.0,1,1.0,1,1.0,1,0.09443962961043832,36
2905,0,5449,2227,3222,0,0,0,1.0,1,1.0,1,1.0,1,0.07917568352706177,35
2906,1,5450,2228,3222,0,0,0,1.0,1,1.0,1,1.0,1,0.10243707088355411,36
2907,0,5450,2228,3222,0,0,0,1.0,1,1.0,1,1.0,1,0.10438125563297895,37
2908,1,5451,2229,3222,0,0,0,1.0,1,1.0,1,1.0,1,0.14243330170425766,38
2909,1,5452,2230,3222,0,0,0,1.0,1,1.0,1,1.0,1,0.1708079579909354,37
2910,2,5454,2231,3223,0,0,0,1.0,1,1.0,1,1.0,1,0.14594866917446683,37
2911,0,5454,2231,3223,0,0,0,1.0,1,1.0,1,1.0,1,0.15662573786751288,36
2912,4,5458,2233,3225,0,0,0,1.0,1,1.0,1,1.0,1,0.12336474727824304,36
2913,0,5458,2233,3225,0,0,0,1.0,1,1.0,1,1.0,1,0.13411209110801858,36
2914,0,5458,2233,3225,0,0,0,1.0,1,1.0,1,1.0,1,0.14862880567091513,38
2915,0,5458,2233,3225,0,0,0,1.0,1,1.0,1,1.0,1,0.1435840945868152,37
2916,2,5460,2233,3227,0,0,0,1.0,1,1.0,1,1.0,1,0.11519773336790139,39
2917,3,5463,2235,3228,0,0,0,1.0,1,1.0,1,1.0,1,0.1627211896700049,40
2918,4,5467,2237,3230,0,0,0,1.0,1,1.0,1,1.0,1,0.16463580682633627,40
2919,5,5472,2238,3234,0,0,0,1.0,1,1.0,1,1.0,1,0.09863338841297978,42
2920,0,5472,2238,3234,0,0,0,1.0,1,1.0,1,1.0,1,0.09863338841297978,42
2921,0,5472,2238,3234,0,0,0,1.0,1,1.0,1,1.0,1,0.09863338841297978,42
2922,1,5473,2238,3235,0,0,0,1.0,1,1.0,1,1.0,1,0.07380987431859294,43
2923,2,5475,2238,3237,0,0,0,1.0,1,1.0,1,1.0,1,0.08490120315391154,45
2924,1,5476,2239,3237,0,0,0,1.0,1,1.0,1,1.0,1,0.0935687712402041,46
2925,0,5476,2239,3237,0,0,0,1.0,1,1.0,1,1.0,1,0.0935687712402041,46
2926,1,5477,2240,3237,0,0,0,1.0,1,1.0,1,1.0,1,0.10693734890770211,46
2927,3,5480,2241,3239,0,0,0,1.0,1,1.0,1,1.0,1,0.09806130527191821,48
2928,1,5481,2242,3239,0,0,0,1.0,1,1.0,1,1.0,1,0.12196673303916056,48
2929,0,5481,2242,3239,0,0,0,1.0,1,1.0,1,1.0,1,0.12196673303916056,48
2930,1,5482,2242,3240,0,0,0,1.0,1,1.0,1,1.0,1,0.1326304939942339,50
2931,3,5485,2243,3242,0,0,0,1.0,1,1.0,1,1.0,1,0.14821882998535077,51
2932,4,5489,2244,3245,0,0,0,1.0,1,1.0,1,1.0,1,0.11343142074509253,52
2933,2,5491,2244,3247,0,0,0,1.0,1,1.0,1,1.0,1,0.0802833657541622,53
2934,2,5493,2245,3248,0,0,0,1.0,1,1.0,1,1.0,1,0.10956518110737526,54
2935,2,5495,2247,3248,0,0,0,1.0,1,1.0,1,1.0,1,0.1291282034909478,53
2936,1,5496,2247,3249,0,0,0,1.0,1,1.0,1,1.0,1,0.11392196587233241,53
2937,1,5497,2248,3249,0,0,0,1.0,1,1.0,1,1.0,1,0.14758396529746878,51
2938,2,5499,2249,3250,0,0,0,1.0,1,1.0,1,1.0,1,0.17244774352700395,53
2939,1,5500,2249,3251,0,0,0,1.0,1,1.0,1,1.0,1,0.17662698479150907,52
2940,5,5505,2251,3254,0,0,0,1.0,1,1.0,1,1.0,1,0.17810480346715507,52
2941,0,5505,2251,3254,0,0,0,1.0,1,1.0,1,1.0,1,0.17113728750540833,50
2942,2,5507,2252,3255,0,0,0,1.0,1,1.0,1,1.0,1,0.17845912573176448,50
2943,4,5511,2253,3258,0,0,0,1.0,1,1.0,1,1.0,1,0.13432426887354373,49
2944,2,5513,2254,3259,0,0,0,1.0,1,1.0,1,1.0,1,0.1186198649951222,48
2945,0,5513,2254,3259,0,0,0,1.0,1,1.0,1,1.0,1,0.12055558481164017,48
2946,4,5517,2256,3261,0,0,0,1.0,1,1.0,1,1.0,1,0.11048810338510459,47
2947,1,5518,2256,3262,0,0,0,1.0,1,1.0,1,1.0,1,0.07923236586074657,47
2948,2,5520,2256,3264,0,0,0,1.0,1,1.0,1,1.0,1,0.05995159808089436,48
2949,0,5520,2256,3264,0,0,0,1.0,1,1.0,1,1.0,1,0.05995159808089436,48
2950,1,5521,2257,3264,0,0,0,1.0,1,1.0,1,1.0,1,0.07401392168620424,48
2951,1,5522,2257,3265,0,0,0,1.0,1,1.0,1,1.0,1,0.09458878479689829,50
2952,2,5524,2258,3266,0,0,0,1.0,1,1.0,1,1.0,1,0.12230374100286229,50
2953,3,5527,2258,3269,0,0,0,1.0,1,1.0,1,1.0,1,0.11941341478270436,51
2954,0,5527,2258,3269,0,0,0,1.0,1,1.0,1,1.0,1,0.11941341478270436,51
2955,1,5528,2259,3269,0,0,0,1.0,1,1.0,1,1.0,1,0.1359751964467078,51
2956,3,5531,2260,3271,0,0,0,1.0,1,1.0,1,1.0,1,0.12832855379627356,51
2957,0,5531,2260,3271,0,0,0,1.0,1,1.0,1,1.0,1,0.13733485636278395,52
2958,1,5532,2260,3272,0,0,0,1.0,1,1.0,1,1.0,1,0.12624892637376808,52
2959,3,5535,2261,3274,0,0,0,1.0,1,1.0,1,1.0,1,0.10914934975723382,53
2960,1,5536,2261,3275,0,0,0,1.0,1,1.0,1,1.0,1,0.09609011005355522,52
2961,1,5537,2261,3276,0,0,0,1.0,1,1.0,1,1.0,1,0.08601605576599805,53
2962,0,5537,2261,3276,0,0,0,1.0,1,1.0,1,1.0,1,0.10478116883738631,54
2963,2,5539,2262,3277,0,0,0,1.0,1,1.0,1,1.0,1,0.1294434614210861,55
2964,1,5540,2262,3278,0,0,0,1.0,1,1.0,1,1.0,1,0.1408740509203661,55
2965,1,5541,2262,3279,0,0,0,1.0,1,1.0,1,1.0,1,0.1320421577777486,55
2966,1,5542,2263,3279,0,0,0,1.0,1,1.0,1,1.0,1,0.14113754895249037,55
2967,3,5545,2263,3282,0,0,0,1.0,1,1.0,1,1.0,1,0.14335992143381904,56
2968,0,5545,2263,3282,0,0,0,1.0,1,1.0,1,1.0,1,0.14335992143381904,56
2969,1,5546,2263,3283,0,0,0,1.0,1,1.0,1,1.0,1,0.15511445436052843,55
2970,1,5547,2263,3284,0,0,0,1.0,1,1.0,1,1.0,1,0.1568363336948919,57
2971,1,5548,2263,3285,0,0,0,1.0,1,1.0,1,1.0,1,0.16070030982649713,56
2972,3,5551,2264,3287,0,0,0,1.0,1,1.0,1,1.0,1,0.1584936751692291,57
2973,4,5555,2264,3291,0,0,0,1.0,1,1.0,1,1.0,1,0.12365693182873187,59
2974,1,5556,2265,3291,0,0,0,1.0,1,1.0,1,1.0,1,0.1279224934425063,60
2975,4,5560,2267,3293,0,0,0,1.0,1,1.0,1,1.0,1,0.13518457140043846,58
2976,4,5564,2268,3296,0,0,0,1.0,1,1.0,1,1.0,1,0.14106369990292414,59
2977,4,5568,2269,3299,0,0,0,1.0,1,1.0,1,1.0,1,0.10247241159968908,59
2978,4,5572,2270,3302,0,0,0,1.0,1,1.0,1,1.0,1,0.1489099487694633,58
2979,5,5577,2273,3304,0,0,0,1.0,1,1.0,1,1.0,1,0.13974846364094684,57
2980,0,5577,2273,3304,0,0,0,1.0,1,1.0,1,1.0,1,0.13876349200377183,56
2981,2,5579,2275,3304,0,0,0,1.0,1,1.0,1,1.0,1,0.1818646293480453,56
2982,5,5584,2277,3307,0,0,0,1.0,1,1.0,1,1.0,1,0.1574968026497414,57
2983,6,5590,2278,3312,0,0,0,1.0,1,1.0,1,1.0,1,0.12300210342480672,57
2984,2,5592,2278,3314,0,0,0,1.0,1,1.0,1,1.0,1,0.1135658563648338,56
2985,7,5599,2280,3319,0,0,0,1.0,1,1.0,1,1.0,1,0.09699949446984356,55
2986,6,5605,2283,3322,0,0,0,1.0,1,1.0,1,1.0,1,0.12416176341312402,55
2987,5,5610,2283,3327,0,0,0,1.0,1,1.0,1,1.0,1,0.0917314780938151,51
2988,3,5613,2284,3329,0,0,0,1.0,1,1.0,1,1.0,1,0.1053423123941893,52
2989,2,5615,2284,3331,0,0,0,1.0,1,1.0,1,1.0,1,0.06763936699553394,50
2990,1,5616,2285,3331,0,0,0,1.0,1,1.0,1,1.0,1,0.09423881786867286,50
2991,1,5617,2285,3332,0,0,0,1.0,1,1.0,1,1.0,1,0.06585977239867018,50
2992,2,5619,2286,3333,0,0,0,1.0,1,1.0,1,1.0,1,0.034468281512136725,50
2993,0,5619,2286,3333,0,0,0,1.0,1,1.0,1,1.0,1,0.07443393122551237,51
2994,2,5621,2288,3333,0,0,0,1.0,1,1.0,1,1.0,1,0.11485416140601083,51
2995,3,5624,2289,3335,0,0,0,1.0,1,1.0,1,1.0,1,0.1094078793160388,51
2996,1,5625,2290,3335,0,0,0,1.0,1,1.0,1,1.0,1,0.1423301086302638,52
2997,1,5626,2290,3336,0,0,0,1.0,1,1.0,1,1.0,1,0.1272456810873692,52
2998,1,5627,2291,3336,0,0,0,1.0,1,1.0,1,1.0,1,0.12498574918394136,51
2999,0,5627,2291,3336,0,0,0,1.0,1,1.0,1,1.0,1,0.12498574918394136,51
3000,2,5629,2293,3336,0,0,0,1.0,1,1.0,1,1.0,1,0.12433705822105943,52
3001,0,5629,2293,3336,0,0,0,1.0,1,1.0,1,1.0,1,0.12433705822105943,52
3002,2,5631,2294,3337,0,0,0,1.0,1,1.0,1,1.0,1,0.14256857452948096,53
3003,0,5631,2294,3337,0,0,0,1.0,1,1.0,1,1.0,1,0.1364966866439193,54
3004,0,5631,2294,3337,0,0,0,1.0,1,1.0,1,1.0,1,0.14593890255211003,55
3005,1,5632,2294,3338,0,0,0,1.0,1,1.0,1,1.0,1,0.13907823467296637,56
3006,1,5633,2294,3339,0,0,0,1.0,1,1.0,1,1.0,1,0.12241313618107838,57
3007,0,5633,2294,3339,0,0,0,1.0,1,1.0,1,1.0,1,0.13181550251474583,58
3008,4,5637,2297,3340,0,0,0,1.0,1,1.0,1,1.0,1,0.14620640454102365,59
3009,0,5637,2297,3340,0,0,0,1.0,1,1.0,1,1.0,1,0.14620640454102365,59
3010,3,5640,2297,3343,0,0,0,1.0,1,1.0,1,1.0,1,0.11063318304820535,59
3011,4,5644,2298,3346,0,0,0,1.0,1,1.0,1,1.0,1,0.09422304425378414,59
3012,3,5647,2300,3347,0,0,0,1.0,1,1.0,1,1.0,1,0.13535230607194096,61
3013,1,5648,2300,3348,0,0,0,1.0,1,1.0,1,1.0,1,0.133955084478495,59
3014,0,5648,2300,3348,0,0,0,1.0,1,1.0,1,1.0,1,0.13918389733713146,60
3015,3,5651,2301,3350,0,0,0,1.0,1,1.0,1,1.0,1,0.14630711146866782,58
3016,0,5651,2301,3350,0,0,0,1.0,1,1.0,1,1.0,1,0.13840934337990318,57
3017,2,5653,2303,3350,0,0,0,1.0,1,1.0,1,1.0,1,0.1528869092786503,58
3018,0,5653,2303,3350,0,0,0,1.0,1,1.0,1,1.0,1,0.20017368871666424,55
3019,6,5659,2304,3355,0,0,0,1.0,1,1.0,1,1.0,1,0.18602358416004963,56
3020,3,5662,2304,3358,0,0,0,1.0,1,1.0,1,1.0,1,0.1935437679082516,55
3021,4,5666,2305,3361,0,0,0,1.0,1,1.0,1,1.0,1,0.1283942663631727,55
3022,2,5668,2306,3362,0,0,0,1.0,1,1.0,1,1.0,1,0.16028240152877424,55
3023,2,5670,2307,3363,0,0,0,1.0,1,1.0,1,1.0,1,0.10724143701154921,54
3024,2,5672,2308,3364,0,0,0,1.0,1,1.0,1,1.0,1,0.1022870563639566,54
3025,4,5676,2311,3365,0,0,0,1.0,1,1.0,1,1.0,1,0.11127524349921517,54
3026,2,5678,2311,3367,0,0,0,1.0,1,1.0,1,1.0,1,0.11371217416963732,53
3027,7,5685,2314,3371,0,0,0,1.0,1,1.0,1,1.0,1,0.11924880677488746,53
3028,0,5685,2314,3371,0,0,0,1.0,1,1.0,1,1.0,1,0.14159980587553647,51
3029,1,5686,2314,3372,0,0,0,1.0,1,1.0,1,1.0,1,0.11411078891964177,51
3030,3,5689,2316,3373,0,0,0,1.0,1,1.0,1,1.0,1,0.1336075947310004,52
3031,2,5691,2316,3375,0,0,0,1.0,1,1.0,1,1.0,1,0.10004780776933106,51
3032,1,5692,2316,3376,0,0,0,1.0,1,1.0,1,1.0,1,0.06918364667673606,50
3033,0,5692,2316,3376,0,0,0,1.0,1,1.0,1,1.0,1,0.07985845609458096,52
3034,1,5693,2317,3376,0,0,0,1.0,1,1.0,1,1.0,1,0.0866978529186032,51
3035,0,5693,2317,3376,0,0,0,1.0,1,1.0,1,1.0,1,0.08881605882673554,51
3036,1,5694,2317,3377,0,0,0,1.0,1,1.0,1,1.0,1,0.08081299414134366,53
3037,0,5694,2317,3377,0,0,0,1.0,1,1.0,1,1.0,1,0.0694999559861173,52
3038,0,5694,2317,3377,0,0,0,1.0,1,1.0,1,1.0,1,0.0694999559861173,52
3039,3,5697,2319,3378,0,0,0,1.0,1,1.0,1,1.0,1,0.13026571530736605,54
3040,2,5699,2319,3380,0,0,0,1.0,1,1.0,1,1.0,1,0.0825707694678165,55
3041,1,5700,2319,3381,0,0,0,1.0,1,1.0,1,1.0,1,0.0814434494435706,56
3042,2,5702,2321,3381,0,0,0,1.0,1,1.0,1,1.0,1,0.130614864647832,56
3043,8,5710,2321,3389,0,0,0,1.0,1,1.0,1,1.0,1,0.08160782260325249,57
3044,1,5711,2322,3389,0,0,0,1.0,1,1.0,1,1.0,1,0.06763471196983388,57
3045,0,5711,2322,3389,0,0,0,1.0,1,1.0,1,1.0,1,0.061374250033567036,56
3046,0,5711,2322,3389,0,0,0,1.0,1,1.0,1,1.0,1,0.06648010198172645,57
3047,1,5712,2323,3389,0,0,0,1.0,1,1.0,1,1.0,1,0.09492268236673132,56
3048,2,5714,2323,3391,0,0,0,1.0,1,1.0,1,1.0,1,0.08099825049181036,58
3049,1,5715,2323,3392,0,0,0,1.0,1,1.0,1,1.0,1,0.10415247657253579,59
3050,0,5715,2323,3392,0,0,0,1.0,1,1.0,1,1.0,1,0.08991757696657308,60
3051,3,5718,2324,3394,0,0,0,1.0,1,1.0,1,1.0,1,0.11549508633021298,59
3052,4,5722,2326,3396,0,0,0,1.0,1,1.0,1,1.0,1,0.11052906320643131,58
3053,4,5726,2329,3397,0,0,0,1.0,1,1.0,1,1.0,1,0.15830782292074239,57
3054,4,5730,2331,3399,0,0,0,1.0,1,1.0,1,1.0,1,0.1649293501082886,55
3055,5,5735,2332,3403,0,0,0,1.0,1,1.0,1,1.0,1,0.12992554555023647,54
3056,3,5738,2334,3404,0,0,0,1.0,1,1.0,1,1.0,1,0.1763565474960934,55
3057,3,5741,2335,3406,0,0,0,1.0,1,1.0,1,1.0,1,0.1755891101211205,54
3058,1,5742,2335,3407,0,0,0,1.0,1,1.0,1,1.0,1,0.1965647386688318,55
3059,1,5743,2335,3408,0,0,0,1.0,1,1.0,1,1.0,1,0.18341251604201966,56
3060,0,5743,2335,3408,0,0,0,1.0,1,1.0,1,1.0,1,0.18341251604201966,56
3061,0,5743,2335,3408,0,0,0,1.0,1,1.0,1,1.0,1,0.18341251604201966,56
3062,4,5747,2338,3409,0,0,0,1.0,1,1.0,1,1.0,1,0.21933539097855964,57
3063,4,5751,2339,3412,0,0,0,1.0,1,1.0,1,1.0,1,0.1735252785225139,55
3064,2,5753,2340,3413,0,0,0,1.0,1,1.0,1,1.0,1,0.18421593020267776,56
3065,4,5757,2341,3416,0,0,0,1.0,1,1.0,1,1.0,1,0.12631784452783482,55
3066,2,5759,2343,3416,0,0,0,1.0,1,1.0,1,1.0,1,0.16419159349173432,55
3067,2,5761,2344,3417,0,0,0,1.0,1,1.0,1,1.0,1,0.15974330394078146,54
3068,3,5764,2345,3419,0,0,0,1.0,1,1.0,1,1.0,1,0.1560466019915129,53
3069,3,5767,2347,3420,0,0,0,1.0,1,1.0,1,1.0,1,0.15274102848344231,51
3070,1,5768,2347,3421,0,0,0,1.0,1,1.0,1,1.0,1,0.09936138136402482,50
3071,1,5769,2348,3421,0,0,0,1.0,1,1.0,1,1.0,1,0.07695979452689132,51
3072,2,5771,2350,3421,0,0,0,1.0,1,1.0,1,1.0,1,0.1249368270526135,53
3073,1,5772,2350,3422,0,0,0,1.0,1,1.0,1,1.0,1,0.10213560499354975,51
3074,1,5773,2350,3423,0,0,0,1.0,1,1.0,1,1.0,1,0.08645130879902471,50
3075,2,5775,2351,3424,0,0,0,1.0,1,1.0,1,1.0,1,0.1255380609391524,52
3076,6,5781,2352,3429,0,0,0,1.0,1,1.0,1,1.0,1,0.13116775355384871,53
3077,1,5782,2352,3430,0,0,0,1.0,1,1.0,1,1.0,1,0.09661824436818456,52
3078,0,5782,2352,3430,0,0,0,1.0,1,1.0,1,1.0,1,0.12900854852450108,53
3079,3,5785,2353,3432,0,0,0,1.0,1,1.0,1,1.0,1,0.12197674471981904,53
3080,2,5787,2353,3434,0,0,0,1.0,1,1.0,1,1.0,1,0.12851673214435716,52
3081,3,5790,2354,3436,0,0,0,1.0,1,1.0,1,1.0,1,0.1550826347910975,54
3082,5,5795,2358,3437,0,0,0,1.0,1,1.0,1,1.0,1,0.22940763722306962,54
3083,5,5800,2358,3442,0,0,0,1.0,1,1.0,1,1.0,1,0.170303488390945,54
3084,3,5803,2359,3444,0,0,0,1.0,1,1.0,1,1.0,1,0.15373299601998766,55
3085,1,5804,2360,3444,0,0,0,1.0,1,1.0,1,1.0,1,0.19640212416918448,55
3086,2,5806,2360,3446,0,0,0,1.0,1,1.0,1,1.0,1,0.16486254817871543,56
3087,0,5806,2360,3446,0,0,0,1.0,1,1.0,1,1.0,1,0.1681366149677183,57
3088,0,5806,2360,3446,0,0,0,1.0,1,1.0,1,1.0,1,0.18500775687526694,56
3089,2,5808,2361,3447,0,0,0,1.0,1,1.0,1,1.0,1,0.21650061387915245,55
3090,1,5809,2361,3448,0,0,0,1.0,1,1.0,1,1.0,1,0.22752046512161103,54
3091,3,5812,2361,3451,0,0,0,1.0,1,1.0,1,1.0,1,0.22849467186241146,53
3092,1,5813,2361,3452,0,0,0,1.0,1,1.0,1,1.0,1,0.19516941552378617,56
3093,0,5813,2361,3452,0,0,0,1.0,1,1.0,1,1.0,1,0.19516941552378617,56
3094,0,5813,2361,3452,0,0,0,1.0,1,1.0,1,1.0,1,0.21371630391339488,58
3095,4,5817,2361,3456,0,0,0,1.0,1,1.0,1,1.0,1,0.1633974434233267,59
3096,0,5817,2361,3456,0,0,0,1.0,1,1.0,1,1.0,1,0.17192193598708527,60
3097,2,5819,2361,3458,0,0,0,1.0,1,1.0,1,1.0,1,0.16990480896581464,60
3098,1,5820,2361,3459,0,0,0,1.0,1,1.0,1,1.0,1,0.19119381039467595,58
3099,1,5821,2361,3460,0,0,0,1.0,1,1.0,1,1.0,1,0.1961168343326945,57
3100,0,5821,2361,3460,0,0,0,1.0,1,1.0,1,1.0,1,0.1961168343326945,57
3101,1,5822,2362,3460,0,0,0,1.0,1,1.0,1,1.0,1,0.18400017794590193,58
3102,5,5827,2364,3463,0,0,0,1.0,1,1.0,1,1.0,1,0.19175229226950363,59
3103,3,5830,2365,3465,0,0,0,1.0,1,1.0,1,1.0,1,0.1668888591876692,58
3104,6,5836,2367,3469,0,0,0,1.0,1,1.0,1,1.0,1,0.12843211176730185,58
3105,0,5836,2367,3469,0,0,0,1.0,1,1.0,1,1.0,1,0.11947775748121585,56
3106,1,5837,2368,3469,0,0,0,1.0,1,1.0,1,1.0,1,0.11254824130070744,57
3107,3,5840,2371,3469,0,0,0,1.0,1,1.0,1,1.0,1,0.10347617338717618,55
3108,6,5846,2374,3472,0,0,0,1.0,1,1.0,1,1.0,1,0.11404736186260384,55
3109,5,5851,2376,3475,0,0,0,1.0,1,1.0,1,1.0,1,0.055145159473062845,54
3110,1,5852,2377,3475,0,0,0,1.0,1,1.0,1,1.0,1,0.06482123765839554,54
3111,1,5853,2378,3475,0,0,0,1.0,1,1.0,1,1.0,1,0.10411072654460285,54
3112,7,5860,2383,3477,0,0,0,1.0,1,1.0,1,1.0,1,0.1588914782761428,56
3113,5,5865,2386,3479,0,0,0,1.0,1,1.0,1,1.0,1,0.15745466602617594,55
3114,5,5870,2388,3482,0,0,0,1.0,1,1.0,1,1.0,1,0.13845900210182774,54
3115,4,5874,2388,3486,0,0,0,1.0,1,1.0,1,1.0,1,0.09333766108141471,56
3116,4,5878,2390,3488,0,0,0,1.0,1,1.0,1,1.0,1,0.09363367031892209,56
3117,2,5880,2390,3490,0,0,0,1.0,1,1.0,1,1.0,1,0.11755122802595182,58
3118,3,5883,2391,3492,0,0,0,1.0,1,1.0,1,1.0,1,0.0989921730112426,57
3119,2,5885,2391,3494,0,0,0,1.0,1,1.0,1,1.0,1,0.07340992146498206,57
3120,1,5886,2391,3495,0,0,0,1.0,1,1.0,1,1.0,1,0.06669197596523568,56
3121,1,5887,2392,3495,0,0,0,1.0,1,1.0,1,1.0,1,0.09235244830693387,57
3122,0,5887,2392,3495,0,0,0,1.0,1,1.0,1,1.0,1,0.09235244830693387,57
3123,0,5887,2392,3495,0,0,0,1.0,1,1.0,1,1.0,1,0.09235244830693387,57
3124,0,5887,2392,3495,0,0,0,1.0,1,1.0,1,1.0,1,0.06818132368699936,59
3125,1,5888,2392,3496,0,0,0,1.0,1,1.0,1,1.0,1,0.0794055612303135,61
3126,0,5888,2392,3496,0,0,0,1.0,1,1.0,1,1.0,1,0.0958558439472425,60
3127,3,5891,2392,3499,0,0,0,1.0,1,1.0,1,1.0,1,0.043671516049367996,58
3128,2,5893,2393,3500,0,0,0,1.0,1,1.0,1,1.0,1,0.11592651347888333,58
3129,4,5897,2395,3502,0,0,0,1.0,1,1.0,1,1.0,1,0.11270079062586301,56
3130,1,5898,2395,3503,0,0,0,1.0,1,1.0,1,1.0,1,0.12330094294498806,56
3131,6,5904,2397,3507,0,0,0,1.0,1,1.0,1,1.0,1,0.11956526025866976,55
3132,2,5906,2398,3508,0,0,0,1.0,1,1.0,1,1.0,1,0.14833232906950156,53
3133,4,5910,2399,3511,0,0,0,1.0,1,1.0,1,1.0,1,0.12134130091745328,52
3134,4,5914,2400,3514,0,0,0,1.0,1,1.0,1,1.0,1,0.10937271968004371,52
3135,2,5916,2400,3516,0,0,0,1.0,1,1.0,1,1.0,1,0.08247648756057914,53
3136,1,5917,2401,3516,0,0,0,1.0,1,1.0,1,1.0,1,0.0788305133296438,54
3137,1,5918,2402,3516,0,0,0,1.0,1,1.0,1,1.0,1,0.0992130224186402,55
3138,7,5925,2405,3520,0,0,0,1.0,1,1.0,1,1.0,1,0.11043418104768848,57
3139,9,5934,2407,3527,0,0,0,1.0,1,1.0,1,1.0,1,0.10000817568822055,56
3140,4,5938,2408,3530,0,0,0,1.0,1,1.0,1,1.0,1,0.14315004246201032,56
3141,2,5940,2408,3532,0,0,0,1.0,1,1.0,1,1.0,1,0.11749443553575721,56
3142,3,5943,2409,3534,0,0,0,1.0,1,1.0,1,1.0,1,0.09057025606778249,56
3143,2,5945,2410,3535,0,0,0,1.0,1,1.0,1,1.0,1,0.09686397850075702,56
3144,1,5946,2411,3535,0,0,0,1.0,1,1.0,1,1.0,1,0.10015359671617748,54
3145,3,5949,2412,3537,0,0,0,1.0,1,1.0,1,1.0,1,0.08310581866245065,55
3146,0,5949,2412,3537,0,0,0,1.0,1,1.0,1,1.0,1,0.10360995729708768,53
3147,4,5953,2412,3541,0,0,0,1.0,1,1.0,1,1.0,1,0.10169138091329516,54
3148,2,5955,2413,3542,0,0,0,1.0,1,1.0,1,1.0,1,0.08897684124815348,54
3149,2,5957,2414,3543,0,0,0,1.0,1,1.0,1,1.0,1,0.07542217107581109,53
3150,0,5957,2414,3543,0,0,0,1.0,1,1.0,1,1.0,1,0.07542217107581109,53
3151,0,5957,2414,3543,0,0,0,1.0,1,1.0,1,1.0,1,0.07942133419691279,53
3152,1,5958,2414,3544,0,0,0,1.0,1,1.0,1,1.0,1,0.06366868288748881,54
3153,0,5958,2414,3544,0,0,0,1.0,1,1.0,1,1.0,1,0.08427178099642764,53
3154,4,5962,2415,3547,0,0,0,1.0,1,1.0,1,1.0,1,0.07566720370592606,55
3155,2,5964,2415,3549,0,0,0,1.0,1,1.0,1,1.0,1,0.05715169190623298,56
3156,1,5965,2416,3549,0,0,0,1.0,1,1.0,1,1.0,1,0.06649683920605588,56
3157,0,5965,2416,3549,0,0,0,1.0,1,1.0,1,1.0,1,0.06649683920605588,56
3158,0,5965,2416,3549,0,0,0,1.0,1,1.0,1,1.0,1,0.06898309365091933,57
3159,2,5967,2417,3550,0,0,0,1.0,1,1.0,1,1.0,1,0.0801835875454308,56
3160,1,5968,2417,3551,0,0,0,1.0,1,1.0,1,1.0,1,0.08667278280477672,58
3161,0,5968,2417,3551,0,0,0,1.0,1,1.0,1,1.0,1,0.08081643391584074,59
3162,1,5969,2418,3551,0,0,0,1.0,1,1.0,1,1.0,1,0.09896429802633386,59
3163,5,5974,2420,3554,0,0,0,1.0,1,1.0,1,1.0,1,0.08728006188015258,59
3164,3,5977,2421,3556,0,0,0,1.0,1,1.0,1,1.0,1,0.09652712655127733,60
3165,6,5983,2422,3561,0,0,0,1.0,1,1.0,1,1.0,1,0.10116171890574054,58
3166,2,5985,2422,3563,0,0,0,1.0,1,1.0,1,1.0,1,0.09935175836989026,59
3167,4,5989,2425,3564,0,0,0,1.0,1,1.0,1,1.0,1,0.14822411939849986,57
3168,8,5997,2426,3571,0,0,0,1.0,1,1.0,1,1.0,1,0.1089137810188795,58
3169,1,5998,2426,3572,0,0,0,1.0,1,1.0,1,1.0,1,0.07445098932019502,57
3170,1,5999,2427,3572,0,0,0,1.0,1,1.0,1,1.0,1,0.09990624665346814,55
3171,3,6002,2429,3573,0,0,0,1.0,1,1.0,1,1.0,1,0.13310362790894667,56
3172,0,6002,2429,3573,0,0,0,1.0,1,1.0,1,1.0,1,0.156944776985911,54
3173,5,6007,2430,3577,0,0,0,1.0,1,1.0,1,1.0,1,0.12599479725157844,53
3174,1,6008,2430,3578,0,0,0,1.0,1,1.0,1,1.0,1,0.10986623609567006,53
3175,1,6009,2430,3579,0,0,0,1.0,1,1.0,1,1.0,1,0.1129780715081709,52
3176,2,6011,2432,3579,0,0,0,1.0,1,1.0,1,1.0,1,0.11541594957277301,53
3177,4,6015,2432,3583,0,0,0,1.0,1,1.0,1,1.0,1,0.11338849052683327,52
3178,3,6018,2433,3585,0,0,0,1.0,1,1.0,1,1.0,1,0.12694046416389207,53
3179,3,6021,2433,3588,0,0,0,1.0,1,1.0,1,1.0,1,0.07911816728779632,54
3180,1,6022,2433,3589,0,0,0,1.0,1,1.0,1,1.0,1,0.08385882154901422,54
3181,1,6023,2433,3590,0,0,0,1.0,1,1.0,1,1.0,1,0.0727923837787647,55
3182,0,6023,2433,3590,0,0,0,1.0,1,1.0,1,1.0,1,0.08337648690659458,54
3183,2,6025,2434,3591,0,0,0,1.0,1,1.0,1,1.0,1,0.10244185745608748,56
3184,2,6027,2436,3591,0,0,0,1.0,1,1.0,1,1.0,1,0.08675796184781889,54
3185,2,6029,2436,3593,0,0,0,1.0,1,1.0,1,1.0,1,0.07302497697128811,53
3186,3,6032,2437,3595,0,0,0,1.0,1,1.0,1,1.0,1,0.08624986162032078,52
3187,1,6033,2437,3596,0,0,0,1.0,1,1.0,1,1.0,1,0.08446665259022265,50
3188,2,6035,2439,3596,0,0,0,1.0,1,1.0,1,1.0,1,0.1110715397908214,50
3189,3,6038,2441,3597,0,0,0,1.0,1,1.0,1,1.0,1,0.13965640715259656,49
3190,1,6039,2442,3597,0,0,0,1.0,1,1.0,1,1.0,1,0.1677469132196889,50
3191,3,6042,2444,3598,0,0,0,1.0,1,1.0,1,1.0,1,0.17504773048635944,49
3192,3,6045,2444,3601,0,0,0,1.0,1,1.0,1,1.0,1,0.14526841824979173,49
3193,2,6047,2444,3603,0,0,0,1.0,1,1.0,1,1.0,1,0.11869324291963823,49
3194,2,6049,2446,3603,0,0,0,1.0,1,1.0,1,1.0,1,0.16796795858993716,50
3195,2,6051,2446,3605,0,0,0,1.0,1,1.0,1,1.0,1,0.16491329135067492,49
3196,0,6051,2446,3605,0,0,0,1.0,1,1.0,1,1.0,1,0.16491329135067492,49
3197,1,6052,2446,3606,0,0,0,1.0,1,1.0,1,1.0,1,0.1269410138088036,50
3198,0,6052,2446,3606,0,0,0,1.0,1,1.0,1,1.0,1,0.1269410138088036,50
3199,1,6053,2446,3607,0,0,0,1.0,1,1.0,1,1.0,1,0.10842551635444828,52
3200,2,6055,2447,3608,0,0,0,1.0,1,1.0,1,1.0,1,0.10721359101033655,53
3201,3,6058,2448,3610,0,0,0,1.0,1,1.0,1,1.0,1,0.0980238558312102,55
3202,2,6060,2449,3611,0,0,0,1.0,1,1.0,1,1.0,1,0.07418783065699285,55
3203,0,6060,2449,3611,0,0,0,1.0,1,1.0,1,1.0,1,0.07707233517337017,53
3204,1,6061,2449,3612,0,0,0,1.0,1,1.0,1,1.0,1,0.09718463665691635,53
3205,3,6064,2450,3614,0,0,0,1.0,1,1.0,1,1.0,1,0.08901625074150193,53
3206,0,6064,2450,3614,0,0,0,1.0,1,1.0,1,1.0,1,0.0797085418211853,52
3207,2,6066,2452,3614,0,0,0,1.0,1,1.0,1,1.0,1,0.1426322296363946,53
3208,0,6066,2452,3614,0,0,0,1.0,1,1.0,1,1.0,1,0.17146095368737593,51
3209,2,6068,2452,3616,0,0,0,1.0,1,1.0,1,1.0,1,0.1433641707974014,52
3210,1,6069,2452,3617,0,0,0,1.0,1,1.0,1,1.0,1,0.15195259736425598,49
3211,5,6074,2454,3620,0,0,0,1.0,1,1.0,1,1.0,1,0.14026186624843287,48
3212,0,6074,2454,3620,0,0,0,1.0,1,1.0,1,1.0,1,0.14086320939807886,48
3213,4,6078,2456,3622,0,0,0,1.0,1,1.0,1,1.0,1,0.12166845586239647,49
3214,1,6079,2457,3622,0,0,0,1.0,1,1.0,1,1.0,1,0.10365199450483674,51
3215,1,6080,2457,3623,0,0,0,1.0,1,1.0,1,1.0,1,0.09667379916639801,51
3216,2,6082,2459,3623,0,0,0,1.0,1,1.0,1,1.0,1,0.07750950630960539,51
3217,1,6083,2460,3623,0,0,0,1.0,1,1.0,1,1.0,1,0.10756722629679805,51
3218,0,6083,2460,3623,0,0,0,1.0,1,1.0,1,1.0,1,0.10756722629679805,51
3219,1,6084,2460,3624,0,0,0,1.0,1,1.0,1,1.0,1,0.11687006191806587,52
3220,1,6085,2460,3625,0,0,0,1.0,1,1.0,1,1.0,1,0.1085161686469686,52
3221,2,6087,2461,3626,0,0,0,1.0,1,1.0,1,1.0,1,0.10212638650805568,54
3222,0,6087,2461,3626,0,0,0,1.0,1,1.0,1,1.0,1,0.10255366053460871,54
3223,1,6088,2461,3627,0,0,0,1.0,1,1.0,1,1.0,1,0.11527831710132774,56
3224,1,6089,2462,3627,0,0,0,1.0,1,1.0,1,1.0,1,0.12688611565516755,57
3225,4,6093,2462,3631,0,0,0,1.0,1,1.0,1,1.0,1,0.0810491248761721,58
3226,0,6093,2462,3631,0,0,0,1.0,1,1.0,1,1.0,1,0.0810491248761721,58
3227,0,6093,2462,3631,0,0,0,1.0,1,1.0,1,1.0,1,0.0810491248761721,58
3228,0,6093,2462,3631,0,0,0,1.0,1,1.0,1,1.0,1,0.0810491248761721,58
3229,3,6096,2464,3632,0,0,0,1.0,1,1.0,1,1.0,1,0.14254236121666128,60
3230,4,6100,2464,3636,0,0,0,1.0,1,1.0,1,1.0,1,0.13321576732650683,61
3231,1,6101,2464,3637,0,0,0,1.0,1,1.0,1,1.0,1,0.12054517554334668,61
3232,0,6101,2464,3637,0,0,0,1.0,1,1.0,1,1.0,1,0.12054517554334668,61
3233,4,6105,2464,3641,0,0,0,1.0,1,1.0,1,1.0,1,0.09094261500484707,63
3234,1,6106,2465,3641,0,0,0,1.0,1,1.0,1,1.0,1,0.125313776242443,64
3235,1,6107,2465,3642,0,0,0,1.0,1,1.0,1,1.0,1,0.10890262167923791,65
3236,0,6107,2465,3642,0,0,0,1.0,1,1.0,1,1.0,1,0.11735558905398162,66
3237,2,6109,2465,3644,0,0,0,1.0,1,1.0,1,1.0,1,0.09282232889404933,67
3238,0,6109,2465,3644,0,0,0,1.0,1,1.0,1,1.0,1,0.09282232889404933,67
3239,1,6110,2465,3645,0,0,0,1.0,1,1.0,1,1.0,1,0.10278263181228911,69
3240,0,6110,2465,3645,0,0,0,1.0,1,1.0,1,1.0,1,0.10278263181228911,69
3241,3,6113,2466,3647,0,0,0,1.0,1,1.0,1,1.0,1,0.0850521347291729,68
3242,1,6114,2467,3647,0,0,0,1.0,1,1.0,1,1.0,1,0.0933954428662638,67
3243,5,6119,2469,3650,0,0,0,1.0,1,1.0,1,1.0,1,0.07194146367183019,68
3244,0,6119,2469,3650,0,0,0,1.0,1,1.0,1,1.0,1,0.06682009013871175,68
3245,1,6120,2469,3651,0,0,0,1.0,1,1.0,1,1.0,1,0.05619282566461536,69
3246,0,6120,2469,3651,0,0,0,1.0,1,1.0,1,1.0,1,0.06204193944220428,68
3247,0,6120,2469,3651,0,0,0,1.0,1,1.0,1,1.0,1,0.06204193944220428,68
3248,3,6123,2471,3652,0,0,0,1.0,1,1.0,1,1.0,1,0.08755843762406182,68
3249,1,6124,2471,3653,0,0,0,1.0,1,1.0,1,1.0,1,0.07912382953892276,69
3250,1,6125,2472,3653,0,0,0,1.0,1,1.0,1,1.0,1,0.08102824462532879,69
3251,3,6128,2473,3655,0,0,0,1.0,1,1.0,1,1.0,1,0.092571588903532,68
3252,0,6128,2473,3655,0,0,0,1.0,1,1.0,1,1.0,1,0.09204114875517767,68
3253,1,6129,2474,3655,0,0,0,1.0,1,1.0,1,1.0,1,0.08666309016536022,69
3254,0,6129,2474,3655,0,0,0,1.0,1,1.0,1,1.0,1,0.08666309016536022,69
3255,4,6133,2474,3659,0,0,0,1.0,1,1.0,1,1.0,1,0.06369659507765389,70
3256,0,6133,2474,3659,0,0,0,1.0,1,1.0,1,1.0,1,0.06369659507765389,70
3257,1,6134,2474,3660,0,0,0,1.0,1,1.0,1,1.0,1,0.059303160338798254,71
3258,4,6138,2478,3660,0,0,0,1.0,1,1.0,1,1.0,1,0.08084576090094815,72
3259,4,6142,2480,3662,0,0,0,1.0,1,1.0,1,1.0,1,0.07386388494450966,71
3260,3,6145,2480,3665,0,0,0,1.0,1,1.0,1,1.0,1,0.05798229390182162,72
3261,0,6145,2480,3665,0,0,0,1.0,1,1.0,1,1.0,1,0.07750644049437912,74
3262,5,6150,2483,3667,0,0,0,1.0,1,1.0,1,1.0,1,0.12718151475075865,73
3263,7,6157,2484,3673,0,0,0,1.0,1,1.0,1,1.0,1,0.10160694181885785,73
3264,3,6160,2486,3674,0,0,0,1.0,1,1.0,1,1.0,1,0.17022404069960614,71
3265,5,6165,2488,3677,0,0,0,1.0,1,1.0,1,1.0,1,0.11780450504986856,70
3266,3,6168,2490,3678,0,0,0,1.0,1,1.0,1,1.0,1,0.11448500090948821,69
3267,1,6169,2490,3679,0,0,0,1.0,1,1.0,1,1.0,1,0.12309160071124985,69
3268,2,6171,2492,3679,0,0,0,1.0,1,1.0,1,1.0,1,0.1362202872208847,68
3269,5,6176,2495,3681,0,0,0,1.0,1,1.0,1,1.0,1,0.18596675479459204,68
3270,0,6176,2495,3681,0,0,0,1.0,1,1.0,1,1.0,1,0.1974172875923144,67
3271,2,6178,2495,3683,0,0,0,1.0,1,1.0,1,1.0,1,0.1856655061779202,66
3272,0,6178,2495,3683,0,0,0,1.0,1,1.0,1,1.0,1,0.17140647194192365,67
3273,4,6182,2495,3687,0,0,0,1.0,1,1.0,1,1.0,1,0.1359065194365593,66
3274,1,6183,2496,3687,0,0,0,1.0,1,1.0,1,1.0,1,0.1312307454897582,68
3275,5,6188,2496,3692,0,0,0,1.0,1,1.0,1,1.0,1,0.115124650151421,68
3276,5,6193,2496,3697,0,0,0,1.0,1,1.0,1,1.0,1,0.10807206357730795,69
3277,3,6196,2497,3699,0,0,0,1.0,1,1.0,1,1.0,1,0.10624581773959277,68
3278,0,6196,2497,3699,0,0,0,1.0,1,1.0,1,1.0,1,0.11397607759676416,69
3279,2,6198,2499,3699,0,0,0,1.0,1,1.0,1,1.0,1,0.11031642843029066,67
3280,2,6200,2501,3699,0,0,0,1.0,1,1.0,1,1.0,1,0.13416459923031565,66
3281,2,6202,2502,3700,0,0,0,1.0,1,1.0,1,1.0,1,0.12872843435517972,67
3282,0,6202,2502,3700,0,0,0,1.0,1,1.0,1,1.0,1,0.1351386620387634,66
3283,5,6207,2504,3703,0,0,0,1.0,1,1.0,1,1.0,1,0.15580137415583317,67
3284,0,6207,2504,3703,0,0,0,1.0,1,1.0,1,1.0,1,0.12786622513327137,66
3285,3,6210,2505,3705,0,0,0,1.0,1,1.0,1,1.0,1,0.11868063778252629,66
3286,0,6210,2505,3705,0,0,0,1.0,1,1.0,1,1.0,1,0.12291795984622798,63
3287,4,6214,2506,3708,0,0,0,1.0,1,1.0,1,1.0,1,0.13482876512309439,61
3288,1,6215,2506,3709,0,0,0,1.0,1,1.0,1,1.0,1,0.14999503654736404,63
3289,3,6218,2506,3712,0,0,0,1.0,1,1.0,1,1.0,1,0.14450337066300914,62
3290,3,6221,2507,3714,0,0,0,1.0,1,1.0,1,1.0,1,0.1471732113437685,63
3291,6,6227,2510,3717,0,0,0,1.0,1,1.0,1,1.0,1,0.1591608983703745,62
3292,1,6228,2511,3717,0,0,0,1.0,1,1.0,1,1.0,1,0.18189800211582643,63
3293,5,6233,2511,3722,0,0,0,1.0,1,1.0,1,1.0,1,0.1503531044336569,65
3294,0,6233,2511,3722,0,0,0,1.0,1,1.0,1,1.0,1,0.1503531044336569,65
3295,3,6236,2511,3725,0,0,0,1.0,1,1.0,1,1.0,1,0.11240428750695695,65
3296,2,6238,2512,3726,0,0,0,1.0,1,1.0,1,1.0,1,0.12325053101476995,65
3297,1,6239,2512,3727,0,0,0,1.0,1,1.0,1,1.0,1,0.11889096977012904,66
3298,0,6239,2512,3727,0,0,0,1.0,1,1.0,1,1.0,1,0.11889096977012904,66
3299,1,6240,2512,3728,0,0,0,1.0,1,1.0,1,1.0,1,0.1168276623857897,67
3300,5,6245,2515,3730,0,0,0,1.0,1,1.0,1,1.0,1,0.14144137910029417,67
3301,4,6249,2517,3732,0,0,0,1.0,1,1.0,1,1.0,1,0.16472218407344574,68
3302,0,6249,2517,3732,0,0,0,1.0,1,1.0,1,1.0,1,0.1764365664744218,67
3303,2,6251,2518,3733,0,0,0,1.0,1,1.0,1,1.0,1,0.17435971161214248,67
3304,2,6253,2518,3735,0,0,0,1.0,1,1.0,1,1.0,1,0.16366555676554717,67
3305,3,6256,2518,3738,0,0,0,1.0,1,1.0,1,1.0,1,0.14616190052277825,69
3306,1,6257,2518,3739,0,0,0,1.0,1,1.0,1,1.0,1,0.1296497603752586,70
3307,0,6257,2518,3739,0,0,0,1.0,1,1.0,1,1.0,1,0.1296497603752586,70
3308,0,6257,2518,3739,0,0,0,1.0,1,1.0,1,1.0,1,0.1296497603752586,70
3309,3,6260,2518,3742,0,0,0,1.0,1,1.0,1,1.0,1,0.12294588630500915,72
3310,2,6262,2518,3744,0,0,0,1.0,1,1.0,1,1.0,1,0.11568895047789528,74
3311,0,6262,2518,3744,0,0,0,1.0,1,1.0,1,1.0,1,0.11568895047789528,74
3312,0,6262,2518,3744,0,0,0,1.0,1,1.0,1,1.0,1,0.11568895047789528,74
3313,3,6265,2518,3747,0,0,0,1.0,1,1.0,1,1.0,1,0.09954766806731218,75
3314,4,6269,2518,3751,0,0,0,1.0,1,1.0,1,1.0,1,0.08987701790909988,76
3315,1,6270,2519,3751,0,0,0,1.0,1,1.0,1,1.0,1,0.1235042029897985,75
3316,3,6273,2520,3753,0,0,0,1.0,1,1.0,1,1.0,1,0.12300457445279113,76
3317,2,6275,2520,3755,0,0,0,1.0,1,1.0,1,1.0,1,0.1139876107964257,73
3318,2,6277,2522,3755,0,0,0,1.0,1,1.0,1,1.0,1,0.14781157221577226,72
3319,3,6280,2523,3757,0,0,0,1.0,1,1.0,1,1.0,1,0.14647375625559322,71
3320,2,6282,2523,3759,0,0,0,1.0,1,1.0,1,1.0,1,0.1357571600426553,70
3321,5,6287,2524,3763,0,0,0,1.0,1,1.0,1,1.0,1,0.14030971335370498,69
3322,0,6287,2524,3763,0,0,0,1.0,1,1.0,1,1.0,1,0.13472382973245864,68
3323,0,6287,2524,3763,0,0,0,1.0,1,1.0,1,1.0,1,0.14207331088720437,69
3324,1,6288,2525,3763,0,0,0,1.0,1,1.0,1,1.0,1,0.133704111274825,69
3325,1,6289,2525,3764,0,0,0,1.0,1,1.0,1,1.0,1,0.13083741108420713,70
3326,6,6295,2529,3766,0,0,0,1.0,1,1.0,1,1.0,1,0.1743812794717265,69
3327,2,6297,2530,3767,0,0,0,1.0,1,1.0,1,1.0,1,0.1651409957976115,70
3328,4,6301,2531,3770,0,0,0,1.0,1,1.0,1,1.0,1,0.16160479013559667,73
3329,2,6303,2531,3772,0,0,0,1.0,1,1.0,1,1.0,1,0.16094230074220517,72
3330,2,6305,2532,3773,0,0,0,1.0,1,1.0,1,1.0,1,0.17064889990639087,72
3331,1,6306,2532,3774,0,0,0,1.0,1,1.0,1,1.0,1,0.16051855844412263,72
3332,2,6308,2532,3776,0,0,0,1.0,1,1.0,1,1.0,1,0.1431058220743773,73
3333,2,6310,2532,3778,0,0,0,1.0,1,1.0,1,1.0,1,0.13285774145993265,72
3334,1,6311,2532,3779,0,0,0,1.0,1,1.0,1,1.0,1,0.12438359432255398,73
3335,1,6312,2533,3779,0,0,0,1.0,1,1.0,1,1.0,1,0.1506501318405534,74
3336,1,6313,2533,3780,0,0,0,1.0,1,1.0,1,1.0,1,0.13708103515834175,74
3337,1,6314,2533,3781,0,0,0,1.0,1,1.0,1,1.0,1,0.13429183334951125,74
3338,1,6315,2533,3782,0,0,0,1.0,1,1.0,1,1.0,1,0.129148910569521,74
3339,2,6317,2534,3783,0,0,0,1.0,1,1.0,1,1.0,1,0.1475691067004837,75
3340,2,6319,2534,3785,0,0,0,1.0,1,1.0,1,1.0,1,0.1568417887397049,75
3341,5,6324,2534,3790,0,0,0,1.0,1,1.0,1,1.0,1,0.13987077364598258,76
3342,3,6327,2535,3792,0,0,0,1.0,1,1.0,1,1.0,1,0.14745994224985895,76
3343,3,6330,2537,3793,0,0,0,1.0,1,1.0,1,1.0,1,0.1366091664941805,75
3344,3,6333,2539,3794,0,0,0,1.0,1,1.0,1,1.0,1,0.15863211504969876,75
3345,3,6336,2540,3796,0,0,0,1.0,1,1.0,1,1.0,1,0.1573705072612345,72
3346,4,6340,2541,3799,0,0,0,1.0,1,1.0,1,1.0,1,0.1499758379999985,73
3347,4,6344,2542,3802,0,0,0,1.0,1,1.0,1,1.0,1,0.12033144238858601,73
3348,1,6345,2542,3803,0,0,0,1.0,1,1.0,1,1.0,1,0.11215013187617036,73
3349,2,6347,2543,3804,0,0,0,1.0,1,1.0,1,1.0,1,0.12118238279903094,74
3350,4,6351,2545,3806,0,0,0,1.0,1,1.0,1,1.0,1,0.1377274147376082,73
3351,2,6353,2546,3807,0,0,0,1.0,1,1.0,1,1.0,1,0.12644953854452307,72
3352,1,6354,2547,3807,0,0,0,1.0,1,1.0,1,1.0,1,0.14024232590866956,72
3353,1,6355,2548,3807,0,0,0,1.0,1,1.0,1,1.0,1,0.17170607254956669,72
3354,4,6359,2550,3809,0,0,0,1.0,1,1.0,1,1.0,1,0.1879445433279129,70
3355,7,6366,2551,3815,0,0,0,1.0,1,1.0,1,1.0,1,0.14544845997180256,69
3356,4,6370,2554,3816,0,0,0,1.0,1,1.0,1,1.0,1,0.17809810034480647,69
3357,6,6376,2555,3821,0,0,0,1.0,1,1.0,1,1.0,1,0.12438230141560255,68
3358,1,6377,2555,3822,0,0,0,1.0,1,1.0,1,1.0,1,0.12116693970544441,68
3359,1,6378,2555,3823,0,0,0,1.0,1,1.0,1,1.0,1,0.1295690173171109,66
3360,2,6380,2557,3823,0,0,0,1.0,1,1.0,1,1.0,1,0.1577979552437757,65
3361,2,6382,2557,3825,0,0,0,1.0,1,1.0,1,1.0,1,0.16828572425435245,64
3362,0,6382,2557,3825,0,0,0,1.0,1,1.0,1,1.0,1,0.16828572425435245,64
3363,3,6385,2557,3828,0,0,0,1.0,1,1.0,1,1.0,1,0.14411495171933913,65
3364,0,6385,2557,3828,0,0,0,1.0,1,1.0,1,1.0,1,0.15082364219849048,66
3365,1,6386,2557,3829,0,0,0,1.0,1,1.0,1,1.0,1,0.14077636907599772,68
3366,1,6387,2557,3830,0,0,0,1.0,1,1.0,1,1.0,1,0.14062391586622203,66
3367,1,6388,2557,3831,0,0,0,1.0,1,1.0,1,1.0,1,0.13345890142534964,68
3368,2,6390,2558,3832,0,0,0,1.0,1,1.0,1,1.0,1,0.12508207283229583,68
3369,1,6391,2558,3833,0,0,0,1.0,1,1.0,1,1.0,1,0.130725221789897,69
3370,1,6392,2558,3834,0,0,0,1.0,1,1.0,1,1.0,1,0.10496464263191492,71
3371,0,6392,2558,3834,0,0,0,1.0,1,1.0,1,1.0,1,0.10496464263191492,71
3372,2,6394,2559,3835,0,0,0,1.0,1,1.0,1,1.0,1,0.11660109429554552,71
3373,2,6396,2559,3837,0,0,0,1.0,1,1.0,1,1.0,1,0.10998433383752068,72
3374,0,6396,2559,3837,0,0,0,1.0,1,1.0,1,1.0,1,0.10423762032111028,72
3375,2,6398,2559,3839,0,0,0,1.0,1,1.0,1,1.0,1,0.0797576482550971,73
3376,1,6399,2559,3840,0,0,0,1.0,1,1.0,1,1.0,1,0.07139806559419803,75
3377,1,6400,2560,3840,0,0,0,1.0,1,1.0,1,1.0,1,0.08864805518062736,77
3378,0,6400,2560,3840,0,0,0,1.0,1,1.0,1,1.0,1,0.08864805518062736,77
3379,3,6403,2563,3840,0,0,0,1.0,1,1.0,1,1.0,1,0.13025145192873833,77
3380,4,6407,2565,3842,0,0,0,1.0,1,1.0,1,1.0,1,0.13678552432028648,76
3381,5,6412,2568,3844,0,0,0,1.0,1,1.0,1,1.0,1,0.11894372586263152,76
3382,3,6415,2568,3847,0,0,0,1.0,1,1.0,1,1.0,1,0.12292461871653355,78
3383,5,6420,2568,3852,0,0,0,1.0,1,1.0,1,1.0,1,0.11467060781252164,77
3384,4,6424,2571,3853,0,0,0,1.0,1,1.0,1,1.0,1,0.15067066437928253,77
3385,3,6427,2572,3855,0,0,0,1.0,1,1.0,1,1.0,1,0.12293846187164396,75
3386,6,6433,2575,3858,0,0,0,1.0,1,1.0,1,1.0,1,0.15630162117162266,76
3387,3,6436,2575,3861,0,0,0,1.0,1,1.0,1,1.0,1,0.13796481957744947,75
3388,0,6436,2575,3861,0,0,0,1.0,1,1.0,1,1.0,1,0.1454845817591202,76
3389,3,6439,2575,3864,0,0,0,1.0,1,1.0,1,1.0,1,0.12896070562575393,77
3390,0,6439,2575,3864,0,0,0,1.0,1,1.0,1,1.0,1,0.13363849756305124,76
3391,2,6441,2576,3865,0,0,0,1.0,1,1.0,1,1.0,1,0.09971904333755083,77
3392,3,6444,2577,3867,0,0,0,1.0,1,1.0,1,1.0,1,0.0856622422964282,78
3393,0,6444,2577,3867,0,0,0,1.0,1,1.0,1,1.0,1,0.08430214581095255,76
3394,1,6445,2578,3867,0,0,0,1.0,1,1.0,1,1.0,1,0.1155066155621189,75
3395,3,6448,2578,3870,0,0,0,1.0,1,1.0,1,1.0,1,0.09587977757995735,73
3396,0,6448,2578,3870,0,0,0,1.0,1,1.0,1,1.0,1,0.09587977757995735,73
3397,2,6450,2579,3871,0,0,0,1.0,1,1.0,1,1.0,1,0.08422046389334137,74
3398,0,6450,2579,3871,0,0,0,1.0,1,1.0,1,1.0,1,0.08422046389334137,74
3399,3,6453,2580,3873,0,0,0,1.0,1,1.0,1,1.0,1,0.07379770664606099,75
3400,2,6455,2581,3874,0,0,0,1.0,1,1.0,1,1.0,1,0.07530101368308995,75
3401,3,6458,2582,3876,0,0,0,1.0,1,1.0,1,1.0,1,0.06351827319211867,77
3402,2,6460,2583,3877,0,0,0,1.0,1,1.0,1,1.0,1,0.06441460986346795,77
3403,1,6461,2584,3877,0,0,0,1.0,1,1.0,1,1.0,1,0.0788141677184033,78
3404,1,6462,2585,3877,0,0,0,1.0,1,1.0,1,1.0,1,0.09975562834208597,78
3405,2,6464,2585,3879,0,0,0,1.0,1,1.0,1,1.0,1,0.0811716654987936,78
3406,2,6466,2586,3880,0,0,0,1.0,1,1.0,1,1.0,1,0.08150885813778141,78
3407,0,6466,2586,3880,0,0,0,1.0,1,1.0,1,1.0,1,0.08687244498679834,78
3408,4,6470,2587,3883,0,0,0,1.0,1,1.0,1,1.0,1,0.0858584225247289,79
3409,3,6473,2587,3886,0,0,0,1.0,1,1.0,1,1.0,1,0.06629081313074904,81
3410,1,6474,2587,3887,0,0,0,1.0,1,1.0,1,1.0,1,0.07234741318008865,82
3411,1,6475,2588,3887,0,0,0,1.0,1,1.0,1,1.0,1,0.06970335144783335,84
3412,0,6475,2588,3887,0,0,0,1.0,1,1.0,1,1.0,1,0.06970335144783335,84
3413,1,6476,2588,3888,0,0,0,1.0,1,1.0,1,1.0,1,0.0625183042084487,84
3414,0,6476,2588,3888,0,0,0,1.0,1,1.0,1,1.0,1,0.0625183042084487,84
3415,2,6478,2588,3890,0,0,0,1.0,1,1.0,1,1.0,1,0.04083062188748071,85
3416,3,6481,2590,3891,0,0,0,1.0,1,1.0,1,1.0,1,0.05250865592224097,85
3417,2,6483,2591,3892,0,0,0,1.0,1,1.0,1,1.0,1,0.06288677643514995,86
3418,3,6486,2594,3892,0,0,0,1.0,1,1.0,1,1.0,1,0.11350730592311156,86
3419,6,6492,2595,3897,0,0,0,1.0,1,1.0,1,1.0,1,0.10508487828683792,87
3420,1,6493,2595,3898,0,0,0,1.0,1,1.0,1,1.0,1,0.09709845589372382,88
3421,4,6497,2596,3901,0,0,0,1.0,1,1.0,1,1.0,1,0.09534963974962503,89
3422,2,6499,2597,3902,0,0,0,1.0,1,1.0,1,1.0,1,0.11403100046437459,90
3423,3,6502,2597,3905,0,0,0,1.0,1,1.0,1,1.0,1,0.10262392778342373,90
3424,2,6504,2597,3907,0,0,0,1.0,1,1.0,1,1.0,1,0.09122451344875526,91
3425,1,6505,2597,3908,0,0,0,1.0,1,1.0,1,1.0,1,0.08415209272337965,90
3426,2,6507,2599,3908,0,0,0,1.0,1,1.0,1,1.0,1,0.070247064561981,92
3427,1,6508,2599,3909,0,0,0,1.0,1,1.0,1,1.0,1,0.07695128323863266,92
3428,0,6508,2599,3909,0,0,0,1.0,1,1.0,1,1.0,1,0.08098535237137114,91
3429,0,6508,2599,3909,0,0,0,1.0,1,1.0,1,1.0,1,0.08098535237137114,91
3430,3,6511,2602,3909,0,0,0,1.0,1,1.0,1,1.0,1,0.11907425682407463,91
3431,1,6512,2602,3910,0,0,0,1.0,1,1.0,1,1.0,1,0.10056099174232855,90
3432,5,6517,2605,3912,0,0,0,1.0,1,1.0,1,1.0,1,0.13287711998265506,91
3433,1,6518,2605,3913,0,0,0,1.0,1,1.0,1,1.0,1,0.11902084990626796,90
3434,1,6519,2605,3914,0,0,0,1.0,1,1.0,1,1.0,1,0.11398834471388439,89
3435,1,6520,2606,3914,0,0,0,1.0,1,1.0,1,1.0,1,0.12249791472119982,88
3436,0,6520,2606,3914,0,0,0,1.0,1,1.0,1,1.0,1,0.12982077926264476,86
3437,5,6525,2606,3919,0,0,0,1.0,1,1.0,1,1.0,1,0.11478181770613097,86
3438,1,6526,2606,3920,0,0,0,1.0,1,1.0,1,1.0,1,0.11902518552221879,87
3439,4,6530,2607,3923,0,0,0,1.0,1,1.0,1,1.0,1,0.12261644099464725,86
3440,1,6531,2607,3924,0,0,0,1.0,1,1.0,1,1.0,1,0.11454499817522883,86
3441,5,6536,2608,3928,0,0,0,1.0,1,1.0,1,1.0,1,0.10751879582499341,85
3442,1,6537,2609,3928,0,0,0,1.0,1,1.0,1,1.0,1,0.11868041064243275,85
3443,3,6540,2609,3931,0,0,0,1.0,1,1.0,1,1.0,1,0.11581255698070611,85
3444,2,6542,2611,3931,0,0,0,1.0,1,1.0,1,1.0,1,0.1306659377897791,85
3445,4,6546,2612,3934,0,0,0,1.0,1,1.0,1,1.0,1,0.11510032014643586,84
3446,6,6552,2615,3937,0,0,0,1.0,1,1.0,1,1.0,1,0.15105454604978613,85
3447,5,6557,2616,3941,0,0,0,1.0,1,1.0,1,1.0,1,0.13821596911524472,85
3448,1,6558,2617,3941,0,0,0,1.0,1,1.0,1,1.0,1,0.1514488103145997,85
3449,4,6562,2617,3945,0,0,0,1.0,1,1.0,1,1.0,1,0.1375308356561191,84
3450,1,6563,2617,3946,0,0,0,1.0,1,1.0,1,1.0,1,0.142433186649543,84
3451,2,6565,2617,3948,0,0,0,1.0,1,1.0,1,1.0,1,0.12813503132524082,85
3452,0,6565,2617,3948,0,0,0,1.0,1,1.0,1,1.0,1,0.12336356476406016,86
3453,1,6566,2617,3949,0,0,0,1.0,1,1.0,1,1.0,1,0.1180246283337756,85
3454,1,6567,2617,3950,0,0,0,1.0,1,1.0,1,1.0,1,0.10421978137918192,88
3455,0,6567,2617,3950,0,0,0,1.0,1,1.0,1,1.0,1,0.10421978137918192,88
3456,2,6569,2618,3951,0,0,0,1.0,1,1.0,1,1.0,1,0.11104274276709725,88
3457,2,6571,2618,3953,0,0,0,1.0,1,1.0,1,1.0,1,0.10618560319546773,89
3458,0,6571,2618,3953,0,0,0,1.0,1,1.0,1,1.0,1,0.11524674169800558,88
3459,2,6573,2618,3955,0,0,0,1.0,1,1.0,1,1.0,1,0.10489297006372295,88
3460,0,6573,2618,3955,0,0,0,1.0,1,1.0,1,1.0,1,0.10705767896440457,89
3461,0,6573,2618,3955,0,0,0,1.0,1,1.0,1,1.0,1,0.10705767896440457,89
3462,2,6575,2618,3957,0,0,0,1.0,1,1.0,1,1.0,1,0.09840754744488428,90
3463,3,6578,2618,3960,0,0,0,1.0,1,1.0,1,1.0,1,0.08263291751052254,89
3464,0,6578,2618,3960,0,0,0,1.0,1,1.0,1,1.0,1,0.08757897003020564,88
3465,1,6579,2618,3961,0,0,0,1.0,1,1.0,1,1.0,1,0.10714866155624932,87
3466,1,6580,2618,3962,0,0,0,1.0,1,1.0,1,1.0,1,0.09317078020822951,87
3467,3,6583,2619,3964,0,0,0,1.0,1,1.0,1,1.0,1,0.09557422300788442,87
3468,3,6586,2620,3966,0,0,0,1.0,1,1.0,1,1.0,1,0.12212807983322138,88
3469,4,6590,2621,3969,0,0,0,1.0,1,1.0,1,1.0,1,0.13333442103115603,85
3470,1,6591,2621,3970,0,0,0,1.0,1,1.0,1,1.0,1,0.12497364943758524,86
3471,6,6597,2623,3974,0,0,0,1.0,1,1.0,1,1.0,1,0.13574972091252097,84
3472,2,6599,2624,3975,0,0,0,1.0,1,1.0,1,1.0,1,0.12878195535325454,83
3473,2,6601,2625,3976,0,0,0,1.0,1,1.0,1,1.0,1,0.1537172766473549,81
3474,1,6602,2625,3977,0,0,0,1.0,1,1.0,1,1.0,1,0.117848923786897,80
3475,5,6607,2627,3980,0,0,0,1.0,1,1.0,1,1.0,1,0.164988179047226,82
3476,3,6610,2628,3982,0,0,0,1.0,1,1.0,1,1.0,1,0.13090178847775805,81
3477,2,6612,2628,3984,0,0,0,1.0,1,1.0,1,1.0,1,0.13706554611553268,83
3478,1,6613,2628,3985,0,0,0,1.0,1,1.0,1,1.0,1,0.1290426454495052,83
3479,1,6614,2628,3986,0,0,0,1.0,1,1.0,1,1.0,1,0.12017627220569059,83
3480,0,6614,2628,3986,0,0,0,1.0,1,1.0,1,1.0,1,0.12017627220569059,83
3481,5,6619,2630,3989,0,0,0,1.0,1,1.0,1,1.0,1,0.10002353941211323,83
3482,8,6627,2632,3995,0,0,0,1.0,1,1.0,1,1.0,1,0.1344718620048774,83
3483,5,6632,2635,3997,0,0,0,1.0,1,1.0,1,1.0,1,0.12796164997416817,82
3484,1,6633,2636,3997,0,0,0,1.0,1,1.0,1,1.0,1,0.15104964042565425,82
3485,5,6638,2637,4001,0,0,0,1.0,1,1.0,1,1.0,1,0.13869685215197955,83
3486,0,6638,2637,4001,0,0,0,1.0,1,1.0,1,1.0,1,0.13869685215197955,83
3487,4,6642,2637,4005,0,0,0,1.0,1,1.0,1,1.0,1,0.12207398414530712,84
3488,0,6642,2637,4005,0,0,0,1.0,1,1.0,1,1.0,1,0.1305494726409306,84
3489,2,6644,2637,4007,0,0,0,1.0,1,1.0,1,1.0,1,0.11523908607950407,84
3490,0,6644,2637,4007,0,0,0,1.0,1,1.0,1,1.0,1,0.11523908607950407,84
3491,1,6645,2637,4008,0,0,0,1.0,1,1.0,1,1.0,1,0.10701090230523065,86
3492,1,6646,2638,4008,0,0,0,1.0,1,1.0,1,1.0,1,0.09999021243968265,86
3493,2,6648,2638,4010,0,0,0,1.0,1,1.0,1,1.0,1,0.08827218144776276,86
3494,0,6648,2638,4010,0,0,0,1.0,1,1.0,1,1.0,1,0.08827218144776276,86
3495,1,6649,2638,4011,0,0,0,1.0,1,1.0,1,1.0,1,0.07991788437291882,87
3496,1,6650,2638,4012,0,0,0,1.0,1,1.0,1,1.0,1,0.07522092629088252,88
3497,2,6652,2639,4013,0,0,0,1.0,1,1.0,1,1.0,1,0.0829202945741743,89
3498,2,6654,2639,4015,0,0,0,1.0,1,1.0,1,1.0,1,0.08522911171991833,89
3499,2,6656,2640,4016,0,0,0,1.0,1,1.0,1,1.0,1,0.08677267506264681,91
3500,0,6656,2640,4016,0,0,0,1.0,1,1.0,1,1.0,1,0.0945303059076308,90
3501,0,6656,2640,4016,0,0,0,1.0,1,1.0,1,1.0,1,0.0945303059076308,90
3502,0,6656,2640,4016,0,0,0,1.0,1,1.0,1,1.0,1,0.1016457209895954,91
3503,4,6660,2640,4020,0,0,0,1.0,1,1.0,1,1.0,1,0.07745997336918715,91
3504,2,6662,2642,4020,0,0,0,1.0,1,1.0,1,1.0,1,0.10482789870723333,89
3505,2,6664,2643,4021,0,0,0,1.0,1,1.0,1,1.0,1,0.1219088672712209,87
3506,3,6667,2644,4023,0,0,0,1.0,1,1.0,1,1.0,1,0.11996754423944664,87
3507,4,6671,2646,4025,0,0,0,1.0,1,1.0,1,1.0,1,0.08923246627493965,84
3508,3,6674,2649,4025,0,0,0,1.0,1,1.0,1,1.0,1,0.1361067591074829,83
3509,4,6678,2652,4026,0,0,0,1.0,1,1.0,1,1.0,1,0.13638920022072976,80
3510,2,6680,2652,4028,0,0,0,1.0,1,1.0,1,1.0,1,0.12204655425613245,78
3511,4,6684,2654,4030,0,0,0,1.0,1,1.0,1,1.0,1,0.12922438843411221,77
3512,1,6685,2654,4031,0,0,0,1.0,1,1.0,1,1.0,1,0.11552478878549542,74
3513,3,6688,2655,4033,0,0,0,1.0,1,1.0,1,1.0,1,0.1144824385028226,76
3514,3,6691,2655,4036,0,0,0,1.0,1,1.0,1,1.0,1,0.10489644853866745,76
3515,1,6692,2655,4037,0,0,0,1.0,1,1.0,1,1.0,1,0.09802519195454315,75
3516,1,6693,2656,4037,0,0,0,1.0,1,1.0,1,1.0,1,0.12863464528629917,73
3517,8,6701,2658,4043,0,0,0,1.0,1,1.0,1,1.0,1,0.1284496746054713,74
3518,1,6702,2658,4044,0,0,0,1.0,1,1.0,1,1.0,1,0.13970121766664295,74
3519,3,6705,2658,4047,0,0,0,1.0,1,1.0,1,1.0,1,0.1468730289185985,73
3520,3,6708,2658,4050,0,0,0,1.0,1,1.0,1,1.0,1,0.09293018324407237,74
3521,2,6710,2658,4052,0,0,0,1.0,1,1.0,1,1.0,1,0.09159560848885727,75
3522,0,6710,2658,4052,0,0,0,1.0,1,1.0,1,1.0,1,0.09159560848885727,75
3523,0,6710,2658,4052,0,0,0,1.0,1,1.0,1,1.0,1,0.09159560848885727,75
3524,0,6710,2658,4052,0,0,0,1.0,1,1.0,1,1.0,1,0.07828062791348754,75
3525,0,6710,2658,4052,0,0,0,1.0,1,1.0,1,1.0,1,0.08691692751096405,75
3526,0,6710,2658,4052,0,0,0,1.0,1,1.0,1,1.0,1,0.07943057750856818,76
3527,3,6713,2660,4053,0,0,0,1.0,1,1.0,1,1.0,1,0.13224501308508912,77
3528,4,6717,2661,4056,0,0,0,1.0,1,1.0,1,1.0,1,0.13252857981852326,77
3529,7,6724,2664,4060,0,0,0,1.0,1,1.0,1,1.0,1,0.1343647206609109,78
3530,3,6727,2664,4063,0,0,0,1.0,1,1.0,1,1.0,1,0.13014225517444425,78
3531,7,6734,2665,4069,0,0,0,1.0,1,1.0,1,1.0,1,0.14227224562592858,79
3532,3,6737,2666,4071,0,0,0,1.0,1,1.0,1,1.0,1,0.15115789484001413,79
3533,5,6742,2668,4074,0,0,0,1.0,1,1.0,1,1.0,1,0.15007024232869232,79
3534,6,6748,2670,4078,0,0,0,1.0,1,1.0,1,1.0,1,0.13004499797601757,80
3535,2,6750,2670,4080,0,0,0,1.0,1,1.0,1,1.0,1,0.121883912056284,81
3536,3,6753,2671,4082,0,0,0,1.0,1,1.0,1,1.0,1,0.11685820859873083,82
3537,0,6753,2671,4082,0,0,0,1.0,1,1.0,1,1.0,1,0.11685820859873083,82
3538,0,6753,2671,4082,0,0,0,1.0,1,1.0,1,1.0,1,0.12373590900689163,83
3539,0,6753,2671,4082,0,0,0,1.0,1,1.0,1,1.0,1,0.12373590900689163,83
3540,1,6754,2672,4082,0,0,0,1.0,1,1.0,1,1.0,1,0.12202248722263784,85
3541,3,6757,2673,4084,0,0,0,1.0,1,1.0,1,1.0,1,0.12018700261919926,85
3542,3,6760,2673,4087,0,0,0,1.0,1,1.0,1,1.0,1,0.10574859001698794,88
3543,2,6762,2674,4088,0,0,0,1.0,1,1.0,1,1.0,1,0.08854622850317631,87
3544,1,6763,2674,4089,0,0,0,1.0,1,1.0,1,1.0,1,0.08189384006786937,87
3545,0,6763,2674,4089,0,0,0,1.0,1,1.0,1,1.0,1,0.07828169960894843,85
3546,0,6763,2674,4089,0,0,0,1.0,1,1.0,1,1.0,1,0.08206498138006002,83
3547,3,6766,2674,4092,0,0,0,1.0,1,1.0,1,1.0,1,0.07229325644416058,82
3548,1,6767,2675,4092,0,0,0,1.0,1,1.0,1,1.0,1,0.07755338620421963,82
3549,1,6768,2675,4093,0,0,0,1.0,1,1.0,1,1.0,1,0.06530256260455111,81
3550,1,6769,2676,4093,0,0,0,1.0,1,1.0,1,1.0,1,0.08228583812005497,79
3551,2,6771,2677,4094,0,0,0,1.0,1,1.0,1,1.0,1,0.07714035263180916,80
3552,2,6773,2678,4095,0,0,0,1.0,1,1.0,1,1.0,1,0.08368497180380313,78
3553,5,6778,2678,4100,0,0,0,1.0,1,1.0,1,1.0,1,0.05052858130150783,79
3554,0,6778,2678,4100,0,0,0,1.0,1,1.0,1,1.0,1,0.07150726136793031,77
3555,1,6779,2679,4100,0,0,0,1.0,1,1.0,1,1.0,1,0.07837686024716617,77
3556,0,6779,2679,4100,0,0,0,1.0,1,1.0,1,1.0,1,0.08882824540373425,76
3557,2,6781,2679,4102,0,0,0,1.0,1,1.0,1,1.0,1,0.0715449346818617,76
3558,1,6782,2680,4102,0,0,0,1.0,1,1.0,1,1.0,1,0.10100506857786773,76
3559,2,6784,2680,4104,0,0,0,1.0,1,1.0,1,1.0,1,0.08642556046367642,76
3560,5,6789,2681,4108,0,0,0,1.0,1,1.0,1,1.0,1,0.09479474015970281,78
3561,3,6792,2682,4110,0,0,0,1.0,1,1.0,1,1.0,1,0.07776959397748957,79
3562,3,6795,2683,4112,0,0,0,1.0,1,1.0,1,1.0,1,0.09595466541516406,79
3563,2,6797,2684,4113,0,0,0,1.0,1,1.0,1,1.0,1,0.06372589138018499,79
3564,1,6798,2685,4113,0,0,0,1.0,1,1.0,1,1.0,1,0.08088904658441362,80
3565,3,6801,2686,4115,0,0,0,1.0,1,1.0,1,1.0,1,0.1054563002226333,83
3566,6,6807,2688,4119,0,0,0,1.0,1,1.0,1,1.0,1,0.11889368698032181,84
3567,5,6812,2688,4124,0,0,0,1.0,1,1.0,1,1.0,1,0.08054223702668445,84
3568,3,6815,2690,4125,0,0,0,1.0,1,1.0,1,1.0,1,0.07840150798208363,84
3569,2,6817,2691,4126,0,0,0,1.0,1,1.0,1,1.0,1,0.08344684333042411,84
3570,6,6823,2693,4130,0,0,0,1.0,1,1.0,1,1.0,1,0.08257790351748481,87
3571,5,6828,2695,4133,0,0,0,1.0,1,1.0,1,1.0,1,0.10906284438637025,86
3572,5,6833,2697,4136,0,0,0,1.0,1,1.0,1,1.0,1,0.12305862478239386,87
3573,4,6837,2699,4138,0,0,0,1.0,1,1.0,1,1.0,1,0.13350115727786266,87
3574,1,6838,2700,4138,0,0,0,1.0,1,1.0,1,1.0,1,0.13914079240000762,88
3575,3,6841,2700,4141,0,0,0,1.0,1,1.0,1,1.0,1,0.12755162167232634,88
3576,1,6842,2701,4141,0,0,0,1.0,1,1.0,1,1.0,1,0.12191397267015025,90
3577,2,6844,2701,4143,0,0,0,1.0,1,1.0,1,1.0,1,0.10436933721373672,90
3578,2,6846,2701,4145,0,0,0,1.0,1,1.0,1,1.0,1,0.11049448657807978,91
3579,4,6850,2701,4149,0,0,0,1.0,1,1.0,1,1.0,1,0.09615778509965539,91
3580,1,6851,2701,4150,0,0,0,1.0,1,1.0,1,1.0,1,0.107809702295473,91
3581,4,6855,2701,4154,0,0,0,1.0,1,1.0,1,1.0,1,0.09990030702894093,91
3582,1,6856,2701,4155,0,0,0,1.0,1,1.0,1,1.0,1,0.10309261638957895,92
3583,1,6857,2701,4156,0,0,0,1.0,1,1.0,1,1.0,1,0.09143199012432544,88
3584,2,6859,2702,4157,0,0,0,1.0,1,1.0,1,1.0,1,0.0856855289709264,87
3585,2,6861,2702,4159,0,0,0,1.0,1,1.0,1,1.0,1,0.09275659650317808,84
3586,2,6863,2703,4160,0,0,0,1.0,1,1.0,1,1.0,1,0.08841841248139708,83
3587,6,6869,2704,4165,0,0,0,1.0,1,1.0,1,1.0,1,0.06198476760319741,82
3588,3,6872,2706,4166,0,0,0,1.0,1,1.0,1,1.0,1,0.09806636610275456,81
3589,6,6878,2708,4170,0,0,0,1.0,1,1.0,1,1.0,1,0.0885492338458663,80
3590,3,6881,2708,4173,0,0,0,1.0,1,1.0,1,1.0,1,0.09800145526827936,78
3591,2,6883,2708,4175,0,0,0,1.0,1,1.0,1,1.0,1,0.08311832762426685,77
3592,2,6885,2709,4176,0,0,0,1.0,1,1.0,1,1.0,1,0.08692555458973471,75
3593,3,6888,2709,4179,0,0,0,1.0,1,1.0,1,1.0,1,0.08440618389369864,76
3594,1,6889,2710,4179,0,0,0,1.0,1,1.0,1,1.0,1,0.09056321214414445,74
3595,2,6891,2712,4179,0,0,0,1.0,1,1.0,1,1.0,1,0.1010083453840526,74
3596,2,6893,2713,4180,0,0,0,1.0,1,1.0,1,1.0,1,0.10146313601207532,73
3597,4,6897,2716,4181,0,0,0,1.0,1,1.0,1,1.0,1,0.10002175404707278,73
3598,1,6898,2717,4181,0,0,0,1.0,1,1.0,1,1.0,1,0.10733748334849554,73
3599,1,6899,2717,4182,0,0,0,1.0,1,1.0,1,1.0,1,0.09858696200247094,73
3600,1,6900,2717,4183,0,0,0,1.0,1,1.0,1,1.0,1,0.0976577994616073,74
3601,8,6908,2720,4188,0,0,0,1.0,1,1.0,1,1.0,1,0.09738243525004112,75
3602,0,6908,2720,4188,0,0,0,1.0,1,1.0,1,1.0,1,0.08814125877886705,76
3603,6,6914,2722,4192,0,0,0,1.0,1,1.0,1,1.0,1,0.10449956096313784,77
3604,6,6920,2725,4195,0,0,0,1.0,1,1.0,1,1.0,1,0.1519613964238688,78
3605,9,6929,2727,4202,0,0,0,1.0,1,1.0,1,1.0,1,0.11213536604699932,77
3606,2,6931,2727,4204,0,0,0,1.0,1,1.0,1,1.0,1,0.08338314675236867,79
3607,2,6933,2727,4206,0,0,0,1.0,1,1.0,1,1.0,1,0.06494503839220887,79
3608,0,6933,2727,4206,0,0,0,1.0,1,1.0,1,1.0,1,0.06494503839220887,79
3609,0,6933,2727,4206,0,0,0,1.0,1,1.0,1,1.0,1,0.06494503839220887,79
3610,2,6935,2729,4206,0,0,0,1.0,1,1.0,1,1.0,1,0.08659554563574612,80
3611,2,6937,2730,4207,0,0,0,1.0,1,1.0,1,1.0,1,0.0763909967000795,80
3612,4,6941,2731,4210,0,0,0,1.0,1,1.0,1,1.0,1,0.08368318831335651,79
3613,4,6945,2732,4213,0,0,0,1.0,1,1.0,1,1.0,1,0.08887417772723613,79
3614,2,6947,2734,4213,0,0,0,1.0,1,1.0,1,1.0,1,0.09699579537467501,78
3615,6,6953,2734,4219,0,0,0,1.0,1,1.0,1,1.0,1,0.04871023454298207,79
3616,1,6954,2735,4219,0,0,0,1.0,1,1.0,1,1.0,1,0.061670772522910956,79
3617,4,6958,2737,4221,0,0,0,1.0,1,1.0,1,1.0,1,0.042678541069969274,80
3618,1,6959,2737,4222,0,0,0,1.0,1,1.0,1,1.0,1,0.06666301932022185,82
3619,0,6959,2737,4222,0,0,0,1.0,1,1.0,1,1.0,1,0.08749924582918145,82
3620,2,6961,2739,4222,0,0,0,1.0,1,1.0,1,1.0,1,0.11010418769969421,81
3621,4,6965,2739,4226,0,0,0,1.0,1,1.0,1,1.0,1,0.10764926834799166,83
3622,4,6969,2740,4229,0,0,0,1.0,1,1.0,1,1.0,1,0.1003815211992249,81
3623,4,6973,2742,4231,0,0,0,1.0,1,1.0,1,1.0,1,0.10211183274543026,81
3624,1,6974,2743,4231,0,0,0,1.0,1,1.0,1,1.0,1,0.12180914143390911,79
3625,6,6980,2745,4235,0,0,0,1.0,1,1.0,1,1.0,1,0.10219627186531349,80
3626,2,6982,2745,4237,0,0,0,1.0,1,1.0,1,1.0,1,0.08411995317168254,78
3627,5,6987,2746,4241,0,0,0,1.0,1,1.0,1,1.0,1,0.07837113366152722,78
3628,1,6988,2746,4242,0,0,0,1.0,1,1.0,1,1.0,1,0.08883596313134584,77
3629,3,6991,2746,4245,0,0,0,1.0,1,1.0,1,1.0,1,0.07469206791803662,76
3630,0,6991,2746,4245,0,0,0,1.0,1,1.0,1,1.0,1,0.08112336957058144,77
3631,4,6995,2749,4246,0,0,0,1.0,1,1.0,1,1.0,1,0.08798479171028557,75
3632,1,6996,2750,4246,0,0,0,1.0,1,1.0,1,1.0,1,0.11792754807581189,74
3633,7,7003,2752,4251,0,0,0,1.0,1,1.0,1,1.0,1,0.10322909717502085,75
3634,0,7003,2752,4251,0,0,0,1.0,1,1.0,1,1.0,1,0.10450990633041876,74
3635,4,7007,2753,4254,0,0,0,1.0,1,1.0,1,1.0,1,0.08746233051681726,74
3636,1,7008,2754,4254,0,0,0,1.0,1,1.0,1,1.0,1,0.0998800516525606,74
3637,2,7010,2754,4256,0,0,0,1.0,1,1.0,1,1.0,1,0.1082488801457617,74
3638,1,7011,2754,4257,0,0,0,1.0,1,1.0,1,1.0,1,0.10949003804057529,75
3639,5,7016,2757,4259,0,0,0,1.0,1,1.0,1,1.0,1,0.09398053910408105,76
3640,1,7017,2757,4260,0,0,0,1.0,1,1.0,1,1.0,1,0.0843391173880651,76
3641,3,7020,2759,4261,0,0,0,1.0,1,1.0,1,1.0,1,0.11774810842581747,75
3642,3,7023,2761,4262,0,0,0,1.0,1,1.0,1,1.0,1,0.1190424176682933,75
3643,3,7026,2761,4265,0,0,0,1.0,1,1.0,1,1.0,1,0.10451314288703425,74
3644,1,7027,2761,4266,0,0,0,1.0,1,1.0,1,1.0,1,0.10162297782483388,74
3645,2,7029,2761,4268,0,0,0,1.0,1,1.0,1,1.0,1,0.07534916920876412,74
3646,1,7030,2761,4269,0,0,0,1.0,1,1.0,1,1.0,1,0.06962355430512851,75
3647,0,7030,2761,4269,0,0,0,1.0,1,1.0,1,1.0,1,0.07382302214445956,77
3648,0,7030,2761,4269,0,0,0,1.0,1,1.0,1,1.0,1,0.09453705406334718,78
3649,2,7032,2761,4271,0,0,0,1.0,1,1.0,1,1.0,1,0.09787410825845508,80
3650,3,7035,2762,4273,0,0,0,1.0,1,1.0,1,1.0,1,0.10028402585875787,81
3651,2,7037,2762,4275,0,0,0,1.0,1,1.0,1,1.0,1,0.0894712397594247,81
3652,3,7040,2763,4277,0,0,0,1.0,1,1.0,1,1.0,1,0.10678910961651206,83
3653,3,7043,2763,4280,0,0,0,1.0,1,1.0,1,1.0,1,0.08431150746021474,83
3654,0,7043,2763,4280,0,0,0,1.0,1,1.0,1,1.0,1,0.08431150746021474,83
3655,1,7044,2763,4281,0,0,0,1.0,1,1.0,1,1.0,1,0.07527973638167212,84
3656,0,7044,2763,4281,0,0,0,1.0,1,1.0,1,1.0,1,0.08261132298505106,85
3657,1,7045,2763,4282,0,0,0,1.0,1,1.0,1,1.0,1,0.07230616501078611,86
3658,2,7047,2765,4282,0,0,0,1.0,1,1.0,1,1.0,1,0.11779591270245945,87
3659,3,7050,2765,4285,0,0,0,1.0,1,1.0,1,1.0,1,0.08353159099781197,87
3660,0,7050,2765,4285,0,0,0,1.0,1,1.0,1,1.0,1,0.08981229207236663,86
3661,4,7054,2767,4287,0,0,0,1.0,1,1.0,1,1.0,1,0.11578775936736584,86
3662,1,7055,2768,4287,0,0,0,1.0,1,1.0,1,1.0,1,0.13530691703809278,83
3663,11,7066,2773,4293,0,0,0,1.0,1,1.0,1,1.0,1,0.14989757500861023,85
3664,3,7069,2774,4295,0,0,0,1.0,1,1.0,1,1.0,1,0.12162076906041903,82
3665,5,7074,2774,4300,0,0,0,1.0,1,1.0,1,1.0,1,0.08890001175349523,81
3666,2,7076,2775,4301,0,0,0,1.0,1,1.0,1,1.0,1,0.10523831958869324,79
3667,3,7079,2775,4304,0,0,0,1.0,1,1.0,1,1.0,1,0.08911483575924586,79
3668,0,7079,2775,4304,0,0,0,1.0,1,1.0,1,1.0,1,0.08441863452984173,77
3669,1,7080,2775,4305,0,0,0,1.0,1,1.0,1,1.0,1,0.08548302324356624,75
3670,2,7082,2777,4305,0,0,0,1.0,1,1.0,1,1.0,1,0.10345538085110749,76
3671,1,7083,2777,4306,0,0,0,1.0,1,1.0,1,1.0,1,0.0753288896922885,74
3672,1,7084,2778,4306,0,0,0,1.0,1,1.0,1,1.0,1,0.06541040831180783,75
3673,1,7085,2779,4306,0,0,0,1.0,1,1.0,1,1.0,1,0.07766653456858648,75
3674,3,7088,2781,4307,0,0,0,1.0,1,1.0,1,1.0,1,0.08356291913065139,75
3675,1,7089,2781,4308,0,0,0,1.0,1,1.0,1,1.0,1,0.07041365954206538,75
3676,1,7090,2782,4308,0,0,0,1.0,1,1.0,1,1.0,1,0.08888435931088805,75
3677,1,7091,2782,4309,0,0,0,1.0,1,1.0,1,1.0,1,0.08630249084120976,75
3678,1,7092,2783,4309,0,0,0,1.0,1,1.0,1,1.0,1,0.12870143064555115,77
3679,3,7095,2784,4311,0,0,0,1.0,1,1.0,1,1.0,1,0.14014079591934972,78
3680,1,7096,2784,4312,0,0,0,1.0,1,1.0,1,1.0,1,0.1343272744100329,80
3681,1,7097,2784,4313,0,0,0,1.0,1,1.0,1,1.0,1,0.1319782199609664,81
3682,0,7097,2784,4313,0,0,0,1.0,1,1.0,1,1.0,1,0.1319782199609664,81
3683,1,7098,2785,4313,0,0,0,1.0,1,1.0,1,1.0,1,0.14783516899396237,81
3684,0,7098,2785,4313,0,0,0,1.0,1,1.0,1,1.0,1,0.14783516899396237,81
3685,0,7098,2785,4313,0,0,0,1.0,1,1.0,1,1.0,1,0.14783516899396237,81
3686,0,7098,2785,4313,0,0,0,1.0,1,1.0,1,1.0,1,0.14783516899396237,81
3687,1,7099,2785,4314,0,0,0,1.0,1,1.0,1,1.0,1,0.1335221059148148,82
3688,4,7103,2785,4318,0,0,0,1.0,1,1.0,1,1.0,1,0.12505336524170407,84
3689,0,7103,2785,4318,0,0,0,1.0,1,1.0,1,1.0,1,0.12505336524170407,84
3690,2,7105,2787,4318,0,0,0,1.0,1,1.0,1,1.0,1,0.1489067207183377,85
3691,3,7108,2787,4321,0,0,0,1.0,1,1.0,1,1.0,1,0.12975145577193817,86
3692,0,7108,2787,4321,0,0,0,1.0,1,1.0,1,1.0,1,0.12494382241625555,86
3693,1,7109,2787,4322,0,0,0,1.0,1,1.0,1,1.0,1,0.1214452152786965,86
3694,0,7109,2787,4322,0,0,0,1.0,1,1.0,1,1.0,1,0.1214452152786965,86
3695,1,7110,2788,4322,0,0,0,1.0,1,1.0,1,1.0,1,0.1452522174344354,86
3696,1,7111,2788,4323,0,0,0,1.0,1,1.0,1,1.0,1,0.12087216828764309,87
3697,0,7111,2788,4323,0,0,0,1.0,1,1.0,1,1.0,1,0.11852423089463872,85
3698,0,7111,2788,4323,0,0,0,1.0,1,1.0,1,1.0,1,0.11740980392406326,85
3699,3,7114,2789,4325,0,0,0,1.0,1,1.0,1,1.0,1,0.10155287391743277,85
3700,6,7120,2793,4327,0,0,0,1.0,1,1.0,1,1.0,1,0.11683587345301125,84
3701,2,7122,2794,4328,0,0,0,1.0,1,1.0,1,1.0,1,0.14195230460434247,85
3702,5,7127,2796,4331,0,0,0,1.0,1,1.0,1,1.0,1,0.15881991975809337,85
3703,1,7128,2796,4332,0,0,0,1.0,1,1.0,1,1.0,1,0.14377263070212984,85
3704,2,7130,2796,4334,0,0,0,1.0,1,1.0,1,1.0,1,0.1351708734684583,85
3705,1,7131,2796,4335,0,0,0,1.0,1,1.0,1,1.0,1,0.12284629826005346,86
3706,1,7132,2797,4335,0,0,0,1.0,1,1.0,1,1.0,1,0.12748900757432347,86
3707,5,7137,2800,4337,0,0,0,1.0,1,1.0,1,1.0,1,0.14342243856000797,85
3708,1,7138,2800,4338,0,0,0,1.0,1,1.0,1,1.0,1,0.12711233046580317,84
3709,0,7138,2800,4338,0,0,0,1.0,1,1.0,1,1.0,1,0.13127692918046246,85
3710,0,7138,2800,4338,0,0,0,1.0,1,1.0,1,1.0,1,0.1278015874038363,84
3711,1,7139,2800,4339,0,0,0,1.0,1,1.0,1,1.0,1,0.12587087771098335,85
3712,3,7142,2800,4342,0,0,0,1.0,1,1.0,1,1.0,1,0.1036665126096939,85
3713,1,7143,2800,4343,0,0,0,1.0,1,1.0,1,1.0,1,0.1011176248570549,85
3714,2,7145,2801,4344,0,0,0,1.0,1,1.0,1,1.0,1,0.11726787710644136,85
3715,2,7147,2802,4345,0,0,0,1.0,1,1.0,1,1.0,1,0.11328745852821427,85
3716,2,7149,2803,4346,0,0,0,1.0,1,1.0,1,1.0,1,0.11593765057137288,84
3717,2,7151,2803,4348,0,0,0,1.0,1,1.0,1,1.0,1,0.11245419145383972,86
3718,0,7151,2803,4348,0,0,0,1.0,1,1.0,1,1.0,1,0.12593620381199963,85
3719,3,7154,2805,4349,0,0,0,1.0,1,1.0,1,1.0,1,0.12340371187059082,84
3720,4,7158,2805,4353,0,0,0,1.0,1,1.0,1,1.0,1,0.129917317061558,84
3721,6,7164,2808,4356,0,0,0,1.0,1,1.0,1,1.0,1,0.13507104539565407,85
3722,2,7166,2809,4357,0,0,0,1.0,1,1.0,1,1.0,1,0.13256979296855176,85
3723,4,7170,2810,4360,0,0,0,1.0,1,1.0,1,1.0,1,0.1331895881230433,85
3724,1,7171,2810,4361,0,0,0,1.0,1,1.0,1,1.0,1,0.12186128079514846,86
3725,1,7172,2811,4361,0,0,0,1.0,1,1.0,1,1.0,1,0.12728838867949147,86
3726,1,7173,2811,4362,0,0,0,1.0,1,1.0,1,1.0,1,0.11863430012870212,86
3727,2,7175,2811,4364,0,0,0,1.0,1,1.0,1,1.0,1,0.10652967324239805,86
3728,2,7177,2813,4364,0,0,0,1.0,1,1.0,1,1.0,1,0.12771721285064247,86
3729,0,7177,2813,4364,0,0,0,1.0,1,1.0,1,1.0,1,0.12771721285064247,86
3730,0,7177,2813,4364,0,0,0,1.0,1,1.0,1,1.0,1,0.1370073812997032,85
3731,1,7178,2813,4365,0,0,0,1.0,1,1.0,1,1.0,1,0.13112896809695113,86
3732,0,7178,2813,4365,0,0,0,1.0,1,1.0,1,1.0,1,0.1271465188955022,87
3733,1,7179,2814,4365,0,0,0,1.0,1,1.0,1,1.0,1,0.1493890448291463,87
3734,1,7180,2814,4366,0,0,0,1.0,1,1.0,1,1.0,1,0.14594693294080732,87
3735,6,7186,2816,4370,0,0,0,1.0,1,1.0,1,1.0,1,0.1582788090670925,86
3736,2,7188,2817,4371,0,0,0,1.0,1,1.0,1,1.0,1,0.14944308421015962,87
3737,2,7190,2817,4373,0,0,0,1.0,1,1.0,1,1.0,1,0.12531370355881594,87
3738,1,7191,2817,4374,0,0,0,1.0,1,1.0,1,1.0,1,0.13185878092180356,87
3739,3,7194,2817,4377,0,0,0,1.0,1,1.0,1,1.0,1,0.11515354081509639,88
3740,6,7200,2821,4379,0,0,0,1.0,1,1.0,1,1.0,1,0.16384368731771742,87
3741,7,7207,2821,4386,0,0,0,1.0,1,1.0,1,1.0,1,0.128928064566816,87
3742,3,7210,2822,4388,0,0,0,1.0,1,1.0,1,1.0,1,0.11858522406019492,86
3743,3,7213,2823,4390,0,0,0,1.0,1,1.0,1,1.0,1,0.1098134095451758,84
3744,1,7214,2823,4391,0,0,0,1.0,1,1.0,1,1.0,1,0.11718458761293919,83
3745,2,7216,2823,4393,0,0,0,1.0,1,1.0,1,1.0,1,0.09502952452114174,83
3746,2,7218,2824,4394,0,0,0,1.0,1,1.0,1,1.0,1,0.11321294635472802,83
3747,2,7220,2825,4395,0,0,0,1.0,1,1.0,1,1.0,1,0.11626784568931624,81
3748,0,7220,2825,4395,0,0,0,1.0,1,1.0,1,1.0,1,0.11758130488231283,81
3749,1,7221,2825,4396,0,0,0,1.0,1,1.0,1,1.0,1,0.11305890369087097,80
3750,0,7221,2825,4396,0,0,0,1.0,1,1.0,1,1.0,1,0.11611078174037066,79
3751,7,7228,2828,4400,0,0,0,1.0,1,1.0,1,1.0,1,0.139155743638254,80
3752,4,7232,2829,4403,0,0,0,1.0,1,1.0,1,1.0,1,0.14685992103248763,80
3753,5,7237,2831,4406,0,0,0,1.0,1,1.0,1,1.0,1,0.15710157847389403,81
3754,2,7239,2832,4407,0,0,0,1.0,1,1.0,1,1.0,1,0.17808186281888747,81
3755,7,7246,2833,4413,0,0,0,1.0,1,1.0,1,1.0,1,0.17071646348286265,80
3756,0,7246,2833,4413,0,0,0,1.0,1,1.0,1,1.0,1,0.18015336588145126,79
3757,2,7248,2833,4415,0,0,0,1.0,1,1.0,1,1.0,1,0.1749005047092866,80
3758,0,7248,2833,4415,0,0,0,1.0,1,1.0,1,1.0,1,0.1806228895084845,79
3759,2,7250,2834,4416,0,0,0,1.0,1,1.0,1,1.0,1,0.17534256480585445,79
3760,0,7250,2834,4416,0,0,0,1.0,1,1.0,1,1.0,1,0.17534256480585445,79
3761,0,7250,2834,4416,0,0,0,1.0,1,1.0,1,1.0,1,0.19098157997417067,78
3762,1,7251,2834,4417,0,0,0,1.0,1,1.0,1,1.0,1,0.18637658618331962,80
3763,0,7251,2834,4417,0,0,0,1.0,1,1.0,1,1.0,1,0.18637658618331962,80
3764,4,7255,2836,4419,0,0,0,1.0,1,1.0,1,1.0,1,0.21234199124786496,80
3765,6,7261,2836,4425,0,0,0,1.0,1,1.0,1,1.0,1,0.17988299393429683,81
3766,4,7265,2837,4428,0,0,0,1.0,1,1.0,1,1.0,1,0.17690583951020414,83
3767,2,7267,2837,4430,0,0,0,1.0,1,1.0,1,1.0,1,0.16846225148296137,83
3768,3,7270,2837,4433,0,0,0,1.0,1,1.0,1,1.0,1,0.153433212024757,84
3769,1,7271,2837,4434,0,0,0,1.0,1,1.0,1,1.0,1,0.13218775461512827,86
3770,1,7272,2837,4435,0,0,0,1.0,1,1.0,1,1.0,1,0.1273520591533065,87
3771,2,7274,2837,4437,0,0,0,1.0,1,1.0,1,1.0,1,0.11530840280847371,87
3772,1,7275,2838,4437,0,0,0,1.0,1,1.0,1,1.0,1,0.14416600140316024,88
3773,3,7278,2838,4440,0,0,0,1.0,1,1.0,1,1.0,1,0.12603175115615387,85
3774,2,7280,2838,4442,0,0,0,1.0,1,1.0,1,1.0,1,0.12055504323366713,85
3775,4,7284,2840,4444,0,0,0,1.0,1,1.0,1,1.0,1,0.12724921445302984,83
3776,2,7286,2841,4445,0,0,0,1.0,1,1.0,1,1.0,1,0.13594269716055385,82
3777,1,7287,2841,4446,0,0,0,1.0,1,1.0,1,1.0,1,0.1269466355633433,81
3778,0,7287,2841,4446,0,0,0,1.0,1,1.0,1,1.0,1,0.13480945221615528,81
3779,2,7289,2843,4446,0,0,0,1.0,1,1.0,1,1.0,1,0.1651245421431837,80
3780,0,7289,2843,4446,0,0,0,1.0,1,1.0,1,1.0,1,0.1651245421431837,80
3781,2,7291,2843,4448,0,0,0,1.0,1,1.0,1,1.0,1,0.14983698104646367,80
3782,2,7293,2844,4449,0,0,0,1.0,1,1.0,1,1.0,1,0.15708093464805933,80
3783,2,7295,2845,4450,0,0,0,1.0,1,1.0,1,1.0,1,0.14796160012161488,80
3784,0,7295,2845,4450,0,0,0,1.0,1,1.0,1,1.0,1,0.15108553225970342,79
3785,3,7298,2845,4453,0,0,0,1.0,1,1.0,1,1.0,1,0.14826935640146538,77
3786,0,7298,2845,4453,0,0,0,1.0,1,1.0,1,1.0,1,0.14259590593763055,78
3787,1,7299,2846,4453,0,0,0,1.0,1,1.0,1,1.0,1,0.16318372860787378,77
3788,2,7301,2846,4455,0,0,0,1.0,1,1.0,1,1.0,1,0.1616446247624053,78
3789,8,7309,2849,4460,0,0,0,1.0,1,1.0,1,1.0,1,0.14670127026378474,77
3790,1,7310,2850,4460,0,0,0,1.0,1,1.0,1,1.0,1,0.16400621244232758,77
3791,3,7313,2851,4462,0,0,0,1.0,1,1.0,1,1.0,1,0.16673110676196612,77
3792,0,7313,2851,4462,0,0,0,1.0,1,1.0,1,1.0,1,0.155244449060943,78
3793,1,7314,2851,4463,0,0,0,1.0,1,1.0,1,1.0,1,0.1458205406990899,80
3794,7,7321,2851,4470,0,0,0,1.0,1,1.0,1,1.0,1,0.1022391785123393,82
3795,2,7323,2852,4471,0,0,0,1.0,1,1.0,1,1.0,1,0.09652721117499678,83
3796,1,7324,2853,4471,0,0,0,1.0,1,1.0,1,1.0,1,0.09019384099787864,83
3797,1,7325,2853,4472,0,0,0,1.0,1,1.0,1,1.0,1,0.09172919103702867,82
3798,0,7325,2853,4472,0,0,0,1.0,1,1.0,1,1.0,1,0.09732791805395542,82
3799,1,7326,2853,4473,0,0,0,1.0,1,1.0,1,1.0,1,0.09966259848003195,83
3800,3,7329,2854,4475,0,0,0,1.0,1,1.0,1,1.0,1,0.10517154566982591,83
3801,3,7332,2855,4477,0,0,0,1.0,1,1.0,1,1.0,1,0.0996704184125615,83
3802,0,7332,2855,4477,0,0,0,1.0,1,1.0,1,1.0,1,0.11495039807509937,82
3803,1,7333,2855,4478,0,0,0,1.0,1,1.0,1,1.0,1,0.11458196376995443,84
3804,1,7334,2855,4479,0,0,0,1.0,1,1.0,1,1.0,1,0.10207225322909831,84
3805,2,7336,2856,4480,0,0,0,1.0,1,1.0,1,1.0,1,0.12808777668428573,86
3806,0,7336,2856,4480,0,0,0,1.0,1,1.0,1,1.0,1,0.12808777668428573,86
3807,2,7338,2857,4481,0,0,0,1.0,1,1.0,1,1.0,1,0.13981049707440585,86
3808,1,7339,2857,4482,0,0,0,1.0,1,1.0,1,1.0,1,0.13492812886976016,85
3809,4,7343,2858,4485,0,0,0,1.0,1,1.0,1,1.0,1,0.13132303631221426,85
3810,1,7344,2859,4485,0,0,0,1.0,1,1.0,1,1.0,1,0.13804176167954033,85
3811,2,7346,2860,4486,0,0,0,1.0,1,1.0,1,1.0,1,0.1200698038035964,84
3812,0,7346,2860,4486,0,0,0,1.0,1,1.0,1,1.0,1,0.12034834737241329,83
3813,2,7348,2860,4488,0,0,0,1.0,1,1.0,1,1.0,1,0.10878313017568653,82
3814,1,7349,2861,4488,0,0,0,1.0,1,1.0,1,1.0,1,0.10823003671593735,81
3815,1,7350,2861,4489,0,0,0,1.0,1,1.0,1,1.0,1,0.09645825440748002,82
3816,2,7352,2861,4491,0,0,0,1.0,1,1.0,1,1.0,1,0.07768163451598528,81
3817,1,7353,2861,4492,0,0,0,1.0,1,1.0,1,1.0,1,0.07451553209486023,81
3818,2,7355,2863,4492,0,0,0,1.0,1,1.0,1,1.0,1,0.10502653189783821,81
3819,2,7357,2865,4492,0,0,0,1.0,1,1.0,1,1.0,1,0.14485700913360314,82
3820,4,7361,2865,4496,0,0,0,1.0,1,1.0,1,1.0,1,0.14095138497571472,84
3821,3,7364,2866,4498,0,0,0,1.0,1,1.0,1,1.0,1,0.15696316704622368,84
3822,2,7366,2866,4500,0,0,0,1.0,1,1.0,1,1.0,1,0.1279371942363763,82
3823,1,7367,2867,4500,0,0,0,1.0,1,1.0,1,1.0,1,0.12121030842956411,81
3824,0,7367,2867,4500,0,0,0,1.0,1,1.0,1,1.0,1,0.1405050668983674,78
3825,4,7371,2867,4504,0,0,0,1.0,1,1.0,1,1.0,1,0.13587154040748112,76
3826,0,7371,2867,4504,0,0,0,1.0,1,1.0,1,1.0,1,0.15166844978962724,76
3827,3,7374,2868,4506,0,0,0,1.0,1,1.0,1,1.0,1,0.16060666746162092,75
3828,3,7377,2869,4508,0,0,0,1.0,1,1.0,1,1.0,1,0.16275664881309929,74
3829,5,7382,2870,4512,0,0,0,1.0,1,1.0,1,1.0,1,0.1537616224014793,74
3830,1,7383,2870,4513,0,0,0,1.0,1,1.0,1,1.0,1,0.13592981557711847,74
3831,5,7388,2872,4516,0,0,0,1.0,1,1.0,1,1.0,1,0.15129489033875324,74
3832,4,7392,2873,4519,0,0,0,1.0,1,1.0,1,1.0,1,0.14846698005337622,73
3833,3,7395,2875,4520,0,0,0,1.0,1,1.0,1,1.0,1,0.1424061099562535,73
3834,2,7397,2875,4522,0,0,0,1.0,1,1.0,1,1.0,1,0.14866038851512295,74
3835,3,7400,2876,4524,0,0,0,1.0,1,1.0,1,1.0,1,0.1525427078596792,75
3836,3,7403,2877,4526,0,0,0,1.0,1,1.0,1,1.0,1,0.15295369091118716,75
3837,8,7411,2878,4533,0,0,0,1.0,1,1.0,1,1.0,1,0.1370954802549854,78
3838,2,7413,2878,4535,0,0,0,1.0,1,1.0,1,1.0,1,0.1305069729668295,78
3839,4,7417,2878,4539,0,0,0,1.0,1,1.0,1,1.0,1,0.09890167047599611,79
3840,4,7421,2879,4542,0,0,0,1.0,1,1.0,1,1.0,1,0.11216855382148695,82
3841,1,7422,2879,4543,0,0,0,1.0,1,1.0,1,1.0,1,0.10359225837904538,82
3842,0,7422,2879,4543,0,0,0,1.0,1,1.0,1,1.0,1,0.10201516939433272,82
3843,1,7423,2879,4544,0,0,0,1.0,1,1.0,1,1.0,1,0.09724316751041606,82
3844,0,7423,2879,4544,0,0,0,1.0,1,1.0,1,1.0,1,0.09853945051083154,83
3845,5,7428,2879,4549,0,0,0,1.0,1,1.0,1,1.0,1,0.08123424481295596,84
3846,2,7430,2879,4551,0,0,0,1.0,1,1.0,1,1.0,1,0.06754934593170009,85
3847,0,7430,2879,4551,0,0,0,1.0,1,1.0,1,1.0,1,0.07824900277193794,84
3848,1,7431,2880,4551,0,0,0,1.0,1,1.0,1,1.0,1,0.09425939430964383,84
3849,1,7432,2880,4552,0,0,0,1.0,1,1.0,1,1.0,1,0.07923920040312506,83
3850,1,7433,2880,4553,0,0,0,1.0,1,1.0,1,1.0,1,0.09583593129687669,80
3851,3,7436,2880,4556,0,0,0,1.0,1,1.0,1,1.0,1,0.07111334985924919,80
3852,1,7437,2881,4556,0,0,0,1.0,1,1.0,1,1.0,1,0.09962758243275677,79
3853,3,7440,2882,4558,0,0,0,1.0,1,1.0,1,1.0,1,0.10429222373853911,79
3854,1,7441,2883,4558,0,0,0,1.0,1,1.0,1,1.0,1,0.12666473752189686,78
3855,1,7442,2884,4558,0,0,0,1.0,1,1.0,1,1.0,1,0.14449603267970182,78
3856,1,7443,2884,4559,0,0,0,1.0,1,1.0,1,1.0,1,0.1471924387374087,80
3857,5,7448,2884,4564,0,0,0,1.0,1,1.0,1,1.0,1,0.090876279604489,81
3858,2,7450,2886,4564,0,0,0,1.0,1,1.0,1,1.0,1,0.11221639248048912,81
3859,0,7450,2886,4564,0,0,0,1.0,1,1.0,1,1.0,1,0.12413845145120607,83
3860,1,7451,2887,4564,0,0,0,1.0,1,1.0,1,1.0,1,0.1289809306092773,82
3861,2,7453,2887,4566,0,0,0,1.0,1,1.0,1,1.0,1,0.13406862575631082,84
3862,3,7456,2888,4568,0,0,0,1.0,1,1.0,1,1.0,1,0.13529224421795247,85
3863,0,7456,2888,4568,0,0,0,1.0,1,1.0,1,1.0,1,0.12458253055796757,84
3864,1,7457,2889,4568,0,0,0,1.0,1,1.0,1,1.0,1,0.11710133636422507,83
3865,1,7458,2890,4568,0,0,0,1.0,1,1.0,1,1.0,1,0.11799682975878611,82
3866,1,7459,2891,4568,0,0,0,1.0,1,1.0,1,1.0,1,0.1129258950507185,81
3867,1,7460,2892,4568,0,0,0,1.0,1,1.0,1,1.0,1,0.1140548087939751,81
3868,2,7462,2893,4569,0,0,0,1.0,1,1.0,1,1.0,1,0.11643689100410388,81
3869,5,7467,2895,4572,0,0,0,1.0,1,1.0,1,1.0,1,0.07991073049701228,81
3870,0,7467,2895,4572,0,0,0,1.0,1,1.0,1,1.0,1,0.0767778267323443,80
3871,2,7469,2896,4573,0,0,0,1.0,1,1.0,1,1.0,1,0.08976754757791107,82
3872,3,7472,2897,4575,0,0,0,1.0,1,1.0,1,1.0,1,0.08023828021436828,81
3873,2,7474,2898,4576,0,0,0,1.0,1,1.0,1,1.0,1,0.07878633326285216,81
3874,0,7474,2898,4576,0,0,0,1.0,1,1.0,1,1.0,1,0.07495126373727305,78
3875,2,7476,2898,4578,0,0,0,1.0,1,1.0,1,1.0,1,0.06234933950862616,77
3876,3,7479,2899,4580,0,0,0,1.0,1,1.0,1,1.0,1,0.06321234886604636,78
3877,0,7479,2899,4580,0,0,0,1.0,1,1.0,1,1.0,1,0.07337905522992796,75
3878,1,7480,2900,4580,0,0,0,1.0,1,1.0,1,1.0,1,0.0780127639888008,75
3879,1,7481,2900,4581,0,0,0,1.0,1,1.0,1,1.0,1,0.08428857976054921,73
3880,2,7483,2900,4583,0,0,0,1.0,1,1.0,1,1.0,1,0.0721326610834197,74
3881,1,7484,2900,4584,0,0,0,1.0,1,1.0,1,1.0,1,0.05714566953134175,75
3882,3,7487,2900,4587,0,0,0,1.0,1,1.0,1,1.0,1,0.05360342068595004,76
3883,2,7489,2900,4589,0,0,0,1.0,1,1.0,1,1.0,1,0.049733406515880554,77
3884,3,7492,2902,4590,0,0,0,1.0,1,1.0,1,1.0,1,0.08668918383705888,78
3885,1,7493,2902,4591,0,0,0,1.0,1,1.0,1,1.0,1,0.06649478747451143,78
3886,4,7497,2903,4594,0,0,0,1.0,1,1.0,1,1.0,1,0.07296987163824993,79
3887,1,7498,2904,4594,0,0,0,1.0,1,1.0,1,1.0,1,0.08075733701161832,78
3888,4,7502,2906,4596,0,0,0,1.0,1,1.0,1,1.0,1,0.09508132358110642,80
3889,6,7508,2907,4601,0,0,0,1.0,1,1.0,1,1.0,1,0.09063927655411619,82
3890,4,7512,2908,4604,0,0,0,1.0,1,1.0,1,1.0,1,0.08288231461871093,82
3891,5,7517,2910,4607,0,0,0,1.0,1,1.0,1,1.0,1,0.08579463673007105,85
3892,6,7523,2912,4611,0,0,0,1.0,1,1.0,1,1.0,1,0.09345969596451181,87
3893,5,7528,2912,4616,0,0,0,1.0,1,1.0,1,1.0,1,0.0507467887939652,86
3894,0,7528,2912,4616,0,0,0,1.0,1,1.0,1,1.0,1,0.05248180601989208,87
3895,2,7530,2914,4616,0,0,0,1.0,1,1.0,1,1.0,1,0.07235837439707422,87
3896,0,7530,2914,4616,0,0,0,1.0,1,1.0,1,1.0,1,0.07737749090617498,85
3897,1,7531,2915,4616,0,0,0,1.0,1,1.0,1,1.0,1,0.08421394775192703,85
3898,3,7534,2916,4618,0,0,0,1.0,1,1.0,1,1.0,1,0.11060758890873838,86
3899,2,7536,2918,4618,0,0,0,1.0,1,1.0,1,1.0,1,0.12076448161425497,86
3900,1,7537,2918,4619,0,0,0,1.0,1,1.0,1,1.0,1,0.11572169488936511,86
3901,7,7544,2920,4624,0,0,0,1.0,1,1.0,1,1.0,1,0.10594798016000553,86
3902,2,7546,2921,4625,0,0,0,1.0,1,1.0,1,1.0,1,0.11794791597176797,87
3903,3,7549,2922,4627,0,0,0,1.0,1,1.0,1,1.0,1,0.11238905027019243,87
3904,4,7553,2922,4631,0,0,0,1.0,1,1.0,1,1.0,1,0.0728660016997422,85
3905,4,7557,2923,4634,0,0,0,1.0,1,1.0,1,1.0,1,0.0643409782701228,84
3906,1,7558,2924,4634,0,0,0,1.0,1,1.0,1,1.0,1,0.07356396132534437,86
3907,3,7561,2924,4637,0,0,0,1.0,1,1.0,1,1.0,1,0.05737831557567936,84
3908,2,7563,2925,4638,0,0,0,1.0,1,1.0,1,1.0,1,0.05809065720676283,83
3909,2,7565,2926,4639,0,0,0,1.0,1,1.0,1,1.0,1,0.07670132349019146,81
3910,5,7570,2929,4641,0,0,0,1.0,1,1.0,1,1.0,1,0.07305843879407695,82
3911,5,7575,2931,4644,0,0,0,1.0,1,1.0,1,1.0,1,0.044031101247252055,81
3912,2,7577,2932,4645,0,0,0,1.0,1,1.0,1,1.0,1,0.057951972567733795,80
3913,4,7581,2934,4647,0,0,0,1.0,1,1.0,1,1.0,1,0.06819885300804965,80
3914,3,7584,2935,4649,0,0,0,1.0,1,1.0,1,1.0,1,0.08546946082353181,81
3915,4,7588,2937,4651,0,0,0,1.0,1,1.0,1,1.0,1,0.07417225253745591,81
3916,5,7593,2940,4653,0,0,0,1.0,1,1.0,1,1.0,1,0.11831251532036514,81
3917,3,7596,2940,4656,0,0,0,1.0,1,1.0,1,1.0,1,0.07899056465404411,82
3918,6,7602,2942,4660,0,0,0,1.0,1,1.0,1,1.0,1,0.12439921151536254,85
3919,4,7606,2944,4662,0,0,0,1.0,1,1.0,1,1.0,1,0.09481460322303546,85
3920,1,7607,2944,4663,0,0,0,1.0,1,1.0,1,1.0,1,0.0891803438466621,85
3921,4,7611,2945,4666,0,0,0,1.0,1,1.0,1,1.0,1,0.07966973328223487,88
3922,2,7613,2946,4667,0,0,0,1.0,1,1.0,1,1.0,1,0.08612839409472574,88
3923,1,7614,2946,4668,0,0,0,1.0,1,1.0,1,1.0,1,0.07582851765051266,89
3924,0,7614,2946,4668,0,0,0,1.0,1,1.0,1,1.0,1,0.08326184127267493,90
3925,1,7615,2947,4668,0,0,0,1.0,1,1.0,1,1.0,1,0.09152116105273254,88
3926,3,7618,2948,4670,0,0,0,1.0,1,1.0,1,1.0,1,0.08206123999679178,89
3927,2,7620,2948,4672,0,0,0,1.0,1,1.0,1,1.0,1,0.08392950267808322,89
3928,1,7621,2948,4673,0,0,0,1.0,1,1.0,1,1.0,1,0.08082109270999484,88
3929,1,7622,2949,4673,0,0,0,1.0,1,1.0,1,1.0,1,0.08912404488795872,88
3930,0,7622,2949,4673,0,0,0,1.0,1,1.0,1,1.0,1,0.09369487851656731,87
3931,1,7623,2949,4674,0,0,0,1.0,1,1.0,1,1.0,1,0.09437894431126008,86
3932,1,7624,2950,4674,0,0,0,1.0,1,1.0,1,1.0,1,0.10827041722960666,85
3933,0,7624,2950,4674,0,0,0,1.0,1,1.0,1,1.0,1,0.11797869254439741,84
3934,1,7625,2950,4675,0,0,0,1.0,1,1.0,1,1.0,1,0.1090452454114648,85
3935,6,7631,2954,4677,0,0,0,1.0,1,1.0,1,1.0,1,0.11690305134539523,84
3936,2,7633,2954,4679,0,0,0,1.0,1,1.0,1,1.0,1,0.10433245378390242,84
3937,5,7638,2955,4683,0,0,0,1.0,1,1.0,1,1.0,1,0.07770509722931951,82
3938,1,7639,2955,4684,0,0,0,1.0,1,1.0,1,1.0,1,0.07465955950672079,82
3939,1,7640,2955,4685,0,0,0,1.0,1,1.0,1,1.0,1,0.06530211464980325,84
3940,3,7643,2957,4686,0,0,0,1.0,1,1.0,1,1.0,1,0.08394150268375289,84
3941,1,7644,2957,4687,0,0,0,1.0,1,1.0,1,1.0,1,0.07141924239632176,85
3942,2,7646,2958,4688,0,0,0,1.0,1,1.0,1,1.0,1,0.07187951545163526,85
3943,3,7649,2958,4691,0,0,0,1.0,1,1.0,1,1.0,1,0.042392642127598475,84
3944,1,7650,2959,4691,0,0,0,1.0,1,1.0,1,1.0,1,0.07530711160866307,83
3945,2,7652,2960,4692,0,0,0,1.0,1,1.0,1,1.0,1,0.06864758108819871,83
3946,0,7652,2960,4692,0,0,0,1.0,1,1.0,1,1.0,1,0.09168355736864746,83
3947,1,7653,2960,4693,0,0,0,1.0,1,1.0,1,1.0,1,0.08284643152930057,83
3948,1,7654,2961,4693,0,0,0,1.0,1,1.0,1,1.0,1,0.09853292965729289,84
3949,4,7658,2961,4697,0,0,0,1.0,1,1.0,1,1.0,1,0.09601709359198969,84
3950,3,7661,2962,4699,0,0,0,1.0,1,1.0,1,1.0,1,0.0883330044604519,86
3951,3,7664,2962,4702,0,0,0,1.0,1,1.0,1,1.0,1,0.07944711307033432,87
3952,1,7665,2962,4703,0,0,0,1.0,1,1.0,1,1.0,1,0.07566569667586912,86
3953,3,7668,2964,4704,0,0,0,1.0,1,1.0,1,1.0,1,0.07998697362481007,86
3954,2,7670,2964,4706,0,0,0,1.0,1,1.0,1,1.0,1,0.062440073386614656,85
3955,4,7674,2964,4710,0,0,0,1.0,1,1.0,1,1.0,1,0.05346169301341933,85
3956,0,7674,2964,4710,0,0,0,1.0,1,1.0,1,1.0,1,0.06232857082213444,84
3957,0,7674,2964,4710,0,0,0,1.0,1,1.0,1,1.0,1,0.070529325692061,85
3958,1,7675,2964,4711,0,0,0,1.0,1,1.0,1,1.0,1,0.06503474712927555,84
3959,1,7676,2964,4712,0,0,0,1.0,1,1.0,1,1.0,1,0.06795520043694646,83
3960,2,7678,2966,4712,0,0,0,1.0,1,1.0,1,1.0,1,0.09051446083488184,84
3961,3,7681,2967,4714,0,0,0,1.0,1,1.0,1,1.0,1,0.09408784331973105,83
3962,2,7683,2969,4714,0,0,0,1.0,1,1.0,1,1.0,1,0.11418115670774999,84
3963,5,7688,2970,4718,0,0,0,1.0,1,1.0,1,1.0,1,0.08446682835001594,81
3964,4,7692,2973,4719,0,0,0,1.0,1,1.0,1,1.0,1,0.12748131966535248,81
3965,7,7699,2974,4725,0,0,0,1.0,1,1.0,1,1.0,1,0.07260910023022185,81
3966,2,7701,2975,4726,0,0,0,1.0,1,1.0,1,1.0,1,0.08602291652586248,79
3967,2,7703,2976,4727,0,0,0,1.0,1,1.0,1,1.0,1,0.0781499603687605,81
3968,0,7703,2976,4727,0,0,0,1.0,1,1.0,1,1.0,1,0.08582066012352252,79
3969,3,7706,2978,4728,0,0,0,1.0,1,1.0,1,1.0,1,0.09040009808718595,79
3970,1,7707,2979,4728,0,0,0,1.0,1,1.0,1,1.0,1,0.11478810507273433,78
3971,3,7710,2980,4730,0,0,0,1.0,1,1.0,1,1.0,1,0.12630363241311388,77
3972,2,7712,2981,4731,0,0,0,1.0,1,1.0,1,1.0,1,0.12265271770781778,78
3973,0,7712,2981,4731,0,0,0,1.0,1,1.0,1,1.0,1,0.12570516693649006,77
3974,0,7712,2981,4731,0,0,0,1.0,1,1.0,1,1.0,1,0.12570516693649006,77
3975,3,7715,2982,4733,0,0,0,1.0,1,1.0,1,1.0,1,0.13091876441226244,76
3976,1,7716,2982,4734,0,0,0,1.0,1,1.0,1,1.0,1,0.13286755532588362,77
3977,1,7717,2982,4735,0,0,0,1.0,1,1.0,1,1.0,1,0.13341918976285094,78
3978,4,7721,2983,4738,0,0,0,1.0,1,1.0,1,1.0,1,0.14914520502315362,79
3979,5,7726,2983,4743,0,0,0,1.0,1,1.0,1,1.0,1,0.11821736312841913,79
3980,1,7727,2984,4743,0,0,0,1.0,1,1.0,1,1.0,1,0.12038355138090265,79
3981,3,7730,2985,4745,0,0,0,1.0,1,1.0,1,1.0,1,0.12906661451812354,83
3982,3,7733,2985,4748,0,0,0,1.0,1,1.0,1,1.0,1,0.10314675063128273,83
3983,2,7735,2985,4750,0,0,0,1.0,1,1.0,1,1.0,1,0.09414664469528056,82
3984,0,7735,2985,4750,0,0,0,1.0,1,1.0,1,1.0,1,0.09907451162595,83
3985,2,7737,2986,4751,0,0,0,1.0,1,1.0,1,1.0,1,0.10161783463258746,84
3986,4,7741,2988,4753,0,0,0,1.0,1,1.0,1,1.0,1,0.10857788504830222,83
3987,1,7742,2988,4754,0,0,0,1.0,1,1.0,1,1.0,1,0.11311536682717112,82
3988,2,7744,2988,4756,0,0,0,1.0,1,1.0,1,1.0,1,0.11289119077248877,83
3989,2,7746,2988,4758,0,0,0,1.0,1,1.0,1,1.0,1,0.11146986127943263,81
3990,1,7747,2988,4759,0,0,0,1.0,1,1.0,1,1.0,1,0.10682599718148204,81
3991,5,7752,2990,4762,0,0,0,1.0,1,1.0,1,1.0,1,0.12499807194907929,79
3992,1,7753,2991,4762,0,0,0,1.0,1,1.0,1,1.0,1,0.11417189579607878,81
3993,5,7758,2993,4765,0,0,0,1.0,1,1.0,1,1.0,1,0.08885077679683363,80
3994,0,7758,2993,4765,0,0,0,1.0,1,1.0,1,1.0,1,0.08885077679683363,80
3995,2,7760,2994,4766,0,0,0,1.0,1,1.0,1,1.0,1,0.08380246971359775,81
3996,0,7760,2994,4766,0,0,0,1.0,1,1.0,1,1.0,1,0.11062968103049929,80
3997,3,7763,2995,4768,0,0,0,1.0,1,1.0,1,1.0,1,0.0886574396797499,81
3998,2,7765,2996,4769,0,0,0,1.0,1,1.0,1,1.0,1,0.0801326256015507,82
3999,4,7769,2997,4772,0,0,0,1.0,1,1.0,1,1.0,1,0.07129793472575464,82
4000,4,7773,3000,4773,0,0,0,1.0,1,1.0,1,1.0,1,0.08447448639244151,82
4001,2,7775,3001,4774,0,0,0,1.0,1,1.0,1,1.0,1,0.08261781022973567,81
4002,2,7777,3003,4774,0,0,0,1.0,1,1.0,1,1.0,1,0.09322091077152232,81
4003,3,7780,3005,4775,0,0,0,1.0,1,1.0,1,1.0,1,0.11264235045053396,81
4004,4,7784,3007,4777,0,0,0,1.0,1,1.0,1,1.0,1,0.11162703216452771,80
4005,4,7788,3008,4780,0,0,0,1.0,1,1.0,1,1.0,1,0.10265250505165305,78
4006,0,7788,3008,4780,0,0,0,1.0,1,1.0,1,1.0,1,0.08760580105142504,76
4007,2,7790,3009,4781,0,0,0,1.0,1,1.0,1,1.0,1,0.09616354121905275,75
4008,0,7790,3009,4781,0,0,0,1.0,1,1.0,1,1.0,1,0.09215859931981758,74
4009,3,7793,3011,4782,0,0,0,1.0,1,1.0,1,1.0,1,0.12844944102038947,75
4010,3,7796,3013,4783,0,0,0,1.0,1,1.0,1,1.0,1,0.1461749027071744,75
4011,3,7799,3014,4785,0,0,0,1.0,1,1.0,1,1.0,1,0.11963850910865263,74
4012,3,7802,3015,4787,0,0,0,1.0,1,1.0,1,1.0,1,0.10934637343430881,74
4013,2,7804,3016,4788,0,0,0,1.0,1,1.0,1,1.0,1,0.11011842043595338,74
4014,2,7806,3018,4788,0,0,0,1.0,1,1.0,1,1.0,1,0.14353231417292786,73
4015,2,7808,3018,4790,0,0,0,1.0,1,1.0,1,1.0,1,0.12703423276998532,74
4016,0,7808,3018,4790,0,0,0,1.0,1,1.0,1,1.0,1,0.1488061900677672,74
4017,8,7816,3019,4797,0,0,0,1.0,1,1.0,1,1.0,1,0.12571936756559152,78
4018,4,7820,3020,4800,0,0,0,1.0,1,1.0,1,1.0,1,0.12125892276795894,78
4019,0,7820,3020,4800,0,0,0,1.0,1,1.0,1,1.0,1,0.12125892276795894,78
4020,1,7821,3020,4801,0,0,0,1.0,1,1.0,1,1.0,1,0.1119226396647709,78
4021,1,7822,3020,4802,0,0,0,1.0,1,1.0,1,1.0,1,0.10596665765857743,78
4022,3,7825,3022,4803,0,0,0,1.0,1,1.0,1,1.0,1,0.11203106665845729,79
4023,0,7825,3022,4803,0,0,0,1.0,1,1.0,1,1.0,1,0.10922585367511276,78
4024,3,7828,3024,4804,0,0,0,1.0,1,1.0,1,1.0,1,0.13137704705961858,77
4025,4,7832,3026,4806,0,0,0,1.0,1,1.0,1,1.0,1,0.11803000493380558,76
4026,4,7836,3028,4808,0,0,0,1.0,1,1.0,1,1.0,1,0.11802032047943208,76
4027,4,7840,3030,4810,0,0,0,1.0,1,1.0,1,1.0,1,0.1309043028201413,75
4028,2,7842,3030,4812,0,0,0,1.0,1,1.0,1,1.0,1,0.11064937616668993,76
4029,2,7844,3030,4814,0,0,0,1.0,1,1.0,1,1.0,1,0.09660547607622319,75
4030,0,7844,3030,4814,0,0,0,1.0,1,1.0,1,1.0,1,0.10080216797021785,74
4031,3,7847,3031,4816,0,0,0,1.0,1,1.0,1,1.0,1,0.11067411371276088,73
4032,2,7849,3031,4818,0,0,0,1.0,1,1.0,1,1.0,1,0.08956116680981957,71
4033,4,7853,3032,4821,0,0,0,1.0,1,1.0,1,1.0,1,0.060159453422917404,73
4034,2,7855,3033,4822,0,0,0,1.0,1,1.0,1,1.0,1,0.0451903164689219,72
4035,0,7855,3033,4822,0,0,0,1.0,1,1.0,1,1.0,1,0.060206677821161576,71
4036,1,7856,3034,4822,0,0,0,1.0,1,1.0,1,1.0,1,0.05975651821168484,71
4037,1,7857,3035,4822,0,0,0,1.0,1,1.0,1,1.0,1,0.0865606813674544,70
4038,2,7859,3036,4823,0,0,0,1.0,1,1.0,1,1.0,1,0.11263872664180671,69
4039,4,7863,3037,4826,0,0,0,1.0,1,1.0,1,1.0,1,0.1347498378735105,68
4040,4,7867,3039,4828,0,0,0,1.0,1,1.0,1,1.0,1,0.1576937010410177,69
4041,4,7871,3040,4831,0,0,0,1.0,1,1.0,1,1.0,1,0.17242294855098333,67
4042,2,7873,3040,4833,0,0,0,1.0,1,1.0,1,1.0,1,0.18537042955210356,67
4043,7,7880,3041,4839,0,0,0,1.0,1,1.0,1,1.0,1,0.15575331790978836,66
4044,1,7881,3041,4840,0,0,0,1.0,1,1.0,1,1.0,1,0.15421083163071264,65
4045,1,7882,3041,4841,0,0,0,1.0,1,1.0,1,1.0,1,0.14705526614573664,66
4046,2,7884,3041,4843,0,0,0,1.0,1,1.0,1,1.0,1,0.151486401075308,68
4047,1,7885,3041,4844,0,0,0,1.0,1,1.0,1,1.0,1,0.13339211184936087,68
4048,0,7885,3041,4844,0,0,0,1.0,1,1.0,1,1.0,1,0.14217380290236276,69
4049,0,7885,3041,4844,0,0,0,1.0,1,1.0,1,1.0,1,0.14217380290236276,69
4050,0,7885,3041,4844,0,0,0,1.0,1,1.0,1,1.0,1,0.1428712695796314,69
4051,0,7885,3041,4844,0,0,0,1.0,1,1.0,1,1.0,1,0.1428712695796314,69
4052,2,7887,3041,4846,0,0,0,1.0,1,1.0,1,1.0,1,0.1259482501288195,69
4053,1,7888,3042,4846,0,0,0,1.0,1,1.0,1,1.0,1,0.13983956920692595,69
4054,2,7890,3043,4847,0,0,0,1.0,1,1.0,1,1.0,1,0.143053584259013,70
4055,2,7892,3043,4849,0,0,0,1.0,1,1.0,1,1.0,1,0.12368529449810146,70
4056,1,7893,3043,4850,0,0,0,1.0,1,1.0,1,1.0,1,0.11724431445174818,70
4057,0,7893,3043,4850,0,0,0,1.0,1,1.0,1,1.0,1,0.12238288486548037,71
4058,2,7895,3043,4852,0,0,0,1.0,1,1.0,1,1.0,1,0.10335023903954237,71
4059,2,7897,3044,4853,0,0,0,1.0,1,1.0,1,1.0,1,0.10694442200295429,72
4060,0,7897,3044,4853,0,0,0,1.0,1,1.0,1,1.0,1,0.11696759211312274,71
4061,3,7900,3046,4854,0,0,0,1.0,1,1.0,1,1.0,1,0.1379050813772578,72
4062,2,7902,3046,4856,0,0,0,1.0,1,1.0,1,1.0,1,0.12429398450393496,72
4063,4,7906,3047,4859,0,0,0,1.0,1,1.0,1,1.0,1,0.11664654325873797,72
4064,4,7910,3050,4860,0,0,0,1.0,1,1.0,1,1.0,1,0.11703326130948673,71
4065,6,7916,3051,4865,0,0,0,1.0,1,1.0,1,1.0,1,0.08746499285055766,70
4066,4,7920,3053,4867,0,0,0,1.0,1,1.0,1,1.0,1,0.09679158690213008,70
4067,2,7922,3053,4869,0,0,0,1.0,1,1.0,1,1.0,1,0.04283822547422745,68
4068,5,7927,3055,4872,0,0,0,1.0,1,1.0,1,1.0,1,0.08382964872766696,70
4069,2,7929,3056,4873,0,0,0,1.0,1,1.0,1,1.0,1,0.0710046961397768,68
4070,3,7932,3059,4873,0,0,0,1.0,1,1.0,1,1.0,1,0.09727070225807054,67
4071,5,7937,3061,4876,0,0,0,1.0,1,1.0,1,1.0,1,0.10747866467626763,68
4072,4,7941,3063,4878,0,0,0,1.0,1,1.0,1,1.0,1,0.11304826465302277,70
4073,4,7945,3066,4879,0,0,0,1.0,1,1.0,1,1.0,1,0.12564930021884502,70
4074,10,7955,3071,4884,0,0,0,1.0,1,1.0,1,1.0,1,0.15442854068158954,71
4075,5,7960,3072,4888,0,0,0,1.0,1,1.0,1,1.0,1,0.11963442059686188,72
4076,6,7966,3072,4894,0,0,0,1.0,1,1.0,1,1.0,1,0.11547872792560464,73
4077,1,7967,3072,4895,0,0,0,1.0,1,1.0,1,1.0,1,0.12499743650609542,72
4078,5,7972,3075,4897,0,0,0,1.0,1,1.0,1,1.0,1,0.15746740036096873,71
4079,2,7974,3075,4899,0,0,0,1.0,1,1.0,1,1.0,1,0.14040911241686507,69
4080,1,7975,3076,4899,0,0,0,1.0,1,1.0,1,1.0,1,0.14540865422199248,67
4081,3,7978,3076,4902,0,0,0,1.0,1,1.0,1,1.0,1,0.12716918859541174,66
4082,0,7978,3076,4902,0,0,0,1.0,1,1.0,1,1.0,1,0.146540932298759,65
4083,2,7980,3078,4902,0,0,0,1.0,1,1.0,1,1.0,1,0.1649769810939724,64
4084,2,7982,3080,4902,0,0,0,1.0,1,1.0,1,1.0,1,0.1948518134305629,64
4085,6,7988,3080,4908,0,0,0,1.0,1,1.0,1,1.0,1,0.14527482561241514,65
4086,2,7990,3081,4909,0,0,0,1.0,1,1.0,1,1.0,1,0.14266820052918833,66
4087,4,7994,3082,4912,0,0,0,1.0,1,1.0,1,1.0,1,0.11853498074370453,66
4088,1,7995,3082,4913,0,0,0,1.0,1,1.0,1,1.0,1,0.1440405077043428,65
4089,1,7996,3083,4913,0,0,0,1.0,1,1.0,1,1.0,1,0.14177341275136926,65
4090,1,7997,3083,4914,0,0,0,1.0,1,1.0,1,1.0,1,0.14945436998585826,65
4091,2,7999,3083,4916,0,0,0,1.0,1,1.0,1,1.0,1,0.1272714395766235,65
4092,1,8000,3083,4917,0,0,0,1.0,1,1.0,1,1.0,1,0.1279836086055633,64
4093,0,8000,3083,4917,0,0,0,1.0,1,1.0,1,1.0,1,0.11367302754330329,66
4094,1,8001,3084,4917,0,0,0,1.0,1,1.0,1,1.0,1,0.1370343464539738,65
4095,2,8003,3085,4918,0,0,0,1.0,1,1.0,1,1.0,1,0.12883683107397984,65
4096,5,8008,3088,4920,0,0,0,1.0,1,1.0,1,1.0,1,0.1325621765201612,67
4097,3,8011,3089,4922,0,0,0,1.0,1,1.0,1,1.0,1,0.11318557608841778,67
4098,1,8012,3090,4922,0,0,0,1.0,1,1.0,1,1.0,1,0.1296816394621942,68
4099,6,8018,3092,4926,0,0,0,1.0,1,1.0,1,1.0,1,0.0990292988848132,69
4100,0,8018,3092,4926,0,0,0,1.0,1,1.0,1,1.0,1,0.10254979916083491,70
4101,3,8021,3093,4928,0,0,0,1.0,1,1.0,1,1.0,1,0.1046466173475236,71
4102,5,8026,3097,4929,0,0,0,1.0,1,1.0,1,1.0,1,0.12460599159474069,71
4103,3,8029,3097,4932,0,0,0,1.0,1,1.0,1,1.0,1,0.10327755195284223,71
4104,3,8032,3099,4933,0,0,0,1.0,1,1.0,1,1.0,1,0.13319460178951764,69
4105,4,8036,3099,4937,0,0,0,1.0,1,1.0,1,1.0,1,0.10841235780365399,67
4106,1,8037,3100,4937,0,0,0,1.0,1,1.0,1,1.0,1,0.13460133617107872,68
4107,2,8039,3100,4939,0,0,0,1.0,1,1.0,1,1.0,1,0.11956046901441549,70
4108,0,8039,3100,4939,0,0,0,1.0,1,1.0,1,1.0,1,0.11759707765399344,70
4109,2,8041,3100,4941,0,0,0,1.0,1,1.0,1,1.0,1,0.11449365703223745,69
4110,2,8043,3101,4942,0,0,0,1.0,1,1.0,1,1.0,1,0.0890592379472537,71
4111,1,8044,3101,4943,0,0,0,1.0,1,1.0,1,1.0,1,0.07628371171931185,70
4112,1,8045,3101,4944,0,0,0,1.0,1,1.0,1,1.0,1,0.0694320449113519,72
4113,1,8046,3101,4945,0,0,0,1.0,1,1.0,1,1.0,1,0.06253790562295168,72
4114,4,8050,3103,4947,0,0,0,1.0,1,1.0,1,1.0,1,0.07270646786045847,72
4115,2,8052,3104,4948,0,0,0,1.0,1,1.0,1,1.0,1,0.05298690667087438,70
4116,1,8053,3105,4948,0,0,0,1.0,1,1.0,1,1.0,1,0.09200217923500116,67
4117,3,8056,3107,4949,0,0,0,1.0,1,1.0,1,1.0,1,0.08700557711661597,67
4118,0,8056,3107,4949,0,0,0,1.0,1,1.0,1,1.0,1,0.10054302959736859,66
4119,4,8060,3109,4951,0,0,0,1.0,1,1.0,1,1.0,1,0.13222952034288132,67
4120,3,8063,3111,4952,0,0,0,1.0,1,1.0,1,1.0,1,0.19962111786892603,64
4121,8,8071,3113,4958,0,0,0,1.0,1,1.0,1,1.0,1,0.16458099437847537,63
4122,2,8073,3113,4960,0,0,0,1.0,1,1.0,1,1.0,1,0.15561652002137458,63
4123,7,8080,3113,4967,0,0,0,1.0,1,1.0,1,1.0,1,0.09684433928627409,61
4124,2,8082,3114,4968,0,0,0,1.0,1,1.0,1,1.0,1,0.10105249164815608,62
4125,0,8082,3114,4968,0,0,0,1.0,1,1.0,1,1.0,1,0.1198087716353662,60
4126,0,8082,3114,4968,0,0,0,1.0,1,1.0,1,1.0,1,0.13842744732441814,59
4127,4,8086,3116,4970,0,0,0,1.0,1,1.0,1,1.0,1,0.15123498627535062,60
4128,3,8089,3118,4971,0,0,0,1.0,1,1.0,1,1.0,1,0.1523461892905162,60
4129,2,8091,3118,4973,0,0,0,1.0,1,1.0,1,1.0,1,0.14971398441559022,60
4130,2,8093,3120,4973,0,0,0,1.0,1,1.0,1,1.0,1,0.15458180411842332,61
4131,2,8095,3120,4975,0,0,0,1.0,1,1.0,1,1.0,1,0.14118439092977436,60
4132,1,8096,3121,4975,0,0,0,1.0,1,1.0,1,1.0,1,0.14653336062089414,60
4133,3,8099,3122,4977,0,0,0,1.0,1,1.0,1,1.0,1,0.15727812424313975,62
4134,1,8100,3123,4977,0,0,0,1.0,1,1.0,1,1.0,1,0.1531078442056323,63
4135,4,8104,3124,4980,0,0,0,1.0,1,1.0,1,1.0,1,0.11205445327067909,65
4136,1,8105,3124,4981,0,0,0,1.0,1,1.0,1,1.0,1,0.10964718373742627,65
4137,1,8106,3125,4981,0,0,0,1.0,1,1.0,1,1.0,1,0.12501046522479123,66
4138,0,8106,3125,4981,0,0,0,1.0,1,1.0,1,1.0,1,0.12664567671449917,67
4139,2,8108,3127,4981,0,0,0,1.0,1,1.0,1,1.0,1,0.14771137765949685,67
4140,0,8108,3127,4981,0,0,0,1.0,1,1.0,1,1.0,1,0.1350563920087961,66
4141,2,8110,3127,4983,0,0,0,1.0,1,1.0,1,1.0,1,0.10915525182398178,67
4142,0,8110,3127,4983,0,0,0,1.0,1,1.0,1,1.0,1,0.10915525182398178,67
4143,2,8112,3127,4985,0,0,0,1.0,1,1.0,1,1.0,1,0.08154059761776357,66
4144,0,8112,3127,4985,0,0,0,1.0,1,1.0,1,1.0,1,0.09553391267109217,64
4145,3,8115,3130,4985,0,0,0,1.0,1,1.0,1,1.0,1,0.13392687546040444,63
4146,5,8120,3134,4986,0,0,0,1.0,1,1.0,1,1.0,1,0.16140179274182076,62
4147,5,8125,3135,4990,0,0,0,1.0,1,1.0,1,1.0,1,0.12502698318527045,60
4148,6,8131,3138,4993,0,0,0,1.0,1,1.0,1,1.0,1,0.12208183002871459,62
4149,3,8134,3138,4996,0,0,0,1.0,1,1.0,1,1.0,1,0.10858905135227274,61
4150,2,8136,3140,4996,0,0,0,1.0,1,1.0,1,1.0,1,0.1170135083026323,60
4151,3,8139,3141,4998,0,0,0,1.0,1,1.0,1,1.0,1,0.1190667106331543,60
4152,2,8141,3142,4999,0,0,0,1.0,1,1.0,1,1.0,1,0.14278851228013248,60
4153,1,8142,3143,4999,0,0,0,1.0,1,1.0,1,1.0,1,0.156151234327643,58
4154,3,8145,3144,5001,0,0,0,1.0,1,1.0,1,1.0,1,0.14580501154098913,57
4155,4,8149,3145,5004,0,0,0,1.0,1,1.0,1,1.0,1,0.1392831775310642,57
4156,0,8149,3145,5004,0,0,0,1.0,1,1.0,1,1.0,1,0.15104032065295014,58
4157,1,8150,3145,5005,0,0,0,1.0,1,1.0,1,1.0,1,0.15409813309403414,57
4158,2,8152,3146,5006,0,0,0,1.0,1,1.0,1,1.0,1,0.17131134051554223,55
4159,2,8154,3147,5007,0,0,0,1.0,1,1.0,1,1.0,1,0.1761417117820494,57
4160,3,8157,3148,5009,0,0,0,1.0,1,1.0,1,1.0,1,0.1569663022500775,58
4161,2,8159,3148,5011,0,0,0,1.0,1,1.0,1,1.0,1,0.13662147873714092,58
4162,0,8159,3148,5011,0,0,0,1.0,1,1.0,1,1.0,1,0.1325096414833406,57
4163,0,8159,3148,5011,0,0,0,1.0,1,1.0,1,1.0,1,0.1310112975846303,58
4164,3,8162,3151,5011,0,0,0,1.0,1,1.0,1,1.0,1,0.16977251530785928,56
4165,4,8166,3152,5014,0,0,0,1.0,1,1.0,1,1.0,1,0.1720829608118199,58
4166,2,8168,3152,5016,0,0,0,1.0,1,1.0,1,1.0,1,0.147492426695855,57
4167,1,8169,3152,5017,0,0,0,1.0,1,1.0,1,1.0,1,0.13856820286676116,57
4168,1,8170,3152,5018,0,0,0,1.0,1,1.0,1,1.0,1,0.1269365068554232,58
4169,1,8171,3153,5018,0,0,0,1.0,1,1.0,1,1.0,1,0.13636024904685293,58
4170,1,8172,3154,5018,0,0,0,1.0,1,1.0,1,1.0,1,0.14912237199043377,58
4171,1,8173,3154,5019,0,0,0,1.0,1,1.0,1,1.0,1,0.1485478264141534,57
4172,0,8173,3154,5019,0,0,0,1.0,1,1.0,1,1.0,1,0.1485478264141534,57
4173,2,8175,3155,5020,0,0,0,1.0,1,1.0,1,1.0,1,0.18033860027087992,56
4174,1,8176,3156,5020,0,0,0,1.0,1,1.0,1,1.0,1,0.21171095704810486,56
4175,4,8180,3156,5024,0,0,0,1.0,1,1.0,1,1.0,1,0.1672997415360359,55
4176,2,8182,3156,5026,0,0,0,1.0,1,1.0,1,1.0,1,0.17206337065680646,57
4177,6,8188,3157,5031,0,0,0,1.0,1,1.0,1,1.0,1,0.14316677713350784,58
4178,5,8193,3158,5035,0,0,0,1.0,1,1.0,1,1.0,1,0.13874788694645407,60
4179,0,8193,3158,5035,0,0,0,1.0,1,1.0,1,1.0,1,0.13776072232969663,61
4180,0,8193,3158,5035,0,0,0,1.0,1,1.0,1,1.0,1,0.14762348884547685,62
4181,1,8194,3158,5036,0,0,0,1.0,1,1.0,1,1.0,1,0.1427972345805807,63
4182,1,8195,3159,5036,0,0,0,1.0,1,1.0,1,1.0,1,0.1428214370788695,63
4183,3,8198,3159,5039,0,0,0,1.0,1,1.0,1,1.0,1,0.11994293089570136,63
4184,3,8201,3160,5041,0,0,0,1.0,1,1.0,1,1.0,1,0.13841454666857397,63
4185,4,8205,3160,5045,0,0,0,1.0,1,1.0,1,1.0,1,0.09983945730789369,61
4186,1,8206,3160,5046,0,0,0,1.0,1,1.0,1,1.0,1,0.07567258433501327,62
4187,1,8207,3161,5046,0,0,0,1.0,1,1.0,1,1.0,1,0.0842249333958842,60
4188,2,8209,3162,5047,0,0,0,1.0,1,1.0,1,1.0,1,0.0958363734870663,60
4189,3,8212,3163,5049,0,0,0,1.0,1,1.0,1,1.0,1,0.08028035049780252,60
4190,1,8213,3164,5049,0,0,0,1.0,1,1.0,1,1.0,1,0.09981676126300063,61
4191,0,8213,3164,5049,0,0,0,1.0,1,1.0,1,1.0,1,0.08593838065300052,59
4192,1,8214,3165,5049,0,0,0,1.0,1,1.0,1,1.0,1,0.09252818287310115,58
4193,3,8217,3168,5049,0,0,0,1.0,1,1.0,1,1.0,1,0.13191274733006675,57
4194,3,8220,3171,5049,0,0,0,1.0,1,1.0,1,1.0,1,0.17928566850726452,54
4195,3,8223,3171,5052,0,0,0,1.0,1,1.0,1,1.0,1,0.1274146147660212,55
4196,1,8224,3171,5053,0,0,0,1.0,1,1.0,1,1.0,1,0.143924369844042,56
4197,3,8227,3171,5056,0,0,0,1.0,1,1.0,1,1.0,1,0.11643716460306788,55
4198,3,8230,3172,5058,0,0,0,1.0,1,1.0,1,1.0,1,0.16551985083507473,56
4199,7,8237,3174,5063,0,0,0,1.0,1,1.0,1,1.0,1,0.1749106848334946,55
4200,0,8237,3174,5063,0,0,0,1.0,1,1.0,1,1.0,1,0.17484398172935045,55
4201,2,8239,3174,5065,0,0,0,1.0,1,1.0,1,1.0,1,0.14378987341469837,56
4202,0,8239,3174,5065,0,0,0,1.0,1,1.0,1,1.0,1,0.14378987341469837,56
4203,2,8241,3174,5067,0,0,0,1.0,1,1.0,1,1.0,1,0.13288594940373866,57
4204,2,8243,3175,5068,0,0,0,1.0,1,1.0,1,1.0,1,0.11779122059605028,57
4205,0,8243,3175,5068,0,0,0,1.0,1,1.0,1,1.0,1,0.117933380916904,58
4206,1,8244,3176,5068,0,0,0,1.0,1,1.0,1,1.0,1,0.12137592649945599,58
4207,1,8245,3177,5068,0,0,0,1.0,1,1.0,1,1.0,1,0.1218742504348144,58
4208,1,8246,3178,5068,0,0,0,1.0,1,1.0,1,1.0,1,0.1435455897569797,60
4209,5,8251,3180,5071,0,0,0,1.0,1,1.0,1,1.0,1,0.09694455448297921,61
4210,2,8253,3180,5073,0,0,0,1.0,1,1.0,1,1.0,1,0.09292616485174697,62
4211,2,8255,3181,5074,0,0,0,1.0,1,1.0,1,1.0,1,0.08428027336960468,63
4212,0,8255,3181,5074,0,0,0,1.0,1,1.0,1,1.0,1,0.08978067415188606,64
4213,0,8255,3181,5074,0,0,0,1.0,1,1.0,1,1.0,1,0.10402253617062797,65
4214,0,8255,3181,5074,0,0,0,1.0,1,1.0,1,1.0,1,0.1006629754939798,65
4215,0,8255,3181,5074,0,0,0,1.0,1,1.0,1,1.0,1,0.1006629754939798,65
4216,0,8255,3181,5074,0,0,0,1.0,1,1.0,1,1.0,1,0.11663322181130788,64
4217,2,8257,3182,5075,0,0,0,1.0,1,1.0,1,1.0,1,0.11930720878251638,65
4218,0,8257,3182,5075,0,0,0,1.0,1,1.0,1,1.0,1,0.11930720878251638,65
4219,2,8259,3182,5077,0,0,0,1.0,1,1.0,1,1.0,1,0.09097847017213329,65
4220,1,8260,3183,5077,0,0,0,1.0,1,1.0,1,1.0,1,0.10402427448030614,65
4221,3,8263,3186,5077,0,0,0,1.0,1,1.0,1,1.0,1,0.17236536802348298,67
4222,5,8268,3186,5082,0,0,0,1.0,1,1.0,1,1.0,1,0.14717626713912954,68
4223,4,8272,3188,5084,0,0,0,1.0,1,1.0,1,1.0,1,0.16162094748074415,68
4224,3,8275,3189,5086,0,0,0,1.0,1,1.0,1,1.0,1,0.15863086704915733,68
4225,1,8276,3189,5087,0,0,0,1.0,1,1.0,1,1.0,1,0.13842561742844112,66
4226,0,8276,3189,5087,0,0,0,1.0,1,1.0,1,1.0,1,0.1383276310756834,66
4227,1,8277,3189,5088,0,0,0,1.0,1,1.0,1,1.0,1,0.1303302928668748,66
4228,0,8277,3189,5088,0,0,0,1.0,1,1.0,1,1.0,1,0.13457846238254828,65
4229,2,8279,3190,5089,0,0,0,1.0,1,1.0,1,1.0,1,0.14881409899200748,65
4230,2,8281,3191,5090,0,0,0,1.0,1,1.0,1,1.0,1,0.1446412038542857,64
4231,3,8284,3192,5092,0,0,0,1.0,1,1.0,1,1.0,1,0.1334620504367788,64
4232,2,8286,3193,5093,0,0,0,1.0,1,1.0,1,1.0,1,0.13075438737666834,65
4233,1,8287,3193,5094,0,0,0,1.0,1,1.0,1,1.0,1,0.12183158920230767,64
4234,0,8287,3193,5094,0,0,0,1.0,1,1.0,1,1.0,1,0.1243924163969012,63
4235,1,8288,3194,5094,0,0,0,1.0,1,1.0,1,1.0,1,0.12563602905502017,63
4236,1,8289,3194,5095,0,0,0,1.0,1,1.0,1,1.0,1,0.11078806304661984,63
4237,4,8293,3196,5097,0,0,0,1.0,1,1.0,1,1.0,1,0.13094114478517654,65
4238,1,8294,3196,5098,0,0,0,1.0,1,1.0,1,1.0,1,0.115332485370146,65
4239,1,8295,3196,5099,0,0,0,1.0,1,1.0,1,1.0,1,0.09928122831033093,65
4240,1,8296,3197,5099,0,0,0,1.0,1,1.0,1,1.0,1,0.08547357848326972,66
4241,0,8296,3197,5099,0,0,0,1.0,1,1.0,1,1.0,1,0.08547357848326972,66
4242,1,8297,3198,5099,0,0,0,1.0,1,1.0,1,1.0,1,0.10018384613379507,69
4243,3,8300,3198,5102,0,0,0,1.0,1,1.0,1,1.0,1,0.08441920994866645,71
4244,0,8300,3198,5102,0,0,0,1.0,1,1.0,1,1.0,1,0.08441920994866645,71
4245,2,8302,3198,5104,0,0,0,1.0,1,1.0,1,1.0,1,0.07721920404972026,73
4246,1,8303,3198,5105,0,0,0,1.0,1,1.0,1,1.0,1,0.06506796435081438,74
4247,0,8303,3198,5105,0,0,0,1.0,1,1.0,1,1.0,1,0.06506796435081438,74
4248,0,8303,3198,5105,0,0,0,1.0,1,1.0,1,1.0,1,0.06506796435081438,74
4249,0,8303,3198,5105,0,0,0,1.0,1,1.0,1,1.0,1,0.06506796435081438,74
4250,0,8303,3198,5105,0,0,0,1.0,1,1.0,1,1.0,1,0.06506796435081438,74
4251,0,8303,3198,5105,0,0,0,1.0,1,1.0,1,1.0,1,0.06871273608959891,75
4252,4,8307,3202,5105,0,0,0,1.0,1,1.0,1,1.0,1,0.15216938076487013,75
4253,5,8312,3202,5110,0,0,0,1.0,1,1.0,1,1.0,1,0.12788188060929126,76
4254,1,8313,3203,5110,0,0,0,1.0,1,1.0,1,1.0,1,0.1351108722568961,75
4255,6,8319,3206,5113,0,0,0,1.0,1,1.0,1,1.0,1,0.14388499427393484,76
4256,3,8322,3206,5116,0,0,0,1.0,1,1.0,1,1.0,1,0.11638483048812906,78
4257,4,8326,3207,5119,0,0,0,1.0,1,1.0,1,1.0,1,0.10568527892957241,78
4258,1,8327,3208,5119,0,0,0,1.0,1,1.0,1,1.0,1,0.12616282077527258,77
4259,4,8331,3209,5122,0,0,0,1.0,1,1.0,1,1.0,1,0.11199123456492033,78
4260,0,8331,3209,5122,0,0,0,1.0,1,1.0,1,1.0,1,0.12205030966848893,77
4261,2,8333,3210,5123,0,0,0,1.0,1,1.0,1,1.0,1,0.12409184885846543,76
4262,0,8333,3210,5123,0,0,0,1.0,1,1.0,1,1.0,1,0.14099238479530943,75
4263,3,8336,3212,5124,0,0,0,1.0,1,1.0,1,1.0,1,0.12895476787903648,74
4264,4,8340,3212,5128,0,0,0,1.0,1,1.0,1,1.0,1,0.13001460190089167,74
4265,4,8344,3214,5130,0,0,0,1.0,1,1.0,1,1.0,1,0.09232077373206977,73
4266,1,8345,3215,5130,0,0,0,1.0,1,1.0,1,1.0,1,0.10249382157468541,71
4267,2,8347,3216,5131,0,0,0,1.0,1,1.0,1,1.0,1,0.0762188931019812,69
4268,0,8347,3216,5131,0,0,0,1.0,1,1.0,1,1.0,1,0.10125498297863005,67
4269,6,8353,3218,5135,0,0,0,1.0,1,1.0,1,1.0,1,0.0873846352111774,64
4270,1,8354,3219,5135,0,0,0,1.0,1,1.0,1,1.0,1,0.09806350627604052,63
4271,2,8356,3220,5136,0,0,0,1.0,1,1.0,1,1.0,1,0.12205953717503076,63
4272,3,8359,3222,5137,0,0,0,1.0,1,1.0,1,1.0,1,0.18358390653730058,62
4273,6,8365,3223,5142,0,0,0,1.0,1,1.0,1,1.0,1,0.13189281434631103,62
4274,1,8366,3223,5143,0,0,0,1.0,1,1.0,1,1.0,1,0.13017936346397563,62
4275,2,8368,3223,5145,0,0,0,1.0,1,1.0,1,1.0,1,0.12568427589889564,61
4276,0,8368,3223,5145,0,0,0,1.0,1,1.0,1,1.0,1,0.12218150537501239,62
4277,1,8369,3223,5146,0,0,0,1.0,1,1.0,1,1.0,1,0.12355045609342381,63
4278,0,8369,3223,5146,0,0,0,1.0,1,1.0,1,1.0,1,0.11899623056049735,64
4279,3,8372,3224,5148,0,0,0,1.0,1,1.0,1,1.0,1,0.11860141369880511,65
4280,3,8375,3224,5151,0,0,0,1.0,1,1.0,1,1.0,1,0.09356070176964497,65
4281,2,8377,3225,5152,0,0,0,1.0,1,1.0,1,1.0,1,0.09054003804861312,65
4282,3,8380,3228,5152,0,0,0,1.0,1,1.0,1,1.0,1,0.11516870053854401,66
4283,2,8382,3229,5153,0,0,0,1.0,1,1.0,1,1.0,1,0.1285028873671386,66
4284,2,8384,3231,5153,0,0,0,1.0,1,1.0,1,1.0,1,0.1790272986249873,66
4285,7,8391,3231,5160,0,0,0,1.0,1,1.0,1,1.0,1,0.13293765601678936,67
4286,1,8392,3232,5160,0,0,0,1.0,1,1.0,1,1.0,1,0.16572102096959754,67
4287,1,8393,3232,5161,0,0,0,1.0,1,1.0,1,1.0,1,0.15779575917062477,67
4288,0,8393,3232,5161,0,0,0,1.0,1,1.0,1,1.0,1,0.14912772073864514,68
4289,1,8394,3232,5162,0,0,0,1.0,1,1.0,1,1.0,1,0.15473109241998095,68
4290,2,8396,3232,5164,0,0,0,1.0,1,1.0,1,1.0,1,0.14085468737721143,70
4291,1,8397,3233,5164,0,0,0,1.0,1,1.0,1,1.0,1,0.15069498941134601,71
4292,0,8397,3233,5164,0,0,0,1.0,1,1.0,1,1.0,1,0.15069498941134601,71
4293,2,8399,3233,5166,0,0,0,1.0,1,1.0,1,1.0,1,0.1371714401038807,71
4294,1,8400,3234,5166,0,0,0,1.0,1,1.0,1,1.0,1,0.14914175331664417,71
4295,3,8403,3234,5169,0,0,0,1.0,1,1.0,1,1.0,1,0.13365669816260076,72
4296,1,8404,3235,5169,0,0,0,1.0,1,1.0,1,1.0,1,0.14017774888730322,73
4297,3,8407,3235,5172,0,0,0,1.0,1,1.0,1,1.0,1,0.1353662586068962,73
4298,1,8408,3236,5172,0,0,0,1.0,1,1.0,1,1.0,1,0.15806824042597234,74
4299,4,8412,3236,5176,0,0,0,1.0,1,1.0,1,1.0,1,0.12178445901505729,75
4300,1,8413,3236,5177,0,0,0,1.0,1,1.0,1,1.0,1,0.1077279196736188,75
4301,1,8414,3236,5178,0,0,0,1.0,1,1.0,1,1.0,1,0.09946226710076063,76
4302,0,8414,3236,5178,0,0,0,1.0,1,1.0,1,1.0,1,0.09946226710076063,76
4303,1,8415,3236,5179,0,0,0,1.0,1,1.0,1,1.0,1,0.10100877501333863,75
4304,2,8417,3238,5179,0,0,0,1.0,1,1.0,1,1.0,1,0.14771380411127544,75
4305,6,8423,3239,5184,0,0,0,1.0,1,1.0,1,1.0,1,0.08986574142327688,73
4306,3,8426,3241,5185,0,0,0,1.0,1,1.0,1,1.0,1,0.08376554898146521,74
4307,2,8428,3243,5185,0,0,0,1.0,1,1.0,1,1.0,1,0.10989736306264968,73
4308,0,8428,3243,5185,0,0,0,1.0,1,1.0,1,1.0,1,0.10604484916378536,71
4309,2,8430,3244,5186,0,0,0,1.0,1,1.0,1,1.0,1,0.11250030735594795,70
4310,2,8432,3246,5186,0,0,0,1.0,1,1.0,1,1.0,1,0.13437479534064797,69
4311,5,8437,3248,5189,0,0,0,1.0,1,1.0,1,1.0,1,0.11432302791216724,69
4312,2,8439,3249,5190,0,0,0,1.0,1,1.0,1,1.0,1,0.13215905802954758,66
4313,0,8439,3249,5190,0,0,0,1.0,1,1.0,1,1.0,1,0.13455883820822973,64
4314,4,8443,3250,5193,0,0,0,1.0,1,1.0,1,1.0,1,0.15870425833830382,61
4315,5,8448,3253,5195,0,0,0,1.0,1,1.0,1,1.0,1,0.13924825095246365,61
4316,1,8449,3254,5195,0,0,0,1.0,1,1.0,1,1.0,1,0.14086823099697962,60
4317,3,8452,3255,5197,0,0,0,1.0,1,1.0,1,1.0,1,0.13117214224084328,62
4318,2,8454,3257,5197,0,0,0,1.0,1,1.0,1,1.0,1,0.15437394280309294,59
4319,2,8456,3259,5197,0,0,0,1.0,1,1.0,1,1.0,1,0.19521472422095418,60
4320,2,8458,3259,5199,0,0,0,1.0,1,1.0,1,1.0,1,0.1724455511504711,60
4321,4,8462,3261,5201,0,0,0,1.0,1,1.0,1,1.0,1,0.1906745750807597,61
4322,0,8462,3261,5201,0,0,0,1.0,1,1.0,1,1.0,1,0.1906745750807597,61
4323,4,8466,3263,5203,0,0,0,1.0,1,1.0,1,1.0,1,0.20202002127773194,61
4324,1,8467,3264,5203,0,0,0,1.0,1,1.0,1,1.0,1,0.2217717611289322,60
4325,4,8471,3265,5206,0,0,0,1.0,1,1.0,1,1.0,1,0.21274659864850928,60
4326,2,8473,3265,5208,0,0,0,1.0,1,1.0,1,1.0,1,0.19907846760867898,61
4327,4,8477,3265,5212,0,0,0,1.0,1,1.0,1,1.0,1,0.14868618860452285,62
4328,0,8477,3265,5212,0,0,0,1.0,1,1.0,1,1.0,1,0.14868618860452285,62
4329,1,8478,3265,5213,0,0,0,1.0,1,1.0,1,1.0,1,0.1329598989059673,65
4330,1,8479,3265,5214,0,0,0,1.0,1,1.0,1,1.0,1,0.1208785636701739,65
4331,0,8479,3265,5214,0,0,0,1.0,1,1.0,1,1.0,1,0.1208785636701739,65
4332,1,8480,3266,5214,0,0,0,1.0,1,1.0,1,1.0,1,0.1453475912409991,66
4333,0,8480,3266,5214,0,0,0,1.0,1,1.0,1,1.0,1,0.1453475912409991,66
4334,1,8481,3267,5214,0,0,0,1.0,1,1.0,1,1.0,1,0.16289864691061673,66
4335,4,8485,3267,5218,0,0,0,1.0,1,1.0,1,1.0,1,0.13897843279215696,65
4336,5,8490,3270,5220,0,0,0,1.0,1,1.0,1,1.0,1,0.14835776681780197,67
4337,4,8494,3271,5223,0,0,0,1.0,1,1.0,1,1.0,1,0.154979667317183,69
4338,1,8495,3271,5224,0,0,0,1.0,1,1.0,1,1.0,1,0.16126537990896087,70
4339,2,8497,3271,5226,0,0,0,1.0,1,1.0,1,1.0,1,0.14696168910536342,70
4340,1,8498,3271,5227,0,0,0,1.0,1,1.0,1,1.0,1,0.1482943423004283,71
4341,4,8502,3273,5229,0,0,0,1.0,1,1.0,1,1.0,1,0.14157868950451163,70
4342,2,8504,3273,5231,0,0,0,1.0,1,1.0,1,1.0,1,0.13914561276675227,71
4343,6,8510,3275,5235,0,0,0,1.0,1,1.0,1,1.0,1,0.12772410257772734,67
4344,5,8515,3278,5237,0,0,0,1.0,1,1.0,1,1.0,1,0.13779416023691982,67
4345,4,8519,3280,5239,0,0,0,1.0,1,1.0,1,1.0,1,0.12868893609768842,64
4346,5,8524,3283,5241,0,0,0,1.0,1,1.0,1,1.0,1,0.13691758217988148,64
4347,6,8530,3288,5242,0,0,0,1.0,1,1.0,1,1.0,1,0.19350471774908276,62
4348,4,8534,3289,5245,0,0,0,1.0,1,1.0,1,1.0,1,0.21522174571480063,62
4349,6,8540,3290,5250,0,0,0,1.0,1,1.0,1,1.0,1,0.17908051914946532,61
4350,1,8541,3290,5251,0,0,0,1.0,1,1.0,1,1.0,1,0.16937721440041856,60
4351,2,8543,3290,5253,0,0,0,1.0,1,1.0,1,1.0,1,0.15113989125502883,60
4352,1,8544,3290,5254,0,0,0,1.0,1,1.0,1,1.0,1,0.16970202351930344,57
4353,3,8547,3291,5256,0,0,0,1.0,1,1.0,1,1.0,1,0.17526523410608838,55
4354,2,8549,3291,5258,0,0,0,1.0,1,1.0,1,1.0,1,0.14472659981083838,55
4355,2,8551,3291,5260,0,0,0,1.0,1,1.0,1,1.0,1,0.1440897455257791,53
4356,2,8553,3291,5262,0,0,0,1.0,1,1.0,1,1.0,1,0.10514281052832439,55
4357,2,8555,3292,5263,0,0,0,1.0,1,1.0,1,1.0,1,0.11083351227241728,55
4358,1,8556,3292,5264,0,0,0,1.0,1,1.0,1,1.0,1,0.12785186852585106,55
4359,1,8557,3292,5265,0,0,0,1.0,1,1.0,1,1.0,1,0.1350486200031683,54
4360,0,8557,3292,5265,0,0,0,1.0,1,1.0,1,1.0,1,0.12669639289232656,55
4361,2,8559,3293,5266,0,0,0,1.0,1,1.0,1,1.0,1,0.12155035183534237,54
4362,0,8559,3293,5266,0,0,0,1.0,1,1.0,1,1.0,1,0.1141047501728155,55
4363,1,8560,3294,5266,0,0,0,1.0,1,1.0,1,1.0,1,0.13857687583186046,55
4364,2,8562,3295,5267,0,0,0,1.0,1,1.0,1,1.0,1,0.14804588505982028,55
4365,2,8564,3295,5269,0,0,0,1.0,1,1.0,1,1.0,1,0.12476783044574603,54
4366,2,8566,3297,5269,0,0,0,1.0,1,1.0,1,1.0,1,0.13451373547521306,54
4367,3,8569,3298,5271,0,0,0,1.0,1,1.0,1,1.0,1,0.13250963199401344,57
4368,0,8569,3298,5271,0,0,0,1.0,1,1.0,1,1.0,1,0.15165065824547114,57
4369,2,8571,3299,5272,0,0,0,1.0,1,1.0,1,1.0,1,0.1273010416272124,58
4370,1,8572,3299,5273,0,0,0,1.0,1,1.0,1,1.0,1,0.11926382201883431,59
4371,6,8578,3299,5279,0,0,0,1.0,1,1.0,1,1.0,1,0.06651680299110478,60
4372,2,8580,3300,5280,0,0,0,1.0,1,1.0,1,1.0,1,0.09166600996225366,60
4373,0,8580,3300,5280,0,0,0,1.0,1,1.0,1,1.0,1,0.09166600996225366,60
4374,1,8581,3300,5281,0,0,0,1.0,1,1.0,1,1.0,1,0.07775291959355618,59
4375,1,8582,3300,5282,0,0,0,1.0,1,1.0,1,1.0,1,0.07469209428745124,60
4376,0,8582,3300,5282,0,0,0,1.0,1,1.0,1,1.0,1,0.09383718814771831,60
4377,2,8584,3302,5282,0,0,0,1.0,1,1.0,1,1.0,1,0.1595553116778913,61
4378,5,8589,3303,5286,0,0,0,1.0,1,1.0,1,1.0,1,0.15381765957497676,64
4379,2,8591,3304,5287,0,0,0,1.0,1,1.0,1,1.0,1,0.1689967551668038,64
4380,3,8594,3305,5289,0,0,0,1.0,1,1.0,1,1.0,1,0.15165298400206095,65
4381,2,8596,3305,5291,0,0,0,1.0,1,1.0,1,1.0,1,0.15323192957906492,64
4382,3,8599,3306,5293,0,0,0,1.0,1,1.0,1,1.0,1,0.16005176616911093,64
4383,7,8606,3309,5297,0,0,0,1.0,1,1.0,1,1.0,1,0.1734732239195844,64
4384,2,8608,3310,5298,0,0,0,1.0,1,1.0,1,1.0,1,0.23239331560431198,60
4385,6,8614,3311,5303,0,0,0,1.0,1,1.0,1,1.0,1,0.21166524790022218,58
4386,3,8617,3313,5304,0,0,0,1.0,1,1.0,1,1.0,1,0.2116165670996321,58
4387,4,8621,3314,5307,0,0,0,1.0,1,1.0,1,1.0,1,0.16579068210742648,55
4388,1,8622,3314,5308,0,0,0,1.0,1,1.0,1,1.0,1,0.16795314306706208,56
4389,2,8624,3314,5310,0,0,0,1.0,1,1.0,1,1.0,1,0.1421529452379809,55
4390,0,8624,3314,5310,0,0,0,1.0,1,1.0,1,1.0,1,0.1421529452379809,55
4391,4,8628,3315,5313,0,0,0,1.0,1,1.0,1,1.0,1,0.12439581987972977,56
4392,1,8629,3315,5314,0,0,0,1.0,1,1.0,1,1.0,1,0.1071028394279175,56
4393,2,8631,3316,5315,0,0,0,1.0,1,1.0,1,1.0,1,0.1282602467457374,55
4394,1,8632,3317,5315,0,0,0,1.0,1,1.0,1,1.0,1,0.13352537723281868,53
4395,1,8633,3317,5316,0,0,0,1.0,1,1.0,1,1.0,1,0.1251956712052707,53
4396,2,8635,3319,5316,0,0,0,1.0,1,1.0,1,1.0,1,0.1401625654796096,53
4397,1,8636,3320,5316,0,0,0,1.0,1,1.0,1,1.0,1,0.18282880778030078,50
4398,1,8637,3321,5316,0,0,0,1.0,1,1.0,1,1.0,1,0.2256086811755615,50
4399,3,8640,3321,5319,0,0,0,1.0,1,1.0,1,1.0,1,0.19932415608372248,52
4400,3,8643,3321,5322,0,0,0,1.0,1,1.0,1,1.0,1,0.1818084178049209,55
4401,1,8644,3321,5323,0,0,0,1.0,1,1.0,1,1.0,1,0.15552465182274355,56
4402,2,8646,3322,5324,0,0,0,1.0,1,1.0,1,1.0,1,0.16074062837354372,56
4403,2,8648,3323,5325,0,0,0,1.0,1,1.0,1,1.0,1,0.15205836167868766,57
4404,0,8648,3323,5325,0,0,0,1.0,1,1.0,1,1.0,1,0.15205836167868766,57
4405,0,8648,3323,5325,0,0,0,1.0,1,1.0,1,1.0,1,0.1515908509833362,58
4406,0,8648,3323,5325,0,0,0,1.0,1,1.0,1,1.0,1,0.1515908509833362,58
4407,0,8648,3323,5325,0,0,0,1.0,1,1.0,1,1.0,1,0.1515908509833362,58
4408,0,8648,3323,5325,0,0,0,1.0,1,1.0,1,1.0,1,0.15139459418273907,59
4409,0,8648,3323,5325,0,0,0,1.0,1,1.0,1,1.0,1,0.15139459418273907,59
4410,0,8648,3323,5325,0,0,0,1.0,1,1.0,1,1.0,1,0.15139459418273907,59
4411,1,8649,3323,5326,0,0,0,1.0,1,1.0,1,1.0,1,0.14070442745227107,62
4412,0,8649,3323,5326,0,0,0,1.0,1,1.0,1,1.0,1,0.14440722723553592,63
4413,1,8650,3324,5326,0,0,0,1.0,1,1.0,1,1.0,1,0.14839338149815454,63
4414,1,8651,3324,5327,0,0,0,1.0,1,1.0,1,1.0,1,0.14946118645216824,64
4415,2,8653,3324,5329,0,0,0,1.0,1,1.0,1,1.0,1,0.12800642548271698,64
4416,0,8653,3324,5329,0,0,0,1.0,1,1.0,1,1.0,1,0.12800642548271698,64
4417,2,8655,3325,5330,0,0,0,1.0,1,1.0,1,1.0,1,0.13747827381600897,65
4418,2,8657,3326,5331,0,0,0,1.0,1,1.0,1,1.0,1,0.15538352660162671,65
4419,4,8661,3326,5335,0,0,0,1.0,1,1.0,1,1.0,1,0.1576181776711479,62
4420,1,8662,3326,5336,0,0,0,1.0,1,1.0,1,1.0,1,0.17385209208251126,62
4421,3,8665,3327,5338,0,0,0,1.0,1,1.0,1,1.0,1,0.1655143188951275,65
4422,6,8671,3329,5342,0,0,0,1.0,1,1.0,1,1.0,1,0.1596963940148966,64
4423,3,8674,3330,5344,0,0,0,1.0,1,1.0,1,1.0,1,0.14269282501361102,63
4424,2,8676,3331,5345,0,0,0,1.0,1,1.0,1,1.0,1,0.14010591277197995,63
4425,6,8682,3333,5349,0,0,0,1.0,1,1.0,1,1.0,1,0.12817298619376152,63
4426,3,8685,3334,5351,0,0,0,1.0,1,1.0,1,1.0,1,0.0844752853759325,63
4427,0,8685,3334,5351,0,0,0,1.0,1,1.0,1,1.0,1,0.07565350085443641,62
4428,0,8685,3334,5351,0,0,0,1.0,1,1.0,1,1.0,1,0.06791959096759996,61
4429,4,8689,3336,5353,0,0,0,1.0,1,1.0,1,1.0,1,0.09930836307757844,62
4430,2,8691,3337,5354,0,0,0,1.0,1,1.0,1,1.0,1,0.10415385143788729,60
4431,4,8695,3338,5357,0,0,0,1.0,1,1.0,1,1.0,1,0.07627243029565735,59
4432,1,8696,3339,5357,0,0,0,1.0,1,1.0,1,1.0,1,0.0879314788849022,60
4433,4,8700,3342,5358,0,0,0,1.0,1,1.0,1,1.0,1,0.12773468359178367,61
4434,1,8701,3342,5359,0,0,0,1.0,1,1.0,1,1.0,1,0.1188774859217902,61
4435,5,8706,3344,5362,0,0,0,1.0,1,1.0,1,1.0,1,0.10218102507642407,61
4436,1,8707,3344,5363,0,0,0,1.0,1,1.0,1,1.0,1,0.08572401696043037,61
4437,5,8712,3346,5366,0,0,0,1.0,1,1.0,1,1.0,1,0.12580240407284515,61
4438,2,8714,3346,5368,0,0,0,1.0,1,1.0,1,1.0,1,0.1022884139904439,62
4439,2,8716,3346,5370,0,0,0,1.0,1,1.0,1,1.0,1,0.09081089223379869,63
4440,1,8717,3347,5370,0,0,0,1.0,1,1.0,1,1.0,1,0.10988187924516152,64
4441,3,8720,3348,5372,0,0,0,1.0,1,1.0,1,1.0,1,0.09419379846680263,64
4442,5,8725,3351,5374,0,0,0,1.0,1,1.0,1,1.0,1,0.15708616052826305,67
4443,4,8729,3353,5376,0,0,0,1.0,1,1.0,1,1.0,1,0.12146511303269737,68
4444,0,8729,3353,5376,0,0,0,1.0,1,1.0,1,1.0,1,0.12257400682153424,69
4445,6,8735,3355,5380,0,0,0,1.0,1,1.0,1,1.0,1,0.12119339814652261,71
4446,0,8735,3355,5380,0,0,0,1.0,1,1.0,1,1.0,1,0.12119339814652261,71
4447,3,8738,3355,5383,0,0,0,1.0,1,1.0,1,1.0,1,0.09723140952287922,72
4448,0,8738,3355,5383,0,0,0,1.0,1,1.0,1,1.0,1,0.10511508372286492,71
4449,2,8740,3355,5385,0,0,0,1.0,1,1.0,1,1.0,1,0.09390061465133408,70
4450,0,8740,3355,5385,0,0,0,1.0,1,1.0,1,1.0,1,0.10542493386417245,69
4451,2,8742,3355,5387,0,0,0,1.0,1,1.0,1,1.0,1,0.09033940051720721,69
4452,2,8744,3355,5389,0,0,0,1.0,1,1.0,1,1.0,1,0.07916191415413881,70
4453,0,8744,3355,5389,0,0,0,1.0,1,1.0,1,1.0,1,0.09479928471810628,70
4454,3,8747,3356,5391,0,0,0,1.0,1,1.0,1,1.0,1,0.09202260468275787,71
4455,4,8751,3357,5394,0,0,0,1.0,1,1.0,1,1.0,1,0.08313393828241171,71
4456,2,8753,3358,5395,0,0,0,1.0,1,1.0,1,1.0,1,0.08478879083020217,71
4457,3,8756,3358,5398,0,0,0,1.0,1,1.0,1,1.0,1,0.07798752055817901,69
4458,0,8756,3358,5398,0,0,0,1.0,1,1.0,1,1.0,1,0.08827157787939718,70
4459,0,8756,3358,5398,0,0,0,1.0,1,1.0,1,1.0,1,0.09185924764321156,68
4460,4,8760,3362,5398,0,0,0,1.0,1,1.0,1,1.0,1,0.09319260902614356,68
4461,2,8762,3363,5399,0,0,0,1.0,1,1.0,1,1.0,1,0.08126380467529164,67
4462,4,8766,3366,5400,0,0,0,1.0,1,1.0,1,1.0,1,0.09122941023805764,66
4463,6,8772,3369,5403,0,0,0,1.0,1,1.0,1,1.0,1,0.11714643407619045,65
4464,6,8778,3373,5405,0,0,0,1.0,1,1.0,1,1.0,1,0.20213723606855002,62
4465,13,8791,3377,5414,0,0,0,1.0,1,1.0,1,1.0,1,0.14467635264446202,61
4466,2,8793,3377,5416,0,0,0,1.0,1,1.0,1,1.0,1,0.16191141900568706,60
4467,9,8802,3380,5422,0,0,0,1.0,1,1.0,1,1.0,1,0.14252915684491185,58
4468,2,8804,3381,5423,0,0,0,1.0,1,1.0,1,1.0,1,0.159265868517249,57
4469,4,8808,3381,5427,0,0,0,1.0,1,1.0,1,1.0,1,0.11888238138135658,56
4470,2,8810,3382,5428,0,0,0,1.0,1,1.0,1,1.0,1,0.12376031149798766,55
4471,4,8814,3383,5431,0,0,0,1.0,1,1.0,1,1.0,1,0.11674352384896684,55
4472,2,8816,3385,5431,0,0,0,1.0,1,1.0,1,1.0,1,0.1447171317930921,55
4473,2,8818,3386,5432,0,0,0,1.0,1,1.0,1,1.0,1,0.12985549690726375,55
4474,4,8822,3388,5434,0,0,0,1.0,1,1.0,1,1.0,1,0.14409979543081933,55
4475,5,8827,3389,5438,0,0,0,1.0,1,1.0,1,1.0,1,0.0895000387195441,56
4476,0,8827,3389,5438,0,0,0,1.0,1,1.0,1,1.0,1,0.08977359358433666,56
4477,0,8827,3389,5438,0,0,0,1.0,1,1.0,1,1.0,1,0.10245220477313413,57
4478,0,8827,3389,5438,0,0,0,1.0,1,1.0,1,1.0,1,0.12290685481675202,55
4479,0,8827,3389,5438,0,0,0,1.0,1,1.0,1,1.0,1,0.12290685481675202,55
4480,4,8831,3390,5441,0,0,0,1.0,1,1.0,1,1.0,1,0.10741042222731301,54
4481,2,8833,3390,5443,0,0,0,1.0,1,1.0,1,1.0,1,0.11115577186113726,53
4482,1,8834,3391,5443,0,0,0,1.0,1,1.0,1,1.0,1,0.13668007729626122,54
4483,4,8838,3391,5447,0,0,0,1.0,1,1.0,1,1.0,1,0.08533418687600357,55
4484,1,8839,3392,5447,0,0,0,1.0,1,1.0,1,1.0,1,0.08709573295330574,57
4485,3,8842,3394,5448,0,0,0,1.0,1,1.0,1,1.0,1,0.10720772629784743,60
4486,2,8844,3396,5448,0,0,0,1.0,1,1.0,1,1.0,1,0.10264987171471775,60
4487,2,8846,3396,5450,0,0,0,1.0,1,1.0,1,1.0,1,0.08124993138382425,60
4488,0,8846,3396,5450,0,0,0,1.0,1,1.0,1,1.0,1,0.08124993138382425,60
4489,2,8848,3397,5451,0,0,0,1.0,1,1.0,1,1.0,1,0.08768543966833948,60
4490,1,8849,3397,5452,0,0,0,1.0,1,1.0,1,1.0,1,0.08382763442823507,60
4491,1,8850,3397,5453,0,0,0,1.0,1,1.0,1,1.0,1,0.08671565955872423,61
4492,0,8850,3397,5453,0,0,0,1.0,1,1.0,1,1.0,1,0.08671565955872423,61
4493,2,8852,3398,5454,0,0,0,1.0,1,1.0,1,1.0,1,0.10265168342067599,60
4494,2,8854,3399,5455,0,0,0,1.0,1,1.0,1,1.0,1,0.07499122485545959,61
4495,1,8855,3399,5456,0,0,0,1.0,1,1.0,1,1.0,1,0.06981923936652729,59
4496,3,8858,3401,5457,0,0,0,1.0,1,1.0,1,1.0,1,0.1160818493178575,60
4497,1,8859,3401,5458,0,0,0,1.0,1,1.0,1,1.0,1,0.1125711897044962,59
4498,0,8859,3401,5458,0,0,0,1.0,1,1.0,1,1.0,1,0.12053644792033118,57
4499,4,8863,3403,5460,0,0,0,1.0,1,1.0,1,1.0,1,0.10854846880378564,58
4500,1,8864,3404,5460,0,0,0,1.0,1,1.0,1,1.0,1,0.10476390608481584,56
4501,5,8869,3405,5464,0,0,0,1.0,1,1.0,1,1.0,1,0.138294157120835,57
4502,5,8874,3407,5467,0,0,0,1.0,1,1.0,1,1.0,1,0.13443407868188573,56
4503,1,8875,3408,5467,0,0,0,1.0,1,1.0,1,1.0,1,0.1536850055628274,54
4504,4,8879,3410,5469,0,0,0,1.0,1,1.0,1,1.0,1,0.12400411915621427,54
4505,3,8882,3412,5470,0,0,0,1.0,1,1.0,1,1.0,1,0.15153350114804867,51
4506,2,8884,3413,5471,0,0,0,1.0,1,1.0,1,1.0,1,0.13773089693665766,49
4507,4,8888,3414,5474,0,0,0,1.0,1,1.0,1,1.0,1,0.14927637887908446,48
4508,1,8889,3414,5475,0,0,0,1.0,1,1.0,1,1.0,1,0.13732488379488425,48
4509,2,8891,3414,5477,0,0,0,1.0,1,1.0,1,1.0,1,0.13766984687624836,46
4510,0,8891,3414,5477,0,0,0,1.0,1,1.0,1,1.0,1,0.1321800967113357,44
4511,2,8893,3415,5478,0,0,0,1.0,1,1.0,1,1.0,1,0.15312376183333887,45
4512,3,8896,3416,5480,0,0,0,1.0,1,1.0,1,1.0,1,0.13471671786915781,46
4513,3,8899,3417,5482,0,0,0,1.0,1,1.0,1,1.0,1,0.12874550871332022,45
4514,0,8899,3417,5482,0,0,0,1.0,1,1.0,1,1.0,1,0.13778806706411004,46
4515,2,8901,3417,5484,0,0,0,1.0,1,1.0,1,1.0,1,0.12292870299849107,48
4516,1,8902,3417,5485,0,0,0,1.0,1,1.0,1,1.0,1,0.13218669314569859,49
4517,1,8903,3417,5486,0,0,0,1.0,1,1.0,1,1.0,1,0.1159708775601973,50
4518,1,8904,3418,5486,0,0,0,1.0,1,1.0,1,1.0,1,0.12168441396126028,50
4519,1,8905,3419,5486,0,0,0,1.0,1,1.0,1,1.0,1,0.14712551408933564,49
4520,0,8905,3419,5486,0,0,0,1.0,1,1.0,1,1.0,1,0.1608204000684703,50
4521,3,8908,3420,5488,0,0,0,1.0,1,1.0,1,1.0,1,0.1281674778598158,50
4522,0,8908,3420,5488,0,0,0,1.0,1,1.0,1,1.0,1,0.1281674778598158,50
4523,2,8910,3421,5489,0,0,0,1.0,1,1.0,1,1.0,1,0.1307666485438005,51
4524,3,8913,3422,5491,0,0,0,1.0,1,1.0,1,1.0,1,0.13077367594402353,52
4525,3,8916,3423,5493,0,0,0,1.0,1,1.0,1,1.0,1,0.10064105806559784,53
4526,0,8916,3423,5493,0,0,0,1.0,1,1.0,1,1.0,1,0.09142301682172806,54
4527,0,8916,3423,5493,0,0,0,1.0,1,1.0,1,1.0,1,0.10603375046681245,55
4528,0,8916,3423,5493,0,0,0,1.0,1,1.0,1,1.0,1,0.10603375046681245,55
4529,4,8920,3424,5496,0,0,0,1.0,1,1.0,1,1.0,1,0.11932876228825436,55
4530,0,8920,3424,5496,0,0,0,1.0,1,1.0,1,1.0,1,0.12559222314730956,56
4531,5,8925,3428,5497,0,0,0,1.0,1,1.0,1,1.0,1,0.1466152832321019,56
4532,2,8927,3429,5498,0,0,0,1.0,1,1.0,1,1.0,1,0.16220353203762036,55
4533,3,8930,3430,5500,0,0,0,1.0,1,1.0,1,1.0,1,0.13377480288220406,54
4534,1,8931,3430,5501,0,0,0,1.0,1,1.0,1,1.0,1,0.12174734025301776,55
4535,4,8935,3430,5505,0,0,0,1.0,1,1.0,1,1.0,1,0.13673842500724884,52
4536,2,8937,3431,5506,0,0,0,1.0,1,1.0,1,1.0,1,0.1375616953669159,53
4537,2,8939,3432,5507,0,0,0,1.0,1,1.0,1,1.0,1,0.15227885010745268,52
4538,2,8941,3434,5507,0,0,0,1.0,1,1.0,1,1.0,1,0.14306752744643003,52
4539,7,8948,3437,5511,0,0,0,1.0,1,1.0,1,1.0,1,0.13526600467597244,53
4540,3,8951,3438,5513,0,0,0,1.0,1,1.0,1,1.0,1,0.1686138090914967,54
4541,1,8952,3438,5514,0,0,0,1.0,1,1.0,1,1.0,1,0.1537207861659796,53
4542,3,8955,3440,5515,0,0,0,1.0,1,1.0,1,1.0,1,0.1454654783254118,53
4543,1,8956,3440,5516,0,0,0,1.0,1,1.0,1,1.0,1,0.12711286872390773,53
4544,2,8958,3441,5517,0,0,0,1.0,1,1.0,1,1.0,1,0.10551338714380805,52
4545,1,8959,3441,5518,0,0,0,1.0,1,1.0,1,1.0,1,0.1071309054855615,50
4546,2,8961,3442,5519,0,0,0,1.0,1,1.0,1,1.0,1,0.13844621627835432,49
4547,0,8961,3442,5519,0,0,0,1.0,1,1.0,1,1.0,1,0.13807790486603577,49
4548,1,8962,3442,5520,0,0,0,1.0,1,1.0,1,1.0,1,0.11056306028005794,49
4549,1,8963,3442,5521,0,0,0,1.0,1,1.0,1,1.0,1,0.09658858835774987,50
4550,0,8963,3442,5521,0,0,0,1.0,1,1.0,1,1.0,1,0.11486983089440309,49
4551,1,8964,3442,5522,0,0,0,1.0,1,1.0,1,1.0,1,0.0973047689899321,49
4552,0,8964,3442,5522,0,0,0,1.0,1,1.0,1,1.0,1,0.0973047689899321,49
4553,4,8968,3443,5525,0,0,0,1.0,1,1.0,1,1.0,1,0.10892357866934185,49
4554,0,8968,3443,5525,0,0,0,1.0,1,1.0,1,1.0,1,0.10892357866934185,49
4555,3,8971,3444,5527,0,0,0,1.0,1,1.0,1,1.0,1,0.0895198086411667,48
4556,3,8974,3446,5528,0,0,0,1.0,1,1.0,1,1.0,1,0.08658394557235537,48
4557,1,8975,3446,5529,0,0,0,1.0,1,1.0,1,1.0,1,0.10298748786936383,49
4558,2,8977,3447,5530,0,0,0,1.0,1,1.0,1,1.0,1,0.0996108234233468,49
4559,0,8977,3447,5530,0,0,0,1.0,1,1.0,1,1.0,1,0.11973455357371579,50
4560,1,8978,3447,5531,0,0,0,1.0,1,1.0,1,1.0,1,0.1259905081321634,51
4561,0,8978,3447,5531,0,0,0,1.0,1,1.0,1,1.0,1,0.11808774735367063,52
4562,1,8979,3448,5531,0,0,0,1.0,1,1.0,1,1.0,1,0.16007897783027675,53
4563,2,8981,3448,5533,0,0,0,1.0,1,1.0,1,1.0,1,0.1278845957069097,52
4564,1,8982,3448,5534,0,0,0,1.0,1,1.0,1,1.0,1,0.10856828225964008,54
4565,1,8983,3448,5535,0,0,0,1.0,1,1.0,1,1.0,1,0.11391456617394285,55
4566,1,8984,3448,5536,0,0,0,1.0,1,1.0,1,1.0,1,0.10299278678230692,55
4567,2,8986,3449,5537,0,0,0,1.0,1,1.0,1,1.0,1,0.08690826617848033,56
4568,1,8987,3450,5537,0,0,0,1.0,1,1.0,1,1.0,1,0.09236831731642005,58
4569,1,8988,3450,5538,0,0,0,1.0,1,1.0,1,1.0,1,0.07803743786523791,59
4570,2,8990,3452,5538,0,0,0,1.0,1,1.0,1,1.0,1,0.12385841272053733,59
4571,1,8991,3452,5539,0,0,0,1.0,1,1.0,1,1.0,1,0.09258002653670164,57
4572,3,8994,3455,5539,0,0,0,1.0,1,1.0,1,1.0,1,0.13470381526697733,56
4573,4,8998,3456,5542,0,0,0,1.0,1,1.0,1,1.0,1,0.141841442024507,56
4574,1,8999,3456,5543,0,0,0,1.0,1,1.0,1,1.0,1,0.17908114826315708,55
4575,3,9002,3457,5545,0,0,0,1.0,1,1.0,1,1.0,1,0.15716827021826485,55
4576,0,9002,3457,5545,0,0,0,1.0,1,1.0,1,1.0,1,0.1617022494096131,55
4577,1,9003,3457,5546,0,0,0,1.0,1,1.0,1,1.0,1,0.15521395853935574,54
4578,1,9004,3458,5546,0,0,0,1.0,1,1.0,1,1.0,1,0.16423004778561207,54
4579,1,9005,3458,5547,0,0,0,1.0,1,1.0,1,1.0,1,0.15091270810983318,54
4580,0,9005,3458,5547,0,0,0,1.0,1,1.0,1,1.0,1,0.14417531219234478,55
4581,3,9008,3460,5548,0,0,0,1.0,1,1.0,1,1.0,1,0.1941035152876254,56
4582,2,9010,3460,5550,0,0,0,1.0,1,1.0,1,1.0,1,0.1796133459514192,56
4583,1,9011,3460,5551,0,0,0,1.0,1,1.0,1,1.0,1,0.17401870396384028,57
4584,3,9014,3462,5552,0,0,0,1.0,1,1.0,1,1.0,1,0.19901232077802744,57
4585,2,9016,3462,5554,0,0,0,1.0,1,1.0,1,1.0,1,0.18476221746531438,57
4586,0,9016,3462,5554,0,0,0,1.0,1,1.0,1,1.0,1,0.18476221746531438,57
4587,2,9018,3462,5556,0,0,0,1.0,1,1.0,1,1.0,1,0.1664648849363811,57
4588,1,9019,3462,5557,0,0,0,1.0,1,1.0,1,1.0,1,0.1593111300695506,58
4589,0,9019,3462,5557,0,0,0,1.0,1,1.0,1,1.0,1,0.16849244258523186,59
4590,2,9021,3462,5559,0,0,0,1.0,1,1.0,1,1.0,1,0.16320928191031148,60
4591,2,9023,3462,5561,0,0,0,1.0,1,1.0,1,1.0,1,0.13524780088311536,61
4592,1,9024,3462,5562,0,0,0,1.0,1,1.0,1,1.0,1,0.11662225227008462,62
4593,0,9024,3462,5562,0,0,0,1.0,1,1.0,1,1.0,1,0.11359751038704537,64
4594,1,9025,3462,5563,0,0,0,1.0,1,1.0,1,1.0,1,0.09240504140591752,64
4595,2,9027,3463,5564,0,0,0,1.0,1,1.0,1,1.0,1,0.0880518704996576,63
4596,0,9027,3463,5564,0,0,0,1.0,1,1.0,1,1.0,1,0.0880518704996576,63
4597,0,9027,3463,5564,0,0,0,1.0,1,1.0,1,1.0,1,0.0880518704996576,63
4598,1,9028,3463,5565,0,0,0,1.0,1,1.0,1,1.0,1,0.07680380765895156,65
4599,2,9030,3464,5566,0,0,0,1.0,1,1.0,1,1.0,1,0.07874468984840727,66
4600,1,9031,3465,5566,0,0,0,1.0,1,1.0,1,1.0,1,0.1080623035215971,67
4601,4,9035,3467,5568,0,0,0,1.0,1,1.0,1,1.0,1,0.12062672552507041,67
4602,1,9036,3467,5569,0,0,0,1.0,1,1.0,1,1.0,1,0.11501425122543571,69
4603,4,9040,3468,5572,0,0,0,1.0,1,1.0,1,1.0,1,0.1026155037197659,69
4604,1,9041,3468,5573,0,0,0,1.0,1,1.0,1,1.0,1,0.09988806085521296,69
4605,1,9042,3468,5574,0,0,0,1.0,1,1.0,1,1.0,1,0.08506645310362258,70
4606,1,9043,3468,5575,0,0,0,1.0,1,1.0,1,1.0,1,0.0740844720241288,70
4607,1,9044,3469,5575,0,0,0,1.0,1,1.0,1,1.0,1,0.10972837088908513,72
4608,1,9045,3469,5576,0,0,0,1.0,1,1.0,1,1.0,1,0.10799091522116963,73
4609,0,9045,3469,5576,0,0,0,1.0,1,1.0,1,1.0,1,0.09992292483841704,72
4610,2,9047,3470,5577,0,0,0,1.0,1,1.0,1,1.0,1,0.10093159940594264,72
4611,1,9048,3471,5577,0,0,0,1.0,1,1.0,1,1.0,1,0.11404528354065803,71
4612,3,9051,3472,5579,0,0,0,1.0,1,1.0,1,1.0,1,0.10900029595140515,70
4613,1,9052,3472,5580,0,0,0,1.0,1,1.0,1,1.0,1,0.09087447569353346,69
4614,0,9052,3472,5580,0,0,0,1.0,1,1.0,1,1.0,1,0.1155522249905573,68
4615,2,9054,3473,5581,0,0,0,1.0,1,1.0,1,1.0,1,0.10583990880298305,68
4616,0,9054,3473,5581,0,0,0,1.0,1,1.0,1,1.0,1,0.12756558075669994,65
4617,1,9055,3474,5581,0,0,0,1.0,1,1.0,1,1.0,1,0.11946991395829928,66
4618,2,9057,3475,5582,0,0,0,1.0,1,1.0,1,1.0,1,0.12125798868146903,66
4619,2,9059,3476,5583,0,0,0,1.0,1,1.0,1,1.0,1,0.12925866057155994,65
4620,1,9060,3476,5584,0,0,0,1.0,1,1.0,1,1.0,1,0.12051309060695763,65
4621,9,9069,3480,5589,0,0,0,1.0,1,1.0,1,1.0,1,0.14743080456319962,67
4622,3,9072,3481,5591,0,0,0,1.0,1,1.0,1,1.0,1,0.16376517286309678,65
4623,4,9076,3482,5594,0,0,0,1.0,1,1.0,1,1.0,1,0.16388901012194165,66
4624,1,9077,3483,5594,0,0,0,1.0,1,1.0,1,1.0,1,0.15812611470895713,65
4625,2,9079,3483,5596,0,0,0,1.0,1,1.0,1,1.0,1,0.1503831339164917,64
4626,4,9083,3486,5597,0,0,0,1.0,1,1.0,1,1.0,1,0.16456140337277791,63
4627,7,9090,3486,5604,0,0,0,1.0,1,1.0,1,1.0,1,0.09048384103923318,65
4628,1,9091,3486,5605,0,0,0,1.0,1,1.0,1,1.0,1,0.09170108474862305,64
4629,1,9092,3486,5606,0,0,0,1.0,1,1.0,1,1.0,1,0.07274063969819654,64
4630,0,9092,3486,5606,0,0,0,1.0,1,1.0,1,1.0,1,0.07274063969819654,64
4631,7,9099,3489,5610,0,0,0,1.0,1,1.0,1,1.0,1,0.13680286095529812,66
4632,2,9101,3490,5611,0,0,0,1.0,1,1.0,1,1.0,1,0.1535722165443551,65
4633,3,9104,3490,5614,0,0,0,1.0,1,1.0,1,1.0,1,0.11753570490138779,66
4634,1,9105,3491,5614,0,0,0,1.0,1,1.0,1,1.0,1,0.12127258739970503,66
4635,0,9105,3491,5614,0,0,0,1.0,1,1.0,1,1.0,1,0.12095909499992777,66
4636,1,9106,3491,5615,0,0,0,1.0,1,1.0,1,1.0,1,0.10823211125782256,66
4637,1,9107,3491,5616,0,0,0,1.0,1,1.0,1,1.0,1,0.08690449809843934,68
4638,0,9107,3491,5616,0,0,0,1.0,1,1.0,1,1.0,1,0.08690449809843934,68
4639,1,9108,3492,5616,0,0,0,1.0,1,1.0,1,1.0,1,0.09659901154585417,69
4640,0,9108,3492,5616,0,0,0,1.0,1,1.0,1,1.0,1,0.09659901154585417,69
4641,4,9112,3493,5619,0,0,0,1.0,1,1.0,1,1.0,1,0.077429628383898,70
4642,0,9112,3493,5619,0,0,0,1.0,1,1.0,1,1.0,1,0.0848251730323094,69
4643,2,9114,3494,5620,0,0,0,1.0,1,1.0,1,1.0,1,0.09562250231245611,70
4644,1,9115,3494,5621,0,0,0,1.0,1,1.0,1,1.0,1,0.0941794136358439,69
4645,2,9117,3494,5623,0,0,0,1.0,1,1.0,1,1.0,1,0.08762466830938732,70
4646,1,9118,3495,5623,0,0,0,1.0,1,1.0,1,1.0,1,0.11011540347235048,68
4647,4,9122,3498,5624,0,0,0,1.0,1,1.0,1,1.0,1,0.12148593903659924,68
4648,1,9123,3498,5625,0,0,0,1.0,1,1.0,1,1.0,1,0.15453525282524624,67
4649,4,9127,3499,5628,0,0,0,1.0,1,1.0,1,1.0,1,0.1495782204995342,67
4650,0,9127,3499,5628,0,0,0,1.0,1,1.0,1,1.0,1,0.12744699805427798,67
4651,6,9133,3501,5632,0,0,0,1.0,1,1.0,1,1.0,1,0.13112785711162075,68
4652,0,9133,3501,5632,0,0,0,1.0,1,1.0,1,1.0,1,0.13479674077873738,66
4653,3,9136,3502,5634,0,0,0,1.0,1,1.0,1,1.0,1,0.1322182096440427,64
4654,0,9136,3502,5634,0,0,0,1.0,1,1.0,1,1.0,1,0.15335381078326066,65
4655,1,9137,3502,5635,0,0,0,1.0,1,1.0,1,1.0,1,0.13806544656079867,64
4656,2,9139,3502,5637,0,0,0,1.0,1,1.0,1,1.0,1,0.13155246194231385,65
4657,5,9144,3502,5642,0,0,0,1.0,1,1.0,1,1.0,1,0.12430513680718899,66
4658,4,9148,3504,5644,0,0,0,1.0,1,1.0,1,1.0,1,0.1637884770468251,65
4659,3,9151,3504,5647,0,0,0,1.0,1,1.0,1,1.0,1,0.11993283876622604,65
4660,3,9154,3507,5647,0,0,0,1.0,1,1.0,1,1.0,1,0.14400325814277012,66
4661,0,9154,3507,5647,0,0,0,1.0,1,1.0,1,1.0,1,0.16336197629078858,66
4662,1,9155,3507,5648,0,0,0,1.0,1,1.0,1,1.0,1,0.1511751337448201,68
4663,0,9155,3507,5648,0,0,0,1.0,1,1.0,1,1.0,1,0.15646956594227898,67
4664,3,9158,3508,5650,0,0,0,1.0,1,1.0,1,1.0,1,0.1541362191642078,67
4665,3,9161,3509,5652,0,0,0,1.0,1,1.0,1,1.0,1,0.1397226120839371,67
4666,3,9164,3510,5654,0,0,0,1.0,1,1.0,1,1.0,1,0.13380664976505602,67
4667,3,9167,3511,5656,0,0,0,1.0,1,1.0,1,1.0,1,0.12277303674040461,66
4668,3,9170,3513,5657,0,0,0,1.0,1,1.0,1,1.0,1,0.13464343589696398,66
4669,3,9173,3514,5659,0,0,0,1.0,1,1.0,1,1.0,1,0.14832629424676969,66
4670,0,9173,3514,5659,0,0,0,1.0,1,1.0,1,1.0,1,0.1617023211512933,64
4671,0,9173,3514,5659,0,0,0,1.0,1,1.0,1,1.0,1,0.1617023211512933,64
4672,3,9176,3515,5661,0,0,0,1.0,1,1.0,1,1.0,1,0.1907219996649124,64
4673,5,9181,3515,5666,0,0,0,1.0,1,1.0,1,1.0,1,0.1566381248188139,65
4674,3,9184,3517,5667,0,0,0,1.0,1,1.0,1,1.0,1,0.16119693888524042,66
4675,3,9187,3517,5670,0,0,0,1.0,1,1.0,1,1.0,1,0.16385483170682077,65
4676,3,9190,3517,5673,0,0,0,1.0,1,1.0,1,1.0,1,0.1549064837551478,65
4677,2,9192,3517,5675,0,0,0,1.0,1,1.0,1,1.0,1,0.158436655549617,65
4678,0,9192,3517,5675,0,0,0,1.0,1,1.0,1,1.0,1,0.16924581789966198,64
4679,2,9194,3517,5677,0,0,0,1.0,1,1.0,1,1.0,1,0.14724491207154658,66
4680,5,9199,3518,5681,0,0,0,1.0,1,1.0,1,1.0,1,0.15610024479404408,67
4681,3,9202,3518,5684,0,0,0,1.0,1,1.0,1,1.0,1,0.1295710727995194,67
4682,4,9206,3521,5685,0,0,0,1.0,1,1.0,1,1.0,1,0.15247011450021336,67
4683,3,9209,3521,5688,0,0,0,1.0,1,1.0,1,1.0,1,0.12296612945814064,67
4684,2,9211,3523,5688,0,0,0,1.0,1,1.0,1,1.0,1,0.14457209143324853,66
4685,2,9213,3523,5690,0,0,0,1.0,1,1.0,1,1.0,1,0.13135673443957505,65
4686,0,9213,3523,5690,0,0,0,1.0,1,1.0,1,1.0,1,0.13187717248067193,65
4687,0,9213,3523,5690,0,0,0,1.0,1,1.0,1,1.0,1,0.1294111764863368,65
4688,2,9215,3525,5690,0,0,0,1.0,1,1.0,1,1.0,1,0.16855341805058902,64
4689,5,9220,3527,5693,0,0,0,1.0,1,1.0,1,1.0,1,0.19564722836772738,65
4690,0,9220,3527,5693,0,0,0,1.0,1,1.0,1,1.0,1,0.21445815611330918,63
4691,8,9228,3529,5699,0,0,0,1.0,1,1.0,1,1.0,1,0.17702158097154588,64
4692,0,9228,3529,5699,0,0,0,1.0,1,1.0,1,1.0,1,0.1567212403954198,63
4693,1,9229,3529,5700,0,0,0,1.0,1,1.0,1,1.0,1,0.15927179741350478,64
4694,0,9229,3529,5700,0,0,0,1.0,1,1.0,1,1.0,1,0.1586733955174762,63
4695,1,9230,3529,5701,0,0,0,1.0,1,1.0,1,1.0,1,0.14674141932290588,62
4696,2,9232,3530,5702,0,0,0,1.0,1,1.0,1,1.0,1,0.16318409035438813,61
4697,6,9238,3531,5707,0,0,0,1.0,1,1.0,1,1.0,1,0.13076931300373745,63
4698,2,9240,3531,5709,0,0,0,1.0,1,1.0,1,1.0,1,0.12587434929393027,63
4699,1,9241,3531,5710,0,0,0,1.0,1,1.0,1,1.0,1,0.12055826009868445,65
4700,0,9241,3531,5710,0,0,0,1.0,1,1.0,1,1.0,1,0.13308445699760293,64
4701,1,9242,3532,5710,0,0,0,1.0,1,1.0,1,1.0,1,0.14411613617150093,64
4702,2,9244,3532,5712,0,0,0,1.0,1,1.0,1,1.0,1,0.11735358849567352,66
4703,1,9245,3533,5712,0,0,0,1.0,1,1.0,1,1.0,1,0.11547047609134825,65
4704,2,9247,3535,5712,0,0,0,1.0,1,1.0,1,1.0,1,0.13669189179308935,64
4705,8,9255,3537,5718,0,0,0,1.0,1,1.0,1,1.0,1,0.16287909899446268,65
4706,3,9258,3538,5720,0,0,0,1.0,1,1.0,1,1.0,1,0.19904609530125056,65
4707,6,9264,3538,5726,0,0,0,1.0,1,1.0,1,1.0,1,0.1796482813235892,63
4708,3,9267,3539,5728,0,0,0,1.0,1,1.0,1,1.0,1,0.15537560859955798,62
4709,6,9273,3541,5732,0,0,0,1.0,1,1.0,1,1.0,1,0.14010400987602856,61
4710,0,9273,3541,5732,0,0,0,1.0,1,1.0,1,1.0,1,0.13479061163495235,60
4711,3,9276,3542,5734,0,0,0,1.0,1,1.0,1,1.0,1,0.11067016345550212,59
4712,1,9277,3542,5735,0,0,0,1.0,1,1.0,1,1.0,1,0.11268193626803251,58
4713,0,9277,3542,5735,0,0,0,1.0,1,1.0,1,1.0,1,0.11268193626803251,58
4714,1,9278,3542,5736,0,0,0,1.0,1,1.0,1,1.0,1,0.10147487749612358,57
4715,0,9278,3542,5736,0,0,0,1.0,1,1.0,1,1.0,1,0.12184387215669268,57
4716,2,9280,3543,5737,0,0,0,1.0,1,1.0,1,1.0,1,0.1416901728559735,55
4717,6,9286,3544,5742,0,0,0,1.0,1,1.0,1,1.0,1,0.06634134663493794,57
4718,1,9287,3544,5743,0,0,0,1.0,1,1.0,1,1.0,1,0.06346055926539682,56
4719,2,9289,3545,5744,0,0,0,1.0,1,1.0,1,1.0,1,0.09532704824853597,56
4720,2,9291,3545,5746,0,0,0,1.0,1,1.0,1,1.0,1,0.07906726595523289,57
4721,0,9291,3545,5746,0,0,0,1.0,1,1.0,1,1.0,1,0.07906726595523289,57
4722,1,9292,3546,5746,0,0,0,1.0,1,1.0,1,1.0,1,0.07669968619542844,57
4723,1,9293,3546,5747,0,0,0,1.0,1,1.0,1,1.0,1,0.077624657314106,57
4724,0,9293,3546,5747,0,0,0,1.0,1,1.0,1,1.0,1,0.07947684992587668,57
4725,1,9294,3547,5747,0,0,0,1.0,1,1.0,1,1.0,1,0.10693076639006442,57
4726,3,9297,3550,5747,0,0,0,1.0,1,1.0,1,1.0,1,0.14672488099136421,57
4727,2,9299,3550,5749,0,0,0,1.0,1,1.0,1,1.0,1,0.14281424427147313,56
4728,0,9299,3550,5749,0,0,0,1.0,1,1.0,1,1.0,1,0.140113773691657,57
4729,0,9299,3550,5749,0,0,0,1.0,1,1.0,1,1.0,1,0.15245662732791534,56
4730,1,9300,3551,5749,0,0,0,1.0,1,1.0,1,1.0,1,0.19842921541756492,54
4731,4,9304,3552,5752,0,0,0,1.0,1,1.0,1,1.0,1,0.16972002281995643,54
4732,2,9306,3553,5753,0,0,0,1.0,1,1.0,1,1.0,1,0.1835502922387168,54
4733,2,9308,3554,5754,0,0,0,1.0,1,1.0,1,1.0,1,0.18601777752963367,55
4734,4,9312,3556,5756,0,0,0,1.0,1,1.0,1,1.0,1,0.23643201620332813,56
4735,4,9316,3557,5759,0,0,0,1.0,1,1.0,1,1.0,1,0.2148967952809716,56
4736,1,9317,3558,5759,0,0,0,1.0,1,1.0,1,1.0,1,0.2171691875676969,58
4737,2,9319,3558,5761,0,0,0,1.0,1,1.0,1,1.0,1,0.20117467739634914,59
4738,3,9322,3560,5762,0,0,0,1.0,1,1.0,1,1.0,1,0.2501596209290709,60
4739,3,9325,3560,5765,0,0,0,1.0,1,1.0,1,1.0,1,0.22824986192979257,60
4740,0,9325,3560,5765,0,0,0,1.0,1,1.0,1,1.0,1,0.22824986192979257,60
4741,5,9330,3561,5769,0,0,0,1.0,1,1.0,1,1.0,1,0.18916307206445507,61
4742,5,9335,3564,5771,0,0,0,1.0,1,1.0,1,1.0,1,0.21076588067783078,61
4743,1,9336,3564,5772,0,0,0,1.0,1,1.0,1,1.0,1,0.1950777287234339,60
4744,3,9339,3565,5774,0,0,0,1.0,1,1.0,1,1.0,1,0.17148241727108593,60
4745,2,9341,3566,5775,0,0,0,1.0,1,1.0,1,1.0,1,0.1591074755545954,59
4746,2,9343,3568,5775,0,0,0,1.0,1,1.0,1,1.0,1,0.16722921728858264,59
4747,3,9346,3570,5776,0,0,0,1.0,1,1.0,1,1.0,1,0.1430082638608346,58
4748,1,9347,3570,5777,0,0,0,1.0,1,1.0,1,1.0,1,0.12285677401480151,58
4749,3,9350,3571,5779,0,0,0,1.0,1,1.0,1,1.0,1,0.11062103525384295,58
4750,2,9352,3572,5780,0,0,0,1.0,1,1.0,1,1.0,1,0.09601284244188128,56
4751,1,9353,3573,5780,0,0,0,1.0,1,1.0,1,1.0,1,0.11408924029848859,58
4752,2,9355,3574,5781,0,0,0,1.0,1,1.0,1,1.0,1,0.09689920926010644,55
4753,0,9355,3574,5781,0,0,0,1.0,1,1.0,1,1.0,1,0.09689920926010644,55
4754,0,9355,3574,5781,0,0,0,1.0,1,1.0,1,1.0,1,0.10612485456002833,54
4755,3,9358,3575,5783,0,0,0,1.0,1,1.0,1,1.0,1,0.0784028943896924,54
4756,2,9360,3576,5784,0,0,0,1.0,1,1.0,1,1.0,1,0.07431227849202449,54
4757,0,9360,3576,5784,0,0,0,1.0,1,1.0,1,1.0,1,0.08558375949337384,53
4758,1,9361,3576,5785,0,0,0,1.0,1,1.0,1,1.0,1,0.06242269474565703,53
4759,0,9361,3576,5785,0,0,0,1.0,1,1.0,1,1.0,1,0.06242269474565703,53
4760,1,9362,3577,5785,0,0,0,1.0,1,1.0,1,1.0,1,0.10203533540302875,53
4761,4,9366,3580,5786,0,0,0,1.0,1,1.0,1,1.0,1,0.15924944508033367,52
4762,4,9370,3582,5788,0,0,0,1.0,1,1.0,1,1.0,1,0.1947657504606035,54
4763,5,9375,3582,5793,0,0,0,1.0,1,1.0,1,1.0,1,0.15098634082849724,54
4764,2,9377,3583,5794,0,0,0,1.0,1,1.0,1,1.0,1,0.15868346231982733,55
4765,3,9380,3584,5796,0,0,0,1.0,1,1.0,1,1.0,1,0.1731319904944231,56
4766,2,9382,3585,5797,0,0,0,1.0,1,1.0,1,1.0,1,0.1525803526040326,58
4767,1,9383,3585,5798,0,0,0,1.0,1,1.0,1,1.0,1,0.14299930681283682,59
4768,1,9384,3586,5798,0,0,0,1.0,1,1.0,1,1.0,1,0.13824614276322078,60
4769,0,9384,3586,5798,0,0,0,1.0,1,1.0,1,1.0,1,0.1401071562616891,59
4770,1,9385,3586,5799,0,0,0,1.0,1,1.0,1,1.0,1,0.1389031990018415,60
4771,0,9385,3586,5799,0,0,0,1.0,1,1.0,1,1.0,1,0.15516105485971024,59
4772,1,9386,3587,5799,0,0,0,1.0,1,1.0,1,1.0,1,0.14963047121818354,59
4773,1,9387,3587,5800,0,0,0,1.0,1,1.0,1,1.0,1,0.12324966006611139,60
4774,0,9387,3587,5800,0,0,0,1.0,1,1.0,1,1.0,1,0.12324966006611139,60
4775,3,9390,3588,5802,0,0,0,1.0,1,1.0,1,1.0,1,0.11669232440154875,62
4776,1,9391,3588,5803,0,0,0,1.0,1,1.0,1,1.0,1,0.09581122838963782,63
4777,0,9391,3588,5803,0,0,0,1.0,1,1.0,1,1.0,1,0.09581122838963782,63
4778,2,9393,3589,5804,0,0,0,1.0,1,1.0,1,1.0,1,0.10187618370127613,63
4779,1,9394,3590,5804,0,0,0,1.0,1,1.0,1,1.0,1,0.10333729981672506,63
4780,2,9396,3590,5806,0,0,0,1.0,1,1.0,1,1.0,1,0.09284745784131879,65
4781,2,9398,3590,5808,0,0,0,1.0,1,1.0,1,1.0,1,0.08040678302183055,64
4782,0,9398,3590,5808,0,0,0,1.0,1,1.0,1,1.0,1,0.09271775408505044,65
4783,3,9401,3591,5810,0,0,0,1.0,1,1.0,1,1.0,1,0.07234607809185765,66
4784,4,9405,3595,5810,0,0,0,1.0,1,1.0,1,1.0,1,0.1145213233510153,64
4785,8,9413,3598,5815,0,0,0,1.0,1,1.0,1,1.0,1,0.08739609541376032,65
4786,6,9419,3601,5818,0,0,0,1.0,1,1.0,1,1.0,1,0.11098146340732486,66
4787,3,9422,3602,5820,0,0,0,1.0,1,1.0,1,1.0,1,0.06514410077719741,63
4788,3,9425,3604,5821,0,0,0,1.0,1,1.0,1,1.0,1,0.08738623931734608,63
4789,2,9427,3606,5821,0,0,0,1.0,1,1.0,1,1.0,1,0.08424190786976814,60
4790,3,9430,3608,5822,0,0,0,1.0,1,1.0,1,1.0,1,0.07532241129317388,61
4791,7,9437,3612,5825,0,0,0,1.0,1,1.0,1,1.0,1,0.06402297411216346,59
4792,2,9439,3614,5825,0,0,0,1.0,1,1.0,1,1.0,1,0.08120977164231259,59
4793,3,9442,3615,5827,0,0,0,1.0,1,1.0,1,1.0,1,0.0804029692082276,61
4794,2,9444,3616,5828,0,0,0,1.0,1,1.0,1,1.0,1,0.08339687986872484,60
4795,4,9448,3616,5832,0,0,0,1.0,1,1.0,1,1.0,1,0.07997169659702044,61
4796,3,9451,3618,5833,0,0,0,1.0,1,1.0,1,1.0,1,0.09683560350644513,60
4797,2,9453,3619,5834,0,0,0,1.0,1,1.0,1,1.0,1,0.08570889968299071,61
4798,3,9456,3620,5836,0,0,0,1.0,1,1.0,1,1.0,1,0.06759787895376686,61
4799,1,9457,3620,5837,0,0,0,1.0,1,1.0,1,1.0,1,0.0701630869463326,59
4800,1,9458,3621,5837,0,0,0,1.0,1,1.0,1,1.0,1,0.1145636143506094,57
4801,3,9461,3621,5840,0,0,0,1.0,1,1.0,1,1.0,1,0.08017279401229392,58
4802,2,9463,3621,5842,0,0,0,1.0,1,1.0,1,1.0,1,0.08744901078231421,56
4803,5,9468,3624,5844,0,0,0,1.0,1,1.0,1,1.0,1,0.11300252472269878,57
4804,0,9468,3624,5844,0,0,0,1.0,1,1.0,1,1.0,1,0.11551533541733412,55
4805,7,9475,3625,5850,0,0,0,1.0,1,1.0,1,1.0,1,0.05638785280228752,56
4806,2,9477,3626,5851,0,0,0,1.0,1,1.0,1,1.0,1,0.11750879843852895,55
4807,3,9480,3626,5854,0,0,0,1.0,1,1.0,1,1.0,1,0.07921416693913651,53
4808,5,9485,3629,5856,0,0,0,1.0,1,1.0,1,1.0,1,0.11392122144873643,54
4809,3,9488,3629,5859,0,0,0,1.0,1,1.0,1,1.0,1,0.09818508922752564,53
4810,1,9489,3629,5860,0,0,0,1.0,1,1.0,1,1.0,1,0.09361884981298198,53
4811,2,9491,3630,5861,0,0,0,1.0,1,1.0,1,1.0,1,0.053004338221215995,54
4812,1,9492,3631,5861,0,0,0,1.0,1,1.0,1,1.0,1,0.0702469288264149,54
4813,0,9492,3631,5861,0,0,0,1.0,1,1.0,1,1.0,1,0.07234233562396802,55
4814,1,9493,3632,5861,0,0,0,1.0,1,1.0,1,1.0,1,0.07958744756251836,55
4815,1,9494,3632,5862,0,0,0,1.0,1,1.0,1,1.0,1,0.07724079854564606,56
4816,1,9495,3633,5862,0,0,0,1.0,1,1.0,1,1.0,1,0.08301098075819015,56
4817,4,9499,3635,5864,0,0,0,1.0,1,1.0,1,1.0,1,0.08896548085819567,58
4818,3,9502,3637,5865,0,0,0,1.0,1,1.0,1,1.0,1,0.13852856557075158,58
4819,3,9505,3638,5867,0,0,0,1.0,1,1.0,1,1.0,1,0.1407107005949336,58
4820,1,9506,3638,5868,0,0,0,1.0,1,1.0,1,1.0,1,0.1319020307917158,58
4821,4,9510,3638,5872,0,0,0,1.0,1,1.0,1,1.0,1,0.09715831318136679,58
4822,1,9511,3639,5872,0,0,0,1.0,1,1.0,1,1.0,1,0.12063425976475467,58
4823,4,9515,3640,5875,0,0,0,1.0,1,1.0,1,1.0,1,0.08933836548992329,57
4824,1,9516,3640,5876,0,0,0,1.0,1,1.0,1,1.0,1,0.09897402373355228,56
4825,2,9518,3640,5878,0,0,0,1.0,1,1.0,1,1.0,1,0.12503867322720294,57
4826,1,9519,3641,5878,0,0,0,1.0,1,1.0,1,1.0,1,0.12750360269013122,57
4827,1,9520,3641,5879,0,0,0,1.0,1,1.0,1,1.0,1,0.1450916656634454,56
4828,1,9521,3642,5879,0,0,0,1.0,1,1.0,1,1.0,1,0.13061742778994942,57
4829,1,9522,3643,5879,0,0,0,1.0,1,1.0,1,1.0,1,0.1456592955759469,56
4830,2,9524,3644,5880,0,0,0,1.0,1,1.0,1,1.0,1,0.12647111371158853,57
4831,5,9529,3646,5883,0,0,0,1.0,1,1.0,1,1.0,1,0.15049905983294018,57
4832,0,9529,3646,5883,0,0,0,1.0,1,1.0,1,1.0,1,0.1613283684129412,55
4833,5,9534,3647,5887,0,0,0,1.0,1,1.0,1,1.0,1,0.12301950870941074,55
4834,0,9534,3647,5887,0,0,0,1.0,1,1.0,1,1.0,1,0.12399994022098386,55
4835,3,9537,3647,5890,0,0,0,1.0,1,1.0,1,1.0,1,0.12024710420771537,55
4836,0,9537,3647,5890,0,0,0,1.0,1,1.0,1,1.0,1,0.12024710420771537,55
4837,4,9541,3649,5892,0,0,0,1.0,1,1.0,1,1.0,1,0.13641628826882132,53
4838,2,9543,3650,5893,0,0,0,1.0,1,1.0,1,1.0,1,0.12756857364810342,54
4839,5,9548,3653,5895,0,0,0,1.0,1,1.0,1,1.0,1,0.11541196906613917,53
4840,5,9553,3655,5898,0,0,0,1.0,1,1.0,1,1.0,1,0.13081152938935828,52
4841,2,9555,3657,5898,0,0,0,1.0,1,1.0,1,1.0,1,0.16155313996109472,51
4842,3,9558,3659,5899,0,0,0,1.0,1,1.0,1,1.0,1,0.17034354849902766,50
4843,7,9565,3660,5905,0,0,0,1.0,1,1.0,1,1.0,1,0.11867161211195892,51
4844,2,9567,3660,5907,0,0,0,1.0,1,1.0,1,1.0,1,0.09705033210417693,50
4845,4,9571,3662,5909,0,0,0,1.0,1,1.0,1,1.0,1,0.10865371900976196,49
4846,1,9572,3663,5909,0,0,0,1.0,1,1.0,1,1.0,1,0.12354158330341905,49
4847,9,9581,3663,5918,0,0,0,1.0,1,1.0,1,1.0,1,0.10263162271567788,48
4848,5,9586,3664,5922,0,0,0,1.0,1,1.0,1,1.0,1,0.10958358537988203,48
4849,2,9588,3665,5923,0,0,0,1.0,1,1.0,1,1.0,1,0.10088408478669555,48
4850,2,9590,3665,5925,0,0,0,1.0,1,1.0,1,1.0,1,0.08900926387242508,49
4851,1,9591,3666,5925,0,0,0,1.0,1,1.0,1,1.0,1,0.08341753487826743,49
4852,0,9591,3666,5925,0,0,0,1.0,1,1.0,1,1.0,1,0.08982408309973659,49
4853,1,9592,3667,5925,0,0,0,1.0,1,1.0,1,1.0,1,0.12693646843450485,50
4854,0,9592,3667,5925,0,0,0,1.0,1,1.0,1,1.0,1,0.1360912728661749,51
4855,0,9592,3667,5925,0,0,0,1.0,1,1.0,1,1.0,1,0.1360912728661749,51
4856,0,9592,3667,5925,0,0,0,1.0,1,1.0,1,1.0,1,0.14573579009521817,50
4857,3,9595,3667,5928,0,0,0,1.0,1,1.0,1,1.0,1,0.10015449605551545,51
4858,0,9595,3667,5928,0,0,0,1.0,1,1.0,1,1.0,1,0.09898314602106267,51
4859,2,9597,3667,5930,0,0,0,1.0,1,1.0,1,1.0,1,0.09615949975330487,52
4860,0,9597,3667,5930,0,0,0,1.0,1,1.0,1,1.0,1,0.09615949975330487,52
4861,0,9597,3667,5930,0,0,0,1.0,1,1.0,1,1.0,1,0.11315872491054992,53
4862,3,9600,3670,5930,0,0,0,1.0,1,1.0,1,1.0,1,0.16495359499061815,53
4863,2,9602,3670,5932,0,0,0,1.0,1,1.0,1,1.0,1,0.0963849661685486,51
4864,2,9604,3671,5933,0,0,0,1.0,1,1.0,1,1.0,1,0.12595456812095815,53
4865,2,9606,3671,5935,0,0,0,1.0,1,1.0,1,1.0,1,0.09036944675772204,52
4866,1,9607,3671,5936,0,0,0,1.0,1,1.0,1,1.0,1,0.10351041598764088,53
4867,2,9609,3672,5937,0,0,0,1.0,1,1.0,1,1.0,1,0.059517940027534764,51
4868,1,9610,3673,5937,0,0,0,1.0,1,1.0,1,1.0,1,0.0872376747529667,53
4869,1,9611,3674,5937,0,0,0,1.0,1,1.0,1,1.0,1,0.1101587233205794,53
4870,6,9617,3676,5941,0,0,0,1.0,1,1.0,1,1.0,1,0.09228286270003266,55
4871,2,9619,3677,5942,0,0,0,1.0,1,1.0,1,1.0,1,0.079180654508752,55
4872,2,9621,3678,5943,0,0,0,1.0,1,1.0,1,1.0,1,0.10678137857106995,56
4873,2,9623,3679,5944,0,0,0,1.0,1,1.0,1,1.0,1,0.09482544599874232,56
4874,5,9628,3681,5947,0,0,0,1.0,1,1.0,1,1.0,1,0.11112601586202606,58
4875,5,9633,3681,5952,0,0,0,1.0,1,1.0,1,1.0,1,0.06244382268290669,56
4876,4,9637,3683,5954,0,0,0,1.0,1,1.0,1,1.0,1,0.09720053793387691,56
4877,3,9640,3683,5957,0,0,0,1.0,1,1.0,1,1.0,1,0.07984002573888119,54
4878,0,9640,3683,5957,0,0,0,1.0,1,1.0,1,1.0,1,0.07984002573888119,54
4879,8,9648,3688,5960,0,0,0,1.0,1,1.0,1,1.0,1,0.11010203794815707,54
4880,2,9650,3688,5962,0,0,0,1.0,1,1.0,1,1.0,1,0.13351861281740446,53
4881,0,9650,3688,5962,0,0,0,1.0,1,1.0,1,1.0,1,0.12948633857759506,54
4882,1,9651,3689,5962,0,0,0,1.0,1,1.0,1,1.0,1,0.15846169736670146,52
4883,3,9654,3689,5965,0,0,0,1.0,1,1.0,1,1.0,1,0.1394650532073848,54
4884,0,9654,3689,5965,0,0,0,1.0,1,1.0,1,1.0,1,0.15136353944459208,52
4885,2,9656,3690,5966,0,0,0,1.0,1,1.0,1,1.0,1,0.17012933442945186,51
4886,2,9658,3690,5968,0,0,0,1.0,1,1.0,1,1.0,1,0.15503938522947883,50
4887,3,9661,3691,5970,0,0,0,1.0,1,1.0,1,1.0,1,0.15461450653458014,49
4888,0,9661,3691,5970,0,0,0,1.0,1,1.0,1,1.0,1,0.1691586054748341,48
4889,0,9661,3691,5970,0,0,0,1.0,1,1.0,1,1.0,1,0.1691586054748341,48
4890,0,9661,3691,5970,0,0,0,1.0,1,1.0,1,1.0,1,0.1691586054748341,48
4891,1,9662,3692,5970,0,0,0,1.0,1,1.0,1,1.0,1,0.19844135346464742,49
4892,3,9665,3692,5973,0,0,0,1.0,1,1.0,1,1.0,1,0.17544927317829564,51
4893,3,9668,3692,5976,0,0,0,1.0,1,1.0,1,1.0,1,0.14305088357401152,51
4894,1,9669,3692,5977,0,0,0,1.0,1,1.0,1,1.0,1,0.15282218445174947,52
4895,2,9671,3692,5979,0,0,0,1.0,1,1.0,1,1.0,1,0.11268144287507988,52
4896,2,9673,3692,5981,0,0,0,1.0,1,1.0,1,1.0,1,0.08471321495258056,51
4897,0,9673,3692,5981,0,0,0,1.0,1,1.0,1,1.0,1,0.08503364939290889,52
4898,0,9673,3692,5981,0,0,0,1.0,1,1.0,1,1.0,1,0.08503364939290889,52
4899,1,9674,3692,5982,0,0,0,1.0,1,1.0,1,1.0,1,0.0786942460256272,53
4900,1,9675,3692,5983,0,0,0,1.0,1,1.0,1,1.0,1,0.07147300421413538,54
4901,2,9677,3694,5983,0,0,0,1.0,1,1.0,1,1.0,1,0.09361134669241422,54
4902,0,9677,3694,5983,0,0,0,1.0,1,1.0,1,1.0,1,0.09717850155673671,55
4903,4,9681,3695,5986,0,0,0,1.0,1,1.0,1,1.0,1,0.0964901980511156,56
4904,2,9683,3697,5986,0,0,0,1.0,1,1.0,1,1.0,1,0.1261305653292181,55
4905,2,9685,3697,5988,0,0,0,1.0,1,1.0,1,1.0,1,0.07829450115326696,54
4906,5,9690,3699,5991,0,0,0,1.0,1,1.0,1,1.0,1,0.112899454783867,54
4907,3,9693,3699,5994,0,0,0,1.0,1,1.0,1,1.0,1,0.06869062409589942,54
4908,1,9694,3699,5995,0,0,0,1.0,1,1.0,1,1.0,1,0.048531606337763135,53
4909,1,9695,3700,5995,0,0,0,1.0,1,1.0,1,1.0,1,0.08104311107094399,54
4910,0,9695,3700,5995,0,0,0,1.0,1,1.0,1,1.0,1,0.09203893632199127,55
4911,4,9699,3701,5998,0,0,0,1.0,1,1.0,1,1.0,1,0.07994290800795638,57
4912,2,9701,3703,5998,0,0,0,1.0,1,1.0,1,1.0,1,0.12372215514722515,57
4913,3,9704,3703,6001,0,0,0,1.0,1,1.0,1,1.0,1,0.08790442005470858,56
4914,0,9704,3703,6001,0,0,0,1.0,1,1.0,1,1.0,1,0.08790442005470858,56
4915,2,9706,3704,6002,0,0,0,1.0,1,1.0,1,1.0,1,0.06713454902407238,56
4916,0,9706,3704,6002,0,0,0,1.0,1,1.0,1,1.0,1,0.08492473439100823,54
4917,1,9707,3704,6003,0,0,0,1.0,1,1.0,1,1.0,1,0.08801722405391137,53
4918,0,9707,3704,6003,0,0,0,1.0,1,1.0,1,1.0,1,0.09701847737730998,52
4919,1,9708,3705,6003,0,0,0,1.0,1,1.0,1,1.0,1,0.15085290762250364,49
4920,0,9708,3705,6003,0,0,0,1.0,1,1.0,1,1.0,1,0.15085290762250364,49
4921,3,9711,3707,6004,0,0,0,1.0,1,1.0,1,1.0,1,0.18283220966784558,50
4922,1,9712,3707,6005,0,0,0,1.0,1,1.0,1,1.0,1,0.17859617369938782,50
4923,2,9714,3708,6006,0,0,0,1.0,1,1.0,1,1.0,1,0.14282316393480077,52
4924,3,9717,3709,6008,0,0,0,1.0,1,1.0,1,1.0,1,0.1664250732531561,53
4925,6,9723,3710,6013,0,0,0,1.0,1,1.0,1,1.0,1,0.09627259356230049,54
4926,2,9725,3710,6015,0,0,0,1.0,1,1.0,1,1.0,1,0.09627259356230049,54
4927,2,9727,3712,6015,0,0,0,1.0,1,1.0,1,1.0,1,0.08898874042643905,54
4928,0,9727,3712,6015,0,0,0,1.0,1,1.0,1,1.0,1,0.08898874042643905,54
4929,1,9728,3712,6016,0,0,0,1.0,1,1.0,1,1.0,1,0.08734994216776364,55
4930,3,9731,3713,6018,0,0,0,1.0,1,1.0,1,1.0,1,0.12327827479510013,58
4931,0,9731,3713,6018,0,0,0,1.0,1,1.0,1,1.0,1,0.12327827479510013,58
4932,1,9732,3713,6019,0,0,0,1.0,1,1.0,1,1.0,1,0.13178131743428564,59
4933,0,9732,3713,6019,0,0,0,1.0,1,1.0,1,1.0,1,0.13178131743428564,59
4934,1,9733,3714,6019,0,0,0,1.0,1,1.0,1,1.0,1,0.13488648894372987,59
4935,3,9736,3715,6021,0,0,0,1.0,1,1.0,1,1.0,1,0.13118707418390763,59
4936,1,9737,3716,6021,0,0,0,1.0,1,1.0,1,1.0,1,0.16020536938972285,59
4937,4,9741,3716,6025,0,0,0,1.0,1,1.0,1,1.0,1,0.13671383038985815,61
4938,3,9744,3716,6028,0,0,0,1.0,1,1.0,1,1.0,1,0.12136550755558902,62
4939,1,9745,3716,6029,0,0,0,1.0,1,1.0,1,1.0,1,0.11199153482048761,63
4940,1,9746,3716,6030,0,0,0,1.0,1,1.0,1,1.0,1,0.12244092925928306,65
4941,1,9747,3717,6030,0,0,0,1.0,1,1.0,1,1.0,1,0.12600513091963175,65
4942,6,9753,3719,6034,0,0,0,1.0,1,1.0,1,1.0,1,0.12145603887345627,67
4943,6,9759,3720,6039,0,0,0,1.0,1,1.0,1,1.0,1,0.10280662006471264,66
4944,4,9763,3723,6040,0,0,0,1.0,1,1.0,1,1.0,1,0.1251132601553481,63
4945,7,9770,3724,6046,0,0,0,1.0,1,1.0,1,1.0,1,0.0961293270961336,61
4946,6,9776,3726,6050,0,0,0,1.0,1,1.0,1,1.0,1,0.10558588969083176,60
4947,1,9777,3726,6051,0,0,0,1.0,1,1.0,1,1.0,1,0.05024325865721434,58
4948,2,9779,3727,6052,0,0,0,1.0,1,1.0,1,1.0,1,0.07302395111541156,57
4949,3,9782,3729,6053,0,0,0,1.0,1,1.0,1,1.0,1,0.06780197754903276,56
4950,0,9782,3729,6053,0,0,0,1.0,1,1.0,1,1.0,1,0.0803723233116369,57
4951,3,9785,3730,6055,0,0,0,1.0,1,1.0,1,1.0,1,0.08446793944216348,55
4952,5,9790,3733,6057,0,0,0,1.0,1,1.0,1,1.0,1,0.13707172620010705,55
4953,4,9794,3734,6060,0,0,0,1.0,1,1.0,1,1.0,1,0.04997939141098827,54
4954,3,9797,3735,6062,0,0,0,1.0,1,1.0,1,1.0,1,0.06650458682369888,54
4955,0,9797,3735,6062,0,0,0,1.0,1,1.0,1,1.0,1,0.060024902085206104,52
4956,0,9797,3735,6062,0,0,0,1.0,1,1.0,1,1.0,1,0.060024902085206104,52
4957,1,9798,3735,6063,0,0,0,1.0,1,1.0,1,1.0,1,0.06372076891554254,53
4958,0,9798,3735,6063,0,0,0,1.0,1,1.0,1,1.0,1,0.06156404879012774,52
4959,1,9799,3736,6063,0,0,0,1.0,1,1.0,1,1.0,1,0.09391525569376084,51
4960,1,9800,3736,6064,0,0,0,1.0,1,1.0,1,1.0,1,0.08575034189350393,53
4961,1,9801,3737,6064,0,0,0,1.0,1,1.0,1,1.0,1,0.05882092318697421,53
4962,0,9801,3737,6064,0,0,0,1.0,1,1.0,1,1.0,1,0.07409118552276936,55
4963,0,9801,3737,6064,0,0,0,1.0,1,1.0,1,1.0,1,0.06042436863964363,54
4964,1,9802,3738,6064,0,0,0,1.0,1,1.0,1,1.0,1,0.08748341876451936,54
4965,4,9806,3740,6066,0,0,0,1.0,1,1.0,1,1.0,1,0.0716129873443435,54
4966,2,9808,3742,6066,0,0,0,1.0,1,1.0,1,1.0,1,0.0860427592276363,54
4967,4,9812,3744,6068,0,0,0,1.0,1,1.0,1,1.0,1,0.14052640411503214,55
4968,4,9816,3746,6070,0,0,0,1.0,1,1.0,1,1.0,1,0.1346890504526885,55
4969,7,9823,3748,6075,0,0,0,1.0,1,1.0,1,1.0,1,0.10815126309531738,57
4970,1,9824,3748,6076,0,0,0,1.0,1,1.0,1,1.0,1,0.12511981803887126,56
4971,3,9827,3749,6078,0,0,0,1.0,1,1.0,1,1.0,1,0.1158924869272186,57
4972,2,9829,3750,6079,0,0,0,1.0,1,1.0,1,1.0,1,0.13989917293847193,57
4973,2,9831,3751,6080,0,0,0,1.0,1,1.0,1,1.0,1,0.13837793360029751,60
4974,1,9832,3751,6081,0,0,0,1.0,1,1.0,1,1.0,1,0.12379253121609966,58
4975,5,9837,3752,6085,0,0,0,1.0,1,1.0,1,1.0,1,0.10764167699836033,59
4976,2,9839,3753,6086,0,0,0,1.0,1,1.0,1,1.0,1,0.09746189842585984,59
4977,3,9842,3756,6086,0,0,0,1.0,1,1.0,1,1.0,1,0.11414500861043576,59
4978,0,9842,3756,6086,0,0,0,1.0,1,1.0,1,1.0,1,0.11414500861043576,59
4979,3,9845,3756,6089,0,0,0,1.0,1,1.0,1,1.0,1,0.07735841553412277,61
4980,1,9846,3757,6089,0,0,0,1.0,1,1.0,1,1.0,1,0.1019461397446015,62
4981,2,9848,3757,6091,0,0,0,1.0,1,1.0,1,1.0,1,0.06619529496222974,62
4982,5,9853,3760,6093,0,0,0,1.0,1,1.0,1,1.0,1,0.06856439628663542,63
4983,1,9854,3760,6094,0,0,0,1.0,1,1.0,1,1.0,1,0.05470201232963869,63
4984,0,9854,3760,6094,0,0,0,1.0,1,1.0,1,1.0,1,0.06436588152408754,61
4985,3,9857,3760,6097,0,0,0,1.0,1,1.0,1,1.0,1,0.07181728720280249,59
4986,3,9860,3762,6098,0,0,0,1.0,1,1.0,1,1.0,1,0.10692568260305145,62
4987,2,9862,3763,6099,0,0,0,1.0,1,1.0,1,1.0,1,0.10340077686638414,60
4988,2,9864,3764,6100,0,0,0,1.0,1,1.0,1,1.0,1,0.10108577717903561,59
4989,6,9870,3767,6103,0,0,0,1.0,1,1.0,1,1.0,1,0.09565138722168841,57
4990,2,9872,3768,6104,0,0,0,1.0,1,1.0,1,1.0,1,0.13192990820991618,55
4991,6,9878,3771,6107,0,0,0,1.0,1,1.0,1,1.0,1,0.08421975534713202,54
4992,1,9879,3772,6107,0,0,0,1.0,1,1.0,1,1.0,1,0.13221468007713832,52
4993,0,9879,3772,6107,0,0,0,1.0,1,1.0,1,1.0,1,0.11431365353432713,51
4994,3,9882,3774,6108,0,0,0,1.0,1,1.0,1,1.0,1,0.11825880980641387,49
4995,2,9884,3776,6108,0,0,0,1.0,1,1.0,1,1.0,1,0.12571731541826472,48
4996,5,9889,3779,6110,0,0,0,1.0,1,1.0,1,1.0,1,0.10923091920255468,48
4997,1,9890,3780,6110,0,0,0,1.0,1,1.0,1,1.0,1,0.10433621270115925,46
4998,3,9893,3781,6112,0,0,0,1.0,1,1.0,1,1.0,1,0.10198218064282749,48
4999,6,9899,3783,6116,0,0,0,1.0,1,1.0,1,1.0,1,0.09152972119235678,48
5000,0,9899,3783,6116,0,0,0,1.0,1,1.0,1,1.0,1,0.08413850867410015,47
5001,1,9900,3784,6116,0,0,0,1.0,1,1.0,1,1.0,1,0.11316156615438287,45
5002,2,9902,3786,6116,0,0,0,1.0,1,1.0,1,1.0,1,0.14644651366348144,46
5003,1,9903,3786,6117,0,0,0,1.0,1,1.0,1,1.0,1,0.16022524921859632,46
5004,3,9906,3788,6118,0,0,0,1.0,1,1.0,1,1.0,1,0.16307438993249354,46
5005,1,9907,3788,6119,0,0,0,1.0,1,1.0,1,1.0,1,0.17703459959921483,45
5006,0,9907,3788,6119,0,0,0,1.0,1,1.0,1,1.0,1,0.19654408598487028,45
5007,3,9910,3788,6122,0,0,0,1.0,1,1.0,1,1.0,1,0.1470056162546706,46
5008,0,9910,3788,6122,0,0,0,1.0,1,1.0,1,1.0,1,0.1328726386207627,49
5009,0,9910,3788,6122,0,0,0,1.0,1,1.0,1,1.0,1,0.12873528177008808,49
5010,0,9910,3788,6122,0,0,0,1.0,1,1.0,1,1.0,1,0.12705259502390462,50
5011,0,9910,3788,6122,0,0,0,1.0,1,1.0,1,1.0,1,0.14087860273795053,51
5012,0,9910,3788,6122,0,0,0,1.0,1,1.0,1,1.0,1,0.1500046950765378,52
5013,0,9910,3788,6122,0,0,0,1.0,1,1.0,1,1.0,1,0.1500046950765378,52
5014,0,9910,3788,6122,0,0,0,1.0,1,1.0,1,1.0,1,0.15171489790801054,53
5015,5,9915,3790,6125,0,0,0,1.0,1,1.0,1,1.0,1,0.17729522041584925,54
5016,7,9922,3791,6131,0,0,0,1.0,1,1.0,1,1.0,1,0.1694945030559008,55
5017,2,9924,3791,6133,0,0,0,1.0,1,1.0,1,1.0,1,0.14475380444419575,55
5018,1,9925,3792,6133,0,0,0,1.0,1,1.0,1,1.0,1,0.13331844640947096,56
5019,1,9926,3792,6134,0,0,0,1.0,1,1.0,1,1.0,1,0.12242676066525991,56
5020,1,9927,3793,6134,0,0,0,1.0,1,1.0,1,1.0,1,0.13076471643884235,55
5021,2,9929,3793,6136,0,0,0,1.0,1,1.0,1,1.0,1,0.11579286038168947,56
5022,2,9931,3795,6136,0,0,0,1.0,1,1.0,1,1.0,1,0.15098353173183787,56
5023,3,9934,3795,6139,0,0,0,1.0,1,1.0,1,1.0,1,0.08464051131674914,55
5024,2,9936,3797,6139,0,0,0,1.0,1,1.0,1,1.0,1,0.12103090599358861,55
5025,4,9940,3799,6141,0,0,0,1.0,1,1.0,1,1.0,1,0.10630726696055366,53
5026,3,9943,3802,6141,0,0,0,1.0,1,1.0,1,1.0,1,0.11309538382396045,52
5027,1,9944,3803,6141,0,0,0,1.0,1,1.0,1,1.0,1,0.13693993167265117,51
5028,6,9950,3807,6143,0,0,0,1.0,1,1.0,1,1.0,1,0.1927722982699161,51
5029,3,9953,3809,6144,0,0,0,1.0,1,1.0,1,1.0,1,0.19841771500441036,50
5030,0,9953,3809,6144,0,0,0,1.0,1,1.0,1,1.0,1,0.14700644018389672,49
5031,1,9954,3810,6144,0,0,0,1.0,1,1.0,1,1.0,1,0.15536346062598164,49
5032,2,9956,3811,6145,0,0,0,1.0,1,1.0,1,1.0,1,0.15122492179610217,48
5033,2,9958,3812,6146,0,0,0,1.0,1,1.0,1,1.0,1,0.16168542117976617,50
5034,0,9958,3812,6146,0,0,0,1.0,1,1.0,1,1.0,1,0.14861146420159732,49
5035,4,9962,3814,6148,0,0,0,1.0,1,1.0,1,1.0,1,0.16267783328013177,49
5036,1,9963,3815,6148,0,0,0,1.0,1,1.0,1,1.0,1,0.1504985132362039,47
5037,3,9966,3815,6151,0,0,0,1.0,1,1.0,1,1.0,1,0.10341992555266868,47
5038,1,9967,3815,6152,0,0,0,1.0,1,1.0,1,1.0,1,0.10038767301565568,47
5039,0,9967,3815,6152,0,0,0,1.0,1,1.0,1,1.0,1,0.1032281491225756,48
5040,0,9967,3815,6152,0,0,0,1.0,1,1.0,1,1.0,1,0.1032281491225756,48
5041,0,9967,3815,6152,0,0,0,1.0,1,1.0,1,1.0,1,0.1032281491225756,48
5042,1,9968,3815,6153,0,0,0,1.0,1,1.0,1,1.0,1,0.09133401910883802,50
5043,0,9968,3815,6153,0,0,0,1.0,1,1.0,1,1.0,1,0.09606828438331731,51
5044,0,9968,3815,6153,0,0,0,1.0,1,1.0,1,1.0,1,0.09606828438331731,51
5045,1,9969,3815,6154,0,0,0,1.0,1,1.0,1,1.0,1,0.09854501579659466,52
5046,1,9970,3816,6154,0,0,0,1.0,1,1.0,1,1.0,1,0.11810027882012063,51
5047,2,9972,3817,6155,0,0,0,1.0,1,1.0,1,1.0,1,0.09102758821348857,51
5048,2,9974,3818,6156,0,0,0,1.0,1,1.0,1,1.0,1,0.10820450893786897,52
5049,3,9977,3819,6158,0,0,0,1.0,1,1.0,1,1.0,1,0.11192429198810278,54
5050,4,9981,3819,6162,0,0,0,1.0,1,1.0,1,1.0,1,0.10274078610533197,56
5051,2,9983,3819,6164,0,0,0,1.0,1,1.0,1,1.0,1,0.08134314030844818,55
5052,0,9983,3819,6164,0,0,0,1.0,1,1.0,1,1.0,1,0.08134314030844818,55
5053,2,9985,3820,6165,0,0,0,1.0,1,1.0,1,1.0,1,0.10235833608302859,55
5054,2,9987,3821,6166,0,0,0,1.0,1,1.0,1,1.0,1,0.10428786483623574,55
5055,2,9989,3821,6168,0,0,0,1.0,1,1.0,1,1.0,1,0.0865250464894739,55
5056,0,9989,3821,6168,0,0,0,1.0,1,1.0,1,1.0,1,0.1016310226099405,56
5057,2,9991,3821,6170,0,0,0,1.0,1,1.0,1,1.0,1,0.07816767737648661,58
5058,0,9991,3821,6170,0,0,0,1.0,1,1.0,1,1.0,1,0.09003630789521203,59
5059,2,9993,3821,6172,0,0,0,1.0,1,1.0,1,1.0,1,0.07662977019076997,59
5060,1,9994,3821,6173,0,0,0,1.0,1,1.0,1,1.0,1,0.060571148525728966,59
5061,0,9994,3821,6173,0,0,0,1.0,1,1.0,1,1.0,1,0.08162578616209207,59
5062,3,9997,3824,6173,0,0,0,1.0,1,1.0,1,1.0,1,0.18241315750550308,59
5063,5,10002,3825,6177,0,0,0,1.0,1,1.0,1,1.0,1,0.1619227854255938,59
5064,5,10007,3829,6178,0,0,0,1.0,1,1.0,1,1.0,1,0.1755775546659517,57
5065,5,10012,3831,6181,0,0,0,1.0,1,1.0,1,1.0,1,0.15267396308479933,55
5066,5,10017,3832,6185,0,0,0,1.0,1,1.0,1,1.0,1,0.1885097590230996,55
5067,4,10021,3833,6188,0,0,0,1.0,1,1.0,1,1.0,1,0.13688319667140708,54
5068,2,10023,3833,6190,0,0,0,1.0,1,1.0,1,1.0,1,0.10663803925821298,54
5069,1,10024,3834,6190,0,0,0,1.0,1,1.0,1,1.0,1,0.10039905550566952,54
5070,1,10025,3834,6191,0,0,0,1.0,1,1.0,1,1.0,1,0.10049979240473605,52
5071,4,10029,3836,6193,0,0,0,1.0,1,1.0,1,1.0,1,0.11712003113495563,54
5072,0,10029,3836,6193,0,0,0,1.0,1,1.0,1,1.0,1,0.11051652332123027,52
5073,1,10030,3836,6194,0,0,0,1.0,1,1.0,1,1.0,1,0.10706958343893788,51
5074,4,10034,3837,6197,0,0,0,1.0,1,1.0,1,1.0,1,0.09648186304919701,52
5075,0,10034,3837,6197,0,0,0,1.0,1,1.0,1,1.0,1,0.10197354105357602,53
5076,0,10034,3837,6197,0,0,0,1.0,1,1.0,1,1.0,1,0.10197354105357602,53
5077,3,10037,3838,6199,0,0,0,1.0,1,1.0,1,1.0,1,0.08051819263662341,56
5078,2,10039,3839,6200,0,0,0,1.0,1,1.0,1,1.0,1,0.07552200374766846,55
5079,1,10040,3839,6201,0,0,0,1.0,1,1.0,1,1.0,1,0.07586142903521224,56
5080,0,10040,3839,6201,0,0,0,1.0,1,1.0,1,1.0,1,0.08175770886349194,57
5081,0,10040,3839,6201,0,0,0,1.0,1,1.0,1,1.0,1,0.0848144826780218,58
5082,0,10040,3839,6201,0,0,0,1.0,1,1.0,1,1.0,1,0.0848144826780218,58
5083,0,10040,3839,6201,0,0,0,1.0,1,1.0,1,1.0,1,0.09465716531668635,59
5084,2,10042,3841,6201,0,0,0,1.0,1,1.0,1,1.0,1,0.07846975066759003,59
5085,1,10043,3842,6201,0,0,0,1.0,1,1.0,1,1.0,1,0.09836097219728926,60
5086,2,10045,3843,6202,0,0,0,1.0,1,1.0,1,1.0,1,0.09714628712364788,61
5087,6,10051,3846,6205,0,0,0,1.0,1,1.0,1,1.0,1,0.10758995047777675,62
5088,5,10056,3848,6208,0,0,0,1.0,1,1.0,1,1.0,1,0.07897996081619116,64
5089,2,10058,3849,6209,0,0,0,1.0,1,1.0,1,1.0,1,0.08266608188318558,64
5090,0,10058,3849,6209,0,0,0,1.0,1,1.0,1,1.0,1,0.08266608188318558,64
5091,4,10062,3853,6209,0,0,0,1.0,1,1.0,1,1.0,1,0.16898279012042233,64
5092,2,10064,3855,6209,0,0,0,1.0,1,1.0,1,1.0,1,0.18046363421885367,64
5093,5,10069,3855,6214,0,0,0,1.0,1,1.0,1,1.0,1,0.1161305029714519,64
5094,3,10072,3855,6217,0,0,0,1.0,1,1.0,1,1.0,1,0.11907684453105559,65
5095,7,10079,3856,6223,0,0,0,1.0,1,1.0,1,1.0,1,0.09753133587857402,66
5096,4,10083,3856,6227,0,0,0,1.0,1,1.0,1,1.0,1,0.08850284049800491,66
5097,2,10085,3856,6229,0,0,0,1.0,1,1.0,1,1.0,1,0.0580154658285522,67
5098,2,10087,3857,6230,0,0,0,1.0,1,1.0,1,1.0,1,0.06715358318355248,67
5099,2,10089,3858,6231,0,0,0,1.0,1,1.0,1,1.0,1,0.09339841476216137,70
5100,1,10090,3859,6231,0,0,0,1.0,1,1.0,1,1.0,1,0.1125012009433058,71
5101,3,10093,3859,6234,0,0,0,1.0,1,1.0,1,1.0,1,0.08400419557055487,72
5102,6,10099,3862,6237,0,0,0,1.0,1,1.0,1,1.0,1,0.10588809815400992,72
5103,5,10104,3864,6240,0,0,0,1.0,1,1.0,1,1.0,1,0.08975732156645533,70
5104,5,10109,3866,6243,0,0,0,1.0,1,1.0,1,1.0,1,0.09318392994385412,67
5105,6,10115,3868,6247,0,0,0,1.0,1,1.0,1,1.0,1,0.08245389054621866,66
5106,2,10117,3870,6247,0,0,0,1.0,1,1.0,1,1.0,1,0.15205861747462124,64
5107,8,10125,3873,6252,0,0,0,1.0,1,1.0,1,1.0,1,0.08360046699260244,61
5108,5,10130,3875,6255,0,0,0,1.0,1,1.0,1,1.0,1,0.08178151278758648,57
5109,3,10133,3878,6255,0,0,0,1.0,1,1.0,1,1.0,1,0.08747270748862752,55
5110,1,10134,3879,6255,0,0,0,1.0,1,1.0,1,1.0,1,0.09584196845635155,53
5111,3,10137,3881,6256,0,0,0,1.0,1,1.0,1,1.0,1,0.13154867926966213,52
5112,4,10141,3885,6256,0,0,0,1.0,1,1.0,1,1.0,1,0.13701849057673843,52
5113,7,10148,3886,6262,0,0,0,1.0,1,1.0,1,1.0,1,0.07490634031033003,49
5114,6,10154,3889,6265,0,0,0,1.0,1,1.0,1,1.0,1,0.11655133074405068,49
5115,3,10157,3889,6268,0,0,0,1.0,1,1.0,1,1.0,1,0.1053131067811784,48
5116,2,10159,3890,6269,0,0,0,1.0,1,1.0,1,1.0,1,0.13732129794913572,47
5117,1,10160,3890,6270,0,0,0,1.0,1,1.0,1,1.0,1,0.14169048981729168,48
5118,1,10161,3890,6271,0,0,0,1.0,1,1.0,1,1.0,1,0.09303582931602136,49
5119,0,10161,3890,6271,0,0,0,1.0,1,1.0,1,1.0,1,0.09303582931602136,49
5120,1,10162,3890,6272,0,0,0,1.0,1,1.0,1,1.0,1,0.10008575093161373,48
5121,5,10167,3893,6274,0,0,0,1.0,1,1.0,1,1.0,1,0.10732285841276576,48
5122,2,10169,3894,6275,0,0,0,1.0,1,1.0,1,1.0,1,0.15342375944588815,46
5123,3,10172,3895,6277,0,0,0,1.0,1,1.0,1,1.0,1,0.13156118286885354,46
5124,1,10173,3895,6278,0,0,0,1.0,1,1.0,1,1.0,1,0.11582609155260641,47
5125,8,10181,3896,6285,0,0,0,1.0,1,1.0,1,1.0,1,0.1326593722349246,49
5126,0,10181,3896,6285,0,0,0,1.0,1,1.0,1,1.0,1,0.1326593722349246,49
5127,3,10184,3897,6287,0,0,0,1.0,1,1.0,1,1.0,1,0.12695243709603674,51
5128,3,10187,3898,6289,0,0,0,1.0,1,1.0,1,1.0,1,0.16499405264146583,53
5129,6,10193,3899,6294,0,0,0,1.0,1,1.0,1,1.0,1,0.11023272029746117,55
5130,0,10193,3899,6294,0,0,0,1.0,1,1.0,1,1.0,1,0.11023272029746117,55
5131,1,10194,3899,6295,0,0,0,1.0,1,1.0,1,1.0,1,0.09925516517385552,55
5132,0,10194,3899,6295,0,0,0,1.0,1,1.0,1,1.0,1,0.09925516517385552,55
5133,2,10196,3899,6297,0,0,0,1.0,1,1.0,1,1.0,1,0.0874161744060033,56
5134,1,10197,3899,6298,0,0,0,1.0,1,1.0,1,1.0,1,0.09541188842481996,56
5135,1,10198,3900,6298,0,0,0,1.0,1,1.0,1,1.0,1,0.10051432814856655,56
5136,0,10198,3900,6298,0,0,0,1.0,1,1.0,1,1.0,1,0.1121461022142452,55
5137,2,10200,3901,6299,0,0,0,1.0,1,1.0,1,1.0,1,0.11869809195408167,55
5138,3,10203,3901,6302,0,0,0,1.0,1,1.0,1,1.0,1,0.09287803793466262,54
5139,2,10205,3902,6303,0,0,0,1.0,1,1.0,1,1.0,1,0.1018865082138618,54
5140,1,10206,3903,6303,0,0,0,1.0,1,1.0,1,1.0,1,0.09364822472130607,54
5141,2,10208,3905,6303,0,0,0,1.0,1,1.0,1,1.0,1,0.10269920150907971,53
5142,5,10213,3908,6305,0,0,0,1.0,1,1.0,1,1.0,1,0.14708057801905883,55
5143,8,10221,3912,6309,0,0,0,1.0,1,1.0,1,1.0,1,0.09724119959198618,54
5144,6,10227,3914,6313,0,0,0,1.0,1,1.0,1,1.0,1,0.0642514150305161,50
5145,3,10230,3914,6316,0,0,0,1.0,1,1.0,1,1.0,1,0.0326711411805111,51
5146,2,10232,3915,6317,0,0,0,1.0,1,1.0,1,1.0,1,0.03872950370054104,48
5147,2,10234,3917,6317,0,0,0,1.0,1,1.0,1,1.0,1,0.11855757238674527,49
5148,0,10234,3917,6317,0,0,0,1.0,1,1.0,1,1.0,1,0.09445582527503396,47
5149,5,10239,3919,6320,0,0,0,1.0,1,1.0,1,1.0,1,0.13614037988950614,46
5150,5,10244,3922,6322,0,0,0,1.0,1,1.0,1,1.0,1,0.1513604673136857,46
5151,3,10247,3922,6325,0,0,0,1.0,1,1.0,1,1.0,1,0.1425290290431528,45
5152,4,10251,3922,6329,0,0,0,1.0,1,1.0,1,1.0,1,0.131522654487531,45
5153,1,10252,3922,6330,0,0,0,1.0,1,1.0,1,1.0,1,0.13694703027517804,45
5154,3,10255,3923,6332,0,0,0,1.0,1,1.0,1,1.0,1,0.17085732933412404,45
5155,2,10257,3924,6333,0,0,0,1.0,1,1.0,1,1.0,1,0.17958574901865065,44
5156,4,10261,3926,6335,0,0,0,1.0,1,1.0,1,1.0,1,0.16006570257599,44
5157,0,10261,3926,6335,0,0,0,1.0,1,1.0,1,1.0,1,0.16259249788926747,42
5158,2,10263,3927,6336,0,0,0,1.0,1,1.0,1,1.0,1,0.1477746093219634,43
5159,2,10265,3927,6338,0,0,0,1.0,1,1.0,1,1.0,1,0.16391830119354137,43
5160,0,10265,3927,6338,0,0,0,1.0,1,1.0,1,1.0,1,0.16391830119354137,43
5161,1,10266,3927,6339,0,0,0,1.0,1,1.0,1,1.0,1,0.1473154105554171,43
5162,1,10267,3927,6340,0,0,0,1.0,1,1.0,1,1.0,1,0.13481281104744777,44
5163,3,10270,3928,6342,0,0,0,1.0,1,1.0,1,1.0,1,0.12697707478223827,46
5164,1,10271,3928,6343,0,0,0,1.0,1,1.0,1,1.0,1,0.12423347921819741,46
5165,1,10272,3928,6344,0,0,0,1.0,1,1.0,1,1.0,1,0.11499509006693148,46
5166,5,10277,3930,6347,0,0,0,1.0,1,1.0,1,1.0,1,0.11706288478116975,47
5167,2,10279,3930,6349,0,0,0,1.0,1,1.0,1,1.0,1,0.09348016697162198,47
5168,2,10281,3932,6349,0,0,0,1.0,1,1.0,1,1.0,1,0.1252989834128346,47
5169,3,10284,3932,6352,0,0,0,1.0,1,1.0,1,1.0,1,0.09147926432185867,47
5170,1,10285,3933,6352,0,0,0,1.0,1,1.0,1,1.0,1,0.09781640154771916,48
5171,1,10286,3934,6352,0,0,0,1.0,1,1.0,1,1.0,1,0.12111225587506695,48
5172,0,10286,3934,6352,0,0,0,1.0,1,1.0,1,1.0,1,0.10426410936820518,49
5173,0,10286,3934,6352,0,0,0,1.0,1,1.0,1,1.0,1,0.10081616036403497,49
5174,0,10286,3934,6352,0,0,0,1.0,1,1.0,1,1.0,1,0.1146624935260344,52
5175,0,10286,3934,6352,0,0,0,1.0,1,1.0,1,1.0,1,0.09992920056918284,53
5176,2,10288,3934,6354,0,0,0,1.0,1,1.0,1,1.0,1,0.10867449412349187,54
5177,2,10290,3936,6354,0,0,0,1.0,1,1.0,1,1.0,1,0.13582804281494607,54
5178,3,10293,3937,6356,0,0,0,1.0,1,1.0,1,1.0,1,0.13881147986992984,55
5179,2,10295,3938,6357,0,0,0,1.0,1,1.0,1,1.0,1,0.16173821523548604,53
5180,3,10298,3938,6360,0,0,0,1.0,1,1.0,1,1.0,1,0.10891687001720941,52
5181,2,10300,3940,6360,0,0,0,1.0,1,1.0,1,1.0,1,0.0991124303654175,52
5182,2,10302,3942,6360,0,0,0,1.0,1,1.0,1,1.0,1,0.12688267137972728,52
5183,2,10304,3943,6361,0,0,0,1.0,1,1.0,1,1.0,1,0.12447306961635025,52
5184,3,10307,3945,6362,0,0,0,1.0,1,1.0,1,1.0,1,0.14624010839395551,52
5185,2,10309,3946,6363,0,0,0,1.0,1,1.0,1,1.0,1,0.12830293167978624,50
5186,1,10310,3947,6363,0,0,0,1.0,1,1.0,1,1.0,1,0.14765040694120915,48
5187,2,10312,3948,6364,0,0,0,1.0,1,1.0,1,1.0,1,0.16105957195020212,46
5188,0,10312,3948,6364,0,0,0,1.0,1,1.0,1,1.0,1,0.14600800406249614,44
5189,0,10312,3948,6364,0,0,0,1.0,1,1.0,1,1.0,1,0.138459338428505,44
5190,1,10313,3949,6364,0,0,0,1.0,1,1.0,1,1.0,1,0.17826152535900514,45
5191,1,10314,3949,6365,0,0,0,1.0,1,1.0,1,1.0,1,0.1631902843103622,45
5192,3,10317,3950,6367,0,0,0,1.0,1,1.0,1,1.0,1,0.107128759409266,45
5193,0,10317,3950,6367,0,0,0,1.0,1,1.0,1,1.0,1,0.107128759409266,45
5194,0,10317,3950,6367,0,0,0,1.0,1,1.0,1,1.0,1,0.1101037036697897,45
5195,2,10319,3951,6368,0,0,0,1.0,1,1.0,1,1.0,1,0.10994901407999218,46
5196,0,10319,3951,6368,0,0,0,1.0,1,1.0,1,1.0,1,0.10994901407999218,46
5197,1,10320,3952,6368,0,0,0,1.0,1,1.0,1,1.0,1,0.1362901728163614,46
5198,0,10320,3952,6368,0,0,0,1.0,1,1.0,1,1.0,1,0.12459400795410897,47
5199,3,10323,3954,6369,0,0,0,1.0,1,1.0,1,1.0,1,0.14279875033505987,49
5200,1,10324,3954,6370,0,0,0,1.0,1,1.0,1,1.0,1,0.1341143176091491,49
5201,4,10328,3955,6373,0,0,0,1.0,1,1.0,1,1.0,1,0.10960428302316653,50
5202,4,10332,3955,6377,0,0,0,1.0,1,1.0,1,1.0,1,0.1103101511379396,52
5203,2,10334,3955,6379,0,0,0,1.0,1,1.0,1,1.0,1,0.08212301045063033,52
5204,2,10336,3955,6381,0,0,0,1.0,1,1.0,1,1.0,1,0.0668094403655987,54
5205,0,10336,3955,6381,0,0,0,1.0,1,1.0,1,1.0,1,0.0668094403655987,54
5206,0,10336,3955,6381,0,0,0,1.0,1,1.0,1,1.0,1,0.07969172563456531,55
5207,0,10336,3955,6381,0,0,0,1.0,1,1.0,1,1.0,1,0.07583363106283349,54
5208,0,10336,3955,6381,0,0,0,1.0,1,1.0,1,1.0,1,0.07583363106283349,54
5209,0,10336,3955,6381,0,0,0,1.0,1,1.0,1,1.0,1,0.07583363106283349,54
5210,0,10336,3955,6381,0,0,0,1.0,1,1.0,1,1.0,1,0.07583363106283349,54
5211,2,10338,3956,6382,0,0,0,1.0,1,1.0,1,1.0,1,0.10086920622801278,56
5212,1,10339,3957,6382,0,0,0,1.0,1,1.0,1,1.0,1,0.0855973054384255,57
5213,5,10344,3962,6382,0,0,0,1.0,1,1.0,1,1.0,1,0.16233740720556256,57
5214,5,10349,3964,6385,0,0,0,1.0,1,1.0,1,1.0,1,0.19458682183079107,58
5215,3,10352,3964,6388,0,0,0,1.0,1,1.0,1,1.0,1,0.18471475586951572,57
5216,2,10354,3964,6390,0,0,0,1.0,1,1.0,1,1.0,1,0.15674919203083426,57
5217,5,10359,3965,6394,0,0,0,1.0,1,1.0,1,1.0,1,0.1203298250608473,56
5218,5,10364,3965,6399,0,0,0,1.0,1,1.0,1,1.0,1,0.11451936902692235,56
5219,2,10366,3965,6401,0,0,0,1.0,1,1.0,1,1.0,1,0.10847840843021252,54
5220,2,10368,3967,6401,0,0,0,1.0,1,1.0,1,1.0,1,0.14008148569486395,53
5221,0,10368,3967,6401,0,0,0,1.0,1,1.0,1,1.0,1,0.14531730746602295,52
5222,2,10370,3967,6403,0,0,0,1.0,1,1.0,1,1.0,1,0.14317197058068207,52
5223,2,10372,3968,6404,0,0,0,1.0,1,1.0,1,1.0,1,0.12649161217967556,52
5224,2,10374,3969,6405,0,0,0,1.0,1,1.0,1,1.0,1,0.12635494630500568,52
5225,6,10380,3969,6411,0,0,0,1.0,1,1.0,1,1.0,1,0.0990780889994099,50
5226,3,10383,3971,6412,0,0,0,1.0,1,1.0,1,1.0,1,0.12010024817879868,51
5227,1,10384,3971,6413,0,0,0,1.0,1,1.0,1,1.0,1,0.056372489954630685,49
5228,1,10385,3971,6414,0,0,0,1.0,1,1.0,1,1.0,1,0.057231303125382375,48
5229,0,10385,3971,6414,0,0,0,1.0,1,1.0,1,1.0,1,0.042747662186872135,49
5230,0,10385,3971,6414,0,0,0,1.0,1,1.0,1,1.0,1,0.042747662186872135,49
5231,1,10386,3972,6414,0,0,0,1.0,1,1.0,1,1.0,1,0.06175292339007083,49
5232,1,10387,3973,6414,0,0,0,1.0,1,1.0,1,1.0,1,0.07816919411931422,51
5233,2,10389,3974,6415,0,0,0,1.0,1,1.0,1,1.0,1,0.09090757957536195,51
5234,5,10394,3978,6416,0,0,0,1.0,1,1.0,1,1.0,1,0.12175758192570733,52
5235,1,10395,3978,6417,0,0,0,1.0,1,1.0,1,1.0,1,0.10214127757779667,52
5236,1,10396,3978,6418,0,0,0,1.0,1,1.0,1,1.0,1,0.07336807809789803,52
5237,2,10398,3978,6420,0,0,0,1.0,1,1.0,1,1.0,1,0.08282391543519682,53
5238,1,10399,3978,6421,0,0,0,1.0,1,1.0,1,1.0,1,0.08152847353428339,53
5239,0,10399,3978,6421,0,0,0,1.0,1,1.0,1,1.0,1,0.08152847353428339,53
5240,4,10403,3981,6422,0,0,0,1.0,1,1.0,1,1.0,1,0.10387382669106235,55
5241,1,10404,3981,6423,0,0,0,1.0,1,1.0,1,1.0,1,0.09093692874132726,56
5242,2,10406,3983,6423,0,0,0,1.0,1,1.0,1,1.0,1,0.13599900982199953,54
5243,3,10409,3984,6425,0,0,0,1.0,1,1.0,1,1.0,1,0.1437000072663718,55
5244,0,10409,3984,6425,0,0,0,1.0,1,1.0,1,1.0,1,0.1456018759772769,55
5245,0,10409,3984,6425,0,0,0,1.0,1,1.0,1,1.0,1,0.1456018759772769,55
5246,0,10409,3984,6425,0,0,0,1.0,1,1.0,1,1.0,1,0.1687726026984413,55
5247,4,10413,3985,6428,0,0,0,1.0,1,1.0,1,1.0,1,0.12275369473450333,54
5248,4,10417,3986,6431,0,0,0,1.0,1,1.0,1,1.0,1,0.1346063907853458,53
5249,5,10422,3988,6434,0,0,0,1.0,1,1.0,1,1.0,1,0.11066581528598687,55
5250,1,10423,3989,6434,0,0,0,1.0,1,1.0,1,1.0,1,0.1165657644116394,55
5251,4,10427,3990,6437,0,0,0,1.0,1,1.0,1,1.0,1,0.09937190315723889,57
5252,0,10427,3990,6437,0,0,0,1.0,1,1.0,1,1.0,1,0.10710013081458465,58
5253,4,10431,3992,6439,0,0,0,1.0,1,1.0,1,1.0,1,0.1430237859631054,59
5254,1,10432,3992,6440,0,0,0,1.0,1,1.0,1,1.0,1,0.13699319561347859,59
5255,3,10435,3992,6443,0,0,0,1.0,1,1.0,1,1.0,1,0.10377709765757621,58
5256,3,10438,3994,6444,0,0,0,1.0,1,1.0,1,1.0,1,0.11726271943975197,59
5257,2,10440,3995,6445,0,0,0,1.0,1,1.0,1,1.0,1,0.12750281258747864,58
5258,1,10441,3996,6445,0,0,0,1.0,1,1.0,1,1.0,1,0.17853963299306164,56
5259,2,10443,3996,6447,0,0,0,1.0,1,1.0,1,1.0,1,0.15778495503042747,56
5260,0,10443,3996,6447,0,0,0,1.0,1,1.0,1,1.0,1,0.15400044281318462,55
5261,3,10446,3997,6449,0,0,0,1.0,1,1.0,1,1.0,1,0.14168723607612163,54
5262,4,10450,3998,6452,0,0,0,1.0,1,1.0,1,1.0,1,0.10536416092046604,54
5263,3,10453,4000,6453,0,0,0,1.0,1,1.0,1,1.0,1,0.11033527156064477,53
5264,0,10453,4000,6453,0,0,0,1.0,1,1.0,1,1.0,1,0.08640754549965536,51
5265,1,10454,4001,6453,0,0,0,1.0,1,1.0,1,1.0,1,0.10457483651815339,50
5266,2,10456,4003,6453,0,0,0,1.0,1,1.0,1,1.0,1,0.14131003257035243,49
5267,4,10460,4004,6456,0,0,0,1.0,1,1.0,1,1.0,1,0.0701197172371628,48
5268,2,10462,4006,6456,0,0,0,1.0,1,1.0,1,1.0,1,0.09992438268784762,47
5269,3,10465,4007,6458,0,0,0,1.0,1,1.0,1,1.0,1,0.1258516908629545,45
5270,1,10466,4008,6458,0,0,0,1.0,1,1.0,1,1.0,1,0.14750714608509494,47
5271,3,10469,4010,6459,0,0,0,1.0,1,1.0,1,1.0,1,0.13163354038430328,45
5272,5,10474,4014,6460,0,0,0,1.0,1,1.0,1,1.0,1,0.20543686019929716,46
5273,4,10478,4014,6464,0,0,0,1.0,1,1.0,1,1.0,1,0.10631414488320237,44
5274,2,10480,4015,6465,0,0,0,1.0,1,1.0,1,1.0,1,0.12238802350225761,44
5275,6,10486,4018,6468,0,0,0,1.0,1,1.0,1,1.0,1,0.13309042320137943,46
5276,1,10487,4018,6469,0,0,0,1.0,1,1.0,1,1.0,1,0.11719713048940458,46
5277,1,10488,4018,6470,0,0,0,1.0,1,1.0,1,1.0,1,0.0892640213558549,46
5278,3,10491,4021,6470,0,0,0,1.0,1,1.0,1,1.0,1,0.10483658667884173,46
5279,3,10494,4023,6471,0,0,0,1.0,1,1.0,1,1.0,1,0.12505232822347104,47
5280,3,10497,4025,6472,0,0,0,1.0,1,1.0,1,1.0,1,0.15238561946300114,47
5281,2,10499,4025,6474,0,0,0,1.0,1,1.0,1,1.0,1,0.14031817877362363,48
5282,1,10500,4025,6475,0,0,0,1.0,1,1.0,1,1.0,1,0.12768224489237848,48
5283,1,10501,4026,6475,0,0,0,1.0,1,1.0,1,1.0,1,0.1694023969898243,49
5284,0,10501,4026,6475,0,0,0,1.0,1,1.0,1,1.0,1,0.1694023969898243,49
5285,0,10501,4026,6475,0,0,0,1.0,1,1.0,1,1.0,1,0.1269308932709815,50
5286,2,10503,4026,6477,0,0,0,1.0,1,1.0,1,1.0,1,0.11499473945118373,51
5287,1,10504,4026,6478,0,0,0,1.0,1,1.0,1,1.0,1,0.10326331678562513,51
5288,0,10504,4026,6478,0,0,0,1.0,1,1.0,1,1.0,1,0.10326331678562513,51
5289,1,10505,4026,6479,0,0,0,1.0,1,1.0,1,1.0,1,0.10389067556907805,53
5290,0,10505,4026,6479,0,0,0,1.0,1,1.0,1,1.0,1,0.10389067556907805,53
5291,0,10505,4026,6479,0,0,0,1.0,1,1.0,1,1.0,1,0.10389067556907805,53
5292,4,10509,4028,6481,0,0,0,1.0,1,1.0,1,1.0,1,0.13157472207443427,53
5293,2,10511,4029,6482,0,0,0,1.0,1,1.0,1,1.0,1,0.12745872810942308,53
5294,3,10514,4030,6484,0,0,0,1.0,1,1.0,1,1.0,1,0.11532502465244467,54
5295,3,10517,4032,6485,0,0,0,1.0,1,1.0,1,1.0,1,0.12838535361236383,52
5296,1,10518,4032,6486,0,0,0,1.0,1,1.0,1,1.0,1,0.10537614842504009,49
5297,3,10521,4034,6487,0,0,0,1.0,1,1.0,1,1.0,1,0.14577084663364884,49
5298,1,10522,4035,6487,0,0,0,1.0,1,1.0,1,1.0,1,0.18024322962433986,49
5299,3,10525,4036,6489,0,0,0,1.0,1,1.0,1,1.0,1,0.15918148492639028,50
5300,0,10525,4036,6489,0,0,0,1.0,1,1.0,1,1.0,1,0.17572423786335348,48
5301,3,10528,4037,6491,0,0,0,1.0,1,1.0,1,1.0,1,0.19553551097056923,46
5302,2,10530,4038,6492,0,0,0,1.0,1,1.0,1,1.0,1,0.19359010990990028,47
5303,6,10536,4041,6495,0,0,0,1.0,1,1.0,1,1.0,1,0.17552764433708665,46
5304,3,10539,4043,6496,0,0,0,1.0,1,1.0,1,1.0,1,0.21558187248683164,45
5305,1,10540,4043,6497,0,0,0,1.0,1,1.0,1,1.0,1,0.199260047672548,44
5306,2,10542,4045,6497,0,0,0,1.0,1,1.0,1,1.0,1,0.25907065746089086,42
5307,2,10544,4046,6498,0,0,0,1.0,1,1.0,1,1.0,1,0.2030181322631925,42
5308,0,10544,4046,6498,0,0,0,1.0,1,1.0,1,1.0,1,0.2104950987630295,43
5309,1,10545,4047,6498,0,0,0,1.0,1,1.0,1,1.0,1,0.2156311597319973,41
5310,4,10549,4048,6501,0,0,0,1.0,1,1.0,1,1.0,1,0.22118529338039752,41
5311,4,10553,4049,6504,0,0,0,1.0,1,1.0,1,1.0,1,0.1737998934957885,42
5312,1,10554,4049,6505,0,0,0,1.0,1,1.0,1,1.0,1,0.16248741530996821,43
5313,2,10556,4049,6507,0,0,0,1.0,1,1.0,1,1.0,1,0.12083425504102314,44
5314,0,10556,4049,6507,0,0,0,1.0,1,1.0,1,1.0,1,0.12083425504102314,44
5315,3,10559,4051,6508,0,0,0,1.0,1,1.0,1,1.0,1,0.12829508749369337,45
5316,0,10559,4051,6508,0,0,0,1.0,1,1.0,1,1.0,1,0.13956560957594732,46
5317,1,10560,4051,6509,0,0,0,1.0,1,1.0,1,1.0,1,0.13869032429362857,46
5318,1,10561,4052,6509,0,0,0,1.0,1,1.0,1,1.0,1,0.13387642535652367,46
5319,6,10567,4053,6514,0,0,0,1.0,1,1.0,1,1.0,1,0.12145520646276335,47
5320,1,10568,4054,6514,0,0,0,1.0,1,1.0,1,1.0,1,0.10643511943455483,48
5321,2,10570,4054,6516,0,0,0,1.0,1,1.0,1,1.0,1,0.08494469916006699,49
5322,0,10570,4054,6516,0,0,0,1.0,1,1.0,1,1.0,1,0.08494469916006699,49
5323,1,10571,4054,6517,0,0,0,1.0,1,1.0,1,1.0,1,0.09938381647882683,51
5324,0,10571,4054,6517,0,0,0,1.0,1,1.0,1,1.0,1,0.10508440060467973,53
5325,1,10572,4055,6517,0,0,0,1.0,1,1.0,1,1.0,1,0.1062888149871051,53
5326,1,10573,4055,6518,0,0,0,1.0,1,1.0,1,1.0,1,0.09580784818617623,53
5327,0,10573,4055,6518,0,0,0,1.0,1,1.0,1,1.0,1,0.12452143041707107,53
5328,1,10574,4055,6519,0,0,0,1.0,1,1.0,1,1.0,1,0.1251501591296055,54
5329,4,10578,4057,6521,0,0,0,1.0,1,1.0,1,1.0,1,0.14414707504489915,53
5330,1,10579,4058,6521,0,0,0,1.0,1,1.0,1,1.0,1,0.15702519142551,52
5331,4,10583,4058,6525,0,0,0,1.0,1,1.0,1,1.0,1,0.1317748793260493,51
5332,1,10584,4059,6525,0,0,0,1.0,1,1.0,1,1.0,1,0.15190357545111144,52
5333,2,10586,4060,6526,0,0,0,1.0,1,1.0,1,1.0,1,0.1815379129445066,53
5334,3,10589,4061,6528,0,0,0,1.0,1,1.0,1,1.0,1,0.16932212218809192,54
5335,4,10593,4061,6532,0,0,0,1.0,1,1.0,1,1.0,1,0.10188149329204003,55
5336,1,10594,4061,6533,0,0,0,1.0,1,1.0,1,1.0,1,0.10556125384320122,54
5337,4,10598,4062,6536,0,0,0,1.0,1,1.0,1,1.0,1,0.11010402853310418,55
5338,1,10599,4062,6537,0,0,0,1.0,1,1.0,1,1.0,1,0.09413985971726165,55
5339,1,10600,4062,6538,0,0,0,1.0,1,1.0,1,1.0,1,0.09010340372936637,55
5340,1,10601,4063,6538,0,0,0,1.0,1,1.0,1,1.0,1,0.0957434126591893,55
5341,1,10602,4064,6538,0,0,0,1.0,1,1.0,1,1.0,1,0.12270882107182486,54
5342,1,10603,4065,6538,0,0,0,1.0,1,1.0,1,1.0,1,0.1386599718065425,55
5343,4,10607,4067,6540,0,0,0,1.0,1,1.0,1,1.0,1,0.09941254360492442,54
5344,2,10609,4068,6541,0,0,0,1.0,1,1.0,1,1.0,1,0.11623570610579251,55
5345,3,10612,4069,6543,0,0,0,1.0,1,1.0,1,1.0,1,0.10033930242559297,53
5346,3,10615,4071,6544,0,0,0,1.0,1,1.0,1,1.0,1,0.12829061621452764,53
5347,6,10621,4074,6547,0,0,0,1.0,1,1.0,1,1.0,1,0.09035293753880139,51
5348,4,10625,4076,6549,0,0,0,1.0,1,1.0,1,1.0,1,0.07907516866918593,53
5349,2,10627,4077,6550,0,0,0,1.0,1,1.0,1,1.0,1,0.05852279840299786,52
5350,1,10628,4078,6550,0,0,0,1.0,1,1.0,1,1.0,1,0.08123778204021521,50
5351,2,10630,4079,6551,0,0,0,1.0,1,1.0,1,1.0,1,0.09277114529914601,52
5352,2,10632,4081,6551,0,0,0,1.0,1,1.0,1,1.0,1,0.10775685720081324,49
5353,0,10632,4081,6551,0,0,0,1.0,1,1.0,1,1.0,1,0.10775685720081324,49
5354,0,10632,4081,6551,0,0,0,1.0,1,1.0,1,1.0,1,0.08579749890207475,49
5355,0,10632,4081,6551,0,0,0,1.0,1,1.0,1,1.0,1,0.09604293076774992,48
5356,3,10635,4082,6553,0,0,0,1.0,1,1.0,1,1.0,1,0.0940898069462178,49
5357,0,10635,4082,6553,0,0,0,1.0,1,1.0,1,1.0,1,0.11515677982326088,47
5358,1,10636,4083,6553,0,0,0,1.0,1,1.0,1,1.0,1,0.12852959929989277,48
5359,3,10639,4084,6555,0,0,0,1.0,1,1.0,1,1.0,1,0.10347307003691628,48
5360,0,10639,4084,6555,0,0,0,1.0,1,1.0,1,1.0,1,0.10347307003691628,48
5361,0,10639,4084,6555,0,0,0,1.0,1,1.0,1,1.0,1,0.10727320411446163,50
5362,0,10639,4084,6555,0,0,0,1.0,1,1.0,1,1.0,1,0.10727320411446163,50
5363,0,10639,4084,6555,0,0,0,1.0,1,1.0,1,1.0,1,0.10727320411446163,50
5364,2,10641,4086,6555,0,0,0,1.0,1,1.0,1,1.0,1,0.11423846630887231,51
5365,2,10643,4086,6557,0,0,0,1.0,1,1.0,1,1.0,1,0.11604122770694297,52
5366,0,10643,4086,6557,0,0,0,1.0,1,1.0,1,1.0,1,0.11604122770694297,52
5367,3,10646,4088,6558,0,0,0,1.0,1,1.0,1,1.0,1,0.1397799603344544,54
5368,5,10651,4088,6563,0,0,0,1.0,1,1.0,1,1.0,1,0.10238424212420477,55
5369,2,10653,4089,6564,0,0,0,1.0,1,1.0,1,1.0,1,0.1218689746420211,53
5370,2,10655,4090,6565,0,0,0,1.0,1,1.0,1,1.0,1,0.14104402688042783,54
5371,4,10659,4093,6566,0,0,0,1.0,1,1.0,1,1.0,1,0.17426831203393,53
5372,3,10662,4096,6566,0,0,0,1.0,1,1.0,1,1.0,1,0.2163813863378931,53
5373,4,10666,4096,6570,0,0,0,1.0,1,1.0,1,1.0,1,0.1334322315614227,52
5374,5,10671,4099,6572,0,0,0,1.0,1,1.0,1,1.0,1,0.1275942725685477,51
5375,1,10672,4099,6573,0,0,0,1.0,1,1.0,1,1.0,1,0.08979024963142725,52
5376,2,10674,4101,6573,0,0,0,1.0,1,1.0,1,1.0,1,0.14488811419940215,51
5377,2,10676,4101,6575,0,0,0,1.0,1,1.0,1,1.0,1,0.10574655211044584,52
5378,2,10678,4103,6575,0,0,0,1.0,1,1.0,1,1.0,1,0.13075426973315687,50
5379,0,10678,4103,6575,0,0,0,1.0,1,1.0,1,1.0,1,0.13075426973315687,50
5380,2,10680,4103,6577,0,0,0,1.0,1,1.0,1,1.0,1,0.1155887065682361,52
5381,0,10680,4103,6577,0,0,0,1.0,1,1.0,1,1.0,1,0.1155887065682361,52
5382,1,10681,4103,6578,0,0,0,1.0,1,1.0,1,1.0,1,0.10159509517579124,52
5383,0,10681,4103,6578,0,0,0,1.0,1,1.0,1,1.0,1,0.10280731575641586,51
5384,2,10683,4104,6579,0,0,0,1.0,1,1.0,1,1.0,1,0.10328869359685952,52
5385,1,10684,4105,6579,0,0,0,1.0,1,1.0,1,1.0,1,0.13578487104162196,51
5386,3,10687,4107,6580,0,0,0,1.0,1,1.0,1,1.0,1,0.1242381543756661,52
5387,3,10690,4107,6583,0,0,0,1.0,1,1.0,1,1.0,1,0.09476091935677192,53
5388,1,10691,4107,6584,0,0,0,1.0,1,1.0,1,1.0,1,0.06737478793440622,54
5389,1,10692,4108,6584,0,0,0,1.0,1,1.0,1,1.0,1,0.0781236846105673,55
5390,4,10696,4110,6586,0,0,0,1.0,1,1.0,1,1.0,1,0.08468698129607272,56
5391,1,10697,4110,6587,0,0,0,1.0,1,1.0,1,1.0,1,0.07667709196445192,56
5392,3,10700,4113,6587,0,0,0,1.0,1,1.0,1,1.0,1,0.11264600940912321,56
5393,5,10705,4114,6591,0,0,0,1.0,1,1.0,1,1.0,1,0.09348198885213861,54
5394,3,10708,4115,6593,0,0,0,1.0,1,1.0,1,1.0,1,0.08759284926728225,53
5395,2,10710,4115,6595,0,0,0,1.0,1,1.0,1,1.0,1,0.06935042032082345,53
5396,1,10711,4115,6596,0,0,0,1.0,1,1.0,1,1.0,1,0.05948862465759547,54
5397,2,10713,4117,6596,0,0,0,1.0,1,1.0,1,1.0,1,0.08149369875623175,53
5398,1,10714,4117,6597,0,0,0,1.0,1,1.0,1,1.0,1,0.08080310610775046,53
5399,7,10721,4121,6600,0,0,0,1.0,1,1.0,1,1.0,1,0.11825987247507674,55
5400,4,10725,4122,6603,0,0,0,1.0,1,1.0,1,1.0,1,0.10603769871940977,55
5401,7,10732,4124,6608,0,0,0,1.0,1,1.0,1,1.0,1,0.12107454305234659,56
5402,0,10732,4124,6608,0,0,0,1.0,1,1.0,1,1.0,1,0.0,0
